2006-01-02 00:00:00.000,Adelaide Australia ATP World Tour,HARD,2,Lleyton Hewitt,Jan Hernych,Lleyton Hewitt,4-6; 6-2; 6-4,R32,116,5,4,51,89,36,51,15,38,6,11,14,51,89,1,0,69,103,40,69,12,34,9,16,14,52,103
2006-01-02 00:00:00.000,Adelaide Australia ATP World Tour,HARD,2,Philipp Kohlschreiber,Chris Guccione,Philipp Kohlschreiber,6-4; 6-3,R32,76,4,1,28,49,22,28,14,21,2,3,9,36,49,14,5,49,84,30,49,14,35,12,16,10,44,84
2006-01-02 00:00:00.000,Adelaide Australia ATP World Tour,HARD,2,Andy Murray,Paolo Lorenzi,Andy Murray,3-6; 6-0; 6-2,R32,88,7,6,44,70,29,44,13,26,5,8,11,42,70,0,1,40,75,17,40,17,35,5,12,12,34,75
2006-01-02 00:00:00.000,Adelaide Australia ATP World Tour,HARD,2,Tomas Berdych,Agustin Calleri,Tomas Berdych,6-4; 6-7(5); 6-4,R32,138,5,5,53,103,43,53,29,50,4,5,16,72,103,13,9,58,110,43,58,27,52,5,8,16,70,110
2006-01-02 00:00:00.000,Adelaide Australia ATP World Tour,HARD,2,Mario Ancic,Arnaud Clement,Mario Ancic,6-0; 6-2,R32,59,7,0,23,36,21,23,8,13,2,2,7,29,36,1,1,23,45,15,23,4,22,4,9,7,19,45
2006-01-02 00:00:00.000,Adelaide Australia ATP World Tour,HARD,2,Xavier Malisse,Peter Luczak,Xavier Malisse,7-6(11); 6-3,R32,105,17,4,54,95,44,54,17,41,14,16,11,61,95,5,2,40,73,29,40,15,33,6,9,10,44,73
2006-01-02 00:00:00.000,Adelaide Australia ATP World Tour,HARD,2,Andreas Seppi,Boris Pashanski,Andreas Seppi,6-4; 6-4,R32,70,8,2,36,57,29,36,11,21,2,3,10,40,57,3,4,33,58,24,33,11,25,5,8,10,35,58
2006-01-02 00:00:00.000,Adelaide Australia ATP World Tour,HARD,2,James Blake,Alberto Martin,James Blake,6-3; 6-3,R32,65,4,0,25,51,21,25,13,26,3,5,9,34,51,3,6,33,60,21,33,8,27,6,11,9,29,60
2006-01-02 00:00:00.000,Adelaide Australia ATP World Tour,HARD,2,Jarkko Nieminen,Paul-Henri Mathieu,Jarkko Nieminen,6-2; 7-6(5),R32,92,3,2,52,78,36,52,14,26,5,6,10,50,78,4,5,35,66,27,35,13,31,5,8,10,40,66
2006-01-02 00:00:00.000,Adelaide Australia ATP World Tour,HARD,2,Florian Mayer,Juan Monaco,Florian Mayer,6-2; 6-4,R32,73,2,3,25,45,22,25,11,20,1,2,9,33,45,1,0,42,67,24,42,11,25,5,9,9,35,67
2006-01-02 00:00:00.000,Adelaide Australia ATP World Tour,HARD,2,Florent Serra,Michael Llodra,Florent Serra,3-6; 3-1 RET,R32,70,3,2,31,40,19,31,5,9,2,4,6,24,40,1,1,30,48,16,30,11,18,3,5,7,27,48
2006-01-02 00:00:00.000,Adelaide Australia ATP World Tour,HARD,2,Tommy Robredo,Jurgen Melzer,Tommy Robredo,7-5; 6-4,R32,83,2,3,27,59,23,27,23,32,0,0,11,46,59,1,4,41,79,32,41,17,38,4,6,11,49,79
2006-01-02 00:00:00.000,Adelaide Australia ATP World Tour,HARD,2,Ivo Karlovic,Juan Ignacio Chela,Ivo Karlovic,6-3; 3-6; 6-1,R32,104,13,2,46,79,37,46,16,33,1,2,13,53,79,3,3,48,80,33,48,16,32,5,8,12,49,80
2006-01-02 00:00:00.000,Adelaide Australia ATP World Tour,HARD,2,Kenneth Carlsen,Gregory Carraz,Kenneth Carlsen,5-7; 7-5; 6-3,R32,127,7,2,65,96,52,65,17,31,6,7,16,69,96,18,9,60,104,46,60,21,44,3,6,17,67,104
2006-01-02 00:00:00.000,Adelaide Australia ATP World Tour,HARD,2,Mark Philippoussis,Vincent Spadea,Mark Philippoussis,6-4; 3-6; 6-4,R32,121,14,2,53,94,36,53,21,41,6,10,15,57,94,4,3,55,95,37,55,18,40,6,10,14,55,95
2006-01-02 00:00:00.000,Adelaide Australia ATP World Tour,HARD,2,Dominik Hrbaty,Rameez Junaid,Dominik Hrbaty,6-3; 7-5,R32,71,6,5,37,63,26,37,15,26,3,5,11,41,63,2,5,33,58,23,33,9,25,2,6,10,32,58
2006-01-02 00:00:00.000,Adelaide Australia ATP World Tour,HARD,2,Philipp Kohlschreiber,Lleyton Hewitt,Philipp Kohlschreiber,6-3; 0-6; 7-5,R16,115,4,0,42,91,22,42,31,49,4,8,14,53,91,7,4,48,80,35,48,17,32,5,8,13,52,80
2006-01-02 00:00:00.000,Adelaide Australia ATP World Tour,HARD,2,Tomas Berdych,Andy Murray,Tomas Berdych,7-6(2); 4-6; 6-1,R16,127,5,5,56,94,42,56,18,38,0,2,14,60,94,5,3,54,106,39,54,22,52,10,14,15,61,106
2006-01-02 00:00:00.000,Adelaide Australia ATP World Tour,HARD,2,Xavier Malisse,Mario Ancic,Xavier Malisse,3-6; 6-3; 7-6(8),R16,147,6,1,56,93,40,56,18,37,4,8,15,58,93,5,5,54,100,35,54,25,46,5,9,15,60,100
2006-01-02 00:00:00.000,Adelaide Australia ATP World Tour,HARD,2,Andreas Seppi,James Blake,Andreas Seppi,3-6; 6-3; 6-4,R16,113,5,2,79,111,48,79,19,32,12,14,14,67,111,4,2,45,87,33,45,21,42,6,9,14,54,87
2006-01-02 00:00:00.000,Adelaide Australia ATP World Tour,HARD,2,Jarkko Nieminen,Florian Mayer,Jarkko Nieminen,7-6(1); 7-5,R16,78,2,1,43,69,32,43,15,26,0,3,12,47,69,4,0,36,69,24,36,18,33,2,6,12,42,69
2006-01-02 00:00:00.000,Adelaide Australia ATP World Tour,HARD,2,Florent Serra,Tommy Robredo,Florent Serra,7-6(4); 3-6; 6-3,R16,129,0,2,67,105,47,67,18,38,6,9,15,65,105,5,3,57,100,41,57,21,43,10,13,15,62,100
2006-01-02 00:00:00.000,Adelaide Australia ATP World Tour,HARD,2,Kenneth Carlsen,Ivo Karlovic,Kenneth Carlsen,2-6; 7-6(5); 6-4,R16,117,4,5,54,86,43,54,17,32,1,3,15,60,86,24,2,56,84,45,56,19,28,2,3,15,64,84
2006-01-02 00:00:00.000,Adelaide Australia ATP World Tour,HARD,2,Dominik Hrbaty,Mark Philippoussis,Dominik Hrbaty,3-6; 6-4; 6-1,R16,111,4,6,54,89,39,54,16,35,6,9,13,55,89,5,1,41,85,26,41,21,44,7,12,13,47,85
2006-01-02 00:00:00.000,Adelaide Australia ATP World Tour,HARD,2,Tomas Berdych,Philipp Kohlschreiber,Tomas Berdych,6-1; 6-4,Q,55,5,2,28,50,24,28,13,22,0,0,9,37,50,2,2,30,47,19,30,7,17,3,6,8,26,47
2006-01-02 00:00:00.000,Adelaide Australia ATP World Tour,HARD,2,Xavier Malisse,Andreas Seppi,Xavier Malisse,6-0; 6-1,Q,48,6,0,19,29,16,19,8,10,0,0,6,24,29,2,2,27,50,16,27,2,23,7,13,7,18,50
2006-01-02 00:00:00.000,Adelaide Australia ATP World Tour,HARD,2,Florent Serra,Jarkko Nieminen,Florent Serra,6-4; 6-7(4); 6-2,Q,118,4,2,63,98,45,63,18,35,4,6,15,63,98,1,5,57,95,37,57,16,38,1,6,15,53,95
2006-01-02 00:00:00.000,Adelaide Australia ATP World Tour,HARD,2,Dominik Hrbaty,Kenneth Carlsen,Dominik Hrbaty,7-5; 6-3,Q,86,4,5,46,72,33,46,14,26,7,8,10,47,72,4,3,41,70,26,41,12,29,3,7,11,38,70
2006-01-02 00:00:00.000,Adelaide Australia ATP World Tour,HARD,2,Xavier Malisse,Tomas Berdych,Xavier Malisse,6-4; 6-0,S,61,5,2,29,58,19,29,17,29,4,5,8,36,58,2,2,21,41,12,21,4,20,0,5,8,16,41
2006-01-02 00:00:00.000,Adelaide Australia ATP World Tour,HARD,2,Florent Serra,Dominik Hrbaty,Florent Serra,6-3; 6-3,S,76,4,4,38,66,25,38,16,28,7,8,9,41,66,1,6,33,60,17,33,12,27,4,8,9,29,60
2006-01-02 00:00:00.000,Adelaide Australia ATP World Tour,HARD,2,Florent Serra,Xavier Malisse,Florent Serra,6-3; 6-4,F,71,7,0,41,63,30,41,14,22,6,6,10,44,63,12,1,41,64,26,41,11,23,3,5,9,37,64
2006-01-02 00:00:00.000,Chennai India ATP World Tour,HARD,2,Ivan Ljubicic,Guillermo Garcia-Lopez,Ivan Ljubicic,7-6(6); 7-5,R32,130,13,3,58,86,41,58,15,28,6,8,12,56,86,6,8,70,104,46,70,14,34,3,6,12,60,104
2006-01-02 00:00:00.000,Chennai India ATP World Tour,HARD,2,Jiri Vanek,Vishal Uppal,Jiri Vanek,6-3; 6-1,R32,58,3,0,30,44,24,30,7,14,4,5,8,31,44,2,6,24,53,15,24,9,29,0,5,8,24,53
2006-01-02 00:00:00.000,Chennai India ATP World Tour,HARD,2,Rohan Bopanna,Cyril Saulnier,Rohan Bopanna,6-3; 6-3,R32,55,7,3,38,58,29,38,11,20,3,3,9,40,58,3,3,28,45,21,28,8,17,0,3,9,29,45
2006-01-02 00:00:00.000,Chennai India ATP World Tour,HARD,2,Gilles Muller,Razvan Sabau,Gilles Muller,6-2; 7-6(5),R32,73,13,6,32,57,29,32,10,25,1,4,10,39,57,1,10,32,66,25,32,11,34,4,9,10,36,66
2006-01-02 00:00:00.000,Chennai India ATP World Tour,HARD,2,Paradorn Srichaphan,Ramon Delgado,Paradorn Srichaphan,4-6; 6-1; 7-6(3),R32,136,11,2,51,90,41,51,23,39,1,2,15,64,90,6,2,65,113,46,65,23,48,11,13,14,69,113
2006-01-02 00:00:00.000,Chennai India ATP World Tour,HARD,2,Marc Gicquel,Hyung-Taik Lee,Marc Gicquel,7-5; 6-4,R32,94,6,1,39,72,25,39,13,33,2,6,11,38,72,1,1,35,65,18,35,15,30,7,13,11,33,65
2006-01-02 00:00:00.000,Chennai India ATP World Tour,HARD,2,Kristof Vliegen,Jimmy Wang,Kristof Vliegen,6-3; 6-2,R32,70,7,2,36,49,25,36,7,13,5,6,8,32,49,4,6,32,66,20,32,13,34,4,9,9,33,66
2006-01-02 00:00:00.000,Chennai India ATP World Tour,HARD,2,Rainer Schuettler,Fernando Vicente,Rainer Schuettler,6-4; 6-3,R32,78,1,3,41,58,27,41,8,17,4,7,10,35,58,4,3,30,52,17,30,8,22,3,8,9,25,52
2006-01-02 00:00:00.000,Chennai India ATP World Tour,HARD,2,Bjorn Phau,Bobby Reynolds,Bjorn Phau,6-3; 6-0,R32,67,2,3,21,48,15,21,18,27,2,2,7,33,48,2,6,31,58,16,31,10,27,3,8,8,26,58
2006-01-02 00:00:00.000,Chennai India ATP World Tour,HARD,2,Michael Berrer,Lukas Dlouhy,Michael Berrer,3-6; 6-3; 6-2,R32,97,5,1,48,66,37,48,10,18,1,3,13,47,66,8,5,54,96,35,54,18,42,7,11,13,53,96
2006-01-02 00:00:00.000,Chennai India ATP World Tour,HARD,2,Justin Gimelstob,Alexander Waske,Justin Gimelstob,6-2; 6-2,R32,70,9,2,37,52,27,37,8,15,2,3,8,35,52,5,4,32,55,18,32,8,23,5,10,8,26,55
2006-01-02 00:00:00.000,Chennai India ATP World Tour,HARD,2,Carlos Moya,Dick Norman,Carlos Moya,6-4; 3-6; 6-1,R32,101,13,2,39,73,35,39,18,34,4,5,13,53,73,12,6,57,98,37,57,22,41,10,13,13,59,98
2006-01-02 00:00:00.000,Chennai India ATP World Tour,HARD,2,Tomas Behrend,Marcos Daniel,Tomas Behrend,6-3; 7-5,R32,76,7,4,39,61,33,39,10,22,4,5,10,43,61,3,2,38,62,24,38,14,24,2,6,11,38,62
2006-01-02 00:00:00.000,Chennai India ATP World Tour,HARD,2,Thierry Ascione,Simon Greul,Thierry Ascione,7-5; 6-1,R32,75,7,2,34,61,24,34,18,27,1,1,10,42,61,2,1,20,54,13,20,19,34,3,6,9,32,54
2006-01-02 00:00:00.000,Chennai India ATP World Tour,HARD,2,Prakash Amritraj,Ricardo Mello,Prakash Amritraj,2-6; 6-2; 6-3,R32,102,1,2,27,65,24,27,21,38,3,6,13,45,65,3,1,51,68,33,51,7,17,2,6,12,40,68
2006-01-02 00:00:00.000,Chennai India ATP World Tour,HARD,2,Radek Stepanek,Ivan Navarro,Radek Stepanek,6-4; 7-6(3),R32,92,3,1,48,68,39,48,14,20,2,2,11,53,68,9,4,35,80,30,35,22,45,2,3,11,52,80
2006-01-02 00:00:00.000,Chennai India ATP World Tour,HARD,2,Ivan Ljubicic,Jiri Vanek,Ivan Ljubicic,6-3; 3-6; 6-3,R16,107,10,0,50,86,40,50,20,36,5,6,14,60,86,10,3,53,83,41,53,14,30,7,9,13,55,83
2006-01-02 00:00:00.000,Chennai India ATP World Tour,HARD,2,Gilles Muller,Rohan Bopanna,Gilles Muller,6-3; 6-4,R16,67,6,2,39,51,32,39,9,12,0,0,10,41,51,4,2,39,56,28,39,7,17,6,8,9,35,56
2006-01-02 00:00:00.000,Chennai India ATP World Tour,HARD,2,Paradorn Srichaphan,Marc Gicquel,Paradorn Srichaphan,6-3; 6-7(5); 6-2,R16,128,6,4,45,87,37,45,26,42,0,0,15,63,87,8,2,51,113,39,51,31,62,10,13,14,70,113
2006-01-02 00:00:00.000,Chennai India ATP World Tour,HARD,2,Kristof Vliegen,Rainer Schuettler,Kristof Vliegen,6-2; 6-4,R16,65,3,1,37,52,25,37,11,15,4,5,9,36,52,1,2,27,47,18,27,8,20,2,6,9,26,47
2006-01-02 00:00:00.000,Chennai India ATP World Tour,HARD,2,Bjorn Phau,Michael Berrer,Bjorn Phau,1-6; 6-2; 6-4,R16,102,2,1,44,79,31,44,18,35,6,10,13,49,79,2,2,48,72,30,48,11,24,5,9,12,41,72
2006-01-02 00:00:00.000,Chennai India ATP World Tour,HARD,2,Carlos Moya,Justin Gimelstob,Carlos Moya,3-6; 6-3; 6-4,R16,100,12,2,50,74,35,50,15,24,1,4,14,50,74,11,2,57,86,40,57,10,29,3,7,14,50,86
2006-01-02 00:00:00.000,Chennai India ATP World Tour,HARD,2,Thierry Ascione,Tomas Behrend,Thierry Ascione,6-4; 6-1,R16,75,4,3,39,60,31,39,8,21,4,5,9,39,60,2,3,35,60,22,35,9,25,7,11,8,31,60
2006-01-02 00:00:00.000,Chennai India ATP World Tour,HARD,2,Radek Stepanek,Prakash Amritraj,Radek Stepanek,3-6; 6-0; 6-4,R16,104,8,1,49,60,36,49,10,11,1,2,12,46,60,3,2,62,90,36,62,16,28,7,11,13,52,90
2006-01-02 00:00:00.000,Chennai India ATP World Tour,HARD,2,Ivan Ljubicic,Gilles Muller,Ivan Ljubicic,6-1; 6-3,Q,60,7,0,27,41,22,27,11,14,0,0,8,33,41,3,4,35,56,22,35,7,21,3,7,8,29,56
2006-01-02 00:00:00.000,Chennai India ATP World Tour,HARD,2,Kristof Vliegen,Paradorn Srichaphan,Kristof Vliegen,6-1; 6-2,Q,53,5,1,23,33,22,23,6,10,0,0,7,28,33,4,1,30,59,14,30,15,29,5,10,8,29,59
2006-01-02 00:00:00.000,Chennai India ATP World Tour,HARD,2,Carlos Moya,Bjorn Phau,Carlos Moya,6-4; 4-6; 6-1,Q,108,7,3,54,86,41,54,17,32,3,5,14,58,86,1,1,56,93,34,56,20,37,8,12,13,54,93
2006-01-02 00:00:00.000,Chennai India ATP World Tour,HARD,2,Radek Stepanek,Thierry Ascione,Radek Stepanek,6-3; 6-4,Q,78,2,0,33,56,20,33,16,23,2,3,9,36,56,0,3,32,62,19,32,16,30,0,4,10,35,62
2006-01-02 00:00:00.000,Chennai India ATP World Tour,HARD,2,Ivan Ljubicic,Kristof Vliegen,Ivan Ljubicic,6-3; 3-6; 7-6(6),S,124,20,2,56,85,47,56,18,29,2,3,15,65,85,4,3,62,99,49,62,21,37,3,4,15,70,99
2006-01-02 00:00:00.000,Chennai India ATP World Tour,HARD,2,Carlos Moya,Radek Stepanek,Carlos Moya,6-4; 6-7(5); 7-6(3),S,165,12,4,66,115,49,66,32,49,8,9,17,81,115,5,3,66,109,48,66,25,43,4,6,17,73,109
2006-01-02 00:00:00.000,Chennai India ATP World Tour,HARD,2,Ivan Ljubicic,Carlos Moya,Ivan Ljubicic,7-6(6); 6-2,F,101,12,4,40,63,35,40,12,23,2,2,10,47,63,5,2,56,93,39,56,15,37,7,9,10,54,93
2006-01-02 00:00:00.000,Doha Qatar ATP World Tour,HARD,2,Roger Federer,Ivo Minar,Roger Federer,6-1; 6-3,R32,64,0,1,33,62,21,33,18,29,6,7,8,39,62,5,3,36,66,20,36,12,30,7,12,8,32,66
2006-01-02 00:00:00.000,Doha Qatar ATP World Tour,HARD,2,Fabrice Santoro,Oliver Marach,Fabrice Santoro,6-0; 2-6; 6-4,R32,125,3,3,57,89,34,57,16,32,7,11,12,50,89,1,2,43,74,27,43,12,31,7,13,12,39,74
2006-01-02 00:00:00.000,Doha Qatar ATP World Tour,HARD,2,Marcos Baghdatis,Sultan Khalfan,Marcos Baghdatis,6-1; 6-1,R32,69,4,4,13,39,12,13,18,26,0,0,7,30,39,0,3,30,54,17,30,6,24,6,11,7,23,54
2006-01-02 00:00:00.000,Doha Qatar ATP World Tour,HARD,2,Feliciano Lopez,Victor Hanescu,Feliciano Lopez,6-4; 7-6(2),R32,80,6,3,28,64,21,28,21,36,2,5,11,42,64,2,0,38,58,25,38,8,20,1,5,11,33,58
2006-01-02 00:00:00.000,Doha Qatar ATP World Tour,HARD,2,Tim Henman,Richard Gasquet,Tim Henman,6-4; 6-4,R32,98,2,2,50,75,38,50,10,25,4,5,10,48,75,2,2,48,73,28,48,14,25,9,12,10,42,73
2006-01-02 00:00:00.000,Doha Qatar ATP World Tour,HARD,2,Tommy Haas,Stanislas Wawrinka,Tommy Haas,5-7; 6-2; 7-5,R32,147,5,4,55,99,37,55,24,44,2,5,16,61,99,4,8,62,116,39,62,26,54,10,15,16,65,116
2006-01-02 00:00:00.000,Doha Qatar ATP World Tour,HARD,2,Mikhail Youzhny,Jonas Bjorkman,Mikhail Youzhny,1-6; 6-3; 6-4,R32,103,7,9,45,89,32,45,17,44,5,10,13,49,89,3,6,54,83,35,54,9,29,5,10,13,44,83
2006-01-02 00:00:00.000,Doha Qatar ATP World Tour,HARD,2,Davide Sanguinetti,Olivier Rochus,Davide Sanguinetti,2-6; 7-6(4); 7-6(5),R32,166,18,3,72,135,55,72,25,63,16,21,16,80,135,0,2,69,110,46,69,22,41,2,5,16,68,110
2006-01-02 00:00:00.000,Doha Qatar ATP World Tour,HARD,2,Gael Monfils,Tomas Zib,Gael Monfils,7-5; 6-4,R32,81,11,1,32,61,27,32,16,29,0,1,11,43,61,0,1,37,62,22,37,15,25,4,7,11,37,62
2006-01-02 00:00:00.000,Doha Qatar ATP World Tour,HARD,2,Wesley Moodie,Max Mirnyi,Wesley Moodie,6-4; 4-6; 7-6(3),R32,132,13,3,66,94,50,66,17,28,2,5,16,67,94,15,9,72,111,56,72,14,39,10,13,16,70,111
2006-01-02 00:00:00.000,Doha Qatar ATP World Tour,HARD,2,Dmitry Tursunov,Janko Tipsarevic,Dmitry Tursunov,7-5; 6-2,R32,85,5,2,31,63,21,31,20,32,5,6,10,41,63,3,0,40,77,26,40,16,37,5,9,10,42,77
2006-01-02 00:00:00.000,Doha Qatar ATP World Tour,HARD,2,Younes El Aynaoui,Sebastien Grosjean,Younes El Aynaoui,6-4; 6-4,R32,80,4,2,34,58,26,34,11,24,1,3,10,37,58,3,1,32,52,23,32,7,20,2,6,10,30,52
2006-01-02 00:00:00.000,Doha Qatar ATP World Tour,HARD,2,Potito Starace,Igor Andreev,Potito Starace,7-5; 1-6; 7-5,R32,130,5,4,63,99,43,63,14,36,7,11,15,57,99,6,4,59,90,44,59,13,31,2,6,16,57,90
2006-01-02 00:00:00.000,Doha Qatar ATP World Tour,HARD,2,Filippo Volandri,Nicolas Mahut,Filippo Volandri,6-4; 6-4,R32,80,0,1,43,66,30,43,13,23,7,9,10,43,66,2,2,40,63,24,40,9,23,6,10,10,33,63
2006-01-02 00:00:00.000,Doha Qatar ATP World Tour,HARD,2,Robin Vik,Andrei Pavel,Robin Vik,2-6; 7-6(2); 7-6(1),R32,145,7,4,85,109,54,85,11,24,3,8,16,65,109,1,3,79,109,48,79,18,30,6,9,16,66,109
2006-01-02 00:00:00.000,Doha Qatar ATP World Tour,HARD,2,Nikolay Davydenko,Christophe Rochus,Nikolay Davydenko,6-3; 6-1,R32,61,4,1,38,48,27,38,5,10,3,4,8,32,48,0,3,32,59,17,32,9,27,5,10,8,26,59
2006-01-02 00:00:00.000,Doha Qatar ATP World Tour,HARD,2,Roger Federer,Fabrice Santoro,Roger Federer,7-6(2); 7-6(5),R16,95,11,0,57,74,44,57,12,17,0,0,12,56,74,4,2,59,92,42,59,20,33,6,6,12,62,92
2006-01-02 00:00:00.000,Doha Qatar ATP World Tour,HARD,2,Marcos Baghdatis,Feliciano Lopez,Marcos Baghdatis,6-2; 3-6; 7-5,R16,112,10,3,54,86,41,54,20,32,5,6,14,61,86,7,9,55,95,41,55,19,40,7,10,15,60,95
2006-01-02 00:00:00.000,Doha Qatar ATP World Tour,HARD,2,Tommy Haas,Tim Henman,Tommy Haas,6-2; 7-6(5),R16,101,7,0,43,58,33,43,11,15,0,0,10,44,58,3,4,44,85,34,44,15,41,9,11,10,49,85
2006-01-02 00:00:00.000,Doha Qatar ATP World Tour,HARD,2,Mikhail Youzhny,Davide Sanguinetti,Mikhail Youzhny,6-2; 6-3,R16,76,0,1,31,55,23,31,15,24,1,1,9,38,55,3,1,38,55,24,38,5,17,5,8,8,29,55
2006-01-02 00:00:00.000,Doha Qatar ATP World Tour,HARD,2,Gael Monfils,Wesley Moodie,Gael Monfils,7-6(3); 6-4,R16,91,4,1,37,64,31,37,16,27,0,1,11,47,64,3,2,45,63,31,45,12,18,0,2,11,43,63
2006-01-02 00:00:00.000,Doha Qatar ATP World Tour,HARD,2,Dmitry Tursunov,Younes El Aynaoui,Dmitry Tursunov,7-6(1); 6-2,R16,97,7,2,40,74,31,40,16,34,9,10,10,47,74,5,4,31,65,23,31,14,34,2,5,10,37,65
2006-01-02 00:00:00.000,Doha Qatar ATP World Tour,HARD,2,Filippo Volandri,Potito Starace,Filippo Volandri,6-4; 6-3,R16,78,1,3,35,52,26,35,10,17,0,1,9,36,52,1,1,45,72,25,45,14,27,6,10,10,39,72
2006-01-02 00:00:00.000,Doha Qatar ATP World Tour,HARD,2,Nikolay Davydenko,Robin Vik,Nikolay Davydenko,6-3; 6-4,R16,91,2,2,36,52,27,36,10,16,4,5,9,37,52,2,2,51,80,31,51,12,29,5,9,10,43,80
2006-01-02 00:00:00.000,Doha Qatar ATP World Tour,HARD,2,Roger Federer,Marcos Baghdatis,Roger Federer,6-4; 6-3,Q,69,3,1,43,61,31,43,11,18,3,4,10,42,61,4,2,38,53,26,38,5,15,5,8,9,31,53
2006-01-02 00:00:00.000,Doha Qatar ATP World Tour,HARD,2,Tommy Haas,Mikhail Youzhny,Tommy Haas,6-4; 6-3,Q,81,1,2,43,64,28,43,10,21,6,9,10,38,64,2,5,27,65,17,27,15,38,7,12,9,32,65
2006-01-02 00:00:00.000,Doha Qatar ATP World Tour,HARD,2,Gael Monfils,Dmitry Tursunov,Gael Monfils,6-2; 7-6(4),Q,101,4,4,36,71,23,36,17,35,3,7,10,40,71,5,1,45,72,25,45,12,27,5,11,10,37,72
2006-01-02 00:00:00.000,Doha Qatar ATP World Tour,HARD,2,Filippo Volandri,Nikolay Davydenko,Filippo Volandri,6-3; 6-4,Q,89,0,7,45,76,32,45,16,31,6,7,10,48,76,1,3,32,60,20,32,14,28,4,7,9,34,60
2006-01-02 00:00:00.000,Doha Qatar ATP World Tour,HARD,2,Roger Federer,Tommy Haas,Roger Federer,6-3; 6-3,S,70,3,3,26,55,21,26,19,29,0,0,9,40,55,2,1,32,49,21,32,8,17,3,6,9,29,49
2006-01-02 00:00:00.000,Doha Qatar ATP World Tour,HARD,2,Gael Monfils,Filippo Volandri,Gael Monfils,6-3; 6-4,S,69,8,3,36,63,22,36,18,27,2,4,10,40,63,0,0,38,53,21,38,8,15,2,6,9,29,53
2006-01-02 00:00:00.000,Doha Qatar ATP World Tour,HARD,2,Roger Federer,Gael Monfils,Roger Federer,6-3; 7-6(5),F,115,2,0,40,69,28,40,18,29,4,6,11,46,69,12,8,47,96,31,47,20,49,12,15,10,51,96
2006-01-09 00:00:00.000,Auckland New Zealand ATP World Tour,HARD,2,Fernando Gonzalez,Luis Horna,Fernando Gonzalez,6-3; 6-4,R32,65,13,7,26,55,23,26,17,29,1,2,10,40,55,2,4,34,53,20,34,12,19,2,5,9,32,53
2006-01-09 00:00:00.000,Auckland New Zealand ATP World Tour,HARD,2,Ivo Minar,Wesley Moodie,Ivo Minar,2-1 RET,R32,14,1,1,14,22,12,14,1,8,4,4,2,13,22,0,1,3,5,3,3,1,2,0,0,1,4,5
2006-01-09 00:00:00.000,Auckland New Zealand ATP World Tour,HARD,2,Andy Murray,Kenneth Carlsen,Andy Murray,7-5; 6-2,R32,105,5,8,35,65,22,35,16,30,4,7,10,38,65,1,4,36,72,18,36,16,36,9,15,10,34,72
2006-01-09 00:00:00.000,Auckland New Zealand ATP World Tour,HARD,2,Mario Ancic,Mark Nielsen,Mario Ancic,6-1; 6-2,R32,77,10,1,23,48,18,23,18,25,2,2,8,36,48,1,1,46,60,22,46,7,14,5,9,7,29,60
2006-01-09 00:00:00.000,Auckland New Zealand ATP World Tour,HARD,2,Alberto Martin,Robby Ginepri,Alberto Martin,7-6(1); 3-6; 6-2,R32,113,3,5,53,90,35,53,18,37,4,10,15,53,90,4,1,53,94,32,53,18,41,9,15,14,50,94
2006-01-09 00:00:00.000,Auckland New Zealand ATP World Tour,HARD,2,Stanislas Wawrinka,Tomas Zib,Stanislas Wawrinka,6-3; 6-4,R32,76,8,2,42,67,33,42,12,25,1,2,10,45,67,3,1,33,62,21,33,15,29,4,7,9,36,62
2006-01-09 00:00:00.000,Auckland New Zealand ATP World Tour,HARD,2,Florian Mayer,Daniel King-Turner,Florian Mayer,6-2; 6-2,R32,63,2,1,25,41,23,25,10,16,1,1,8,33,41,3,4,42,67,24,42,9,25,3,7,8,33,67
2006-01-09 00:00:00.000,Auckland New Zealand ATP World Tour,HARD,2,Robin Vik,Feliciano Lopez,Robin Vik,7-6(6); 6-1,R32,81,6,7,38,67,29,38,15,29,5,7,9,44,67,3,5,46,80,28,46,13,34,10,15,10,41,80
2006-01-09 00:00:00.000,Auckland New Zealand ATP World Tour,HARD,2,Jarkko Nieminen,Marcos Baghdatis,Jarkko Nieminen,6-2; 6-2,R32,51,2,0,29,42,22,29,11,13,0,0,8,33,42,3,6,27,49,19,27,5,22,6,10,8,24,49
2006-01-09 00:00:00.000,Auckland New Zealand ATP World Tour,HARD,2,Paul Goldstein,Filippo Volandri,Paul Goldstein,6-0; 3-1 RET,R32,39,1,0,13,27,10,13,10,14,0,0,5,20,27,0,4,26,40,14,26,3,14,6,10,5,17,40
2006-01-09 00:00:00.000,Auckland New Zealand ATP World Tour,HARD,2,Christophe Rochus,Jose Acasuso,Christophe Rochus,6-4; 6-4,R32,66,1,3,44,64,35,44,9,20,9,10,10,44,64,9,3,30,54,21,30,12,24,3,6,10,33,54
2006-01-09 00:00:00.000,Auckland New Zealand ATP World Tour,HARD,2,Nicolas Massu,Dominik Hrbaty,Nicolas Massu,6-2; 6-4,R32,91,6,0,30,55,22,30,16,25,1,2,9,38,55,3,4,27,70,16,27,19,43,5,9,9,35,70
2006-01-09 00:00:00.000,Auckland New Zealand ATP World Tour,HARD,2,Olivier Rochus,Albert Montanes,Olivier Rochus,6-2; 6-4,R32,60,3,0,29,47,20,29,15,18,3,4,9,35,47,6,6,35,63,23,35,10,28,3,7,9,33,63
2006-01-09 00:00:00.000,Auckland New Zealand ATP World Tour,HARD,2,Jan Hernych,Andrei Pavel,Jan Hernych,6-1; 6-2,R32,53,2,0,47,60,29,47,11,13,5,5,8,40,60,0,0,35,46,17,35,4,11,4,8,7,21,46
2006-01-09 00:00:00.000,Auckland New Zealand ATP World Tour,HARD,2,Raemon Sluiter,Daniele Bracciali,Raemon Sluiter,6-3; 6-4,R32,63,13,1,26,47,25,26,16,21,0,0,10,41,47,5,5,24,62,17,24,19,38,4,6,9,36,62
2006-01-09 00:00:00.000,Auckland New Zealand ATP World Tour,HARD,2,David Ferrer,Federico Luzzi,David Ferrer,7-5; 6-2,R32,67,5,0,36,54,25,36,15,18,4,5,10,40,54,3,2,29,56,18,29,14,27,2,6,10,32,56
2006-01-09 00:00:00.000,Auckland New Zealand ATP World Tour,HARD,2,Fernando Gonzalez,Ivo Minar,Fernando Gonzalez,6-1; 6-4,R16,56,6,8,30,57,23,30,12,27,3,5,9,35,57,1,3,20,46,13,20,8,26,3,8,8,21,46
2006-01-09 00:00:00.000,Auckland New Zealand ATP World Tour,HARD,2,Mario Ancic,Andy Murray,Mario Ancic,6-3; 7-6(4),R16,95,6,2,48,80,36,48,16,32,8,10,11,52,80,1,4,32,62,22,32,17,30,2,5,10,39,62
2006-01-09 00:00:00.000,Auckland New Zealand ATP World Tour,HARD,2,Stanislas Wawrinka,Alberto Martin,Stanislas Wawrinka,6-2; 6-2,R16,69,5,3,20,41,19,20,10,21,1,2,8,29,41,0,1,41,66,22,41,9,25,10,15,8,31,66
2006-01-09 00:00:00.000,Auckland New Zealand ATP World Tour,HARD,2,Florian Mayer,Robin Vik,Florian Mayer,6-2; 6-2,R16,56,1,1,25,46,16,25,14,21,1,2,8,30,46,0,1,25,48,11,25,10,23,3,8,8,21,48
2006-01-09 00:00:00.000,Auckland New Zealand ATP World Tour,HARD,2,Jarkko Nieminen,Paul Goldstein,Jarkko Nieminen,6-4; 6-3,R16,74,5,0,39,56,29,39,11,17,1,2,10,40,56,3,2,36,59,22,36,11,23,2,5,9,33,59
2006-01-09 00:00:00.000,Auckland New Zealand ATP World Tour,HARD,2,Nicolas Massu,Christophe Rochus,Nicolas Massu,6-4; 6-2,R16,85,9,4,33,58,25,33,13,25,1,2,9,38,58,2,0,45,65,26,45,8,20,8,12,9,34,65
2006-01-09 00:00:00.000,Auckland New Zealand ATP World Tour,HARD,2,Olivier Rochus,Jan Hernych,Olivier Rochus,6-1; 7-5,R16,93,1,2,44,72,27,44,15,28,5,7,9,42,72,7,2,62,91,35,62,8,29,7,13,10,43,91
2006-01-09 00:00:00.000,Auckland New Zealand ATP World Tour,HARD,2,David Ferrer,Raemon Sluiter,David Ferrer,6-4; 6-3,R16,65,4,2,40,65,29,40,15,25,4,5,10,44,65,1,3,24,47,15,24,12,23,1,4,9,27,47
2006-01-09 00:00:00.000,Auckland New Zealand ATP World Tour,HARD,2,Mario Ancic,Fernando Gonzalez,Mario Ancic,6-0; 6-3,Q,53,6,1,35,48,27,35,8,13,5,5,8,35,48,2,5,23,39,14,23,4,16,4,8,7,18,39
2006-01-09 00:00:00.000,Auckland New Zealand ATP World Tour,HARD,2,Stanislas Wawrinka,Florian Mayer,Stanislas Wawrinka,6-3; 6-4,Q,64,4,7,26,54,23,26,17,28,0,0,10,40,54,3,0,37,63,26,37,13,26,7,9,9,39,63
2006-01-09 00:00:00.000,Auckland New Zealand ATP World Tour,HARD,2,Jarkko Nieminen,Nicolas Massu,Jarkko Nieminen,6-3; 7-6(4),Q,92,1,1,55,75,41,55,11,20,1,1,10,52,75,6,3,34,56,24,34,15,22,0,2,11,39,56
2006-01-09 00:00:00.000,Auckland New Zealand ATP World Tour,HARD,2,Olivier Rochus,David Ferrer,Olivier Rochus,6-2; 6-0,Q,50,0,0,22,35,18,22,11,13,0,0,7,29,35,2,2,27,43,14,27,4,16,4,9,7,18,43
2006-01-09 00:00:00.000,Auckland New Zealand ATP World Tour,HARD,2,Mario Ancic,Stanislas Wawrinka,Mario Ancic,6-3; 6-1,S,78,2,2,35,57,23,35,13,22,2,3,8,36,57,1,4,21,54,11,21,14,33,1,6,8,25,54
2006-01-09 00:00:00.000,Auckland New Zealand ATP World Tour,HARD,2,Jarkko Nieminen,Olivier Rochus,Jarkko Nieminen,6-4; 6-7(4); 7-6(4),S,172,10,5,116,166,70,116,22,50,15,21,17,92,166,5,2,73,122,41,73,28,49,8,15,17,69,122
2006-01-09 00:00:00.000,Auckland New Zealand ATP World Tour,HARD,2,Jarkko Nieminen,Mario Ancic,Jarkko Nieminen,6-2; 6-2,F,61,0,0,37,54,26,37,11,17,3,3,8,37,54,1,0,28,45,17,28,5,17,1,5,8,22,45
2006-01-09 00:00:00.000,Sydney Australia ATP World Tour,HARD,2,Lleyton Hewitt,Vincent Spadea,Lleyton Hewitt,2-6; 7-5; 6-3,R32,122,6,10,50,98,36,50,25,48,11,14,15,61,98,2,3,38,80,28,38,22,42,2,5,14,50,80
2006-01-09 00:00:00.000,Sydney Australia ATP World Tour,HARD,2,Jurgen Melzer,Juan Ignacio Chela,Jurgen Melzer,6-2; 7-6(1),R32,75,3,3,32,62,28,32,14,30,1,2,10,42,62,0,1,35,55,20,35,13,20,1,4,10,33,55
2006-01-09 00:00:00.000,Sydney Australia ATP World Tour,HARD,2,Andreas Seppi,Kristof Vliegen,Andreas Seppi,6-3; 6-7(3); 6-3,R32,122,2,1,59,87,37,59,17,28,3,6,14,54,87,8,2,83,111,46,83,17,28,4,11,16,63,111
2006-01-09 00:00:00.000,Sydney Australia ATP World Tour,HARD,2,Chris Guccione,Juan Carlos Ferrero,Chris Guccione,4-6; 6-3; 7-5,R32,97,27,4,47,82,44,47,18,35,0,1,16,62,82,6,2,50,80,40,50,17,30,1,3,15,57,80
2006-01-09 00:00:00.000,Sydney Australia ATP World Tour,HARD,2,Igor Andreev,Richard Gasquet,Igor Andreev,6-2; 6-4,R32,65,2,2,33,53,22,33,14,20,3,4,9,36,53,1,4,24,50,15,24,11,26,3,7,9,26,50
2006-01-09 00:00:00.000,Sydney Australia ATP World Tour,HARD,2,Peter Luczak,Xavier Malisse,Peter Luczak,7-6(5); 7-6(3),R32,111,4,6,53,82,41,53,14,29,2,4,12,55,82,3,4,39,84,30,39,23,45,4,6,12,53,84
2006-01-09 00:00:00.000,Sydney Australia ATP World Tour,HARD,2,Florent Serra,Fabrice Santoro,Florent Serra,5-7; 6-2; 6-4,R32,126,3,2,67,106,41,67,20,39,7,11,15,61,106,3,7,48,92,32,48,18,44,7,13,15,50,92
2006-01-09 00:00:00.000,Sydney Australia ATP World Tour,HARD,2,Dmitry Tursunov,Tommy Robredo,Dmitry Tursunov,7-6(4); 6-3,R32,93,7,4,39,79,24,39,25,40,3,4,10,49,79,2,1,40,69,25,40,13,29,1,4,11,38,69
2006-01-09 00:00:00.000,Sydney Australia ATP World Tour,HARD,2,James Blake,Davide Sanguinetti,James Blake,7-6(4); 6-4,R32,84,5,3,47,78,37,47,15,31,2,3,11,52,78,2,7,39,74,29,39,17,35,2,4,11,46,74
2006-01-09 00:00:00.000,Sydney Australia ATP World Tour,HARD,2,Carlos Moya,Sebastien Grosjean,Carlos Moya,5-7; 7-5; 7-6(4),R32,153,10,8,60,109,44,60,30,49,3,6,18,74,109,9,1,65,125,52,65,29,60,15,18,18,81,125
2006-01-09 00:00:00.000,Sydney Australia ATP World Tour,HARD,2,Arnaud Clement,Taylor Dent,Arnaud Clement,6-1; 2-6; 6-2,R32,60,4,2,34,66,26,34,20,32,4,6,12,46,66,7,8,29,66,21,29,18,37,6,10,11,39,66
2006-01-09 00:00:00.000,Sydney Australia ATP World Tour,HARD,2,Juan Monaco,Fernando Verdasco,Juan Monaco,6-3; 6-2,R32,63,2,1,30,50,25,30,14,20,2,2,9,39,50,2,5,25,47,21,25,7,22,4,7,8,28,47
2006-01-09 00:00:00.000,Sydney Australia ATP World Tour,HARD,2,Paradorn Srichaphan,Radek Stepanek,Paradorn Srichaphan,6-3; 6-4,R32,71,10,3,36,59,29,36,15,23,2,2,10,44,59,4,3,26,45,19,26,11,19,1,3,9,30,45
2006-01-09 00:00:00.000,Sydney Australia ATP World Tour,HARD,2,Ivo Karlovic,Victor Hanescu,Ivo Karlovic,7-6(7); 3-6; 6-3,R32,124,11,2,57,89,44,57,19,32,4,5,15,63,89,3,3,53,91,39,53,24,38,3,4,15,63,91
2006-01-09 00:00:00.000,Sydney Australia ATP World Tour,HARD,2,Agustin Calleri,Paul-Henri Mathieu,Agustin Calleri,6-4; 6-3,R32,85,4,5,13,45,10,13,17,32,1,4,9,27,45,0,8,34,72,20,34,14,38,3,9,10,34,72
2006-01-09 00:00:00.000,Sydney Australia ATP World Tour,HARD,2,Nikolay Davydenko,Tomas Berdych,Nikolay Davydenko,7-6(4); 6-3,R32,106,1,2,47,74,34,47,14,27,4,6,11,48,74,4,5,41,79,27,41,17,38,6,9,10,44,79
2006-01-09 00:00:00.000,Sydney Australia ATP World Tour,HARD,2,Lleyton Hewitt,Jurgen Melzer,Lleyton Hewitt,6-1; 6-4,R16,84,6,2,35,68,25,35,16,33,3,4,9,41,68,1,4,36,70,19,36,17,34,7,11,8,36,70
2006-01-09 00:00:00.000,Sydney Australia ATP World Tour,HARD,2,Andreas Seppi,Chris Guccione,Andreas Seppi,7-5; 7-6(2),R16,83,5,6,38,70,31,38,20,32,4,6,12,51,70,15,5,55,91,38,55,15,36,10,13,12,53,91
2006-01-09 00:00:00.000,Sydney Australia ATP World Tour,HARD,2,Igor Andreev,Peter Luczak,Igor Andreev,6-7(6); 7-6(5); 7-6(6),R16,195,6,7,94,132,69,94,13,38,4,8,18,82,132,3,3,106,136,65,106,17,30,6,10,18,82,136
2006-01-09 00:00:00.000,Sydney Australia ATP World Tour,HARD,2,Dmitry Tursunov,Florent Serra,Dmitry Tursunov,7-6(3); 6-2,R16,78,6,2,37,61,30,37,13,24,1,2,10,43,61,2,0,39,69,21,39,17,30,4,7,10,38,69
2006-01-09 00:00:00.000,Sydney Australia ATP World Tour,HARD,2,James Blake,Carlos Moya,James Blake,W/O,R16,0,0,0,0,0,0,0,0,0,0,0,0,0,0,0,0,0,0,0,0,0,0,0,0,0,0,0
2006-01-09 00:00:00.000,Sydney Australia ATP World Tour,HARD,2,Arnaud Clement,Juan Monaco,Arnaud Clement,7-6(3); 6-3,R16,112,4,3,28,63,20,28,26,35,1,1,10,46,63,1,1,41,71,26,41,18,30,3,5,11,44,71
2006-01-09 00:00:00.000,Sydney Australia ATP World Tour,HARD,2,Paradorn Srichaphan,Ivo Karlovic,Paradorn Srichaphan,7-6(5); 7-6(6),R16,109,2,5,43,82,35,43,26,39,1,2,12,61,82,21,4,47,83,42,47,16,36,2,3,12,58,83
2006-01-09 00:00:00.000,Sydney Australia ATP World Tour,HARD,2,Nikolay Davydenko,Agustin Calleri,Nikolay Davydenko,6-4; 7-6(4),R16,109,1,3,71,95,44,71,15,24,8,10,11,59,95,2,4,42,71,29,42,14,29,2,5,11,43,71
2006-01-09 00:00:00.000,Sydney Australia ATP World Tour,HARD,2,Andreas Seppi,Lleyton Hewitt,Andreas Seppi,4-6; 7-5; 7-5,Q,137,8,2,64,108,42,64,20,44,5,11,17,62,108,5,4,53,92,38,53,16,39,4,11,17,54,92
2006-01-09 00:00:00.000,Sydney Australia ATP World Tour,HARD,2,Igor Andreev,Dmitry Tursunov,Igor Andreev,6-2; 3-6; 6-4,Q,121,7,4,57,85,37,57,13,28,7,10,13,50,85,8,1,62,102,38,62,19,40,9,14,14,57,102
2006-01-09 00:00:00.000,Sydney Australia ATP World Tour,HARD,2,James Blake,Arnaud Clement,James Blake,3-6; 6-1; 6-4,Q,121,11,5,51,96,39,51,22,45,4,5,13,61,96,7,5,53,96,37,53,20,43,8,11,13,57,96
2006-01-09 00:00:00.000,Sydney Australia ATP World Tour,HARD,2,Nikolay Davydenko,Paradorn Srichaphan,Nikolay Davydenko,W/O,Q,0,0,0,0,0,0,0,0,0,0,0,0,0,0,0,0,0,0,0,0,0,0,0,0,0,0,0
2006-01-09 00:00:00.000,Sydney Australia ATP World Tour,HARD,2,Igor Andreev,Andreas Seppi,Igor Andreev,6-2; 2-6; 6-2,S,97,2,5,48,78,33,48,15,30,1,3,12,48,78,1,1,28,64,21,28,18,36,0,4,12,39,64
2006-01-09 00:00:00.000,Sydney Australia ATP World Tour,HARD,2,James Blake,Nikolay Davydenko,James Blake,6-4; 6-2,S,83,7,1,43,75,26,43,16,32,8,11,9,42,75,1,4,34,57,20,34,5,23,3,9,9,25,57
2006-01-09 00:00:00.000,Sydney Australia ATP World Tour,HARD,2,James Blake,Igor Andreev,James Blake,6-2; 3-6; 7-6(3),F,109,9,3,53,95,38,53,22,42,4,7,14,60,95,7,4,61,92,44,61,14,31,5,9,15,58,92
2006-01-16 00:00:00.000,Australian Open Australia Grand Slams,HARD,3,Roger Federer,Denis Istomin,Roger Federer,6-2; 6-3; 6-2,R128,83,2,0,46,67,38,46,12,21,2,3,13,50,67,8,3,53,83,31,53,11,30,5,11,12,42,83
2006-01-16 00:00:00.000,Australian Open Australia Grand Slams,HARD,3,Florian Mayer,Hyung-Taik Lee,Florian Mayer,6-4; 6-1; 4-6; 6-4,R128,138,10,3,54,107,42,54,23,53,2,7,18,65,107,2,4,71,113,36,71,22,42,5,14,19,58,113
2006-01-16 00:00:00.000,Australian Open Australia Grand Slams,HARD,3,Davide Sanguinetti,Jacob Adaktusson,Davide Sanguinetti,7-6(5); 6-3; 6-2,R128,111,5,1,52,92,40,52,25,40,3,4,14,65,92,5,3,60,112,39,60,22,52,7,12,15,61,112
2006-01-16 00:00:00.000,Australian Open Australia Grand Slams,HARD,3,Max Mirnyi,Thierry Ascione,Max Mirnyi,6-3; 3-6; 6-1; 6-7(4); 6-0,R128,155,11,7,107,145,78,107,20,38,10,12,22,98,145,4,4,99,130,65,99,13,31,5,12,21,78,130
2006-01-16 00:00:00.000,Australian Open Australia Grand Slams,HARD,3,Olivier Rochus,Michael Llodra,Olivier Rochus,6-4; 6-2; 6-2,R128,96,2,0,48,73,34,48,21,25,3,3,13,55,73,9,2,45,78,30,45,14,33,2,7,13,44,78
2006-01-16 00:00:00.000,Australian Open Australia Grand Slams,HARD,3,Peter Luczak,Ivo Minar,Peter Luczak,7-6(4); 7-6(5); 6-4,R128,120,15,2,69,107,54,69,26,38,2,3,17,80,107,12,0,54,101,44,54,31,47,2,4,17,75,101
2006-01-16 00:00:00.000,Australian Open Australia Grand Slams,HARD,3,Paul Goldstein,Novak Djokovic,Paul Goldstein,6-2; 1-6; 6-3; 6-2,R128,148,2,7,72,116,51,72,20,44,10,13,16,71,116,6,9,71,114,44,71,18,43,13,19,16,62,114
2006-01-16 00:00:00.000,Australian Open Australia Grand Slams,HARD,3,Tommy Haas,Richard Gasquet,Tommy Haas,6-2; 7-5; 6-2,R128,111,7,1,56,91,44,56,19,35,10,11,14,63,91,4,4,39,78,25,39,20,39,4,10,14,45,78
2006-01-16 00:00:00.000,Australian Open Australia Grand Slams,HARD,3,Dominik Hrbaty,Oliver Marach,Dominik Hrbaty,3-6; 4-6; 6-2; 6-1; 6-3,R128,183,7,8,66,113,46,66,26,47,3,9,21,72,113,12,9,79,166,53,79,32,87,13,23,22,85,166
2006-01-16 00:00:00.000,Australian Open Australia Grand Slams,HARD,3,Dick Norman,Zack Fleishman,Dick Norman,6-4; 7-6(6); 5-7; 0-6; 6-3,R128,211,18,9,112,179,81,112,22,67,17,25,25,103,179,6,9,84,161,58,84,41,77,7,13,24,99,161
2006-01-16 00:00:00.000,Australian Open Australia Grand Slams,HARD,3,Raemon Sluiter,Pavel Snobel,Raemon Sluiter,6-4; 2-6; 6-2; 6-4,R128,124,7,5,54,95,42,54,25,41,1,4,18,67,95,5,7,56,121,36,56,38,65,8,13,18,74,121
2006-01-16 00:00:00.000,Australian Open Australia Grand Slams,HARD,3,Igor Andreev,Nicolas Almagro,Igor Andreev,7-5; 6-4; 6-3,R128,109,3,1,63,99,47,63,19,36,3,5,16,66,99,7,2,64,88,38,64,14,24,7,12,15,52,88
2006-01-16 00:00:00.000,Australian Open Australia Grand Slams,HARD,3,Nathan Healey,Filippo Volandri,Nathan Healey,6-2; 6-3 RET,R128,68,3,4,23,42,18,23,13,19,1,2,8,31,42,1,3,48,72,25,48,8,24,7,12,9,33,72
2006-01-16 00:00:00.000,Australian Open Australia Grand Slams,HARD,3,Amer Delic,Potito Starace,Amer Delic,7-5; 6-7(3); 6-3; 3-6; 6-3,R128,196,14,8,109,178,77,109,37,69,9,12,26,114,178,6,5,122,163,79,122,25,41,10,15,25,104,163
2006-01-16 00:00:00.000,Australian Open Australia Grand Slams,HARD,3,Kevin Kim,Harel Levy,Kevin Kim,6-4; 6-4; 6-0,R128,97,8,6,58,93,42,58,19,35,7,8,13,61,93,2,4,59,94,34,59,13,35,3,9,13,47,94
2006-01-16 00:00:00.000,Australian Open Australia Grand Slams,HARD,3,Nikolay Davydenko,Ivo Karlovic,Nikolay Davydenko,7-5; 4-6; 3-6; 7-5; 6-3,R128,201,5,4,126,155,92,126,18,29,7,9,26,110,155,31,4,107,166,85,107,26,59,8,11,26,111,166
2006-01-16 00:00:00.000,Australian Open Australia Grand Slams,HARD,3,Lleyton Hewitt,Robin Vik,Lleyton Hewitt,6-4; 2-6; 5-7; 7-6(4); 6-3,R128,226,11,13,107,186,68,107,33,79,20,29,25,101,186,8,13,104,165,71,104,22,61,12,21,26,93,165
2006-01-16 00:00:00.000,Australian Open Australia Grand Slams,HARD,3,Juan Ignacio Chela,Andy Murray,Juan Ignacio Chela,6-1; 6-3; 6-3,R128,106,1,1,54,84,38,54,20,30,3,3,13,58,84,7,1,39,77,25,39,17,38,3,8,12,42,77
2006-01-16 00:00:00.000,Australian Open Australia Grand Slams,HARD,3,Kristof Vliegen,Christophe Rochus,Kristof Vliegen,6-3; 6-1; 6-4,R128,87,17,3,58,88,46,58,14,30,4,5,13,60,88,1,2,37,65,20,37,14,28,2,8,13,34,65
2006-01-16 00:00:00.000,Australian Open Australia Grand Slams,HARD,3,Fernando Verdasco,Kenneth Carlsen,Fernando Verdasco,7-6(5); 6-4; 6-4,R128,134,3,6,63,100,53,63,20,37,6,6,16,73,100,7,5,66,117,50,66,24,51,13,15,16,74,117
2006-01-16 00:00:00.000,Australian Open Australia Grand Slams,HARD,3,Nicolas Kiefer,Paradorn Srichaphan,Nicolas Kiefer,6-7(5); 4-6; 7-6(5); 6-1; 6-2,R128,230,11,6,74,158,53,74,48,84,6,13,25,101,158,6,13,72,150,41,72,36,78,6,16,24,77,150
2006-01-16 00:00:00.000,Australian Open Australia Grand Slams,HARD,3,Boris Pashanski,Wayne Arthurs,Boris Pashanski,6-3; 6-4; 4-6; 7-6(2),R128,161,6,0,82,122,61,82,27,40,4,5,20,88,122,29,9,63,134,50,63,35,71,6,9,21,85,134
2006-01-16 00:00:00.000,Australian Open Australia Grand Slams,HARD,3,Janko Tipsarevic,Andreas Seppi,Janko Tipsarevic,1-6; 6-4; 4-6; 6-2; 6-4,R128,184,9,3,78,147,53,78,35,69,7,14,23,88,147,9,5,62,129,44,62,31,67,7,14,22,75,129
2006-01-16 00:00:00.000,Australian Open Australia Grand Slams,HARD,3,Juan Carlos Ferrero,Tomas Zib,Juan Carlos Ferrero,7-5; 6-0; 6-2,R128,97,8,0,40,70,29,40,20,30,1,3,13,49,70,3,3,50,80,27,50,11,30,4,12,13,38,80
2006-01-16 00:00:00.000,Australian Open Australia Grand Slams,HARD,3,Alex Bogomolov Jr.,Fernando Gonzalez,Alex Bogomolov Jr.,4-6; 7-6(6); 6-3; 6-7(3); 7-5,R128,245,7,10,154,217,98,154,25,63,14,22,28,123,217,10,14,98,178,70,98,36,80,4,13,27,106,178
2006-01-16 00:00:00.000,Australian Open Australia Grand Slams,HARD,3,Paul-Henri Mathieu,Arnaud Clement,Paul-Henri Mathieu,6-3; 7-6(4); 6-3,R128,152,11,3,62,106,45,62,23,44,5,7,16,68,106,5,2,51,89,36,51,15,38,3,7,14,51,89
2006-01-16 00:00:00.000,Australian Open Australia Grand Slams,HARD,3,Bjorn Phau,Carlos Berlocq,Bjorn Phau,6-4; 7-6(3); 2-6; 7-6(4),R128,192,2,5,70,138,44,70,35,68,8,17,21,79,138,6,6,75,132,45,75,28,57,4,12,21,73,132
2006-01-16 00:00:00.000,Australian Open Australia Grand Slams,HARD,3,Luis Horna,Gael Monfils,Luis Horna,6-4; 7-5; 6-1,R128,114,1,2,63,75,46,63,8,12,1,2,14,54,75,6,6,46,91,32,46,19,45,5,11,15,51,91
2006-01-16 00:00:00.000,Australian Open Australia Grand Slams,HARD,3,Sebastien Grosjean,Mark Philippoussis,Sebastien Grosjean,6-4; 6-2; 6-3,R128,107,6,1,31,69,23,31,29,38,1,2,13,52,69,3,9,48,82,28,48,16,34,3,9,14,44,82
2006-01-16 00:00:00.000,Australian Open Australia Grand Slams,HARD,3,Juan Monaco,Jean-Rene Lisnard,Juan Monaco,4-6; 6-2; 6-4; 6-3,R128,154,2,4,66,114,45,66,27,48,9,13,19,72,114,1,9,45,123,36,45,31,78,7,14,18,67,123
2006-01-16 00:00:00.000,Australian Open Australia Grand Slams,HARD,3,Federico Luzzi,Juan Antonio Marin,Federico Luzzi,6-1; 6-4; 7-5,R128,115,8,2,46,83,40,46,17,37,1,3,15,57,83,0,1,49,81,30,49,17,32,6,12,14,47,81
2006-01-16 00:00:00.000,Australian Open Australia Grand Slams,HARD,3,Guillermo Coria,Victor Hanescu,Guillermo Coria,6-4; 1-6; 4-6; 6-2; 6-1,R128,209,2,17,107,156,61,107,16,49,14,24,21,77,156,9,7,100,148,54,100,15,48,16,28,21,69,148
2006-01-16 00:00:00.000,Australian Open Australia Grand Slams,HARD,3,Gaston Gaudio,Razvan Sabau,Gaston Gaudio,6-2; 5-0 RET,R128,56,6,2,23,42,19,23,10,19,1,2,7,29,42,1,9,23,45,13,23,6,22,6,11,6,19,45
2006-01-16 00:00:00.000,Australian Open Australia Grand Slams,HARD,3,Lars Burgsmuller,Rainer Schuettler,Lars Burgsmuller,3-6; 6-3; 7-6(2); 6-3,R128,170,3,5,73,127,50,73,24,54,9,15,20,74,127,2,3,60,105,40,60,20,45,3,10,19,60,105
2006-01-16 00:00:00.000,Australian Open Australia Grand Slams,HARD,3,Fabrice Santoro,Vincent Spadea,Fabrice Santoro,3-6; 6-0; 6-2; 6-3,R128,123,1,1,50,87,34,50,24,37,3,6,16,58,87,0,7,59,110,34,59,21,51,10,18,16,55,110
2006-01-16 00:00:00.000,Australian Open Australia Grand Slams,HARD,3,Andrei Pavel,Carlos Moya,Andrei Pavel,6-4; 7-6(5); 4-6; 3-6; 6-4,R128,224,0,3,100,148,70,100,21,48,2,8,25,91,148,8,4,98,179,69,98,40,81,16,22,26,109,179
2006-01-16 00:00:00.000,Australian Open Australia Grand Slams,HARD,3,Mario Ancic,Agustin Calleri,Mario Ancic,6-4; 4-6; 6-3; 6-4,R128,166,9,4,69,122,54,69,23,53,6,10,20,77,122,6,7,60,118,41,60,29,58,13,19,19,70,118
2006-01-16 00:00:00.000,Australian Open Australia Grand Slams,HARD,3,Jan Hernych,Fernando Vicente,Jan Hernych,2-6; 6-3; 7-6(5); 6-2,R128,159,5,4,95,134,67,95,19,39,7,10,19,86,134,4,5,88,132,58,88,22,44,9,13,18,80,132
2006-01-16 00:00:00.000,Australian Open Australia Grand Slams,HARD,3,Daniele Bracciali,Yen-Hsun Lu,Daniele Bracciali,6-1; 7-6(4); 6-2,R128,0,0,0,0,0,0,0,0,0,0,0,18,0,0,0,0,0,0,0,0,0,0,0,0,9,0,0
2006-01-16 00:00:00.000,Australian Open Australia Grand Slams,HARD,3,David Ferrer,Florent Serra,David Ferrer,4-6; 6-3; 6-1; 6-4,R128,149,3,4,70,107,43,70,19,37,4,10,18,62,107,2,4,97,155,62,97,14,58,10,20,18,76,155
2006-01-16 00:00:00.000,Australian Open Australia Grand Slams,HARD,3,Tommy Robredo,Jiri Vanek,Tommy Robredo,6-4; 7-6(6); 6-3,R128,125,10,4,75,104,55,75,16,29,4,5,16,71,104,8,10,73,111,52,73,14,38,8,11,15,66,111
2006-01-16 00:00:00.000,Australian Open Australia Grand Slams,HARD,3,Dmitry Tursunov,Tim Henman,Dmitry Tursunov,5-7; 6-3; 6-4; 7-5,R128,194,7,8,84,149,61,84,26,65,10,16,21,87,149,5,5,93,144,56,93,22,51,9,18,22,78,144
2006-01-16 00:00:00.000,Australian Open Australia Grand Slams,HARD,3,Jean-Christophe Faurel,Alexander Waske,Jean-Christophe Faurel,7-6(5); 6-3; 7-6(2),R128,153,7,4,73,102,56,73,15,29,0,1,16,71,102,17,5,81,120,57,81,14,39,4,7,17,71,120
2006-01-16 00:00:00.000,Australian Open Australia Grand Slams,HARD,3,James Blake,Jose Acasuso,James Blake,6-2; 6-3; 4-6; 7-6(4),R128,155,11,2,73,133,51,73,32,60,9,13,20,83,133,11,3,66,124,42,66,31,58,11,17,19,73,124
2006-01-16 00:00:00.000,Australian Open Australia Grand Slams,HARD,3,Jarkko Nieminen,Marc Kimmich,Jarkko Nieminen,6-2; 6-3; 6-1,R128,88,2,2,56,77,41,56,10,21,1,2,12,51,77,4,4,31,67,18,31,15,36,1,8,12,33,67
2006-01-16 00:00:00.000,Australian Open Australia Grand Slams,HARD,3,Jimmy Wang,Mariano Zabaleta,Jimmy Wang,6-2; 7-5; 4-1 RET,R128,124,4,2,46,75,33,46,19,29,5,7,13,52,75,3,8,47,92,28,47,19,45,11,17,12,47,92
2006-01-16 00:00:00.000,Australian Open Australia Grand Slams,HARD,3,Stanislas Wawrinka,Albert Montanes,Stanislas Wawrinka,4-6; 6-2; 6-3; 6-0,R128,108,10,6,54,101,46,54,24,47,1,2,17,70,101,6,4,55,91,35,55,20,36,2,8,16,55,91
2006-01-16 00:00:00.000,Australian Open Australia Grand Slams,HARD,3,David Nalbandian,Danai Udomchoke,David Nalbandian,6-2; 6-2; 1-6; 6-7(4); 6-1,R128,211,5,6,106,171,70,106,31,65,13,17,20,101,171,10,11,81,144,52,81,28,63,6,15,22,80,144
2006-01-16 00:00:00.000,Australian Open Australia Grand Slams,HARD,3,Ivan Ljubicic,Chris Guccione,Ivan Ljubicic,7-6(5); 6-4; 7-6(3),R128,126,13,1,64,102,54,64,25,38,2,3,17,79,102,23,5,72,118,59,72,21,46,8,10,17,80,118
2006-01-16 00:00:00.000,Australian Open Australia Grand Slams,HARD,3,Philipp Kohlschreiber,Lukas Dlouhy,Philipp Kohlschreiber,7-5; 6-2; 6-4,R128,106,12,1,44,81,37,44,22,37,5,7,15,59,81,8,2,51,93,29,51,21,42,10,16,15,50,93
2006-01-16 00:00:00.000,Australian Open Australia Grand Slams,HARD,3,Gilles Muller,Ricardo Mello,Gilles Muller,5-7; 6-2; 6-7(4); 7-6(4); 6-0,R128,196,24,3,105,169,82,105,33,64,5,7,25,115,169,4,11,106,161,74,106,24,55,9,15,25,98,161
2006-01-16 00:00:00.000,Australian Open Australia Grand Slams,HARD,3,Feliciano Lopez,Tomas Behrend,Feliciano Lopez,6-2; 7-5; 6-3,R128,115,13,1,46,85,38,46,25,39,2,2,14,63,85,4,5,67,114,43,67,22,47,14,19,15,65,114
2006-01-16 00:00:00.000,Australian Open Australia Grand Slams,HARD,3,Tomas Berdych,Bobby Reynolds,Tomas Berdych,7-5; 6-3; 6-7(2); 6-1,R128,173,24,7,76,143,61,76,30,67,8,10,21,91,143,10,10,73,128,49,73,23,55,3,9,19,72,128
2006-01-16 00:00:00.000,Australian Open Australia Grand Slams,HARD,3,Gilles Simon,Nicolas Massu,Gilles Simon,7-6(6); 6-2; 3-6; 4-6; 6-3,R128,253,8,3,89,169,60,89,40,80,10,17,24,100,169,7,4,108,183,68,108,35,75,13,21,24,103,183
2006-01-16 00:00:00.000,Australian Open Australia Grand Slams,HARD,3,Xavier Malisse,Mikhail Youzhny,Xavier Malisse,7-5; 5-7; 6-4; 6-2,R128,169,7,2,61,125,46,61,32,64,7,13,21,78,125,3,9,63,127,40,63,28,64,10,19,21,68,127
2006-01-16 00:00:00.000,Australian Open Australia Grand Slams,HARD,3,Thomas Johansson,Cyril Saulnier,Thomas Johansson,6-1; 7-6(3); 6-4,R128,139,13,3,51,95,42,51,26,44,7,8,15,68,95,10,5,56,111,36,56,27,55,9,13,14,63,111
2006-01-16 00:00:00.000,Australian Open Australia Grand Slams,HARD,3,Robby Ginepri,Jurgen Melzer,Robby Ginepri,6-1; 6-4; 6-2,R128,79,1,4,37,73,29,37,18,36,1,4,13,47,73,3,1,35,67,16,35,13,32,6,14,12,29,67
2006-01-16 00:00:00.000,Australian Open Australia Grand Slams,HARD,3,Denis Gremelmayr,Jonas Bjorkman,Denis Gremelmayr,3-6; 6-2; 6-0; 6-1,R128,125,8,2,51,93,38,51,23,42,3,5,15,61,93,4,6,52,98,28,52,18,46,3,11,15,46,98
2006-01-16 00:00:00.000,Australian Open Australia Grand Slams,HARD,3,Marcos Baghdatis,Justin Gimelstob,Marcos Baghdatis,7-6(6); 7-5; 6-0,R128,139,4,4,38,83,33,38,25,45,2,4,15,58,83,8,4,60,112,36,60,24,52,9,15,15,60,112
2006-01-16 00:00:00.000,Australian Open Australia Grand Slams,HARD,3,Radek Stepanek,Bjorn Rehnquist,Radek Stepanek,6-1; 6-2; 6-2,R128,88,1,1,41,71,29,41,22,30,3,3,12,51,71,3,2,32,54,16,32,10,22,1,7,11,26,54
2006-01-16 00:00:00.000,Australian Open Australia Grand Slams,HARD,3,Guillermo Garcia-Lopez,Taylor Dent,Guillermo Garcia-Lopez,7-6(4); 6-3; 7-6(4),R128,136,9,4,67,105,53,67,18,38,5,8,17,71,105,13,7,50,97,40,50,20,47,2,6,16,60,97
2006-01-16 00:00:00.000,Australian Open Australia Grand Slams,HARD,3,Julien Benneteau,Marcos Daniel,Julien Benneteau,6-2; 6-1; 3-0 RET,R128,71,4,1,35,50,26,35,12,15,3,3,9,38,50,2,3,43,60,21,43,5,17,4,10,9,26,60
2006-01-16 00:00:00.000,Australian Open Australia Grand Slams,HARD,3,Wesley Moodie,Oscar Hernandez,Wesley Moodie,3-6; 7-6(5); 6-4; 6-2,R128,180,21,9,84,133,65,84,27,49,9,10,19,92,133,6,1,87,135,61,87,27,48,9,12,20,88,135
2006-01-16 00:00:00.000,Australian Open Australia Grand Slams,HARD,3,Andy Roddick,Michael Lammer,Andy Roddick,6-4; 6-2; 6-2,R128,104,7,2,46,79,39,46,15,33,2,3,13,54,79,2,2,43,74,26,43,11,31,3,9,13,37,74
2006-01-16 00:00:00.000,Australian Open Australia Grand Slams,HARD,3,Roger Federer,Florian Mayer,Roger Federer,6-1; 6-4; 6-0,R64,72,9,1,45,74,34,45,18,29,1,1,12,52,74,2,5,44,69,23,44,11,25,4,10,11,34,69
2006-01-16 00:00:00.000,Australian Open Australia Grand Slams,HARD,3,Max Mirnyi,Davide Sanguinetti,Max Mirnyi,7-5; 6-3; 4-6; 7-6(8),R64,190,7,4,96,145,68,96,31,49,10,14,22,99,145,6,5,86,147,58,86,36,61,10,15,21,94,147
2006-01-16 00:00:00.000,Australian Open Australia Grand Slams,HARD,3,Peter Luczak,Olivier Rochus,Peter Luczak,6-7(4); 6-4; 6-1; 6-7(1); 6-1,R64,187,22,3,101,147,76,101,23,46,3,6,25,99,147,9,12,84,143,61,84,26,59,8,16,23,87,143
2006-01-16 00:00:00.000,Australian Open Australia Grand Slams,HARD,3,Tommy Haas,Paul Goldstein,Tommy Haas,6-0; 6-1; 6-2,R64,76,2,0,31,57,29,31,17,26,2,2,11,46,57,3,3,38,63,25,38,5,25,2,9,10,30,63
2006-01-16 00:00:00.000,Australian Open Australia Grand Slams,HARD,3,Dominik Hrbaty,Dick Norman,Dominik Hrbaty,6-2; 7-5; 5-7; 4-6; 10-8,R64,231,11,12,96,162,77,96,32,66,5,11,30,109,162,20,17,127,221,85,127,42,94,23,31,30,127,221
2006-01-16 00:00:00.000,Australian Open Australia Grand Slams,HARD,3,Igor Andreev,Raemon Sluiter,Igor Andreev,3-6; 6-3; 7-6(4); 2-6; 6-2,R64,180,9,4,100,146,70,100,24,46,6,11,23,94,146,11,3,80,139,54,80,34,59,4,9,23,88,139
2006-01-16 00:00:00.000,Australian Open Australia Grand Slams,HARD,3,Nathan Healey,Amer Delic,Nathan Healey,6-4; 6-7(4); 6-3; 6-4,R64,166,10,6,86,143,64,86,36,57,10,10,21,100,143,13,6,62,112,51,62,27,50,4,7,20,78,112
2006-01-16 00:00:00.000,Australian Open Australia Grand Slams,HARD,3,Nikolay Davydenko,Kevin Kim,Nikolay Davydenko,4-6; 6-0; 6-3; 6-2,R64,134,3,2,81,102,54,81,14,21,2,5,17,68,102,0,9,58,99,37,58,15,41,6,14,16,52,99
2006-01-16 00:00:00.000,Australian Open Australia Grand Slams,HARD,3,Juan Ignacio Chela,Lleyton Hewitt,Juan Ignacio Chela,6-4; 6-4; 6-7(8); 6-2,R64,203,6,0,82,129,52,82,30,47,9,13,20,82,129,8,3,81,146,53,81,28,65,13,21,20,81,146
2006-01-16 00:00:00.000,Australian Open Australia Grand Slams,HARD,3,Kristof Vliegen,Fernando Verdasco,Kristof Vliegen,3-6; 6-2; 7-6(4); 7-5,R64,193,10,2,92,138,63,92,19,46,8,13,20,82,138,9,20,97,163,65,97,28,66,15,22,21,93,163
2006-01-16 00:00:00.000,Australian Open Australia Grand Slams,HARD,3,Nicolas Kiefer,Boris Pashanski,Nicolas Kiefer,4-6; 6-1; 6-4; 6-1,R64,152,15,4,53,103,42,53,24,50,5,9,17,66,103,4,6,64,117,37,64,21,53,7,16,17,58,117
2006-01-16 00:00:00.000,Australian Open Australia Grand Slams,HARD,3,Juan Carlos Ferrero,Janko Tipsarevic,Juan Carlos Ferrero,6-3; 3-6; 5-7; 6-3; 6-2,R64,218,14,2,80,129,59,80,26,49,0,5,24,85,129,16,3,81,163,54,81,38,82,13,20,23,92,163
2006-01-16 00:00:00.000,Australian Open Australia Grand Slams,HARD,3,Paul-Henri Mathieu,Alex Bogomolov Jr.,Paul-Henri Mathieu,6-0; 7-6(5); 6-2,R64,145,13,3,40,81,35,40,22,41,0,2,13,57,81,1,7,75,117,43,75,15,42,12,19,13,58,117
2006-01-16 00:00:00.000,Australian Open Australia Grand Slams,HARD,3,Luis Horna,Bjorn Phau,Luis Horna,6-3; 6-2; 6-1,R64,78,8,2,46,65,38,46,9,19,1,2,12,47,65,2,6,33,63,18,33,10,30,3,10,12,28,63
2006-01-16 00:00:00.000,Australian Open Australia Grand Slams,HARD,3,Sebastien Grosjean,Juan Monaco,Sebastien Grosjean,6-4; 6-3; 6-3,R64,122,3,1,38,85,33,38,23,47,4,6,14,56,85,2,4,45,74,22,45,18,29,1,7,14,40,74
2006-01-16 00:00:00.000,Australian Open Australia Grand Slams,HARD,3,Guillermo Coria,Federico Luzzi,Guillermo Coria,7-6(10); 6-4; 6-3,R64,172,1,9,93,119,63,93,12,26,7,10,16,75,119,5,6,71,127,46,71,24,56,13,18,15,70,127
2006-01-16 00:00:00.000,Australian Open Australia Grand Slams,HARD,3,Gaston Gaudio,Lars Burgsmuller,Gaston Gaudio,6-3; 6-2; 6-3,R64,118,1,1,42,76,32,42,21,34,4,5,13,53,76,3,4,41,82,29,41,13,41,5,11,13,42,82
2006-01-16 00:00:00.000,Australian Open Australia Grand Slams,HARD,3,Fabrice Santoro,Andrei Pavel,Fabrice Santoro,6-4; 6-1; 6-4,R64,129,8,2,59,100,41,59,18,41,10,13,14,59,100,4,3,54,83,30,54,10,29,4,11,13,40,83
2006-01-16 00:00:00.000,Australian Open Australia Grand Slams,HARD,3,Mario Ancic,Jan Hernych,Mario Ancic,6-1; 6-4; 6-4,R64,107,10,2,44,70,40,44,16,26,0,0,14,56,70,1,1,56,86,34,56,18,30,11,15,13,52,86
2006-01-16 00:00:00.000,Australian Open Australia Grand Slams,HARD,3,David Ferrer,Daniele Bracciali,David Ferrer,6-4; 6-4; 6-7(5); 6-2,R64,169,5,2,93,140,60,93,22,47,7,12,20,82,140,6,11,63,123,33,63,27,60,4,13,20,60,123
2006-01-16 00:00:00.000,Australian Open Australia Grand Slams,HARD,3,Tommy Robredo,Dmitry Tursunov,Tommy Robredo,7-6(4); 3-6; 7-6(5); 6-3,R64,183,5,2,102,140,70,102,24,38,6,9,20,94,140,8,5,83,154,65,83,29,71,2,6,22,94,154
2006-01-16 00:00:00.000,Australian Open Australia Grand Slams,HARD,3,James Blake,Jean-Christophe Faurel,James Blake,2-6; 6-1; 6-4; 6-3,R64,129,5,3,53,97,41,53,21,44,4,8,17,62,97,9,6,74,122,47,74,18,48,8,15,17,65,122
2006-01-16 00:00:00.000,Australian Open Australia Grand Slams,HARD,3,Jarkko Nieminen,Jimmy Wang,Jarkko Nieminen,6-2; 7-6(3); 6-2,R64,113,4,2,58,93,42,58,23,35,8,10,14,65,93,4,2,43,86,27,43,17,43,3,9,14,44,86
2006-01-16 00:00:00.000,Australian Open Australia Grand Slams,HARD,3,David Nalbandian,Stanislas Wawrinka,David Nalbandian,6-4; 3-6; 6-4; 6-2,R64,180,2,3,83,125,55,83,28,42,11,12,18,83,125,10,4,74,134,48,74,33,60,8,12,19,81,134
2006-01-16 00:00:00.000,Australian Open Australia Grand Slams,HARD,3,Ivan Ljubicic,Philipp Kohlschreiber,Ivan Ljubicic,7-5; 6-2; 6-1,R64,140,3,4,50,96,35,50,26,46,3,5,14,61,96,3,5,43,93,25,43,22,50,9,16,13,47,93
2006-01-16 00:00:00.000,Australian Open Australia Grand Slams,HARD,3,Feliciano Lopez,Gilles Muller,Feliciano Lopez,6-2; 6-4; 6-7(6); 6-4,R64,155,17,5,74,122,59,74,23,48,1,3,20,82,122,10,4,92,141,61,92,24,49,10,16,20,85,141
2006-01-16 00:00:00.000,Australian Open Australia Grand Slams,HARD,3,Gilles Simon,Tomas Berdych,Gilles Simon,6-3; 6-2; 4-6; 6-2,R64,150,6,3,63,129,46,63,34,66,11,14,18,80,129,3,9,52,112,34,52,23,60,2,9,17,57,112
2006-01-16 00:00:00.000,Australian Open Australia Grand Slams,HARD,3,Thomas Johansson,Xavier Malisse,Thomas Johansson,6-3; 3-6; 7-5; 4-6; 6-3,R64,220,12,4,81,154,61,81,39,73,6,10,25,100,154,16,3,69,147,52,69,42,78,6,11,24,94,147
2006-01-16 00:00:00.000,Australian Open Australia Grand Slams,HARD,3,Denis Gremelmayr,Robby Ginepri,Denis Gremelmayr,2-6; 5-7; 6-4; 6-3; 6-3,R64,183,8,10,91,181,61,91,41,90,14,21,24,102,181,7,3,99,150,66,99,23,51,4,12,24,89,150
2006-01-16 00:00:00.000,Australian Open Australia Grand Slams,HARD,3,Marcos Baghdatis,Radek Stepanek,Marcos Baghdatis,6-4; 6-3; 3-6; 0-6; 7-5,R64,190,6,6,65,128,47,65,36,63,5,11,23,83,128,11,4,85,150,57,85,35,65,7,12,23,92,150
2006-01-16 00:00:00.000,Australian Open Australia Grand Slams,HARD,3,Julien Benneteau,Guillermo Garcia-Lopez,Julien Benneteau,6-4; 7-6(3); 6-1,R64,131,8,4,73,97,57,73,12,24,2,2,15,69,97,4,6,54,99,38,54,22,45,9,12,14,60,99
2006-01-16 00:00:00.000,Australian Open Australia Grand Slams,HARD,3,Andy Roddick,Wesley Moodie,Andy Roddick,7-5; 6-3; 6-2,R64,108,11,1,48,78,41,48,20,30,1,1,15,61,78,11,2,61,85,38,61,16,24,5,9,14,54,85
2006-01-16 00:00:00.000,Australian Open Australia Grand Slams,HARD,3,Roger Federer,Max Mirnyi,Roger Federer,6-3; 6-4; 6-3,R32,109,6,2,47,70,37,47,20,23,1,1,14,57,70,5,6,72,108,50,72,11,36,11,15,14,61,108
2006-01-16 00:00:00.000,Australian Open Australia Grand Slams,HARD,3,Tommy Haas,Peter Luczak,Tommy Haas,4-6; 6-3; 6-4; 6-4,R32,157,18,1,68,113,55,68,28,45,0,1,20,83,113,21,2,69,115,50,69,25,46,3,6,19,75,115
2006-01-16 00:00:00.000,Australian Open Australia Grand Slams,HARD,3,Dominik Hrbaty,Igor Andreev,Dominik Hrbaty,1-6; 6-4; 6-3; 2-6; 6-4,R32,211,12,5,87,156,53,87,39,69,8,14,22,92,156,12,6,95,164,63,95,33,69,16,21,22,96,164
2006-01-16 00:00:00.000,Australian Open Australia Grand Slams,HARD,3,Nikolay Davydenko,Nathan Healey,Nikolay Davydenko,6-2; 5-7; 6-4; 7-5,R32,179,4,2,86,114,64,86,20,28,4,6,21,84,114,17,6,90,146,63,90,23,56,13,18,21,86,146
2006-01-16 00:00:00.000,Australian Open Australia Grand Slams,HARD,3,Juan Ignacio Chela,Kristof Vliegen,Juan Ignacio Chela,6-1; 6-4; 6-4,R32,124,4,3,52,95,41,52,25,43,8,8,14,66,95,5,5,53,82,36,53,11,29,7,11,13,47,82
2006-01-16 00:00:00.000,Australian Open Australia Grand Slams,HARD,3,Nicolas Kiefer,Juan Carlos Ferrero,Nicolas Kiefer,6-3; 6-2; 5-7; 6-2,R32,177,13,4,53,103,46,53,28,50,2,3,19,74,103,5,2,81,126,49,81,26,45,9,14,18,75,126
2006-01-16 00:00:00.000,Australian Open Australia Grand Slams,HARD,3,Paul-Henri Mathieu,Luis Horna,Paul-Henri Mathieu,7-6(2); 7-6(7); 6-1,R32,159,0,0,0,0,0,0,0,0,0,0,18,0,0,0,0,0,0,0,0,0,0,0,0,13,0,0
2006-01-16 00:00:00.000,Australian Open Australia Grand Slams,HARD,3,Sebastien Grosjean,Guillermo Coria,Sebastien Grosjean,6-2; 6-2; 3-6; 6-4,R32,172,7,8,55,108,40,55,21,53,5,11,18,61,108,0,23,82,129,50,82,12,47,17,26,17,62,129
2006-01-16 00:00:00.000,Australian Open Australia Grand Slams,HARD,3,Fabrice Santoro,Gaston Gaudio,Fabrice Santoro,6-3; 6-2; 5-7; 1-6; 6-4,R32,227,9,5,95,172,64,95,33,77,18,25,23,97,172,1,3,81,136,51,81,26,55,5,13,23,77,136
2006-01-16 00:00:00.000,Australian Open Australia Grand Slams,HARD,3,David Ferrer,Mario Ancic,David Ferrer,6-3; 6-3; 6-3,R32,113,0,2,60,84,39,60,14,24,2,4,14,53,84,3,5,57,86,31,57,14,29,7,13,13,45,86
2006-01-16 00:00:00.000,Australian Open Australia Grand Slams,HARD,3,Tommy Robredo,James Blake,Tommy Robredo,6-3; 6-4; 6-4,R32,115,9,6,49,86,38,49,24,37,4,5,15,62,86,6,8,50,96,35,50,20,46,9,13,14,55,96
2006-01-16 00:00:00.000,Australian Open Australia Grand Slams,HARD,3,David Nalbandian,Jarkko Nieminen,David Nalbandian,2-6; 6-3; 6-2; 7-5,R32,174,6,3,88,136,55,88,28,48,11,16,19,83,136,3,1,86,126,50,86,18,40,12,19,18,68,126
2006-01-16 00:00:00.000,Australian Open Australia Grand Slams,HARD,3,Ivan Ljubicic,Feliciano Lopez,Ivan Ljubicic,7-5; 7-6(5); 6-0,R32,146,10,4,54,99,45,54,24,45,4,5,15,69,99,12,8,64,114,45,64,19,50,12,17,15,64,114
2006-01-16 00:00:00.000,Australian Open Australia Grand Slams,HARD,3,Thomas Johansson,Gilles Simon,Thomas Johansson,6-3; 6-2; 6-1,R32,91,9,1,41,71,35,41,16,30,4,4,12,51,71,4,2,37,83,26,37,19,46,9,15,12,45,83
2006-01-16 00:00:00.000,Australian Open Australia Grand Slams,HARD,3,Marcos Baghdatis,Denis Gremelmayr,Marcos Baghdatis,6-2; 6-1; 6-2,R32,80,5,3,36,66,24,36,18,30,1,3,12,42,66,0,4,42,68,19,42,9,26,3,11,11,28,68
2006-01-16 00:00:00.000,Australian Open Australia Grand Slams,HARD,3,Andy Roddick,Julien Benneteau,Andy Roddick,6-1; 6-2; 6-2,R32,82,17,1,37,62,32,37,16,25,0,0,12,48,62,5,3,35,59,17,35,9,24,1,7,11,26,59
2006-01-16 00:00:00.000,Australian Open Australia Grand Slams,HARD,3,Roger Federer,Tommy Haas,Roger Federer,6-4; 6-0; 3-6; 4-6; 6-2,R16,178,10,1,77,132,60,77,29,55,7,9,21,89,132,5,0,89,138,56,89,28,49,5,11,22,84,138
2006-01-16 00:00:00.000,Australian Open Australia Grand Slams,HARD,3,Nikolay Davydenko,Dominik Hrbaty,Nikolay Davydenko,4-6; 4-6; 6-4; 6-2; 6-3,R16,210,6,3,110,160,65,110,31,50,8,14,24,96,160,7,6,75,149,54,75,30,74,4,12,23,84,149
2006-01-16 00:00:00.000,Australian Open Australia Grand Slams,HARD,3,Nicolas Kiefer,Juan Ignacio Chela,Nicolas Kiefer,7-6(4); 6-3; 6-3,R16,142,5,3,43,94,36,43,26,51,7,9,15,62,94,2,0,54,94,34,54,21,40,2,7,15,55,94
2006-01-16 00:00:00.000,Australian Open Australia Grand Slams,HARD,3,Sebastien Grosjean,Paul-Henri Mathieu,Sebastien Grosjean,7-5; 6-2; 6-2,R16,127,12,3,31,72,29,31,19,41,1,4,14,48,72,3,4,44,89,23,44,21,45,6,14,14,44,89
2006-01-16 00:00:00.000,Australian Open Australia Grand Slams,HARD,3,Fabrice Santoro,David Ferrer,Fabrice Santoro,6-4; 7-5; 7-5,R16,133,6,0,56,94,35,56,18,38,7,14,17,53,94,0,2,77,106,41,77,10,29,8,18,17,51,106
2006-01-16 00:00:00.000,Australian Open Australia Grand Slams,HARD,3,David Nalbandian,Tommy Robredo,David Nalbandian,6-3; 6-0; 2-6; 6-2,R16,127,3,2,55,84,40,55,19,29,0,2,15,59,84,9,6,81,119,50,81,12,38,15,22,16,62,119
2006-01-16 00:00:00.000,Australian Open Australia Grand Slams,HARD,3,Ivan Ljubicic,Thomas Johansson,Ivan Ljubicic,6-2; 6-4; 6-4,R16,115,12,1,43,81,33,43,27,38,1,1,14,60,81,12,7,42,91,34,42,20,49,3,7,14,54,91
2006-01-16 00:00:00.000,Australian Open Australia Grand Slams,HARD,3,Marcos Baghdatis,Andy Roddick,Marcos Baghdatis,6-4; 1-6; 6-3; 6-4,R16,152,16,1,60,125,43,60,37,65,7,9,18,80,125,15,4,65,108,48,65,24,43,7,10,18,72,108
2006-01-16 00:00:00.000,Australian Open Australia Grand Slams,HARD,3,Roger Federer,Nikolay Davydenko,Roger Federer,6-4; 3-6; 7-6(7); 7-6(5),Q,193,6,0,86,139,64,86,28,53,5,10,22,92,139,1,2,111,144,78,111,14,33,6,10,21,92,144
2006-01-16 00:00:00.000,Australian Open Australia Grand Slams,HARD,3,Nicolas Kiefer,Sebastien Grosjean,Nicolas Kiefer,6-3; 0-6; 6-4; 6-7(1); 8-6,Q,288,4,9,74,164,46,74,46,90,4,13,26,92,164,12,2,84,165,54,84,43,81,7,16,25,97,165
2006-01-16 00:00:00.000,Australian Open Australia Grand Slams,HARD,3,David Nalbandian,Fabrice Santoro,David Nalbandian,7-5; 6-0; 6-0,Q,101,2,0,39,64,29,39,18,25,2,3,12,47,64,4,1,46,76,27,46,6,30,7,15,12,33,76
2006-01-16 00:00:00.000,Australian Open Australia Grand Slams,HARD,3,Marcos Baghdatis,Ivan Ljubicic,Marcos Baghdatis,6-4; 6-2; 4-6; 3-6; 6-3,Q,197,8,4,69,131,55,69,37,62,7,9,23,92,131,14,3,98,154,70,98,30,56,11,15,23,100,154
2006-01-16 00:00:00.000,Australian Open Australia Grand Slams,HARD,3,Roger Federer,Nicolas Kiefer,Roger Federer,6-3; 5-7; 6-0; 6-2,S,160,7,5,70,106,50,70,24,36,3,4,18,74,106,14,7,62,122,44,62,23,60,13,19,17,67,122
2006-01-16 00:00:00.000,Australian Open Australia Grand Slams,HARD,3,Marcos Baghdatis,David Nalbandian,Marcos Baghdatis,3-6; 5-7; 6-3; 6-4; 6-4,S,207,15,2,86,154,60,86,34,68,10,17,25,94,154,5,1,95,141,60,95,23,46,5,13,25,83,141
2006-01-16 00:00:00.000,Australian Open Australia Grand Slams,HARD,3,Roger Federer,Marcos Baghdatis,Roger Federer,5-7; 7-5; 6-0; 6-2,F,166,11,6,77,144,55,77,34,67,7,10,19,89,144,6,2,55,114,39,55,22,59,4,12,19,61,114
2006-01-30 00:00:00.000,Delray Beach FL; U.S.A. ATP World Tour,HARD,2,Andre Agassi,Ricardo Mello,Andre Agassi,6-4; 6-4,R32,67,10,1,27,48,25,27,16,21,0,0,10,41,48,1,1,33,59,19,33,17,26,6,8,10,36,59
2006-01-30 00:00:00.000,Delray Beach FL; U.S.A. ATP World Tour,HARD,2,Ramon Delgado,Bobby Reynolds,Ramon Delgado,4-6; 6-1; 6-4,R32,107,13,3,42,77,37,42,18,35,1,2,14,55,77,6,1,43,74,26,43,22,31,2,5,13,48,74
2006-01-30 00:00:00.000,Delray Beach FL; U.S.A. ATP World Tour,HARD,2,Guillermo Garcia-Lopez,Bjorn Phau,Guillermo Garcia-Lopez,6-1; 6-4,R32,68,3,4,26,56,22,26,17,30,2,2,9,39,56,3,1,24,46,18,24,8,22,2,5,8,26,46
2006-01-30 00:00:00.000,Delray Beach FL; U.S.A. ATP World Tour,HARD,2,Todd Widom,Wesley Moodie,Todd Widom,3-6; 6-4; 6-4,R32,142,5,3,57,99,39,57,21,42,5,9,15,60,99,11,3,58,89,38,58,14,31,7,11,14,52,89
2006-01-30 00:00:00.000,Delray Beach FL; U.S.A. ATP World Tour,HARD,2,Xavier Malisse,Sargis Sargsian,Xavier Malisse,6-2; 6-2,R32,74,9,1,22,45,22,22,10,23,2,3,8,32,45,1,7,43,73,25,43,8,30,7,12,8,33,73
2006-01-30 00:00:00.000,Delray Beach FL; U.S.A. ATP World Tour,HARD,2,Justin Gimelstob,Danai Udomchoke,Justin Gimelstob,6-4; 6-4,R32,82,4,0,36,54,27,36,6,18,4,7,10,33,54,2,2,34,59,19,34,12,25,3,8,10,31,59
2006-01-30 00:00:00.000,Delray Beach FL; U.S.A. ATP World Tour,HARD,2,Oliver Marach,Cyril Saulnier,Oliver Marach,2-0 RET,R32,9,0,0,5,5,4,5,0,0,0,0,1,4,5,0,1,2,6,0,2,2,4,0,1,1,2,6
2006-01-30 00:00:00.000,Delray Beach FL; U.S.A. ATP World Tour,HARD,2,Florian Mayer,Michael Berrer,Florian Mayer,4-6; 6-0; 6-3,R32,65,11,6,46,72,38,46,15,26,2,3,13,53,72,7,3,36,68,25,36,15,32,2,6,12,40,68
2006-01-30 00:00:00.000,Delray Beach FL; U.S.A. ATP World Tour,HARD,2,Gilles Muller,Bjorn Rehnquist,Gilles Muller,7-6(4); 6-4,R32,61,7,1,48,75,40,48,10,27,3,4,11,50,75,6,1,53,76,33,53,13,23,8,10,11,46,76
2006-01-30 00:00:00.000,Delray Beach FL; U.S.A. ATP World Tour,HARD,2,Jeff Salzenstein,Razvan Sabau,Jeff Salzenstein,7-5; 7-6(5),R32,68,13,4,46,78,36,46,19,32,4,5,12,55,78,1,6,64,110,42,64,23,46,13,15,12,65,110
2006-01-30 00:00:00.000,Delray Beach FL; U.S.A. ATP World Tour,HARD,2,Andrei Pavel,Olivier Patience,Andrei Pavel,6-3; 7-6(4),R32,80,6,1,49,77,35,49,16,28,2,3,11,51,77,3,4,38,58,24,38,13,20,0,2,10,37,58
2006-01-30 00:00:00.000,Delray Beach FL; U.S.A. ATP World Tour,HARD,2,Tommy Haas,Igor Kunitsyn,Tommy Haas,7-6(4); 6-2,R32,65,6,2,40,65,28,40,13,25,2,3,10,41,65,4,2,28,59,14,28,19,31,2,5,10,33,59
2006-01-30 00:00:00.000,Delray Beach FL; U.S.A. ATP World Tour,HARD,2,Vincent Spadea,Jimmy Wang,Vincent Spadea,5-7; 6-1; 6-1,R32,127,0,1,58,107,37,58,24,49,11,15,13,61,107,3,3,53,95,28,53,16,42,12,20,13,44,95
2006-01-30 00:00:00.000,Delray Beach FL; U.S.A. ATP World Tour,HARD,2,Robert Kendrick,Kevin Kim,Robert Kendrick,6-4; 7-5,R32,71,11,4,42,70,34,42,12,28,1,2,11,46,70,5,2,34,56,24,34,13,22,2,5,11,37,56
2006-01-30 00:00:00.000,Delray Beach FL; U.S.A. ATP World Tour,HARD,2,Simon Greul,Mardy Fish,Simon Greul,6-3; 6-3,R32,59,3,2,25,45,22,25,14,20,0,0,9,36,45,6,2,26,53,20,26,10,27,3,6,9,30,53
2006-01-30 00:00:00.000,Delray Beach FL; U.S.A. ATP World Tour,HARD,2,Hyung-Taik Lee,Robby Ginepri,Hyung-Taik Lee,5-7; 6-2; 6-4,R32,105,6,2,57,93,42,57,19,36,3,5,15,61,93,10,1,43,75,32,43,17,32,1,5,15,49,75
2006-01-30 00:00:00.000,Delray Beach FL; U.S.A. ATP World Tour,HARD,2,Andre Agassi,Ramon Delgado,Andre Agassi,4-6; 7-6(4); 6-0,R16,118,7,2,53,85,39,53,16,32,3,6,14,55,85,15,4,55,95,36,55,17,40,6,11,14,53,95
2006-01-30 00:00:00.000,Delray Beach FL; U.S.A. ATP World Tour,HARD,2,Guillermo Garcia-Lopez,Todd Widom,Guillermo Garcia-Lopez,6-3; 6-2,R16,65,11,2,43,65,33,43,10,22,4,4,9,43,65,1,4,33,59,19,33,14,26,2,5,8,33,59
2006-01-30 00:00:00.000,Delray Beach FL; U.S.A. ATP World Tour,HARD,2,Xavier Malisse,Justin Gimelstob,Xavier Malisse,6-2; 7-5,R16,85,6,1,33,61,26,33,19,28,2,2,10,45,61,5,2,38,68,27,38,12,30,7,10,10,39,68
2006-01-30 00:00:00.000,Delray Beach FL; U.S.A. ATP World Tour,HARD,2,Florian Mayer,Oliver Marach,Florian Mayer,7-5; 6-3,R16,80,7,3,29,53,26,29,14,24,0,0,10,40,53,4,2,30,67,24,30,16,37,4,7,11,40,67
2006-01-30 00:00:00.000,Delray Beach FL; U.S.A. ATP World Tour,HARD,2,Gilles Muller,Jeff Salzenstein,Gilles Muller,6-3; 6-4,R16,70,11,3,37,65,29,37,17,28,4,4,10,46,65,8,2,26,48,22,26,11,22,1,3,9,33,48
2006-01-30 00:00:00.000,Delray Beach FL; U.S.A. ATP World Tour,HARD,2,Tommy Haas,Andrei Pavel,Tommy Haas,6-7(1); 6-1; 7-5,R16,120,10,6,50,94,36,50,24,44,2,4,15,60,94,9,3,52,93,37,52,16,41,1,7,16,53,93
2006-01-30 00:00:00.000,Delray Beach FL; U.S.A. ATP World Tour,HARD,2,Vincent Spadea,Robert Kendrick,Vincent Spadea,6-4; 6-1,R16,64,2,1,30,54,23,30,16,24,3,3,9,39,54,3,6,38,59,27,38,4,21,10,13,8,31,59
2006-01-30 00:00:00.000,Delray Beach FL; U.S.A. ATP World Tour,HARD,2,Hyung-Taik Lee,Simon Greul,Hyung-Taik Lee,2-6; 6-3; 6-4,R16,117,2,3,57,94,41,57,17,37,6,9,14,58,94,6,1,49,80,33,49,16,31,5,8,13,49,80
2006-01-30 00:00:00.000,Delray Beach FL; U.S.A. ATP World Tour,HARD,2,Guillermo Garcia-Lopez,Andre Agassi,Guillermo Garcia-Lopez,6-4; 6-2,Q,75,14,6,27,64,21,27,20,37,4,5,9,41,64,3,3,31,56,18,31,12,25,4,8,9,30,56
2006-01-30 00:00:00.000,Delray Beach FL; U.S.A. ATP World Tour,HARD,2,Xavier Malisse,Florian Mayer,Xavier Malisse,6-7(4); 6-2; 6-3,Q,109,10,3,57,105,42,57,29,48,7,8,15,71,105,3,3,42,90,28,42,23,48,3,7,14,51,90
2006-01-30 00:00:00.000,Delray Beach FL; U.S.A. ATP World Tour,HARD,2,Tommy Haas,Gilles Muller,Tommy Haas,6-3; 6-2,Q,63,3,1,31,47,27,31,9,16,0,0,9,36,47,6,2,36,57,23,36,9,21,3,6,8,32,57
2006-01-30 00:00:00.000,Delray Beach FL; U.S.A. ATP World Tour,HARD,2,Vincent Spadea,Hyung-Taik Lee,Vincent Spadea,6-3; 6-3,Q,64,4,2,37,53,28,37,11,16,4,5,9,39,53,0,1,34,61,21,34,11,27,3,7,9,32,61
2006-01-30 00:00:00.000,Delray Beach FL; U.S.A. ATP World Tour,HARD,2,Xavier Malisse,Guillermo Garcia-Lopez,Xavier Malisse,7-6(4); 6-1,S,82,2,2,45,70,37,45,12,25,4,5,10,49,70,2,4,36,63,25,36,13,27,4,7,9,38,63
2006-01-30 00:00:00.000,Delray Beach FL; U.S.A. ATP World Tour,HARD,2,Tommy Haas,Vincent Spadea,Tommy Haas,6-3; 6-2,S,74,5,1,44,64,32,44,11,20,4,5,9,43,64,1,3,32,53,16,32,10,21,4,8,8,26,53
2006-01-30 00:00:00.000,Delray Beach FL; U.S.A. ATP World Tour,HARD,2,Tommy Haas,Xavier Malisse,Tommy Haas,6-3; 3-6; 7-6(5),F,122,6,2,58,89,46,58,18,31,3,5,15,64,89,7,3,70,112,51,70,20,42,4,6,15,71,112
2006-01-30 00:00:00.000,ViÂ±a del Mar Chile ATP World Tour,CLAY,2,Gaston Gaudio,Felipe Parada,Gaston Gaudio,6-1; 6-4,R32,70,8,0,27,46,22,27,15,19,0,0,9,37,46,3,2,40,60,26,40,8,20,8,11,8,34,60
2006-01-30 00:00:00.000,ViÂ±a del Mar Chile ATP World Tour,CLAY,2,Ruben Ramirez Hidalgo,Nicolas Almagro,Ruben Ramirez Hidalgo,0-6; 6-3; 6-1,R32,93,4,1,39,68,32,39,12,29,5,8,11,44,68,2,0,37,63,24,37,13,26,0,4,11,37,63
2006-01-30 00:00:00.000,ViÂ±a del Mar Chile ATP World Tour,CLAY,2,Santiago Ventura,Paul Capdeville,Santiago Ventura,6-3; 0-6; 6-3,R32,101,1,1,43,69,25,43,15,26,6,10,12,40,69,5,2,47,80,33,47,16,33,9,13,12,49,80
2006-01-30 00:00:00.000,ViÂ±a del Mar Chile ATP World Tour,CLAY,2,Albert Montanes,Juan Monaco,Albert Montanes,6-4; 6-2,R32,104,0,0,36,57,22,36,13,21,5,7,9,35,57,3,1,37,76,20,37,17,39,7,12,9,37,76
2006-01-30 00:00:00.000,ViÂ±a del Mar Chile ATP World Tour,CLAY,2,Jose Acasuso,Ivan Navarro,Jose Acasuso,6-3; 6-2,R32,76,4,1,23,55,19,23,18,32,0,1,9,37,55,4,0,25,45,17,25,5,20,0,4,8,22,45
2006-01-30 00:00:00.000,ViÂ±a del Mar Chile ATP World Tour,CLAY,2,Gustavo Marcaccio,Luis Horna,Gustavo Marcaccio,7-6(6); 0-6; 6-3,R32,128,9,4,59,100,41,59,20,41,10,14,14,61,100,4,2,73,83,52,73,4,10,5,7,13,56,83
2006-01-30 00:00:00.000,ViÂ±a del Mar Chile ATP World Tour,CLAY,2,Jorge Aguilar,Guillermo Hormazabal,Jorge Aguilar,6-4; 6-2,R32,66,0,3,38,56,26,38,14,18,0,0,9,40,56,5,1,33,46,26,33,4,13,2,5,9,30,46
2006-01-30 00:00:00.000,ViÂ±a del Mar Chile ATP World Tour,CLAY,2,Leos Friedl,Carlos Berlocq,Leos Friedl,6-7(5); 6-3; 6-1,R32,164,1,3,58,90,35,58,15,32,1,5,14,50,90,1,5,68,111,41,68,10,43,8,16,14,51,111
2006-01-30 00:00:00.000,ViÂ±a del Mar Chile ATP World Tour,CLAY,2,Nicolas Massu,Marcos Daniel,Nicolas Massu,6-3; 6-3,R32,72,5,1,40,61,28,40,10,21,0,1,9,38,61,4,0,32,49,20,32,7,17,3,7,9,27,49
2006-01-30 00:00:00.000,ViÂ±a del Mar Chile ATP World Tour,CLAY,2,Juan Antonio Marin,Hugo Armando,Juan Antonio Marin,6-2; 6-3,R32,67,4,0,27,49,25,27,12,22,1,1,8,37,49,1,3,28,46,17,28,8,18,1,5,9,25,46
2006-01-30 00:00:00.000,ViÂ±a del Mar Chile ATP World Tour,CLAY,2,Carlos Cuadrado,Tomas Behrend,Carlos Cuadrado,7-5; 6-0,R32,61,1,1,30,45,25,30,8,15,0,1,9,33,45,3,3,27,54,17,27,10,27,5,10,9,27,54
2006-01-30 00:00:00.000,ViÂ±a del Mar Chile ATP World Tour,CLAY,2,Daniel Gimeno-Traver,Agustin Calleri,Daniel Gimeno-Traver,1-6; 6-3; 6-3,R32,101,3,0,60,96,41,60,13,36,5,9,13,54,96,9,3,45,75,31,45,12,30,5,9,12,43,75
2006-01-30 00:00:00.000,ViÂ±a del Mar Chile ATP World Tour,CLAY,2,Boris Pashanski,Flavio Saretta,Boris Pashanski,1-6; 7-5; 6-3,R32,144,4,3,66,98,42,66,14,32,6,11,14,56,98,3,7,67,106,39,67,17,39,12,17,14,56,106
2006-01-30 00:00:00.000,ViÂ±a del Mar Chile ATP World Tour,CLAY,2,Alessio Di Mauro,Adrian Garcia,Alessio Di Mauro,6-7(6); 6-1; 6-4,R32,148,6,1,66,102,40,66,17,36,7,12,15,57,102,2,4,65,101,36,65,14,36,9,17,14,50,101
2006-01-30 00:00:00.000,ViÂ±a del Mar Chile ATP World Tour,CLAY,2,Juan Martin Del Potro,Albert Portas,Juan Martin Del Potro,6-2; 6-2,R32,55,2,1,30,50,19,30,16,20,3,4,8,35,50,1,3,21,43,14,21,5,22,1,6,8,19,43
2006-01-30 00:00:00.000,ViÂ±a del Mar Chile ATP World Tour,CLAY,2,Fernando Gonzalez,Vasilis Mazarakis,Fernando Gonzalez,6-1; 6-2,R32,52,7,2,24,43,20,24,10,19,4,5,7,30,43,0,2,32,50,16,32,4,18,4,10,8,20,50
2006-01-30 00:00:00.000,ViÂ±a del Mar Chile ATP World Tour,CLAY,2,Ruben Ramirez Hidalgo,Gaston Gaudio,Ruben Ramirez Hidalgo,6-7(6); 6-1; 6-4,R16,157,11,2,48,85,37,48,17,37,3,7,14,54,85,2,4,71,104,41,71,10,33,7,15,15,51,104
2006-01-30 00:00:00.000,ViÂ±a del Mar Chile ATP World Tour,CLAY,2,Albert Montanes,Santiago Ventura,Albert Montanes,4-6; 6-4; 6-3,R16,103,9,5,34,72,28,34,21,38,2,5,14,49,72,3,0,56,88,38,56,15,32,5,10,15,53,88
2006-01-30 00:00:00.000,ViÂ±a del Mar Chile ATP World Tour,CLAY,2,Jose Acasuso,Gustavo Marcaccio,Jose Acasuso,6-1; 6-1,R16,58,7,1,29,43,21,29,10,14,1,1,7,31,43,0,0,25,41,13,25,3,16,7,12,7,16,41
2006-01-30 00:00:00.000,ViÂ±a del Mar Chile ATP World Tour,CLAY,2,Leos Friedl,Jorge Aguilar,Leos Friedl,7-6(4); 6-3,R16,98,6,3,45,65,29,45,11,20,4,7,11,40,65,2,1,50,71,27,50,12,21,1,5,10,39,71
2006-01-30 00:00:00.000,ViÂ±a del Mar Chile ATP World Tour,CLAY,2,Nicolas Massu,Juan Antonio Marin,Nicolas Massu,6-3; 6-4,R16,91,5,0,31,57,23,31,20,26,0,0,10,43,57,3,0,20,55,12,20,21,35,2,4,9,33,55
2006-01-30 00:00:00.000,ViÂ±a del Mar Chile ATP World Tour,CLAY,2,Carlos Cuadrado,Daniel Gimeno-Traver,Carlos Cuadrado,6-3; 6-3,R16,62,2,3,40,53,31,40,8,13,3,3,9,39,53,4,1,25,50,15,25,14,25,1,4,9,29,50
2006-01-30 00:00:00.000,ViÂ±a del Mar Chile ATP World Tour,CLAY,2,Boris Pashanski,Alessio Di Mauro,Boris Pashanski,6-7(2); 7-6(4); 6-0,R16,166,5,3,64,107,43,64,24,43,3,6,15,67,107,4,3,56,101,34,56,24,45,5,11,15,58,101
2006-01-30 00:00:00.000,ViÂ±a del Mar Chile ATP World Tour,CLAY,2,Fernando Gonzalez,Juan Martin Del Potro,Fernando Gonzalez,6-3; 7-6(4),R16,95,2,2,40,80,29,40,18,40,7,11,11,47,80,0,2,52,68,29,52,6,16,1,6,10,35,68
2006-01-30 00:00:00.000,ViÂ±a del Mar Chile ATP World Tour,CLAY,2,Ruben Ramirez Hidalgo,Albert Montanes,Ruben Ramirez Hidalgo,6-2; 2-6; 6-2,Q,109,6,0,41,79,33,41,16,38,9,12,12,49,79,1,2,43,70,30,43,9,27,4,9,12,39,70
2006-01-30 00:00:00.000,ViÂ±a del Mar Chile ATP World Tour,CLAY,2,Jose Acasuso,Leos Friedl,Jose Acasuso,3-6; 6-1; 7-5,Q,143,12,1,47,94,37,47,22,47,4,7,14,59,94,6,5,63,97,42,63,12,34,7,12,14,54,97
2006-01-30 00:00:00.000,ViÂ±a del Mar Chile ATP World Tour,CLAY,2,Nicolas Massu,Carlos Cuadrado,Nicolas Massu,4-6; 7-6(4); 6-3,Q,171,9,3,63,91,51,63,19,28,4,5,16,70,91,1,0,83,111,58,83,15,28,12,13,15,73,111
2006-01-30 00:00:00.000,ViÂ±a del Mar Chile ATP World Tour,CLAY,2,Fernando Gonzalez,Boris Pashanski,Fernando Gonzalez,6-4; 6-3,Q,89,9,1,30,57,25,30,14,27,3,3,9,39,57,0,2,49,72,34,49,9,23,5,8,10,43,72
2006-01-30 00:00:00.000,ViÂ±a del Mar Chile ATP World Tour,CLAY,2,Jose Acasuso,Ruben Ramirez Hidalgo,Jose Acasuso,6-2; 6-4,S,96,7,0,37,49,31,37,7,12,1,1,9,38,49,0,1,35,64,22,35,14,29,5,8,9,36,64
2006-01-30 00:00:00.000,ViÂ±a del Mar Chile ATP World Tour,CLAY,2,Nicolas Massu,Fernando Gonzalez,Nicolas Massu,3-6; 7-6(3); 6-4,S,192,3,1,79,111,56,79,13,32,6,8,15,69,111,2,6,67,114,44,67,26,47,6,8,16,70,114
2006-01-30 00:00:00.000,ViÂ±a del Mar Chile ATP World Tour,CLAY,2,Jose Acasuso,Nicolas Massu,Jose Acasuso,6-4; 6-3,F,96,4,0,27,53,20,27,17,26,0,0,9,37,53,3,0,38,55,23,38,9,17,1,4,10,32,55
2006-01-30 00:00:00.000,Zagreb Croatia ATP World Tour,HARD,2,Ivan Ljubicic,Andy Murray,Ivan Ljubicic,4-6; 6-2; 6-3,R32,118,15,3,54,93,41,54,19,39,4,6,14,60,93,4,2,41,73,29,41,16,32,2,6,13,45,73
2006-01-30 00:00:00.000,Zagreb Croatia ATP World Tour,HARD,2,Kenneth Carlsen,Jan Hernych,Kenneth Carlsen,6-2; 6-4,R32,68,7,1,33,47,27,33,9,14,0,0,9,36,47,2,1,43,66,26,43,9,23,6,9,9,35,66
2006-01-30 00:00:00.000,Zagreb Croatia ATP World Tour,HARD,2,Mikhail Youzhny,Tomas Zib,Mikhail Youzhny,6-4; 3-6; 6-1,R32,100,10,1,57,87,42,57,18,30,5,6,13,60,87,9,0,40,77,29,40,21,37,3,6,13,50,77
2006-01-30 00:00:00.000,Zagreb Croatia ATP World Tour,HARD,2,Jarkko Nieminen,Potito Starace,Jarkko Nieminen,3-6; 7-5; 6-3,R32,111,3,3,49,82,34,49,18,33,1,4,15,52,82,10,2,64,97,44,64,14,33,5,9,15,58,97
2006-01-30 00:00:00.000,Zagreb Croatia ATP World Tour,HARD,2,Radek Stepanek,Tomas Cakl,Radek Stepanek,6-3; 7-6(2),R32,66,17,2,37,54,33,37,12,17,0,0,10,45,54,10,6,34,76,29,34,17,42,3,5,11,46,76
2006-01-30 00:00:00.000,Zagreb Croatia ATP World Tour,HARD,2,Novak Djokovic,Robin Vik,Novak Djokovic,6-1; 7-5,R32,79,4,2,37,65,27,37,15,28,5,7,10,42,65,3,8,33,68,17,33,16,35,6,11,9,33,68
2006-01-30 00:00:00.000,Zagreb Croatia ATP World Tour,HARD,2,Ilija Bozoljac,Daniele Bracciali,Ilija Bozoljac,6-4; 7-6(5),R32,81,14,4,35,62,33,35,16,27,0,0,11,49,62,10,6,35,74,29,35,19,39,3,4,11,48,74
2006-01-30 00:00:00.000,Zagreb Croatia ATP World Tour,HARD,2,Feliciano Lopez,Robin Soderling,Feliciano Lopez,7-6(4); 4-6; 6-1,R32,100,14,7,53,87,45,53,17,34,0,1,15,62,87,12,3,56,87,46,56,12,31,1,3,14,58,87
2006-01-30 00:00:00.000,Zagreb Croatia ATP World Tour,HARD,2,Marin Cilic,Igor Andreev,Marin Cilic,6-3; 1-6; 6-3,R32,101,5,6,50,96,39,50,22,46,10,12,13,61,96,0,1,48,71,34,48,14,23,6,8,12,48,71
2006-01-30 00:00:00.000,Zagreb Croatia ATP World Tour,HARD,2,Andreas Seppi,Noam Okun,Andreas Seppi,6-2; 6-4,R32,90,4,2,36,52,25,36,9,16,3,5,9,34,52,4,4,42,80,26,42,13,38,18,23,9,39,80
2006-01-30 00:00:00.000,Zagreb Croatia ATP World Tour,HARD,2,Tim Henman,Arnaud Clement,Tim Henman,6-3; 6-3,R32,77,7,1,30,50,26,30,11,20,0,0,9,37,50,5,1,32,57,20,32,14,25,4,7,9,34,57
2006-01-30 00:00:00.000,Zagreb Croatia ATP World Tour,HARD,2,Richard Gasquet,Davide Sanguinetti,Richard Gasquet,6-3; 6-0,R32,68,4,3,38,62,31,38,9,24,3,3,8,40,62,4,2,24,52,14,24,12,28,5,9,7,26,52
2006-01-30 00:00:00.000,Zagreb Croatia ATP World Tour,HARD,2,Mario Ancic,Dmitry Tursunov,Mario Ancic,6-3; 4-6; 6-4,R32,90,21,2,51,76,47,51,12,25,2,3,15,59,76,5,1,47,68,37,47,16,21,0,2,14,53,68
2006-01-30 00:00:00.000,Zagreb Croatia ATP World Tour,HARD,2,Ivo Karlovic,Rainer Schuettler,Ivo Karlovic,7-6(0); 6-3,R32,90,24,2,48,71,45,48,8,23,3,3,11,53,71,5,8,34,73,27,34,19,39,3,4,10,46,73
2006-01-30 00:00:00.000,Zagreb Croatia ATP World Tour,HARD,2,Stefan Koubek,Ivo Minar,Stefan Koubek,7-6(7); 3-6; 6-3,R32,95,7,3,52,90,41,52,23,38,2,3,15,64,90,6,1,64,87,48,64,13,23,2,3,15,61,87
2006-01-30 00:00:00.000,Zagreb Croatia ATP World Tour,HARD,2,Stanislas Wawrinka,David Ferrer,Stanislas Wawrinka,4-6; 6-1; 6-3,R32,109,6,3,53,101,36,53,22,48,7,10,13,58,101,3,2,55,84,31,55,14,29,7,13,13,45,84
2006-01-30 00:00:00.000,Zagreb Croatia ATP World Tour,HARD,2,Ivan Ljubicic,Kenneth Carlsen,Ivan Ljubicic,7-6(5); 6-4,R16,84,8,0,44,60,39,44,11,16,0,0,11,50,60,4,2,42,67,34,42,14,25,4,5,11,48,67
2006-01-30 00:00:00.000,Zagreb Croatia ATP World Tour,HARD,2,Mikhail Youzhny,Jarkko Nieminen,Mikhail Youzhny,2-6; 7-6(3); 7-6(0),R16,119,4,2,68,109,45,68,21,41,5,10,16,66,109,3,3,72,98,47,72,14,26,3,6,16,61,98
2006-01-30 00:00:00.000,Zagreb Croatia ATP World Tour,HARD,2,Novak Djokovic,Radek Stepanek,Novak Djokovic,6-3; 6-4,R16,83,7,3,33,60,26,33,15,27,1,2,10,41,60,4,2,34,53,22,34,9,19,4,7,9,31,53
2006-01-30 00:00:00.000,Zagreb Croatia ATP World Tour,HARD,2,Ilija Bozoljac,Feliciano Lopez,Ilija Bozoljac,7-6(5); 6-2,R16,78,14,0,30,67,27,30,21,37,3,3,10,48,67,10,7,30,68,27,30,16,38,3,5,10,43,68
2006-01-30 00:00:00.000,Zagreb Croatia ATP World Tour,HARD,2,Andreas Seppi,Marin Cilic,Andreas Seppi,4-6; 6-4; 6-4,R16,102,3,2,49,82,35,49,21,33,1,3,15,56,82,10,6,47,86,35,47,21,39,3,6,15,56,86
2006-01-30 00:00:00.000,Zagreb Croatia ATP World Tour,HARD,2,Tim Henman,Richard Gasquet,Tim Henman,6-4; 6-4,R16,85,9,4,43,70,33,43,12,27,5,6,10,45,70,1,4,28,61,23,28,16,33,7,10,10,39,61
2006-01-30 00:00:00.000,Zagreb Croatia ATP World Tour,HARD,2,Ivo Karlovic,Mario Ancic,Ivo Karlovic,7-6(7); 7-6(4),R16,102,14,0,54,76,49,54,14,22,1,1,12,63,76,7,1,50,71,43,50,15,21,2,2,12,58,71
2006-01-30 00:00:00.000,Zagreb Croatia ATP World Tour,HARD,2,Stefan Koubek,Stanislas Wawrinka,Stefan Koubek,6-4; 6-4,R16,86,1,2,35,57,26,35,14,22,0,1,10,40,57,3,4,41,72,29,41,13,31,5,8,10,42,72
2006-01-30 00:00:00.000,Zagreb Croatia ATP World Tour,HARD,2,Ivan Ljubicic,Mikhail Youzhny,Ivan Ljubicic,6-3; 6-2,Q,64,12,2,28,51,23,28,14,23,0,0,9,37,51,1,1,31,52,16,31,13,21,5,8,8,29,52
2006-01-30 00:00:00.000,Zagreb Croatia ATP World Tour,HARD,2,Novak Djokovic,Ilija Bozoljac,Novak Djokovic,6-2; 6-3,Q,60,10,0,34,49,29,34,9,15,2,2,9,38,49,10,2,27,44,20,27,7,17,1,4,8,27,44
2006-01-30 00:00:00.000,Zagreb Croatia ATP World Tour,HARD,2,Tim Henman,Andreas Seppi,Tim Henman,6-3; 6-4,Q,85,1,2,43,73,27,43,19,30,3,4,10,46,73,0,4,26,56,15,26,18,30,7,10,9,33,56
2006-01-30 00:00:00.000,Zagreb Croatia ATP World Tour,HARD,2,Stefan Koubek,Ivo Karlovic,Stefan Koubek,7-6(4); 6-7(6); 6-3,Q,134,3,5,80,119,60,80,25,39,6,6,17,85,119,21,0,62,97,51,62,21,35,4,5,16,72,97
2006-01-30 00:00:00.000,Zagreb Croatia ATP World Tour,HARD,2,Ivan Ljubicic,Novak Djokovic,Ivan Ljubicic,6-7(6); 6-3; 6-4,S,141,16,3,68,102,59,68,15,34,3,3,16,74,102,8,4,65,105,47,65,21,40,8,10,15,68,105
2006-01-30 00:00:00.000,Zagreb Croatia ATP World Tour,HARD,2,Stefan Koubek,Tim Henman,Stefan Koubek,6-3; 3-6; 6-2,S,101,4,1,51,82,36,51,15,31,11,14,13,51,82,1,4,57,84,39,57,7,27,3,8,13,46,84
2006-01-30 00:00:00.000,Zagreb Croatia ATP World Tour,HARD,2,Ivan Ljubicic,Stefan Koubek,Ivan Ljubicic,6-3; 6-4,F,66,10,3,35,51,34,35,8,16,2,2,10,42,51,1,0,29,47,18,29,14,18,2,4,9,32,47
2006-02-13 00:00:00.000,Buenos Aires Argentina ATP World Tour,CLAY,2,Alberto Martin,Albert Portas,Alberto Martin,6-2; 7-5,R32,91,3,1,27,56,24,27,16,29,3,4,10,40,56,4,2,42,78,27,42,15,36,8,12,10,42,78
2006-02-13 00:00:00.000,Buenos Aires Argentina ATP World Tour,CLAY,2,Boris Pashanski,Juan Pablo Brzezicki,Boris Pashanski,6-4; 5-7; 7-5,R32,191,3,2,75,141,49,75,30,66,14,19,17,79,141,5,5,57,101,40,57,20,44,6,12,17,60,101
2006-02-13 00:00:00.000,Buenos Aires Argentina ATP World Tour,CLAY,2,Tomas Behrend,Carlos Berlocq,Tomas Behrend,7-6(1); 6-4,R32,112,3,3,40,75,28,40,16,35,2,5,11,44,75,2,5,41,78,27,41,13,37,2,6,11,40,78
2006-02-13 00:00:00.000,Buenos Aires Argentina ATP World Tour,CLAY,2,Filippo Volandri,Fernando Vicente,Filippo Volandri,6-3; 6-2,R32,55,0,1,28,42,20,28,9,14,0,1,8,29,42,0,0,30,51,15,30,9,21,5,10,9,24,51
2006-02-13 00:00:00.000,Buenos Aires Argentina ATP World Tour,CLAY,2,Jose Acasuso,Albert Montanes,Jose Acasuso,6-1; 6-3,R32,61,5,0,25,45,23,25,9,20,0,0,8,32,45,0,4,26,51,15,26,10,25,6,10,8,25,51
2006-02-13 00:00:00.000,Buenos Aires Argentina ATP World Tour,CLAY,2,Martin Vassallo Arguello,Ricardo Mello,Martin Vassallo Arguello,6-3; 6-3,R32,82,5,1,36,52,29,36,9,16,0,0,9,38,52,2,2,43,64,29,43,9,21,7,10,9,38,64
2006-02-13 00:00:00.000,Buenos Aires Argentina ATP World Tour,CLAY,2,Juan Antonio Marin,Razvan Sabau,Juan Antonio Marin,6-1; 6-1,R32,53,3,1,13,35,10,13,18,22,0,0,7,28,35,0,4,25,47,13,25,6,22,5,10,7,19,47
2006-02-13 00:00:00.000,Buenos Aires Argentina ATP World Tour,CLAY,2,Agustin Calleri,Florent Serra,Agustin Calleri,6-0; 6-4,R32,61,6,0,17,38,14,17,16,21,0,1,8,30,38,1,1,34,52,17,34,7,18,5,10,8,24,52
2006-02-13 00:00:00.000,Buenos Aires Argentina ATP World Tour,CLAY,2,Juan Ignacio Chela,Luis Horna,Juan Ignacio Chela,7-6(1) RET,R32,55,1,1,26,35,21,26,6,9,1,2,6,27,35,3,1,32,45,19,32,6,13,3,4,6,25,45
2006-02-13 00:00:00.000,Buenos Aires Argentina ATP World Tour,CLAY,2,Potito Starace,Juan Monaco,Potito Starace,6-3; 6-3,R32,97,1,2,37,50,29,37,7,13,1,2,9,36,50,1,2,37,67,23,37,12,30,5,9,9,35,67
2006-02-13 00:00:00.000,Buenos Aires Argentina ATP World Tour,CLAY,2,Flavio Saretta,Gorka Fraile,Flavio Saretta,6-0; 4-6; 6-3,R32,12,3,0,43,66,29,43,13,23,5,8,12,42,66,0,0,78,90,42,78,3,12,11,18,13,45,90
2006-02-13 00:00:00.000,Buenos Aires Argentina ATP World Tour,CLAY,2,Juan Carlos Ferrero,Juan Martin Del Potro,Juan Carlos Ferrero,6-2; 4-6; 6-4,R32,137,4,1,58,82,36,58,14,24,6,10,14,50,82,2,2,81,108,44,81,12,27,7,13,14,56,108
2006-02-13 00:00:00.000,Buenos Aires Argentina ATP World Tour,CLAY,2,Carlos Moya,Fabio Fognini,Carlos Moya,6-7(6); 6-4; 6-4,R32,143,2,2,72,105,49,72,18,33,1,3,16,67,105,2,2,57,102,35,57,29,45,4,8,16,64,102
2006-02-13 00:00:00.000,Buenos Aires Argentina ATP World Tour,CLAY,2,Nicolas Massu,Marcos Daniel,Nicolas Massu,6-3; 5-7; 6-1,R32,134,4,1,40,77,27,40,23,37,3,6,14,50,77,3,2,50,76,30,50,12,26,0,6,14,42,76
2006-02-13 00:00:00.000,Buenos Aires Argentina ATP World Tour,CLAY,2,Ruben Ramirez Hidalgo,Eric Prodon,Ruben Ramirez Hidalgo,3-6; 6-4; 6-2,R32,121,5,5,56,96,42,56,18,40,8,10,14,60,96,2,3,55,84,36,55,16,29,6,9,13,52,84
2006-02-13 00:00:00.000,Buenos Aires Argentina ATP World Tour,CLAY,2,Guillermo Coria,Jiri Vanek,Guillermo Coria,6-1; 2-6; 7-6(2),R32,163,2,9,69,102,41,69,14,33,6,12,13,55,102,6,3,65,107,42,65,13,42,15,22,14,55,107
2006-02-13 00:00:00.000,Buenos Aires Argentina ATP World Tour,CLAY,2,Boris Pashanski,Alberto Martin,Boris Pashanski,3-6; 7-6(5); 6-3,R16,148,5,4,73,118,50,73,20,45,8,12,16,70,118,5,5,47,86,34,47,21,39,2,5,14,55,86
2006-02-13 00:00:00.000,Buenos Aires Argentina ATP World Tour,CLAY,2,Filippo Volandri,Tomas Behrend,Filippo Volandri,3-6; 7-6(5); 7-6(2),R16,139,1,0,88,114,55,88,16,26,4,8,17,71,114,0,3,64,114,44,64,27,50,5,7,16,71,114
2006-02-13 00:00:00.000,Buenos Aires Argentina ATP World Tour,CLAY,2,Jose Acasuso,Martin Vassallo Arguello,Jose Acasuso,6-3; 6-1,R16,64,4,2,22,39,20,22,10,17,1,2,8,30,39,1,3,31,46,14,31,4,15,2,7,8,18,46
2006-02-13 00:00:00.000,Buenos Aires Argentina ATP World Tour,CLAY,2,Agustin Calleri,Juan Antonio Marin,Agustin Calleri,6-4; 6-2,R16,87,9,2,28,44,26,28,11,16,0,0,9,37,44,2,0,28,59,20,28,14,31,2,5,9,34,59
2006-02-13 00:00:00.000,Buenos Aires Argentina ATP World Tour,CLAY,2,Potito Starace,Juan Ignacio Chela,Potito Starace,3-6; 7-6(4); 6-2,R16,157,3,1,75,97,57,75,8,22,5,6,14,65,97,6,2,66,105,43,66,22,39,5,7,15,65,105
2006-02-13 00:00:00.000,Buenos Aires Argentina ATP World Tour,CLAY,2,Juan Carlos Ferrero,Flavio Saretta,Juan Carlos Ferrero,4-6; 6-2; 6-3,R16,148,4,0,65,95,42,65,16,30,7,10,14,58,95,3,3,49,80,29,49,17,31,6,11,13,46,80
2006-02-13 00:00:00.000,Buenos Aires Argentina ATP World Tour,CLAY,2,Carlos Moya,Nicolas Massu,Carlos Moya,4-6; 6-3; 7-6(4),R16,162,6,3,66,96,54,66,16,30,2,4,16,70,96,0,2,65,104,46,65,22,39,5,7,15,68,104
2006-02-13 00:00:00.000,Buenos Aires Argentina ATP World Tour,CLAY,2,Ruben Ramirez Hidalgo,Guillermo Coria,Ruben Ramirez Hidalgo,7-5; 6-2,R16,94,5,4,41,72,30,41,12,31,6,9,10,42,72,0,12,31,58,17,31,10,27,4,10,10,27,58
2006-02-13 00:00:00.000,Buenos Aires Argentina ATP World Tour,CLAY,2,Filippo Volandri,Boris Pashanski,Filippo Volandri,6-4; 6-3,Q,93,4,1,50,65,32,50,8,15,4,7,10,40,65,1,3,37,72,20,37,14,35,8,13,9,34,72
2006-02-13 00:00:00.000,Buenos Aires Argentina ATP World Tour,CLAY,2,Agustin Calleri,Jose Acasuso,Agustin Calleri,6-3; 3-6; 6-4,Q,133,3,1,51,86,38,51,15,35,3,7,14,53,86,2,2,48,84,35,48,13,36,1,6,14,48,84
2006-02-13 00:00:00.000,Buenos Aires Argentina ATP World Tour,CLAY,2,Juan Carlos Ferrero,Potito Starace,Juan Carlos Ferrero,6-3; 7-5,Q,102,1,0,49,63,31,49,6,14,5,9,11,37,63,1,0,54,76,27,54,8,22,12,18,10,35,76
2006-02-13 00:00:00.000,Buenos Aires Argentina ATP World Tour,CLAY,2,Carlos Moya,Ruben Ramirez Hidalgo,Carlos Moya,6-2; 6-2,Q,66,7,2,32,56,28,32,9,24,4,5,8,37,56,1,3,33,48,18,33,4,15,6,11,8,22,48
2006-02-13 00:00:00.000,Buenos Aires Argentina ATP World Tour,CLAY,2,Filippo Volandri,Agustin Calleri,Filippo Volandri,6-3; 6-4,S,85,0,0,57,74,34,57,9,17,3,5,10,43,74,0,3,26,50,17,26,9,24,3,7,9,26,50
2006-02-13 00:00:00.000,Buenos Aires Argentina ATP World Tour,CLAY,2,Carlos Moya,Juan Carlos Ferrero,Carlos Moya,3-6; 7-6(3); 6-4,S,155,6,4,62,105,48,62,21,43,4,6,15,69,105,3,2,81,101,58,81,9,20,1,3,16,67,101
2006-02-13 00:00:00.000,Buenos Aires Argentina ATP World Tour,CLAY,2,Carlos Moya,Filippo Volandri,Carlos Moya,7-6(6); 6-4,F,90,3,0,45,65,37,45,10,20,2,3,11,47,65,0,0,58,72,37,58,8,14,3,5,11,45,72
2006-02-13 00:00:00.000,Marseille France ATP World Tour,HARD,2,Rafael Nadal,Olivier Rochus,Rafael Nadal,4-6; 6-2; 7-5,R32,145,3,1,50,81,32,50,17,31,3,8,15,49,81,2,6,62,97,34,62,15,35,6,13,15,49,97
2006-02-13 00:00:00.000,Marseille France ATP World Tour,HARD,2,Gilles Simon,Jarkko Nieminen,Gilles Simon,4-6; 6-3; 6-2,R32,126,8,4,42,85,35,42,25,43,4,5,14,60,85,2,0,65,107,39,65,23,42,10,13,13,62,107
2006-02-13 00:00:00.000,Marseille France ATP World Tour,HARD,2,Paul-Henri Mathieu,Jerome Haehnel,Paul-Henri Mathieu,5-7; 6-3; 6-4,R32,130,7,6,48,99,37,48,23,51,6,10,16,60,99,8,5,57,96,41,57,13,39,1,6,15,54,96
2006-02-13 00:00:00.000,Marseille France ATP World Tour,HARD,2,Radek Stepanek,Tomas Berdych,Radek Stepanek,7-5; 6-4,R32,83,12,2,34,54,30,34,14,20,0,0,11,44,54,6,0,34,66,25,34,20,32,5,7,11,45,66
2006-02-13 00:00:00.000,Marseille France ATP World Tour,HARD,2,Fabrice Santoro,Thomas Johansson,Fabrice Santoro,6-4; 7-6(3),R32,86,3,2,38,73,33,38,18,35,3,3,11,51,73,10,3,42,75,29,42,19,33,1,2,11,48,75
2006-02-13 00:00:00.000,Marseille France ATP World Tour,HARD,2,Greg Rusedski,Nicolas Thomann,Greg Rusedski,6-3; 6-2,R32,73,15,4,38,59,30,38,11,21,3,3,9,41,59,0,2,26,50,14,26,13,24,3,6,8,27,50
2006-02-13 00:00:00.000,Marseille France ATP World Tour,HARD,2,Fernando Verdasco,Jurgen Melzer,Fernando Verdasco,6-4; 7-6(3),R32,84,6,5,49,77,34,49,14,28,4,6,11,48,77,8,2,45,71,29,45,12,26,4,7,11,41,71
2006-02-13 00:00:00.000,Marseille France ATP World Tour,HARD,2,Arnaud Clement,Richard Gasquet,Arnaud Clement,3-6; 6-4; 6-0,R32,114,5,1,48,85,32,48,23,37,5,6,12,55,85,6,3,45,76,30,45,16,31,3,7,13,46,76
2006-02-13 00:00:00.000,Marseille France ATP World Tour,HARD,2,Sebastien Grosjean,Gael Monfils,Sebastien Grosjean,2-6; 7-5; 6-3,R32,133,3,3,46,94,32,46,22,48,2,7,15,54,94,3,1,40,74,24,40,20,34,3,8,14,44,74
2006-02-13 00:00:00.000,Marseille France ATP World Tour,HARD,2,Mikhail Youzhny,Sebastien De Chaunac,Mikhail Youzhny,6-4; 6-3,R32,77,3,0,31,52,26,31,13,21,2,2,9,39,52,2,0,40,67,26,40,14,27,7,10,10,40,67
2006-02-13 00:00:00.000,Marseille France ATP World Tour,HARD,2,Evgeny Korolev,Alexandre Sidorenko,Evgeny Korolev,2-6; 6-4; 6-1,R32,112,8,7,41,82,35,41,20,41,6,8,13,55,82,5,2,34,78,22,34,24,44,1,4,12,46,78
2006-02-13 00:00:00.000,Marseille France ATP World Tour,HARD,2,Nikolay Davydenko,Christophe Rochus,Nikolay Davydenko,6-1; 6-2,R32,70,5,2,24,42,20,24,8,18,1,2,7,28,42,1,3,24,54,15,24,6,30,6,12,8,21,54
2006-02-13 00:00:00.000,Marseille France ATP World Tour,HARD,2,Mario Ancic,Marcos Baghdatis,Mario Ancic,6-2; 6-7(9); 6-4,R32,125,14,2,64,107,56,64,19,43,4,5,15,75,107,7,1,69,108,47,69,22,39,4,8,15,69,108
2006-02-13 00:00:00.000,Marseille France ATP World Tour,HARD,2,Jean-Christophe Faurel,Feliciano Lopez,Jean-Christophe Faurel,6-3; 6-3,R32,61,5,1,27,50,22,27,16,23,0,0,9,38,50,10,4,28,55,19,28,12,27,5,8,9,31,55
2006-02-13 00:00:00.000,Marseille France ATP World Tour,HARD,2,Igor Andreev,Taylor Dent,Igor Andreev,2-6; 6-3; 7-6(0),R32,101,4,2,59,89,40,59,21,30,5,7,15,61,89,6,6,44,75,37,44,16,31,0,1,14,53,75
2006-02-13 00:00:00.000,Marseille France ATP World Tour,HARD,2,Ivan Ljubicic,Paradorn Srichaphan,Ivan Ljubicic,6-3; 6-7(6); 6-3,R32,110,21,3,63,92,53,63,14,29,1,2,16,67,92,5,1,47,85,39,47,17,38,3,6,14,56,85
2006-02-13 00:00:00.000,Marseille France ATP World Tour,HARD,2,Rafael Nadal,Gilles Simon,Rafael Nadal,7-5; 6-4,R16,103,1,2,52,71,36,52,10,19,3,4,11,46,71,9,2,37,60,29,37,10,23,0,3,11,39,60
2006-02-13 00:00:00.000,Marseille France ATP World Tour,HARD,2,Paul-Henri Mathieu,Radek Stepanek,Paul-Henri Mathieu,7-6(0); 6-3,R16,94,5,1,40,67,32,40,15,27,2,2,10,47,67,14,0,43,66,31,43,11,23,0,2,11,42,66
2006-02-13 00:00:00.000,Marseille France ATP World Tour,HARD,2,Fabrice Santoro,Greg Rusedski,Fabrice Santoro,6-3; 6-2,R16,73,2,1,28,55,20,28,20,27,1,1,9,40,55,4,6,33,51,19,33,8,18,2,5,8,27,51
2006-02-13 00:00:00.000,Marseille France ATP World Tour,HARD,2,Arnaud Clement,Fernando Verdasco,Arnaud Clement,7-6(5); 6-3,R16,100,5,3,43,70,30,43,15,27,5,7,10,45,70,6,3,44,73,29,44,12,29,2,6,11,41,73
2006-02-13 00:00:00.000,Marseille France ATP World Tour,HARD,2,Sebastien Grosjean,Mikhail Youzhny,Sebastien Grosjean,6-3; 6-1,R16,74,5,0,32,54,26,32,11,22,4,4,8,37,54,1,3,23,47,16,23,7,24,3,7,8,23,47
2006-02-13 00:00:00.000,Marseille France ATP World Tour,HARD,2,Evgeny Korolev,Nikolay Davydenko,Evgeny Korolev,6-4; 7-6(6),R16,91,6,6,41,75,30,41,15,34,5,8,11,45,75,4,3,44,63,28,44,9,19,2,6,11,37,63
2006-02-13 00:00:00.000,Marseille France ATP World Tour,HARD,2,Mario Ancic,Jean-Christophe Faurel,Mario Ancic,6-3; 6-3,R16,62,12,1,32,58,28,32,13,26,2,2,9,41,58,1,2,39,65,21,39,15,26,8,11,9,36,65
2006-02-13 00:00:00.000,Marseille France ATP World Tour,HARD,2,Ivan Ljubicic,Igor Andreev,Ivan Ljubicic,7-6(5); 6-4,R16,84,18,4,45,70,39,45,14,25,2,2,11,53,70,4,1,43,67,37,43,12,24,1,2,11,49,67
2006-02-13 00:00:00.000,Marseille France ATP World Tour,HARD,2,Rafael Nadal,Paul-Henri Mathieu,Rafael Nadal,7-5; 6-4,Q,122,8,4,55,83,39,55,16,28,6,6,11,55,83,3,6,34,64,27,34,16,30,4,6,11,43,64
2006-02-13 00:00:00.000,Marseille France ATP World Tour,HARD,2,Arnaud Clement,Fabrice Santoro,Arnaud Clement,7-5; 4-6; 7-6(5),Q,162,10,1,66,108,47,66,24,42,2,5,17,71,108,16,0,58,100,47,58,19,42,0,3,17,66,100
2006-02-13 00:00:00.000,Marseille France ATP World Tour,HARD,2,Sebastien Grosjean,Evgeny Korolev,Sebastien Grosjean,7-6(4); 6-3,Q,104,10,1,35,65,31,35,16,30,3,3,10,47,65,5,5,41,83,31,41,18,42,6,8,11,49,83
2006-02-13 00:00:00.000,Marseille France ATP World Tour,HARD,2,Mario Ancic,Ivan Ljubicic,Mario Ancic,7-6(2); 3-6; 6-3,Q,136,17,3,71,106,57,71,16,35,4,5,15,73,106,8,0,50,77,44,50,15,27,0,1,15,59,77
2006-02-13 00:00:00.000,Marseille France ATP World Tour,HARD,2,Arnaud Clement,Rafael Nadal,Arnaud Clement,2-6; 6-3; 7-5,S,115,8,3,54,86,40,54,18,32,1,3,15,58,86,5,1,58,93,37,58,22,35,7,9,14,59,93
2006-02-13 00:00:00.000,Marseille France ATP World Tour,HARD,2,Mario Ancic,Sebastien Grosjean,Mario Ancic,6-3; 3-6; 6-3,S,129,11,2,48,84,40,48,20,36,2,3,14,60,84,2,1,36,80,27,36,24,44,2,4,13,51,80
2006-02-13 00:00:00.000,Marseille France ATP World Tour,HARD,2,Arnaud Clement,Mario Ancic,Arnaud Clement,6-4; 6-2,F,92,4,1,29,59,22,29,18,30,3,3,9,40,59,6,2,28,57,22,28,11,29,2,5,9,33,57
2006-02-13 00:00:00.000,San Jose CA; U.S.A. ATP World Tour,HARD,2,Andy Roddick,Guillermo Garcia-Lopez,Andy Roddick,6-3; 6-4,R32,79,6,2,27,56,20,27,19,29,5,6,10,39,56,7,1,34,59,23,34,12,25,3,6,9,35,59
2006-02-13 00:00:00.000,San Jose CA; U.S.A. ATP World Tour,HARD,2,Kenneth Carlsen,Lukas Dlouhy,Kenneth Carlsen,3-6; 6-2; 6-1,R32,95,2,1,40,69,29,40,13,29,6,9,12,42,69,7,6,53,86,33,53,11,33,9,15,12,44,86
2006-02-13 00:00:00.000,San Jose CA; U.S.A. ATP World Tour,HARD,2,Bjorn Phau,Cyril Saulnier,Bjorn Phau,6-4; 7-5,R32,106,1,3,37,78,26,37,24,41,4,5,11,50,78,4,6,46,88,36,46,16,42,13,16,11,52,88
2006-02-13 00:00:00.000,San Jose CA; U.S.A. ATP World Tour,HARD,2,Brian Wilson,Ivo Karlovic,Brian Wilson,7-6(1); 7-6(5),R32,99,2,4,51,77,42,51,18,26,4,4,12,60,77,11,3,43,77,34,43,20,34,1,1,12,54,77
2006-02-13 00:00:00.000,San Jose CA; U.S.A. ATP World Tour,HARD,2,Mark Philippoussis,Tommy Robredo,Mark Philippoussis,3-6; 7-5; 7-5,R32,139,11,8,47,107,38,47,25,60,5,10,17,63,107,4,2,60,91,39,60,16,31,1,6,16,55,91
2006-02-13 00:00:00.000,San Jose CA; U.S.A. ATP World Tour,HARD,2,Robin Soderling,Andrei Pavel,Robin Soderling,6-3; 6-4,R32,67,6,1,33,51,26,33,12,18,3,5,10,38,51,3,2,35,69,19,35,17,34,6,10,9,36,69
2006-02-13 00:00:00.000,San Jose CA; U.S.A. ATP World Tour,HARD,2,Andy Murray,Mardy Fish,Andy Murray,6-2; 6-2,R32,64,5,1,21,42,16,21,14,21,0,1,8,30,42,3,6,26,59,13,26,14,33,6,11,8,27,59
2006-02-13 00:00:00.000,San Jose CA; U.S.A. ATP World Tour,HARD,2,Jimmy Wang,James Blake,Jimmy Wang,6-3; 7-5,R32,99,5,1,36,89,26,36,27,53,10,12,11,53,89,7,6,38,72,27,38,12,34,5,9,10,39,72
2006-02-13 00:00:00.000,San Jose CA; U.S.A. ATP World Tour,HARD,2,Dmitry Tursunov,Jonas Bjorkman,Dmitry Tursunov,4-6; 6-3; 6-2,R32,111,16,6,51,103,41,51,23,52,7,9,14,64,103,5,2,47,82,30,47,17,35,4,8,13,47,82
2006-02-13 00:00:00.000,San Jose CA; U.S.A. ATP World Tour,HARD,2,Wayne Arthurs,Bobby Reynolds,Wayne Arthurs,4-6; 7-5; 7-5,R32,122,27,3,55,90,46,55,24,35,4,5,17,70,90,13,5,61,104,47,61,24,43,7,9,17,71,104
2006-02-13 00:00:00.000,San Jose CA; U.S.A. ATP World Tour,HARD,2,Sam Warburg,Joachim Johansson,Sam Warburg,6-3; 4-6; 6-3,R32,112,6,4,57,78,39,57,12,21,0,3,14,51,78,5,5,51,92,32,51,19,41,4,9,14,51,92
2006-02-13 00:00:00.000,San Jose CA; U.S.A. ATP World Tour,HARD,2,Lleyton Hewitt,Paul Goldstein,Lleyton Hewitt,6-4; 6-2,R32,58,6,2,22,45,20,22,14,23,0,1,9,34,45,0,0,27,48,19,27,8,21,1,5,9,27,48
2006-02-13 00:00:00.000,San Jose CA; U.S.A. ATP World Tour,HARD,2,Justin Gimelstob,Bjorn Rehnquist,Justin Gimelstob,6-1; 6-4,R32,68,4,2,23,55,16,23,19,32,2,4,9,35,55,1,4,22,53,11,22,14,31,9,14,8,25,53
2006-02-13 00:00:00.000,San Jose CA; U.S.A. ATP World Tour,HARD,2,Kristof Vliegen,Rainer Schuettler,Kristof Vliegen,6-1; 6-3,R32,67,3,2,33,49,23,33,10,16,2,3,8,33,49,5,5,35,60,21,35,8,25,3,8,8,29,60
2006-02-13 00:00:00.000,San Jose CA; U.S.A. ATP World Tour,HARD,2,Vincent Spadea,Sam Querrey,Vincent Spadea,6-7(4); 6-4; 6-2,R32,115,5,2,61,103,46,61,21,42,4,5,15,67,103,15,6,63,103,48,63,14,40,5,9,15,62,103
2006-02-13 00:00:00.000,San Jose CA; U.S.A. ATP World Tour,HARD,2,Travis Rettenmaier,Scoville Jenkins,Travis Rettenmaier,7-5; 3-6; 6-3,R32,120,3,4,53,90,41,53,20,37,4,6,15,61,90,5,4,46,84,35,46,23,38,4,7,15,58,84
2006-02-13 00:00:00.000,San Jose CA; U.S.A. ATP World Tour,HARD,2,Andy Roddick,Kenneth Carlsen,Andy Roddick,6-3; 1-6; 6-3,R16,95,9,1,52,82,39,52,14,30,3,5,13,53,82,8,3,40,66,30,40,15,26,1,3,12,45,66
2006-02-13 00:00:00.000,San Jose CA; U.S.A. ATP World Tour,HARD,2,Bjorn Phau,Brian Wilson,Bjorn Phau,7-5; 7-5,R16,99,2,2,31,63,24,31,18,32,0,2,12,42,63,4,13,53,95,36,53,16,42,11,15,12,52,95
2006-02-13 00:00:00.000,San Jose CA; U.S.A. ATP World Tour,HARD,2,Robin Soderling,Mark Philippoussis,Robin Soderling,6-2; 6-3,R16,61,6,2,32,46,29,32,9,14,2,2,9,38,46,6,1,35,55,26,35,5,20,5,8,8,31,55
2006-02-13 00:00:00.000,San Jose CA; U.S.A. ATP World Tour,HARD,2,Andy Murray,Jimmy Wang,Andy Murray,6-4; 6-2,R16,100,4,1,30,73,22,30,21,43,7,9,9,43,73,1,0,38,70,15,38,17,32,7,12,9,32,70
2006-02-13 00:00:00.000,San Jose CA; U.S.A. ATP World Tour,HARD,2,Wayne Arthurs,Dmitry Tursunov,Wayne Arthurs,6-3; 6-7(5); 6-3,R16,113,21,7,49,99,41,49,26,50,3,5,16,67,99,8,12,49,91,39,49,14,42,2,6,14,53,91
2006-02-13 00:00:00.000,San Jose CA; U.S.A. ATP World Tour,HARD,2,Lleyton Hewitt,Sam Warburg,Lleyton Hewitt,6-4; 6-3,R16,72,10,4,34,59,26,34,10,25,1,3,10,36,59,1,1,39,57,20,39,10,18,3,7,9,30,57
2006-02-13 00:00:00.000,San Jose CA; U.S.A. ATP World Tour,HARD,2,Kristof Vliegen,Justin Gimelstob,Kristof Vliegen,7-6(1); 4-6; 6-1,R16,107,7,1,61,89,46,61,18,28,4,6,15,64,89,7,2,47,82,33,47,19,35,2,5,14,52,82
2006-02-13 00:00:00.000,San Jose CA; U.S.A. ATP World Tour,HARD,2,Vincent Spadea,Travis Rettenmaier,Vincent Spadea,6-2; 6-0,R16,45,3,0,29,36,24,29,4,7,0,0,7,28,36,0,3,25,40,15,25,3,15,4,9,7,18,40
2006-02-13 00:00:00.000,San Jose CA; U.S.A. ATP World Tour,HARD,2,Andy Roddick,Bjorn Phau,Andy Roddick,6-3; 6-2,Q,64,8,3,33,46,31,33,6,13,1,1,9,37,46,2,4,28,58,17,28,15,30,1,4,8,32,58
2006-02-13 00:00:00.000,San Jose CA; U.S.A. ATP World Tour,HARD,2,Andy Murray,Robin Soderling,Andy Murray,4-6; 7-5; 6-4,Q,123,4,2,54,92,43,54,16,38,3,7,16,59,92,13,6,66,106,45,66,17,40,6,11,16,62,106
2006-02-13 00:00:00.000,San Jose CA; U.S.A. ATP World Tour,HARD,2,Lleyton Hewitt,Wayne Arthurs,Lleyton Hewitt,7-6(4); 6-2,Q,69,10,2,28,57,23,28,20,29,0,1,10,43,57,19,6,34,70,25,34,16,36,3,6,10,41,70
2006-02-13 00:00:00.000,San Jose CA; U.S.A. ATP World Tour,HARD,2,Vincent Spadea,Kristof Vliegen,Vincent Spadea,6-1; 2-6; 6-3,Q,103,3,1,47,86,32,47,20,39,8,11,12,52,86,6,2,45,77,27,45,15,32,4,9,12,42,77
2006-02-13 00:00:00.000,San Jose CA; U.S.A. ATP World Tour,HARD,2,Andy Murray,Andy Roddick,Andy Murray,7-5; 7-5,S,69,7,2,47,76,32,47,18,29,3,4,12,50,76,6,2,37,67,28,37,14,30,4,7,12,42,67
2006-02-13 00:00:00.000,San Jose CA; U.S.A. ATP World Tour,HARD,2,Lleyton Hewitt,Vincent Spadea,Lleyton Hewitt,6-3; 6-4,S,72,6,4,38,65,33,38,13,27,3,3,10,46,65,4,1,31,55,26,31,8,24,5,7,9,34,55
2006-02-13 00:00:00.000,San Jose CA; U.S.A. ATP World Tour,HARD,2,Andy Murray,Lleyton Hewitt,Andy Murray,2-6; 6-1; 7-6(3),F,143,8,5,46,86,37,46,12,40,3,8,13,49,86,10,11,52,118,33,52,28,66,10,16,14,61,118
2006-02-20 00:00:00.000,Costa Do Sauipe Brasil ATP World Tour,CLAY,2,Gaston Gaudio,Albert Portas,Gaston Gaudio,6-3; 3-6; 6-3,R32,110,2,2,45,73,32,45,14,28,2,6,13,46,73,6,8,45,83,28,45,17,38,5,11,14,45,83
2006-02-20 00:00:00.000,Costa Do Sauipe Brasil ATP World Tour,CLAY,2,Olivier Patience,Razvan Sabau,Olivier Patience,7-6(5); 6-3,R32,78,10,4,43,68,28,43,12,25,5,8,10,40,68,1,6,40,70,25,40,12,30,6,11,11,37,70
2006-02-20 00:00:00.000,Costa Do Sauipe Brasil ATP World Tour,CLAY,2,Ricardo Mello,Juan Antonio Marin,Ricardo Mello,7-6(9); 3-6; 6-0,R32,140,3,3,39,80,26,39,19,41,1,6,13,45,80,4,1,45,98,27,45,23,53,3,10,14,50,98
2006-02-20 00:00:00.000,Costa Do Sauipe Brasil ATP World Tour,CLAY,2,Boris Pashanski,Tomas Behrend,Boris Pashanski,6-3; 1-6; 6-3,R32,115,3,5,44,82,33,44,18,38,4,7,13,51,82,5,1,46,85,31,46,17,39,7,10,12,48,85
2006-02-20 00:00:00.000,Costa Do Sauipe Brasil ATP World Tour,CLAY,2,Filippo Volandri,Kevin Kim,Filippo Volandri,3-6; 6-3; 6-0,R32,99,0,1,59,77,33,59,11,18,3,7,12,44,77,2,4,49,86,23,49,18,37,7,14,12,41,86
2006-02-20 00:00:00.000,Costa Do Sauipe Brasil ATP World Tour,CLAY,2,Jiri Vanek,Albert Montanes,Jiri Vanek,7-6(6); 6-1,R32,87,11,3,37,57,29,37,11,20,1,3,10,40,57,5,7,38,71,24,38,14,33,5,9,9,38,71
2006-02-20 00:00:00.000,Costa Do Sauipe Brasil ATP World Tour,CLAY,2,Andre Ghem,Gustavo Kuerten,Andre Ghem,3-6; 6-3; 6-4,R32,108,5,2,54,91,39,54,22,37,5,6,14,61,91,8,3,42,79,32,42,20,37,1,3,14,52,79
2006-02-20 00:00:00.000,Costa Do Sauipe Brasil ATP World Tour,CLAY,2,Alberto Martin,Luis Horna,Alberto Martin,6-4; 7-5,R32,94,7,3,43,70,27,43,17,27,2,4,11,44,70,2,2,40,60,24,40,10,20,2,6,11,34,60
2006-02-20 00:00:00.000,Costa Do Sauipe Brasil ATP World Tour,CLAY,2,Juan Ignacio Chela,Daniel Gimeno-Traver,Juan Ignacio Chela,7-6(3); 6-3,R32,123,1,1,43,73,33,43,16,30,5,7,11,49,73,4,2,51,85,30,51,17,34,8,11,10,47,85
2006-02-20 00:00:00.000,Costa Do Sauipe Brasil ATP World Tour,CLAY,2,Potito Starace,Ivan Navarro,Potito Starace,6-3; 3-6; 6-3,R32,120,1,1,61,81,39,61,14,20,5,9,14,53,81,8,5,47,87,36,47,13,40,9,14,13,49,87
2006-02-20 00:00:00.000,Costa Do Sauipe Brasil ATP World Tour,CLAY,2,Juan Monaco,Juan Martin Del Potro,Juan Monaco,7-5; 7-5,R32,116,1,3,39,69,27,39,19,30,2,4,12,46,69,0,2,42,69,26,42,14,27,1,5,12,40,69
2006-02-20 00:00:00.000,Costa Do Sauipe Brasil ATP World Tour,CLAY,2,Florent Serra,Lukas Dlouhy,Florent Serra,6-3; 2-6; 6-4,R32,103,2,2,60,95,39,60,18,35,7,10,14,57,95,10,4,48,75,35,48,11,27,4,7,13,46,75
2006-02-20 00:00:00.000,Costa Do Sauipe Brasil ATP World Tour,CLAY,2,Nicolas Massu,Marcos Daniel,Nicolas Massu,7-6(3); 6-1,R32,102,2,2,37,75,26,37,23,38,7,8,10,49,75,1,1,39,52,26,39,3,13,2,5,9,29,52
2006-02-20 00:00:00.000,Costa Do Sauipe Brasil ATP World Tour,CLAY,2,Fernando Vicente,Carlos Berlocq,Fernando Vicente,6-4; 2-0 RET,R32,65,2,1,20,35,15,20,8,15,0,1,6,23,35,2,4,25,43,14,25,6,18,3,6,6,20,43
2006-02-20 00:00:00.000,Costa Do Sauipe Brasil ATP World Tour,CLAY,2,Nicolas Almagro,Andre Sa,Nicolas Almagro,6-1; 7-6(3),R32,92,9,2,39,50,33,39,7,11,1,2,9,40,50,1,5,46,81,26,46,17,35,6,10,10,43,81
2006-02-20 00:00:00.000,Costa Do Sauipe Brasil ATP World Tour,CLAY,2,Flavio Saretta,Juan Carlos Ferrero,Flavio Saretta,6-4; 6-3,R32,96,7,3,37,57,28,37,8,20,7,9,9,36,57,1,3,33,64,18,33,15,31,4,9,10,33,64
2006-02-20 00:00:00.000,Costa Do Sauipe Brasil ATP World Tour,CLAY,2,Olivier Patience,Gaston Gaudio,Olivier Patience,6-2; 6-2,R16,51,5,0,29,39,24,29,8,10,0,0,8,32,39,4,4,24,42,17,24,5,18,4,8,8,22,42
2006-02-20 00:00:00.000,Costa Do Sauipe Brasil ATP World Tour,CLAY,2,Boris Pashanski,Ricardo Mello,Boris Pashanski,6-2; 6-3,R16,78,3,0,33,49,28,33,10,16,2,2,9,38,49,5,2,36,62,22,36,12,26,8,11,8,34,62
2006-02-20 00:00:00.000,Costa Do Sauipe Brasil ATP World Tour,CLAY,2,Jiri Vanek,Filippo Volandri,Jiri Vanek,6-0; 6-1,R16,54,6,1,25,40,20,25,7,15,3,3,6,27,40,0,1,38,51,14,38,6,13,2,8,7,20,51
2006-02-20 00:00:00.000,Costa Do Sauipe Brasil ATP World Tour,CLAY,2,Alberto Martin,Andre Ghem,Alberto Martin,6-2; 3-6; 6-3,R16,109,4,0,43,66,29,43,18,23,5,7,13,47,66,6,5,50,100,36,50,20,50,6,10,13,56,100
2006-02-20 00:00:00.000,Costa Do Sauipe Brasil ATP World Tour,CLAY,2,Juan Ignacio Chela,Potito Starace,Juan Ignacio Chela,6-4; 7-5,R16,108,0,1,45,69,32,45,13,24,5,7,11,45,69,2,2,55,76,35,55,7,21,5,9,11,42,76
2006-02-20 00:00:00.000,Costa Do Sauipe Brasil ATP World Tour,CLAY,2,Juan Monaco,Florent Serra,Juan Monaco,6-1; 6-1,R16,73,6,0,33,48,24,33,8,15,1,1,7,32,48,0,4,22,46,12,22,7,24,3,8,7,19,46
2006-02-20 00:00:00.000,Costa Do Sauipe Brasil ATP World Tour,CLAY,2,Nicolas Massu,Fernando Vicente,Nicolas Massu,3-6; 7-6(6); 6-3,R16,168,2,2,63,105,43,63,17,42,6,10,14,60,105,2,1,65,97,40,65,16,32,2,7,16,56,97
2006-02-20 00:00:00.000,Costa Do Sauipe Brasil ATP World Tour,CLAY,2,Nicolas Almagro,Flavio Saretta,Nicolas Almagro,7-5; 7-5,R16,115,7,1,34,65,28,34,19,31,1,2,12,47,65,2,3,44,75,30,44,16,31,2,5,12,46,75
2006-02-20 00:00:00.000,Costa Do Sauipe Brasil ATP World Tour,CLAY,2,Olivier Patience,Boris Pashanski,Olivier Patience,4-6; 6-3; 6-2,Q,127,5,2,44,84,30,44,24,40,1,3,14,54,84,6,4,46,93,26,46,27,47,10,14,13,53,93
2006-02-20 00:00:00.000,Costa Do Sauipe Brasil ATP World Tour,CLAY,2,Alberto Martin,Jiri Vanek,Alberto Martin,7-6(5); 6-3,Q,104,2,2,44,75,29,44,15,31,3,7,11,44,75,4,1,37,67,22,37,12,30,3,8,10,34,67
2006-02-20 00:00:00.000,Costa Do Sauipe Brasil ATP World Tour,CLAY,2,Juan Monaco,Juan Ignacio Chela,Juan Monaco,6-3; 6-2,Q,96,1,1,31,57,22,31,16,26,1,2,9,38,57,0,3,30,54,17,30,9,24,5,9,8,26,54
2006-02-20 00:00:00.000,Costa Do Sauipe Brasil ATP World Tour,CLAY,2,Nicolas Massu,Nicolas Almagro,Nicolas Massu,7-6(4); 6-3,Q,105,8,3,50,72,35,50,12,22,3,5,11,47,72,5,4,40,68,25,40,14,28,1,4,10,39,68
2006-02-20 00:00:00.000,Costa Do Sauipe Brasil ATP World Tour,CLAY,2,Alberto Martin,Olivier Patience,Alberto Martin,6-2; 5-7; 7-6(3),S,166,4,6,59,110,43,59,28,51,7,9,16,71,110,9,4,67,126,45,67,28,59,8,11,16,73,126
2006-02-20 00:00:00.000,Costa Do Sauipe Brasil ATP World Tour,CLAY,2,Nicolas Massu,Juan Monaco,Nicolas Massu,2-6; 6-2; 7-5,S,164,5,3,63,108,39,63,25,45,8,10,14,64,108,0,4,49,82,32,49,20,33,3,6,14,52,82
2006-02-20 00:00:00.000,Costa Do Sauipe Brasil ATP World Tour,CLAY,2,Nicolas Massu,Alberto Martin,Nicolas Massu,6-3; 6-4,F,85,1,3,29,52,19,29,14,23,3,6,10,33,52,0,4,24,46,13,24,9,22,2,7,9,22,46
2006-02-20 00:00:00.000,Memphis TN; U.S.A. ATP World Tour,HARD,2,Andy Roddick,Mardy Fish,Andy Roddick,6-3; 6-7(5); 7-6(2),R32,135,12,1,76,110,58,76,21,34,6,6,17,79,110,18,2,52,108,43,52,31,56,6,7,16,74,108
2006-02-20 00:00:00.000,Memphis TN; U.S.A. ATP World Tour,HARD,2,Wayne Arthurs,Tomas Zib,Wayne Arthurs,6-4; 7-6(2),R32,80,29,3,45,66,41,45,9,21,1,1,11,50,66,9,4,39,83,29,39,22,44,4,5,11,51,83
2006-02-20 00:00:00.000,Memphis TN; U.S.A. ATP World Tour,HARD,2,Julien Benneteau,Jimmy Wang,Julien Benneteau,3-6; 6-3; 7-6(2),R32,124,9,5,58,100,45,58,18,42,4,7,15,63,100,2,1,66,101,45,66,19,35,5,8,15,64,101
2006-02-20 00:00:00.000,Memphis TN; U.S.A. ATP World Tour,HARD,2,Xavier Malisse,Bjorn Phau,Xavier Malisse,6-1; 6-4,R32,64,3,0,36,67,28,36,18,31,7,7,9,46,67,5,1,33,56,21,33,12,23,2,5,8,33,56
2006-02-20 00:00:00.000,Memphis TN; U.S.A. ATP World Tour,HARD,2,Dmitry Tursunov,Robby Ginepri,Dmitry Tursunov,7-5; 7-6(4),R32,67,12,0,42,77,32,42,22,35,2,3,12,54,77,10,0,46,74,34,46,17,28,3,5,12,51,74
2006-02-20 00:00:00.000,Memphis TN; U.S.A. ATP World Tour,HARD,2,Cyril Saulnier,Guillermo Garcia-Lopez,Cyril Saulnier,6-3; 6-4,R32,70,9,1,39,64,31,39,13,25,1,1,10,44,64,9,3,28,51,21,28,13,23,1,3,9,34,51
2006-02-20 00:00:00.000,Memphis TN; U.S.A. ATP World Tour,HARD,2,Vincent Spadea,Bobby Reynolds,Vincent Spadea,6-2; 5-7; 7-6(2),R32,125,7,3,53,90,41,53,16,37,4,9,16,57,90,8,9,77,129,47,77,22,52,13,19,16,69,129
2006-02-20 00:00:00.000,Memphis TN; U.S.A. ATP World Tour,HARD,2,Tommy Haas,Justin Gimelstob,Tommy Haas,2-1 RET,R32,3,0,0,6,11,5,6,3,5,0,0,2,8,11,3,0,10,12,6,10,1,2,0,0,1,7,12
2006-02-20 00:00:00.000,Memphis TN; U.S.A. ATP World Tour,HARD,2,Kristof Vliegen,James Blake,Kristof Vliegen,6-4; 6-4,R32,86,5,3,50,73,39,50,9,23,8,8,10,48,73,6,2,46,77,29,46,18,31,6,8,10,47,77
2006-02-20 00:00:00.000,Memphis TN; U.S.A. ATP World Tour,HARD,2,Paul Goldstein,Scoville Jenkins,Paul Goldstein,6-4; 6-3,R32,81,3,0,24,51,17,24,18,27,3,4,9,35,51,5,1,41,56,26,41,7,15,2,6,10,33,56
2006-02-20 00:00:00.000,Memphis TN; U.S.A. ATP World Tour,HARD,2,Ivo Karlovic,Kristian Pless,Ivo Karlovic,6-7(3); 7-6(4); 6-4,R32,117,32,4,73,106,65,73,15,33,3,3,17,80,106,1,4,70,101,55,70,21,31,5,6,17,76,101
2006-02-20 00:00:00.000,Memphis TN; U.S.A. ATP World Tour,HARD,2,Paul Capdeville,Tommy Robredo,Paul Capdeville,4-6; 7-6(3); 6-4,R32,115,4,2,70,106,49,70,20,36,5,8,16,69,106,17,3,59,87,46,59,13,28,3,6,16,59,87
2006-02-20 00:00:00.000,Memphis TN; U.S.A. ATP World Tour,HARD,2,Robin Soderling,Max Mirnyi,Robin Soderling,6-0; 6-1,R32,42,7,1,25,37,23,25,7,12,3,3,7,30,37,2,2,23,38,12,23,3,15,4,9,6,15,38
2006-02-20 00:00:00.000,Memphis TN; U.S.A. ATP World Tour,HARD,2,Kenneth Carlsen,Peter Luczak,Kenneth Carlsen,7-6(4); 6-3,R32,73,11,0,39,60,35,39,13,21,0,0,11,48,60,4,2,54,61,35,54,5,7,1,2,10,40,61
2006-02-20 00:00:00.000,Memphis TN; U.S.A. ATP World Tour,HARD,2,Andy Murray,Rainer Schuettler,Andy Murray,1-6; 7-5; 6-2,R32,111,6,2,34,66,27,34,19,32,0,3,13,46,66,3,3,47,90,32,47,20,43,5,9,14,52,90
2006-02-20 00:00:00.000,Memphis TN; U.S.A. ATP World Tour,HARD,2,Rik De Voest,Jonas Bjorkman,Rik De Voest,6-4; 6-3,R32,66,6,0,40,54,30,40,7,14,3,4,9,37,54,1,3,26,50,18,26,10,24,0,4,10,28,50
2006-02-20 00:00:00.000,Memphis TN; U.S.A. ATP World Tour,HARD,2,Andy Roddick,Wayne Arthurs,Andy Roddick,6-7(4); 7-6(9); 7-6(2),R16,133,20,2,94,126,75,94,18,32,2,3,18,93,126,33,5,75,112,63,75,23,37,1,2,18,86,112
2006-02-20 00:00:00.000,Memphis TN; U.S.A. ATP World Tour,HARD,2,Julien Benneteau,Xavier Malisse,Julien Benneteau,7-6(4); 6-4,R16,91,7,2,55,75,40,55,9,20,7,9,11,49,75,6,1,45,74,33,45,13,29,7,10,11,46,74
2006-02-20 00:00:00.000,Memphis TN; U.S.A. ATP World Tour,HARD,2,Dmitry Tursunov,Cyril Saulnier,Dmitry Tursunov,6-0; 6-7(3); 6-3,R16,102,10,1,39,77,33,39,25,38,0,0,14,58,77,7,5,43,82,35,43,16,39,7,11,13,51,82
2006-02-20 00:00:00.000,Memphis TN; U.S.A. ATP World Tour,HARD,2,Tommy Haas,Vincent Spadea,Tommy Haas,7-6(7); 6-1,R16,75,10,2,44,67,37,44,12,23,4,4,10,49,67,7,4,47,72,32,47,12,25,7,9,9,44,72
2006-02-20 00:00:00.000,Memphis TN; U.S.A. ATP World Tour,HARD,2,Kristof Vliegen,Paul Goldstein,Kristof Vliegen,6-1; 6-4,R16,76,10,2,43,62,32,43,9,19,3,3,9,41,62,3,2,29,58,20,29,13,29,8,11,8,33,58
2006-02-20 00:00:00.000,Memphis TN; U.S.A. ATP World Tour,HARD,2,Paul Capdeville,Ivo Karlovic,Paul Capdeville,7-6(1); 3-6; 7-5,R16,63,6,6,51,104,38,51,31,53,1,4,17,69,104,23,0,54,77,47,54,11,23,0,2,16,58,77
2006-02-20 00:00:00.000,Memphis TN; U.S.A. ATP World Tour,HARD,2,Robin Soderling,Kenneth Carlsen,Robin Soderling,7-6(3); 6-4,R16,85,13,1,44,60,37,44,11,16,0,1,11,48,60,17,1,64,91,46,64,10,27,9,11,11,56,91
2006-02-20 00:00:00.000,Memphis TN; U.S.A. ATP World Tour,HARD,2,Andy Murray,Rik De Voest,Andy Murray,7-6(4); 3-6; 7-5,R16,148,11,4,71,102,46,71,17,31,2,6,16,63,102,9,3,68,130,48,68,31,62,9,13,17,79,130
2006-02-20 00:00:00.000,Memphis TN; U.S.A. ATP World Tour,HARD,2,Julien Benneteau,Andy Roddick,Julien Benneteau,3-6; 6-4; 7-6(4),Q,133,18,4,77,99,56,77,13,22,7,9,15,69,99,14,3,74,104,52,74,15,30,7,9,16,67,104
2006-02-20 00:00:00.000,Memphis TN; U.S.A. ATP World Tour,HARD,2,Tommy Haas,Dmitry Tursunov,Tommy Haas,6-7(7); 6-4; 6-4,Q,117,13,3,57,102,45,57,28,45,6,7,16,73,102,14,4,56,96,44,56,22,40,4,7,16,66,96
2006-02-20 00:00:00.000,Memphis TN; U.S.A. ATP World Tour,HARD,2,Kristof Vliegen,Paul Capdeville,Kristof Vliegen,3-6; 7-6(5); 6-4,Q,132,8,2,60,102,44,60,26,42,5,6,15,70,102,3,1,65,101,45,65,23,36,2,3,16,68,101
2006-02-20 00:00:00.000,Memphis TN; U.S.A. ATP World Tour,HARD,2,Robin Soderling,Andy Murray,Robin Soderling,6-1; 6-4,Q,68,8,4,32,54,25,32,11,22,2,3,9,36,54,3,1,26,60,16,26,13,34,7,11,8,29,60
2006-02-20 00:00:00.000,Memphis TN; U.S.A. ATP World Tour,HARD,2,Tommy Haas,Julien Benneteau,Tommy Haas,6-3; 6-1,S,55,7,1,29,38,27,29,5,9,0,0,8,32,38,6,1,31,51,18,31,7,20,6,10,8,25,51
2006-02-20 00:00:00.000,Memphis TN; U.S.A. ATP World Tour,HARD,2,Robin Soderling,Kristof Vliegen,Robin Soderling,7-5; 2-6; 7-6(5),S,140,5,9,67,121,50,67,27,54,10,12,16,77,121,10,4,83,118,60,83,16,35,7,8,16,76,118
2006-02-20 00:00:00.000,Memphis TN; U.S.A. ATP World Tour,HARD,2,Tommy Haas,Robin Soderling,Tommy Haas,6-3; 6-2,F,61,8,3,36,58,27,36,13,22,4,4,9,40,58,5,1,29,41,19,29,6,12,2,5,8,25,41
2006-02-20 00:00:00.000,Rotterdam The Netherlands ATP World Tour,HARD,2,Arvind Parmar,Paradorn Srichaphan,Arvind Parmar,7-6(3); 5-7; 7-6(7),R32,145,14,3,61,122,54,61,34,61,5,6,18,88,122,11,5,66,110,52,66,31,44,3,3,18,83,110
2006-02-20 00:00:00.000,Rotterdam The Netherlands ATP World Tour,HARD,2,Dominik Meffert,Raemon Sluiter,Dominik Meffert,2-4 RET,R32,34,4,2,16,28,12,16,3,12,4,5,3,15,28,1,0,11,15,9,11,3,4,0,0,3,12,15
2006-02-20 00:00:00.000,Rotterdam The Netherlands ATP World Tour,HARD,2,Christophe Rochus,Jean-Rene Lisnard,Christophe Rochus,3-6; 7-6(3); 6-4,R32,128,4,1,56,93,37,56,22,37,3,7,15,59,93,5,8,56,113,42,56,27,57,14,18,16,69,113
2006-02-20 00:00:00.000,Rotterdam The Netherlands ATP World Tour,HARD,2,Taylor Dent,Tomas Berdych,Taylor Dent,6-4; 7-5,R32,77,8,2,41,60,36,41,9,19,1,1,11,45,60,6,1,38,60,29,38,13,22,2,4,11,42,60
2006-02-20 00:00:00.000,Rotterdam The Netherlands ATP World Tour,HARD,2,David Ferrer,Ivo Minar,David Ferrer,6-2; 6-3,R32,76,1,2,52,86,33,52,20,34,9,9,9,53,86,1,3,26,49,20,26,8,23,4,7,8,28,49
2006-02-20 00:00:00.000,Rotterdam The Netherlands ATP World Tour,HARD,2,Olivier Rochus,Jurgen Melzer,Olivier Rochus,7-6(3); 4-6; 7-6(9),R32,157,0,1,84,126,51,84,24,42,11,16,17,75,126,11,5,76,134,52,76,29,58,8,12,17,81,134
2006-02-20 00:00:00.000,Rotterdam The Netherlands ATP World Tour,HARD,2,Gilles Simon,Wesley Moodie,Gilles Simon,6-3; 6-7(4); 6-3,R32,115,5,1,60,104,44,60,24,44,3,4,16,68,104,9,3,51,78,37,51,18,27,2,5,14,55,78
2006-02-20 00:00:00.000,Rotterdam The Netherlands ATP World Tour,HARD,2,Jarkko Nieminen,Mario Ancic,Jarkko Nieminen,7-5; 7-6(5),R32,86,4,1,48,73,37,48,17,25,0,0,12,54,73,12,3,54,71,42,54,8,17,1,2,12,50,71
2006-02-20 00:00:00.000,Rotterdam The Netherlands ATP World Tour,HARD,2,Radek Stepanek,Michael Lammer,Radek Stepanek,6-4; 6-2,R32,69,11,1,46,56,30,46,5,10,3,5,9,35,56,3,2,43,59,21,43,8,16,4,9,9,29,59
2006-02-20 00:00:00.000,Rotterdam The Netherlands ATP World Tour,HARD,2,Fabrice Santoro,Paul-Henri Mathieu,Fabrice Santoro,6-3; 6-3,R32,79,9,3,35,58,26,35,10,23,4,6,9,36,58,1,1,25,54,13,25,13,29,1,6,9,26,54
2006-02-20 00:00:00.000,Rotterdam The Netherlands ATP World Tour,HARD,2,Novak Djokovic,Andreas Seppi,Novak Djokovic,6-2; 2-6; 7-5,R32,111,5,2,45,83,30,45,18,38,1,6,14,48,83,7,5,39,85,29,39,19,46,4,10,14,48,85
2006-02-20 00:00:00.000,Rotterdam The Netherlands ATP World Tour,HARD,2,Tim Henman,Thomas Johansson,Tim Henman,6-4; 6-4,R32,87,3,1,47,61,34,47,8,14,0,1,10,42,61,6,2,31,66,22,31,18,35,4,7,10,40,66
2006-02-20 00:00:00.000,Rotterdam The Netherlands ATP World Tour,HARD,2,Daniele Bracciali,Igor Andreev,Daniele Bracciali,6-2; 6-3,R32,61,6,2,24,49,21,24,16,25,2,2,9,37,49,3,0,20,42,12,20,12,22,1,4,8,24,42
2006-02-20 00:00:00.000,Rotterdam The Netherlands ATP World Tour,HARD,2,Alex Calatrava,Antal Van Der Duim,Alex Calatrava,6-2; 7-6(2),R32,84,8,1,48,64,38,48,7,16,2,3,10,45,64,5,6,47,72,29,47,11,25,6,9,10,40,72
2006-02-20 00:00:00.000,Rotterdam The Netherlands ATP World Tour,HARD,2,Greg Rusedski,Robin Vik,Greg Rusedski,6-3; 7-5,R32,74,9,2,39,60,31,39,12,21,2,3,11,43,60,4,2,26,54,18,26,14,28,2,5,10,32,54
2006-02-20 00:00:00.000,Rotterdam The Netherlands ATP World Tour,HARD,2,Nikolay Davydenko,Jan Hernych,Nikolay Davydenko,6-3; 6-3,R32,87,4,2,47,69,31,47,14,22,9,10,9,45,69,1,0,46,60,27,46,5,14,5,9,9,32,60
2006-02-20 00:00:00.000,Rotterdam The Netherlands ATP World Tour,HARD,2,Arvind Parmar,Dominik Meffert,Arvind Parmar,6-3; 6-3,R16,66,2,2,24,48,21,24,17,24,1,1,9,38,48,1,4,33,51,25,33,5,18,3,6,9,30,51
2006-02-20 00:00:00.000,Rotterdam The Netherlands ATP World Tour,HARD,2,Christophe Rochus,Taylor Dent,Christophe Rochus,7-6(0) RET,R16,47,0,1,30,47,19,30,9,17,3,5,6,28,47,5,2,31,41,18,31,3,10,3,5,6,21,41
2006-02-20 00:00:00.000,Rotterdam The Netherlands ATP World Tour,HARD,2,Olivier Rochus,David Ferrer,Olivier Rochus,6-4; 6-4,R16,100,0,1,27,55,17,27,17,28,2,5,10,34,55,8,4,56,78,32,56,8,22,2,7,10,40,78
2006-02-20 00:00:00.000,Rotterdam The Netherlands ATP World Tour,HARD,2,Jarkko Nieminen,Gilles Simon,Jarkko Nieminen,7-6(1); 6-1,R16,70,2,2,50,63,36,50,8,13,2,3,10,44,63,1,0,31,56,20,31,13,25,1,4,9,33,56
2006-02-20 00:00:00.000,Rotterdam The Netherlands ATP World Tour,HARD,2,Radek Stepanek,Fabrice Santoro,Radek Stepanek,6-4; 6-1,R16,56,12,1,33,46,27,33,8,13,3,3,8,35,46,1,1,37,53,21,37,7,16,0,4,9,28,53
2006-02-20 00:00:00.000,Rotterdam The Netherlands ATP World Tour,HARD,2,Novak Djokovic,Tim Henman,Novak Djokovic,5-7; 6-3; 6-4,R16,160,5,4,76,123,55,76,24,47,8,9,16,79,123,2,2,70,101,48,70,17,31,11,13,15,65,101
2006-02-20 00:00:00.000,Rotterdam The Netherlands ATP World Tour,HARD,2,Daniele Bracciali,Alex Calatrava,Daniele Bracciali,4-6; 6-2; 7-6(5),R16,138,19,5,46,99,41,46,28,53,3,4,15,69,99,8,1,56,97,38,56,27,41,3,5,15,65,97
2006-02-20 00:00:00.000,Rotterdam The Netherlands ATP World Tour,HARD,2,Nikolay Davydenko,Greg Rusedski,Nikolay Davydenko,6-4; 6-1,R16,54,4,1,31,37,26,31,4,6,0,1,8,30,37,4,4,30,52,17,30,8,22,0,5,9,25,52
2006-02-20 00:00:00.000,Rotterdam The Netherlands ATP World Tour,HARD,2,Christophe Rochus,Arvind Parmar,Christophe Rochus,6-3; 6-3,Q,69,4,1,35,49,28,35,7,14,1,2,9,35,49,1,4,37,57,22,37,7,20,4,8,9,29,57
2006-02-20 00:00:00.000,Rotterdam The Netherlands ATP World Tour,HARD,2,Jarkko Nieminen,Olivier Rochus,Jarkko Nieminen,6-7(4); 6-4; 7-6(3),Q,126,7,5,77,132,55,77,24,55,15,20,17,79,132,3,4,89,122,52,89,17,33,9,15,17,69,122
2006-02-20 00:00:00.000,Rotterdam The Netherlands ATP World Tour,HARD,2,Radek Stepanek,Novak Djokovic,Radek Stepanek,7-5; 4-6; 7-6(2),Q,140,20,6,64,95,51,64,17,31,3,5,17,68,95,3,3,74,107,51,74,20,33,2,4,17,71,107
2006-02-20 00:00:00.000,Rotterdam The Netherlands ATP World Tour,HARD,2,Nikolay Davydenko,Daniele Bracciali,Nikolay Davydenko,6-4; 6-2,Q,73,4,1,32,51,26,32,10,19,2,3,9,36,51,8,4,29,59,21,29,10,30,3,7,9,31,59
2006-02-20 00:00:00.000,Rotterdam The Netherlands ATP World Tour,HARD,2,Christophe Rochus,Jarkko Nieminen,Christophe Rochus,6-4; 6-3,S,67,4,0,40,51,31,40,8,11,0,1,10,39,51,7,1,49,70,31,49,8,21,7,10,9,39,70
2006-02-20 00:00:00.000,Rotterdam The Netherlands ATP World Tour,HARD,2,Radek Stepanek,Nikolay Davydenko,Radek Stepanek,4-6; 6-3; 6-3,S,114,16,4,62,92,46,62,13,30,4,6,14,59,92,3,2,49,83,35,49,15,34,2,6,14,50,83
2006-02-20 00:00:00.000,Rotterdam The Netherlands ATP World Tour,HARD,2,Radek Stepanek,Christophe Rochus,Radek Stepanek,6-0; 6-3,F,46,17,0,26,39,25,26,8,13,0,0,8,33,39,0,3,21,39,13,21,6,18,2,6,7,19,39
2006-02-27 00:00:00.000,Acapulco Mexico ATP World Tour,CLAY,2,Alessio Di Mauro,Guillermo Coria,Alessio Di Mauro,6-2; 6-4,R32,83,3,1,31,59,25,31,11,28,5,7,9,36,59,1,16,24,62,19,24,11,38,1,6,9,30,62
2006-02-27 00:00:00.000,Acapulco Mexico ATP World Tour,CLAY,2,Boris Pashanski,Ivo Minar,Boris Pashanski,2-6; 6-3; 7-5,R32,108,11,4,49,74,36,49,16,25,3,5,14,52,74,10,7,45,90,36,45,24,45,3,6,15,60,90
2006-02-27 00:00:00.000,Acapulco Mexico ATP World Tour,CLAY,2,Tomas Behrend,Jiri Vanek,Tomas Behrend,7-6(4); 5-7; 6-3,R32,138,4,4,50,99,37,50,28,49,2,6,17,65,99,5,7,63,99,48,63,15,36,6,10,16,63,99
2006-02-27 00:00:00.000,Acapulco Mexico ATP World Tour,CLAY,2,Juan Ignacio Chela,Juan Monaco,Juan Ignacio Chela,4-6; 7-6(4); 3-0 RET,R32,124,5,5,52,78,40,52,13,26,1,3,13,53,78,3,1,47,77,33,47,17,30,1,3,12,50,77
2006-02-27 00:00:00.000,Acapulco Mexico ATP World Tour,CLAY,2,Carlos Moya,Miguel Gallardo-Valles,Carlos Moya,3-6; 6-4; 7-5,R32,105,12,5,73,108,54,73,15,35,5,8,16,69,108,4,1,56,84,38,56,16,28,3,6,15,54,84
2006-02-27 00:00:00.000,Acapulco Mexico ATP World Tour,CLAY,2,Albert Montanes,Juan Martin Del Potro,Albert Montanes,6-2; 5-3 RET,R32,67,1,1,25,40,21,25,12,15,1,1,8,33,40,0,2,46,57,24,46,5,11,5,8,8,29,57
2006-02-27 00:00:00.000,Acapulco Mexico ATP World Tour,CLAY,2,Nicolas Almagro,Fernando Vicente,Nicolas Almagro,6-3; 4-6; 6-4,R32,123,6,2,63,88,40,63,16,25,3,7,15,56,88,1,2,59,93,34,59,18,34,8,13,14,52,93
2006-02-27 00:00:00.000,Acapulco Mexico ATP World Tour,CLAY,2,Jose Acasuso,Santiago Gonzalez,Jose Acasuso,6-2; 6-1,R32,62,0,1,19,39,14,19,15,20,0,0,7,29,39,1,6,31,55,23,31,3,24,5,10,8,26,55
2006-02-27 00:00:00.000,Acapulco Mexico ATP World Tour,CLAY,2,Juan Antonio Marin,Florent Serra,Juan Antonio Marin,6-4; 6-7(4); 6-4,R32,166,5,1,65,108,48,65,19,43,5,8,16,67,108,10,3,77,122,51,77,21,45,12,17,16,72,122
2006-02-27 00:00:00.000,Acapulco Mexico ATP World Tour,CLAY,2,Luis Horna,Lukas Dlouhy,Luis Horna,6-4; 6-4,R32,81,4,1,40,57,32,40,7,17,1,2,10,39,57,6,4,43,67,29,43,11,24,5,8,10,40,67
2006-02-27 00:00:00.000,Acapulco Mexico ATP World Tour,CLAY,2,Agustin Calleri,Nicolas Lapentti,Agustin Calleri,6-3; 6-3,R32,86,6,2,23,50,20,23,16,27,4,5,9,36,50,4,1,37,64,24,37,10,27,10,14,9,34,64
2006-02-27 00:00:00.000,Acapulco Mexico ATP World Tour,CLAY,2,Alberto Martin,Filippo Volandri,Alberto Martin,6-0; 2-6; 6-2,R32,94,4,4,41,80,27,41,20,39,6,9,11,47,80,0,1,55,70,28,55,5,15,5,11,11,33,70
2006-02-27 00:00:00.000,Acapulco Mexico ATP World Tour,CLAY,2,Nicolas Massu,Carlos Berlocq,Nicolas Massu,6-2; 7-5,R32,123,3,2,38,64,26,38,14,26,2,4,10,40,64,5,3,44,76,25,44,13,32,9,14,10,38,76
2006-02-27 00:00:00.000,Acapulco Mexico ATP World Tour,CLAY,2,Marcos Daniel,Kevin Kim,Marcos Daniel,7-5; 6-3,R32,80,4,1,40,54,25,40,9,14,1,3,10,34,54,2,7,36,70,25,36,12,34,4,9,11,37,70
2006-02-27 00:00:00.000,Acapulco Mexico ATP World Tour,CLAY,2,Razvan Sabau,Potito Starace,Razvan Sabau,0-6; 7-5; 6-3,R32,113,2,6,59,98,35,59,18,39,9,14,14,53,98,10,1,50,72,35,50,10,22,1,5,13,45,72
2006-02-27 00:00:00.000,Acapulco Mexico ATP World Tour,CLAY,2,Gaston Gaudio,Albert Portas,Gaston Gaudio,7-5; 6-2,R32,89,2,1,40,60,31,40,11,20,1,1,10,42,60,5,2,29,62,21,29,18,33,6,9,10,39,62
2006-02-27 00:00:00.000,Acapulco Mexico ATP World Tour,CLAY,2,Alessio Di Mauro,Boris Pashanski,Alessio Di Mauro,1-6; 6-3; 6-4,R16,119,14,0,45,75,32,45,12,30,2,6,13,44,75,2,1,50,84,29,50,19,34,3,7,13,48,84
2006-02-27 00:00:00.000,Acapulco Mexico ATP World Tour,CLAY,2,Juan Ignacio Chela,Tomas Behrend,Juan Ignacio Chela,6-1; 2-6; 6-2,R16,112,7,2,52,89,39,52,16,37,11,13,12,55,89,6,3,41,72,28,41,11,31,6,10,11,39,72
2006-02-27 00:00:00.000,Acapulco Mexico ATP World Tour,CLAY,2,Albert Montanes,Carlos Moya,Albert Montanes,2-6; 7-6(5); 6-4,R16,139,7,2,75,113,51,75,15,38,10,13,15,66,113,5,2,55,91,43,55,18,36,4,6,15,61,91
2006-02-27 00:00:00.000,Acapulco Mexico ATP World Tour,CLAY,2,Nicolas Almagro,Jose Acasuso,Nicolas Almagro,6-3 RET,R16,36,2,0,13,23,11,13,9,10,0,0,5,20,23,1,1,16,28,11,16,6,12,1,2,4,17,28
2006-02-27 00:00:00.000,Acapulco Mexico ATP World Tour,CLAY,2,Luis Horna,Juan Antonio Marin,Luis Horna,6-3; 7-6(4),R16,131,13,1,55,82,39,55,15,27,6,8,11,54,82,1,0,48,71,32,48,8,23,1,4,10,40,71
2006-02-27 00:00:00.000,Acapulco Mexico ATP World Tour,CLAY,2,Agustin Calleri,Alberto Martin,Agustin Calleri,6-3; 6-2,R16,70,7,3,38,60,32,38,10,22,3,3,9,42,60,2,3,24,50,18,24,9,26,4,7,8,27,50
2006-02-27 00:00:00.000,Acapulco Mexico ATP World Tour,CLAY,2,Marcos Daniel,Nicolas Massu,Marcos Daniel,6-4; 6-4,R16,98,5,0,44,56,32,44,3,12,0,2,10,35,56,2,3,32,64,19,32,14,32,0,4,10,33,64
2006-02-27 00:00:00.000,Acapulco Mexico ATP World Tour,CLAY,2,Gaston Gaudio,Razvan Sabau,Gaston Gaudio,6-3; 3-6; 6-2,R16,119,7,3,59,84,44,59,12,25,2,3,13,56,84,0,3,59,89,39,59,13,30,6,9,13,52,89
2006-02-27 00:00:00.000,Acapulco Mexico ATP World Tour,CLAY,2,Juan Ignacio Chela,Alessio Di Mauro,Juan Ignacio Chela,7-5; 6-2,Q,100,2,3,35,58,25,35,12,23,1,3,10,37,58,4,4,48,66,26,48,6,18,2,7,10,32,66
2006-02-27 00:00:00.000,Acapulco Mexico ATP World Tour,CLAY,2,Nicolas Almagro,Albert Montanes,Nicolas Almagro,6-4; 6-0,Q,64,7,0,27,46,19,27,13,19,2,3,8,32,46,1,4,40,53,20,40,5,13,3,8,8,25,53
2006-02-27 00:00:00.000,Acapulco Mexico ATP World Tour,CLAY,2,Luis Horna,Agustin Calleri,Luis Horna,6-3; 6-4,Q,82,3,1,37,53,29,37,11,16,0,0,10,40,53,8,0,46,74,34,46,10,28,9,11,9,44,74
2006-02-27 00:00:00.000,Acapulco Mexico ATP World Tour,CLAY,2,Gaston Gaudio,Marcos Daniel,Gaston Gaudio,6-4; 2-6; 6-3,Q,134,3,8,58,94,41,58,15,36,8,12,14,56,94,5,1,62,84,40,62,9,22,6,10,13,49,84
2006-02-27 00:00:00.000,Acapulco Mexico ATP World Tour,CLAY,2,Juan Ignacio Chela,Nicolas Almagro,Juan Ignacio Chela,6-2; 6-2,S,81,1,2,42,70,28,42,16,28,5,5,8,44,70,4,0,27,48,15,27,8,21,4,8,8,23,48
2006-02-27 00:00:00.000,Acapulco Mexico ATP World Tour,CLAY,2,Luis Horna,Gaston Gaudio,Luis Horna,4-6; 6-4; 6-3,S,156,9,1,68,101,51,68,14,33,8,10,14,65,101,2,7,68,96,47,68,12,28,5,9,15,59,96
2006-02-27 00:00:00.000,Acapulco Mexico ATP World Tour,CLAY,2,Luis Horna,Juan Ignacio Chela,Luis Horna,7-6(5); 6-4,F,122,7,1,51,82,33,51,19,31,4,6,11,52,82,6,2,49,70,36,49,9,21,4,7,11,45,70
2006-02-27 00:00:00.000,Dubai U.A.E. ATP World Tour,HARD,2,Roger Federer,Stanislas Wawrinka,Roger Federer,7-6(3); 6-3,R32,81,3,0,46,71,33,46,13,25,4,7,11,46,71,2,2,27,62,16,27,20,35,3,7,10,36,62
2006-02-27 00:00:00.000,Dubai U.A.E. ATP World Tour,HARD,2,Mohammad Ghareeb,Omar Awadhy,Mohammad Ghareeb,7-6(4); 6-2,R32,84,11,5,43,66,26,43,9,23,3,8,10,35,66,0,6,40,67,23,40,8,27,3,10,10,31,67
2006-02-27 00:00:00.000,Dubai U.A.E. ATP World Tour,HARD,2,Robin Vik,Janko Tipsarevic,Robin Vik,6-2; 6-4,R32,67,2,6,37,60,31,37,11,23,6,6,9,42,60,4,1,31,45,23,31,5,14,1,4,9,28,45
2006-02-27 00:00:00.000,Dubai U.A.E. ATP World Tour,HARD,2,Tomas Berdych,Christophe Rochus,Tomas Berdych,6-4; 6-2,R32,56,13,0,26,44,23,26,10,18,0,1,9,33,44,2,2,35,52,20,35,7,17,2,6,9,27,52
2006-02-27 00:00:00.000,Dubai U.A.E. ATP World Tour,HARD,2,Marat Safin,Nikolay Davydenko,Marat Safin,4-6; 6-2; 6-2,R32,105,10,2,36,69,31,36,20,33,3,4,13,51,69,3,0,44,80,27,44,20,36,6,10,13,47,80
2006-02-27 00:00:00.000,Dubai U.A.E. ATP World Tour,HARD,2,Olivier Rochus,Fabrice Santoro,Olivier Rochus,6-4; 6-1,R32,74,0,2,25,40,18,25,11,15,0,1,8,29,40,4,0,45,72,26,45,9,27,11,16,9,35,72
2006-02-27 00:00:00.000,Dubai U.A.E. ATP World Tour,HARD,2,Igor Andreev,Andreas Seppi,Igor Andreev,7-6(5); 1-6; 6-4,R32,198,5,4,53,94,37,53,18,41,2,7,14,55,94,3,5,54,103,34,54,29,49,5,9,15,63,103
2006-02-27 00:00:00.000,Dubai U.A.E. ATP World Tour,HARD,2,Mikhail Youzhny,Dominik Hrbaty,Mikhail Youzhny,7-5; 1-6; 6-4,R32,123,2,1,55,94,31,55,19,39,3,9,14,50,94,4,8,52,100,32,52,24,48,5,11,15,56,100
2006-02-27 00:00:00.000,Dubai U.A.E. ATP World Tour,HARD,2,Rainer Schuettler,David Ferrer,Rainer Schuettler,6-2; 3-6; 7-5,R32,136,4,4,58,118,36,58,31,60,9,13,15,67,118,0,2,46,77,33,46,12,31,2,7,14,45,77
2006-02-27 00:00:00.000,Dubai U.A.E. ATP World Tour,HARD,2,Ivo Klec,Daniele Bracciali,Ivo Klec,6-4; 6-4,R32,85,6,2,38,62,28,38,15,24,6,7,10,43,62,1,3,37,79,23,37,20,42,8,11,10,43,79
2006-02-27 00:00:00.000,Dubai U.A.E. ATP World Tour,HARD,2,Bjorn Phau,Giorgio Galimberti,Bjorn Phau,5-7; 6-3; 6-2,R32,136,4,5,49,95,35,49,21,46,4,8,15,56,95,1,10,76,128,46,76,20,52,14,20,14,66,128
2006-02-27 00:00:00.000,Dubai U.A.E. ATP World Tour,HARD,2,Andre Agassi,Greg Rusedski,Andre Agassi,7-6(4); 6-0,R32,75,6,2,38,56,30,38,13,18,1,1,9,43,56,11,6,50,79,38,50,8,29,6,9,9,46,79
2006-02-27 00:00:00.000,Dubai U.A.E. ATP World Tour,HARD,2,Radek Stepanek,John van Lottum,Radek Stepanek,6-3; 7-6(6),R32,93,8,1,40,62,30,40,13,22,3,4,10,43,62,4,2,39,76,25,39,20,37,6,9,11,45,76
2006-02-27 00:00:00.000,Dubai U.A.E. ATP World Tour,HARD,2,Tim Henman,Feliciano Lopez,Tim Henman,6-2; 7-6(6),R32,84,2,2,40,60,32,40,12,20,2,3,10,44,60,6,4,48,80,32,48,14,32,4,7,10,46,80
2006-02-27 00:00:00.000,Dubai U.A.E. ATP World Tour,HARD,2,Younes El Aynaoui,Wesley Moodie,Younes El Aynaoui,6-4; 6-4,R32,78,8,0,32,51,27,32,14,19,2,2,10,41,51,6,4,44,70,30,44,12,26,7,9,10,42,70
2006-02-27 00:00:00.000,Dubai U.A.E. ATP World Tour,HARD,2,Rafael Nadal,Paul-Henri Mathieu,Rafael Nadal,6-7(5); 6-1; 6-2,R32,153,9,3,62,100,47,62,20,38,7,7,14,67,100,2,3,44,82,32,44,17,38,2,6,13,49,82
2006-02-27 00:00:00.000,Dubai U.A.E. ATP World Tour,HARD,2,Roger Federer,Mohammad Ghareeb,Roger Federer,7-6(5); 6-4,R16,88,7,0,45,67,36,45,11,22,0,1,11,47,67,6,4,44,89,34,44,20,45,14,16,11,54,89
2006-02-27 00:00:00.000,Dubai U.A.E. ATP World Tour,HARD,2,Robin Vik,Tomas Berdych,Robin Vik,3-6; 7-6(5); 6-2,R16,125,5,6,62,100,42,62,18,38,4,7,14,60,100,7,4,44,94,33,44,22,50,3,7,15,55,94
2006-02-27 00:00:00.000,Dubai U.A.E. ATP World Tour,HARD,2,Olivier Rochus,Marat Safin,Olivier Rochus,7-6(5); 6-4,R16,88,0,4,47,72,37,47,10,25,1,4,11,47,72,13,1,34,58,24,34,13,24,1,5,11,37,58
2006-02-27 00:00:00.000,Dubai U.A.E. ATP World Tour,HARD,2,Mikhail Youzhny,Igor Andreev,Mikhail Youzhny,6-1; 7-6(4),R16,82,3,1,45,78,30,45,22,33,5,6,10,52,78,5,3,23,49,19,23,11,26,0,3,9,30,49
2006-02-27 00:00:00.000,Dubai U.A.E. ATP World Tour,HARD,2,Rainer Schuettler,Ivo Klec,Rainer Schuettler,7-5; 6-4,R16,88,3,1,30,53,24,30,14,23,1,3,11,38,53,1,3,41,76,30,41,13,35,4,8,11,43,76
2006-02-27 00:00:00.000,Dubai U.A.E. ATP World Tour,HARD,2,Bjorn Phau,Andre Agassi,Bjorn Phau,7-5; 7-5,R16,81,7,1,50,79,37,50,14,29,8,10,12,51,79,4,3,53,79,27,53,18,26,6,10,12,45,79
2006-02-27 00:00:00.000,Dubai U.A.E. ATP World Tour,HARD,2,Tim Henman,Radek Stepanek,Tim Henman,7-5; 2-6; 7-6(3),R16,128,2,0,65,102,46,65,17,37,5,9,16,63,102,6,2,50,87,35,50,23,37,1,4,16,58,87
2006-02-27 00:00:00.000,Dubai U.A.E. ATP World Tour,HARD,2,Rafael Nadal,Younes El Aynaoui,Rafael Nadal,W/O,R16,0,0,0,0,0,0,0,0,0,0,0,0,0,0,0,0,0,0,0,0,0,0,0,0,0,0,0
2006-02-27 00:00:00.000,Dubai U.A.E. ATP World Tour,HARD,2,Roger Federer,Robin Vik,Roger Federer,6-3; 6-2,Q,58,8,1,40,56,31,40,8,16,5,6,9,39,56,2,2,27,44,18,27,6,17,2,6,8,24,44
2006-02-27 00:00:00.000,Dubai U.A.E. ATP World Tour,HARD,2,Mikhail Youzhny,Olivier Rochus,Mikhail Youzhny,6-3; 6-1,Q,68,4,4,28,57,19,28,15,29,7,9,8,34,57,1,2,27,51,12,27,9,24,4,10,8,21,51
2006-02-27 00:00:00.000,Dubai U.A.E. ATP World Tour,HARD,2,Rainer Schuettler,Bjorn Phau,Rainer Schuettler,6-4; 6-1,Q,68,1,0,20,44,18,20,19,24,0,0,9,37,44,1,4,30,53,18,30,12,23,3,6,8,30,53
2006-02-27 00:00:00.000,Dubai U.A.E. ATP World Tour,HARD,2,Rafael Nadal,Tim Henman,Rafael Nadal,7-6(1); 6-1,Q,87,8,1,52,64,39,52,7,12,8,9,10,46,64,4,4,32,55,22,32,10,23,4,7,9,32,55
2006-02-27 00:00:00.000,Dubai U.A.E. ATP World Tour,HARD,2,Roger Federer,Mikhail Youzhny,Roger Federer,6-2; 6-3,S,66,3,0,31,58,23,31,17,27,8,8,9,40,58,4,2,23,54,14,23,18,31,2,5,8,32,54
2006-02-27 00:00:00.000,Dubai U.A.E. ATP World Tour,HARD,2,Rafael Nadal,Rainer Schuettler,Rafael Nadal,6-4; 6-2,S,89,6,3,37,53,29,37,6,16,2,3,9,35,53,2,3,37,61,22,37,11,24,5,9,9,33,61
2006-02-27 00:00:00.000,Dubai U.A.E. ATP World Tour,HARD,2,Rafael Nadal,Roger Federer,Rafael Nadal,2-6; 6-4; 6-4,F,113,1,1,56,80,38,56,13,24,0,3,14,51,80,9,0,41,69,33,41,16,28,2,5,14,49,69
2006-02-27 00:00:00.000,Las Vegas NV; U.S.A. ATP World Tour,HARD,2,Lleyton Hewitt,Florian Mayer,Lleyton Hewitt,5-7; 6-2; 6-4,R32,111,5,3,47,83,35,47,22,36,2,5,15,57,83,5,3,52,97,33,52,20,45,5,10,15,53,97
2006-02-27 00:00:00.000,Las Vegas NV; U.S.A. ATP World Tour,HARD,2,Jan Hernych,Kristian Pless,Jan Hernych,6-3; 6-3,R32,53,1,2,26,46,20,26,12,20,0,1,9,32,46,2,10,31,53,20,31,7,22,3,7,9,27,53
2006-02-27 00:00:00.000,Las Vegas NV; U.S.A. ATP World Tour,HARD,2,Julien Benneteau,Robin Soderling,Julien Benneteau,6-4; 7-6(0),R32,91,2,2,48,68,26,48,16,20,3,6,11,42,68,1,3,45,62,27,45,8,17,2,6,11,35,62
2006-02-27 00:00:00.000,Las Vegas NV; U.S.A. ATP World Tour,HARD,2,Philipp Kohlschreiber,Fernando Verdasco,Philipp Kohlschreiber,6-7(4); 7-5; 6-2,R32,69,7,1,48,87,41,48,22,39,0,1,16,63,87,2,3,64,84,46,64,11,20,1,5,16,57,84
2006-02-27 00:00:00.000,Las Vegas NV; U.S.A. ATP World Tour,HARD,2,Paul Goldstein,Robby Ginepri,Paul Goldstein,6-7(4); 6-3; 6-1,R32,68,1,4,56,100,34,56,23,44,12,15,14,57,100,10,6,53,81,31,53,11,28,3,10,14,42,81
2006-02-27 00:00:00.000,Las Vegas NV; U.S.A. ATP World Tour,HARD,2,Vincent Spadea,Paul Capdeville,Vincent Spadea,6-3; 6-2,R32,64,2,3,34,59,23,34,16,25,3,4,9,39,59,1,2,26,47,15,26,8,21,2,6,8,23,47
2006-02-27 00:00:00.000,Las Vegas NV; U.S.A. ATP World Tour,HARD,2,Xavier Malisse,Max Mirnyi,Xavier Malisse,6-4; 4-6; 6-4,R32,111,9,2,57,93,41,57,18,36,5,8,15,59,93,8,2,56,97,40,56,20,41,6,10,15,60,97
2006-02-27 00:00:00.000,Las Vegas NV; U.S.A. ATP World Tour,HARD,2,Peter Luczak,Dmitry Tursunov,Peter Luczak,6-4; 7-6(7),R32,67,3,1,70,99,42,70,13,29,8,12,11,55,99,11,6,50,81,31,50,11,31,4,9,11,42,81
2006-02-27 00:00:00.000,Las Vegas NV; U.S.A. ATP World Tour,HARD,2,Jonas Bjorkman,Gael Monfils,Jonas Bjorkman,7-6(8); 6-3,R32,112,3,4,45,85,34,45,15,40,1,4,11,49,85,7,8,36,75,22,36,18,39,1,5,10,40,75
2006-02-27 00:00:00.000,Las Vegas NV; U.S.A. ATP World Tour,HARD,2,Ivo Karlovic,Davide Sanguinetti,Ivo Karlovic,6-2; 6-4,R32,63,1,5,34,53,26,34,9,19,3,4,9,35,53,0,1,33,53,18,33,10,20,1,5,9,28,53
2006-02-27 00:00:00.000,Las Vegas NV; U.S.A. ATP World Tour,HARD,2,Mardy Fish,Prakash Amritraj,Mardy Fish,6-4; 7-6(4),R32,101,10,5,53,84,35,53,20,31,6,7,11,55,84,1,4,47,78,29,47,19,31,7,9,11,48,78
2006-02-27 00:00:00.000,Las Vegas NV; U.S.A. ATP World Tour,HARD,2,Tommy Robredo,Andy Murray,Tommy Robredo,6-2; 6-2,R32,54,2,1,26,43,20,26,13,17,0,0,8,33,43,0,4,27,45,17,27,6,18,3,7,8,23,45
2006-02-27 00:00:00.000,Las Vegas NV; U.S.A. ATP World Tour,HARD,2,James Blake,Paradorn Srichaphan,James Blake,7-6(3); 6-0,R32,82,3,6,53,85,36,53,16,32,8,9,9,52,85,1,6,35,66,19,35,15,31,4,8,9,34,66
2006-02-27 00:00:00.000,Las Vegas NV; U.S.A. ATP World Tour,HARD,2,Brian Vahaly,Sam Querrey,Brian Vahaly,3-6; 7-6(3); 6-3,R32,109,1,2,64,92,44,64,21,28,1,2,14,65,92,12,2,55,93,43,55,22,38,4,6,16,65,93
2006-02-27 00:00:00.000,Las Vegas NV; U.S.A. ATP World Tour,HARD,2,Kenneth Carlsen,Tomas Zib,Kenneth Carlsen,6-4; 6-3,R32,69,11,4,28,47,23,28,10,19,1,2,9,33,47,3,1,35,64,21,35,12,29,4,8,10,33,64
2006-02-27 00:00:00.000,Las Vegas NV; U.S.A. ATP World Tour,HARD,2,Nicolas Kiefer,Sargis Sargsian,Nicolas Kiefer,6-3; 6-2,R32,88,4,2,36,59,30,36,12,23,2,2,9,42,59,0,6,33,54,18,33,11,21,4,7,8,29,54
2006-02-27 00:00:00.000,Las Vegas NV; U.S.A. ATP World Tour,HARD,2,Lleyton Hewitt,Jan Hernych,Lleyton Hewitt,6-3; 6-3,R16,71,1,1,30,51,22,30,15,21,0,0,9,37,51,2,3,33,63,21,33,14,30,4,7,9,35,63
2006-02-27 00:00:00.000,Las Vegas NV; U.S.A. ATP World Tour,HARD,2,Philipp Kohlschreiber,Julien Benneteau,Philipp Kohlschreiber,6-3; 6-2,R16,67,4,0,31,43,26,31,8,12,1,1,8,34,43,0,2,34,58,23,34,7,24,6,10,9,30,58
2006-02-27 00:00:00.000,Las Vegas NV; U.S.A. ATP World Tour,HARD,2,Paul Goldstein,Vincent Spadea,Paul Goldstein,6-2; 6-1,R16,63,0,2,34,50,26,34,8,16,3,3,7,34,50,3,3,26,49,14,26,9,23,6,11,8,23,49
2006-02-27 00:00:00.000,Las Vegas NV; U.S.A. ATP World Tour,HARD,2,Xavier Malisse,Peter Luczak,Xavier Malisse,6-4; 4-6; 6-4,R16,122,12,2,53,88,46,53,15,35,3,5,15,61,88,3,3,67,114,46,67,25,47,8,11,15,71,114
2006-02-27 00:00:00.000,Las Vegas NV; U.S.A. ATP World Tour,HARD,2,Ivo Karlovic,Jonas Bjorkman,Ivo Karlovic,3-6; 6-3; 6-4,R16,97,16,2,54,81,45,54,13,27,2,3,14,58,81,2,4,39,70,32,39,20,31,1,3,14,52,70
2006-02-27 00:00:00.000,Las Vegas NV; U.S.A. ATP World Tour,HARD,2,Tommy Robredo,Mardy Fish,Tommy Robredo,6-4; 6-4,R16,67,4,5,30,58,23,30,15,28,4,6,10,38,58,3,3,25,57,16,25,17,32,3,7,10,33,57
2006-02-27 00:00:00.000,Las Vegas NV; U.S.A. ATP World Tour,HARD,2,James Blake,Brian Vahaly,James Blake,6-1; 6-1,R16,51,2,4,25,38,22,25,7,13,1,1,7,29,38,0,5,24,58,10,24,15,34,8,13,7,25,58
2006-02-27 00:00:00.000,Las Vegas NV; U.S.A. ATP World Tour,HARD,2,Kenneth Carlsen,Nicolas Kiefer,Kenneth Carlsen,W/O,R16,0,0,0,0,0,0,0,0,0,0,0,0,0,0,0,0,0,0,0,0,0,0,0,0,0,0,0
2006-02-27 00:00:00.000,Las Vegas NV; U.S.A. ATP World Tour,HARD,2,Lleyton Hewitt,Philipp Kohlschreiber,Lleyton Hewitt,6-2; 6-0,Q,59,1,6,31,48,22,31,10,17,3,4,7,32,48,1,0,29,43,11,29,5,14,2,8,7,16,43
2006-02-27 00:00:00.000,Las Vegas NV; U.S.A. ATP World Tour,HARD,2,Paul Goldstein,Xavier Malisse,Paul Goldstein,6-3; 2-0 RET,Q,5,0,1,27,38,18,27,7,11,0,1,6,25,38,4,0,26,34,14,26,2,8,5,8,5,16,34
2006-02-27 00:00:00.000,Las Vegas NV; U.S.A. ATP World Tour,HARD,2,Ivo Karlovic,Tommy Robredo,Ivo Karlovic,7-6(4); 6-4,Q,89,8,5,38,66,35,38,15,28,0,0,11,50,66,2,2,53,70,38,53,11,17,1,2,11,49,70
2006-02-27 00:00:00.000,Las Vegas NV; U.S.A. ATP World Tour,HARD,2,James Blake,Kenneth Carlsen,James Blake,6-4; 6-4,Q,68,4,2,41,59,36,41,7,18,4,4,10,43,59,5,1,38,60,24,38,14,22,3,5,10,38,60
2006-02-27 00:00:00.000,Las Vegas NV; U.S.A. ATP World Tour,HARD,2,Lleyton Hewitt,Paul Goldstein,Lleyton Hewitt,3-6; 6-1; 6-0,S,93,3,3,39,67,25,39,14,28,2,6,11,39,67,1,2,37,70,19,37,10,33,5,13,11,29,70
2006-02-27 00:00:00.000,Las Vegas NV; U.S.A. ATP World Tour,HARD,2,James Blake,Ivo Karlovic,James Blake,7-6(2); 6-1,S,72,1,3,32,54,28,32,16,22,3,3,10,44,54,5,3,32,59,26,32,9,27,0,2,9,35,59
2006-02-27 00:00:00.000,Las Vegas NV; U.S.A. ATP World Tour,HARD,2,James Blake,Lleyton Hewitt,James Blake,7-5; 2-6; 6-3,F,119,5,4,47,96,32,47,23,49,5,10,14,55,96,3,2,56,95,32,56,19,39,6,12,15,51,95
2006-03-06 00:00:00.000,ATP Masters Series Indian Wells CA; U.S.A. ATP World Tour,HARD,2,Roger Federer,N/A Bye,Roger Federer,,R128,0,0,0,0,0,0,0,0,0,0,0,0,0,0,0,0,0,0,0,0,0,0,0,0,0,0,0
2006-03-06 00:00:00.000,ATP Masters Series Indian Wells CA; U.S.A. ATP World Tour,HARD,2,Nicolas Massu,Agustin Calleri,Nicolas Massu,6-1; 5-7; 7-6(10),R128,162,6,2,74,116,47,74,27,42,7,10,16,74,116,6,3,59,107,37,59,26,48,2,6,15,63,107
2006-03-06 00:00:00.000,ATP Masters Series Indian Wells CA; U.S.A. ATP World Tour,HARD,2,Stanislas Wawrinka,Greg Rusedski,Stanislas Wawrinka,6-2; 6-4,R128,81,4,2,38,58,26,38,11,20,2,3,9,37,58,2,5,33,66,21,33,14,33,8,12,9,35,66
2006-03-06 00:00:00.000,ATP Masters Series Indian Wells CA; U.S.A. ATP World Tour,HARD,2,Olivier Rochus,N/A Bye,Olivier Rochus,,R128,0,0,0,0,0,0,0,0,0,0,0,0,0,0,0,0,0,0,0,0,0,0,0,0,0,0,0
2006-03-06 00:00:00.000,ATP Masters Series Indian Wells CA; U.S.A. ATP World Tour,HARD,2,Dominik Hrbaty,N/A Bye,Dominik Hrbaty,,R128,0,0,0,0,0,0,0,0,0,0,0,0,0,0,0,0,0,0,0,0,0,0,0,0,0,0,0
2006-03-06 00:00:00.000,ATP Masters Series Indian Wells CA; U.S.A. ATP World Tour,HARD,2,Daniele Bracciali,Luis Horna,Daniele Bracciali,6-3; 6-3,R128,77,8,0,19,41,19,19,17,22,0,0,9,36,41,5,5,53,82,32,53,13,29,11,14,9,45,82
2006-03-06 00:00:00.000,ATP Masters Series Indian Wells CA; U.S.A. ATP World Tour,HARD,2,Kevin Kim,Mikhail Youzhny,Kevin Kim,7-5; 6-4,R128,88,2,1,35,60,28,35,14,25,0,2,11,42,60,1,3,58,83,33,58,13,25,8,12,11,46,83
2006-03-06 00:00:00.000,ATP Masters Series Indian Wells CA; U.S.A. ATP World Tour,HARD,2,Richard Gasquet,N/A Bye,Richard Gasquet,,R128,0,0,0,0,0,0,0,0,0,0,0,0,0,0,0,0,0,0,0,0,0,0,0,0,0,0,0
2006-03-06 00:00:00.000,ATP Masters Series Indian Wells CA; U.S.A. ATP World Tour,HARD,2,Nicolas Kiefer,N/A Bye,Nicolas Kiefer,,R128,0,0,0,0,0,0,0,0,0,0,0,0,0,0,0,0,0,0,0,0,0,0,0,0,0,0,0
2006-03-06 00:00:00.000,ATP Masters Series Indian Wells CA; U.S.A. ATP World Tour,HARD,2,Paul-Henri Mathieu,Andreas Seppi,Paul-Henri Mathieu,2-6; 6-4; 6-1,R128,112,6,3,40,72,31,40,16,32,3,6,13,47,72,5,1,48,84,31,48,17,36,7,11,12,48,84
2006-03-06 00:00:00.000,ATP Masters Series Indian Wells CA; U.S.A. ATP World Tour,HARD,2,Davide Sanguinetti,Paul Capdeville,Davide Sanguinetti,6-7(5); 6-2; 6-3,R128,116,7,2,48,81,39,48,24,33,0,1,15,63,81,1,1,58,104,36,58,26,46,6,10,14,62,104
2006-03-06 00:00:00.000,ATP Masters Series Indian Wells CA; U.S.A. ATP World Tour,HARD,2,Mario Ancic,N/A Bye,Mario Ancic,,R128,0,0,0,0,0,0,0,0,0,0,0,0,0,0,0,0,0,0,0,0,0,0,0,0,0,0,0
2006-03-06 00:00:00.000,ATP Masters Series Indian Wells CA; U.S.A. ATP World Tour,HARD,2,Gael Monfils,N/A Bye,Gael Monfils,,R128,0,0,0,0,0,0,0,0,0,0,0,0,0,0,0,0,0,0,0,0,0,0,0,0,0,0,0
2006-03-06 00:00:00.000,ATP Masters Series Indian Wells CA; U.S.A. ATP World Tour,HARD,2,Jeff Morrison,Andrei Pavel,Jeff Morrison,6-7(5); 7-5; 6-3,R128,131,8,2,63,110,44,63,27,47,10,14,17,71,110,1,3,51,101,30,51,29,50,6,12,16,59,101
2006-03-06 00:00:00.000,ATP Masters Series Indian Wells CA; U.S.A. ATP World Tour,HARD,2,Janko Tipsarevic,Sam Warburg,Janko Tipsarevic,6-4; 7-6(4),R128,101,4,0,33,63,28,33,19,30,2,3,11,47,63,2,2,42,74,28,42,18,32,2,4,11,46,74
2006-03-06 00:00:00.000,ATP Masters Series Indian Wells CA; U.S.A. ATP World Tour,HARD,2,Ivan Ljubicic,N/A Bye,Ivan Ljubicic,,R128,0,0,0,0,0,0,0,0,0,0,0,0,0,0,0,0,0,0,0,0,0,0,0,0,0,0,0
2006-03-06 00:00:00.000,ATP Masters Series Indian Wells CA; U.S.A. ATP World Tour,HARD,2,David Nalbandian,N/A Bye,David Nalbandian,,R128,0,0,0,0,0,0,0,0,0,0,0,0,0,0,0,0,0,0,0,0,0,0,0,0,0,0,0
2006-03-06 00:00:00.000,ATP Masters Series Indian Wells CA; U.S.A. ATP World Tour,HARD,2,Justin Gimelstob,Feliciano Lopez,Justin Gimelstob,7-5; 6-3,R128,68,3,4,26,55,22,26,19,29,0,1,11,41,55,2,2,33,59,23,33,12,26,1,4,10,35,59
2006-03-06 00:00:00.000,ATP Masters Series Indian Wells CA; U.S.A. ATP World Tour,HARD,2,Julien Benneteau,Novak Djokovic,Julien Benneteau,6-3; 6-4,R128,93,2,1,40,56,30,40,6,16,2,4,9,36,56,1,2,42,75,25,42,14,33,7,12,10,39,75
2006-03-06 00:00:00.000,ATP Masters Series Indian Wells CA; U.S.A. ATP World Tour,HARD,2,Juan Ignacio Chela,N/A Bye,Juan Ignacio Chela,,R128,0,0,0,0,0,0,0,0,0,0,0,0,0,0,0,0,0,0,0,0,0,0,0,0,0,0,0
2006-03-06 00:00:00.000,ATP Masters Series Indian Wells CA; U.S.A. ATP World Tour,HARD,2,Robby Ginepri,N/A Bye,Robby Ginepri,,R128,0,0,0,0,0,0,0,0,0,0,0,0,0,0,0,0,0,0,0,0,0,0,0,0,0,0,0
2006-03-06 00:00:00.000,ATP Masters Series Indian Wells CA; U.S.A. ATP World Tour,HARD,2,Paradorn Srichaphan,Wesley Moodie,Paradorn Srichaphan,7-6(2); 6-4,R128,77,8,0,34,61,26,34,20,27,0,1,11,46,61,9,3,41,64,30,41,10,23,2,4,11,40,64
2006-03-06 00:00:00.000,ATP Masters Series Indian Wells CA; U.S.A. ATP World Tour,HARD,2,Vincent Spadea,Carlos Berlocq,Vincent Spadea,6-1; 4-1 RET,R128,57,2,1,22,35,18,22,8,13,0,0,6,26,35,0,2,16,30,7,16,5,14,1,5,6,12,30
2006-03-06 00:00:00.000,ATP Masters Series Indian Wells CA; U.S.A. ATP World Tour,HARD,2,Juan Carlos Ferrero,N/A Bye,Juan Carlos Ferrero,,R128,0,0,0,0,0,0,0,0,0,0,0,0,0,0,0,0,0,0,0,0,0,0,0,0,0,0,0
2006-03-06 00:00:00.000,ATP Masters Series Indian Wells CA; U.S.A. ATP World Tour,HARD,2,David Ferrer,N/A Bye,David Ferrer,,R128,0,0,0,0,0,0,0,0,0,0,0,0,0,0,0,0,0,0,0,0,0,0,0,0,0,0,0
2006-03-06 00:00:00.000,ATP Masters Series Indian Wells CA; U.S.A. ATP World Tour,HARD,2,Philipp Kohlschreiber,Florent Serra,Philipp Kohlschreiber,3-6; 6-4; 6-3,R128,130,3,2,62,94,42,62,16,32,9,12,14,58,94,2,2,68,104,47,68,14,36,9,13,14,61,104
2006-03-06 00:00:00.000,ATP Masters Series Indian Wells CA; U.S.A. ATP World Tour,HARD,2,Florian Mayer,Mark Philippoussis,Florian Mayer,6-4; 6-3,R128,77,3,3,44,59,33,44,7,15,4,5,9,40,59,4,3,30,63,17,30,16,33,3,7,10,33,63
2006-03-06 00:00:00.000,ATP Masters Series Indian Wells CA; U.S.A. ATP World Tour,HARD,2,Jarkko Nieminen,N/A Bye,Jarkko Nieminen,,R128,0,0,0,0,0,0,0,0,0,0,0,0,0,0,0,0,0,0,0,0,0,0,0,0,0,0,0
2006-03-06 00:00:00.000,ATP Masters Series Indian Wells CA; U.S.A. ATP World Tour,HARD,2,Carlos Moya,N/A Bye,Carlos Moya,,R128,0,0,0,0,0,0,0,0,0,0,0,0,0,0,0,0,0,0,0,0,0,0,0,0,0,0,0
2006-03-06 00:00:00.000,ATP Masters Series Indian Wells CA; U.S.A. ATP World Tour,HARD,2,Marat Safin,Amer Delic,Marat Safin,6-3; 6-4,R128,91,4,0,34,60,25,34,17,26,1,2,10,42,60,0,0,27,51,16,27,12,24,2,5,9,28,51
2006-03-06 00:00:00.000,ATP Masters Series Indian Wells CA; U.S.A. ATP World Tour,HARD,2,Andy Murray,Vasilis Mazarakis,Andy Murray,6-2; 6-1,R128,47,2,1,25,45,20,25,10,20,1,2,8,30,45,0,2,21,37,12,21,3,16,1,6,7,15,37
2006-03-06 00:00:00.000,ATP Masters Series Indian Wells CA; U.S.A. ATP World Tour,HARD,2,Nikolay Davydenko,N/A Bye,Nikolay Davydenko,,R128,0,0,0,0,0,0,0,0,0,0,0,0,0,0,0,0,0,0,0,0,0,0,0,0,0,0,0
2006-03-06 00:00:00.000,ATP Masters Series Indian Wells CA; U.S.A. ATP World Tour,HARD,2,Andre Agassi,N/A Bye,Andre Agassi,,R128,0,0,0,0,0,0,0,0,0,0,0,0,0,0,0,0,0,0,0,0,0,0,0,0,0,0,0
2006-03-06 00:00:00.000,ATP Masters Series Indian Wells CA; U.S.A. ATP World Tour,HARD,2,Paul Goldstein,Alberto Martin,Paul Goldstein,3-6; 6-1; 6-1,R128,94,3,0,38,71,22,38,22,33,3,5,11,44,71,2,7,52,79,29,52,10,27,6,12,12,39,79
2006-03-06 00:00:00.000,ATP Masters Series Indian Wells CA; U.S.A. ATP World Tour,HARD,2,Arnaud Clement,Glenn Weiner,Arnaud Clement,6-3; 6-2,R128,66,6,1,28,50,23,28,13,22,0,0,9,36,50,4,1,27,48,16,27,12,21,3,6,8,28,48
2006-03-06 00:00:00.000,ATP Masters Series Indian Wells CA; U.S.A. ATP World Tour,HARD,2,Tommy Haas,N/A Bye,Tommy Haas,,R128,0,0,0,0,0,0,0,0,0,0,0,0,0,0,0,0,0,0,0,0,0,0,0,0,0,0,0
2006-03-06 00:00:00.000,ATP Masters Series Indian Wells CA; U.S.A. ATP World Tour,HARD,2,Tommy Robredo,N/A Bye,Tommy Robredo,,R128,0,0,0,0,0,0,0,0,0,0,0,0,0,0,0,0,0,0,0,0,0,0,0,0,0,0,0
2006-03-06 00:00:00.000,ATP Masters Series Indian Wells CA; U.S.A. ATP World Tour,HARD,2,Kenneth Carlsen,Gilles Muller,Kenneth Carlsen,6-3; 4-6; 6-3,R128,148,5,0,59,89,41,59,18,30,7,9,14,59,89,5,3,65,97,41,65,16,32,6,10,14,57,97
2006-03-06 00:00:00.000,ATP Masters Series Indian Wells CA; U.S.A. ATP World Tour,HARD,2,Sam Querrey,Bobby Reynolds,Sam Querrey,6-3; 7-5,R128,86,13,3,47,81,37,47,15,34,8,9,11,52,81,3,2,39,65,26,39,12,26,2,5,10,38,65
2006-03-06 00:00:00.000,ATP Masters Series Indian Wells CA; U.S.A. ATP World Tour,HARD,2,James Blake,N/A Bye,James Blake,,R128,0,0,0,0,0,0,0,0,0,0,0,0,0,0,0,0,0,0,0,0,0,0,0,0,0,0,0
2006-03-06 00:00:00.000,ATP Masters Series Indian Wells CA; U.S.A. ATP World Tour,HARD,2,Fernando Gonzalez,N/A Bye,Fernando Gonzalez,,R128,0,0,0,0,0,0,0,0,0,0,0,0,0,0,0,0,0,0,0,0,0,0,0,0,0,0,0
2006-03-06 00:00:00.000,ATP Masters Series Indian Wells CA; U.S.A. ATP World Tour,HARD,2,Robin Soderling,Jurgen Melzer,Robin Soderling,6-4; 6-4,R128,69,2,2,40,62,28,40,12,22,1,2,10,40,62,4,5,40,64,27,40,11,24,4,7,10,38,64
2006-03-06 00:00:00.000,ATP Masters Series Indian Wells CA; U.S.A. ATP World Tour,HARD,2,Dmitry Tursunov,Tomas Behrend,Dmitry Tursunov,6-4; 6-2,R128,58,7,2,30,49,26,30,12,19,0,0,9,38,49,1,3,26,50,20,26,9,24,3,6,9,29,50
2006-03-06 00:00:00.000,ATP Masters Series Indian Wells CA; U.S.A. ATP World Tour,HARD,2,Igor Andreev,N/A Bye,Igor Andreev,,R128,0,0,0,0,0,0,0,0,0,0,0,0,0,0,0,0,0,0,0,0,0,0,0,0,0,0,0
2006-03-06 00:00:00.000,ATP Masters Series Indian Wells CA; U.S.A. ATP World Tour,HARD,2,Fernando Verdasco,N/A Bye,Fernando Verdasco,,R128,0,0,0,0,0,0,0,0,0,0,0,0,0,0,0,0,0,0,0,0,0,0,0,0,0,0,0
2006-03-06 00:00:00.000,ATP Masters Series Indian Wells CA; U.S.A. ATP World Tour,HARD,2,Ivo Karlovic,Tomas Zib,Ivo Karlovic,7-6(9); 6-4,R128,94,27,0,50,69,42,50,13,19,1,1,11,55,69,1,0,44,67,32,44,18,23,0,1,11,50,67
2006-03-06 00:00:00.000,ATP Masters Series Indian Wells CA; U.S.A. ATP World Tour,HARD,2,Jose Acasuso,Jeff Salzenstein,Jose Acasuso,6-7(2); 6-3; 6-1,R128,115,9,1,51,84,40,51,24,33,4,4,14,64,84,8,13,68,106,51,68,13,38,5,9,14,64,106
2006-03-06 00:00:00.000,ATP Masters Series Indian Wells CA; U.S.A. ATP World Tour,HARD,2,Andy Roddick,N/A Bye,Andy Roddick,,R128,0,0,0,0,0,0,0,0,0,0,0,0,0,0,0,0,0,0,0,0,0,0,0,0,0,0,0
2006-03-06 00:00:00.000,ATP Masters Series Indian Wells CA; U.S.A. ATP World Tour,HARD,2,Gaston Gaudio,N/A Bye,Gaston Gaudio,,R128,0,0,0,0,0,0,0,0,0,0,0,0,0,0,0,0,0,0,0,0,0,0,0,0,0,0,0
2006-03-06 00:00:00.000,ATP Masters Series Indian Wells CA; U.S.A. ATP World Tour,HARD,2,Cyril Saulnier,Max Mirnyi,Cyril Saulnier,6-4; 7-6(5),R128,78,4,2,39,63,32,39,17,24,0,0,11,49,63,18,3,35,62,30,35,18,27,3,4,11,48,62
2006-03-06 00:00:00.000,ATP Masters Series Indian Wells CA; U.S.A. ATP World Tour,HARD,2,Jonas Bjorkman,Christophe Rochus,Jonas Bjorkman,6-2; 3-6; 6-2,R128,114,9,5,53,88,30,53,20,35,3,7,12,50,88,4,2,49,77,27,49,10,28,2,9,13,37,77
2006-03-06 00:00:00.000,ATP Masters Series Indian Wells CA; U.S.A. ATP World Tour,HARD,2,Marcos Baghdatis,N/A Bye,Marcos Baghdatis,,R128,0,0,0,0,0,0,0,0,0,0,0,0,0,0,0,0,0,0,0,0,0,0,0,0,0,0,0
2006-03-06 00:00:00.000,ATP Masters Series Indian Wells CA; U.S.A. ATP World Tour,HARD,2,Tomas Berdych,N/A Bye,Tomas Berdych,,R128,0,0,0,0,0,0,0,0,0,0,0,0,0,0,0,0,0,0,0,0,0,0,0,0,0,0,0
2006-03-06 00:00:00.000,ATP Masters Series Indian Wells CA; U.S.A. ATP World Tour,HARD,2,Tim Henman,Donald Young,Tim Henman,6-3; 6-1,R128,64,1,1,36,58,25,36,14,22,5,5,8,39,58,0,2,30,51,16,30,10,21,0,4,8,26,51
2006-03-06 00:00:00.000,ATP Masters Series Indian Wells CA; U.S.A. ATP World Tour,HARD,2,Rainer Schuettler,Boris Pashanski,Rainer Schuettler,7-6(4); 7-5,R128,117,5,0,43,72,30,43,20,29,2,3,12,50,72,1,2,66,105,42,66,19,39,8,10,12,61,105
2006-03-06 00:00:00.000,ATP Masters Series Indian Wells CA; U.S.A. ATP World Tour,HARD,2,Lleyton Hewitt,N/A Bye,Lleyton Hewitt,,R128,0,0,0,0,0,0,0,0,0,0,0,0,0,0,0,0,0,0,0,0,0,0,0,0,0,0,0
2006-03-06 00:00:00.000,ATP Masters Series Indian Wells CA; U.S.A. ATP World Tour,HARD,2,Radek Stepanek,N/A Bye,Radek Stepanek,,R128,0,0,0,0,0,0,0,0,0,0,0,0,0,0,0,0,0,0,0,0,0,0,0,0,0,0,0
2006-03-06 00:00:00.000,ATP Masters Series Indian Wells CA; U.S.A. ATP World Tour,HARD,2,Xavier Malisse,Fabrice Santoro,Xavier Malisse,6-1; 4-6; 6-4,R128,108,6,1,40,65,28,40,18,25,0,3,13,46,65,1,2,61,105,32,61,22,44,10,16,14,54,105
2006-03-06 00:00:00.000,ATP Masters Series Indian Wells CA; U.S.A. ATP World Tour,HARD,2,Kristof Vliegen,Lars Burgsmuller,Kristof Vliegen,6-4; 4-6; 6-4,R128,124,6,0,52,83,41,52,18,31,3,5,15,59,83,3,2,58,90,40,58,20,32,4,7,15,60,90
2006-03-06 00:00:00.000,ATP Masters Series Indian Wells CA; U.S.A. ATP World Tour,HARD,2,Sebastien Grosjean,N/A Bye,Sebastien Grosjean,,R128,0,0,0,0,0,0,0,0,0,0,0,0,0,0,0,0,0,0,0,0,0,0,0,0,0,0,0
2006-03-06 00:00:00.000,ATP Masters Series Indian Wells CA; U.S.A. ATP World Tour,HARD,2,Filippo Volandri,N/A Bye,Filippo Volandri,,R128,0,0,0,0,0,0,0,0,0,0,0,0,0,0,0,0,0,0,0,0,0,0,0,0,0,0,0
2006-03-06 00:00:00.000,ATP Masters Series Indian Wells CA; U.S.A. ATP World Tour,HARD,2,Mardy Fish,Giovanni Lapentti,Mardy Fish,5-7; 6-3; 6-3,R128,111,11,1,42,78,35,42,20,36,3,6,15,55,78,2,0,64,98,37,64,18,34,10,15,15,55,98
2006-03-06 00:00:00.000,ATP Masters Series Indian Wells CA; U.S.A. ATP World Tour,HARD,2,Jan Hernych,Robin Vik,Jan Hernych,6-1; 6-4,R128,74,1,3,42,59,29,42,8,17,1,3,9,37,59,1,2,42,55,21,42,5,13,4,9,8,26,55
2006-03-06 00:00:00.000,ATP Masters Series Indian Wells CA; U.S.A. ATP World Tour,HARD,2,Rafael Nadal,N/A Bye,Rafael Nadal,,R128,0,0,0,0,0,0,0,0,0,0,0,0,0,0,0,0,0,0,0,0,0,0,0,0,0,0,0
2006-03-06 00:00:00.000,ATP Masters Series Indian Wells CA; U.S.A. ATP World Tour,HARD,2,Roger Federer,Nicolas Massu,Roger Federer,6-3; 7-6(4),R64,94,3,1,40,66,30,40,21,26,1,1,11,51,66,2,1,46,67,30,46,13,21,3,4,10,43,67
2006-03-06 00:00:00.000,ATP Masters Series Indian Wells CA; U.S.A. ATP World Tour,HARD,2,Olivier Rochus,Stanislas Wawrinka,Olivier Rochus,7-6(4); 7-5,R64,105,0,2,50,88,33,50,24,38,3,4,12,57,88,6,3,40,74,28,40,22,34,2,4,12,50,74
2006-03-06 00:00:00.000,ATP Masters Series Indian Wells CA; U.S.A. ATP World Tour,HARD,2,Dominik Hrbaty,Daniele Bracciali,Dominik Hrbaty,7-5; 7-5,R64,80,3,2,44,67,35,44,13,23,2,3,12,48,67,4,5,38,69,24,38,17,31,2,5,12,41,69
2006-03-06 00:00:00.000,ATP Masters Series Indian Wells CA; U.S.A. ATP World Tour,HARD,2,Richard Gasquet,Kevin Kim,Richard Gasquet,6-4; 6-3,R64,68,3,3,43,64,35,43,7,21,3,4,10,42,64,3,6,40,61,27,40,8,21,6,9,9,35,61
2006-03-06 00:00:00.000,ATP Masters Series Indian Wells CA; U.S.A. ATP World Tour,HARD,2,Paul-Henri Mathieu,Nicolas Kiefer,Paul-Henri Mathieu,7-6(5); 4-6; 6-2,R64,156,8,2,42,90,30,42,27,48,2,5,15,57,90,10,2,43,81,29,43,24,38,0,4,15,53,81
2006-03-06 00:00:00.000,ATP Masters Series Indian Wells CA; U.S.A. ATP World Tour,HARD,2,Mario Ancic,Davide Sanguinetti,Mario Ancic,6-3; 7-6(3),R64,88,5,2,41,67,33,41,11,26,3,5,11,44,67,0,0,37,58,25,37,10,21,1,4,10,35,58
2006-03-06 00:00:00.000,ATP Masters Series Indian Wells CA; U.S.A. ATP World Tour,HARD,2,Gael Monfils,Jeff Morrison,Gael Monfils,6-3; 0-6; 6-3,R64,86,4,2,45,70,33,45,9,25,2,5,12,42,70,5,5,44,76,30,44,18,32,2,5,12,48,76
2006-03-06 00:00:00.000,ATP Masters Series Indian Wells CA; U.S.A. ATP World Tour,HARD,2,Ivan Ljubicic,Janko Tipsarevic,Ivan Ljubicic,6-1; 6-4,R64,65,10,2,32,54,23,32,13,22,0,1,9,36,54,0,2,22,45,15,22,10,23,4,8,8,25,45
2006-03-06 00:00:00.000,ATP Masters Series Indian Wells CA; U.S.A. ATP World Tour,HARD,2,David Nalbandian,Justin Gimelstob,David Nalbandian,6-4; 6-4,R64,80,5,3,32,58,24,32,13,26,4,6,10,37,58,3,0,34,60,24,34,10,26,4,8,10,34,60
2006-03-06 00:00:00.000,ATP Masters Series Indian Wells CA; U.S.A. ATP World Tour,HARD,2,Julien Benneteau,Juan Ignacio Chela,Julien Benneteau,6-4; 4-6; 6-3,R64,122,3,1,55,86,38,55,19,31,2,4,15,57,86,4,3,56,87,38,56,17,31,4,7,14,55,87
2006-03-06 00:00:00.000,ATP Masters Series Indian Wells CA; U.S.A. ATP World Tour,HARD,2,Paradorn Srichaphan,Robby Ginepri,Paradorn Srichaphan,7-6(10); 6-3,R64,86,4,2,37,71,27,37,27,34,0,0,11,54,71,0,0,42,66,30,42,16,24,0,1,10,46,66
2006-03-06 00:00:00.000,ATP Masters Series Indian Wells CA; U.S.A. ATP World Tour,HARD,2,Juan Carlos Ferrero,Vincent Spadea,Juan Carlos Ferrero,6-2; 4-6; 7-6(4),R64,138,3,1,61,92,43,61,17,31,4,7,15,60,92,7,3,67,102,44,67,16,35,3,7,15,60,102
2006-03-06 00:00:00.000,ATP Masters Series Indian Wells CA; U.S.A. ATP World Tour,HARD,2,Philipp Kohlschreiber,David Ferrer,Philipp Kohlschreiber,6-2; 6-2,R64,66,3,0,32,50,25,32,11,18,3,3,8,36,50,1,0,38,54,19,38,9,16,4,8,8,28,54
2006-03-06 00:00:00.000,ATP Masters Series Indian Wells CA; U.S.A. ATP World Tour,HARD,2,Jarkko Nieminen,Florian Mayer,Jarkko Nieminen,6-4; 6-4,R64,80,1,1,49,70,36,49,11,21,3,3,10,47,70,3,2,37,67,27,37,15,30,3,5,10,42,67
2006-03-06 00:00:00.000,ATP Masters Series Indian Wells CA; U.S.A. ATP World Tour,HARD,2,Marat Safin,Carlos Moya,Marat Safin,6-7(4); 6-3; 6-4,R64,128,14,2,54,96,45,54,26,42,2,2,16,71,96,5,2,42,93,32,42,32,51,4,6,15,64,93
2006-03-06 00:00:00.000,ATP Masters Series Indian Wells CA; U.S.A. ATP World Tour,HARD,2,Nikolay Davydenko,Andy Murray,Nikolay Davydenko,6-1; 3-6; 6-3,R64,108,1,6,53,73,33,53,8,20,5,9,12,41,73,1,4,57,88,30,57,12,31,6,13,13,42,88
2006-03-06 00:00:00.000,ATP Masters Series Indian Wells CA; U.S.A. ATP World Tour,HARD,2,Andre Agassi,Paul Goldstein,Andre Agassi,6-4; 4-6; 6-2,R64,100,5,1,47,86,34,47,20,39,3,6,14,54,86,0,3,59,82,32,59,13,23,3,8,14,45,82
2006-03-06 00:00:00.000,ATP Masters Series Indian Wells CA; U.S.A. ATP World Tour,HARD,2,Tommy Haas,Arnaud Clement,Tommy Haas,6-3; 1-6; 6-4,R64,114,10,9,47,87,33,47,19,40,3,7,13,52,87,5,1,41,89,27,41,22,48,9,13,13,49,89
2006-03-06 00:00:00.000,ATP Masters Series Indian Wells CA; U.S.A. ATP World Tour,HARD,2,Tommy Robredo,Kenneth Carlsen,Tommy Robredo,6-1; 6-3,R64,58,0,1,36,47,25,36,6,11,1,2,8,31,47,3,1,30,44,16,30,4,14,1,6,8,20,44
2006-03-06 00:00:00.000,ATP Masters Series Indian Wells CA; U.S.A. ATP World Tour,HARD,2,James Blake,Sam Querrey,James Blake,1-6; 6-1; 6-3,R64,90,5,3,41,62,28,41,13,21,1,4,11,41,62,5,2,37,74,21,37,18,37,3,8,12,39,74
2006-03-06 00:00:00.000,ATP Masters Series Indian Wells CA; U.S.A. ATP World Tour,HARD,2,Robin Soderling,Fernando Gonzalez,Robin Soderling,6-4; 6-0,R64,48,2,1,25,40,20,25,10,15,1,2,8,30,40,2,4,18,43,11,18,10,25,3,8,8,21,43
2006-03-06 00:00:00.000,ATP Masters Series Indian Wells CA; U.S.A. ATP World Tour,HARD,2,Igor Andreev,Dmitry Tursunov,Igor Andreev,6-7(2); 6-1; 6-2,R64,127,2,4,53,93,33,53,26,40,6,8,14,59,93,3,6,54,96,33,54,19,42,11,17,13,52,96
2006-03-06 00:00:00.000,ATP Masters Series Indian Wells CA; U.S.A. ATP World Tour,HARD,2,Fernando Verdasco,Ivo Karlovic,Fernando Verdasco,6-3; 3-6; 7-6(5),R64,121,1,2,67,93,48,67,16,26,4,6,15,64,93,16,3,69,100,51,69,16,31,3,5,15,67,100
2006-03-06 00:00:00.000,ATP Masters Series Indian Wells CA; U.S.A. ATP World Tour,HARD,2,Andy Roddick,Jose Acasuso,Andy Roddick,7-6(5); 6-0,R64,76,8,1,30,51,28,30,11,21,0,1,9,39,51,2,2,27,55,16,27,14,28,0,4,9,30,55
2006-03-06 00:00:00.000,ATP Masters Series Indian Wells CA; U.S.A. ATP World Tour,HARD,2,Gaston Gaudio,Cyril Saulnier,Gaston Gaudio,3-6; 6-3; 6-4,R64,124,3,2,55,80,37,55,14,25,3,7,14,51,80,7,3,51,99,34,51,20,48,8,13,14,54,99
2006-03-06 00:00:00.000,ATP Masters Series Indian Wells CA; U.S.A. ATP World Tour,HARD,2,Marcos Baghdatis,Jonas Bjorkman,Marcos Baghdatis,6-4; 6-3,R64,85,7,1,35,56,24,35,13,21,1,3,10,37,56,2,3,31,61,19,31,14,30,7,11,9,33,61
2006-03-06 00:00:00.000,ATP Masters Series Indian Wells CA; U.S.A. ATP World Tour,HARD,2,Tomas Berdych,Tim Henman,Tomas Berdych,6-4; 6-4,R64,88,4,3,29,62,25,29,16,33,4,5,10,41,62,4,2,40,63,28,40,8,23,2,5,10,36,63
2006-03-06 00:00:00.000,ATP Masters Series Indian Wells CA; U.S.A. ATP World Tour,HARD,2,Lleyton Hewitt,Rainer Schuettler,Lleyton Hewitt,7-6(3); 2-6; 6-4,R64,162,7,5,42,103,29,42,35,61,4,7,15,64,103,4,7,54,116,34,54,36,62,9,11,15,70,116
2006-03-06 00:00:00.000,ATP Masters Series Indian Wells CA; U.S.A. ATP World Tour,HARD,2,Xavier Malisse,Radek Stepanek,Xavier Malisse,6-1; 6-1,R64,60,0,0,26,41,20,26,9,15,1,1,7,29,41,1,3,30,50,14,30,7,20,3,8,7,21,50
2006-03-06 00:00:00.000,ATP Masters Series Indian Wells CA; U.S.A. ATP World Tour,HARD,2,Sebastien Grosjean,Kristof Vliegen,Sebastien Grosjean,6-1; 6-3,R64,79,2,1,15,43,13,15,17,28,0,1,8,30,43,2,3,33,58,20,33,7,25,2,7,8,27,58
2006-03-06 00:00:00.000,ATP Masters Series Indian Wells CA; U.S.A. ATP World Tour,HARD,2,Mardy Fish,Filippo Volandri,Mardy Fish,6-3; 6-2,R64,56,7,1,29,48,23,29,12,19,1,2,9,35,48,0,0,39,53,19,39,8,14,1,5,8,27,53
2006-03-06 00:00:00.000,ATP Masters Series Indian Wells CA; U.S.A. ATP World Tour,HARD,2,Rafael Nadal,Jan Hernych,Rafael Nadal,6-4; 6-4,R64,85,3,1,36,59,29,36,13,23,1,1,10,42,59,0,0,34,53,21,34,14,19,1,3,10,35,53
2006-03-06 00:00:00.000,ATP Masters Series Indian Wells CA; U.S.A. ATP World Tour,HARD,2,Roger Federer,Olivier Rochus,Roger Federer,3-6; 6-2; 7-5,R32,114,8,3,54,97,39,54,24,43,5,6,14,63,97,1,4,59,87,39,59,16,28,3,6,15,55,87
2006-03-06 00:00:00.000,ATP Masters Series Indian Wells CA; U.S.A. ATP World Tour,HARD,2,Richard Gasquet,Dominik Hrbaty,Richard Gasquet,6-3; 6-4,R32,77,6,2,33,50,26,33,14,17,0,0,10,40,50,1,1,34,62,23,34,13,28,4,6,9,36,62
2006-03-06 00:00:00.000,ATP Masters Series Indian Wells CA; U.S.A. ATP World Tour,HARD,2,Mario Ancic,Paul-Henri Mathieu,Mario Ancic,7-6(5); 6-3,R32,117,5,2,59,94,42,59,18,35,5,7,11,60,94,4,1,38,64,24,38,15,26,0,3,10,39,64
2006-03-06 00:00:00.000,ATP Masters Series Indian Wells CA; U.S.A. ATP World Tour,HARD,2,Ivan Ljubicic,Gael Monfils,Ivan Ljubicic,6-3; 6-2,R32,70,6,0,22,45,20,22,14,23,1,2,9,34,45,5,2,30,56,17,30,10,26,7,11,8,27,56
2006-03-06 00:00:00.000,ATP Masters Series Indian Wells CA; U.S.A. ATP World Tour,HARD,2,David Nalbandian,Julien Benneteau,David Nalbandian,6-4; 6-1,R32,88,1,2,40,66,20,40,17,26,7,10,9,37,66,4,3,33,57,16,33,8,24,6,12,8,24,57
2006-03-06 00:00:00.000,ATP Masters Series Indian Wells CA; U.S.A. ATP World Tour,HARD,2,Paradorn Srichaphan,Juan Carlos Ferrero,Paradorn Srichaphan,6-2; 6-2,R32,63,7,3,37,58,28,37,10,21,4,5,8,38,58,1,0,37,47,17,37,4,10,3,8,8,21,47
2006-03-06 00:00:00.000,ATP Masters Series Indian Wells CA; U.S.A. ATP World Tour,HARD,2,Jarkko Nieminen,Philipp Kohlschreiber,Jarkko Nieminen,6-1; 3-6; 6-3,R32,98,0,2,50,77,33,50,10,27,10,14,12,43,77,1,5,47,83,26,47,14,36,6,13,13,40,83
2006-03-06 00:00:00.000,ATP Masters Series Indian Wells CA; U.S.A. ATP World Tour,HARD,2,Marat Safin,Nikolay Davydenko,Marat Safin,7-6(5); 3-6; 6-4,R32,146,9,1,73,119,46,73,21,46,15,20,15,67,119,0,6,78,102,51,78,12,24,5,10,16,63,102
2006-03-06 00:00:00.000,ATP Masters Series Indian Wells CA; U.S.A. ATP World Tour,HARD,2,Tommy Haas,Andre Agassi,Tommy Haas,7-5; 6-2,R32,91,5,6,27,55,24,27,13,28,1,3,10,37,55,7,5,52,90,31,52,14,38,8,13,10,45,90
2006-03-06 00:00:00.000,ATP Masters Series Indian Wells CA; U.S.A. ATP World Tour,HARD,2,James Blake,Tommy Robredo,James Blake,6-2; 7-5,R32,74,1,5,42,63,30,42,11,21,0,1,10,41,63,3,2,37,57,24,37,7,20,6,10,10,31,57
2006-03-06 00:00:00.000,ATP Masters Series Indian Wells CA; U.S.A. ATP World Tour,HARD,2,Igor Andreev,Robin Soderling,Igor Andreev,3-6; 7-6(14); 6-4,R32,148,9,4,61,105,42,61,24,44,2,5,15,66,105,8,6,63,123,48,63,27,60,5,8,16,75,123
2006-03-06 00:00:00.000,ATP Masters Series Indian Wells CA; U.S.A. ATP World Tour,HARD,2,Andy Roddick,Fernando Verdasco,Andy Roddick,6-3; 6-4,R32,73,4,2,37,55,31,37,11,18,1,1,10,42,55,3,2,46,60,28,46,9,14,5,7,9,37,60
2006-03-06 00:00:00.000,ATP Masters Series Indian Wells CA; U.S.A. ATP World Tour,HARD,2,Marcos Baghdatis,Gaston Gaudio,Marcos Baghdatis,6-7(5); 6-3; 6-2,R32,141,9,2,49,88,42,49,23,39,0,1,15,65,88,2,8,67,100,45,67,16,33,7,11,14,61,100
2006-03-06 00:00:00.000,ATP Masters Series Indian Wells CA; U.S.A. ATP World Tour,HARD,2,Tomas Berdych,Lleyton Hewitt,Tomas Berdych,7-5; 6-3,R32,98,10,1,33,69,26,33,18,36,3,5,11,44,69,5,6,42,80,21,42,21,38,9,13,10,42,80
2006-03-06 00:00:00.000,ATP Masters Series Indian Wells CA; U.S.A. ATP World Tour,HARD,2,Sebastien Grosjean,Xavier Malisse,Sebastien Grosjean,6-4; 6-7(10); 6-2,R32,147,2,2,65,103,45,65,21,38,2,4,15,66,103,5,6,67,121,47,67,21,54,7,12,15,68,121
2006-03-06 00:00:00.000,ATP Masters Series Indian Wells CA; U.S.A. ATP World Tour,HARD,2,Rafael Nadal,Mardy Fish,Rafael Nadal,6-1; 6-4,R32,88,1,2,29,47,22,29,12,18,0,0,8,34,47,10,3,38,81,23,38,19,43,13,17,9,42,81
2006-03-06 00:00:00.000,ATP Masters Series Indian Wells CA; U.S.A. ATP World Tour,HARD,2,Roger Federer,Richard Gasquet,Roger Federer,6-3; 6-4,R16,57,3,1,32,48,30,32,10,16,0,0,10,40,48,1,1,32,52,23,32,10,20,0,2,9,33,52
2006-03-06 00:00:00.000,ATP Masters Series Indian Wells CA; U.S.A. ATP World Tour,HARD,2,Ivan Ljubicic,Mario Ancic,Ivan Ljubicic,6-3; 6-4,R16,83,4,1,40,61,33,40,11,21,5,5,10,44,61,2,3,36,53,28,36,7,17,1,3,9,35,53
2006-03-06 00:00:00.000,ATP Masters Series Indian Wells CA; U.S.A. ATP World Tour,HARD,2,Paradorn Srichaphan,David Nalbandian,Paradorn Srichaphan,6-7(5); 6-3; 6-2,R16,140,13,5,64,103,46,64,21,39,5,7,15,67,103,2,8,59,101,40,59,19,42,12,17,14,59,101
2006-03-06 00:00:00.000,ATP Masters Series Indian Wells CA; U.S.A. ATP World Tour,HARD,2,Jarkko Nieminen,Marat Safin,Jarkko Nieminen,6-4; 6-3,R16,77,2,1,46,61,31,46,10,15,1,2,10,41,61,2,0,42,62,28,42,6,20,4,7,9,34,62
2006-03-06 00:00:00.000,ATP Masters Series Indian Wells CA; U.S.A. ATP World Tour,HARD,2,James Blake,Tommy Haas,James Blake,6-3; 3-0 RET,R16,45,6,1,22,37,19,22,8,15,2,2,6,27,37,1,2,17,40,11,17,8,23,3,6,6,19,40
2006-03-06 00:00:00.000,ATP Masters Series Indian Wells CA; U.S.A. ATP World Tour,HARD,2,Igor Andreev,Andy Roddick,Igor Andreev,6-4; 6-7(5); 6-1,R16,126,7,2,64,95,48,64,20,31,6,6,15,68,95,4,5,51,89,36,51,19,38,3,6,14,55,89
2006-03-06 00:00:00.000,ATP Masters Series Indian Wells CA; U.S.A. ATP World Tour,HARD,2,Marcos Baghdatis,Tomas Berdych,Marcos Baghdatis,6-4; 6-1,R16,98,10,3,48,84,33,48,19,36,11,11,8,52,84,3,6,32,65,25,32,9,33,8,12,9,34,65
2006-03-06 00:00:00.000,ATP Masters Series Indian Wells CA; U.S.A. ATP World Tour,HARD,2,Rafael Nadal,Sebastien Grosjean,Rafael Nadal,6-4; 6-2,R16,84,2,0,34,50,23,34,11,16,5,7,9,34,50,4,3,34,54,19,34,7,20,3,8,9,26,54
2006-03-06 00:00:00.000,ATP Masters Series Indian Wells CA; U.S.A. ATP World Tour,HARD,2,Roger Federer,Ivan Ljubicic,Roger Federer,6-2; 6-3,Q,67,5,1,37,53,29,37,9,16,1,1,9,38,53,4,1,38,51,23,38,5,13,4,7,8,28,51
2006-03-06 00:00:00.000,ATP Masters Series Indian Wells CA; U.S.A. ATP World Tour,HARD,2,Paradorn Srichaphan,Jarkko Nieminen,Paradorn Srichaphan,7-6(3); 3-6; 7-5,Q,161,4,3,51,105,40,51,37,54,4,5,16,77,105,3,1,95,134,64,95,22,39,11,12,17,86,134
2006-03-06 00:00:00.000,ATP Masters Series Indian Wells CA; U.S.A. ATP World Tour,HARD,2,James Blake,Igor Andreev,James Blake,6-1; 6-4,Q,70,3,1,26,51,19,26,18,25,1,1,9,37,51,0,1,38,63,26,38,8,25,5,8,8,34,63
2006-03-06 00:00:00.000,ATP Masters Series Indian Wells CA; U.S.A. ATP World Tour,HARD,2,Rafael Nadal,Marcos Baghdatis,Rafael Nadal,7-5; 6-0,Q,98,1,1,44,57,32,44,6,13,2,3,9,38,57,4,4,33,70,22,33,13,37,5,10,9,35,70
2006-03-06 00:00:00.000,ATP Masters Series Indian Wells CA; U.S.A. ATP World Tour,HARD,2,Roger Federer,Paradorn Srichaphan,Roger Federer,6-2; 6-3,S,60,3,0,36,50,24,36,10,14,0,1,9,34,50,4,2,38,55,21,38,8,17,3,7,8,29,55
2006-03-06 00:00:00.000,ATP Masters Series Indian Wells CA; U.S.A. ATP World Tour,HARD,2,James Blake,Rafael Nadal,James Blake,7-5; 6-3,S,91,3,1,41,67,29,41,16,26,5,6,11,45,67,2,3,41,62,28,41,8,21,4,7,10,36,62
2006-03-06 00:00:00.000,ATP Masters Series Indian Wells CA; U.S.A. ATP World Tour,HARD,2,Roger Federer,James Blake,Roger Federer,7-5; 6-3; 6-0,F,103,3,1,46,79,37,46,18,33,2,4,14,55,79,3,3,44,89,20,44,22,45,9,16,13,42,89
2006-03-20 00:00:00.000,ATP Masters Series Miami FL; U.S.A. ATP World Tour,HARD,2,Roger Federer,N/A Bye,Roger Federer,,R128,0,0,0,0,0,0,0,0,0,0,0,0,0,0,0,0,0,0,0,0,0,0,0,0,0,0,0
2006-03-20 00:00:00.000,ATP Masters Series Miami FL; U.S.A. ATP World Tour,HARD,2,Arnaud Clement,Peter Luczak,Arnaud Clement,6-1; 6-2,R128,58,9,1,27,40,24,27,8,13,0,0,8,32,40,3,0,27,44,14,27,7,17,1,5,7,21,44
2006-03-20 00:00:00.000,ATP Masters Series Miami FL; U.S.A. ATP World Tour,HARD,2,Luis Horna,Florian Mayer,Luis Horna,6-4; 7-6(5),R128,99,6,5,48,76,35,48,17,28,3,3,11,52,76,11,0,47,77,35,47,12,30,0,1,11,47,77
2006-03-20 00:00:00.000,ATP Masters Series Miami FL; U.S.A. ATP World Tour,HARD,2,Tommy Haas,N/A Bye,Tommy Haas,,R128,0,0,0,0,0,0,0,0,0,0,0,0,0,0,0,0,0,0,0,0,0,0,0,0,0,0,0
2006-03-20 00:00:00.000,ATP Masters Series Miami FL; U.S.A. ATP World Tour,HARD,2,Igor Andreev,N/A Bye,Igor Andreev,,R128,0,0,0,0,0,0,0,0,0,0,0,0,0,0,0,0,0,0,0,0,0,0,0,0,0,0,0
2006-03-20 00:00:00.000,ATP Masters Series Miami FL; U.S.A. ATP World Tour,HARD,2,George Bastl,Daniele Bracciali,George Bastl,6-7(5); 6-1; 6-4,R128,156,11,1,80,130,52,80,30,50,10,10,15,82,130,6,5,46,94,35,46,24,48,5,8,14,59,94
2006-03-20 00:00:00.000,ATP Masters Series Miami FL; U.S.A. ATP World Tour,HARD,2,Dmitry Tursunov,Paul Capdeville,Dmitry Tursunov,6-2; 6-1,R128,54,7,1,21,43,20,21,11,22,0,1,8,31,43,1,4,24,43,12,24,5,19,1,6,7,17,43
2006-03-20 00:00:00.000,ATP Masters Series Miami FL; U.S.A. ATP World Tour,HARD,2,Juan Carlos Ferrero,N/A Bye,Juan Carlos Ferrero,,R128,0,0,0,0,0,0,0,0,0,0,0,0,0,0,0,0,0,0,0,0,0,0,0,0,0,0,0
2006-03-20 00:00:00.000,ATP Masters Series Miami FL; U.S.A. ATP World Tour,HARD,2,James Blake,N/A Bye,James Blake,,R128,0,0,0,0,0,0,0,0,0,0,0,0,0,0,0,0,0,0,0,0,0,0,0,0,0,0,0
2006-03-20 00:00:00.000,ATP Masters Series Miami FL; U.S.A. ATP World Tour,HARD,2,Carlos Berlocq,Donald Young,Carlos Berlocq,6-0; 6-0,R128,49,2,0,21,39,15,21,12,18,2,2,6,27,39,0,3,18,33,6,18,2,15,2,8,6,8,33
2006-03-20 00:00:00.000,ATP Masters Series Miami FL; U.S.A. ATP World Tour,HARD,2,Mark Philippoussis,Davide Sanguinetti,Mark Philippoussis,6-4; 4-6; 6-3,R128,120,15,4,49,97,37,49,27,48,6,8,15,64,97,9,2,44,83,34,44,19,39,2,5,14,53,83
2006-03-20 00:00:00.000,ATP Masters Series Miami FL; U.S.A. ATP World Tour,HARD,2,Jarkko Nieminen,N/A Bye,Jarkko Nieminen,,R128,0,0,0,0,0,0,0,0,0,0,0,0,0,0,0,0,0,0,0,0,0,0,0,0,0,0,0
2006-03-20 00:00:00.000,ATP Masters Series Miami FL; U.S.A. ATP World Tour,HARD,2,Juan Ignacio Chela,N/A Bye,Juan Ignacio Chela,,R128,0,0,0,0,0,0,0,0,0,0,0,0,0,0,0,0,0,0,0,0,0,0,0,0,0,0,0
2006-03-20 00:00:00.000,ATP Masters Series Miami FL; U.S.A. ATP World Tour,HARD,2,Greg Rusedski,Mikhail Youzhny,Greg Rusedski,6-3; 6-1,R128,71,4,5,26,48,19,26,13,22,2,3,8,32,48,4,6,32,61,18,32,12,29,3,8,8,30,61
2006-03-20 00:00:00.000,ATP Masters Series Miami FL; U.S.A. ATP World Tour,HARD,2,Kristof Vliegen,Boris Pashanski,Kristof Vliegen,6-2; 4-6; 6-3,R128,114,14,3,48,78,41,48,16,30,2,3,14,57,78,0,2,49,83,39,49,13,34,3,6,13,52,83
2006-03-20 00:00:00.000,ATP Masters Series Miami FL; U.S.A. ATP World Tour,HARD,2,Gaston Gaudio,N/A Bye,Gaston Gaudio,,R128,0,0,0,0,0,0,0,0,0,0,0,0,0,0,0,0,0,0,0,0,0,0,0,0,0,0,0
2006-03-20 00:00:00.000,ATP Masters Series Miami FL; U.S.A. ATP World Tour,HARD,2,Andy Roddick,N/A Bye,Andy Roddick,,R128,0,0,0,0,0,0,0,0,0,0,0,0,0,0,0,0,0,0,0,0,0,0,0,0,0,0,0
2006-03-20 00:00:00.000,ATP Masters Series Miami FL; U.S.A. ATP World Tour,HARD,2,Alberto Martin,Andrei Pavel,Alberto Martin,6-2; 6-2,R128,65,5,2,25,53,19,25,15,28,3,4,8,34,53,4,4,39,61,24,39,4,22,9,14,8,28,61
2006-03-20 00:00:00.000,ATP Masters Series Miami FL; U.S.A. ATP World Tour,HARD,2,Vincent Spadea,Andreas Seppi,Vincent Spadea,6-1; 6-4,R128,74,4,2,33,57,23,33,16,24,3,4,9,39,57,1,1,26,54,17,26,11,28,4,8,8,28,54
2006-03-20 00:00:00.000,ATP Masters Series Miami FL; U.S.A. ATP World Tour,HARD,2,Fernando Verdasco,N/A Bye,Fernando Verdasco,,R128,0,0,0,0,0,0,0,0,0,0,0,0,0,0,0,0,0,0,0,0,0,0,0,0,0,0,0
2006-03-20 00:00:00.000,ATP Masters Series Miami FL; U.S.A. ATP World Tour,HARD,2,Dominik Hrbaty,N/A Bye,Dominik Hrbaty,,R128,0,0,0,0,0,0,0,0,0,0,0,0,0,0,0,0,0,0,0,0,0,0,0,0,0,0,0
2006-03-20 00:00:00.000,ATP Masters Series Miami FL; U.S.A. ATP World Tour,HARD,2,Simon Greul,Paradorn Srichaphan,Simon Greul,5-7; 6-2; 7-5,R128,143,6,3,53,106,40,53,31,53,8,9,16,71,106,10,7,74,126,55,74,21,52,8,11,16,76,126
2006-03-20 00:00:00.000,ATP Masters Series Miami FL; U.S.A. ATP World Tour,HARD,2,Tim Henman,Marat Safin,Tim Henman,6-3; 6-3,R128,76,3,0,28,49,21,28,12,21,0,1,9,33,49,3,2,36,68,21,36,15,32,5,9,9,36,68
2006-03-20 00:00:00.000,ATP Masters Series Miami FL; U.S.A. ATP World Tour,HARD,2,Lleyton Hewitt,N/A Bye,Lleyton Hewitt,,R128,0,0,0,0,0,0,0,0,0,0,0,0,0,0,0,0,0,0,0,0,0,0,0,0,0,0,0
2006-03-20 00:00:00.000,ATP Masters Series Miami FL; U.S.A. ATP World Tour,HARD,2,David Ferrer,N/A Bye,David Ferrer,,R128,0,0,0,0,0,0,0,0,0,0,0,0,0,0,0,0,0,0,0,0,0,0,0,0,0,0,0
2006-03-20 00:00:00.000,ATP Masters Series Miami FL; U.S.A. ATP World Tour,HARD,2,Albert Montanes,Igor Kunitsyn,Albert Montanes,6-4; 6-2,R128,92,2,0,33,56,23,33,15,23,4,5,9,38,56,0,0,30,52,19,30,8,22,0,4,9,27,52
2006-03-20 00:00:00.000,ATP Masters Series Miami FL; U.S.A. ATP World Tour,HARD,2,Feliciano Lopez,Alex Kuznetsov,Feliciano Lopez,6-4; 4-6; 6-1,R128,102,6,4,36,74,29,36,19,38,2,5,13,48,74,0,5,54,87,30,54,16,33,2,8,14,46,87
2006-03-20 00:00:00.000,ATP Masters Series Miami FL; U.S.A. ATP World Tour,HARD,2,Sebastien Grosjean,N/A Bye,Sebastien Grosjean,,R128,0,0,0,0,0,0,0,0,0,0,0,0,0,0,0,0,0,0,0,0,0,0,0,0,0,0,0
2006-03-20 00:00:00.000,ATP Masters Series Miami FL; U.S.A. ATP World Tour,HARD,2,Olivier Rochus,N/A Bye,Olivier Rochus,,R128,0,0,0,0,0,0,0,0,0,0,0,0,0,0,0,0,0,0,0,0,0,0,0,0,0,0,0
2006-03-20 00:00:00.000,ATP Masters Series Miami FL; U.S.A. ATP World Tour,HARD,2,Max Mirnyi,Gilles Muller,Max Mirnyi,7-6(5); 5-7; 6-4,R128,193,19,9,53,94,50,53,22,41,2,3,17,72,94,13,3,74,112,59,74,18,38,2,3,17,77,112
2006-03-20 00:00:00.000,ATP Masters Series Miami FL; U.S.A. ATP World Tour,HARD,2,Novak Djokovic,Paul-Henri Mathieu,Novak Djokovic,6-1; 6-3,R128,57,8,1,26,36,26,26,6,10,0,0,8,32,36,3,2,30,50,18,30,8,20,3,7,8,26,50
2006-03-20 00:00:00.000,ATP Masters Series Miami FL; U.S.A. ATP World Tour,HARD,2,Guillermo Coria,N/A Bye,Guillermo Coria,,R128,0,0,0,0,0,0,0,0,0,0,0,0,0,0,0,0,0,0,0,0,0,0,0,0,0,0,0
2006-03-20 00:00:00.000,ATP Masters Series Miami FL; U.S.A. ATP World Tour,HARD,2,Nikolay Davydenko,N/A Bye,Nikolay Davydenko,,R128,0,0,0,0,0,0,0,0,0,0,0,0,0,0,0,0,0,0,0,0,0,0,0,0,0,0,0
2006-03-20 00:00:00.000,ATP Masters Series Miami FL; U.S.A. ATP World Tour,HARD,2,Mardy Fish,Jan Hernych,Mardy Fish,6-3; 6-3,R128,81,5,0,41,60,30,41,13,19,4,4,9,43,60,0,1,48,70,28,48,10,22,7,10,9,38,70
2006-03-20 00:00:00.000,ATP Masters Series Miami FL; U.S.A. ATP World Tour,HARD,2,Alex Bogomolov Jr.,Sam Querrey,Alex Bogomolov Jr.,4-6; 6-4; 6-3,R128,88,3,2,45,79,35,45,19,34,0,2,15,54,79,21,0,47,72,39,47,11,25,2,5,14,50,72
2006-03-20 00:00:00.000,ATP Masters Series Miami FL; U.S.A. ATP World Tour,HARD,2,Marcos Baghdatis,N/A Bye,Marcos Baghdatis,,R128,0,0,0,0,0,0,0,0,0,0,0,0,0,0,0,0,0,0,0,0,0,0,0,0,0,0,0
2006-03-20 00:00:00.000,ATP Masters Series Miami FL; U.S.A. ATP World Tour,HARD,2,Mario Ancic,N/A Bye,Mario Ancic,,R128,0,0,0,0,0,0,0,0,0,0,0,0,0,0,0,0,0,0,0,0,0,0,0,0,0,0,0
2006-03-20 00:00:00.000,ATP Masters Series Miami FL; U.S.A. ATP World Tour,HARD,2,Kevin Kim,Jurgen Melzer,Kevin Kim,3-6; 6-2; 6-3,R128,101,7,0,50,85,38,50,19,35,2,4,13,57,85,8,8,33,79,25,33,21,46,4,8,13,46,79
2006-03-20 00:00:00.000,ATP Masters Series Miami FL; U.S.A. ATP World Tour,HARD,2,Florent Serra,Gilles Simon,Florent Serra,6-2; 6-4,R128,68,3,2,27,58,20,27,18,31,2,3,9,38,58,7,1,21,50,15,21,13,29,4,8,9,28,50
2006-03-20 00:00:00.000,ATP Masters Series Miami FL; U.S.A. ATP World Tour,HARD,2,Richard Gasquet,N/A Bye,Richard Gasquet,,R128,0,0,0,0,0,0,0,0,0,0,0,0,0,0,0,0,0,0,0,0,0,0,0,0,0,0,0
2006-03-20 00:00:00.000,ATP Masters Series Miami FL; U.S.A. ATP World Tour,HARD,2,Radek Stepanek,N/A Bye,Radek Stepanek,,R128,0,0,0,0,0,0,0,0,0,0,0,0,0,0,0,0,0,0,0,0,0,0,0,0,0,0,0
2006-03-20 00:00:00.000,ATP Masters Series Miami FL; U.S.A. ATP World Tour,HARD,2,Xavier Malisse,Nicolas Lapentti,Xavier Malisse,3-6; 6-3; 6-0,R128,99,6,4,41,76,31,41,17,35,6,9,12,48,76,8,1,46,68,29,46,6,22,5,11,12,35,68
2006-03-20 00:00:00.000,ATP Masters Series Miami FL; U.S.A. ATP World Tour,HARD,2,Nicolas Massu,Raemon Sluiter,Nicolas Massu,6-4; 6-3,R128,79,6,3,29,54,23,29,13,25,1,2,9,36,54,4,2,31,55,17,31,13,24,2,6,10,30,55
2006-03-20 00:00:00.000,ATP Masters Series Miami FL; U.S.A. ATP World Tour,HARD,2,Tommy Robredo,N/A Bye,Tommy Robredo,,R128,0,0,0,0,0,0,0,0,0,0,0,0,0,0,0,0,0,0,0,0,0,0,0,0,0,0,0
2006-03-20 00:00:00.000,ATP Masters Series Miami FL; U.S.A. ATP World Tour,HARD,2,Tomas Berdych,N/A Bye,Tomas Berdych,,R128,0,0,0,0,0,0,0,0,0,0,0,0,0,0,0,0,0,0,0,0,0,0,0,0,0,0,0
2006-03-20 00:00:00.000,ATP Masters Series Miami FL; U.S.A. ATP World Tour,HARD,2,Jose Acasuso,Tomas Zib,Jose Acasuso,5-7; 6-1; 6-1,R128,100,21,1,38,67,33,38,17,29,3,5,13,50,67,6,7,55,85,31,55,13,30,8,14,13,44,85
2006-03-20 00:00:00.000,ATP Masters Series Miami FL; U.S.A. ATP World Tour,HARD,2,Paul Goldstein,Justin Gimelstob,Paul Goldstein,3-6; 7-6(6); 1-1 RET,R128,126,0,3,55,79,36,55,17,24,4,6,11,53,79,7,6,44,95,31,44,29,51,6,7,12,60,95
2006-03-20 00:00:00.000,ATP Masters Series Miami FL; U.S.A. ATP World Tour,HARD,2,David Nalbandian,N/A Bye,David Nalbandian,,R128,0,0,0,0,0,0,0,0,0,0,0,0,0,0,0,0,0,0,0,0,0,0,0,0,0,0,0
2006-03-20 00:00:00.000,ATP Masters Series Miami FL; U.S.A. ATP World Tour,HARD,2,Ivan Ljubicic,N/A Bye,Ivan Ljubicic,,R128,0,0,0,0,0,0,0,0,0,0,0,0,0,0,0,0,0,0,0,0,0,0,0,0,0,0,0
2006-03-20 00:00:00.000,ATP Masters Series Miami FL; U.S.A. ATP World Tour,HARD,2,Robin Vik,Jonas Bjorkman,Robin Vik,6-4; 6-4,R128,90,4,3,40,67,29,40,13,27,1,3,10,42,67,1,4,31,61,26,31,10,30,6,10,10,36,61
2006-03-20 00:00:00.000,ATP Masters Series Miami FL; U.S.A. ATP World Tour,HARD,2,Michael Llodra,Lukas Dlouhy,Michael Llodra,6-7(4); 6-0; 6-3,R128,106,10,2,55,80,41,55,12,25,2,4,13,53,80,2,5,40,88,24,40,20,48,1,8,14,44,88
2006-03-20 00:00:00.000,ATP Masters Series Miami FL; U.S.A. ATP World Tour,HARD,2,Filippo Volandri,N/A Bye,Filippo Volandri,,R128,0,0,0,0,0,0,0,0,0,0,0,0,0,0,0,0,0,0,0,0,0,0,0,0,0,0,0
2006-03-20 00:00:00.000,ATP Masters Series Miami FL; U.S.A. ATP World Tour,HARD,2,Robby Ginepri,N/A Bye,Robby Ginepri,,R128,0,0,0,0,0,0,0,0,0,0,0,0,0,0,0,0,0,0,0,0,0,0,0,0,0,0,0
2006-03-20 00:00:00.000,ATP Masters Series Miami FL; U.S.A. ATP World Tour,HARD,2,Kenneth Carlsen,Cyril Saulnier,Kenneth Carlsen,3-6; 6-3; 6-0,R128,98,14,2,49,80,38,49,14,31,2,3,12,52,80,4,4,37,64,25,37,12,27,1,5,12,37,64
2006-03-20 00:00:00.000,ATP Masters Series Miami FL; U.S.A. ATP World Tour,HARD,2,Christophe Rochus,Wesley Moodie,Christophe Rochus,2-6; 6-4; 6-4,R128,113,1,4,65,87,43,65,9,22,2,6,14,52,87,12,10,57,86,45,57,9,29,9,13,14,54,86
2006-03-20 00:00:00.000,ATP Masters Series Miami FL; U.S.A. ATP World Tour,HARD,2,Bjorn Phau,N/A Bye,Bjorn Phau,,R128,0,0,0,0,0,0,0,0,0,0,0,0,0,0,0,0,0,0,0,0,0,0,0,0,0,0,0
2006-03-20 00:00:00.000,ATP Masters Series Miami FL; U.S.A. ATP World Tour,HARD,2,Nicolas Kiefer,N/A Bye,Nicolas Kiefer,,R128,0,0,0,0,0,0,0,0,0,0,0,0,0,0,0,0,0,0,0,0,0,0,0,0,0,0,0
2006-03-20 00:00:00.000,ATP Masters Series Miami FL; U.S.A. ATP World Tour,HARD,2,Fabrice Santoro,Ivo Karlovic,Fabrice Santoro,6-3; 7-6(5),R128,94,2,2,57,73,42,57,9,16,0,0,11,51,73,9,1,36,63,30,36,14,27,3,4,10,44,63
2006-03-20 00:00:00.000,ATP Masters Series Miami FL; U.S.A. ATP World Tour,HARD,2,Stanislas Wawrinka,Andy Murray,Stanislas Wawrinka,7-5; 3-6; 6-4,R128,127,1,8,65,105,41,65,16,40,5,11,16,57,105,5,2,49,91,24,49,25,42,7,13,15,49,91
2006-03-20 00:00:00.000,ATP Masters Series Miami FL; U.S.A. ATP World Tour,HARD,2,Fernando Gonzalez,N/A Bye,Fernando Gonzalez,,R128,0,0,0,0,0,0,0,0,0,0,0,0,0,0,0,0,0,0,0,0,0,0,0,0,0,0,0
2006-03-20 00:00:00.000,ATP Masters Series Miami FL; U.S.A. ATP World Tour,HARD,2,Gael Monfils,N/A Bye,Gael Monfils,,R128,0,0,0,0,0,0,0,0,0,0,0,0,0,0,0,0,0,0,0,0,0,0,0,0,0,0,0
2006-03-20 00:00:00.000,ATP Masters Series Miami FL; U.S.A. ATP World Tour,HARD,2,Agustin Calleri,Juan Monaco,Agustin Calleri,6-2; 6-1,R128,62,2,3,29,51,22,29,13,22,1,1,8,35,51,2,0,23,44,11,23,9,21,2,6,7,20,44
2006-03-20 00:00:00.000,ATP Masters Series Miami FL; U.S.A. ATP World Tour,HARD,2,Carlos Moya,Victor Hanescu,Carlos Moya,5-7; 7-5; 6-4,R128,120,2,3,49,89,39,49,27,40,3,4,17,66,89,7,2,62,92,43,62,20,30,2,4,17,63,92
2006-03-20 00:00:00.000,ATP Masters Series Miami FL; U.S.A. ATP World Tour,HARD,2,Rafael Nadal,N/A Bye,Rafael Nadal,,R128,0,0,0,0,0,0,0,0,0,0,0,0,0,0,0,0,0,0,0,0,0,0,0,0,0,0,0
2006-03-20 00:00:00.000,ATP Masters Series Miami FL; U.S.A. ATP World Tour,HARD,2,Roger Federer,Arnaud Clement,Roger Federer,6-2; 6-7(4); 6-0,R64,119,6,2,60,94,44,60,16,34,3,4,13,60,94,2,3,39,75,22,39,19,36,3,9,13,41,75
2006-03-20 00:00:00.000,ATP Masters Series Miami FL; U.S.A. ATP World Tour,HARD,2,Tommy Haas,Luis Horna,Tommy Haas,6-0; 6-3,R64,59,5,3,27,46,23,27,10,19,2,2,8,33,46,5,7,27,42,19,27,3,15,4,8,7,22,42
2006-03-20 00:00:00.000,ATP Masters Series Miami FL; U.S.A. ATP World Tour,HARD,2,Igor Andreev,George Bastl,Igor Andreev,6-4; 6-4,R64,78,4,0,29,51,20,29,17,22,2,4,10,37,51,2,1,36,61,23,36,9,25,3,7,10,32,61
2006-03-20 00:00:00.000,ATP Masters Series Miami FL; U.S.A. ATP World Tour,HARD,2,Dmitry Tursunov,Juan Carlos Ferrero,Dmitry Tursunov,6-3; 7-6(0),R64,87,5,3,40,71,28,40,21,31,3,4,11,49,71,5,4,41,70,28,41,13,29,0,2,10,41,70
2006-03-20 00:00:00.000,ATP Masters Series Miami FL; U.S.A. ATP World Tour,HARD,2,James Blake,Carlos Berlocq,James Blake,6-0; 6-0,R64,54,2,1,21,35,16,21,10,14,2,2,6,26,35,1,4,22,44,11,22,4,22,6,12,6,15,44
2006-03-20 00:00:00.000,ATP Masters Series Miami FL; U.S.A. ATP World Tour,HARD,2,Jarkko Nieminen,Mark Philippoussis,Jarkko Nieminen,6-4; 7-6(3),R64,91,4,2,47,68,31,47,14,21,4,6,11,45,68,10,5,33,73,24,33,17,40,3,6,11,41,73
2006-03-20 00:00:00.000,ATP Masters Series Miami FL; U.S.A. ATP World Tour,HARD,2,Juan Ignacio Chela,Greg Rusedski,Juan Ignacio Chela,6-4; 6-4,R64,81,1,2,31,52,25,31,13,21,1,2,10,38,52,5,6,51,74,33,51,10,23,6,9,10,43,74
2006-03-20 00:00:00.000,ATP Masters Series Miami FL; U.S.A. ATP World Tour,HARD,2,Kristof Vliegen,Gaston Gaudio,Kristof Vliegen,7-5; 7-6(6),R64,114,8,3,53,84,39,53,18,31,2,3,12,57,84,2,5,44,84,32,44,21,40,1,3,12,53,84
2006-03-20 00:00:00.000,ATP Masters Series Miami FL; U.S.A. ATP World Tour,HARD,2,Andy Roddick,Alberto Martin,Andy Roddick,6-3; 6-1,R64,56,10,0,28,42,26,28,7,14,0,0,8,33,42,0,3,30,50,15,30,10,20,3,7,8,25,50
2006-03-20 00:00:00.000,ATP Masters Series Miami FL; U.S.A. ATP World Tour,HARD,2,Fernando Verdasco,Vincent Spadea,Fernando Verdasco,1-6; 6-4; 6-3,R64,100,6,7,43,75,27,43,10,32,2,8,13,37,75,4,4,34,67,23,34,14,33,1,7,13,37,67
2006-03-20 00:00:00.000,ATP Masters Series Miami FL; U.S.A. ATP World Tour,HARD,2,Simon Greul,Dominik Hrbaty,Simon Greul,7-6(6); 6-3,R64,95,7,3,45,87,32,45,18,42,4,8,11,50,87,4,7,40,68,25,40,9,28,5,10,10,34,68
2006-03-20 00:00:00.000,ATP Masters Series Miami FL; U.S.A. ATP World Tour,HARD,2,Tim Henman,Lleyton Hewitt,Tim Henman,7-6(5); 6-3,R64,107,3,1,47,79,36,47,11,32,2,5,11,47,79,3,4,41,73,28,41,11,32,5,9,10,39,73
2006-03-20 00:00:00.000,ATP Masters Series Miami FL; U.S.A. ATP World Tour,HARD,2,David Ferrer,Albert Montanes,David Ferrer,6-1; 6-1,R64,46,1,1,30,39,21,30,6,9,1,2,7,27,39,1,4,15,40,7,15,7,25,5,11,7,14,40
2006-03-20 00:00:00.000,ATP Masters Series Miami FL; U.S.A. ATP World Tour,HARD,2,Sebastien Grosjean,Feliciano Lopez,Sebastien Grosjean,6-3; 7-6(6),R64,91,6,2,34,64,25,34,21,30,1,2,11,46,64,5,3,46,70,35,46,9,24,3,5,10,44,70
2006-03-20 00:00:00.000,ATP Masters Series Miami FL; U.S.A. ATP World Tour,HARD,2,Olivier Rochus,Max Mirnyi,Olivier Rochus,6-4; 3-6; 6-1,R64,118,0,3,78,104,51,78,12,26,14,16,13,63,104,7,5,43,87,33,43,19,44,5,9,13,52,87
2006-03-20 00:00:00.000,ATP Masters Series Miami FL; U.S.A. ATP World Tour,HARD,2,Guillermo Coria,Novak Djokovic,Guillermo Coria,7-5; 6-1,R64,88,1,0,39,52,24,39,10,13,0,2,9,34,52,2,6,43,82,24,43,15,39,12,18,10,39,82
2006-03-20 00:00:00.000,ATP Masters Series Miami FL; U.S.A. ATP World Tour,HARD,2,Nikolay Davydenko,Mardy Fish,Nikolay Davydenko,6-4; 7-5,R64,96,1,3,39,60,29,39,13,21,0,1,11,42,60,6,3,42,85,26,42,22,43,4,7,11,48,85
2006-03-20 00:00:00.000,ATP Masters Series Miami FL; U.S.A. ATP World Tour,HARD,2,Marcos Baghdatis,Alex Bogomolov Jr.,Marcos Baghdatis,6-2; 6-4,R64,63,7,0,27,49,19,27,16,22,0,1,9,35,49,0,4,34,51,19,34,8,17,2,6,9,27,51
2006-03-20 00:00:00.000,ATP Masters Series Miami FL; U.S.A. ATP World Tour,HARD,2,Mario Ancic,Kevin Kim,Mario Ancic,6-3; 2-6; 6-4,R64,104,12,1,53,79,39,53,9,26,1,5,14,48,79,3,5,60,89,39,60,12,29,4,8,13,51,89
2006-03-20 00:00:00.000,ATP Masters Series Miami FL; U.S.A. ATP World Tour,HARD,2,Florent Serra,Richard Gasquet,Florent Serra,7-6(7); 6-3,R64,87,4,0,45,79,33,45,21,34,3,4,11,54,79,7,2,42,64,31,42,12,22,1,3,10,43,64
2006-03-20 00:00:00.000,ATP Masters Series Miami FL; U.S.A. ATP World Tour,HARD,2,Radek Stepanek,Xavier Malisse,Radek Stepanek,6-1; 6-4,R64,69,4,1,37,55,28,37,12,18,2,2,9,40,55,1,0,38,59,22,38,10,21,6,9,8,32,59
2006-03-20 00:00:00.000,ATP Masters Series Miami FL; U.S.A. ATP World Tour,HARD,2,Nicolas Massu,Tommy Robredo,Nicolas Massu,6-4; 6-4,R64,86,1,2,42,58,32,42,8,16,1,2,10,40,58,1,2,43,67,29,43,10,24,6,9,10,39,67
2006-03-20 00:00:00.000,ATP Masters Series Miami FL; U.S.A. ATP World Tour,HARD,2,Tomas Berdych,Jose Acasuso,Tomas Berdych,6-1; 6-2,R64,45,10,1,25,41,24,25,8,16,0,0,8,32,41,3,5,22,43,14,22,8,21,1,5,7,22,43
2006-03-20 00:00:00.000,ATP Masters Series Miami FL; U.S.A. ATP World Tour,HARD,2,David Nalbandian,Paul Goldstein,David Nalbandian,3-6; 7-5; 7-6(2),R64,170,2,6,77,120,50,77,21,43,12,17,16,71,120,1,4,64,122,40,64,32,58,10,15,17,72,122
2006-03-20 00:00:00.000,ATP Masters Series Miami FL; U.S.A. ATP World Tour,HARD,2,Ivan Ljubicic,Robin Vik,Ivan Ljubicic,6-3; 6-7(2); 6-3,R64,126,11,1,61,92,47,61,15,31,2,4,16,62,92,5,3,71,97,49,71,10,26,6,10,14,59,97
2006-03-20 00:00:00.000,ATP Masters Series Miami FL; U.S.A. ATP World Tour,HARD,2,Filippo Volandri,Michael Llodra,Filippo Volandri,3-6; 7-6(5); 6-2,R64,119,1,1,72,106,46,72,17,34,9,12,14,63,106,7,2,61,101,42,61,20,40,9,13,15,62,101
2006-03-20 00:00:00.000,ATP Masters Series Miami FL; U.S.A. ATP World Tour,HARD,2,Robby Ginepri,Kenneth Carlsen,Robby Ginepri,6-2; 7-5,R64,74,3,1,36,48,28,36,8,12,0,1,10,36,48,2,3,39,66,24,39,11,27,3,7,10,35,66
2006-03-20 00:00:00.000,ATP Masters Series Miami FL; U.S.A. ATP World Tour,HARD,2,Christophe Rochus,Bjorn Phau,Christophe Rochus,5-7; 6-4; 6-2,R64,122,3,7,74,111,52,74,16,37,10,13,15,68,111,8,6,49,99,34,49,20,50,6,11,15,54,99
2006-03-20 00:00:00.000,ATP Masters Series Miami FL; U.S.A. ATP World Tour,HARD,2,Nicolas Kiefer,Fabrice Santoro,Nicolas Kiefer,7-6(4); 2-6; 6-4,R64,150,6,2,56,94,37,56,19,38,7,12,15,56,94,7,4,59,119,40,59,27,60,12,16,15,67,119
2006-03-20 00:00:00.000,ATP Masters Series Miami FL; U.S.A. ATP World Tour,HARD,2,Fernando Gonzalez,Stanislas Wawrinka,Fernando Gonzalez,3-6; 6-2; 7-6(1),R64,105,4,1,50,77,36,50,15,27,1,4,14,51,77,3,11,45,85,34,45,18,40,2,6,15,52,85
2006-03-20 00:00:00.000,ATP Masters Series Miami FL; U.S.A. ATP World Tour,HARD,2,Agustin Calleri,Gael Monfils,Agustin Calleri,7-5; 6-4,R64,75,0,3,37,64,29,37,15,27,3,5,11,44,64,3,6,35,63,25,35,10,28,1,5,11,35,63
2006-03-20 00:00:00.000,ATP Masters Series Miami FL; U.S.A. ATP World Tour,HARD,2,Carlos Moya,Rafael Nadal,Carlos Moya,2-6; 6-1; 6-1,R64,103,6,2,42,67,32,42,10,25,0,3,11,42,67,2,3,47,74,27,47,11,27,6,12,11,38,74
2006-03-20 00:00:00.000,ATP Masters Series Miami FL; U.S.A. ATP World Tour,HARD,2,Roger Federer,Tommy Haas,Roger Federer,6-1; 6-3,R32,74,4,2,36,55,29,36,9,19,4,4,8,38,55,2,1,37,55,25,37,4,18,3,7,8,29,55
2006-03-20 00:00:00.000,ATP Masters Series Miami FL; U.S.A. ATP World Tour,HARD,2,Dmitry Tursunov,Igor Andreev,Dmitry Tursunov,6-3; 1-6; 6-4,R32,99,2,3,40,80,23,40,24,40,4,9,13,47,80,3,5,48,71,34,48,6,23,3,8,13,40,71
2006-03-20 00:00:00.000,ATP Masters Series Miami FL; U.S.A. ATP World Tour,HARD,2,James Blake,Jarkko Nieminen,James Blake,6-3; 4-6; 6-1,R32,98,12,1,44,85,32,44,22,41,8,11,13,54,85,2,5,59,100,35,59,16,41,13,19,13,51,100
2006-03-20 00:00:00.000,ATP Masters Series Miami FL; U.S.A. ATP World Tour,HARD,2,Juan Ignacio Chela,Kristof Vliegen,Juan Ignacio Chela,6-3; 7-6(3),R32,95,1,2,42,65,34,42,13,23,3,4,11,47,65,2,2,40,75,26,40,18,35,3,5,10,44,75
2006-03-20 00:00:00.000,ATP Masters Series Miami FL; U.S.A. ATP World Tour,HARD,2,Andy Roddick,Fernando Verdasco,Andy Roddick,6-3; 6-4,R32,69,8,1,39,51,32,39,7,12,2,3,10,39,51,5,3,39,56,28,39,5,17,4,7,9,33,56
2006-03-20 00:00:00.000,ATP Masters Series Miami FL; U.S.A. ATP World Tour,HARD,2,Simon Greul,Tim Henman,Simon Greul,0-6; 6-1; 7-5,R32,107,2,7,41,75,28,41,14,34,3,7,12,42,75,0,1,42,71,24,42,16,29,2,7,13,40,71
2006-03-20 00:00:00.000,ATP Masters Series Miami FL; U.S.A. ATP World Tour,HARD,2,David Ferrer,Sebastien Grosjean,David Ferrer,4-6; 7-5; 6-4,R32,168,1,5,80,116,50,80,16,36,5,11,16,66,116,6,2,48,106,32,48,25,58,11,18,16,57,106
2006-03-20 00:00:00.000,ATP Masters Series Miami FL; U.S.A. ATP World Tour,HARD,2,Olivier Rochus,Guillermo Coria,Olivier Rochus,6-4; 6-3,R32,84,1,4,34,50,26,34,9,16,3,4,9,35,50,0,6,55,67,33,55,1,12,3,7,10,34,67
2006-03-20 00:00:00.000,ATP Masters Series Miami FL; U.S.A. ATP World Tour,HARD,2,Nikolay Davydenko,Marcos Baghdatis,Nikolay Davydenko,2-6; 6-2; 7-5,R32,129,0,2,76,98,45,76,11,22,3,8,14,56,98,11,7,46,92,32,46,17,46,4,10,14,49,92
2006-03-20 00:00:00.000,ATP Masters Series Miami FL; U.S.A. ATP World Tour,HARD,2,Mario Ancic,Florent Serra,Mario Ancic,7-6(4); 6-7(11); 6-2,R32,171,17,4,69,106,56,69,18,37,2,4,16,74,106,4,3,63,116,45,63,29,53,4,8,16,74,116
2006-03-20 00:00:00.000,ATP Masters Series Miami FL; U.S.A. ATP World Tour,HARD,2,Radek Stepanek,Nicolas Massu,Radek Stepanek,6-7(6); 7-6(5); 7-5,R32,191,17,6,84,129,63,84,25,45,5,7,18,88,129,6,0,73,117,48,73,31,44,5,8,18,79,117
2006-03-20 00:00:00.000,ATP Masters Series Miami FL; U.S.A. ATP World Tour,HARD,2,David Nalbandian,Tomas Berdych,David Nalbandian,6-7(3); 6-1; 6-0,R32,125,2,1,65,90,45,65,17,25,2,2,13,62,90,6,8,43,92,30,43,21,49,7,12,12,51,92
2006-03-20 00:00:00.000,ATP Masters Series Miami FL; U.S.A. ATP World Tour,HARD,2,Ivan Ljubicic,Filippo Volandri,Ivan Ljubicic,6-2; 6-3,R32,55,11,0,28,41,24,28,7,13,0,2,9,31,41,0,1,37,54,17,37,7,17,5,10,8,24,54
2006-03-20 00:00:00.000,ATP Masters Series Miami FL; U.S.A. ATP World Tour,HARD,2,Christophe Rochus,Robby Ginepri,Christophe Rochus,4-6; 7-5; 6-3,R32,121,4,7,53,95,38,53,22,42,6,9,15,60,95,13,5,51,111,40,51,24,60,6,11,16,64,111
2006-03-20 00:00:00.000,ATP Masters Series Miami FL; U.S.A. ATP World Tour,HARD,2,Nicolas Kiefer,Fernando Gonzalez,Nicolas Kiefer,6-2; 3-6; 7-5,R32,143,5,4,52,99,36,52,25,47,7,11,14,61,99,5,8,43,85,28,43,20,42,5,11,15,48,85
2006-03-20 00:00:00.000,ATP Masters Series Miami FL; U.S.A. ATP World Tour,HARD,2,Agustin Calleri,Carlos Moya,Agustin Calleri,6-3; 7-6(6),R32,89,6,0,37,62,29,37,16,25,0,2,11,45,62,6,4,43,76,33,43,12,33,6,9,10,45,76
2006-03-20 00:00:00.000,ATP Masters Series Miami FL; U.S.A. ATP World Tour,HARD,2,Roger Federer,Dmitry Tursunov,Roger Federer,6-3; 6-3,R16,58,5,2,29,43,25,29,8,14,0,1,9,33,43,4,3,33,56,22,33,7,23,3,7,9,29,56
2006-03-20 00:00:00.000,ATP Masters Series Miami FL; U.S.A. ATP World Tour,HARD,2,James Blake,Juan Ignacio Chela,James Blake,4-6; 6-1; 6-0,R16,100,5,5,44,84,29,44,25,40,1,2,12,54,84,2,6,38,79,23,38,19,41,6,11,11,42,79
2006-03-20 00:00:00.000,ATP Masters Series Miami FL; U.S.A. ATP World Tour,HARD,2,Andy Roddick,Simon Greul,Andy Roddick,6-3; 3-6; 6-2,R16,94,9,0,43,63,36,43,15,20,1,2,13,51,63,4,5,48,83,31,48,19,35,3,6,13,50,83
2006-03-20 00:00:00.000,ATP Masters Series Miami FL; U.S.A. ATP World Tour,HARD,2,David Ferrer,Olivier Rochus,David Ferrer,6-7(5); 7-6(2); 7-5,R16,198,6,2,96,133,60,96,20,37,6,10,18,80,133,1,1,85,132,51,85,23,47,4,9,18,74,132
2006-03-20 00:00:00.000,ATP Masters Series Miami FL; U.S.A. ATP World Tour,HARD,2,Mario Ancic,Nikolay Davydenko,Mario Ancic,7-5; 6-4,R16,88,9,0,41,58,29,41,11,17,4,6,11,40,58,2,1,48,63,28,48,7,15,2,6,11,35,63
2006-03-20 00:00:00.000,ATP Masters Series Miami FL; U.S.A. ATP World Tour,HARD,2,David Nalbandian,Radek Stepanek,David Nalbandian,6-3; 6-4,R16,90,0,2,46,73,30,46,13,27,4,6,10,43,73,0,7,19,49,13,19,12,30,0,4,9,25,49
2006-03-20 00:00:00.000,ATP Masters Series Miami FL; U.S.A. ATP World Tour,HARD,2,Ivan Ljubicic,Christophe Rochus,Ivan Ljubicic,6-3; 6-1,R16,57,13,0,28,48,23,28,9,20,3,4,8,32,48,0,1,33,41,18,33,1,8,2,7,8,19,41
2006-03-20 00:00:00.000,ATP Masters Series Miami FL; U.S.A. ATP World Tour,HARD,2,Agustin Calleri,Nicolas Kiefer,Agustin Calleri,3-6; 6-3; 7-5,R16,136,11,2,54,95,41,54,25,41,3,4,15,66,95,8,4,53,92,37,53,21,39,3,5,15,58,92
2006-03-20 00:00:00.000,ATP Masters Series Miami FL; U.S.A. ATP World Tour,HARD,2,Roger Federer,James Blake,Roger Federer,7-6(2); 6-4,Q,87,6,1,46,78,32,46,22,32,2,3,11,54,78,4,4,36,71,29,36,17,35,2,4,11,46,71
2006-03-20 00:00:00.000,ATP Masters Series Miami FL; U.S.A. ATP World Tour,HARD,2,David Ferrer,Andy Roddick,David Ferrer,6-3; 4-6; 6-4,Q,112,0,1,54,84,40,54,15,30,2,5,15,55,84,10,2,50,80,39,50,10,30,4,8,14,49,80
2006-03-20 00:00:00.000,ATP Masters Series Miami FL; U.S.A. ATP World Tour,HARD,2,David Nalbandian,Mario Ancic,David Nalbandian,6-2; 6-2,Q,57,3,0,32,41,28,32,6,9,1,1,8,34,41,7,3,23,41,13,23,6,18,0,4,8,19,41
2006-03-20 00:00:00.000,ATP Masters Series Miami FL; U.S.A. ATP World Tour,HARD,2,Ivan Ljubicic,Agustin Calleri,Ivan Ljubicic,7-6(4); 6-3,Q,100,14,3,37,57,36,37,10,20,0,0,10,46,57,2,4,47,83,35,47,18,36,6,8,11,53,83
2006-03-20 00:00:00.000,ATP Masters Series Miami FL; U.S.A. ATP World Tour,HARD,2,Roger Federer,David Ferrer,Roger Federer,6-1; 6-4,S,60,2,1,35,52,27,35,10,17,2,3,9,37,52,0,2,38,52,21,38,6,14,1,5,8,27,52
2006-03-20 00:00:00.000,ATP Masters Series Miami FL; U.S.A. ATP World Tour,HARD,2,Ivan Ljubicic,David Nalbandian,Ivan Ljubicic,6-1; 6-2,S,73,12,0,26,37,25,26,7,11,0,0,8,32,37,1,0,47,66,20,47,12,19,13,17,7,32,66
2006-03-20 00:00:00.000,ATP Masters Series Miami FL; U.S.A. ATP World Tour,HARD,2,Roger Federer,Ivan Ljubicic,Roger Federer,7-6(5); 7-6(4); 7-6(6),F,177,8,3,78,124,58,78,29,46,5,7,18,87,124,21,3,68,121,53,68,31,53,5,7,18,84,121
2006-04-10 00:00:00.000,Houston TX; U.S.A. ATP World Tour,CLAY,2,Andy Roddick,Paul Capdeville,Andy Roddick,6-3; 6-2,R32,59,3,0,30,46,21,30,13,16,0,1,9,34,46,1,2,33,53,20,33,6,20,4,8,8,26,53
2006-04-10 00:00:00.000,Houston TX; U.S.A. ATP World Tour,CLAY,2,Oliver Marach,Juan Antonio Marin,Oliver Marach,6-4; 6-1,R32,80,8,3,30,52,27,30,9,22,3,3,8,36,52,3,1,26,56,20,26,11,30,2,6,9,31,56
2006-04-10 00:00:00.000,Houston TX; U.S.A. ATP World Tour,CLAY,2,Alexander Waske,Jiri Vanek,Alexander Waske,6-4; 2-6; 7-6(2),R32,156,10,7,52,105,41,52,23,53,3,7,15,64,105,2,5,73,104,47,73,18,31,6,9,15,65,104
2006-04-10 00:00:00.000,Houston TX; U.S.A. ATP World Tour,CLAY,2,Tommy Haas,Oscar Hernandez,Tommy Haas,6-1; 6-4,R32,74,5,4,31,55,21,31,16,24,1,2,9,37,55,0,6,32,52,19,32,8,20,3,7,8,27,52
2006-04-10 00:00:00.000,Houston TX; U.S.A. ATP World Tour,CLAY,2,Marcos Baghdatis,Jesse Witten,Marcos Baghdatis,6-4; 7-6(2),R32,77,2,3,39,64,31,39,15,25,2,3,11,46,64,1,0,34,60,27,34,15,26,2,4,11,42,60
2006-04-10 00:00:00.000,Houston TX; U.S.A. ATP World Tour,CLAY,2,Vincent Spadea,Carlos Berlocq,Vincent Spadea,6-1; 6-3,R32,67,2,1,22,45,16,22,13,23,3,5,8,29,45,0,3,28,54,15,28,8,26,4,10,8,23,54
2006-04-10 00:00:00.000,Houston TX; U.S.A. ATP World Tour,CLAY,2,Rainer Schuettler,Gilles Muller,Rainer Schuettler,6-0; 6-3,R32,65,2,2,21,40,17,21,12,19,1,2,8,29,40,2,1,28,56,16,28,9,28,5,10,7,25,56
2006-04-10 00:00:00.000,Houston TX; U.S.A. ATP World Tour,CLAY,2,Mardy Fish,Juan Monaco,Mardy Fish,6-2; 1-6; 7-6(5),R32,149,12,4,65,115,44,65,25,50,15,18,13,69,115,1,0,78,106,50,78,13,28,8,11,14,63,106
2006-04-10 00:00:00.000,Houston TX; U.S.A. ATP World Tour,CLAY,2,Paul Goldstein,Janko Tipsarevic,Paul Goldstein,6-3; 6-3,R32,72,1,1,36,50,27,36,8,14,1,2,9,35,50,3,1,30,56,23,30,7,26,2,6,9,30,56
2006-04-10 00:00:00.000,Houston TX; U.S.A. ATP World Tour,CLAY,2,Scoville Jenkins,Igor Kunitsyn,Scoville Jenkins,7-5; 2-6; 6-3,R32,143,6,5,62,93,44,62,13,31,4,8,15,57,93,3,2,65,98,40,65,18,33,6,10,14,58,98
2006-04-10 00:00:00.000,Houston TX; U.S.A. ATP World Tour,CLAY,2,Tomas Behrend,Razvan Sabau,Tomas Behrend,7-5; 5-7; 7-5,R32,141,7,8,69,124,47,69,25,55,1,7,18,72,124,0,6,77,117,49,77,16,40,8,15,18,65,117
2006-04-10 00:00:00.000,Houston TX; U.S.A. ATP World Tour,CLAY,2,Albert Montanes,Robby Ginepri,Albert Montanes,6-4; 6-4,R32,99,3,3,33,62,28,33,13,29,4,6,10,41,62,4,1,46,68,30,46,6,22,4,8,10,36,68
2006-04-10 00:00:00.000,Houston TX; U.S.A. ATP World Tour,CLAY,2,Marcos Daniel,Luis Horna,Marcos Daniel,6-3; 6-4,R32,83,4,0,34,65,23,34,21,31,2,3,10,44,65,1,3,27,49,20,27,9,22,5,8,9,29,49
2006-04-10 00:00:00.000,Houston TX; U.S.A. ATP World Tour,CLAY,2,Jurgen Melzer,Ivo Minar,Jurgen Melzer,7-6(7); 6-0,R32,67,4,2,30,62,22,30,20,32,1,2,9,42,62,4,4,37,62,23,37,10,25,2,6,9,33,62
2006-04-10 00:00:00.000,Houston TX; U.S.A. ATP World Tour,CLAY,2,Fernando Vicente,Bobby Reynolds,Fernando Vicente,6-2; 6-1,R32,55,2,0,25,42,21,25,12,17,2,2,8,33,42,2,2,27,41,17,27,4,14,1,5,7,21,41
2006-04-10 00:00:00.000,Houston TX; U.S.A. ATP World Tour,CLAY,2,Antony Dupuis,James Blake,Antony Dupuis,7-6(2); 3-6; 6-1,R32,107,9,4,58,93,43,58,20,35,6,8,14,63,93,3,1,38,74,27,38,23,36,1,4,14,50,74
2006-04-10 00:00:00.000,Houston TX; U.S.A. ATP World Tour,CLAY,2,Andy Roddick,Oliver Marach,Andy Roddick,6-3; 6-4,R16,80,5,1,47,67,36,47,12,20,6,6,10,48,67,5,4,27,51,24,27,10,24,1,3,9,34,51
2006-04-10 00:00:00.000,Houston TX; U.S.A. ATP World Tour,CLAY,2,Tommy Haas,Alexander Waske,Tommy Haas,6-1; 7-6(7),R16,84,3,1,36,67,28,36,17,31,1,3,10,45,67,2,4,38,64,25,38,9,26,3,7,9,34,64
2006-04-10 00:00:00.000,Houston TX; U.S.A. ATP World Tour,CLAY,2,Vincent Spadea,Marcos Baghdatis,Vincent Spadea,6-2; 3-1 RET,R16,47,2,0,17,31,13,17,7,14,0,1,6,20,31,1,1,21,39,10,21,7,18,1,5,6,17,39
2006-04-10 00:00:00.000,Houston TX; U.S.A. ATP World Tour,CLAY,2,Mardy Fish,Rainer Schuettler,Mardy Fish,W/O,R16,0,0,0,0,0,0,0,0,0,0,0,0,0,0,0,0,0,0,0,0,0,0,0,0,0,0,0
2006-04-10 00:00:00.000,Houston TX; U.S.A. ATP World Tour,CLAY,2,Paul Goldstein,Scoville Jenkins,Paul Goldstein,6-4; 6-1,R16,79,1,1,37,47,28,37,6,10,1,1,8,34,47,4,4,41,67,21,41,13,26,5,9,9,34,67
2006-04-10 00:00:00.000,Houston TX; U.S.A. ATP World Tour,CLAY,2,Albert Montanes,Tomas Behrend,Albert Montanes,6-2; 6-3,R16,70,5,8,26,52,21,26,13,26,1,2,8,34,52,3,5,41,69,24,41,10,28,0,5,9,34,69
2006-04-10 00:00:00.000,Houston TX; U.S.A. ATP World Tour,CLAY,2,Jurgen Melzer,Marcos Daniel,Jurgen Melzer,7-6(2); 6-4,R16,90,0,3,35,71,25,35,20,36,1,4,11,45,71,3,1,37,62,22,37,14,25,2,6,11,36,62
2006-04-10 00:00:00.000,Houston TX; U.S.A. ATP World Tour,CLAY,2,Fernando Vicente,Antony Dupuis,Fernando Vicente,6-2; 7-5,R16,88,2,1,36,58,25,36,14,22,5,7,10,39,58,3,1,34,69,17,34,18,35,4,9,10,35,69
2006-04-10 00:00:00.000,Houston TX; U.S.A. ATP World Tour,CLAY,2,Tommy Haas,Andy Roddick,Tommy Haas,6-7(1); 6-4; 6-4,Q,131,6,5,59,105,44,59,24,46,6,8,16,68,105,11,3,59,92,43,59,15,33,5,9,16,58,92
2006-04-10 00:00:00.000,Houston TX; U.S.A. ATP World Tour,CLAY,2,Mardy Fish,Vincent Spadea,Mardy Fish,4-6; 7-6(1); 6-2,Q,141,4,3,58,110,38,58,27,52,10,15,15,65,110,1,5,53,103,35,53,22,50,7,13,15,57,103
2006-04-10 00:00:00.000,Houston TX; U.S.A. ATP World Tour,CLAY,2,Paul Goldstein,Albert Montanes,Paul Goldstein,6-3; 6-4,Q,78,1,1,57,77,36,57,10,20,5,7,10,46,77,3,6,27,50,19,27,7,23,0,4,9,26,50
2006-04-10 00:00:00.000,Houston TX; U.S.A. ATP World Tour,CLAY,2,Jurgen Melzer,Fernando Vicente,Jurgen Melzer,7-5; 6-4,Q,97,1,2,61,79,36,61,9,18,8,11,11,45,79,1,2,40,72,23,40,13,32,3,8,11,36,72
2006-04-10 00:00:00.000,Houston TX; U.S.A. ATP World Tour,CLAY,2,Mardy Fish,Tommy Haas,Mardy Fish,4-1 RET,S,18,3,0,10,14,9,10,3,4,0,0,3,12,14,2,0,12,16,6,12,2,4,3,4,2,8,16
2006-04-10 00:00:00.000,Houston TX; U.S.A. ATP World Tour,CLAY,2,Jurgen Melzer,Paul Goldstein,Jurgen Melzer,6-3; 6-4,S,70,5,2,37,56,26,37,10,19,2,5,10,36,56,0,2,30,53,16,30,10,23,5,10,9,26,53
2006-04-10 00:00:00.000,Houston TX; U.S.A. ATP World Tour,CLAY,2,Mardy Fish,Jurgen Melzer,Mardy Fish,3-6; 6-4; 6-3,F,112,6,6,46,81,39,46,17,35,4,6,14,56,81,1,3,58,80,41,58,9,22,6,9,14,50,80
2006-04-10 00:00:00.000,Valencia Spain ATP World Tour,CLAY,2,Jan Hernych,Nikolay Davydenko,Jan Hernych,7-5; 7-5,R32,109,0,3,46,77,30,46,13,31,3,7,12,43,77,0,2,52,73,31,52,6,21,3,9,12,37,73
2006-04-10 00:00:00.000,Valencia Spain ATP World Tour,CLAY,2,Guillermo Garcia-Lopez,Feliciano Lopez,Guillermo Garcia-Lopez,6-3; 6-3,R32,76,3,7,42,71,27,42,9,29,6,11,10,36,71,1,1,33,61,21,33,12,28,3,7,9,33,61
2006-04-10 00:00:00.000,Valencia Spain ATP World Tour,CLAY,2,Potito Starace,Lukas Dlouhy,Potito Starace,6-3; 6-3,R32,52,2,0,40,46,29,40,4,6,0,1,9,33,46,0,4,33,52,20,33,8,19,4,8,9,28,52
2006-04-10 00:00:00.000,Valencia Spain ATP World Tour,CLAY,2,Fernando Verdasco,Alberto Martin,Fernando Verdasco,6-3; 6-4,R32,89,3,1,44,66,30,44,11,22,5,7,10,41,66,4,3,39,64,23,39,10,25,7,11,9,33,64
2006-04-10 00:00:00.000,Valencia Spain ATP World Tour,CLAY,2,Thierry Ascione,David Ferrer,Thierry Ascione,7-6(1) RET,R32,46,0,1,26,42,17,26,7,16,4,6,6,24,42,1,2,29,34,18,29,0,5,0,2,6,18,34
2006-04-10 00:00:00.000,Valencia Spain ATP World Tour,CLAY,2,Andreas Seppi,Ruben Ramirez Hidalgo,Andreas Seppi,6-2; 6-2,R32,66,2,2,25,46,16,25,9,21,2,5,8,25,46,6,0,30,45,25,30,11,15,0,0,9,36,45
2006-04-10 00:00:00.000,Valencia Spain ATP World Tour,CLAY,2,Gilles Simon,Robin Vik,Gilles Simon,6-3; 6-2,R32,65,3,0,24,48,19,24,14,24,0,2,9,33,48,0,5,42,66,24,42,8,24,5,10,8,32,66
2006-04-10 00:00:00.000,Valencia Spain ATP World Tour,CLAY,2,Davide Sanguinetti,Teymuraz Gabashvili,Davide Sanguinetti,6-7(4); 6-4; 6-3,R32,129,3,1,42,108,31,42,34,66,7,11,16,65,108,1,5,57,101,31,57,25,44,10,16,15,56,101
2006-04-10 00:00:00.000,Valencia Spain ATP World Tour,CLAY,2,Filippo Volandri,Albert Portas,Filippo Volandri,6-0; 6-1,R32,45,0,0,26,37,22,26,8,11,1,1,7,30,37,2,3,15,40,10,15,6,25,3,8,6,16,40
2006-04-10 00:00:00.000,Valencia Spain ATP World Tour,CLAY,2,Tomas Zib,Andrei Pavel,Tomas Zib,7-5; 6-3,R32,93,3,1,48,73,32,48,13,25,4,6,10,45,73,3,4,42,77,24,42,15,35,5,10,11,39,77
2006-04-10 00:00:00.000,Valencia Spain ATP World Tour,CLAY,2,Bjorn Phau,Gorka Fraile,Bjorn Phau,7-6(1); 6-7(4); 6-2,R32,135,5,2,60,116,46,60,28,56,5,8,16,74,116,1,1,82,94,51,82,6,12,2,7,16,57,94
2006-04-10 00:00:00.000,Valencia Spain ATP World Tour,CLAY,2,Nicolas Almagro,Juan Carlos Ferrero,Nicolas Almagro,6-7(3); 6-4; 6-4,R32,160,5,5,69,110,50,69,22,41,7,8,16,72,110,4,3,78,109,55,78,12,31,11,14,16,67,109
2006-04-10 00:00:00.000,Valencia Spain ATP World Tour,CLAY,2,Marat Safin,Igor Andreev,Marat Safin,7-6(6); 6-4,R32,111,3,3,48,74,35,48,17,26,4,6,11,52,74,0,3,62,91,38,62,15,29,5,8,11,53,91
2006-04-10 00:00:00.000,Valencia Spain ATP World Tour,CLAY,2,Boris Pashanski,Albert Costa,Boris Pashanski,3-6; 6-3; 6-4,R32,116,0,1,32,56,23,32,11,24,5,7,9,34,56,0,3,35,53,17,35,5,18,4,10,9,22,53
2006-04-10 00:00:00.000,Valencia Spain ATP World Tour,CLAY,2,Florian Mayer,Guillem Burniol,Florian Mayer,6-0; 6-3,R32,51,5,2,36,49,26,36,7,13,7,8,8,33,49,2,2,25,45,13,25,5,20,8,13,7,18,45
2006-04-10 00:00:00.000,Valencia Spain ATP World Tour,CLAY,2,Gaston Gaudio,Raemon Sluiter,Gaston Gaudio,7-6(6); 7-6(3),R32,114,4,6,68,98,51,68,10,30,5,7,12,61,98,10,0,55,89,37,55,17,34,4,6,12,54,89
2006-04-10 00:00:00.000,Valencia Spain ATP World Tour,CLAY,2,Guillermo Garcia-Lopez,Jan Hernych,Guillermo Garcia-Lopez,6-2; 6-4,R16,67,2,4,47,81,27,47,17,34,9,13,10,44,81,2,4,45,74,35,45,13,29,7,9,11,48,74
2006-04-10 00:00:00.000,Valencia Spain ATP World Tour,CLAY,2,Fernando Verdasco,Potito Starace,Fernando Verdasco,6-3; 7-6(4),R16,93,1,3,65,83,46,65,10,18,6,7,11,56,83,3,0,50,70,35,50,10,20,4,6,10,45,70
2006-04-10 00:00:00.000,Valencia Spain ATP World Tour,CLAY,2,Andreas Seppi,Thierry Ascione,Andreas Seppi,1-6; 6-1; 6-2,R16,91,7,3,50,77,35,50,14,27,6,8,11,49,77,2,3,46,69,30,46,9,23,5,9,11,39,69
2006-04-10 00:00:00.000,Valencia Spain ATP World Tour,CLAY,2,Gilles Simon,Davide Sanguinetti,Gilles Simon,3-6; 7-5; 6-3,R16,114,4,1,45,81,32,45,20,36,4,8,15,52,81,0,4,59,108,37,59,24,49,8,13,15,61,108
2006-04-10 00:00:00.000,Valencia Spain ATP World Tour,CLAY,2,Filippo Volandri,Tomas Zib,Filippo Volandri,6-4; 6-4,R16,71,1,1,34,52,28,34,14,18,2,2,10,42,52,4,0,46,69,30,46,11,23,7,9,10,41,69
2006-04-10 00:00:00.000,Valencia Spain ATP World Tour,CLAY,2,Nicolas Almagro,Bjorn Phau,Nicolas Almagro,6-2; 6-1,R16,68,2,1,36,53,29,36,8,17,6,6,8,37,53,2,3,31,61,18,31,12,30,12,16,7,30,61
2006-04-10 00:00:00.000,Valencia Spain ATP World Tour,CLAY,2,Marat Safin,Boris Pashanski,Marat Safin,6-2; 6-2,R16,55,2,1,25,42,22,25,11,17,1,1,8,33,42,1,3,31,51,19,31,7,20,3,7,8,26,51
2006-04-10 00:00:00.000,Valencia Spain ATP World Tour,CLAY,2,Gaston Gaudio,Florian Mayer,Gaston Gaudio,6-4; 6-2,R16,68,4,1,35,49,24,35,9,14,0,2,9,33,49,2,3,35,65,18,35,14,30,4,9,9,32,65
2006-04-10 00:00:00.000,Valencia Spain ATP World Tour,CLAY,2,Fernando Verdasco,Guillermo Garcia-Lopez,Fernando Verdasco,6-7(2); 6-4; 6-3,Q,157,2,1,71,95,48,71,19,24,6,8,16,67,95,1,3,84,114,51,84,17,30,9,13,15,68,114
2006-04-10 00:00:00.000,Valencia Spain ATP World Tour,CLAY,2,Gilles Simon,Andreas Seppi,Gilles Simon,7-6(2); 7-6(4),Q,106,2,2,44,85,34,44,26,41,4,5,12,60,85,6,2,38,77,32,38,23,39,2,3,12,55,77
2006-04-10 00:00:00.000,Valencia Spain ATP World Tour,CLAY,2,Nicolas Almagro,Filippo Volandri,Nicolas Almagro,6-4; 6-1,Q,71,3,1,52,73,35,52,12,21,4,4,9,47,73,0,0,31,49,16,31,10,18,2,5,8,26,49
2006-04-10 00:00:00.000,Valencia Spain ATP World Tour,CLAY,2,Marat Safin,Gaston Gaudio,Marat Safin,6-4; 6-4,Q,81,4,0,41,61,32,41,13,20,4,4,10,45,61,0,3,40,61,25,40,12,21,3,5,10,37,61
2006-04-10 00:00:00.000,Valencia Spain ATP World Tour,CLAY,2,Gilles Simon,Fernando Verdasco,Gilles Simon,6-2; 7-6(5),S,99,5,1,41,65,30,41,12,24,2,4,10,42,65,1,6,47,72,29,47,9,25,6,10,10,38,72
2006-04-10 00:00:00.000,Valencia Spain ATP World Tour,CLAY,2,Nicolas Almagro,Marat Safin,Nicolas Almagro,6-2; 2-6; 6-4,S,134,3,1,56,90,37,56,17,34,8,11,13,54,90,10,3,50,93,38,50,14,43,7,11,13,52,93
2006-04-10 00:00:00.000,Valencia Spain ATP World Tour,CLAY,2,Nicolas Almagro,Gilles Simon,Nicolas Almagro,6-2; 6-3,F,79,7,0,43,66,32,43,12,23,6,6,8,44,66,2,1,25,64,14,25,18,39,6,10,9,32,64
2006-04-17 00:00:00.000,ATP Masters Series Monte Carlo Monaco ATP World Tour,CLAY,2,Roger Federer,Novak Djokovic,Roger Federer,6-3; 2-6; 6-3,R64,109,1,0,39,73,28,39,21,34,0,2,13,49,73,1,4,61,94,36,61,19,33,8,11,13,55,94
2006-04-17 00:00:00.000,ATP Masters Series Monte Carlo Monaco ATP World Tour,CLAY,2,Alberto Martin,Ivo Karlovic,Alberto Martin,6-4; 7-6(3),R64,83,1,1,45,61,34,45,12,16,1,2,11,46,61,6,4,33,71,28,33,16,38,3,5,11,44,71
2006-04-17 00:00:00.000,ATP Masters Series Monte Carlo Monaco ATP World Tour,CLAY,2,Benjamin Balleret,Christophe Rochus,Benjamin Balleret,6-3; 6-3,R64,62,4,5,33,55,24,33,7,22,3,6,9,31,55,0,7,31,50,15,31,6,19,1,7,9,21,50
2006-04-17 00:00:00.000,ATP Masters Series Monte Carlo Monaco ATP World Tour,CLAY,2,Sebastien Grosjean,Fernando Verdasco,Sebastien Grosjean,7-6(6); 6-3,R64,96,4,1,30,73,22,30,18,43,6,9,10,40,73,0,6,52,69,28,52,6,17,4,9,11,34,69
2006-04-17 00:00:00.000,ATP Masters Series Monte Carlo Monaco ATP World Tour,CLAY,2,Juan Carlos Ferrero,Dmitry Tursunov,Juan Carlos Ferrero,6-1; 6-2,R64,58,2,0,37,44,31,37,3,7,2,2,8,34,44,2,8,29,53,18,29,8,24,3,7,7,26,53
2006-04-17 00:00:00.000,ATP Masters Series Monte Carlo Monaco ATP World Tour,CLAY,2,Juan Ignacio Chela,Greg Rusedski,Juan Ignacio Chela,6-4; 6-7(5); 6-1,R64,126,1,3,39,91,32,39,27,52,8,11,14,59,91,5,6,53,99,32,53,19,46,3,10,15,51,99
2006-04-17 00:00:00.000,ATP Masters Series Monte Carlo Monaco ATP World Tour,CLAY,2,Dominik Hrbaty,Daniele Bracciali,Dominik Hrbaty,6-4; 3-6; 6-4,R64,123,2,7,48,85,35,48,13,37,2,7,15,48,85,4,2,44,93,28,44,25,49,8,13,14,53,93
2006-04-17 00:00:00.000,ATP Masters Series Monte Carlo Monaco ATP World Tour,CLAY,2,David Ferrer,Nicolas Massu,David Ferrer,6-0; 4-6; 6-2,R64,120,0,1,43,71,32,43,14,28,2,4,12,46,71,2,3,52,89,35,52,10,37,10,16,12,45,89
2006-04-17 00:00:00.000,ATP Masters Series Monte Carlo Monaco ATP World Tour,CLAY,2,Ivan Ljubicic,Igor Andreev,Ivan Ljubicic,6-3; 4-6; 6-2,R64,102,5,3,46,81,36,46,16,35,2,5,14,52,81,0,1,55,78,31,55,10,23,6,11,13,41,78
2006-04-17 00:00:00.000,ATP Masters Series Monte Carlo Monaco ATP World Tour,CLAY,2,Florent Serra,Paradorn Srichaphan,Florent Serra,6-1; 7-5,R64,71,1,4,28,61,19,28,21,33,2,3,9,40,61,5,4,28,57,18,28,12,29,1,6,10,30,57
2006-04-17 00:00:00.000,ATP Masters Series Monte Carlo Monaco ATP World Tour,CLAY,2,Gilles Simon,Teymuraz Gabashvili,Gilles Simon,6-4; 6-2,R64,73,3,1,25,59,20,25,18,34,8,10,9,38,59,2,2,27,56,17,27,9,29,0,5,9,26,56
2006-04-17 00:00:00.000,ATP Masters Series Monte Carlo Monaco ATP World Tour,CLAY,2,Tomas Berdych,Fabrice Santoro,Tomas Berdych,6-2; 6-4,R64,81,2,4,41,68,32,41,11,27,6,7,9,43,68,2,1,37,63,25,37,8,26,3,7,9,33,63
2006-04-17 00:00:00.000,ATP Masters Series Monte Carlo Monaco ATP World Tour,CLAY,2,Fernando Gonzalez,Carlos Moya,Fernando Gonzalez,6-3; 3-6; 6-1,R64,110,5,2,60,83,45,60,13,23,2,3,13,58,83,1,2,62,92,42,62,12,30,9,12,12,54,92
2006-04-17 00:00:00.000,ATP Masters Series Monte Carlo Monaco ATP World Tour,CLAY,2,Feliciano Lopez,Victor Hanescu,Feliciano Lopez,6-4; 4-6; 7-6(2),R64,123,8,4,57,91,39,57,19,34,1,5,16,58,91,9,2,68,104,45,68,16,36,4,8,16,61,104
2006-04-17 00:00:00.000,ATP Masters Series Monte Carlo Monaco ATP World Tour,CLAY,2,Potito Starace,Nicolas Mahut,Potito Starace,7-6(2); 6-2,R64,96,0,0,49,59,35,49,10,10,0,1,10,45,59,2,4,53,75,34,53,9,22,5,8,10,43,75
2006-04-17 00:00:00.000,ATP Masters Series Monte Carlo Monaco ATP World Tour,CLAY,2,Robin Soderling,Nikolay Davydenko,Robin Soderling,6-3; 2-6; 6-4,R64,112,5,7,46,89,29,46,18,43,5,11,14,47,89,1,4,57,80,32,57,11,23,3,9,13,43,80
2006-04-17 00:00:00.000,ATP Masters Series Monte Carlo Monaco ATP World Tour,CLAY,2,Gaston Gaudio,Tim Henman,Gaston Gaudio,6-1; 6-3,R64,86,0,2,36,58,23,36,10,22,4,6,8,33,58,5,2,27,57,16,27,7,30,4,10,8,23,57
2006-04-17 00:00:00.000,ATP Masters Series Monte Carlo Monaco ATP World Tour,CLAY,2,Jose Acasuso,Filippo Volandri,Jose Acasuso,6-4; 6-2,R64,78,2,2,26,61,17,26,22,35,3,4,9,39,61,0,2,27,42,17,27,6,15,0,4,9,23,42
2006-04-17 00:00:00.000,ATP Masters Series Monte Carlo Monaco ATP World Tour,CLAY,2,Alessio Di Mauro,Stanislas Wawrinka,Alessio Di Mauro,6-2; 6-4,R64,84,5,2,28,57,23,28,17,29,1,1,9,40,57,0,2,33,58,19,33,14,25,4,7,9,33,58
2006-04-17 00:00:00.000,ATP Masters Series Monte Carlo Monaco ATP World Tour,CLAY,2,Radek Stepanek,Evgeny Korolev,Radek Stepanek,6-2; 7-6(5),R64,92,5,1,33,63,26,33,18,30,3,4,10,44,63,5,3,42,77,28,42,17,35,10,13,10,45,77
2006-04-17 00:00:00.000,ATP Masters Series Monte Carlo Monaco ATP World Tour,CLAY,2,Tommy Robredo,Luis Horna,Tommy Robredo,6-3; 6-4,R64,91,3,0,53,72,38,53,12,19,3,3,10,50,72,1,2,32,56,21,32,12,24,4,6,9,33,56
2006-04-17 00:00:00.000,ATP Masters Series Monte Carlo Monaco ATP World Tour,CLAY,2,Olivier Rochus,Gael Monfils,Olivier Rochus,4-6; 6-4; 6-1,R64,146,2,2,50,85,32,50,18,35,2,6,13,50,85,9,7,57,101,35,57,15,44,17,24,14,50,101
2006-04-17 00:00:00.000,ATP Masters Series Monte Carlo Monaco ATP World Tour,CLAY,2,Andreas Seppi,Davide Sanguinetti,Andreas Seppi,2-6; 6-1; 6-4,R64,109,4,3,37,79,29,37,24,42,4,6,13,53,79,5,4,42,89,29,42,22,47,8,11,12,51,89
2006-04-17 00:00:00.000,ATP Masters Series Monte Carlo Monaco ATP World Tour,CLAY,2,David Nalbandian,Xavier Malisse,David Nalbandian,6-4; 6-4,R64,80,1,2,37,61,25,37,16,24,5,6,10,41,61,4,1,32,57,22,32,12,25,4,7,10,34,57
2006-04-17 00:00:00.000,ATP Masters Series Monte Carlo Monaco ATP World Tour,CLAY,2,Guillermo Coria,Mikhail Youzhny,Guillermo Coria,6-3; 6-1,R64,80,0,6,40,61,27,40,10,21,3,4,8,37,61,1,2,28,52,18,28,8,24,2,7,8,26,52
2006-04-17 00:00:00.000,ATP Masters Series Monte Carlo Monaco ATP World Tour,CLAY,2,Paul-Henri Mathieu,Marat Safin,Paul-Henri Mathieu,6-0; 7-5,R64,93,1,0,32,49,24,32,8,17,0,2,9,32,49,0,3,35,68,16,35,14,33,7,13,9,30,68
2006-04-17 00:00:00.000,ATP Masters Series Monte Carlo Monaco ATP World Tour,CLAY,2,Michael Llodra,Boris Pashanski,Michael Llodra,6-3; 6-0,R64,72,3,2,33,63,22,33,16,30,10,11,8,38,63,1,4,22,43,8,22,10,21,4,9,7,18,43
2006-04-17 00:00:00.000,ATP Masters Series Monte Carlo Monaco ATP World Tour,CLAY,2,Nicolas Kiefer,Max Mirnyi,Nicolas Kiefer,6-4; 4-6; 7-6(2),R64,148,9,6,49,89,33,49,27,40,2,6,16,60,89,9,6,66,122,47,66,26,56,10,14,16,73,122
2006-04-17 00:00:00.000,ATP Masters Series Monte Carlo Monaco ATP World Tour,CLAY,2,Kristof Vliegen,Jarkko Nieminen,Kristof Vliegen,1-6; 6-4; 7-6(5),R64,131,7,2,65,113,44,65,23,48,10,14,15,67,113,4,1,56,86,42,56,16,30,6,8,14,58,86
2006-04-17 00:00:00.000,ATP Masters Series Monte Carlo Monaco ATP World Tour,CLAY,2,Jan Hernych,Julien Benneteau,Jan Hernych,7-6(9); 4-6; 7-6(4),R64,198,3,3,82,124,52,82,22,42,5,11,17,74,124,9,6,103,148,61,103,23,45,10,15,17,84,148
2006-04-17 00:00:00.000,ATP Masters Series Monte Carlo Monaco ATP World Tour,CLAY,2,Jean-Rene Lisnard,Andy Murray,Jean-Rene Lisnard,4-6; 7-6(5); 7-5,R64,187,1,6,64,125,41,64,29,61,8,14,17,70,125,3,3,70,130,45,70,26,60,17,23,17,71,130
2006-04-17 00:00:00.000,ATP Masters Series Monte Carlo Monaco ATP World Tour,CLAY,2,Rafael Nadal,Arnaud Clement,Rafael Nadal,6-4; 6-4,R64,96,0,1,48,64,30,48,11,16,6,8,10,41,64,2,5,32,57,20,32,10,25,1,5,10,30,57
2006-04-17 00:00:00.000,ATP Masters Series Monte Carlo Monaco ATP World Tour,CLAY,2,Roger Federer,Alberto Martin,Roger Federer,6-0; 6-1,R32,46,2,1,20,33,18,20,10,13,0,0,7,28,33,0,3,23,37,8,23,5,14,1,6,6,13,37
2006-04-17 00:00:00.000,ATP Masters Series Monte Carlo Monaco ATP World Tour,CLAY,2,Benjamin Balleret,Sebastien Grosjean,Benjamin Balleret,4-6; 7-5; 3-2 RET,R32,113,1,3,53,89,36,53,15,36,9,14,14,51,89,4,1,38,76,27,38,17,38,5,10,13,44,76
2006-04-17 00:00:00.000,ATP Masters Series Monte Carlo Monaco ATP World Tour,CLAY,2,Juan Carlos Ferrero,Juan Ignacio Chela,Juan Carlos Ferrero,6-1; 6-2,R32,73,0,0,33,45,27,33,6,12,1,1,8,33,45,0,2,32,55,15,32,11,23,12,16,7,26,55
2006-04-17 00:00:00.000,ATP Masters Series Monte Carlo Monaco ATP World Tour,CLAY,2,David Ferrer,Dominik Hrbaty,David Ferrer,6-4; 3-6; 6-4,R32,133,0,2,61,89,41,61,9,28,2,7,14,50,89,2,4,51,98,33,51,21,47,7,13,15,54,98
2006-04-17 00:00:00.000,ATP Masters Series Monte Carlo Monaco ATP World Tour,CLAY,2,Ivan Ljubicic,Florent Serra,Ivan Ljubicic,4-6; 6-3; 7-5,R32,112,17,3,55,85,44,55,20,30,6,7,16,64,85,5,1,58,92,44,58,18,34,5,7,15,62,92
2006-04-17 00:00:00.000,ATP Masters Series Monte Carlo Monaco ATP World Tour,CLAY,2,Gilles Simon,Tomas Berdych,Gilles Simon,7-6(2); 6-7(5); 6-4,R32,163,10,2,61,122,48,61,30,61,5,8,17,78,122,4,6,50,106,38,50,30,56,3,7,17,68,106
2006-04-17 00:00:00.000,ATP Masters Series Monte Carlo Monaco ATP World Tour,CLAY,2,Fernando Gonzalez,Feliciano Lopez,Fernando Gonzalez,6-7(4); 6-2; 7-5,R32,134,6,3,56,95,38,56,28,39,5,7,16,66,95,1,2,61,101,34,61,26,40,7,12,16,60,101
2006-04-17 00:00:00.000,ATP Masters Series Monte Carlo Monaco ATP World Tour,CLAY,2,Robin Soderling,Potito Starace,Robin Soderling,6-4; 6-4,R32,86,4,6,36,67,29,36,12,31,7,9,10,41,67,1,0,48,71,28,48,11,23,3,7,10,39,71
2006-04-17 00:00:00.000,ATP Masters Series Monte Carlo Monaco ATP World Tour,CLAY,2,Gaston Gaudio,Jose Acasuso,Gaston Gaudio,6-3; 3-6; 6-4,R32,126,2,5,51,81,30,51,15,30,4,10,14,45,81,6,4,60,103,32,60,19,43,9,16,14,51,103
2006-04-17 00:00:00.000,ATP Masters Series Monte Carlo Monaco ATP World Tour,CLAY,2,Alessio Di Mauro,Radek Stepanek,Alessio Di Mauro,6-2; 2-6; 7-6(4),R32,138,3,1,41,91,25,41,28,50,6,11,14,53,91,8,6,52,90,33,52,22,38,6,11,14,55,90
2006-04-17 00:00:00.000,ATP Masters Series Monte Carlo Monaco ATP World Tour,CLAY,2,Tommy Robredo,Olivier Rochus,Tommy Robredo,7-5; 6-4,R32,105,0,2,53,68,36,53,8,15,2,4,11,44,68,0,1,50,76,31,50,13,26,7,11,11,44,76
2006-04-17 00:00:00.000,ATP Masters Series Monte Carlo Monaco ATP World Tour,CLAY,2,David Nalbandian,Andreas Seppi,David Nalbandian,7-5; 7-5,R32,103,2,4,44,74,30,44,12,30,2,6,12,42,74,4,5,44,80,25,44,16,36,7,13,12,41,80
2006-04-17 00:00:00.000,ATP Masters Series Monte Carlo Monaco ATP World Tour,CLAY,2,Guillermo Coria,Paul-Henri Mathieu,Guillermo Coria,1-6; 7-6(6); 6-4,R32,167,0,20,68,112,41,68,18,44,10,17,14,59,112,3,2,65,106,34,65,25,41,10,16,15,59,106
2006-04-17 00:00:00.000,ATP Masters Series Monte Carlo Monaco ATP World Tour,CLAY,2,Nicolas Kiefer,Michael Llodra,Nicolas Kiefer,7-6(4); 6-4,R32,98,4,1,43,83,31,43,20,40,3,6,11,51,83,3,5,45,73,27,45,12,28,2,6,11,39,73
2006-04-17 00:00:00.000,ATP Masters Series Monte Carlo Monaco ATP World Tour,CLAY,2,Kristof Vliegen,Jan Hernych,Kristof Vliegen,7-5; 6-1,R32,85,1,1,41,65,24,41,14,24,6,8,9,38,65,2,1,31,60,17,31,11,29,2,8,10,28,60
2006-04-17 00:00:00.000,ATP Masters Series Monte Carlo Monaco ATP World Tour,CLAY,2,Rafael Nadal,Jean-Rene Lisnard,Rafael Nadal,6-4; 6-1,R32,88,0,1,34,48,25,34,8,14,3,4,8,33,48,0,3,22,54,13,22,13,32,6,11,9,26,54
2006-04-17 00:00:00.000,ATP Masters Series Monte Carlo Monaco ATP World Tour,CLAY,2,Roger Federer,Benjamin Balleret,Roger Federer,6-3; 6-2,R16,55,3,0,30,44,26,30,11,14,3,3,9,37,44,2,2,34,52,21,34,8,18,3,6,8,29,52
2006-04-17 00:00:00.000,ATP Masters Series Monte Carlo Monaco ATP World Tour,CLAY,2,David Ferrer,Juan Carlos Ferrero,David Ferrer,6-1; 6-7(5); 6-3,R16,142,0,2,67,103,39,67,22,36,8,12,15,61,103,1,1,65,89,34,65,13,24,2,9,13,47,89
2006-04-17 00:00:00.000,ATP Masters Series Monte Carlo Monaco ATP World Tour,CLAY,2,Ivan Ljubicic,Gilles Simon,Ivan Ljubicic,6-3; 6-2,R16,71,4,1,24,46,17,24,11,22,1,3,8,28,46,1,3,31,58,14,31,11,27,2,8,9,25,58
2006-04-17 00:00:00.000,ATP Masters Series Monte Carlo Monaco ATP World Tour,CLAY,2,Fernando Gonzalez,Robin Soderling,Fernando Gonzalez,6-2; 3-1 RET,R16,54,1,2,25,38,20,25,6,13,3,3,6,26,38,1,1,31,42,18,31,5,11,1,4,6,23,42
2006-04-17 00:00:00.000,ATP Masters Series Monte Carlo Monaco ATP World Tour,CLAY,2,Gaston Gaudio,Alessio Di Mauro,Gaston Gaudio,6-2; 6-4,R16,85,1,0,34,50,25,34,11,16,4,5,9,36,50,3,0,35,65,24,35,11,30,4,8,9,35,65
2006-04-17 00:00:00.000,ATP Masters Series Monte Carlo Monaco ATP World Tour,CLAY,2,Tommy Robredo,David Nalbandian,Tommy Robredo,5-7; 6-1; 7-5,R16,170,2,0,103,122,57,103,11,19,11,15,15,68,122,1,9,74,123,49,74,16,49,6,13,16,65,123
2006-04-17 00:00:00.000,ATP Masters Series Monte Carlo Monaco ATP World Tour,CLAY,2,Guillermo Coria,Nicolas Kiefer,Guillermo Coria,6-7(5); 6-4; 6-3,R16,164,0,23,71,116,46,71,11,45,13,20,16,57,116,3,1,44,94,26,44,18,50,5,14,15,44,94
2006-04-17 00:00:00.000,ATP Masters Series Monte Carlo Monaco ATP World Tour,CLAY,2,Rafael Nadal,Kristof Vliegen,Rafael Nadal,6-3; 6-3,R16,105,2,2,50,61,33,50,5,11,2,3,9,38,61,0,0,34,60,18,34,12,26,4,8,9,30,60
2006-04-17 00:00:00.000,ATP Masters Series Monte Carlo Monaco ATP World Tour,CLAY,2,Roger Federer,David Ferrer,Roger Federer,6-1; 6-3,Q,61,3,1,28,45,22,28,8,17,4,5,8,30,45,1,2,31,51,16,31,6,20,9,14,8,22,51
2006-04-17 00:00:00.000,ATP Masters Series Monte Carlo Monaco ATP World Tour,CLAY,2,Fernando Gonzalez,Ivan Ljubicic,Fernando Gonzalez,7-5; 6-1,Q,107,1,1,37,55,24,37,13,18,3,4,9,37,55,2,2,41,79,25,41,14,38,2,7,10,39,79
2006-04-17 00:00:00.000,ATP Masters Series Monte Carlo Monaco ATP World Tour,CLAY,2,Gaston Gaudio,Tommy Robredo,Gaston Gaudio,6-1; 6-3,Q,78,1,2,26,47,21,26,13,21,2,2,8,34,47,1,1,37,61,18,37,12,24,6,10,8,30,61
2006-04-17 00:00:00.000,ATP Masters Series Monte Carlo Monaco ATP World Tour,CLAY,2,Rafael Nadal,Guillermo Coria,Rafael Nadal,6-2; 6-1,Q,70,4,0,33,43,21,33,6,10,6,8,7,27,43,0,8,36,53,12,36,6,17,6,13,8,18,53
2006-04-17 00:00:00.000,ATP Masters Series Monte Carlo Monaco ATP World Tour,CLAY,2,Roger Federer,Fernando Gonzalez,Roger Federer,6-2; 6-4,S,69,3,0,36,52,28,36,11,16,3,3,9,39,52,0,3,37,55,23,37,9,18,3,6,9,32,55
2006-04-17 00:00:00.000,ATP Masters Series Monte Carlo Monaco ATP World Tour,CLAY,2,Rafael Nadal,Gaston Gaudio,Rafael Nadal,5-7; 6-1; 6-1,S,159,0,1,52,80,35,52,15,28,5,8,13,50,80,0,3,54,96,30,54,16,42,13,20,13,46,96
2006-04-17 00:00:00.000,ATP Masters Series Monte Carlo Monaco ATP World Tour,CLAY,2,Rafael Nadal,Roger Federer,Rafael Nadal,6-2; 6-7(2); 6-3; 7-6(5),F,230,1,4,106,152,70,106,24,46,14,18,21,94,152,3,3,86,143,54,86,28,57,7,14,20,82,143
2006-04-24 00:00:00.000,Barcelona Spain ATP World Tour,CLAY,2,Rafael Nadal,N/A Bye,Rafael Nadal,,R64,0,0,0,0,0,0,0,0,0,0,0,0,0,0,0,0,0,0,0,0,0,0,0,0,0,0,0
2006-04-24 00:00:00.000,Barcelona Spain ATP World Tour,CLAY,2,Feliciano Lopez,Ivo Klec,Feliciano Lopez,4-6; 6-4; 6-4,R64,131,4,5,54,111,36,54,21,57,9,15,15,57,111,1,6,44,86,28,44,18,42,10,17,15,46,86
2006-04-24 00:00:00.000,Barcelona Spain ATP World Tour,CLAY,2,Daniel Gimeno-Traver,Novak Djokovic,Daniel Gimeno-Traver,6-4; 3-6; 6-3,R64,133,2,5,70,105,49,70,12,35,7,10,14,61,105,2,1,54,82,37,54,12,28,3,7,14,49,82
2006-04-24 00:00:00.000,Barcelona Spain ATP World Tour,CLAY,2,Ivan Navarro,Paradorn Srichaphan,Ivan Navarro,6-3; 6-4,R64,99,3,0,37,62,30,37,12,25,5,5,9,42,62,1,2,52,80,29,52,16,28,12,15,10,45,80
2006-04-24 00:00:00.000,Barcelona Spain ATP World Tour,CLAY,2,Tomas Berdych,Albert Montanes,Tomas Berdych,4-6; 7-5; 7-5,R64,146,13,5,63,110,45,63,22,47,7,11,17,67,110,5,8,56,102,45,56,16,46,2,7,17,61,102
2006-04-24 00:00:00.000,Barcelona Spain ATP World Tour,CLAY,2,Albert Portas,Oscar Hernandez,Albert Portas,6-2; 6-4,R64,78,7,2,28,59,24,28,19,31,5,5,9,43,59,0,1,43,60,23,43,11,17,7,10,9,34,60
2006-04-24 00:00:00.000,Barcelona Spain ATP World Tour,CLAY,2,Philipp Kohlschreiber,Raemon Sluiter,Philipp Kohlschreiber,7-6(2); 7-6,R64,93,1,1,25,36,20,25,6,11,0,0,6,26,36,6,1,29,47,22,29,12,18,5,5,6,34,47
2006-04-24 00:00:00.000,Barcelona Spain ATP World Tour,CLAY,2,Jarkko Nieminen,N/A Bye,Jarkko Nieminen,,R64,0,0,0,0,0,0,0,0,0,0,0,0,0,0,0,0,0,0,0,0,0,0,0,0,0,0,0
2006-04-24 00:00:00.000,Barcelona Spain ATP World Tour,CLAY,2,Guillermo Coria,N/A Bye,Guillermo Coria,,R64,0,0,0,0,0,0,0,0,0,0,0,0,0,0,0,0,0,0,0,0,0,0,0,0,0,0,0
2006-04-24 00:00:00.000,Barcelona Spain ATP World Tour,CLAY,2,Galo Blanco,Tomas Zib,Galo Blanco,6-7(3); 7-6(3); 6-2,R64,164,12,4,76,127,55,76,22,51,11,14,16,77,127,8,1,64,106,42,64,23,42,4,9,16,65,106
2006-04-24 00:00:00.000,Barcelona Spain ATP World Tour,CLAY,2,Nicolas Almagro,Andrei Pavel,Nicolas Almagro,6-4; 6-2,R64,63,4,1,24,44,21,24,15,20,0,0,9,36,44,0,1,38,52,24,38,5,14,2,5,9,29,52
2006-04-24 00:00:00.000,Barcelona Spain ATP World Tour,CLAY,2,Gael Monfils,Stefano Galvani,Gael Monfils,6-2; 7-5,R64,91,2,1,36,57,25,36,13,21,2,3,10,38,57,1,3,38,59,23,38,8,21,3,7,10,31,59
2006-04-24 00:00:00.000,Barcelona Spain ATP World Tour,CLAY,2,Juan Carlos Ferrero,Kristof Vliegen,Juan Carlos Ferrero,6-1; 6-2,R64,68,1,0,36,46,30,36,4,10,2,2,8,34,46,0,3,26,42,17,26,2,16,3,7,7,19,42
2006-04-24 00:00:00.000,Barcelona Spain ATP World Tour,CLAY,2,Alberto Martin,Bartolome Salva-Vidal,Alberto Martin,6-4; 6-2,R64,89,3,1,31,52,25,31,13,21,2,2,9,38,52,0,4,40,71,26,40,15,31,8,11,9,41,71
2006-04-24 00:00:00.000,Barcelona Spain ATP World Tour,CLAY,2,Albert Costa,Vincent Spadea,Albert Costa,7-6(7); 4-6; 6-1,R64,157,3,6,85,112,56,85,11,27,10,14,15,67,112,7,6,69,130,45,69,26,61,17,22,14,71,130
2006-04-24 00:00:00.000,Barcelona Spain ATP World Tour,CLAY,2,Dominik Hrbaty,N/A Bye,Dominik Hrbaty,,R64,0,0,0,0,0,0,0,0,0,0,0,0,0,0,0,0,0,0,0,0,0,0,0,0,0,0,0
2006-04-24 00:00:00.000,Barcelona Spain ATP World Tour,CLAY,2,Tommy Robredo,N/A Bye,Tommy Robredo,,R64,0,0,0,0,0,0,0,0,0,0,0,0,0,0,0,0,0,0,0,0,0,0,0,0,0,0,0
2006-04-24 00:00:00.000,Barcelona Spain ATP World Tour,CLAY,2,Potito Starace,Lukas Dlouhy,Potito Starace,6-4; 6-2,R64,58,1,0,40,48,32,40,4,8,0,0,9,36,48,0,3,55,62,33,55,4,7,4,7,9,37,62
2006-04-24 00:00:00.000,Barcelona Spain ATP World Tour,CLAY,2,Agustin Calleri,Justin Gimelstob,Agustin Calleri,6-2; 6-1,R64,159,6,0,30,39,23,30,6,9,0,0,7,29,39,2,0,34,56,19,34,8,22,8,13,8,27,56
2006-04-24 00:00:00.000,Barcelona Spain ATP World Tour,CLAY,2,Fernando Verdasco,Robin Vik,Fernando Verdasco,6-3; 6-4,R64,70,2,3,41,55,27,41,8,14,2,4,10,35,55,2,3,35,61,23,35,8,26,4,8,9,31,61
2006-04-24 00:00:00.000,Barcelona Spain ATP World Tour,CLAY,2,Carlos Cuadrado,Dmitry Tursunov,Carlos Cuadrado,4-6; 6-0(3); 6-3,R64,108,6,2,46,77,34,46,16,31,5,8,11,50,77,9,3,44,87,29,44,19,43,10,14,11,48,87
2006-04-24 00:00:00.000,Barcelona Spain ATP World Tour,CLAY,2,Paul-Henri Mathieu,Juan Antonio Marin,Paul-Henri Mathieu,7-6(3); 6-2,R64,100,2,2,43,62,27,43,10,19,0,3,10,37,62,2,2,31,64,19,31,13,33,1,6,10,32,64
2006-04-24 00:00:00.000,Barcelona Spain ATP World Tour,CLAY,2,Filippo Volandri,Andrea Stoppini,Filippo Volandri,6-3; 6-1,R64,59,0,0,27,50,17,27,12,23,0,2,8,29,50,0,4,28,50,15,28,5,22,5,11,8,20,50
2006-04-24 00:00:00.000,Barcelona Spain ATP World Tour,CLAY,2,Radek Stepanek,N/A Bye,Radek Stepanek,,R64,0,0,0,0,0,0,0,0,0,0,0,0,0,0,0,0,0,0,0,0,0,0,0,0,0,0,0
2006-04-24 00:00:00.000,Barcelona Spain ATP World Tour,CLAY,2,David Ferrer,N/A Bye,David Ferrer,,R64,0,0,0,0,0,0,0,0,0,0,0,0,0,0,0,0,0,0,0,0,0,0,0,0,0,0,0
2006-04-24 00:00:00.000,Barcelona Spain ATP World Tour,CLAY,2,Andy Murray,Marcel Granollers,Andy Murray,4-6; 6-4; 6-2,R64,122,1,1,51,94,29,51,23,43,7,12,14,52,94,4,4,44,83,24,44,18,39,4,11,14,42,83
2006-04-24 00:00:00.000,Barcelona Spain ATP World Tour,CLAY,2,Stanislas Wawrinka,Nicolas Lapentti,Stanislas Wawrinka,6-2; 6-7(3); 6-3,R64,142,5,5,56,97,40,56,24,41,7,9,15,64,97,1,1,69,97,44,69,12,28,7,12,14,56,97
2006-04-24 00:00:00.000,Barcelona Spain ATP World Tour,CLAY,2,Teymuraz Gabashvili,Igor Andreev,Teymuraz Gabashvili,4-6; 7-6(6); 7-6,R64,148,4,1,52,63,39,52,8,11,1,2,11,47,63,7,2,59,68,48,59,6,9,3,3,12,54,68
2006-04-24 00:00:00.000,Barcelona Spain ATP World Tour,CLAY,2,Evgeny Korolev,Carlos Moya,Evgeny Korolev,7-5; 6-4,R64,108,2,3,53,80,35,53,11,27,5,8,11,46,80,5,3,33,75,21,33,19,42,6,11,11,40,75
2006-04-24 00:00:00.000,Barcelona Spain ATP World Tour,CLAY,2,Fernando Vicente,Alex Calatrava,Fernando Vicente,7-6(4); 6-4,R64,106,5,3,59,85,43,59,10,26,4,6,11,53,85,5,0,49,79,36,49,13,30,8,11,11,49,79
2006-04-24 00:00:00.000,Barcelona Spain ATP World Tour,CLAY,2,Ivo Karlovic,Max Mirnyi,Ivo Karlovic,6-3; 6-4,R64,67,16,3,38,50,33,38,7,12,0,0,10,40,50,4,3,34,54,22,34,10,20,1,3,9,32,54
2006-04-24 00:00:00.000,Barcelona Spain ATP World Tour,CLAY,2,Nikolay Davydenko,N/A Bye,Nikolay Davydenko,,R64,0,0,0,0,0,0,0,0,0,0,0,0,0,0,0,0,0,0,0,0,0,0,0,0,0,0,0
2006-04-24 00:00:00.000,Barcelona Spain ATP World Tour,CLAY,2,Rafael Nadal,Feliciano Lopez,Rafael Nadal,6-4; 6-2,R32,74,1,1,32,48,21,32,12,16,2,4,9,33,48,6,3,32,54,20,32,7,22,2,7,9,27,54
2006-04-24 00:00:00.000,Barcelona Spain ATP World Tour,CLAY,2,Ivan Navarro,Daniel Gimeno-Traver,Ivan Navarro,7-6(5); 7-5,R32,125,2,2,56,82,41,56,14,26,9,11,12,55,82,6,1,50,86,37,50,15,36,3,6,12,52,86
2006-04-24 00:00:00.000,Barcelona Spain ATP World Tour,CLAY,2,Albert Portas,Tomas Berdych,Albert Portas,7-6(6); 6-3,R32,97,10,3,45,72,36,45,12,27,2,3,11,48,72,4,1,44,65,32,44,9,21,2,4,10,41,65
2006-04-24 00:00:00.000,Barcelona Spain ATP World Tour,CLAY,2,Jarkko Nieminen,Philipp Kohlschreiber,Jarkko Nieminen,6-1; 6-2,R32,73,1,2,37,60,25,37,13,23,9,10,8,38,60,1,1,20,49,9,20,12,29,7,12,7,21,49
2006-04-24 00:00:00.000,Barcelona Spain ATP World Tour,CLAY,2,Guillermo Coria,Galo Blanco,Guillermo Coria,6-7(4); 6-0; 6-2,R32,126,1,16,55,86,37,55,8,31,4,9,13,45,86,2,5,51,96,25,51,14,45,8,18,13,39,96
2006-04-24 00:00:00.000,Barcelona Spain ATP World Tour,CLAY,2,Nicolas Almagro,Gael Monfils,Nicolas Almagro,6-2; 6-4,R32,116,4,2,40,73,28,40,17,33,6,7,9,45,73,3,2,39,69,22,39,15,30,12,16,9,37,69
2006-04-24 00:00:00.000,Barcelona Spain ATP World Tour,CLAY,2,Juan Carlos Ferrero,Alberto Martin,Juan Carlos Ferrero,6-4; 7-6(1),R32,112,1,1,64,84,41,64,10,20,5,7,11,51,84,2,4,28,65,18,28,18,37,3,6,11,36,65
2006-04-24 00:00:00.000,Barcelona Spain ATP World Tour,CLAY,2,Albert Costa,Dominik Hrbaty,Albert Costa,6-3; 7-5,R32,82,2,0,51,66,33,51,6,15,3,6,11,39,66,1,2,34,57,22,34,6,23,4,9,10,28,57
2006-04-24 00:00:00.000,Barcelona Spain ATP World Tour,CLAY,2,Tommy Robredo,Potito Starace,Tommy Robredo,6-4; 6-0,R32,66,1,1,47,55,31,47,4,8,5,6,8,35,55,0,1,30,49,15,30,9,19,6,11,8,24,49
2006-04-24 00:00:00.000,Barcelona Spain ATP World Tour,CLAY,2,Fernando Verdasco,Agustin Calleri,Fernando Verdasco,7-5; 6-4,R32,85,2,5,46,67,37,46,9,21,4,5,11,46,67,3,2,52,71,35,52,8,19,5,8,11,43,71
2006-04-24 00:00:00.000,Barcelona Spain ATP World Tour,CLAY,2,Paul-Henri Mathieu,Carlos Cuadrado,Paul-Henri Mathieu,7-6(4); 6-4,R32,101,1,2,53,72,34,53,13,19,2,3,11,47,72,4,3,51,73,36,51,10,22,5,7,11,46,73
2006-04-24 00:00:00.000,Barcelona Spain ATP World Tour,CLAY,2,Radek Stepanek,Filippo Volandri,Radek Stepanek,3-6; 7-6(0); 6-4,R32,119,4,7,67,110,50,67,19,43,8,11,15,69,110,2,3,68,90,48,68,10,22,2,5,16,58,90
2006-04-24 00:00:00.000,Barcelona Spain ATP World Tour,CLAY,2,David Ferrer,Andy Murray,David Ferrer,4-6(5); 7-6; 6-1,R32,145,21,4,64,114,44,64,24,50,9,12,15,68,114,12,2,52,100,40,52,26,48,8,10,15,66,100
2006-04-24 00:00:00.000,Barcelona Spain ATP World Tour,CLAY,2,Stanislas Wawrinka,Teymuraz Gabashvili,Stanislas Wawrinka,6-4; 6-7(4); 6-4,R32,123,8,3,48,88,35,48,26,40,0,3,16,61,88,8,3,66,105,47,66,15,39,5,10,16,62,105
2006-04-24 00:00:00.000,Barcelona Spain ATP World Tour,CLAY,2,Evgeny Korolev,Fernando Vicente,Evgeny Korolev,6-3; 6-0,R32,62,5,3,48,73,34,48,12,25,7,7,8,46,73,1,0,34,48,18,34,4,14,2,6,7,22,48
2006-04-24 00:00:00.000,Barcelona Spain ATP World Tour,CLAY,2,Ivo Karlovic,Nikolay Davydenko,Ivo Karlovic,6-7(7); 7-5; 6-4,R32,165,19,0,74,114,60,74,22,40,6,6,17,82,114,4,2,103,125,75,103,12,22,9,11,17,87,125
2006-04-24 00:00:00.000,Barcelona Spain ATP World Tour,CLAY,2,Rafael Nadal,Ivan Navarro,Rafael Nadal,6-4; 6-2,R16,89,0,1,39,57,29,39,11,18,1,1,9,40,57,3,4,30,59,20,30,14,29,4,7,9,34,59
2006-04-24 00:00:00.000,Barcelona Spain ATP World Tour,CLAY,2,Jarkko Nieminen,Albert Portas,Jarkko Nieminen,6-3; 6-2,R16,82,4,0,33,53,24,33,8,20,7,9,8,32,53,2,3,41,72,23,41,10,31,9,15,9,33,72
2006-04-24 00:00:00.000,Barcelona Spain ATP World Tour,CLAY,2,Nicolas Almagro,Guillermo Coria,Nicolas Almagro,6-2; 6-0,R16,51,3,0,30,43,23,30,9,13,2,2,7,32,43,0,14,19,41,13,19,3,22,1,6,7,16,41
2006-04-24 00:00:00.000,Barcelona Spain ATP World Tour,CLAY,2,Juan Carlos Ferrero,Albert Costa,Juan Carlos Ferrero,6-1; 5-7; 7-5,R16,127,4,0,73,93,54,73,10,20,4,6,16,64,93,3,1,59,84,37,59,17,25,0,4,15,54,84
2006-04-24 00:00:00.000,Barcelona Spain ATP World Tour,CLAY,2,Tommy Robredo,Fernando Verdasco,Tommy Robredo,6-3; 2-6; 6-2,R16,129,2,2,79,110,49,79,13,31,12,15,13,62,110,1,2,59,74,40,59,4,15,4,8,12,44,74
2006-04-24 00:00:00.000,Barcelona Spain ATP World Tour,CLAY,2,Radek Stepanek,Paul-Henri Mathieu,Radek Stepanek,1-6; 6-3; 6-2,R16,107,8,2,54,76,38,54,10,22,4,6,12,48,76,1,1,50,73,36,50,10,23,4,7,12,46,73
2006-04-24 00:00:00.000,Barcelona Spain ATP World Tour,CLAY,2,Stanislas Wawrinka,David Ferrer,Stanislas Wawrinka,2-6; 6-2; 6-1,R16,101,4,1,43,78,25,43,16,35,9,13,11,41,78,1,3,62,87,30,62,11,25,6,13,12,41,87
2006-04-24 00:00:00.000,Barcelona Spain ATP World Tour,CLAY,2,Ivo Karlovic,Evgeny Korolev,Ivo Karlovic,6-7(4); 7-6(4); 7-6(5),R16,166,24,4,83,130,70,83,24,47,8,8,18,94,130,6,5,75,114,61,75,27,39,7,7,18,88,114
2006-04-24 00:00:00.000,Barcelona Spain ATP World Tour,CLAY,2,Rafael Nadal,Jarkko Nieminen,Rafael Nadal,4-6; 6-4; 6-3,Q,138,1,1,58,83,39,58,12,25,5,9,14,51,83,2,2,57,90,36,57,12,33,7,13,15,48,90
2006-04-24 00:00:00.000,Barcelona Spain ATP World Tour,CLAY,2,Nicolas Almagro,Juan Carlos Ferrero,Nicolas Almagro,6-3; 6-3,Q,86,5,3,43,75,31,43,15,32,10,11,9,46,75,0,0,42,52,25,42,3,10,2,6,9,28,52
2006-04-24 00:00:00.000,Barcelona Spain ATP World Tour,CLAY,2,Tommy Robredo,Radek Stepanek,Tommy Robredo,6-3; 6-2,Q,72,1,0,56,66,38,56,7,10,7,7,9,45,66,6,1,35,48,20,35,6,13,1,4,8,26,48
2006-04-24 00:00:00.000,Barcelona Spain ATP World Tour,CLAY,2,Stanislas Wawrinka,Ivo Karlovic,Stanislas Wawrinka,4-6; 6-3; 6-4,Q,120,7,1,57,94,43,57,20,37,4,5,15,63,94,12,1,51,77,39,51,15,26,2,4,14,54,77
2006-04-24 00:00:00.000,Barcelona Spain ATP World Tour,CLAY,2,Rafael Nadal,Nicolas Almagro,Rafael Nadal,7-6(2); 6-3,S,100,5,1,48,68,38,48,10,20,1,2,11,48,68,7,2,29,62,23,29,15,33,2,4,10,38,62
2006-04-24 00:00:00.000,Barcelona Spain ATP World Tour,CLAY,2,Tommy Robredo,Stanislas Wawrinka,Tommy Robredo,6-4; 6-4,S,94,2,0,47,61,31,47,7,14,3,6,10,38,61,0,5,39,63,26,39,6,24,5,10,10,32,63
2006-04-24 00:00:00.000,Barcelona Spain ATP World Tour,CLAY,2,Rafael Nadal,Tommy Robredo,Rafael Nadal,6-4; 6-4; 6-0,F,139,2,4,61,85,44,61,15,24,3,3,13,59,85,3,0,58,85,33,58,14,27,3,8,13,47,85
2006-04-24 00:00:00.000,Casablanca Morocco ATP World Tour,CLAY,2,Nicolas Massu,Michael Berrer,Nicolas Massu,7-6(4); 6-0,R32,90,4,2,33,64,25,33,21,31,3,3,9,46,64,4,5,32,54,23,32,11,22,1,4,9,34,54
2006-04-24 00:00:00.000,Casablanca Morocco ATP World Tour,CLAY,2,Alessio Di Mauro,Mounir El Aarej,Alessio Di Mauro,6-2; 6-4,R32,71,2,1,37,59,29,37,11,22,3,3,9,40,59,3,1,38,51,26,38,3,13,0,3,9,29,51
2006-04-24 00:00:00.000,Casablanca Morocco ATP World Tour,CLAY,2,Nicolas Mahut,Carlos Berlocq,Nicolas Mahut,6-4; 6-1,R32,86,1,3,24,46,18,24,13,22,0,1,8,31,46,3,3,28,66,17,28,15,38,5,10,9,32,66
2006-04-24 00:00:00.000,Casablanca Morocco ATP World Tour,CLAY,2,Arnaud Clement,Juan Monaco,Arnaud Clement,6-4; 6-1,R32,104,2,1,30,63,21,30,19,33,3,4,9,40,63,1,3,54,85,29,54,14,31,10,14,8,43,85
2006-04-24 00:00:00.000,Casablanca Morocco ATP World Tour,CLAY,2,Bjorn Phau,Andreas Seppi,Bjorn Phau,7-6(4); 6-1,R32,79,3,3,37,69,27,37,17,32,6,7,9,44,69,4,2,35,62,18,35,14,27,1,5,10,32,62
2006-04-24 00:00:00.000,Casablanca Morocco ATP World Tour,CLAY,2,Slimane Saoudi,David Skoch,Slimane Saoudi,6-3; 6-2,R32,65,1,2,42,54,30,42,6,12,0,1,9,36,54,3,3,28,49,16,28,9,21,2,6,8,25,49
2006-04-24 00:00:00.000,Casablanca Morocco ATP World Tour,CLAY,2,Jiri Vanek,Ruben Ramirez Hidalgo,Jiri Vanek,5-7; 6-1; 6-4,R32,117,2,3,48,80,38,48,18,32,4,6,14,56,80,2,2,43,82,26,43,21,39,3,8,15,47,82
2006-04-24 00:00:00.000,Casablanca Morocco ATP World Tour,CLAY,2,Jurgen Melzer,Guillermo Garcia-Lopez,Jurgen Melzer,6-3; 1-6; 6-3,R32,98,5,4,56,92,38,56,16,36,6,10,13,54,92,2,5,44,69,29,44,10,25,0,4,12,39,69
2006-04-24 00:00:00.000,Casablanca Morocco ATP World Tour,CLAY,2,Gilles Simon,Jan Hernych,Gilles Simon,6-1; 4-6; 6-4,R32,100,2,1,47,79,29,47,17,32,1,5,14,46,79,3,5,49,78,26,49,15,29,3,9,13,41,78
2006-04-24 00:00:00.000,Casablanca Morocco ATP World Tour,CLAY,2,Mehdi Tahiri,Oliver Marach,Mehdi Tahiri,3-6; 6-3; 7-6(2),R32,151,2,3,65,88,40,65,13,23,2,6,15,53,88,6,1,51,94,35,51,20,43,5,9,15,55,94
2006-04-24 00:00:00.000,Casablanca Morocco ATP World Tour,CLAY,2,Florian Mayer,Lamine Ouahab,Florian Mayer,6-1; 7-6(4),R32,93,2,1,33,60,28,33,16,27,1,2,10,44,60,1,1,47,61,28,47,8,14,2,5,9,36,61
2006-04-24 00:00:00.000,Casablanca Morocco ATP World Tour,CLAY,2,Christophe Rochus,Tomas Behrend,Christophe Rochus,6-3; 6-4,R32,63,1,2,42,59,22,42,10,17,4,8,9,32,59,2,7,37,61,24,37,1,24,1,8,10,25,61
2006-04-24 00:00:00.000,Casablanca Morocco ATP World Tour,CLAY,2,Daniele Bracciali,Olivier Patience,Daniele Bracciali,6-3; 6-4,R32,64,4,4,28,50,26,28,11,22,1,1,9,37,50,1,2,43,62,27,43,8,19,2,5,10,35,62
2006-04-24 00:00:00.000,Casablanca Morocco ATP World Tour,CLAY,2,Alexander Waske,Gilles Muller,Alexander Waske,6-4; 7-5,R32,93,4,5,34,66,28,34,16,32,2,3,11,44,66,9,8,43,72,28,43,15,29,3,6,11,43,72
2006-04-24 00:00:00.000,Casablanca Morocco ATP World Tour,CLAY,2,Marc Gicquel,Janko Tipsarevic,Marc Gicquel,6-4; 6-1,R32,56,7,2,26,44,22,26,12,18,3,3,8,34,44,4,8,24,53,18,24,10,29,4,8,9,28,53
2006-04-24 00:00:00.000,Casablanca Morocco ATP World Tour,CLAY,2,Luis Horna,Tomislav Peric,Luis Horna,7-5; 6-2,R32,67,2,0,45,56,31,45,10,11,0,0,10,41,56,10,8,27,59,24,27,11,32,6,9,10,35,59
2006-04-24 00:00:00.000,Casablanca Morocco ATP World Tour,CLAY,2,Nicolas Massu,Alessio Di Mauro,Nicolas Massu,6-7(2); 6-3; 6-1,R16,144,3,4,32,85,23,32,32,53,4,7,14,55,85,4,1,56,90,35,56,13,34,9,16,14,48,90
2006-04-24 00:00:00.000,Casablanca Morocco ATP World Tour,CLAY,2,Nicolas Mahut,Arnaud Clement,Nicolas Mahut,6-3; 7-6(6),R16,140,8,5,44,83,26,44,22,39,7,9,10,48,83,3,1,38,71,20,38,18,33,3,7,11,38,71
2006-04-24 00:00:00.000,Casablanca Morocco ATP World Tour,CLAY,2,Bjorn Phau,Slimane Saoudi,Bjorn Phau,6-4; 6-4,R16,71,4,2,41,57,27,41,11,16,0,2,10,38,57,2,4,35,54,22,35,8,19,2,6,10,30,54
2006-04-24 00:00:00.000,Casablanca Morocco ATP World Tour,CLAY,2,Jiri Vanek,Jurgen Melzer,Jiri Vanek,7-6(5); 6-2,R16,89,2,3,36,62,27,36,10,26,5,9,10,37,62,6,3,53,78,32,53,8,25,8,14,10,40,78
2006-04-24 00:00:00.000,Casablanca Morocco ATP World Tour,CLAY,2,Gilles Simon,Mehdi Tahiri,Gilles Simon,6-3; 6-4,R16,89,9,0,31,53,25,31,15,22,0,1,10,40,53,1,2,37,61,24,37,10,24,2,5,9,34,61
2006-04-24 00:00:00.000,Casablanca Morocco ATP World Tour,CLAY,2,Christophe Rochus,Florian Mayer,Christophe Rochus,6-2; 6-1,R16,53,2,0,30,44,24,30,10,14,1,1,8,34,44,3,2,23,44,15,23,5,21,2,6,7,20,44
2006-04-24 00:00:00.000,Casablanca Morocco ATP World Tour,CLAY,2,Daniele Bracciali,Alexander Waske,Daniele Bracciali,6-4; 7-5,R16,96,7,2,41,71,31,41,19,30,7,7,11,50,71,5,3,47,72,29,47,17,25,3,5,11,46,72
2006-04-24 00:00:00.000,Casablanca Morocco ATP World Tour,CLAY,2,Luis Horna,Marc Gicquel,Luis Horna,6-1; 5-7; 6-3,R16,143,7,1,51,84,34,51,20,33,5,8,14,54,84,9,4,39,84,28,39,18,45,4,10,14,46,84
2006-04-24 00:00:00.000,Casablanca Morocco ATP World Tour,CLAY,2,Nicolas Massu,Nicolas Mahut,Nicolas Massu,6-3; 7-6(3),Q,117,4,0,53,68,40,53,9,15,1,2,11,49,68,5,4,43,72,30,43,14,29,4,6,10,44,72
2006-04-24 00:00:00.000,Casablanca Morocco ATP World Tour,CLAY,2,Bjorn Phau,Jiri Vanek,Bjorn Phau,7-5; 6-3,Q,92,3,1,43,77,30,43,13,34,6,9,10,43,77,3,6,46,72,25,46,8,26,3,9,11,33,72
2006-04-24 00:00:00.000,Casablanca Morocco ATP World Tour,CLAY,2,Gilles Simon,Christophe Rochus,Gilles Simon,6-3; 3-6; 6-4,Q,119,4,3,52,107,38,52,21,55,11,16,14,59,107,1,8,51,81,31,51,14,30,2,8,14,45,81
2006-04-24 00:00:00.000,Casablanca Morocco ATP World Tour,CLAY,2,Daniele Bracciali,Luis Horna,Daniele Bracciali,6-7(12); 6-4; 7-6(3),Q,164,19,6,65,131,53,65,33,66,8,9,17,86,131,8,4,80,119,59,80,20,39,4,6,17,79,119
2006-04-24 00:00:00.000,Casablanca Morocco ATP World Tour,CLAY,2,Nicolas Massu,Bjorn Phau,Nicolas Massu,6-2; 6-4,S,91,4,0,38,57,29,38,12,19,3,3,9,41,57,1,3,28,46,20,28,7,18,2,5,9,27,46
2006-04-24 00:00:00.000,Casablanca Morocco ATP World Tour,CLAY,2,Daniele Bracciali,Gilles Simon,Daniele Bracciali,6-0; 3-1 RET,S,45,5,1,17,34,14,17,10,17,3,3,5,24,34,1,1,21,40,11,21,6,19,6,10,5,17,40
2006-04-24 00:00:00.000,Casablanca Morocco ATP World Tour,CLAY,2,Daniele Bracciali,Nicolas Massu,Daniele Bracciali,6-1; 6-4,F,93,9,0,33,57,27,33,13,24,4,4,9,40,57,4,2,31,61,21,31,12,30,8,11,8,33,61
2006-05-01 00:00:00.000,Estoril Portugal ATP World Tour,CLAY,2,David Nalbandian,Nicolas Mahut,David Nalbandian,7-5; 7-5,R32,110,1,3,41,76,28,41,18,35,3,6,12,46,76,5,4,41,77,24,41,18,36,0,5,12,42,77
2006-05-01 00:00:00.000,Estoril Portugal ATP World Tour,CLAY,2,Jeremy Chardy,Jimmy Wang,Jeremy Chardy,7-5; 6-1,R32,102,5,6,54,96,38,54,15,42,9,11,9,53,96,1,5,43,64,20,43,9,21,2,8,10,29,64
2006-05-01 00:00:00.000,Estoril Portugal ATP World Tour,CLAY,2,Frederico Gil,David Luque-Velasco,Frederico Gil,1-6; 7-6(5); 6-4,R32,154,4,4,50,88,34,50,24,38,3,6,14,58,88,0,8,71,110,45,71,23,39,7,9,15,68,110
2006-05-01 00:00:00.000,Estoril Portugal ATP World Tour,CLAY,2,Dmitry Tursunov,Gastao Elias,Dmitry Tursunov,6-2; 6-1,R32,53,4,1,26,43,20,26,11,17,0,0,7,31,43,3,3,15,53,8,15,15,38,5,10,8,23,53
2006-05-01 00:00:00.000,Estoril Portugal ATP World Tour,CLAY,2,Gael Monfils,Razvan Sabau,Gael Monfils,6-1; 6-2,R32,39,8,0,24,35,18,24,8,11,0,1,7,26,35,1,4,24,42,12,24,2,18,4,10,8,14,42
2006-05-01 00:00:00.000,Estoril Portugal ATP World Tour,CLAY,2,Albert Portas,Juan Antonio Marin,Albert Portas,6-3; 6-4,R32,85,1,3,40,57,28,40,7,17,3,5,9,35,57,2,1,27,54,19,27,10,27,4,9,10,29,54
2006-05-01 00:00:00.000,Estoril Portugal ATP World Tour,CLAY,2,Justin Gimelstob,Lukas Dlouhy,Justin Gimelstob,3-6; 7-5; 6-3,R32,131,5,5,47,93,30,47,28,46,4,7,15,58,93,2,3,64,98,40,64,19,34,13,17,15,59,98
2006-05-01 00:00:00.000,Estoril Portugal ATP World Tour,CLAY,2,Nicolas Massu,Raemon Sluiter,Nicolas Massu,6-0; 7-5,R32,84,5,1,35,46,27,35,6,11,1,3,9,33,46,6,2,41,64,23,41,5,23,4,10,9,28,64
2006-05-01 00:00:00.000,Estoril Portugal ATP World Tour,CLAY,2,Carlos Moya,Flavio Saretta,Carlos Moya,6-3; 6-4,R32,105,4,0,29,61,23,29,21,32,4,4,10,44,61,1,3,52,82,31,52,14,30,9,11,9,45,82
2006-05-01 00:00:00.000,Estoril Portugal ATP World Tour,CLAY,2,Gustavo Marcaccio,Tomas Zib,Gustavo Marcaccio,6-4; 6-2,R32,82,2,0,41,61,27,41,11,20,4,5,9,38,61,5,2,24,48,15,24,11,24,2,6,9,26,48
2006-05-01 00:00:00.000,Estoril Portugal ATP World Tour,CLAY,2,Guillermo Garcia-Lopez,Leonardo Azzaro,Guillermo Garcia-Lopez,6-4; 4-6; 6-4,R32,141,6,6,49,94,31,49,26,45,3,7,15,57,94,4,2,68,102,45,68,14,34,11,16,15,59,102
2006-05-01 00:00:00.000,Estoril Portugal ATP World Tour,CLAY,2,Carlos Berlocq,Didac Perez,Carlos Berlocq,6-0; 6-1,R32,55,2,0,33,43,23,33,7,10,3,3,6,30,43,1,6,22,42,13,22,3,20,2,8,7,16,42
2006-05-01 00:00:00.000,Estoril Portugal ATP World Tour,CLAY,2,Gilles Muller,Christophe Rochus,Gilles Muller,6-2; 6-0,R32,45,10,0,29,38,22,29,7,9,3,3,7,29,38,1,1,28,44,13,28,4,16,2,7,7,17,44
2006-05-01 00:00:00.000,Estoril Portugal ATP World Tour,CLAY,2,Nicolas Lapentti,Michal Przysiezny,Nicolas Lapentti,6-7(3); 6-4; 6-4,R32,188,4,4,75,122,54,75,26,47,7,8,16,80,122,5,3,65,122,42,65,34,57,7,10,16,76,122
2006-05-01 00:00:00.000,Estoril Portugal ATP World Tour,CLAY,2,Marat Safin,Fabio Fognini,Marat Safin,6-1; 6-4,R32,71,2,1,29,54,18,29,16,25,3,4,8,34,54,0,3,31,57,15,31,12,26,5,10,9,27,57
2006-05-01 00:00:00.000,Estoril Portugal ATP World Tour,CLAY,2,Nikolay Davydenko,Vincent Spadea,Nikolay Davydenko,7-6(3); 6-3,R32,95,2,4,49,75,32,49,16,26,1,3,11,48,75,2,2,29,62,20,29,14,33,1,4,10,34,62
2006-05-01 00:00:00.000,Estoril Portugal ATP World Tour,CLAY,2,David Nalbandian,Jeremy Chardy,David Nalbandian,6-1; 7-6(0),R16,75,2,6,34,64,27,34,17,30,7,9,10,44,64,1,5,30,49,16,30,9,19,3,7,9,25,49
2006-05-01 00:00:00.000,Estoril Portugal ATP World Tour,CLAY,2,Frederico Gil,Dmitry Tursunov,Frederico Gil,4-6; 6-4; 6-1,R16,139,2,1,69,98,44,69,15,29,9,12,14,59,98,6,6,40,80,27,40,16,40,5,10,13,43,80
2006-05-01 00:00:00.000,Estoril Portugal ATP World Tour,CLAY,2,Albert Portas,Gael Monfils,Albert Portas,3-6; 7-6(3); 6-4,R16,148,1,2,53,106,36,53,23,53,6,11,15,59,106,6,8,50,101,36,50,24,51,6,11,16,60,101
2006-05-01 00:00:00.000,Estoril Portugal ATP World Tour,CLAY,2,Justin Gimelstob,Nicolas Massu,Justin Gimelstob,2-6; 7-6(3); 6-4,R16,157,9,4,55,102,40,55,23,47,5,8,15,63,102,9,1,66,103,41,66,25,37,7,9,15,66,103
2006-05-01 00:00:00.000,Estoril Portugal ATP World Tour,CLAY,2,Carlos Moya,Gustavo Marcaccio,Carlos Moya,6-1; 7-5,R16,94,17,1,40,69,30,40,15,29,5,6,10,45,69,1,3,38,64,18,38,14,26,3,7,9,32,64
2006-05-01 00:00:00.000,Estoril Portugal ATP World Tour,CLAY,2,Guillermo Garcia-Lopez,Carlos Berlocq,Guillermo Garcia-Lopez,6-7(11); 7-5; 7-6(5),R16,206,0,5,78,126,47,78,27,48,1,6,18,74,126,0,4,94,130,53,94,21,36,4,10,18,74,130
2006-05-01 00:00:00.000,Estoril Portugal ATP World Tour,CLAY,2,Gilles Muller,Nicolas Lapentti,Gilles Muller,6-1; 6-4,R16,93,5,2,36,65,28,36,15,29,3,3,9,43,65,1,0,40,62,26,40,8,22,6,9,8,34,62
2006-05-01 00:00:00.000,Estoril Portugal ATP World Tour,CLAY,2,Nikolay Davydenko,Marat Safin,Nikolay Davydenko,4-6; 6-1; 6-2,R16,108,1,2,51,79,38,51,13,28,4,6,13,51,79,5,0,48,75,29,48,10,27,5,10,12,39,75
2006-05-01 00:00:00.000,Estoril Portugal ATP World Tour,CLAY,2,David Nalbandian,Frederico Gil,David Nalbandian,6-1; 6-2,Q,76,2,2,22,42,17,22,14,20,2,2,7,31,42,0,0,53,62,27,53,2,9,7,12,8,29,62
2006-05-01 00:00:00.000,Estoril Portugal ATP World Tour,CLAY,2,Albert Portas,Justin Gimelstob,Albert Portas,6-4; 6-3,Q,82,2,1,34,50,25,34,8,16,3,5,9,33,50,5,2,45,72,26,45,10,27,4,9,10,36,72
2006-05-01 00:00:00.000,Estoril Portugal ATP World Tour,CLAY,2,Carlos Moya,Guillermo Garcia-Lopez,Carlos Moya,7-6(4); 6-4,Q,104,3,1,40,71,31,40,18,31,1,3,11,49,71,4,2,54,76,37,54,10,22,4,7,11,47,76
2006-05-01 00:00:00.000,Estoril Portugal ATP World Tour,CLAY,2,Nikolay Davydenko,Gilles Muller,Nikolay Davydenko,6-4; 6-4,Q,91,1,2,47,67,32,47,14,20,4,4,10,46,67,5,2,48,79,34,48,16,31,11,13,10,50,79
2006-05-01 00:00:00.000,Estoril Portugal ATP World Tour,CLAY,2,David Nalbandian,Albert Portas,David Nalbandian,7-5; 6-1,S,78,4,0,30,52,22,30,16,22,1,2,10,38,52,2,2,25,60,15,25,15,35,4,8,9,30,60
2006-05-01 00:00:00.000,Estoril Portugal ATP World Tour,CLAY,2,Nikolay Davydenko,Carlos Moya,Nikolay Davydenko,3-6; 6-2; 6-2,S,109,1,1,56,79,35,56,13,23,2,5,13,48,79,1,4,53,78,34,53,10,25,5,10,12,44,78
2006-05-01 00:00:00.000,Estoril Portugal ATP World Tour,CLAY,2,David Nalbandian,Nikolay Davydenko,David Nalbandian,6-3; 6-4,F,79,2,4,38,61,26,38,15,23,1,2,10,41,61,1,2,33,52,21,33,8,19,3,6,9,29,52
2006-05-01 00:00:00.000,Munich Germany ATP World Tour,CLAY,2,Denis Gremelmayr,Guillermo Coria,Denis Gremelmayr,3-6; 6-2; 6-3,R32,118,4,1,38,83,24,38,24,45,8,12,13,48,83,0,17,54,91,33,54,16,37,10,16,13,49,91
2006-05-01 00:00:00.000,Munich Germany ATP World Tour,CLAY,2,Alexander Peya,Dieter Kindlmann,Alexander Peya,6-3; 6-4,R32,62,5,3,35,56,25,35,14,21,2,3,10,39,56,0,5,34,53,21,34,9,19,4,7,9,30,53
2006-05-01 00:00:00.000,Munich Germany ATP World Tour,CLAY,2,Ruben Ramirez Hidalgo,Tobias Summerer,Ruben Ramirez Hidalgo,6-1; 6-2,R32,72,3,1,43,61,30,43,10,18,1,1,8,40,61,4,1,32,51,16,32,10,19,4,8,7,26,51
2006-05-01 00:00:00.000,Munich Germany ATP World Tour,CLAY,2,Olivier Rochus,Julio Silva,Olivier Rochus,6-2; 6-0,R32,59,0,0,25,35,19,25,7,10,1,2,7,26,35,3,1,31,49,14,31,4,18,4,10,7,18,49
2006-05-01 00:00:00.000,Munich Germany ATP World Tour,CLAY,2,Ivo Karlovic,Tommy Haas,Ivo Karlovic,6-3; 7-6(3),R32,94,22,1,54,74,43,54,10,20,3,3,11,53,74,2,1,41,58,31,41,9,17,0,1,10,40,58
2006-05-01 00:00:00.000,Munich Germany ATP World Tour,CLAY,2,Bjorn Phau,Tomas Behrend,Bjorn Phau,3-2 RET,R32,22,0,0,4,14,3,4,6,10,1,1,2,9,14,1,1,16,21,10,16,1,5,1,2,3,11,21
2006-05-01 00:00:00.000,Munich Germany ATP World Tour,CLAY,2,Simon Greul,Boris Pashanski,Simon Greul,6-3; 6-7(0); 7-6(8),R32,165,14,5,64,121,49,64,30,57,8,9,16,79,121,5,5,74,127,56,74,23,53,4,7,17,79,127
2006-05-01 00:00:00.000,Munich Germany ATP World Tour,CLAY,2,Jurgen Melzer,Mikhail Youzhny,Jurgen Melzer,6-3; 6-4,R32,75,6,3,53,77,32,53,13,24,7,9,10,45,77,1,2,43,59,26,43,5,16,5,9,9,31,59
2006-05-01 00:00:00.000,Munich Germany ATP World Tour,CLAY,2,Juan Monaco,Paradorn Srichaphan,Juan Monaco,6-4; 6-4,R32,84,3,1,35,60,24,35,16,25,3,4,10,40,60,2,2,37,61,24,37,12,24,3,6,10,36,61
2006-05-01 00:00:00.000,Munich Germany ATP World Tour,CLAY,2,Robin Vik,Rainer Schuettler,Robin Vik,7-6(5); 4-6; 6-3,R32,139,6,2,68,108,45,68,14,40,4,10,16,59,108,1,1,54,96,31,54,18,42,2,8,15,49,96
2006-05-01 00:00:00.000,Munich Germany ATP World Tour,CLAY,2,Alexander Waske,Florian Mayer,Alexander Waske,7-6(4); 6-3,R32,90,7,2,52,71,38,52,10,19,3,4,10,48,71,5,1,50,72,31,50,13,22,4,7,11,44,72
2006-05-01 00:00:00.000,Munich Germany ATP World Tour,CLAY,2,Jarkko Nieminen,Andrei Pavel,Jarkko Nieminen,7-6(7); 7-6(7),R32,109,9,1,63,103,44,63,27,40,9,9,12,71,103,7,1,45,79,36,45,22,34,0,0,12,58,79
2006-05-01 00:00:00.000,Munich Germany ATP World Tour,CLAY,2,Robin Soderling,Florent Serra,Robin Soderling,6-7(6); 7-5; 6-4,R32,151,10,5,66,113,52,66,21,47,6,10,17,73,113,6,4,70,121,47,70,23,51,10,16,17,70,121
2006-05-01 00:00:00.000,Munich Germany ATP World Tour,CLAY,2,Kristof Vliegen,Janko Tipsarevic,Kristof Vliegen,5-7; 6-2; 6-4,R32,115,11,2,53,81,45,53,15,28,5,6,15,60,81,5,2,49,90,38,49,19,41,0,3,15,57,90
2006-05-01 00:00:00.000,Munich Germany ATP World Tour,CLAY,2,Jan Hernych,Andreas Beck,Jan Hernych,7-6(3); 4-6; 6-4,R32,137,10,3,77,104,45,77,16,27,4,9,16,61,104,5,7,57,102,32,57,26,45,7,12,16,58,102
2006-05-01 00:00:00.000,Munich Germany ATP World Tour,CLAY,2,Philipp Kohlschreiber,Mario Ancic,Philipp Kohlschreiber,7-6(3); 7-6(5),R32,112,1,1,50,77,42,50,18,27,0,0,12,60,77,11,0,59,81,47,59,13,22,6,6,12,60,81
2006-05-01 00:00:00.000,Munich Germany ATP World Tour,CLAY,2,Denis Gremelmayr,Alexander Peya,Denis Gremelmayr,6-4; 6-4,R16,80,0,1,33,64,24,33,20,31,3,4,10,44,64,0,2,45,70,28,45,14,25,6,9,10,42,70
2006-05-01 00:00:00.000,Munich Germany ATP World Tour,CLAY,2,Olivier Rochus,Ruben Ramirez Hidalgo,Olivier Rochus,6-2; 7-6(6),R16,97,1,3,45,71,31,45,14,26,3,5,10,45,71,6,2,39,64,26,39,9,25,3,7,10,35,64
2006-05-01 00:00:00.000,Munich Germany ATP World Tour,CLAY,2,Ivo Karlovic,Bjorn Phau,Ivo Karlovic,4-6; 6-3; 7-6(8),R16,137,21,4,64,111,54,64,23,47,2,3,16,77,111,3,4,52,90,40,52,28,38,5,6,15,68,90
2006-05-01 00:00:00.000,Munich Germany ATP World Tour,CLAY,2,Jurgen Melzer,Simon Greul,Jurgen Melzer,6-3; 1-6; 6-4,R16,119,6,1,56,88,37,56,16,32,5,8,13,53,88,2,4,45,87,29,45,23,42,8,11,13,52,87
2006-05-01 00:00:00.000,Munich Germany ATP World Tour,CLAY,2,Robin Vik,Juan Monaco,Robin Vik,7-6(3); 4-6; 6-4,R16,163,2,4,71,108,44,71,18,37,6,13,16,62,108,0,4,66,106,34,66,20,40,3,10,16,54,106
2006-05-01 00:00:00.000,Munich Germany ATP World Tour,CLAY,2,Jarkko Nieminen,Alexander Waske,Jarkko Nieminen,7-6(2); 6-3,R16,112,3,3,43,68,34,43,15,25,2,3,11,49,68,6,4,46,74,32,46,13,28,3,5,10,45,74
2006-05-01 00:00:00.000,Munich Germany ATP World Tour,CLAY,2,Kristof Vliegen,Robin Soderling,Kristof Vliegen,5-7; 6-3; 6-2,R16,107,7,1,49,83,37,49,17,34,3,5,14,54,83,7,3,44,78,30,44,17,34,2,7,15,47,78
2006-05-01 00:00:00.000,Munich Germany ATP World Tour,CLAY,2,Philipp Kohlschreiber,Jan Hernych,Philipp Kohlschreiber,3-6; 6-0; 7-5,R16,111,4,1,61,83,37,61,11,22,5,9,13,48,83,4,7,54,83,34,54,8,29,3,10,14,42,83
2006-05-01 00:00:00.000,Munich Germany ATP World Tour,CLAY,2,Olivier Rochus,Denis Gremelmayr,Olivier Rochus,6-4; 7-5,Q,96,0,2,63,84,39,63,14,21,9,11,11,53,84,4,5,33,61,23,33,11,28,3,7,11,34,61
2006-05-01 00:00:00.000,Munich Germany ATP World Tour,CLAY,2,Jurgen Melzer,Ivo Karlovic,Jurgen Melzer,7-6(4); 6-1,Q,65,2,1,42,59,35,42,13,17,0,0,10,48,59,11,0,35,48,28,35,7,13,1,3,9,35,48
2006-05-01 00:00:00.000,Munich Germany ATP World Tour,CLAY,2,Jarkko Nieminen,Robin Vik,Jarkko Nieminen,7-5; 2-6; 6-2,Q,103,3,0,55,90,35,55,18,35,5,9,14,53,90,2,1,45,78,29,45,13,33,4,9,14,42,78
2006-05-01 00:00:00.000,Munich Germany ATP World Tour,CLAY,2,Kristof Vliegen,Philipp Kohlschreiber,Kristof Vliegen,7-5; 6-4,Q,99,5,1,37,65,28,37,17,28,1,2,11,45,65,3,1,48,73,29,48,15,25,7,10,11,44,73
2006-05-01 00:00:00.000,Munich Germany ATP World Tour,CLAY,2,Olivier Rochus,Jurgen Melzer,Olivier Rochus,6-4; 6-7(1); 6-3,S,137,1,4,65,98,49,65,13,33,3,5,16,62,98,13,3,68,113,47,68,20,45,17,21,15,67,113
2006-05-01 00:00:00.000,Munich Germany ATP World Tour,CLAY,2,Kristof Vliegen,Jarkko Nieminen,Kristof Vliegen,6-1; 6-2,S,68,4,1,34,50,26,34,10,16,3,3,8,36,50,2,1,29,48,18,29,6,19,6,10,7,24,48
2006-05-01 00:00:00.000,Munich Germany ATP World Tour,CLAY,2,Olivier Rochus,Kristof Vliegen,Olivier Rochus,6-4; 6-2,F,82,1,1,31,50,25,31,11,19,2,3,9,36,50,2,4,34,59,18,34,12,25,4,8,9,30,59
2006-05-08 00:00:00.000,ATP Masters Series Rome Italy ATP World Tour,CLAY,2,Roger Federer,Juan Ignacio Chela,Roger Federer,6-2; 6-1,R64,68,3,0,29,51,20,29,15,22,1,2,8,35,51,0,1,23,50,15,23,7,27,5,10,7,22,50
2006-05-08 00:00:00.000,ATP Masters Series Rome Italy ATP World Tour,CLAY,2,Potito Starace,Dmitry Tursunov,Potito Starace,6-4; 6-1,R64,67,1,0,32,48,26,32,10,16,2,2,8,36,48,1,2,20,47,17,20,9,27,2,6,9,26,47
2006-05-08 00:00:00.000,ATP Masters Series Rome Italy ATP World Tour,CLAY,2,Jarkko Nieminen,Sebastien Grosjean,Jarkko Nieminen,6-2; 6-1,R64,69,0,0,21,41,12,21,14,20,1,2,7,26,41,2,1,16,53,10,16,13,37,4,10,8,23,53
2006-05-08 00:00:00.000,ATP Masters Series Rome Italy ATP World Tour,CLAY,2,Radek Stepanek,Feliciano Lopez,Radek Stepanek,6-4; 6-4,R64,88,7,8,41,75,28,41,17,34,10,12,10,45,75,2,3,28,56,16,28,15,28,2,6,10,31,56
2006-05-08 00:00:00.000,ATP Masters Series Rome Italy ATP World Tour,CLAY,2,Jose Acasuso,David Ferrer,Jose Acasuso,7-5; 6-0,R64,80,3,0,28,53,22,28,11,25,0,2,9,33,53,1,5,38,61,20,38,7,23,3,9,9,27,61
2006-05-08 00:00:00.000,ATP Masters Series Rome Italy ATP World Tour,CLAY,2,Nicolas Almagro,Nicolas Massu,Nicolas Almagro,7-5; 6-4,R64,119,3,2,50,68,36,50,11,18,4,5,11,47,68,1,0,50,68,35,50,6,18,5,8,11,41,68
2006-05-08 00:00:00.000,ATP Masters Series Rome Italy ATP World Tour,CLAY,2,Fernando Verdasco,Simone Bolelli,Fernando Verdasco,6-4; 2-6; 6-1,R64,106,2,2,46,67,23,46,12,21,3,8,12,35,67,1,1,45,72,23,45,12,27,3,10,13,35,72
2006-05-08 00:00:00.000,ATP Masters Series Rome Italy ATP World Tour,CLAY,2,Nikolay Davydenko,Boris Pashanski,Nikolay Davydenko,6-1; 6-4,R64,83,3,4,43,63,29,43,8,20,9,11,9,37,63,0,4,27,46,17,27,4,19,4,9,8,21,46
2006-05-08 00:00:00.000,ATP Masters Series Rome Italy ATP World Tour,CLAY,2,David Nalbandian,Fernando Vicente,David Nalbandian,6-2; 3-6; 6-3,R64,117,1,4,48,82,38,48,18,34,7,8,13,56,82,7,1,55,86,38,55,17,31,6,9,13,55,86
2006-05-08 00:00:00.000,ATP Masters Series Rome Italy ATP World Tour,CLAY,2,Paul-Henri Mathieu,Juan Carlos Ferrero,Paul-Henri Mathieu,6-1; 6-3,R64,68,5,3,32,50,29,32,8,18,2,2,8,37,50,1,1,40,47,20,40,3,7,2,6,8,23,47
2006-05-08 00:00:00.000,ATP Masters Series Rome Italy ATP World Tour,CLAY,2,Alberto Martin,Davide Sanguinetti,Alberto Martin,6-4; 6-2,R64,77,0,0,31,57,22,31,17,26,5,6,9,39,57,1,2,29,52,17,29,12,23,3,7,9,29,52
2006-05-08 00:00:00.000,ATP Masters Series Rome Italy ATP World Tour,CLAY,2,Nicolas Kiefer,Daniele Bracciali,Nicolas Kiefer,4-6; 6-2; 6-4,R64,127,4,7,41,91,31,41,25,50,7,10,14,56,91,4,3,34,75,21,34,21,41,3,8,14,42,75
2006-05-08 00:00:00.000,ATP Masters Series Rome Italy ATP World Tour,CLAY,2,Ruben Ramirez Hidalgo,Guillermo Coria,Ruben Ramirez Hidalgo,6-3; 6-2,R64,88,2,1,26,55,21,26,10,29,3,6,9,31,55,0,10,36,55,18,36,5,19,7,13,8,23,55
2006-05-08 00:00:00.000,ATP Masters Series Rome Italy ATP World Tour,CLAY,2,Marat Safin,Teymuraz Gabashvili,Marat Safin,7-5; 3-6; 6-1,R64,150,5,4,59,119,42,59,31,60,10,11,14,73,119,5,3,45,91,30,45,25,46,6,9,14,55,91
2006-05-08 00:00:00.000,ATP Masters Series Rome Italy ATP World Tour,CLAY,2,Mario Ancic,Luis Horna,Mario Ancic,6-4; 6-4,R64,86,7,1,37,52,29,37,9,15,2,3,10,38,52,1,2,53,73,33,53,8,20,5,8,10,41,73
2006-05-08 00:00:00.000,ATP Masters Series Rome Italy ATP World Tour,CLAY,2,Florent Serra,James Blake,Florent Serra,6-4; 7-6(3),R64,101,1,2,57,90,36,57,18,33,7,10,11,54,90,4,2,39,66,27,39,12,27,2,6,11,39,66
2006-05-08 00:00:00.000,ATP Masters Series Rome Italy ATP World Tour,CLAY,2,Andy Roddick,Victor Hanescu,Andy Roddick,6-1; 6-0,R64,51,3,2,12,33,12,12,13,21,2,2,6,25,33,1,3,33,55,11,33,10,22,3,9,7,21,55
2006-05-08 00:00:00.000,ATP Masters Series Rome Italy ATP World Tour,CLAY,2,Marcos Baghdatis,Olivier Rochus,Marcos Baghdatis,7-5; 6-4,R64,116,15,1,43,85,32,43,17,42,8,10,11,49,85,1,2,50,88,27,50,18,38,5,9,11,45,88
2006-05-08 00:00:00.000,ATP Masters Series Rome Italy ATP World Tour,CLAY,2,Stefano Galvani,Jiri Novak,Stefano Galvani,6-3; 6-4,R64,100,0,6,49,84,25,49,20,35,12,16,10,45,84,1,3,38,63,16,38,10,25,6,12,9,26,63
2006-05-08 00:00:00.000,ATP Masters Series Rome Italy ATP World Tour,CLAY,2,Greg Rusedski,Tommy Robredo,Greg Rusedski,5-7; 6-3; 6-4,R64,133,7,4,73,117,54,73,13,44,11,15,16,67,117,1,1,53,78,34,53,14,25,4,9,15,48,78
2006-05-08 00:00:00.000,ATP Masters Series Rome Italy ATP World Tour,CLAY,2,Robby Ginepri,Max Mirnyi,Robby Ginepri,3-6; 6-2; 6-3,R64,118,7,3,54,88,39,54,18,34,6,8,13,57,88,7,5,49,98,34,49,24,49,8,12,13,58,98
2006-05-08 00:00:00.000,ATP Masters Series Rome Italy ATP World Tour,CLAY,2,Gael Monfils,Tommy Haas,Gael Monfils,6-2; 3-6; 6-4,R64,126,4,6,44,97,29,44,24,53,5,9,13,53,97,0,4,50,89,29,50,20,39,9,15,14,49,89
2006-05-08 00:00:00.000,ATP Masters Series Rome Italy ATP World Tour,CLAY,2,Fabrice Santoro,Juan Monaco,Fabrice Santoro,4-6; 6-2; 6-3,R64,137,1,3,52,97,36,52,18,45,6,10,14,54,97,1,0,62,83,39,62,5,21,6,12,13,44,83
2006-05-08 00:00:00.000,ATP Masters Series Rome Italy ATP World Tour,CLAY,2,Dominik Hrbaty,Ivan Ljubicic,Dominik Hrbaty,5-7; 7-6(4); 6-4,R64,169,4,7,64,116,49,64,28,52,10,12,17,77,116,13,5,53,119,37,53,37,66,7,9,17,74,119
2006-05-08 00:00:00.000,ATP Masters Series Rome Italy ATP World Tour,CLAY,2,Xavier Malisse,Gaston Gaudio,Xavier Malisse,4-6; 6-3; 6-3,R64,131,3,0,39,78,28,39,20,39,7,11,14,48,78,2,6,56,100,36,56,18,44,5,11,14,54,100
2006-05-08 00:00:00.000,ATP Masters Series Rome Italy ATP World Tour,CLAY,2,Tomas Berdych,Paradorn Srichaphan,Tomas Berdych,6-1; 6-3,R64,59,5,1,27,41,24,27,10,14,3,3,8,34,41,2,2,34,51,18,34,6,17,4,8,8,24,51
2006-05-08 00:00:00.000,ATP Masters Series Rome Italy ATP World Tour,CLAY,2,Mikhail Youzhny,Andreas Seppi,Mikhail Youzhny,6-2; 7-6(7),R64,100,3,1,38,65,29,38,14,27,3,4,10,43,65,2,3,33,65,22,33,18,32,2,5,10,40,65
2006-05-08 00:00:00.000,ATP Masters Series Rome Italy ATP World Tour,CLAY,2,Fernando Gonzalez,Stanislas Wawrinka,Fernando Gonzalez,6-4; 6-4,R64,94,3,4,45,70,31,45,9,25,5,8,10,40,70,1,2,30,57,21,30,6,27,2,7,10,27,57
2006-05-08 00:00:00.000,ATP Masters Series Rome Italy ATP World Tour,CLAY,2,Thomas Johansson,Fabio Fognini,Thomas Johansson,7-6(3); 6-3,R64,112,3,3,42,74,35,42,15,32,3,5,11,50,74,4,2,47,95,31,47,23,48,5,8,10,54,95
2006-05-08 00:00:00.000,ATP Masters Series Rome Italy ATP World Tour,CLAY,2,Tim Henman,Alessio Di Mauro,Tim Henman,7-5; 7-6(2),R64,117,6,0,47,79,34,47,20,32,7,8,12,54,79,2,1,40,72,28,40,19,32,1,3,12,47,72
2006-05-08 00:00:00.000,ATP Masters Series Rome Italy ATP World Tour,CLAY,2,Filippo Volandri,Andy Murray,Filippo Volandri,6-4; 6-4,R64,95,0,1,33,63,21,33,15,30,0,3,10,36,63,1,4,36,73,20,36,17,37,7,12,10,37,73
2006-05-08 00:00:00.000,ATP Masters Series Rome Italy ATP World Tour,CLAY,2,Rafael Nadal,Carlos Moya,Rafael Nadal,6-1; 2-6; 6-2,R64,114,1,2,57,70,37,57,7,13,2,4,11,44,70,0,2,48,73,32,48,9,25,5,10,12,41,73
2006-05-08 00:00:00.000,ATP Masters Series Rome Italy ATP World Tour,CLAY,2,Roger Federer,Potito Starace,Roger Federer,6-3; 7-6(2),R32,111,2,2,39,80,28,39,21,41,0,3,10,49,80,0,2,56,83,33,56,8,27,6,11,11,41,83
2006-05-08 00:00:00.000,ATP Masters Series Rome Italy ATP World Tour,CLAY,2,Radek Stepanek,Jarkko Nieminen,Radek Stepanek,6-4; 7-6(5),R32,103,4,2,42,70,30,42,14,28,1,3,11,44,70,1,1,56,83,36,56,9,27,3,6,11,45,83
2006-05-08 00:00:00.000,ATP Masters Series Rome Italy ATP World Tour,CLAY,2,Nicolas Almagro,Jose Acasuso,Nicolas Almagro,6-4; 2-6; 6-4,R32,124,3,3,67,94,44,67,14,27,13,16,14,58,94,5,2,47,85,31,47,22,38,4,7,14,53,85
2006-05-08 00:00:00.000,ATP Masters Series Rome Italy ATP World Tour,CLAY,2,Nikolay Davydenko,Fernando Verdasco,Nikolay Davydenko,6-1; 3-6; 6-0,R32,103,1,3,59,82,33,59,15,23,6,9,11,48,82,1,3,48,71,23,48,9,23,3,10,11,32,71
2006-05-08 00:00:00.000,ATP Masters Series Rome Italy ATP World Tour,CLAY,2,David Nalbandian,Paul-Henri Mathieu,David Nalbandian,6-2; 6-4,R32,83,4,1,25,48,19,25,16,23,4,5,9,35,48,0,1,30,56,20,30,11,26,5,9,9,31,56
2006-05-08 00:00:00.000,ATP Masters Series Rome Italy ATP World Tour,CLAY,2,Alberto Martin,Nicolas Kiefer,Alberto Martin,6-3; 7-6(3),R32,110,1,3,49,73,31,49,17,24,2,4,10,48,73,7,3,43,75,27,43,14,32,6,10,11,41,75
2006-05-08 00:00:00.000,ATP Masters Series Rome Italy ATP World Tour,CLAY,2,Ruben Ramirez Hidalgo,Marat Safin,Ruben Ramirez Hidalgo,0-6; 7-6(6); 7-6(3),R32,182,6,1,76,122,47,76,21,46,5,10,15,68,122,6,3,60,117,41,60,30,57,7,9,15,71,117
2006-05-08 00:00:00.000,ATP Masters Series Rome Italy ATP World Tour,CLAY,2,Mario Ancic,Florent Serra,Mario Ancic,3-6; 7-6(10); 6-0,R32,140,13,5,63,104,43,63,23,41,6,10,14,66,104,2,3,47,87,28,47,21,40,4,9,13,49,87
2006-05-08 00:00:00.000,ATP Masters Series Rome Italy ATP World Tour,CLAY,2,Andy Roddick,Marcos Baghdatis,Andy Roddick,3-6; 6-1; 6-2,R32,114,2,7,45,84,29,45,16,39,6,11,12,45,84,1,5,37,84,23,37,14,47,8,16,12,37,84
2006-05-08 00:00:00.000,ATP Masters Series Rome Italy ATP World Tour,CLAY,2,Greg Rusedski,Stefano Galvani,Greg Rusedski,7-6(4); 6-4,R32,106,2,3,53,80,36,53,11,27,3,6,11,47,80,2,6,45,73,30,45,11,28,4,8,11,41,73
2006-05-08 00:00:00.000,ATP Masters Series Rome Italy ATP World Tour,CLAY,2,Gael Monfils,Robby Ginepri,Gael Monfils,6-1; 4-6; 6-4,R32,113,1,9,52,89,37,52,22,37,4,6,14,59,89,2,1,46,73,31,46,14,27,6,10,13,45,73
2006-05-08 00:00:00.000,ATP Masters Series Rome Italy ATP World Tour,CLAY,2,Fabrice Santoro,Dominik Hrbaty,Fabrice Santoro,7-6(2); 6-3,R32,110,1,1,41,81,26,41,23,40,6,8,10,49,81,3,5,44,82,27,44,16,38,3,7,11,43,82
2006-05-08 00:00:00.000,ATP Masters Series Rome Italy ATP World Tour,CLAY,2,Tomas Berdych,Xavier Malisse,Tomas Berdych,6-2; 6-1,R32,64,5,3,23,41,18,23,10,18,0,1,8,28,41,1,1,27,48,12,27,9,21,4,9,7,21,48
2006-05-08 00:00:00.000,ATP Masters Series Rome Italy ATP World Tour,CLAY,2,Fernando Gonzalez,Mikhail Youzhny,Fernando Gonzalez,6-4; 5-7; 6-3,R32,180,3,7,59,117,36,59,31,58,13,18,16,67,117,0,2,73,111,44,73,15,38,10,16,15,59,111
2006-05-08 00:00:00.000,ATP Masters Series Rome Italy ATP World Tour,CLAY,2,Tim Henman,Thomas Johansson,Tim Henman,7-6(8); 6-1,R32,97,4,1,52,75,36,52,13,23,3,5,10,49,75,3,2,37,66,24,37,14,29,5,9,9,38,66
2006-05-08 00:00:00.000,ATP Masters Series Rome Italy ATP World Tour,CLAY,2,Rafael Nadal,Filippo Volandri,Rafael Nadal,6-1; 6-2,R32,71,0,1,34,52,27,34,9,18,4,4,8,36,52,1,1,28,36,10,28,5,8,2,6,7,15,36
2006-05-08 00:00:00.000,ATP Masters Series Rome Italy ATP World Tour,CLAY,2,Roger Federer,Radek Stepanek,Roger Federer,6-1; 6-4,R16,57,2,2,24,46,23,24,14,22,3,3,9,37,46,3,2,35,47,24,35,4,12,4,7,8,28,47
2006-05-08 00:00:00.000,ATP Masters Series Rome Italy ATP World Tour,CLAY,2,Nicolas Almagro,Nikolay Davydenko,Nicolas Almagro,7-6(6) RET,R16,71,2,1,22,46,19,22,14,24,3,3,6,33,46,0,3,34,51,25,34,9,17,7,7,6,34,51
2006-05-08 00:00:00.000,ATP Masters Series Rome Italy ATP World Tour,CLAY,2,David Nalbandian,Alberto Martin,David Nalbandian,7-5; 6-4,R16,108,1,1,39,61,24,39,11,22,3,7,11,35,61,2,2,37,76,22,37,15,39,2,8,11,37,76
2006-05-08 00:00:00.000,ATP Masters Series Rome Italy ATP World Tour,CLAY,2,Mario Ancic,Ruben Ramirez Hidalgo,Mario Ancic,6-3; 6-7(4); 7-5,R16,190,6,4,68,107,48,68,19,39,5,8,16,67,107,6,4,75,119,54,75,18,44,10,16,17,72,119
2006-05-08 00:00:00.000,ATP Masters Series Rome Italy ATP World Tour,CLAY,2,Andy Roddick,Greg Rusedski,Andy Roddick,7-6(4); 6-2,R16,75,5,0,32,51,28,32,16,19,0,0,10,44,51,1,2,47,66,30,47,9,19,2,4,10,39,66
2006-05-08 00:00:00.000,ATP Masters Series Rome Italy ATP World Tour,CLAY,2,Gael Monfils,Fabrice Santoro,Gael Monfils,7-6(7); 6-2,R16,121,5,5,40,78,30,40,10,38,3,7,10,40,78,2,1,49,76,23,49,9,27,9,15,10,32,76
2006-05-08 00:00:00.000,ATP Masters Series Rome Italy ATP World Tour,CLAY,2,Fernando Gonzalez,Tomas Berdych,Fernando Gonzalez,6-2; 6-4,R16,89,4,1,33,56,24,33,16,23,3,3,9,40,56,2,1,25,52,18,25,12,27,1,4,9,30,52
2006-05-08 00:00:00.000,ATP Masters Series Rome Italy ATP World Tour,CLAY,2,Rafael Nadal,Tim Henman,Rafael Nadal,6-2; 6-2,R16,71,1,0,32,41,25,32,7,9,0,0,8,32,41,5,1,34,51,19,34,7,17,0,4,8,26,51
2006-05-08 00:00:00.000,ATP Masters Series Rome Italy ATP World Tour,CLAY,2,Roger Federer,Nicolas Almagro,Roger Federer,6-3; 6-7(2); 7-5,Q,153,9,2,69,111,49,69,24,42,7,9,17,73,111,1,1,85,118,53,85,18,33,7,11,16,71,118
2006-05-08 00:00:00.000,ATP Masters Series Rome Italy ATP World Tour,CLAY,2,David Nalbandian,Mario Ancic,David Nalbandian,6-3; 6-3,Q,84,0,1,23,55,18,23,20,32,2,3,9,38,55,2,1,36,57,24,36,6,21,1,5,9,30,57
2006-05-08 00:00:00.000,ATP Masters Series Rome Italy ATP World Tour,CLAY,2,Gael Monfils,Andy Roddick,Gael Monfils,6-2; 6-3,Q,71,4,5,31,49,22,31,9,18,5,7,8,31,49,2,1,35,57,18,35,8,22,5,11,9,26,57
2006-05-08 00:00:00.000,ATP Masters Series Rome Italy ATP World Tour,CLAY,2,Rafael Nadal,Fernando Gonzalez,Rafael Nadal,6-4; 6-3,Q,102,0,1,45,53,31,45,4,8,2,4,9,35,53,3,1,41,72,22,41,15,31,5,10,10,37,72
2006-05-08 00:00:00.000,ATP Masters Series Rome Italy ATP World Tour,CLAY,2,Roger Federer,David Nalbandian,Roger Federer,6-3; 3-6; 7-6(5),S,163,9,2,56,117,39,56,27,61,11,16,15,66,117,2,8,64,112,40,64,23,48,4,9,15,63,112
2006-05-08 00:00:00.000,ATP Masters Series Rome Italy ATP World Tour,CLAY,2,Rafael Nadal,Gael Monfils,Rafael Nadal,6-2; 6-2,S,77,0,0,39,51,24,39,7,12,2,3,8,31,51,0,4,25,46,13,25,7,21,2,7,8,20,46
2006-05-08 00:00:00.000,ATP Masters Series Rome Italy ATP World Tour,CLAY,2,Rafael Nadal,Roger Federer,Rafael Nadal,6-7(0); 7-6(5); 6-4; 2-6; 7-6(5),F,305,4,1,147,173,101,147,14,26,6,10,27,115,173,10,0,112,180,86,112,35,68,6,9,27,121,180
2006-05-15 00:00:00.000,ATP Masters Series Hamburg Germany ATP World Tour,CLAY,2,Rainer Schuettler,Lukas Dlouhy,Rainer Schuettler,4-6; 6-3; 6-2,R64,104,1,4,60,92,44,60,13,32,6,8,14,57,92,2,5,46,73,30,46,14,27,1,5,13,44,73
2006-05-15 00:00:00.000,ATP Masters Series Hamburg Germany ATP World Tour,CLAY,2,Juan Carlos Ferrero,Olivier Rochus,Juan Carlos Ferrero,7-6(4); 5-7; 6-3,R64,163,4,2,82,100,50,82,10,18,6,11,16,60,100,1,6,80,123,46,80,17,43,7,13,17,63,123
2006-05-15 00:00:00.000,ATP Masters Series Hamburg Germany ATP World Tour,CLAY,2,Flavio Saretta,Marat Safin,Flavio Saretta,5-7; 6-0; 6-4,R64,132,1,1,53,82,32,53,17,29,4,8,14,49,82,7,2,65,98,40,65,13,33,5,12,14,53,98
2006-05-15 00:00:00.000,ATP Masters Series Hamburg Germany ATP World Tour,CLAY,2,David Ferrer,Feliciano Lopez,David Ferrer,6-4; 6-2,R64,80,4,1,32,48,26,32,12,16,3,3,9,38,48,4,4,39,71,27,39,13,32,6,9,9,40,71
2006-05-15 00:00:00.000,ATP Masters Series Hamburg Germany ATP World Tour,CLAY,2,Paul-Henri Mathieu,Thomas Johansson,Paul-Henri Mathieu,6-3; 6-4,R64,87,1,3,30,57,24,30,17,27,2,3,10,41,57,6,1,37,64,25,37,11,27,10,13,9,36,64
2006-05-15 00:00:00.000,ATP Masters Series Hamburg Germany ATP World Tour,CLAY,2,Kristof Vliegen,Richard Gasquet,Kristof Vliegen,6-4; 6-2,R64,97,5,1,32,47,24,32,9,15,0,2,9,33,47,0,6,51,96,30,51,16,45,9,14,9,46,96
2006-05-15 00:00:00.000,ATP Masters Series Hamburg Germany ATP World Tour,CLAY,2,Florent Serra,Tomas Berdych,Florent Serra,6-4; 0-6; 7-5,R64,118,7,2,54,99,36,54,18,45,6,11,14,54,99,6,4,51,85,36,51,16,34,4,8,14,52,85
2006-05-15 00:00:00.000,ATP Masters Series Hamburg Germany ATP World Tour,CLAY,2,Tommy Robredo,Jiri Novak,Tommy Robredo,6-3; 6-2,R64,62,1,1,47,59,35,47,7,12,4,4,9,42,59,0,0,30,47,19,30,6,17,1,4,8,25,47
2006-05-15 00:00:00.000,ATP Masters Series Hamburg Germany ATP World Tour,CLAY,2,Nikolay Davydenko,Nicolas Massu,Nikolay Davydenko,6-3; 6-4,R64,87,2,1,39,50,29,39,8,11,0,1,10,37,50,1,2,35,63,24,35,11,28,6,9,9,35,63
2006-05-15 00:00:00.000,ATP Masters Series Hamburg Germany ATP World Tour,CLAY,2,Andreas Seppi,Stanislas Wawrinka,Andreas Seppi,2-6; 7-6(4); 6-1,R64,118,1,3,57,98,36,57,28,41,7,9,14,64,98,10,5,47,86,35,47,19,39,4,6,13,54,86
2006-05-15 00:00:00.000,ATP Masters Series Hamburg Germany ATP World Tour,CLAY,2,Christophe Rochus,Paradorn Srichaphan,Christophe Rochus,7-5; 6-1,R64,87,1,5,32,61,24,32,17,29,0,1,10,41,61,0,3,37,75,23,37,15,38,4,8,9,38,75
2006-05-15 00:00:00.000,ATP Masters Series Hamburg Germany ATP World Tour,CLAY,2,Jarkko Nieminen,Davide Sanguinetti,Jarkko Nieminen,5-7; 6-1; 6-4,R64,128,1,0,44,83,24,44,22,39,3,8,14,46,83,2,1,49,96,24,49,21,47,6,14,15,45,96
2006-05-15 00:00:00.000,ATP Masters Series Hamburg Germany ATP World Tour,CLAY,2,Mario Ancic,Alexander Waske,Mario Ancic,6-2; 7-5,R64,98,7,1,46,81,33,46,18,35,8,9,10,51,81,5,4,34,51,24,34,6,17,1,5,10,30,51
2006-05-15 00:00:00.000,ATP Masters Series Hamburg Germany ATP World Tour,CLAY,2,Guillermo Garcia-Lopez,Mikhail Youzhny,Guillermo Garcia-Lopez,6-0; 6-4,R64,56,2,0,31,43,24,31,10,12,0,0,8,34,43,1,0,26,46,15,26,8,20,0,4,8,23,46
2006-05-15 00:00:00.000,ATP Masters Series Hamburg Germany ATP World Tour,CLAY,2,Andy Murray,Gael Monfils,Andy Murray,6-4; 6-1,R64,81,1,0,28,53,16,28,13,25,2,5,8,29,53,1,0,34,65,17,34,10,31,9,16,9,27,65
2006-05-15 00:00:00.000,ATP Masters Series Hamburg Germany ATP World Tour,CLAY,2,James Blake,Carlos Moya,James Blake,6-3; 3-6; 7-5,R64,133,3,7,58,106,36,58,24,48,5,10,15,60,106,5,1,64,99,36,64,19,35,8,14,15,55,99
2006-05-15 00:00:00.000,ATP Masters Series Hamburg Germany ATP World Tour,CLAY,2,Fernando Gonzalez,Dmitry Tursunov,Fernando Gonzalez,6-4; 6-3,R64,85,4,3,45,70,29,45,16,25,2,2,9,45,70,4,3,43,70,28,43,12,27,3,6,10,40,70
2006-05-15 00:00:00.000,ATP Masters Series Hamburg Germany ATP World Tour,CLAY,2,Dominik Hrbaty,Florian Mayer,Dominik Hrbaty,6-4; 6-2,R64,86,3,1,33,59,24,33,13,26,6,8,9,37,59,2,1,44,78,28,44,10,34,10,15,9,38,78
2006-05-15 00:00:00.000,ATP Masters Series Hamburg Germany ATP World Tour,CLAY,2,Fernando Verdasco,Juan Ignacio Chela,Fernando Verdasco,1-6; 6-4; 6-2,R64,110,1,1,73,87,48,73,6,14,9,12,13,54,87,1,1,50,76,34,50,13,26,7,10,12,47,76
2006-05-15 00:00:00.000,ATP Masters Series Hamburg Germany ATP World Tour,CLAY,2,Novak Djokovic,Guillermo Coria,Novak Djokovic,6-3; 3-6; 6-3,R64,138,0,1,64,93,35,64,19,29,9,13,14,54,93,0,10,53,84,34,53,12,31,9,14,13,46,84
2006-05-15 00:00:00.000,ATP Masters Series Hamburg Germany ATP World Tour,CLAY,2,Sebastien Grosjean,Robby Ginepri,Sebastien Grosjean,7-5; 7-5,R64,105,4,2,45,72,29,45,15,27,2,5,12,44,72,5,1,55,80,33,55,10,25,4,9,12,43,80
2006-05-15 00:00:00.000,ATP Masters Series Hamburg Germany ATP World Tour,CLAY,2,Filippo Volandri,Boris Pashanski,Filippo Volandri,6-2; 6-2,R64,59,0,2,29,41,27,29,6,12,0,0,8,33,41,0,4,32,57,19,32,9,25,6,10,8,28,57
2006-05-15 00:00:00.000,ATP Masters Series Hamburg Germany ATP World Tour,CLAY,2,Jose Acasuso,Simon Greul,Jose Acasuso,6-2; 6-1,R64,58,1,0,21,42,16,21,14,21,4,4,7,30,42,0,2,26,43,10,26,9,17,2,7,8,19,43
2006-05-15 00:00:00.000,ATP Masters Series Hamburg Germany ATP World Tour,CLAY,2,Ivan Ljubicic,Philipp Kohlschreiber,Ivan Ljubicic,6-7(3); 6-3; 6-3,R64,139,15,2,59,100,50,59,18,41,8,9,15,68,100,3,4,55,92,39,55,20,37,5,9,15,59,92
2006-05-15 00:00:00.000,ATP Masters Series Hamburg Germany ATP World Tour,CLAY,2,Gaston Gaudio,Alberto Martin,Gaston Gaudio,6-2; 3-6; 6-4,R64,133,1,3,48,88,24,48,19,40,9,16,13,43,88,0,3,55,89,26,55,12,34,8,17,14,38,89
2006-05-15 00:00:00.000,ATP Masters Series Hamburg Germany ATP World Tour,CLAY,2,Gilles Simon,Greg Rusedski,Gilles Simon,6-1; 6-1,R64,51,2,2,20,38,17,20,12,18,1,1,7,29,38,1,2,28,45,11,28,8,17,6,11,7,19,45
2006-05-15 00:00:00.000,ATP Masters Series Hamburg Germany ATP World Tour,CLAY,2,Max Mirnyi,Luis Horna,Max Mirnyi,7-6(5); 7-5,R64,112,7,6,41,71,35,41,21,30,0,0,12,56,71,4,1,59,84,43,59,14,25,4,5,12,57,84
2006-05-15 00:00:00.000,ATP Masters Series Hamburg Germany ATP World Tour,CLAY,2,Nicolas Kiefer,Jurgen Melzer,Nicolas Kiefer,6-2; 3-6; 6-3,R64,146,7,7,44,95,31,44,29,51,13,15,13,60,95,2,3,55,86,33,55,17,31,5,9,13,50,86
2006-05-15 00:00:00.000,ATP Masters Series Hamburg Germany ATP World Tour,CLAY,2,Radek Stepanek,Marcos Baghdatis,Radek Stepanek,6-3; 3-1 RET,R64,50,1,1,21,35,17,21,7,14,0,2,7,24,35,2,5,15,33,8,15,6,18,3,7,6,14,33
2006-05-15 00:00:00.000,ATP Masters Series Hamburg Germany ATP World Tour,CLAY,2,Bjorn Phau,Fabrice Santoro,Bjorn Phau,3-6; 6-1; 6-4,R64,112,2,3,55,95,37,55,20,40,5,7,13,57,95,1,4,36,67,22,36,19,31,1,5,13,41,67
2006-05-15 00:00:00.000,ATP Masters Series Hamburg Germany ATP World Tour,CLAY,2,Juan Monaco,Xavier Malisse,Juan Monaco,6-3; 2-0 RET,R64,66,0,1,37,48,26,37,4,11,5,6,6,30,48,1,3,14,30,10,14,3,16,0,3,5,13,30
2006-05-15 00:00:00.000,ATP Masters Series Hamburg Germany ATP World Tour,CLAY,2,Robin Soderling,Tommy Haas,Robin Soderling,6-2; 2-1 RET,R64,53,1,0,13,26,9,13,11,13,0,0,5,20,26,2,1,23,38,14,23,6,15,0,3,6,20,38
2006-05-15 00:00:00.000,ATP Masters Series Hamburg Germany ATP World Tour,CLAY,2,Juan Carlos Ferrero,Rainer Schuettler,Juan Carlos Ferrero,6-3; 3-6; 6-2,R32,110,2,1,48,65,30,48,10,17,1,5,13,40,65,2,4,39,87,25,39,21,48,4,10,13,46,87
2006-05-15 00:00:00.000,ATP Masters Series Hamburg Germany ATP World Tour,CLAY,2,David Ferrer,Flavio Saretta,David Ferrer,6-1; 7-6(9),R32,101,0,0,39,67,25,39,14,28,0,2,10,39,67,0,1,36,68,19,36,15,32,4,8,9,34,68
2006-05-15 00:00:00.000,ATP Masters Series Hamburg Germany ATP World Tour,CLAY,2,Paul-Henri Mathieu,Kristof Vliegen,Paul-Henri Mathieu,6-2; 6-4,R32,70,0,4,29,48,23,29,10,19,2,4,9,33,48,2,0,28,48,14,28,8,20,4,9,9,22,48
2006-05-15 00:00:00.000,ATP Masters Series Hamburg Germany ATP World Tour,CLAY,2,Tommy Robredo,Florent Serra,Tommy Robredo,3-6; 6-3; 6-2,R32,100,4,1,64,78,43,64,6,14,5,8,13,49,78,1,1,50,76,27,50,15,26,0,5,13,42,76
2006-05-15 00:00:00.000,ATP Masters Series Hamburg Germany ATP World Tour,CLAY,2,Nikolay Davydenko,Andreas Seppi,Nikolay Davydenko,6-1; 6-2,R32,63,3,1,34,49,25,34,9,15,0,0,8,34,49,0,1,21,44,10,21,10,23,1,5,7,20,44
2006-05-15 00:00:00.000,ATP Masters Series Hamburg Germany ATP World Tour,CLAY,2,Jarkko Nieminen,Christophe Rochus,Jarkko Nieminen,6-1; 6-0,R32,46,1,0,26,42,20,26,10,16,0,0,7,30,42,0,1,23,35,9,23,4,12,2,7,6,13,35
2006-05-15 00:00:00.000,ATP Masters Series Hamburg Germany ATP World Tour,CLAY,2,Mario Ancic,Guillermo Garcia-Lopez,Mario Ancic,3-6; 6-4; 6-0,R32,120,3,2,50,82,31,50,18,32,3,6,13,49,82,1,5,47,76,32,47,10,29,5,10,12,42,76
2006-05-15 00:00:00.000,ATP Masters Series Hamburg Germany ATP World Tour,CLAY,2,James Blake,Andy Murray,James Blake,6-3; 6-3,R32,65,3,1,27,46,21,27,6,19,2,6,9,27,46,3,1,40,57,17,40,5,17,5,12,9,22,57
2006-05-15 00:00:00.000,ATP Masters Series Hamburg Germany ATP World Tour,CLAY,2,Fernando Gonzalez,Dominik Hrbaty,Fernando Gonzalez,6-7(4); 6-1; 6-3,R32,122,3,4,57,92,41,57,18,35,3,6,14,59,92,2,4,48,83,31,48,13,35,2,9,14,44,83
2006-05-15 00:00:00.000,ATP Masters Series Hamburg Germany ATP World Tour,CLAY,2,Fernando Verdasco,Novak Djokovic,Fernando Verdasco,6-4; 6-3,R32,89,1,1,47,56,28,47,6,9,4,7,9,34,56,1,0,46,60,20,46,7,14,3,9,10,27,60
2006-05-15 00:00:00.000,ATP Masters Series Hamburg Germany ATP World Tour,CLAY,2,Sebastien Grosjean,Filippo Volandri,Sebastien Grosjean,7-5; 7-6(4),R32,126,1,2,42,86,25,42,22,44,6,10,12,47,86,0,3,66,87,34,66,13,21,4,9,12,47,87
2006-05-15 00:00:00.000,ATP Masters Series Hamburg Germany ATP World Tour,CLAY,2,Jose Acasuso,Ivan Ljubicic,Jose Acasuso,6-2; 6-0,R32,63,3,3,19,38,17,19,8,19,1,2,7,25,38,1,0,25,43,9,25,5,18,2,8,7,14,43
2006-05-15 00:00:00.000,ATP Masters Series Hamburg Germany ATP World Tour,CLAY,2,Gilles Simon,Gaston Gaudio,Gilles Simon,6-4; 3-6; 6-4,R32,138,5,2,38,81,24,38,24,43,2,7,15,48,81,3,2,69,100,44,69,11,31,6,11,14,55,100
2006-05-15 00:00:00.000,ATP Masters Series Hamburg Germany ATP World Tour,CLAY,2,Max Mirnyi,Nicolas Kiefer,Max Mirnyi,6-2; 6-2,R32,86,7,0,34,54,25,34,13,20,6,6,8,38,54,1,5,34,63,23,34,9,29,7,11,8,32,63
2006-05-15 00:00:00.000,ATP Masters Series Hamburg Germany ATP World Tour,CLAY,2,Radek Stepanek,Bjorn Phau,Radek Stepanek,6-4; 6-3,R32,74,6,2,41,58,30,41,6,17,3,5,10,36,58,2,1,27,54,17,27,15,27,1,5,9,32,54
2006-05-15 00:00:00.000,ATP Masters Series Hamburg Germany ATP World Tour,CLAY,2,Robin Soderling,Juan Monaco,Robin Soderling,6-4; 6-4,R32,80,0,2,34,58,26,34,11,24,2,4,10,37,58,1,3,40,61,25,40,7,21,4,8,10,32,61
2006-05-15 00:00:00.000,ATP Masters Series Hamburg Germany ATP World Tour,CLAY,2,David Ferrer,Juan Carlos Ferrero,David Ferrer,6-2; 6-4,R16,91,1,3,48,76,28,48,16,28,9,11,9,44,76,0,1,35,52,16,35,8,17,3,8,9,24,52
2006-05-15 00:00:00.000,ATP Masters Series Hamburg Germany ATP World Tour,CLAY,2,Tommy Robredo,Paul-Henri Mathieu,Tommy Robredo,6-3; 6-3,R16,89,0,1,35,47,28,35,5,12,0,1,9,33,47,0,4,48,62,27,48,5,14,3,7,9,32,62
2006-05-15 00:00:00.000,ATP Masters Series Hamburg Germany ATP World Tour,CLAY,2,Nikolay Davydenko,Jarkko Nieminen,Nikolay Davydenko,6-1; 6-3,R16,57,2,1,30,45,21,30,9,15,2,3,8,30,45,1,1,24,42,11,24,7,18,1,6,8,18,42
2006-05-15 00:00:00.000,ATP Masters Series Hamburg Germany ATP World Tour,CLAY,2,Mario Ancic,James Blake,Mario Ancic,4-6; 7-5; 7-6(3),R16,154,10,1,73,115,48,73,20,42,7,12,17,68,115,5,1,57,105,36,57,26,48,6,11,17,62,105
2006-05-15 00:00:00.000,ATP Masters Series Hamburg Germany ATP World Tour,CLAY,2,Fernando Verdasco,Fernando Gonzalez,Fernando Verdasco,3-6; 6-2; 6-3,R16,134,3,4,64,87,39,64,11,23,10,14,13,50,87,5,4,62,102,31,62,20,40,8,14,13,51,102
2006-05-15 00:00:00.000,ATP Masters Series Hamburg Germany ATP World Tour,CLAY,2,Jose Acasuso,Sebastien Grosjean,Jose Acasuso,7-5; 6-4,R16,116,1,3,29,71,20,29,23,42,6,9,11,43,71,3,0,47,73,27,47,10,26,10,15,11,37,73
2006-05-15 00:00:00.000,ATP Masters Series Hamburg Germany ATP World Tour,CLAY,2,Max Mirnyi,Gilles Simon,Max Mirnyi,6-3; 6-2,R16,70,2,3,34,58,27,34,14,24,5,5,9,41,58,0,0,36,46,19,36,7,10,2,5,8,26,46
2006-05-15 00:00:00.000,ATP Masters Series Hamburg Germany ATP World Tour,CLAY,2,Radek Stepanek,Robin Soderling,Radek Stepanek,6-3; 6-2,R16,59,6,0,25,41,20,25,13,16,1,1,8,33,41,0,3,33,53,19,33,9,20,4,8,9,28,53
2006-05-15 00:00:00.000,ATP Masters Series Hamburg Germany ATP World Tour,CLAY,2,Tommy Robredo,David Ferrer,Tommy Robredo,7-6(8); 6-4,Q,119,3,0,62,88,34,62,16,26,4,6,11,50,88,0,3,49,73,26,49,13,24,3,6,11,39,73
2006-05-15 00:00:00.000,ATP Masters Series Hamburg Germany ATP World Tour,CLAY,2,Mario Ancic,Nikolay Davydenko,Mario Ancic,5-7; 7-6(4); 6-3,Q,167,12,4,76,121,53,76,25,45,13,16,17,78,121,1,7,73,102,52,73,16,29,3,6,16,68,102
2006-05-15 00:00:00.000,ATP Masters Series Hamburg Germany ATP World Tour,CLAY,2,Jose Acasuso,Fernando Verdasco,Jose Acasuso,6-1; 6-7(6); 6-3,Q,138,3,2,46,86,32,46,27,40,0,2,15,59,86,3,2,68,89,41,68,10,21,4,9,13,51,89
2006-05-15 00:00:00.000,ATP Masters Series Hamburg Germany ATP World Tour,CLAY,2,Radek Stepanek,Max Mirnyi,Radek Stepanek,7-6(5); 6-1,Q,80,6,1,38,54,34,38,9,16,0,1,10,43,54,4,4,32,58,25,32,10,26,2,5,9,35,58
2006-05-15 00:00:00.000,ATP Masters Series Hamburg Germany ATP World Tour,CLAY,2,Tommy Robredo,Mario Ancic,Tommy Robredo,7-5; 6-4,S,122,1,0,60,77,44,60,8,17,9,10,11,52,77,7,1,47,77,29,47,17,30,5,8,11,46,77
2006-05-15 00:00:00.000,ATP Masters Series Hamburg Germany ATP World Tour,CLAY,2,Radek Stepanek,Jose Acasuso,Radek Stepanek,6-4; 7-6(5),S,100,5,3,42,72,36,42,16,30,1,1,11,52,72,9,3,44,79,32,44,19,35,4,5,11,51,79
2006-05-15 00:00:00.000,ATP Masters Series Hamburg Germany ATP World Tour,CLAY,2,Tommy Robredo,Radek Stepanek,Tommy Robredo,6-1; 6-3; 6-3,F,121,0,1,71,90,48,71,13,19,8,8,13,61,90,4,1,65,101,40,65,14,36,8,13,12,54,101
2006-05-22 00:00:00.000,Poertschach Austria ATP World Tour,CLAY,2,Nikolay Davydenko,Tomas Zib,Nikolay Davydenko,6-3; 6-0,R32,66,8,0,26,33,21,26,1,7,1,3,7,22,33,1,0,24,60,11,24,12,36,6,13,8,23,60
2006-05-22 00:00:00.000,Poertschach Austria ATP World Tour,CLAY,2,Ruben Ramirez Hidalgo,Nicolas Lapentti,Ruben Ramirez Hidalgo,4-6; 6-4; 6-3,R32,191,2,3,68,109,45,68,19,41,7,10,15,64,109,3,1,52,110,40,52,24,58,7,11,14,64,110
2006-05-22 00:00:00.000,Poertschach Austria ATP World Tour,CLAY,2,Potito Starace,Alberto Martin,Potito Starace,7-5; 7-6(5),R32,80,1,1,55,68,49,55,7,13,2,2,12,56,68,1,0,45,62,38,45,12,17,0,1,12,50,62
2006-05-22 00:00:00.000,Poertschach Austria ATP World Tour,CLAY,2,Nicolas Almagro,Christophe Rochus,Nicolas Almagro,6-3; 6-4,R32,61,5,1,37,53,33,37,9,16,0,0,10,42,53,0,4,34,62,25,34,12,28,1,3,9,37,62
2006-05-22 00:00:00.000,Poertschach Austria ATP World Tour,CLAY,2,Richard Gasquet,Dominik Hrbaty,Richard Gasquet,6-0; 4-6; 6-3,R32,86,11,0,53,77,38,53,16,24,0,1,13,54,77,7,3,44,67,29,44,12,23,4,8,12,41,67
2006-05-22 00:00:00.000,Poertschach Austria ATP World Tour,CLAY,2,Jurgen Melzer,Stefan Koubek,Jurgen Melzer,6-4; 7-5,R32,98,3,4,52,91,32,52,21,39,8,11,11,53,91,3,3,36,71,23,36,15,35,9,14,11,38,71
2006-05-22 00:00:00.000,Poertschach Austria ATP World Tour,CLAY,2,Jiri Novak,Bjorn Phau,Jiri Novak,6-3; 6-3,R32,61,3,0,32,46,26,32,8,14,1,2,9,34,46,2,1,26,57,15,26,13,31,5,9,9,28,57
2006-05-22 00:00:00.000,Poertschach Austria ATP World Tour,CLAY,2,Juan Ignacio Chela,Jimmy Wang,Juan Ignacio Chela,6-3; 6-1,R32,66,2,3,26,52,22,26,11,26,3,5,8,33,52,0,0,34,54,15,34,7,20,7,13,8,22,54
2006-05-22 00:00:00.000,Poertschach Austria ATP World Tour,CLAY,2,Luis Horna,Wesley Moodie,Luis Horna,7-6(3); 6-3,R32,84,4,0,48,66,38,48,14,18,1,1,11,52,66,7,1,54,72,37,54,9,18,4,5,10,46,72
2006-05-22 00:00:00.000,Poertschach Austria ATP World Tour,CLAY,2,Andreas Seppi,Lukas Dlouhy,Andreas Seppi,6-3; 6-4,R32,68,2,2,34,60,24,34,15,26,3,5,10,39,60,1,4,39,59,23,39,9,20,2,6,9,32,59
2006-05-22 00:00:00.000,Poertschach Austria ATP World Tour,CLAY,2,Gilles Muller,Leonardo Azzaro,Gilles Muller,6-3; 7-6(6),R32,93,14,2,52,82,41,52,15,30,8,8,11,56,82,3,0,45,64,33,45,13,19,3,4,10,46,64
2006-05-22 00:00:00.000,Poertschach Austria ATP World Tour,CLAY,2,Juan Monaco,Dmitry Tursunov,Juan Monaco,7-6(4); 6-2,R32,93,1,3,38,67,28,38,18,29,1,2,10,46,67,6,3,37,67,24,37,18,30,7,10,10,42,67
2006-05-22 00:00:00.000,Poertschach Austria ATP World Tour,CLAY,2,Gilles Simon,Torsten Popp,Gilles Simon,7-5; 6-4,R32,241,6,2,45,71,28,45,15,26,2,5,11,43,71,2,10,38,75,23,38,18,37,8,13,11,41,75
2006-05-22 00:00:00.000,Poertschach Austria ATP World Tour,CLAY,2,Oliver Marach,Vincent Spadea,Oliver Marach,6-4; 6-3,R32,96,9,2,41,66,30,41,12,25,7,8,9,42,66,0,2,32,58,16,32,14,26,1,5,10,30,58
2006-05-22 00:00:00.000,Poertschach Austria ATP World Tour,CLAY,2,Andrei Pavel,Carlos Berlocq,Andrei Pavel,7-5; 6-2,R32,83,2,1,47,65,35,47,8,18,7,9,10,43,65,2,2,28,53,16,28,10,25,1,6,10,26,53
2006-05-22 00:00:00.000,Poertschach Austria ATP World Tour,CLAY,2,Marcos Daniel,Lleyton Hewitt,Marcos Daniel,3-6; 6-3; 7-6(3),R32,153,5,3,65,108,46,65,17,43,9,14,15,63,108,7,3,64,103,41,64,18,39,1,6,15,59,103
2006-05-22 00:00:00.000,Poertschach Austria ATP World Tour,CLAY,2,Nikolay Davydenko,Ruben Ramirez Hidalgo,Nikolay Davydenko,6-2; 6-4,R16,68,6,1,31,50,25,31,10,19,3,4,9,35,50,1,1,30,49,19,30,7,19,1,5,9,26,49
2006-05-22 00:00:00.000,Poertschach Austria ATP World Tour,CLAY,2,Potito Starace,Nicolas Almagro,Potito Starace,4-6; 6-4; 6-1,R16,106,2,1,85,106,52,85,13,21,8,10,14,65,106,4,1,62,82,37,62,11,20,5,9,13,48,82
2006-05-22 00:00:00.000,Poertschach Austria ATP World Tour,CLAY,2,Jurgen Melzer,Richard Gasquet,Jurgen Melzer,6-0; 1-1 RET,R16,29,4,0,15,23,13,15,5,8,1,1,4,18,23,0,1,16,20,8,16,0,4,1,4,4,8,20
2006-05-22 00:00:00.000,Poertschach Austria ATP World Tour,CLAY,2,Jiri Novak,Juan Ignacio Chela,Jiri Novak,6-1; 3-6; 6-2,R16,89,5,2,54,80,36,54,15,26,2,4,12,51,80,3,2,41,72,27,41,11,31,3,8,12,38,72
2006-05-22 00:00:00.000,Poertschach Austria ATP World Tour,CLAY,2,Luis Horna,Andreas Seppi,Luis Horna,6-1; 6-1,R16,58,7,1,30,44,21,30,9,14,2,2,7,30,44,3,3,25,47,14,25,7,22,3,8,7,21,47
2006-05-22 00:00:00.000,Poertschach Austria ATP World Tour,CLAY,2,Juan Monaco,Gilles Muller,Juan Monaco,6-2; 6-0,R16,53,1,2,25,44,18,25,13,19,1,1,7,31,44,1,5,29,49,14,29,6,20,3,8,7,20,49
2006-05-22 00:00:00.000,Poertschach Austria ATP World Tour,CLAY,2,Oliver Marach,Gilles Simon,Oliver Marach,7-6(3); 6-1,R16,97,4,0,43,68,35,43,12,25,2,3,10,47,68,3,1,30,58,18,30,16,28,2,5,9,34,58
2006-05-22 00:00:00.000,Poertschach Austria ATP World Tour,CLAY,2,Andrei Pavel,Marcos Daniel,Andrei Pavel,7-5; 6-0,R16,70,3,1,34,56,24,34,12,22,3,5,9,36,56,0,1,31,57,16,31,11,26,2,8,9,27,57
2006-05-22 00:00:00.000,Poertschach Austria ATP World Tour,CLAY,2,Nikolay Davydenko,Potito Starace,Nikolay Davydenko,6-2; 6-1,Q,49,6,1,27,39,24,27,8,12,0,0,8,32,39,1,0,30,42,12,30,5,12,1,5,7,17,42
2006-05-22 00:00:00.000,Poertschach Austria ATP World Tour,CLAY,2,Jiri Novak,Jurgen Melzer,Jiri Novak,6-7(7); 6-4; 6-4,Q,141,9,3,93,130,61,93,17,37,13,16,16,78,130,7,4,69,118,44,69,22,49,12,17,16,66,118
2006-05-22 00:00:00.000,Poertschach Austria ATP World Tour,CLAY,2,Luis Horna,Juan Monaco,Luis Horna,6-3; 6-4,Q,89,7,0,36,63,27,36,18,27,7,7,10,45,63,1,0,37,53,26,37,8,16,1,3,9,34,53
2006-05-22 00:00:00.000,Poertschach Austria ATP World Tour,CLAY,2,Andrei Pavel,Oliver Marach,Andrei Pavel,6-4; 6-2,Q,88,5,0,50,63,34,50,9,13,4,4,9,43,63,1,2,35,55,20,35,13,20,3,6,9,33,55
2006-05-22 00:00:00.000,Poertschach Austria ATP World Tour,CLAY,2,Nikolay Davydenko,Jiri Novak,Nikolay Davydenko,6-2; 6-2,S,66,3,0,31,45,23,31,8,14,2,3,8,31,45,0,1,33,55,18,33,8,22,7,12,8,26,55
2006-05-22 00:00:00.000,Poertschach Austria ATP World Tour,CLAY,2,Andrei Pavel,Luis Horna,Andrei Pavel,W/O,S,0,0,0,0,0,0,0,0,0,0,0,0,0,0,0,0,0,0,0,0,0,0,0,0,0,0,0
2006-05-22 00:00:00.000,Poertschach Austria ATP World Tour,CLAY,2,Nikolay Davydenko,Andrei Pavel,Nikolay Davydenko,6-0; 6-3,F,63,5,1,19,36,15,19,13,17,0,0,7,28,36,1,2,39,61,19,39,9,22,1,6,8,28,61
2006-05-29 00:00:00.000,Roland Garros France Grand Slams,CLAY,3,Roger Federer,Diego Hartfield,Roger Federer,7-5; 7-6(2); 6-2,R128,156,5,2,70,106,48,70,22,36,6,9,16,70,106,0,2,92,133,53,92,20,41,15,21,16,73,133
2006-05-29 00:00:00.000,Roland Garros France Grand Slams,CLAY,3,Alejandro Falla,Justin Gimelstob,Alejandro Falla,6-4; 6-4; 6-2,R128,113,3,1,66,83,44,66,8,17,3,6,14,52,83,2,3,55,89,33,55,12,34,3,10,14,45,89
2006-05-29 00:00:00.000,Roland Garros France Grand Slams,CLAY,3,Max Mirnyi,Gilles Muller,Max Mirnyi,6-3; 6-1; 7-6(3),R128,103,6,2,43,77,38,43,24,34,0,0,14,62,77,8,3,61,88,41,61,12,27,8,12,14,53,88
2006-05-29 00:00:00.000,Roland Garros France Grand Slams,CLAY,3,Nicolas Massu,Xavier Malisse,Nicolas Massu,6-1; 7-5; 1-6; 4-6; 9-7,R128,265,6,5,99,180,61,99,44,81,16,23,26,105,180,12,3,90,155,65,90,26,65,10,18,26,91,155
2006-05-29 00:00:00.000,Roland Garros France Grand Slams,CLAY,3,Tomas Berdych,Feliciano Lopez,Tomas Berdych,6-2; 6-4; 6-3,R128,124,7,2,47,86,35,47,28,39,6,6,14,63,86,4,2,50,82,31,50,15,32,7,11,13,46,82
2006-05-29 00:00:00.000,Roland Garros France Grand Slams,CLAY,3,Filippo Volandri,Kristian Pless,Filippo Volandri,6-4; 7-6(0); 6-4,R128,127,0,2,81,104,50,81,13,23,9,14,16,63,104,2,4,68,108,39,68,16,40,9,16,16,55,108
2006-05-29 00:00:00.000,Roland Garros France Grand Slams,CLAY,3,Marc Gicquel,Alessio Di Mauro,Marc Gicquel,7-5; 7-6(6); 6-3,R128,156,3,0,70,111,52,70,24,41,6,8,17,76,111,2,0,53,93,39,53,20,40,0,4,16,59,93
2006-05-29 00:00:00.000,Roland Garros France Grand Slams,CLAY,3,Nicolas Kiefer,Jurgen Melzer,Nicolas Kiefer,7-6(4); 6-3; 6-1,R128,131,9,2,47,85,36,47,26,38,1,1,14,62,85,8,1,65,96,45,65,10,31,10,14,14,55,96
2006-05-29 00:00:00.000,Roland Garros France Grand Slams,CLAY,3,Mario Ancic,Nathan Healey,Mario Ancic,6-3; 4-6; 7-6(3); 6-1,R128,196,10,0,79,135,54,79,41,56,12,13,20,95,135,5,6,78,116,53,78,25,38,2,5,18,78,116
2006-05-29 00:00:00.000,Roland Garros France Grand Slams,CLAY,3,Paul Capdeville,Greg Rusedski,Paul Capdeville,6-3; 6-1; 4-6; 7-6(7),R128,175,2,3,77,141,55,77,33,64,8,11,19,88,141,6,8,90,150,55,90,28,60,6,12,19,83,150
2006-05-29 00:00:00.000,Roland Garros France Grand Slams,CLAY,3,Stefano Galvani,Florian Mayer,Stefano Galvani,4-6; 6-0; 7-6(4); 3-6; 7-5,R128,205,4,9,104,157,71,104,25,53,6,12,24,96,157,3,3,102,167,64,102,33,65,11,19,25,97,167
2006-05-29 00:00:00.000,Roland Garros France Grand Slams,CLAY,3,Albert Montanes,Robby Ginepri,Albert Montanes,6-3; 6-7(2); 6-1; 6-4,R128,147,6,2,73,119,53,73,27,46,5,8,20,80,119,1,1,76,114,43,76,22,38,8,15,18,65,114
2006-05-29 00:00:00.000,Roland Garros France Grand Slams,CLAY,3,Jose Acasuso,Fabrice Santoro,Jose Acasuso,6-3; 6-1; 3-6; 1-6; 11-9,R128,237,10,3,91,161,70,91,30,70,5,11,26,100,161,6,1,92,168,60,92,42,76,7,14,26,102,168
2006-05-29 00:00:00.000,Roland Garros France Grand Slams,CLAY,3,Lukas Dlouhy,Kristof Vliegen,Lukas Dlouhy,4-6; 6-4; 3-6; 7-6(5); 6-2,R128,209,6,5,127,183,81,127,28,56,14,21,25,109,183,11,5,92,152,66,92,28,60,11,18,24,94,152
2006-05-29 00:00:00.000,Roland Garros France Grand Slams,CLAY,3,Ilija Bozoljac,Boris Pashanski,Ilija Bozoljac,6-4; 6-3; 6-4,R128,107,15,3,53,86,44,53,17,33,4,5,14,61,86,4,2,61,98,40,61,17,37,4,9,15,57,98
2006-05-29 00:00:00.000,Roland Garros France Grand Slams,CLAY,3,Tommy Robredo,Tomas Zib,Tommy Robredo,6-4; 6-2; 6-2,R128,121,6,2,64,85,46,64,11,21,1,2,13,57,85,1,3,57,94,34,57,15,37,7,13,13,49,94
2006-05-29 00:00:00.000,Roland Garros France Grand Slams,CLAY,3,David Nalbandian,Stanislas Wawrinka,David Nalbandian,6-2; 7-6(5); 6-4,R128,173,0,4,60,112,41,60,28,52,6,8,15,69,112,6,7,61,127,37,61,29,66,13,18,15,66,127
2006-05-29 00:00:00.000,Roland Garros France Grand Slams,CLAY,3,Richard Gasquet,Jimmy Wang,Richard Gasquet,6-4; 6-1; 7-5,R128,112,12,1,45,79,39,45,20,34,3,4,14,59,79,3,4,65,108,34,65,24,43,9,15,15,58,108
2006-05-29 00:00:00.000,Roland Garros France Grand Slams,CLAY,3,Tim Henman,Kenneth Carlsen,Tim Henman,6-3; 6-4; 4-6; 6-4,R128,161,7,4,86,125,65,86,21,39,6,8,20,86,125,4,1,72,110,50,72,19,38,3,7,19,69,110
2006-05-29 00:00:00.000,Roland Garros France Grand Slams,CLAY,3,Dmitry Tursunov,Jiri Novak,Dmitry Tursunov,6-2; 6-3; 6-2,R128,96,6,2,47,83,40,47,18,36,6,6,13,58,83,1,6,52,88,33,52,14,36,8,13,12,47,88
2006-05-29 00:00:00.000,Roland Garros France Grand Slams,CLAY,3,Sebastien Grosjean,Andrei Pavel,Sebastien Grosjean,6-3; 6-2; 6-3,R128,129,7,0,46,81,36,46,22,35,6,7,13,58,81,1,1,70,100,38,70,13,30,11,17,13,51,100
2006-05-29 00:00:00.000,Roland Garros France Grand Slams,CLAY,3,Martin Vassallo Arguello,Paul Goldstein,Martin Vassallo Arguello,6-2; 6-0; 6-3,R128,111,5,0,63,78,40,63,11,15,4,5,12,51,78,0,6,52,92,22,52,19,40,13,20,11,41,92
2006-05-29 00:00:00.000,Roland Garros France Grand Slams,CLAY,3,Nicolas Lapentti,Wesley Moodie,Nicolas Lapentti,4-6; 7-6(5); 7-6(5); 6-7(5); 6-2,R128,269,5,2,140,166,110,140,13,26,8,10,27,123,166,13,5,144,193,105,144,22,49,6,9,27,127,193
2006-05-29 00:00:00.000,Roland Garros France Grand Slams,CLAY,3,Raemon Sluiter,Jarkko Nieminen,Raemon Sluiter,6-2; 7-6(6); 2-1 RET,R128,98,6,2,35,75,25,35,20,40,3,6,11,45,75,2,2,46,78,24,46,16,32,4,10,12,40,78
2006-05-29 00:00:00.000,Roland Garros France Grand Slams,CLAY,3,Gaston Gaudio,Roko Karanusic,Gaston Gaudio,6-2; 6-2; 6-2,R128,92,1,1,52,77,39,52,15,25,5,5,12,54,77,3,0,43,69,26,43,9,26,3,9,12,35,69
2006-05-29 00:00:00.000,Roland Garros France Grand Slams,CLAY,3,Evgeny Korolev,Andreas Seppi,Evgeny Korolev,6-4; 2-6; 3-6; 7-5; 6-1,R128,168,5,8,77,133,54,77,32,56,3,8,23,86,133,6,7,89,145,64,89,22,56,9,15,23,86,145
2006-05-29 00:00:00.000,Roland Garros France Grand Slams,CLAY,3,Philipp Kohlschreiber,Oliver Marach,Philipp Kohlschreiber,6-3; 7-5; 6-7(6); 6-2,R128,183,12,3,75,118,62,75,26,43,2,2,20,88,118,2,0,94,146,64,94,27,52,13,18,21,91,146
2006-05-29 00:00:00.000,Roland Garros France Grand Slams,CLAY,3,Juan Carlos Ferrero,Juan Martin Del Potro,Juan Carlos Ferrero,6-3; 2-6; 6-2; 6-4,R128,177,5,2,80,123,52,80,21,43,15,19,18,73,123,3,3,94,125,55,94,16,31,6,12,17,71,125
2006-05-29 00:00:00.000,Roland Garros France Grand Slams,CLAY,3,Carlos Moya,Juan Antonio Marin,Carlos Moya,7-5; 6-3; 6-3,R128,133,2,2,60,91,46,60,17,31,3,4,15,63,91,3,3,63,98,41,63,17,35,9,14,15,58,98
2006-05-29 00:00:00.000,Roland Garros France Grand Slams,CLAY,3,Mikhail Youzhny,Sasa Tuksar,Mikhail Youzhny,6-3; 6-3; 3-6; 6-0,R128,137,6,4,74,123,51,74,19,49,10,15,17,70,123,1,2,66,102,35,66,13,36,2,11,16,48,102
2006-05-29 00:00:00.000,Roland Garros France Grand Slams,CLAY,3,Flavio Saretta,Potito Starace,Flavio Saretta,6-7(2); 2-6; 6-4; 7-6(1); 6-3,R128,258,7,2,130,191,85,130,29,61,20,26,26,114,191,1,2,141,173,91,141,13,32,7,13,25,104,173
2006-05-29 00:00:00.000,Roland Garros France Grand Slams,CLAY,3,Nikolay Davydenko,Vincent Spadea,Nikolay Davydenko,7-5; 6-4; 6-4,R128,141,2,3,62,103,44,62,23,41,7,9,16,67,103,6,8,62,109,41,62,21,47,10,15,16,62,109
2006-05-29 00:00:00.000,Roland Garros France Grand Slams,CLAY,3,Alberto Martin,Andy Roddick,Alberto Martin,6-4; 7-5; 1-0 RET,R128,101,4,0,39,60,32,39,13,21,1,2,11,45,60,7,3,41,76,31,41,11,35,5,9,12,42,76
2006-05-29 00:00:00.000,Roland Garros France Grand Slams,CLAY,3,Dieter Kindlmann,Razvan Sabau,Dieter Kindlmann,6-3; 6-2; 6-2,R128,110,1,2,72,95,46,72,13,23,5,7,13,59,95,1,3,69,97,35,69,12,28,8,15,12,47,97
2006-05-29 00:00:00.000,Roland Garros France Grand Slams,CLAY,3,Jiri Vanek,Nicolas Mahut,Jiri Vanek,6-3; 7-6(3); 6-7(5); 7-6(3),R128,242,4,3,128,179,85,128,26,51,13,16,23,111,179,6,1,102,150,69,102,24,48,4,8,22,93,150
2006-05-29 00:00:00.000,Roland Garros France Grand Slams,CLAY,3,Olivier Rochus,Jean-Christophe Faurel,Olivier Rochus,6-1; 6-4; 6-2,R128,97,0,1,47,65,39,47,13,18,0,0,13,52,65,1,2,44,73,26,44,15,29,6,11,12,41,73
2006-05-29 00:00:00.000,Roland Garros France Grand Slams,CLAY,3,Marcos Baghdatis,Albert Portas,Marcos Baghdatis,6-4; 6-4; 6-7(5); 6-1,R128,156,6,4,62,119,50,62,33,57,4,7,20,83,119,4,2,75,125,48,75,24,50,6,13,19,72,125
2006-05-29 00:00:00.000,Roland Garros France Grand Slams,CLAY,3,Julien Benneteau,Janko Tipsarevic,Julien Benneteau,6-2; 6-4; 6-7(5); 6-3,R128,177,9,1,102,134,68,102,17,32,5,8,20,85,134,6,5,87,143,53,87,26,56,5,12,19,79,143
2006-05-29 00:00:00.000,Roland Garros France Grand Slams,CLAY,3,Davide Sanguinetti,Daniele Bracciali,Davide Sanguinetti,3-6; 7-6(10); 6-3; 6-3,R128,167,6,0,75,117,64,75,24,42,2,3,19,88,117,10,1,71,134,50,71,38,63,6,9,20,88,134
2006-05-29 00:00:00.000,Roland Garros France Grand Slams,CLAY,3,Radek Stepanek,Michael Llodra,Radek Stepanek,6-4; 6-4; 6-2,R128,100,3,0,53,82,44,53,19,29,8,8,14,63,82,5,1,51,84,36,51,17,33,6,10,14,53,84
2006-05-29 00:00:00.000,Roland Garros France Grand Slams,CLAY,3,David Ferrer,Guillermo Garcia-Lopez,David Ferrer,7-5; 6-1; 6-0,R128,110,2,0,60,89,42,60,17,29,3,4,13,59,89,2,3,36,74,18,36,13,38,4,11,12,31,74
2006-05-29 00:00:00.000,Roland Garros France Grand Slams,CLAY,3,Jeremy Chardy,Jonas Bjorkman,Jeremy Chardy,6-2; 7-5; 6-2,R128,109,7,3,48,74,38,48,13,26,0,2,14,51,74,6,3,64,95,39,64,12,31,6,13,14,51,95
2006-05-29 00:00:00.000,Roland Garros France Grand Slams,CLAY,3,Ruben Ramirez Hidalgo,Thierry Ascione,Ruben Ramirez Hidalgo,7-6(7); 6-4; 6-7(6); 6-3,R128,177,7,2,99,147,69,99,29,48,6,9,22,98,147,8,5,97,140,61,97,24,43,4,9,21,85,140
2006-05-29 00:00:00.000,Roland Garros France Grand Slams,CLAY,3,Christophe Rochus,Thomas Johansson,Christophe Rochus,3-6; 5-7; 6-4; 6-4; 6-2,R128,189,7,4,96,156,73,96,26,60,4,8,24,99,156,25,4,77,156,61,77,34,79,10,16,25,95,156
2006-05-29 00:00:00.000,Roland Garros France Grand Slams,CLAY,3,Fernando Verdasco,Juan Ignacio Chela,Fernando Verdasco,6-1; 6-3; 6-7(6); 6-4,R128,174,0,3,96,118,64,96,12,22,5,9,19,76,118,2,6,95,143,58,95,15,48,8,17,19,73,143
2006-05-29 00:00:00.000,Roland Garros France Grand Slams,CLAY,3,Juan Monaco,Melle Van Gemerden,Juan Monaco,6-3; 6-2; 6-4,R128,116,7,1,51,79,37,51,18,28,2,4,14,55,79,5,5,63,100,38,63,15,37,15,21,13,53,100
2006-05-29 00:00:00.000,Roland Garros France Grand Slams,CLAY,3,Oscar Hernandez,Gilles Simon,Oscar Hernandez,6-4; 6-2; 6-3,R128,115,0,3,54,80,39,54,13,26,4,6,13,52,80,3,0,53,85,29,53,13,32,6,13,14,42,85
2006-05-29 00:00:00.000,Roland Garros France Grand Slams,CLAY,3,Ivan Ljubicic,Carlos Berlocq,Ivan Ljubicic,6-2; 6-0; 6-3,R128,95,3,2,41,59,31,41,15,18,1,1,11,46,59,2,3,59,101,29,59,19,42,11,18,12,48,101
2006-05-29 00:00:00.000,Roland Garros France Grand Slams,CLAY,3,James Blake,Paradorn Srichaphan,James Blake,6-0; 6-4; 7-6(3),R128,93,5,0,59,85,45,59,16,26,2,4,14,61,85,1,2,47,84,27,47,18,37,2,8,14,45,84
2006-05-29 00:00:00.000,Roland Garros France Grand Slams,CLAY,3,Nicolas Almagro,Wayne Arthurs,Nicolas Almagro,7-5; 6-2; 6-2,R128,95,12,0,60,81,45,60,18,21,2,2,14,63,81,11,4,46,82,34,46,14,36,9,14,14,48,82
2006-05-29 00:00:00.000,Roland Garros France Grand Slams,CLAY,3,Dick Norman,Edgardo Massa,Dick Norman,6-1; 6-3; 6-3,R128,91,7,5,56,74,44,56,10,18,3,4,13,54,74,0,3,66,82,32,66,8,16,6,12,12,40,82
2006-05-29 00:00:00.000,Roland Garros France Grand Slams,CLAY,3,Gael Monfils,Andy Murray,Gael Monfils,6-4; 6-7(2); 1-6; 6-2; 6-1,R128,222,6,10,105,168,67,105,27,63,14,20,22,94,168,0,3,107,162,60,107,27,55,14,23,22,87,162
2006-05-29 00:00:00.000,Roland Garros France Grand Slams,CLAY,3,Tommy Haas,Rainer Schuettler,Tommy Haas,6-4; 6-3; 6-3,R128,101,4,3,40,76,31,40,24,36,3,4,14,55,76,2,2,57,90,32,57,18,33,7,12,14,50,90
2006-05-29 00:00:00.000,Roland Garros France Grand Slams,CLAY,3,Alexander Waske,Fernando Vicente,Alexander Waske,6-4; 4-6; 7-6(6); 7-6(4),R128,206,11,3,99,151,72,99,26,52,6,11,22,98,151,4,3,104,142,68,104,20,38,6,11,22,88,142
2006-05-29 00:00:00.000,Roland Garros France Grand Slams,CLAY,3,Novak Djokovic,Luis Horna,Novak Djokovic,6-3; 5-0 RET,R128,60,6,1,30,36,25,30,4,6,0,0,7,29,36,1,2,32,53,16,32,11,21,4,8,7,27,53
2006-05-29 00:00:00.000,Roland Garros France Grand Slams,CLAY,3,Fernando Gonzalez,Marat Safin,Fernando Gonzalez,6-3; 1-6; 6-3; 6-1,R128,149,7,3,65,99,44,65,17,34,8,12,16,61,99,7,3,76,133,48,76,21,57,19,26,16,69,133
2006-05-29 00:00:00.000,Roland Garros France Grand Slams,CLAY,3,Lleyton Hewitt,Jan Hernych,Lleyton Hewitt,7-6(5); 3-6; 6-2; 6-0,R128,171,4,1,88,137,51,88,26,49,5,10,17,77,137,4,4,74,119,42,74,19,45,5,14,18,61,119
2006-05-29 00:00:00.000,Roland Garros France Grand Slams,CLAY,3,Mathieu Montcourt,Marcos Daniel,Mathieu Montcourt,6-2; 6-4; 1-6; 6-2,R128,146,1,6,70,104,46,70,17,34,8,12,16,63,104,5,0,66,103,39,66,17,37,9,16,17,56,103
2006-05-29 00:00:00.000,Roland Garros France Grand Slams,CLAY,3,Ivo Karlovic,Olivier Patience,Ivo Karlovic,7-6(6); 7-6(1); 7-6(10),R128,147,26,0,86,119,73,86,20,33,1,1,18,93,119,4,1,91,119,71,91,20,28,2,2,18,91,119
2006-05-29 00:00:00.000,Roland Garros France Grand Slams,CLAY,3,Dominik Hrbaty,Sergio Roitman,Dominik Hrbaty,6-4; 6-2; 3-6; 2-6; 6-3,R128,164,6,2,85,141,63,85,24,56,12,17,22,87,141,2,1,81,114,51,81,21,33,6,12,22,72,114
2006-05-29 00:00:00.000,Roland Garros France Grand Slams,CLAY,3,Paul-Henri Mathieu,Bjorn Phau,Paul-Henri Mathieu,6-4; 6-2; 6-1,R128,130,0,2,49,80,30,49,18,31,0,3,13,48,80,1,1,47,96,23,47,19,49,12,20,12,42,96
2006-05-29 00:00:00.000,Roland Garros France Grand Slams,CLAY,3,Florent Serra,Robin Vik,Florent Serra,6-1; 1-6; 7-5; 6-4,R128,135,2,3,61,113,41,61,25,52,7,12,18,66,113,8,3,81,130,49,81,19,49,16,23,18,68,130
2006-05-29 00:00:00.000,Roland Garros France Grand Slams,CLAY,3,Kevin Kim,Julio Silva,Kevin Kim,7-5; 6-2; 6-7(4); 7-6(3),R128,172,10,6,79,128,62,79,24,49,4,9,22,86,128,3,1,112,154,67,112,20,42,14,22,22,87,154
2006-05-29 00:00:00.000,Roland Garros France Grand Slams,CLAY,3,Rafael Nadal,Robin Soderling,Rafael Nadal,6-2; 7-5; 6-1,R128,128,1,3,56,81,42,56,12,25,5,7,13,54,81,2,1,73,100,37,73,11,27,14,22,14,48,100
2006-05-29 00:00:00.000,Roland Garros France Grand Slams,CLAY,3,Roger Federer,Alejandro Falla,Roger Federer,6-1; 6-4; 6-3,R64,86,4,0,46,68,40,46,15,22,3,3,13,55,68,4,1,57,86,33,57,14,29,6,11,13,47,86
2006-05-29 00:00:00.000,Roland Garros France Grand Slams,CLAY,3,Nicolas Massu,Max Mirnyi,Nicolas Massu,6-4; 7-5; 6-4,R64,150,4,1,58,78,51,58,11,20,1,2,16,62,78,9,8,55,97,39,55,22,42,7,11,16,61,97
2006-05-29 00:00:00.000,Roland Garros France Grand Slams,CLAY,3,Tomas Berdych,Filippo Volandri,Tomas Berdych,6-3; 6-1; 6-1,R64,94,6,1,43,75,32,43,17,32,8,10,12,49,75,0,0,53,73,20,53,9,20,6,14,11,29,73
2006-05-29 00:00:00.000,Roland Garros France Grand Slams,CLAY,3,Nicolas Kiefer,Marc Gicquel,Nicolas Kiefer,6-0; 6-1; 5-7; 3-6; 11-9,R64,290,15,4,90,172,65,90,44,82,13,18,27,109,172,8,3,120,203,75,120,36,83,16,25,27,111,203
2006-05-29 00:00:00.000,Roland Garros France Grand Slams,CLAY,3,Mario Ancic,Paul Capdeville,Mario Ancic,7-5; 6-3; 7-6(3),R64,159,8,0,65,96,57,65,15,31,4,5,17,72,96,5,3,89,132,61,89,19,43,10,13,16,80,132
2006-05-29 00:00:00.000,Roland Garros France Grand Slams,CLAY,3,Albert Montanes,Stefano Galvani,Albert Montanes,7-5; 6-1; 3-6; 2-6; 6-4,R64,181,4,2,98,137,70,98,24,39,6,9,23,94,137,2,6,91,152,60,91,37,61,10,14,23,97,152
2006-05-29 00:00:00.000,Roland Garros France Grand Slams,CLAY,3,Lukas Dlouhy,Jose Acasuso,Lukas Dlouhy,4-6; 7-6(2); 6-3; 6-1,R64,139,4,5,81,122,58,81,21,41,4,7,19,79,122,3,1,80,131,50,80,29,51,6,12,19,79,131
2006-05-29 00:00:00.000,Roland Garros France Grand Slams,CLAY,3,Tommy Robredo,Ilija Bozoljac,Tommy Robredo,7-5; 6-2; 3-6; 6-1,R64,128,0,1,77,97,57,77,14,20,2,4,18,71,97,9,2,56,102,39,56,21,46,1,7,18,60,102
2006-05-29 00:00:00.000,Roland Garros France Grand Slams,CLAY,3,David Nalbandian,Richard Gasquet,David Nalbandian,6-2; 3-6; 7-5; 6-0,R64,152,3,3,64,104,43,64,22,40,8,11,17,65,104,7,6,75,125,47,75,20,50,8,16,18,67,125
2006-05-29 00:00:00.000,Roland Garros France Grand Slams,CLAY,3,Dmitry Tursunov,Tim Henman,Dmitry Tursunov,6-3; 6-2; 4-6; 6-4,R64,171,10,9,87,151,65,87,28,64,18,21,19,93,151,3,1,75,118,48,75,19,43,8,14,18,67,118
2006-05-29 00:00:00.000,Roland Garros France Grand Slams,CLAY,3,Martin Vassallo Arguello,Sebastien Grosjean,Martin Vassallo Arguello,1-6; 6-4; 4-6; 7-5; 6-2,R64,238,3,1,121,151,71,121,16,30,10,18,23,87,151,3,0,85,149,61,85,27,64,14,23,24,88,149
2006-05-29 00:00:00.000,Roland Garros France Grand Slams,CLAY,3,Raemon Sluiter,Nicolas Lapentti,Raemon Sluiter,6-1; 6-4; 6-1,R64,104,7,4,47,78,41,47,9,31,7,9,12,50,78,2,1,59,84,29,59,12,25,9,17,12,41,84
2006-05-29 00:00:00.000,Roland Garros France Grand Slams,CLAY,3,Gaston Gaudio,Evgeny Korolev,Gaston Gaudio,6-3; 6-7(5); 6-4; 3-6; 6-4,R64,212,3,3,119,175,79,119,29,56,7,13,26,108,175,5,6,88,140,64,88,25,52,8,15,24,89,140
2006-05-29 00:00:00.000,Roland Garros France Grand Slams,CLAY,3,Juan Carlos Ferrero,Philipp Kohlschreiber,Juan Carlos Ferrero,6-2; 6-4; 6-2,R64,101,3,2,50,72,37,50,9,22,0,2,13,46,72,6,1,46,79,30,46,9,33,7,14,13,39,79
2006-05-29 00:00:00.000,Roland Garros France Grand Slams,CLAY,3,Carlos Moya,Mikhail Youzhny,Carlos Moya,6-3; 6-4; 6-2,R64,114,3,0,53,95,42,53,22,42,3,3,14,64,95,1,2,55,82,35,55,13,27,5,9,13,48,82
2006-05-29 00:00:00.000,Roland Garros France Grand Slams,CLAY,3,Nikolay Davydenko,Flavio Saretta,Nikolay Davydenko,6-2; 4-1 RET,R64,64,0,1,16,30,13,16,11,14,0,0,6,24,30,2,1,39,62,19,39,12,23,4,8,7,31,62
2006-05-29 00:00:00.000,Roland Garros France Grand Slams,CLAY,3,Alberto Martin,Dieter Kindlmann,Alberto Martin,6-3; 6-3; 6-3,R64,114,4,1,62,93,42,62,17,31,5,7,13,59,93,1,1,57,85,35,57,9,28,3,10,14,44,85
2006-05-29 00:00:00.000,Roland Garros France Grand Slams,CLAY,3,Olivier Rochus,Jiri Vanek,Olivier Rochus,6-2; 6-0; 6-2,R64,98,1,0,46,66,33,46,14,20,0,0,11,47,66,7,4,60,96,34,60,9,36,10,17,11,43,96
2006-05-29 00:00:00.000,Roland Garros France Grand Slams,CLAY,3,Julien Benneteau,Marcos Baghdatis,Julien Benneteau,3-6; 6-4; 6-3; 6-7(1); 6-4,R64,226,3,3,116,162,79,116,26,46,4,7,25,105,162,9,3,91,166,63,91,43,75,12,17,25,106,166
2006-05-29 00:00:00.000,Roland Garros France Grand Slams,CLAY,3,Radek Stepanek,Davide Sanguinetti,Radek Stepanek,6-3; 6-3; 6-1,R64,85,12,4,43,71,39,43,16,28,1,1,13,55,71,4,1,50,82,29,50,16,32,4,9,12,45,82
2006-05-29 00:00:00.000,Roland Garros France Grand Slams,CLAY,3,David Ferrer,Jeremy Chardy,David Ferrer,6-1; 6-4; 3-6; 6-1,R64,133,1,5,71,114,49,71,23,43,6,10,17,72,114,2,8,71,116,37,71,18,45,12,20,16,55,116
2006-05-29 00:00:00.000,Roland Garros France Grand Slams,CLAY,3,Ruben Ramirez Hidalgo,Christophe Rochus,Ruben Ramirez Hidalgo,5-2 RET,R64,39,1,0,18,28,14,18,5,10,2,2,4,19,28,0,2,18,31,11,18,5,13,6,7,3,16,31
2006-05-29 00:00:00.000,Roland Garros France Grand Slams,CLAY,3,Juan Monaco,Fernando Verdasco,Juan Monaco,4-6; 6-4; 6-4; 6-1,R64,163,3,2,96,118,59,96,10,22,9,14,18,69,118,2,4,104,139,60,104,14,35,13,22,19,74,139
2006-05-29 00:00:00.000,Roland Garros France Grand Slams,CLAY,3,Ivan Ljubicic,Oscar Hernandez,Ivan Ljubicic,6-3; 6-7(7); 6-1; 6-2,R64,169,8,5,79,123,67,79,20,44,7,7,19,87,123,1,1,73,115,42,73,27,42,2,7,17,69,115
2006-05-29 00:00:00.000,Roland Garros France Grand Slams,CLAY,3,James Blake,Nicolas Almagro,James Blake,6-7(5); 6-2; 6-4; 6-4,R64,158,6,1,65,114,52,65,30,49,0,1,20,82,114,7,2,91,153,63,91,27,62,6,11,20,90,153
2006-05-29 00:00:00.000,Roland Garros France Grand Slams,CLAY,3,Gael Monfils,Dick Norman,Gael Monfils,4-6; 6-3; 6-7(4); 6-0; 7-5,R64,199,7,3,89,142,70,89,29,53,4,7,25,99,142,4,7,100,156,62,100,29,56,8,15,24,91,156
2006-05-29 00:00:00.000,Roland Garros France Grand Slams,CLAY,3,Tommy Haas,Alexander Waske,Tommy Haas,6-4; 7-5; 6-7(6); 6-4,R64,197,16,2,92,149,72,92,31,57,9,10,22,103,149,14,4,89,138,66,89,24,49,3,7,22,90,138
2006-05-29 00:00:00.000,Roland Garros France Grand Slams,CLAY,3,Novak Djokovic,Fernando Gonzalez,Novak Djokovic,6-4; 6-1; 3-6; 4-6; 6-1,R64,183,6,1,105,153,75,105,26,48,12,15,22,101,153,9,4,73,114,53,73,18,41,4,10,21,71,114
2006-05-29 00:00:00.000,Roland Garros France Grand Slams,CLAY,3,Lleyton Hewitt,Mathieu Montcourt,Lleyton Hewitt,7-5; 6-3; 6-3,R64,144,6,3,62,105,43,62,20,43,5,9,15,63,105,1,7,62,97,36,62,11,35,10,18,15,47,97
2006-05-29 00:00:00.000,Roland Garros France Grand Slams,CLAY,3,Dominik Hrbaty,Ivo Karlovic,Dominik Hrbaty,4-6; 6-4; 6-7(2); 7-5; 6-2,R64,204,11,7,91,154,73,91,38,63,8,9,26,111,154,31,1,119,161,89,119,19,42,12,16,26,108,161
2006-05-29 00:00:00.000,Roland Garros France Grand Slams,CLAY,3,Paul-Henri Mathieu,Florent Serra,Paul-Henri Mathieu,6-0; 7-6(5); 7-6(6),R64,153,4,3,65,96,42,65,19,31,2,5,15,61,96,3,1,64,115,40,64,22,51,5,11,15,62,115
2006-05-29 00:00:00.000,Roland Garros France Grand Slams,CLAY,3,Rafael Nadal,Kevin Kim,Rafael Nadal,6-2; 6-1; 6-4,R64,118,2,0,56,76,41,56,15,20,3,3,13,56,76,2,1,53,89,31,53,16,36,10,15,12,47,89
2006-05-29 00:00:00.000,Roland Garros France Grand Slams,CLAY,3,Roger Federer,Nicolas Massu,Roger Federer,6-1; 6-2; 6-7(4); 7-5,R32,155,6,3,70,114,52,70,29,44,5,7,20,81,114,4,5,77,119,51,77,18,42,5,12,19,69,119
2006-05-29 00:00:00.000,Roland Garros France Grand Slams,CLAY,3,Tomas Berdych,Nicolas Kiefer,Tomas Berdych,6-1 RET,R32,29,3,0,11,19,10,11,6,8,0,0,4,16,19,2,2,9,19,7,9,2,10,2,4,3,9,19
2006-05-29 00:00:00.000,Roland Garros France Grand Slams,CLAY,3,Mario Ancic,Albert Montanes,Mario Ancic,6-1; 6-2; 6-4,R32,93,9,1,52,71,42,52,11,19,1,2,13,53,71,0,3,47,73,27,47,7,26,6,12,12,34,73
2006-05-29 00:00:00.000,Roland Garros France Grand Slams,CLAY,3,Tommy Robredo,Lukas Dlouhy,Tommy Robredo,6-1; 6-4; 6-2,R32,97,1,1,77,92,53,77,6,15,7,8,13,59,92,1,5,57,86,31,57,11,29,6,12,12,42,86
2006-05-29 00:00:00.000,Roland Garros France Grand Slams,CLAY,3,David Nalbandian,Dmitry Tursunov,David Nalbandian,2-6; 5-7; 6-4; 6-2; 6-4,R32,191,8,1,97,148,69,97,25,51,5,10,24,94,148,10,3,85,137,60,85,28,52,5,11,24,88,137
2006-05-29 00:00:00.000,Roland Garros France Grand Slams,CLAY,3,Martin Vassallo Arguello,Raemon Sluiter,Martin Vassallo Arguello,2-6; 6-4; 6-3; 3-6; 6-1,R32,186,12,1,101,128,71,101,12,27,7,11,21,83,128,8,8,78,142,57,78,27,64,4,10,22,84,142
2006-05-29 00:00:00.000,Roland Garros France Grand Slams,CLAY,3,Gaston Gaudio,Juan Carlos Ferrero,Gaston Gaudio,7-5; 7-5; 7-6(7),R32,195,3,3,82,118,60,82,18,36,3,7,18,78,118,2,0,98,130,59,98,16,32,14,20,18,75,130
2006-05-29 00:00:00.000,Roland Garros France Grand Slams,CLAY,3,Nikolay Davydenko,Carlos Moya,Nikolay Davydenko,6-1; 7-5; 6-3,R32,123,3,3,55,79,40,55,13,24,5,7,14,53,79,2,1,55,100,31,55,19,45,10,17,14,50,100
2006-05-29 00:00:00.000,Roland Garros France Grand Slams,CLAY,3,Alberto Martin,Olivier Rochus,Alberto Martin,7-5; 4-6; 6-7(5); 6-1; 6-4,R32,239,12,7,123,193,83,123,35,70,16,22,26,118,193,2,2,96,155,57,96,32,59,8,17,25,89,155
2006-05-29 00:00:00.000,Roland Garros France Grand Slams,CLAY,3,Julien Benneteau,Radek Stepanek,Julien Benneteau,5-7; 7-5; 7-6(8); 6-3,R32,213,6,0,97,144,68,97,31,47,3,5,23,99,144,15,5,94,151,74,94,25,57,11,14,22,99,151
2006-05-29 00:00:00.000,Roland Garros France Grand Slams,CLAY,3,Ruben Ramirez Hidalgo,David Ferrer,Ruben Ramirez Hidalgo,7-6(4); 7-5; 6-4,R32,165,3,2,67,112,46,67,20,45,4,8,17,66,112,3,4,66,119,41,66,26,53,9,15,17,67,119
2006-05-29 00:00:00.000,Roland Garros France Grand Slams,CLAY,3,Ivan Ljubicic,Juan Monaco,Ivan Ljubicic,4-6; 5-7; 6-3; 6-4; 6-2,R32,240,13,5,88,163,62,88,36,75,14,20,25,98,163,2,1,102,144,60,102,26,42,8,16,24,86,144
2006-05-29 00:00:00.000,Roland Garros France Grand Slams,CLAY,3,Gael Monfils,James Blake,Gael Monfils,6-2; 6-7(2); 7-6(1); 5-7; 6-4,R32,201,12,3,122,174,81,122,31,52,13,18,27,112,174,3,2,116,177,72,116,35,61,7,14,27,107,177
2006-05-29 00:00:00.000,Roland Garros France Grand Slams,CLAY,3,Novak Djokovic,Tommy Haas,Novak Djokovic,7-5; 6-1; 7-6(4),R32,134,6,3,57,80,43,57,16,23,2,4,15,59,80,5,2,60,101,40,60,19,41,6,12,16,59,101
2006-05-29 00:00:00.000,Roland Garros France Grand Slams,CLAY,3,Lleyton Hewitt,Dominik Hrbaty,Lleyton Hewitt,7-6(5); 6-2; 6-2,R32,126,11,2,63,104,47,63,22,41,6,8,14,69,104,4,4,58,94,37,58,13,36,5,11,14,50,94
2006-05-29 00:00:00.000,Roland Garros France Grand Slams,CLAY,3,Rafael Nadal,Paul-Henri Mathieu,Rafael Nadal,5-7; 6-4; 6-4; 6-4,R32,293,6,1,88,129,54,88,23,41,7,13,21,77,129,4,5,108,168,62,108,27,60,21,29,21,89,168
2006-05-29 00:00:00.000,Roland Garros France Grand Slams,CLAY,3,Roger Federer,Tomas Berdych,Roger Federer,6-3; 6-2; 6-3,R16,107,9,1,50,79,38,50,16,29,2,3,13,54,79,7,3,54,92,39,54,10,38,10,16,13,49,92
2006-05-29 00:00:00.000,Roland Garros France Grand Slams,CLAY,3,Mario Ancic,Tommy Robredo,Mario Ancic,6-4; 4-6; 2-6; 6-4; 7-5,R16,229,8,1,89,147,61,89,30,58,4,9,25,91,147,3,2,112,144,74,112,18,32,5,10,25,92,144
2006-05-29 00:00:00.000,Roland Garros France Grand Slams,CLAY,3,David Nalbandian,Martin Vassallo Arguello,David Nalbandian,6-4; 6-4; 6-4,R16,130,1,4,59,94,39,59,19,35,4,7,15,58,94,6,1,77,96,42,77,10,19,4,10,15,52,96
2006-05-29 00:00:00.000,Roland Garros France Grand Slams,CLAY,3,Nikolay Davydenko,Gaston Gaudio,Nikolay Davydenko,6-3; 6-4; 3-6; 6-3,R16,170,5,3,71,113,46,71,20,42,13,20,19,66,113,1,5,65,115,35,65,25,50,11,20,18,60,115
2006-05-29 00:00:00.000,Roland Garros France Grand Slams,CLAY,3,Julien Benneteau,Alberto Martin,Julien Benneteau,5-1 RET,R16,28,1,0,10,15,9,10,3,5,0,0,3,12,15,0,1,7,16,5,7,2,9,1,3,3,7,16
2006-05-29 00:00:00.000,Roland Garros France Grand Slams,CLAY,3,Ivan Ljubicic,Ruben Ramirez Hidalgo,Ivan Ljubicic,6-3; 3-6; 6-3; 6-2,R16,182,6,1,63,108,46,63,25,45,2,4,18,71,108,3,1,53,109,29,53,34,56,10,15,17,63,109
2006-05-29 00:00:00.000,Roland Garros France Grand Slams,CLAY,3,Novak Djokovic,Gael Monfils,Novak Djokovic,7-6(5); 7-6(5); 6-3,R16,153,7,4,59,101,44,59,28,42,3,6,17,72,101,6,3,48,101,35,48,29,53,5,9,16,64,101
2006-05-29 00:00:00.000,Roland Garros France Grand Slams,CLAY,3,Rafael Nadal,Lleyton Hewitt,Rafael Nadal,6-2; 5-7; 6-4; 6-2,R16,197,1,4,79,113,53,79,21,34,5,9,19,74,113,4,6,62,121,42,62,22,59,13,21,19,64,121
2006-05-29 00:00:00.000,Roland Garros France Grand Slams,CLAY,3,Roger Federer,Mario Ancic,Roger Federer,6-4; 6-3; 6-4,Q,137,4,0,65,104,43,65,28,39,8,9,15,71,104,3,2,64,100,45,64,13,36,14,18,14,58,100
2006-05-29 00:00:00.000,Roland Garros France Grand Slams,CLAY,3,David Nalbandian,Nikolay Davydenko,David Nalbandian,6-3; 6-3; 2-6; 6-4,Q,166,8,4,66,112,44,66,26,46,6,10,18,70,112,9,0,93,129,59,93,16,36,15,21,18,75,129
2006-05-29 00:00:00.000,Roland Garros France Grand Slams,CLAY,3,Ivan Ljubicic,Julien Benneteau,Ivan Ljubicic,6-2; 6-2; 6-3,Q,133,13,0,53,93,37,53,21,40,7,10,13,58,93,1,3,40,70,17,40,12,30,1,9,12,29,70
2006-05-29 00:00:00.000,Roland Garros France Grand Slams,CLAY,3,Rafael Nadal,Novak Djokovic,Rafael Nadal,6-4; 6-4 RET,Q,114,3,0,47,59,30,47,7,12,3,6,10,37,59,2,3,49,67,27,49,4,18,2,7,10,31,67
2006-05-29 00:00:00.000,Roland Garros France Grand Slams,CLAY,3,Roger Federer,David Nalbandian,Roger Federer,3-6; 6-4; 5-2 RET,S,98,4,1,41,72,32,41,15,31,2,5,13,47,72,1,5,49,74,28,49,17,25,4,8,13,45,74
2006-05-29 00:00:00.000,Roland Garros France Grand Slams,CLAY,3,Rafael Nadal,Ivan Ljubicic,Rafael Nadal,6-4; 6-2; 7-6(7),S,169,7,0,65,95,51,65,17,30,1,2,15,68,95,10,5,61,104,42,61,22,43,5,9,15,64,104
2006-05-29 00:00:00.000,Roland Garros France Grand Slams,CLAY,3,Rafael Nadal,Roger Federer,Rafael Nadal,1-6; 6-1; 6-4; 7-6(4),F,182,3,0,85,111,59,85,17,26,7,10,18,76,111,8,1,72,119,49,72,25,47,8,12,18,74,119
2006-06-12 00:00:00.000,Halle Germany ATP World Tour,GRASS,2,Roger Federer,Rohan Bopanna,Roger Federer,7-6(4); 6-2,R32,71,7,0,37,56,32,37,16,19,2,2,10,48,56,9,10,31,76,27,31,20,45,9,11,10,47,76
2006-06-12 00:00:00.000,Halle Germany ATP World Tour,GRASS,2,Richard Gasquet,George Bastl,Richard Gasquet,6-2; 6-3,R32,64,8,1,38,50,31,38,7,12,1,1,9,38,50,2,4,37,58,24,37,7,21,4,7,8,31,58
2006-06-12 00:00:00.000,Halle Germany ATP World Tour,GRASS,2,Marat Safin,Florent Serra,Marat Safin,7-6(4); 6-3,R32,72,5,0,39,66,35,39,13,27,1,2,11,48,66,1,2,37,64,26,37,16,27,1,3,10,42,64
2006-06-12 00:00:00.000,Halle Germany ATP World Tour,GRASS,2,Olivier Rochus,Alexander Waske,Olivier Rochus,2-6; 6-4; 6-3,R32,114,3,4,50,84,37,50,20,34,3,5,14,57,84,14,5,48,80,37,48,16,32,5,7,13,53,80
2006-06-12 00:00:00.000,Halle Germany ATP World Tour,GRASS,2,Andrei Pavel,Marcos Baghdatis,Andrei Pavel,7-6(5); 6-3,R32,82,6,2,39,65,30,39,11,26,1,3,10,41,65,9,2,34,67,22,34,16,33,4,8,11,38,67
2006-06-12 00:00:00.000,Halle Germany ATP World Tour,GRASS,2,Robin Soderling,Rainer Schuettler,Robin Soderling,6-3; 7-6(3),R32,68,6,2,46,67,40,46,11,21,2,2,11,51,67,7,3,34,59,29,34,13,25,2,3,10,42,59
2006-06-12 00:00:00.000,Halle Germany ATP World Tour,GRASS,2,Andreas Seppi,Davide Sanguinetti,Andreas Seppi,7-6(12); 7-5,R32,103,4,2,52,88,40,52,20,36,3,3,12,60,88,5,5,50,88,34,50,25,38,5,6,12,59,88
2006-06-12 00:00:00.000,Halle Germany ATP World Tour,GRASS,2,Tommy Haas,Gilles Simon,Tommy Haas,6-4; 7-5,R32,66,6,2,35,58,29,35,15,23,0,0,11,44,58,6,0,35,59,27,35,15,24,3,5,11,42,59
2006-06-12 00:00:00.000,Halle Germany ATP World Tour,GRASS,2,Kristof Vliegen,Stanislas Wawrinka,Kristof Vliegen,6-2; 6-3,R32,64,3,0,26,37,24,26,8,11,0,0,8,32,37,5,4,24,58,14,24,16,34,2,6,9,30,58
2006-06-12 00:00:00.000,Halle Germany ATP World Tour,GRASS,2,Marco Chiudinelli,Christophe Rochus,Marco Chiudinelli,6-3; 6-4,R32,62,5,2,30,57,22,30,17,27,3,5,10,39,57,2,4,38,58,26,38,5,20,1,5,9,31,58
2006-06-12 00:00:00.000,Halle Germany ATP World Tour,GRASS,2,Florian Mayer,Bjorn Phau,Florian Mayer,7-5; 1-6; 7-6(8),R32,114,7,2,73,104,47,73,12,31,5,10,15,59,104,6,4,63,111,46,63,20,48,2,6,16,66,111
2006-06-12 00:00:00.000,Halle Germany ATP World Tour,GRASS,2,Jarkko Nieminen,Philipp Kohlschreiber,Jarkko Nieminen,7-6(3); 6-4,R32,81,6,0,42,65,30,42,17,23,1,2,11,47,65,9,9,36,65,28,36,14,29,1,3,11,42,65
2006-06-12 00:00:00.000,Halle Germany ATP World Tour,GRASS,2,Tomas Berdych,Benjamin Becker,Tomas Berdych,6-4; 6-3,R32,63,13,1,32,48,27,32,14,16,3,3,10,41,48,10,3,30,54,23,30,12,24,6,8,9,35,54
2006-06-12 00:00:00.000,Halle Germany ATP World Tour,GRASS,2,Jiri Novak,Boris Pashanski,Jiri Novak,7-5; 6-2,R32,70,4,2,35,54,31,35,7,19,0,1,10,38,54,3,9,43,77,28,43,11,34,11,15,10,39,77
2006-06-12 00:00:00.000,Halle Germany ATP World Tour,GRASS,2,Fabrice Santoro,Mikhail Youzhny,Fabrice Santoro,7-6(4); 6-2,R32,90,1,0,34,68,28,34,18,34,0,0,10,46,68,3,0,37,58,23,37,13,21,0,2,10,36,58
2006-06-12 00:00:00.000,Halle Germany ATP World Tour,GRASS,2,Arnaud Clement,Kristian Pless,Arnaud Clement,7-5; 6-3,R32,76,6,0,43,56,31,43,10,13,3,4,10,41,56,4,2,37,68,24,37,14,31,2,6,11,38,68
2006-06-12 00:00:00.000,Halle Germany ATP World Tour,GRASS,2,Roger Federer,Richard Gasquet,Roger Federer,7-6(7); 6-7(7); 6-4,R16,134,10,0,74,113,57,74,22,39,1,2,17,79,113,1,0,75,110,55,75,21,35,2,4,17,76,110
2006-06-12 00:00:00.000,Halle Germany ATP World Tour,GRASS,2,Olivier Rochus,Marat Safin,Olivier Rochus,4-6; 6-4; 6-1,R16,112,1,6,60,95,42,60,17,35,11,13,13,59,95,6,2,60,92,37,60,15,32,5,10,14,52,92
2006-06-12 00:00:00.000,Halle Germany ATP World Tour,GRASS,2,Robin Soderling,Andrei Pavel,Robin Soderling,4-6; 6-3; 6-0,R16,89,12,2,61,88,44,61,14,27,6,7,13,58,88,6,1,48,70,33,48,8,22,4,8,12,41,70
2006-06-12 00:00:00.000,Halle Germany ATP World Tour,GRASS,2,Tommy Haas,Andreas Seppi,Tommy Haas,6-1; 6-2,R16,50,9,0,22,37,20,22,12,15,0,0,8,32,37,0,1,22,47,11,22,13,25,4,8,7,24,47
2006-06-12 00:00:00.000,Halle Germany ATP World Tour,GRASS,2,Kristof Vliegen,Marco Chiudinelli,Kristof Vliegen,7-6(4); 6-0,R16,76,14,2,47,64,35,47,11,17,7,7,9,46,64,1,4,32,56,19,32,12,24,1,4,9,31,56
2006-06-12 00:00:00.000,Halle Germany ATP World Tour,GRASS,2,Florian Mayer,Jarkko Nieminen,Florian Mayer,6-4; 3-6; 6-4,R16,102,7,1,53,82,40,53,12,29,2,5,14,52,82,8,4,71,114,49,71,16,43,12,16,15,65,114
2006-06-12 00:00:00.000,Halle Germany ATP World Tour,GRASS,2,Tomas Berdych,Jiri Novak,Tomas Berdych,6-3; 6-7(5); 7-5,R16,113,15,2,59,90,49,59,23,31,0,0,17,72,90,4,2,74,108,51,74,23,34,4,6,16,74,108
2006-06-12 00:00:00.000,Halle Germany ATP World Tour,GRASS,2,Fabrice Santoro,Arnaud Clement,Fabrice Santoro,6-4; 7-6(2),R16,102,8,2,52,79,39,52,12,27,4,6,11,51,79,3,0,46,67,30,46,12,21,6,9,11,42,67
2006-06-12 00:00:00.000,Halle Germany ATP World Tour,GRASS,2,Roger Federer,Olivier Rochus,Roger Federer,6-7(2); 7-6(9); 7-6(5),Q,165,19,2,88,134,60,88,20,46,7,11,18,80,134,2,6,88,128,56,88,21,40,6,10,18,77,128
2006-06-12 00:00:00.000,Halle Germany ATP World Tour,GRASS,2,Tommy Haas,Robin Soderling,Tommy Haas,7-5; 6-4,Q,73,11,4,36,57,33,36,10,21,0,1,11,43,57,8,3,39,65,24,39,15,26,4,7,11,39,65
2006-06-12 00:00:00.000,Halle Germany ATP World Tour,GRASS,2,Kristof Vliegen,Florian Mayer,Kristof Vliegen,6-3; 6-7(5); 6-4,Q,118,12,6,66,97,55,66,15,31,4,5,16,70,97,3,2,65,97,45,65,19,32,4,7,15,64,97
2006-06-12 00:00:00.000,Halle Germany ATP World Tour,GRASS,2,Tomas Berdych,Fabrice Santoro,Tomas Berdych,7-5; 7-6(3),Q,110,7,0,44,69,36,44,16,25,1,2,12,52,69,9,2,62,101,43,62,18,39,9,11,12,61,101
2006-06-12 00:00:00.000,Halle Germany ATP World Tour,GRASS,2,Roger Federer,Tommy Haas,Roger Federer,6-4; 6-7(4); 6-3,S,137,9,1,65,97,51,65,19,32,3,3,16,70,97,4,6,75,121,55,75,22,46,14,16,15,77,121
2006-06-12 00:00:00.000,Halle Germany ATP World Tour,GRASS,2,Tomas Berdych,Kristof Vliegen,Tomas Berdych,6-3; 6-2,S,60,5,3,32,55,29,32,10,23,5,5,9,39,55,4,3,33,46,23,33,2,13,0,3,8,25,46
2006-06-12 00:00:00.000,Halle Germany ATP World Tour,GRASS,2,Roger Federer,Tomas Berdych,Roger Federer,6-0; 6-7(4); 6-2,F,95,11,3,48,73,40,48,14,25,0,1,13,54,73,10,2,47,83,30,47,16,36,2,8,13,46,83
2006-06-12 00:00:00.000,London / Queen's Club England ATP World Tour,GRASS,2,Rafael Nadal,N/A Bye,Rafael Nadal,,R64,0,0,0,0,0,0,0,0,0,0,0,0,0,0,0,0,0,0,0,0,0,0,0,0,0,0,0
2006-06-12 00:00:00.000,London / Queen's Club England ATP World Tour,GRASS,2,Mardy Fish,Jamie Baker,Mardy Fish,6-1; 6-3,R64,63,11,1,23,41,21,23,12,18,2,2,8,33,41,2,5,36,55,20,36,7,19,4,8,8,27,55
2006-06-12 00:00:00.000,London / Queen's Club England ATP World Tour,GRASS,2,Fernando Verdasco,Simon Greul,Fernando Verdasco,6-3; 6-3,R64,72,3,5,34,51,29,34,10,17,3,3,9,39,51,3,1,35,56,24,35,7,21,1,4,9,31,56
2006-06-12 00:00:00.000,London / Queen's Club England ATP World Tour,GRASS,2,Hyung-Taik Lee,Paul-Henri Mathieu,Hyung-Taik Lee,7-6(2); 6-7(3); 6-4,R64,148,9,1,92,114,68,92,13,22,4,5,17,81,114,14,3,83,130,60,83,26,47,11,13,17,86,130
2006-06-12 00:00:00.000,London / Queen's Club England ATP World Tour,GRASS,2,Max Mirnyi,Thomas Johansson,Max Mirnyi,7-6(6); 3-6; 7-6(4),R64,159,13,6,70,115,51,70,25,45,2,4,16,76,115,12,3,68,111,48,68,27,43,3,4,17,75,111
2006-06-12 00:00:00.000,London / Queen's Club England ATP World Tour,GRASS,2,Daniele Bracciali,Feliciano Lopez,Daniele Bracciali,6-1; 7-6(4),R64,82,4,1,36,68,30,36,18,32,1,2,10,48,68,13,1,31,56,25,31,10,25,0,3,9,35,56
2006-06-12 00:00:00.000,London / Queen's Club England ATP World Tour,GRASS,2,Fernando Vicente,Martin Lee,Fernando Vicente,6-3; 6-2,R64,59,8,0,34,47,29,34,9,13,2,2,9,38,47,3,6,33,66,25,33,12,33,7,10,8,37,66
2006-06-12 00:00:00.000,London / Queen's Club England ATP World Tour,GRASS,2,Lleyton Hewitt,N/A Bye,Lleyton Hewitt,,R64,0,0,0,0,0,0,0,0,0,0,0,0,0,0,0,0,0,0,0,0,0,0,0,0,0,0,0
2006-06-12 00:00:00.000,London / Queen's Club England ATP World Tour,GRASS,2,Nikolay Davydenko,N/A Bye,Nikolay Davydenko,,R64,0,0,0,0,0,0,0,0,0,0,0,0,0,0,0,0,0,0,0,0,0,0,0,0,0,0,0
2006-06-12 00:00:00.000,London / Queen's Club England ATP World Tour,GRASS,2,Jimmy Wang,Jonas Bjorkman,Jimmy Wang,6-3; 6-3,R64,63,0,2,30,49,25,30,12,19,2,2,9,37,49,3,4,26,49,19,26,10,23,0,3,9,29,49
2006-06-12 00:00:00.000,London / Queen's Club England ATP World Tour,GRASS,2,Danai Udomchoke,Tomas Zib,Danai Udomchoke,3-6; 7-5; 6-0,R64,90,13,2,65,85,50,65,8,20,2,3,13,58,85,9,5,49,79,36,49,14,30,4,8,14,50,79
2006-06-12 00:00:00.000,London / Queen's Club England ATP World Tour,GRASS,2,Dmitry Tursunov,Alex Bogdanovic,Dmitry Tursunov,7-6(4); 6-4,R64,76,11,1,37,69,31,37,18,32,0,0,11,49,69,6,4,39,64,28,39,17,25,0,1,11,45,64
2006-06-12 00:00:00.000,London / Queen's Club England ATP World Tour,GRASS,2,Tim Henman,Andre Agassi,Tim Henman,6-4; 6-4,R64,75,7,4,37,64,23,37,18,27,5,6,10,41,64,5,1,31,55,21,31,13,24,0,3,10,34,55
2006-06-12 00:00:00.000,London / Queen's Club England ATP World Tour,GRASS,2,Ramon Delgado,Lukas Dlouhy,Ramon Delgado,6-4; 7-6(3),R64,80,5,0,39,70,27,39,26,31,8,8,11,53,70,9,4,42,68,32,42,15,26,0,1,11,47,68
2006-06-12 00:00:00.000,London / Queen's Club England ATP World Tour,GRASS,2,Nicolas Mahut,Julien Benneteau,Nicolas Mahut,6-4; 6-1,R64,73,9,2,35,51,26,35,9,16,0,1,9,35,51,4,1,33,46,20,33,5,13,4,8,8,25,46
2006-06-12 00:00:00.000,London / Queen's Club England ATP World Tour,GRASS,2,Radek Stepanek,N/A Bye,Radek Stepanek,,R64,0,0,0,0,0,0,0,0,0,0,0,0,0,0,0,0,0,0,0,0,0,0,0,0,0,0,0
2006-06-12 00:00:00.000,London / Queen's Club England ATP World Tour,GRASS,2,Fernando Gonzalez,N/A Bye,Fernando Gonzalez,,R64,0,0,0,0,0,0,0,0,0,0,0,0,0,0,0,0,0,0,0,0,0,0,0,0,0,0,0
2006-06-12 00:00:00.000,London / Queen's Club England ATP World Tour,GRASS,2,Antony Dupuis,Greg Rusedski,Antony Dupuis,5-7; 6-3; 3-2 RET,R64,101,7,0,42,71,31,42,19,29,1,3,13,50,71,14,5,33,69,24,33,21,36,1,4,13,45,69
2006-06-12 00:00:00.000,London / Queen's Club England ATP World Tour,GRASS,2,Mark Philippoussis,Wesley Moodie,Mark Philippoussis,6-3; 6-4,R64,74,12,8,35,68,31,35,16,33,6,6,10,47,68,2,3,32,48,26,32,6,16,2,4,9,32,48
2006-06-12 00:00:00.000,London / Queen's Club England ATP World Tour,GRASS,2,Sebastien Grosjean,Ivo Minar,Sebastien Grosjean,6-3; 7-6(4),R64,80,10,2,49,73,39,49,15,24,3,3,11,54,73,2,3,43,66,33,43,12,23,0,1,10,45,66
2006-06-12 00:00:00.000,London / Queen's Club England ATP World Tour,GRASS,2,Paradorn Srichaphan,Dick Norman,Paradorn Srichaphan,6-4; 7-6(5),R64,79,13,2,41,65,34,41,15,24,1,1,11,49,65,14,11,47,77,32,47,16,30,2,3,11,48,77
2006-06-12 00:00:00.000,London / Queen's Club England ATP World Tour,GRASS,2,Yen-Hsun Lu,Gilles Muller,Yen-Hsun Lu,6-4; 7-6(7),R64,106,1,3,44,75,33,44,19,31,3,4,11,52,75,8,2,47,77,37,47,12,30,2,4,11,49,77
2006-06-12 00:00:00.000,London / Queen's Club England ATP World Tour,GRASS,2,Frank Dancevic,Kenneth Carlsen,Frank Dancevic,4-6; 6-3; 6-3,R64,99,17,3,55,87,42,55,18,32,8,9,14,60,87,12,3,48,81,35,48,18,33,4,7,14,53,81
2006-06-12 00:00:00.000,London / Queen's Club England ATP World Tour,GRASS,2,Andy Roddick,N/A Bye,Andy Roddick,,R64,0,0,0,0,0,0,0,0,0,0,0,0,0,0,0,0,0,0,0,0,0,0,0,0,0,0,0
2006-06-12 00:00:00.000,London / Queen's Club England ATP World Tour,GRASS,2,James Blake,N/A Bye,James Blake,,R64,0,0,0,0,0,0,0,0,0,0,0,0,0,0,0,0,0,0,0,0,0,0,0,0,0,0,0
2006-06-12 00:00:00.000,London / Queen's Club England ATP World Tour,GRASS,2,Justin Gimelstob,Raemon Sluiter,Justin Gimelstob,7-6(7); 6-2,R64,97,16,2,36,67,32,36,19,31,1,1,10,51,67,12,4,51,85,38,51,14,34,11,13,10,52,85
2006-06-12 00:00:00.000,London / Queen's Club England ATP World Tour,GRASS,2,Janko Tipsarevic,Andy Murray,Janko Tipsarevic,7-6(3); 3-6; 6-2,R64,136,0,3,57,98,41,57,18,41,5,9,14,59,98,12,3,60,108,39,60,20,48,5,10,15,59,108
2006-06-12 00:00:00.000,London / Queen's Club England ATP World Tour,GRASS,2,Robby Ginepri,Paul Goldstein,Robby Ginepri,3-6; 7-5; 6-1,R64,95,9,1,58,90,43,58,18,32,4,5,14,61,90,3,1,48,78,39,48,13,30,2,5,14,52,78
2006-06-12 00:00:00.000,London / Queen's Club England ATP World Tour,GRASS,2,Gael Monfils,Jurgen Melzer,Gael Monfils,7-6(2); 7-6(2),R64,85,6,5,42,72,33,42,21,30,0,1,12,54,72,2,4,43,85,33,43,21,42,1,2,12,54,85
2006-06-12 00:00:00.000,London / Queen's Club England ATP World Tour,GRASS,2,Bobby Reynolds,Igor Kunitsyn,Bobby Reynolds,6-4; 6-4,R64,76,16,0,40,55,36,40,6,15,1,1,10,42,55,3,2,48,67,32,48,10,19,6,8,10,42,67
2006-06-12 00:00:00.000,London / Queen's Club England ATP World Tour,GRASS,2,Razvan Sabau,Robin Vik,Razvan Sabau,6-3; 6-3,R64,70,3,3,28,52,23,28,12,24,1,2,9,35,52,4,4,41,68,25,41,11,27,11,15,9,36,68
2006-06-12 00:00:00.000,London / Queen's Club England ATP World Tour,GRASS,2,Ivan Ljubicic,N/A Bye,Ivan Ljubicic,,R64,0,0,0,0,0,0,0,0,0,0,0,0,0,0,0,0,0,0,0,0,0,0,0,0,0,0,0
2006-06-12 00:00:00.000,London / Queen's Club England ATP World Tour,GRASS,2,Rafael Nadal,Mardy Fish,Rafael Nadal,7-6(1); 6-1,R32,76,4,1,40,61,35,40,11,21,2,2,10,46,61,12,8,22,57,20,22,15,35,2,4,9,35,57
2006-06-12 00:00:00.000,London / Queen's Club England ATP World Tour,GRASS,2,Fernando Verdasco,Hyung-Taik Lee,Fernando Verdasco,6-2; 5-7; 6-4,R32,112,3,3,69,86,48,69,8,17,4,7,15,56,86,4,3,76,103,45,76,15,27,7,12,15,60,103
2006-06-12 00:00:00.000,London / Queen's Club England ATP World Tour,GRASS,2,Max Mirnyi,Daniele Bracciali,Max Mirnyi,6-1; 6-3,R32,53,10,0,32,41,26,32,7,9,0,0,8,33,41,8,3,31,51,20,31,6,20,4,8,8,26,51
2006-06-12 00:00:00.000,London / Queen's Club England ATP World Tour,GRASS,2,Lleyton Hewitt,Fernando Vicente,Lleyton Hewitt,4-6; 6-4; 6-2,R32,115,7,3,51,94,37,51,22,43,7,9,14,59,94,4,1,66,88,41,66,10,22,8,12,14,51,88
2006-06-12 00:00:00.000,London / Queen's Club England ATP World Tour,GRASS,2,Jimmy Wang,Nikolay Davydenko,Jimmy Wang,2-6; 6-3; 6-1,R32,94,3,1,46,80,31,46,17,34,6,9,12,48,80,4,4,37,70,27,37,14,33,4,9,12,41,70
2006-06-12 00:00:00.000,London / Queen's Club England ATP World Tour,GRASS,2,Dmitry Tursunov,Danai Udomchoke,Dmitry Tursunov,6-3; 2-6; 6-2,R32,81,5,8,46,84,32,46,19,38,3,6,13,51,84,7,5,35,62,22,35,15,27,2,6,12,37,62
2006-06-12 00:00:00.000,London / Queen's Club England ATP World Tour,GRASS,2,Tim Henman,Ramon Delgado,Tim Henman,6-2; 6-4,R32,63,8,1,31,44,28,31,9,13,0,0,9,37,44,3,2,36,51,23,36,9,15,3,6,9,32,51
2006-06-12 00:00:00.000,London / Queen's Club England ATP World Tour,GRASS,2,Nicolas Mahut,Radek Stepanek,Nicolas Mahut,6-4; 4-6; 6-2,R32,112,10,5,51,81,37,51,13,30,3,7,14,50,81,7,10,61,97,41,61,12,36,15,21,14,53,97
2006-06-12 00:00:00.000,London / Queen's Club England ATP World Tour,GRASS,2,Fernando Gonzalez,Antony Dupuis,Fernando Gonzalez,7-6(5); 7-6(2),R32,94,8,3,50,79,41,50,22,29,4,4,12,63,79,11,0,55,79,47,55,12,24,1,1,12,59,79
2006-06-12 00:00:00.000,London / Queen's Club England ATP World Tour,GRASS,2,Mark Philippoussis,Sebastien Grosjean,Mark Philippoussis,7-6(5); 4-6; 6-3,R32,123,23,4,62,95,53,62,19,33,3,4,16,72,95,11,0,69,94,53,69,14,25,3,4,15,67,94
2006-06-12 00:00:00.000,London / Queen's Club England ATP World Tour,GRASS,2,Paradorn Srichaphan,Yen-Hsun Lu,Paradorn Srichaphan,6-3; 5-7; 6-4,R32,90,12,1,49,81,42,49,22,32,0,1,16,64,81,3,3,51,75,42,51,14,24,0,2,15,56,75
2006-06-12 00:00:00.000,London / Queen's Club England ATP World Tour,GRASS,2,Andy Roddick,Frank Dancevic,Andy Roddick,2-6; 6-4; 6-3,R32,85,11,0,49,66,40,49,7,17,1,3,13,47,66,3,2,67,92,46,67,12,25,9,12,14,58,92
2006-06-12 00:00:00.000,London / Queen's Club England ATP World Tour,GRASS,2,James Blake,Justin Gimelstob,James Blake,7-5; 6-1,R32,69,3,2,37,59,29,37,14,22,4,4,10,43,59,4,2,44,60,28,44,6,16,5,8,9,34,60
2006-06-12 00:00:00.000,London / Queen's Club England ATP World Tour,GRASS,2,Robby Ginepri,Janko Tipsarevic,Robby Ginepri,7-6(4); 6-4,R32,77,6,1,50,76,36,50,16,26,6,7,11,52,76,9,2,47,69,33,47,12,22,5,7,11,45,69
2006-06-12 00:00:00.000,London / Queen's Club England ATP World Tour,GRASS,2,Gael Monfils,Bobby Reynolds,Gael Monfils,6-1; 6-2,R32,49,10,1,31,43,24,31,8,12,0,0,8,32,43,2,3,22,45,12,22,9,23,4,8,7,21,45
2006-06-12 00:00:00.000,London / Queen's Club England ATP World Tour,GRASS,2,Ivan Ljubicic,Razvan Sabau,Ivan Ljubicic,7-6(6); 6-2,R32,78,24,4,34,57,34,34,12,23,0,0,10,46,57,3,1,54,78,39,54,11,24,7,9,10,50,78
2006-06-12 00:00:00.000,London / Queen's Club England ATP World Tour,GRASS,2,Rafael Nadal,Fernando Verdasco,Rafael Nadal,2-6; 7-6(3); 7-6(3),R16,181,2,2,80,112,51,80,15,32,7,13,16,66,112,6,9,89,125,57,89,15,36,12,16,16,72,125
2006-06-12 00:00:00.000,London / Queen's Club England ATP World Tour,GRASS,2,Lleyton Hewitt,Max Mirnyi,Lleyton Hewitt,4-6; 6-1; 7-6(4),R16,116,8,4,59,96,39,59,24,37,4,8,15,63,96,12,3,57,78,39,57,6,21,0,5,14,45,78
2006-06-12 00:00:00.000,London / Queen's Club England ATP World Tour,GRASS,2,Dmitry Tursunov,Jimmy Wang,Dmitry Tursunov,6-3; 3-6; 6-1,R16,83,10,3,38,74,31,38,19,36,2,4,13,50,74,4,2,40,68,26,40,14,28,5,9,12,40,68
2006-06-12 00:00:00.000,London / Queen's Club England ATP World Tour,GRASS,2,Tim Henman,Nicolas Mahut,Tim Henman,6-3; 6-4,R16,75,5,2,31,51,27,31,11,20,0,1,10,38,51,2,1,34,54,21,34,10,20,3,6,9,31,54
2006-06-12 00:00:00.000,London / Queen's Club England ATP World Tour,GRASS,2,Fernando Gonzalez,Mark Philippoussis,Fernando Gonzalez,6-2; 3-6; 6-3,R16,110,4,8,51,95,38,51,23,44,7,8,13,61,95,15,4,37,66,31,37,14,29,1,4,13,45,66
2006-06-12 00:00:00.000,London / Queen's Club England ATP World Tour,GRASS,2,Andy Roddick,Paradorn Srichaphan,Andy Roddick,7-6(5); 6-3,R16,82,8,0,48,75,36,48,18,27,3,3,11,54,75,6,1,43,72,31,43,16,29,6,7,10,47,72
2006-06-12 00:00:00.000,London / Queen's Club England ATP World Tour,GRASS,2,James Blake,Robby Ginepri,James Blake,6-3; 3-6; 6-3,R16,93,11,4,63,107,46,63,20,44,11,13,14,66,107,6,1,53,77,37,53,12,24,3,6,13,49,77
2006-06-12 00:00:00.000,London / Queen's Club England ATP World Tour,GRASS,2,Gael Monfils,Ivan Ljubicic,Gael Monfils,7-6(11); 7-5,R16,103,12,3,55,89,41,55,21,34,3,4,12,62,89,7,6,51,82,41,51,12,31,0,2,12,53,82
2006-06-12 00:00:00.000,London / Queen's Club England ATP World Tour,GRASS,2,Lleyton Hewitt,Rafael Nadal,Lleyton Hewitt,3-6; 6-3 RET,Q,85,9,1,35,56,24,35,11,21,0,2,9,35,56,4,4,39,69,29,39,12,30,11,13,9,41,69
2006-06-12 00:00:00.000,London / Queen's Club England ATP World Tour,GRASS,2,Tim Henman,Dmitry Tursunov,Tim Henman,6-3; 7-6(1),Q,95,4,2,37,64,26,37,8,27,4,9,10,34,64,6,3,41,74,22,41,10,33,3,10,11,32,74
2006-06-12 00:00:00.000,London / Queen's Club England ATP World Tour,GRASS,2,Andy Roddick,Fernando Gonzalez,Andy Roddick,6-4; 6-3,Q,62,13,0,37,47,35,37,5,10,0,0,10,40,47,10,4,41,66,33,41,8,25,7,9,9,41,66
2006-06-12 00:00:00.000,London / Queen's Club England ATP World Tour,GRASS,2,James Blake,Gael Monfils,James Blake,6-1 RET,Q,21,2,0,12,22,9,12,8,10,1,1,4,17,22,1,3,17,24,11,17,1,7,1,3,3,12,24
2006-06-12 00:00:00.000,London / Queen's Club England ATP World Tour,GRASS,2,Lleyton Hewitt,Tim Henman,Lleyton Hewitt,6-3; 3-6; 6-2,S,106,6,2,44,75,31,44,19,31,3,5,13,50,75,4,2,47,76,35,47,13,29,5,9,13,48,76
2006-06-12 00:00:00.000,London / Queen's Club England ATP World Tour,GRASS,2,James Blake,Andy Roddick,James Blake,7-5; 6-4,S,74,8,3,41,65,28,41,16,24,3,4,11,44,65,9,1,58,75,39,58,5,17,3,6,11,44,75
2006-06-12 00:00:00.000,London / Queen's Club England ATP World Tour,GRASS,2,Lleyton Hewitt,James Blake,Lleyton Hewitt,6-4; 6-4,F,186,5,1,36,50,30,36,6,14,0,1,10,36,50,5,1,39,70,28,39,13,31,2,5,10,41,70
2006-06-19 00:00:00.000,Nottingham England ATP World Tour,GRASS,2,Jan Vacek,Thomas Johansson,Jan Vacek,7-6(6); 6-7(11); 6-4,R32,140,9,4,69,113,53,69,29,44,3,4,17,82,113,17,3,67,108,57,67,18,41,0,2,17,75,108
2006-06-19 00:00:00.000,Nottingham England ATP World Tour,GRASS,2,Gilles Simon,Igor Kunitsyn,Gilles Simon,6-4; 6-3,R32,73,5,2,22,51,20,22,17,29,0,1,10,37,51,1,0,44,61,27,44,8,17,7,10,9,35,61
2006-06-19 00:00:00.000,Nottingham England ATP World Tour,GRASS,2,Richard Gasquet,Ivan Navarro,Richard Gasquet,6-3; 3-6; 7-5,R32,96,3,1,49,74,35,49,16,25,0,3,15,51,74,8,7,39,83,32,39,23,44,3,7,15,55,83
2006-06-19 00:00:00.000,Nottingham England ATP World Tour,GRASS,2,Daniele Bracciali,Nicolas Almagro,Daniele Bracciali,1-6; 6-3; 7-6(7),R32,101,11,1,48,94,39,48,26,46,5,7,14,65,94,12,1,48,76,38,48,21,28,1,2,14,59,76
2006-06-19 00:00:00.000,Nottingham England ATP World Tour,GRASS,2,Nicolas Mahut,Xavier Malisse,Nicolas Mahut,3-6; 7-6(8); 7-5,R32,132,19,4,66,100,53,66,20,34,3,5,17,73,100,7,2,60,99,47,60,25,39,3,4,16,72,99
2006-06-19 00:00:00.000,Nottingham England ATP World Tour,GRASS,2,Robin Soderling,Justin Gimelstob,Robin Soderling,7-6(5); 6-7(4); 7-6(7),R32,189,12,2,90,132,64,90,22,42,5,7,18,86,132,13,3,78,149,58,78,37,71,12,14,18,95,149
2006-06-19 00:00:00.000,Nottingham England ATP World Tour,GRASS,2,Janko Tipsarevic,Richard Bloomfield,Janko Tipsarevic,6-4; 3-6; 6-3,R32,93,8,1,43,63,36,43,17,20,0,1,14,53,63,20,2,64,98,53,64,10,34,11,13,14,63,98
2006-06-19 00:00:00.000,Nottingham England ATP World Tour,GRASS,2,Paradorn Srichaphan,Danai Udomchoke,Paradorn Srichaphan,6-3; 7-6(4),R32,61,9,2,36,63,30,36,19,27,3,4,11,49,63,3,1,43,61,32,43,10,18,1,3,10,42,61
2006-06-19 00:00:00.000,Nottingham England ATP World Tour,GRASS,2,Jiri Vanek,Paul-Henri Mathieu,Jiri Vanek,6-4; 6-4,R32,68,11,2,45,57,35,45,6,12,2,3,10,41,57,4,4,38,58,28,38,9,20,1,4,10,37,58
2006-06-19 00:00:00.000,Nottingham England ATP World Tour,GRASS,2,Jonas Bjorkman,Agustin Calleri,Jonas Bjorkman,2-6; 6-1; 6-3,R32,88,4,2,49,67,32,49,7,18,1,5,12,39,67,5,2,43,73,26,43,11,30,2,8,12,37,73
2006-06-19 00:00:00.000,Nottingham England ATP World Tour,GRASS,2,Paul Goldstein,Wesley Moodie,Paul Goldstein,6-1; 7-5,R32,59,1,1,33,47,29,33,8,14,1,1,9,37,47,8,2,36,53,26,36,4,17,4,8,10,30,53
2006-06-19 00:00:00.000,Nottingham England ATP World Tour,GRASS,2,Feliciano Lopez,Olivier Rochus,Feliciano Lopez,6-3; 6-1,R32,50,7,4,23,43,19,23,14,20,1,1,8,33,43,2,5,28,42,15,28,5,14,0,4,8,20,42
2006-06-19 00:00:00.000,Nottingham England ATP World Tour,GRASS,2,Andy Murray,Dmitry Tursunov,Andy Murray,6-4; 6-3,R32,77,6,1,34,62,26,34,17,28,4,4,10,43,62,8,0,31,56,23,31,13,25,5,7,9,36,56
2006-06-19 00:00:00.000,Nottingham England ATP World Tour,GRASS,2,Max Mirnyi,Alex Bogdanovic,Max Mirnyi,4-6; 7-6(4); 6-3,R32,119,18,4,65,92,57,65,14,27,1,2,16,71,92,8,2,72,100,55,72,15,28,3,4,15,70,100
2006-06-19 00:00:00.000,Nottingham England ATP World Tour,GRASS,2,Andreas Seppi,Stanislas Wawrinka,Andreas Seppi,7-6(7); 4-6; 6-4,R32,133,2,4,50,92,40,50,25,42,3,5,16,65,92,11,6,57,112,46,57,28,55,5,7,16,74,112
2006-06-19 00:00:00.000,Nottingham England ATP World Tour,GRASS,2,Dominik Hrbaty,Jimmy Wang,Dominik Hrbaty,6-0; 6-3,R32,56,3,1,19,42,16,19,16,23,1,1,7,32,42,1,3,41,65,15,41,14,24,8,13,8,29,65
2006-06-19 00:00:00.000,Nottingham England ATP World Tour,GRASS,2,Gilles Simon,Jan Vacek,Gilles Simon,4-6; 6-4; 6-3,R16,106,8,4,48,93,32,48,25,45,10,14,15,57,93,1,3,50,88,31,50,19,38,8,13,14,50,88
2006-06-19 00:00:00.000,Nottingham England ATP World Tour,GRASS,2,Richard Gasquet,Daniele Bracciali,Richard Gasquet,7-5; 6-3,R16,82,4,2,43,60,37,43,10,17,2,2,11,47,60,4,0,33,72,25,33,19,39,5,7,10,44,72
2006-06-19 00:00:00.000,Nottingham England ATP World Tour,GRASS,2,Robin Soderling,Nicolas Mahut,Robin Soderling,6-3; 6-2,R16,59,8,2,33,50,26,33,11,17,2,2,9,37,50,3,2,31,50,19,31,8,19,5,8,8,27,50
2006-06-19 00:00:00.000,Nottingham England ATP World Tour,GRASS,2,Janko Tipsarevic,Paradorn Srichaphan,Janko Tipsarevic,7-6(3); 6-7(4); 7-5,R16,136,18,3,67,113,57,67,25,46,6,7,18,82,113,14,9,70,121,55,70,26,51,6,8,18,81,121
2006-06-19 00:00:00.000,Nottingham England ATP World Tour,GRASS,2,Jonas Bjorkman,Jiri Vanek,Jonas Bjorkman,6-3; 6-3,R16,68,4,0,31,47,24,31,13,16,1,1,9,37,47,3,5,55,77,33,55,8,22,4,7,9,41,77
2006-06-19 00:00:00.000,Nottingham England ATP World Tour,GRASS,2,Feliciano Lopez,Paul Goldstein,Feliciano Lopez,3-6; 6-2; 6-3,R16,106,15,3,50,82,41,50,11,32,0,2,13,52,82,3,6,37,83,23,37,25,46,5,9,13,48,83
2006-06-19 00:00:00.000,Nottingham England ATP World Tour,GRASS,2,Andy Murray,Max Mirnyi,Andy Murray,7-6(2); 6-4,R16,85,1,1,52,66,41,52,6,14,1,2,11,47,66,9,2,49,67,35,49,9,18,2,4,11,44,67
2006-06-19 00:00:00.000,Nottingham England ATP World Tour,GRASS,2,Andreas Seppi,Dominik Hrbaty,Andreas Seppi,7-5; 7-5,R16,99,7,4,46,86,31,46,20,40,7,10,12,51,86,5,6,38,68,25,38,11,30,3,8,12,36,68
2006-06-19 00:00:00.000,Nottingham England ATP World Tour,GRASS,2,Richard Gasquet,Gilles Simon,Richard Gasquet,6-3; 6-1,Q,68,3,4,30,52,21,30,11,22,2,3,8,32,52,0,1,31,58,15,31,12,27,4,9,8,27,58
2006-06-19 00:00:00.000,Nottingham England ATP World Tour,GRASS,2,Robin Soderling,Janko Tipsarevic,Robin Soderling,7-6(4); 6-4,Q,83,9,2,38,67,34,38,16,29,2,2,11,50,67,7,0,47,78,36,47,15,31,5,6,11,51,78
2006-06-19 00:00:00.000,Nottingham England ATP World Tour,GRASS,2,Jonas Bjorkman,Feliciano Lopez,Jonas Bjorkman,6-3; 6-4,Q,79,8,1,37,54,32,37,10,17,2,2,10,42,54,10,4,35,66,26,35,13,31,5,7,9,39,66
2006-06-19 00:00:00.000,Nottingham England ATP World Tour,GRASS,2,Andreas Seppi,Andy Murray,Andreas Seppi,7-6(4); 4-6; 6-1,Q,130,2,2,58,101,39,58,21,43,1,5,15,60,101,7,5,53,87,37,53,14,34,7,12,14,51,87
2006-06-19 00:00:00.000,Nottingham England ATP World Tour,GRASS,2,Richard Gasquet,Robin Soderling,Richard Gasquet,7-6(7); 7-6(5),S,96,9,1,64,87,47,64,15,23,3,4,12,62,87,13,6,59,83,51,59,8,24,0,1,12,59,83
2006-06-19 00:00:00.000,Nottingham England ATP World Tour,GRASS,2,Jonas Bjorkman,Andreas Seppi,Jonas Bjorkman,6-3; 6-1,S,71,3,0,22,43,18,22,14,21,0,0,8,32,43,1,4,31,56,20,31,8,25,5,9,8,28,56
2006-06-19 00:00:00.000,Nottingham England ATP World Tour,GRASS,2,Richard Gasquet,Jonas Bjorkman,Richard Gasquet,6-4; 6-3,F,77,4,0,35,50,29,35,9,15,1,1,9,38,50,4,2,45,65,29,45,8,20,4,7,10,37,65
2006-06-19 00:00:00.000,'s-Hertogenbosch The Netherlands ATP World Tour,GRASS,2,Philipp Kohlschreiber,Nikolay Davydenko,Philipp Kohlschreiber,6-2; 6-4,R32,71,4,1,32,51,26,32,12,19,1,1,9,38,51,3,3,38,64,25,38,12,26,7,10,9,37,64
2006-06-19 00:00:00.000,'s-Hertogenbosch The Netherlands ATP World Tour,GRASS,2,Julien Benneteau,Joseph Sirianni,Julien Benneteau,6-4; 6-4,R32,92,7,6,46,73,33,46,10,27,5,7,10,43,73,0,5,38,61,21,38,10,23,1,5,10,31,61
2006-06-19 00:00:00.000,'s-Hertogenbosch The Netherlands ATP World Tour,GRASS,2,Vincent Spadea,Bjorn Phau,Vincent Spadea,4-6; 6-1; 6-4,R32,107,2,1,50,83,39,50,19,33,7,8,14,58,83,7,4,53,96,35,53,23,43,12,15,13,58,96
2006-06-19 00:00:00.000,'s-Hertogenbosch The Netherlands ATP World Tour,GRASS,2,Marcos Baghdatis,Ivo Minar,Marcos Baghdatis,3-6; 6-3; 7-5,R32,112,8,6,56,99,45,56,21,43,5,6,15,66,99,6,4,65,103,48,65,17,38,8,10,15,65,103
2006-06-19 00:00:00.000,'s-Hertogenbosch The Netherlands ATP World Tour,GRASS,2,Mario Ancic,Aisam-Ul-Haq Qureshi,Mario Ancic,7-6(3); 6-7(0); 7-5,R32,163,18,8,65,109,55,65,23,44,3,4,18,78,109,11,6,83,121,59,83,20,38,3,5,18,79,121
2006-06-19 00:00:00.000,'s-Hertogenbosch The Netherlands ATP World Tour,GRASS,2,Raemon Sluiter,Robin Vik,Raemon Sluiter,1-6; 6-3; 6-2,R32,89,10,8,40,73,34,40,14,33,3,5,12,48,73,4,2,46,77,30,46,17,31,4,7,12,47,77
2006-06-19 00:00:00.000,'s-Hertogenbosch The Netherlands ATP World Tour,GRASS,2,Kristof Vliegen,Lukas Dlouhy,Kristof Vliegen,7-5; 6-4,R32,74,9,1,41,60,32,41,12,19,1,2,11,44,60,5,5,41,65,30,41,11,24,4,7,11,41,65
2006-06-19 00:00:00.000,'s-Hertogenbosch The Netherlands ATP World Tour,GRASS,2,Fabrice Santoro,Robby Ginepri,Fabrice Santoro,6-1; 3-2 RET,R32,54,4,2,29,41,21,29,5,12,1,2,6,26,41,3,3,27,50,16,27,7,23,4,8,6,23,50
2006-06-19 00:00:00.000,'s-Hertogenbosch The Netherlands ATP World Tour,GRASS,2,Novak Djokovic,Alexander Waske,Novak Djokovic,6-7(9); 7-6(4); 7-6(4),R32,182,10,9,68,121,59,68,28,53,2,3,18,87,121,18,12,77,126,61,77,28,49,2,3,18,89,126
2006-06-19 00:00:00.000,'s-Hertogenbosch The Netherlands ATP World Tour,GRASS,2,Jan Hernych,Mikhail Ledovskikh,Jan Hernych,6-0; 6-2,R32,57,8,0,34,55,23,34,13,21,5,5,7,36,55,5,7,19,49,13,19,9,30,4,9,7,22,49
2006-06-19 00:00:00.000,'s-Hertogenbosch The Netherlands ATP World Tour,GRASS,2,Hyung-Taik Lee,Arnaud Clement,Hyung-Taik Lee,6-4; 6-4,R32,83,8,3,39,55,33,39,8,16,0,0,10,41,55,4,0,44,60,32,44,7,16,2,4,10,39,60
2006-06-19 00:00:00.000,'s-Hertogenbosch The Netherlands ATP World Tour,GRASS,2,Mischa Zverev,Davide Sanguinetti,Mischa Zverev,7-6(4); 7-6(5),R32,72,3,1,59,75,50,59,9,16,5,6,12,59,75,2,1,58,77,44,58,11,19,2,3,12,55,77
2006-06-19 00:00:00.000,'s-Hertogenbosch The Netherlands ATP World Tour,GRASS,2,Juan Carlos Ferrero,Robin Haase,Juan Carlos Ferrero,6-4; 3-6; 6-2,R32,107,5,1,57,86,41,57,15,29,5,7,13,56,86,8,6,42,86,28,42,24,44,6,10,14,52,86
2006-06-19 00:00:00.000,'s-Hertogenbosch The Netherlands ATP World Tour,GRASS,2,Jurgen Melzer,Gilles Muller,Jurgen Melzer,6-2; 6-2,R32,59,8,1,25,41,20,25,12,16,0,0,8,32,41,2,5,33,59,19,33,10,26,9,13,8,29,59
2006-06-19 00:00:00.000,'s-Hertogenbosch The Netherlands ATP World Tour,GRASS,2,Florent Serra,Rainer Schuettler,Florent Serra,6-4; 6-4,R32,69,4,1,31,54,27,31,14,23,0,0,10,41,54,6,3,39,59,28,39,11,20,4,6,10,39,59
2006-06-19 00:00:00.000,'s-Hertogenbosch The Netherlands ATP World Tour,GRASS,2,Tommy Robredo,Marin Cilic,Tommy Robredo,6-4; 6-4,R32,91,3,2,39,59,30,39,13,20,3,3,10,43,59,4,4,51,87,32,51,18,36,8,10,10,50,87
2006-06-19 00:00:00.000,'s-Hertogenbosch The Netherlands ATP World Tour,GRASS,2,Philipp Kohlschreiber,Julien Benneteau,Philipp Kohlschreiber,7-6(2); 7-5,R16,108,8,5,42,80,33,42,18,38,6,8,12,51,80,4,3,51,77,34,51,11,26,2,5,12,45,77
2006-06-19 00:00:00.000,'s-Hertogenbosch The Netherlands ATP World Tour,GRASS,2,Marcos Baghdatis,Vincent Spadea,Marcos Baghdatis,6-2; 7-6(5),R16,85,8,2,40,69,30,40,18,29,2,2,10,48,69,2,0,52,67,34,52,9,15,2,4,10,43,67
2006-06-19 00:00:00.000,'s-Hertogenbosch The Netherlands ATP World Tour,GRASS,2,Mario Ancic,Raemon Sluiter,Mario Ancic,6-7(7); 7-5; 6-2,R16,146,17,2,64,97,52,64,19,33,2,2,16,71,97,6,5,64,118,49,64,27,54,8,11,16,76,118
2006-06-19 00:00:00.000,'s-Hertogenbosch The Netherlands ATP World Tour,GRASS,2,Fabrice Santoro,Kristof Vliegen,Fabrice Santoro,2-6; 6-1; 6-4,R16,106,5,1,45,75,32,45,18,30,3,5,13,50,75,6,3,63,98,43,63,15,35,9,12,12,58,98
2006-06-19 00:00:00.000,'s-Hertogenbosch The Netherlands ATP World Tour,GRASS,2,Jan Hernych,Novak Djokovic,Jan Hernych,6-2; 6-4,R16,68,1,2,36,54,26,36,12,18,0,0,9,38,54,5,6,30,55,22,30,10,25,3,6,9,32,55
2006-06-19 00:00:00.000,'s-Hertogenbosch The Netherlands ATP World Tour,GRASS,2,Hyung-Taik Lee,Mischa Zverev,Hyung-Taik Lee,6-1; 6-3,R16,49,2,1,28,45,22,28,12,17,4,4,8,34,45,2,2,25,39,15,25,4,14,2,6,8,19,39
2006-06-19 00:00:00.000,'s-Hertogenbosch The Netherlands ATP World Tour,GRASS,2,Juan Carlos Ferrero,Jurgen Melzer,Juan Carlos Ferrero,4-6; 6-3; 6-4,R16,150,4,4,78,122,46,78,26,44,11,14,14,72,122,5,10,64,115,41,64,23,51,9,14,15,64,115
2006-06-19 00:00:00.000,'s-Hertogenbosch The Netherlands ATP World Tour,GRASS,2,Florent Serra,Tommy Robredo,Florent Serra,6-1; 3-6; 6-4,R16,104,2,4,41,86,28,41,23,45,6,9,13,51,86,1,2,51,83,34,51,15,32,13,18,13,49,83
2006-06-19 00:00:00.000,'s-Hertogenbosch The Netherlands ATP World Tour,GRASS,2,Marcos Baghdatis,Philipp Kohlschreiber,Marcos Baghdatis,6-2; 3-0 RET,Q,44,2,1,17,33,13,17,8,16,0,1,6,21,33,0,1,18,32,7,18,5,14,2,6,5,12,32
2006-06-19 00:00:00.000,'s-Hertogenbosch The Netherlands ATP World Tour,GRASS,2,Mario Ancic,Fabrice Santoro,Mario Ancic,6-4; 6-0,Q,64,10,3,27,45,23,27,11,18,4,4,8,34,45,0,3,30,55,17,30,11,25,6,10,8,28,55
2006-06-19 00:00:00.000,'s-Hertogenbosch The Netherlands ATP World Tour,GRASS,2,Jan Hernych,Hyung-Taik Lee,Jan Hernych,6-4; 6-4,Q,0,1,0,9,14,5,9,1,5,2,3,1,6,14,0,0,6,11,3,6,3,5,0,1,2,6,11
2006-06-19 00:00:00.000,'s-Hertogenbosch The Netherlands ATP World Tour,GRASS,2,Florent Serra,Juan Carlos Ferrero,Florent Serra,6-3; 6-7(4); 6-3,Q,132,6,1,71,105,53,71,17,34,8,10,16,70,105,8,1,55,81,39,55,13,26,2,6,14,52,81
2006-06-19 00:00:00.000,'s-Hertogenbosch The Netherlands ATP World Tour,GRASS,2,Mario Ancic,Marcos Baghdatis,Mario Ancic,7-6(4); 6-3,S,120,12,4,47,78,38,47,14,31,2,3,11,52,78,7,5,53,101,37,53,21,48,8,10,10,58,101
2006-06-19 00:00:00.000,'s-Hertogenbosch The Netherlands ATP World Tour,GRASS,2,Jan Hernych,Florent Serra,Jan Hernych,6-2; 7-6(3),S,74,2,1,43,69,28,43,12,26,2,5,10,40,69,0,3,32,59,16,32,11,27,1,6,10,27,59
2006-06-19 00:00:00.000,'s-Hertogenbosch The Netherlands ATP World Tour,GRASS,2,Mario Ancic,Jan Hernych,Mario Ancic,6-0; 5-7; 7-5,F,126,21,5,59,95,47,59,17,36,6,8,15,64,95,3,1,60,79,37,60,12,19,2,7,15,49,79
2006-06-26 00:00:00.000,Wimbledon England Grand Slams,GRASS,3,Roger Federer,Richard Gasquet,Roger Federer,6-3; 6-2; 6-2,R128,74,5,1,47,70,40,47,15,23,1,1,13,55,70,2,1,54,69,30,54,8,15,2,7,12,38,69
2006-06-26 00:00:00.000,Wimbledon England Grand Slams,GRASS,3,Tim Henman,Robin Soderling,Tim Henman,6-7(8); 6-3; 6-2; 1-6; 6-3,R128,195,4,6,82,144,61,82,36,62,4,7,23,97,144,17,10,98,149,72,98,21,51,10,15,22,93,149
2006-06-26 00:00:00.000,Wimbledon England Grand Slams,GRASS,3,Nicolas Mahut,Jurgen Melzer,Nicolas Mahut,6-7(3); 7-5; 6-1; 6-4,R128,152,19,5,81,112,67,81,22,31,4,4,21,89,112,12,9,81,128,57,81,24,47,3,7,20,81,128
2006-06-26 00:00:00.000,Wimbledon England Grand Slams,GRASS,3,Kristof Vliegen,Jiri Novak,Kristof Vliegen,6-4; 7-5; 6-2,R128,107,9,3,61,92,52,61,16,31,3,3,15,68,92,8,2,70,97,43,70,14,27,4,8,15,57,97
2006-06-26 00:00:00.000,Wimbledon England Grand Slams,GRASS,3,Tommy Haas,Jiri Vanek,Tommy Haas,7-6(2); 7-5; 6-4,R128,120,9,5,58,95,48,58,22,37,2,4,17,70,95,11,3,85,121,61,85,11,36,17,21,17,72,121
2006-06-26 00:00:00.000,Wimbledon England Grand Slams,GRASS,3,Richard Bloomfield,Carlos Berlocq,Richard Bloomfield,6-1; 6-2; 6-2,R128,78,10,4,33,64,28,33,22,31,1,1,12,50,64,0,9,37,73,20,37,15,36,8,14,11,35,73
2006-06-26 00:00:00.000,Wimbledon England Grand Slams,GRASS,3,Fabrice Santoro,Wayne Arthurs,Fabrice Santoro,7-6(3); 6-3; 3-6; 6-1,R128,148,6,2,73,110,56,73,22,37,0,1,19,78,110,17,7,68,128,51,68,30,60,8,11,18,81,128
2006-06-26 00:00:00.000,Wimbledon England Grand Slams,GRASS,3,Tomas Berdych,Jan Hernych,Tomas Berdych,6-3; 6-4; 7-5,R128,105,13,3,51,95,40,51,25,44,4,5,16,65,95,2,2,59,85,41,59,10,26,2,6,15,51,85
2006-06-26 00:00:00.000,Wimbledon England Grand Slams,GRASS,3,Tommy Robredo,Simon Greul,Tommy Robredo,6-2; 6-2; 5-7; 7-6(3),R128,142,4,2,89,117,66,89,14,28,4,7,20,80,117,3,4,86,132,55,86,21,46,3,9,20,76,132
2006-06-26 00:00:00.000,Wimbledon England Grand Slams,GRASS,3,Novak Djokovic,Paul Goldstein,Novak Djokovic,6-3; 6-2; 7-6(3),R128,124,8,4,59,98,46,59,19,39,4,6,15,65,98,1,5,43,87,31,43,21,44,3,8,14,52,87
2006-06-26 00:00:00.000,Wimbledon England Grand Slams,GRASS,3,Mikhail Youzhny,Potito Starace,Mikhail Youzhny,6-0; 6-4; 6-1,R128,75,3,1,40,56,31,40,13,16,0,0,11,44,56,1,2,62,93,35,62,8,31,4,11,12,43,93
2006-06-26 00:00:00.000,Wimbledon England Grand Slams,GRASS,3,Igor Kunitsyn,Gael Monfils,Igor Kunitsyn,5-7; 7-6(7); 6-3; 6-4,R128,177,0,1,131,179,83,131,30,48,17,20,22,113,179,13,1,70,123,53,70,29,53,1,5,21,82,123
2006-06-26 00:00:00.000,Wimbledon England Grand Slams,GRASS,3,Agustin Calleri,Paradorn Srichaphan,Agustin Calleri,6-7(3); 7-5; 6-3; 3-6; 6-3,R128,186,12,6,93,150,79,93,29,57,0,2,26,108,150,7,7,82,159,63,82,41,77,9,13,25,104,159
2006-06-26 00:00:00.000,Wimbledon England Grand Slams,GRASS,3,Stanislas Wawrinka,Ivo Karlovic,Stanislas Wawrinka,7-6(5); 3-6; 6-2; 6-7(8); 11-9,R128,232,16,9,90,169,76,90,56,79,3,4,30,132,169,35,16,134,193,107,134,29,59,6,9,31,136,193
2006-06-26 00:00:00.000,Wimbledon England Grand Slams,GRASS,3,Davide Sanguinetti,Kevin Kim,Davide Sanguinetti,6-3; 7-6(10); 6-1,R128,91,11,1,63,99,52,63,19,36,6,7,15,71,99,3,3,56,90,39,56,14,34,3,7,13,53,90
2006-06-26 00:00:00.000,Wimbledon England Grand Slams,GRASS,3,Mario Ancic,Nicolas Almagro,Mario Ancic,7-6(2); 7-5; 7-6(4),R128,157,21,3,75,114,58,75,27,39,2,3,18,85,114,11,6,70,124,55,70,27,54,8,10,18,82,124
2006-06-26 00:00:00.000,Wimbledon England Grand Slams,GRASS,3,David Nalbandian,Wesley Moodie,David Nalbandian,6-3; 6-4; 6-1,R128,97,1,5,47,75,40,47,16,28,2,2,13,56,75,10,2,65,90,40,65,10,25,9,14,13,50,90
2006-06-26 00:00:00.000,Wimbledon England Grand Slams,GRASS,3,Arnaud Clement,Albert Portas,Arnaud Clement,6-3; 6-2; 6-4,R128,91,6,1,51,69,44,51,11,18,3,4,14,55,69,6,1,41,83,31,41,14,42,3,8,13,45,83
2006-06-26 00:00:00.000,Wimbledon England Grand Slams,GRASS,3,Benjamin Becker,Juan Ignacio Chela,Benjamin Becker,6-3; 3-6; 6-3; 6-4,R128,137,21,6,88,136,69,88,20,48,9,10,19,89,136,8,0,67,100,48,67,18,33,2,5,18,66,100
2006-06-26 00:00:00.000,Wimbledon England Grand Slams,GRASS,3,Fernando Verdasco,Vincent Spadea,Fernando Verdasco,3-6; 6-4; 7-6(1); 6-3,R128,152,8,2,88,122,63,88,24,34,8,9,19,87,122,7,5,91,138,67,91,22,47,12,15,21,89,138
2006-06-26 00:00:00.000,Wimbledon England Grand Slams,GRASS,3,Juan Carlos Ferrero,Fernando Vicente,Juan Carlos Ferrero,6-1; 6-3; 6-2,R128,84,8,0,42,58,37,42,12,16,1,1,12,49,58,1,1,62,90,34,62,11,28,8,14,12,45,90
2006-06-26 00:00:00.000,Wimbledon England Grand Slams,GRASS,3,Roko Karanusic,Rainer Schuettler,Roko Karanusic,7-6(7); 4-6; 6-2; 6-1,R128,131,10,1,75,107,62,75,20,32,3,4,19,82,107,3,2,78,112,54,78,14,34,1,5,18,68,112
2006-06-26 00:00:00.000,Wimbledon England Grand Slams,GRASS,3,Xavier Malisse,Benedikt Dorsch,Xavier Malisse,6-2; 7-5; 6-2,R128,102,10,0,61,88,44,61,18,27,5,6,14,62,88,6,0,46,75,26,46,13,29,1,7,14,39,75
2006-06-26 00:00:00.000,Wimbledon England Grand Slams,GRASS,3,Radek Stepanek,Frank Dancevic,Radek Stepanek,7-6(4); 6-3; 6-4,R128,113,10,5,77,106,63,77,13,29,6,6,16,76,106,8,1,63,91,46,63,14,28,3,5,15,60,91
2006-06-26 00:00:00.000,Wimbledon England Grand Slams,GRASS,3,Jonas Bjorkman,Thomas Johansson,Jonas Bjorkman,3-6; 7-6(4); 6-1; 6-1,R128,147,6,0,72,103,54,72,21,31,2,3,17,75,103,8,6,79,126,55,79,19,47,7,12,18,74,126
2006-06-26 00:00:00.000,Wimbledon England Grand Slams,GRASS,3,Lukas Dlouhy,Florent Serra,Lukas Dlouhy,4-6; 6-3; 6-4; 7-5,R128,147,9,7,89,130,66,89,21,41,7,9,21,87,130,7,3,92,150,59,92,32,58,12,16,20,91,150
2006-06-26 00:00:00.000,Wimbledon England Grand Slams,GRASS,3,Stefano Galvani,Alexander Waske,Stefano Galvani,4-6; 7-6(2); 6-4; 3-6; 16-14,R128,296,10,11,135,213,110,135,42,78,11,14,35,152,213,44,13,129,204,103,129,42,75,8,11,36,145,204
2006-06-26 00:00:00.000,Wimbledon England Grand Slams,GRASS,3,Daniele Bracciali,Dominik Hrbaty,Daniele Bracciali,6-2; 6-4; 6-4,R128,94,21,0,40,76,35,40,24,36,1,1,14,59,76,7,6,48,81,37,48,11,33,0,4,14,48,81
2006-06-26 00:00:00.000,Wimbledon England Grand Slams,GRASS,3,Mark Philippoussis,Paul-Henri Mathieu,Mark Philippoussis,5-7; 7-6(5); 6-3; 7-6(12),R128,195,40,6,78,128,69,78,35,50,0,1,23,104,128,7,1,89,150,67,89,36,61,2,3,22,103,150
2006-06-26 00:00:00.000,Wimbledon England Grand Slams,GRASS,3,Max Mirnyi,Ruben Ramirez Hidalgo,Max Mirnyi,6-7(5); 6-4; 6-3; 6-3,R128,153,21,2,73,112,62,73,29,39,5,5,20,91,112,14,3,86,129,58,86,26,43,10,14,20,84,129
2006-06-26 00:00:00.000,Wimbledon England Grand Slams,GRASS,3,Jimmy Wang,Oliver Marach,Jimmy Wang,6-1; 7-6(2); 6-0,R128,115,9,1,50,86,38,50,23,36,5,6,13,61,86,8,4,57,99,34,57,17,42,8,14,12,51,99
2006-06-26 00:00:00.000,Wimbledon England Grand Slams,GRASS,3,James Blake,Kristian Pless,James Blake,6-3; 7-5; 5-7; 6-4,R128,121,11,9,70,122,55,70,30,52,1,3,22,85,122,4,2,85,118,59,85,18,33,3,7,21,77,118
2006-06-26 00:00:00.000,Wimbledon England Grand Slams,GRASS,3,Lleyton Hewitt,Filippo Volandri,Lleyton Hewitt,6-1; 6-1; 6-3,R128,69,12,1,39,67,30,39,21,28,0,0,12,51,67,0,5,35,66,19,35,12,31,5,11,11,31,66
2006-06-26 00:00:00.000,Wimbledon England Grand Slams,GRASS,3,Hyung-Taik Lee,Flavio Saretta,Hyung-Taik Lee,7-6(10); 6-3; 7-5,R128,130,5,1,76,109,55,76,21,33,7,9,16,76,109,12,10,76,130,50,76,28,54,11,16,17,78,130
2006-06-26 00:00:00.000,Wimbledon England Grand Slams,GRASS,3,Tomas Zib,Albert Montanes,Tomas Zib,6-3; 6-4; 7-6(7),R128,122,7,1,67,106,52,67,17,39,4,7,16,69,106,8,5,72,111,46,72,18,39,6,11,15,64,111
2006-06-26 00:00:00.000,Wimbledon England Grand Slams,GRASS,3,Olivier Rochus,Gilles Muller,Olivier Rochus,6-4; 7-5; 6-3,R128,129,2,3,57,92,43,57,25,35,4,4,15,68,92,21,6,73,120,46,73,23,47,12,16,16,69,120
2006-06-26 00:00:00.000,Wimbledon England Grand Slams,GRASS,3,David Ferrer,Simon Stadler,David Ferrer,6-1; 6-4; 6-4,R128,120,1,3,71,100,52,71,13,29,8,9,14,65,100,2,0,59,87,40,59,10,28,9,14,13,50,87
2006-06-26 00:00:00.000,Wimbledon England Grand Slams,GRASS,3,Guillermo Garcia-Lopez,Ivo Minar,Guillermo Garcia-Lopez,7-6(1); 4-6; 7-6(3); 6-2,R128,189,10,4,95,152,66,95,28,57,16,21,21,94,152,5,4,89,143,59,89,26,54,10,16,21,85,143
2006-06-26 00:00:00.000,Wimbledon England Grand Slams,GRASS,3,Marat Safin,Greg Rusedski,Marat Safin,6-4; 6-4; 6-4,R128,93,13,1,48,79,39,48,23,31,1,1,15,62,79,7,5,60,96,45,60,16,36,3,6,15,61,96
2006-06-26 00:00:00.000,Wimbledon England Grand Slams,GRASS,3,Fernando Gonzalez,Luis Horna,Fernando Gonzalez,7-6(3); 7-5; 6-2,R128,110,16,4,52,88,45,52,25,36,1,1,16,70,88,12,2,61,102,46,61,19,41,5,8,16,65,102
2006-06-26 00:00:00.000,Wimbledon England Grand Slams,GRASS,3,Sebastien Grosjean,Gilles Simon,Sebastien Grosjean,6-4; 6-2; 6-4,R128,109,5,3,49,85,39,49,22,36,6,7,14,61,85,4,1,53,92,37,53,16,39,5,10,14,53,92
2006-06-26 00:00:00.000,Wimbledon England Grand Slams,GRASS,3,Jamie Delgado,Michael Berrer,Jamie Delgado,6-4; 6-2; 3-6; 3-6; 6-3,R128,143,12,4,82,129,65,82,21,47,4,7,22,86,129,31,11,81,130,64,81,23,49,9,14,23,87,130
2006-06-26 00:00:00.000,Wimbledon England Grand Slams,GRASS,3,Andrei Pavel,Marcel Granollers,Andrei Pavel,7-6(4); 6-4; 6-4,R128,133,9,4,76,129,55,76,26,53,13,15,16,81,129,9,4,64,108,42,64,21,44,7,11,16,63,108
2006-06-26 00:00:00.000,Wimbledon England Grand Slams,GRASS,3,Marcos Baghdatis,Alan Mackin,Marcos Baghdatis,6-4; 6-7(4); 6-7(4); 7-5; 6-2,R128,261,22,4,109,189,89,109,33,80,7,11,27,122,189,7,10,128,192,80,128,34,64,9,17,27,114,192
2006-06-26 00:00:00.000,Wimbledon England Grand Slams,GRASS,3,Andy Murray,Nicolas Massu,Andy Murray,6-1; 6-4; 6-4,R128,113,5,3,44,85,32,44,26,41,3,4,14,58,85,6,4,62,99,37,62,16,37,8,13,13,53,99
2006-06-26 00:00:00.000,Wimbledon England Grand Slams,GRASS,3,Julien Benneteau,Bjorn Phau,Julien Benneteau,5-7; 6-4; 6-2; 7-6(6),R128,169,6,4,108,137,80,108,11,29,6,9,21,91,137,8,1,81,128,53,81,26,47,6,11,21,79,128
2006-06-26 00:00:00.000,Wimbledon England Grand Slams,GRASS,3,Florian Mayer,Robin Vik,Florian Mayer,6-3; 6-3; 6-3,R128,80,4,0,53,73,39,53,13,20,2,3,13,52,73,6,3,59,89,36,59,11,30,6,12,14,47,89
2006-06-26 00:00:00.000,Wimbledon England Grand Slams,GRASS,3,Andy Roddick,Janko Tipsarevic,Andy Roddick,6-7(5); 6-4; 7-6(6); 6-2,R128,173,28,2,98,151,75,98,30,53,9,9,21,105,151,12,3,58,118,39,58,44,60,1,4,21,83,118
2006-06-26 00:00:00.000,Wimbledon England Grand Slams,GRASS,3,Ivan Ljubicic,Feliciano Lopez,Ivan Ljubicic,6-3; 6-4; 5-7; 3-6; 11-9,R128,243,32,10,115,184,89,115,37,69,4,7,30,126,184,26,9,113,180,94,113,30,67,13,17,30,124,180
2006-06-26 00:00:00.000,Wimbledon England Grand Slams,GRASS,3,Justin Gimelstob,Christophe Rochus,Justin Gimelstob,6-3; 6-4; 6-4,R128,117,18,2,57,107,48,57,25,50,6,6,15,73,107,0,2,60,79,43,60,9,19,3,6,14,52,79
2006-06-26 00:00:00.000,Wimbledon England Grand Slams,GRASS,3,Alberto Martin,Alessio Di Mauro,Alberto Martin,6-3; 6-4; 6-1,R128,94,10,2,49,77,41,49,15,28,0,0,13,56,77,4,3,55,93,29,55,20,38,8,13,13,49,93
2006-06-26 00:00:00.000,Wimbledon England Grand Slams,GRASS,3,Dmitry Tursunov,Danai Udomchoke,Dmitry Tursunov,6-1; 6-4; 6-2,R128,81,9,5,41,68,37,41,17,27,0,0,13,54,68,6,6,72,94,44,72,5,22,11,16,12,49,94
2006-06-26 00:00:00.000,Wimbledon England Grand Slams,GRASS,3,Jarkko Nieminen,Marcos Daniel,Jarkko Nieminen,6-2; 6-4; 7-5,R128,111,6,2,50,90,40,50,21,40,4,6,15,61,90,6,5,66,96,41,66,9,30,5,11,15,50,96
2006-06-26 00:00:00.000,Wimbledon England Grand Slams,GRASS,3,Martin Lee,Dick Norman,Martin Lee,6-2; 7-6(2); 7-6(4),R128,123,14,3,68,111,49,68,25,43,2,4,16,74,111,10,2,66,105,47,66,15,39,9,13,16,62,105
2006-06-26 00:00:00.000,Wimbledon England Grand Slams,GRASS,3,Philipp Kohlschreiber,Razvan Sabau,Philipp Kohlschreiber,6-3; 6-2; 6-4,R128,89,17,5,39,74,38,39,16,35,1,2,14,54,74,4,3,54,81,32,54,12,27,5,10,13,44,81
2006-06-26 00:00:00.000,Wimbledon England Grand Slams,GRASS,3,Alejandro Falla,Nikolay Davydenko,Alejandro Falla,2-6; 7-6(4); 7-6(8); 6-3,R128,170,4,0,105,154,64,105,25,49,5,12,21,89,154,8,5,87,131,55,87,26,44,5,11,20,81,131
2006-06-26 00:00:00.000,Wimbledon England Grand Slams,GRASS,3,Gaston Gaudio,Jean-Christophe Faurel,Gaston Gaudio,7-5; 3-6; 6-2; 6-4,R128,161,9,5,95,142,62,95,23,47,18,23,20,85,142,6,9,80,121,47,80,19,41,5,12,19,66,121
2006-06-26 00:00:00.000,Wimbledon England Grand Slams,GRASS,3,Irakli Labadze,Alexander Peya,Irakli Labadze,6-4; 4-6; 5-7; 6-3; 6-1,R128,173,5,6,82,143,60,82,35,61,7,10,24,95,143,8,7,80,138,55,80,30,58,6,12,24,85,138
2006-06-26 00:00:00.000,Wimbledon England Grand Slams,GRASS,3,Melle Van Gemerden,Josh Goodall,Melle Van Gemerden,6-4; 7-5; 7-5,R128,136,13,7,55,104,40,55,33,49,5,6,17,73,104,13,7,79,130,59,79,20,51,8,12,17,79,130
2006-06-26 00:00:00.000,Wimbledon England Grand Slams,GRASS,3,Mardy Fish,Robby Ginepri,Mardy Fish,6-3; 6-2; 6-4,R128,83,12,2,43,79,34,43,21,36,2,3,14,55,79,7,2,46,72,35,46,9,26,6,11,13,44,72
2006-06-26 00:00:00.000,Wimbledon England Grand Slams,GRASS,3,Andre Agassi,Boris Pashanski,Andre Agassi,2-6; 6-2; 6-4; 6-3,R128,132,17,4,62,100,43,62,25,38,3,5,17,68,100,8,11,69,142,50,69,29,73,8,13,18,79,142
2006-06-26 00:00:00.000,Wimbledon England Grand Slams,GRASS,3,Andreas Seppi,Jamie Baker,Andreas Seppi,6-3; 6-7(3); 6-4; 6-3,R128,177,8,3,81,130,53,81,21,49,6,11,19,74,130,5,4,94,146,57,94,18,52,7,17,21,75,146
2006-06-26 00:00:00.000,Wimbledon England Grand Slams,GRASS,3,Robert Kendrick,Yen-Hsun Lu,Robert Kendrick,7-6(5); 6-3; 6-0,R128,109,13,4,66,93,52,66,13,27,8,9,14,65,93,4,4,62,85,37,62,12,23,4,9,13,49,85
2006-06-26 00:00:00.000,Wimbledon England Grand Slams,GRASS,3,Rafael Nadal,Alex Bogdanovic,Rafael Nadal,6-4; 7-6(3); 6-4,R128,152,3,3,79,108,60,79,14,29,4,5,16,74,108,1,0,82,111,58,82,12,29,6,9,16,70,111
2006-06-26 00:00:00.000,Wimbledon England Grand Slams,GRASS,3,Roger Federer,Tim Henman,Roger Federer,6-4; 6-0; 6-2,R64,85,6,0,44,71,35,44,17,27,2,2,12,52,71,0,3,38,61,21,38,8,23,2,8,12,29,61
2006-06-26 00:00:00.000,Wimbledon England Grand Slams,GRASS,3,Nicolas Mahut,Kristof Vliegen,Nicolas Mahut,6-4; 6-4; 6-3,R64,106,13,4,57,85,48,57,12,28,2,2,14,60,85,9,3,54,76,40,54,9,22,2,6,15,49,76
2006-06-26 00:00:00.000,Wimbledon England Grand Slams,GRASS,3,Tommy Haas,Richard Bloomfield,Tommy Haas,6-3; 6-4; 7-6(4),R64,114,15,6,61,94,51,61,21,33,2,2,16,72,94,15,8,69,118,50,69,22,49,12,14,15,72,118
2006-06-26 00:00:00.000,Wimbledon England Grand Slams,GRASS,3,Tomas Berdych,Fabrice Santoro,Tomas Berdych,6-4; 6-7(6); 2-6; 7-6(5); 6-4,R64,251,15,6,109,189,78,109,37,80,9,15,26,115,189,10,9,115,190,84,115,31,75,10,16,26,115,190
2006-06-26 00:00:00.000,Wimbledon England Grand Slams,GRASS,3,Novak Djokovic,Tommy Robredo,Novak Djokovic,7-6(5); 6-2; 6-4,R64,133,2,3,63,94,46,63,15,31,2,5,15,61,94,1,3,74,107,45,74,12,33,9,15,15,57,107
2006-06-26 00:00:00.000,Wimbledon England Grand Slams,GRASS,3,Mikhail Youzhny,Igor Kunitsyn,Mikhail Youzhny,6-3; 6-1; 3-0 RET,R64,80,10,2,32,53,25,32,12,21,6,7,9,37,53,1,1,57,90,30,57,12,33,14,21,10,42,90
2006-06-26 00:00:00.000,Wimbledon England Grand Slams,GRASS,3,Stanislas Wawrinka,Agustin Calleri,Stanislas Wawrinka,7-6(5); 7-5; 6-3,R64,141,5,8,72,123,52,72,26,51,9,12,16,78,123,5,2,90,131,54,90,20,41,9,15,17,74,131
2006-06-26 00:00:00.000,Wimbledon England Grand Slams,GRASS,3,Mario Ancic,Davide Sanguinetti,Mario Ancic,6-4; 6-2; 6-1,R64,101,12,0,41,67,33,41,18,26,1,2,13,51,67,1,2,49,80,28,49,11,31,6,12,12,39,80
2006-06-26 00:00:00.000,Wimbledon England Grand Slams,GRASS,3,David Nalbandian,Arnaud Clement,David Nalbandian,6-4; 6-4; 6-3,R64,115,4,2,51,86,41,51,17,35,5,6,14,58,86,10,3,57,93,43,57,11,36,3,8,15,54,93
2006-06-26 00:00:00.000,Wimbledon England Grand Slams,GRASS,3,Fernando Verdasco,Benjamin Becker,Fernando Verdasco,6-4; 6-7(7); 4-6; 6-3; 9-7,R64,202,16,3,113,163,89,113,34,50,2,4,29,123,163,22,7,92,154,76,92,36,62,3,7,28,112,154
2006-06-26 00:00:00.000,Wimbledon England Grand Slams,GRASS,3,Juan Carlos Ferrero,Roko Karanusic,Juan Carlos Ferrero,6-3; 7-6(4); 6-3,R64,110,3,1,66,104,47,66,27,38,4,4,16,74,104,9,0,60,83,47,60,11,23,5,7,14,58,83
2006-06-26 00:00:00.000,Wimbledon England Grand Slams,GRASS,3,Radek Stepanek,Xavier Malisse,Radek Stepanek,6-3; 6-7(4); 7-5; 6-1,R64,145,5,2,84,124,59,84,23,40,4,6,21,82,124,6,2,79,111,47,79,19,32,6,12,19,66,111
2006-06-26 00:00:00.000,Wimbledon England Grand Slams,GRASS,3,Jonas Bjorkman,Lukas Dlouhy,Jonas Bjorkman,6-3; 6-4; 4-6; 1-6; 6-4,R64,183,5,7,90,141,60,90,22,51,5,13,23,82,141,9,7,100,145,62,100,19,45,11,19,23,81,145
2006-06-26 00:00:00.000,Wimbledon England Grand Slams,GRASS,3,Daniele Bracciali,Stefano Galvani,Daniele Bracciali,6-3; 6-7(3); 6-3; 6-4,R64,159,29,1,75,130,58,75,31,55,5,7,21,89,130,6,5,68,115,50,68,21,47,3,8,19,71,115
2006-06-26 00:00:00.000,Wimbledon England Grand Slams,GRASS,3,Max Mirnyi,Mark Philippoussis,Max Mirnyi,7-6(6); 6-4; 6-7(5); 6-3,R64,196,21,3,102,157,80,102,28,55,9,10,22,108,157,26,6,86,132,69,86,21,46,5,8,21,90,132
2006-06-26 00:00:00.000,Wimbledon England Grand Slams,GRASS,3,James Blake,Jimmy Wang,James Blake,6-4; 6-2; 4-6; 6-2,R64,134,11,4,84,131,63,84,23,47,20,21,18,86,131,4,4,77,127,51,77,22,50,13,18,18,73,127
2006-06-26 00:00:00.000,Wimbledon England Grand Slams,GRASS,3,Lleyton Hewitt,Hyung-Taik Lee,Lleyton Hewitt,6-7(4); 6-2; 7-6(6); 6-7(5); 6-4,R64,237,19,6,103,185,78,103,41,82,8,11,27,119,185,13,4,128,193,86,128,34,65,14,20,27,120,193
2006-06-26 00:00:00.000,Wimbledon England Grand Slams,GRASS,3,Olivier Rochus,Tomas Zib,Olivier Rochus,6-1; 6-1; 6-0,R64,89,7,1,42,62,33,42,13,20,3,3,10,46,62,5,3,51,89,25,51,13,38,7,15,10,38,89
2006-06-26 00:00:00.000,Wimbledon England Grand Slams,GRASS,3,David Ferrer,Guillermo Garcia-Lopez,David Ferrer,7-6(2); 7-5; 6-3,R64,150,3,7,52,90,42,52,23,38,1,3,17,65,90,6,4,81,126,56,81,15,45,13,17,16,71,126
2006-06-26 00:00:00.000,Wimbledon England Grand Slams,GRASS,3,Fernando Gonzalez,Marat Safin,Fernando Gonzalez,4-6; 6-7(4); 6-4; 6-4; 6-4,R64,202,18,0,105,155,81,105,28,50,4,6,26,109,155,18,4,126,180,92,126,28,54,9,13,26,120,180
2006-06-26 00:00:00.000,Wimbledon England Grand Slams,GRASS,3,Sebastien Grosjean,Jamie Delgado,Sebastien Grosjean,6-3; 3-6; 6-2; 6-3,R64,133,9,7,59,102,45,59,22,43,3,6,18,67,102,10,7,70,118,45,70,19,48,7,13,17,64,118
2006-06-26 00:00:00.000,Wimbledon England Grand Slams,GRASS,3,Marcos Baghdatis,Andrei Pavel,Marcos Baghdatis,3-0 RET,R64,19,1,0,4,11,4,4,4,7,0,0,2,8,11,1,1,2,8,1,2,0,6,1,2,1,1,8
2006-06-26 00:00:00.000,Wimbledon England Grand Slams,GRASS,3,Andy Murray,Julien Benneteau,Andy Murray,7-6(5); 6-4; 4-6; 6-1,R64,173,8,1,61,121,42,61,34,60,6,10,19,76,121,8,10,89,140,57,89,21,51,7,14,20,78,140
2006-06-26 00:00:00.000,Wimbledon England Grand Slams,GRASS,3,Andy Roddick,Florian Mayer,Andy Roddick,6-4; 6-1; 6-2,R64,69,12,0,45,64,39,45,13,19,0,0,13,52,64,6,0,49,68,30,49,8,19,2,7,12,38,68
2006-06-26 00:00:00.000,Wimbledon England Grand Slams,GRASS,3,Ivan Ljubicic,Justin Gimelstob,Ivan Ljubicic,6-3; 7-6(1); 7-5,R64,157,16,3,73,103,56,73,18,30,2,2,16,74,103,17,6,70,131,52,70,29,61,16,19,17,81,131
2006-06-26 00:00:00.000,Wimbledon England Grand Slams,GRASS,3,Dmitry Tursunov,Alberto Martin,Dmitry Tursunov,6-1; 7-5; 6-4,R64,104,11,5,55,85,47,55,18,30,5,5,15,65,85,3,3,57,92,35,57,19,35,11,15,14,54,92
2006-06-26 00:00:00.000,Wimbledon England Grand Slams,GRASS,3,Jarkko Nieminen,Martin Lee,Jarkko Nieminen,6-4; 6-0; 6-3,R64,85,2,5,48,75,38,48,16,27,1,1,12,54,75,6,3,46,86,26,46,17,40,3,9,13,43,86
2006-06-26 00:00:00.000,Wimbledon England Grand Slams,GRASS,3,Philipp Kohlschreiber,Alejandro Falla,Philipp Kohlschreiber,6-4; 6-4; 3-6; 7-6(1),R64,152,11,5,76,125,63,76,29,49,5,6,20,92,125,4,1,86,128,66,86,21,42,4,6,21,87,128
2006-06-26 00:00:00.000,Wimbledon England Grand Slams,GRASS,3,Irakli Labadze,Gaston Gaudio,Irakli Labadze,6-4; 6-2; 6-3,R64,87,14,5,47,72,39,47,15,25,4,5,13,54,72,6,4,51,82,30,51,13,31,4,10,14,43,82
2006-06-26 00:00:00.000,Wimbledon England Grand Slams,GRASS,3,Mardy Fish,Melle Van Gemerden,Mardy Fish,6-2; 6-0; 6-1,R64,82,12,3,35,62,31,35,17,27,0,0,11,48,62,2,10,34,64,19,34,9,30,5,12,10,28,64
2006-06-26 00:00:00.000,Wimbledon England Grand Slams,GRASS,3,Andre Agassi,Andreas Seppi,Andre Agassi,6-4; 7-6(2); 6-4,R64,143,9,4,72,121,54,72,24,49,7,8,16,78,121,10,3,57,107,38,57,26,50,7,10,16,64,107
2006-06-26 00:00:00.000,Wimbledon England Grand Slams,GRASS,3,Rafael Nadal,Robert Kendrick,Rafael Nadal,6-7(4); 3-6; 7-6(2); 7-5; 6-4,R64,226,7,3,115,152,93,115,24,37,1,2,27,117,152,32,8,111,171,90,111,30,60,7,9,28,120,171
2006-06-26 00:00:00.000,Wimbledon England Grand Slams,GRASS,3,Roger Federer,Nicolas Mahut,Roger Federer,6-3; 7-6(2); 6-4,R32,125,7,1,60,93,43,60,26,33,1,2,16,69,93,10,5,58,96,40,58,19,38,5,8,15,59,96
2006-06-26 00:00:00.000,Wimbledon England Grand Slams,GRASS,3,Tomas Berdych,Tommy Haas,Tomas Berdych,2-6; 7-5; 7-6(7); 4-6; 8-6,R32,215,17,5,113,172,79,113,34,59,2,7,28,113,172,24,8,93,166,74,93,41,73,2,6,28,115,166
2006-06-26 00:00:00.000,Wimbledon England Grand Slams,GRASS,3,Novak Djokovic,Mikhail Youzhny,Novak Djokovic,4-6; 6-2; 6-3; 6-3,R32,156,7,3,71,111,56,71,22,40,4,5,18,78,111,6,2,63,98,41,63,20,35,1,6,18,61,98
2006-06-26 00:00:00.000,Wimbledon England Grand Slams,GRASS,3,Mario Ancic,Stanislas Wawrinka,Mario Ancic,7-6(5); 6-7(5); 6-1; 6-3,R32,199,14,6,87,138,73,87,24,51,5,5,20,97,138,2,7,81,145,58,81,32,64,11,15,20,90,145
2006-06-26 00:00:00.000,Wimbledon England Grand Slams,GRASS,3,Fernando Verdasco,David Nalbandian,Fernando Verdasco,7-6(9); 7-6(9); 6-2,R32,167,3,3,95,131,68,95,23,36,18,19,16,91,131,8,4,79,135,54,79,32,56,8,11,16,86,135
2006-06-26 00:00:00.000,Wimbledon England Grand Slams,GRASS,3,Radek Stepanek,Juan Carlos Ferrero,Radek Stepanek,5-7; 6-7(3); 6-4; 6-2; 11-9,R32,243,34,7,108,182,85,108,47,74,8,10,31,132,182,17,0,113,165,85,113,33,52,4,9,31,118,165
2006-06-26 00:00:00.000,Wimbledon England Grand Slams,GRASS,3,Jonas Bjorkman,Daniele Bracciali,Jonas Bjorkman,7-5; 6-2; 6-1,R32,112,4,1,69,89,53,69,11,20,3,4,14,64,89,5,6,59,94,35,59,14,35,9,15,13,49,94
2006-06-26 00:00:00.000,Wimbledon England Grand Slams,GRASS,3,Max Mirnyi,James Blake,Max Mirnyi,6-4; 3-6; 4-6; 6-1; 6-0,R32,166,16,2,89,135,64,89,22,46,9,13,21,86,135,6,6,78,128,54,78,18,50,7,15,21,72,128
2006-06-26 00:00:00.000,Wimbledon England Grand Slams,GRASS,3,Lleyton Hewitt,Olivier Rochus,Lleyton Hewitt,6-1; 6-4; 6-4,R32,119,15,5,36,77,31,36,25,41,1,2,14,56,77,4,4,63,100,40,63,16,37,8,13,13,56,100
2006-06-26 00:00:00.000,Wimbledon England Grand Slams,GRASS,3,David Ferrer,Fernando Gonzalez,David Ferrer,4-6; 2-6; 6-2; 6-3; 6-4,R32,175,11,6,91,128,65,91,23,37,2,7,23,88,128,5,12,78,131,57,78,21,53,7,13,22,78,131
2006-06-26 00:00:00.000,Wimbledon England Grand Slams,GRASS,3,Marcos Baghdatis,Sebastien Grosjean,Marcos Baghdatis,4-6; 6-4; 6-4; 6-1,R32,156,8,3,67,120,51,67,24,53,4,9,19,75,120,13,7,72,111,47,72,13,39,7,15,18,60,111
2006-06-26 00:00:00.000,Wimbledon England Grand Slams,GRASS,3,Andy Murray,Andy Roddick,Andy Murray,7-6(4); 6-4; 6-4,R32,151,6,1,61,115,45,61,34,54,11,12,16,79,115,21,3,78,113,57,78,14,35,9,12,16,71,113
2006-06-26 00:00:00.000,Wimbledon England Grand Slams,GRASS,3,Dmitry Tursunov,Ivan Ljubicic,Dmitry Tursunov,5-7; 4-6; 6-1; 7-6(6); 6-2,R32,225,19,6,78,149,66,78,38,71,4,7,24,104,149,24,10,96,161,71,96,30,65,6,12,25,101,161
2006-06-26 00:00:00.000,Wimbledon England Grand Slams,GRASS,3,Jarkko Nieminen,Philipp Kohlschreiber,Jarkko Nieminen,1-6; 6-2; 6-3; 7-6(4),R32,133,6,2,68,106,49,68,20,38,1,5,18,69,106,6,2,63,112,42,63,27,49,6,11,18,69,112
2006-06-26 00:00:00.000,Wimbledon England Grand Slams,GRASS,3,Irakli Labadze,Mardy Fish,Irakli Labadze,6-2 RET,R32,26,6,1,12,23,10,12,7,11,0,0,4,17,23,3,3,11,25,9,11,4,14,1,3,4,13,25
2006-06-26 00:00:00.000,Wimbledon England Grand Slams,GRASS,3,Rafael Nadal,Andre Agassi,Rafael Nadal,7-6(5); 6-2; 6-4,R32,134,18,2,56,79,49,56,15,23,0,0,15,64,79,7,2,63,108,45,63,22,45,8,11,15,67,108
2006-06-26 00:00:00.000,Wimbledon England Grand Slams,GRASS,3,Roger Federer,Tomas Berdych,Roger Federer,6-3; 6-3; 6-4,R16,83,21,1,49,72,41,49,17,23,1,1,14,58,72,1,3,57,84,36,57,13,27,3,7,14,49,84
2006-06-26 00:00:00.000,Wimbledon England Grand Slams,GRASS,3,Mario Ancic,Novak Djokovic,Mario Ancic,6-4; 4-6; 4-6; 7-5; 6-3,R16,204,31,6,81,138,69,81,32,57,1,3,26,101,138,11,5,86,132,70,86,25,46,5,8,25,95,132
2006-06-26 00:00:00.000,Wimbledon England Grand Slams,GRASS,3,Radek Stepanek,Fernando Verdasco,Radek Stepanek,6-7(4); 6-3; 4-6; 6-4; 6-2,R16,215,21,9,93,150,70,93,34,57,10,13,25,104,150,7,8,126,164,85,126,16,38,9,15,24,101,164
2006-06-26 00:00:00.000,Wimbledon England Grand Slams,GRASS,3,Jonas Bjorkman,Max Mirnyi,Jonas Bjorkman,6-3; 7-6(6); 4-6; 2-6; 6-3,R16,222,8,7,105,166,78,105,31,61,6,10,25,109,166,17,5,99,153,73,99,28,54,8,11,23,101,153
2006-06-26 00:00:00.000,Wimbledon England Grand Slams,GRASS,3,Lleyton Hewitt,David Ferrer,Lleyton Hewitt,6-4; 6-4; 4-6; 7-5,R16,170,11,5,71,123,57,71,25,52,8,12,21,82,123,5,4,81,127,56,81,21,46,6,12,21,77,127
2006-06-26 00:00:00.000,Wimbledon England Grand Slams,GRASS,3,Marcos Baghdatis,Andy Murray,Marcos Baghdatis,6-3; 6-4; 7-6(2),R16,113,7,1,60,92,47,60,21,32,3,4,16,68,92,8,7,48,91,36,48,20,43,2,5,15,56,91
2006-06-26 00:00:00.000,Wimbledon England Grand Slams,GRASS,3,Jarkko Nieminen,Dmitry Tursunov,Jarkko Nieminen,7-5; 6-4; 6-7(2); 6-7(6); 9-7,R16,241,9,5,122,198,91,122,46,76,8,10,31,137,198,21,3,109,186,85,109,42,77,5,10,31,127,186
2006-06-26 00:00:00.000,Wimbledon England Grand Slams,GRASS,3,Rafael Nadal,Irakli Labadze,Rafael Nadal,6-3; 7-6(4); 6-3,R16,132,7,0,54,85,43,54,26,31,0,0,16,69,85,8,7,60,102,42,60,23,42,4,6,14,65,102
2006-06-26 00:00:00.000,Wimbledon England Grand Slams,GRASS,3,Roger Federer,Mario Ancic,Roger Federer,6-4; 6-4; 6-4,Q,107,7,1,50,87,39,50,24,37,2,3,15,63,87,7,1,46,80,33,46,18,34,3,7,15,51,80
2006-06-26 00:00:00.000,Wimbledon England Grand Slams,GRASS,3,Jonas Bjorkman,Radek Stepanek,Jonas Bjorkman,7-6(3); 4-6; 6-7(5); 7-6(7); 6-4,Q,243,9,6,103,176,77,103,40,73,9,15,28,117,176,20,12,112,179,86,112,30,67,4,10,28,116,179
2006-06-26 00:00:00.000,Wimbledon England Grand Slams,GRASS,3,Marcos Baghdatis,Lleyton Hewitt,Marcos Baghdatis,6-1; 5-7; 7-6(5); 6-2,Q,152,20,1,75,129,55,75,25,54,6,10,20,80,129,6,2,63,105,44,63,19,42,0,7,19,63,105
2006-06-26 00:00:00.000,Wimbledon England Grand Slams,GRASS,3,Rafael Nadal,Jarkko Nieminen,Rafael Nadal,6-3; 6-4; 6-4,Q,135,6,2,74,103,56,74,15,29,2,2,15,71,103,5,2,43,85,34,43,19,42,6,9,14,53,85
2006-06-26 00:00:00.000,Wimbledon England Grand Slams,GRASS,3,Roger Federer,Jonas Bjorkman,Roger Federer,6-2; 6-0; 6-2,S,77,9,0,43,59,36,43,10,16,0,0,11,46,59,3,2,39,64,20,39,10,25,2,9,11,30,64
2006-06-26 00:00:00.000,Wimbledon England Grand Slams,GRASS,3,Rafael Nadal,Marcos Baghdatis,Rafael Nadal,6-1; 7-5; 6-3,S,147,4,0,75,103,52,75,16,28,9,9,14,68,103,3,2,49,89,32,49,19,40,6,11,14,51,89
2006-06-26 00:00:00.000,Wimbledon England Grand Slams,GRASS,3,Roger Federer,Rafael Nadal,Roger Federer,6-0; 7-6(5); 6-7(2); 6-3,F,178,13,1,83,119,64,83,20,36,1,3,20,84,119,9,3,94,127,64,94,14,33,4,10,19,78,127
2006-07-10 00:00:00.000,Bastad Sweden ATP World Tour,CLAY,2,Nikolay Davydenko,Alberto Martin,Nikolay Davydenko,6-4; 6-1,R32,70,1,0,32,41,25,32,8,9,0,1,9,33,41,0,2,37,61,20,37,10,24,3,7,8,30,61
2006-07-10 00:00:00.000,Bastad Sweden ATP World Tour,CLAY,2,Yuri Schukin,Ivo Minar,Yuri Schukin,2-6; 6-2; 6-3,R32,89,0,3,44,67,32,44,9,23,2,6,13,41,67,8,2,54,81,33,54,11,27,9,14,12,44,81
2006-07-10 00:00:00.000,Bastad Sweden ATP World Tour,CLAY,2,Nicolas Massu,Mariano Zabaleta,Nicolas Massu,6-4; 3-1 RET,R32,80,2,2,35,49,25,35,9,14,3,3,7,34,49,0,5,26,43,17,26,8,17,2,4,7,25,43
2006-07-10 00:00:00.000,Bastad Sweden ATP World Tour,CLAY,2,Jose Acasuso,Guillermo Coria,Jose Acasuso,2-6; 6-2; 7-5,R32,116,3,2,44,90,29,44,24,46,5,8,14,53,90,1,6,49,77,36,49,11,28,3,7,14,47,77
2006-07-10 00:00:00.000,Bastad Sweden ATP World Tour,CLAY,2,Nicolas Almagro,Tomas Berdych,Nicolas Almagro,6-2; 7-6(7),R32,87,8,3,55,81,36,55,12,26,5,8,10,48,81,1,2,34,66,21,34,15,32,3,8,10,36,66
2006-07-10 00:00:00.000,Bastad Sweden ATP World Tour,CLAY,2,Agustin Calleri,Peter Luczak,Agustin Calleri,3-6; 6-1; 6-2,R32,93,9,5,23,60,21,23,25,37,1,2,12,46,60,6,3,52,90,33,52,16,38,7,11,12,49,90
2006-07-10 00:00:00.000,Bastad Sweden ATP World Tour,CLAY,2,Robin Soderling,Boris Pashanski,Robin Soderling,6-2; 6-3,R32,59,2,2,23,42,20,23,13,19,1,1,8,33,42,1,6,33,57,23,33,7,24,5,9,9,30,57
2006-07-10 00:00:00.000,Bastad Sweden ATP World Tour,CLAY,2,David Ferrer,Mohammad Ghareeb,David Ferrer,6-4; 6-4,R32,76,2,3,29,56,25,29,12,27,2,4,10,37,56,4,4,39,61,24,39,8,22,1,5,10,32,61
2006-07-10 00:00:00.000,Bastad Sweden ATP World Tour,CLAY,2,Juan Carlos Ferrero,Ervin Eleskovic,Juan Carlos Ferrero,6-3; 3-6; 6-3,R32,105,2,1,60,76,39,60,11,16,3,6,14,50,76,4,9,40,84,26,40,20,44,6,10,13,46,84
2006-07-10 00:00:00.000,Bastad Sweden ATP World Tour,CLAY,2,Oliver Marach,Filip Prpic,Oliver Marach,6-3; 6-7(2); 6-2,R32,135,4,4,42,84,33,42,19,42,3,6,14,52,84,4,6,46,93,31,46,19,47,5,12,15,50,93
2006-07-10 00:00:00.000,Bastad Sweden ATP World Tour,CLAY,2,Lukas Dlouhy,Andreas Vinciguerra,Lukas Dlouhy,6-3; 6-2,R32,59,9,2,37,52,32,37,7,15,4,4,9,39,52,2,2,43,63,24,43,9,20,4,7,8,33,63
2006-07-10 00:00:00.000,Bastad Sweden ATP World Tour,CLAY,2,Jarkko Nieminen,Juan Ignacio Chela,Jarkko Nieminen,6-4; 5-7; 6-1,R32,127,5,1,52,89,36,52,12,37,6,11,14,48,89,1,1,54,97,30,54,18,43,9,17,15,48,97
2006-07-10 00:00:00.000,Bastad Sweden ATP World Tour,CLAY,2,Luis Horna,Thomas Johansson,Luis Horna,6-4; 6-2,R32,95,10,1,33,53,26,33,14,20,1,1,9,40,53,4,2,35,61,21,35,15,26,1,4,9,36,61
2006-07-10 00:00:00.000,Bastad Sweden ATP World Tour,CLAY,2,Evgeny Korolev,Florent Serra,Evgeny Korolev,6-3; 3-6; 6-4,R32,111,9,6,65,93,44,65,12,28,4,8,14,56,93,2,3,50,87,29,50,19,37,3,8,14,48,87
2006-07-10 00:00:00.000,Bastad Sweden ATP World Tour,CLAY,2,Alexander Waske,Jonas Bjorkman,Alexander Waske,6-4; 4-6; 6-3,R32,159,5,6,60,110,40,60,21,50,8,12,14,61,110,4,4,48,88,33,48,15,40,9,15,15,48,88
2006-07-10 00:00:00.000,Bastad Sweden ATP World Tour,CLAY,2,Tommy Robredo,Gilles Simon,Tommy Robredo,4-6; 6-1; 6-4,R32,132,1,0,61,76,36,61,8,15,4,9,13,44,76,1,3,66,115,38,66,16,49,15,23,14,54,115
2006-07-10 00:00:00.000,Bastad Sweden ATP World Tour,CLAY,2,Nikolay Davydenko,Yuri Schukin,Nikolay Davydenko,6-0; 3-6; 6-1,R16,104,6,2,49,68,38,49,9,19,7,8,11,47,68,1,0,46,77,29,46,11,31,3,8,11,40,77
2006-07-10 00:00:00.000,Bastad Sweden ATP World Tour,CLAY,2,Nicolas Massu,Jose Acasuso,Nicolas Massu,6-4; 6-2,R16,87,4,0,35,53,28,35,12,18,1,1,9,40,53,3,1,38,63,21,38,14,25,4,7,9,35,63
2006-07-10 00:00:00.000,Bastad Sweden ATP World Tour,CLAY,2,Agustin Calleri,Nicolas Almagro,Agustin Calleri,6-3; 6-4,R16,71,5,2,36,60,28,36,12,24,2,3,10,40,60,1,4,39,59,26,39,8,20,5,8,9,34,59
2006-07-10 00:00:00.000,Bastad Sweden ATP World Tour,CLAY,2,Robin Soderling,David Ferrer,Robin Soderling,6-3; 6-1,R16,70,3,0,27,44,24,27,10,17,1,1,8,34,44,0,7,32,59,17,32,12,27,2,6,8,29,59
2006-07-10 00:00:00.000,Bastad Sweden ATP World Tour,CLAY,2,Juan Carlos Ferrero,Oliver Marach,Juan Carlos Ferrero,6-2; 6-3,R16,95,2,2,30,47,21,30,10,17,0,2,9,31,47,3,1,40,79,23,40,14,39,12,17,8,37,79
2006-07-10 00:00:00.000,Bastad Sweden ATP World Tour,CLAY,2,Jarkko Nieminen,Lukas Dlouhy,Jarkko Nieminen,6-7(2); 6-0; 6-3,R16,93,2,1,55,82,36,55,18,27,2,4,14,54,82,6,6,55,92,37,55,11,37,5,11,13,48,92
2006-07-10 00:00:00.000,Bastad Sweden ATP World Tour,CLAY,2,Evgeny Korolev,Luis Horna,Evgeny Korolev,6-2; 6-3,R16,176,5,3,29,54,23,29,16,25,1,1,9,39,54,1,1,32,55,16,32,14,23,0,3,8,30,55
2006-07-10 00:00:00.000,Bastad Sweden ATP World Tour,CLAY,2,Tommy Robredo,Alexander Waske,Tommy Robredo,6-3; 6-1,R16,72,0,0,35,47,29,35,7,12,0,0,8,36,47,1,5,41,70,23,41,12,29,4,8,8,35,70
2006-07-10 00:00:00.000,Bastad Sweden ATP World Tour,CLAY,2,Nikolay Davydenko,Nicolas Massu,Nikolay Davydenko,6-4; 6-3,Q,84,1,1,32,48,23,32,11,16,0,1,9,34,48,2,4,29,58,19,29,13,29,4,8,10,32,58
2006-07-10 00:00:00.000,Bastad Sweden ATP World Tour,CLAY,2,Agustin Calleri,Robin Soderling,Agustin Calleri,6-4; 6-4,Q,80,6,2,31,58,22,31,18,27,0,1,10,40,58,3,4,46,69,30,46,10,23,5,8,10,40,69
2006-07-10 00:00:00.000,Bastad Sweden ATP World Tour,CLAY,2,Jarkko Nieminen,Juan Carlos Ferrero,Jarkko Nieminen,7-6(5); 6-2,Q,75,4,1,35,60,30,35,16,25,3,3,10,46,60,3,1,42,57,32,42,7,15,0,2,10,39,57
2006-07-10 00:00:00.000,Bastad Sweden ATP World Tour,CLAY,2,Tommy Robredo,Evgeny Korolev,Tommy Robredo,4-6; 6-3; 6-1,Q,111,2,2,54,66,41,54,5,12,3,5,13,46,66,1,5,56,98,32,56,19,42,9,14,13,51,98
2006-07-10 00:00:00.000,Bastad Sweden ATP World Tour,CLAY,2,Nikolay Davydenko,Agustin Calleri,Nikolay Davydenko,6-3; 6-3,S,77,0,1,37,54,25,37,12,17,4,5,9,37,54,2,2,35,61,22,35,10,26,4,8,9,32,61
2006-07-10 00:00:00.000,Bastad Sweden ATP World Tour,CLAY,2,Tommy Robredo,Jarkko Nieminen,Tommy Robredo,3-6; 6-2; 6-4,S,111,0,1,65,78,39,65,9,13,4,8,14,48,78,0,2,59,84,37,59,7,25,5,10,13,44,84
2006-07-10 00:00:00.000,Bastad Sweden ATP World Tour,CLAY,2,Tommy Robredo,Nikolay Davydenko,Tommy Robredo,6-2; 6-1,F,75,0,0,28,44,20,28,10,16,0,0,7,30,44,0,2,45,61,21,45,7,16,9,14,8,28,61
2006-07-10 00:00:00.000,Gstaad Switzerland ATP World Tour,CLAY,2,Ivan Ljubicic,Albert Portas,Ivan Ljubicic,6-3; 7-6(5),R32,100,10,3,39,70,33,39,19,31,1,1,11,52,70,3,6,33,67,26,33,18,34,2,3,10,44,67
2006-07-10 00:00:00.000,Gstaad Switzerland ATP World Tour,CLAY,2,Marco Chiudinelli,Davide Sanguinetti,Marco Chiudinelli,6-3; 6-2,R32,75,4,2,41,67,26,41,15,26,7,9,9,41,67,3,1,23,43,13,23,7,20,0,5,8,20,43
2006-07-10 00:00:00.000,Gstaad Switzerland ATP World Tour,CLAY,2,Ruben Ramirez Hidalgo,Robin Roshardt,Ruben Ramirez Hidalgo,6-1; 6-4,R32,66,3,4,29,46,25,29,7,17,3,4,8,32,46,3,2,40,58,23,40,5,18,4,9,9,28,58
2006-07-10 00:00:00.000,Gstaad Switzerland ATP World Tour,CLAY,2,Feliciano Lopez,Filippo Volandri,Feliciano Lopez,6-4; 6-4,R32,63,12,0,26,54,26,26,16,28,4,4,10,42,54,1,5,41,59,31,41,6,18,1,3,10,37,59
2006-07-10 00:00:00.000,Gstaad Switzerland ATP World Tour,CLAY,2,Dusan Vemic,Paul-Henri Mathieu,Dusan Vemic,3-6; 7-5; 7-6(6),R32,139,12,5,66,106,48,66,23,40,8,10,16,71,106,5,1,57,98,46,57,25,41,6,8,17,71,98
2006-07-10 00:00:00.000,Gstaad Switzerland ATP World Tour,CLAY,2,Marin Cilic,Andreas Seppi,Marin Cilic,6-3; 7-6(6),R32,95,4,3,33,70,24,33,21,37,1,3,11,45,70,6,8,43,87,24,43,24,44,7,10,10,48,87
2006-07-10 00:00:00.000,Gstaad Switzerland ATP World Tour,CLAY,2,Andrei Pavel,Stanislas Wawrinka,Andrei Pavel,6-4; 1-6; 7-6(4),R32,138,3,1,66,107,43,66,25,41,3,5,14,68,107,13,6,56,95,48,56,17,39,3,4,15,65,95
2006-07-10 00:00:00.000,Gstaad Switzerland ATP World Tour,CLAY,2,Max Mirnyi,Carlos Berlocq,Max Mirnyi,6-3; 7-5,R32,80,5,0,31,51,28,31,16,20,0,0,11,44,51,2,6,35,59,25,35,14,24,6,8,10,39,59
2006-07-10 00:00:00.000,Gstaad Switzerland ATP World Tour,CLAY,2,Jiri Novak,Carlos Moya,Jiri Novak,6-3; 6-2,R32,56,4,0,28,47,24,28,14,19,1,1,9,38,47,3,3,28,49,17,28,11,21,2,5,8,28,49
2006-07-10 00:00:00.000,Gstaad Switzerland ATP World Tour,CLAY,2,Philipp Kohlschreiber,Alessio Di Mauro,Philipp Kohlschreiber,6-3; 6-1,R32,58,9,2,22,44,21,22,7,22,0,2,8,28,44,1,4,34,51,16,34,4,17,3,9,8,20,51
2006-07-10 00:00:00.000,Gstaad Switzerland ATP World Tour,CLAY,2,Daniele Bracciali,Flavio Saretta,Daniele Bracciali,5-7; 6-1; 6-4,R32,124,10,1,43,100,34,43,30,57,6,8,14,64,100,4,2,44,92,32,44,22,48,5,10,15,54,92
2006-07-10 00:00:00.000,Gstaad Switzerland ATP World Tour,CLAY,2,Fernando Verdasco,Dick Norman,Fernando Verdasco,6-4; 6-3,R32,60,3,4,37,52,27,37,9,15,1,2,9,36,52,3,5,32,58,18,32,13,26,3,7,10,31,58
2006-07-10 00:00:00.000,Gstaad Switzerland ATP World Tour,CLAY,2,Richard Gasquet,Simon Greul,Richard Gasquet,6-3; 6-3,R32,70,5,4,36,59,27,36,14,23,2,2,9,41,59,3,4,30,50,20,30,8,20,1,4,9,28,50
2006-07-10 00:00:00.000,Gstaad Switzerland ATP World Tour,CLAY,2,Robin Vik,Roman Vogeli,Robin Vik,6-2; 6-1,R32,60,2,1,26,40,22,26,8,14,2,2,7,30,40,4,5,27,55,15,27,10,28,4,9,8,25,55
2006-07-10 00:00:00.000,Gstaad Switzerland ATP World Tour,CLAY,2,Christophe Rochus,Fernando Vicente,Christophe Rochus,6-1; 4-6; 6-2,R32,107,1,3,60,87,39,60,12,27,10,13,13,51,87,4,4,36,78,24,36,16,42,6,12,12,40,78
2006-07-10 00:00:00.000,Gstaad Switzerland ATP World Tour,CLAY,2,Gaston Gaudio,Marcos Daniel,Gaston Gaudio,7-6(4); 6-2,R32,103,2,4,35,62,27,35,15,27,1,3,10,42,62,6,3,37,74,23,37,17,37,7,11,10,40,74
2006-07-10 00:00:00.000,Gstaad Switzerland ATP World Tour,CLAY,2,Ivan Ljubicic,Marco Chiudinelli,Ivan Ljubicic,6-7(6); 6-3; 6-2,R16,133,13,5,40,77,39,40,22,37,0,0,14,61,77,7,5,56,110,40,56,27,54,5,9,15,67,110
2006-07-10 00:00:00.000,Gstaad Switzerland ATP World Tour,CLAY,2,Feliciano Lopez,Ruben Ramirez Hidalgo,Feliciano Lopez,6-7(5); 6-3; 7-6(3),R16,133,16,2,62,94,56,62,20,32,0,0,17,76,94,6,0,63,102,49,63,23,39,5,6,16,72,102
2006-07-10 00:00:00.000,Gstaad Switzerland ATP World Tour,CLAY,2,Marin Cilic,Dusan Vemic,Marin Cilic,2-6; 6-3; 6-4,R16,109,3,5,37,80,26,37,24,43,2,5,14,50,80,7,1,60,85,35,60,16,25,4,7,13,51,85
2006-07-10 00:00:00.000,Gstaad Switzerland ATP World Tour,CLAY,2,Andrei Pavel,Max Mirnyi,Andrei Pavel,6-2; 6-4,R16,141,4,1,35,47,29,35,9,12,2,2,9,38,47,6,5,33,58,22,33,11,25,3,6,9,33,58
2006-07-10 00:00:00.000,Gstaad Switzerland ATP World Tour,CLAY,2,Philipp Kohlschreiber,Jiri Novak,Philipp Kohlschreiber,3-6; 6-7(5); 6-1,R16,111,8,0,48,90,35,48,23,42,5,7,13,58,90,4,0,54,90,36,54,21,36,4,8,15,57,90
2006-07-10 00:00:00.000,Gstaad Switzerland ATP World Tour,CLAY,2,Fernando Verdasco,Daniele Bracciali,Fernando Verdasco,6-3; 6-1,R16,52,4,3,36,46,30,36,5,10,3,3,8,35,46,0,6,31,48,17,31,8,17,2,6,8,25,48
2006-07-10 00:00:00.000,Gstaad Switzerland ATP World Tour,CLAY,2,Richard Gasquet,Robin Vik,Richard Gasquet,6-1; 6-1,R16,53,5,1,23,39,19,23,9,16,1,2,7,28,39,0,8,20,41,10,20,2,21,1,7,7,12,41
2006-07-10 00:00:00.000,Gstaad Switzerland ATP World Tour,CLAY,2,Gaston Gaudio,Christophe Rochus,Gaston Gaudio,6-0; 6-4,R16,68,1,4,23,41,19,23,11,18,0,1,8,30,41,1,0,33,58,17,33,10,25,5,10,8,27,58
2006-07-10 00:00:00.000,Gstaad Switzerland ATP World Tour,CLAY,2,Feliciano Lopez,Ivan Ljubicic,Feliciano Lopez,7-6(4); 6-3,Q,82,10,1,36,70,29,36,22,34,4,4,11,51,70,10,3,37,65,29,37,14,28,1,2,10,43,65
2006-07-10 00:00:00.000,Gstaad Switzerland ATP World Tour,CLAY,2,Marin Cilic,Andrei Pavel,Marin Cilic,6-7(5); 6-3; 7-5,Q,145,11,3,71,120,55,71,24,49,6,6,16,79,120,4,4,61,106,45,61,25,45,5,8,17,70,106
2006-07-10 00:00:00.000,Gstaad Switzerland ATP World Tour,CLAY,2,Philipp Kohlschreiber,Fernando Verdasco,Philipp Kohlschreiber,6-3; 4-6; 6-4,Q,133,4,4,51,99,35,51,26,48,7,10,15,61,99,1,3,74,101,46,74,12,27,9,13,14,58,101
2006-07-10 00:00:00.000,Gstaad Switzerland ATP World Tour,CLAY,2,Richard Gasquet,Gaston Gaudio,Richard Gasquet,6-3; 6-2,Q,82,8,6,42,69,31,42,14,27,8,8,9,45,69,4,4,32,55,23,32,9,23,2,5,8,32,55
2006-07-10 00:00:00.000,Gstaad Switzerland ATP World Tour,CLAY,2,Feliciano Lopez,Marin Cilic,Feliciano Lopez,7-6(2); 6-7(5); 6-3,S,157,27,6,77,116,59,77,18,39,4,6,17,77,116,9,6,64,116,46,64,25,52,9,12,16,71,116
2006-07-10 00:00:00.000,Gstaad Switzerland ATP World Tour,CLAY,2,Richard Gasquet,Philipp Kohlschreiber,Richard Gasquet,6-1; 1-6; 6-2,S,92,7,3,38,61,30,38,11,23,1,3,11,41,61,4,5,32,71,23,32,17,39,5,9,11,40,71
2006-07-10 00:00:00.000,Gstaad Switzerland ATP World Tour,CLAY,2,Richard Gasquet,Feliciano Lopez,Richard Gasquet,7-6(4); 6-7(3); 6-3; 6-3,F,185,9,2,82,120,67,82,27,38,2,2,21,94,120,24,6,89,141,68,89,29,52,6,9,21,97,141
2006-07-10 00:00:00.000,Newport RI; U.S.A. ATP World Tour,GRASS,2,Andy Murray,Ricardo Mello,Andy Murray,6-1; 1-6; 7-6(5),R32,122,2,1,44,82,25,44,21,38,4,9,13,46,82,1,4,63,97,36,63,17,34,7,12,13,53,97
2006-07-10 00:00:00.000,Newport RI; U.S.A. ATP World Tour,GRASS,2,Sam Querrey,Danai Udomchoke,Sam Querrey,6-4; 6-3,R32,61,11,1,42,62,33,42,9,20,3,4,10,42,62,0,7,32,58,21,32,10,26,1,4,9,31,58
2006-07-10 00:00:00.000,Newport RI; U.S.A. ATP World Tour,GRASS,2,Igor Kunitsyn,Bobby Reynolds,Igor Kunitsyn,7-5; 6-2,R32,79,3,2,31,60,24,31,17,29,1,2,10,41,60,5,5,37,71,23,37,16,34,6,10,10,39,71
2006-07-10 00:00:00.000,Newport RI; U.S.A. ATP World Tour,GRASS,2,Robert Kendrick,Vincent Spadea,Robert Kendrick,6-4; 3-6; 6-3,R32,94,7,7,56,80,45,56,10,24,3,4,14,55,80,2,7,50,83,37,50,16,33,3,5,14,53,83
2006-07-10 00:00:00.000,Newport RI; U.S.A. ATP World Tour,GRASS,2,Paul Capdeville,Gilles Muller,Paul Capdeville,7-6(7); 6-2,R32,90,11,3,35,71,30,35,20,36,3,4,10,50,71,5,10,39,76,29,39,16,37,5,8,10,45,76
2006-07-10 00:00:00.000,Newport RI; U.S.A. ATP World Tour,GRASS,2,Kristian Pless,Michael Russell,Kristian Pless,7-6(2) RET,R32,50,5,3,28,47,20,28,8,19,4,7,6,28,47,1,4,28,43,16,28,4,15,2,5,6,20,43
2006-07-10 00:00:00.000,Newport RI; U.S.A. ATP World Tour,GRASS,2,Wayne Arthurs,Kenneth Carlsen,Wayne Arthurs,7-6(5); 7-6(6),R32,100,14,8,48,79,41,48,19,31,0,0,12,60,79,4,7,45,83,37,45,22,38,3,3,12,59,83
2006-07-10 00:00:00.000,Newport RI; U.S.A. ATP World Tour,GRASS,2,Justin Gimelstob,Wesley Whitehouse,Justin Gimelstob,4-6; 6-3; 6-4,R32,122,4,6,50,95,40,50,22,45,3,5,15,62,95,5,6,45,91,31,45,25,46,5,8,14,56,91
2006-07-10 00:00:00.000,Newport RI; U.S.A. ATP World Tour,GRASS,2,Mardy Fish,Cyril Saulnier,Mardy Fish,6-3; 6-1,R32,57,11,3,30,50,25,30,10,20,5,5,8,35,50,0,2,35,52,21,35,5,17,5,9,8,26,52
2006-07-10 00:00:00.000,Newport RI; U.S.A. ATP World Tour,GRASS,2,Thiago Alves,Tomas Behrend,Thiago Alves,6-4; 6-4,R32,69,1,3,36,58,26,36,8,22,6,9,10,34,58,6,9,36,65,21,36,12,29,4,9,10,33,65
2006-07-10 00:00:00.000,Newport RI; U.S.A. ATP World Tour,GRASS,2,Rik De Voest,Lukasz Kubot,Rik De Voest,6-2; 6-2,R32,77,1,0,32,58,19,32,16,26,6,7,8,35,58,2,5,34,60,20,34,9,26,4,9,8,29,60
2006-07-10 00:00:00.000,Newport RI; U.S.A. ATP World Tour,GRASS,2,Mark Philippoussis,Paul Goldstein,Mark Philippoussis,6-4; 6-2,R32,69,14,6,28,49,26,28,12,21,0,0,9,38,49,0,4,40,65,25,40,10,25,5,8,9,35,65
2006-07-10 00:00:00.000,Newport RI; U.S.A. ATP World Tour,GRASS,2,Jurgen Melzer,Razvan Sabau,Jurgen Melzer,7-5; 7-5,R32,92,15,8,34,63,27,34,16,29,0,2,12,43,63,2,7,60,109,36,60,23,49,13,17,12,59,109
2006-07-10 00:00:00.000,Newport RI; U.S.A. ATP World Tour,GRASS,2,Frank Dancevic,Kevin Kim,Frank Dancevic,6-4; 6-3,R32,57,5,0,32,58,27,32,16,26,1,1,10,43,58,0,5,33,63,21,33,16,30,5,7,9,37,63
2006-07-10 00:00:00.000,Newport RI; U.S.A. ATP World Tour,GRASS,2,Alex Bogdanovic,Jesse Levine,Alex Bogdanovic,6-4; 7-5,R32,82,3,2,49,77,33,49,15,28,7,9,11,48,77,4,2,39,65,27,39,12,26,4,8,11,39,65
2006-07-10 00:00:00.000,Newport RI; U.S.A. ATP World Tour,GRASS,2,George Bastl,Ivo Karlovic,George Bastl,6-7(2); 6-4; 4-2 RET,R32,114,4,7,39,79,33,39,24,40,3,4,14,57,79,17,11,56,88,42,56,14,32,5,8,14,56,88
2006-07-10 00:00:00.000,Newport RI; U.S.A. ATP World Tour,GRASS,2,Andy Murray,Sam Querrey,Andy Murray,7-5; 6-2,R16,71,3,4,37,65,24,37,15,28,5,7,10,39,65,8,4,37,63,23,37,6,26,9,14,10,29,63
2006-07-10 00:00:00.000,Newport RI; U.S.A. ATP World Tour,GRASS,2,Robert Kendrick,Igor Kunitsyn,Robert Kendrick,6-4; 6-2,R16,75,7,7,34,66,24,34,17,32,9,10,9,41,66,1,4,36,59,20,36,11,23,3,7,9,31,59
2006-07-10 00:00:00.000,Newport RI; U.S.A. ATP World Tour,GRASS,2,Kristian Pless,Paul Capdeville,Kristian Pless,6-4; 4-6; 6-4,R16,100,7,2,54,95,40,54,18,41,5,8,15,58,95,4,3,47,79,37,47,10,32,0,4,15,47,79
2006-07-10 00:00:00.000,Newport RI; U.S.A. ATP World Tour,GRASS,2,Justin Gimelstob,Wayne Arthurs,Justin Gimelstob,6-3; 7-6(1),R16,91,8,7,37,77,33,37,18,40,6,7,11,51,77,9,2,27,53,22,27,14,26,2,4,10,36,53
2006-07-10 00:00:00.000,Newport RI; U.S.A. ATP World Tour,GRASS,2,Mardy Fish,Thiago Alves,Mardy Fish,6-2; 6-3,R16,66,13,6,23,55,20,23,16,32,0,1,9,36,55,1,3,34,48,17,34,8,14,2,6,8,25,48
2006-07-10 00:00:00.000,Newport RI; U.S.A. ATP World Tour,GRASS,2,Mark Philippoussis,Rik De Voest,Mark Philippoussis,6-3; 6-4,R16,71,8,3,26,53,23,26,19,27,3,3,10,42,53,1,2,31,56,23,31,11,25,1,3,9,34,56
2006-07-10 00:00:00.000,Newport RI; U.S.A. ATP World Tour,GRASS,2,Jurgen Melzer,Frank Dancevic,Jurgen Melzer,6-4; 3-6; 6-4,R16,104,10,4,40,84,27,40,25,44,5,8,14,52,84,6,2,58,86,40,58,13,28,5,9,15,53,86
2006-07-10 00:00:00.000,Newport RI; U.S.A. ATP World Tour,GRASS,2,Alex Bogdanovic,George Bastl,Alex Bogdanovic,6-1; 7-6(6),R16,81,2,1,36,57,29,36,14,21,3,3,9,43,57,9,7,35,67,28,35,12,32,3,6,10,40,67
2006-07-10 00:00:00.000,Newport RI; U.S.A. ATP World Tour,GRASS,2,Andy Murray,Robert Kendrick,Andy Murray,6-0; 6-0,Q,60,4,1,29,39,23,29,4,10,3,3,6,27,39,4,7,37,68,20,37,8,31,12,18,6,28,68
2006-07-10 00:00:00.000,Newport RI; U.S.A. ATP World Tour,GRASS,2,Justin Gimelstob,Kristian Pless,Justin Gimelstob,6-3; 6-1,Q,53,4,2,26,52,20,26,16,26,2,2,8,36,52,0,1,25,42,14,25,8,17,0,4,8,22,42
2006-07-10 00:00:00.000,Newport RI; U.S.A. ATP World Tour,GRASS,2,Mark Philippoussis,Mardy Fish,Mark Philippoussis,7-6(7); 6-3,Q,96,11,4,47,76,39,47,15,29,2,2,11,54,76,14,1,37,68,32,37,15,31,5,6,10,47,68
2006-07-10 00:00:00.000,Newport RI; U.S.A. ATP World Tour,GRASS,2,Jurgen Melzer,Alex Bogdanovic,Jurgen Melzer,3-6; 6-2; 6-1,Q,79,8,5,39,71,29,39,19,32,4,5,12,48,71,1,3,47,67,32,47,9,20,4,8,12,41,67
2006-07-10 00:00:00.000,Newport RI; U.S.A. ATP World Tour,GRASS,2,Justin Gimelstob,Andy Murray,Justin Gimelstob,6-1; 7-6(4),S,90,6,2,33,60,27,33,16,27,0,0,9,43,60,2,2,38,70,24,38,16,32,1,4,10,40,70
2006-07-10 00:00:00.000,Newport RI; U.S.A. ATP World Tour,GRASS,2,Mark Philippoussis,Jurgen Melzer,Mark Philippoussis,6-7(2); 6-2; 6-0,S,108,16,6,47,77,41,47,16,30,0,0,13,57,77,9,5,55,90,33,55,20,35,5,10,13,53,90
2006-07-10 00:00:00.000,Newport RI; U.S.A. ATP World Tour,GRASS,2,Mark Philippoussis,Justin Gimelstob,Mark Philippoussis,6-3; 7-5,F,102,15,6,39,65,34,39,13,26,3,3,11,47,65,8,3,49,83,31,49,16,34,9,11,10,47,83
2006-07-17 00:00:00.000,Amersfoort The Netherlands ATP World Tour,CLAY,2,Guillermo Coria,Robin Haase,Guillermo Coria,6-3; 4-6; 6-4,R32,137,1,14,59,99,48,59,12,40,7,12,15,60,99,1,1,64,111,41,64,19,47,10,16,14,60,111
2006-07-17 00:00:00.000,Amersfoort The Netherlands ATP World Tour,CLAY,2,Sergio Roitman,Marin Cilic,Sergio Roitman,6-3; 6-1,R32,68,4,0,34,45,26,34,6,11,5,6,8,32,45,1,0,35,55,17,35,8,20,2,7,8,25,55
2006-07-17 00:00:00.000,Amersfoort The Netherlands ATP World Tour,CLAY,2,Agustin Calleri,Denis Gremelmayr,Agustin Calleri,6-2; 7-6(5),R32,93,4,4,42,80,30,42,23,38,7,8,10,53,80,0,3,34,67,25,34,14,33,1,4,10,39,67
2006-07-17 00:00:00.000,Amersfoort The Netherlands ATP World Tour,CLAY,2,Daniele Bracciali,Igor Sijsling,Daniele Bracciali,6-7(5); 6-4; 6-2,R32,138,20,4,65,107,50,65,21,42,10,11,15,71,107,8,6,53,106,37,53,25,53,6,10,15,62,106
2006-07-17 00:00:00.000,Amersfoort The Netherlands ATP World Tour,CLAY,2,Novak Djokovic,Boris Pashanski,Novak Djokovic,6-0; 6-3,R32,82,3,2,33,55,21,33,14,22,0,1,8,35,55,0,3,31,60,12,31,15,29,5,10,7,27,60
2006-07-17 00:00:00.000,Amersfoort The Netherlands ATP World Tour,CLAY,2,Tomas Zib,Steve Darcis,Tomas Zib,7-5; 6-3,R32,91,3,1,33,53,25,33,15,20,0,0,10,40,53,2,3,43,80,26,43,22,37,9,12,11,48,80
2006-07-17 00:00:00.000,Amersfoort The Netherlands ATP World Tour,CLAY,2,Marc Gicquel,Fernando Vicente,Marc Gicquel,6-2; 6-4,R32,70,2,2,29,54,22,29,16,25,1,1,9,38,54,5,0,32,44,19,32,7,12,0,3,9,26,44
2006-07-17 00:00:00.000,Amersfoort The Netherlands ATP World Tour,CLAY,2,Thiemo de Bakker,Julien Benneteau,Thiemo de Bakker,6-3; 6-3,R32,84,3,4,28,67,22,28,21,39,5,6,0,43,67,2,2,36,53,19,36,9,17,4,8,0,28,53
2006-07-17 00:00:00.000,Amersfoort The Netherlands ATP World Tour,CLAY,2,Carlos Moya,Guillermo Garcia-Lopez,Carlos Moya,6-4; 7-6(6),R32,114,7,0,45,78,37,45,20,33,1,1,11,57,78,0,1,46,76,33,46,18,30,1,2,11,51,76
2006-07-17 00:00:00.000,Amersfoort The Netherlands ATP World Tour,CLAY,2,Fabio Fognini,Juan-Pablo Guzman,Fabio Fognini,6-3; 1-6; 7-5,R32,126,3,5,58,106,37,58,24,48,4,7,14,61,106,5,1,45,80,31,45,21,35,1,4,14,52,80
2006-07-17 00:00:00.000,Amersfoort The Netherlands ATP World Tour,CLAY,2,Juan Antonio Marin,Davide Sanguinetti,Juan Antonio Marin,6-2; 7-5,R32,107,3,1,31,65,22,31,23,34,0,0,10,45,65,2,0,37,63,28,37,9,26,3,6,10,37,63
2006-07-17 00:00:00.000,Amersfoort The Netherlands ATP World Tour,CLAY,2,Nicolas Massu,Andreas Vinciguerra,Nicolas Massu,7-6(3); 6-3,R32,106,6,7,32,68,24,32,18,36,1,4,11,42,68,1,3,37,58,21,37,8,21,0,4,10,29,58
2006-07-17 00:00:00.000,Amersfoort The Netherlands ATP World Tour,CLAY,2,Alberto Martin,Albert Montanes,Alberto Martin,6-2; 6-2,R32,69,8,3,24,47,19,24,14,23,2,3,8,33,47,0,0,42,63,19,42,10,21,7,12,8,29,63
2006-07-17 00:00:00.000,Amersfoort The Netherlands ATP World Tour,CLAY,2,Edgardo Massa,Ivo Minar,Edgardo Massa,6-4; 6-3,R32,71,1,2,33,56,26,33,14,23,1,2,10,40,56,3,8,38,69,24,38,15,31,5,8,9,39,69
2006-07-17 00:00:00.000,Amersfoort The Netherlands ATP World Tour,CLAY,2,Ruben Ramirez Hidalgo,Carlos Berlocq,Ruben Ramirez Hidalgo,6-7(4); 6-3; 6-3,R32,183,4,4,62,106,41,62,23,44,6,10,15,64,106,8,5,56,101,36,56,18,45,8,15,15,54,101
2006-07-17 00:00:00.000,Amersfoort The Netherlands ATP World Tour,CLAY,2,Paul-Henri Mathieu,Alessio Di Mauro,Paul-Henri Mathieu,6-0; 6-3,R32,76,0,2,32,53,23,32,12,21,1,2,8,35,53,1,1,25,40,12,25,3,15,0,5,7,15,40
2006-07-17 00:00:00.000,Amersfoort The Netherlands ATP World Tour,CLAY,2,Guillermo Coria,Sergio Roitman,Guillermo Coria,7-5; 4-6; 6-2,R16,140,2,15,73,115,51,73,17,42,10,14,15,68,115,5,0,59,86,36,59,12,27,6,12,15,48,86
2006-07-17 00:00:00.000,Amersfoort The Netherlands ATP World Tour,CLAY,2,Agustin Calleri,Daniele Bracciali,Agustin Calleri,2-6; 7-6(2); 6-0,R16,102,12,2,45,76,36,45,17,31,0,2,13,53,76,6,1,49,84,36,49,15,35,1,4,13,51,84
2006-07-17 00:00:00.000,Amersfoort The Netherlands ATP World Tour,CLAY,2,Novak Djokovic,Tomas Zib,Novak Djokovic,6-4; 6-2,R16,86,13,4,41,61,33,41,11,20,4,4,9,44,61,1,2,36,73,24,36,17,37,9,12,9,41,73
2006-07-17 00:00:00.000,Amersfoort The Netherlands ATP World Tour,CLAY,2,Marc Gicquel,Thiemo de Bakker,Marc Gicquel,4-6; 6-3; 6-2,R16,127,9,3,39,83,35,39,22,44,2,3,14,57,83,4,2,56,83,39,56,12,27,5,8,13,51,83
2006-07-17 00:00:00.000,Amersfoort The Netherlands ATP World Tour,CLAY,2,Carlos Moya,Fabio Fognini,Carlos Moya,7-5; 6-3,R16,96,9,3,31,59,23,31,12,28,0,4,11,35,59,1,4,40,82,23,40,15,42,6,12,10,38,82
2006-07-17 00:00:00.000,Amersfoort The Netherlands ATP World Tour,CLAY,2,Nicolas Massu,Juan Antonio Marin,Nicolas Massu,6-4; 7-6(2),R16,146,0,6,39,73,28,39,12,34,7,11,11,40,73,3,1,50,77,28,50,11,27,2,7,11,39,77
2006-07-17 00:00:00.000,Amersfoort The Netherlands ATP World Tour,CLAY,2,Alberto Martin,Edgardo Massa,Alberto Martin,6-2; 6-4,R16,86,0,3,34,58,24,34,14,24,3,4,9,38,58,2,4,45,80,26,45,16,35,8,12,9,42,80
2006-07-17 00:00:00.000,Amersfoort The Netherlands ATP World Tour,CLAY,2,Ruben Ramirez Hidalgo,Paul-Henri Mathieu,Ruben Ramirez Hidalgo,6-4; 6-2,R16,80,3,1,30,52,22,30,10,22,1,3,9,32,52,1,3,27,47,15,27,8,20,0,5,9,23,47
2006-07-17 00:00:00.000,Amersfoort The Netherlands ATP World Tour,CLAY,2,Guillermo Coria,Agustin Calleri,Guillermo Coria,6-3; 7-6(4),Q,95,1,5,47,79,35,47,17,32,1,2,11,52,79,5,2,28,56,22,28,15,28,1,3,10,37,56
2006-07-17 00:00:00.000,Amersfoort The Netherlands ATP World Tour,CLAY,2,Novak Djokovic,Marc Gicquel,Novak Djokovic,6-3; 6-4,Q,75,5,3,37,61,30,37,10,24,2,3,10,40,61,1,2,36,61,27,36,6,25,4,7,9,33,61
2006-07-17 00:00:00.000,Amersfoort The Netherlands ATP World Tour,CLAY,2,Nicolas Massu,Carlos Moya,Nicolas Massu,7-5; 6-4,Q,106,3,1,41,63,25,41,17,22,2,4,11,42,63,3,3,36,67,22,36,15,31,4,8,11,37,67
2006-07-17 00:00:00.000,Amersfoort The Netherlands ATP World Tour,CLAY,2,Ruben Ramirez Hidalgo,Alberto Martin,Ruben Ramirez Hidalgo,6-2; 6-2,Q,63,3,0,29,44,26,29,7,15,0,0,8,33,44,2,2,24,47,14,24,10,23,4,8,8,24,47
2006-07-17 00:00:00.000,Amersfoort The Netherlands ATP World Tour,CLAY,2,Novak Djokovic,Guillermo Coria,Novak Djokovic,6-2; 1-0 RET,S,38,2,0,17,26,12,17,7,9,1,2,5,19,26,0,5,9,21,4,9,3,12,0,3,4,7,21
2006-07-17 00:00:00.000,Amersfoort The Netherlands ATP World Tour,CLAY,2,Nicolas Massu,Ruben Ramirez Hidalgo,Nicolas Massu,6-1; 6-3,S,79,6,0,23,42,21,23,11,19,0,0,8,32,42,4,0,27,49,15,27,10,22,4,8,8,25,49
2006-07-17 00:00:00.000,Amersfoort The Netherlands ATP World Tour,CLAY,2,Novak Djokovic,Nicolas Massu,Novak Djokovic,7-6(5); 6-4,F,162,9,3,36,68,27,36,16,32,2,4,11,43,68,11,4,40,89,27,40,25,49,7,10,11,52,89
2006-07-17 00:00:00.000,Indianapolis IN; U.S.A. ATP World Tour,HARD,2,James Blake,N/A Bye,James Blake,,R64,0,0,0,0,0,0,0,0,0,0,0,0,0,0,0,0,0,0,0,0,0,0,0,0,0,0,0
2006-07-17 00:00:00.000,Indianapolis IN; U.S.A. ATP World Tour,HARD,2,Danai Udomchoke,Tomas Cakl,Danai Udomchoke,6-2; 6-2,R64,68,5,2,33,50,25,33,11,17,3,3,8,36,50,3,9,32,72,17,32,19,40,10,14,8,36,72
2006-07-17 00:00:00.000,Indianapolis IN; U.S.A. ATP World Tour,HARD,2,Wesley Whitehouse,Justin Gimelstob,Wesley Whitehouse,6-3; 7-5,R64,92,3,1,40,66,29,40,14,26,1,3,11,43,66,6,4,30,66,21,30,14,36,1,5,10,35,66
2006-07-17 00:00:00.000,Indianapolis IN; U.S.A. ATP World Tour,HARD,2,Marat Safin,N/A Bye,Marat Safin,,R64,0,0,0,0,0,0,0,0,0,0,0,0,0,0,0,0,0,0,0,0,0,0,0,0,0,0,0
2006-07-17 00:00:00.000,Indianapolis IN; U.S.A. ATP World Tour,HARD,2,Nicolas Mahut,N/A Bye,Nicolas Mahut,,R64,0,0,0,0,0,0,0,0,0,0,0,0,0,0,0,0,0,0,0,0,0,0,0,0,0,0,0
2006-07-17 00:00:00.000,Indianapolis IN; U.S.A. ATP World Tour,HARD,2,Thiago Alves,Bobby Reynolds,Thiago Alves,6-4; 6-4,R64,72,2,2,35,52,27,35,10,17,0,1,10,37,52,9,5,34,64,25,34,14,30,6,9,10,39,64
2006-07-17 00:00:00.000,Indianapolis IN; U.S.A. ATP World Tour,HARD,2,George Bastl,Nathan Healey,George Bastl,6-3; 6-0,R64,68,7,3,23,41,20,23,13,18,0,0,8,33,41,4,5,32,57,19,32,9,25,5,9,7,28,57
2006-07-17 00:00:00.000,Indianapolis IN; U.S.A. ATP World Tour,HARD,2,Tommy Haas,N/A Bye,Tommy Haas,,R64,0,0,0,0,0,0,0,0,0,0,0,0,0,0,0,0,0,0,0,0,0,0,0,0,0,0,0
2006-07-17 00:00:00.000,Indianapolis IN; U.S.A. ATP World Tour,HARD,2,Fernando Gonzalez,N/A Bye,Fernando Gonzalez,,R64,0,0,0,0,0,0,0,0,0,0,0,0,0,0,0,0,0,0,0,0,0,0,0,0,0,0,0
2006-07-17 00:00:00.000,Indianapolis IN; U.S.A. ATP World Tour,HARD,2,Sam Querrey,Janko Tipsarevic,Sam Querrey,6-4; 6-7(4); 6-4,R64,117,19,3,52,100,43,52,28,48,1,2,16,71,100,9,2,56,95,44,56,20,39,1,4,16,64,95
2006-07-17 00:00:00.000,Indianapolis IN; U.S.A. ATP World Tour,HARD,2,Ricardo Mello,Jean-Rene Lisnard,Ricardo Mello,7-5; 7-5,R64,104,2,3,46,80,32,46,12,34,4,8,12,44,80,1,3,28,72,16,28,21,44,2,8,12,37,72
2006-07-17 00:00:00.000,Indianapolis IN; U.S.A. ATP World Tour,HARD,2,Vincent Spadea,N/A Bye,Vincent Spadea,,R64,0,0,0,0,0,0,0,0,0,0,0,0,0,0,0,0,0,0,0,0,0,0,0,0,0,0,0
2006-07-17 00:00:00.000,Indianapolis IN; U.S.A. ATP World Tour,HARD,2,Xavier Malisse,N/A Bye,Xavier Malisse,,R64,0,0,0,0,0,0,0,0,0,0,0,0,0,0,0,0,0,0,0,0,0,0,0,0,0,0,0
2006-07-17 00:00:00.000,Indianapolis IN; U.S.A. ATP World Tour,HARD,2,Hyung-Taik Lee,Mark Philippoussis,Hyung-Taik Lee,6-4; 7-6(3),R64,90,6,0,40,60,32,40,14,20,1,2,11,46,60,12,9,36,75,31,36,15,39,2,4,11,46,75
2006-07-17 00:00:00.000,Indianapolis IN; U.S.A. ATP World Tour,HARD,2,Benjamin Becker,Ivan Navarro,Benjamin Becker,6-2; 4-6; 7-5,R64,109,12,2,51,83,44,51,18,32,1,2,15,62,83,18,2,51,90,40,51,19,39,5,8,15,59,90
2006-07-17 00:00:00.000,Indianapolis IN; U.S.A. ATP World Tour,HARD,2,Dmitry Tursunov,N/A Bye,Dmitry Tursunov,,R64,0,0,0,0,0,0,0,0,0,0,0,0,0,0,0,0,0,0,0,0,0,0,0,0,0,0,0
2006-07-17 00:00:00.000,Indianapolis IN; U.S.A. ATP World Tour,HARD,2,Paradorn Srichaphan,N/A Bye,Paradorn Srichaphan,,R64,0,0,0,0,0,0,0,0,0,0,0,0,0,0,0,0,0,0,0,0,0,0,0,0,0,0,0
2006-07-17 00:00:00.000,Indianapolis IN; U.S.A. ATP World Tour,HARD,2,Wayne Arthurs,Harel Levy,Wayne Arthurs,6-3; 7-5,R64,71,5,4,26,56,22,26,19,30,1,2,11,41,56,1,1,39,57,25,39,11,18,4,7,10,36,57
2006-07-17 00:00:00.000,Indianapolis IN; U.S.A. ATP World Tour,HARD,2,Razvan Sabau,Yen-Hsun Lu,Razvan Sabau,6-3; 6-4,R64,74,6,2,35,55,26,35,11,20,0,1,10,37,55,7,2,33,61,22,33,14,28,5,8,9,36,61
2006-07-17 00:00:00.000,Indianapolis IN; U.S.A. ATP World Tour,HARD,2,Paul Goldstein,N/A Bye,Paul Goldstein,,R64,0,0,0,0,0,0,0,0,0,0,0,0,0,0,0,0,0,0,0,0,0,0,0,0,0,0,0
2006-07-17 00:00:00.000,Indianapolis IN; U.S.A. ATP World Tour,HARD,2,Igor Kunitsyn,N/A Bye,Igor Kunitsyn,,R64,0,0,0,0,0,0,0,0,0,0,0,0,0,0,0,0,0,0,0,0,0,0,0,0,0,0,0
2006-07-17 00:00:00.000,Indianapolis IN; U.S.A. ATP World Tour,HARD,2,Lars Burgsmuller,Zack Fleishman,Lars Burgsmuller,6-2; 6-3,R64,67,4,2,27,45,24,27,12,18,0,0,9,36,45,3,0,33,69,22,33,16,36,3,6,8,38,69
2006-07-17 00:00:00.000,Indianapolis IN; U.S.A. ATP World Tour,HARD,2,Alejandro Falla,Jean-Christophe Faurel,Alejandro Falla,6-4; 6-2,R64,83,1,1,29,59,20,29,17,30,1,3,9,37,59,1,4,28,67,15,28,16,39,12,17,9,31,67
2006-07-17 00:00:00.000,Indianapolis IN; U.S.A. ATP World Tour,HARD,2,Robby Ginepri,N/A Bye,Robby Ginepri,,R64,0,0,0,0,0,0,0,0,0,0,0,0,0,0,0,0,0,0,0,0,0,0,0,0,0,0,0
2006-07-17 00:00:00.000,Indianapolis IN; U.S.A. ATP World Tour,HARD,2,Dominik Hrbaty,N/A Bye,Dominik Hrbaty,,R64,0,0,0,0,0,0,0,0,0,0,0,0,0,0,0,0,0,0,0,0,0,0,0,0,0,0,0
2006-07-17 00:00:00.000,Indianapolis IN; U.S.A. ATP World Tour,HARD,2,Kenneth Carlsen,Andrea Stoppini,Kenneth Carlsen,7-6(5); 6-4,R64,101,9,0,39,65,28,39,23,26,1,1,11,51,65,4,3,59,95,39,59,19,36,8,9,11,58,95
2006-07-17 00:00:00.000,Indianapolis IN; U.S.A. ATP World Tour,HARD,2,Paul Capdeville,Tomas Behrend,Paul Capdeville,6-2; 6-0,R64,43,6,1,15,34,14,15,14,19,0,0,7,28,34,3,3,20,37,9,20,5,17,1,6,7,14,37
2006-07-17 00:00:00.000,Indianapolis IN; U.S.A. ATP World Tour,HARD,2,Gilles Muller,N/A Bye,Gilles Muller,,R64,0,0,0,0,0,0,0,0,0,0,0,0,0,0,0,0,0,0,0,0,0,0,0,0,0,0,0
2006-07-17 00:00:00.000,Indianapolis IN; U.S.A. ATP World Tour,HARD,2,Kevin Kim,N/A Bye,Kevin Kim,,R64,0,0,0,0,0,0,0,0,0,0,0,0,0,0,0,0,0,0,0,0,0,0,0,0,0,0,0
2006-07-17 00:00:00.000,Indianapolis IN; U.S.A. ATP World Tour,HARD,2,Jeff Morrison,Santiago Gonzalez,Jeff Morrison,6-2; 6-2,R64,59,1,2,21,48,17,21,18,27,0,0,8,35,48,2,4,28,56,16,28,14,28,3,7,8,30,56
2006-07-17 00:00:00.000,Indianapolis IN; U.S.A. ATP World Tour,HARD,2,Ramon Delgado,Amer Delic,Ramon Delgado,4-6; 6-2; 7-6(5),R64,137,1,2,53,99,38,53,24,46,4,8,15,62,99,15,8,46,98,33,46,22,52,3,8,15,55,98
2006-07-17 00:00:00.000,Indianapolis IN; U.S.A. ATP World Tour,HARD,2,Andy Roddick,N/A Bye,Andy Roddick,,R64,0,0,0,0,0,0,0,0,0,0,0,0,0,0,0,0,0,0,0,0,0,0,0,0,0,0,0
2006-07-17 00:00:00.000,Indianapolis IN; U.S.A. ATP World Tour,HARD,2,James Blake,Danai Udomchoke,James Blake,7-6(5); 6-4,R32,83,7,3,31,67,24,31,24,36,3,4,11,48,67,3,3,61,87,40,61,10,26,6,8,11,50,87
2006-07-17 00:00:00.000,Indianapolis IN; U.S.A. ATP World Tour,HARD,2,Wesley Whitehouse,Marat Safin,Wesley Whitehouse,6-1; 6-4,R32,74,12,1,30,54,26,30,15,24,2,2,9,41,54,4,2,37,71,25,37,13,34,9,12,8,38,71
2006-07-17 00:00:00.000,Indianapolis IN; U.S.A. ATP World Tour,HARD,2,Nicolas Mahut,Thiago Alves,Nicolas Mahut,6-4; 3-6; 6-3,R32,112,13,5,50,79,40,50,10,29,2,5,14,50,79,2,3,57,80,36,57,13,23,2,6,14,49,80
2006-07-17 00:00:00.000,Indianapolis IN; U.S.A. ATP World Tour,HARD,2,Tommy Haas,George Bastl,Tommy Haas,6-3; 6-3,R32,88,8,8,31,57,24,31,15,26,2,3,9,39,57,8,4,37,72,27,37,11,35,6,10,9,38,72
2006-07-17 00:00:00.000,Indianapolis IN; U.S.A. ATP World Tour,HARD,2,Fernando Gonzalez,Sam Querrey,Fernando Gonzalez,6-3; 6-4,R32,67,6,3,40,68,33,40,14,28,3,3,10,47,68,7,4,23,45,20,23,12,22,1,3,9,32,45
2006-07-17 00:00:00.000,Indianapolis IN; U.S.A. ATP World Tour,HARD,2,Vincent Spadea,Ricardo Mello,Vincent Spadea,6-3; 6-1,R32,52,3,5,26,45,21,26,8,19,1,3,8,29,45,1,5,34,51,18,34,3,17,2,8,8,21,51
2006-07-17 00:00:00.000,Indianapolis IN; U.S.A. ATP World Tour,HARD,2,Xavier Malisse,Hyung-Taik Lee,Xavier Malisse,7-6(4); 6-1,R32,83,12,0,38,68,29,38,18,30,0,0,10,47,68,0,3,37,68,23,37,18,31,4,6,9,41,68
2006-07-17 00:00:00.000,Indianapolis IN; U.S.A. ATP World Tour,HARD,2,Dmitry Tursunov,Benjamin Becker,Dmitry Tursunov,6-3; 5-7; 2-1 RET,R32,110,21,11,41,95,32,41,26,54,13,15,12,58,95,13,5,40,77,30,40,16,37,5,8,12,46,77
2006-07-17 00:00:00.000,Indianapolis IN; U.S.A. ATP World Tour,HARD,2,Paradorn Srichaphan,Wayne Arthurs,Paradorn Srichaphan,7-6(4); 6-7(4); 6-4,R32,131,15,4,58,103,53,58,26,45,1,1,17,79,103,27,5,62,104,55,62,23,42,0,1,17,78,104
2006-07-17 00:00:00.000,Indianapolis IN; U.S.A. ATP World Tour,HARD,2,Paul Goldstein,Razvan Sabau,Paul Goldstein,6-2; 6-1,R32,51,3,3,24,38,21,24,8,14,2,2,7,29,38,1,3,39,56,21,39,3,17,6,11,8,24,56
2006-07-17 00:00:00.000,Indianapolis IN; U.S.A. ATP World Tour,HARD,2,Igor Kunitsyn,Lars Burgsmuller,Igor Kunitsyn,7-5; 6-2,R32,98,0,3,47,74,32,47,15,27,6,7,10,47,74,2,6,39,73,27,39,11,34,8,12,10,38,73
2006-07-17 00:00:00.000,Indianapolis IN; U.S.A. ATP World Tour,HARD,2,Robby Ginepri,Alejandro Falla,Robby Ginepri,4-6; 7-5; 7-5,R32,137,2,6,70,110,46,70,22,40,6,10,17,68,110,6,5,72,131,48,72,27,59,7,12,17,75,131
2006-07-17 00:00:00.000,Indianapolis IN; U.S.A. ATP World Tour,HARD,2,Kenneth Carlsen,Dominik Hrbaty,Kenneth Carlsen,6-3; 6-2,R32,82,3,1,49,75,33,49,13,26,10,11,9,46,75,2,5,30,56,19,30,10,26,2,6,8,29,56
2006-07-17 00:00:00.000,Indianapolis IN; U.S.A. ATP World Tour,HARD,2,Gilles Muller,Paul Capdeville,Gilles Muller,6-2; 6-3,R32,62,12,1,23,40,19,23,11,17,0,1,8,30,40,3,5,27,54,16,27,9,27,2,7,9,25,54
2006-07-17 00:00:00.000,Indianapolis IN; U.S.A. ATP World Tour,HARD,2,Jeff Morrison,Kevin Kim,Jeff Morrison,6-2; 6-2,R32,52,9,2,26,42,21,26,11,16,0,0,8,32,42,1,4,33,52,20,33,7,19,2,6,8,27,52
2006-07-17 00:00:00.000,Indianapolis IN; U.S.A. ATP World Tour,HARD,2,Andy Roddick,Ramon Delgado,Andy Roddick,6-3; 6-2,R32,67,8,0,31,51,25,31,13,20,1,1,9,38,51,3,1,24,46,15,24,10,22,1,4,8,25,46
2006-07-17 00:00:00.000,Indianapolis IN; U.S.A. ATP World Tour,HARD,2,James Blake,Wesley Whitehouse,James Blake,6-7(5); 6-3; 6-4,R16,107,19,5,43,93,37,43,29,50,3,5,16,66,93,11,10,47,100,38,47,26,53,4,8,15,64,100
2006-07-17 00:00:00.000,Indianapolis IN; U.S.A. ATP World Tour,HARD,2,Nicolas Mahut,Tommy Haas,Nicolas Mahut,6-4; 7-5,R16,92,12,3,44,70,37,44,12,26,6,7,11,49,70,5,5,35,70,21,35,22,35,7,10,11,43,70
2006-07-17 00:00:00.000,Indianapolis IN; U.S.A. ATP World Tour,HARD,2,Fernando Gonzalez,Vincent Spadea,Fernando Gonzalez,6-4; 7-6(7),R16,95,10,3,38,68,34,38,15,30,2,3,11,49,68,2,2,38,82,27,38,25,44,11,13,11,52,82
2006-07-17 00:00:00.000,Indianapolis IN; U.S.A. ATP World Tour,HARD,2,Xavier Malisse,Dmitry Tursunov,Xavier Malisse,7-6(4); 3-6; 6-3,R16,133,7,4,54,105,41,54,23,51,8,12,15,64,105,14,4,42,93,32,42,23,51,6,10,15,55,93
2006-07-17 00:00:00.000,Indianapolis IN; U.S.A. ATP World Tour,HARD,2,Paradorn Srichaphan,Paul Goldstein,Paradorn Srichaphan,5-7; 6-3; 7-6(3),R16,140,13,6,54,114,40,54,26,60,4,9,17,66,114,1,2,60,97,38,60,18,37,3,8,16,56,97
2006-07-17 00:00:00.000,Indianapolis IN; U.S.A. ATP World Tour,HARD,2,Robby Ginepri,Igor Kunitsyn,Robby Ginepri,6-2; 6-7(2); 6-1,R16,117,11,0,64,92,45,64,16,28,4,5,14,61,92,2,4,49,87,32,49,18,38,7,12,13,50,87
2006-07-17 00:00:00.000,Indianapolis IN; U.S.A. ATP World Tour,HARD,2,Gilles Muller,Kenneth Carlsen,Gilles Muller,6-1; 6-2,R16,52,5,2,26,45,21,26,11,19,3,4,8,32,45,1,2,19,37,9,19,5,18,1,6,7,14,37
2006-07-17 00:00:00.000,Indianapolis IN; U.S.A. ATP World Tour,HARD,2,Andy Roddick,Jeff Morrison,Andy Roddick,7-6(4); 7-5,R16,98,9,1,47,67,39,47,13,20,0,0,12,52,67,12,3,60,100,45,60,16,40,6,7,12,61,100
2006-07-17 00:00:00.000,Indianapolis IN; U.S.A. ATP World Tour,HARD,2,James Blake,Nicolas Mahut,James Blake,7-6(2); 7-6(5),Q,106,8,0,43,74,37,43,19,31,1,2,12,56,74,6,3,46,82,35,46,19,36,3,4,12,54,82
2006-07-17 00:00:00.000,Indianapolis IN; U.S.A. ATP World Tour,HARD,2,Xavier Malisse,Fernando Gonzalez,Xavier Malisse,7-6(4); 6-4,Q,93,5,0,44,73,32,44,18,29,4,6,11,50,73,2,5,38,62,29,38,9,24,0,3,11,38,62
2006-07-17 00:00:00.000,Indianapolis IN; U.S.A. ATP World Tour,HARD,2,Robby Ginepri,Paradorn Srichaphan,Robby Ginepri,6-4; 6-1,Q,49,1,0,28,39,25,28,7,11,0,0,8,32,39,5,4,26,44,14,26,10,18,0,4,9,24,44
2006-07-17 00:00:00.000,Indianapolis IN; U.S.A. ATP World Tour,HARD,2,Andy Roddick,Gilles Muller,Andy Roddick,6-2; 6-3,Q,63,6,0,31,39,26,31,7,8,3,3,8,33,39,4,8,34,72,24,34,14,38,8,12,9,38,72
2006-07-17 00:00:00.000,Indianapolis IN; U.S.A. ATP World Tour,HARD,2,James Blake,Xavier Malisse,James Blake,6-3; 2-6; 6-1,S,93,9,3,45,89,32,45,21,44,8,11,12,53,89,4,3,31,62,22,31,13,31,2,7,12,35,62
2006-07-17 00:00:00.000,Indianapolis IN; U.S.A. ATP World Tour,HARD,2,Andy Roddick,Robby Ginepri,Andy Roddick,7-5; 6-3,S,67,8,0,40,56,32,40,12,16,0,0,11,44,56,3,0,36,56,22,36,14,20,1,3,10,36,56
2006-07-17 00:00:00.000,Indianapolis IN; U.S.A. ATP World Tour,HARD,2,James Blake,Andy Roddick,James Blake,4-6; 6-4; 7-6(5),F,123,15,9,71,126,57,71,23,55,10,12,16,80,126,18,3,69,93,51,69,16,24,4,6,16,67,93
2006-07-17 00:00:00.000,Stuttgart Germany ATP World Tour,CLAY,2,Gaston Gaudio,N/A Bye,Gaston Gaudio,,R64,0,0,0,0,0,0,0,0,0,0,0,0,0,0,0,0,0,0,0,0,0,0,0,0,0,0,0
2006-07-17 00:00:00.000,Stuttgart Germany ATP World Tour,CLAY,2,Mariano Zabaleta,Alexander Waske,Mariano Zabaleta,6-3; 3-6; 6-3,R64,124,4,3,48,86,36,48,23,38,2,3,14,59,86,6,4,47,85,35,47,20,38,11,13,13,55,85
2006-07-17 00:00:00.000,Stuttgart Germany ATP World Tour,CLAY,2,Albert Portas,Flavio Saretta,Albert Portas,5-7; 6-3; 6-3,R64,141,7,4,40,91,30,40,29,51,3,5,15,59,91,12,2,49,108,37,49,25,59,6,10,15,62,108
2006-07-17 00:00:00.000,Stuttgart Germany ATP World Tour,CLAY,2,Luis Horna,N/A Bye,Luis Horna,,R64,0,0,0,0,0,0,0,0,0,0,0,0,0,0,0,0,0,0,0,0,0,0,0,0,0,0,0
2006-07-17 00:00:00.000,Stuttgart Germany ATP World Tour,CLAY,2,Max Mirnyi,N/A Bye,Max Mirnyi,,R64,0,0,0,0,0,0,0,0,0,0,0,0,0,0,0,0,0,0,0,0,0,0,0,0,0,0,0
2006-07-17 00:00:00.000,Stuttgart Germany ATP World Tour,CLAY,2,Jurgen Melzer,Philipp Kohlschreiber,Jurgen Melzer,W/O,R64,0,0,0,0,0,0,0,0,0,0,0,0,0,0,0,0,0,0,0,0,0,0,0,0,0,0,0
2006-07-17 00:00:00.000,Stuttgart Germany ATP World Tour,CLAY,2,Juan Monaco,Michael Berrer,Juan Monaco,4-6; 7-6(6); 6-4,R64,164,2,4,86,126,45,86,27,40,8,14,16,72,126,4,14,65,106,51,65,13,41,7,13,16,64,106
2006-07-17 00:00:00.000,Stuttgart Germany ATP World Tour,CLAY,2,Kristof Vliegen,N/A Bye,Kristof Vliegen,,R64,0,0,0,0,0,0,0,0,0,0,0,0,0,0,0,0,0,0,0,0,0,0,0,0,0,0,0
2006-07-17 00:00:00.000,Stuttgart Germany ATP World Tour,CLAY,2,Stefan Koubek,N/A Bye,Stefan Koubek,,R64,0,0,0,0,0,0,0,0,0,0,0,0,0,0,0,0,0,0,0,0,0,0,0,0,0,0,0
2006-07-17 00:00:00.000,Stuttgart Germany ATP World Tour,CLAY,2,Teymuraz Gabashvili,Jiri Vanek,Teymuraz Gabashvili,6-3; 4-6; 6-3,R64,112,3,5,44,91,36,44,22,47,7,9,14,58,91,4,4,72,90,49,72,6,18,4,8,14,55,90
2006-07-17 00:00:00.000,Stuttgart Germany ATP World Tour,CLAY,2,Oliver Marach,Torsten Popp,Oliver Marach,6-1; 6-2,R64,74,5,3,19,40,17,19,15,21,0,0,8,32,40,2,10,29,52,18,29,6,23,2,6,7,24,52
2006-07-17 00:00:00.000,Stuttgart Germany ATP World Tour,CLAY,2,Richard Gasquet,N/A Bye,Richard Gasquet,,R64,0,0,0,0,0,0,0,0,0,0,0,0,0,0,0,0,0,0,0,0,0,0,0,0,0,0,0
2006-07-17 00:00:00.000,Stuttgart Germany ATP World Tour,CLAY,2,Mikhail Youzhny,N/A Bye,Mikhail Youzhny,,R64,0,0,0,0,0,0,0,0,0,0,0,0,0,0,0,0,0,0,0,0,0,0,0,0,0,0,0
2006-07-17 00:00:00.000,Stuttgart Germany ATP World Tour,CLAY,2,Simon Greul,Rainer Schuettler,Simon Greul,7-5; 7-5,R64,107,1,5,28,74,20,28,23,46,1,5,12,43,74,3,6,44,84,26,44,17,40,7,13,12,43,84
2006-07-17 00:00:00.000,Stuttgart Germany ATP World Tour,CLAY,2,Andreas Seppi,Dick Norman,Andreas Seppi,7-6(8); 6-4,R64,94,3,10,41,77,32,41,19,36,3,5,11,51,77,9,5,54,80,39,54,9,26,4,7,11,48,80
2006-07-17 00:00:00.000,Stuttgart Germany ATP World Tour,CLAY,2,Jose Acasuso,N/A Bye,Jose Acasuso,,R64,0,0,0,0,0,0,0,0,0,0,0,0,0,0,0,0,0,0,0,0,0,0,0,0,0,0,0
2006-07-17 00:00:00.000,Stuttgart Germany ATP World Tour,CLAY,2,Juan Ignacio Chela,N/A Bye,Juan Ignacio Chela,,R64,0,0,0,0,0,0,0,0,0,0,0,0,0,0,0,0,0,0,0,0,0,0,0,0,0,0,0
2006-07-17 00:00:00.000,Stuttgart Germany ATP World Tour,CLAY,2,Juan Martin Del Potro,Andrei Pavel,Juan Martin Del Potro,3-6; 6-2; 6-2,R64,118,2,3,62,80,37,62,8,18,5,9,12,45,80,1,0,49,83,28,49,15,34,5,12,13,43,83
2006-07-17 00:00:00.000,Stuttgart Germany ATP World Tour,CLAY,2,Florian Mayer,Andreas Beck,Florian Mayer,6-4; 3-6; 6-3,R64,186,8,1,53,80,39,53,14,27,7,11,14,53,80,2,6,60,92,37,60,17,32,5,10,14,54,92
2006-07-17 00:00:00.000,Stuttgart Germany ATP World Tour,CLAY,2,Gilles Simon,N/A Bye,Gilles Simon,,R64,0,0,0,0,0,0,0,0,0,0,0,0,0,0,0,0,0,0,0,0,0,0,0,0,0,0,0
2006-07-17 00:00:00.000,Stuttgart Germany ATP World Tour,CLAY,2,Bjorn Phau,N/A Bye,Bjorn Phau,,R64,0,0,0,0,0,0,0,0,0,0,0,0,0,0,0,0,0,0,0,0,0,0,0,0,0,0,0
2006-07-17 00:00:00.000,Stuttgart Germany ATP World Tour,CLAY,2,Stanislas Wawrinka,Lukas Dlouhy,Stanislas Wawrinka,6-7(1); 6-3; 6-4,R64,134,4,4,72,111,45,72,23,39,7,9,15,68,111,3,7,61,113,38,61,26,52,8,13,16,64,113
2006-07-17 00:00:00.000,Stuttgart Germany ATP World Tour,CLAY,2,Jiri Novak,Simone Bolelli,Jiri Novak,7-6(4); 6-1,R64,80,14,0,44,59,36,44,10,15,3,3,10,46,59,2,0,38,69,22,38,18,31,4,6,9,40,69
2006-07-17 00:00:00.000,Stuttgart Germany ATP World Tour,CLAY,2,David Ferrer,N/A Bye,David Ferrer,,R64,0,0,0,0,0,0,0,0,0,0,0,0,0,0,0,0,0,0,0,0,0,0,0,0,0,0,0
2006-07-17 00:00:00.000,Stuttgart Germany ATP World Tour,CLAY,2,Florent Serra,N/A Bye,Florent Serra,,R64,0,0,0,0,0,0,0,0,0,0,0,0,0,0,0,0,0,0,0,0,0,0,0,0,0,0,0
2006-07-17 00:00:00.000,Stuttgart Germany ATP World Tour,CLAY,2,Nicolas Lapentti,Sebastian Rieschick,Nicolas Lapentti,4-6; 6-3; 6-1,R64,106,7,0,51,78,36,51,12,27,2,5,13,48,78,1,4,45,77,27,45,13,32,1,7,13,40,77
2006-07-17 00:00:00.000,Stuttgart Germany ATP World Tour,CLAY,2,Diego Hartfield,Robin Vik,Diego Hartfield,3-6; 7-6(7); 6-4,R64,140,2,2,71,102,45,71,19,31,4,7,15,64,102,5,9,74,110,49,74,19,36,4,7,16,68,110
2006-07-17 00:00:00.000,Stuttgart Germany ATP World Tour,CLAY,2,Nicolas Almagro,N/A Bye,Nicolas Almagro,,R64,0,0,0,0,0,0,0,0,0,0,0,0,0,0,0,0,0,0,0,0,0,0,0,0,0,0,0
2006-07-17 00:00:00.000,Stuttgart Germany ATP World Tour,CLAY,2,Filippo Volandri,N/A Bye,Filippo Volandri,,R64,0,0,0,0,0,0,0,0,0,0,0,0,0,0,0,0,0,0,0,0,0,0,0,0,0,0,0
2006-07-17 00:00:00.000,Stuttgart Germany ATP World Tour,CLAY,2,Diego Junqueira,Christophe Rochus,Diego Junqueira,6-3; 2-6; 7-6(5),R64,123,3,0,80,99,43,80,10,19,8,14,15,53,99,2,1,61,99,36,61,20,38,8,13,14,56,99
2006-07-17 00:00:00.000,Stuttgart Germany ATP World Tour,CLAY,2,Hugo Armando,Dieter Kindlmann,Hugo Armando,6-4; 6-3,R64,68,9,0,32,49,29,32,12,17,1,1,10,41,49,0,3,34,54,25,34,8,20,2,4,9,33,54
2006-07-17 00:00:00.000,Stuttgart Germany ATP World Tour,CLAY,2,Tomas Berdych,N/A Bye,Tomas Berdych,,R64,0,0,0,0,0,0,0,0,0,0,0,0,0,0,0,0,0,0,0,0,0,0,0,0,0,0,0
2006-07-17 00:00:00.000,Stuttgart Germany ATP World Tour,CLAY,2,Mariano Zabaleta,Gaston Gaudio,Mariano Zabaleta,6-4; 6-0,R32,85,3,1,32,58,23,32,15,26,5,6,8,38,58,0,2,36,69,18,36,15,33,14,19,8,33,69
2006-07-17 00:00:00.000,Stuttgart Germany ATP World Tour,CLAY,2,Luis Horna,Albert Portas,Luis Horna,7-6(4); 6-2,R32,86,5,2,33,59,24,33,19,26,0,1,10,43,59,8,4,40,76,28,40,16,36,12,15,10,44,76
2006-07-17 00:00:00.000,Stuttgart Germany ATP World Tour,CLAY,2,Jurgen Melzer,Max Mirnyi,Jurgen Melzer,6-3; 6-1,R32,71,2,3,30,57,19,30,16,27,3,4,8,35,57,4,1,42,65,21,42,8,23,5,10,8,29,65
2006-07-17 00:00:00.000,Stuttgart Germany ATP World Tour,CLAY,2,Juan Monaco,Kristof Vliegen,Juan Monaco,6-3; 1-0 RET,R32,38,1,0,18,27,13,18,5,9,2,3,5,18,27,1,6,14,30,7,14,7,16,0,3,5,14,30
2006-07-17 00:00:00.000,Stuttgart Germany ATP World Tour,CLAY,2,Stefan Koubek,Teymuraz Gabashvili,Stefan Koubek,7-6(6); 6-2,R32,88,5,4,28,65,18,28,24,37,3,5,10,42,65,0,6,34,70,22,34,17,36,3,7,10,39,70
2006-07-17 00:00:00.000,Stuttgart Germany ATP World Tour,CLAY,2,Oliver Marach,Richard Gasquet,Oliver Marach,6-4; 6-2,R32,84,4,2,35,58,28,35,12,23,1,1,9,40,58,1,2,40,58,24,40,10,18,5,8,9,34,58
2006-07-17 00:00:00.000,Stuttgart Germany ATP World Tour,CLAY,2,Simon Greul,Mikhail Youzhny,Simon Greul,6-7(5); 7-5; 6-4,R32,147,3,3,51,106,39,51,32,55,5,7,17,71,106,4,5,68,116,50,68,22,48,5,9,17,72,116
2006-07-17 00:00:00.000,Stuttgart Germany ATP World Tour,CLAY,2,Jose Acasuso,Andreas Seppi,Jose Acasuso,6-4; 7-6(2),R32,99,7,0,33,66,29,33,21,33,2,2,11,50,66,2,5,46,83,36,46,15,37,10,11,11,51,83
2006-07-17 00:00:00.000,Stuttgart Germany ATP World Tour,CLAY,2,Juan Martin Del Potro,Juan Ignacio Chela,Juan Martin Del Potro,6-2; 4-6; 6-1,R32,122,0,8,78,102,49,78,10,24,10,13,13,59,102,0,4,53,85,28,53,13,32,6,12,12,41,85
2006-07-17 00:00:00.000,Stuttgart Germany ATP World Tour,CLAY,2,Florian Mayer,Gilles Simon,Florian Mayer,7-6(3); 6-2,R32,68,3,1,48,67,38,48,8,19,3,4,10,46,67,0,1,38,65,23,38,15,27,6,9,10,38,65
2006-07-17 00:00:00.000,Stuttgart Germany ATP World Tour,CLAY,2,Stanislas Wawrinka,Bjorn Phau,Stanislas Wawrinka,6-7(3); 6-2; 6-3,R32,120,5,5,53,84,41,53,13,31,0,2,14,54,84,3,1,45,90,29,45,21,45,6,12,15,50,90
2006-07-17 00:00:00.000,Stuttgart Germany ATP World Tour,CLAY,2,David Ferrer,Jiri Novak,David Ferrer,6-3; 6-1,R32,56,4,2,25,49,18,25,15,24,1,2,8,33,49,3,1,27,49,13,27,8,22,4,9,8,21,49
2006-07-17 00:00:00.000,Stuttgart Germany ATP World Tour,CLAY,2,Nicolas Lapentti,Florent Serra,Nicolas Lapentti,5-7; 7-6(3); 6-2,R32,176,4,5,58,102,46,58,22,44,6,9,16,68,102,1,6,47,103,30,47,32,56,6,10,16,62,103
2006-07-17 00:00:00.000,Stuttgart Germany ATP World Tour,CLAY,2,Diego Hartfield,Nicolas Almagro,Diego Hartfield,6-7(2); 7-6(1); 7-5,R32,161,3,3,75,104,57,75,17,29,0,2,18,74,104,13,2,85,133,61,85,23,48,4,7,18,84,133
2006-07-17 00:00:00.000,Stuttgart Germany ATP World Tour,CLAY,2,Diego Junqueira,Filippo Volandri,Diego Junqueira,6-3; 6-4,R32,83,0,2,51,74,36,51,11,23,6,7,10,47,74,0,1,35,57,22,35,12,22,6,9,9,34,57
2006-07-17 00:00:00.000,Stuttgart Germany ATP World Tour,CLAY,2,Tomas Berdych,Hugo Armando,Tomas Berdych,7-5; 6-3,R32,80,10,7,39,61,35,39,9,22,1,2,11,44,61,1,4,45,74,31,45,11,29,3,6,10,42,74
2006-07-17 00:00:00.000,Stuttgart Germany ATP World Tour,CLAY,2,Luis Horna,Mariano Zabaleta,Luis Horna,6-3; 6-7(6); 6-4,R16,161,14,5,68,113,51,68,27,45,10,11,16,78,113,8,3,73,113,55,73,18,40,12,15,15,73,113
2006-07-17 00:00:00.000,Stuttgart Germany ATP World Tour,CLAY,2,Juan Monaco,Jurgen Melzer,Juan Monaco,6-4; 6-7(3); 6-4,R16,148,0,3,68,107,47,68,25,39,3,4,16,72,107,5,3,71,117,51,71,25,46,10,13,16,76,117
2006-07-17 00:00:00.000,Stuttgart Germany ATP World Tour,CLAY,2,Oliver Marach,Stefan Koubek,Oliver Marach,6-4; 6-4,R16,93,5,2,32,65,25,32,17,33,4,5,10,42,65,5,1,30,63,23,30,14,33,2,5,10,37,63
2006-07-17 00:00:00.000,Stuttgart Germany ATP World Tour,CLAY,2,Jose Acasuso,Simon Greul,Jose Acasuso,7-6(4); 2-6; 6-4,R16,142,8,2,45,91,34,45,25,46,5,8,15,59,91,2,1,69,106,48,69,19,37,5,7,15,67,106
2006-07-17 00:00:00.000,Stuttgart Germany ATP World Tour,CLAY,2,Florian Mayer,Juan Martin Del Potro,Florian Mayer,6-1; 6-0,R16,48,4,1,18,35,16,18,12,17,0,0,7,28,35,1,2,32,41,12,32,3,9,5,10,6,15,41
2006-07-17 00:00:00.000,Stuttgart Germany ATP World Tour,CLAY,2,David Ferrer,Stanislas Wawrinka,David Ferrer,6-3; 6-4,R16,84,0,6,28,52,21,28,13,24,3,5,9,34,52,1,2,45,68,22,45,11,23,4,9,10,33,68
2006-07-17 00:00:00.000,Stuttgart Germany ATP World Tour,CLAY,2,Nicolas Lapentti,Diego Hartfield,Nicolas Lapentti,7-6(5); 6-2,R16,126,3,1,47,71,38,47,11,24,8,9,10,49,71,2,3,51,82,33,51,13,31,8,11,10,46,82
2006-07-17 00:00:00.000,Stuttgart Germany ATP World Tour,CLAY,2,Tomas Berdych,Diego Junqueira,Tomas Berdych,6-1; 6-4,R16,77,4,3,38,67,27,38,16,29,9,10,9,43,67,2,2,36,51,19,36,8,15,2,6,8,27,51
2006-07-17 00:00:00.000,Stuttgart Germany ATP World Tour,CLAY,2,Juan Monaco,Luis Horna,Juan Monaco,5-2 RET,Q,33,3,0,13,18,10,13,3,5,0,1,4,13,18,1,0,12,17,5,12,2,5,2,4,3,7,17
2006-07-17 00:00:00.000,Stuttgart Germany ATP World Tour,CLAY,2,Jose Acasuso,Oliver Marach,Jose Acasuso,6-2; 6-3,Q,80,9,2,30,56,25,30,15,26,3,3,9,40,56,4,0,26,50,17,26,12,24,4,7,8,29,50
2006-07-17 00:00:00.000,Stuttgart Germany ATP World Tour,CLAY,2,David Ferrer,Florian Mayer,David Ferrer,6-4; 6-3,Q,66,1,9,33,57,25,33,9,24,5,7,9,34,57,4,1,29,59,23,29,7,30,4,9,10,30,59
2006-07-17 00:00:00.000,Stuttgart Germany ATP World Tour,CLAY,2,Tomas Berdych,Nicolas Lapentti,Tomas Berdych,6-1; 6-2,Q,56,4,0,25,38,19,25,10,13,1,2,8,29,38,1,2,25,41,11,25,5,16,3,8,7,16,41
2006-07-17 00:00:00.000,Stuttgart Germany ATP World Tour,CLAY,2,Jose Acasuso,Juan Monaco,Jose Acasuso,4-6; 6-2; 6-2,S,145,10,2,49,106,32,49,27,57,8,12,13,59,106,0,0,62,80,31,62,9,18,2,9,13,40,80
2006-07-17 00:00:00.000,Stuttgart Germany ATP World Tour,CLAY,2,David Ferrer,Tomas Berdych,David Ferrer,6-3; 7-5,S,80,1,2,33,54,29,33,9,21,2,3,10,38,54,5,5,40,69,26,40,12,29,2,6,11,38,69
2006-07-17 00:00:00.000,Stuttgart Germany ATP World Tour,CLAY,2,David Ferrer,Jose Acasuso,David Ferrer,6-4; 3-6; 6-7(3); 7-5; 6-4,F,300,9,7,123,188,80,123,29,65,9,16,26,109,188,13,6,80,187,58,80,48,107,10,19,27,106,187
2006-07-24 00:00:00.000,Kitzbuhel Austria ATP World Tour,CLAY,2,Nikolay Davydenko,N/A Bye,Nikolay Davydenko,,R64,0,0,0,0,0,0,0,0,0,0,0,0,0,0,0,0,0,0,0,0,0,0,0,0,0,0,0
2006-07-24 00:00:00.000,Kitzbuhel Austria ATP World Tour,CLAY,2,Nicolas Lapentti,Tomas Zib,Nicolas Lapentti,7-6(10); 6-3,R64,130,9,1,45,77,30,45,16,32,2,4,10,46,77,4,5,33,75,21,33,18,42,1,5,11,39,75
2006-07-24 00:00:00.000,Kitzbuhel Austria ATP World Tour,CLAY,2,Stefan Koubek,Juan Antonio Marin,Stefan Koubek,3-6; 6-4; 7-6(1),R64,139,6,5,62,110,41,62,22,48,9,15,16,63,110,6,4,59,95,40,59,15,36,3,8,15,55,95
2006-07-24 00:00:00.000,Kitzbuhel Austria ATP World Tour,CLAY,2,Boris Pashanski,N/A Bye,Boris Pashanski,,R64,0,0,0,0,0,0,0,0,0,0,0,0,0,0,0,0,0,0,0,0,0,0,0,0,0,0,0
2006-07-24 00:00:00.000,Kitzbuhel Austria ATP World Tour,CLAY,2,Max Mirnyi,N/A Bye,Max Mirnyi,,R64,0,0,0,0,0,0,0,0,0,0,0,0,0,0,0,0,0,0,0,0,0,0,0,0,0,0,0
2006-07-24 00:00:00.000,Kitzbuhel Austria ATP World Tour,CLAY,2,Andreas Haider-Maurer,Damian Patriarca,Andreas Haider-Maurer,6-7(5); 6-2; 6-3,R64,100,11,8,52,93,36,52,21,41,4,6,14,57,93,0,5,49,83,34,49,12,34,3,9,15,46,83
2006-07-24 00:00:00.000,Kitzbuhel Austria ATP World Tour,CLAY,2,Alexander Waske,Lukasz Kubot,Alexander Waske,6-3; 3-6; 7-6(6),R64,189,10,4,66,101,48,66,15,35,7,10,15,63,101,8,11,69,111,53,69,12,42,8,11,15,65,111
2006-07-24 00:00:00.000,Kitzbuhel Austria ATP World Tour,CLAY,2,Fernando Verdasco,N/A Bye,Fernando Verdasco,,R64,0,0,0,0,0,0,0,0,0,0,0,0,0,0,0,0,0,0,0,0,0,0,0,0,0,0,0
2006-07-24 00:00:00.000,Kitzbuhel Austria ATP World Tour,CLAY,2,Gaston Gaudio,N/A Bye,Gaston Gaudio,,R64,0,0,0,0,0,0,0,0,0,0,0,0,0,0,0,0,0,0,0,0,0,0,0,0,0,0,0
2006-07-24 00:00:00.000,Kitzbuhel Austria ATP World Tour,CLAY,2,Juan Monaco,Leonardo Azzaro,Juan Monaco,6-4; 6-2,R64,67,3,1,33,51,28,33,10,18,2,2,9,38,51,1,0,31,58,22,31,13,27,4,7,9,35,58
2006-07-24 00:00:00.000,Kitzbuhel Austria ATP World Tour,CLAY,2,Denis Gremelmayr,Michael Berrer,Denis Gremelmayr,6-3; 3-6; 7-6(6),R64,110,6,3,58,89,45,58,16,31,2,4,15,61,89,6,8,62,94,42,62,17,32,5,7,15,59,94
2006-07-24 00:00:00.000,Kitzbuhel Austria ATP World Tour,CLAY,2,Christophe Rochus,N/A Bye,Christophe Rochus,,R64,0,0,0,0,0,0,0,0,0,0,0,0,0,0,0,0,0,0,0,0,0,0,0,0,0,0,0
2006-07-24 00:00:00.000,Kitzbuhel Austria ATP World Tour,CLAY,2,Agustin Calleri,N/A Bye,Agustin Calleri,,R64,0,0,0,0,0,0,0,0,0,0,0,0,0,0,0,0,0,0,0,0,0,0,0,0,0,0,0
2006-07-24 00:00:00.000,Kitzbuhel Austria ATP World Tour,CLAY,2,Rainer Eitzinger,Oliver Marach,Rainer Eitzinger,6-3; 6-0,R64,63,4,3,36,56,28,36,10,20,4,4,8,38,56,1,0,20,42,10,20,11,22,2,6,7,21,42
2006-07-24 00:00:00.000,Kitzbuhel Austria ATP World Tour,CLAY,2,Alex Calatrava,Diego Junqueira,Alex Calatrava,4-6; 6-3; 6-4,R64,137,8,2,58,100,44,58,17,42,5,9,15,61,100,2,1,73,88,46,73,6,15,7,12,14,52,88
2006-07-24 00:00:00.000,Kitzbuhel Austria ATP World Tour,CLAY,2,Nicolas Massu,N/A Bye,Nicolas Massu,,R64,0,0,0,0,0,0,0,0,0,0,0,0,0,0,0,0,0,0,0,0,0,0,0,0,0,0,0
2006-07-24 00:00:00.000,Kitzbuhel Austria ATP World Tour,CLAY,2,Juan Ignacio Chela,N/A Bye,Juan Ignacio Chela,,R64,0,0,0,0,0,0,0,0,0,0,0,0,0,0,0,0,0,0,0,0,0,0,0,0,0,0,0
2006-07-24 00:00:00.000,Kitzbuhel Austria ATP World Tour,CLAY,2,Mariano Zabaleta,Rainer Schuettler,Mariano Zabaleta,6-1 RET,R64,24,1,2,9,15,9,9,3,6,0,0,3,12,15,0,2,11,25,5,11,4,14,4,7,4,9,25
2006-07-24 00:00:00.000,Kitzbuhel Austria ATP World Tour,CLAY,2,Dusan Vemic,Armin Sandbichler,Dusan Vemic,6-3; 6-3,R64,67,11,4,28,52,24,28,14,24,3,3,9,38,52,0,2,36,53,19,36,9,17,1,4,9,28,53
2006-07-24 00:00:00.000,Kitzbuhel Austria ATP World Tour,CLAY,2,Luis Horna,N/A Bye,Luis Horna,,R64,0,0,0,0,0,0,0,0,0,0,0,0,0,0,0,0,0,0,0,0,0,0,0,0,0,0,0
2006-07-24 00:00:00.000,Kitzbuhel Austria ATP World Tour,CLAY,2,Philipp Kohlschreiber,N/A Bye,Philipp Kohlschreiber,,R64,0,0,0,0,0,0,0,0,0,0,0,0,0,0,0,0,0,0,0,0,0,0,0,0,0,0,0
2006-07-24 00:00:00.000,Kitzbuhel Austria ATP World Tour,CLAY,2,Peter Luczak,Ivo Minar,Peter Luczak,6-1; 3-6; 6-1,R64,68,10,1,43,65,34,43,16,22,0,1,12,50,65,9,4,30,61,23,30,13,31,2,6,11,36,61
2006-07-24 00:00:00.000,Kitzbuhel Austria ATP World Tour,CLAY,2,Sergio Roitman,Razvan Sabau,Sergio Roitman,6-4; 6-3,R64,80,5,0,38,60,26,38,8,22,4,7,9,34,60,1,3,39,65,20,39,11,26,5,11,10,31,65
2006-07-24 00:00:00.000,Kitzbuhel Austria ATP World Tour,CLAY,2,Jarkko Nieminen,N/A Bye,Jarkko Nieminen,,R64,0,0,0,0,0,0,0,0,0,0,0,0,0,0,0,0,0,0,0,0,0,0,0,0,0,0,0
2006-07-24 00:00:00.000,Kitzbuhel Austria ATP World Tour,CLAY,2,Mikhail Youzhny,N/A Bye,Mikhail Youzhny,,R64,0,0,0,0,0,0,0,0,0,0,0,0,0,0,0,0,0,0,0,0,0,0,0,0,0,0,0
2006-07-24 00:00:00.000,Kitzbuhel Austria ATP World Tour,CLAY,2,Martin Vassallo Arguello,Dick Norman,Martin Vassallo Arguello,6-0; 6-4,R64,75,0,1,35,52,26,35,10,17,7,7,8,36,52,8,6,50,72,30,50,6,22,7,11,8,36,72
2006-07-24 00:00:00.000,Kitzbuhel Austria ATP World Tour,CLAY,2,Edgardo Massa,Werner Eschauer,Edgardo Massa,3-6; 7-6(6); 6-4,R64,124,2,6,47,90,34,47,26,43,3,6,15,60,90,9,6,44,89,35,44,25,45,1,4,16,60,89
2006-07-24 00:00:00.000,Kitzbuhel Austria ATP World Tour,CLAY,2,Andreas Seppi,N/A Bye,Andreas Seppi,,R64,0,0,0,0,0,0,0,0,0,0,0,0,0,0,0,0,0,0,0,0,0,0,0,0,0,0,0
2006-07-24 00:00:00.000,Kitzbuhel Austria ATP World Tour,CLAY,2,Andrei Pavel,N/A Bye,Andrei Pavel,,R64,0,0,0,0,0,0,0,0,0,0,0,0,0,0,0,0,0,0,0,0,0,0,0,0,0,0,0
2006-07-24 00:00:00.000,Kitzbuhel Austria ATP World Tour,CLAY,2,Marcos Daniel,Albert Montanes,Marcos Daniel,6-4; 6-3,R64,79,7,2,46,65,31,46,9,19,4,6,10,40,65,4,4,28,56,16,28,13,28,3,7,9,29,56
2006-07-24 00:00:00.000,Kitzbuhel Austria ATP World Tour,CLAY,2,Jurgen Melzer,Oscar Hernandez,Jurgen Melzer,6-3; 6-4,R64,76,2,3,34,49,29,34,11,15,0,0,10,40,49,2,1,50,69,29,50,11,19,2,4,9,40,69
2006-07-24 00:00:00.000,Kitzbuhel Austria ATP World Tour,CLAY,2,Tommy Robredo,N/A Bye,Tommy Robredo,,R64,0,0,0,0,0,0,0,0,0,0,0,0,0,0,0,0,0,0,0,0,0,0,0,0,0,0,0
2006-07-24 00:00:00.000,Kitzbuhel Austria ATP World Tour,CLAY,2,Nicolas Lapentti,Nikolay Davydenko,Nicolas Lapentti,6-3; 6-3,R32,97,3,1,40,60,31,40,9,20,2,3,9,40,60,2,3,51,72,29,51,8,21,7,11,9,37,72
2006-07-24 00:00:00.000,Kitzbuhel Austria ATP World Tour,CLAY,2,Stefan Koubek,Boris Pashanski,Stefan Koubek,6-1; 3-6; 6-2,R32,0,0,0,0,0,0,0,0,0,0,0,0,0,0,0,0,0,0,0,0,0,0,0,0,0,0,0
2006-07-24 00:00:00.000,Kitzbuhel Austria ATP World Tour,CLAY,2,Max Mirnyi,Andreas Haider-Maurer,Max Mirnyi,6-2; 6-4,R32,63,7,3,21,44,20,21,16,23,0,0,9,36,44,4,5,29,50,20,29,7,21,1,4,9,27,50
2006-07-24 00:00:00.000,Kitzbuhel Austria ATP World Tour,CLAY,2,Fernando Verdasco,Alexander Waske,Fernando Verdasco,6-3; 6-3,R32,70,3,3,39,56,30,39,10,17,1,1,9,40,56,7,1,25,53,17,25,13,28,4,7,9,30,53
2006-07-24 00:00:00.000,Kitzbuhel Austria ATP World Tour,CLAY,2,Gaston Gaudio,Juan Monaco,Gaston Gaudio,7-6(4); 4-1 RET,R32,94,2,2,35,61,24,35,14,26,3,5,9,38,61,1,2,41,63,25,41,8,22,2,5,8,33,63
2006-07-24 00:00:00.000,Kitzbuhel Austria ATP World Tour,CLAY,2,Denis Gremelmayr,Christophe Rochus,Denis Gremelmayr,7-5; 6-1,R32,69,6,3,35,60,26,35,16,25,0,1,10,42,60,3,2,46,57,26,46,3,11,2,6,9,29,57
2006-07-24 00:00:00.000,Kitzbuhel Austria ATP World Tour,CLAY,2,Agustin Calleri,Rainer Eitzinger,Agustin Calleri,7-6(3); 6-3,R32,90,4,3,30,71,20,30,24,41,3,7,11,44,71,0,3,46,69,24,46,9,23,4,9,10,33,69
2006-07-24 00:00:00.000,Kitzbuhel Austria ATP World Tour,CLAY,2,Nicolas Massu,Alex Calatrava,Nicolas Massu,3-6; 7-5; 7-6(3),R32,186,13,4,58,107,47,58,27,49,9,10,16,74,107,9,3,64,114,41,64,36,50,9,10,17,77,114
2006-07-24 00:00:00.000,Kitzbuhel Austria ATP World Tour,CLAY,2,Juan Ignacio Chela,Mariano Zabaleta,Juan Ignacio Chela,6-7(4); 6-3; 6-3,R32,122,7,3,48,84,41,48,22,36,2,3,15,63,84,3,2,38,76,30,38,20,38,0,4,15,50,76
2006-07-24 00:00:00.000,Kitzbuhel Austria ATP World Tour,CLAY,2,Dusan Vemic,Luis Horna,Dusan Vemic,7-6(3); 5-2 RET,R32,90,9,6,41,70,32,41,15,29,3,3,9,47,70,1,6,46,66,32,46,9,20,2,4,10,41,66
2006-07-24 00:00:00.000,Kitzbuhel Austria ATP World Tour,CLAY,2,Philipp Kohlschreiber,Peter Luczak,Philipp Kohlschreiber,7-6(3); 7-5,R32,101,12,3,43,82,36,43,20,39,8,9,12,56,82,4,1,42,73,32,42,15,31,3,5,12,47,73
2006-07-24 00:00:00.000,Kitzbuhel Austria ATP World Tour,CLAY,2,Jarkko Nieminen,Sergio Roitman,Jarkko Nieminen,6-3; 1-6; 6-4,R32,96,2,3,38,80,30,38,17,42,2,6,13,47,80,5,3,57,83,35,57,12,26,6,10,13,47,83
2006-07-24 00:00:00.000,Kitzbuhel Austria ATP World Tour,CLAY,2,Mikhail Youzhny,Martin Vassallo Arguello,Mikhail Youzhny,0-6; 6-4; 7-6(2),R32,117,2,4,49,84,35,49,14,35,2,7,14,49,84,3,1,64,85,44,64,11,21,1,4,14,55,85
2006-07-24 00:00:00.000,Kitzbuhel Austria ATP World Tour,CLAY,2,Edgardo Massa,Andreas Seppi,Edgardo Massa,7-6(5); 7-6(5),R32,130,3,4,44,79,33,44,14,35,2,5,12,47,79,2,9,61,100,40,61,16,39,8,11,12,56,100
2006-07-24 00:00:00.000,Kitzbuhel Austria ATP World Tour,CLAY,2,Andrei Pavel,Marcos Daniel,Andrei Pavel,6-4; 6-4,R32,81,2,0,26,55,20,26,21,29,0,0,10,41,55,3,2,38,64,24,38,15,26,1,3,10,39,64
2006-07-24 00:00:00.000,Kitzbuhel Austria ATP World Tour,CLAY,2,Jurgen Melzer,Tommy Robredo,Jurgen Melzer,6-2; 7-5,R32,79,6,1,36,58,24,36,15,22,2,3,10,39,58,0,1,50,69,30,50,10,19,6,10,10,40,69
2006-07-24 00:00:00.000,Kitzbuhel Austria ATP World Tour,CLAY,2,Nicolas Lapentti,Stefan Koubek,Nicolas Lapentti,6-3; 6-3,R16,96,2,1,40,67,27,40,12,27,6,9,9,39,67,1,7,32,66,19,32,10,34,5,11,9,29,66
2006-07-24 00:00:00.000,Kitzbuhel Austria ATP World Tour,CLAY,2,Fernando Verdasco,Max Mirnyi,Fernando Verdasco,6-4; 7-5,R16,96,5,2,40,55,33,40,12,15,0,0,11,45,55,9,6,48,85,37,48,14,37,7,9,11,51,85
2006-07-24 00:00:00.000,Kitzbuhel Austria ATP World Tour,CLAY,2,Gaston Gaudio,Denis Gremelmayr,Gaston Gaudio,6-7(1); 7-6(7); 6-0,R16,143,3,3,69,111,50,69,16,42,11,14,15,66,111,6,2,55,96,32,55,23,41,5,11,15,55,96
2006-07-24 00:00:00.000,Kitzbuhel Austria ATP World Tour,CLAY,2,Agustin Calleri,Nicolas Massu,Agustin Calleri,6-2; 7-6(4),R16,112,12,2,37,69,28,37,20,32,4,5,10,48,69,2,4,30,74,22,30,20,44,7,10,10,42,74
2006-07-24 00:00:00.000,Kitzbuhel Austria ATP World Tour,CLAY,2,Juan Ignacio Chela,Dusan Vemic,Juan Ignacio Chela,6-4; 6-0,R16,76,3,1,38,55,27,38,11,17,4,4,8,38,55,5,6,30,53,20,30,7,23,6,10,8,27,53
2006-07-24 00:00:00.000,Kitzbuhel Austria ATP World Tour,CLAY,2,Philipp Kohlschreiber,Jarkko Nieminen,Philipp Kohlschreiber,6-2; 4-6; 6-3,R16,90,6,2,42,69,36,42,18,27,1,2,14,54,69,3,4,44,84,30,44,21,40,5,8,13,51,84
2006-07-24 00:00:00.000,Kitzbuhel Austria ATP World Tour,CLAY,2,Mikhail Youzhny,Edgardo Massa,Mikhail Youzhny,6-4; 6-1,R16,67,2,0,30,41,21,30,6,11,3,5,8,27,41,1,7,42,70,20,42,11,28,9,15,9,31,70
2006-07-24 00:00:00.000,Kitzbuhel Austria ATP World Tour,CLAY,2,Jurgen Melzer,Andrei Pavel,Jurgen Melzer,7-5; 6-3,R16,84,8,3,40,63,33,40,14,23,3,3,11,47,63,4,2,42,67,26,42,14,25,3,5,10,40,67
2006-07-24 00:00:00.000,Kitzbuhel Austria ATP World Tour,CLAY,2,Fernando Verdasco,Nicolas Lapentti,Fernando Verdasco,6-4; 6-4,Q,96,3,2,51,65,35,51,7,14,6,7,10,42,65,2,2,49,61,31,49,4,12,1,4,10,35,61
2006-07-24 00:00:00.000,Kitzbuhel Austria ATP World Tour,CLAY,2,Agustin Calleri,Gaston Gaudio,Agustin Calleri,7-5; 6-0,Q,72,11,2,28,44,25,28,8,16,0,1,9,33,44,0,4,29,58,15,29,14,29,6,11,9,29,58
2006-07-24 00:00:00.000,Kitzbuhel Austria ATP World Tour,CLAY,2,Juan Ignacio Chela,Philipp Kohlschreiber,Juan Ignacio Chela,6-4; 6-4,Q,76,6,0,28,49,26,28,11,21,1,3,10,37,49,2,4,35,63,24,35,11,28,2,6,10,35,63
2006-07-24 00:00:00.000,Kitzbuhel Austria ATP World Tour,CLAY,2,Mikhail Youzhny,Jurgen Melzer,Mikhail Youzhny,6-3; 3-6; 6-3,Q,110,5,3,42,83,35,42,24,41,2,3,14,59,83,8,5,51,89,41,51,14,38,5,7,13,55,89
2006-07-24 00:00:00.000,Kitzbuhel Austria ATP World Tour,CLAY,2,Agustin Calleri,Fernando Verdasco,Agustin Calleri,4-6; 6-1; 6-3,S,123,7,7,50,98,38,50,21,48,6,8,13,59,98,3,4,61,87,38,61,9,26,10,15,13,47,87
2006-07-24 00:00:00.000,Kitzbuhel Austria ATP World Tour,CLAY,2,Juan Ignacio Chela,Mikhail Youzhny,Juan Ignacio Chela,6-2; 4-6; 6-4,S,153,3,3,70,117,45,70,24,47,7,10,14,69,117,1,2,52,99,33,52,19,47,6,11,14,52,99
2006-07-24 00:00:00.000,Kitzbuhel Austria ATP World Tour,CLAY,2,Agustin Calleri,Juan Ignacio Chela,Agustin Calleri,7-6(9); 6-2; 6-3,F,143,11,3,43,95,33,43,31,52,3,5,15,64,95,2,4,50,94,32,50,20,44,4,9,14,52,94
2006-07-24 00:00:00.000,Los Angeles CA; U.S.A. ATP World Tour,HARD,2,Andy Roddick,Rik De Voest,Andy Roddick,6-4; 6-4,R32,67,9,0,39,56,32,39,11,17,5,5,10,43,56,3,4,37,67,27,37,15,30,3,5,10,42,67
2006-07-24 00:00:00.000,Los Angeles CA; U.S.A. ATP World Tour,HARD,2,Scott Oudsema,Benjamin Becker,Scott Oudsema,7-5; 6-3,R32,75,17,1,35,65,27,35,17,30,1,2,11,44,65,11,3,22,53,19,22,16,31,3,6,10,35,53
2006-07-24 00:00:00.000,Los Angeles CA; U.S.A. ATP World Tour,HARD,2,Sam Querrey,Vincent Spadea,Sam Querrey,7-5; 6-4,R32,70,8,3,29,60,26,29,15,31,1,2,11,41,60,4,2,31,62,21,31,20,31,2,5,11,41,62
2006-07-24 00:00:00.000,Los Angeles CA; U.S.A. ATP World Tour,HARD,2,Dmitry Tursunov,Danai Udomchoke,Dmitry Tursunov,7-6(5); 7-6(4),R32,118,16,3,43,88,35,43,23,45,3,5,12,58,88,6,5,56,104,41,56,23,48,9,11,12,64,104
2006-07-24 00:00:00.000,Los Angeles CA; U.S.A. ATP World Tour,HARD,2,Fernando Gonzalez,Gilles Muller,Fernando Gonzalez,7-6(5); 7-6(5),R32,88,6,1,54,73,46,54,13,19,1,1,12,59,73,14,3,43,74,36,43,21,31,2,2,12,57,74
2006-07-24 00:00:00.000,Los Angeles CA; U.S.A. ATP World Tour,HARD,2,Marat Safin,Mardy Fish,Marat Safin,6-4; 7-5,R32,80,8,1,43,62,34,43,12,19,3,4,11,46,62,2,1,27,60,21,27,18,33,4,7,11,39,60
2006-07-24 00:00:00.000,Los Angeles CA; U.S.A. ATP World Tour,HARD,2,George Bastl,Nicolas Mahut,George Bastl,6-3; 7-6(1),R32,98,10,3,34,69,24,34,21,35,0,2,11,45,69,4,2,35,59,21,35,11,24,3,6,10,32,59
2006-07-24 00:00:00.000,Los Angeles CA; U.S.A. ATP World Tour,HARD,2,Andre Agassi,Xavier Malisse,Andre Agassi,7-6(10); 6-0,R32,81,6,0,38,63,29,38,16,25,4,5,9,45,63,4,4,39,75,25,39,15,36,4,8,9,40,75
2006-07-24 00:00:00.000,Los Angeles CA; U.S.A. ATP World Tour,HARD,2,Dominik Hrbaty,Zack Fleishman,Dominik Hrbaty,7-5; 7-5,R32,83,8,4,37,68,29,37,21,31,4,5,12,50,68,8,5,37,76,30,37,15,39,4,7,12,45,76
2006-07-24 00:00:00.000,Los Angeles CA; U.S.A. ATP World Tour,HARD,2,Lars Burgsmuller,Michael Yani,Lars Burgsmuller,6-4; 3-6; 6-3,R32,139,5,4,63,101,43,63,17,38,8,12,14,60,101,9,5,50,95,32,50,19,45,4,9,14,51,95
2006-07-24 00:00:00.000,Los Angeles CA; U.S.A. ATP World Tour,HARD,2,Kenneth Carlsen,Paradorn Srichaphan,Kenneth Carlsen,6-2; 5-7; 7-6(3),R32,125,10,2,54,92,41,54,19,38,1,5,16,60,92,10,7,50,89,37,50,19,39,1,6,16,56,89
2006-07-24 00:00:00.000,Los Angeles CA; U.S.A. ATP World Tour,HARD,2,Robby Ginepri,Justin Gimelstob,Robby Ginepri,6-4; 6-4,R32,78,3,2,32,54,24,32,15,22,3,4,10,39,54,6,1,34,67,23,34,16,33,7,10,10,39,67
2006-07-24 00:00:00.000,Los Angeles CA; U.S.A. ATP World Tour,HARD,2,Tommy Haas,Wayne Arthurs,Tommy Haas,6-4; 6-4,R32,59,5,1,31,46,27,31,13,15,0,0,10,40,46,12,1,34,55,27,34,12,21,2,4,10,39,55
2006-07-24 00:00:00.000,Los Angeles CA; U.S.A. ATP World Tour,HARD,2,Paul Capdeville,Arnaud Clement,Paul Capdeville,6-4; 3-6; 6-4,R32,151,6,5,52,94,32,52,16,42,4,10,14,48,94,2,6,52,106,27,52,28,54,9,16,15,55,106
2006-07-24 00:00:00.000,Los Angeles CA; U.S.A. ATP World Tour,HARD,2,Igor Kunitsyn,Janko Tipsarevic,Igor Kunitsyn,4-6; 6-1; 6-2,R32,119,3,3,36,84,27,36,28,48,5,7,13,55,84,3,2,40,93,25,40,24,53,12,17,12,49,93
2006-07-24 00:00:00.000,Los Angeles CA; U.S.A. ATP World Tour,HARD,2,Paul Goldstein,Lleyton Hewitt,Paul Goldstein,6-4; 6-4,R32,83,8,2,39,67,29,39,13,28,6,8,10,42,67,5,3,26,63,17,26,15,37,4,8,10,32,63
2006-07-24 00:00:00.000,Los Angeles CA; U.S.A. ATP World Tour,HARD,2,Andy Roddick,Scott Oudsema,Andy Roddick,6-7(3); 6-3; 6-2,R16,101,21,2,59,83,49,59,14,24,0,0,15,63,83,9,2,53,90,40,53,17,37,1,4,14,57,90
2006-07-24 00:00:00.000,Los Angeles CA; U.S.A. ATP World Tour,HARD,2,Dmitry Tursunov,Sam Querrey,Dmitry Tursunov,7-5; 6-4,R16,79,12,7,43,77,34,43,19,34,2,2,11,53,77,8,2,35,66,22,35,20,31,3,5,11,42,66
2006-07-24 00:00:00.000,Los Angeles CA; U.S.A. ATP World Tour,HARD,2,Fernando Gonzalez,Marat Safin,Fernando Gonzalez,6-4; 7-5,R16,69,3,2,40,53,31,40,8,13,2,2,9,39,53,8,3,41,59,30,41,5,18,5,8,9,35,59
2006-07-24 00:00:00.000,Los Angeles CA; U.S.A. ATP World Tour,HARD,2,Andre Agassi,George Bastl,Andre Agassi,6-7(4); 6-2; 6-1,R16,102,18,2,50,79,44,50,14,29,3,4,14,58,79,6,4,42,81,28,42,16,39,2,7,13,44,81
2006-07-24 00:00:00.000,Los Angeles CA; U.S.A. ATP World Tour,HARD,2,Dominik Hrbaty,Lars Burgsmuller,Dominik Hrbaty,7-5; 6-4,R16,87,6,2,37,69,29,37,13,32,5,8,11,42,69,1,5,33,68,18,33,17,35,4,9,11,35,68
2006-07-24 00:00:00.000,Los Angeles CA; U.S.A. ATP World Tour,HARD,2,Robby Ginepri,Kenneth Carlsen,Robby Ginepri,7-6(5); 3-6; 6-4,R16,124,5,0,64,86,45,64,13,22,4,8,15,58,86,18,2,58,102,49,58,15,44,4,8,16,64,102
2006-07-24 00:00:00.000,Los Angeles CA; U.S.A. ATP World Tour,HARD,2,Tommy Haas,Paul Capdeville,Tommy Haas,6-3; 4-6; 6-1,R16,94,13,4,37,69,31,37,18,32,1,3,13,49,69,2,2,56,79,36,56,7,23,5,10,13,43,79
2006-07-24 00:00:00.000,Los Angeles CA; U.S.A. ATP World Tour,HARD,2,Paul Goldstein,Igor Kunitsyn,Paul Goldstein,6-4; 6-4,R16,85,4,3,35,53,26,35,7,18,2,5,10,33,53,2,1,45,72,23,45,11,27,4,9,10,34,72
2006-07-24 00:00:00.000,Los Angeles CA; U.S.A. ATP World Tour,HARD,2,Dmitry Tursunov,Andy Roddick,Dmitry Tursunov,W/O,Q,0,0,0,0,0,0,0,0,0,0,0,0,0,0,0,0,0,0,0,0,0,0,0,0,0,0,0
2006-07-24 00:00:00.000,Los Angeles CA; U.S.A. ATP World Tour,HARD,2,Fernando Gonzalez,Andre Agassi,Fernando Gonzalez,6-4; 3-6; 7-5,Q,108,7,0,64,84,49,64,12,20,4,5,15,61,84,6,2,43,89,33,43,27,46,3,5,16,60,89
2006-07-24 00:00:00.000,Los Angeles CA; U.S.A. ATP World Tour,HARD,2,Dominik Hrbaty,Robby Ginepri,Dominik Hrbaty,7-6(0); 6-2,Q,80,1,4,38,65,29,38,13,27,2,4,10,42,65,6,2,41,68,26,41,9,27,1,5,10,35,68
2006-07-24 00:00:00.000,Los Angeles CA; U.S.A. ATP World Tour,HARD,2,Tommy Haas,Paul Goldstein,Tommy Haas,6-3; 6-4,Q,85,8,3,39,66,29,39,17,27,3,3,10,46,66,4,1,30,61,23,30,14,31,3,5,9,37,61
2006-07-24 00:00:00.000,Los Angeles CA; U.S.A. ATP World Tour,HARD,2,Dmitry Tursunov,Fernando Gonzalez,Dmitry Tursunov,6-4; 6-2,S,65,6,0,30,49,24,30,12,19,0,0,9,36,49,3,2,37,51,25,37,5,14,1,4,9,30,51
2006-07-24 00:00:00.000,Los Angeles CA; U.S.A. ATP World Tour,HARD,2,Tommy Haas,Dominik Hrbaty,Tommy Haas,6-2; 7-5,S,74,9,1,28,44,27,28,13,16,0,0,10,40,44,3,2,38,67,27,38,13,29,7,10,10,40,67
2006-07-24 00:00:00.000,Los Angeles CA; U.S.A. ATP World Tour,HARD,2,Tommy Haas,Dmitry Tursunov,Tommy Haas,4-6; 7-5; 6-3,F,124,12,5,55,92,47,55,20,37,2,3,16,67,92,10,4,51,92,40,51,22,41,5,7,15,62,92
2006-07-24 00:00:00.000,Umag Croatia ATP World Tour,CLAY,2,Carlos Berlocq,Stefano Galvani,Carlos Berlocq,6-2; 6-2,R32,68,1,0,34,45,24,34,7,11,3,4,8,31,45,0,4,20,42,11,20,7,22,0,5,8,18,42
2006-07-24 00:00:00.000,Umag Croatia ATP World Tour,CLAY,2,Juan-Pablo Guzman,Guillermo Garcia-Lopez,Juan-Pablo Guzman,4-6; 6-3; 6-4,R32,142,1,6,66,108,44,66,22,42,5,7,15,66,108,5,1,53,87,33,53,20,34,8,11,14,53,87
2006-07-24 00:00:00.000,Umag Croatia ATP World Tour,CLAY,2,Simon Greul,Alessio Di Mauro,Simon Greul,7-5; 7-6(5),R32,135,2,5,47,91,35,47,20,44,6,9,12,55,91,1,3,50,88,38,50,14,38,7,11,12,52,88
2006-07-24 00:00:00.000,Umag Croatia ATP World Tour,CLAY,2,Carlos Moya,Jiri Novak,Carlos Moya,6-4; 6-7(6); 7-6(3),R32,153,10,2,60,118,43,60,36,58,7,8,17,79,118,7,3,75,113,54,75,22,38,4,6,17,76,113
2006-07-24 00:00:00.000,Umag Croatia ATP World Tour,CLAY,2,Novak Djokovic,Luka Belic,Novak Djokovic,6-3; 6-3,R32,60,3,2,34,46,25,34,7,12,0,2,9,32,46,3,2,33,53,21,33,8,20,6,11,9,29,53
2006-07-24 00:00:00.000,Umag Croatia ATP World Tour,CLAY,2,Stefano Ianni,Teymuraz Gabashvili,Stefano Ianni,6-6(4) RET,R32,57,3,4,34,51,22,34,8,17,4,6,6,30,51,1,1,21,35,14,21,8,14,2,4,6,22,35
2006-07-24 00:00:00.000,Umag Croatia ATP World Tour,CLAY,2,Jiri Vanek,Santiago Ventura,Jiri Vanek,7-5; 6-4,R32,80,1,1,46,62,33,46,9,16,2,3,11,42,62,1,2,41,71,24,41,20,30,4,7,11,44,71
2006-07-24 00:00:00.000,Umag Croatia ATP World Tour,CLAY,2,Lukas Dlouhy,Julien Benneteau,Lukas Dlouhy,2-6; 6-3; 6-2,R32,110,4,3,53,85,31,53,22,32,5,8,13,53,85,2,5,47,74,33,47,8,27,5,9,12,41,74
2006-07-24 00:00:00.000,Umag Croatia ATP World Tour,CLAY,2,Stanislas Wawrinka,Alberto Martin,Stanislas Wawrinka,7-6(3); 6-4,R32,114,3,3,42,80,29,42,21,38,2,4,11,50,80,2,3,40,79,27,40,20,39,4,7,11,47,79
2006-07-24 00:00:00.000,Umag Croatia ATP World Tour,CLAY,2,Marin Cilic,Evgeny Korolev,Marin Cilic,6-7(5); 6-4; 6-3,R32,167,10,6,53,106,43,53,24,53,5,8,16,67,106,4,8,53,119,38,53,27,66,10,15,15,65,119
2006-07-24 00:00:00.000,Umag Croatia ATP World Tour,CLAY,2,Juan Martin Del Potro,Raemon Sluiter,Juan Martin Del Potro,6-3; 6-2,R32,59,6,3,36,48,30,36,7,12,2,2,9,37,48,2,1,25,42,17,25,8,17,0,3,8,25,42
2006-07-24 00:00:00.000,Umag Croatia ATP World Tour,CLAY,2,Robin Vik,Guillermo Coria,Robin Vik,6-2; 6-3,R32,70,2,6,29,59,17,29,12,30,2,6,9,29,59,1,12,23,49,11,23,5,26,2,9,8,16,49
2006-07-24 00:00:00.000,Umag Croatia ATP World Tour,CLAY,2,Filippo Volandri,Marc Gicquel,Filippo Volandri,6-1 RET,R32,26,1,3,15,22,12,15,3,7,2,3,4,15,22,1,2,10,22,6,10,2,12,3,6,3,8,22
2006-07-24 00:00:00.000,Umag Croatia ATP World Tour,CLAY,2,Ruben Ramirez Hidalgo,Fernando Vicente,Ruben Ramirez Hidalgo,5-7; 6-0; 6-1,R32,96,2,1,44,68,36,44,14,24,6,8,13,50,68,5,1,45,69,27,45,11,24,6,12,12,38,69
2006-07-24 00:00:00.000,Umag Croatia ATP World Tour,CLAY,2,Jan Hernych,Flavio Cipolla,Jan Hernych,6-2; 6-1,R32,72,1,0,41,52,31,41,3,11,2,3,8,34,52,1,2,31,47,14,31,7,16,4,9,7,21,47
2006-07-24 00:00:00.000,Umag Croatia ATP World Tour,CLAY,2,Albert Portas,Juan Carlos Ferrero,Albert Portas,7-6(4); 6-7(5); 7-5,R32,168,15,7,68,121,52,68,21,53,10,14,18,73,121,6,4,93,133,59,93,19,40,6,11,18,78,133
2006-07-24 00:00:00.000,Umag Croatia ATP World Tour,CLAY,2,Juan-Pablo Guzman,Carlos Berlocq,Juan-Pablo Guzman,3-6; 6-3; 6-2,R16,133,0,3,64,90,43,64,15,26,8,10,13,58,90,3,1,53,84,32,53,17,31,4,8,13,49,84
2006-07-24 00:00:00.000,Umag Croatia ATP World Tour,CLAY,2,Carlos Moya,Simon Greul,Carlos Moya,6-2; 6-1,R16,60,4,1,33,57,26,33,9,24,4,6,8,35,57,0,3,19,37,7,19,5,18,2,8,7,12,37
2006-07-24 00:00:00.000,Umag Croatia ATP World Tour,CLAY,2,Novak Djokovic,Stefano Ianni,Novak Djokovic,6-3; 6-4,R16,172,3,1,35,56,29,35,12,21,3,4,10,41,56,0,4,26,57,19,26,13,31,5,8,9,32,57
2006-07-24 00:00:00.000,Umag Croatia ATP World Tour,CLAY,2,Jiri Vanek,Lukas Dlouhy,Jiri Vanek,7-6(4); 6-4,R16,107,7,7,51,82,33,51,14,31,4,8,11,47,82,4,6,56,88,34,56,12,32,12,17,11,46,88
2006-07-24 00:00:00.000,Umag Croatia ATP World Tour,CLAY,2,Stanislas Wawrinka,Marin Cilic,Stanislas Wawrinka,6-4; 2-6; 6-4,R16,139,5,5,65,95,43,65,12,30,11,15,14,55,95,4,3,55,84,38,55,14,29,2,6,14,52,84
2006-07-24 00:00:00.000,Umag Croatia ATP World Tour,CLAY,2,Juan Martin Del Potro,Robin Vik,Juan Martin Del Potro,2-6; 6-4; 6-3,R16,121,3,4,70,94,40,70,11,24,4,9,14,51,94,3,1,46,72,32,46,10,26,1,6,13,42,72
2006-07-24 00:00:00.000,Umag Croatia ATP World Tour,CLAY,2,Filippo Volandri,Ruben Ramirez Hidalgo,Filippo Volandri,4-6; 7-6(4); 7-6(5),R16,183,0,4,74,117,43,74,23,43,2,9,17,66,117,8,7,59,113,44,59,21,54,5,11,17,65,113
2006-07-24 00:00:00.000,Umag Croatia ATP World Tour,CLAY,2,Albert Portas,Jan Hernych,Albert Portas,5-7; 6-4; 6-2,R16,125,5,5,51,93,41,51,19,42,6,9,15,60,93,3,2,56,88,36,56,15,32,6,11,15,51,88
2006-07-24 00:00:00.000,Umag Croatia ATP World Tour,CLAY,2,Carlos Moya,Juan-Pablo Guzman,Carlos Moya,6-1; 6-4,Q,72,2,3,25,50,23,25,13,25,0,1,9,36,50,2,2,31,55,21,31,7,24,3,7,8,28,55
2006-07-24 00:00:00.000,Umag Croatia ATP World Tour,CLAY,2,Novak Djokovic,Jiri Vanek,Novak Djokovic,6-1; 3-6; 7-5,Q,110,6,6,45,80,29,45,18,35,3,8,14,47,80,3,1,52,79,31,52,10,27,3,10,14,41,79
2006-07-24 00:00:00.000,Umag Croatia ATP World Tour,CLAY,2,Stanislas Wawrinka,Juan Martin Del Potro,Stanislas Wawrinka,6-1; 2-6; 6-4,Q,118,2,1,46,81,31,46,19,35,4,7,13,50,81,1,0,57,67,34,57,4,10,1,5,12,38,67
2006-07-24 00:00:00.000,Umag Croatia ATP World Tour,CLAY,2,Filippo Volandri,Albert Portas,Filippo Volandri,7-6(4); 6-4,Q,98,1,3,59,77,36,59,9,18,4,7,11,45,77,8,3,30,67,21,30,19,37,4,8,11,40,67
2006-07-24 00:00:00.000,Umag Croatia ATP World Tour,CLAY,2,Novak Djokovic,Carlos Moya,Novak Djokovic,6-1; 7-5,S,82,0,3,41,61,30,41,11,20,2,3,10,41,61,3,0,30,50,14,30,12,20,2,6,9,26,50
2006-07-24 00:00:00.000,Umag Croatia ATP World Tour,CLAY,2,Stanislas Wawrinka,Filippo Volandri,Stanislas Wawrinka,7-5; 2-6; 6-4,S,124,4,2,42,81,27,42,14,39,3,10,15,41,81,1,1,63,88,34,63,13,25,4,11,15,47,88
2006-07-24 00:00:00.000,Umag Croatia ATP World Tour,CLAY,2,Stanislas Wawrinka,Novak Djokovic,Stanislas Wawrinka,6-6(1) RET,F,73,0,1,26,45,17,26,9,19,3,5,6,26,45,0,1,29,45,20,29,7,16,7,9,6,27,45
2006-07-31 00:00:00.000,Sopot Poland ATP World Tour,CLAY,2,Nikolay Davydenko,Christophe Rochus,Nikolay Davydenko,6-1; 6-2,R32,54,6,2,26,41,22,26,10,15,0,0,8,32,41,0,1,33,49,19,33,4,16,1,5,7,23,49
2006-07-31 00:00:00.000,Sopot Poland ATP World Tour,CLAY,2,Juan Monaco,Jurgen Melzer,Juan Monaco,2-6; 7-6(2); 6-4,R32,138,1,3,68,89,43,68,7,21,2,9,15,50,89,7,4,72,119,43,72,19,47,12,18,15,62,119
2006-07-31 00:00:00.000,Sopot Poland ATP World Tour,CLAY,2,Carlos Berlocq,Philipp Kohlschreiber,Carlos Berlocq,6-0; 6-2,R32,60,5,0,34,47,27,34,5,13,1,1,7,32,47,1,2,22,44,10,22,8,22,3,8,7,18,44
2006-07-31 00:00:00.000,Sopot Poland ATP World Tour,CLAY,2,Lukas Dlouhy,Ruben Ramirez Hidalgo,Lukas Dlouhy,6-4; 6-2,R32,63,4,1,29,54,23,29,15,25,1,1,9,38,54,1,1,33,50,20,33,9,17,0,3,9,29,50
2006-07-31 00:00:00.000,Sopot Poland ATP World Tour,CLAY,2,Gaston Gaudio,Boris Pashanski,Gaston Gaudio,6-1; 6-7(4); 6-4,R32,141,6,4,69,94,46,69,16,25,5,8,15,62,94,2,7,45,101,30,45,24,56,8,14,14,54,101
2006-07-31 00:00:00.000,Sopot Poland ATP World Tour,CLAY,2,Oliver Marach,Alexander Waske,Oliver Marach,6-4; 7-6(6),R32,100,5,2,36,73,29,36,21,37,2,3,11,50,73,14,4,38,67,31,38,13,29,2,4,11,44,67
2006-07-31 00:00:00.000,Sopot Poland ATP World Tour,CLAY,2,Guillermo Garcia-Lopez,Mariano Zabaleta,Guillermo Garcia-Lopez,7-6(4); 7-5,R32,131,1,3,51,75,34,51,15,24,1,4,12,49,75,5,2,82,118,51,82,12,36,17,21,12,63,118
2006-07-31 00:00:00.000,Sopot Poland ATP World Tour,CLAY,2,Filippo Volandri,Daniel Gimeno-Traver,Filippo Volandri,6-4; 6-1,R32,60,0,1,35,46,27,35,7,11,1,2,9,34,46,1,2,22,48,16,22,8,26,3,7,8,24,48
2006-07-31 00:00:00.000,Sopot Poland ATP World Tour,CLAY,2,Agustin Calleri,Hugo Armando,Agustin Calleri,6-4; 2-6; 7-6(4),R32,132,8,4,58,97,43,58,19,39,6,9,15,62,97,1,1,83,112,54,83,16,29,11,13,15,70,112
2006-07-31 00:00:00.000,Sopot Poland ATP World Tour,CLAY,2,Raemon Sluiter,Grzegorz Panfil,Raemon Sluiter,6-1; 6-3,R32,65,9,3,21,47,18,21,16,26,2,2,7,34,47,4,0,28,45,15,28,7,17,0,4,8,22,45
2006-07-31 00:00:00.000,Sopot Poland ATP World Tour,CLAY,2,Jiri Vanek,Alessio Di Mauro,Jiri Vanek,7-6(3); 6-0,R32,96,0,3,43,55,30,43,4,12,0,2,9,34,55,3,2,39,70,22,39,12,31,5,10,9,34,70
2006-07-31 00:00:00.000,Sopot Poland ATP World Tour,CLAY,2,Michal Przysiezny,Guillermo Coria,Michal Przysiezny,5-6 RET,R32,66,0,2,24,43,12,24,7,19,7,11,6,19,43,0,9,22,37,13,22,4,15,2,5,5,17,37
2006-07-31 00:00:00.000,Sopot Poland ATP World Tour,CLAY,2,Juan Ignacio Chela,Adrian Garcia,Juan Ignacio Chela,6-3; 6-2,R32,78,5,0,44,66,34,44,12,22,2,2,9,46,66,1,0,28,52,16,28,12,24,2,5,8,28,52
2006-07-31 00:00:00.000,Sopot Poland ATP World Tour,CLAY,2,Martin Vassallo Arguello,Marcos Daniel,Martin Vassallo Arguello,6-4; 2-0 RET,R32,80,2,0,17,26,15,17,5,9,0,1,6,20,26,0,3,33,56,18,33,10,23,6,9,6,28,56
2006-07-31 00:00:00.000,Sopot Poland ATP World Tour,CLAY,2,Florian Mayer,Lukasz Kubot,Florian Mayer,6-1; 6-2,R32,52,8,1,26,41,23,26,9,15,0,0,8,32,41,0,7,24,46,13,24,7,22,5,9,7,20,46
2006-07-31 00:00:00.000,Sopot Poland ATP World Tour,CLAY,2,Tommy Robredo,Ivo Minar,Tommy Robredo,7-6(5); 3-6; 6-4,R32,143,1,1,71,99,43,71,12,28,3,8,15,55,99,2,1,86,129,54,86,17,43,10,15,16,71,129
2006-07-31 00:00:00.000,Sopot Poland ATP World Tour,CLAY,2,Nikolay Davydenko,Juan Monaco,Nikolay Davydenko,7-5; 6-7(7); 6-1,R16,165,4,2,74,104,55,74,14,30,4,6,15,69,104,3,4,81,122,53,81,17,41,14,20,16,70,122
2006-07-31 00:00:00.000,Sopot Poland ATP World Tour,CLAY,2,Carlos Berlocq,Lukas Dlouhy,Carlos Berlocq,5-7; 7-5; 6-0,R16,121,0,0,81,95,48,81,9,14,1,4,15,57,95,6,4,54,85,34,54,15,31,2,8,15,49,85
2006-07-31 00:00:00.000,Sopot Poland ATP World Tour,CLAY,2,Oliver Marach,Gaston Gaudio,Oliver Marach,5-7; 6-4; 7-6(4),R16,161,11,3,61,111,42,61,25,50,4,8,17,67,111,5,3,66,102,48,66,17,36,0,4,17,65,102
2006-07-31 00:00:00.000,Sopot Poland ATP World Tour,CLAY,2,Filippo Volandri,Guillermo Garcia-Lopez,Filippo Volandri,6-3; 3-6; 6-4,R16,117,0,3,83,99,51,83,7,16,6,9,14,58,99,3,4,56,87,34,56,18,31,3,7,14,52,87
2006-07-31 00:00:00.000,Sopot Poland ATP World Tour,CLAY,2,Agustin Calleri,Raemon Sluiter,Agustin Calleri,6-4; 6-4,R16,75,9,2,35,64,29,35,15,29,5,5,10,44,64,1,2,22,54,16,22,20,32,0,2,10,36,54
2006-07-31 00:00:00.000,Sopot Poland ATP World Tour,CLAY,2,Michal Przysiezny,Jiri Vanek,Michal Przysiezny,6-3; 6-1,R16,66,1,1,32,49,21,32,12,17,0,1,8,33,49,3,1,40,51,18,40,5,11,3,8,8,23,51
2006-07-31 00:00:00.000,Sopot Poland ATP World Tour,CLAY,2,Juan Ignacio Chela,Martin Vassallo Arguello,Juan Ignacio Chela,6-2; 6-1,R16,75,1,0,19,37,15,19,14,18,1,1,7,29,37,0,0,43,52,21,43,3,9,3,8,8,24,52
2006-07-31 00:00:00.000,Sopot Poland ATP World Tour,CLAY,2,Florian Mayer,Tommy Robredo,Florian Mayer,6-2; 6-4,R16,70,4,1,35,58,27,35,10,23,5,7,9,37,58,1,0,34,53,16,34,9,19,3,8,9,25,53
2006-07-31 00:00:00.000,Sopot Poland ATP World Tour,CLAY,2,Nikolay Davydenko,Carlos Berlocq,Nikolay Davydenko,6-0; 6-4,Q,77,2,1,33,42,26,33,6,9,0,0,8,32,42,2,0,36,62,19,36,12,26,4,8,8,31,62
2006-07-31 00:00:00.000,Sopot Poland ATP World Tour,CLAY,2,Filippo Volandri,Oliver Marach,Filippo Volandri,6-2; 6-3,Q,88,0,0,47,58,26,47,6,11,6,9,8,32,58,0,4,28,72,14,28,17,44,12,19,9,31,72
2006-07-31 00:00:00.000,Sopot Poland ATP World Tour,CLAY,2,Agustin Calleri,Michal Przysiezny,Agustin Calleri,6-4; 6-2,Q,89,5,2,31,50,26,31,11,19,1,1,9,37,50,2,2,33,63,21,33,14,30,4,7,9,35,63
2006-07-31 00:00:00.000,Sopot Poland ATP World Tour,CLAY,2,Florian Mayer,Juan Ignacio Chela,Florian Mayer,6-4; 6-0,Q,61,4,1,31,43,23,31,9,12,0,0,8,32,43,1,3,32,59,17,32,13,27,7,11,8,30,59
2006-07-31 00:00:00.000,Sopot Poland ATP World Tour,CLAY,2,Nikolay Davydenko,Filippo Volandri,Nikolay Davydenko,6-2; 6-4,S,73,1,1,42,60,30,42,5,18,5,8,9,35,60,0,1,39,59,18,39,6,20,5,11,9,24,59
2006-07-31 00:00:00.000,Sopot Poland ATP World Tour,CLAY,2,Florian Mayer,Agustin Calleri,Florian Mayer,6-2; 4-3 RET,S,56,2,1,22,33,20,22,9,11,0,0,7,29,33,4,1,39,58,28,39,4,19,5,8,8,32,58
2006-07-31 00:00:00.000,Sopot Poland ATP World Tour,CLAY,2,Nikolay Davydenko,Florian Mayer,Nikolay Davydenko,7-6(6); 5-7; 6-4,F,154,2,1,66,106,37,66,25,40,6,11,17,62,106,5,4,87,138,58,87,18,51,11,16,17,76,138
2006-07-31 00:00:00.000,Washington DC; U.S.A. ATP World Tour,HARD,2,James Blake,N/A Bye,James Blake,,R64,0,0,0,0,0,0,0,0,0,0,0,0,0,0,0,0,0,0,0,0,0,0,0,0,0,0,0
2006-07-31 00:00:00.000,Washington DC; U.S.A. ATP World Tour,HARD,2,Kevin Kim,Scott Oudsema,Kevin Kim,6-1; 6-3,R64,61,3,1,21,36,21,21,11,15,0,0,8,32,36,3,4,29,50,20,29,4,21,5,9,8,24,50
2006-07-31 00:00:00.000,Washington DC; U.S.A. ATP World Tour,HARD,2,Marat Safin,Igor Kunitsyn,Marat Safin,6-3; 7-6(6),R64,81,10,4,40,70,34,40,21,30,2,2,11,55,70,1,3,37,64,30,37,15,27,3,4,10,45,64
2006-07-31 00:00:00.000,Washington DC; U.S.A. ATP World Tour,HARD,2,Nicolas Mahut,N/A Bye,Nicolas Mahut,,R64,0,0,0,0,0,0,0,0,0,0,0,0,0,0,0,0,0,0,0,0,0,0,0,0,0,0,0
2006-07-31 00:00:00.000,Washington DC; U.S.A. ATP World Tour,HARD,2,Paradorn Srichaphan,N/A Bye,Paradorn Srichaphan,,R64,0,0,0,0,0,0,0,0,0,0,0,0,0,0,0,0,0,0,0,0,0,0,0,0,0,0,0
2006-07-31 00:00:00.000,Washington DC; U.S.A. ATP World Tour,HARD,2,Kenneth Carlsen,Danai Udomchoke,Kenneth Carlsen,6-1; 6-2,R64,72,10,2,25,51,22,25,14,26,4,4,8,36,51,3,3,31,51,17,31,7,20,3,7,7,24,51
2006-07-31 00:00:00.000,Washington DC; U.S.A. ATP World Tour,HARD,2,Wesley Moodie,Sam Querrey,Wesley Moodie,2-6; 7-6(4); 7-6(6),R64,136,10,1,71,105,52,71,20,34,3,5,16,72,105,19,4,61,111,50,61,28,50,5,5,16,78,111
2006-07-31 00:00:00.000,Washington DC; U.S.A. ATP World Tour,HARD,2,Sebastien Grosjean,N/A Bye,Sebastien Grosjean,,R64,0,0,0,0,0,0,0,0,0,0,0,0,0,0,0,0,0,0,0,0,0,0,0,0,0,0,0
2006-07-31 00:00:00.000,Washington DC; U.S.A. ATP World Tour,HARD,2,Lleyton Hewitt,N/A Bye,Lleyton Hewitt,,R64,0,0,0,0,0,0,0,0,0,0,0,0,0,0,0,0,0,0,0,0,0,0,0,0,0,0,0
2006-07-31 00:00:00.000,Washington DC; U.S.A. ATP World Tour,HARD,2,Vincent Spadea,Roko Karanusic,Vincent Spadea,7-5; 1-0 RET,R64,43,4,3,24,36,21,24,3,12,0,2,7,24,36,1,1,26,38,13,26,7,12,3,6,6,20,38
2006-07-31 00:00:00.000,Washington DC; U.S.A. ATP World Tour,HARD,2,Denis Gremelmayr,Wesley Whitehouse,Denis Gremelmayr,6-2; 6-2,R64,52,6,1,32,42,25,32,6,10,2,3,8,31,42,3,3,26,43,14,26,2,17,0,5,8,16,43
2006-07-31 00:00:00.000,Washington DC; U.S.A. ATP World Tour,HARD,2,Bjorn Phau,N/A Bye,Bjorn Phau,,R64,0,0,0,0,0,0,0,0,0,0,0,0,0,0,0,0,0,0,0,0,0,0,0,0,0,0,0
2006-07-31 00:00:00.000,Washington DC; U.S.A. ATP World Tour,HARD,2,Arnaud Clement,N/A Bye,Arnaud Clement,,R64,0,0,0,0,0,0,0,0,0,0,0,0,0,0,0,0,0,0,0,0,0,0,0,0,0,0,0
2006-07-31 00:00:00.000,Washington DC; U.S.A. ATP World Tour,HARD,2,Ryan Sweeting,Justin Gimelstob,Ryan Sweeting,7-6(7); 6-2,R64,99,7,0,35,67,27,35,21,32,6,6,10,48,67,8,3,38,71,28,38,16,33,4,6,10,44,71
2006-07-31 00:00:00.000,Washington DC; U.S.A. ATP World Tour,HARD,2,Gilles Muller,Paul Capdeville,Gilles Muller,3-6; 7-6(7); 4-0 RET,R64,116,15,9,50,84,41,50,14,34,1,2,12,55,84,7,3,55,91,38,55,18,36,4,6,13,56,91
2006-07-31 00:00:00.000,Washington DC; U.S.A. ATP World Tour,HARD,2,Dominik Hrbaty,N/A Bye,Dominik Hrbaty,,R64,0,0,0,0,0,0,0,0,0,0,0,0,0,0,0,0,0,0,0,0,0,0,0,0,0,0,0
2006-07-31 00:00:00.000,Washington DC; U.S.A. ATP World Tour,HARD,2,Andy Murray,N/A Bye,Andy Murray,,R64,0,0,0,0,0,0,0,0,0,0,0,0,0,0,0,0,0,0,0,0,0,0,0,0,0,0,0
2006-07-31 00:00:00.000,Washington DC; U.S.A. ATP World Tour,HARD,2,Ramon Delgado,Peter Luczak,Ramon Delgado,6-4; 6-4,R64,89,17,2,39,64,32,39,14,25,0,0,10,46,64,6,1,32,62,23,32,16,30,2,4,10,39,62
2006-07-31 00:00:00.000,Washington DC; U.S.A. ATP World Tour,HARD,2,Teymuraz Gabashvili,Jean-Christophe Faurel,Teymuraz Gabashvili,6-3; 6-3,R64,68,9,1,23,47,21,23,16,24,0,0,9,37,47,3,2,41,66,27,41,11,25,3,6,9,38,66
2006-07-31 00:00:00.000,Washington DC; U.S.A. ATP World Tour,HARD,2,Feliciano Lopez,N/A Bye,Feliciano Lopez,,R64,0,0,0,0,0,0,0,0,0,0,0,0,0,0,0,0,0,0,0,0,0,0,0,0,0,0,0
2006-07-31 00:00:00.000,Washington DC; U.S.A. ATP World Tour,HARD,2,Mardy Fish,N/A Bye,Mardy Fish,,R64,0,0,0,0,0,0,0,0,0,0,0,0,0,0,0,0,0,0,0,0,0,0,0,0,0,0,0
2006-07-31 00:00:00.000,Washington DC; U.S.A. ATP World Tour,HARD,2,Tomas Zib,Jean-Rene Lisnard,Tomas Zib,7-5; 6-4,R64,107,9,2,43,77,31,43,17,34,6,8,11,48,77,5,6,31,63,24,31,14,32,2,6,11,38,63
2006-07-31 00:00:00.000,Washington DC; U.S.A. ATP World Tour,HARD,2,Andrea Stoppini,Paul Goldstein,Andrea Stoppini,6-3; 6-2,R64,73,4,3,38,62,27,38,8,24,5,8,9,35,62,3,4,31,56,13,31,10,25,4,10,8,23,56
2006-07-31 00:00:00.000,Washington DC; U.S.A. ATP World Tour,HARD,2,Andre Agassi,N/A Bye,Andre Agassi,,R64,0,0,0,0,0,0,0,0,0,0,0,0,0,0,0,0,0,0,0,0,0,0,0,0,0,0,0
2006-07-31 00:00:00.000,Washington DC; U.S.A. ATP World Tour,HARD,2,Dmitry Tursunov,N/A Bye,Dmitry Tursunov,,R64,0,0,0,0,0,0,0,0,0,0,0,0,0,0,0,0,0,0,0,0,0,0,0,0,0,0,0
2006-07-31 00:00:00.000,Washington DC; U.S.A. ATP World Tour,HARD,2,Edgardo Massa,Somdev Devvarman,Edgardo Massa,6-4; 6-0,R64,74,5,5,24,46,20,24,10,22,2,4,8,30,46,0,1,40,66,19,40,9,26,9,15,8,28,66
2006-07-31 00:00:00.000,Washington DC; U.S.A. ATP World Tour,HARD,2,Hyung-Taik Lee,Frank Dancevic,Hyung-Taik Lee,2-6; 6-3; 6-2,R64,86,4,2,47,75,36,47,12,28,6,9,13,48,75,6,4,33,66,22,33,18,33,2,6,12,40,66
2006-07-31 00:00:00.000,Washington DC; U.S.A. ATP World Tour,HARD,2,Julien Benneteau,N/A Bye,Julien Benneteau,,R64,0,0,0,0,0,0,0,0,0,0,0,0,0,0,0,0,0,0,0,0,0,0,0,0,0,0,0
2006-07-31 00:00:00.000,Washington DC; U.S.A. ATP World Tour,HARD,2,Tim Henman,N/A Bye,Tim Henman,,R64,0,0,0,0,0,0,0,0,0,0,0,0,0,0,0,0,0,0,0,0,0,0,0,0,0,0,0
2006-07-31 00:00:00.000,Washington DC; U.S.A. ATP World Tour,HARD,2,Phillip King,Bobby Reynolds,Phillip King,7-6(5); 3-6; 6-3,R64,133,10,4,46,97,37,46,22,51,6,11,15,59,97,7,10,56,109,40,56,25,53,6,11,15,65,109
2006-07-31 00:00:00.000,Washington DC; U.S.A. ATP World Tour,HARD,2,Janko Tipsarevic,Michael Venus,Janko Tipsarevic,6-2; 6-1,R64,51,3,1,20,33,19,20,9,13,0,0,7,28,33,5,2,26,55,17,26,8,29,4,9,8,25,55
2006-07-31 00:00:00.000,Washington DC; U.S.A. ATP World Tour,HARD,2,Jan-Michael Gambill,N/A Bye,Jan-Michael Gambill,,R64,0,0,0,0,0,0,0,0,0,0,0,0,0,0,0,0,0,0,0,0,0,0,0,0,0,0,0
2006-07-31 00:00:00.000,Washington DC; U.S.A. ATP World Tour,HARD,2,James Blake,Kevin Kim,James Blake,7-5; 3-6; 6-2,R32,107,4,4,46,90,32,46,21,44,3,8,15,53,90,3,5,37,90,28,37,23,53,7,13,14,51,90
2006-07-31 00:00:00.000,Washington DC; U.S.A. ATP World Tour,HARD,2,Marat Safin,Nicolas Mahut,Marat Safin,6-3; 5-7; 6-4,R32,128,12,3,53,86,44,53,20,33,1,2,16,64,86,12,8,55,94,44,55,18,39,3,5,15,62,94
2006-07-31 00:00:00.000,Washington DC; U.S.A. ATP World Tour,HARD,2,Kenneth Carlsen,Paradorn Srichaphan,Kenneth Carlsen,4-6; 7-6(6); 6-3,R32,147,10,2,60,92,51,60,14,32,3,5,16,65,92,7,9,45,108,32,45,36,63,5,7,15,68,108
2006-07-31 00:00:00.000,Washington DC; U.S.A. ATP World Tour,HARD,2,Wesley Moodie,Sebastien Grosjean,Wesley Moodie,6-4; 3-6; 6-3,R32,111,7,2,52,74,44,52,11,22,0,1,14,55,74,7,2,44,82,31,44,21,38,4,6,14,52,82
2006-07-31 00:00:00.000,Washington DC; U.S.A. ATP World Tour,HARD,2,Lleyton Hewitt,Vincent Spadea,Lleyton Hewitt,6-7(3); 7-6(5); 6-4,R32,152,10,5,53,105,42,53,25,52,2,6,17,67,105,4,7,67,121,44,67,29,54,11,16,17,73,121
2006-07-31 00:00:00.000,Washington DC; U.S.A. ATP World Tour,HARD,2,Denis Gremelmayr,Bjorn Phau,Denis Gremelmayr,6-4; 6-3,R32,74,5,3,35,67,27,35,16,32,4,5,10,43,67,1,5,22,54,16,22,13,32,3,6,9,29,54
2006-07-31 00:00:00.000,Washington DC; U.S.A. ATP World Tour,HARD,2,Arnaud Clement,Ryan Sweeting,Arnaud Clement,6-2; 6-1,R32,60,5,4,29,58,25,29,15,29,5,5,8,40,58,2,2,18,38,8,18,11,20,2,6,7,19,38
2006-07-31 00:00:00.000,Washington DC; U.S.A. ATP World Tour,HARD,2,Dominik Hrbaty,Gilles Muller,Dominik Hrbaty,4-6; 6-4; 6-3,R32,110,5,4,64,98,48,64,16,34,9,11,14,64,98,21,4,51,85,39,51,16,34,3,7,15,55,85
2006-07-31 00:00:00.000,Washington DC; U.S.A. ATP World Tour,HARD,2,Andy Murray,Ramon Delgado,Andy Murray,6-4; 6-3,R32,92,13,6,33,72,26,33,16,39,2,4,9,42,72,4,4,32,56,17,32,11,24,3,8,10,28,56
2006-07-31 00:00:00.000,Washington DC; U.S.A. ATP World Tour,HARD,2,Feliciano Lopez,Teymuraz Gabashvili,Feliciano Lopez,6-4; 6-4,R32,98,11,1,39,72,29,39,18,33,2,3,10,47,72,6,6,27,63,19,27,19,36,5,8,10,38,63
2006-07-31 00:00:00.000,Washington DC; U.S.A. ATP World Tour,HARD,2,Mardy Fish,Tomas Zib,Mardy Fish,6-4; 6-4,R32,82,13,2,24,52,23,24,18,28,1,1,10,41,52,6,5,38,68,27,38,15,30,3,5,10,42,68
2006-07-31 00:00:00.000,Washington DC; U.S.A. ATP World Tour,HARD,2,Andrea Stoppini,Andre Agassi,Andrea Stoppini,6-4; 6-3,R32,61,8,0,35,57,30,35,13,22,4,4,10,43,57,6,7,27,60,20,27,16,33,6,8,9,36,60
2006-07-31 00:00:00.000,Washington DC; U.S.A. ATP World Tour,HARD,2,Dmitry Tursunov,Edgardo Massa,Dmitry Tursunov,3-6; 6-1; 3-3 RET,R32,84,14,4,33,66,28,33,15,33,1,3,11,43,66,2,3,45,71,29,45,11,26,8,11,11,40,71
2006-07-31 00:00:00.000,Washington DC; U.S.A. ATP World Tour,HARD,2,Hyung-Taik Lee,Julien Benneteau,Hyung-Taik Lee,6-3; 6-4,R32,87,6,1,36,61,26,36,16,25,4,5,10,42,61,8,6,40,68,28,40,9,28,6,9,9,37,68
2006-07-31 00:00:00.000,Washington DC; U.S.A. ATP World Tour,HARD,2,Tim Henman,Phillip King,Tim Henman,6-7(3); 6-3; 7-5,R32,153,10,3,62,109,51,62,29,47,4,4,17,80,109,9,1,53,101,39,53,32,48,4,6,16,71,101
2006-07-31 00:00:00.000,Washington DC; U.S.A. ATP World Tour,HARD,2,Jan-Michael Gambill,Janko Tipsarevic,Jan-Michael Gambill,2-6; 6-3; 6-0,R32,90,17,6,44,75,33,44,17,31,6,8,12,50,75,6,8,30,68,22,30,16,38,4,8,11,38,68
2006-07-31 00:00:00.000,Washington DC; U.S.A. ATP World Tour,HARD,2,Marat Safin,James Blake,Marat Safin,7-6(6); 7-6(5),R16,113,10,2,49,89,37,49,17,40,2,5,12,54,89,3,6,52,93,39,52,14,41,6,9,12,53,93
2006-07-31 00:00:00.000,Washington DC; U.S.A. ATP World Tour,HARD,2,Wesley Moodie,Kenneth Carlsen,Wesley Moodie,6-3; 6-7(5); 7-6(6),R16,173,17,3,100,135,72,100,17,35,7,8,17,89,135,13,4,59,109,47,59,26,50,5,7,16,73,109
2006-07-31 00:00:00.000,Washington DC; U.S.A. ATP World Tour,HARD,2,Lleyton Hewitt,Denis Gremelmayr,Lleyton Hewitt,6-1; 6-4,R16,62,5,0,22,38,18,22,14,16,0,0,8,32,38,5,1,32,64,19,32,15,32,6,10,9,34,64
2006-07-31 00:00:00.000,Washington DC; U.S.A. ATP World Tour,HARD,2,Arnaud Clement,Dominik Hrbaty,Arnaud Clement,6-3; 6-2,R16,74,9,2,37,58,28,37,12,21,2,2,9,40,58,2,2,25,50,14,25,14,25,2,5,8,28,50
2006-07-31 00:00:00.000,Washington DC; U.S.A. ATP World Tour,HARD,2,Andy Murray,Feliciano Lopez,Andy Murray,7-5; 6-2,R16,75,2,6,25,62,22,25,24,37,4,4,10,46,62,6,6,34,58,25,34,10,24,3,6,10,35,58
2006-07-31 00:00:00.000,Washington DC; U.S.A. ATP World Tour,HARD,2,Mardy Fish,Andrea Stoppini,Mardy Fish,6-3; 6-1,R16,54,7,1,20,38,17,20,15,18,0,0,8,32,38,2,3,37,55,16,37,11,18,4,8,8,27,55
2006-07-31 00:00:00.000,Washington DC; U.S.A. ATP World Tour,HARD,2,Dmitry Tursunov,Hyung-Taik Lee,Dmitry Tursunov,6-7(10); 7-5; 6-3,R16,146,14,3,59,114,44,59,34,55,5,7,17,78,114,2,2,87,117,63,87,12,30,9,13,16,75,117
2006-07-31 00:00:00.000,Washington DC; U.S.A. ATP World Tour,HARD,2,Tim Henman,Jan-Michael Gambill,Tim Henman,6-1; 6-3,R16,73,7,0,29,52,22,29,12,23,4,5,8,34,52,6,8,21,57,15,21,12,36,4,9,8,27,57
2006-07-31 00:00:00.000,Washington DC; U.S.A. ATP World Tour,HARD,2,Marat Safin,Wesley Moodie,Marat Safin,7-6(5); 7-6(9),Q,118,7,0,45,76,39,45,25,31,0,0,12,64,76,11,5,70,96,56,70,12,26,3,3,12,68,96
2006-07-31 00:00:00.000,Washington DC; U.S.A. ATP World Tour,HARD,2,Arnaud Clement,Lleyton Hewitt,Arnaud Clement,7-6(1); 6-4,Q,130,11,2,47,91,31,47,25,44,12,14,11,56,91,7,3,34,82,23,34,22,48,5,8,11,45,82
2006-07-31 00:00:00.000,Washington DC; U.S.A. ATP World Tour,HARD,2,Andy Murray,Mardy Fish,Andy Murray,6-2; 6-4,Q,77,0,4,34,59,23,34,15,25,4,5,9,38,59,1,2,24,51,16,24,11,27,2,6,9,27,51
2006-07-31 00:00:00.000,Washington DC; U.S.A. ATP World Tour,HARD,2,Dmitry Tursunov,Tim Henman,Dmitry Tursunov,6-3; 6-2,Q,65,7,4,30,55,24,30,14,25,0,0,9,38,55,2,0,29,54,17,29,14,25,6,9,8,31,54
2006-07-31 00:00:00.000,Washington DC; U.S.A. ATP World Tour,HARD,2,Arnaud Clement,Marat Safin,Arnaud Clement,7-6(5); 7-6(4),S,122,4,1,45,74,36,45,19,29,3,5,12,55,74,9,5,52,90,36,52,19,38,7,9,12,55,90
2006-07-31 00:00:00.000,Washington DC; U.S.A. ATP World Tour,HARD,2,Andy Murray,Dmitry Tursunov,Andy Murray,6-2; 7-5,S,84,1,2,26,58,18,26,20,32,1,2,10,38,58,4,4,32,63,20,32,13,31,5,9,10,33,63
2006-07-31 00:00:00.000,Washington DC; U.S.A. ATP World Tour,HARD,2,Arnaud Clement,Andy Murray,Arnaud Clement,7-6(3); 6-2,F,103,1,2,32,61,22,32,19,29,2,4,10,41,61,9,2,35,67,23,35,14,32,4,8,10,37,67
2006-08-07 00:00:00.000,ATP Masters Series Canada Toronto; Canada ATP World Tour,HARD,2,Roger Federer,Paul-Henri Mathieu,Roger Federer,6-3; 6-4,R64,74,14,0,24,48,21,24,19,24,0,0,10,40,48,2,2,32,60,20,32,16,28,4,6,9,36,60
2006-08-07 00:00:00.000,ATP Masters Series Canada Toronto; Canada ATP World Tour,HARD,2,Sebastien Grosjean,Florent Serra,Sebastien Grosjean,6-3; 6-2,R64,73,3,0,24,53,20,24,18,29,2,3,9,38,53,0,2,26,53,13,26,12,27,1,5,8,25,53
2006-08-07 00:00:00.000,ATP Masters Series Canada Toronto; Canada ATP World Tour,HARD,2,Dmitry Tursunov,Daniele Bracciali,Dmitry Tursunov,4-6; 6-1; 6-4,R64,109,10,1,36,76,30,36,21,40,1,3,14,51,76,5,1,46,84,30,46,21,38,5,9,13,51,84
2006-08-07 00:00:00.000,ATP Masters Series Canada Toronto; Canada ATP World Tour,HARD,2,Tommy Haas,Max Mirnyi,Tommy Haas,6-3; 6-3,R64,73,4,2,33,46,30,33,6,13,0,0,9,36,46,2,3,43,70,27,43,12,27,10,13,9,39,70
2006-08-07 00:00:00.000,ATP Masters Series Canada Toronto; Canada ATP World Tour,HARD,2,Lleyton Hewitt,Juan Ignacio Chela,Lleyton Hewitt,3-6; 6-2; 7-5,R64,156,2,5,58,110,41,58,23,52,10,15,15,64,110,6,1,58,104,39,58,17,46,10,16,14,56,104
2006-08-07 00:00:00.000,ATP Masters Series Canada Toronto; Canada ATP World Tour,HARD,2,Thomas Johansson,Feliciano Lopez,Thomas Johansson,5-7; 6-4; 6-3,R64,122,8,3,60,100,48,60,19,40,9,11,16,67,100,19,6,46,82,40,46,14,36,2,5,15,54,82
2006-08-07 00:00:00.000,ATP Masters Series Canada Toronto; Canada ATP World Tour,HARD,2,Paradorn Srichaphan,Gilles Simon,Paradorn Srichaphan,6-4; 6-2,R64,76,3,3,26,51,22,26,14,25,0,1,9,36,51,2,0,30,62,16,30,15,32,7,11,9,31,62
2006-08-07 00:00:00.000,ATP Masters Series Canada Toronto; Canada ATP World Tour,HARD,2,Xavier Malisse,Nikolay Davydenko,Xavier Malisse,6-3; 7-5,R64,91,5,2,43,66,33,43,13,23,5,6,11,46,66,1,1,41,63,26,41,11,22,1,4,10,37,63
2006-08-07 00:00:00.000,ATP Masters Series Canada Toronto; Canada ATP World Tour,HARD,2,Ivan Ljubicic,Nicolas Almagro,Ivan Ljubicic,7-5; 6-1,R64,88,10,3,33,61,27,33,17,28,3,4,10,44,61,10,5,41,72,26,41,12,31,8,12,9,38,72
2006-08-07 00:00:00.000,ATP Masters Series Canada Toronto; Canada ATP World Tour,HARD,2,Arnaud Clement,Alberto Martin,Arnaud Clement,6-2; 6-1,R64,64,1,1,30,42,26,30,7,12,0,0,8,33,42,3,3,37,61,24,37,6,24,6,10,7,30,61
2006-08-07 00:00:00.000,ATP Masters Series Canada Toronto; Canada ATP World Tour,HARD,2,Juan Carlos Ferrero,Paul Goldstein,Juan Carlos Ferrero,7-5; 6-2,R64,98,9,2,37,66,26,37,16,29,5,7,10,42,66,2,1,40,71,25,40,12,31,6,11,10,37,71
2006-08-07 00:00:00.000,ATP Masters Series Canada Toronto; Canada ATP World Tour,HARD,2,Fernando Gonzalez,Robin Soderling,Fernando Gonzalez,6-3; 4-6; 6-2,R64,117,10,7,65,101,45,65,21,36,7,8,14,66,101,6,1,50,80,33,50,17,30,7,10,13,50,80
2006-08-07 00:00:00.000,ATP Masters Series Canada Toronto; Canada ATP World Tour,HARD,2,Julien Benneteau,Marcos Baghdatis,Julien Benneteau,5-7; 6-2; 6-3,R64,132,2,4,65,94,42,65,17,29,10,14,15,59,94,5,1,40,79,23,40,18,39,4,10,14,41,79
2006-08-07 00:00:00.000,ATP Masters Series Canada Toronto; Canada ATP World Tour,HARD,2,Dominik Hrbaty,Robert Kendrick,Dominik Hrbaty,6-4; 6-4,R64,95,6,4,47,80,31,47,22,33,9,9,10,53,80,10,3,55,89,35,55,17,34,8,10,10,52,89
2006-08-07 00:00:00.000,ATP Masters Series Canada Toronto; Canada ATP World Tour,HARD,2,Jose Acasuso,Bjorn Phau,Jose Acasuso,7-5; 7-6(18),R64,121,4,3,40,86,36,40,31,46,5,5,12,67,86,1,3,43,93,33,43,33,50,4,5,12,66,93
2006-08-07 00:00:00.000,ATP Masters Series Canada Toronto; Canada ATP World Tour,HARD,2,Tommy Robredo,Marat Safin,Tommy Robredo,7-5; 5-7; 6-2,R64,133,4,5,67,106,46,67,17,39,6,10,16,63,106,3,7,37,78,27,37,15,41,1,7,16,42,78
2006-08-07 00:00:00.000,ATP Masters Series Canada Toronto; Canada ATP World Tour,HARD,2,Denis Gremelmayr,Kristof Vliegen,Denis Gremelmayr,7-6(2); 6-2,R64,73,3,0,33,58,25,33,20,25,0,0,10,45,58,5,2,45,67,26,45,16,22,3,5,10,42,67
2006-08-07 00:00:00.000,ATP Masters Series Canada Toronto; Canada ATP World Tour,HARD,2,Carlos Moya,Gaston Gaudio,Carlos Moya,6-1; 6-4,R64,72,8,2,31,60,22,31,20,29,3,3,9,42,60,1,6,41,62,28,41,6,21,5,8,8,34,62
2006-08-07 00:00:00.000,ATP Masters Series Canada Toronto; Canada ATP World Tour,HARD,2,Tim Henman,Jonas Bjorkman,Tim Henman,6-2; 6-3,R64,81,1,0,37,52,25,37,10,15,1,1,8,35,52,1,3,27,56,17,27,13,29,2,6,9,30,56
2006-08-07 00:00:00.000,ATP Masters Series Canada Toronto; Canada ATP World Tour,HARD,2,Andy Murray,David Ferrer,Andy Murray,6-2; 7-6(6),R64,97,7,1,31,68,25,31,18,37,2,4,10,43,68,1,3,43,80,23,43,18,37,10,14,10,41,80
2006-08-07 00:00:00.000,ATP Masters Series Canada Toronto; Canada ATP World Tour,HARD,2,Jarkko Nieminen,Teymuraz Gabashvili,Jarkko Nieminen,6-4; 7-5,R64,76,5,4,41,76,30,41,17,35,8,10,11,47,76,2,2,34,54,22,34,13,20,0,4,11,35,54
2006-08-07 00:00:00.000,ATP Masters Series Canada Toronto; Canada ATP World Tour,HARD,2,Frank Dancevic,Peter Polansky,Frank Dancevic,7-6(3); 6-3,R64,81,8,0,44,69,36,44,15,25,2,2,11,51,69,5,3,53,75,39,53,10,22,7,8,10,49,75
2006-08-07 00:00:00.000,ATP Masters Series Canada Toronto; Canada ATP World Tour,HARD,2,Jan Hernych,Nicolas Mahut,Jan Hernych,6-3; 6-3,R64,81,3,0,34,49,25,34,14,15,2,2,9,39,49,3,3,42,65,26,42,11,23,7,10,9,37,65
2006-08-07 00:00:00.000,ATP Masters Series Canada Toronto; Canada ATP World Tour,HARD,2,Davide Sanguinetti,David Nalbandian,Davide Sanguinetti,6-1; 6-2,R64,59,6,2,26,43,21,26,12,17,1,1,8,33,43,0,2,24,47,10,24,11,23,5,9,7,21,47
2006-08-07 00:00:00.000,ATP Masters Series Canada Toronto; Canada ATP World Tour,HARD,2,James Blake,Philip Bester,James Blake,6-4; 6-1,R64,56,4,2,22,41,18,22,14,19,0,0,8,32,41,1,3,36,57,18,36,11,21,4,8,9,29,57
2006-08-07 00:00:00.000,ATP Masters Series Canada Toronto; Canada ATP World Tour,HARD,2,Richard Gasquet,Fabrice Santoro,Richard Gasquet,6-4; 6-3,R64,70,2,3,30,51,24,30,11,21,0,1,9,35,51,3,5,33,56,24,33,8,23,3,7,10,32,56
2006-08-07 00:00:00.000,ATP Masters Series Canada Toronto; Canada ATP World Tour,HARD,2,Fernando Verdasco,Rajeev Ram,Fernando Verdasco,3-6; 6-1; 6-4,R64,84,5,2,52,68,39,52,11,16,0,1,13,50,68,2,1,51,74,38,51,8,23,0,3,13,46,74
2006-08-07 00:00:00.000,ATP Masters Series Canada Toronto; Canada ATP World Tour,HARD,2,Kevin Kim,Robby Ginepri,Kevin Kim,3-6; 7-5; 6-3,R64,97,3,2,59,86,45,59,15,27,5,7,15,60,86,4,2,53,80,39,53,15,27,0,3,15,54,80
2006-08-07 00:00:00.000,ATP Masters Series Canada Toronto; Canada ATP World Tour,HARD,2,Tomas Berdych,Daniel Nestor,Tomas Berdych,6-4; 7-5,R64,93,4,4,33,55,29,33,12,22,0,1,11,41,55,8,5,38,80,27,38,20,42,4,7,11,47,80
2006-08-07 00:00:00.000,ATP Masters Series Canada Toronto; Canada ATP World Tour,HARD,2,Mikhail Youzhny,Greg Rusedski,Mikhail Youzhny,6-4; 6-2,R64,74,3,2,41,64,33,41,12,23,5,5,9,45,64,2,2,33,51,21,33,9,18,3,6,9,30,51
2006-08-07 00:00:00.000,ATP Masters Series Canada Toronto; Canada ATP World Tour,HARD,2,Hyung-Taik Lee,Alejandro Falla,Hyung-Taik Lee,6-0; 6-7(5); 6-1,R64,109,2,3,49,85,34,49,25,36,5,6,13,59,85,2,2,41,72,25,41,13,31,4,10,12,38,72
2006-08-07 00:00:00.000,ATP Masters Series Canada Toronto; Canada ATP World Tour,HARD,2,Rafael Nadal,Nicolas Massu,Rafael Nadal,6-3; 6-2,R64,109,0,1,33,61,23,33,16,28,7,8,8,39,61,4,5,32,64,23,32,8,32,1,6,9,31,64
2006-08-07 00:00:00.000,ATP Masters Series Canada Toronto; Canada ATP World Tour,HARD,2,Roger Federer,Sebastien Grosjean,Roger Federer,6-3; 6-3,R32,67,3,2,31,56,24,31,16,25,7,8,9,40,56,3,0,29,56,17,29,13,27,3,7,9,30,56
2006-08-07 00:00:00.000,ATP Masters Series Canada Toronto; Canada ATP World Tour,HARD,2,Dmitry Tursunov,Tommy Haas,Dmitry Tursunov,7-5; 2-6; 6-1,R32,112,9,3,44,88,34,44,25,44,3,5,14,59,88,6,7,48,84,33,48,17,36,5,8,13,50,84
2006-08-07 00:00:00.000,ATP Masters Series Canada Toronto; Canada ATP World Tour,HARD,2,Thomas Johansson,Lleyton Hewitt,Thomas Johansson,6-3; 3-2 RET,R32,56,8,2,31,49,24,31,8,18,4,5,7,32,49,6,2,21,42,12,21,11,21,4,7,7,23,42
2006-08-07 00:00:00.000,ATP Masters Series Canada Toronto; Canada ATP World Tour,HARD,2,Xavier Malisse,Paradorn Srichaphan,Xavier Malisse,7-6(3); 6-3,R32,91,1,1,36,70,28,36,23,34,4,4,11,51,70,5,2,34,63,25,34,18,29,1,2,10,43,63
2006-08-07 00:00:00.000,ATP Masters Series Canada Toronto; Canada ATP World Tour,HARD,2,Ivan Ljubicic,Arnaud Clement,Ivan Ljubicic,7-6(6); 6-4,R32,121,10,2,37,73,31,37,19,36,2,3,11,50,73,1,2,47,81,34,47,17,34,4,6,11,51,81
2006-08-07 00:00:00.000,ATP Masters Series Canada Toronto; Canada ATP World Tour,HARD,2,Fernando Gonzalez,Juan Carlos Ferrero,Fernando Gonzalez,6-2; 6-1,R32,58,6,4,25,37,22,25,5,12,0,1,7,27,37,2,2,27,47,12,27,7,20,1,7,8,19,47
2006-08-07 00:00:00.000,ATP Masters Series Canada Toronto; Canada ATP World Tour,HARD,2,Julien Benneteau,Dominik Hrbaty,Julien Benneteau,7-6(2); 5-7; 6-1,R32,149,8,4,71,111,45,71,17,40,7,13,16,62,111,2,6,49,90,26,49,19,41,3,10,15,45,90
2006-08-07 00:00:00.000,ATP Masters Series Canada Toronto; Canada ATP World Tour,HARD,2,Jose Acasuso,Tommy Robredo,Jose Acasuso,2-6; 6-3; 6-4,R32,101,1,3,37,74,32,37,18,37,4,7,14,50,74,7,1,38,66,30,38,13,28,1,4,13,43,66
2006-08-07 00:00:00.000,ATP Masters Series Canada Toronto; Canada ATP World Tour,HARD,2,Carlos Moya,Denis Gremelmayr,Carlos Moya,6-1; 6-4,R32,54,8,0,30,49,26,30,13,19,1,1,9,39,49,3,3,30,53,21,30,9,23,5,8,8,30,53
2006-08-07 00:00:00.000,ATP Masters Series Canada Toronto; Canada ATP World Tour,HARD,2,Andy Murray,Tim Henman,Andy Murray,6-2; 7-6(3),R32,105,0,6,40,72,31,40,10,32,4,7,10,41,72,4,4,53,90,28,53,15,37,12,17,10,43,90
2006-08-07 00:00:00.000,ATP Masters Series Canada Toronto; Canada ATP World Tour,HARD,2,Jarkko Nieminen,Frank Dancevic,Jarkko Nieminen,6-2; 6-3,R32,71,1,0,31,50,21,31,14,19,0,2,9,35,50,1,1,29,50,14,29,9,21,4,9,8,23,50
2006-08-07 00:00:00.000,ATP Masters Series Canada Toronto; Canada ATP World Tour,HARD,2,Davide Sanguinetti,Jan Hernych,Davide Sanguinetti,6-4; 7-6(4),R32,92,5,2,41,78,29,41,20,37,3,6,11,49,78,1,1,49,70,29,49,12,21,4,8,11,41,70
2006-08-07 00:00:00.000,ATP Masters Series Canada Toronto; Canada ATP World Tour,HARD,2,Richard Gasquet,James Blake,Richard Gasquet,6-4; 6-3,R32,73,1,3,37,59,21,37,9,22,4,8,10,30,59,0,0,29,56,16,29,9,27,2,8,9,25,56
2006-08-07 00:00:00.000,ATP Masters Series Canada Toronto; Canada ATP World Tour,HARD,2,Fernando Verdasco,Kevin Kim,Fernando Verdasco,6-3; 6-2,R32,67,6,3,46,60,37,46,5,14,5,5,9,42,60,2,1,30,52,19,30,11,22,1,4,8,30,52
2006-08-07 00:00:00.000,ATP Masters Series Canada Toronto; Canada ATP World Tour,HARD,2,Tomas Berdych,Mikhail Youzhny,Tomas Berdych,7-6(3); 6-4,R32,103,6,1,48,79,34,48,14,31,3,5,11,48,79,7,2,40,72,27,40,16,32,4,7,11,43,72
2006-08-07 00:00:00.000,ATP Masters Series Canada Toronto; Canada ATP World Tour,HARD,2,Rafael Nadal,Hyung-Taik Lee,Rafael Nadal,6-4; 6-3,R32,88,2,1,34,54,26,34,8,20,1,3,9,34,54,1,0,38,61,22,38,8,23,5,10,10,30,61
2006-08-07 00:00:00.000,ATP Masters Series Canada Toronto; Canada ATP World Tour,HARD,2,Roger Federer,Dmitry Tursunov,Roger Federer,6-3; 5-7; 6-0,R16,107,8,1,61,92,45,61,16,31,6,7,14,61,92,1,1,51,82,31,51,17,31,9,13,13,48,82
2006-08-07 00:00:00.000,ATP Masters Series Canada Toronto; Canada ATP World Tour,HARD,2,Xavier Malisse,Thomas Johansson,Xavier Malisse,7-6(7); 6-3,R16,95,3,2,50,73,40,50,13,23,6,7,11,53,73,5,3,46,73,32,46,16,27,6,8,10,48,73
2006-08-07 00:00:00.000,ATP Masters Series Canada Toronto; Canada ATP World Tour,HARD,2,Fernando Gonzalez,Ivan Ljubicic,Fernando Gonzalez,6-4; 6-7(4); 7-6(3),R16,184,7,3,72,115,50,72,30,43,6,7,17,80,115,21,5,81,133,60,81,25,52,9,11,17,85,133
2006-08-07 00:00:00.000,ATP Masters Series Canada Toronto; Canada ATP World Tour,HARD,2,Jose Acasuso,Julien Benneteau,Jose Acasuso,6-3; 7-6(4),R16,94,9,0,32,62,25,32,26,30,3,3,11,51,62,4,2,44,65,35,44,9,21,1,2,10,44,65
2006-08-07 00:00:00.000,ATP Masters Series Canada Toronto; Canada ATP World Tour,HARD,2,Andy Murray,Carlos Moya,Andy Murray,6-2; 6-4,R16,77,0,7,30,55,20,30,14,25,1,3,9,34,55,3,2,30,56,16,30,10,26,3,8,9,26,56
2006-08-07 00:00:00.000,ATP Masters Series Canada Toronto; Canada ATP World Tour,HARD,2,Jarkko Nieminen,Davide Sanguinetti,Jarkko Nieminen,3-6; 6-3; 7-6(10),R16,130,3,2,69,105,42,69,21,36,4,7,15,63,105,6,1,54,103,39,54,21,49,3,6,15,60,103
2006-08-07 00:00:00.000,ATP Masters Series Canada Toronto; Canada ATP World Tour,HARD,2,Richard Gasquet,Fernando Verdasco,Richard Gasquet,6-0; 4-6; 6-2,R16,97,1,2,44,69,31,44,16,25,1,3,12,47,69,4,6,54,76,32,54,7,22,6,12,12,39,76
2006-08-07 00:00:00.000,ATP Masters Series Canada Toronto; Canada ATP World Tour,HARD,2,Tomas Berdych,Rafael Nadal,Tomas Berdych,6-1; 3-6; 6-2,R16,109,3,3,45,72,37,45,13,27,3,4,12,50,72,3,1,45,71,30,45,11,26,2,6,12,41,71
2006-08-07 00:00:00.000,ATP Masters Series Canada Toronto; Canada ATP World Tour,HARD,2,Roger Federer,Xavier Malisse,Roger Federer,7-6(4); 6-7(5); 6-3,Q,147,2,3,70,110,47,70,25,40,5,8,17,72,110,4,2,61,112,41,61,27,51,4,8,16,68,112
2006-08-07 00:00:00.000,ATP Masters Series Canada Toronto; Canada ATP World Tour,HARD,2,Fernando Gonzalez,Jose Acasuso,Fernando Gonzalez,6-1; 7-5,Q,81,3,1,43,63,31,43,13,20,3,4,10,44,63,2,4,37,67,25,37,10,30,8,12,9,35,67
2006-08-07 00:00:00.000,ATP Masters Series Canada Toronto; Canada ATP World Tour,HARD,2,Andy Murray,Jarkko Nieminen,Andy Murray,6-4; 6-7(0); 6-3,Q,148,6,9,41,112,26,41,34,71,9,14,15,60,112,1,6,67,114,40,67,15,47,8,16,16,55,114
2006-08-07 00:00:00.000,ATP Masters Series Canada Toronto; Canada ATP World Tour,HARD,2,Richard Gasquet,Tomas Berdych,Richard Gasquet,6-4; 6-1,Q,65,4,3,24,43,22,24,11,19,0,0,8,33,43,3,2,31,54,17,31,13,23,4,8,9,30,54
2006-08-07 00:00:00.000,ATP Masters Series Canada Toronto; Canada ATP World Tour,HARD,2,Roger Federer,Fernando Gonzalez,Roger Federer,6-1; 5-7; 6-3,S,110,3,3,54,81,39,54,18,27,4,5,14,57,81,1,3,60,88,37,60,17,28,6,10,14,54,88
2006-08-07 00:00:00.000,ATP Masters Series Canada Toronto; Canada ATP World Tour,HARD,2,Richard Gasquet,Andy Murray,Richard Gasquet,6-2; 7-5,S,84,5,3,39,61,32,39,9,22,4,5,10,41,61,1,2,28,61,13,28,20,33,3,7,10,33,61
2006-08-07 00:00:00.000,ATP Masters Series Canada Toronto; Canada ATP World Tour,HARD,2,Roger Federer,Richard Gasquet,Roger Federer,2-6; 6-3; 6-2,F,107,6,4,50,88,37,50,18,38,8,10,13,55,88,2,3,44,77,32,44,15,33,8,11,12,47,77
2006-08-14 00:00:00.000,ATP Masters Series Cincinnati OH; U.S.A. ATP World Tour,HARD,2,Roger Federer,Paradorn Srichaphan,Roger Federer,7-5; 6-4,R64,84,10,3,46,73,35,46,10,27,2,4,11,45,73,5,4,36,70,26,36,12,34,1,5,11,38,70
2006-08-14 00:00:00.000,ATP Masters Series Cincinnati OH; U.S.A. ATP World Tour,HARD,2,Andy Murray,Tim Henman,Andy Murray,4-6; 6-4; 7-5,R64,145,10,5,54,99,41,54,21,45,5,8,16,62,99,5,3,52,96,33,52,24,44,6,10,16,57,96
2006-08-14 00:00:00.000,ATP Masters Series Cincinnati OH; U.S.A. ATP World Tour,HARD,2,Dmitry Tursunov,Sebastien Grosjean,Dmitry Tursunov,4-6; 6-4; 6-3,R64,120,7,2,47,84,34,47,19,37,6,10,14,53,84,3,2,44,89,34,44,14,45,7,13,15,48,89
2006-08-14 00:00:00.000,ATP Masters Series Cincinnati OH; U.S.A. ATP World Tour,HARD,2,Robby Ginepri,Paul-Henri Mathieu,Robby Ginepri,1-6; 6-3; 6-4,R64,110,10,2,61,87,41,61,14,26,6,8,13,55,87,8,4,46,81,36,46,18,35,3,5,13,54,81
2006-08-14 00:00:00.000,ATP Masters Series Cincinnati OH; U.S.A. ATP World Tour,HARD,2,Andy Roddick,Daniele Bracciali,Andy Roddick,6-7(6); 7-6(4); 7-6(5),R64,154,22,3,77,119,61,77,28,42,2,2,18,89,119,19,2,66,122,58,66,33,56,7,7,18,91,122
2006-08-14 00:00:00.000,ATP Masters Series Cincinnati OH; U.S.A. ATP World Tour,HARD,2,Kristof Vliegen,Marc Gicquel,Kristof Vliegen,7-6(7); 7-6(3),R64,115,17,2,57,87,48,57,16,30,2,2,12,64,87,7,2,52,96,40,52,23,44,5,5,12,63,96
2006-08-14 00:00:00.000,ATP Masters Series Cincinnati OH; U.S.A. ATP World Tour,HARD,2,Vincent Spadea,Andreas Seppi,Vincent Spadea,6-4; 6-3,R64,90,1,3,49,94,30,49,25,45,8,9,10,55,94,4,3,34,65,19,34,16,31,7,10,9,35,65
2006-08-14 00:00:00.000,ATP Masters Series Cincinnati OH; U.S.A. ATP World Tour,HARD,2,Juan Ignacio Chela,Nikolay Davydenko,Juan Ignacio Chela,6-4; 2-6; 6-2,R64,100,5,3,49,74,34,49,13,25,3,6,13,47,74,3,1,51,76,34,51,11,25,1,5,13,45,76
2006-08-14 00:00:00.000,ATP Masters Series Cincinnati OH; U.S.A. ATP World Tour,HARD,2,David Nalbandian,Rik De Voest,David Nalbandian,6-0; 6-4,R64,68,1,4,22,45,21,22,13,23,0,0,8,34,45,2,2,22,45,14,22,10,23,1,5,8,24,45
2006-08-14 00:00:00.000,ATP Masters Series Cincinnati OH; U.S.A. ATP World Tour,HARD,2,Stanislas Wawrinka,Jose Acasuso,Stanislas Wawrinka,5-7; 6-4; 6-1,R64,107,8,5,40,76,35,40,20,36,2,4,15,55,76,4,2,29,76,21,29,27,47,2,6,14,48,76
2006-08-14 00:00:00.000,ATP Masters Series Cincinnati OH; U.S.A. ATP World Tour,HARD,2,Mardy Fish,Nicolas Mahut,Mardy Fish,6-1; 6-3,R64,73,12,2,21,42,20,21,12,21,0,0,8,32,42,5,3,30,51,19,30,6,21,3,7,8,25,51
2006-08-14 00:00:00.000,ATP Masters Series Cincinnati OH; U.S.A. ATP World Tour,HARD,2,Fernando Gonzalez,Nicolas Massu,Fernando Gonzalez,6-4; 6-4,R64,82,5,3,46,67,35,46,9,21,3,4,10,44,67,3,3,33,55,24,33,11,22,1,4,10,35,55
2006-08-14 00:00:00.000,ATP Masters Series Cincinnati OH; U.S.A. ATP World Tour,HARD,2,David Ferrer,Carlos Moya,David Ferrer,6-3; 6-1,R64,72,2,1,37,49,27,37,9,12,2,2,8,36,49,3,4,35,74,25,35,12,39,7,11,8,37,74
2006-08-14 00:00:00.000,ATP Masters Series Cincinnati OH; U.S.A. ATP World Tour,HARD,2,Nicolas Almagro,Alberto Martin,Nicolas Almagro,6-3; 6-3,R64,63,10,0,30,48,23,30,11,18,1,2,9,34,48,2,3,34,57,21,34,8,23,2,6,9,29,57
2006-08-14 00:00:00.000,ATP Masters Series Cincinnati OH; U.S.A. ATP World Tour,HARD,2,Gael Monfils,Marat Safin,Gael Monfils,6-4; 7-5,R64,87,3,5,38,84,28,38,27,46,7,7,11,55,84,4,1,33,53,28,33,12,20,1,3,11,40,53
2006-08-14 00:00:00.000,ATP Masters Series Cincinnati OH; U.S.A. ATP World Tour,HARD,2,Marcos Baghdatis,Thomas Johansson,Marcos Baghdatis,7-6(3); 7-6(3),R64,126,10,8,43,88,39,43,25,45,5,5,12,64,88,22,5,58,88,47,58,12,30,4,4,12,59,88
2006-08-14 00:00:00.000,ATP Masters Series Cincinnati OH; U.S.A. ATP World Tour,HARD,2,Tommy Robredo,Richard Gasquet,Tommy Robredo,7-5; 7-5,R64,99,4,2,46,75,37,46,18,29,2,2,12,55,75,2,2,49,78,36,49,14,29,2,4,12,50,78
2006-08-14 00:00:00.000,ATP Masters Series Cincinnati OH; U.S.A. ATP World Tour,HARD,2,Max Mirnyi,Xavier Malisse,Max Mirnyi,7-5; 4-6; 6-3,R64,105,9,2,60,86,49,60,15,26,1,2,16,64,86,6,0,59,90,44,59,15,31,3,5,15,59,90
2006-08-14 00:00:00.000,ATP Masters Series Cincinnati OH; U.S.A. ATP World Tour,HARD,2,Florent Serra,Julien Benneteau,Florent Serra,6-3; 6-3,R64,78,4,2,35,58,27,35,12,23,1,2,9,39,58,2,4,41,61,24,41,7,20,2,6,9,31,61
2006-08-14 00:00:00.000,ATP Masters Series Cincinnati OH; U.S.A. ATP World Tour,HARD,2,Novak Djokovic,Jarkko Nieminen,Novak Djokovic,7-6(5); 6-4,R64,102,5,4,44,82,29,44,25,38,3,3,11,54,82,3,0,51,78,37,51,12,27,1,2,11,49,78
2006-08-14 00:00:00.000,ATP Masters Series Cincinnati OH; U.S.A. ATP World Tour,HARD,2,Dominik Hrbaty,Paul Goldstein,Dominik Hrbaty,6-4; 6-3,R64,71,6,3,30,57,25,30,15,27,4,5,10,40,57,5,2,30,59,21,30,11,29,7,10,9,32,59
2006-08-14 00:00:00.000,ATP Masters Series Cincinnati OH; U.S.A. ATP World Tour,HARD,2,Davide Sanguinetti,Robin Vik,Davide Sanguinetti,6-3; 6-7(4); 6-3,R64,125,15,1,51,86,41,51,17,35,6,8,14,58,86,3,5,68,111,43,68,19,43,9,15,16,62,111
2006-08-14 00:00:00.000,ATP Masters Series Cincinnati OH; U.S.A. ATP World Tour,HARD,2,Mikhail Youzhny,Bjorn Phau,Mikhail Youzhny,6-2; 6-3,R64,60,2,0,23,44,18,23,15,21,0,0,8,33,44,3,4,36,64,19,36,13,28,5,9,9,32,64
2006-08-14 00:00:00.000,ATP Masters Series Cincinnati OH; U.S.A. ATP World Tour,HARD,2,Ivan Ljubicic,Greg Rusedski,Ivan Ljubicic,6-3; 6-4,R64,60,6,1,32,48,30,32,10,16,0,0,10,40,48,5,2,35,51,21,35,11,16,1,3,9,32,51
2006-08-14 00:00:00.000,ATP Masters Series Cincinnati OH; U.S.A. ATP World Tour,HARD,2,James Blake,Fabrice Santoro,James Blake,6-4; 6-4,R64,72,5,1,40,60,31,40,10,20,5,6,10,41,60,5,2,31,54,23,31,10,23,0,3,10,33,54
2006-08-14 00:00:00.000,ATP Masters Series Cincinnati OH; U.S.A. ATP World Tour,HARD,2,Juan Carlos Ferrero,Jonas Bjorkman,Juan Carlos Ferrero,6-6 RET,R64,52,2,0,22,31,21,22,5,9,1,1,6,26,31,1,1,19,34,15,19,11,15,3,3,6,26,34
2006-08-14 00:00:00.000,ATP Masters Series Cincinnati OH; U.S.A. ATP World Tour,HARD,2,Justin Gimelstob,Feliciano Lopez,Justin Gimelstob,6-3; 7-6(4),R64,95,5,3,48,73,38,48,14,25,3,4,11,52,73,6,1,37,72,26,37,19,35,8,10,10,45,72
2006-08-14 00:00:00.000,ATP Masters Series Cincinnati OH; U.S.A. ATP World Tour,HARD,2,Robin Soderling,Tomas Berdych,Robin Soderling,6-4; 6-3,R64,64,4,1,36,58,26,36,14,22,3,4,10,40,58,8,0,34,55,24,34,10,21,3,6,9,34,55
2006-08-14 00:00:00.000,ATP Masters Series Cincinnati OH; U.S.A. ATP World Tour,HARD,2,Tommy Haas,Fernando Verdasco,Tommy Haas,6-3; 6-4,R64,74,8,4,36,57,32,36,10,21,4,4,10,42,57,7,6,49,75,31,49,12,26,5,7,9,43,75
2006-08-14 00:00:00.000,ATP Masters Series Cincinnati OH; U.S.A. ATP World Tour,HARD,2,Gilles Simon,Lukas Dlouhy,Gilles Simon,6-4; 6-4,R64,63,2,3,31,60,22,31,17,29,0,1,10,39,60,2,4,36,57,25,36,9,21,1,4,10,34,57
2006-08-14 00:00:00.000,ATP Masters Series Cincinnati OH; U.S.A. ATP World Tour,HARD,2,Hyung-Taik Lee,Arnaud Clement,Hyung-Taik Lee,6-4; 6-4,R64,92,5,2,38,57,29,38,9,19,5,7,10,38,57,6,2,31,66,21,31,16,35,3,7,10,37,66
2006-08-14 00:00:00.000,ATP Masters Series Cincinnati OH; U.S.A. ATP World Tour,HARD,2,Rafael Nadal,Sam Querrey,Rafael Nadal,6-7(5); 6-2; 6-3,R64,122,4,4,55,88,44,55,21,33,0,0,15,65,88,10,5,42,87,37,42,19,45,5,8,14,56,87
2006-08-14 00:00:00.000,ATP Masters Series Cincinnati OH; U.S.A. ATP World Tour,HARD,2,Andy Murray,Roger Federer,Andy Murray,7-5; 6-4,R32,97,4,3,28,68,17,28,19,40,2,7,11,36,68,6,3,42,76,24,42,13,34,7,14,11,37,76
2006-08-14 00:00:00.000,ATP Masters Series Cincinnati OH; U.S.A. ATP World Tour,HARD,2,Robby Ginepri,Dmitry Tursunov,Robby Ginepri,6-3; 6-4,R32,64,8,1,32,51,28,32,12,19,0,0,10,40,51,8,3,27,55,23,27,13,28,4,6,9,36,55
2006-08-14 00:00:00.000,ATP Masters Series Cincinnati OH; U.S.A. ATP World Tour,HARD,2,Andy Roddick,Kristof Vliegen,Andy Roddick,6-4; 6-4,R32,77,8,1,36,49,33,36,7,13,0,0,10,40,49,9,4,40,68,30,40,12,28,6,8,10,42,68
2006-08-14 00:00:00.000,ATP Masters Series Cincinnati OH; U.S.A. ATP World Tour,HARD,2,Juan Ignacio Chela,Vincent Spadea,Juan Ignacio Chela,6-7(5); 7-5; 6-2,R32,139,5,1,59,100,41,59,22,41,3,7,16,63,100,9,2,62,110,41,62,21,48,8,15,16,62,110
2006-08-14 00:00:00.000,ATP Masters Series Cincinnati OH; U.S.A. ATP World Tour,HARD,2,Stanislas Wawrinka,David Nalbandian,Stanislas Wawrinka,6-4; 6-2,R32,80,4,3,24,57,19,24,21,33,4,4,9,40,57,0,0,30,54,17,30,14,24,2,5,9,31,54
2006-08-14 00:00:00.000,ATP Masters Series Cincinnati OH; U.S.A. ATP World Tour,HARD,2,Fernando Gonzalez,Mardy Fish,Fernando Gonzalez,7-5; 7-5,R32,90,4,0,48,61,35,48,10,13,0,1,12,45,61,12,3,39,82,33,39,16,43,3,6,12,49,82
2006-08-14 00:00:00.000,ATP Masters Series Cincinnati OH; U.S.A. ATP World Tour,HARD,2,David Ferrer,Nicolas Almagro,David Ferrer,4-6; 7-6(1); 6-0,R32,123,2,9,74,120,51,74,22,46,11,13,14,73,120,10,3,38,82,32,38,18,44,3,7,14,50,82
2006-08-14 00:00:00.000,ATP Masters Series Cincinnati OH; U.S.A. ATP World Tour,HARD,2,Marcos Baghdatis,Gael Monfils,Marcos Baghdatis,7-6(8); 2-6; 6-1,R32,138,1,5,34,90,27,34,26,56,3,7,14,53,90,3,7,41,83,30,41,17,42,4,8,13,47,83
2006-08-14 00:00:00.000,ATP Masters Series Cincinnati OH; U.S.A. ATP World Tour,HARD,2,Tommy Robredo,Max Mirnyi,Tommy Robredo,6-4; 6-4,R32,71,0,1,46,57,36,46,7,11,1,1,10,43,57,4,2,35,55,27,35,10,20,2,4,10,37,55
2006-08-14 00:00:00.000,ATP Masters Series Cincinnati OH; U.S.A. ATP World Tour,HARD,2,Florent Serra,Novak Djokovic,Florent Serra,6-4; 6-4,R32,68,3,1,31,56,19,31,19,25,0,1,10,38,56,6,3,33,57,21,33,13,24,1,4,10,34,57
2006-08-14 00:00:00.000,ATP Masters Series Cincinnati OH; U.S.A. ATP World Tour,HARD,2,Dominik Hrbaty,Davide Sanguinetti,Dominik Hrbaty,6-3; 6-2,R32,68,2,3,29,55,22,29,16,26,2,2,9,38,55,5,6,43,72,27,43,11,29,9,12,8,38,72
2006-08-14 00:00:00.000,ATP Masters Series Cincinnati OH; U.S.A. ATP World Tour,HARD,2,Ivan Ljubicic,Mikhail Youzhny,Ivan Ljubicic,6-4; 7-6(5),R32,101,11,3,46,71,37,46,12,25,2,3,11,49,71,5,1,45,76,29,45,19,31,2,4,11,48,76
2006-08-14 00:00:00.000,ATP Masters Series Cincinnati OH; U.S.A. ATP World Tour,HARD,2,Juan Carlos Ferrero,James Blake,Juan Carlos Ferrero,6-2; 6-4,R32,64,3,0,32,51,24,32,13,19,0,0,9,37,51,7,3,26,51,20,26,12,25,5,8,9,32,51
2006-08-14 00:00:00.000,ATP Masters Series Cincinnati OH; U.S.A. ATP World Tour,HARD,2,Robin Soderling,Justin Gimelstob,Robin Soderling,6-3; 2-6; 7-6(6),R32,133,7,2,60,94,40,60,24,34,6,8,15,64,94,10,2,65,105,51,65,18,40,7,8,14,69,105
2006-08-14 00:00:00.000,ATP Masters Series Cincinnati OH; U.S.A. ATP World Tour,HARD,2,Tommy Haas,Gilles Simon,Tommy Haas,6-3; 4-6; 6-4,R32,108,13,5,57,91,40,57,18,34,4,7,15,58,91,2,1,46,87,31,46,19,41,5,9,14,50,87
2006-08-14 00:00:00.000,ATP Masters Series Cincinnati OH; U.S.A. ATP World Tour,HARD,2,Rafael Nadal,Hyung-Taik Lee,Rafael Nadal,6-4; 6-3,R32,79,1,1,32,45,28,32,8,13,0,0,9,36,45,0,0,40,59,23,40,11,19,2,5,10,34,59
2006-08-14 00:00:00.000,ATP Masters Series Cincinnati OH; U.S.A. ATP World Tour,HARD,2,Andy Murray,Robby Ginepri,Andy Murray,7-6(3); 2-6; 6-4,R16,127,10,4,30,86,24,30,29,56,3,7,15,53,86,9,2,67,108,49,67,17,41,6,9,15,66,108
2006-08-14 00:00:00.000,ATP Masters Series Cincinnati OH; U.S.A. ATP World Tour,HARD,2,Andy Roddick,Juan Ignacio Chela,Andy Roddick,6-3; 6-4,R16,73,10,1,34,51,26,34,11,17,0,1,10,37,51,1,0,37,66,22,37,16,29,6,9,9,38,66
2006-08-14 00:00:00.000,ATP Masters Series Cincinnati OH; U.S.A. ATP World Tour,HARD,2,Fernando Gonzalez,Stanislas Wawrinka,Fernando Gonzalez,7-6(2); 7-5,R16,116,5,4,51,71,39,51,10,20,2,3,12,49,71,7,6,48,88,33,48,18,40,4,6,12,51,88
2006-08-14 00:00:00.000,ATP Masters Series Cincinnati OH; U.S.A. ATP World Tour,HARD,2,David Ferrer,Marcos Baghdatis,David Ferrer,7-5; 6-4,R16,90,1,2,43,65,27,43,13,22,3,6,11,40,65,5,3,29,64,22,29,13,35,1,6,11,35,64
2006-08-14 00:00:00.000,ATP Masters Series Cincinnati OH; U.S.A. ATP World Tour,HARD,2,Tommy Robredo,Florent Serra,Tommy Robredo,6-3; 6-1,R16,66,1,3,36,48,26,36,8,12,3,3,8,34,48,1,0,37,60,23,37,8,23,3,7,8,31,60
2006-08-14 00:00:00.000,ATP Masters Series Cincinnati OH; U.S.A. ATP World Tour,HARD,2,Ivan Ljubicic,Dominik Hrbaty,Ivan Ljubicic,7-5; 6-4,R16,105,10,2,35,69,28,35,17,34,3,5,11,45,69,5,3,40,75,25,40,17,35,1,5,11,42,75
2006-08-14 00:00:00.000,ATP Masters Series Cincinnati OH; U.S.A. ATP World Tour,HARD,2,Juan Carlos Ferrero,Robin Soderling,Juan Carlos Ferrero,7-5; 6-4,R16,84,10,0,39,57,34,39,11,18,2,2,11,45,57,3,2,41,63,32,41,11,22,2,4,11,43,63
2006-08-14 00:00:00.000,ATP Masters Series Cincinnati OH; U.S.A. ATP World Tour,HARD,2,Rafael Nadal,Tommy Haas,Rafael Nadal,7-6(5); 6-3,R16,112,5,2,39,62,31,39,16,23,2,3,11,47,62,3,0,42,67,29,42,12,25,3,5,10,41,67
2006-08-14 00:00:00.000,ATP Masters Series Cincinnati OH; U.S.A. ATP World Tour,HARD,2,Andy Roddick,Andy Murray,Andy Roddick,6-3; 6-4,Q,95,16,2,46,69,34,46,10,23,3,4,10,44,69,1,3,35,73,24,35,16,38,8,11,9,40,73
2006-08-14 00:00:00.000,ATP Masters Series Cincinnati OH; U.S.A. ATP World Tour,HARD,2,Fernando Gonzalez,David Ferrer,Fernando Gonzalez,6-2; 6-4,Q,64,5,0,40,51,30,40,4,11,2,4,9,34,51,0,3,30,48,18,30,5,18,1,6,9,23,48
2006-08-14 00:00:00.000,ATP Masters Series Cincinnati OH; U.S.A. ATP World Tour,HARD,2,Tommy Robredo,Ivan Ljubicic,Tommy Robredo,7-6(6); 6-2,Q,102,0,0,53,71,43,53,7,18,6,6,10,50,71,11,2,50,75,35,50,10,25,3,5,10,45,75
2006-08-14 00:00:00.000,ATP Masters Series Cincinnati OH; U.S.A. ATP World Tour,HARD,2,Juan Carlos Ferrero,Rafael Nadal,Juan Carlos Ferrero,7-6(2); 7-6(3),Q,163,3,3,47,81,36,47,20,34,2,3,12,56,81,8,2,46,74,31,46,18,28,1,2,12,49,74
2006-08-14 00:00:00.000,ATP Masters Series Cincinnati OH; U.S.A. ATP World Tour,HARD,2,Andy Roddick,Fernando Gonzalez,Andy Roddick,6-3; 6-3,S,66,12,0,32,51,29,32,9,19,1,1,9,38,51,6,3,34,55,23,34,7,21,4,7,9,30,55
2006-08-14 00:00:00.000,ATP Masters Series Cincinnati OH; U.S.A. ATP World Tour,HARD,2,Juan Carlos Ferrero,Tommy Robredo,Juan Carlos Ferrero,6-3; 6-4,S,97,8,3,39,60,31,39,13,21,2,3,10,44,60,2,1,54,84,32,54,14,30,8,11,9,46,84
2006-08-14 00:00:00.000,ATP Masters Series Cincinnati OH; U.S.A. ATP World Tour,HARD,2,Andy Roddick,Juan Carlos Ferrero,Andy Roddick,6-3; 6-4,F,70,17,2,38,55,28,38,9,17,2,4,10,37,55,9,2,36,54,24,36,5,18,3,7,9,29,54
2006-08-21 00:00:00.000,New Haven CT; U.S.A. ATP World Tour,HARD,2,James Blake,N/A Bye,James Blake,,R64,0,0,0,0,0,0,0,0,0,0,0,0,0,0,0,0,0,0,0,0,0,0,0,0,0,0,0
2006-08-21 00:00:00.000,New Haven CT; U.S.A. ATP World Tour,HARD,2,Ruben Ramirez Hidalgo,Christophe Rochus,Ruben Ramirez Hidalgo,6-3; 7-5,R64,81,13,7,38,73,28,38,19,35,2,3,11,47,73,1,7,47,74,32,47,9,27,6,9,10,41,74
2006-08-21 00:00:00.000,New Haven CT; U.S.A. ATP World Tour,HARD,2,Robin Vik,Fabrice Santoro,Robin Vik,6-4; 6-2,R64,62,3,0,33,50,26,33,12,17,2,2,9,38,50,4,6,34,61,22,34,13,27,2,5,9,35,61
2006-08-21 00:00:00.000,New Haven CT; U.S.A. ATP World Tour,HARD,2,Xavier Malisse,N/A Bye,Xavier Malisse,,R64,0,0,0,0,0,0,0,0,0,0,0,0,0,0,0,0,0,0,0,0,0,0,0,0,0,0,0
2006-08-21 00:00:00.000,New Haven CT; U.S.A. ATP World Tour,HARD,2,Juan Ignacio Chela,N/A Bye,Juan Ignacio Chela,,R64,0,0,0,0,0,0,0,0,0,0,0,0,0,0,0,0,0,0,0,0,0,0,0,0,0,0,0
2006-08-21 00:00:00.000,New Haven CT; U.S.A. ATP World Tour,HARD,2,Andreas Seppi,Bjorn Phau,Andreas Seppi,6-1; 6-1,R64,53,7,3,36,53,26,36,10,17,3,3,7,36,53,4,6,16,40,9,16,6,24,3,8,7,15,40
2006-08-21 00:00:00.000,New Haven CT; U.S.A. ATP World Tour,HARD,2,Nicolas Mahut,Daniele Bracciali,Nicolas Mahut,7-5; 7-6(2),R64,92,12,3,41,66,35,41,20,25,2,2,12,55,66,6,4,39,75,30,39,21,36,1,2,12,51,75
2006-08-21 00:00:00.000,New Haven CT; U.S.A. ATP World Tour,HARD,2,Jose Acasuso,N/A Bye,Jose Acasuso,,R64,0,0,0,0,0,0,0,0,0,0,0,0,0,0,0,0,0,0,0,0,0,0,0,0,0,0,0
2006-08-21 00:00:00.000,New Haven CT; U.S.A. ATP World Tour,HARD,2,Jarkko Nieminen,N/A Bye,Jarkko Nieminen,,R64,0,0,0,0,0,0,0,0,0,0,0,0,0,0,0,0,0,0,0,0,0,0,0,0,0,0,0
2006-08-21 00:00:00.000,New Haven CT; U.S.A. ATP World Tour,HARD,2,Greg Rusedski,Ivo Karlovic,Greg Rusedski,7-6(2); 6-7(7); 6-2,R64,141,15,7,42,98,36,42,39,56,3,4,16,75,98,17,8,66,118,53,66,21,52,8,11,16,74,118
2006-08-21 00:00:00.000,New Haven CT; U.S.A. ATP World Tour,HARD,2,Boris Pashanski,Gilles Muller,Boris Pashanski,6-3; 2-6; 7-6(3),R64,118,4,11,36,86,32,36,25,50,1,3,14,57,86,15,8,57,106,43,57,24,49,8,10,15,67,106
2006-08-21 00:00:00.000,New Haven CT; U.S.A. ATP World Tour,HARD,2,Nicolas Massu,N/A Bye,Nicolas Massu,,R64,0,0,0,0,0,0,0,0,0,0,0,0,0,0,0,0,0,0,0,0,0,0,0,0,0,0,0
2006-08-21 00:00:00.000,New Haven CT; U.S.A. ATP World Tour,HARD,2,Agustin Calleri,N/A Bye,Agustin Calleri,,R64,0,0,0,0,0,0,0,0,0,0,0,0,0,0,0,0,0,0,0,0,0,0,0,0,0,0,0
2006-08-21 00:00:00.000,New Haven CT; U.S.A. ATP World Tour,HARD,2,Max Mirnyi,Paul-Henri Mathieu,Max Mirnyi,6-2; 7-6(6),R64,95,11,2,54,83,39,54,11,29,9,10,10,50,83,2,2,44,70,26,44,14,26,0,3,10,40,70
2006-08-21 00:00:00.000,New Haven CT; U.S.A. ATP World Tour,HARD,2,Mardy Fish,Davide Sanguinetti,Mardy Fish,6-3; 6-3,R64,70,6,2,36,64,28,36,17,28,8,8,9,45,64,3,2,31,53,20,31,11,22,1,4,9,31,53
2006-08-21 00:00:00.000,New Haven CT; U.S.A. ATP World Tour,HARD,2,David Ferrer,N/A Bye,David Ferrer,,R64,0,0,0,0,0,0,0,0,0,0,0,0,0,0,0,0,0,0,0,0,0,0,0,0,0,0,0
2006-08-21 00:00:00.000,New Haven CT; U.S.A. ATP World Tour,HARD,2,Fernando Verdasco,N/A Bye,Fernando Verdasco,,R64,0,0,0,0,0,0,0,0,0,0,0,0,0,0,0,0,0,0,0,0,0,0,0,0,0,0,0
2006-08-21 00:00:00.000,New Haven CT; U.S.A. ATP World Tour,HARD,2,Julien Benneteau,Luis Horna,Julien Benneteau,7-6(3); 2-6; 6-1,R64,138,6,6,57,86,46,57,15,29,8,10,14,61,86,12,4,52,90,40,52,19,38,4,6,13,59,90
2006-08-21 00:00:00.000,New Haven CT; U.S.A. ATP World Tour,HARD,2,Feliciano Lopez,Filippo Volandri,Feliciano Lopez,6-3; 6-4,R64,68,12,1,41,60,36,41,5,19,4,5,10,41,60,0,3,31,54,19,31,13,23,4,7,9,32,54
2006-08-21 00:00:00.000,New Haven CT; U.S.A. ATP World Tour,HARD,2,Jurgen Melzer,N/A Bye,Jurgen Melzer,,R64,0,0,0,0,0,0,0,0,0,0,0,0,0,0,0,0,0,0,0,0,0,0,0,0,0,0,0
2006-08-21 00:00:00.000,New Haven CT; U.S.A. ATP World Tour,HARD,2,Robin Soderling,N/A Bye,Robin Soderling,,R64,0,0,0,0,0,0,0,0,0,0,0,0,0,0,0,0,0,0,0,0,0,0,0,0,0,0,0
2006-08-21 00:00:00.000,New Haven CT; U.S.A. ATP World Tour,HARD,2,Sam Querrey,Alberto Martin,Sam Querrey,6-3; 6-2,R64,61,11,3,36,55,28,36,11,19,2,2,9,39,55,2,3,33,59,21,33,12,26,6,9,8,33,59
2006-08-21 00:00:00.000,New Haven CT; U.S.A. ATP World Tour,HARD,2,Michael Berrer,Ryan Sweeting,Michael Berrer,7-5; 6-2,R64,70,5,3,31,49,23,31,12,18,1,3,10,35,49,0,5,39,66,25,39,10,27,5,10,10,35,66
2006-08-21 00:00:00.000,New Haven CT; U.S.A. ATP World Tour,HARD,2,Marcos Baghdatis,N/A Bye,Marcos Baghdatis,,R64,0,0,0,0,0,0,0,0,0,0,0,0,0,0,0,0,0,0,0,0,0,0,0,0,0,0,0
2006-08-21 00:00:00.000,New Haven CT; U.S.A. ATP World Tour,HARD,2,Olivier Rochus,N/A Bye,Olivier Rochus,,R64,0,0,0,0,0,0,0,0,0,0,0,0,0,0,0,0,0,0,0,0,0,0,0,0,0,0,0
2006-08-21 00:00:00.000,New Haven CT; U.S.A. ATP World Tour,HARD,2,Gilles Simon,Justin Gimelstob,Gilles Simon,4-6; 7-5; 6-1,R64,133,4,3,57,97,43,57,21,40,6,8,15,64,97,1,3,54,106,41,54,19,52,10,14,14,60,106
2006-08-21 00:00:00.000,New Haven CT; U.S.A. ATP World Tour,HARD,2,Marc Gicquel,Jan Hajek,Marc Gicquel,7-6(3); 6-3,R64,75,5,2,31,67,27,31,17,36,4,7,11,44,67,2,5,27,57,18,27,12,30,1,5,10,30,57
2006-08-21 00:00:00.000,New Haven CT; U.S.A. ATP World Tour,HARD,2,Gael Monfils,N/A Bye,Gael Monfils,,R64,0,0,0,0,0,0,0,0,0,0,0,0,0,0,0,0,0,0,0,0,0,0,0,0,0,0,0
2006-08-21 00:00:00.000,New Haven CT; U.S.A. ATP World Tour,HARD,2,Paradorn Srichaphan,N/A Bye,Paradorn Srichaphan,,R64,0,0,0,0,0,0,0,0,0,0,0,0,0,0,0,0,0,0,0,0,0,0,0,0,0,0,0
2006-08-21 00:00:00.000,New Haven CT; U.S.A. ATP World Tour,HARD,2,Stanislas Wawrinka,Nicolas Almagro,Stanislas Wawrinka,6-3; 6-7(5); 6-4,R64,132,12,4,60,100,44,60,28,40,2,3,16,72,100,12,6,52,100,40,52,25,48,3,6,15,65,100
2006-08-21 00:00:00.000,New Haven CT; U.S.A. ATP World Tour,HARD,2,Arnaud Clement,Florent Serra,Arnaud Clement,6-4; 6-1,R64,80,4,1,42,73,29,42,13,31,5,7,9,42,73,0,3,28,49,16,28,5,21,1,6,8,21,49
2006-08-21 00:00:00.000,New Haven CT; U.S.A. ATP World Tour,HARD,2,Nikolay Davydenko,N/A Bye,Nikolay Davydenko,,R64,0,0,0,0,0,0,0,0,0,0,0,0,0,0,0,0,0,0,0,0,0,0,0,0,0,0,0
2006-08-21 00:00:00.000,New Haven CT; U.S.A. ATP World Tour,HARD,2,Ruben Ramirez Hidalgo,James Blake,Ruben Ramirez Hidalgo,2-6; 7-6(6); 7-6(4),R32,142,7,8,69,124,50,69,28,55,13,18,16,78,124,7,2,67,105,50,67,18,38,5,8,16,68,105
2006-08-21 00:00:00.000,New Haven CT; U.S.A. ATP World Tour,HARD,2,Xavier Malisse,Robin Vik,Xavier Malisse,6-1; 4-6; 6-3,R32,109,10,1,46,88,35,46,19,42,4,7,13,54,88,6,3,63,87,31,63,12,24,1,7,13,43,87
2006-08-21 00:00:00.000,New Haven CT; U.S.A. ATP World Tour,HARD,2,Juan Ignacio Chela,Andreas Seppi,Juan Ignacio Chela,6-3; 6-2,R32,68,3,1,30,53,23,30,16,23,1,1,9,39,53,1,2,35,63,27,35,8,28,7,10,8,35,63
2006-08-21 00:00:00.000,New Haven CT; U.S.A. ATP World Tour,HARD,2,Jose Acasuso,Nicolas Mahut,Jose Acasuso,7-5; 3-3 RET,R32,75,7,4,29,54,26,29,12,25,0,0,9,38,54,9,2,36,58,26,36,12,22,3,4,9,38,58
2006-08-21 00:00:00.000,New Haven CT; U.S.A. ATP World Tour,HARD,2,Jarkko Nieminen,Greg Rusedski,Jarkko Nieminen,7-6(2); 6-4,R32,87,6,1,42,69,33,42,16,27,3,4,11,49,69,6,5,50,77,32,50,12,27,4,6,11,44,77
2006-08-21 00:00:00.000,New Haven CT; U.S.A. ATP World Tour,HARD,2,Nicolas Massu,Boris Pashanski,Nicolas Massu,6-3; 7-6(4),R32,78,17,2,42,57,36,42,11,15,1,2,11,47,57,3,4,44,66,31,44,12,22,3,5,10,43,66
2006-08-21 00:00:00.000,New Haven CT; U.S.A. ATP World Tour,HARD,2,Agustin Calleri,Max Mirnyi,Agustin Calleri,7-6(4); 6-3,R32,91,13,3,46,68,37,46,16,22,2,2,11,53,68,10,3,47,75,35,47,15,28,7,8,10,50,75
2006-08-21 00:00:00.000,New Haven CT; U.S.A. ATP World Tour,HARD,2,David Ferrer,Mardy Fish,David Ferrer,6-2; 2-6; 7-6(5),R32,127,1,3,56,94,39,56,19,38,4,7,14,58,94,7,4,51,101,37,51,24,50,6,9,14,61,101
2006-08-21 00:00:00.000,New Haven CT; U.S.A. ATP World Tour,HARD,2,Fernando Verdasco,Julien Benneteau,Fernando Verdasco,7-6(4); 6-4,R32,80,9,3,51,63,42,51,7,12,2,2,11,49,63,3,1,42,65,32,42,11,23,0,1,11,43,65
2006-08-21 00:00:00.000,New Haven CT; U.S.A. ATP World Tour,HARD,2,Jurgen Melzer,Feliciano Lopez,Jurgen Melzer,6-7(3); 7-6(1); 6-4,R32,140,10,4,77,113,54,77,22,36,7,9,17,76,113,9,5,67,113,53,67,22,46,2,5,17,75,113
2006-08-21 00:00:00.000,New Haven CT; U.S.A. ATP World Tour,HARD,2,Robin Soderling,Sam Querrey,Robin Soderling,6-3; 4-6; 6-1,R32,78,3,1,45,68,35,45,16,23,3,4,13,51,68,10,3,44,76,30,44,15,32,2,6,13,45,76
2006-08-21 00:00:00.000,New Haven CT; U.S.A. ATP World Tour,HARD,2,Marcos Baghdatis,Michael Berrer,Marcos Baghdatis,7-6(5); 7-6(6),R32,108,5,3,43,75,33,43,19,32,0,2,12,52,75,2,3,51,84,37,51,19,33,4,6,12,56,84
2006-08-21 00:00:00.000,New Haven CT; U.S.A. ATP World Tour,HARD,2,Olivier Rochus,Gilles Simon,Olivier Rochus,4-6; 6-4; 6-3,R32,124,2,3,48,94,37,48,22,46,6,9,15,59,94,12,2,54,93,36,54,19,39,3,7,14,55,93
2006-08-21 00:00:00.000,New Haven CT; U.S.A. ATP World Tour,HARD,2,Gael Monfils,Marc Gicquel,Gael Monfils,7-6(6); 6-4,R32,88,11,3,47,78,35,47,19,31,6,7,11,54,78,6,2,48,74,37,48,12,26,3,5,11,49,74
2006-08-21 00:00:00.000,New Haven CT; U.S.A. ATP World Tour,HARD,2,Paradorn Srichaphan,Stanislas Wawrinka,Paradorn Srichaphan,7-6(2); 4-6; 6-4,R32,138,8,8,57,107,42,57,27,50,7,10,16,69,107,4,4,54,98,46,54,20,44,5,8,16,66,98
2006-08-21 00:00:00.000,New Haven CT; U.S.A. ATP World Tour,HARD,2,Nikolay Davydenko,Arnaud Clement,Nikolay Davydenko,6-2; 6-1,R32,64,0,1,21,35,20,21,9,14,2,2,7,29,35,1,3,24,49,13,24,11,25,6,11,8,24,49
2006-08-21 00:00:00.000,New Haven CT; U.S.A. ATP World Tour,HARD,2,Xavier Malisse,Ruben Ramirez Hidalgo,Xavier Malisse,6-1; 6-3,R16,66,5,0,24,38,21,24,11,14,0,0,8,32,38,3,3,30,64,17,30,14,34,5,9,8,31,64
2006-08-21 00:00:00.000,New Haven CT; U.S.A. ATP World Tour,HARD,2,Juan Ignacio Chela,Jose Acasuso,Juan Ignacio Chela,7-6(1); 6-2,R16,84,4,0,41,66,33,41,12,25,1,2,10,45,66,4,1,31,69,21,31,18,38,3,6,10,39,69
2006-08-21 00:00:00.000,New Haven CT; U.S.A. ATP World Tour,HARD,2,Nicolas Massu,Jarkko Nieminen,Nicolas Massu,6-3; 6-4,R16,88,6,5,29,65,25,29,21,36,2,2,10,46,65,1,5,29,62,20,29,16,33,2,4,9,36,62
2006-08-21 00:00:00.000,New Haven CT; U.S.A. ATP World Tour,HARD,2,Agustin Calleri,David Ferrer,Agustin Calleri,6-3; 6-1,R16,78,7,3,46,74,33,46,11,28,11,12,8,44,74,0,3,31,50,17,31,7,19,5,10,8,24,50
2006-08-21 00:00:00.000,New Haven CT; U.S.A. ATP World Tour,HARD,2,Jurgen Melzer,Fernando Verdasco,Jurgen Melzer,6-4; 4-1 RET,R16,55,6,3,31,50,24,31,10,19,3,3,7,34,50,3,2,27,40,16,27,6,13,1,4,8,22,40
2006-08-21 00:00:00.000,New Haven CT; U.S.A. ATP World Tour,HARD,2,Robin Soderling,Marcos Baghdatis,Robin Soderling,6-3; 6-7(3); 7-5,R16,137,9,5,66,101,53,66,18,35,3,4,17,71,101,14,1,56,120,42,56,32,64,4,7,16,74,120
2006-08-21 00:00:00.000,New Haven CT; U.S.A. ATP World Tour,HARD,2,Olivier Rochus,Gael Monfils,Olivier Rochus,6-4; 6-3,R16,71,0,1,28,57,21,28,21,29,2,2,10,42,57,9,3,28,47,23,28,7,19,2,4,9,30,47
2006-08-21 00:00:00.000,New Haven CT; U.S.A. ATP World Tour,HARD,2,Nikolay Davydenko,Paradorn Srichaphan,Nikolay Davydenko,6-4; 6-1,R16,62,4,3,28,43,24,28,8,15,0,0,8,32,43,2,4,33,62,19,33,12,29,10,14,9,31,62
2006-08-21 00:00:00.000,New Haven CT; U.S.A. ATP World Tour,HARD,2,Xavier Malisse,Juan Ignacio Chela,Xavier Malisse,4-6; 6-4; 6-2,Q,118,3,3,52,92,40,52,17,40,6,9,14,57,92,2,2,58,95,37,58,17,37,9,14,14,54,95
2006-08-21 00:00:00.000,New Haven CT; U.S.A. ATP World Tour,HARD,2,Agustin Calleri,Nicolas Massu,Agustin Calleri,6-3; 3-6; 6-4,Q,113,11,4,46,79,39,46,17,33,2,4,14,56,79,6,5,46,91,32,46,26,45,5,8,14,58,91
2006-08-21 00:00:00.000,New Haven CT; U.S.A. ATP World Tour,HARD,2,Robin Soderling,Jurgen Melzer,Robin Soderling,6-3; 6-2,Q,54,7,1,37,49,31,37,6,12,2,2,9,37,49,6,0,27,44,17,27,9,17,2,5,8,26,44
2006-08-21 00:00:00.000,New Haven CT; U.S.A. ATP World Tour,HARD,2,Nikolay Davydenko,Olivier Rochus,Nikolay Davydenko,6-4; 6-2,Q,75,3,1,33,49,22,33,10,16,2,4,9,32,49,1,2,35,58,19,35,7,23,3,8,9,26,58
2006-08-21 00:00:00.000,New Haven CT; U.S.A. ATP World Tour,HARD,2,Agustin Calleri,Xavier Malisse,Agustin Calleri,6-2 RET,S,37,6,0,24,35,20,24,4,11,2,2,4,24,35,2,1,12,21,9,12,2,9,3,5,4,11,21
2006-08-21 00:00:00.000,New Haven CT; U.S.A. ATP World Tour,HARD,2,Nikolay Davydenko,Robin Soderling,Nikolay Davydenko,7-6(6); 6-2,S,98,5,1,61,77,39,61,6,16,3,6,10,45,77,4,4,40,73,23,40,15,33,5,10,10,38,73
2006-08-21 00:00:00.000,New Haven CT; U.S.A. ATP World Tour,HARD,2,Nikolay Davydenko,Agustin Calleri,Nikolay Davydenko,6-4; 6-3,F,82,5,2,40,64,32,40,11,24,6,6,9,43,64,5,4,32,58,27,32,7,26,4,7,10,34,58
2006-08-28 00:00:00.000,US Open NY; U.S.A. Grand Slams,HARD,3,Roger Federer,Jimmy Wang,Roger Federer,6-4; 6-1; 6-0,R128,99,7,1,39,64,35,39,11,25,0,1,11,46,64,3,6,50,104,27,50,20,54,10,18,12,47,104
2006-08-28 00:00:00.000,US Open NY; U.S.A. Grand Slams,HARD,3,Tim Henman,Greg Rusedski,Tim Henman,7-6(4); 6-2; 6-3,R128,114,8,1,55,85,41,55,21,30,0,1,15,62,85,6,5,56,92,37,56,17,36,2,6,14,54,92
2006-08-28 00:00:00.000,US Open NY; U.S.A. Grand Slams,HARD,3,Vincent Spadea,Gilles Muller,Vincent Spadea,6-2; 6-4; 6-3,R128,98,4,2,50,84,35,50,20,34,4,5,13,55,84,2,7,61,93,38,61,13,32,5,11,14,51,93
2006-08-28 00:00:00.000,US Open NY; U.S.A. Grand Slams,HARD,3,Jonas Bjorkman,Scoville Jenkins,Jonas Bjorkman,7-5; 6-4; 6-4,R128,135,5,5,57,95,46,57,17,38,6,9,16,63,95,2,6,62,101,39,62,20,39,11,17,16,59,101
2006-08-28 00:00:00.000,US Open NY; U.S.A. Grand Slams,HARD,3,Gaston Gaudio,Andreas Seppi,Gaston Gaudio,6-4; 6-4; 6-2,R128,106,7,2,47,82,37,47,21,35,4,5,14,58,82,8,6,49,88,32,49,18,39,2,7,14,50,88
2006-08-28 00:00:00.000,US Open NY; U.S.A. Grand Slams,HARD,3,Sam Querrey,Philipp Kohlschreiber,Sam Querrey,6-3; 6-4; 6-4,R128,90,7,3,56,85,41,56,21,29,2,2,15,62,85,6,3,48,90,33,48,22,42,6,9,14,55,90
2006-08-28 00:00:00.000,US Open NY; U.S.A. Grand Slams,HARD,3,Marc Gicquel,Christophe Rochus,Marc Gicquel,6-3; 6-3; 6-4,R128,94,21,1,49,80,39,49,16,31,1,3,14,55,80,1,5,49,89,32,49,17,40,2,8,14,49,89
2006-08-28 00:00:00.000,US Open NY; U.S.A. Grand Slams,HARD,3,Juan Carlos Ferrero,George Bastl,Juan Carlos Ferrero,7-5; 6-4; 3-6; 6-3,R128,185,9,4,81,129,60,81,26,48,4,7,20,86,129,15,4,76,122,58,76,19,46,12,17,20,77,122
2006-08-28 00:00:00.000,US Open NY; U.S.A. Grand Slams,HARD,3,Tomas Berdych,Boris Pashanski,Tomas Berdych,6-4; 6-2; 6-1,R128,89,10,2,31,61,28,31,19,30,3,4,12,47,61,0,5,47,88,27,47,16,41,6,13,13,43,88
2006-08-28 00:00:00.000,US Open NY; U.S.A. Grand Slams,HARD,3,Florian Mayer,Stefan Koubek,Florian Mayer,6-4; 6-1; 6-1,R128,71,5,0,36,65,27,36,20,29,1,2,12,47,65,0,3,30,65,17,30,15,35,5,12,12,32,65
2006-08-28 00:00:00.000,US Open NY; U.S.A. Grand Slams,HARD,3,Alejandro Falla,Juan Martin Del Potro,Alejandro Falla,7-6(3); 6-2; 4-6; 7-5,R128,190,6,5,101,153,69,101,25,52,11,16,21,94,153,3,6,79,131,53,79,23,52,8,15,21,76,131
2006-08-28 00:00:00.000,US Open NY; U.S.A. Grand Slams,HARD,3,Dmitry Tursunov,Igor Kunitsyn,Dmitry Tursunov,6-2; 6-3; 6-4,R128,97,8,4,54,93,42,54,20,39,8,10,14,62,93,2,4,46,83,28,46,16,37,7,13,13,44,83
2006-08-28 00:00:00.000,US Open NY; U.S.A. Grand Slams,HARD,3,Carlos Moya,Agustin Calleri,Carlos Moya,7-5; 7-6(5); 6-7(3); 6-3,R128,196,19,9,99,176,74,99,41,77,13,13,23,115,176,19,11,77,138,65,77,30,61,5,7,22,95,138
2006-08-28 00:00:00.000,US Open NY; U.S.A. Grand Slams,HARD,3,Paul-Henri Mathieu,Josh Goodall,Paul-Henri Mathieu,6-3; 6-2; 3-6; 6-3,R128,127,10,5,51,97,48,51,24,46,0,1,18,72,97,14,4,49,101,40,49,22,52,6,10,17,62,101
2006-08-28 00:00:00.000,US Open NY; U.S.A. Grand Slams,HARD,3,Teymuraz Gabashvili,Marcos Daniel,Teymuraz Gabashvili,6-3; 6-2; 3-6; 3-6; 6-3,R128,176,10,4,69,132,55,69,31,63,6,10,22,86,132,6,3,90,143,58,90,29,53,13,19,22,87,143
2006-08-28 00:00:00.000,US Open NY; U.S.A. Grand Slams,HARD,3,James Blake,Juan Monaco,James Blake,6-3; 7-5; 7-6(7),R128,117,7,5,53,101,37,53,28,48,3,7,17,65,101,3,3,74,98,41,74,12,24,6,12,16,53,98
2006-08-28 00:00:00.000,US Open NY; U.S.A. Grand Slams,HARD,3,David Nalbandian,Michael Berrer,David Nalbandian,4-6; 6-7(2); 6-3; 7-5; 6-2,R128,213,15,10,85,152,63,85,39,67,8,12,26,102,152,13,8,99,167,73,99,27,68,7,14,25,100,167
2006-08-28 00:00:00.000,US Open NY; U.S.A. Grand Slams,HARD,3,Marat Safin,Robin Vik,Marat Safin,6-1; 6-1; 3-6; 6-3,R128,108,15,0,53,89,44,53,21,36,6,7,16,65,89,6,2,68,103,45,68,15,35,7,13,16,60,103
2006-08-28 00:00:00.000,US Open NY; U.S.A. Grand Slams,HARD,3,Ryan Sweeting,Guillermo Coria,Ryan Sweeting,3-2 RET,R128,24,3,1,6,11,5,6,0,5,0,1,2,5,11,0,5,6,17,4,6,3,11,0,2,3,7,17
2006-08-28 00:00:00.000,US Open NY; U.S.A. Grand Slams,HARD,3,Olivier Rochus,Olivier Patience,Olivier Rochus,6-0; 6-2; 6-2,R128,76,4,1,40,61,33,40,14,21,3,3,11,47,61,3,1,48,78,22,48,12,30,6,13,11,34,78
2006-08-28 00:00:00.000,US Open NY; U.S.A. Grand Slams,HARD,3,Robby Ginepri,Julien Benneteau,Robby Ginepri,3-6; 6-4; 6-4; 6-4,R128,163,12,2,75,117,48,75,23,42,6,11,20,71,117,7,5,97,142,58,97,24,45,14,20,19,82,142
2006-08-28 00:00:00.000,US Open NY; U.S.A. Grand Slams,HARD,3,Paul Goldstein,Jesse Witten,Paul Goldstein,6-3; 6-4; 2-6; 3-6; 6-1,R128,180,3,5,83,150,51,83,36,67,9,15,22,87,150,14,4,76,141,53,76,32,65,8,15,21,85,141
2006-08-28 00:00:00.000,US Open NY; U.S.A. Grand Slams,HARD,3,Raemon Sluiter,Wayne Odesnik,Raemon Sluiter,6-4; 6-4; 7-5,R128,110,14,4,47,88,41,47,21,41,3,5,16,62,88,19,3,64,99,44,64,18,35,7,12,16,62,99
2006-08-28 00:00:00.000,US Open NY; U.S.A. Grand Slams,HARD,3,Tommy Haas,Alex Kuznetsov,Tommy Haas,6-2; 6-4; 6-0,R128,88,6,1,34,62,27,34,21,28,0,0,12,48,62,12,1,52,79,31,52,10,27,7,13,12,41,79
2006-08-28 00:00:00.000,US Open NY; U.S.A. Grand Slams,HARD,3,Fernando Gonzalez,Jiri Vanek,Fernando Gonzalez,6-2; 6-3; 6-2,R128,91,10,5,62,92,50,62,12,30,8,8,13,62,92,1,1,52,86,26,52,19,34,6,11,12,45,86
2006-08-28 00:00:00.000,US Open NY; U.S.A. Grand Slams,HARD,3,Jan Hajek,Lukas Dlouhy,Jan Hajek,6-3; 6-4; 6-4,R128,99,11,3,59,90,47,59,11,31,3,5,15,58,90,6,8,67,97,44,67,9,30,6,11,14,53,97
2006-08-28 00:00:00.000,US Open NY; U.S.A. Grand Slams,HARD,3,Alessio Di Mauro,Jurgen Melzer,Alessio Di Mauro,5-7; 6-1; 7-5; 7-5,R128,176,18,4,85,159,60,85,39,74,17,20,22,99,159,8,4,81,118,55,81,17,37,5,11,21,72,118
2006-08-28 00:00:00.000,US Open NY; U.S.A. Grand Slams,HARD,3,Andy Murray,Robert Kendrick,Andy Murray,6-2; 1-6; 6-3; 6-3,R128,137,8,6,55,109,37,55,25,54,4,9,16,62,109,9,10,64,118,42,64,19,54,9,17,17,61,118
2006-08-28 00:00:00.000,US Open NY; U.S.A. Grand Slams,HARD,3,Lukasz Kubot,Kristof Vliegen,Lukasz Kubot,2-6; 6-1; 6-4; 1-6; 6-3,R128,181,4,2,87,140,55,87,32,53,7,11,21,87,140,13,1,59,103,47,59,22,44,0,4,20,69,103
2006-08-28 00:00:00.000,US Open NY; U.S.A. Grand Slams,HARD,3,Noam Okun,Potito Starace,Noam Okun,6-2; 6-0; 4-6; 6-2,R128,141,15,3,65,108,45,65,30,43,7,8,16,75,108,4,4,63,108,35,63,23,45,3,10,16,58,108
2006-08-28 00:00:00.000,US Open NY; U.S.A. Grand Slams,HARD,3,Nicolas Mahut,Rainer Schuettler,Nicolas Mahut,6-4; 6-7(5); 6-3; 6-3,R128,186,23,5,77,138,58,77,36,61,6,6,20,94,138,5,4,54,112,37,54,40,58,2,6,20,77,112
2006-08-28 00:00:00.000,US Open NY; U.S.A. Grand Slams,HARD,3,Nikolay Davydenko,Ramon Delgado,Nikolay Davydenko,4-6; 6-4; 7-5; 6-0,R128,142,6,1,60,101,44,60,20,41,5,10,19,64,101,5,7,61,119,37,61,25,58,5,14,19,62,119
2006-08-28 00:00:00.000,US Open NY; U.S.A. Grand Slams,HARD,3,Marcos Baghdatis,Alexander Waske,Marcos Baghdatis,7-6(1); 7-6(7); 6-3,R128,131,10,3,53,97,48,53,31,44,0,1,17,79,97,18,6,64,102,52,64,19,38,1,3,16,71,102
2006-08-28 00:00:00.000,US Open NY; U.S.A. Grand Slams,HARD,3,Andre Agassi,Andrei Pavel,Andre Agassi,6-7(4); 7-6(8); 7-6(6); 6-2,R128,210,17,8,89,154,71,89,29,65,2,5,22,100,154,15,2,113,167,77,113,26,54,6,11,22,103,167
2006-08-28 00:00:00.000,US Open NY; U.S.A. Grand Slams,HARD,3,Benjamin Becker,Filippo Volandri,Benjamin Becker,4-6; 7-6(3); 6-4; 7-6(3),R128,191,15,6,61,135,47,61,43,74,2,6,22,90,135,6,7,104,163,70,104,25,59,8,12,22,95,163
2006-08-28 00:00:00.000,US Open NY; U.S.A. Grand Slams,HARD,3,Sebastien Grosjean,Thomas Johansson,Sebastien Grosjean,6-3; 6-4; 5-7; 6-7(1); 6-2,R128,227,20,2,105,165,79,105,35,60,6,7,26,114,165,12,4,117,185,87,117,29,68,10,14,25,116,185
2006-08-28 00:00:00.000,US Open NY; U.S.A. Grand Slams,HARD,3,Fernando Verdasco,Fabrice Santoro,Fernando Verdasco,6-4; 6-1; 3-6; 6-1,R128,129,1,3,79,99,56,79,15,20,2,3,17,71,99,2,7,58,112,41,58,21,54,10,15,16,62,112
2006-08-28 00:00:00.000,US Open NY; U.S.A. Grand Slams,HARD,3,Thiago Alves,Mariano Zabaleta,Thiago Alves,6-2; 7-5; 6-7(5); 6-3,R128,150,5,2,82,119,57,82,31,37,3,4,21,88,119,9,8,67,121,48,67,29,54,4,9,20,77,121
2006-08-28 00:00:00.000,US Open NY; U.S.A. Grand Slams,HARD,3,Kristian Pless,Alberto Martin,Kristian Pless,3-6; 3-6; 7-6(5); 6-1; 6-2,R128,174,14,8,82,133,58,82,19,51,3,10,22,77,133,7,10,93,159,54,93,35,66,7,16,23,89,159
2006-08-28 00:00:00.000,US Open NY; U.S.A. Grand Slams,HARD,3,Andy Roddick,Florent Serra,Andy Roddick,6-2; 6-1; 6-3,R128,79,9,1,49,69,39,49,11,20,3,4,12,50,69,1,2,47,70,26,47,7,23,8,15,12,33,70
2006-08-28 00:00:00.000,US Open NY; U.S.A. Grand Slams,HARD,3,Lleyton Hewitt,Albert Montanes,Lleyton Hewitt,7-5; 6-4; 6-3,R128,131,8,5,53,88,40,53,22,35,2,3,15,62,88,4,4,59,106,41,59,19,47,5,10,16,60,106
2006-08-28 00:00:00.000,US Open NY; U.S.A. Grand Slams,HARD,3,Jan Hernych,Kevin Kim,Jan Hernych,6-1; 6-4; 3-6; 7-5,R128,123,6,1,80,118,49,80,20,38,7,12,19,69,118,7,6,58,103,38,58,20,45,2,10,19,58,103
2006-08-28 00:00:00.000,US Open NY; U.S.A. Grand Slams,HARD,3,Mardy Fish,Simon Greul,Mardy Fish,6-4; 6-4; 1-6; 6-3,R128,150,17,3,53,109,44,53,25,56,10,15,18,69,109,2,5,64,132,45,64,30,68,10,16,18,75,132
2006-08-28 00:00:00.000,US Open NY; U.S.A. Grand Slams,HARD,3,Novak Djokovic,Donald Young,Novak Djokovic,4-6; 6-3; 6-0; 6-1,R128,101,8,4,70,102,51,70,18,32,7,8,16,69,102,4,8,44,87,24,44,20,43,2,9,16,44,87
2006-08-28 00:00:00.000,US Open NY; U.S.A. Grand Slams,HARD,3,Richard Gasquet,Phillip Simmonds,Richard Gasquet,6-1; 6-3; 6-1,R128,85,2,2,48,74,38,48,17,26,4,4,12,55,74,5,5,40,73,24,40,10,33,6,12,11,34,73
2006-08-28 00:00:00.000,US Open NY; U.S.A. Grand Slams,HARD,3,Gilles Simon,Daniele Bracciali,Gilles Simon,7-5; 6-4; 6-1,R128,110,5,0,57,104,42,57,27,47,6,7,15,69,104,9,5,47,96,36,47,17,49,6,11,14,53,96
2006-08-28 00:00:00.000,US Open NY; U.S.A. Grand Slams,HARD,3,Marco Chiudinelli,Fernando Vicente,Marco Chiudinelli,6-4; 6-1; 6-4,R128,124,5,0,52,92,36,52,26,40,7,8,14,62,92,0,3,65,94,36,65,13,29,9,14,13,49,94
2006-08-28 00:00:00.000,US Open NY; U.S.A. Grand Slams,HARD,3,Feliciano Lopez,Ivan Ljubicic,Feliciano Lopez,6-3; 6-3; 6-3,R128,100,11,0,46,65,43,46,10,19,0,0,13,53,65,13,2,52,87,35,52,18,35,8,13,14,53,87
2006-08-28 00:00:00.000,US Open NY; U.S.A. Grand Slams,HARD,3,Tommy Robredo,Flavio Saretta,Tommy Robredo,6-2; 6-1; 6-2,R128,112,6,4,64,91,46,64,15,27,10,10,12,61,91,5,4,48,76,28,48,12,28,10,16,11,40,76
2006-08-28 00:00:00.000,US Open NY; U.S.A. Grand Slams,HARD,3,Hyung-Taik Lee,Ruben Ramirez Hidalgo,Hyung-Taik Lee,7-5; 6-4; 6-0,R128,118,7,2,49,77,37,49,18,28,3,4,14,55,77,3,6,49,94,29,49,21,45,10,16,14,50,94
2006-08-28 00:00:00.000,US Open NY; U.S.A. Grand Slams,HARD,3,Robin Soderling,Ivo Karlovic,Robin Soderling,6-4; 7-6(3); 7-5,R128,114,10,4,56,95,45,56,31,39,1,1,17,76,95,26,9,67,104,55,67,15,37,2,4,17,70,104
2006-08-28 00:00:00.000,US Open NY; U.S.A. Grand Slams,HARD,3,Stanislas Wawrinka,Juan Ignacio Chela,Stanislas Wawrinka,6-7(3); 6-4; 6-4; 6-4,R128,187,13,7,77,143,58,77,37,66,7,9,21,95,143,1,4,75,128,48,75,32,53,2,7,21,80,128
2006-08-28 00:00:00.000,US Open NY; U.S.A. Grand Slams,HARD,3,Mikhail Youzhny,Dominik Hrbaty,Mikhail Youzhny,7-5; 6-1; 6-3,R128,111,10,1,44,76,36,44,19,32,0,2,14,55,76,3,10,49,93,28,49,18,44,3,10,14,46,93
2006-08-28 00:00:00.000,US Open NY; U.S.A. Grand Slams,HARD,3,Nicolas Massu,Davide Sanguinetti,Nicolas Massu,6-7(4); 6-4; 6-4; 6-4,R128,184,11,5,64,128,55,64,35,64,3,4,21,90,128,16,4,79,142,60,79,31,63,10,14,21,91,142
2006-08-28 00:00:00.000,US Open NY; U.S.A. Grand Slams,HARD,3,Justin Gimelstob,Oliver Marach,Justin Gimelstob,6-2; 6-3; 7-5,R128,111,12,2,44,81,38,44,23,37,0,0,15,61,81,8,4,49,86,36,49,17,37,3,7,14,53,86
2006-08-28 00:00:00.000,US Open NY; U.S.A. Grand Slams,HARD,3,David Ferrer,Nicolas Almagro,David Ferrer,7-6(1); 7-6(6); 6-1,R128,155,6,3,61,102,45,61,27,41,10,13,16,72,102,13,7,64,121,44,64,22,57,12,17,15,66,121
2006-08-28 00:00:00.000,US Open NY; U.S.A. Grand Slams,HARD,3,Xavier Malisse,Jarkko Nieminen,Xavier Malisse,6-4; 7-5; 6-2,R128,114,7,2,58,86,46,58,16,28,0,1,15,62,86,3,4,67,103,38,67,19,36,9,14,15,57,103
2006-08-28 00:00:00.000,US Open NY; U.S.A. Grand Slams,HARD,3,Bjorn Phau,Jeff Morrison,Bjorn Phau,6-3; 7-6(0); 6-4,R128,112,4,4,44,90,34,44,28,46,4,6,15,62,90,8,2,71,121,42,71,24,50,9,14,16,66,121
2006-08-28 00:00:00.000,US Open NY; U.S.A. Grand Slams,HARD,3,Jiri Novak,Arnaud Clement,Jiri Novak,7-5; 6-2; 7-5,R128,140,15,3,56,87,43,56,17,31,3,6,16,60,87,4,3,65,111,37,65,21,46,12,19,16,58,111
2006-08-28 00:00:00.000,US Open NY; U.S.A. Grand Slams,HARD,3,Paradorn Srichaphan,Jose Acasuso,Paradorn Srichaphan,6-3; 3-6; 7-6(5); 6-7(4); 6-3,R128,195,23,9,102,170,83,102,37,68,5,6,26,120,170,29,6,92,149,78,92,31,57,5,7,25,109,149
2006-08-28 00:00:00.000,US Open NY; U.S.A. Grand Slams,HARD,3,Gael Monfils,Michael Russell,Gael Monfils,6-2; 3-6; 7-5; 7-6(4),R128,194,12,4,75,128,54,75,25,53,7,11,20,79,128,2,4,93,139,55,93,28,46,7,13,21,83,139
2006-08-28 00:00:00.000,US Open NY; U.S.A. Grand Slams,HARD,3,Wesley Moodie,Max Mirnyi,Wesley Moodie,6-4; 4-6; 6-4; 6-7(5); 6-4,R128,214,38,7,120,174,88,120,32,54,7,9,26,120,174,6,9,101,151,80,101,27,50,6,10,26,107,151
2006-08-28 00:00:00.000,US Open NY; U.S.A. Grand Slams,HARD,3,Luis Horna,Guillermo Garcia-Lopez,Luis Horna,7-5; 6-4; 6-3,R128,112,16,7,53,98,43,53,24,45,2,3,16,67,98,5,4,54,90,36,54,16,36,4,8,15,52,90
2006-08-28 00:00:00.000,US Open NY; U.S.A. Grand Slams,HARD,3,Rafael Nadal,Mark Philippoussis,Rafael Nadal,6-4; 6-4; 6-4,R128,122,7,1,47,79,41,47,22,32,4,4,15,63,79,19,3,48,87,45,48,10,39,1,4,15,55,87
2006-08-28 00:00:00.000,US Open NY; U.S.A. Grand Slams,HARD,3,Roger Federer,Tim Henman,Roger Federer,6-3; 6-4; 7-5,R64,121,6,1,56,81,46,56,17,25,0,1,16,63,81,2,6,64,113,44,64,21,49,9,13,15,65,113
2006-08-28 00:00:00.000,US Open NY; U.S.A. Grand Slams,HARD,3,Vincent Spadea,Jonas Bjorkman,Vincent Spadea,6-4; 7-6(4); 6-2,R64,145,6,4,75,120,50,75,24,45,11,14,15,74,120,1,8,51,93,31,51,20,42,4,10,15,51,93
2006-08-28 00:00:00.000,US Open NY; U.S.A. Grand Slams,HARD,3,Gaston Gaudio,Sam Querrey,Gaston Gaudio,3-6; 6-2; 6-1; 6-4,R64,122,3,3,61,98,47,61,25,37,8,9,17,72,98,10,7,62,113,40,62,24,51,5,10,17,64,113
2006-08-28 00:00:00.000,US Open NY; U.S.A. Grand Slams,HARD,3,Marc Gicquel,Juan Carlos Ferrero,Marc Gicquel,7-5; 6-3; 6-4,R64,111,9,4,52,96,43,52,27,44,2,2,16,70,96,2,0,65,90,43,65,14,25,10,13,15,57,90
2006-08-28 00:00:00.000,US Open NY; U.S.A. Grand Slams,HARD,3,Tomas Berdych,Florian Mayer,Tomas Berdych,6-1; 3-6; 6-3; 6-3,R64,106,12,4,52,90,46,52,18,38,0,2,17,64,90,4,3,69,104,45,69,13,35,3,9,17,58,104
2006-08-28 00:00:00.000,US Open NY; U.S.A. Grand Slams,HARD,3,Dmitry Tursunov,Alejandro Falla,Dmitry Tursunov,6-3; 7-6(4); 7-5,R64,123,8,3,70,110,50,70,18,40,6,10,17,68,110,7,0,58,103,35,58,20,45,4,10,16,55,103
2006-08-28 00:00:00.000,US Open NY; U.S.A. Grand Slams,HARD,3,Carlos Moya,Paul-Henri Mathieu,Carlos Moya,7-6(5); 7-6(7); 6-4,R64,149,11,2,60,107,50,60,30,47,1,1,17,80,107,9,3,73,110,54,73,24,37,3,4,17,78,110
2006-08-28 00:00:00.000,US Open NY; U.S.A. Grand Slams,HARD,3,James Blake,Teymuraz Gabashvili,James Blake,6-3; 6-4; 7-6(5),R64,115,15,2,62,92,51,62,18,30,4,6,16,69,92,4,2,65,98,44,65,15,33,1,5,15,59,98
2006-08-28 00:00:00.000,US Open NY; U.S.A. Grand Slams,HARD,3,Marat Safin,David Nalbandian,Marat Safin,6-3; 7-5; 2-6; 3-6; 7-6(6),R64,226,15,7,83,154,62,83,37,71,6,10,25,99,154,6,11,99,164,72,99,33,65,6,9,25,105,164
2006-08-28 00:00:00.000,US Open NY; U.S.A. Grand Slams,HARD,3,Olivier Rochus,Ryan Sweeting,Olivier Rochus,6-2; 3-6; 4-6; 6-4; 6-0,R64,157,4,4,78,123,63,78,20,45,6,10,21,83,123,14,4,78,133,50,78,26,55,10,18,22,76,133
2006-08-28 00:00:00.000,US Open NY; U.S.A. Grand Slams,HARD,3,Robby Ginepri,Paul Goldstein,Robby Ginepri,6-2; 6-2; 6-4,R64,103,7,1,54,79,41,54,16,25,3,4,13,57,79,5,4,67,109,43,67,13,42,10,16,13,56,109
2006-08-28 00:00:00.000,US Open NY; U.S.A. Grand Slams,HARD,3,Tommy Haas,Raemon Sluiter,Tommy Haas,6-4; 6-2; 6-3,R64,86,10,6,50,74,38,50,16,24,2,4,14,54,74,5,3,38,76,25,38,17,38,6,12,13,42,76
2006-08-28 00:00:00.000,US Open NY; U.S.A. Grand Slams,HARD,3,Fernando Gonzalez,Jan Hajek,Fernando Gonzalez,6-4; 6-4; 6-2,R64,93,7,2,66,95,48,66,18,29,6,6,14,66,95,5,4,39,92,24,39,31,53,6,10,14,55,92
2006-08-28 00:00:00.000,US Open NY; U.S.A. Grand Slams,HARD,3,Andy Murray,Alessio Di Mauro,Andy Murray,6-0; 6-1; 6-1,R64,74,3,3,33,58,27,33,17,25,3,3,10,44,58,1,2,34,65,16,34,9,31,3,11,10,25,65
2006-08-28 00:00:00.000,US Open NY; U.S.A. Grand Slams,HARD,3,Lukasz Kubot,Noam Okun,Lukasz Kubot,7-6(7); 6-4; 2-6; 2-6; 6-4,R64,260,5,5,105,159,70,105,29,54,5,10,24,99,159,15,5,107,157,74,107,30,50,7,10,24,104,157
2006-08-28 00:00:00.000,US Open NY; U.S.A. Grand Slams,HARD,3,Nikolay Davydenko,Nicolas Mahut,Nikolay Davydenko,6-0 RET,R64,27,0,0,10,15,8,10,4,5,0,0,3,12,15,1,2,19,27,7,19,2,8,3,6,3,9,27
2006-08-28 00:00:00.000,US Open NY; U.S.A. Grand Slams,HARD,3,Andre Agassi,Marcos Baghdatis,Andre Agassi,6-4; 6-4; 3-6; 5-7; 7-5,R64,225,9,2,112,176,77,112,35,64,12,17,26,112,176,21,6,99,181,73,99,35,82,8,14,27,108,181
2006-08-28 00:00:00.000,US Open NY; U.S.A. Grand Slams,HARD,3,Benjamin Becker,Sebastien Grosjean,Benjamin Becker,7-6(3); 6-1; 6-2,R64,113,12,3,52,86,44,52,18,34,4,5,14,62,86,6,4,41,91,27,41,22,50,5,10,13,49,91
2006-08-28 00:00:00.000,US Open NY; U.S.A. Grand Slams,HARD,3,Fernando Verdasco,Thiago Alves,Fernando Verdasco,7-6(3); 6-4; 6-1,R64,113,11,4,70,93,55,70,13,23,9,9,14,68,93,1,5,59,94,37,59,20,35,2,6,15,57,94
2006-08-28 00:00:00.000,US Open NY; U.S.A. Grand Slams,HARD,3,Andy Roddick,Kristian Pless,Andy Roddick,6-3; 7-6(3); 6-3,R64,90,21,1,65,84,60,65,13,19,2,2,16,73,84,12,3,52,84,40,52,18,32,2,4,14,58,84
2006-08-28 00:00:00.000,US Open NY; U.S.A. Grand Slams,HARD,3,Lleyton Hewitt,Jan Hernych,Lleyton Hewitt,6-4; 6-2; 6-2,R64,102,9,5,39,86,29,39,26,47,4,6,13,55,86,1,0,53,68,24,53,7,15,3,10,13,31,68
2006-08-28 00:00:00.000,US Open NY; U.S.A. Grand Slams,HARD,3,Novak Djokovic,Mardy Fish,Novak Djokovic,7-6(5); 6-4; 3-6; 7-6(3),R64,191,9,8,92,148,71,92,33,56,9,10,21,104,148,21,4,72,144,59,72,45,72,6,7,22,104,144
2006-08-28 00:00:00.000,US Open NY; U.S.A. Grand Slams,HARD,3,Richard Gasquet,Gilles Simon,Richard Gasquet,6-0; 6-2; 6-3,R64,106,6,0,51,83,33,51,20,32,6,7,12,53,83,3,1,51,73,26,51,7,22,9,16,11,33,73
2006-08-28 00:00:00.000,US Open NY; U.S.A. Grand Slams,HARD,3,Marco Chiudinelli,Feliciano Lopez,Marco Chiudinelli,3-6; 6-3; 4-6; 6-4; 6-3,R64,183,11,1,87,148,64,87,36,61,7,10,24,100,148,21,2,90,136,65,90,25,46,5,9,23,90,136
2006-08-28 00:00:00.000,US Open NY; U.S.A. Grand Slams,HARD,3,Tommy Robredo,Hyung-Taik Lee,Tommy Robredo,3-6; 6-3; 6-4; 6-1,R64,142,4,1,73,108,45,73,20,35,9,13,17,65,108,1,3,70,110,46,70,15,40,2,10,18,61,110
2006-08-28 00:00:00.000,US Open NY; U.S.A. Grand Slams,HARD,3,Stanislas Wawrinka,Robin Soderling,Stanislas Wawrinka,6-7(4); 2-6; 7-6(4); 6-0; 6-1,R64,192,23,4,100,163,77,100,34,63,9,11,23,111,163,3,4,89,153,60,89,33,64,11,16,22,93,153
2006-08-28 00:00:00.000,US Open NY; U.S.A. Grand Slams,HARD,3,Mikhail Youzhny,Nicolas Massu,Mikhail Youzhny,5-7; 6-7(6); 6-4; 6-3; 6-0,R64,233,9,5,74,148,58,74,38,74,4,9,25,96,148,7,8,94,157,61,94,29,63,7,16,24,90,157
2006-08-28 00:00:00.000,US Open NY; U.S.A. Grand Slams,HARD,3,David Ferrer,Justin Gimelstob,David Ferrer,6-2; 6-4; 6-1,R64,98,0,2,39,67,33,39,18,28,2,2,12,51,67,5,6,47,86,33,47,11,39,5,11,13,44,86
2006-08-28 00:00:00.000,US Open NY; U.S.A. Grand Slams,HARD,3,Xavier Malisse,Bjorn Phau,Xavier Malisse,6-3; 6-0; 6-2,R64,94,3,0,25,55,22,25,22,30,0,1,12,44,55,4,10,47,94,25,47,18,47,7,14,11,43,94
2006-08-28 00:00:00.000,US Open NY; U.S.A. Grand Slams,HARD,3,Jiri Novak,Paradorn Srichaphan,Jiri Novak,7-6(3); 3-6; 6-4; 6-4,R64,154,3,2,96,144,66,96,23,48,11,16,21,89,144,12,5,63,121,52,63,25,58,4,9,20,77,121
2006-08-28 00:00:00.000,US Open NY; U.S.A. Grand Slams,HARD,3,Wesley Moodie,Gael Monfils,Wesley Moodie,6-4; 2-6; 6-2; 7-6(4),R64,147,9,3,81,109,67,81,15,28,2,4,19,82,109,16,6,68,121,49,68,31,53,8,11,19,80,121
2006-08-28 00:00:00.000,US Open NY; U.S.A. Grand Slams,HARD,3,Rafael Nadal,Luis Horna,Rafael Nadal,6-4; 4-6; 6-4; 6-2,R64,163,7,0,67,97,51,67,22,30,2,4,19,73,97,7,6,90,122,64,90,11,32,10,15,19,75,122
2006-08-28 00:00:00.000,US Open NY; U.S.A. Grand Slams,HARD,3,Roger Federer,Vincent Spadea,Roger Federer,6-3; 6-3; 6-0,R32,88,7,0,46,74,38,46,16,28,4,4,12,54,74,2,2,42,75,22,42,17,33,5,11,12,39,75
2006-08-28 00:00:00.000,US Open NY; U.S.A. Grand Slams,HARD,3,Marc Gicquel,Gaston Gaudio,Marc Gicquel,6-0; 4-6; 4-6; 6-1; 7-6(3),R32,196,12,2,90,150,70,90,23,60,9,15,23,93,150,7,9,93,151,55,93,25,58,12,21,22,80,151
2006-08-28 00:00:00.000,US Open NY; U.S.A. Grand Slams,HARD,3,Tomas Berdych,Dmitry Tursunov,Tomas Berdych,6-7(2); 6-3; 3-6; 6-3; 6-4,R32,192,18,2,92,165,74,92,34,73,11,14,25,108,165,21,5,84,156,62,84,38,72,8,13,24,100,156
2006-08-28 00:00:00.000,US Open NY; U.S.A. Grand Slams,HARD,3,James Blake,Carlos Moya,James Blake,6-4; 7-6(6); 2-6; 6-3,R32,154,7,2,73,120,56,73,26,47,3,6,20,82,120,10,5,94,148,68,94,24,54,11,14,19,92,148
2006-08-28 00:00:00.000,US Open NY; U.S.A. Grand Slams,HARD,3,Marat Safin,Olivier Rochus,Marat Safin,6-3; 6-2; 6-3,R32,91,12,2,38,66,32,38,18,28,0,1,13,50,66,1,6,54,81,34,54,11,27,5,11,13,45,81
2006-08-28 00:00:00.000,US Open NY; U.S.A. Grand Slams,HARD,3,Tommy Haas,Robby Ginepri,Tommy Haas,7-6(1); 6-4; 3-6; 3-6; 7-6(1),R32,203,20,10,96,164,77,96,34,68,7,11,26,111,164,15,3,97,154,73,97,31,57,4,6,26,104,154
2006-08-28 00:00:00.000,US Open NY; U.S.A. Grand Slams,HARD,3,Andy Murray,Fernando Gonzalez,Andy Murray,6-3; 3-6; 2-6; 6-3; 6-2,R32,161,4,8,68,119,52,68,27,51,2,7,22,79,119,9,4,94,136,66,94,18,42,11,17,21,84,136
2006-08-28 00:00:00.000,US Open NY; U.S.A. Grand Slams,HARD,3,Nikolay Davydenko,Lukasz Kubot,Nikolay Davydenko,6-4; 6-1; 6-1,R32,100,2,1,54,73,39,54,13,19,6,6,12,52,73,1,4,38,72,22,38,14,34,2,8,12,36,72
2006-08-28 00:00:00.000,US Open NY; U.S.A. Grand Slams,HARD,3,Benjamin Becker,Andre Agassi,Benjamin Becker,7-5; 6-7(4); 6-4; 7-5,R32,181,27,4,77,157,55,77,47,80,8,10,23,102,157,20,6,90,150,61,90,32,60,8,13,23,93,150
2006-08-28 00:00:00.000,US Open NY; U.S.A. Grand Slams,HARD,3,Andy Roddick,Fernando Verdasco,Andy Roddick,6-7(5); 6-3; 6-4; 6-7(4); 6-2,R32,199,14,2,111,162,84,111,29,51,5,7,26,113,162,8,7,116,149,81,116,18,33,1,7,25,99,149
2006-08-28 00:00:00.000,US Open NY; U.S.A. Grand Slams,HARD,3,Lleyton Hewitt,Novak Djokovic,Lleyton Hewitt,6-3; 6-1; 6-2,R32,89,10,3,37,71,29,37,23,34,5,5,12,52,71,3,7,56,83,32,56,10,27,5,11,12,42,83
2006-08-28 00:00:00.000,US Open NY; U.S.A. Grand Slams,HARD,3,Richard Gasquet,Marco Chiudinelli,Richard Gasquet,7-6(2); 6-3; 2-6; 7-6(2),R32,171,11,4,72,135,52,72,36,63,4,8,20,88,135,3,4,78,133,59,78,23,55,5,9,21,82,133
2006-08-28 00:00:00.000,US Open NY; U.S.A. Grand Slams,HARD,3,Tommy Robredo,Stanislas Wawrinka,Tommy Robredo,6-3; 6-4; 6-2,R32,113,4,1,49,71,36,49,10,22,4,7,13,46,71,2,5,52,95,32,52,16,43,11,19,14,48,95
2006-08-28 00:00:00.000,US Open NY; U.S.A. Grand Slams,HARD,3,Mikhail Youzhny,David Ferrer,Mikhail Youzhny,4-6; 6-4; 7-5; 6-4,R32,175,10,7,78,152,60,78,34,74,17,21,21,94,152,3,5,77,123,56,77,17,46,7,13,21,73,123
2006-08-28 00:00:00.000,US Open NY; U.S.A. Grand Slams,HARD,3,Jiri Novak,Xavier Malisse,Jiri Novak,6-7(6); 6-3; 6-4; 6-4,R32,148,6,1,84,126,64,84,24,42,1,3,21,88,126,10,4,71,126,51,71,29,55,9,14,20,80,126
2006-08-28 00:00:00.000,US Open NY; U.S.A. Grand Slams,HARD,3,Rafael Nadal,Wesley Moodie,Rafael Nadal,6-4; 7-6(5); 7-6(4),R32,169,8,3,74,101,57,74,20,27,2,3,17,77,101,11,7,94,134,66,94,19,40,8,10,17,85,134
2006-08-28 00:00:00.000,US Open NY; U.S.A. Grand Slams,HARD,3,Roger Federer,Marc Gicquel,Roger Federer,6-3; 7-6(2); 6-3,R16,104,15,2,61,94,48,61,23,33,5,5,16,71,94,8,0,43,87,33,43,22,44,1,3,14,55,87
2006-08-28 00:00:00.000,US Open NY; U.S.A. Grand Slams,HARD,3,James Blake,Tomas Berdych,James Blake,6-4; 6-3; 6-1,R16,96,14,1,57,95,43,57,21,38,15,15,13,64,95,7,3,56,86,34,56,13,30,4,9,13,47,86
2006-08-28 00:00:00.000,US Open NY; U.S.A. Grand Slams,HARD,3,Tommy Haas,Marat Safin,Tommy Haas,4-6; 6-3; 2-6; 6-2; 7-6(5),R16,190,5,4,101,153,68,101,26,52,6,11,24,94,153,9,2,68,129,48,68,35,61,1,6,23,83,129
2006-08-28 00:00:00.000,US Open NY; U.S.A. Grand Slams,HARD,3,Nikolay Davydenko,Andy Murray,Nikolay Davydenko,6-1; 5-7; 6-3; 6-0,R16,179,3,4,83,123,58,83,16,40,9,12,17,74,123,7,5,51,108,33,51,23,57,7,16,17,56,108
2006-08-28 00:00:00.000,US Open NY; U.S.A. Grand Slams,HARD,3,Andy Roddick,Benjamin Becker,Andy Roddick,6-3; 6-4; 6-3,R16,95,20,0,53,70,46,53,11,17,0,0,14,57,70,9,5,43,87,32,43,18,44,2,6,14,50,87
2006-08-28 00:00:00.000,US Open NY; U.S.A. Grand Slams,HARD,3,Lleyton Hewitt,Richard Gasquet,Lleyton Hewitt,6-4; 6-4; 4-6; 3-6; 6-3,R16,210,17,3,88,164,55,88,43,76,9,15,24,98,164,7,5,94,140,65,94,21,46,7,14,24,86,140
2006-08-28 00:00:00.000,US Open NY; U.S.A. Grand Slams,HARD,3,Mikhail Youzhny,Tommy Robredo,Mikhail Youzhny,6-2; 6-0; 6-1,R16,77,2,1,34,61,28,34,18,27,1,1,11,46,61,2,5,34,59,13,34,9,25,9,16,10,22,59
2006-08-28 00:00:00.000,US Open NY; U.S.A. Grand Slams,HARD,3,Rafael Nadal,Jiri Novak,Rafael Nadal,6-1; 7-6(3); 6-4,R16,129,6,1,54,90,43,54,22,36,1,2,15,65,90,9,5,62,92,42,62,13,30,7,11,14,55,92
2006-08-28 00:00:00.000,US Open NY; U.S.A. Grand Slams,HARD,3,Roger Federer,James Blake,Roger Federer,7-6(7); 6-0; 6-7(9); 6-4,Q,165,9,4,84,137,66,84,24,53,5,8,20,90,137,8,4,91,154,54,91,31,63,10,17,20,85,154
2006-08-28 00:00:00.000,US Open NY; U.S.A. Grand Slams,HARD,3,Nikolay Davydenko,Tommy Haas,Nikolay Davydenko,4-6; 6-7(3); 6-3; 6-4; 6-4,Q,222,6,0,133,172,86,133,23,39,6,10,26,109,172,13,8,90,141,65,90,23,51,2,8,25,88,141
2006-08-28 00:00:00.000,US Open NY; U.S.A. Grand Slams,HARD,3,Andy Roddick,Lleyton Hewitt,Andy Roddick,6-3; 7-5; 6-4,Q,112,17,2,65,89,53,65,13,24,3,4,16,66,89,10,3,39,79,30,39,21,40,0,4,15,51,79
2006-08-28 00:00:00.000,US Open NY; U.S.A. Grand Slams,HARD,3,Mikhail Youzhny,Rafael Nadal,Mikhail Youzhny,6-3; 5-7; 7-6(5); 6-1,Q,195,7,3,84,128,61,84,29,44,9,11,21,90,128,1,1,78,123,52,78,22,45,5,9,19,74,123
2006-08-28 00:00:00.000,US Open NY; U.S.A. Grand Slams,HARD,3,Roger Federer,Nikolay Davydenko,Roger Federer,6-1; 7-5; 6-4,S,101,4,1,54,81,41,54,16,27,1,3,15,57,81,2,2,60,85,31,60,15,25,2,8,14,46,85
2006-08-28 00:00:00.000,US Open NY; U.S.A. Grand Slams,HARD,3,Andy Roddick,Mikhail Youzhny,Andy Roddick,6-7(5); 6-0; 7-6(3); 6-3,S,164,14,1,85,121,67,85,23,36,2,3,20,90,121,6,6,89,132,61,89,15,43,5,10,19,76,132
2006-08-28 00:00:00.000,US Open NY; U.S.A. Grand Slams,HARD,3,Roger Federer,Andy Roddick,Roger Federer,6-2; 4-6; 7-5; 6-1,F,145,17,0,63,103,53,63,20,40,6,8,19,73,103,7,1,80,122,53,80,16,42,10,16,18,69,122
2006-09-11 00:00:00.000,Beijing China ATP World Tour,HARD,2,Ivan Ljubicic,Go Soeda,Ivan Ljubicic,6-4; 6-2,R32,71,11,3,29,51,22,29,14,22,0,1,9,36,51,1,5,27,57,18,27,11,30,6,10,9,29,57
2006-09-11 00:00:00.000,Beijing China ATP World Tour,HARD,2,Kevin Kim,Kristian Pless,Kevin Kim,6-2; 6-4,R32,54,6,1,26,51,21,26,17,25,2,2,9,38,51,8,2,30,51,20,30,11,21,2,5,9,31,51
2006-09-11 00:00:00.000,Beijing China ATP World Tour,HARD,2,Michael Berrer,Gouichi Motomura,Michael Berrer,7-5; 6-4,R32,83,6,1,41,66,30,41,14,25,2,3,11,44,66,2,2,41,66,31,41,9,25,1,4,11,40,66
2006-09-11 00:00:00.000,Beijing China ATP World Tour,HARD,2,Hyung-Taik Lee,Igor Kunitsyn,Hyung-Taik Lee,6-3; 6-4,R32,67,2,2,38,57,30,38,12,19,1,2,10,42,57,5,1,30,51,24,30,6,21,2,5,9,30,51
2006-09-11 00:00:00.000,Beijing China ATP World Tour,HARD,2,Mario Ancic,Feliciano Lopez,Mario Ancic,6-3; 3-6; 6-3,R32,113,8,0,45,77,37,45,20,32,4,5,14,57,77,9,3,51,87,35,51,21,36,3,5,13,56,87
2006-09-11 00:00:00.000,Beijing China ATP World Tour,HARD,2,Stefano Galvani,Yen-Hsun Lu,Stefano Galvani,6-3; 7-6(4),R32,93,1,4,50,72,34,50,12,22,2,4,11,46,72,1,4,44,72,28,44,13,28,5,8,10,41,72
2006-09-11 00:00:00.000,Beijing China ATP World Tour,HARD,2,Alexander Peya,Ramon Delgado,Alexander Peya,6-4; 6-2,R32,65,2,1,32,49,24,32,11,17,1,2,9,35,49,1,3,32,53,19,32,10,21,3,7,9,29,53
2006-09-11 00:00:00.000,Beijing China ATP World Tour,HARD,2,Dominik Hrbaty,Rik De Voest,Dominik Hrbaty,6-1; 6-0,R32,64,3,2,20,36,19,20,8,16,3,3,6,27,36,2,1,41,72,21,41,9,31,11,17,7,30,72
2006-09-11 00:00:00.000,Beijing China ATP World Tour,HARD,2,Ivo Karlovic,Mikhail Ledovskikh,Ivo Karlovic,6-2; 7-6(2),R32,74,25,1,45,57,40,45,6,12,1,1,10,46,57,7,5,31,61,21,31,16,30,1,3,10,37,61
2006-09-11 00:00:00.000,Beijing China ATP World Tour,HARD,2,Danai Udomchoke,Marco Chiudinelli,Danai Udomchoke,0-6; 6-2; 6-3,R32,120,5,2,43,75,32,43,13,32,4,7,11,45,75,10,0,55,102,34,55,21,47,14,18,12,55,102
2006-09-11 00:00:00.000,Beijing China ATP World Tour,HARD,2,Jimmy Wang,Xin-Yuan Yu,Jimmy Wang,6-1; 6-4,R32,71,5,0,31,47,24,31,8,16,4,5,8,32,47,4,2,27,52,16,27,8,25,3,8,9,24,52
2006-09-11 00:00:00.000,Beijing China ATP World Tour,HARD,2,Marcos Baghdatis,Denis Gremelmayr,Marcos Baghdatis,4-6; 6-1; 7-6(5),R32,130,4,5,43,104,34,43,32,61,9,11,15,66,104,2,2,60,90,37,60,19,30,3,6,14,56,90
2006-09-11 00:00:00.000,Beijing China ATP World Tour,HARD,2,Paradorn Srichaphan,Rainer Schuettler,Paradorn Srichaphan,6-3; 6-3,R32,67,7,3,23,53,18,23,21,30,2,2,9,39,53,4,2,33,55,20,33,11,22,5,8,9,31,55
2006-09-11 00:00:00.000,Beijing China ATP World Tour,HARD,2,Satoshi Iwabuchi,Nathan Healey,Satoshi Iwabuchi,6-1; 7-6(5),R32,86,2,0,46,62,32,46,12,16,2,3,10,44,62,4,8,34,60,24,34,10,26,4,7,9,34,60
2006-09-11 00:00:00.000,Beijing China ATP World Tour,HARD,2,Luka Gregorc,Yu Jr. Wang,Luka Gregorc,7-6(6); 6-3,R32,113,8,7,37,64,28,37,11,27,2,5,10,39,64,4,3,60,85,36,60,8,25,3,8,11,44,85
2006-09-11 00:00:00.000,Beijing China ATP World Tour,HARD,2,Nikolay Davydenko,Kenneth Carlsen,Nikolay Davydenko,6-3; 6-4,R32,78,3,2,41,60,27,41,14,19,5,6,10,41,60,1,1,30,50,19,30,10,20,0,3,9,29,50
2006-09-11 00:00:00.000,Beijing China ATP World Tour,HARD,2,Ivan Ljubicic,Kevin Kim,Ivan Ljubicic,6-3; 6-4,R16,67,15,2,35,59,31,35,12,24,1,1,10,43,59,2,4,27,57,21,27,14,30,0,2,9,35,57
2006-09-11 00:00:00.000,Beijing China ATP World Tour,HARD,2,Hyung-Taik Lee,Michael Berrer,Hyung-Taik Lee,4-6; 7-6(4); 7-6(4),R16,144,10,0,73,105,53,73,19,32,4,7,17,72,105,10,7,71,115,56,71,18,44,3,5,17,74,115
2006-09-11 00:00:00.000,Beijing China ATP World Tour,HARD,2,Mario Ancic,Stefano Galvani,Mario Ancic,6-3; 7-5,R16,101,13,1,37,60,28,37,13,23,0,1,11,41,60,1,5,38,73,24,38,19,35,1,4,10,43,73
2006-09-11 00:00:00.000,Beijing China ATP World Tour,HARD,2,Dominik Hrbaty,Alexander Peya,Dominik Hrbaty,6-1; 2-6; 6-0,R16,80,0,4,43,72,25,43,17,29,5,8,11,42,72,6,7,35,58,20,35,8,23,5,11,10,28,58
2006-09-11 00:00:00.000,Beijing China ATP World Tour,HARD,2,Danai Udomchoke,Ivo Karlovic,Danai Udomchoke,6-2; 3-1 RET,R16,42,3,0,26,31,23,26,2,5,0,0,6,25,31,7,0,24,39,15,24,5,15,2,5,6,20,39
2006-09-11 00:00:00.000,Beijing China ATP World Tour,HARD,2,Marcos Baghdatis,Jimmy Wang,Marcos Baghdatis,7-6(4); 6-4,R16,100,10,3,39,82,25,39,27,43,3,4,11,52,82,3,1,47,77,31,47,14,30,4,6,11,45,77
2006-09-11 00:00:00.000,Beijing China ATP World Tour,HARD,2,Paradorn Srichaphan,Satoshi Iwabuchi,Paradorn Srichaphan,6-3; 6-1,R16,54,8,2,20,43,19,20,14,23,0,0,8,33,43,0,2,29,52,16,29,9,23,3,7,8,25,52
2006-09-11 00:00:00.000,Beijing China ATP World Tour,HARD,2,Nikolay Davydenko,Luka Gregorc,Nikolay Davydenko,7-6(2); 6-2,R16,82,5,1,52,68,40,52,8,16,3,4,10,48,68,6,8,43,61,30,43,6,18,1,4,10,36,61
2006-09-11 00:00:00.000,Beijing China ATP World Tour,HARD,2,Hyung-Taik Lee,Ivan Ljubicic,Hyung-Taik Lee,6-3; 7-6(3),Q,101,0,0,51,72,37,51,13,21,1,2,11,50,72,12,2,53,81,37,53,11,28,4,6,10,48,81
2006-09-11 00:00:00.000,Beijing China ATP World Tour,HARD,2,Mario Ancic,Dominik Hrbaty,Mario Ancic,2-6; 7-6(4); 6-4,Q,130,13,0,78,99,53,78,13,21,5,7,15,66,99,2,8,63,100,50,63,17,37,5,6,15,67,100
2006-09-11 00:00:00.000,Beijing China ATP World Tour,HARD,2,Marcos Baghdatis,Danai Udomchoke,Marcos Baghdatis,6-2; 6-1,Q,79,8,5,23,59,22,23,17,36,7,7,8,39,59,0,7,29,55,20,29,5,26,8,12,7,25,55
2006-09-11 00:00:00.000,Beijing China ATP World Tour,HARD,2,Paradorn Srichaphan,Nikolay Davydenko,Paradorn Srichaphan,6-2; 1-0 RET,Q,32,1,0,14,25,10,14,10,11,0,0,5,20,25,2,1,12,19,8,12,2,7,0,2,4,10,19
2006-09-11 00:00:00.000,Beijing China ATP World Tour,HARD,2,Mario Ancic,Hyung-Taik Lee,Mario Ancic,4-6; 6-1; 6-1,S,129,3,3,47,82,30,47,22,35,6,8,12,52,82,3,0,55,84,29,55,14,29,5,11,12,43,84
2006-09-11 00:00:00.000,Beijing China ATP World Tour,HARD,2,Marcos Baghdatis,Paradorn Srichaphan,Marcos Baghdatis,6-2; 3-6; 7-5,S,121,2,3,47,83,40,47,18,36,5,6,14,58,83,6,3,61,95,44,61,15,34,6,9,15,59,95
2006-09-11 00:00:00.000,Beijing China ATP World Tour,HARD,2,Marcos Baghdatis,Mario Ancic,Marcos Baghdatis,6-4; 6-0,F,72,5,1,21,39,18,21,14,18,0,0,8,32,39,5,0,32,54,18,32,8,22,2,6,8,26,54
2006-09-11 00:00:00.000,Bucharest Romania ATP World Tour,CLAY,2,Dmitry Tursunov,Alexander Waske,Dmitry Tursunov,1-6; 7-6(4); 6-4,R32,130,9,2,55,101,39,55,17,46,4,10,15,56,101,10,4,54,85,37,54,14,31,3,7,14,51,85
2006-09-11 00:00:00.000,Bucharest Romania ATP World Tour,CLAY,2,Guillermo Garcia-Lopez,Albert Montanes,Guillermo Garcia-Lopez,3-6; 7-5; 6-1,R32,113,4,2,60,85,35,60,12,25,8,13,14,47,85,1,4,45,85,29,45,14,40,5,12,14,43,85
2006-09-11 00:00:00.000,Bucharest Romania ATP World Tour,CLAY,2,Victor Crivoi,Edgardo Massa,Victor Crivoi,7-5; 4-6; 6-4,R32,126,1,3,58,86,45,58,10,28,2,6,16,55,86,3,4,66,107,44,66,21,41,8,13,16,65,107
2006-09-11 00:00:00.000,Bucharest Romania ATP World Tour,CLAY,2,Paul-Henri Mathieu,Simon Greul,Paul-Henri Mathieu,6-1; 6-1,R32,54,1,0,26,43,18,26,11,17,2,3,7,29,43,0,0,26,39,11,26,2,13,5,11,7,13,39
2006-09-11 00:00:00.000,Bucharest Romania ATP World Tour,CLAY,2,Gilles Simon,Juan Monaco,Gilles Simon,7-5; 3-6; 6-3,R32,152,6,4,49,97,31,49,27,48,7,11,15,58,97,1,4,60,89,39,60,14,29,5,10,15,53,89
2006-09-11 00:00:00.000,Bucharest Romania ATP World Tour,CLAY,2,Jurgen Melzer,Michal Mertinak,Jurgen Melzer,5-7; 6-2; 7-5,R32,138,8,2,62,97,44,62,17,35,4,8,16,61,97,1,1,57,99,30,57,25,42,6,12,16,55,99
2006-09-11 00:00:00.000,Bucharest Romania ATP World Tour,CLAY,2,Christophe Rochus,Alexandr Dolgopolov,Christophe Rochus,6-2; 7-6(5),R32,70,2,3,43,61,33,43,10,18,2,3,10,43,61,5,1,36,62,24,36,12,26,2,4,10,36,62
2006-09-11 00:00:00.000,Bucharest Romania ATP World Tour,CLAY,2,Ruben Ramirez Hidalgo,Victor Ionita,Ruben Ramirez Hidalgo,6-4; 6-4,R32,88,2,0,41,59,30,41,7,18,2,4,10,37,59,2,1,43,63,25,43,10,20,5,9,10,35,63
2006-09-11 00:00:00.000,Bucharest Romania ATP World Tour,CLAY,2,Filippo Volandri,Simone Vagnozzi,Filippo Volandri,3-6; 6-2; 6-2,R32,85,4,2,55,81,33,55,10,26,6,11,13,43,81,1,1,58,73,25,58,9,15,1,8,12,34,73
2006-09-11 00:00:00.000,Bucharest Romania ATP World Tour,CLAY,2,Stefan Koubek,Mariano Zabaleta,Stefan Koubek,4-6; 6-4; 6-3,R32,154,4,5,61,106,36,61,26,45,7,11,15,62,106,0,2,79,121,49,79,16,42,13,18,14,65,121
2006-09-11 00:00:00.000,Bucharest Romania ATP World Tour,CLAY,2,Andrei Pavel,Boris Pashanski,Andrei Pavel,6-3; 6-1,R32,77,4,1,27,49,21,27,15,22,1,1,8,36,49,0,3,33,65,19,33,15,32,6,10,8,34,65
2006-09-11 00:00:00.000,Bucharest Romania ATP World Tour,CLAY,2,Carlos Moya,Luis Horna,Carlos Moya,6-7(4); 7-6(3); 7-5,R32,179,11,3,71,113,57,71,23,42,1,1,18,80,113,2,5,80,128,60,80,26,48,7,8,18,86,128
2006-09-11 00:00:00.000,Bucharest Romania ATP World Tour,CLAY,2,Florian Mayer,Potito Starace,Florian Mayer,6-2; 6-3,R32,69,1,1,37,56,25,37,10,19,3,5,9,35,56,0,1,43,56,22,43,5,13,1,6,8,27,56
2006-09-11 00:00:00.000,Bucharest Romania ATP World Tour,CLAY,2,Sergio Roitman,Alessio Di Mauro,Sergio Roitman,6-3; 6-2,R32,71,1,0,28,41,22,28,11,13,0,0,8,33,41,1,2,34,54,21,34,7,20,1,5,9,28,54
2006-09-11 00:00:00.000,Bucharest Romania ATP World Tour,CLAY,2,Martin Vassallo Arguello,Razvan Sabau,Martin Vassallo Arguello,6-3; 1-6; 6-3,R32,120,8,2,65,94,41,65,16,29,10,13,13,57,94,2,3,36,61,28,36,11,25,0,3,12,39,61
2006-09-11 00:00:00.000,Bucharest Romania ATP World Tour,CLAY,2,Florent Serra,Juan-Martin Aranguren,Florent Serra,6-1; 6-0,R32,135,2,1,24,32,20,24,5,8,0,0,6,25,32,0,1,21,39,7,21,5,18,1,7,7,12,39
2006-09-11 00:00:00.000,Bucharest Romania ATP World Tour,CLAY,2,Guillermo Garcia-Lopez,Dmitry Tursunov,Guillermo Garcia-Lopez,6-2; 3-6; 7-6(3),R16,148,2,3,71,98,48,71,12,27,7,11,14,60,98,8,2,63,111,39,63,23,48,13,18,15,62,111
2006-09-11 00:00:00.000,Bucharest Romania ATP World Tour,CLAY,2,Paul-Henri Mathieu,Victor Crivoi,Paul-Henri Mathieu,6-1; 6-1,R16,69,4,0,26,38,20,26,9,12,0,0,7,29,38,2,1,35,55,18,35,7,20,5,10,7,25,55
2006-09-11 00:00:00.000,Bucharest Romania ATP World Tour,CLAY,2,Jurgen Melzer,Gilles Simon,Jurgen Melzer,3-6; 6-3; 6-4,R16,133,5,2,64,103,38,64,16,39,6,12,14,54,103,2,1,63,98,36,63,13,35,9,16,14,49,98
2006-09-11 00:00:00.000,Bucharest Romania ATP World Tour,CLAY,2,Ruben Ramirez Hidalgo,Christophe Rochus,Ruben Ramirez Hidalgo,3-6; 6-3; 6-1,R16,99,6,2,52,71,36,52,9,19,5,9,13,45,71,1,0,44,70,23,44,13,26,2,8,12,36,70
2006-09-11 00:00:00.000,Bucharest Romania ATP World Tour,CLAY,2,Filippo Volandri,Stefan Koubek,Filippo Volandri,3-6; 6-2; 6-2,R16,108,1,0,57,75,34,57,8,18,1,5,12,42,75,0,8,61,104,35,61,16,43,19,26,13,51,104
2006-09-11 00:00:00.000,Bucharest Romania ATP World Tour,CLAY,2,Carlos Moya,Andrei Pavel,Carlos Moya,6-4; 7-6(5),R16,98,6,1,44,74,35,44,14,30,4,6,11,49,74,1,1,45,65,32,45,9,20,3,6,11,41,65
2006-09-11 00:00:00.000,Bucharest Romania ATP World Tour,CLAY,2,Florian Mayer,Sergio Roitman,Florian Mayer,6-4; 6-1,R16,68,5,1,32,51,24,32,12,19,1,1,8,36,51,4,0,42,57,27,42,4,15,4,8,9,31,57
2006-09-11 00:00:00.000,Bucharest Romania ATP World Tour,CLAY,2,Florent Serra,Martin Vassallo Arguello,Florent Serra,6-4; 6-1,R16,79,1,1,25,42,21,25,12,17,3,3,8,33,42,1,2,48,64,26,48,7,16,5,9,9,33,64
2006-09-11 00:00:00.000,Bucharest Romania ATP World Tour,CLAY,2,Paul-Henri Mathieu,Guillermo Garcia-Lopez,Paul-Henri Mathieu,6-1; 6-4,Q,91,1,1,41,65,26,41,15,24,6,7,9,41,65,0,1,24,46,10,24,14,22,3,7,8,24,46
2006-09-11 00:00:00.000,Bucharest Romania ATP World Tour,CLAY,2,Jurgen Melzer,Ruben Ramirez Hidalgo,Jurgen Melzer,6-4; 6-2,Q,72,3,1,39,54,23,39,8,15,1,4,9,31,54,3,1,37,53,20,37,4,16,0,6,9,24,53
2006-09-11 00:00:00.000,Bucharest Romania ATP World Tour,CLAY,2,Filippo Volandri,Carlos Moya,Filippo Volandri,6-3; 6-3,Q,78,0,1,45,58,34,45,6,13,4,4,9,40,58,4,5,38,65,29,38,8,27,5,8,9,37,65
2006-09-11 00:00:00.000,Bucharest Romania ATP World Tour,CLAY,2,Florent Serra,Florian Mayer,Florent Serra,6-3; 7-6(5),Q,82,3,1,39,67,24,39,15,28,5,9,10,39,67,4,3,41,67,23,41,11,26,2,8,11,34,67
2006-09-11 00:00:00.000,Bucharest Romania ATP World Tour,CLAY,2,Jurgen Melzer,Paul-Henri Mathieu,Jurgen Melzer,6-4 RET,S,49,2,0,20,29,15,20,7,9,2,2,5,22,29,1,0,20,31,15,20,5,11,3,4,5,20,31
2006-09-11 00:00:00.000,Bucharest Romania ATP World Tour,CLAY,2,Filippo Volandri,Florent Serra,Filippo Volandri,7-6(6); 6-4,S,101,1,1,52,72,34,52,16,20,5,6,11,50,72,3,1,49,85,30,49,21,36,9,11,11,51,85
2006-09-11 00:00:00.000,Bucharest Romania ATP World Tour,CLAY,2,Jurgen Melzer,Filippo Volandri,Jurgen Melzer,6-1; 7-5,F,85,7,0,40,59,31,40,13,19,1,1,10,44,59,0,0,45,67,28,45,11,22,5,8,9,39,67
2006-09-25 00:00:00.000,Bangkok Thailand ATP World Tour,HARD,2,Ivan Ljubicic,Fernando Vicente,Ivan Ljubicic,6-3; 3-6; 6-4,R32,115,19,0,40,68,34,40,19,28,0,1,14,53,68,2,4,64,95,44,64,18,31,8,10,14,62,95
2006-09-25 00:00:00.000,Bangkok Thailand ATP World Tour,HARD,2,Benjamin Becker,Marcos Daniel,Benjamin Becker,6-3; 6-2,R32,49,10,2,30,47,29,30,8,17,1,1,9,37,47,3,1,35,46,22,35,3,11,1,4,8,25,46
2006-09-25 00:00:00.000,Bangkok Thailand ATP World Tour,HARD,2,Danai Udomchoke,George Bastl,Danai Udomchoke,6-3; 6-0,R32,73,3,0,25,44,18,25,13,19,1,1,7,31,44,3,2,29,54,20,29,5,25,4,9,8,25,54
2006-09-25 00:00:00.000,Bangkok Thailand ATP World Tour,HARD,2,Robby Ginepri,Kenneth Carlsen,Robby Ginepri,6-3; 6-4,R32,69,4,1,36,49,29,36,9,13,1,2,10,38,49,3,1,40,62,24,40,9,22,5,8,9,33,62
2006-09-25 00:00:00.000,Bangkok Thailand ATP World Tour,HARD,2,Tim Henman,Andy Murray,Tim Henman,6-4; 6-2,R32,87,7,3,44,70,31,44,13,26,6,7,9,44,70,3,2,39,58,24,39,8,19,2,6,9,32,58
2006-09-25 00:00:00.000,Bangkok Thailand ATP World Tour,HARD,2,Alex Bogdanovic,Jimmy Wang,Alex Bogdanovic,6-7(7); 6-4; 6-4,R32,132,6,2,60,100,49,60,21,40,2,3,16,70,100,14,0,56,97,44,56,21,41,2,5,16,65,97
2006-09-25 00:00:00.000,Bangkok Thailand ATP World Tour,HARD,2,Mikhail Ledovskikh,Michael Ryderstedt,Mikhail Ledovskikh,6-1; 7-6(7),R32,89,18,2,42,70,36,42,15,28,4,4,10,51,70,4,1,32,67,24,32,19,35,5,7,9,43,67
2006-09-25 00:00:00.000,Bangkok Thailand ATP World Tour,HARD,2,Paradorn Srichaphan,Feliciano Lopez,Paradorn Srichaphan,6-1; 6-4,R32,56,3,2,26,42,23,26,13,16,0,0,9,36,42,2,5,21,44,17,21,9,23,3,6,8,26,44
2006-09-25 00:00:00.000,Bangkok Thailand ATP World Tour,HARD,2,Jarkko Nieminen,Edgardo Massa,Jarkko Nieminen,6-7(6); 6-3; 6-2,R32,109,4,5,68,111,50,68,24,43,8,9,15,74,111,4,5,37,83,31,37,24,46,5,9,14,55,83
2006-09-25 00:00:00.000,Bangkok Thailand ATP World Tour,HARD,2,Frank Dancevic,Lars Burgsmuller,Frank Dancevic,7-5; 3-6; 7-6(7),R32,171,10,2,78,117,55,78,19,39,6,9,16,74,117,8,6,94,133,68,94,14,39,14,17,17,82,133
2006-09-25 00:00:00.000,Bangkok Thailand ATP World Tour,HARD,2,Benjamin Balleret,Alexander Waske,Benjamin Balleret,7-5; 2-6; 6-1,R32,95,16,0,49,69,36,49,14,20,0,2,14,50,69,11,4,46,90,39,46,16,44,7,10,13,55,90
2006-09-25 00:00:00.000,Bangkok Thailand ATP World Tour,HARD,2,James Blake,Marin Cilic,James Blake,6-1; 6-2,R32,47,3,1,25,41,20,25,10,16,1,2,8,30,41,2,2,29,45,14,29,6,16,3,8,7,20,45
2006-09-25 00:00:00.000,Bangkok Thailand ATP World Tour,HARD,2,Mischa Zverev,Juan Carlos Ferrero,Mischa Zverev,4-6; 6-2; 6-4,R32,102,10,0,68,94,52,68,10,26,4,5,14,62,94,2,2,51,74,37,51,13,23,2,5,14,50,74
2006-09-25 00:00:00.000,Bangkok Thailand ATP World Tour,HARD,2,Rainer Schuettler,Hyung-Taik Lee,Rainer Schuettler,6-1; 6-4,R32,62,6,3,25,45,18,25,14,20,0,1,9,32,45,0,2,44,58,24,44,5,14,7,11,8,29,58
2006-09-25 00:00:00.000,Bangkok Thailand ATP World Tour,HARD,2,Marat Safin,Kevin Kim,Marat Safin,2-6; 6-1; 6-4,R32,89,10,1,44,73,27,44,16,29,4,8,13,43,73,5,2,60,87,37,60,11,27,8,13,12,48,87
2006-09-25 00:00:00.000,Bangkok Thailand ATP World Tour,HARD,2,Julien Benneteau,Satoshi Iwabuchi,Julien Benneteau,6-4; 6-2,R32,81,12,3,43,64,30,43,11,21,7,8,9,41,64,1,2,47,67,28,47,7,20,9,13,9,35,67
2006-09-25 00:00:00.000,Bangkok Thailand ATP World Tour,HARD,2,Ivan Ljubicic,Benjamin Becker,Ivan Ljubicic,7-6(6); 7-5,R16,114,16,4,47,88,39,47,23,41,3,3,12,62,88,8,3,46,76,35,46,19,30,4,5,12,54,76
2006-09-25 00:00:00.000,Bangkok Thailand ATP World Tour,HARD,2,Robby Ginepri,Danai Udomchoke,Robby Ginepri,6-3; 6-3,R16,68,14,0,46,67,31,46,13,21,6,6,9,44,67,4,2,35,54,26,35,5,19,4,7,9,31,54
2006-09-25 00:00:00.000,Bangkok Thailand ATP World Tour,HARD,2,Tim Henman,Alex Bogdanovic,Tim Henman,6-3; 5-7; 6-1,R16,140,7,3,55,91,41,55,19,36,5,7,14,60,91,2,4,59,101,34,59,22,42,9,14,14,56,101
2006-09-25 00:00:00.000,Bangkok Thailand ATP World Tour,HARD,2,Paradorn Srichaphan,Mikhail Ledovskikh,Paradorn Srichaphan,6-4; 5-7; 6-2,R16,131,14,7,48,92,41,48,25,44,6,7,15,66,92,19,4,62,126,48,62,26,64,11,14,15,74,126
2006-09-25 00:00:00.000,Bangkok Thailand ATP World Tour,HARD,2,Jarkko Nieminen,Frank Dancevic,Jarkko Nieminen,2-6; 7-6(3); 6-4,R16,114,8,5,61,102,43,61,22,41,6,9,15,65,102,9,1,65,87,50,65,10,22,6,8,15,60,87
2006-09-25 00:00:00.000,Bangkok Thailand ATP World Tour,HARD,2,James Blake,Benjamin Balleret,James Blake,6-3; 6-2,R16,56,4,5,29,57,22,29,16,28,3,4,9,38,57,3,0,30,49,13,30,12,19,3,7,8,25,49
2006-09-25 00:00:00.000,Bangkok Thailand ATP World Tour,HARD,2,Mischa Zverev,Rainer Schuettler,Mischa Zverev,7-6(7); 7-5,R16,95,5,4,50,73,36,50,12,23,1,3,12,48,73,1,2,42,81,29,42,21,39,7,10,12,50,81
2006-09-25 00:00:00.000,Bangkok Thailand ATP World Tour,HARD,2,Marat Safin,Julien Benneteau,Marat Safin,7-6(5); 6-7(3); 6-2,R16,138,18,0,76,111,55,76,18,35,7,9,16,73,111,7,7,71,105,52,71,12,34,2,6,16,64,105
2006-09-25 00:00:00.000,Bangkok Thailand ATP World Tour,HARD,2,Ivan Ljubicic,Robby Ginepri,Ivan Ljubicic,4-6; 6-3; 6-4,Q,118,14,3,46,76,36,46,22,30,1,2,15,58,76,4,1,61,89,38,61,19,28,8,10,14,57,89
2006-09-25 00:00:00.000,Bangkok Thailand ATP World Tour,HARD,2,Paradorn Srichaphan,Tim Henman,Paradorn Srichaphan,6-7(2); 6-4; 7-6(4),Q,145,12,6,60,101,49,60,24,41,1,3,17,73,101,6,5,61,106,45,61,26,45,5,8,17,71,106
2006-09-25 00:00:00.000,Bangkok Thailand ATP World Tour,HARD,2,James Blake,Jarkko Nieminen,James Blake,6-2; 2-6; 7-5,Q,101,11,5,44,93,31,44,22,49,4,9,14,53,93,7,3,54,87,39,54,9,33,7,13,14,48,87
2006-09-25 00:00:00.000,Bangkok Thailand ATP World Tour,HARD,2,Marat Safin,Mischa Zverev,Marat Safin,7-6(4); 5-7; 7-5,Q,129,4,3,73,113,57,73,19,40,0,2,18,76,113,10,0,75,105,54,75,19,30,6,8,18,73,105
2006-09-25 00:00:00.000,Bangkok Thailand ATP World Tour,HARD,2,Ivan Ljubicic,Paradorn Srichaphan,Ivan Ljubicic,6-3; 6-2,S,77,17,0,39,67,30,39,15,28,4,4,9,45,67,2,1,32,51,19,32,10,19,3,6,8,29,51
2006-09-25 00:00:00.000,Bangkok Thailand ATP World Tour,HARD,2,James Blake,Marat Safin,James Blake,3-6; 6-4; 7-6(3),S,124,6,0,68,109,51,68,17,41,4,8,16,68,109,5,2,74,112,49,74,20,38,9,12,15,69,112
2006-09-25 00:00:00.000,Bangkok Thailand ATP World Tour,HARD,2,James Blake,Ivan Ljubicic,James Blake,6-3; 6-1,F,59,1,0,30,47,21,30,11,17,1,2,8,32,47,2,4,19,45,13,19,7,26,1,6,8,20,45
2006-09-25 00:00:00.000,Mumbai India ATP World Tour,HARD,2,Tommy Robredo,Alexander Peya,Tommy Robredo,6-4; 6-2,R32,98,2,2,35,54,30,35,10,19,5,5,9,40,54,3,3,39,82,25,39,20,43,4,7,9,45,82
2006-09-25 00:00:00.000,Mumbai India ATP World Tour,HARD,2,Michael Berrer,Konstantinos Economidis,Michael Berrer,6-2; 7-6(3),R32,71,8,1,26,55,22,26,21,29,0,1,10,43,55,5,3,40,64,26,40,13,24,4,7,10,39,64
2006-09-25 00:00:00.000,Mumbai India ATP World Tour,HARD,2,Ramon Delgado,Davide Sanguinetti,Ramon Delgado,6-3; 2-1 RET,R32,58,10,1,22,35,21,22,7,13,0,0,6,28,35,1,2,28,46,18,28,8,18,3,5,6,26,46
2006-09-25 00:00:00.000,Mumbai India ATP World Tour,HARD,2,Juan Martin Del Potro,Carlos Moya,Juan Martin Del Potro,6-3; 6-2,R32,64,1,3,40,54,32,40,5,14,1,2,9,37,54,6,1,20,42,12,20,8,22,2,6,8,20,42
2006-09-25 00:00:00.000,Mumbai India ATP World Tour,HARD,2,Dmitry Tursunov,Akash Wagh,Dmitry Tursunov,6-2; 7-5,R32,62,6,5,28,59,24,28,19,31,3,4,10,43,59,7,3,29,58,19,29,12,29,3,7,10,31,58
2006-09-25 00:00:00.000,Mumbai India ATP World Tour,HARD,2,Kristian Pless,Denis Gremelmayr,Kristian Pless,7-5; 7-5,R32,82,4,4,40,68,31,40,15,28,1,3,12,46,68,6,1,44,73,31,44,9,29,3,7,12,40,73
2006-09-25 00:00:00.000,Mumbai India ATP World Tour,HARD,2,James Auckland,Frank Moser,James Auckland,6-1; 6-4,R32,75,7,4,32,54,25,32,12,22,4,5,9,37,54,5,2,37,54,23,37,5,17,3,7,8,28,54
2006-09-25 00:00:00.000,Mumbai India ATP World Tour,HARD,2,Wesley Moodie,Rohan Bopanna,Wesley Moodie,3-6; 7-6(5); 6-4,R32,125,19,4,65,99,50,65,18,34,7,9,15,68,99,15,1,48,98,40,48,29,50,5,7,16,69,98
2006-09-25 00:00:00.000,Mumbai India ATP World Tour,HARD,2,Bjorn Phau,Karan Rastogi,Bjorn Phau,6-0; 6-3,R32,54,13,0,20,33,18,20,10,13,0,0,7,28,33,0,1,35,50,19,35,5,15,9,14,8,24,50
2006-09-25 00:00:00.000,Mumbai India ATP World Tour,HARD,2,Gouichi Motomura,Jasper Smit,Gouichi Motomura,3-6; 6-0; 7-6(5),R32,116,2,0,64,98,39,64,22,34,3,5,13,61,98,9,9,40,82,32,40,20,42,3,7,14,52,82
2006-09-25 00:00:00.000,Mumbai India ATP World Tour,HARD,2,Simon Greul,Yen-Hsun Lu,Simon Greul,7-6(4); 6-3,R32,94,10,6,50,82,41,50,16,32,8,9,11,57,82,3,4,40,63,31,40,10,23,0,2,10,41,63
2006-09-25 00:00:00.000,Mumbai India ATP World Tour,HARD,2,Tomas Berdych,Lukasz Kubot,Tomas Berdych,6-2; 6-2,R32,68,8,2,32,45,26,32,8,13,3,3,8,34,45,4,2,47,68,28,47,7,21,7,11,8,35,68
2006-09-25 00:00:00.000,Mumbai India ATP World Tour,HARD,2,Stefan Koubek,Juan Monaco,Stefan Koubek,7-6(5); 6-4,R32,106,7,2,42,78,34,42,18,36,6,7,11,52,78,1,3,50,79,35,50,15,29,2,4,11,50,79
2006-09-25 00:00:00.000,Mumbai India ATP World Tour,HARD,2,Nicolas Devilder,Rik De Voest,Nicolas Devilder,6-4; 4-6; 6-3,R32,132,7,4,66,106,47,66,19,40,6,8,15,66,106,6,6,53,85,41,53,14,32,10,13,14,55,85
2006-09-25 00:00:00.000,Mumbai India ATP World Tour,HARD,2,Stefano Galvani,Robin Vik,Stefano Galvani,5-7; 6-4; 6-4,R32,144,4,6,59,93,39,59,16,34,5,10,16,55,93,7,3,65,97,45,65,9,32,5,11,16,54,97
2006-09-25 00:00:00.000,Mumbai India ATP World Tour,HARD,2,Mario Ancic,Igor Kunitsyn,Mario Ancic,6-3; 6-2,R32,80,11,0,37,52,28,37,11,15,0,0,9,39,52,0,5,28,60,17,28,16,32,7,10,8,33,60
2006-09-25 00:00:00.000,Mumbai India ATP World Tour,HARD,2,Tommy Robredo,Michael Berrer,Tommy Robredo,5-7; 6-2; 6-4,R16,112,6,2,53,81,40,53,19,28,4,6,15,59,81,7,3,52,83,39,52,14,31,2,6,15,53,83
2006-09-25 00:00:00.000,Mumbai India ATP World Tour,HARD,2,Ramon Delgado,Juan Martin Del Potro,Ramon Delgado,6-3; 4-1 RET,R16,75,4,0,28,47,20,28,13,19,8,8,7,33,47,3,1,31,41,17,31,5,10,1,4,7,22,41
2006-09-25 00:00:00.000,Mumbai India ATP World Tour,HARD,2,Dmitry Tursunov,Kristian Pless,Dmitry Tursunov,6-7(5); 6-3; 6-4,R16,111,16,4,59,103,45,59,27,44,2,3,16,72,103,14,0,57,91,39,57,23,34,5,8,15,62,91
2006-09-25 00:00:00.000,Mumbai India ATP World Tour,HARD,2,James Auckland,Wesley Moodie,James Auckland,7-6(3); 7-6(5),R16,108,16,1,51,82,38,51,20,31,0,0,12,58,82,15,3,51,78,42,51,13,27,2,2,12,55,78
2006-09-25 00:00:00.000,Mumbai India ATP World Tour,HARD,2,Bjorn Phau,Gouichi Motomura,Bjorn Phau,6-3; 6-3,R16,64,5,1,26,45,23,26,13,19,0,0,9,36,45,2,1,38,62,27,38,9,24,4,7,9,36,62
2006-09-25 00:00:00.000,Mumbai India ATP World Tour,HARD,2,Tomas Berdych,Simon Greul,Tomas Berdych,7-6(4); 6-4,R16,89,6,3,30,67,28,30,23,37,2,2,11,51,67,2,1,43,79,31,43,20,36,3,4,11,51,79
2006-09-25 00:00:00.000,Mumbai India ATP World Tour,HARD,2,Stefan Koubek,Nicolas Devilder,Stefan Koubek,7-5; 6-3,R16,91,12,3,36,64,26,36,18,28,4,6,11,44,64,0,4,38,66,23,38,13,28,4,8,10,36,66
2006-09-25 00:00:00.000,Mumbai India ATP World Tour,HARD,2,Mario Ancic,Stefano Galvani,Mario Ancic,6-1; 7-6,R16,85,7,5,34,57,28,34,7,23,4,5,8,35,57,1,1,31,51,19,31,10,20,3,6,8,29,51
2006-09-25 00:00:00.000,Mumbai India ATP World Tour,HARD,2,Tommy Robredo,Ramon Delgado,Tommy Robredo,6-2; 7-6(1),Q,90,5,4,33,64,28,33,18,31,2,3,10,46,64,3,4,32,58,23,32,12,26,2,5,10,35,58
2006-09-25 00:00:00.000,Mumbai India ATP World Tour,HARD,2,Dmitry Tursunov,James Auckland,Dmitry Tursunov,3-6; 6-3; 6-4,Q,97,10,5,46,78,37,46,19,32,3,4,14,56,78,12,4,51,83,38,51,18,32,4,6,14,56,83
2006-09-25 00:00:00.000,Mumbai India ATP World Tour,HARD,2,Tomas Berdych,Bjorn Phau,Tomas Berdych,6-3; 7-5,Q,73,10,2,38,63,30,38,15,25,5,6,11,45,63,5,4,24,64,15,24,22,40,2,5,10,37,64
2006-09-25 00:00:00.000,Mumbai India ATP World Tour,HARD,2,Stefan Koubek,Mario Ancic,Stefan Koubek,3-6; 6-4; 6-3,Q,131,4,4,47,81,38,47,15,34,2,4,14,53,81,5,1,46,80,30,46,21,34,5,8,14,51,80
2006-09-25 00:00:00.000,Mumbai India ATP World Tour,HARD,2,Dmitry Tursunov,Tommy Robredo,Dmitry Tursunov,7-6(2); 3-6; 6-1,S,128,3,4,46,84,35,46,19,38,2,5,14,54,84,6,3,63,89,41,63,11,26,1,5,14,52,89
2006-09-25 00:00:00.000,Mumbai India ATP World Tour,HARD,2,Tomas Berdych,Stefan Koubek,Tomas Berdych,7-6(2); 6-2,S,80,11,1,43,69,32,43,18,26,2,2,10,50,69,4,2,42,61,29,42,9,19,5,7,10,38,61
2006-09-25 00:00:00.000,Mumbai India ATP World Tour,HARD,2,Dmitry Tursunov,Tomas Berdych,Dmitry Tursunov,6-3; 4-6; 7-6(5),F,165,9,11,53,102,38,53,22,49,4,9,16,60,102,7,2,56,96,37,56,20,40,8,13,15,57,96
2006-09-25 00:00:00.000,Palermo Italy ATP World Tour,CLAY,2,Fernando Verdasco,Daniele Bracciali,Fernando Verdasco,5-7; 6-4; 6-4,R32,145,4,3,77,100,52,77,12,23,5,8,16,64,100,7,3,60,112,43,60,22,52,10,14,16,65,112
2006-09-25 00:00:00.000,Palermo Italy ATP World Tour,CLAY,2,Jan Hajek,Bohdan Ulihrach,Jan Hajek,6-3; 7-6(2),R32,79,5,3,45,76,31,45,11,31,10,14,10,42,76,2,2,38,68,20,38,12,30,5,11,11,32,68
2006-09-25 00:00:00.000,Palermo Italy ATP World Tour,CLAY,2,Gianluca Naso,Jiri Vanek,Gianluca Naso,1-2 RET,R32,17,0,1,5,11,4,5,2,6,1,2,2,6,11,0,2,6,9,3,6,1,3,1,1,1,4,9
2006-09-25 00:00:00.000,Palermo Italy ATP World Tour,CLAY,2,Ruben Ramirez Hidalgo,Alessio Di Mauro,Ruben Ramirez Hidalgo,7-6(7); 6-3,R32,127,2,1,39,74,28,39,19,35,3,5,10,47,74,1,1,44,80,24,44,20,36,4,8,11,44,80
2006-09-25 00:00:00.000,Palermo Italy ATP World Tour,CLAY,2,Gilles Simon,Andreas Seppi,Gilles Simon,6-0; 6-7(6); 6-2,R32,125,4,1,46,92,27,46,31,46,6,8,13,58,92,0,13,47,86,30,47,14,39,1,8,13,44,86
2006-09-25 00:00:00.000,Palermo Italy ATP World Tour,CLAY,2,Mariano Zabaleta,Olivier Patience,Mariano Zabaleta,7-5; 3-6; 6-3,R32,136,4,3,66,102,47,66,18,36,2,4,15,65,102,2,1,83,99,54,83,8,16,9,12,15,62,99
2006-09-25 00:00:00.000,Palermo Italy ATP World Tour,CLAY,2,Fabio Fognini,Juan Antonio Marin,Fabio Fognini,7-6(3); 6-3,R32,124,3,4,41,74,33,41,14,33,0,2,10,47,74,2,1,43,81,27,43,17,38,8,12,11,44,81
2006-09-25 00:00:00.000,Palermo Italy ATP World Tour,CLAY,2,Nicolas Lapentti,Paul-Henri Mathieu,Nicolas Lapentti,3-6; 6-2; 6-3,R32,142,4,3,53,86,39,53,13,33,5,8,13,52,86,5,1,50,93,27,50,23,43,7,12,13,50,93
2006-09-25 00:00:00.000,Palermo Italy ATP World Tour,CLAY,2,Oscar Hernandez,Philipp Kohlschreiber,Oscar Hernandez,6-1; 6-1,R32,61,1,1,28,42,22,28,8,14,3,3,7,30,42,3,2,29,51,13,29,8,22,1,6,7,21,51
2006-09-25 00:00:00.000,Palermo Italy ATP World Tour,CLAY,2,Martin Vassallo Arguello,Juan-Pablo Guzman,Martin Vassallo Arguello,2-6; 6-3; 7-5,R32,115,0,5,61,86,44,61,14,25,5,8,15,58,86,2,3,65,96,42,65,17,31,9,12,14,59,96
2006-09-25 00:00:00.000,Palermo Italy ATP World Tour,CLAY,2,Frantisek Cermak,Andrei Pavel,Frantisek Cermak,6-3; 2-6; 7-5,R32,128,5,7,55,104,38,55,23,49,5,9,15,61,104,1,3,60,87,35,60,16,27,4,8,14,51,87
2006-09-25 00:00:00.000,Palermo Italy ATP World Tour,CLAY,2,Nicolas Almagro,Oliver Marach,Nicolas Almagro,6-1; 6-4,R32,71,8,4,28,44,25,28,12,16,0,0,9,37,44,2,1,33,58,22,33,11,25,11,14,8,33,58
2006-09-25 00:00:00.000,Palermo Italy ATP World Tour,CLAY,2,Albert Montanes,Luis Horna,Albert Montanes,5-2 RET,R32,30,4,0,10,13,9,10,3,3,0,0,3,12,13,3,2,20,35,11,20,6,15,6,8,4,17,35
2006-09-25 00:00:00.000,Palermo Italy ATP World Tour,CLAY,2,Potito Starace,Federico Luzzi,Potito Starace,6-1; 6-2,R32,76,0,1,40,51,25,40,7,11,7,8,7,32,51,1,1,22,46,8,22,9,24,1,7,8,17,46
2006-09-25 00:00:00.000,Palermo Italy ATP World Tour,CLAY,2,Sergio Roitman,Francesco Aldi,Sergio Roitman,6-0; 6-1,R32,94,1,1,28,50,20,28,12,22,3,3,6,32,50,0,8,29,46,13,29,3,17,4,10,7,16,46
2006-09-25 00:00:00.000,Palermo Italy ATP World Tour,CLAY,2,Filippo Volandri,Guillermo Garcia-Lopez,Filippo Volandri,7-6(3); 3-6; 6-3,R32,163,2,5,65,102,45,65,17,37,11,15,15,62,102,3,4,78,136,56,78,20,58,18,22,15,76,136
2006-09-25 00:00:00.000,Palermo Italy ATP World Tour,CLAY,2,Fernando Verdasco,Jan Hajek,Fernando Verdasco,6-2; 6-2,R16,66,1,0,39,52,26,39,8,13,3,4,8,34,52,1,2,29,57,15,29,10,28,5,10,8,25,57
2006-09-25 00:00:00.000,Palermo Italy ATP World Tour,CLAY,2,Ruben Ramirez Hidalgo,Gianluca Naso,Ruben Ramirez Hidalgo,6-2; 6-2,R16,160,4,1,23,39,18,23,10,16,0,1,8,28,39,0,1,27,47,13,27,8,20,1,6,8,21,47
2006-09-25 00:00:00.000,Palermo Italy ATP World Tour,CLAY,2,Gilles Simon,Mariano Zabaleta,Gilles Simon,7-5; 6-3,R16,100,0,0,41,57,32,41,9,16,1,3,11,41,57,3,4,43,81,30,43,12,38,7,11,10,42,81
2006-09-25 00:00:00.000,Palermo Italy ATP World Tour,CLAY,2,Nicolas Lapentti,Fabio Fognini,Nicolas Lapentti,2-6; 6-1; 7-6(4),R16,138,4,1,49,99,34,49,31,50,4,7,14,65,99,2,0,40,75,32,40,16,35,2,5,13,48,75
2006-09-25 00:00:00.000,Palermo Italy ATP World Tour,CLAY,2,Martin Vassallo Arguello,Oscar Hernandez,Martin Vassallo Arguello,2-6; 6-4; 6-4,R16,125,5,3,41,72,30,41,16,31,2,6,14,46,72,2,3,56,97,37,56,19,41,7,11,14,56,97
2006-09-25 00:00:00.000,Palermo Italy ATP World Tour,CLAY,2,Nicolas Almagro,Frantisek Cermak,Nicolas Almagro,6-1; 6-2,R16,59,2,4,27,50,24,27,11,23,2,2,8,35,50,2,3,19,36,9,19,7,17,0,4,7,16,36
2006-09-25 00:00:00.000,Palermo Italy ATP World Tour,CLAY,2,Albert Montanes,Potito Starace,Albert Montanes,6-2; 6-2,R16,65,2,3,29,42,21,29,9,13,0,1,8,30,42,1,1,38,57,18,38,8,19,2,7,8,26,57
2006-09-25 00:00:00.000,Palermo Italy ATP World Tour,CLAY,2,Filippo Volandri,Sergio Roitman,Filippo Volandri,6-7(6); 6-1; 6-4,R16,139,0,2,72,98,47,72,13,26,1,3,15,60,98,5,3,82,117,53,82,9,35,12,17,14,62,117
2006-09-25 00:00:00.000,Palermo Italy ATP World Tour,CLAY,2,Ruben Ramirez Hidalgo,Fernando Verdasco,Ruben Ramirez Hidalgo,6-3; 6-4,Q,80,5,3,31,59,26,31,16,28,2,3,10,42,59,1,4,36,53,21,36,7,17,3,6,9,28,53
2006-09-25 00:00:00.000,Palermo Italy ATP World Tour,CLAY,2,Nicolas Lapentti,Gilles Simon,Nicolas Lapentti,6-0; 6-1,Q,72,2,0,22,41,15,22,11,19,4,5,6,26,41,2,0,32,47,13,32,2,15,3,10,7,15,47
2006-09-25 00:00:00.000,Palermo Italy ATP World Tour,CLAY,2,Nicolas Almagro,Martin Vassallo Arguello,Nicolas Almagro,6-2; 6-2,Q,97,6,1,31,56,23,31,16,25,3,3,8,39,56,0,0,49,69,25,49,9,20,6,10,8,34,69
2006-09-25 00:00:00.000,Palermo Italy ATP World Tour,CLAY,2,Filippo Volandri,Albert Montanes,Filippo Volandri,6-4; 6-2,Q,82,1,3,48,65,31,48,7,17,9,11,9,38,65,0,3,24,57,11,24,14,33,3,8,9,25,57
2006-09-25 00:00:00.000,Palermo Italy ATP World Tour,CLAY,2,Nicolas Lapentti,Ruben Ramirez Hidalgo,Nicolas Lapentti,6-2; 6-1,S,63,3,0,20,33,19,20,9,13,0,0,7,28,33,1,1,33,48,17,33,4,15,5,10,8,21,48
2006-09-25 00:00:00.000,Palermo Italy ATP World Tour,CLAY,2,Filippo Volandri,Nicolas Almagro,Filippo Volandri,6-0; 2-1 RET,S,51,0,2,19,30,17,19,4,11,0,0,5,21,30,0,0,11,26,6,11,6,15,5,8,4,12,26
2006-09-25 00:00:00.000,Palermo Italy ATP World Tour,CLAY,2,Filippo Volandri,Nicolas Lapentti,Filippo Volandri,5-7; 6-1; 6-3,F,135,1,1,49,75,26,49,20,26,1,6,14,46,75,2,1,55,88,28,55,14,33,6,14,14,42,88
2006-10-02 00:00:00.000,Metz France ATP World Tour,HARD,2,Marc Gicquel,David Ferrer,Marc Gicquel,6-3; 5-7; 6-4,R32,120,4,3,51,97,39,51,26,46,3,5,16,65,97,3,2,56,97,40,56,22,41,5,8,15,62,97
2006-10-02 00:00:00.000,Metz France ATP World Tour,HARD,2,Guillermo Garcia-Lopez,Davide Sanguinetti,Guillermo Garcia-Lopez,7-6(3); 4-6; 6-0,R32,96,8,3,44,80,36,44,16,36,1,4,14,52,80,3,5,50,94,32,50,18,44,4,9,14,50,94
2006-10-02 00:00:00.000,Metz France ATP World Tour,HARD,2,Paul-Henri Mathieu,Fabrice Santoro,Paul-Henri Mathieu,6-4; 5-7; 6-4,R32,154,3,8,47,99,36,47,25,52,5,9,16,61,99,6,7,43,105,32,43,29,62,7,12,16,61,105
2006-10-02 00:00:00.000,Metz France ATP World Tour,HARD,2,Florent Serra,Robin Soderling,Florent Serra,5-7; 7-6(3); 6-2,R32,107,10,4,57,103,44,57,24,46,5,8,16,68,103,12,5,52,87,36,52,20,35,3,7,16,56,87
2006-10-02 00:00:00.000,Metz France ATP World Tour,HARD,2,Marat Safin,Mikhail Youzhny,Marat Safin,6-1; 6-4,R32,59,5,0,32,51,26,32,10,19,0,0,9,36,51,1,2,30,50,20,30,8,20,3,6,8,28,50
2006-10-02 00:00:00.000,Metz France ATP World Tour,HARD,2,Jurgen Melzer,Albert Montanes,Jurgen Melzer,7-5; 6-2,R32,68,9,2,37,62,28,37,12,25,4,6,10,40,62,1,7,30,66,19,30,13,36,3,8,10,32,66
2006-10-02 00:00:00.000,Metz France ATP World Tour,HARD,2,Mardy Fish,Thierry Ascione,Mardy Fish,4-6; 6-3; 6-2,R32,104,7,4,37,77,29,37,22,40,3,6,14,51,77,1,3,51,81,34,51,12,30,6,11,13,46,81
2006-10-02 00:00:00.000,Metz France ATP World Tour,HARD,2,Ruben Ramirez Hidalgo,Fernando Verdasco,Ruben Ramirez Hidalgo,6-3; 6-3,R32,68,4,2,31,56,27,31,12,25,0,0,9,39,56,0,2,45,55,30,45,2,10,2,5,9,32,55
2006-10-02 00:00:00.000,Metz France ATP World Tour,HARD,2,Cyril Saulnier,Dominik Hrbaty,Cyril Saulnier,4-6; 6-3; 6-3,R32,96,6,2,56,85,40,56,16,29,2,4,14,56,85,2,9,37,78,24,37,22,41,3,7,14,46,78
2006-10-02 00:00:00.000,Metz France ATP World Tour,HARD,2,Tobias Clemens,Olivier Patience,Tobias Clemens,7-5; 6-7(2); 6-3,R32,152,9,5,68,122,51,68,26,54,6,8,16,77,122,3,0,78,116,53,78,18,38,7,12,17,71,116
2006-10-02 00:00:00.000,Metz France ATP World Tour,HARD,2,Daniele Bracciali,Philipp Kohlschreiber,Daniele Bracciali,4-6; 6-3; 7-5,R32,121,9,3,42,86,37,42,26,44,3,4,16,63,86,15,4,53,102,38,53,27,49,9,11,15,65,102
2006-10-02 00:00:00.000,Metz France ATP World Tour,HARD,2,Novak Djokovic,Nicolas Mahut,Novak Djokovic,6-2; 6-3,R32,64,4,1,27,52,21,27,17,25,2,2,9,38,52,4,5,25,45,18,25,7,20,3,6,8,25,45
2006-10-02 00:00:00.000,Metz France ATP World Tour,HARD,2,Richard Gasquet,Sergiy Stakhovsky,Richard Gasquet,6-3; 6-1,R32,60,2,0,27,45,24,27,11,18,2,2,8,35,45,1,1,33,50,16,33,9,17,2,6,8,25,50
2006-10-02 00:00:00.000,Metz France ATP World Tour,HARD,2,Arnaud Clement,Xavier Malisse,Arnaud Clement,7-6(3); 6-2,R32,92,5,1,35,56,26,35,14,21,0,1,10,40,56,9,4,38,67,27,38,9,29,7,10,10,36,67
2006-10-02 00:00:00.000,Metz France ATP World Tour,HARD,2,Sebastien Grosjean,Florian Mayer,Sebastien Grosjean,6-3; 6-4,R32,77,4,1,39,62,29,39,10,23,4,6,10,39,62,4,2,42,67,28,42,7,25,4,8,9,35,67
2006-10-02 00:00:00.000,Metz France ATP World Tour,HARD,2,Julien Benneteau,Juan Carlos Ferrero,Julien Benneteau,6-4; 1-6; 7-6(7),R32,133,8,3,65,108,42,65,22,43,10,14,14,64,108,7,1,47,84,31,47,25,37,1,4,15,56,84
2006-10-02 00:00:00.000,Metz France ATP World Tour,HARD,2,Marc Gicquel,Guillermo Garcia-Lopez,Marc Gicquel,6-2; 6-3,R16,63,4,3,18,47,14,18,20,29,2,2,8,34,47,6,3,40,66,29,40,7,26,9,13,9,36,66
2006-10-02 00:00:00.000,Metz France ATP World Tour,HARD,2,Florent Serra,Paul-Henri Mathieu,Florent Serra,1-6; 6-3; 7-6(2),R16,138,10,4,55,94,44,55,13,39,5,9,14,57,94,11,3,52,97,33,52,27,45,3,6,14,60,97
2006-10-02 00:00:00.000,Metz France ATP World Tour,HARD,2,Jurgen Melzer,Marat Safin,Jurgen Melzer,4-6; 6-2; 7-6(5),R16,124,4,3,70,109,51,70,22,39,10,11,15,73,109,10,1,54,96,39,54,25,42,8,10,15,64,96
2006-10-02 00:00:00.000,Metz France ATP World Tour,HARD,2,Mardy Fish,Ruben Ramirez Hidalgo,Mardy Fish,6-3; 6-3,R16,71,10,3,29,49,27,29,10,20,1,1,9,37,49,2,4,32,61,19,32,14,29,5,8,9,33,61
2006-10-02 00:00:00.000,Metz France ATP World Tour,HARD,2,Tobias Clemens,Cyril Saulnier,Tobias Clemens,7-6(4); 6-7(4); 7-6(5),R16,166,15,6,66,119,50,66,32,53,2,4,18,82,119,11,3,70,123,57,70,26,53,4,6,18,83,123
2006-10-02 00:00:00.000,Metz France ATP World Tour,HARD,2,Novak Djokovic,Daniele Bracciali,Novak Djokovic,6-0; 6-3,R16,60,8,1,32,49,25,32,10,17,2,2,8,35,49,4,6,21,46,14,21,8,25,4,8,7,22,46
2006-10-02 00:00:00.000,Metz France ATP World Tour,HARD,2,Arnaud Clement,Richard Gasquet,Arnaud Clement,6-7(3); 7-6(3); 7-5,R16,177,2,2,73,110,53,73,18,37,2,5,18,71,110,6,2,66,128,48,66,29,62,10,14,18,77,128
2006-10-02 00:00:00.000,Metz France ATP World Tour,HARD,2,Sebastien Grosjean,Julien Benneteau,Sebastien Grosjean,7-5; 6-1,R16,88,3,2,31,60,24,31,17,29,5,7,10,41,60,4,5,42,64,23,42,8,22,4,9,9,31,64
2006-10-02 00:00:00.000,Metz France ATP World Tour,HARD,2,Marc Gicquel,Florent Serra,Marc Gicquel,6-4; 7-5,Q,85,12,1,32,61,28,32,18,29,3,3,11,46,61,10,6,51,84,34,51,17,33,10,12,11,51,84
2006-10-02 00:00:00.000,Metz France ATP World Tour,HARD,2,Jurgen Melzer,Mardy Fish,Jurgen Melzer,1-6; 7-5; 7-5,Q,123,5,4,56,96,40,56,18,40,5,9,15,58,96,18,11,47,102,32,47,29,55,9,13,16,61,102
2006-10-02 00:00:00.000,Metz France ATP World Tour,HARD,2,Novak Djokovic,Tobias Clemens,Novak Djokovic,6-4; 6-1,Q,59,9,1,26,47,22,26,13,21,0,1,9,35,47,1,6,25,50,14,25,12,25,2,6,8,26,50
2006-10-02 00:00:00.000,Metz France ATP World Tour,HARD,2,Sebastien Grosjean,Arnaud Clement,Sebastien Grosjean,6-7(4); 6-3; 6-2,Q,140,10,2,49,98,39,49,27,49,6,8,15,66,98,4,2,46,83,33,46,19,37,6,11,14,52,83
2006-10-02 00:00:00.000,Metz France ATP World Tour,HARD,2,Jurgen Melzer,Marc Gicquel,Jurgen Melzer,7-6(3); 6-3,S,84,7,4,52,80,37,52,12,28,5,7,10,49,80,4,0,27,62,21,27,14,35,1,5,11,35,62
2006-10-02 00:00:00.000,Metz France ATP World Tour,HARD,2,Novak Djokovic,Sebastien Grosjean,Novak Djokovic,6-7(4); 7-6(1); 6-3,S,165,6,2,69,111,50,69,22,42,6,9,17,72,111,10,0,57,107,41,57,25,50,5,9,16,66,107
2006-10-02 00:00:00.000,Metz France ATP World Tour,HARD,2,Novak Djokovic,Jurgen Melzer,Novak Djokovic,4-6; 6-3; 6-2,F,111,10,1,58,88,41,58,16,30,7,9,14,57,88,2,5,45,90,31,45,20,45,7,11,13,51,90
2006-10-02 00:00:00.000,Tokyo Japan ATP World Tour,HARD,2,Roger Federer,N/A Bye,Roger Federer,,R64,0,0,0,0,0,0,0,0,0,0,0,0,0,0,0,0,0,0,0,0,0,0,0,0,0,0,0
2006-10-02 00:00:00.000,Tokyo Japan ATP World Tour,HARD,2,Viktor Troicki,Fernando Vicente,Viktor Troicki,6-7(4); 6-4; 6-2,R64,125,7,1,54,87,39,54,16,33,1,5,15,55,87,3,0,61,92,31,61,21,31,2,9,15,52,92
2006-10-02 00:00:00.000,Tokyo Japan ATP World Tour,HARD,2,Stefan Koubek,Stefano Galvani,Stefan Koubek,6-3; 4-6; 7-5,R64,136,4,6,50,100,32,50,20,50,7,14,16,52,100,0,3,44,88,28,44,16,44,4,12,15,44,88
2006-10-02 00:00:00.000,Tokyo Japan ATP World Tour,HARD,2,Wesley Moodie,N/A Bye,Wesley Moodie,,R64,0,0,0,0,0,0,0,0,0,0,0,0,0,0,0,0,0,0,0,0,0,0,0,0,0,0,0
2006-10-02 00:00:00.000,Tokyo Japan ATP World Tour,HARD,2,Bjorn Phau,N/A Bye,Bjorn Phau,,R64,0,0,0,0,0,0,0,0,0,0,0,0,0,0,0,0,0,0,0,0,0,0,0,0,0,0,0
2006-10-02 00:00:00.000,Tokyo Japan ATP World Tour,HARD,2,Alexander Waske,Tetsuya Chaen,Alexander Waske,6-4; 6-4,R64,67,10,0,33,49,28,33,12,16,0,0,10,40,49,2,2,39,60,21,39,16,21,2,4,10,37,60
2006-10-02 00:00:00.000,Tokyo Japan ATP World Tour,HARD,2,Takao Suzuki,Simon Greul,Takao Suzuki,6-2; 6-2,R64,58,7,1,25,39,22,25,11,14,1,1,8,33,39,2,0,26,50,16,26,11,24,0,4,8,27,50
2006-10-02 00:00:00.000,Tokyo Japan ATP World Tour,HARD,2,Paradorn Srichaphan,N/A Bye,Paradorn Srichaphan,,R64,0,0,0,0,0,0,0,0,0,0,0,0,0,0,0,0,0,0,0,0,0,0,0,0,0,0,0
2006-10-02 00:00:00.000,Tokyo Japan ATP World Tour,HARD,2,Andy Murray,N/A Bye,Andy Murray,,R64,0,0,0,0,0,0,0,0,0,0,0,0,0,0,0,0,0,0,0,0,0,0,0,0,0,0,0
2006-10-02 00:00:00.000,Tokyo Japan ATP World Tour,HARD,2,Jiri Novak,Robin Vik,Jiri Novak,4-6; 6-4; 6-4,R64,107,10,2,54,78,41,54,13,24,1,4,15,54,78,5,6,63,100,46,63,14,37,7,11,15,60,100
2006-10-02 00:00:00.000,Tokyo Japan ATP World Tour,HARD,2,Danai Udomchoke,Marin Cilic,Danai Udomchoke,7-6(3); 6-3,R64,89,3,0,40,76,34,40,20,36,5,5,11,54,76,5,2,32,63,25,32,19,31,3,4,10,44,63
2006-10-02 00:00:00.000,Tokyo Japan ATP World Tour,HARD,2,Benjamin Becker,N/A Bye,Benjamin Becker,,R64,0,0,0,0,0,0,0,0,0,0,0,0,0,0,0,0,0,0,0,0,0,0,0,0,0,0,0
2006-10-02 00:00:00.000,Tokyo Japan ATP World Tour,HARD,2,Juan Monaco,N/A Bye,Juan Monaco,,R64,0,0,0,0,0,0,0,0,0,0,0,0,0,0,0,0,0,0,0,0,0,0,0,0,0,0,0
2006-10-02 00:00:00.000,Tokyo Japan ATP World Tour,HARD,2,Edgardo Massa,Konstantinos Economidis,Edgardo Massa,6-1; 6-3,R64,54,4,0,23,40,19,23,13,17,0,0,8,32,40,4,3,39,62,23,39,8,23,6,10,8,31,62
2006-10-02 00:00:00.000,Tokyo Japan ATP World Tour,HARD,2,Lars Burgsmuller,Wayne Arthurs,Lars Burgsmuller,6-7(5); 7-6(7); 7-6(3),R64,148,10,4,87,121,71,87,22,34,7,7,18,93,121,34,5,68,116,59,68,30,48,3,3,18,89,116
2006-10-02 00:00:00.000,Tokyo Japan ATP World Tour,HARD,2,Jarkko Nieminen,N/A Bye,Jarkko Nieminen,,R64,0,0,0,0,0,0,0,0,0,0,0,0,0,0,0,0,0,0,0,0,0,0,0,0,0,0,0
2006-10-02 00:00:00.000,Tokyo Japan ATP World Tour,HARD,2,Robby Ginepri,N/A Bye,Robby Ginepri,,R64,0,0,0,0,0,0,0,0,0,0,0,0,0,0,0,0,0,0,0,0,0,0,0,0,0,0,0
2006-10-02 00:00:00.000,Tokyo Japan ATP World Tour,HARD,2,Juan Martin Del Potro,Go Soeda,Juan Martin Del Potro,6-3; 6-1,R64,73,3,2,31,47,25,31,10,16,2,2,8,35,47,2,2,27,49,14,27,11,22,3,7,8,25,49
2006-10-02 00:00:00.000,Tokyo Japan ATP World Tour,HARD,2,Frank Dancevic,Marcos Daniel,Frank Dancevic,6-4; 6-4,R64,67,4,0,28,51,23,28,17,23,0,0,10,40,51,5,0,39,63,24,39,15,24,2,4,10,39,63
2006-10-02 00:00:00.000,Tokyo Japan ATP World Tour,HARD,2,Tim Henman,N/A Bye,Tim Henman,,R64,0,0,0,0,0,0,0,0,0,0,0,0,0,0,0,0,0,0,0,0,0,0,0,0,0,0,0
2006-10-02 00:00:00.000,Tokyo Japan ATP World Tour,HARD,2,Paul Goldstein,N/A Bye,Paul Goldstein,,R64,0,0,0,0,0,0,0,0,0,0,0,0,0,0,0,0,0,0,0,0,0,0,0,0,0,0,0
2006-10-02 00:00:00.000,Tokyo Japan ATP World Tour,HARD,2,Rainer Schuettler,Michael Berrer,Rainer Schuettler,6-2; 6-1,R64,56,6,0,22,34,18,22,10,12,0,0,7,28,34,0,4,26,50,11,26,12,24,5,10,8,23,50
2006-10-02 00:00:00.000,Tokyo Japan ATP World Tour,HARD,2,Kenneth Carlsen,Gouichi Motomura,Kenneth Carlsen,6-7(5); 6-3; 6-2,R64,146,11,0,60,88,50,60,18,28,0,0,15,68,88,0,2,56,93,39,56,19,37,5,8,14,58,93
2006-10-02 00:00:00.000,Tokyo Japan ATP World Tour,HARD,2,Mario Ancic,N/A Bye,Mario Ancic,,R64,0,0,0,0,0,0,0,0,0,0,0,0,0,0,0,0,0,0,0,0,0,0,0,0,0,0,0
2006-10-02 00:00:00.000,Tokyo Japan ATP World Tour,HARD,2,Dmitry Tursunov,N/A Bye,Dmitry Tursunov,,R64,0,0,0,0,0,0,0,0,0,0,0,0,0,0,0,0,0,0,0,0,0,0,0,0,0,0,0
2006-10-02 00:00:00.000,Tokyo Japan ATP World Tour,HARD,2,Jimmy Wang,Kevin Kim,Jimmy Wang,6-3; 6-1,R64,60,3,1,25,45,17,25,9,20,2,4,8,26,45,1,5,33,70,12,33,18,37,9,15,8,30,70
2006-10-02 00:00:00.000,Tokyo Japan ATP World Tour,HARD,2,Kristian Pless,Rik De Voest,Kristian Pless,6-3; 6-4,R64,74,6,1,41,65,34,41,14,24,4,4,10,48,65,2,1,41,66,24,41,15,25,5,7,9,39,66
2006-10-02 00:00:00.000,Tokyo Japan ATP World Tour,HARD,2,Hyung-Taik Lee,N/A Bye,Hyung-Taik Lee,,R64,0,0,0,0,0,0,0,0,0,0,0,0,0,0,0,0,0,0,0,0,0,0,0,0,0,0,0
2006-10-02 00:00:00.000,Tokyo Japan ATP World Tour,HARD,2,Vincent Spadea,N/A Bye,Vincent Spadea,,R64,0,0,0,0,0,0,0,0,0,0,0,0,0,0,0,0,0,0,0,0,0,0,0,0,0,0,0
2006-10-02 00:00:00.000,Tokyo Japan ATP World Tour,HARD,2,Satoshi Iwabuchi,Ti Chen,Satoshi Iwabuchi,6-2; 6-1,R64,57,3,1,31,40,23,31,6,9,1,1,7,29,40,2,2,30,49,15,30,6,19,2,7,8,21,49
2006-10-02 00:00:00.000,Tokyo Japan ATP World Tour,HARD,2,Yen-Hsun Lu,Ramon Delgado,Yen-Hsun Lu,6-2; 6-3,R64,59,11,0,23,37,20,23,10,14,2,3,8,30,37,4,5,35,58,20,35,8,23,3,8,9,28,58
2006-10-02 00:00:00.000,Tokyo Japan ATP World Tour,HARD,2,Tommy Robredo,N/A Bye,Tommy Robredo,,R64,0,0,0,0,0,0,0,0,0,0,0,0,0,0,0,0,0,0,0,0,0,0,0,0,0,0,0
2006-10-02 00:00:00.000,Tokyo Japan ATP World Tour,HARD,2,Roger Federer,Viktor Troicki,Roger Federer,7-6(2); 7-6(3),R32,101,6,1,53,82,39,53,18,29,1,2,12,57,82,9,1,51,84,35,51,19,33,2,3,12,54,84
2006-10-02 00:00:00.000,Tokyo Japan ATP World Tour,HARD,2,Wesley Moodie,Stefan Koubek,Wesley Moodie,6-3; 6-4,R32,75,10,1,47,67,34,47,11,20,2,3,10,45,67,1,1,39,57,22,39,12,18,5,8,9,34,57
2006-10-02 00:00:00.000,Tokyo Japan ATP World Tour,HARD,2,Alexander Waske,Bjorn Phau,Alexander Waske,6-4; 6-4,R32,80,5,3,30,54,25,30,15,24,0,0,10,40,54,4,3,28,58,19,28,20,30,2,4,10,39,58
2006-10-02 00:00:00.000,Tokyo Japan ATP World Tour,HARD,2,Takao Suzuki,Paradorn Srichaphan,Takao Suzuki,7-6(4); 6-7(5); 6-4,R32,131,19,4,63,103,53,63,26,40,1,1,17,79,103,9,3,55,93,45,55,28,38,2,3,17,73,93
2006-10-02 00:00:00.000,Tokyo Japan ATP World Tour,HARD,2,Jiri Novak,Andy Murray,Jiri Novak,6-3; 7-6(1),R32,82,5,1,45,68,32,45,16,23,4,5,10,48,68,5,5,34,69,26,34,14,35,3,6,11,40,69
2006-10-02 00:00:00.000,Tokyo Japan ATP World Tour,HARD,2,Benjamin Becker,Danai Udomchoke,Benjamin Becker,6-2; 6-1,R32,69,5,0,17,41,13,17,17,24,0,0,7,30,41,2,5,58,87,33,58,8,29,11,16,8,41,87
2006-10-02 00:00:00.000,Tokyo Japan ATP World Tour,HARD,2,Juan Monaco,Edgardo Massa,Juan Monaco,7-6(4); 6-3,R32,74,10,4,47,76,36,47,18,29,2,2,11,54,76,4,3,38,61,30,38,11,23,1,2,10,41,61
2006-10-02 00:00:00.000,Tokyo Japan ATP World Tour,HARD,2,Jarkko Nieminen,Lars Burgsmuller,Jarkko Nieminen,7-5; 7-6(2),R32,93,3,4,41,67,33,41,13,26,2,5,12,46,67,5,4,41,71,27,41,16,30,3,7,12,43,71
2006-10-02 00:00:00.000,Tokyo Japan ATP World Tour,HARD,2,Juan Martin Del Potro,Robby Ginepri,Juan Martin Del Potro,6-2; 6-2,R32,64,4,3,34,51,28,34,6,17,5,6,8,34,51,6,1,39,58,20,39,6,19,6,11,8,26,58
2006-10-02 00:00:00.000,Tokyo Japan ATP World Tour,HARD,2,Tim Henman,Frank Dancevic,Tim Henman,6-2; 6-1,R32,55,9,1,26,43,22,26,11,17,1,1,8,33,43,1,0,21,37,11,21,6,16,0,4,7,17,37
2006-10-02 00:00:00.000,Tokyo Japan ATP World Tour,HARD,2,Rainer Schuettler,Paul Goldstein,Rainer Schuettler,6-3; 6-2,R32,77,5,1,37,49,28,37,8,12,1,2,9,36,49,1,1,27,55,17,27,10,28,3,7,8,27,55
2006-10-02 00:00:00.000,Tokyo Japan ATP World Tour,HARD,2,Mario Ancic,Kenneth Carlsen,Mario Ancic,6-1; 6-4,R32,81,11,2,34,57,26,34,14,23,4,4,9,40,57,6,0,39,53,25,39,5,14,3,6,8,30,53
2006-10-02 00:00:00.000,Tokyo Japan ATP World Tour,HARD,2,Dmitry Tursunov,Jimmy Wang,Dmitry Tursunov,6-3; 5-7; 7-5,R32,139,9,9,42,102,30,42,30,60,5,10,16,60,102,0,3,60,108,37,60,20,48,9,16,17,57,108
2006-10-02 00:00:00.000,Tokyo Japan ATP World Tour,HARD,2,Hyung-Taik Lee,Kristian Pless,Hyung-Taik Lee,7-5; 6-1,R32,61,5,1,45,53,35,45,3,8,1,1,9,38,53,5,0,44,62,27,44,6,18,1,5,10,33,62
2006-10-02 00:00:00.000,Tokyo Japan ATP World Tour,HARD,2,Vincent Spadea,Satoshi Iwabuchi,Vincent Spadea,2-6; 6-2; 6-0,R32,70,4,2,40,69,31,40,12,29,5,8,11,43,69,1,2,43,70,27,43,8,27,4,10,11,35,70
2006-10-02 00:00:00.000,Tokyo Japan ATP World Tour,HARD,2,Tommy Robredo,Yen-Hsun Lu,Tommy Robredo,6-4; 6-1,R32,77,3,1,27,48,19,27,14,21,1,3,9,33,48,1,3,31,59,19,31,8,28,5,10,8,27,59
2006-10-02 00:00:00.000,Tokyo Japan ATP World Tour,HARD,2,Roger Federer,Wesley Moodie,Roger Federer,6-2; 6-1,R16,52,5,0,27,40,23,27,10,13,0,0,8,33,40,4,2,24,44,14,24,7,20,4,8,7,21,44
2006-10-02 00:00:00.000,Tokyo Japan ATP World Tour,HARD,2,Takao Suzuki,Alexander Waske,Takao Suzuki,6-7(4); 7-6(10); 6-1,R16,150,19,2,72,112,56,72,27,40,3,3,16,83,112,18,2,67,101,52,67,21,34,4,6,15,73,101
2006-10-02 00:00:00.000,Tokyo Japan ATP World Tour,HARD,2,Benjamin Becker,Jiri Novak,Benjamin Becker,3-6; 6-3; 7-6(4),R16,107,11,3,50,92,43,50,22,42,3,5,15,65,92,14,1,65,103,51,65,18,38,3,5,15,69,103
2006-10-02 00:00:00.000,Tokyo Japan ATP World Tour,HARD,2,Jarkko Nieminen,Juan Monaco,Jarkko Nieminen,6-2; 6-3,R16,65,5,0,37,51,29,37,8,14,0,0,9,37,51,0,0,28,51,15,28,15,23,3,6,8,30,51
2006-10-02 00:00:00.000,Tokyo Japan ATP World Tour,HARD,2,Tim Henman,Juan Martin Del Potro,Tim Henman,7-6(3); 6-3,R16,100,7,3,39,67,29,39,18,28,1,2,11,47,67,2,1,59,83,33,59,15,24,5,7,10,48,83
2006-10-02 00:00:00.000,Tokyo Japan ATP World Tour,HARD,2,Mario Ancic,Rainer Schuettler,Mario Ancic,6-2; 4-6; 6-4,R16,121,7,1,59,83,38,59,14,24,6,9,14,52,83,3,0,46,84,30,46,20,38,4,9,14,50,84
2006-10-02 00:00:00.000,Tokyo Japan ATP World Tour,HARD,2,Hyung-Taik Lee,Dmitry Tursunov,Hyung-Taik Lee,6-4; 2-6; 6-4,R16,98,6,0,51,66,41,51,6,15,2,5,14,47,66,6,1,52,86,35,52,19,34,3,6,14,54,86
2006-10-02 00:00:00.000,Tokyo Japan ATP World Tour,HARD,2,Tommy Robredo,Vincent Spadea,Tommy Robredo,6-4; 7-6(9),R16,129,5,4,58,99,41,58,21,41,12,13,11,62,99,1,3,45,83,29,45,21,38,4,6,11,50,83
2006-10-02 00:00:00.000,Tokyo Japan ATP World Tour,HARD,2,Roger Federer,Takao Suzuki,Roger Federer,4-6; 7-5; 7-6(3),Q,124,15,0,60,88,52,60,17,28,2,3,17,69,88,6,3,68,111,50,68,24,43,1,2,17,74,111
2006-10-02 00:00:00.000,Tokyo Japan ATP World Tour,HARD,2,Benjamin Becker,Jarkko Nieminen,Benjamin Becker,6-7(5); 7-6(6); 6-4,Q,128,10,4,56,108,45,56,30,52,2,4,17,75,108,9,3,62,112,47,62,27,50,5,8,17,74,112
2006-10-02 00:00:00.000,Tokyo Japan ATP World Tour,HARD,2,Tim Henman,Mario Ancic,Tim Henman,6-2; 6-2,Q,62,4,0,32,43,25,32,8,11,3,3,8,33,43,4,2,37,55,23,37,6,18,1,5,8,29,55
2006-10-02 00:00:00.000,Tokyo Japan ATP World Tour,HARD,2,Hyung-Taik Lee,Tommy Robredo,Hyung-Taik Lee,7-6(3); 4-6; 6-1,Q,133,3,2,64,97,48,64,19,33,1,2,15,67,97,4,1,64,93,44,64,16,29,3,5,14,60,93
2006-10-02 00:00:00.000,Tokyo Japan ATP World Tour,HARD,2,Roger Federer,Benjamin Becker,Roger Federer,6-3; 6-4,S,60,8,0,29,49,29,29,12,20,1,1,10,41,49,4,1,31,57,21,31,17,26,2,4,9,38,57
2006-10-02 00:00:00.000,Tokyo Japan ATP World Tour,HARD,2,Tim Henman,Hyung-Taik Lee,Tim Henman,6-4; 7-6(5),S,93,5,1,39,70,31,39,18,31,2,3,11,49,70,2,1,50,69,32,50,13,19,2,4,11,45,69
2006-10-02 00:00:00.000,Tokyo Japan ATP World Tour,HARD,2,Roger Federer,Tim Henman,Roger Federer,6-3; 6-3,F,67,4,2,27,48,20,27,17,21,0,0,9,37,48,0,6,44,65,29,44,7,21,8,11,9,36,65
2006-10-09 00:00:00.000,Moscow Russia ATP World Tour,HARD,2,Nikolay Davydenko,Jiri Vanek,Nikolay Davydenko,6-0; 6-0,R32,37,5,1,16,27,16,16,8,11,0,0,6,24,27,0,1,21,40,6,21,6,19,4,10,6,12,40
2006-10-09 00:00:00.000,Moscow Russia ATP World Tour,HARD,2,Teymuraz Gabashvili,Gilles Muller,Teymuraz Gabashvili,7-6(3); 6-3,R32,74,7,1,34,61,30,34,19,27,1,1,11,49,61,7,0,42,61,30,42,12,19,2,3,10,42,61
2006-10-09 00:00:00.000,Moscow Russia ATP World Tour,HARD,2,Max Mirnyi,Kevin Kim,Max Mirnyi,6-0 RET,R32,20,10,1,8,16,8,8,5,8,2,2,3,13,16,0,1,10,18,2,10,3,8,0,3,3,5,18
2006-10-09 00:00:00.000,Moscow Russia ATP World Tour,HARD,2,Julien Benneteau,Sergio Roitman,Julien Benneteau,6-3; 6-0,R32,50,5,3,25,41,20,25,10,16,1,1,7,30,41,3,0,25,45,15,25,5,20,4,9,8,20,45
2006-10-09 00:00:00.000,Moscow Russia ATP World Tour,HARD,2,Philipp Kohlschreiber,Mikhail Youzhny,Philipp Kohlschreiber,6-2; 7-5,R32,79,3,2,28,62,23,28,22,34,3,3,10,45,62,4,1,35,56,26,35,9,21,2,5,10,35,56
2006-10-09 00:00:00.000,Moscow Russia ATP World Tour,HARD,2,Evgeny Korolev,Denis Istomin,Evgeny Korolev,7-6(2); 6-7(5); 6-3,R32,136,7,3,68,116,55,68,27,48,8,9,17,82,116,7,1,62,105,46,62,25,43,6,8,16,71,105
2006-10-09 00:00:00.000,Moscow Russia ATP World Tour,HARD,2,Konstantin Kravchuk,Hyung-Taik Lee,Konstantin Kravchuk,6-4; 6-4,R32,61,10,3,31,53,25,31,14,22,1,2,10,39,53,0,0,45,61,30,45,6,16,2,5,10,36,61
2006-10-09 00:00:00.000,Moscow Russia ATP World Tour,HARD,2,Fabrice Santoro,Wesley Moodie,Fabrice Santoro,6-3; 6-2,R32,62,2,1,29,46,24,29,13,17,0,0,9,37,46,5,1,34,48,20,34,7,14,1,4,8,27,48
2006-10-09 00:00:00.000,Moscow Russia ATP World Tour,HARD,2,Janko Tipsarevic,Paul-Henri Mathieu,Janko Tipsarevic,7-6(8); 6-4,R32,106,12,2,50,72,46,50,9,22,1,1,11,55,72,9,1,37,76,30,37,24,39,2,3,11,54,76
2006-10-09 00:00:00.000,Moscow Russia ATP World Tour,HARD,2,Robin Vik,Jiri Novak,Robin Vik,6-4; 6-3,R32,58,2,3,31,46,29,31,8,15,1,1,9,37,46,3,4,35,58,28,35,7,23,2,5,10,35,58
2006-10-09 00:00:00.000,Moscow Russia ATP World Tour,HARD,2,Marat Safin,Nicolas Mahut,Marat Safin,6-3; 6-4,R32,61,11,1,28,48,25,28,15,20,0,0,10,40,48,4,2,32,48,24,32,7,16,0,2,9,31,48
2006-10-09 00:00:00.000,Moscow Russia ATP World Tour,HARD,2,Daniele Bracciali,Fernando Verdasco,Daniele Bracciali,6-7(4); 6-4 RET,R32,93,7,2,33,70,24,33,25,37,4,4,11,49,70,15,1,53,75,40,53,12,22,3,4,11,52,75
2006-10-09 00:00:00.000,Moscow Russia ATP World Tour,HARD,2,Jan Hernych,Filippo Volandri,Jan Hernych,6-1; 6-4,R32,62,1,1,40,60,28,40,13,20,1,1,9,41,60,0,4,21,44,14,21,12,23,0,3,8,26,44
2006-10-09 00:00:00.000,Moscow Russia ATP World Tour,HARD,2,Igor Kunitsyn,Rainer Schuettler,Igor Kunitsyn,6-3; 6-2,R32,74,6,0,30,45,27,30,8,15,3,3,8,35,45,2,2,40,63,25,40,9,23,3,7,9,34,63
2006-10-09 00:00:00.000,Moscow Russia ATP World Tour,HARD,2,Arnaud Clement,Mischa Zverev,Arnaud Clement,4-6; 6-3; 6-2,R32,111,3,3,49,89,36,49,22,40,1,4,14,58,89,11,1,58,84,36,58,10,26,4,9,13,46,84
2006-10-09 00:00:00.000,Moscow Russia ATP World Tour,HARD,2,Sergiy Stakhovsky,Dmitry Tursunov,Sergiy Stakhovsky,7-5; 4-6; 7-6(4),R32,121,11,4,61,105,48,61,23,44,6,8,17,71,105,17,2,49,91,43,49,24,42,1,3,17,67,91
2006-10-09 00:00:00.000,Moscow Russia ATP World Tour,HARD,2,Nikolay Davydenko,Teymuraz Gabashvili,Nikolay Davydenko,6-4; 6-2,R16,76,7,3,39,54,32,39,7,15,1,1,9,39,54,8,2,27,58,17,27,16,31,5,8,9,33,58
2006-10-09 00:00:00.000,Moscow Russia ATP World Tour,HARD,2,Max Mirnyi,Julien Benneteau,Max Mirnyi,6-2; 2-6; 7-6(2),R16,130,18,8,54,89,43,54,16,35,5,7,14,59,89,4,2,66,92,43,66,16,26,5,7,14,59,92
2006-10-09 00:00:00.000,Moscow Russia ATP World Tour,HARD,2,Philipp Kohlschreiber,Evgeny Korolev,Philipp Kohlschreiber,6-3; 6-2,R16,61,8,1,24,51,20,24,19,27,2,2,9,39,51,3,2,27,47,21,27,7,20,4,7,8,28,47
2006-10-09 00:00:00.000,Moscow Russia ATP World Tour,HARD,2,Fabrice Santoro,Konstantin Kravchuk,Fabrice Santoro,6-1; 6-1,R16,49,1,0,19,37,15,19,13,18,0,0,7,28,37,1,2,25,49,10,25,10,24,6,11,7,20,49
2006-10-09 00:00:00.000,Moscow Russia ATP World Tour,HARD,2,Janko Tipsarevic,Robin Vik,Janko Tipsarevic,6-4; 6-4,R16,73,13,1,35,50,31,35,10,15,0,0,10,41,50,11,2,34,62,23,34,15,28,4,6,10,38,62
2006-10-09 00:00:00.000,Moscow Russia ATP World Tour,HARD,2,Marat Safin,Daniele Bracciali,Marat Safin,3-6; 6-1; 6-4,R16,103,7,1,47,67,37,47,13,20,0,1,13,50,67,5,3,41,83,30,41,20,42,5,8,13,50,83
2006-10-09 00:00:00.000,Moscow Russia ATP World Tour,HARD,2,Igor Kunitsyn,Jan Hernych,Igor Kunitsyn,6-4; 4-6; 6-2,R16,107,3,2,52,87,35,52,18,35,3,6,14,53,87,5,0,59,78,38,59,7,19,2,7,14,45,78
2006-10-09 00:00:00.000,Moscow Russia ATP World Tour,HARD,2,Arnaud Clement,Sergiy Stakhovsky,Arnaud Clement,6-3; 5-7; 6-4,R16,155,7,2,64,114,45,64,26,50,9,11,16,71,114,14,4,67,99,54,67,9,32,8,11,15,63,99
2006-10-09 00:00:00.000,Moscow Russia ATP World Tour,HARD,2,Nikolay Davydenko,Max Mirnyi,Nikolay Davydenko,6-3; 7-5,Q,88,0,1,40,62,29,40,13,22,5,6,10,42,62,5,3,34,68,23,34,14,34,3,7,11,37,68
2006-10-09 00:00:00.000,Moscow Russia ATP World Tour,HARD,2,Fabrice Santoro,Philipp Kohlschreiber,Fabrice Santoro,6-3; 7-5,Q,97,5,1,48,75,36,48,18,27,5,5,11,54,75,6,3,45,76,30,45,16,31,9,11,10,46,76
2006-10-09 00:00:00.000,Moscow Russia ATP World Tour,HARD,2,Marat Safin,Janko Tipsarevic,Marat Safin,7-6(5); 3-6; 6-4,Q,150,14,1,69,103,46,69,17,34,4,8,16,63,103,7,0,73,118,49,73,20,45,9,12,15,69,118
2006-10-09 00:00:00.000,Moscow Russia ATP World Tour,HARD,2,Igor Kunitsyn,Arnaud Clement,Igor Kunitsyn,6-4; 6-2,Q,78,6,0,30,50,25,30,13,20,3,3,9,38,50,7,0,45,63,28,45,8,18,5,8,9,36,63
2006-10-09 00:00:00.000,Moscow Russia ATP World Tour,HARD,2,Nikolay Davydenko,Fabrice Santoro,Nikolay Davydenko,6-4; 6-1,S,70,6,3,35,51,26,35,9,16,2,3,8,35,51,2,3,39,64,20,39,12,25,3,8,9,32,64
2006-10-09 00:00:00.000,Moscow Russia ATP World Tour,HARD,2,Marat Safin,Igor Kunitsyn,Marat Safin,6-4; 6-3,S,74,4,0,38,51,30,38,9,13,2,3,10,39,51,0,2,29,59,19,29,15,30,7,10,9,34,59
2006-10-09 00:00:00.000,Moscow Russia ATP World Tour,HARD,2,Nikolay Davydenko,Marat Safin,Nikolay Davydenko,6-4; 5-7; 6-4,F,140,2,2,59,83,47,59,12,24,1,4,16,59,83,7,3,67,114,46,67,21,47,8,12,16,67,114
2006-10-09 00:00:00.000,Stockholm Sweden ATP World Tour,HARD,2,Rafael Nadal,Raemon Sluiter,Rafael Nadal,6-4; 6-2,R32,92,5,1,29,59,22,29,20,30,4,4,9,42,59,8,3,33,55,24,33,9,22,2,5,9,33,55
2006-10-09 00:00:00.000,Stockholm Sweden ATP World Tour,HARD,2,Joachim Johansson,Davide Sanguinetti,Joachim Johansson,6-4; 6-4,R32,70,11,3,36,58,31,36,11,22,0,0,10,42,58,3,2,35,63,22,35,18,28,3,5,10,40,63
2006-10-09 00:00:00.000,Stockholm Sweden ATP World Tour,HARD,2,Frank Dancevic,Guillermo Garcia-Lopez,Frank Dancevic,6-4; 6-1,R32,58,8,0,39,55,27,39,11,16,1,2,9,38,55,3,3,37,54,22,37,6,17,1,5,8,28,54
2006-10-09 00:00:00.000,Stockholm Sweden ATP World Tour,HARD,2,Kristof Vliegen,Nicolas Massu,Kristof Vliegen,6-2; 6-4,R32,80,3,0,27,51,21,27,16,24,1,2,9,37,51,0,2,28,55,16,28,12,27,5,9,9,28,55
2006-10-09 00:00:00.000,Stockholm Sweden ATP World Tour,HARD,2,David Ferrer,Andreas Seppi,David Ferrer,6-1; 6-4,R32,77,2,2,33,59,24,33,15,26,2,3,9,39,59,0,7,32,58,17,32,10,26,3,7,8,27,58
2006-10-09 00:00:00.000,Stockholm Sweden ATP World Tour,HARD,2,Feliciano Lopez,Juan Monaco,Feliciano Lopez,2-1 RET,R32,25,4,1,11,20,7,11,5,9,2,2,2,12,20,0,1,3,6,3,3,1,3,0,0,1,4,6
2006-10-09 00:00:00.000,Stockholm Sweden ATP World Tour,HARD,2,Marc Gicquel,Jonathan Marray,Marc Gicquel,6-4; 7-6(3),R32,84,3,0,50,70,41,50,13,20,3,3,11,54,70,5,3,44,70,35,44,12,26,0,1,11,47,70
2006-10-09 00:00:00.000,Stockholm Sweden ATP World Tour,HARD,2,Jarkko Nieminen,Michael Llodra,Jarkko Nieminen,6-4; 6-4,R32,69,2,1,32,57,25,32,17,25,2,2,10,42,57,8,1,30,54,24,30,13,24,1,3,10,37,54
2006-10-09 00:00:00.000,Stockholm Sweden ATP World Tour,HARD,2,Robin Soderling,Christophe Rochus,Robin Soderling,6-1; 6-2,R32,56,9,2,28,46,24,28,11,18,0,0,8,35,46,0,2,28,47,15,28,7,19,3,7,7,22,47
2006-10-09 00:00:00.000,Stockholm Sweden ATP World Tour,HARD,2,Jonas Bjorkman,Peter Wessels,Jonas Bjorkman,7-5; 6-2,R32,75,5,4,37,61,27,37,11,24,2,5,10,38,61,3,3,31,56,17,31,7,25,4,10,10,24,56
2006-10-09 00:00:00.000,Stockholm Sweden ATP World Tour,HARD,2,Andreas Vinciguerra,Nicolas Devilder,Andreas Vinciguerra,6-4; 6-1,R32,81,4,2,36,58,24,36,12,22,4,5,8,36,58,3,1,31,57,17,31,9,26,4,9,9,26,57
2006-10-09 00:00:00.000,Stockholm Sweden ATP World Tour,HARD,2,Tomas Berdych,Bjorn Phau,Tomas Berdych,6-3; 6-2,R32,61,3,1,34,47,27,34,7,13,0,1,9,34,47,1,1,26,57,18,26,12,31,4,8,8,30,57
2006-10-09 00:00:00.000,Stockholm Sweden ATP World Tour,HARD,2,Olivier Rochus,Vincent Spadea,Olivier Rochus,6-3; 6-4,R32,102,1,4,32,57,25,32,12,25,4,5,9,37,57,1,1,51,94,31,51,18,43,12,16,10,49,94
2006-10-09 00:00:00.000,Stockholm Sweden ATP World Tour,HARD,2,Paradorn Srichaphan,Mardy Fish,Paradorn Srichaphan,7-6(5); 3-6; 6-1,R32,119,5,3,44,82,33,44,24,38,2,4,14,57,82,7,6,46,104,32,46,30,58,5,8,14,62,104
2006-10-09 00:00:00.000,Stockholm Sweden ATP World Tour,HARD,2,Simon Greul,Ervin Eleskovic,Simon Greul,6-4; 6-2,R32,58,12,3,27,49,22,27,15,22,1,1,9,37,49,5,5,30,54,21,30,10,24,1,4,9,31,54
2006-10-09 00:00:00.000,Stockholm Sweden ATP World Tour,HARD,2,James Blake,Thomas Johansson,James Blake,6-3; 6-2,R32,60,6,1,30,54,25,30,14,24,1,1,9,39,54,3,1,25,48,18,25,8,23,3,6,8,26,48
2006-10-09 00:00:00.000,Stockholm Sweden ATP World Tour,HARD,2,Joachim Johansson,Rafael Nadal,Joachim Johansson,6-4; 7-6(4),R16,112,17,4,49,84,37,49,19,35,6,7,11,56,84,3,0,33,59,26,33,17,26,1,3,11,43,59
2006-10-09 00:00:00.000,Stockholm Sweden ATP World Tour,HARD,2,Kristof Vliegen,Frank Dancevic,Kristof Vliegen,3-6; 6-3; 6-4,R16,103,8,1,42,80,30,42,27,38,5,6,14,57,80,3,1,46,79,34,46,18,33,1,3,14,52,79
2006-10-09 00:00:00.000,Stockholm Sweden ATP World Tour,HARD,2,Feliciano Lopez,David Ferrer,Feliciano Lopez,3-6; 6-3; 6-2,R16,91,12,1,51,80,40,51,15,29,4,5,13,55,80,4,3,38,68,27,38,18,30,0,3,13,45,68
2006-10-09 00:00:00.000,Stockholm Sweden ATP World Tour,HARD,2,Jarkko Nieminen,Marc Gicquel,Jarkko Nieminen,6-3; 6-2,R16,65,5,1,28,59,24,28,18,31,4,4,9,42,59,1,1,26,49,20,26,9,23,2,5,8,29,49
2006-10-09 00:00:00.000,Stockholm Sweden ATP World Tour,HARD,2,Robin Soderling,Jonas Bjorkman,Robin Soderling,6-0; 6-2,R16,49,4,2,24,34,23,24,5,10,0,0,7,28,34,1,5,25,46,16,25,2,21,5,10,7,18,46
2006-10-09 00:00:00.000,Stockholm Sweden ATP World Tour,HARD,2,Tomas Berdych,Andreas Vinciguerra,Tomas Berdych,4-6; 7-5; 7-5,R16,135,10,0,62,89,46,62,16,27,2,5,17,62,89,6,2,73,107,48,73,18,34,6,10,17,66,107
2006-10-09 00:00:00.000,Stockholm Sweden ATP World Tour,HARD,2,Olivier Rochus,Paradorn Srichaphan,Olivier Rochus,6-2; 6-7(5); 6-2,R16,134,1,1,64,102,44,64,21,38,14,16,14,65,102,8,4,53,87,35,53,16,34,4,10,14,51,87
2006-10-09 00:00:00.000,Stockholm Sweden ATP World Tour,HARD,2,James Blake,Simon Greul,James Blake,6-3; 6-2,R16,71,1,0,32,57,24,32,15,25,3,3,9,39,57,3,1,49,70,32,49,7,21,5,8,8,39,70
2006-10-09 00:00:00.000,Stockholm Sweden ATP World Tour,HARD,2,Joachim Johansson,Kristof Vliegen,Joachim Johansson,6-7(5); 7-6(5); 7-6(7),Q,173,24,4,96,137,74,96,18,41,8,9,18,92,137,24,3,80,120,67,80,18,40,1,2,18,85,120
2006-10-09 00:00:00.000,Stockholm Sweden ATP World Tour,HARD,2,Jarkko Nieminen,Feliciano Lopez,Jarkko Nieminen,6-3; 7-5,Q,71,5,0,46,62,36,46,8,16,2,3,11,44,62,7,3,34,60,24,34,11,26,2,5,10,35,60
2006-10-09 00:00:00.000,Stockholm Sweden ATP World Tour,HARD,2,Robin Soderling,Tomas Berdych,Robin Soderling,6-2; 6-3,Q,56,5,2,29,44,26,29,10,15,0,0,9,36,44,3,3,26,50,20,26,9,24,5,8,8,29,50
2006-10-09 00:00:00.000,Stockholm Sweden ATP World Tour,HARD,2,James Blake,Olivier Rochus,James Blake,6-7(3); 6-4; 6-2,Q,119,16,0,54,90,42,54,22,36,3,4,15,64,90,1,3,63,101,37,63,23,38,5,9,15,60,101
2006-10-09 00:00:00.000,Stockholm Sweden ATP World Tour,HARD,2,Jarkko Nieminen,Joachim Johansson,Jarkko Nieminen,7-6(8); 6-7(5); 6-3,S,135,15,0,82,116,63,82,22,34,5,5,17,85,116,15,3,62,97,52,62,22,35,0,1,16,74,97
2006-10-09 00:00:00.000,Stockholm Sweden ATP World Tour,HARD,2,James Blake,Robin Soderling,James Blake,7-5; 7-6(4),S,89,5,2,51,71,40,51,14,20,0,1,12,54,71,8,2,43,80,34,43,18,37,4,6,12,52,80
2006-10-09 00:00:00.000,Stockholm Sweden ATP World Tour,HARD,2,James Blake,Jarkko Nieminen,James Blake,6-4; 6-2,F,56,4,1,21,45,21,21,12,24,0,1,9,33,45,3,0,40,58,26,40,7,18,2,6,9,33,58
2006-10-09 00:00:00.000,Vienna Austria ATP World Tour,HARD,2,Ivan Ljubicic,Agustin Calleri,Ivan Ljubicic,7-6(3); 6-2,R32,76,8,1,36,55,32,36,12,19,0,0,10,44,55,6,0,38,64,29,38,11,26,4,6,10,40,64
2006-10-09 00:00:00.000,Vienna Austria ATP World Tour,HARD,2,Florian Mayer,Alessio Di Mauro,Florian Mayer,6-2; 6-0,R32,44,5,0,28,34,24,28,4,6,0,0,7,28,34,0,4,25,40,12,25,3,15,0,5,7,15,40
2006-10-09 00:00:00.000,Vienna Austria ATP World Tour,HARD,2,Stanislas Wawrinka,Marin Cilic,Stanislas Wawrinka,6-4; 6-1,R32,79,4,1,41,67,31,41,11,26,4,5,9,42,67,3,3,24,50,16,24,9,26,5,9,8,25,50
2006-10-09 00:00:00.000,Vienna Austria ATP World Tour,HARD,2,Novak Djokovic,Tomas Zib,Novak Djokovic,6-3; 6-4,R32,66,16,2,37,61,34,37,10,24,3,3,10,44,61,2,0,25,49,21,25,11,24,1,3,9,32,49
2006-10-09 00:00:00.000,Vienna Austria ATP World Tour,HARD,2,Marcos Baghdatis,Ruben Ramirez Hidalgo,Marcos Baghdatis,6-3; 3-6; 6-4,R32,143,8,2,60,99,40,60,21,39,8,11,14,61,99,6,4,48,88,34,48,19,40,8,12,14,53,88
2006-10-09 00:00:00.000,Vienna Austria ATP World Tour,HARD,2,Stefan Koubek,Denis Gremelmayr,Stefan Koubek,6-1; 6-0,R32,44,3,0,25,44,21,25,11,19,1,1,7,32,44,0,4,18,37,9,18,4,19,1,6,6,13,37
2006-10-09 00:00:00.000,Vienna Austria ATP World Tour,HARD,2,Dominik Hrbaty,Simone Bolelli,Dominik Hrbaty,6-2; 6-4,R32,76,4,6,31,67,26,31,18,36,2,2,9,44,67,3,1,37,58,21,37,11,21,6,9,9,32,58
2006-10-09 00:00:00.000,Vienna Austria ATP World Tour,HARD,2,Tommy Haas,Martin Fischer,Tommy Haas,7-6(3); 6-2,R32,85,5,1,44,68,33,44,13,24,4,6,10,46,68,0,1,46,69,25,46,11,23,4,8,10,36,69
2006-10-09 00:00:00.000,Vienna Austria ATP World Tour,HARD,2,Jurgen Melzer,Juan Carlos Ferrero,Jurgen Melzer,5-7; 7-6(5); 6-3,R32,150,8,3,60,106,48,60,22,46,2,4,17,70,106,0,2,60,101,41,60,26,41,7,9,16,67,101
2006-10-09 00:00:00.000,Vienna Austria ATP World Tour,HARD,2,Lukasz Kubot,Sebastien Grosjean,Lukasz Kubot,6-4; 6-3,R32,105,4,2,41,64,30,41,11,23,3,4,10,41,64,2,1,45,67,28,45,9,22,5,8,9,37,67
2006-10-09 00:00:00.000,Vienna Austria ATP World Tour,HARD,2,Richard Gasquet,Alejandro Falla,Richard Gasquet,7-6(4); 6-3,R32,109,1,2,59,82,43,59,7,23,7,10,10,50,82,2,0,34,73,22,34,17,39,6,11,11,39,73
2006-10-09 00:00:00.000,Vienna Austria ATP World Tour,HARD,2,Andy Roddick,Jose Acasuso,Andy Roddick,6-0; 7-6(2),R32,63,19,2,39,50,36,39,6,11,0,0,9,42,50,9,2,43,73,28,43,14,30,4,7,9,42,73
2006-10-09 00:00:00.000,Vienna Austria ATP World Tour,HARD,2,Fernando Gonzalez,Gilles Simon,Fernando Gonzalez,7-6(6); 6-4,R32,99,7,2,46,68,34,46,15,22,2,4,11,49,68,1,3,58,84,38,58,13,26,8,11,11,51,84
2006-10-09 00:00:00.000,Vienna Austria ATP World Tour,HARD,2,Carlos Moya,Nicolas Almagro,Carlos Moya,3-6; 6-3; 7-6(3),R32,104,13,2,49,83,42,49,20,34,5,6,15,62,83,16,4,57,93,46,57,18,36,6,7,15,64,93
2006-10-09 00:00:00.000,Vienna Austria ATP World Tour,HARD,2,Oliver Marach,Rainer Eitzinger,Oliver Marach,2-6; 7-5; 7-6(6),R32,161,8,5,76,132,50,76,23,56,5,10,16,73,132,6,2,44,90,35,44,24,46,5,9,16,59,90
2006-10-09 00:00:00.000,Vienna Austria ATP World Tour,HARD,2,David Nalbandian,Juan Ignacio Chela,David Nalbandian,6-7(6); 6-2; 6-2,R32,123,4,3,52,88,37,52,23,36,3,4,14,60,88,4,1,68,101,39,68,18,33,1,6,14,57,101
2006-10-09 00:00:00.000,Vienna Austria ATP World Tour,HARD,2,Ivan Ljubicic,Florian Mayer,Ivan Ljubicic,6-3; 6-3,R16,67,14,1,32,50,30,32,8,18,1,1,9,38,50,1,0,38,58,25,38,8,20,2,5,9,33,58
2006-10-09 00:00:00.000,Vienna Austria ATP World Tour,HARD,2,Stanislas Wawrinka,Novak Djokovic,Stanislas Wawrinka,6-3; 6-3,R16,62,7,1,28,50,23,28,14,22,2,2,9,37,50,1,2,26,45,17,26,8,19,0,3,9,25,45
2006-10-09 00:00:00.000,Vienna Austria ATP World Tour,HARD,2,Stefan Koubek,Marcos Baghdatis,Stefan Koubek,1-6; 7-6(3); 6-2,R16,121,0,2,41,81,29,41,20,40,4,8,13,49,81,5,4,53,91,36,53,17,38,5,9,14,53,91
2006-10-09 00:00:00.000,Vienna Austria ATP World Tour,HARD,2,Dominik Hrbaty,Tommy Haas,Dominik Hrbaty,6-3; 4-6; 6-0,R16,87,12,4,47,75,40,47,14,28,4,5,13,54,75,2,3,46,67,33,46,9,21,2,6,12,42,67
2006-10-09 00:00:00.000,Vienna Austria ATP World Tour,HARD,2,Jurgen Melzer,Lukasz Kubot,Jurgen Melzer,6-4; 3-6; 6-1,R16,129,7,1,62,93,39,62,15,31,7,11,13,54,93,4,2,49,72,27,49,12,23,4,10,13,39,72
2006-10-09 00:00:00.000,Vienna Austria ATP World Tour,HARD,2,Andy Roddick,Richard Gasquet,Andy Roddick,6-7(5); 6-1; 6-3,R16,100,8,0,53,75,46,53,14,22,0,0,14,60,75,7,1,55,83,40,55,14,28,1,5,14,54,83
2006-10-09 00:00:00.000,Vienna Austria ATP World Tour,HARD,2,Fernando Gonzalez,Carlos Moya,Fernando Gonzalez,6-3; 6-4,R16,56,3,0,34,51,27,34,13,17,0,0,10,40,51,4,3,34,48,22,34,9,14,3,5,9,31,48
2006-10-09 00:00:00.000,Vienna Austria ATP World Tour,HARD,2,David Nalbandian,Oliver Marach,David Nalbandian,6-2; 6-3,R16,87,5,1,35,66,28,35,13,31,6,7,9,41,66,1,3,24,56,15,24,13,32,3,7,8,28,56
2006-10-09 00:00:00.000,Vienna Austria ATP World Tour,HARD,2,Ivan Ljubicic,Stanislas Wawrinka,Ivan Ljubicic,6-3; 6-2,Q,66,11,3,27,46,24,27,12,19,0,0,9,36,46,2,1,29,51,19,29,10,22,2,5,8,29,51
2006-10-09 00:00:00.000,Vienna Austria ATP World Tour,HARD,2,Dominik Hrbaty,Stefan Koubek,Dominik Hrbaty,6-1; 5-7; 6-2,Q,122,4,7,48,97,32,48,28,49,11,14,13,60,97,2,6,40,87,23,40,20,47,1,8,14,43,87
2006-10-09 00:00:00.000,Vienna Austria ATP World Tour,HARD,2,Andy Roddick,Jurgen Melzer,Andy Roddick,6-4; 6-3,Q,73,11,0,33,55,28,33,11,22,1,2,10,39,55,1,1,38,58,17,38,16,20,2,5,9,33,58
2006-10-09 00:00:00.000,Vienna Austria ATP World Tour,HARD,2,Fernando Gonzalez,David Nalbandian,Fernando Gonzalez,3-6; 6-3; 6-1,Q,108,11,3,57,82,39,57,13,25,6,8,12,52,82,1,0,60,87,32,60,15,27,8,13,13,47,87
2006-10-09 00:00:00.000,Vienna Austria ATP World Tour,HARD,2,Ivan Ljubicic,Dominik Hrbaty,Ivan Ljubicic,6-1; 6-4,S,65,12,1,32,40,28,32,4,8,0,0,8,32,40,3,4,38,61,22,38,11,23,4,8,9,33,61
2006-10-09 00:00:00.000,Vienna Austria ATP World Tour,HARD,2,Fernando Gonzalez,Andy Roddick,Fernando Gonzalez,6-4; 3-6; 7-6(5),S,127,9,3,63,90,51,63,15,27,0,1,15,66,90,12,0,76,111,50,76,25,35,4,5,16,75,111
2006-10-09 00:00:00.000,Vienna Austria ATP World Tour,HARD,2,Ivan Ljubicic,Fernando Gonzalez,Ivan Ljubicic,6-3; 6-4; 7-5,F,135,17,1,52,83,46,52,21,31,4,4,16,67,83,2,3,81,120,55,81,15,39,7,10,15,70,120
2006-10-16 00:00:00.000,ATP Masters Series Madrid Spain ATP World Tour,HARD,2,Roger Federer,N/A Bye,Roger Federer,,R64,0,0,0,0,0,0,0,0,0,0,0,0,0,0,0,0,0,0,0,0,0,0,0,0,0,0,0
2006-10-16 00:00:00.000,ATP Masters Series Madrid Spain ATP World Tour,HARD,2,Nicolas Massu,Gaston Gaudio,Nicolas Massu,4-6; 6-3 RET,R64,88,4,4,28,57,20,28,15,29,1,4,10,35,57,0,5,35,56,25,35,8,21,1,4,9,33,56
2006-10-16 00:00:00.000,ATP Masters Series Madrid Spain ATP World Tour,HARD,2,Robin Soderling,Olivier Rochus,Robin Soderling,6-3; 6-4,R64,62,11,2,33,53,27,33,13,20,0,0,10,40,53,2,1,35,53,22,35,10,18,6,8,9,32,53
2006-10-16 00:00:00.000,ATP Masters Series Madrid Spain ATP World Tour,HARD,2,Juan Carlos Ferrero,N/A Bye,Juan Carlos Ferrero,,R64,0,0,0,0,0,0,0,0,0,0,0,0,0,0,0,0,0,0,0,0,0,0,0,0,0,0,0
2006-10-16 00:00:00.000,ATP Masters Series Madrid Spain ATP World Tour,HARD,2,Mario Ancic,N/A Bye,Mario Ancic,,R64,0,0,0,0,0,0,0,0,0,0,0,0,0,0,0,0,0,0,0,0,0,0,0,0,0,0,0
2006-10-16 00:00:00.000,ATP Masters Series Madrid Spain ATP World Tour,HARD,2,Robby Ginepri,Feliciano Lopez,Robby Ginepri,6-1; 3-6; 6-3,R64,110,7,2,52,89,35,52,22,37,10,11,13,57,89,7,4,40,76,30,40,17,36,3,6,12,47,76
2006-10-16 00:00:00.000,ATP Masters Series Madrid Spain ATP World Tour,HARD,2,Juan Ignacio Chela,Carlos Moya,Juan Ignacio Chela,6-3; 6-2,R64,58,3,1,29,45,24,29,13,16,2,2,9,37,45,1,1,30,46,21,30,6,16,3,6,8,27,46
2006-10-16 00:00:00.000,ATP Masters Series Madrid Spain ATP World Tour,HARD,2,Tommy Robredo,N/A Bye,Tommy Robredo,,R64,0,0,0,0,0,0,0,0,0,0,0,0,0,0,0,0,0,0,0,0,0,0,0,0,0,0,0
2006-10-16 00:00:00.000,ATP Masters Series Madrid Spain ATP World Tour,HARD,2,David Nalbandian,N/A Bye,David Nalbandian,,R64,0,0,0,0,0,0,0,0,0,0,0,0,0,0,0,0,0,0,0,0,0,0,0,0,0,0,0
2006-10-16 00:00:00.000,ATP Masters Series Madrid Spain ATP World Tour,HARD,2,Julien Benneteau,Alejandro Falla,Julien Benneteau,6-2; 6-1,R64,58,2,1,37,50,27,37,9,13,4,4,8,36,50,0,0,25,41,12,25,8,16,2,6,7,20,41
2006-10-16 00:00:00.000,ATP Masters Series Madrid Spain ATP World Tour,HARD,2,Tim Henman,Fernando Verdasco,Tim Henman,7-5; 6-3,R64,91,6,3,43,66,32,43,17,23,5,5,11,49,66,3,3,42,59,30,42,7,17,2,4,10,37,59
2006-10-16 00:00:00.000,ATP Masters Series Madrid Spain ATP World Tour,HARD,2,David Ferrer,N/A Bye,David Ferrer,,R64,0,0,0,0,0,0,0,0,0,0,0,0,0,0,0,0,0,0,0,0,0,0,0,0,0,0,0
2006-10-16 00:00:00.000,ATP Masters Series Madrid Spain ATP World Tour,HARD,2,Marcos Baghdatis,N/A Bye,Marcos Baghdatis,,R64,0,0,0,0,0,0,0,0,0,0,0,0,0,0,0,0,0,0,0,0,0,0,0,0,0,0,0
2006-10-16 00:00:00.000,ATP Masters Series Madrid Spain ATP World Tour,HARD,2,Marat Safin,Jose Acasuso,Marat Safin,7-6(5); 6-7(4); 6-3,R64,135,16,0,70,109,56,70,18,39,3,5,17,74,109,15,3,57,101,47,57,22,44,4,7,16,69,101
2006-10-16 00:00:00.000,ATP Masters Series Madrid Spain ATP World Tour,HARD,2,Kristof Vliegen,Dmitry Tursunov,Kristof Vliegen,6-3; 6-1,R64,61,6,3,26,45,22,26,12,19,3,3,8,34,45,5,4,34,63,21,34,11,29,6,10,8,32,63
2006-10-16 00:00:00.000,ATP Masters Series Madrid Spain ATP World Tour,HARD,2,James Blake,N/A Bye,James Blake,,R64,0,0,0,0,0,0,0,0,0,0,0,0,0,0,0,0,0,0,0,0,0,0,0,0,0,0,0
2006-10-16 00:00:00.000,ATP Masters Series Madrid Spain ATP World Tour,HARD,2,Nikolay Davydenko,N/A Bye,Nikolay Davydenko,,R64,0,0,0,0,0,0,0,0,0,0,0,0,0,0,0,0,0,0,0,0,0,0,0,0,0,0,0
2006-10-16 00:00:00.000,ATP Masters Series Madrid Spain ATP World Tour,HARD,2,Joachim Johansson,Juan Martin Del Potro,Joachim Johansson,6-4; 6-4,R64,75,17,3,44,63,34,44,11,19,8,8,10,45,63,3,0,45,57,30,45,9,12,4,6,10,39,57
2006-10-16 00:00:00.000,ATP Masters Series Madrid Spain ATP World Tour,HARD,2,Paradorn Srichaphan,Gorka Fraile,Paradorn Srichaphan,6-2; 6-2,R64,55,4,1,25,45,20,25,13,20,0,0,8,33,45,1,0,35,49,20,35,4,14,0,4,8,24,49
2006-10-16 00:00:00.000,ATP Masters Series Madrid Spain ATP World Tour,HARD,2,Fernando Gonzalez,N/A Bye,Fernando Gonzalez,,R64,0,0,0,0,0,0,0,0,0,0,0,0,0,0,0,0,0,0,0,0,0,0,0,0,0,0,0
2006-10-16 00:00:00.000,ATP Masters Series Madrid Spain ATP World Tour,HARD,2,Novak Djokovic,N/A Bye,Novak Djokovic,,R64,0,0,0,0,0,0,0,0,0,0,0,0,0,0,0,0,0,0,0,0,0,0,0,0,0,0,0
2006-10-16 00:00:00.000,ATP Masters Series Madrid Spain ATP World Tour,HARD,2,Richard Gasquet,Jarkko Nieminen,Richard Gasquet,6-2; 6-3,R64,64,5,0,33,54,22,33,16,21,1,1,9,38,54,2,1,33,55,20,33,9,22,3,6,8,29,55
2006-10-16 00:00:00.000,ATP Masters Series Madrid Spain ATP World Tour,HARD,2,Andy Murray,Ivan Navarro,Andy Murray,6-2; 6-4,R64,78,3,2,30,50,26,30,11,20,1,1,9,37,50,5,1,43,67,28,43,9,24,3,6,9,37,67
2006-10-16 00:00:00.000,ATP Masters Series Madrid Spain ATP World Tour,HARD,2,Ivan Ljubicic,N/A Bye,Ivan Ljubicic,,R64,0,0,0,0,0,0,0,0,0,0,0,0,0,0,0,0,0,0,0,0,0,0,0,0,0,0,0
2006-10-16 00:00:00.000,ATP Masters Series Madrid Spain ATP World Tour,HARD,2,Andy Roddick,N/A Bye,Andy Roddick,,R64,0,0,0,0,0,0,0,0,0,0,0,0,0,0,0,0,0,0,0,0,0,0,0,0,0,0,0
2006-10-16 00:00:00.000,ATP Masters Series Madrid Spain ATP World Tour,HARD,2,Sebastien Grosjean,Jonas Bjorkman,Sebastien Grosjean,6-4; 7-5,R64,78,3,0,40,56,33,40,12,16,3,3,11,45,56,3,3,43,61,32,43,9,18,0,2,11,41,61
2006-10-16 00:00:00.000,ATP Masters Series Madrid Spain ATP World Tour,HARD,2,Agustin Calleri,Florent Serra,Agustin Calleri,7-6(3); 6-3,R64,79,13,3,43,60,35,43,5,17,2,4,10,40,60,4,2,48,80,28,48,15,32,2,6,11,43,80
2006-10-16 00:00:00.000,ATP Masters Series Madrid Spain ATP World Tour,HARD,2,Tomas Berdych,N/A Bye,Tomas Berdych,,R64,0,0,0,0,0,0,0,0,0,0,0,0,0,0,0,0,0,0,0,0,0,0,0,0,0,0,0
2006-10-16 00:00:00.000,ATP Masters Series Madrid Spain ATP World Tour,HARD,2,Tommy Haas,N/A Bye,Tommy Haas,,R64,0,0,0,0,0,0,0,0,0,0,0,0,0,0,0,0,0,0,0,0,0,0,0,0,0,0,0
2006-10-16 00:00:00.000,ATP Masters Series Madrid Spain ATP World Tour,HARD,2,Dominik Hrbaty,Gael Monfils,Dominik Hrbaty,3-6; 2-2 RET,R64,52,1,3,22,46,14,22,15,24,1,2,6,29,46,9,2,30,46,22,30,10,16,3,3,7,32,46
2006-10-16 00:00:00.000,ATP Masters Series Madrid Spain ATP World Tour,HARD,2,Mardy Fish,Xavier Malisse,Mardy Fish,5-7; 6-3; 7-5,R64,109,14,4,51,94,43,51,24,43,2,3,17,67,94,16,1,50,78,44,50,15,28,0,2,16,59,78
2006-10-16 00:00:00.000,ATP Masters Series Madrid Spain ATP World Tour,HARD,2,Rafael Nadal,N/A Bye,Rafael Nadal,,R64,0,0,0,0,0,0,0,0,0,0,0,0,0,0,0,0,0,0,0,0,0,0,0,0,0,0,0
2006-10-16 00:00:00.000,ATP Masters Series Madrid Spain ATP World Tour,HARD,2,Roger Federer,Nicolas Massu,Roger Federer,6-3; 6-2,R32,85,7,0,31,57,24,31,16,26,3,3,9,40,57,2,2,34,55,22,34,8,21,3,6,8,30,55
2006-10-16 00:00:00.000,ATP Masters Series Madrid Spain ATP World Tour,HARD,2,Robin Soderling,Juan Carlos Ferrero,Robin Soderling,6-3; 6-2,R32,79,10,4,40,58,34,40,8,18,5,5,9,42,58,3,2,41,64,25,41,8,23,4,7,8,33,64
2006-10-16 00:00:00.000,ATP Masters Series Madrid Spain ATP World Tour,HARD,2,Robby Ginepri,Mario Ancic,Robby Ginepri,7-6(5); 7-6(5),R32,114,6,2,55,89,36,55,23,34,6,8,12,59,89,3,1,47,77,35,47,17,30,4,6,12,52,77
2006-10-16 00:00:00.000,ATP Masters Series Madrid Spain ATP World Tour,HARD,2,Tommy Robredo,Juan Ignacio Chela,Tommy Robredo,7-6(2); 7-6(3),R32,131,8,4,71,101,54,71,10,30,4,6,12,64,101,1,1,69,97,50,69,9,28,8,10,12,59,97
2006-10-16 00:00:00.000,ATP Masters Series Madrid Spain ATP World Tour,HARD,2,David Nalbandian,Julien Benneteau,David Nalbandian,6-7(4); 6-2; 7-5,R32,136,7,4,75,105,52,75,16,30,2,4,16,68,105,8,2,69,97,46,69,13,28,4,9,16,59,97
2006-10-16 00:00:00.000,ATP Masters Series Madrid Spain ATP World Tour,HARD,2,Tim Henman,David Ferrer,Tim Henman,6-1; 4-6; 6-1,R32,105,3,4,45,80,31,45,18,35,5,8,12,49,80,2,1,48,76,24,48,11,28,3,10,12,35,76
2006-10-16 00:00:00.000,ATP Masters Series Madrid Spain ATP World Tour,HARD,2,Marat Safin,Marcos Baghdatis,Marat Safin,6-4; 6-3,R32,76,6,0,35,51,29,35,9,16,2,2,9,38,51,3,7,37,70,29,37,12,33,1,4,10,41,70
2006-10-16 00:00:00.000,ATP Masters Series Madrid Spain ATP World Tour,HARD,2,Kristof Vliegen,James Blake,Kristof Vliegen,6-4; 3-6; 7-6(5),R32,126,8,1,73,104,52,73,15,31,7,11,15,67,104,7,4,57,98,42,57,19,41,6,10,16,61,98
2006-10-16 00:00:00.000,ATP Masters Series Madrid Spain ATP World Tour,HARD,2,Joachim Johansson,Nikolay Davydenko,Joachim Johansson,6-4; 6-7(5); 6-3,R32,111,23,2,69,97,59,69,12,28,3,4,16,71,97,8,6,62,95,49,62,17,33,11,14,15,66,95
2006-10-16 00:00:00.000,ATP Masters Series Madrid Spain ATP World Tour,HARD,2,Fernando Gonzalez,Paradorn Srichaphan,Fernando Gonzalez,7-5; 6-7(5); 6-4,R32,145,10,3,76,118,53,76,24,42,8,10,17,77,118,8,8,70,107,51,70,17,37,4,8,17,68,107
2006-10-16 00:00:00.000,ATP Masters Series Madrid Spain ATP World Tour,HARD,2,Novak Djokovic,Richard Gasquet,Novak Djokovic,7-6(2); 1-6; 6-1,R32,98,9,3,47,72,38,47,13,25,3,6,13,51,72,5,3,51,82,37,51,15,31,2,5,13,52,82
2006-10-16 00:00:00.000,ATP Masters Series Madrid Spain ATP World Tour,HARD,2,Andy Murray,Ivan Ljubicic,Andy Murray,6-4; 3-6; 6-3,R32,133,8,6,37,88,32,37,28,51,5,6,14,60,88,12,7,41,91,37,41,21,50,2,4,14,58,91
2006-10-16 00:00:00.000,ATP Masters Series Madrid Spain ATP World Tour,HARD,2,Andy Roddick,Sebastien Grosjean,Andy Roddick,6-4; 7-6(3),R32,88,9,3,47,68,39,47,11,21,0,0,11,50,68,11,1,52,79,36,52,12,27,3,4,11,48,79
2006-10-16 00:00:00.000,ATP Masters Series Madrid Spain ATP World Tour,HARD,2,Tomas Berdych,Agustin Calleri,Tomas Berdych,7-6(2); 6-3,R32,93,8,2,38,68,28,38,16,30,3,5,10,44,68,8,7,34,77,28,34,14,43,4,8,11,42,77
2006-10-16 00:00:00.000,ATP Masters Series Madrid Spain ATP World Tour,HARD,2,Tommy Haas,Dominik Hrbaty,Tommy Haas,6-3; 7-6(6),R32,94,7,3,43,70,31,43,17,27,8,10,11,48,70,4,2,41,80,28,41,17,39,7,10,10,45,80
2006-10-16 00:00:00.000,ATP Masters Series Madrid Spain ATP World Tour,HARD,2,Rafael Nadal,Mardy Fish,Rafael Nadal,6-4; 6-2,R32,82,3,0,31,48,23,31,14,17,2,2,9,37,48,6,1,29,58,20,29,14,29,7,10,9,34,58
2006-10-16 00:00:00.000,ATP Masters Series Madrid Spain ATP World Tour,HARD,2,Roger Federer,Robin Soderling,Roger Federer,7-6(5); 7-6(8),R16,108,13,0,60,79,51,60,13,19,2,2,12,64,79,8,3,62,102,50,62,19,40,8,8,12,69,102
2006-10-16 00:00:00.000,ATP Masters Series Madrid Spain ATP World Tour,HARD,2,Robby Ginepri,Tommy Robredo,Robby Ginepri,6-3; 7-6(3),R16,90,3,2,43,62,35,43,10,19,0,1,11,45,62,4,2,45,66,27,45,14,21,2,4,10,41,66
2006-10-16 00:00:00.000,ATP Masters Series Madrid Spain ATP World Tour,HARD,2,David Nalbandian,Tim Henman,David Nalbandian,6-2; 2-6; 7-5,R16,100,5,2,57,76,40,57,9,19,3,6,14,49,76,9,2,55,84,35,55,16,29,4,8,14,51,84
2006-10-16 00:00:00.000,ATP Masters Series Madrid Spain ATP World Tour,HARD,2,Marat Safin,Kristof Vliegen,Marat Safin,6-3; 6-2,R16,66,2,0,32,50,23,32,12,18,2,3,9,35,50,2,0,35,59,18,35,13,24,4,8,8,31,59
2006-10-16 00:00:00.000,ATP Masters Series Madrid Spain ATP World Tour,HARD,2,Fernando Gonzalez,Joachim Johansson,Fernando Gonzalez,W/O,R16,0,0,0,0,0,0,0,0,0,0,0,0,0,0,0,0,0,0,0,0,0,0,0,0,0,0,0
2006-10-16 00:00:00.000,ATP Masters Series Madrid Spain ATP World Tour,HARD,2,Novak Djokovic,Andy Murray,Novak Djokovic,1-6; 7-5; 6-3,R16,131,3,3,49,90,35,49,21,41,4,7,14,56,90,5,2,39,86,27,39,27,47,3,6,14,54,86
2006-10-16 00:00:00.000,ATP Masters Series Madrid Spain ATP World Tour,HARD,2,Tomas Berdych,Andy Roddick,Tomas Berdych,7-6(7); 6-3,R16,81,23,2,46,65,41,46,11,19,0,0,11,52,65,12,4,44,63,36,44,11,19,3,4,10,47,63
2006-10-16 00:00:00.000,ATP Masters Series Madrid Spain ATP World Tour,HARD,2,Rafael Nadal,Tommy Haas,Rafael Nadal,6-4; 6-3,R16,87,4,3,30,49,27,30,11,19,1,1,9,38,49,3,3,36,60,25,36,9,24,4,7,10,34,60
2006-10-16 00:00:00.000,ATP Masters Series Madrid Spain ATP World Tour,HARD,2,Roger Federer,Robby Ginepri,Roger Federer,6-3; 7-6(4),Q,82,6,1,49,76,37,49,17,27,1,1,11,54,76,2,0,44,66,34,44,10,22,0,1,10,44,66
2006-10-16 00:00:00.000,ATP Masters Series Madrid Spain ATP World Tour,HARD,2,David Nalbandian,Marat Safin,David Nalbandian,6-4; 6-7(6); 7-6(2),Q,177,3,5,75,124,53,75,30,49,7,10,17,83,124,19,2,74,125,52,74,25,51,9,13,17,77,125
2006-10-16 00:00:00.000,ATP Masters Series Madrid Spain ATP World Tour,HARD,2,Fernando Gonzalez,Novak Djokovic,Fernando Gonzalez,7-5; 5-7; 7-5,Q,141,8,4,55,97,45,55,22,42,2,5,18,67,97,5,3,75,108,52,75,16,33,7,11,18,68,108
2006-10-16 00:00:00.000,ATP Masters Series Madrid Spain ATP World Tour,HARD,2,Tomas Berdych,Rafael Nadal,Tomas Berdych,6-3; 7-6(6),Q,107,9,4,47,78,35,47,17,31,2,2,11,52,78,4,2,43,64,31,43,11,21,0,1,10,42,64
2006-10-16 00:00:00.000,ATP Masters Series Madrid Spain ATP World Tour,HARD,2,Roger Federer,David Nalbandian,Roger Federer,6-4; 6-0,S,59,9,0,27,41,21,27,8,14,0,1,8,29,41,1,2,38,54,21,38,3,16,5,10,8,24,54
2006-10-16 00:00:00.000,ATP Masters Series Madrid Spain ATP World Tour,HARD,2,Fernando Gonzalez,Tomas Berdych,Fernando Gonzalez,6-3; 6-1,S,53,10,1,28,39,25,28,7,11,0,0,8,32,39,4,3,32,47,17,32,6,15,3,7,8,23,47
2006-10-16 00:00:00.000,ATP Masters Series Madrid Spain ATP World Tour,HARD,2,Roger Federer,Fernando Gonzalez,Roger Federer,7-5; 6-1; 6-0,F,108,11,2,45,81,36,45,24,36,2,2,13,60,81,4,0,50,79,26,50,15,29,7,13,12,41,79
2006-10-23 00:00:00.000,Basel Switzerland ATP World Tour,HARD,2,Roger Federer,Tomas Zib,Roger Federer,6-1; 6-2,R32,50,11,0,27,38,24,27,8,11,0,0,8,32,38,0,3,25,47,13,25,9,22,4,8,7,22,47
2006-10-23 00:00:00.000,Basel Switzerland ATP World Tour,HARD,2,Guillermo Garcia-Lopez,Julian Reister,Guillermo Garcia-Lopez,7-6(4); 6-2,R32,77,4,4,36,66,24,36,16,30,6,8,10,40,66,3,1,43,65,25,43,10,22,2,6,10,35,65
2006-10-23 00:00:00.000,Basel Switzerland ATP World Tour,HARD,2,Jiri Novak,Jan Hajek,Jiri Novak,6-7(5); 3-0 RET,R32,70,6,2,31,53,20,31,5,22,1,5,7,25,53,4,2,28,57,12,28,14,29,3,9,8,26,57
2006-10-23 00:00:00.000,Basel Switzerland ATP World Tour,HARD,2,David Ferrer,Marco Chiudinelli,David Ferrer,6-7(1); 6-3; 6-4,R32,134,5,4,69,111,49,69,28,42,6,6,16,77,111,6,4,53,93,42,53,21,40,1,3,15,63,93
2006-10-23 00:00:00.000,Basel Switzerland ATP World Tour,HARD,2,Juan Ignacio Chela,Filippo Volandri,Juan Ignacio Chela,6-4; 7-5,R32,72,2,0,41,66,28,41,18,25,3,4,11,46,66,1,2,28,55,17,28,20,27,3,6,11,37,55
2006-10-23 00:00:00.000,Basel Switzerland ATP World Tour,HARD,2,Paradorn Srichaphan,Benjamin Becker,Paradorn Srichaphan,7-6(4); 7-6(4),R32,88,12,5,52,82,40,52,17,30,3,4,12,57,82,17,2,49,76,41,49,11,27,1,2,12,52,76
2006-10-23 00:00:00.000,Basel Switzerland ATP World Tour,HARD,2,Philipp Kohlschreiber,Nicolas Thomann,Philipp Kohlschreiber,6-1; 7-5,R32,84,8,3,39,69,23,39,21,30,8,9,10,44,69,5,0,31,60,21,31,14,29,5,9,9,35,60
2006-10-23 00:00:00.000,Basel Switzerland ATP World Tour,HARD,2,Jose Acasuso,Albert Montanes,Jose Acasuso,6-4; 6-3,R32,61,7,0,23,46,18,23,18,23,0,0,9,36,46,5,3,29,60,23,29,13,31,1,4,10,36,60
2006-10-23 00:00:00.000,Basel Switzerland ATP World Tour,HARD,2,Juan Martin Del Potro,Tobias Clemens,Juan Martin Del Potro,3-6; 6-3; 6-2,R32,103,4,1,56,77,43,56,10,21,1,3,13,53,77,6,3,46,82,33,46,16,36,6,10,13,49,82
2006-10-23 00:00:00.000,Basel Switzerland ATP World Tour,HARD,2,George Bastl,Lars Burgsmuller,George Bastl,6-1; 6-4,R32,80,9,3,44,61,34,44,7,17,3,3,9,41,61,0,2,28,53,16,28,13,25,1,4,8,29,53
2006-10-23 00:00:00.000,Basel Switzerland ATP World Tour,HARD,2,Mardy Fish,Jiri Vanek,Mardy Fish,6-4; 6-3,R32,56,13,0,26,50,26,26,16,24,1,1,10,42,50,1,4,24,50,19,24,11,26,1,3,9,30,50
2006-10-23 00:00:00.000,Basel Switzerland ATP World Tour,HARD,2,Fernando Gonzalez,Simone Bolelli,Fernando Gonzalez,7-6(3); 6-7(2); 7-6(3),R32,141,22,2,80,120,63,80,22,40,3,4,18,85,120,10,1,79,119,66,79,20,40,4,5,18,86,119
2006-10-23 00:00:00.000,Basel Switzerland ATP World Tour,HARD,2,Stanislas Wawrinka,Agustin Calleri,Stanislas Wawrinka,7-6(6); 6-2,R32,78,7,0,27,55,23,27,19,28,0,1,10,42,55,8,1,33,62,25,33,13,29,2,5,10,38,62
2006-10-23 00:00:00.000,Basel Switzerland ATP World Tour,HARD,2,Tim Henman,Christophe Rochus,Tim Henman,6-2; 6-3,R32,72,11,1,23,43,22,23,12,20,0,1,9,34,43,0,3,38,64,24,38,9,26,5,9,8,33,64
2006-10-23 00:00:00.000,Basel Switzerland ATP World Tour,HARD,2,Feliciano Lopez,Ruben Ramirez Hidalgo,Feliciano Lopez,3-6; 7-6(5); 6-1,R32,106,7,4,43,74,34,43,18,31,0,2,13,52,74,3,7,48,98,32,48,27,50,7,11,15,59,98
2006-10-23 00:00:00.000,Basel Switzerland ATP World Tour,HARD,2,David Nalbandian,Roko Karanusic,David Nalbandian,6-2; 6-4,R32,64,6,3,37,59,27,37,12,22,3,4,9,39,59,6,1,38,57,22,38,7,19,2,6,9,29,57
2006-10-23 00:00:00.000,Basel Switzerland ATP World Tour,HARD,2,Roger Federer,Guillermo Garcia-Lopez,Roger Federer,6-2; 6-0,R16,53,4,1,21,37,18,21,10,16,0,0,7,28,37,2,4,30,55,16,30,8,25,6,11,7,24,55
2006-10-23 00:00:00.000,Basel Switzerland ATP World Tour,HARD,2,David Ferrer,Jiri Novak,David Ferrer,2-6; 6-3; 6-3,R16,102,4,3,44,73,34,44,13,29,0,3,13,47,73,4,2,55,84,33,55,16,29,5,9,13,49,84
2006-10-23 00:00:00.000,Basel Switzerland ATP World Tour,HARD,2,Paradorn Srichaphan,Juan Ignacio Chela,Paradorn Srichaphan,6-4; 6-3,R16,77,7,3,25,56,19,25,23,31,2,2,10,42,56,1,4,49,77,32,49,13,28,8,10,9,45,77
2006-10-23 00:00:00.000,Basel Switzerland ATP World Tour,HARD,2,Jose Acasuso,Philipp Kohlschreiber,Jose Acasuso,7-6(2); 6-1,R16,81,7,2,30,63,28,30,19,33,4,4,10,47,63,5,1,31,59,26,31,12,28,3,5,9,38,59
2006-10-23 00:00:00.000,Basel Switzerland ATP World Tour,HARD,2,Juan Martin Del Potro,George Bastl,Juan Martin Del Potro,6-3; 6-2,R16,77,2,4,31,53,25,31,12,22,3,3,8,37,53,4,2,33,53,18,33,9,20,3,7,9,27,53
2006-10-23 00:00:00.000,Basel Switzerland ATP World Tour,HARD,2,Fernando Gonzalez,Mardy Fish,Fernando Gonzalez,6-7(5); 6-4; 7-6(8),R16,157,8,5,81,125,62,81,24,44,5,7,17,86,125,13,3,69,125,52,69,30,56,8,11,17,82,125
2006-10-23 00:00:00.000,Basel Switzerland ATP World Tour,HARD,2,Stanislas Wawrinka,Tim Henman,Stanislas Wawrinka,2-6; 7-6(4); 6-4,R16,135,9,2,57,92,40,57,22,35,3,6,15,62,92,15,5,58,99,43,58,21,41,3,5,15,64,99
2006-10-23 00:00:00.000,Basel Switzerland ATP World Tour,HARD,2,David Nalbandian,Feliciano Lopez,David Nalbandian,6-7(4); 6-3; 7-6(7),R16,141,7,2,62,108,46,62,30,46,1,2,16,76,108,20,6,70,113,53,70,21,43,4,7,17,74,113
2006-10-23 00:00:00.000,Basel Switzerland ATP World Tour,HARD,2,Roger Federer,David Ferrer,Roger Federer,6-3; 7-6(14),Q,87,2,1,41,67,31,41,17,26,0,2,11,48,67,3,5,40,68,28,40,13,28,1,4,10,41,68
2006-10-23 00:00:00.000,Basel Switzerland ATP World Tour,HARD,2,Paradorn Srichaphan,Jose Acasuso,Paradorn Srichaphan,7-6(2); 6-3,Q,87,7,1,28,62,25,28,24,34,1,1,10,49,62,8,1,39,71,27,39,18,32,3,5,11,45,71
2006-10-23 00:00:00.000,Basel Switzerland ATP World Tour,HARD,2,Fernando Gonzalez,Juan Martin Del Potro,Fernando Gonzalez,5-7; 6-4; 6-4,Q,133,10,2,61,102,48,61,20,41,4,6,16,68,102,4,4,69,97,47,69,17,28,8,11,16,64,97
2006-10-23 00:00:00.000,Basel Switzerland ATP World Tour,HARD,2,Stanislas Wawrinka,David Nalbandian,Stanislas Wawrinka,7-6(7); 6-2,Q,92,13,1,31,60,28,31,18,29,0,0,10,46,60,2,2,54,79,37,54,11,25,7,9,10,48,79
2006-10-23 00:00:00.000,Basel Switzerland ATP World Tour,HARD,2,Roger Federer,Paradorn Srichaphan,Roger Federer,6-4; 3-6; 7-6(5),S,118,8,0,60,83,48,60,16,23,0,1,15,64,83,6,3,58,110,46,58,29,52,6,7,16,75,110
2006-10-23 00:00:00.000,Basel Switzerland ATP World Tour,HARD,2,Fernando Gonzalez,Stanislas Wawrinka,Fernando Gonzalez,6-4; 6-4,S,79,4,0,40,58,32,40,10,18,3,3,10,42,58,2,2,31,57,22,31,15,26,4,6,10,37,57
2006-10-23 00:00:00.000,Basel Switzerland ATP World Tour,HARD,2,Roger Federer,Fernando Gonzalez,Roger Federer,6-3; 6-2; 7-6(3),F,119,14,1,67,86,56,67,13,19,2,2,15,69,86,6,5,67,121,49,67,21,54,8,11,14,70,121
2006-10-23 00:00:00.000,Lyon France ATP World Tour,HARD,2,Arnaud Clement,Marcos Baghdatis,Arnaud Clement,6-2; 5-7; 6-3,R32,124,8,1,49,80,34,49,19,31,4,8,15,53,80,7,11,48,100,36,48,16,52,4,10,14,52,100
2006-10-23 00:00:00.000,Lyon France ATP World Tour,HARD,2,Michael Llodra,Michal Mertinak,Michael Llodra,4-6; 7-6(4); 6-2,R32,129,13,1,68,100,57,68,13,32,4,5,15,70,100,9,1,65,98,42,65,23,33,4,6,15,65,98
2006-10-23 00:00:00.000,Lyon France ATP World Tour,HARD,2,Florian Mayer,Nicolas Mahut,Florian Mayer,7-6(5); 6-3,R32,84,12,0,42,72,33,42,18,30,0,0,11,51,72,11,4,40,63,30,40,12,23,1,2,10,42,63
2006-10-23 00:00:00.000,Lyon France ATP World Tour,HARD,2,Nicolas Almagro,Oliver Marach,Nicolas Almagro,2-6; 7-5; 6-1,R32,107,15,6,49,101,42,49,21,52,6,9,14,63,101,3,3,40,78,24,40,20,38,6,10,13,44,78
2006-10-23 00:00:00.000,Lyon France ATP World Tour,HARD,2,Richard Gasquet,Marat Safin,Richard Gasquet,6-4; 7-6(5),R32,102,8,5,53,79,44,53,13,26,2,2,11,57,79,11,2,55,88,43,55,15,33,7,8,11,58,88
2006-10-23 00:00:00.000,Lyon France ATP World Tour,HARD,2,Dick Norman,Olivier Patience,Dick Norman,6-4; 7-5,R32,91,15,5,40,66,34,40,13,26,3,3,11,47,66,6,0,51,73,33,51,12,22,4,6,11,45,73
2006-10-23 00:00:00.000,Lyon France ATP World Tour,HARD,2,Nicolas Massu,Kevin Kim,Nicolas Massu,7-6(6); 7-5,R32,108,7,1,42,72,34,42,19,30,0,0,12,53,72,3,3,45,89,30,45,28,44,4,5,12,58,89
2006-10-23 00:00:00.000,Lyon France ATP World Tour,HARD,2,Robin Soderling,Thierry Ascione,Robin Soderling,6-3; 6-1,R32,65,7,1,27,44,24,27,10,17,4,4,8,34,44,5,2,38,65,22,38,11,27,9,13,8,33,65
2006-10-23 00:00:00.000,Lyon France ATP World Tour,HARD,2,Sebastien Grosjean,Paul-Henri Mathieu,Sebastien Grosjean,6-3; 7-6(3),R32,99,6,3,41,76,34,41,18,35,3,4,11,52,76,2,1,33,63,25,33,17,30,6,8,10,42,63
2006-10-23 00:00:00.000,Lyon France ATP World Tour,HARD,2,Cyril Saulnier,Alejandro Falla,Cyril Saulnier,6-7(9); 6-3; 6-2,R32,132,7,4,73,108,54,73,17,35,10,11,14,71,108,1,3,59,101,34,59,22,42,3,8,15,56,101
2006-10-23 00:00:00.000,Lyon France ATP World Tour,HARD,2,Marc Gicquel,Andreas Seppi,Marc Gicquel,6-4; 6-3,R32,76,7,0,34,56,27,34,10,22,3,5,9,37,56,1,6,30,65,20,30,12,35,6,11,10,32,65
2006-10-23 00:00:00.000,Lyon France ATP World Tour,HARD,2,Dominik Hrbaty,Florent Serra,Dominik Hrbaty,3-6; 6-3; 6-3,R32,102,8,7,50,92,40,50,16,42,4,6,13,56,92,7,1,56,88,36,56,15,32,7,11,14,51,88
2006-10-23 00:00:00.000,Lyon France ATP World Tour,HARD,2,Xavier Malisse,Vincent Spadea,Xavier Malisse,6-3; 4-6; 6-1,R32,122,10,2,50,87,37,50,16,37,4,7,13,53,87,2,3,64,106,36,64,19,42,14,20,13,55,106
2006-10-23 00:00:00.000,Lyon France ATP World Tour,HARD,2,Julien Benneteau,Julien Mathieu,Julien Benneteau,7-5; 6-4,R32,96,9,2,45,67,30,45,13,22,2,3,11,43,67,6,1,64,94,42,64,11,30,9,12,11,53,94
2006-10-23 00:00:00.000,Lyon France ATP World Tour,HARD,2,Robby Ginepri,Gilles Simon,Robby Ginepri,7-6(3); 7-6(5),R32,103,6,4,70,93,49,70,10,23,7,10,12,59,93,7,3,39,80,28,39,21,41,2,5,12,49,80
2006-10-23 00:00:00.000,Lyon France ATP World Tour,HARD,2,Simon Greul,Gaston Gaudio,Simon Greul,6-0; 6-2,R32,55,6,2,22,41,19,22,12,19,1,1,7,31,41,2,5,26,49,15,26,7,23,5,10,7,22,49
2006-10-23 00:00:00.000,Lyon France ATP World Tour,HARD,2,Arnaud Clement,Michael Llodra,Arnaud Clement,2-6; 6-1; 7-6(2),R16,112,8,0,60,87,44,60,15,27,4,6,13,59,87,15,0,58,81,43,58,8,23,0,3,14,51,81
2006-10-23 00:00:00.000,Lyon France ATP World Tour,HARD,2,Nicolas Almagro,Florian Mayer,Nicolas Almagro,7-6(5); 6-4,R16,74,11,2,42,77,34,42,22,35,5,5,11,56,77,3,2,47,68,31,47,15,21,0,1,11,46,68
2006-10-23 00:00:00.000,Lyon France ATP World Tour,HARD,2,Richard Gasquet,Dick Norman,Richard Gasquet,6-3; 6-4,R16,87,6,2,36,62,32,36,13,26,4,4,10,45,62,12,3,42,74,31,42,13,32,6,8,9,44,74
2006-10-23 00:00:00.000,Lyon France ATP World Tour,HARD,2,Robin Soderling,Nicolas Massu,Robin Soderling,7-5; 6-3,R16,112,10,3,42,65,36,42,11,23,3,3,11,47,65,7,3,42,81,29,42,18,39,7,9,10,47,81
2006-10-23 00:00:00.000,Lyon France ATP World Tour,HARD,2,Sebastien Grosjean,Cyril Saulnier,Sebastien Grosjean,7-6(5); 6-2,R16,97,15,1,39,68,33,39,15,29,5,6,10,48,68,3,0,51,77,36,51,9,26,5,8,10,45,77
2006-10-23 00:00:00.000,Lyon France ATP World Tour,HARD,2,Marc Gicquel,Dominik Hrbaty,Marc Gicquel,6-3; 6-3,R16,76,10,1,32,47,26,32,11,15,0,0,9,37,47,2,4,36,63,24,36,11,27,4,7,9,35,63
2006-10-23 00:00:00.000,Lyon France ATP World Tour,HARD,2,Xavier Malisse,Julien Benneteau,Xavier Malisse,6-2; 7-6(5),R16,100,7,2,55,82,38,55,17,27,8,9,10,55,82,4,3,40,62,26,40,11,22,3,6,10,37,62
2006-10-23 00:00:00.000,Lyon France ATP World Tour,HARD,2,Robby Ginepri,Simon Greul,Robby Ginepri,6-1; 6-2,R16,56,6,0,34,43,25,34,7,9,0,0,8,32,43,1,1,28,60,16,28,13,32,4,8,7,29,60
2006-10-23 00:00:00.000,Lyon France ATP World Tour,HARD,2,Arnaud Clement,Nicolas Almagro,Arnaud Clement,6-3; 6-2,Q,58,10,0,34,49,31,34,7,15,2,2,9,38,49,6,2,29,48,23,29,5,19,1,4,8,28,48
2006-10-23 00:00:00.000,Lyon France ATP World Tour,HARD,2,Richard Gasquet,Robin Soderling,Richard Gasquet,4-6; 6-3; 6-3,Q,111,12,1,63,90,45,63,11,27,5,8,14,56,90,11,4,66,93,44,66,10,27,9,14,14,54,93
2006-10-23 00:00:00.000,Lyon France ATP World Tour,HARD,2,Marc Gicquel,Sebastien Grosjean,Marc Gicquel,7-5; 1-6; 7-6(5),Q,128,10,2,52,90,41,52,17,38,3,6,15,58,90,12,4,57,100,45,57,21,43,5,7,16,66,100
2006-10-23 00:00:00.000,Lyon France ATP World Tour,HARD,2,Xavier Malisse,Robby Ginepri,Xavier Malisse,6-4; 6-3,Q,80,6,2,36,54,28,36,8,18,2,3,9,36,54,4,0,47,65,28,47,5,18,5,9,10,33,65
2006-10-23 00:00:00.000,Lyon France ATP World Tour,HARD,2,Richard Gasquet,Arnaud Clement,Richard Gasquet,6-7(6); 6-4; 6-1,S,139,12,1,73,114,54,73,22,41,5,5,15,76,114,7,2,50,80,40,50,14,30,2,5,14,54,80
2006-10-23 00:00:00.000,Lyon France ATP World Tour,HARD,2,Marc Gicquel,Xavier Malisse,Marc Gicquel,6-4; 1-6; 7-6(5),S,146,9,0,69,104,40,69,22,35,11,15,14,62,104,10,3,69,115,46,69,26,46,8,11,15,72,115
2006-10-23 00:00:00.000,Lyon France ATP World Tour,HARD,2,Richard Gasquet,Marc Gicquel,Richard Gasquet,6-3; 6-1,F,72,6,0,30,39,27,30,6,9,1,1,8,33,39,2,0,33,63,19,33,14,30,6,10,8,33,63
2006-10-23 00:00:00.000,St. Petersburg Russia ATP World Tour,HARD,2,Nikolay Davydenko,Fabrice Santoro,Nikolay Davydenko,6-3; 6-1,R32,61,3,2,32,48,24,32,10,16,0,0,8,34,48,3,3,30,50,14,30,10,20,4,8,8,24,50
2006-10-23 00:00:00.000,St. Petersburg Russia ATP World Tour,HARD,2,Wesley Moodie,Teymuraz Gabashvili,Wesley Moodie,2-6; 7-5; 6-3,R32,101,10,3,56,76,40,56,12,20,2,5,15,52,76,7,5,44,84,34,44,19,40,5,8,14,53,84
2006-10-23 00:00:00.000,St. Petersburg Russia ATP World Tour,HARD,2,Thomas Johansson,Frank Dancevic,Thomas Johansson,6-0; 6-7(3); 6-3,R32,96,12,2,40,70,32,40,19,30,2,4,13,51,70,5,3,60,99,42,60,12,39,10,17,14,54,99
2006-10-23 00:00:00.000,St. Petersburg Russia ATP World Tour,HARD,2,Mikhail Youzhny,Rainer Schuettler,Mikhail Youzhny,7-6(6); 6-4,R32,99,8,0,47,77,33,47,19,30,5,6,11,52,77,2,1,41,68,27,41,17,27,0,2,11,44,68
2006-10-23 00:00:00.000,St. Petersburg Russia ATP World Tour,HARD,2,Tommy Haas,Nenad Zimonjic,Tommy Haas,6-2; 6-7(6); 6-2,R32,129,7,3,61,93,48,61,16,32,2,2,14,64,93,11,4,52,108,35,52,27,56,6,10,14,62,108
2006-10-23 00:00:00.000,St. Petersburg Russia ATP World Tour,HARD,2,Igor Kunitsyn,Bjorn Phau,Igor Kunitsyn,7-6(6); 6-3,R32,95,2,2,41,88,26,41,31,47,7,8,11,57,88,5,2,30,60,22,30,15,30,1,3,10,37,60
2006-10-23 00:00:00.000,St. Petersburg Russia ATP World Tour,HARD,2,Potito Starace,Daniele Bracciali,Potito Starace,6-3; 6-3,R32,68,3,0,39,58,29,39,11,19,5,5,9,40,58,6,4,25,51,20,25,11,26,2,5,9,31,51
2006-10-23 00:00:00.000,St. Petersburg Russia ATP World Tour,HARD,2,Jarkko Nieminen,Janko Tipsarevic,Jarkko Nieminen,7-5; 6-2,R32,87,8,0,36,61,26,36,16,25,4,5,10,42,61,4,0,47,78,30,47,13,31,4,8,10,43,78
2006-10-23 00:00:00.000,St. Petersburg Russia ATP World Tour,HARD,2,Max Mirnyi,Dmitry Tursunov,Max Mirnyi,4-6; 6-3; 6-4,R32,118,16,4,56,94,45,56,16,38,4,6,15,61,94,7,11,46,88,35,46,20,42,4,7,14,55,88
2006-10-23 00:00:00.000,St. Petersburg Russia ATP World Tour,HARD,2,Andrei Pavel,Marin Cilic,Andrei Pavel,6-4; 7-5,R32,96,3,1,44,61,33,44,11,17,3,4,11,44,61,4,0,44,89,31,44,22,45,16,19,11,53,89
2006-10-23 00:00:00.000,St. Petersburg Russia ATP World Tour,HARD,2,Raemon Sluiter,Lukasz Kubot,Raemon Sluiter,6-4; 3-6; 6-3,R32,103,18,2,48,83,38,48,18,35,3,6,14,56,83,1,3,48,77,29,48,17,29,2,6,14,46,77
2006-10-23 00:00:00.000,St. Petersburg Russia ATP World Tour,HARD,2,Mario Ancic,Paul Goldstein,Mario Ancic,7-5; 6-1,R32,72,10,1,27,49,23,27,16,22,1,2,10,39,49,0,0,28,49,18,28,11,21,6,10,9,29,49
2006-10-23 00:00:00.000,St. Petersburg Russia ATP World Tour,HARD,2,Lukas Dlouhy,Jurgen Melzer,Lukas Dlouhy,3-6; 6-4; 6-3,R32,93,6,3,50,94,36,50,23,44,5,8,14,59,94,6,3,55,87,37,55,14,32,3,7,14,51,87
2006-10-23 00:00:00.000,St. Petersburg Russia ATP World Tour,HARD,2,Ernests Gulbis,Robin Vik,Ernests Gulbis,6-4; 3-6; 7-6(4),R32,131,11,3,63,102,49,63,16,39,9,12,15,65,102,2,3,71,109,51,71,19,38,5,8,16,70,109
2006-10-23 00:00:00.000,St. Petersburg Russia ATP World Tour,HARD,2,Jan Hernych,Evgeny Korolev,Jan Hernych,6-7(5); 6-4; 7-6(7),R32,140,5,1,72,116,55,72,21,44,5,7,17,76,116,5,1,75,111,58,75,16,36,0,3,17,74,111
2006-10-23 00:00:00.000,St. Petersburg Russia ATP World Tour,HARD,2,Wayne Arthurs,Tommy Robredo,Wayne Arthurs,6-3; 2-6; 6-4,R32,89,11,1,45,71,36,45,12,26,5,9,14,48,71,3,3,51,71,32,51,12,20,3,7,13,44,71
2006-10-23 00:00:00.000,St. Petersburg Russia ATP World Tour,HARD,2,Wesley Moodie,Nikolay Davydenko,Wesley Moodie,2-6; 3-3 RET,R16,52,4,0,24,34,17,24,5,10,0,2,7,22,34,1,0,20,34,16,20,12,14,0,0,7,28,34
2006-10-23 00:00:00.000,St. Petersburg Russia ATP World Tour,HARD,2,Thomas Johansson,Mikhail Youzhny,Thomas Johansson,W/O,R16,0,0,0,0,0,0,0,0,0,0,0,0,0,0,0,0,0,0,0,0,0,0,0,0,0,0,0
2006-10-23 00:00:00.000,St. Petersburg Russia ATP World Tour,HARD,2,Igor Kunitsyn,Tommy Haas,Igor Kunitsyn,7-6(4); 4-6; 6-2,R16,122,2,0,51,88,34,51,21,37,2,6,15,55,88,13,9,58,97,37,58,19,39,0,5,15,56,97
2006-10-23 00:00:00.000,St. Petersburg Russia ATP World Tour,HARD,2,Potito Starace,Jarkko Nieminen,Potito Starace,7-5; 3-2 RET,R16,57,8,0,32,52,26,32,11,20,2,3,9,37,52,5,1,25,45,20,25,9,20,1,3,8,29,45
2006-10-23 00:00:00.000,St. Petersburg Russia ATP World Tour,HARD,2,Max Mirnyi,Andrei Pavel,Max Mirnyi,6-3; 7-5,R16,86,16,2,38,58,30,38,15,20,0,0,11,45,58,2,2,52,73,33,52,11,21,3,5,10,44,73
2006-10-23 00:00:00.000,St. Petersburg Russia ATP World Tour,HARD,2,Mario Ancic,Raemon Sluiter,Mario Ancic,6-3; 6-4,R16,65,9,2,28,48,24,28,13,20,1,2,10,37,48,3,3,27,47,19,27,10,20,2,5,9,29,47
2006-10-23 00:00:00.000,St. Petersburg Russia ATP World Tour,HARD,2,Ernests Gulbis,Lukas Dlouhy,Ernests Gulbis,5-7; 6-3; 6-3,R16,103,8,4,52,91,43,52,19,39,3,4,15,62,91,3,5,48,78,34,48,16,30,0,3,15,50,78
2006-10-23 00:00:00.000,St. Petersburg Russia ATP World Tour,HARD,2,Jan Hernych,Wayne Arthurs,Jan Hernych,6-4; 6-4,R16,82,2,1,33,56,25,33,19,23,1,1,10,44,56,10,6,40,69,26,40,16,29,4,6,10,42,69
2006-10-23 00:00:00.000,St. Petersburg Russia ATP World Tour,HARD,2,Thomas Johansson,Wesley Moodie,Thomas Johansson,6-3; 3-6; 6-3,Q,102,7,2,46,74,37,46,19,28,1,2,14,56,74,7,2,55,81,42,55,13,26,2,4,13,55,81
2006-10-23 00:00:00.000,St. Petersburg Russia ATP World Tour,HARD,2,Igor Kunitsyn,Potito Starace,Igor Kunitsyn,6-3; 6-2,Q,68,0,1,28,50,24,28,12,22,4,5,9,36,50,5,3,31,52,18,31,8,21,8,12,8,26,52
2006-10-23 00:00:00.000,St. Petersburg Russia ATP World Tour,HARD,2,Mario Ancic,Max Mirnyi,Mario Ancic,6-4; 7-5,Q,93,3,1,43,68,33,43,17,25,2,2,11,50,68,2,1,31,55,23,31,15,24,1,3,11,38,55
2006-10-23 00:00:00.000,St. Petersburg Russia ATP World Tour,HARD,2,Ernests Gulbis,Jan Hernych,Ernests Gulbis,7-6(6); 6-7(4); 6-2,Q,139,9,0,69,106,53,69,21,37,7,8,16,74,106,2,2,83,116,57,83,18,33,6,9,16,75,116
2006-10-23 00:00:00.000,St. Petersburg Russia ATP World Tour,HARD,2,Thomas Johansson,Igor Kunitsyn,Thomas Johansson,6-3; 7-6(3),S,101,8,3,43,83,37,43,16,40,5,7,11,53,83,3,1,38,70,26,38,14,32,0,3,10,40,70
2006-10-23 00:00:00.000,St. Petersburg Russia ATP World Tour,HARD,2,Mario Ancic,Ernests Gulbis,Mario Ancic,6-2; 6-3,S,93,5,3,41,65,31,41,12,24,6,6,9,43,65,4,1,32,45,20,32,4,13,4,7,8,24,45
2006-10-23 00:00:00.000,St. Petersburg Russia ATP World Tour,HARD,2,Mario Ancic,Thomas Johansson,Mario Ancic,7-5; 7-6(2),F,106,5,0,40,61,34,40,14,21,0,1,12,48,61,8,1,43,80,26,43,23,37,0,2,12,49,80
2006-10-30 00:00:00.000,ATP Masters Series Paris France ATP World Tour,HARD,2,Teymuraz Gabashvili,N/A Bye,Teymuraz Gabashvili,,R64,0,0,0,0,0,0,0,0,0,0,0,0,0,0,0,0,0,0,0,0,0,0,0,0,0,0,0
2006-10-30 00:00:00.000,ATP Masters Series Paris France ATP World Tour,HARD,2,Thomas Johansson,Vincent Spadea,Thomas Johansson,7-6(4); 7-6(1),R64,95,11,1,48,86,38,48,22,38,5,6,12,60,86,6,4,39,74,31,39,19,35,0,1,12,50,74
2006-10-30 00:00:00.000,ATP Masters Series Paris France ATP World Tour,HARD,2,Daniele Bracciali,Gilles Simon,Daniele Bracciali,6-3; 6-4,R64,77,3,0,29,50,24,29,10,21,2,3,9,34,50,2,2,30,64,19,30,17,34,5,9,10,36,64
2006-10-30 00:00:00.000,ATP Masters Series Paris France ATP World Tour,HARD,2,Jarkko Nieminen,N/A Bye,Jarkko Nieminen,,R64,0,0,0,0,0,0,0,0,0,0,0,0,0,0,0,0,0,0,0,0,0,0,0,0,0,0,0
2006-10-30 00:00:00.000,ATP Masters Series Paris France ATP World Tour,HARD,2,Novak Djokovic,N/A Bye,Novak Djokovic,,R64,0,0,0,0,0,0,0,0,0,0,0,0,0,0,0,0,0,0,0,0,0,0,0,0,0,0,0
2006-10-30 00:00:00.000,ATP Masters Series Paris France ATP World Tour,HARD,2,Paul-Henri Mathieu,Andreas Seppi,Paul-Henri Mathieu,6-2; 6-4,R64,76,8,3,24,50,20,24,14,26,0,2,9,34,50,1,1,33,54,16,33,11,21,5,10,9,27,54
2006-10-30 00:00:00.000,ATP Masters Series Paris France ATP World Tour,HARD,2,Sebastien Grosjean,Xavier Malisse,Sebastien Grosjean,6-1; 7-6(7),R64,85,6,0,31,64,24,31,21,33,1,3,10,45,64,2,0,34,62,20,34,17,28,5,9,9,37,62
2006-10-30 00:00:00.000,ATP Masters Series Paris France ATP World Tour,HARD,2,Tommy Robredo,N/A Bye,Tommy Robredo,,R64,0,0,0,0,0,0,0,0,0,0,0,0,0,0,0,0,0,0,0,0,0,0,0,0,0,0,0
2006-10-30 00:00:00.000,ATP Masters Series Paris France ATP World Tour,HARD,2,Nikolay Davydenko,N/A Bye,Nikolay Davydenko,,R64,0,0,0,0,0,0,0,0,0,0,0,0,0,0,0,0,0,0,0,0,0,0,0,0,0,0,0
2006-10-30 00:00:00.000,ATP Masters Series Paris France ATP World Tour,HARD,2,Christophe Rochus,Jose Acasuso,Christophe Rochus,4-6; 7-6(4); 6-4,R64,136,4,4,60,97,46,60,20,37,2,4,16,66,97,18,2,71,117,51,71,22,46,11,13,16,73,117
2006-10-30 00:00:00.000,ATP Masters Series Paris France ATP World Tour,HARD,2,Nicolas Almagro,Jonas Bjorkman,Nicolas Almagro,6-7(4); 7-6(7); 7-6(2),R64,186,14,4,77,137,63,77,28,60,4,5,18,91,137,12,1,75,131,56,75,29,56,1,2,18,85,131
2006-10-30 00:00:00.000,ATP Masters Series Paris France ATP World Tour,HARD,2,Dmitry Tursunov,N/A Bye,Dmitry Tursunov,,R64,0,0,0,0,0,0,0,0,0,0,0,0,0,0,0,0,0,0,0,0,0,0,0,0,0,0,0
2006-10-30 00:00:00.000,ATP Masters Series Paris France ATP World Tour,HARD,2,Mario Ancic,N/A Bye,Mario Ancic,,R64,0,0,0,0,0,0,0,0,0,0,0,0,0,0,0,0,0,0,0,0,0,0,0,0,0,0,0
2006-10-30 00:00:00.000,ATP Masters Series Paris France ATP World Tour,HARD,2,Kristof Vliegen,Florent Serra,Kristof Vliegen,3-6; 6-3; 7-6(4),R64,118,15,4,64,90,47,64,15,26,2,4,15,62,90,3,3,58,98,37,58,24,40,2,4,15,61,98
2006-10-30 00:00:00.000,ATP Masters Series Paris France ATP World Tour,HARD,2,Julien Benneteau,Fabrice Santoro,Julien Benneteau,5-7; 6-3; 7-6(5),R64,164,8,5,81,124,54,81,22,43,9,13,16,76,124,7,5,60,114,42,60,26,54,9,14,17,68,114
2006-10-30 00:00:00.000,ATP Masters Series Paris France ATP World Tour,HARD,2,Fernando Gonzalez,N/A Bye,Fernando Gonzalez,,R64,0,0,0,0,0,0,0,0,0,0,0,0,0,0,0,0,0,0,0,0,0,0,0,0,0,0,0
2006-10-30 00:00:00.000,ATP Masters Series Paris France ATP World Tour,HARD,2,Tomas Berdych,N/A Bye,Tomas Berdych,,R64,0,0,0,0,0,0,0,0,0,0,0,0,0,0,0,0,0,0,0,0,0,0,0,0,0,0,0
2006-10-30 00:00:00.000,ATP Masters Series Paris France ATP World Tour,HARD,2,Olivier Rochus,Janko Tipsarevic,Olivier Rochus,6-4; 7-5,R64,92,5,4,50,74,38,50,10,24,2,3,11,48,74,12,2,38,68,31,38,10,30,2,5,11,41,68
2006-10-30 00:00:00.000,ATP Masters Series Paris France ATP World Tour,HARD,2,Robby Ginepri,Max Mirnyi,Robby Ginepri,6-4; 5-7; 6-2,R64,102,5,2,57,93,38,57,26,36,4,5,15,64,93,14,0,52,75,42,52,10,23,3,6,15,52,75
2006-10-30 00:00:00.000,ATP Masters Series Paris France ATP World Tour,HARD,2,David Ferrer,N/A Bye,David Ferrer,,R64,0,0,0,0,0,0,0,0,0,0,0,0,0,0,0,0,0,0,0,0,0,0,0,0,0,0,0
2006-10-30 00:00:00.000,ATP Masters Series Paris France ATP World Tour,HARD,2,Andy Murray,N/A Bye,Andy Murray,,R64,0,0,0,0,0,0,0,0,0,0,0,0,0,0,0,0,0,0,0,0,0,0,0,0,0,0,0
2006-10-30 00:00:00.000,ATP Masters Series Paris France ATP World Tour,HARD,2,Juan Ignacio Chela,Paradorn Srichaphan,Juan Ignacio Chela,6-3; 3-0 RET,R64,42,1,2,22,34,17,22,8,12,2,2,6,25,34,2,4,20,37,14,20,6,17,3,6,6,20,37
2006-10-30 00:00:00.000,ATP Masters Series Paris France ATP World Tour,HARD,2,Igor Andreev,Gael Monfils,Igor Andreev,7-5; 6-4,R64,80,0,2,50,69,38,50,9,19,5,6,11,47,69,6,6,44,77,31,44,15,33,5,8,11,46,77
2006-10-30 00:00:00.000,ATP Masters Series Paris France ATP World Tour,HARD,2,Dominik Hrbaty,N/A Bye,Dominik Hrbaty,,R64,0,0,0,0,0,0,0,0,0,0,0,0,0,0,0,0,0,0,0,0,0,0,0,0,0,0,0
2006-10-30 00:00:00.000,ATP Masters Series Paris France ATP World Tour,HARD,2,James Blake,N/A Bye,James Blake,,R64,0,0,0,0,0,0,0,0,0,0,0,0,0,0,0,0,0,0,0,0,0,0,0,0,0,0,0
2006-10-30 00:00:00.000,ATP Masters Series Paris France ATP World Tour,HARD,2,Arnaud Clement,Nicolas Massu,Arnaud Clement,6-1; 6-4,R64,66,7,0,19,45,17,19,20,26,0,0,9,37,45,5,1,31,50,22,31,7,19,4,7,8,29,50
2006-10-30 00:00:00.000,ATP Masters Series Paris France ATP World Tour,HARD,2,Michael Llodra,Fernando Verdasco,Michael Llodra,6-4; 7-6(4),R64,98,10,1,46,68,38,46,8,22,0,2,11,46,68,5,5,57,74,40,57,5,17,5,8,11,45,74
2006-10-30 00:00:00.000,ATP Masters Series Paris France ATP World Tour,HARD,2,Tommy Haas,N/A Bye,Tommy Haas,,R64,0,0,0,0,0,0,0,0,0,0,0,0,0,0,0,0,0,0,0,0,0,0,0,0,0,0,0
2006-10-30 00:00:00.000,ATP Masters Series Paris France ATP World Tour,HARD,2,Richard Gasquet,N/A Bye,Richard Gasquet,,R64,0,0,0,0,0,0,0,0,0,0,0,0,0,0,0,0,0,0,0,0,0,0,0,0,0,0,0
2006-10-30 00:00:00.000,ATP Masters Series Paris France ATP World Tour,HARD,2,Stanislas Wawrinka,Marc Gicquel,Stanislas Wawrinka,7-6(6); 6-7(4); 7-6(2),R64,161,21,4,62,115,56,62,30,53,1,1,18,86,115,8,1,71,137,51,71,41,66,9,9,18,92,137
2006-10-30 00:00:00.000,ATP Masters Series Paris France ATP World Tour,HARD,2,Marat Safin,Nicolas Mahut,Marat Safin,6-1; 7-6(5),R64,75,17,1,48,63,38,48,9,15,3,3,10,47,63,5,1,34,53,26,34,8,19,2,4,9,34,53
2006-10-30 00:00:00.000,ATP Masters Series Paris France ATP World Tour,HARD,2,Robin Soderling,N/A Bye,Robin Soderling,,R64,0,0,0,0,0,0,0,0,0,0,0,0,0,0,0,0,0,0,0,0,0,0,0,0,0,0,0
2006-10-30 00:00:00.000,ATP Masters Series Paris France ATP World Tour,HARD,2,Teymuraz Gabashvili,Thomas Johansson,Teymuraz Gabashvili,7-6(3); 4-6; 6-3,R32,126,10,3,52,97,40,52,27,45,4,6,16,67,97,21,3,51,106,39,51,30,55,10,12,15,69,106
2006-10-30 00:00:00.000,ATP Masters Series Paris France ATP World Tour,HARD,2,Jarkko Nieminen,Daniele Bracciali,Jarkko Nieminen,6-3; 6-4,R32,63,3,0,25,50,22,25,15,25,1,2,10,37,50,2,3,33,58,21,33,11,25,2,5,9,32,58
2006-10-30 00:00:00.000,ATP Masters Series Paris France ATP World Tour,HARD,2,Paul-Henri Mathieu,Novak Djokovic,Paul-Henri Mathieu,7-6(11); 7-6(4),R32,161,13,3,55,110,43,55,26,55,9,12,12,69,110,6,0,49,87,36,49,18,38,4,7,12,54,87
2006-10-30 00:00:00.000,ATP Masters Series Paris France ATP World Tour,HARD,2,Tommy Robredo,Sebastien Grosjean,Tommy Robredo,3-6; 7-5; 6-4,R32,135,1,2,71,98,42,71,12,27,4,10,15,54,98,4,3,58,90,40,58,9,32,4,11,16,49,90
2006-10-30 00:00:00.000,ATP Masters Series Paris France ATP World Tour,HARD,2,Nikolay Davydenko,Christophe Rochus,Nikolay Davydenko,6-0; 6-0,R32,35,9,0,21,29,20,21,4,8,0,0,6,24,29,0,0,21,34,5,21,3,13,2,8,6,8,34
2006-10-30 00:00:00.000,ATP Masters Series Paris France ATP World Tour,HARD,2,Dmitry Tursunov,Nicolas Almagro,Dmitry Tursunov,6-3; 5-4 RET,R32,62,16,1,30,56,25,30,15,26,3,3,9,40,56,7,4,25,49,18,25,14,24,2,4,9,32,49
2006-10-30 00:00:00.000,ATP Masters Series Paris France ATP World Tour,HARD,2,Mario Ancic,Kristof Vliegen,Mario Ancic,3-6; 7-6(4); 6-3,R32,144,15,1,71,108,53,71,18,37,5,7,16,71,108,9,1,60,94,47,60,19,34,4,5,14,66,94
2006-10-30 00:00:00.000,ATP Masters Series Paris France ATP World Tour,HARD,2,Julien Benneteau,Fernando Gonzalez,Julien Benneteau,3-6; 6-4; 7-5,R32,128,5,3,58,87,41,58,13,29,6,9,15,54,87,9,4,61,105,43,61,20,44,5,9,16,63,105
2006-10-30 00:00:00.000,ATP Masters Series Paris France ATP World Tour,HARD,2,Tomas Berdych,Olivier Rochus,Tomas Berdych,6-7(4); 6-4; 6-2,R32,126,21,2,60,88,46,60,16,28,3,4,15,62,88,6,2,55,101,41,55,22,46,9,13,15,63,101
2006-10-30 00:00:00.000,ATP Masters Series Paris France ATP World Tour,HARD,2,Robby Ginepri,David Ferrer,Robby Ginepri,6-3; 6-4,R32,67,2,0,38,59,26,38,11,21,0,2,9,37,59,3,1,30,54,17,30,10,24,2,7,10,27,54
2006-10-30 00:00:00.000,ATP Masters Series Paris France ATP World Tour,HARD,2,Andy Murray,Juan Ignacio Chela,Andy Murray,7-5; 6-0,R32,78,6,3,30,49,23,30,13,19,1,2,9,36,49,0,1,42,70,20,42,14,28,9,14,9,34,70
2006-10-30 00:00:00.000,ATP Masters Series Paris France ATP World Tour,HARD,2,Dominik Hrbaty,Igor Andreev,Dominik Hrbaty,6-4; 6-3,R32,64,3,4,33,51,29,33,9,18,1,1,9,38,51,5,4,41,63,29,41,7,22,2,5,10,36,63
2006-10-30 00:00:00.000,ATP Masters Series Paris France ATP World Tour,HARD,2,James Blake,Arnaud Clement,James Blake,6-4; 3-6; 6-4,R32,118,16,4,48,89,38,48,20,41,3,6,15,58,89,2,2,47,84,35,47,19,37,3,6,14,54,84
2006-10-30 00:00:00.000,ATP Masters Series Paris France ATP World Tour,HARD,2,Tommy Haas,Michael Llodra,Tommy Haas,7-6(7); 7-6(2),R32,112,8,7,53,97,41,53,21,44,5,7,12,62,97,10,5,50,83,34,50,18,33,1,3,12,52,83
2006-10-30 00:00:00.000,ATP Masters Series Paris France ATP World Tour,HARD,2,Richard Gasquet,Stanislas Wawrinka,Richard Gasquet,7-5; 6-1,R32,66,3,1,41,51,33,41,7,10,0,0,10,40,51,4,0,37,57,24,37,9,20,4,7,9,33,57
2006-10-30 00:00:00.000,ATP Masters Series Paris France ATP World Tour,HARD,2,Marat Safin,Robin Soderling,Marat Safin,3-6; 6-3; 6-4,R32,110,8,2,59,82,42,59,12,23,4,6,14,54,82,4,2,67,99,47,67,14,32,7,10,14,61,99
2006-10-30 00:00:00.000,ATP Masters Series Paris France ATP World Tour,HARD,2,Jarkko Nieminen,Teymuraz Gabashvili,Jarkko Nieminen,4-6; 7-6(6); 6-2,R16,111,12,1,53,92,43,53,22,39,3,4,15,65,92,8,6,53,97,40,53,23,44,2,4,15,63,97
2006-10-30 00:00:00.000,ATP Masters Series Paris France ATP World Tour,HARD,2,Tommy Robredo,Paul-Henri Mathieu,Tommy Robredo,6-4; 7-6(1),R16,98,5,0,43,55,35,43,10,12,0,1,11,45,55,0,2,46,69,29,46,15,23,2,4,11,44,69
2006-10-30 00:00:00.000,ATP Masters Series Paris France ATP World Tour,HARD,2,Nikolay Davydenko,Dmitry Tursunov,Nikolay Davydenko,6-2; 6-2,R16,72,4,1,32,49,25,32,11,17,3,3,8,36,49,1,1,36,60,22,36,8,24,8,12,8,30,60
2006-10-30 00:00:00.000,ATP Masters Series Paris France ATP World Tour,HARD,2,Mario Ancic,Julien Benneteau,Mario Ancic,6-3; 6-1,R16,68,5,1,28,43,22,28,12,15,1,1,8,34,43,1,0,42,51,22,42,4,9,5,9,8,26,51
2006-10-30 00:00:00.000,ATP Masters Series Paris France ATP World Tour,HARD,2,Tomas Berdych,Robby Ginepri,Tomas Berdych,6-3; 6-3,R16,66,5,0,39,59,29,39,13,20,4,4,9,42,59,7,2,33,56,24,33,7,23,2,5,9,31,56
2006-10-30 00:00:00.000,ATP Masters Series Paris France ATP World Tour,HARD,2,Dominik Hrbaty,Andy Murray,Dominik Hrbaty,7-6(6); 6-0,R16,88,3,4,28,56,19,28,11,28,1,5,9,30,56,9,6,29,69,19,29,11,40,11,18,9,30,69
2006-10-30 00:00:00.000,ATP Masters Series Paris France ATP World Tour,HARD,2,Tommy Haas,James Blake,Tommy Haas,6-4; 6-2,R16,60,7,0,30,49,28,30,9,19,2,2,9,37,49,3,3,36,55,24,36,10,19,4,7,9,34,55
2006-10-30 00:00:00.000,ATP Masters Series Paris France ATP World Tour,HARD,2,Marat Safin,Richard Gasquet,Marat Safin,W/O,R16,0,0,0,0,0,0,0,0,0,0,0,0,0,0,0,0,0,0,0,0,0,0,0,0,0,0,0
2006-10-30 00:00:00.000,ATP Masters Series Paris France ATP World Tour,HARD,2,Tommy Robredo,Jarkko Nieminen,Tommy Robredo,6-7(4); 7-6(4); 6-4,Q,165,6,2,69,129,46,69,32,60,5,8,17,78,129,3,1,67,114,50,67,23,47,5,9,17,73,114
2006-10-30 00:00:00.000,ATP Masters Series Paris France ATP World Tour,HARD,2,Nikolay Davydenko,Mario Ancic,Nikolay Davydenko,6-3; 6-3,Q,84,2,2,30,53,26,30,13,23,0,0,9,39,53,2,2,37,64,28,37,9,27,3,6,9,37,64
2006-10-30 00:00:00.000,ATP Masters Series Paris France ATP World Tour,HARD,2,Dominik Hrbaty,Tomas Berdych,Dominik Hrbaty,6-4; 1-6; 6-2,Q,94,3,1,36,69,31,36,13,33,4,7,12,44,69,5,3,54,79,32,54,14,25,3,7,13,46,79
2006-10-30 00:00:00.000,ATP Masters Series Paris France ATP World Tour,HARD,2,Tommy Haas,Marat Safin,Tommy Haas,7-6(1); 3-6; 6-3,Q,112,9,4,49,87,43,49,21,38,2,3,15,64,87,11,0,60,88,42,60,19,28,1,2,15,61,88
2006-10-30 00:00:00.000,ATP Masters Series Paris France ATP World Tour,HARD,2,Nikolay Davydenko,Tommy Robredo,Nikolay Davydenko,6-3; 5-7; 6-2,S,116,4,2,45,71,39,45,13,26,1,3,14,52,71,7,2,61,91,42,61,11,30,3,8,15,53,91
2006-10-30 00:00:00.000,ATP Masters Series Paris France ATP World Tour,HARD,2,Dominik Hrbaty,Tommy Haas,Dominik Hrbaty,6-4; 1-0 RET,S,49,5,1,14,32,11,14,9,18,2,3,5,20,32,3,1,25,39,17,25,4,14,4,7,6,21,39
2006-10-30 00:00:00.000,ATP Masters Series Paris France ATP World Tour,HARD,2,Nikolay Davydenko,Dominik Hrbaty,Nikolay Davydenko,6-1; 6-2; 6-2,F,99,7,4,54,81,44,54,14,27,7,7,12,58,81,5,3,44,72,21,44,13,28,7,13,11,34,72
2007-12-31 00:00:00.000,Adelaide Australia ATP World Tour,HARD,2,Lleyton Hewitt,Dudi Sela,Lleyton Hewitt,6-2; 6-2,R32,66,7,2,29,46,26,29,8,17,3,3,8,34,46,5,2,37,59,22,37,8,22,7,11,8,30,59
2007-12-31 00:00:00.000,Adelaide Australia ATP World Tour,HARD,2,Jose Acasuso,Alejandro Falla,Jose Acasuso,6-3; 7-6(3),R32,101,8,4,40,76,31,40,14,36,8,12,11,45,76,2,1,40,68,21,40,14,28,5,10,10,35,68
2007-12-31 00:00:00.000,Adelaide Australia ATP World Tour,HARD,2,Ernests Gulbis,Andrey Golubev,Ernests Gulbis,6-7(9); 6-4; 6-2,R32,138,7,6,80,133,59,80,22,53,14,16,15,81,133,6,4,63,109,43,63,20,46,3,8,15,63,109
2007-12-31 00:00:00.000,Adelaide Australia ATP World Tour,HARD,2,Jo-Wilfried Tsonga,Victor Hanescu,Jo-Wilfried Tsonga,6-3; 4-6; 7-5,R32,120,11,6,46,84,38,46,21,38,3,6,16,59,84,1,0,56,93,39,56,19,37,3,7,15,58,93
2007-12-31 00:00:00.000,Adelaide Australia ATP World Tour,HARD,2,Jarkko Nieminen,Ivo Klec,Jarkko Nieminen,6-2; 6-4,R32,66,1,1,34,48,24,34,10,14,0,1,9,34,48,3,2,40,65,25,40,9,25,1,5,9,34,65
2007-12-31 00:00:00.000,Adelaide Australia ATP World Tour,HARD,2,Frank Dancevic,Simone Bolelli,Frank Dancevic,6-2; 7-6(3),R32,77,4,0,39,73,30,39,22,34,5,5,10,52,73,8,2,43,65,29,43,12,22,3,5,10,41,65
2007-12-31 00:00:00.000,Adelaide Australia ATP World Tour,HARD,2,Mischa Zverev,Florian Mayer,Mischa Zverev,6-3; 6-3,R32,56,2,0,29,50,26,29,11,21,0,0,9,37,50,0,4,32,51,20,32,9,19,0,3,9,29,51
2007-12-31 00:00:00.000,Adelaide Australia ATP World Tour,HARD,2,Vincent Spadea,Sebastien Grosjean,Vincent Spadea,4-6; 6-1; 6-3,R32,115,6,3,46,84,31,46,18,38,5,9,13,49,84,6,5,47,83,33,47,11,36,3,10,13,44,83
2007-12-31 00:00:00.000,Adelaide Australia ATP World Tour,HARD,2,Michael Russell,Juan Martin Del Potro,Michael Russell,6-3; 6-3,R32,92,6,0,48,64,34,48,8,16,5,6,9,42,64,7,9,33,66,20,33,13,33,9,13,9,33,66
2007-12-31 00:00:00.000,Adelaide Australia ATP World Tour,HARD,2,Benjamin Becker,Robert Smeets,Benjamin Becker,3-6; 6-4; 6-2,R32,107,11,4,38,80,31,38,24,42,1,2,13,55,80,11,6,53,90,35,53,21,37,8,11,14,56,90
2007-12-31 00:00:00.000,Adelaide Australia ATP World Tour,HARD,2,Evgeny Korolev,Alun Jones,Evgeny Korolev,6-2; 7-6(7),R32,82,7,0,36,65,31,36,16,29,3,3,10,47,65,4,2,49,67,31,49,12,18,3,5,10,43,67
2007-12-31 00:00:00.000,Adelaide Australia ATP World Tour,HARD,2,Michael Llodra,Gilles Simon,Michael Llodra,7-6(3); 6-3,R32,89,1,1,41,66,33,41,18,25,3,4,11,51,66,7,4,44,72,32,44,13,28,4,6,10,45,72
2007-12-31 00:00:00.000,Adelaide Australia ATP World Tour,HARD,2,Joseph Sirianni,Radek Stepanek,Joseph Sirianni,7-6(3); 4-3 RET,R32,99,8,2,35,67,27,35,17,32,3,4,9,44,67,8,3,35,61,25,35,16,26,3,5,10,41,61
2007-12-31 00:00:00.000,Adelaide Australia ATP World Tour,HARD,2,Sam Querrey,Steve Darcis,Sam Querrey,7-5; 6-4,R32,80,11,2,32,61,26,32,14,29,1,3,11,40,61,0,6,55,77,34,55,10,22,7,11,11,44,77
2007-12-31 00:00:00.000,Adelaide Australia ATP World Tour,HARD,2,Chris Guccione,Wayne Odesnik,Chris Guccione,7-5; 7-6(5),R32,86,23,4,40,72,35,40,21,32,2,2,12,56,72,5,1,43,74,31,43,23,31,4,5,12,54,74
2007-12-31 00:00:00.000,Adelaide Australia ATP World Tour,HARD,2,Paul-Henri Mathieu,Julien Benneteau,Paul-Henri Mathieu,7-6(2); 7-5,R32,141,8,3,49,94,36,49,22,45,8,11,12,58,94,7,5,51,84,33,51,14,33,5,9,12,47,84
2007-12-31 00:00:00.000,Adelaide Australia ATP World Tour,HARD,2,Lleyton Hewitt,Jose Acasuso,Lleyton Hewitt,6-2; 6-2,R16,61,8,3,14,43,13,14,21,29,1,1,8,34,43,0,4,21,46,13,21,9,25,4,8,8,22,46
2007-12-31 00:00:00.000,Adelaide Australia ATP World Tour,HARD,2,Jo-Wilfried Tsonga,Ernests Gulbis,Jo-Wilfried Tsonga,6-3; 6-2,R16,62,10,1,33,52,29,33,11,19,3,3,9,40,52,3,3,40,60,24,40,7,20,4,7,8,31,60
2007-12-31 00:00:00.000,Adelaide Australia ATP World Tour,HARD,2,Jarkko Nieminen,Frank Dancevic,Jarkko Nieminen,6-4; 6-1,R16,57,2,0,31,52,24,31,13,21,3,3,8,37,52,5,2,32,52,22,32,6,20,3,7,9,28,52
2007-12-31 00:00:00.000,Adelaide Australia ATP World Tour,HARD,2,Vincent Spadea,Mischa Zverev,Vincent Spadea,6-3; 7-5,R16,80,2,3,46,74,33,46,14,28,4,5,11,47,74,2,1,50,65,33,50,6,15,4,7,10,39,65
2007-12-31 00:00:00.000,Adelaide Australia ATP World Tour,HARD,2,Benjamin Becker,Michael Russell,Benjamin Becker,6-4; 6-4,R16,80,8,1,35,58,29,35,12,23,4,5,10,41,58,3,2,37,61,27,37,12,24,4,7,10,39,61
2007-12-31 00:00:00.000,Adelaide Australia ATP World Tour,HARD,2,Michael Llodra,Evgeny Korolev,Michael Llodra,7-6(3); 6-3,R16,83,14,5,41,64,36,41,14,23,6,6,10,50,64,1,2,42,72,31,42,16,30,1,3,11,47,72
2007-12-31 00:00:00.000,Adelaide Australia ATP World Tour,HARD,2,Joseph Sirianni,Sam Querrey,Joseph Sirianni,6-7(5); 6-2; 6-3,R16,109,4,2,50,92,42,50,24,42,4,5,15,66,92,18,1,59,94,41,59,16,35,4,8,14,57,94
2007-12-31 00:00:00.000,Adelaide Australia ATP World Tour,HARD,2,Paul-Henri Mathieu,Chris Guccione,Paul-Henri Mathieu,4-6; 6-3; 6-4,R16,93,9,4,41,78,35,41,24,37,2,3,15,59,78,24,2,46,69,37,46,13,23,1,3,14,50,69
2007-12-31 00:00:00.000,Adelaide Australia ATP World Tour,HARD,2,Jo-Wilfried Tsonga,Lleyton Hewitt,Jo-Wilfried Tsonga,6-4; 6-2,Q,80,14,3,41,64,29,41,10,23,5,6,9,39,64,0,3,26,52,14,26,14,26,3,7,9,28,52
2007-12-31 00:00:00.000,Adelaide Australia ATP World Tour,HARD,2,Jarkko Nieminen,Vincent Spadea,Jarkko Nieminen,7-6(5); 6-7(7); 7-6(5),Q,166,9,4,99,132,70,99,13,33,5,8,18,83,132,6,3,81,138,57,81,27,57,9,12,18,84,138
2007-12-31 00:00:00.000,Adelaide Australia ATP World Tour,HARD,2,Michael Llodra,Benjamin Becker,Michael Llodra,7-6(5); 6-4,Q,110,17,3,47,82,37,47,21,35,4,4,11,58,82,10,2,46,76,32,46,19,30,2,3,11,51,76
2007-12-31 00:00:00.000,Adelaide Australia ATP World Tour,HARD,2,Joseph Sirianni,Paul-Henri Mathieu,Joseph Sirianni,1-6; 6-1; 7-6(6),Q,133,17,4,49,102,39,49,27,53,7,9,13,66,102,12,6,45,93,32,45,27,48,5,7,13,59,93
2007-12-31 00:00:00.000,Adelaide Australia ATP World Tour,HARD,2,Jarkko Nieminen,Jo-Wilfried Tsonga,Jarkko Nieminen,6-2; 6-4,S,64,3,2,42,55,34,42,5,13,3,3,9,39,55,5,2,30,50,24,30,6,20,4,7,9,30,50
2007-12-31 00:00:00.000,Adelaide Australia ATP World Tour,HARD,2,Michael Llodra,Joseph Sirianni,Michael Llodra,6-3; 7-6(8),S,98,14,0,38,63,34,38,18,25,2,2,11,52,63,7,4,38,76,27,38,20,38,3,4,10,47,76
2007-12-31 00:00:00.000,Adelaide Australia ATP World Tour,HARD,2,Michael Llodra,Jarkko Nieminen,Michael Llodra,6-3; 6-4,F,77,6,1,34,53,30,34,12,19,1,1,10,42,53,3,2,53,79,34,53,12,26,12,14,9,46,79
2007-12-31 00:00:00.000,Chennai India ATP World Tour,HARD,2,Rafael Nadal,Mathieu Montcourt,Rafael Nadal,6-2; 6-4,R32,96,2,0,35,59,21,35,14,24,1,4,9,35,59,0,1,41,60,18,41,7,19,4,10,9,25,60
2007-12-31 00:00:00.000,Chennai India ATP World Tour,HARD,2,Rajeev Ram,Yuri Schukin,Rajeev Ram,7-6(6); 7-6(2),R32,113,9,1,63,89,47,63,14,26,2,3,12,61,89,4,2,52,81,36,52,19,29,0,1,12,55,81
2007-12-31 00:00:00.000,Chennai India ATP World Tour,HARD,2,Guillermo Garcia-Lopez,Alexander Peya,Guillermo Garcia-Lopez,6-4; 6-4,R32,88,2,3,39,63,20,39,16,24,1,4,10,36,63,1,7,27,47,16,27,6,20,0,5,10,22,47
2007-12-31 00:00:00.000,Chennai India ATP World Tour,HARD,2,Werner Eschauer,Bartolome Salva-Vidal,Werner Eschauer,7-6(3); 5-7; 6-4,R32,164,4,4,63,108,50,63,27,45,3,4,17,77,108,2,2,66,108,52,66,22,42,5,6,17,74,108
2007-12-31 00:00:00.000,Chennai India ATP World Tour,HARD,2,Carlos Moya,Teymuraz Gabashvili,Carlos Moya,6-4; 6-1,R32,66,5,1,31,44,21,31,9,13,0,2,8,30,44,4,3,36,64,19,36,9,28,6,12,9,28,64
2007-12-31 00:00:00.000,Chennai India ATP World Tour,HARD,2,Alexander Kudryavtsev,Prakash Amritraj,Alexander Kudryavtsev,6-3; 4-6; 7-6(8),R32,120,6,3,49,99,36,49,29,50,3,6,15,65,99,3,2,65,98,42,65,17,33,5,9,16,59,98
2007-12-31 00:00:00.000,Chennai India ATP World Tour,HARD,2,Florent Serra,Ivan Navarro,Florent Serra,6-4; 7-6(6),R32,105,3,0,45,68,34,45,16,23,4,4,11,50,68,9,0,45,83,35,45,18,38,7,8,11,53,83
2007-12-31 00:00:00.000,Chennai India ATP World Tour,HARD,2,Kristof Vliegen,Marc Gicquel,Kristof Vliegen,7-6(5); 6-4,R32,98,7,0,44,69,31,44,16,25,3,5,11,47,69,7,3,43,69,29,43,14,26,3,6,11,43,69
2007-12-31 00:00:00.000,Chennai India ATP World Tour,HARD,2,Jurgen Melzer,Paul Capdeville,Jurgen Melzer,6-2; 6-4,R32,68,6,0,30,50,25,30,13,20,1,1,9,38,50,3,1,36,60,26,36,8,24,5,8,9,34,60
2007-12-31 00:00:00.000,Chennai India ATP World Tour,HARD,2,Xavier Malisse,Gilles Muller,Xavier Malisse,6-4; 6-3,R32,74,7,2,25,45,24,25,12,20,0,0,9,36,45,6,1,41,63,28,41,11,22,4,7,10,39,63
2007-12-31 00:00:00.000,Chennai India ATP World Tour,HARD,2,Edouard Roger-Vasselin,Vishnu Vardhan,Edouard Roger-Vasselin,6-1; 6-2,R32,52,3,3,30,45,24,30,9,15,0,0,8,33,45,1,3,19,35,12,19,6,16,1,5,7,18,35
2007-12-31 00:00:00.000,Chennai India ATP World Tour,HARD,2,Mikhail Youzhny,Jiri Vanek,Mikhail Youzhny,6-3; 6-2,R32,73,7,2,49,70,35,49,11,21,8,9,9,46,70,4,0,29,46,18,29,5,17,3,7,8,23,46
2007-12-31 00:00:00.000,Chennai India ATP World Tour,HARD,2,Nicolas Mahut,Denis Gremelmayr,Nicolas Mahut,6-3; 6-3,R32,68,2,2,28,52,21,28,14,24,3,4,9,35,52,3,3,35,55,22,35,9,20,6,10,9,31,55
2007-12-31 00:00:00.000,Chennai India ATP World Tour,HARD,2,Marin Cilic,Viktor Troicki,Marin Cilic,3-6; 7-6(6); 6-1,R32,134,7,2,48,93,38,48,24,45,4,7,15,62,93,3,3,51,97,31,51,28,46,4,7,13,59,97
2007-12-31 00:00:00.000,Chennai India ATP World Tour,HARD,2,Lovro Zovko,Thierry Ascione,Lovro Zovko,6-4; 6-0,R32,59,15,4,40,57,29,40,8,17,8,8,8,37,57,3,4,26,41,13,26,8,15,2,6,8,21,41
2007-12-31 00:00:00.000,Chennai India ATP World Tour,HARD,2,Robin Haase,Marcos Baghdatis,Robin Haase,6-3; 6-4,R32,84,4,4,52,83,39,52,16,31,7,7,10,55,83,3,2,35,56,26,35,10,21,1,3,9,36,56
2007-12-31 00:00:00.000,Chennai India ATP World Tour,HARD,2,Rafael Nadal,Rajeev Ram,Rafael Nadal,6-2; 6-1,R16,66,4,0,32,45,24,32,11,13,2,2,8,35,45,0,2,27,43,17,27,4,16,2,6,7,21,43
2007-12-31 00:00:00.000,Chennai India ATP World Tour,HARD,2,Guillermo Garcia-Lopez,Werner Eschauer,Guillermo Garcia-Lopez,4-6; 7-5; 7-6(3),R16,152,9,5,63,97,52,63,19,34,2,4,17,71,97,10,2,64,114,48,64,29,50,5,7,17,77,114
2007-12-31 00:00:00.000,Chennai India ATP World Tour,HARD,2,Carlos Moya,Alexander Kudryavtsev,Carlos Moya,6-3; 6-7(4); 6-2,R16,112,4,2,52,95,39,52,27,43,3,3,14,66,95,1,1,35,86,26,35,30,51,1,5,15,56,86
2007-12-31 00:00:00.000,Chennai India ATP World Tour,HARD,2,Florent Serra,Kristof Vliegen,Florent Serra,7-5; 4-6; 7-6(3),R16,146,3,3,60,107,44,60,23,47,2,6,17,67,107,13,3,67,108,46,67,21,41,3,7,17,67,108
2007-12-31 00:00:00.000,Chennai India ATP World Tour,HARD,2,Xavier Malisse,Jurgen Melzer,Xavier Malisse,7-6(3); 6-2,R16,94,8,2,32,62,24,32,21,30,0,0,10,45,62,1,1,62,89,39,62,11,27,13,15,10,50,89
2007-12-31 00:00:00.000,Chennai India ATP World Tour,HARD,2,Mikhail Youzhny,Edouard Roger-Vasselin,Mikhail Youzhny,7-5; 1-6; 6-2,R16,108,1,3,46,74,30,46,17,28,4,8,13,47,74,1,3,57,82,35,57,9,25,2,7,14,44,82
2007-12-31 00:00:00.000,Chennai India ATP World Tour,HARD,2,Marin Cilic,Nicolas Mahut,Marin Cilic,6-2; 6-4,R16,77,8,3,30,53,23,30,12,23,2,3,9,35,53,4,4,47,74,32,47,8,27,8,12,9,40,74
2007-12-31 00:00:00.000,Chennai India ATP World Tour,HARD,2,Robin Haase,Lovro Zovko,Robin Haase,6-1; 7-5,R16,79,6,1,37,54,27,37,13,17,3,3,9,40,54,8,4,44,84,29,44,16,40,12,16,10,45,84
2007-12-31 00:00:00.000,Chennai India ATP World Tour,HARD,2,Rafael Nadal,Guillermo Garcia-Lopez,Rafael Nadal,6-3; 6-2,Q,80,1,0,30,45,24,30,12,15,0,0,9,36,45,6,5,24,52,18,24,9,28,3,6,8,27,52
2007-12-31 00:00:00.000,Chennai India ATP World Tour,HARD,2,Carlos Moya,Florent Serra,Carlos Moya,6-3; 6-4,Q,75,8,1,31,53,25,31,15,22,0,0,10,40,53,0,3,48,75,32,48,12,27,8,10,9,44,75
2007-12-31 00:00:00.000,Chennai India ATP World Tour,HARD,2,Mikhail Youzhny,Xavier Malisse,Mikhail Youzhny,6-4; 6-4,Q,70,1,2,29,47,27,29,13,18,0,0,10,40,47,6,1,35,57,25,35,12,22,2,4,10,37,57
2007-12-31 00:00:00.000,Chennai India ATP World Tour,HARD,2,Marin Cilic,Robin Haase,Marin Cilic,4-6; 6-2; 6-3,Q,107,6,1,48,86,35,48,21,38,3,5,14,56,86,5,4,51,85,35,51,15,34,5,9,13,50,85
2007-12-31 00:00:00.000,Chennai India ATP World Tour,HARD,2,Rafael Nadal,Carlos Moya,Rafael Nadal,6-7(3); 7-6(8); 7-6(1),S,235,4,1,81,121,58,81,27,40,2,4,18,85,121,9,4,109,153,74,109,24,44,15,17,18,98,153
2007-12-31 00:00:00.000,Chennai India ATP World Tour,HARD,2,Mikhail Youzhny,Marin Cilic,Mikhail Youzhny,6-2; 6-3,S,83,3,0,29,43,24,29,9,14,1,1,8,33,43,3,2,35,76,21,35,18,41,4,8,9,39,76
2007-12-31 00:00:00.000,Chennai India ATP World Tour,HARD,2,Mikhail Youzhny,Rafael Nadal,Mikhail Youzhny,6-0; 6-1,F,57,9,0,23,33,21,23,7,10,0,0,7,28,33,1,1,21,32,10,21,2,11,1,6,6,12,32
2007-12-31 00:00:00.000,Doha Qatar ATP World Tour,HARD,2,Nikolay Davydenko,Benedikt Dorsch,Nikolay Davydenko,6-3; 6-0,R32,76,1,3,41,45,29,41,0,4,2,3,7,29,45,2,2,43,59,18,43,8,16,7,13,8,26,59
2007-12-31 00:00:00.000,Doha Qatar ATP World Tour,HARD,2,Fabrice Santoro,Andreas Seppi,Fabrice Santoro,6-4; 1-6; 6-2,R32,118,1,1,47,86,32,47,19,39,8,11,12,51,86,2,6,46,79,35,46,11,33,4,8,13,46,79
2007-12-31 00:00:00.000,Doha Qatar ATP World Tour,HARD,2,Nicolas Kiefer,Sebastien De Chaunac,Nicolas Kiefer,6-4; 6-3,R32,84,3,0,26,44,25,26,8,18,0,1,9,33,44,5,1,41,63,23,41,9,22,5,9,10,32,63
2007-12-31 00:00:00.000,Doha Qatar ATP World Tour,HARD,2,Dmitry Tursunov,Albert Montanes,Dmitry Tursunov,6-2; 7-5,R32,81,9,1,44,67,34,44,10,23,3,4,10,44,67,5,2,40,65,29,40,8,25,2,6,10,37,65
2007-12-31 00:00:00.000,Doha Qatar ATP World Tour,HARD,2,Andy Murray,Olivier Rochus,Andy Murray,6-0; 6-2,R32,79,5,1,21,38,16,21,11,17,0,1,7,27,38,1,5,38,73,24,38,6,35,11,17,7,30,73
2007-12-31 00:00:00.000,Doha Qatar ATP World Tour,HARD,2,Rainer Schuettler,Andrei Pavel,Rainer Schuettler,1-6; 6-2; 6-0,R32,100,3,2,41,74,31,41,15,33,5,8,11,46,74,5,2,39,64,23,39,12,25,5,10,10,35,64
2007-12-31 00:00:00.000,Doha Qatar ATP World Tour,HARD,2,Michael Berrer,Abdulla Hajji,Michael Berrer,6-1; 6-1,R32,35,6,0,20,28,20,20,8,8,0,0,7,28,28,0,4,26,40,15,26,1,14,2,7,7,16,40
2007-12-31 00:00:00.000,Doha Qatar ATP World Tour,HARD,2,Thomas Johansson,Igor Andreev,Thomas Johansson,6-1; 6-0,R32,47,3,1,24,35,21,24,7,11,0,0,7,28,35,0,1,23,36,8,23,5,13,3,8,6,13,36
2007-12-31 00:00:00.000,Doha Qatar ATP World Tour,HARD,2,Philipp Kohlschreiber,Oscar Hernandez,Philipp Kohlschreiber,6-3; 6-1,R32,78,5,4,34,54,26,34,9,20,2,3,8,35,54,3,5,26,59,15,26,11,33,8,13,8,26,59
2007-12-31 00:00:00.000,Doha Qatar ATP World Tour,HARD,2,Filippo Volandri,Diego Hartfield,Filippo Volandri,4-6; 6-3; 7-6(3),R32,166,4,7,86,121,55,86,15,35,12,16,16,70,121,3,5,70,112,45,70,16,42,6,10,15,61,112
2007-12-31 00:00:00.000,Doha Qatar ATP World Tour,HARD,2,Janko Tipsarevic,Santiago Ventura,Janko Tipsarevic,3-6; 6-3; 6-4,R32,140,2,3,43,81,33,43,20,38,7,10,14,53,81,9,3,53,105,38,53,22,52,8,12,14,60,105
2007-12-31 00:00:00.000,Doha Qatar ATP World Tour,HARD,2,Ivan Ljubicic,Stefan Koubek,Ivan Ljubicic,6-4; 6-4,R32,73,10,0,44,56,33,44,7,12,0,1,10,40,56,2,3,36,61,25,36,9,25,2,5,10,34,61
2007-12-31 00:00:00.000,Doha Qatar ATP World Tour,HARD,2,Christophe Rochus,Ivo Karlovic,Christophe Rochus,7-6(2); 6-2,R32,84,3,2,49,71,38,49,11,22,4,4,10,49,71,16,1,45,64,34,45,7,19,1,3,10,41,64
2007-12-31 00:00:00.000,Doha Qatar ATP World Tour,HARD,2,Stanislas Wawrinka,Alberto Martin,Stanislas Wawrinka,6-2; 6-2,R32,73,5,0,23,46,19,23,12,23,0,1,8,31,46,1,2,35,65,18,35,12,30,9,14,8,30,65
2007-12-31 00:00:00.000,Doha Qatar ATP World Tour,HARD,2,Hyung-Taik Lee,Max Mirnyi,Hyung-Taik Lee,6-3; 6-2,R32,57,1,1,36,50,25,36,10,14,1,2,9,35,50,1,0,26,40,14,26,7,14,0,4,8,21,40
2007-12-31 00:00:00.000,Doha Qatar ATP World Tour,HARD,2,Agustin Calleri,Tommy Robredo,Agustin Calleri,6-4; 6-4,R32,104,4,3,33,64,26,33,16,31,3,4,10,42,64,1,1,40,57,27,40,8,17,3,6,10,35,57
2007-12-31 00:00:00.000,Doha Qatar ATP World Tour,HARD,2,Nikolay Davydenko,Fabrice Santoro,Nikolay Davydenko,6-3; 6-3,R16,73,1,2,36,57,27,36,13,21,2,2,9,40,57,0,2,25,47,15,25,13,22,3,6,9,28,47
2007-12-31 00:00:00.000,Doha Qatar ATP World Tour,HARD,2,Dmitry Tursunov,Nicolas Kiefer,Dmitry Tursunov,W/O,R16,0,0,0,0,0,0,0,0,0,0,0,0,0,0,0,0,0,0,0,0,0,0,0,0,0,0,0
2007-12-31 00:00:00.000,Doha Qatar ATP World Tour,HARD,2,Andy Murray,Rainer Schuettler,Andy Murray,1-6; 6-0; 6-1,R16,94,5,2,44,73,32,44,12,29,4,6,10,44,73,0,1,28,50,15,28,12,22,3,8,10,27,50
2007-12-31 00:00:00.000,Doha Qatar ATP World Tour,HARD,2,Thomas Johansson,Michael Berrer,Thomas Johansson,6-3; 7-5,R16,92,3,0,56,79,43,56,11,23,6,6,11,54,79,6,5,39,65,28,39,14,26,4,6,10,42,65
2007-12-31 00:00:00.000,Doha Qatar ATP World Tour,HARD,2,Philipp Kohlschreiber,Filippo Volandri,Philipp Kohlschreiber,6-4; 6-1,R16,65,1,1,29,47,22,29,10,18,0,1,8,32,47,1,1,28,50,17,28,8,22,2,7,9,25,50
2007-12-31 00:00:00.000,Doha Qatar ATP World Tour,HARD,2,Ivan Ljubicic,Janko Tipsarevic,Ivan Ljubicic,W/O,R16,0,0,0,0,0,0,0,0,0,0,0,0,0,0,0,0,0,0,0,0,0,0,0,0,0,0,0
2007-12-31 00:00:00.000,Doha Qatar ATP World Tour,HARD,2,Stanislas Wawrinka,Christophe Rochus,Stanislas Wawrinka,6-2; 7-5,R16,98,10,1,38,68,29,38,15,30,3,4,10,44,68,1,1,46,72,29,46,9,26,7,11,10,38,72
2007-12-31 00:00:00.000,Doha Qatar ATP World Tour,HARD,2,Agustin Calleri,Hyung-Taik Lee,Agustin Calleri,6-3; 6-1,R16,65,7,2,23,44,18,23,13,21,2,3,8,31,44,2,1,37,57,20,37,5,20,4,9,8,25,57
2007-12-31 00:00:00.000,Doha Qatar ATP World Tour,HARD,2,Nikolay Davydenko,Dmitry Tursunov,Nikolay Davydenko,7-5; 6-3,Q,106,5,4,46,64,30,46,9,18,6,9,10,39,64,3,3,44,81,25,44,14,37,4,10,11,39,81
2007-12-31 00:00:00.000,Doha Qatar ATP World Tour,HARD,2,Andy Murray,Thomas Johansson,Andy Murray,7-6(4); 6-0,Q,88,11,2,35,55,28,35,15,20,0,0,9,43,55,2,2,44,61,24,44,9,17,2,5,9,33,61
2007-12-31 00:00:00.000,Doha Qatar ATP World Tour,HARD,2,Ivan Ljubicic,Philipp Kohlschreiber,Ivan Ljubicic,6-3; 6-7(4); 6-3,Q,136,14,2,67,99,54,67,15,32,5,6,16,69,99,5,2,52,85,42,52,13,33,3,6,14,55,85
2007-12-31 00:00:00.000,Doha Qatar ATP World Tour,HARD,2,Stanislas Wawrinka,Agustin Calleri,Stanislas Wawrinka,6-3; 6-0,Q,65,4,0,23,39,20,23,12,16,0,0,8,32,39,2,3,28,59,19,28,9,31,5,9,7,28,59
2007-12-31 00:00:00.000,Doha Qatar ATP World Tour,HARD,2,Andy Murray,Nikolay Davydenko,Andy Murray,6-4; 6-3,S,83,2,1,28,51,21,28,17,23,0,1,10,38,51,1,2,38,57,24,38,9,19,6,9,9,33,57
2007-12-31 00:00:00.000,Doha Qatar ATP World Tour,HARD,2,Stanislas Wawrinka,Ivan Ljubicic,Stanislas Wawrinka,7-6(1); 6-4,S,92,8,4,34,58,30,34,17,24,0,0,11,47,58,8,2,45,63,35,45,8,18,1,2,11,43,63
2007-12-31 00:00:00.000,Doha Qatar ATP World Tour,HARD,2,Andy Murray,Stanislas Wawrinka,Andy Murray,6-4; 4-6; 6-2,F,148,4,5,51,91,36,51,20,40,2,5,14,56,91,6,3,77,101,39,77,15,24,8,13,14,54,101
2008-01-07 00:00:00.000,Auckland New Zealand ATP World Tour,HARD,2,David Ferrer,Oscar Hernandez,David Ferrer,6-1; 6-2,R32,57,2,1,25,37,23,25,9,12,0,0,8,32,37,0,3,29,44,13,29,6,15,4,8,7,19,44
2008-01-07 00:00:00.000,Auckland New Zealand ATP World Tour,HARD,2,Sergio Roitman,Lukas Rosol,Sergio Roitman,6-2; 7-5,R32,69,4,0,32,53,26,32,12,21,0,1,10,38,53,2,2,27,56,18,27,11,29,3,7,10,29,56
2008-01-07 00:00:00.000,Auckland New Zealand ATP World Tour,HARD,2,Julien Benneteau,Dudi Sela,Julien Benneteau,6-4; 7-6(3),R32,100,3,1,58,85,37,58,15,27,12,14,11,52,85,2,4,39,70,25,39,15,31,3,6,11,40,70
2008-01-07 00:00:00.000,Auckland New Zealand ATP World Tour,HARD,2,Nicolas Almagro,Jose Acasuso,Nicolas Almagro,6-3; 6-4,R32,67,9,3,39,64,29,39,13,25,4,5,10,42,64,4,2,38,58,25,38,8,20,6,9,9,33,58
2008-01-07 00:00:00.000,Auckland New Zealand ATP World Tour,HARD,2,Juan Carlos Ferrero,Jesse Levine,Juan Carlos Ferrero,6-4; 6-1,R32,79,5,1,33,50,23,33,13,17,3,3,8,36,50,3,3,38,67,23,38,13,29,11,15,9,36,67
2008-01-07 00:00:00.000,Auckland New Zealand ATP World Tour,HARD,2,Jurgen Melzer,Werner Eschauer,Jurgen Melzer,6-4; 1-6; 6-3,R32,112,7,4,55,86,36,55,14,31,4,8,13,50,86,3,6,45,86,31,45,18,41,2,6,13,49,86
2008-01-07 00:00:00.000,Auckland New Zealand ATP World Tour,HARD,2,Nicolas Massu,G.D. Jones,Nicolas Massu,6-4; 6-2,R32,83,5,0,31,44,26,31,8,13,0,1,9,34,44,2,3,38,55,23,38,6,17,2,6,9,29,55
2008-01-07 00:00:00.000,Auckland New Zealand ATP World Tour,HARD,2,Xavier Malisse,Jarkko Nieminen,Xavier Malisse,7-6(3); 6-3,R32,82,7,2,35,63,29,35,16,28,0,1,11,45,63,0,1,42,70,25,42,17,28,0,2,10,42,70
2008-01-07 00:00:00.000,Auckland New Zealand ATP World Tour,HARD,2,Albert Montanes,Jose (Rubin) Statham,Albert Montanes,6-4; 6-4,R32,71,6,4,32,54,28,32,13,22,0,0,10,41,54,8,1,46,73,36,46,9,27,2,4,10,45,73
2008-01-07 00:00:00.000,Auckland New Zealand ATP World Tour,HARD,2,Michael Llodra,Hyung-Taik Lee,Michael Llodra,6-1; 6-4,R32,63,5,1,28,44,24,28,12,16,0,0,9,36,44,1,3,33,56,22,33,9,23,2,5,8,31,56
2008-01-07 00:00:00.000,Auckland New Zealand ATP World Tour,HARD,2,Olivier Rochus,Michael Berrer,Olivier Rochus,6-7(8); 6-2; 6-4,R32,140,1,2,72,100,56,72,13,28,6,7,15,69,100,12,8,60,101,41,60,19,41,7,11,15,60,101
2008-01-07 00:00:00.000,Auckland New Zealand ATP World Tour,HARD,2,Juan Monaco,Thomas Johansson,Juan Monaco,6-3; 6-4,R32,61,3,2,48,58,37,48,5,10,1,2,10,42,58,7,2,31,47,23,31,6,16,1,4,9,29,47
2008-01-07 00:00:00.000,Auckland New Zealand ATP World Tour,HARD,2,Philipp Kohlschreiber,Michael Russell,Philipp Kohlschreiber,7-5; 6-2,R32,93,7,5,37,70,28,37,13,33,5,7,10,41,70,5,3,29,56,15,29,13,27,0,5,10,28,56
2008-01-07 00:00:00.000,Auckland New Zealand ATP World Tour,HARD,2,Marin Cilic,Tomas Cakl,Marin Cilic,6-4; 6-3,R32,76,6,1,36,67,29,36,15,31,5,5,9,44,67,4,4,33,64,24,33,12,31,6,9,10,36,64
2008-01-07 00:00:00.000,Auckland New Zealand ATP World Tour,HARD,2,Florian Mayer,Sam Querrey,Florian Mayer,7-5; 6-3,R32,73,3,1,35,59,26,35,17,24,2,2,10,43,59,7,7,36,68,28,36,14,32,6,9,11,42,68
2008-01-07 00:00:00.000,Auckland New Zealand ATP World Tour,HARD,2,Juan Ignacio Chela,Daniel King-Turner,Juan Ignacio Chela,5-7; 6-2; 7-5,R32,145,2,6,54,97,39,54,26,43,3,5,16,65,97,9,4,70,110,52,70,14,40,9,13,16,66,110
2008-01-07 00:00:00.000,Auckland New Zealand ATP World Tour,HARD,2,David Ferrer,Sergio Roitman,David Ferrer,6-1; 7-6(2),R16,89,2,2,41,60,32,41,12,19,2,3,10,44,60,4,1,49,80,31,49,12,31,9,12,9,43,80
2008-01-07 00:00:00.000,Auckland New Zealand ATP World Tour,HARD,2,Julien Benneteau,Nicolas Almagro,Julien Benneteau,6-4; 2-6; 6-2,R16,110,0,3,71,95,48,71,11,24,10,12,13,59,95,10,0,44,72,30,44,18,28,5,8,13,48,72
2008-01-07 00:00:00.000,Auckland New Zealand ATP World Tour,HARD,2,Juan Carlos Ferrero,Jurgen Melzer,Juan Carlos Ferrero,6-3; 7-6(6),R16,78,3,0,41,63,34,41,16,22,2,2,11,50,63,1,0,38,60,25,38,17,22,2,3,10,42,60
2008-01-07 00:00:00.000,Auckland New Zealand ATP World Tour,HARD,2,Nicolas Massu,Xavier Malisse,Nicolas Massu,6-4; 6-4,R16,99,3,3,43,70,29,43,15,27,6,7,10,44,70,5,0,37,55,28,37,6,18,2,5,10,34,55
2008-01-07 00:00:00.000,Auckland New Zealand ATP World Tour,HARD,2,Michael Llodra,Albert Montanes,Michael Llodra,6-3; 6-4,R16,79,12,3,47,68,36,47,12,21,6,6,10,48,68,4,5,35,60,26,35,10,25,1,3,9,36,60
2008-01-07 00:00:00.000,Auckland New Zealand ATP World Tour,HARD,2,Juan Monaco,Olivier Rochus,Juan Monaco,6-3; 6-3,R16,75,5,2,32,52,25,32,7,20,1,3,9,32,52,0,2,37,53,23,37,4,16,7,12,9,27,53
2008-01-07 00:00:00.000,Auckland New Zealand ATP World Tour,HARD,2,Philipp Kohlschreiber,Marin Cilic,Philipp Kohlschreiber,6-3; 6-7(5); 6-4,R16,131,4,3,64,98,52,64,18,34,3,5,16,70,98,19,3,55,90,43,55,15,35,3,7,15,58,90
2008-01-07 00:00:00.000,Auckland New Zealand ATP World Tour,HARD,2,Florian Mayer,Juan Ignacio Chela,Florian Mayer,6-3; 7-6(7),R16,85,3,0,36,71,28,36,22,35,1,2,11,50,71,3,3,31,64,23,31,17,33,1,3,10,40,64
2008-01-07 00:00:00.000,Auckland New Zealand ATP World Tour,HARD,2,Julien Benneteau,David Ferrer,Julien Benneteau,6-4; 6-0,Q,64,3,1,30,42,25,30,8,12,0,0,8,33,42,0,0,35,53,21,35,6,18,5,9,8,27,53
2008-01-07 00:00:00.000,Auckland New Zealand ATP World Tour,HARD,2,Juan Carlos Ferrero,Nicolas Massu,Juan Carlos Ferrero,4-6; 6-3; 6-4,Q,153,1,1,57,82,40,57,12,25,2,5,14,52,82,6,5,65,108,40,65,21,43,7,12,15,61,108
2008-01-07 00:00:00.000,Auckland New Zealand ATP World Tour,HARD,2,Juan Monaco,Michael Llodra,Juan Monaco,4-6; 7-6(5); 7-6(5),Q,142,1,3,83,116,54,83,19,33,4,8,17,73,116,15,3,59,98,45,59,22,39,3,6,17,67,98
2008-01-07 00:00:00.000,Auckland New Zealand ATP World Tour,HARD,2,Philipp Kohlschreiber,Florian Mayer,Philipp Kohlschreiber,6-3; 6-4,Q,72,2,0,36,54,26,36,11,18,3,5,10,37,54,2,1,39,61,24,39,8,22,6,10,9,32,61
2008-01-07 00:00:00.000,Auckland New Zealand ATP World Tour,HARD,2,Juan Carlos Ferrero,Julien Benneteau,Juan Carlos Ferrero,6-3; 6-4,S,97,3,2,52,75,36,52,14,23,5,5,10,50,75,3,0,38,59,26,38,9,21,2,4,9,35,59
2008-01-07 00:00:00.000,Auckland New Zealand ATP World Tour,HARD,2,Philipp Kohlschreiber,Juan Monaco,Philipp Kohlschreiber,6-2; 6-1,S,66,2,2,24,43,18,24,10,19,1,2,7,28,43,1,1,35,53,13,35,9,18,4,10,8,22,53
2008-01-07 00:00:00.000,Auckland New Zealand ATP World Tour,HARD,2,Philipp Kohlschreiber,Juan Carlos Ferrero,Philipp Kohlschreiber,7-6(4); 7-5,F,114,7,7,54,89,39,54,19,35,4,5,12,58,89,5,1,59,76,43,59,9,17,3,5,12,52,76
2008-01-07 00:00:00.000,Sydney Australia ATP World Tour,HARD,2,Richard Gasquet,Igor Andreev,Richard Gasquet,6-3; 7-6(6),R32,94,7,5,40,70,35,40,15,30,3,4,11,50,70,2,4,41,66,29,41,11,25,1,3,10,40,66
2008-01-07 00:00:00.000,Sydney Australia ATP World Tour,HARD,2,Dmitry Tursunov,Stanislas Wawrinka,Dmitry Tursunov,6-3; 6-3,R32,67,3,2,27,51,22,27,13,24,3,4,9,35,51,2,1,37,54,23,37,7,17,2,6,9,30,54
2008-01-07 00:00:00.000,Sydney Australia ATP World Tour,HARD,2,Sebastien Grosjean,Peter Luczak,Sebastien Grosjean,6-4; 4-6; 6-0,R32,126,9,2,40,78,32,40,20,38,4,6,13,52,78,5,1,63,98,34,63,20,35,6,11,13,54,98
2008-01-07 00:00:00.000,Sydney Australia ATP World Tour,HARD,2,Fernando Verdasco,Feliciano Lopez,Fernando Verdasco,6-3; 4-6; 6-2,R32,124,3,4,64,83,44,64,8,19,5,8,14,52,83,11,5,54,99,35,54,19,45,8,13,13,54,99
2008-01-07 00:00:00.000,Sydney Australia ATP World Tour,HARD,2,Fabrice Santoro,James Blake,Fabrice Santoro,7-6(4); 6-2,R32,80,5,2,27,68,18,27,23,41,5,8,10,41,68,3,1,31,57,21,31,10,26,2,7,10,31,57
2008-01-07 00:00:00.000,Sydney Australia ATP World Tour,HARD,2,Steve Darcis,Joseph Sirianni,Steve Darcis,6-1; 7-6(4),R32,69,6,2,38,57,32,38,11,19,0,1,10,43,57,1,2,26,56,21,26,14,30,4,7,9,35,56
2008-01-07 00:00:00.000,Sydney Australia ATP World Tour,HARD,2,Ivo Minar,Alun Jones,Ivo Minar,6-2; 7-5,R32,73,5,2,50,71,34,50,10,21,6,8,10,44,71,2,0,34,54,18,34,9,20,0,5,10,27,54
2008-01-07 00:00:00.000,Sydney Australia ATP World Tour,HARD,2,Evgeny Korolev,Paul-Henri Mathieu,Evgeny Korolev,6-1 RET,R32,34,3,2,21,27,16,21,0,6,2,3,4,16,27,2,1,10,20,6,10,1,10,3,6,3,7,20
2008-01-07 00:00:00.000,Sydney Australia ATP World Tour,HARD,2,Lleyton Hewitt,Nicolas Mahut,Lleyton Hewitt,6-3; 6-4,R32,88,5,4,26,48,20,26,12,22,1,3,9,32,48,4,13,41,82,28,41,14,41,8,13,10,42,82
2008-01-07 00:00:00.000,Sydney Australia ATP World Tour,HARD,2,Chris Guccione,Alberto Martin,Chris Guccione,7-6(6); 6-4,R32,77,18,3,43,62,39,43,12,19,1,1,11,51,62,2,3,35,64,27,35,19,29,0,1,11,46,64
2008-01-07 00:00:00.000,Sydney Australia ATP World Tour,HARD,2,Gilles Simon,Mardy Fish,Gilles Simon,7-6(6); 6-1,R32,72,4,2,32,59,23,32,17,27,0,2,10,40,59,5,1,30,60,22,30,10,30,1,5,9,32,60
2008-01-07 00:00:00.000,Sydney Australia ATP World Tour,HARD,2,Tomas Berdych,Filippo Volandri,Tomas Berdych,6-1; 6-3,R32,72,7,1,33,55,26,33,12,22,3,3,8,38,55,1,6,31,66,18,31,15,35,9,13,8,33,66
2008-01-07 00:00:00.000,Sydney Australia ATP World Tour,HARD,2,Carlos Moya,Stefan Koubek,Carlos Moya,1-6; 6-4; 6-2,R32,90,2,3,42,74,30,42,19,32,7,9,12,49,74,3,3,44,72,32,44,13,28,0,3,13,45,72
2008-01-07 00:00:00.000,Sydney Australia ATP World Tour,HARD,2,Agustin Calleri,Greg Jones,Agustin Calleri,6-3; 6-2,R32,76,6,2,22,42,21,22,11,20,0,0,8,32,42,3,3,44,67,25,44,10,23,8,12,9,35,67
2008-01-07 00:00:00.000,Sydney Australia ATP World Tour,HARD,2,Andreas Seppi,Jo-Wilfried Tsonga,Andreas Seppi,3-6; 6-3; 6-2,R32,111,2,0,49,87,34,49,21,38,8,10,13,55,87,7,1,53,87,32,53,19,34,7,11,13,51,87
2008-01-07 00:00:00.000,Sydney Australia ATP World Tour,HARD,2,Radek Stepanek,Tommy Robredo,Radek Stepanek,6-4; 6-2,R32,91,2,3,39,69,26,39,16,30,4,5,9,42,69,1,3,39,57,22,39,8,18,3,7,9,30,57
2008-01-07 00:00:00.000,Sydney Australia ATP World Tour,HARD,2,Dmitry Tursunov,Richard Gasquet,Dmitry Tursunov,3-6; 6-3; 6-4,R16,123,8,2,49,91,39,49,23,42,3,4,14,62,91,7,4,62,96,43,62,17,34,5,7,14,60,96
2008-01-07 00:00:00.000,Sydney Australia ATP World Tour,HARD,2,Sebastien Grosjean,Fernando Verdasco,Sebastien Grosjean,6-3; 6-4,R16,78,3,0,31,52,26,31,10,21,1,3,10,36,52,5,0,47,60,21,47,9,13,7,11,9,30,60
2008-01-07 00:00:00.000,Sydney Australia ATP World Tour,HARD,2,Fabrice Santoro,Steve Darcis,Fabrice Santoro,6-1; 6-3,R16,60,5,0,39,48,28,39,5,9,1,2,8,33,48,1,0,30,43,17,30,2,13,2,7,8,19,43
2008-01-07 00:00:00.000,Sydney Australia ATP World Tour,HARD,2,Evgeny Korolev,Ivo Minar,Evgeny Korolev,6-2; 6-3,R16,66,3,5,29,55,23,29,13,26,3,4,9,36,55,2,4,35,62,20,35,11,27,8,12,8,31,62
2008-01-07 00:00:00.000,Sydney Australia ATP World Tour,HARD,2,Chris Guccione,Lleyton Hewitt,Chris Guccione,7-6(4); 7-6(2),R16,97,23,4,45,80,43,45,18,35,4,4,12,61,80,8,3,40,74,34,40,20,34,0,0,12,54,74
2008-01-07 00:00:00.000,Sydney Australia ATP World Tour,HARD,2,Tomas Berdych,Gilles Simon,Tomas Berdych,7-6(3); 6-2,R16,86,6,3,41,58,32,41,9,17,3,5,10,41,58,2,1,46,76,24,46,14,30,4,8,10,38,76
2008-01-07 00:00:00.000,Sydney Australia ATP World Tour,HARD,2,Agustin Calleri,Carlos Moya,Agustin Calleri,6-3; 6-4,R16,71,10,2,30,53,27,30,13,23,2,3,10,40,53,1,1,38,62,22,38,11,24,5,8,9,33,62
2008-01-07 00:00:00.000,Sydney Australia ATP World Tour,HARD,2,Radek Stepanek,Andreas Seppi,Radek Stepanek,7-5; 2-6; 6-4,R16,140,6,1,57,90,41,57,19,33,6,9,15,60,90,7,1,61,104,43,61,21,43,7,10,15,64,104
2008-01-07 00:00:00.000,Sydney Australia ATP World Tour,HARD,2,Dmitry Tursunov,Sebastien Grosjean,Dmitry Tursunov,6-4; 6-2,Q,74,8,1,38,58,29,38,10,20,7,8,9,39,58,4,1,35,62,22,35,13,27,3,7,9,35,62
2008-01-07 00:00:00.000,Sydney Australia ATP World Tour,HARD,2,Fabrice Santoro,Evgeny Korolev,Fabrice Santoro,6-3; 6-3,Q,78,7,1,38,56,31,38,10,18,3,3,9,41,56,1,1,34,59,21,34,12,25,5,8,9,33,59
2008-01-07 00:00:00.000,Sydney Australia ATP World Tour,HARD,2,Chris Guccione,Tomas Berdych,Chris Guccione,4-6; 7-6(6); 6-4,Q,125,19,5,69,111,53,69,24,42,6,7,16,77,111,7,4,54,97,43,54,26,43,2,3,16,69,97
2008-01-07 00:00:00.000,Sydney Australia ATP World Tour,HARD,2,Radek Stepanek,Agustin Calleri,Radek Stepanek,6-2; 6-4,Q,68,5,1,35,47,28,35,6,12,2,3,9,34,47,1,3,31,55,20,31,11,24,6,10,9,31,55
2008-01-07 00:00:00.000,Sydney Australia ATP World Tour,HARD,2,Dmitry Tursunov,Fabrice Santoro,Dmitry Tursunov,6-3; 7-6(4),S,102,8,2,43,71,31,43,18,28,3,4,11,49,71,3,3,39,77,25,39,21,38,7,9,10,46,77
2008-01-07 00:00:00.000,Sydney Australia ATP World Tour,HARD,2,Chris Guccione,Radek Stepanek,Chris Guccione,7-6(5); 3-6; 6-4,S,178,13,3,60,90,54,60,13,30,4,5,15,67,90,6,1,52,90,42,52,26,38,2,3,16,68,90
2008-01-07 00:00:00.000,Sydney Australia ATP World Tour,HARD,2,Dmitry Tursunov,Chris Guccione,Dmitry Tursunov,7-6(3); 7-6(4),F,83,6,1,43,74,38,43,20,31,0,0,12,58,74,15,0,39,65,36,39,18,26,0,0,12,54,65
2008-01-14 00:00:00.000,Australian Open Australia Grand Slams,HARD,3,Roger Federer,Diego Hartfield,Roger Federer,6-0; 6-3; 6-0,R128,72,11,1,50,65,42,50,7,15,2,2,11,49,65,3,1,40,62,21,40,5,22,3,10,10,26,62
2008-01-14 00:00:00.000,Australian Open Australia Grand Slams,HARD,3,Fabrice Santoro,John Isner,Fabrice Santoro,6-2; 6-2; 6-4,R128,110,3,0,41,67,29,41,21,26,1,2,13,50,67,11,6,56,80,37,56,7,24,3,9,13,44,80
2008-01-14 00:00:00.000,Australian Open Australia Grand Slams,HARD,3,Janko Tipsarevic,Joseph Sirianni,Janko Tipsarevic,7-5; 6-2; 6-7(6); 0-6; 6-0,R128,220,25,5,86,156,65,86,36,70,6,9,22,101,156,11,5,81,157,55,81,41,76,9,15,22,96,157
2008-01-14 00:00:00.000,Australian Open Australia Grand Slams,HARD,3,Fernando Verdasco,Thierry Ascione,Fernando Verdasco,6-4; 6-0; 6-3,R128,97,4,2,56,72,37,56,9,16,6,9,12,46,72,2,5,57,88,28,57,11,31,6,15,13,39,88
2008-01-14 00:00:00.000,Australian Open Australia Grand Slams,HARD,3,Juan Monaco,Carlos Berlocq,Juan Monaco,7-6(5); 7-5; 6-1,R128,139,6,2,62,94,44,62,14,32,2,6,16,58,94,8,7,46,102,30,46,22,56,3,10,15,52,102
2008-01-14 00:00:00.000,Australian Open Australia Grand Slams,HARD,3,Amer Delic,Robert Kendrick,Amer Delic,6-4; 7-5; 6-2,R128,103,8,4,62,93,46,62,18,31,4,5,15,64,93,6,2,46,82,35,46,13,36,1,6,15,48,82
2008-01-14 00:00:00.000,Australian Open Australia Grand Slams,HARD,3,Oscar Hernandez,Ivo Minar,Oscar Hernandez,1-6; 7-6(5); 6-2; 6-1,R128,122,10,4,65,107,51,65,19,42,4,8,18,70,107,3,2,55,96,32,55,25,41,4,9,16,57,96
2008-01-14 00:00:00.000,Australian Open Australia Grand Slams,HARD,3,Tomas Berdych,Werner Eschauer,Tomas Berdych,6-4; 6-4; 6-4,R128,127,10,2,51,79,36,51,18,28,1,4,15,54,79,9,5,58,106,37,58,18,48,3,9,15,55,106
2008-01-14 00:00:00.000,Australian Open Australia Grand Slams,HARD,3,James Blake,Nicolas Massu,James Blake,6-3; 6-2; 6-2,R128,96,11,2,44,80,36,44,20,36,3,4,13,56,80,6,3,54,76,32,54,7,22,7,13,12,39,76
2008-01-14 00:00:00.000,Australian Open Australia Grand Slams,HARD,3,Michael Russell,Fabio Fognini,Michael Russell,6-1; 4-6; 6-2; 3-6; 6-3,R128,183,6,3,94,135,63,94,26,41,2,5,22,89,135,6,9,58,128,38,58,36,70,5,11,21,74,128
2008-01-14 00:00:00.000,Australian Open Australia Grand Slams,HARD,3,Sebastien Grosjean,Filippo Volandri,Sebastien Grosjean,7-6(3); 6-3; 7-6(0),R128,138,4,0,57,96,42,57,22,39,3,7,16,64,96,0,5,55,112,36,55,24,57,4,10,17,60,112
2008-01-14 00:00:00.000,Australian Open Australia Grand Slams,HARD,3,Robin Haase,Ivan Ljubicic,Robin Haase,6-7(2); 6-3; 6-0; 7-6(1),R128,177,16,9,76,134,61,76,29,58,7,9,20,90,134,16,4,79,140,54,79,26,61,8,14,19,80,140
2008-01-14 00:00:00.000,Australian Open Australia Grand Slams,HARD,3,Marin Cilic,Nicolas Almagro,Marin Cilic,7-6(4); 7-5; 6-2,R128,131,16,1,56,103,42,56,29,47,2,4,16,71,103,10,5,57,101,40,57,17,44,7,12,16,57,101
2008-01-14 00:00:00.000,Australian Open Australia Grand Slams,HARD,3,Jurgen Melzer,Jiri Vanek,Jurgen Melzer,6-3; 6-4; 6-4,R128,99,14,2,49,78,42,49,15,29,2,4,15,57,78,8,3,64,107,44,64,15,43,7,12,14,59,107
2008-01-14 00:00:00.000,Australian Open Australia Grand Slams,HARD,3,Hyung-Taik Lee,Chris Guccione,Hyung-Taik Lee,7-6(6); 6-3; 6-4,R128,114,7,0,53,91,45,53,24,38,0,0,16,69,91,16,2,59,93,46,59,18,34,7,9,15,64,93
2008-01-14 00:00:00.000,Australian Open Australia Grand Slams,HARD,3,Fernando Gonzalez,Konstantinos Economidis,Fernando Gonzalez,6-4; 7-6(2); 6-1,R128,110,10,4,51,87,42,51,23,36,1,1,15,65,87,2,4,52,88,34,52,18,36,3,6,14,52,88
2008-01-14 00:00:00.000,Australian Open Australia Grand Slams,HARD,3,Novak Djokovic,Benjamin Becker,Novak Djokovic,6-0; 6-2; 7-6(5),R128,120,6,4,50,79,42,50,13,29,1,2,13,55,79,7,2,38,82,22,38,19,44,1,7,13,41,82
2008-01-14 00:00:00.000,Australian Open Australia Grand Slams,HARD,3,Simone Bolelli,Rajeev Ram,Simone Bolelli,7-6(5); 3-6; 6-4; 2-6; 6-3,R128,187,9,2,94,147,69,94,26,53,9,15,24,95,147,12,3,101,147,75,101,17,46,10,15,24,92,147
2008-01-14 00:00:00.000,Australian Open Australia Grand Slams,HARD,3,Sam Querrey,Olivier Rochus,Sam Querrey,6-3; 6-2; 7-5,R128,118,21,4,49,82,42,49,17,33,4,6,15,59,82,2,4,53,104,26,53,26,51,9,15,14,52,104
2008-01-14 00:00:00.000,Australian Open Australia Grand Slams,HARD,3,Dmitry Tursunov,Xavier Malisse,Dmitry Tursunov,6-7(1); 5-7; 6-2; 6-1; 6-3,R128,183,15,1,90,140,66,90,32,50,5,7,24,98,140,11,4,74,138,56,74,32,64,8,15,24,88,138
2008-01-14 00:00:00.000,Australian Open Australia Grand Slams,HARD,3,Lleyton Hewitt,Steve Darcis,Lleyton Hewitt,6-0; 6-3; 6-0,R128,76,14,6,30,55,25,30,17,25,0,1,11,42,55,1,0,26,53,15,26,5,27,5,13,10,20,53
2008-01-14 00:00:00.000,Australian Open Australia Grand Slams,HARD,3,Denis Istomin,Lukas Lacko,Denis Istomin,6-3; 6-7(1); 7-6(4); 6-1,R128,167,5,3,79,122,57,79,27,43,5,7,20,84,122,8,7,79,145,56,79,31,66,11,17,20,87,145
2008-01-14 00:00:00.000,Australian Open Australia Grand Slams,HARD,3,Marat Safin,Ernests Gulbis,Marat Safin,6-0; 6-4; 7-6(2),R128,114,6,1,39,84,31,39,28,45,2,3,14,59,84,9,6,56,109,36,56,23,53,9,14,14,59,109
2008-01-14 00:00:00.000,Australian Open Australia Grand Slams,HARD,3,Marcos Baghdatis,Thomas Johansson,Marcos Baghdatis,7-6(0); 6-2; 3-6; 6-3,R128,188,16,4,63,125,52,63,30,62,7,10,19,82,125,8,5,72,129,48,72,26,57,11,16,19,74,129
2008-01-14 00:00:00.000,Australian Open Australia Grand Slams,HARD,3,David Nalbandian,Robert Smeets,David Nalbandian,6-1; 6-1; 7-6(3),R128,102,4,5,39,75,32,39,24,36,1,2,13,56,75,6,5,38,87,24,38,20,49,3,9,13,44,87
2008-01-14 00:00:00.000,Australian Open Australia Grand Slams,HARD,3,Peter Luczak,Mariano Zabaleta,Peter Luczak,6-1; 6-7(2); 6-3; 6-4,R128,155,11,7,76,120,61,76,23,44,4,6,20,84,120,13,7,51,111,42,51,25,60,7,13,18,67,111
2008-01-14 00:00:00.000,Australian Open Australia Grand Slams,HARD,3,Alun Jones,Albert Montanes,Alun Jones,6-4; 6-3; 3-6; 6-2,R128,166,5,2,90,129,58,90,16,39,12,17,18,74,129,5,9,69,119,44,69,20,50,6,14,18,64,119
2008-01-14 00:00:00.000,Australian Open Australia Grand Slams,HARD,3,Juan Carlos Ferrero,Nicolas Kiefer,Juan Carlos Ferrero,6-4; 6-3; 6-1,R128,123,8,2,58,81,45,58,13,23,4,4,13,58,81,6,5,43,80,28,43,15,37,4,9,13,43,80
2008-01-14 00:00:00.000,Australian Open Australia Grand Slams,HARD,3,Vincent Spadea,Radek Stepanek,Vincent Spadea,2-6; 2-6; 7-5; 6-2; 6-3,R128,186,0,8,81,146,57,81,34,65,9,14,23,91,146,8,1,72,126,48,72,32,54,3,8,22,80,126
2008-01-14 00:00:00.000,Australian Open Australia Grand Slams,HARD,3,Denis Gremelmayr,Sergio Roitman,Denis Gremelmayr,6-1; 0-6; 6-4; 7-5,R128,146,13,5,67,126,50,67,27,59,19,23,18,77,126,7,6,63,115,39,63,28,52,6,11,17,67,115
2008-01-14 00:00:00.000,Australian Open Australia Grand Slams,HARD,3,Juan Martin Del Potro,Santiago Ventura,Juan Martin Del Potro,6-3; 6-1; 6-3,R128,98,3,2,53,80,41,53,16,27,2,2,13,57,80,8,6,35,74,24,35,15,39,8,13,12,39,74
2008-01-14 00:00:00.000,Australian Open Australia Grand Slams,HARD,3,David Ferrer,Edouard Roger-Vasselin,David Ferrer,6-2; 6-2; 6-1,R128,85,3,2,46,61,35,46,11,15,5,6,11,46,61,2,2,44,74,21,44,10,30,3,11,12,31,74
2008-01-14 00:00:00.000,Australian Open Australia Grand Slams,HARD,3,Richard Gasquet,Nick Lindahl,Richard Gasquet,6-0; 6-1; 3-6; 6-2,R128,104,10,3,52,77,39,52,20,25,1,2,15,59,77,7,3,77,114,48,77,13,37,11,18,15,61,114
2008-01-14 00:00:00.000,Australian Open Australia Grand Slams,HARD,3,Feliciano Lopez,Wayne Odesnik,Feliciano Lopez,7-6(6); 6-1; 6-4,R128,100,28,6,55,95,46,55,25,40,2,2,15,71,95,6,3,41,78,29,41,25,37,1,4,14,54,78
2008-01-14 00:00:00.000,Australian Open Australia Grand Slams,HARD,3,Kristof Vliegen,Olivier Patience,Kristof Vliegen,6-0; 6-1; 7-6(3),R128,98,9,1,46,75,36,46,20,29,3,4,13,56,75,4,2,69,93,36,69,10,24,6,12,12,46,93
2008-01-14 00:00:00.000,Australian Open Australia Grand Slams,HARD,3,Igor Andreev,Andrei Pavel,Igor Andreev,5-7; 6-2; 7-6(4); 6-3,R128,182,7,2,92,126,69,92,22,34,3,4,21,91,126,3,1,105,141,65,105,24,36,3,6,20,89,141
2008-01-14 00:00:00.000,Australian Open Australia Grand Slams,HARD,3,Guillermo Garcia-Lopez,Juan Ignacio Chela,Guillermo Garcia-Lopez,6-4; 6-2; 1-6; 6-2,R128,150,1,4,63,94,40,63,16,31,1,6,16,56,94,2,8,75,125,43,75,23,50,10,18,17,66,125
2008-01-14 00:00:00.000,Australian Open Australia Grand Slams,HARD,3,Alejandro Falla,Kevin Anderson,Alejandro Falla,5-7; 7-5; 6-7(8); 6-2; 7-5,R128,246,4,4,106,175,71,106,40,69,12,17,28,111,175,13,8,138,200,85,138,32,62,10,18,28,117,200
2008-01-14 00:00:00.000,Australian Open Australia Grand Slams,HARD,3,Sam Warburg,Juan Pablo Brzezicki,Sam Warburg,2-6; 6-2; 6-3; 2-6; 6-4,R128,207,5,4,97,138,58,97,24,41,9,16,22,82,138,7,4,94,140,58,94,21,46,9,16,21,79,140
2008-01-14 00:00:00.000,Australian Open Australia Grand Slams,HARD,3,Jo-Wilfried Tsonga,Andy Murray,Jo-Wilfried Tsonga,7-5; 6-4; 0-6; 7-6(5),R128,192,7,6,81,136,58,81,23,55,5,10,20,81,136,7,3,79,136,55,79,27,57,9,13,20,82,136
2008-01-14 00:00:00.000,Australian Open Australia Grand Slams,HARD,3,Mikhail Youzhny,Mathieu Montcourt,Mikhail Youzhny,6-0; 6-2; 7-6(3),R128,111,4,2,59,97,45,59,18,38,11,12,13,63,97,1,4,48,75,28,48,10,27,0,6,13,38,75
2008-01-14 00:00:00.000,Australian Open Australia Grand Slams,HARD,3,Andreas Seppi,Harel Levy,Andreas Seppi,6-4; 6-2; 6-1,R128,87,6,1,42,76,33,42,19,34,0,2,13,52,76,0,3,43,75,20,43,16,32,7,14,12,36,75
2008-01-14 00:00:00.000,Australian Open Australia Grand Slams,HARD,3,Dudi Sela,Martin Slanar,Dudi Sela,6-2; 6-4; 6-2,R128,117,1,3,72,103,52,72,18,31,5,5,13,70,103,3,4,52,87,33,52,13,35,6,11,13,46,87
2008-01-14 00:00:00.000,Australian Open Australia Grand Slams,HARD,3,Ivo Karlovic,Jamie Baker,Ivo Karlovic,6-4; 6-4; 6-7(1); 6-4,R128,209,19,4,76,126,57,76,29,50,4,6,21,86,126,6,2,94,136,57,94,27,42,9,14,21,84,136
2008-01-14 00:00:00.000,Australian Open Australia Grand Slams,HARD,3,Stanislas Wawrinka,Julien Benneteau,Stanislas Wawrinka,6-3; 6-3; 6-3,R128,108,14,3,45,78,38,45,17,33,1,3,14,55,78,2,6,45,88,27,45,18,43,7,13,13,45,88
2008-01-14 00:00:00.000,Australian Open Australia Grand Slams,HARD,3,Marc Gicquel,Yen-Hsun Lu,Marc Gicquel,6-3; 4-6; 6-7(6); 6-4; 6-2,R128,270,14,8,113,184,83,113,30,71,14,18,24,113,184,3,5,102,180,67,102,39,78,10,18,25,106,180
2008-01-14 00:00:00.000,Australian Open Australia Grand Slams,HARD,3,Nicolas Mahut,Jose Acasuso,Nicolas Mahut,7-6(2); 5-7; 6-2; 3-6; 7-5,R128,228,13,9,97,167,69,97,42,70,8,12,26,111,167,14,7,98,178,71,98,41,80,9,14,27,112,178
2008-01-14 00:00:00.000,Australian Open Australia Grand Slams,HARD,3,Nikolay Davydenko,Michael Llodra,Nikolay Davydenko,7-5; 7-5; 6-3,R128,128,1,3,72,92,55,72,8,20,3,5,16,63,92,4,4,60,103,41,60,17,43,4,10,17,58,103
2008-01-14 00:00:00.000,Australian Open Australia Grand Slams,HARD,3,Andy Roddick,Lukas Dlouhy,Andy Roddick,6-3; 6-4; 7-5,R128,98,13,2,58,89,44,58,18,31,5,7,16,62,89,7,12,49,88,33,49,16,39,6,11,0,49,88
2008-01-14 00:00:00.000,Australian Open Australia Grand Slams,HARD,3,Michael Berrer,Donald Young,Michael Berrer,6-7(5); 7-6(4); 6-3; 7-6(5),R128,199,7,10,99,146,77,99,22,47,3,6,22,99,146,5,8,109,178,70,109,35,69,10,15,23,105,178
2008-01-14 00:00:00.000,Australian Open Australia Grand Slams,HARD,3,Evgeny Korolev,Marcel Granollers,Evgeny Korolev,7-5; 6-2; 6-0,R128,89,3,1,47,78,37,47,18,31,8,9,13,55,78,1,7,42,73,19,42,17,31,2,9,13,36,73
2008-01-14 00:00:00.000,Australian Open Australia Grand Slams,HARD,3,Philipp Kohlschreiber,Roko Karanusic,Philipp Kohlschreiber,6-4; 7-6(5); 6-1,R128,132,4,2,88,115,59,88,16,27,10,11,15,75,115,6,1,59,91,41,59,13,32,5,9,14,54,91
2008-01-14 00:00:00.000,Australian Open Australia Grand Slams,HARD,3,Jarkko Nieminen,Frank Dancevic,Jarkko Nieminen,6-3; 6-1; 5-7; 2-6; 6-1,R128,131,1,2,76,113,58,76,19,37,0,3,21,77,113,13,1,79,127,54,79,25,48,7,14,22,79,127
2008-01-14 00:00:00.000,Australian Open Australia Grand Slams,HARD,3,Jesse Levine,Martin Vassallo Arguello,Jesse Levine,6-1; 7-5; 6-1,R128,101,3,3,52,80,38,52,14,28,5,7,13,52,80,1,5,46,77,24,46,11,31,3,11,13,35,77
2008-01-14 00:00:00.000,Australian Open Australia Grand Slams,HARD,3,Mardy Fish,Boris Pashanski,Mardy Fish,6-2; 6-3; 3-6; 6-3,R128,140,12,2,64,107,49,64,22,43,2,5,18,71,107,1,5,83,121,52,83,15,38,10,16,17,67,121
2008-01-14 00:00:00.000,Australian Open Australia Grand Slams,HARD,3,Tommy Robredo,Mischa Zverev,Tommy Robredo,4-6; 2-6; 7-6(2); 6-4; 7-5,R128,238,4,7,123,188,85,123,27,65,11,19,26,112,188,2,1,142,188,91,142,16,46,10,17,26,107,188
2008-01-14 00:00:00.000,Australian Open Australia Grand Slams,HARD,3,Stefan Koubek,Carlos Moya,Stefan Koubek,7-6(5); 6-7(2); 7-5; 6-4,R128,214,5,11,88,158,61,88,38,70,6,9,23,99,158,7,4,105,161,67,105,31,56,5,10,23,98,161
2008-01-14 00:00:00.000,Australian Open Australia Grand Slams,HARD,3,Agustin Calleri,Luis Horna,Agustin Calleri,6-4; 6-7(6); 6-3; 6-4,R128,165,16,4,65,130,50,65,44,65,7,7,21,94,130,14,3,71,118,57,71,22,47,5,8,20,79,118
2008-01-14 00:00:00.000,Australian Open Australia Grand Slams,HARD,3,Paul Capdeville,Brydan Klein,Paul Capdeville,6-4; 7-5; 6-4,R128,154,3,1,72,97,52,72,13,25,2,4,16,65,97,4,7,63,113,40,63,26,50,6,11,16,66,113
2008-01-14 00:00:00.000,Australian Open Australia Grand Slams,HARD,3,Paul-Henri Mathieu,Victor Hanescu,Paul-Henri Mathieu,6-1; 7-6(4); 6-2,R128,134,8,7,53,88,45,53,18,35,5,6,14,63,88,1,2,73,102,47,73,9,29,14,19,13,56,102
2008-01-14 00:00:00.000,Australian Open Australia Grand Slams,HARD,3,Gilles Simon,Bobby Reynolds,Gilles Simon,4-6; 6-4; 6-2; 6-7(3); 6-4,R128,222,10,6,121,176,90,121,24,55,17,20,25,114,176,11,2,93,171,63,93,43,78,12,18,25,106,171
2008-01-14 00:00:00.000,Australian Open Australia Grand Slams,HARD,3,Rainer Schuettler,Arnaud Clement,Rainer Schuettler,6-4; 6-2; 6-7(3); 6-4,R128,192,4,5,83,124,51,83,28,41,8,11,20,79,124,3,4,89,142,56,89,25,53,8,15,20,81,142
2008-01-14 00:00:00.000,Australian Open Australia Grand Slams,HARD,3,Florent Serra,Florian Mayer,Florent Serra,6-3; 7-6(2); 7-6(5),R128,124,2,3,56,101,41,56,28,45,6,10,16,69,101,8,3,87,133,55,87,21,46,8,14,17,76,133
2008-01-14 00:00:00.000,Australian Open Australia Grand Slams,HARD,3,Rafael Nadal,Viktor Troicki,Rafael Nadal,7-6(3); 7-5; 6-1,R128,154,4,4,58,95,39,58,28,37,3,5,16,67,95,14,2,66,97,47,66,10,31,7,12,15,57,97
2008-01-14 00:00:00.000,Australian Open Australia Grand Slams,HARD,3,Roger Federer,Fabrice Santoro,Roger Federer,6-1; 6-2; 6-0,R64,80,6,1,42,61,32,42,15,19,2,2,11,47,61,2,0,45,69,20,45,9,24,7,14,10,29,69
2008-01-14 00:00:00.000,Australian Open Australia Grand Slams,HARD,3,Janko Tipsarevic,Fernando Verdasco,Janko Tipsarevic,7-5; 7-6(3); 7-6(3),R64,160,8,2,72,111,55,72,23,39,0,3,18,78,111,15,6,80,110,57,80,13,30,2,6,18,70,110
2008-01-14 00:00:00.000,Australian Open Australia Grand Slams,HARD,3,Juan Monaco,Amer Delic,Juan Monaco,6-3; 7-6(6); 5-7; 6-7(8); 8-6,R64,251,4,7,145,195,100,145,29,50,9,14,30,129,195,17,12,107,192,81,107,41,85,10,16,29,122,192
2008-01-14 00:00:00.000,Australian Open Australia Grand Slams,HARD,3,Tomas Berdych,Oscar Hernandez,Tomas Berdych,6-2; 6-1; 6-3,R64,91,9,4,39,65,35,39,14,26,2,2,12,49,65,1,2,48,71,31,48,6,23,5,11,12,37,71
2008-01-14 00:00:00.000,Australian Open Australia Grand Slams,HARD,3,James Blake,Michael Russell,James Blake,6-3; 6-2; 6-2,R64,84,8,3,41,69,33,41,17,28,0,1,13,50,69,2,2,50,72,24,50,12,22,4,10,12,36,72
2008-01-14 00:00:00.000,Australian Open Australia Grand Slams,HARD,3,Sebastien Grosjean,Robin Haase,Sebastien Grosjean,4-6; 6-4; 6-0; 6-7(4); 6-4,R64,181,7,2,84,132,63,84,30,48,2,5,24,93,132,5,3,77,138,55,77,31,61,4,11,24,86,138
2008-01-14 00:00:00.000,Australian Open Australia Grand Slams,HARD,3,Marin Cilic,Jurgen Melzer,Marin Cilic,6-4; 6-3; 6-4,R64,116,7,1,49,92,35,49,29,43,1,2,15,64,92,3,2,66,93,34,66,19,27,7,11,14,53,93
2008-01-14 00:00:00.000,Australian Open Australia Grand Slams,HARD,3,Fernando Gonzalez,Hyung-Taik Lee,Fernando Gonzalez,4-6; 6-3; 6-2; 6-4,R64,156,15,4,74,125,47,74,28,51,8,12,19,75,125,5,4,70,116,44,70,21,46,10,17,18,65,116
2008-01-14 00:00:00.000,Australian Open Australia Grand Slams,HARD,3,Novak Djokovic,Simone Bolelli,Novak Djokovic,6-1; 6-2; 6-2,R64,92,12,3,45,73,34,45,18,28,2,2,12,52,73,5,2,38,64,19,38,11,26,2,8,11,30,64
2008-01-14 00:00:00.000,Australian Open Australia Grand Slams,HARD,3,Sam Querrey,Dmitry Tursunov,Sam Querrey,7-6(5); 4-6; 6-4; 6-2,R64,193,13,6,72,132,56,72,29,60,5,8,20,85,132,7,7,81,146,54,81,30,65,3,8,20,84,146
2008-01-14 00:00:00.000,Australian Open Australia Grand Slams,HARD,3,Lleyton Hewitt,Denis Istomin,Lleyton Hewitt,7-6(5); 6-3; 5-7; 6-1,R64,184,13,2,71,123,47,71,36,52,9,12,20,83,123,9,1,74,134,52,74,25,60,6,12,20,77,134
2008-01-14 00:00:00.000,Australian Open Australia Grand Slams,HARD,3,Marcos Baghdatis,Marat Safin,Marcos Baghdatis,6-4; 6-4; 2-6; 3-6; 6-2,R64,192,4,4,80,134,59,80,29,54,3,7,22,88,134,12,0,84,149,57,84,36,65,12,17,23,93,149
2008-01-14 00:00:00.000,Australian Open Australia Grand Slams,HARD,3,David Nalbandian,Peter Luczak,David Nalbandian,4-6; 7-5; 6-4; 6-1,R64,160,19,5,69,113,57,69,25,44,2,3,20,82,113,15,3,76,119,56,76,20,43,3,7,19,76,119
2008-01-14 00:00:00.000,Australian Open Australia Grand Slams,HARD,3,Juan Carlos Ferrero,Alun Jones,Juan Carlos Ferrero,6-4; 6-4; 6-2,R64,107,7,1,55,87,42,55,18,32,8,9,14,60,87,3,2,45,78,31,45,16,33,3,8,14,47,78
2008-01-14 00:00:00.000,Australian Open Australia Grand Slams,HARD,3,Vincent Spadea,Denis Gremelmayr,Vincent Spadea,4-6; 6-2; 6-3; 2-6; 9-7,R64,227,2,1,119,178,81,119,29,59,16,22,26,110,178,8,7,88,169,60,88,39,81,12,19,25,99,169
2008-01-14 00:00:00.000,Australian Open Australia Grand Slams,HARD,3,David Ferrer,Juan Martin Del Potro,David Ferrer,6-3; 6-4 RET,R64,98,1,1,40,53,28,40,5,13,1,3,9,33,53,0,2,62,77,32,62,7,15,7,12,10,39,77
2008-01-14 00:00:00.000,Australian Open Australia Grand Slams,HARD,3,Richard Gasquet,Feliciano Lopez,Richard Gasquet,6-2; 6-1; 6-3,R64,88,8,1,41,59,32,41,16,18,0,0,12,48,59,3,5,55,86,28,55,14,31,5,11,12,42,86
2008-01-14 00:00:00.000,Australian Open Australia Grand Slams,HARD,3,Igor Andreev,Kristof Vliegen,Igor Andreev,7-5; 7-5; 6-2,R64,132,2,8,68,103,54,68,18,35,8,8,16,72,103,5,3,75,99,46,75,15,24,7,11,16,61,99
2008-01-14 00:00:00.000,Australian Open Australia Grand Slams,HARD,3,Guillermo Garcia-Lopez,Alejandro Falla,Guillermo Garcia-Lopez,6-4; 5-7; 6-4; 7-6(6),R64,212,5,6,79,137,59,79,26,58,6,11,22,85,137,5,7,114,178,67,114,34,64,16,22,22,101,178
2008-01-14 00:00:00.000,Australian Open Australia Grand Slams,HARD,3,Jo-Wilfried Tsonga,Sam Warburg,Jo-Wilfried Tsonga,6-4; 7-6(4); 6-2,R64,133,14,0,57,89,46,57,16,32,3,4,15,62,89,3,2,82,115,48,82,15,33,9,13,15,63,115
2008-01-14 00:00:00.000,Australian Open Australia Grand Slams,HARD,3,Mikhail Youzhny,Andreas Seppi,Mikhail Youzhny,4-6; 7-5; 6-3; 7-6(4),R64,199,8,6,91,146,68,91,28,55,8,12,22,96,146,6,3,65,124,48,65,30,59,7,12,21,78,124
2008-01-14 00:00:00.000,Australian Open Australia Grand Slams,HARD,3,Ivo Karlovic,Dudi Sela,Ivo Karlovic,6-7(5); 6-4; 6-3; 6-1,R64,165,15,1,77,122,63,77,22,45,4,4,19,85,122,0,1,89,128,52,89,28,39,8,13,19,80,128
2008-01-14 00:00:00.000,Australian Open Australia Grand Slams,HARD,3,Marc Gicquel,Stanislas Wawrinka,Marc Gicquel,6-2; 3-6; 7-6(5); 2-1 RET,R64,171,2,3,65,110,41,65,28,45,5,8,15,69,110,9,3,59,109,44,59,21,50,3,8,17,65,109
2008-01-14 00:00:00.000,Australian Open Australia Grand Slams,HARD,3,Nikolay Davydenko,Nicolas Mahut,Nikolay Davydenko,6-4; 6-0; 6-3,R64,113,3,2,70,91,43,70,8,21,7,11,13,51,91,3,7,50,75,23,50,8,25,4,13,12,31,75
2008-01-14 00:00:00.000,Australian Open Australia Grand Slams,HARD,3,Andy Roddick,Michael Berrer,Andy Roddick,6-2; 6-2; 6-4,R64,117,10,1,57,75,46,57,9,18,2,3,13,55,75,6,7,63,101,41,63,12,38,12,18,13,53,101
2008-01-14 00:00:00.000,Australian Open Australia Grand Slams,HARD,3,Philipp Kohlschreiber,Evgeny Korolev,Philipp Kohlschreiber,6-4; 6-2; 0-1 RET,R64,85,6,1,29,49,23,29,14,20,1,1,9,37,49,3,5,42,69,32,42,9,27,6,9,10,41,69
2008-01-14 00:00:00.000,Australian Open Australia Grand Slams,HARD,3,Jarkko Nieminen,Jesse Levine,Jarkko Nieminen,6-2; 7-5; 7-6(2),R64,143,4,7,74,102,52,74,9,28,5,10,16,61,102,7,6,68,123,40,68,22,55,15,23,16,62,123
2008-01-14 00:00:00.000,Australian Open Australia Grand Slams,HARD,3,Mardy Fish,Tommy Robredo,Mardy Fish,6-1; 6-2; 6-3,R64,94,4,5,40,70,33,40,15,30,2,3,12,48,70,1,5,52,82,27,52,12,30,7,14,12,39,82
2008-01-14 00:00:00.000,Australian Open Australia Grand Slams,HARD,3,Stefan Koubek,Agustin Calleri,Stefan Koubek,6-3; 7-6(6); 7-6(5),R64,133,3,2,76,119,54,76,29,43,5,6,17,83,119,6,4,53,100,40,53,29,47,2,4,16,69,100
2008-01-14 00:00:00.000,Australian Open Australia Grand Slams,HARD,3,Paul-Henri Mathieu,Paul Capdeville,Paul-Henri Mathieu,6-7(5); 6-0; 6-4; 6-4,R64,183,11,2,70,125,53,70,33,55,4,5,19,86,125,4,2,73,115,50,73,18,42,7,13,19,68,115
2008-01-14 00:00:00.000,Australian Open Australia Grand Slams,HARD,3,Gilles Simon,Rainer Schuettler,Gilles Simon,6-2; 6-2; 6-1,R64,88,4,2,51,70,37,51,12,19,2,2,11,49,70,1,1,47,75,25,47,13,28,10,17,12,38,75
2008-01-14 00:00:00.000,Australian Open Australia Grand Slams,HARD,3,Rafael Nadal,Florent Serra,Rafael Nadal,6-0; 6-2; 6-2,R64,92,9,1,48,67,37,48,8,19,1,3,11,45,67,0,2,45,63,22,45,3,18,5,14,11,25,63
2008-01-14 00:00:00.000,Australian Open Australia Grand Slams,HARD,3,Roger Federer,Janko Tipsarevic,Roger Federer,6-7(5); 7-6(1); 5-7; 6-1; 10-8,R32,265,39,1,107,167,95,107,33,60,0,3,31,128,167,12,6,106,207,75,106,58,101,16,21,30,133,207
2008-01-14 00:00:00.000,Australian Open Australia Grand Slams,HARD,3,Tomas Berdych,Juan Monaco,Tomas Berdych,3-6; 6-3; 7-6(5); 6-2,R32,153,15,7,83,116,63,83,15,33,3,6,19,78,116,10,2,95,130,63,95,15,35,4,9,19,78,130
2008-01-14 00:00:00.000,Australian Open Australia Grand Slams,HARD,3,James Blake,Sebastien Grosjean,James Blake,4-6; 2-6; 6-0; 7-6(5); 6-2,R32,185,10,3,92,167,60,92,41,75,14,20,22,101,167,4,2,81,137,53,81,26,56,6,14,22,79,137
2008-01-14 00:00:00.000,Australian Open Australia Grand Slams,HARD,3,Marin Cilic,Fernando Gonzalez,Marin Cilic,6-2; 6-7(4); 6-3; 6-1,R32,156,14,5,62,111,45,62,32,49,3,4,18,77,111,2,7,82,126,48,82,19,44,8,15,18,67,126
2008-01-14 00:00:00.000,Australian Open Australia Grand Slams,HARD,3,Novak Djokovic,Sam Querrey,Novak Djokovic,6-3; 6-1; 6-3,R32,94,5,1,46,62,35,46,13,16,3,4,12,48,62,8,5,57,92,35,57,11,35,7,14,13,46,92
2008-01-14 00:00:00.000,Australian Open Australia Grand Slams,HARD,3,Lleyton Hewitt,Marcos Baghdatis,Lleyton Hewitt,4-6; 7-5; 7-5; 6-7(4); 6-3,R32,283,9,6,95,168,72,95,36,73,9,14,27,108,168,28,8,108,206,81,108,40,98,15,23,28,121,206
2008-01-14 00:00:00.000,Australian Open Australia Grand Slams,HARD,3,Juan Carlos Ferrero,David Nalbandian,Juan Carlos Ferrero,6-1; 6-2; 6-3,R32,103,11,2,48,77,38,48,17,29,1,1,12,55,77,3,4,36,67,22,36,12,31,4,10,12,34,67
2008-01-14 00:00:00.000,Australian Open Australia Grand Slams,HARD,3,David Ferrer,Vincent Spadea,David Ferrer,6-3; 6-3; 6-2,R32,106,5,2,50,77,41,50,14,27,2,2,13,55,77,0,1,55,93,33,55,18,38,4,9,13,51,93
2008-01-14 00:00:00.000,Australian Open Australia Grand Slams,HARD,3,Richard Gasquet,Igor Andreev,Richard Gasquet,6-3; 6-2; 4-6; 6-4,R32,142,9,2,66,99,49,66,22,33,0,2,19,71,99,2,0,72,105,44,72,22,33,8,13,18,66,105
2008-01-14 00:00:00.000,Australian Open Australia Grand Slams,HARD,3,Jo-Wilfried Tsonga,Guillermo Garcia-Lopez,Jo-Wilfried Tsonga,6-3; 6-4; 6-2,R32,102,21,1,53,76,44,53,10,23,0,1,14,54,76,6,7,42,79,22,42,20,37,3,8,13,42,79
2008-01-14 00:00:00.000,Australian Open Australia Grand Slams,HARD,3,Mikhail Youzhny,Ivo Karlovic,Mikhail Youzhny,6-2; 6-4; 6-2,R32,94,4,1,50,68,41,50,13,18,2,2,13,54,68,11,1,46,71,28,46,12,25,1,6,13,40,71
2008-01-14 00:00:00.000,Australian Open Australia Grand Slams,HARD,3,Nikolay Davydenko,Marc Gicquel,Nikolay Davydenko,6-3; 6-2; 6-3,R32,139,2,1,58,89,38,58,18,31,4,6,13,56,89,7,0,62,95,38,62,10,33,6,13,13,48,95
2008-01-14 00:00:00.000,Australian Open Australia Grand Slams,HARD,3,Philipp Kohlschreiber,Andy Roddick,Philipp Kohlschreiber,6-4; 3-6; 7-6(9); 6-7(3); 8-6,R32,230,32,2,107,165,91,107,37,58,8,9,28,128,165,42,3,131,182,109,131,24,51,9,11,29,133,182
2008-01-14 00:00:00.000,Australian Open Australia Grand Slams,HARD,3,Jarkko Nieminen,Mardy Fish,Jarkko Nieminen,3-6; 7-6(4); 6-3; 6-1,R32,157,11,4,97,133,74,97,17,36,11,12,18,91,133,13,3,72,125,57,72,23,53,9,13,19,80,125
2008-01-14 00:00:00.000,Australian Open Australia Grand Slams,HARD,3,Paul-Henri Mathieu,Stefan Koubek,Paul-Henri Mathieu,4-6; 7-6(4); 2-6; 7-5; 8-6,R32,238,7,8,104,184,72,104,39,80,11,18,28,111,184,18,5,120,188,85,120,31,68,14,20,28,116,188
2008-01-14 00:00:00.000,Australian Open Australia Grand Slams,HARD,3,Rafael Nadal,Gilles Simon,Rafael Nadal,7-5; 6-2; 6-3,R32,145,7,1,51,86,38,51,22,35,5,6,14,60,86,5,0,67,109,42,67,18,42,11,17,15,60,109
2008-01-14 00:00:00.000,Australian Open Australia Grand Slams,HARD,3,Roger Federer,Tomas Berdych,Roger Federer,6-4; 7-6(7); 6-3,R16,117,11,1,59,94,44,59,26,35,2,3,16,70,94,7,4,54,96,41,54,20,42,4,7,15,61,96
2008-01-14 00:00:00.000,Australian Open Australia Grand Slams,HARD,3,James Blake,Marin Cilic,James Blake,6-3; 6-4; 6-4,R16,100,4,0,55,88,42,55,24,33,3,3,15,66,88,5,3,44,78,31,44,18,34,2,5,14,49,78
2008-01-14 00:00:00.000,Australian Open Australia Grand Slams,HARD,3,Novak Djokovic,Lleyton Hewitt,Novak Djokovic,7-5; 6-3; 6-3,R16,146,13,6,62,104,45,62,19,42,4,7,15,64,104,6,4,48,90,28,48,18,42,5,12,15,46,90
2008-01-14 00:00:00.000,Australian Open Australia Grand Slams,HARD,3,David Ferrer,Juan Carlos Ferrero,David Ferrer,7-5; 3-6; 6-4; 6-1,R16,185,6,0,89,120,62,89,13,31,12,16,19,75,120,3,7,93,142,60,93,17,49,15,22,19,77,142
2008-01-14 00:00:00.000,Australian Open Australia Grand Slams,HARD,3,Jo-Wilfried Tsonga,Richard Gasquet,Jo-Wilfried Tsonga,6-2; 6-7(5); 7-6(6); 6-3,R16,195,19,2,88,134,73,88,23,46,7,8,20,96,134,5,4,92,151,64,92,29,59,7,12,21,93,151
2008-01-14 00:00:00.000,Australian Open Australia Grand Slams,HARD,3,Mikhail Youzhny,Nikolay Davydenko,Mikhail Youzhny,7-6(2); 6-3; 6-1,R16,144,5,2,53,87,40,53,17,34,3,6,14,57,87,2,1,58,94,34,58,15,36,2,9,14,49,94
2008-01-14 00:00:00.000,Australian Open Australia Grand Slams,HARD,3,Jarkko Nieminen,Philipp Kohlschreiber,Jarkko Nieminen,3-6; 7-6(7); 7-6(9); 6-3,R16,211,4,4,109,175,68,109,30,66,15,22,21,98,175,9,7,79,149,54,79,31,70,7,14,21,85,149
2008-01-14 00:00:00.000,Australian Open Australia Grand Slams,HARD,3,Rafael Nadal,Paul-Henri Mathieu,Rafael Nadal,6-4; 3-0 RET,R16,51,3,1,27,29,24,27,0,2,0,0,6,24,29,5,3,22,37,12,22,6,15,0,3,7,18,37
2008-01-14 00:00:00.000,Australian Open Australia Grand Slams,HARD,3,Roger Federer,James Blake,Roger Federer,7-5; 7-6(5); 6-4,Q,119,13,0,65,96,49,65,18,31,0,3,17,67,96,8,5,67,116,47,67,21,49,5,10,17,68,116
2008-01-14 00:00:00.000,Australian Open Australia Grand Slams,HARD,3,Novak Djokovic,David Ferrer,Novak Djokovic,6-0; 6-3; 7-5,Q,132,7,3,58,93,44,58,18,35,8,9,14,62,93,4,4,52,91,29,52,17,39,8,14,13,46,91
2008-01-14 00:00:00.000,Australian Open Australia Grand Slams,HARD,3,Jo-Wilfried Tsonga,Mikhail Youzhny,Jo-Wilfried Tsonga,7-5; 6-0; 7-6(6),Q,136,8,1,57,86,49,57,17,29,0,0,15,66,86,0,3,78,106,53,78,9,28,3,7,15,62,106
2008-01-14 00:00:00.000,Australian Open Australia Grand Slams,HARD,3,Rafael Nadal,Jarkko Nieminen,Rafael Nadal,7-5; 6-3; 6-1,Q,138,5,5,55,92,43,55,18,37,7,8,14,61,92,2,2,63,91,40,63,10,28,3,9,14,50,91
2008-01-14 00:00:00.000,Australian Open Australia Grand Slams,HARD,3,Novak Djokovic,Roger Federer,Novak Djokovic,7-5; 6-3; 7-6(5),S,146,13,6,77,113,60,77,15,36,7,9,17,75,113,10,2,68,109,48,68,18,41,7,11,16,66,109
2008-01-14 00:00:00.000,Australian Open Australia Grand Slams,HARD,3,Jo-Wilfried Tsonga,Rafael Nadal,Jo-Wilfried Tsonga,6-2; 6-3; 6-2,S,116,18,1,48,76,41,48,16,28,3,3,13,57,76,2,1,48,70,27,48,11,22,2,7,12,38,70
2008-01-14 00:00:00.000,Australian Open Australia Grand Slams,HARD,3,Novak Djokovic,Jo-Wilfried Tsonga,Novak Djokovic,4-6; 6-4; 6-3; 7-6(2),F,185,11,2,68,122,53,68,34,54,3,5,20,87,122,15,2,97,136,69,97,18,39,8,12,21,87,136
2008-01-28 00:00:00.000,ViÂ±a del Mar Chile ATP World Tour,CLAY,2,Fernando Gonzalez,Paul Capdeville,Fernando Gonzalez,7-5; 6-3,R32,75,5,2,38,57,28,38,9,19,1,4,11,37,57,1,3,46,63,26,46,6,17,2,7,10,32,63
2008-01-28 00:00:00.000,ViÂ±a del Mar Chile ATP World Tour,CLAY,2,Diego Hartfield,Mariano Zabaleta,Diego Hartfield,6-3; 7-5,R32,91,2,4,46,71,32,46,13,25,5,7,11,45,71,4,6,39,71,24,39,13,32,7,11,10,37,71
2008-01-28 00:00:00.000,ViÂ±a del Mar Chile ATP World Tour,CLAY,2,Carlos Berlocq,Nicolas Devilder,Carlos Berlocq,7-5; 6-2,R32,128,5,2,31,66,25,31,19,35,3,4,10,44,66,2,4,48,81,30,48,13,33,8,12,10,43,81
2008-01-28 00:00:00.000,ViÂ±a del Mar Chile ATP World Tour,CLAY,2,Luis Horna,Agustin Calleri,Luis Horna,6-4; 6-4,R32,82,2,2,41,57,35,41,9,16,4,4,10,44,57,10,2,38,66,31,38,10,28,2,4,10,41,66
2008-01-28 00:00:00.000,ViÂ±a del Mar Chile ATP World Tour,CLAY,2,Fernando Verdasco,Hans Podlipnik-Castillo,Fernando Verdasco,6-4; 6-3,R32,82,6,0,32,48,24,32,10,16,1,2,9,34,48,1,4,58,77,35,58,7,19,4,8,10,42,77
2008-01-28 00:00:00.000,ViÂ±a del Mar Chile ATP World Tour,CLAY,2,Pablo Cuevas,Guillermo Coria,Pablo Cuevas,6-4; 4-6; 6-3,R32,124,4,2,53,90,35,53,17,37,5,9,14,52,90,0,10,53,91,34,53,16,38,4,10,15,50,91
2008-01-28 00:00:00.000,ViÂ±a del Mar Chile ATP World Tour,CLAY,2,Daniel Gimeno-Traver,Eduardo Schwank,Daniel Gimeno-Traver,6-4; 1-6; 6-1,R32,79,4,0,37,55,27,37,14,18,0,2,12,41,55,0,0,41,58,31,41,9,17,2,5,12,40,58
2008-01-28 00:00:00.000,ViÂ±a del Mar Chile ATP World Tour,CLAY,2,Jose Acasuso,Peter Luczak,Jose Acasuso,6-2; 6-4,R32,86,6,2,27,60,25,27,18,33,4,4,9,43,60,4,2,28,56,21,28,12,28,6,9,9,33,56
2008-01-28 00:00:00.000,ViÂ±a del Mar Chile ATP World Tour,CLAY,2,Juan Pablo Brzezicki,Oscar Hernandez,Juan Pablo Brzezicki,7-6(4); 6-1,R32,123,1,3,43,68,24,43,15,25,2,6,10,39,68,1,5,36,61,20,36,7,25,0,6,9,27,61
2008-01-28 00:00:00.000,ViÂ±a del Mar Chile ATP World Tour,CLAY,2,Marcel Granollers,Boris Pashanski,Marcel Granollers,7-6(4); 6-2,R32,104,7,2,41,64,34,41,10,23,3,4,10,44,64,0,3,61,89,36,61,12,28,6,9,10,48,89
2008-01-28 00:00:00.000,ViÂ±a del Mar Chile ATP World Tour,CLAY,2,Martin Vassallo Arguello,Olivier Patience,Martin Vassallo Arguello,6-4; 6-1,R32,73,1,1,35,48,28,35,7,13,1,1,8,35,48,0,4,39,60,21,39,11,21,6,10,9,32,60
2008-01-28 00:00:00.000,ViÂ±a del Mar Chile ATP World Tour,CLAY,2,Juan Monaco,Nicolas Lapentti,Juan Monaco,2-6; 6-3; 6-4,R32,153,6,1,72,102,45,72,17,30,9,12,14,62,102,2,2,51,87,35,51,18,36,8,11,13,53,87
2008-01-28 00:00:00.000,ViÂ±a del Mar Chile ATP World Tour,CLAY,2,Sergio Roitman,Nicolas Massu,Sergio Roitman,6-7(3); 7-6(4); 6-3,R32,199,3,1,69,121,46,69,28,52,9,13,17,74,121,4,8,70,118,47,70,25,48,6,11,16,72,118
2008-01-28 00:00:00.000,ViÂ±a del Mar Chile ATP World Tour,CLAY,2,Santiago Ventura,Gaston Gaudio,Santiago Ventura,6-3; 6-0,R32,66,9,3,24,54,21,24,13,30,3,5,8,34,54,1,3,26,49,8,26,11,23,3,9,7,19,49
2008-01-28 00:00:00.000,ViÂ±a del Mar Chile ATP World Tour,CLAY,2,David Marrero,Adrian Garcia,David Marrero,6-7(2); 7-6(3); 6-4,R32,172,11,5,74,113,51,74,25,39,3,4,17,76,113,8,2,76,121,51,76,27,45,10,12,17,78,121
2008-01-28 00:00:00.000,ViÂ±a del Mar Chile ATP World Tour,CLAY,2,Fabio Fognini,Juan Ignacio Chela,Fabio Fognini,7-6(0); 6-2,R32,86,3,0,33,61,26,33,20,28,2,2,10,46,61,1,2,37,65,25,37,14,28,6,8,10,39,65
2008-01-28 00:00:00.000,ViÂ±a del Mar Chile ATP World Tour,CLAY,2,Fernando Gonzalez,Diego Hartfield,Fernando Gonzalez,6-3; 6-4,R16,67,6,6,38,64,29,38,12,26,2,4,10,41,64,1,1,29,47,15,29,11,18,1,5,9,26,47
2008-01-28 00:00:00.000,ViÂ±a del Mar Chile ATP World Tour,CLAY,2,Carlos Berlocq,Luis Horna,Carlos Berlocq,7-6(3); 3-6; 7-6(3),R16,184,12,2,58,110,41,58,31,52,4,8,16,72,110,3,1,86,111,61,86,10,25,5,8,17,71,111
2008-01-28 00:00:00.000,ViÂ±a del Mar Chile ATP World Tour,CLAY,2,Pablo Cuevas,Fernando Verdasco,Pablo Cuevas,7-5; 6-3,R16,87,4,1,46,75,33,46,19,29,6,6,11,52,75,1,6,38,63,26,38,15,25,3,5,10,41,63
2008-01-28 00:00:00.000,ViÂ±a del Mar Chile ATP World Tour,CLAY,2,Jose Acasuso,Daniel Gimeno-Traver,Jose Acasuso,6-2; 6-2,R16,60,1,0,31,41,26,31,6,10,0,0,8,32,41,3,4,37,62,25,37,7,25,7,11,8,32,62
2008-01-28 00:00:00.000,ViÂ±a del Mar Chile ATP World Tour,CLAY,2,Juan Pablo Brzezicki,Marcel Granollers,Juan Pablo Brzezicki,6-2; 6-2,R16,88,1,0,29,49,23,29,12,20,1,1,8,35,49,1,2,32,67,15,32,19,35,11,15,8,34,67
2008-01-28 00:00:00.000,ViÂ±a del Mar Chile ATP World Tour,CLAY,2,Juan Monaco,Martin Vassallo Arguello,Juan Monaco,6-3; 4-6; 7-5,R16,165,7,2,64,106,45,64,21,42,9,12,16,66,106,1,2,70,106,43,70,18,36,5,9,15,61,106
2008-01-28 00:00:00.000,ViÂ±a del Mar Chile ATP World Tour,CLAY,2,Santiago Ventura,Sergio Roitman,Santiago Ventura,4-6; 6-3; 7-6(4),R16,138,2,6,49,97,34,49,18,48,8,15,16,52,97,6,1,59,98,29,59,22,39,7,14,15,51,98
2008-01-28 00:00:00.000,ViÂ±a del Mar Chile ATP World Tour,CLAY,2,Fabio Fognini,David Marrero,Fabio Fognini,6-4; 6-7(5); 6-3,R16,132,9,4,52,104,41,52,31,52,7,8,16,72,104,4,1,64,103,42,64,22,39,8,11,15,64,103
2008-01-28 00:00:00.000,ViÂ±a del Mar Chile ATP World Tour,CLAY,2,Fernando Gonzalez,Carlos Berlocq,Fernando Gonzalez,7-5; 6-0,Q,83,4,1,37,57,26,37,14,20,3,3,9,40,57,1,4,42,64,27,42,7,22,3,7,9,34,64
2008-01-28 00:00:00.000,ViÂ±a del Mar Chile ATP World Tour,CLAY,2,Pablo Cuevas,Jose Acasuso,Pablo Cuevas,6-3; 6-3,Q,91,5,2,45,71,32,45,12,26,3,4,9,44,71,5,4,39,73,24,39,13,34,12,16,9,37,73
2008-01-28 00:00:00.000,ViÂ±a del Mar Chile ATP World Tour,CLAY,2,Juan Monaco,Juan Pablo Brzezicki,Juan Monaco,6-2; 6-3,Q,84,3,0,27,53,22,27,14,26,1,2,9,36,53,1,2,41,66,23,41,10,25,10,14,8,33,66
2008-01-28 00:00:00.000,ViÂ±a del Mar Chile ATP World Tour,CLAY,2,Santiago Ventura,Fabio Fognini,Santiago Ventura,6-3; 6-3,Q,80,6,1,30,52,24,30,14,22,1,1,9,38,52,2,1,39,69,26,39,13,30,5,8,9,39,69
2008-01-28 00:00:00.000,ViÂ±a del Mar Chile ATP World Tour,CLAY,2,Fernando Gonzalez,Pablo Cuevas,Fernando Gonzalez,6-7(4); 7-6(6); 6-2,S,168,10,2,61,107,44,61,26,46,7,10,16,70,107,4,1,80,115,50,80,17,35,2,7,16,67,115
2008-01-28 00:00:00.000,ViÂ±a del Mar Chile ATP World Tour,CLAY,2,Juan Monaco,Santiago Ventura,Juan Monaco,6-2; 6-4,S,75,1,1,33,52,23,33,12,19,2,3,9,35,52,5,3,27,57,21,27,10,30,3,7,9,31,57
2008-01-28 00:00:00.000,ViÂ±a del Mar Chile ATP World Tour,CLAY,2,Fernando Gonzalez,Juan Monaco,Fernando Gonzalez,W/O,F,0,0,0,0,0,0,0,0,0,0,0,0,0,0,0,0,0,0,0,0,0,0,0,0,0,0,0
2008-02-11 00:00:00.000,Costa Do Sauipe Brazil ATP World Tour,CLAY,2,Carlos Moya,Santiago Ventura,Carlos Moya,6-4; 4-6; 6-4,R32,149,3,4,52,95,39,52,27,43,2,3,15,66,95,4,9,53,107,39,53,29,54,5,7,15,68,107
2008-02-11 00:00:00.000,Costa Do Sauipe Brazil ATP World Tour,CLAY,2,Olivier Patience,Juan Pablo Brzezicki,Olivier Patience,6-3; 7-5,R32,84,8,0,39,58,29,39,7,19,1,5,11,36,58,3,2,37,58,18,37,9,21,1,7,10,27,58
2008-02-11 00:00:00.000,Costa Do Sauipe Brazil ATP World Tour,CLAY,2,Oscar Hernandez,Pablo Cuevas,Oscar Hernandez,7-6(5); 6-4,R32,100,2,5,45,69,34,45,11,24,1,3,11,45,69,6,1,41,67,28,41,14,26,1,4,11,42,67
2008-02-11 00:00:00.000,Costa Do Sauipe Brazil ATP World Tour,CLAY,2,Sergio Roitman,Agustin Calleri,Sergio Roitman,6-3; 6-2,R32,62,10,1,30,50,25,30,11,20,0,0,9,36,50,5,2,29,46,20,29,6,17,2,5,8,26,46
2008-02-11 00:00:00.000,Costa Do Sauipe Brazil ATP World Tour,CLAY,2,Eduardo Schwank,Igor Andreev,Eduardo Schwank,6-3; 6-2,R32,72,2,1,32,44,27,32,9,12,0,0,9,36,44,0,1,37,53,23,37,7,16,3,6,8,30,53
2008-02-11 00:00:00.000,Costa Do Sauipe Brazil ATP World Tour,CLAY,2,Peter Luczak,Marcos Daniel,Peter Luczak,7-5; 6-4,R32,96,5,1,38,65,28,38,17,27,3,4,11,45,65,5,4,34,67,23,34,17,33,3,6,11,40,67
2008-02-11 00:00:00.000,Costa Do Sauipe Brazil ATP World Tour,CLAY,2,Nicolas Lapentti,Thomaz Bellucci,Nicolas Lapentti,6-2; 6-2,R32,85,2,0,26,39,23,26,10,13,0,0,8,33,39,11,5,41,75,27,41,11,34,11,15,8,38,75
2008-02-11 00:00:00.000,Costa Do Sauipe Brazil ATP World Tour,CLAY,2,Sebastian Decoud,Jose Acasuso,Sebastian Decoud,6-3; 1-6; 7-6(3),R32,158,3,3,64,93,42,64,15,29,8,11,14,57,93,11,4,61,97,43,61,17,36,7,9,14,60,97
2008-02-11 00:00:00.000,Costa Do Sauipe Brazil ATP World Tour,CLAY,2,Albert Montanes,Nicolas Devilder,Albert Montanes,6-4; 6-4,R32,95,8,6,37,71,30,37,18,34,4,5,10,48,71,3,2,27,60,22,27,14,33,4,7,10,36,60
2008-02-11 00:00:00.000,Costa Do Sauipe Brazil ATP World Tour,CLAY,2,Fabio Fognini,Jiri Vanek,Fabio Fognini,6-3; 6-7(4); 7-6(3),R32,163,5,8,68,133,49,68,29,65,6,10,17,78,133,7,4,59,117,38,59,25,58,7,12,16,63,117
2008-02-11 00:00:00.000,Costa Do Sauipe Brazil ATP World Tour,CLAY,2,Carlos Berlocq,Gustavo Kuerten,Carlos Berlocq,7-5; 6-1,R32,80,8,1,32,49,26,32,11,17,1,2,10,37,49,3,4,35,56,22,35,8,21,2,6,9,30,56
2008-02-11 00:00:00.000,Costa Do Sauipe Brazil ATP World Tour,CLAY,2,Ivo Minar,Potito Starace,Ivo Minar,6-4; 4-6; 6-2,R32,129,4,2,38,75,29,38,22,37,7,10,14,51,75,1,3,54,81,36,54,12,27,8,13,14,48,81
2008-02-11 00:00:00.000,Costa Do Sauipe Brazil ATP World Tour,CLAY,2,Filippo Volandri,Daniel Munoz-De La Nava,Filippo Volandri,6-2; 6-4,R32,84,0,1,40,56,23,40,10,16,4,7,9,33,56,0,1,33,59,18,33,8,26,6,12,9,26,59
2008-02-11 00:00:00.000,Costa Do Sauipe Brazil ATP World Tour,CLAY,2,Guillermo Coria,Francesco Aldi,Guillermo Coria,6-4; 7-5,R32,117,0,16,48,77,25,48,12,29,8,14,11,37,77,0,8,43,65,19,43,8,22,5,13,11,27,65
2008-02-11 00:00:00.000,Costa Do Sauipe Brazil ATP World Tour,CLAY,2,Boris Pashanski,Martin Vassallo Arguello,Boris Pashanski,6-4; 6-4,R32,108,1,4,39,65,25,39,11,26,4,8,10,36,65,0,1,35,59,17,35,11,24,3,9,10,28,59
2008-02-11 00:00:00.000,Costa Do Sauipe Brazil ATP World Tour,CLAY,2,Nicolas Almagro,Nicolas Massu,Nicolas Almagro,6-3; 6-2,R32,64,10,1,34,46,27,34,7,12,1,2,9,34,46,2,4,20,46,14,20,9,26,1,5,8,23,46
2008-02-11 00:00:00.000,Costa Do Sauipe Brazil ATP World Tour,CLAY,2,Carlos Moya,Olivier Patience,Carlos Moya,5-7; 6-1; 6-0,R16,97,10,2,43,72,37,43,13,29,1,2,12,50,72,3,2,54,81,33,54,10,27,5,11,13,43,81
2008-02-11 00:00:00.000,Costa Do Sauipe Brazil ATP World Tour,CLAY,2,Oscar Hernandez,Sergio Roitman,Oscar Hernandez,6-3; 2-6; 6-4,R16,161,1,4,77,110,47,77,13,33,12,17,14,60,110,3,3,55,88,36,55,13,33,5,10,13,49,88
2008-02-11 00:00:00.000,Costa Do Sauipe Brazil ATP World Tour,CLAY,2,Eduardo Schwank,Peter Luczak,Eduardo Schwank,6-2; 6-2,R16,82,5,2,41,54,26,41,8,13,3,5,8,34,54,3,5,28,58,16,28,10,30,2,8,8,26,58
2008-02-11 00:00:00.000,Costa Do Sauipe Brazil ATP World Tour,CLAY,2,Nicolas Lapentti,Sebastian Decoud,Nicolas Lapentti,6-1; 6-2,R16,79,2,0,35,42,26,35,5,7,0,1,8,31,42,0,2,37,47,19,37,1,10,4,9,7,20,47
2008-02-11 00:00:00.000,Costa Do Sauipe Brazil ATP World Tour,CLAY,2,Fabio Fognini,Albert Montanes,Fabio Fognini,7-5; 6-3,R16,98,4,2,28,68,22,28,22,40,7,9,11,44,68,1,9,43,75,27,43,14,32,9,13,10,41,75
2008-02-11 00:00:00.000,Costa Do Sauipe Brazil ATP World Tour,CLAY,2,Ivo Minar,Carlos Berlocq,Ivo Minar,6-4; 6-4,R16,93,4,1,37,65,25,37,18,28,2,3,10,43,65,3,1,35,62,20,35,16,27,2,5,10,36,62
2008-02-11 00:00:00.000,Costa Do Sauipe Brazil ATP World Tour,CLAY,2,Filippo Volandri,Guillermo Coria,Filippo Volandri,6-1; 6-2,R16,51,0,1,27,36,20,27,6,9,2,4,8,26,36,0,7,25,42,10,25,3,17,4,10,7,13,42
2008-02-11 00:00:00.000,Costa Do Sauipe Brazil ATP World Tour,CLAY,2,Nicolas Almagro,Boris Pashanski,Nicolas Almagro,6-2; 6-3,R16,79,8,1,22,41,21,22,12,19,2,2,8,33,41,5,4,46,77,28,46,12,31,7,11,9,40,77
2008-02-11 00:00:00.000,Costa Do Sauipe Brazil ATP World Tour,CLAY,2,Carlos Moya,Oscar Hernandez,Carlos Moya,6-3; 3-6; 7-5,Q,143,2,1,71,102,45,71,16,31,6,9,15,61,102,0,4,72,88,47,72,7,16,3,7,15,54,88
2008-02-11 00:00:00.000,Costa Do Sauipe Brazil ATP World Tour,CLAY,2,Nicolas Lapentti,Eduardo Schwank,Nicolas Lapentti,1-6; 6-4; 7-6(4),Q,172,2,3,66,98,47,66,13,32,4,8,15,60,98,4,4,71,103,47,71,17,32,7,9,14,64,103
2008-02-11 00:00:00.000,Costa Do Sauipe Brazil ATP World Tour,CLAY,2,Fabio Fognini,Ivo Minar,Fabio Fognini,6-7(2); 6-2; 6-3,Q,118,8,2,50,93,45,50,22,43,2,2,15,67,93,7,1,49,88,37,49,19,39,5,8,14,56,88
2008-02-11 00:00:00.000,Costa Do Sauipe Brazil ATP World Tour,CLAY,2,Nicolas Almagro,Filippo Volandri,Nicolas Almagro,7-5; 2-6; 6-1,Q,107,5,3,45,82,33,45,16,37,4,8,14,49,82,1,1,70,83,40,70,5,13,4,9,13,45,83
2008-02-11 00:00:00.000,Costa Do Sauipe Brazil ATP World Tour,CLAY,2,Carlos Moya,Nicolas Lapentti,Carlos Moya,6-2; 3-6; 7-6(5),S,160,5,1,54,82,41,54,18,28,0,2,14,59,82,0,3,64,98,43,64,18,34,9,12,15,61,98
2008-02-11 00:00:00.000,Costa Do Sauipe Brazil ATP World Tour,CLAY,2,Nicolas Almagro,Fabio Fognini,Nicolas Almagro,6-1; 6-1,S,55,5,1,20,41,17,20,15,21,3,3,7,32,41,1,6,24,43,15,24,1,19,2,7,7,16,43
2008-02-11 00:00:00.000,Costa Do Sauipe Brazil ATP World Tour,CLAY,2,Nicolas Almagro,Carlos Moya,Nicolas Almagro,7-6(4); 3-6; 7-5,F,147,3,0,84,108,56,84,15,24,4,8,17,71,108,6,2,70,109,48,70,20,39,9,12,16,68,109
2008-02-11 00:00:00.000,Delray Beach FL; U.S.A. ATP World Tour,HARD,2,James Blake,Robert Kendrick,James Blake,7-5; 7-5,R32,82,5,4,47,79,33,47,18,32,3,5,12,51,79,11,4,35,68,27,35,15,33,6,10,12,42,68
2008-02-11 00:00:00.000,Delray Beach FL; U.S.A. ATP World Tour,HARD,2,Paul Capdeville,Clint Bowles,Paul Capdeville,6-2; 6-4,R32,64,1,2,31,48,19,31,9,17,1,4,9,28,48,0,1,42,60,22,42,6,18,4,10,9,28,60
2008-02-11 00:00:00.000,Delray Beach FL; U.S.A. ATP World Tour,HARD,2,Igor Kunitsyn,Benjamin Becker,Igor Kunitsyn,6-3; 7-6(1),R32,95,2,3,33,67,26,33,22,34,2,3,11,48,67,3,3,34,72,22,34,18,38,6,8,10,40,72
2008-02-11 00:00:00.000,Delray Beach FL; U.S.A. ATP World Tour,HARD,2,Max Mirnyi,Luka Gregorc,Max Mirnyi,7-6(5); 6-2,R32,92,10,1,41,58,35,41,11,17,0,0,10,46,58,4,7,52,81,36,52,13,29,4,6,10,49,81
2008-02-11 00:00:00.000,Delray Beach FL; U.S.A. ATP World Tour,HARD,2,Michael Russell,Alex Bogomolov Jr.,Michael Russell,6-1; 6-0,R32,50,3,0,33,45,26,33,7,12,3,3,7,33,45,0,3,25,38,10,25,4,13,3,8,6,14,38
2008-02-11 00:00:00.000,Delray Beach FL; U.S.A. ATP World Tour,HARD,2,Robby Ginepri,Mathieu Montcourt,Robby Ginepri,6-3; 6-0,R32,45,5,1,23,34,20,23,8,11,0,0,7,28,34,1,4,26,44,14,26,5,18,3,8,8,19,44
2008-02-11 00:00:00.000,Delray Beach FL; U.S.A. ATP World Tour,HARD,2,Ivan Navarro,Florent Serra,Ivan Navarro,6-3; 3-6; 6-3,R32,106,16,5,49,83,36,49,22,34,1,2,14,58,83,3,1,47,79,33,47,19,32,5,7,13,52,79
2008-02-11 00:00:00.000,Delray Beach FL; U.S.A. ATP World Tour,HARD,2,Mardy Fish,Marco Crugnola,Mardy Fish,6-1; 7-5,R32,64,5,0,23,49,19,23,21,26,0,0,10,40,49,1,5,29,52,19,29,10,23,4,7,9,29,52
2008-02-11 00:00:00.000,Delray Beach FL; U.S.A. ATP World Tour,HARD,2,Vincent Spadea,Denis Gremelmayr,Vincent Spadea,6-3; 6-4,R32,95,1,0,36,62,24,36,16,26,4,5,10,40,62,4,3,50,88,28,50,19,38,12,15,9,47,88
2008-02-11 00:00:00.000,Delray Beach FL; U.S.A. ATP World Tour,HARD,2,Gilles Muller,Jesse Levine,Gilles Muller,7-5; 7-6(4),R32,95,10,0,42,69,33,42,17,27,1,2,12,50,69,2,5,45,75,27,45,17,30,2,4,12,44,75
2008-02-11 00:00:00.000,Delray Beach FL; U.S.A. ATP World Tour,HARD,2,Guillermo Garcia-Lopez,Wayne Odesnik,Guillermo Garcia-Lopez,6-4; 6-2,R32,87,2,8,37,74,24,37,18,37,8,10,9,42,74,2,5,31,64,19,31,13,33,6,11,9,32,64
2008-02-11 00:00:00.000,Delray Beach FL; U.S.A. ATP World Tour,HARD,2,Sam Querrey,Yuri Schukin,Sam Querrey,6-1; 6-4,R32,63,12,1,33,49,30,33,7,16,3,3,9,37,49,3,5,32,65,21,32,14,33,9,12,8,35,65
2008-02-11 00:00:00.000,Delray Beach FL; U.S.A. ATP World Tour,HARD,2,Kei Nishikori,Florian Mayer,Kei Nishikori,6-0; 4-3 RET,R32,45,2,0,27,39,17,27,8,12,2,3,6,25,39,2,3,25,48,14,25,6,23,4,9,7,20,48
2008-02-11 00:00:00.000,Delray Beach FL; U.S.A. ATP World Tour,HARD,2,Amer Delic,Donald Young,Amer Delic,7-6(7); 6-3,R32,83,3,5,42,72,32,42,14,30,5,8,11,46,72,3,6,49,79,30,49,13,30,3,7,10,43,79
2008-02-11 00:00:00.000,Delray Beach FL; U.S.A. ATP World Tour,HARD,2,Bobby Reynolds,Xavier Malisse,Bobby Reynolds,6-2; 4-6; 6-3,R32,116,9,7,50,112,37,50,32,62,15,17,14,69,112,5,3,37,78,28,37,18,41,4,8,13,46,78
2008-02-11 00:00:00.000,Delray Beach FL; U.S.A. ATP World Tour,HARD,2,Diego Hartfield,Tommy Haas,Diego Hartfield,6-2; 3-6; 6-2,R32,116,3,3,46,77,29,46,19,31,6,8,12,48,77,5,4,50,94,32,50,20,44,12,17,13,52,94
2008-02-11 00:00:00.000,Delray Beach FL; U.S.A. ATP World Tour,HARD,2,James Blake,Paul Capdeville,James Blake,6-1; 6-4,R16,58,5,2,40,61,30,40,10,21,7,8,9,40,61,1,3,30,51,15,30,9,21,1,5,8,24,51
2008-02-11 00:00:00.000,Delray Beach FL; U.S.A. ATP World Tour,HARD,2,Igor Kunitsyn,Max Mirnyi,Igor Kunitsyn,7-6(4); 6-3,R16,96,2,1,46,72,37,46,15,26,3,3,11,52,72,9,1,54,76,36,54,13,22,6,7,10,49,76
2008-02-11 00:00:00.000,Delray Beach FL; U.S.A. ATP World Tour,HARD,2,Robby Ginepri,Michael Russell,Robby Ginepri,7-5; 4-6; 6-2,R16,152,8,7,61,117,38,61,27,56,9,14,15,65,117,2,9,71,112,41,71,16,41,8,15,15,57,112
2008-02-11 00:00:00.000,Delray Beach FL; U.S.A. ATP World Tour,HARD,2,Mardy Fish,Ivan Navarro,Mardy Fish,2-6; 7-5; 6-3,R16,147,11,3,57,113,37,57,23,56,10,16,15,60,113,6,6,43,87,27,43,22,44,3,9,14,49,87
2008-02-11 00:00:00.000,Delray Beach FL; U.S.A. ATP World Tour,HARD,2,Vincent Spadea,Gilles Muller,Vincent Spadea,7-5; 4-6; 6-3,R16,116,8,1,59,94,42,59,22,35,3,5,16,64,94,15,3,57,98,45,57,19,41,3,6,15,64,98
2008-02-11 00:00:00.000,Delray Beach FL; U.S.A. ATP World Tour,HARD,2,Sam Querrey,Guillermo Garcia-Lopez,Sam Querrey,6-4; 5-7; 6-4,R16,129,9,5,67,113,45,67,23,46,10,13,16,68,113,3,9,54,96,39,54,20,42,3,7,16,59,96
2008-02-11 00:00:00.000,Delray Beach FL; U.S.A. ATP World Tour,HARD,2,Kei Nishikori,Amer Delic,Kei Nishikori,6-7(7); 6-4; 6-2,R16,131,2,1,74,118,56,74,21,44,12,12,15,77,118,16,2,64,109,45,64,24,45,6,9,15,69,109
2008-02-11 00:00:00.000,Delray Beach FL; U.S.A. ATP World Tour,HARD,2,Bobby Reynolds,Diego Hartfield,Bobby Reynolds,7-5; 2-6; 7-6(3),R16,157,13,4,83,132,57,83,20,49,15,20,16,77,132,11,7,60,103,45,60,18,43,8,12,16,63,103
2008-02-11 00:00:00.000,Delray Beach FL; U.S.A. ATP World Tour,HARD,2,James Blake,Igor Kunitsyn,James Blake,6-2; 6-4,Q,80,2,2,34,64,27,34,10,30,7,10,9,37,64,0,5,36,64,18,36,10,28,7,13,9,28,64
2008-02-11 00:00:00.000,Delray Beach FL; U.S.A. ATP World Tour,HARD,2,Robby Ginepri,Mardy Fish,Robby Ginepri,6-1; 4-6; 6-4,Q,106,3,1,42,66,33,42,14,24,3,5,13,47,66,11,2,39,95,28,39,26,56,7,12,14,54,95
2008-02-11 00:00:00.000,Delray Beach FL; U.S.A. ATP World Tour,HARD,2,Sam Querrey,Vincent Spadea,Sam Querrey,6-2; 6-4,Q,57,10,1,33,48,27,33,9,15,0,0,9,36,48,0,3,28,49,20,28,8,21,2,5,9,28,49
2008-02-11 00:00:00.000,Delray Beach FL; U.S.A. ATP World Tour,HARD,2,Kei Nishikori,Bobby Reynolds,Kei Nishikori,6-2; 6-4,Q,65,3,1,30,51,24,30,11,21,2,3,9,35,51,3,1,31,54,20,31,8,23,5,9,9,28,54
2008-02-11 00:00:00.000,Delray Beach FL; U.S.A. ATP World Tour,HARD,2,James Blake,Robby Ginepri,James Blake,6-4; 6-4,S,72,9,2,36,63,27,36,14,27,1,3,10,41,63,4,1,44,64,28,44,7,20,4,8,10,35,64
2008-02-11 00:00:00.000,Delray Beach FL; U.S.A. ATP World Tour,HARD,2,Kei Nishikori,Sam Querrey,Kei Nishikori,4-6; 6-2; 7-6(7),S,113,6,3,57,95,45,57,19,38,1,3,15,64,95,10,2,55,88,46,55,14,33,1,4,15,60,88
2008-02-11 00:00:00.000,Delray Beach FL; U.S.A. ATP World Tour,HARD,2,Kei Nishikori,James Blake,Kei Nishikori,3-6; 6-1; 6-4,F,86,3,0,51,76,39,51,15,25,4,5,13,54,76,8,5,39,75,34,39,16,36,5,8,13,50,75
2008-02-11 00:00:00.000,Marseille France ATP World Tour,HARD,2,Novak Djokovic,Ivan Dodig,Novak Djokovic,6-1; 6-4,R32,70,7,2,25,49,20,25,17,24,0,0,9,37,49,1,0,30,53,21,30,8,23,2,5,8,29,53
2008-02-11 00:00:00.000,Marseille France ATP World Tour,HARD,2,Gilles Simon,David Guez,Gilles Simon,6-2; 6-4,R32,78,4,1,30,57,22,30,15,27,4,5,9,37,57,1,0,30,47,18,30,8,17,3,7,9,26,47
2008-02-11 00:00:00.000,Marseille France ATP World Tour,HARD,2,Michael Llodra,Andreas Seppi,Michael Llodra,6-2; 7-6(5),R32,83,12,2,42,68,33,42,17,26,4,4,10,50,68,5,1,39,63,30,39,13,24,3,5,10,43,63
2008-02-11 00:00:00.000,Marseille France ATP World Tour,HARD,2,Paul-Henri Mathieu,Marc Gicquel,Paul-Henri Mathieu,7-6(7); 7-6(4),R32,113,11,1,37,79,31,37,28,42,1,2,12,59,79,9,6,42,81,36,42,22,39,5,6,12,58,81
2008-02-11 00:00:00.000,Marseille France ATP World Tour,HARD,2,Andy Murray,Jesse Huta Galung,Andy Murray,6-4; 6-4,R32,72,7,2,29,55,23,29,14,26,4,6,10,37,55,4,2,32,59,23,32,10,27,3,7,10,33,59
2008-02-11 00:00:00.000,Marseille France ATP World Tour,HARD,2,Stanislas Wawrinka,Sebastien Grosjean,Stanislas Wawrinka,3-6; 6-4; 6-4,R32,134,5,1,65,103,44,65,21,38,3,5,15,65,103,5,1,46,78,37,46,18,32,4,6,14,55,78
2008-02-11 00:00:00.000,Marseille France ATP World Tour,HARD,2,Nicolas Mahut,Mikhail Elgin,Nicolas Mahut,6-3; 6-3,R32,66,5,0,31,50,28,31,10,19,0,0,9,38,50,6,3,36,60,24,36,11,24,3,6,9,35,60
2008-02-11 00:00:00.000,Marseille France ATP World Tour,HARD,2,Juan Carlos Ferrero,Hyung-Taik Lee,Juan Carlos Ferrero,6-4; 6-1,R32,87,7,0,37,53,27,37,6,16,5,6,8,33,53,2,5,59,95,35,59,12,36,13,18,9,47,95
2008-02-11 00:00:00.000,Marseille France ATP World Tour,HARD,2,Marcos Baghdatis,Arnaud Clement,Marcos Baghdatis,6-3; 6-4,R32,80,10,0,23,50,22,23,19,27,1,1,10,41,50,4,1,35,61,25,35,13,26,5,7,9,38,61
2008-02-11 00:00:00.000,Marseille France ATP World Tour,HARD,2,Ivo Karlovic,Feliciano Lopez,Ivo Karlovic,6-7(6); 7-5; 7-6(4),R32,131,33,2,73,101,66,73,17,28,0,0,18,83,101,13,1,78,113,63,78,21,35,2,3,18,84,113
2008-02-11 00:00:00.000,Marseille France ATP World Tour,HARD,2,Julien Benneteau,Andrei Pavel,Julien Benneteau,6-2; 1-0 RET,R32,41,6,1,12,22,12,12,8,10,0,0,5,20,22,2,0,16,27,11,16,3,11,0,2,4,14,27
2008-02-11 00:00:00.000,Marseille France ATP World Tour,HARD,2,Mikhail Youzhny,Marin Cilic,Mikhail Youzhny,6-4; 7-6(3),R32,112,8,0,49,76,34,49,19,27,2,2,11,53,76,10,2,41,71,33,41,12,30,2,3,11,45,71
2008-02-11 00:00:00.000,Marseille France ATP World Tour,HARD,2,Mario Ancic,Jo-Wilfried Tsonga,Mario Ancic,7-5; 7-6(3),R32,105,3,1,51,68,46,51,8,17,2,2,12,54,68,11,0,40,72,34,40,17,32,4,5,12,51,72
2008-02-11 00:00:00.000,Marseille France ATP World Tour,HARD,2,Teymuraz Gabashvili,Michael Berrer,Teymuraz Gabashvili,7-6(5); 6-4,R32,158,8,2,37,68,31,37,22,31,2,2,11,53,68,8,6,45,76,37,45,15,31,3,4,11,52,76
2008-02-11 00:00:00.000,Marseille France ATP World Tour,HARD,2,Robin Soderling,Jarkko Nieminen,Robin Soderling,6-3; 5-7; 7-5,R32,113,14,9,61,102,48,61,22,41,8,10,17,70,102,6,2,62,92,46,62,16,30,5,8,16,62,92
2008-02-11 00:00:00.000,Marseille France ATP World Tour,HARD,2,Richard Gasquet,Simone Bolelli,Richard Gasquet,6-3; 6-3,R32,70,17,1,29,48,27,29,9,19,0,0,9,36,48,5,2,40,61,27,40,8,21,6,9,9,35,61
2008-02-11 00:00:00.000,Marseille France ATP World Tour,HARD,2,Gilles Simon,Novak Djokovic,Gilles Simon,6-2; 6-7(6); 6-3,R16,127,8,3,60,107,43,60,32,47,6,6,15,75,107,5,3,52,81,40,52,14,29,2,5,14,54,81
2008-02-11 00:00:00.000,Marseille France ATP World Tour,HARD,2,Paul-Henri Mathieu,Michael Llodra,Paul-Henri Mathieu,7-6(4); 7-6(5),R16,114,3,4,38,74,30,38,26,36,0,1,12,56,74,23,3,46,84,34,46,23,38,4,5,12,57,84
2008-02-11 00:00:00.000,Marseille France ATP World Tour,HARD,2,Andy Murray,Stanislas Wawrinka,Andy Murray,3-6; 7-6(5); 6-1,R16,141,8,6,44,87,30,44,18,43,8,13,13,48,87,6,1,58,102,35,58,17,44,4,11,15,52,102
2008-02-11 00:00:00.000,Marseille France ATP World Tour,HARD,2,Nicolas Mahut,Juan Carlos Ferrero,Nicolas Mahut,5-7; 6-4; 7-6(1),R16,152,18,5,58,111,50,58,25,53,5,7,17,75,111,8,0,55,98,43,55,26,43,5,7,17,69,98
2008-02-11 00:00:00.000,Marseille France ATP World Tour,HARD,2,Marcos Baghdatis,Ivo Karlovic,Marcos Baghdatis,6-4; 6-4,R16,78,15,2,51,71,39,51,10,20,6,6,10,49,71,14,2,36,51,28,36,7,15,1,3,10,35,51
2008-02-11 00:00:00.000,Marseille France ATP World Tour,HARD,2,Mikhail Youzhny,Julien Benneteau,Mikhail Youzhny,7-5; 6-3,R16,93,6,3,38,71,29,38,21,33,7,7,11,50,71,4,2,31,52,23,31,12,21,1,3,10,35,52
2008-02-11 00:00:00.000,Marseille France ATP World Tour,HARD,2,Mario Ancic,Teymuraz Gabashvili,Mario Ancic,6-3; 6-2,R16,62,11,0,28,43,24,28,11,15,1,1,8,35,43,4,2,35,54,25,35,5,19,2,6,9,30,54
2008-02-11 00:00:00.000,Marseille France ATP World Tour,HARD,2,Robin Soderling,Richard Gasquet,Robin Soderling,4-6; 6-3; 6-2,R16,94,19,4,47,73,42,47,13,26,2,3,14,55,73,8,7,32,75,27,32,22,43,4,7,13,49,75
2008-02-11 00:00:00.000,Marseille France ATP World Tour,HARD,2,Paul-Henri Mathieu,Gilles Simon,Paul-Henri Mathieu,6-3; 6-4,Q,75,8,2,37,58,32,37,12,21,3,3,10,44,58,4,2,35,56,27,35,7,21,5,7,9,34,56
2008-02-11 00:00:00.000,Marseille France ATP World Tour,HARD,2,Andy Murray,Nicolas Mahut,Andy Murray,7-5; 7-6(5),Q,104,14,1,48,73,38,48,16,25,1,1,12,54,73,10,3,50,83,37,50,18,33,3,4,12,55,83
2008-02-11 00:00:00.000,Marseille France ATP World Tour,HARD,2,Marcos Baghdatis,Mikhail Youzhny,Marcos Baghdatis,7-6(2); 6-3,Q,102,7,2,40,68,31,40,19,28,1,1,10,50,68,5,0,49,74,38,49,11,25,8,10,11,49,74
2008-02-11 00:00:00.000,Marseille France ATP World Tour,HARD,2,Mario Ancic,Robin Soderling,Mario Ancic,6-3; 6-7(4); 6-2,Q,107,25,1,55,80,45,55,17,25,1,1,14,62,80,7,6,53,90,42,53,16,37,5,9,15,58,90
2008-02-11 00:00:00.000,Marseille France ATP World Tour,HARD,2,Andy Murray,Paul-Henri Mathieu,Andy Murray,6-2; 6-2,S,63,4,0,16,38,16,16,16,22,0,0,8,32,38,1,1,25,49,16,25,9,24,5,9,8,25,49
2008-02-11 00:00:00.000,Marseille France ATP World Tour,HARD,2,Mario Ancic,Marcos Baghdatis,Mario Ancic,6-4; 6-2,S,81,4,2,28,53,24,28,15,25,3,3,9,39,53,5,2,31,55,20,31,11,24,2,5,9,31,55
2008-02-11 00:00:00.000,Marseille France ATP World Tour,HARD,2,Andy Murray,Mario Ancic,Andy Murray,6-3; 6-4,F,113,11,1,40,79,33,40,17,39,9,10,10,50,79,4,1,39,59,24,39,8,20,5,8,9,32,59
2008-02-18 00:00:00.000,Buenos Aires Argentina ATP World Tour,CLAY,2,David Nalbandian,Peter Luczak,David Nalbandian,6-3; 6-3,R32,72,10,2,27,45,21,27,12,18,0,1,9,33,45,3,1,40,66,25,40,11,26,1,5,9,36,66
2008-02-18 00:00:00.000,Buenos Aires Argentina ATP World Tour,CLAY,2,Fabio Fognini,Eduardo Schwank,Fabio Fognini,6-2; 6-1,R32,72,0,2,36,44,26,36,4,8,6,7,7,30,44,0,3,28,57,15,28,10,29,2,8,8,25,57
2008-02-18 00:00:00.000,Buenos Aires Argentina ATP World Tour,CLAY,2,Juan Pablo Brzezicki,Nicolas Lapentti,Juan Pablo Brzezicki,6-3; 6-2,R32,81,1,1,38,53,30,38,7,15,4,5,9,37,53,0,0,26,50,15,26,11,24,5,9,8,26,50
2008-02-18 00:00:00.000,Buenos Aires Argentina ATP World Tour,CLAY,2,Potito Starace,Boris Pashanski,Potito Starace,6-1; 3-6; 6-4,R32,111,1,1,60,84,41,60,11,24,5,7,13,52,84,1,2,47,73,28,47,14,26,0,4,13,42,73
2008-02-18 00:00:00.000,Buenos Aires Argentina ATP World Tour,CLAY,2,Juan Ignacio Chela,Santiago Ventura,Juan Ignacio Chela,5-7; 6-3; 6-2,R32,136,2,6,55,86,40,55,14,31,2,5,14,54,86,2,6,63,108,39,63,18,45,10,16,15,57,108
2008-02-18 00:00:00.000,Buenos Aires Argentina ATP World Tour,CLAY,2,Thomaz Bellucci,Werner Eschauer,Thomaz Bellucci,6-4; 6-4,R32,89,3,1,35,58,27,35,14,23,1,2,10,41,58,2,4,37,60,23,37,11,23,4,7,10,34,60
2008-02-18 00:00:00.000,Buenos Aires Argentina ATP World Tour,CLAY,2,Oscar Hernandez,Eric Prodon,Oscar Hernandez,6-4; 6-3,R32,89,2,0,39,51,31,39,7,12,1,1,9,38,51,1,2,40,75,28,40,15,35,6,9,10,43,75
2008-02-18 00:00:00.000,Buenos Aires Argentina ATP World Tour,CLAY,2,Nicolas Almagro,Martin Vassallo Arguello,Nicolas Almagro,7-6(5); 7-6(2),R32,122,3,1,65,84,48,65,14,19,1,1,12,62,84,3,0,66,93,49,66,15,27,6,6,12,64,93
2008-02-18 00:00:00.000,Buenos Aires Argentina ATP World Tour,CLAY,2,Igor Andreev,Albert Montanes,Igor Andreev,6-3; 6-7(8); 7-6(4),R32,170,6,2,70,105,57,70,23,35,2,2,17,80,105,1,2,67,98,51,67,21,31,0,1,16,72,98
2008-02-18 00:00:00.000,Buenos Aires Argentina ATP World Tour,CLAY,2,Jiri Vanek,Carlos Berlocq,Jiri Vanek,6-4; 7-5,R32,92,4,3,35,58,29,35,11,23,3,5,11,40,58,1,1,39,61,22,39,13,22,4,8,11,35,61
2008-02-18 00:00:00.000,Buenos Aires Argentina ATP World Tour,CLAY,2,Daniel Gimeno-Traver,Ruben Ramirez Hidalgo,Daniel Gimeno-Traver,2-6; 6-1; 6-2,R32,109,6,2,36,64,24,36,18,28,1,3,11,42,64,0,7,40,74,26,40,14,34,7,12,12,40,74
2008-02-18 00:00:00.000,Buenos Aires Argentina ATP World Tour,CLAY,2,Jose Acasuso,Carlos Moya,Jose Acasuso,6-2; 6-4,R32,80,2,1,25,44,20,25,13,19,0,1,9,33,44,4,1,38,58,24,38,7,20,1,5,9,31,58
2008-02-18 00:00:00.000,Buenos Aires Argentina ATP World Tour,CLAY,2,Filippo Volandri,Nicolas Massu,Filippo Volandri,6-4; 6-2,R32,80,0,1,40,55,23,40,13,15,4,5,9,36,55,3,1,24,47,14,24,10,23,2,6,9,24,47
2008-02-18 00:00:00.000,Buenos Aires Argentina ATP World Tour,CLAY,2,Sergio Roitman,Ivo Minar,Sergio Roitman,4-0 RET,R32,31,2,1,6,13,4,6,5,7,0,0,2,9,13,0,1,6,14,2,6,2,8,0,2,2,4,14
2008-02-18 00:00:00.000,Buenos Aires Argentina ATP World Tour,CLAY,2,Luis Horna,Maximo Gonzalez,Luis Horna,6-4; 6-4,R32,93,2,0,49,60,37,49,5,11,3,4,10,42,60,1,1,39,73,26,39,16,34,7,10,10,42,73
2008-02-18 00:00:00.000,Buenos Aires Argentina ATP World Tour,CLAY,2,Agustin Calleri,Juan Monaco,Agustin Calleri,6-4; 2-6; 6-3,R32,144,2,6,57,111,39,57,20,54,8,13,13,59,111,0,3,67,100,39,67,15,33,3,9,14,54,100
2008-02-18 00:00:00.000,Buenos Aires Argentina ATP World Tour,CLAY,2,David Nalbandian,Fabio Fognini,David Nalbandian,7-6(5); 4-6; 6-3,R16,152,4,6,57,99,40,57,22,42,3,7,16,62,99,4,3,73,110,48,73,16,37,7,11,15,64,110
2008-02-18 00:00:00.000,Buenos Aires Argentina ATP World Tour,CLAY,2,Potito Starace,Juan Pablo Brzezicki,Potito Starace,6-3; 6-3,R16,79,0,0,38,54,29,38,12,16,0,0,9,41,54,1,0,27,46,20,27,10,19,2,5,9,30,46
2008-02-18 00:00:00.000,Buenos Aires Argentina ATP World Tour,CLAY,2,Juan Ignacio Chela,Thomaz Bellucci,Juan Ignacio Chela,6-4; 6-4,R16,74,0,3,29,52,24,29,14,23,1,2,10,38,52,1,1,35,52,21,35,11,17,0,3,10,32,52
2008-02-18 00:00:00.000,Buenos Aires Argentina ATP World Tour,CLAY,2,Nicolas Almagro,Oscar Hernandez,Nicolas Almagro,6-2; 2-6; 6-3,R16,128,7,1,67,98,46,67,15,31,11,13,13,61,98,0,2,44,68,26,44,16,24,3,6,12,42,68
2008-02-18 00:00:00.000,Buenos Aires Argentina ATP World Tour,CLAY,2,Igor Andreev,Jiri Vanek,Igor Andreev,6-1; 0-6; 6-4,R16,107,5,4,51,79,32,51,14,28,3,7,12,46,79,4,4,37,69,23,37,15,32,5,9,11,38,69
2008-02-18 00:00:00.000,Buenos Aires Argentina ATP World Tour,CLAY,2,Jose Acasuso,Daniel Gimeno-Traver,Jose Acasuso,6-3; 6-4,R16,79,2,1,40,58,32,40,11,18,1,1,10,43,58,1,2,26,48,19,26,13,22,1,3,9,32,48
2008-02-18 00:00:00.000,Buenos Aires Argentina ATP World Tour,CLAY,2,Filippo Volandri,Sergio Roitman,Filippo Volandri,7-5; 7-5,R16,105,1,1,69,85,42,69,9,16,11,14,12,51,85,4,2,47,77,28,47,13,30,6,11,12,41,77
2008-02-18 00:00:00.000,Buenos Aires Argentina ATP World Tour,CLAY,2,Agustin Calleri,Luis Horna,Agustin Calleri,3-6; 6-2; 6-2,R16,108,10,1,41,66,30,41,16,25,5,7,12,46,66,2,3,82,94,49,82,4,12,6,11,13,53,94
2008-02-18 00:00:00.000,Buenos Aires Argentina ATP World Tour,CLAY,2,David Nalbandian,Potito Starace,David Nalbandian,4-6; 7-6(5); 6-4,Q,157,6,6,52,105,38,52,28,53,3,7,16,66,105,1,1,100,108,63,100,3,8,6,10,16,66,108
2008-02-18 00:00:00.000,Buenos Aires Argentina ATP World Tour,CLAY,2,Juan Ignacio Chela,Nicolas Almagro,Juan Ignacio Chela,6-3; 2-1 RET,Q,65,3,0,29,50,18,29,13,21,5,6,6,31,50,2,0,19,40,9,19,11,21,0,3,6,20,40
2008-02-18 00:00:00.000,Buenos Aires Argentina ATP World Tour,CLAY,2,Jose Acasuso,Igor Andreev,Jose Acasuso,3-6; 6-1; 6-3,Q,125,4,1,45,78,28,45,21,33,3,5,12,49,78,4,2,74,93,46,74,6,19,4,9,13,52,93
2008-02-18 00:00:00.000,Buenos Aires Argentina ATP World Tour,CLAY,2,Filippo Volandri,Agustin Calleri,Filippo Volandri,6-4; 6-4,Q,81,1,0,62,84,41,62,12,22,11,11,10,53,84,9,0,44,56,33,44,4,12,2,4,10,37,56
2008-02-18 00:00:00.000,Buenos Aires Argentina ATP World Tour,CLAY,2,David Nalbandian,Juan Ignacio Chela,David Nalbandian,6-1; 6-2,S,58,1,2,21,41,16,21,16,20,0,0,8,32,41,3,4,18,39,9,18,8,21,1,5,7,17,39
2008-02-18 00:00:00.000,Buenos Aires Argentina ATP World Tour,CLAY,2,Jose Acasuso,Filippo Volandri,Jose Acasuso,4-6; 6-4; 6-4,S,143,6,3,53,89,39,53,15,36,3,7,15,54,89,0,5,87,100,53,87,4,13,8,13,15,57,100
2008-02-18 00:00:00.000,Buenos Aires Argentina ATP World Tour,CLAY,2,David Nalbandian,Jose Acasuso,David Nalbandian,3-6; 7-6(5); 6-4,F,163,2,2,59,98,40,59,24,39,4,7,15,64,98,6,1,51,104,36,51,29,53,2,5,16,65,104
2008-02-18 00:00:00.000,Rotterdam The Netherlands ATP World Tour,HARD,2,Rafael Nadal,Dmitry Tursunov,Rafael Nadal,6-4; 6-4,R32,84,2,1,35,52,29,35,11,17,0,0,10,40,52,9,2,29,62,24,29,16,33,1,3,10,40,62
2008-02-18 00:00:00.000,Rotterdam The Netherlands ATP World Tour,HARD,2,Andreas Seppi,Lleyton Hewitt,Andreas Seppi,3-6; 7-6(4); 7-6(4),R32,173,10,2,68,129,50,68,28,61,13,18,17,78,129,7,4,49,104,37,49,30,55,5,8,16,67,104
2008-02-18 00:00:00.000,Rotterdam The Netherlands ATP World Tour,HARD,2,Fernando Verdasco,Jarkko Nieminen,Fernando Verdasco,6-2; 6-2,R32,68,2,2,25,40,20,25,10,15,0,1,8,30,40,2,2,37,63,19,37,10,26,10,15,8,29,63
2008-02-18 00:00:00.000,Rotterdam The Netherlands ATP World Tour,HARD,2,Robin Soderling,Marcos Baghdatis,Robin Soderling,6-3; 3-6; 6-4,R32,104,10,2,45,81,35,45,23,36,2,3,14,58,81,13,1,44,75,34,44,17,31,0,2,14,51,75
2008-02-18 00:00:00.000,Rotterdam The Netherlands ATP World Tour,HARD,2,Janko Tipsarevic,Mikhail Youzhny,Janko Tipsarevic,7-6(3); 6-4,R32,107,7,3,41,75,30,41,22,34,7,8,11,52,75,4,2,37,63,30,37,15,26,3,5,11,45,63
2008-02-18 00:00:00.000,Rotterdam The Netherlands ATP World Tour,HARD,2,Gilles Simon,Feliciano Lopez,Gilles Simon,6-3; 6-4,R32,91,1,0,34,56,25,34,14,22,0,1,10,39,56,7,4,38,62,23,38,11,24,5,8,9,34,62
2008-02-18 00:00:00.000,Rotterdam The Netherlands ATP World Tour,HARD,2,Nicolas Mahut,Tommy Robredo,Nicolas Mahut,7-5; 6-4,R32,95,8,2,37,63,33,37,14,26,1,1,11,47,63,9,0,36,54,30,36,10,18,1,3,11,40,54
2008-02-18 00:00:00.000,Rotterdam The Netherlands ATP World Tour,HARD,2,Teymuraz Gabashvili,Juan Carlos Ferrero,Teymuraz Gabashvili,7-5; 6-1,R32,75,4,0,37,66,30,37,16,29,1,1,10,46,66,4,2,29,46,22,29,9,17,4,7,9,31,46
2008-02-18 00:00:00.000,Rotterdam The Netherlands ATP World Tour,HARD,2,Tomas Berdych,Ivan Ljubicic,Tomas Berdych,6-3; 6-3,R32,66,5,2,21,41,20,21,16,20,0,0,9,36,41,9,4,38,58,29,38,5,20,3,6,9,34,58
2008-02-18 00:00:00.000,Rotterdam The Netherlands ATP World Tour,HARD,2,Ivo Karlovic,Olivier Rochus,Ivo Karlovic,6-1; 6-2,R32,64,12,0,25,46,21,25,14,21,3,3,8,35,46,0,2,26,47,15,26,8,21,1,5,7,23,47
2008-02-18 00:00:00.000,Rotterdam The Netherlands ATP World Tour,HARD,2,Mischa Zverev,Philipp Kohlschreiber,Mischa Zverev,7-5; 7-5,R32,90,4,0,50,66,34,50,10,16,3,6,12,44,66,1,4,54,79,30,54,12,25,6,11,12,42,79
2008-02-18 00:00:00.000,Rotterdam The Netherlands ATP World Tour,HARD,2,David Ferrer,Simone Bolelli,David Ferrer,6-4; 7-5,R32,96,5,0,43,59,34,43,12,16,1,1,11,46,59,2,0,44,71,30,44,14,27,3,5,11,44,71
2008-02-18 00:00:00.000,Rotterdam The Netherlands ATP World Tour,HARD,2,Robin Haase,Andy Murray,Robin Haase,7-5; 6-3,R32,89,2,2,34,60,27,34,19,26,2,2,11,46,60,7,1,41,72,30,41,14,31,9,11,10,44,72
2008-02-18 00:00:00.000,Rotterdam The Netherlands ATP World Tour,HARD,2,Michael Berrer,Matthias Bachinger,Michael Berrer,6-3; 6-2,R32,62,2,1,28,54,23,28,15,26,4,4,9,38,54,2,2,16,37,13,16,10,21,1,4,8,23,37
2008-02-18 00:00:00.000,Rotterdam The Netherlands ATP World Tour,HARD,2,Michael Llodra,Raemon Sluiter,Michael Llodra,6-1; 7-6(6),R32,82,11,1,36,59,32,36,14,23,0,0,10,46,59,7,0,36,59,25,36,11,23,2,4,9,36,59
2008-02-18 00:00:00.000,Rotterdam The Netherlands ATP World Tour,HARD,2,Nikolay Davydenko,Jan Hernych,Nikolay Davydenko,6-3; 6-3,R32,76,2,1,28,45,24,28,9,17,0,1,9,33,45,0,1,51,67,28,51,8,16,3,7,9,36,67
2008-02-18 00:00:00.000,Rotterdam The Netherlands ATP World Tour,HARD,2,Andreas Seppi,Rafael Nadal,Andreas Seppi,3-6; 6-3; 6-4,R16,135,8,4,53,82,39,53,15,29,7,10,14,54,82,1,2,53,78,35,53,13,25,4,8,14,48,78
2008-02-18 00:00:00.000,Rotterdam The Netherlands ATP World Tour,HARD,2,Robin Soderling,Fernando Verdasco,Robin Soderling,6-4; 6-1,R16,69,11,1,35,48,29,35,8,13,3,3,9,37,48,6,2,37,56,22,37,10,19,3,6,8,32,56
2008-02-18 00:00:00.000,Rotterdam The Netherlands ATP World Tour,HARD,2,Gilles Simon,Janko Tipsarevic,Gilles Simon,7-6(4); 7-6(4),R16,129,8,1,52,76,37,52,10,24,2,6,12,47,76,10,2,61,108,40,61,19,47,6,10,12,59,108
2008-02-18 00:00:00.000,Rotterdam The Netherlands ATP World Tour,HARD,2,Teymuraz Gabashvili,Nicolas Mahut,Teymuraz Gabashvili,6-2; 7-6(7),R16,88,7,2,47,76,36,47,18,29,0,0,10,54,76,9,2,40,66,32,40,12,26,4,6,10,44,66
2008-02-18 00:00:00.000,Rotterdam The Netherlands ATP World Tour,HARD,2,Ivo Karlovic,Tomas Berdych,Ivo Karlovic,6-4; 6-4,R16,85,17,1,29,47,27,29,13,18,0,0,10,40,47,5,4,46,85,35,46,16,39,9,11,10,51,85
2008-02-18 00:00:00.000,Rotterdam The Netherlands ATP World Tour,HARD,2,Mischa Zverev,David Ferrer,Mischa Zverev,6-2; 7-5,R16,85,1,1,51,65,33,51,9,14,1,2,10,42,65,0,2,46,71,29,46,11,25,6,10,10,40,71
2008-02-18 00:00:00.000,Rotterdam The Netherlands ATP World Tour,HARD,2,Robin Haase,Michael Berrer,Robin Haase,5-7; 6-3; 6-3,R16,130,8,3,55,82,44,55,14,27,6,8,15,58,82,9,2,84,114,58,84,9,30,8,12,15,67,114
2008-02-18 00:00:00.000,Rotterdam The Netherlands ATP World Tour,HARD,2,Michael Llodra,Nikolay Davydenko,Michael Llodra,6-3; 7-5,R16,92,7,2,44,75,32,44,17,31,7,8,11,49,75,4,1,44,56,30,44,4,12,0,3,10,34,56
2008-02-18 00:00:00.000,Rotterdam The Netherlands ATP World Tour,HARD,2,Robin Soderling,Andreas Seppi,Robin Soderling,6-3; 6-2,Q,64,10,1,32,51,27,32,12,19,1,1,9,39,51,6,1,30,51,17,30,11,21,2,5,8,28,51
2008-02-18 00:00:00.000,Rotterdam The Netherlands ATP World Tour,HARD,2,Gilles Simon,Teymuraz Gabashvili,Gilles Simon,6-3; 6-2,Q,82,4,1,34,62,27,34,16,28,8,8,9,43,62,1,0,40,65,28,40,9,25,9,12,8,37,65
2008-02-18 00:00:00.000,Rotterdam The Netherlands ATP World Tour,HARD,2,Ivo Karlovic,Mischa Zverev,Ivo Karlovic,6-3; 6-1,Q,54,15,1,34,43,31,34,4,9,4,4,8,35,43,0,1,42,54,26,42,3,12,6,10,8,29,54
2008-02-18 00:00:00.000,Rotterdam The Netherlands ATP World Tour,HARD,2,Michael Llodra,Robin Haase,Michael Llodra,7-6(5); 7-6(5),Q,98,13,3,49,78,42,49,19,29,2,2,12,61,78,7,0,62,82,44,62,13,20,2,2,12,57,82
2008-02-18 00:00:00.000,Rotterdam The Netherlands ATP World Tour,HARD,2,Robin Soderling,Gilles Simon,Robin Soderling,6-2; 6-1,S,51,4,1,25,35,22,25,6,10,0,0,7,28,35,3,0,33,50,17,33,6,17,0,5,8,23,50
2008-02-18 00:00:00.000,Rotterdam The Netherlands ATP World Tour,HARD,2,Michael Llodra,Ivo Karlovic,Michael Llodra,7-5; 7-6(4),S,86,5,1,48,68,41,48,15,20,1,1,12,56,68,16,1,55,70,46,55,7,15,2,3,12,53,70
2008-02-18 00:00:00.000,Rotterdam The Netherlands ATP World Tour,HARD,2,Michael Llodra,Robin Soderling,Michael Llodra,6-7(3); 6-3; 7-6(4),F,129,15,3,61,107,51,61,26,46,2,3,17,77,107,22,2,63,93,50,63,20,30,1,3,16,70,93
2008-02-18 00:00:00.000,San Jose CA; U.S.A. ATP World Tour,HARD,2,Andy Roddick,Chris Guccione,Andy Roddick,6-3; 6-7(3); 7-6(5),R32,100,9,3,65,91,55,65,20,26,0,0,17,75,91,20,2,62,94,52,62,19,32,1,2,16,71,94
2008-02-18 00:00:00.000,San Jose CA; U.S.A. ATP World Tour,HARD,2,Kei Nishikori,Diego Hartfield,Kei Nishikori,7-5; 6-3,R32,74,2,3,29,56,24,29,9,27,2,5,10,33,56,0,3,38,60,19,38,10,22,2,8,11,29,60
2008-02-18 00:00:00.000,San Jose CA; U.S.A. ATP World Tour,HARD,2,Mardy Fish,Tim Smyczek,Mardy Fish,6-3; 6-4,R32,75,8,3,33,63,24,33,15,30,3,5,10,39,63,1,2,42,67,22,42,12,25,8,12,9,34,67
2008-02-18 00:00:00.000,San Jose CA; U.S.A. ATP World Tour,HARD,2,Denis Gremelmayr,Sam Querrey,Denis Gremelmayr,5-7; 7-6(1); 6-3,R32,114,5,2,51,92,38,51,22,41,3,7,17,60,92,7,3,51,89,37,51,20,38,1,5,16,57,89
2008-02-18 00:00:00.000,San Jose CA; U.S.A. ATP World Tour,HARD,2,Tommy Haas,Robert Kendrick,Tommy Haas,6-3; 4-6; 6-2,R32,107,6,4,55,89,41,55,19,34,5,7,14,60,89,11,4,54,91,39,54,13,37,5,9,13,52,91
2008-02-18 00:00:00.000,San Jose CA; U.S.A. ATP World Tour,HARD,2,John Isner,Florent Serra,John Isner,7-6(5); 6-4,R32,69,15,5,41,62,37,41,13,21,2,2,11,50,62,6,2,35,66,28,35,19,31,3,4,11,47,66
2008-02-18 00:00:00.000,San Jose CA; U.S.A. ATP World Tour,HARD,2,Benjamin Becker,Marcos Daniel,Benjamin Becker,6-1; 3-0 RET,R32,42,1,3,13,33,10,13,13,20,2,2,5,23,33,1,2,18,36,10,18,6,18,4,8,5,16,36
2008-02-18 00:00:00.000,San Jose CA; U.S.A. ATP World Tour,HARD,2,Guillermo Garcia-Lopez,Jurgen Melzer,Guillermo Garcia-Lopez,6-2; 6-7(5); 7-6(6),R32,162,3,6,58,122,43,58,33,64,3,6,16,76,122,7,3,62,107,43,62,22,45,7,12,16,65,107
2008-02-18 00:00:00.000,San Jose CA; U.S.A. ATP World Tour,HARD,2,Wayne Odesnik,Donald Young,Wayne Odesnik,6-1; 5-7; 6-4,R32,100,1,0,54,68,41,54,9,14,1,3,14,50,68,5,6,48,87,34,48,17,39,0,5,15,51,87
2008-02-18 00:00:00.000,San Jose CA; U.S.A. ATP World Tour,HARD,2,Yen-Hsun Lu,Max Mirnyi,Yen-Hsun Lu,7-6(4); 5-7; 6-2,R32,154,6,8,78,126,54,78,28,48,15,16,16,82,126,17,4,61,107,47,61,23,46,7,9,16,70,107
2008-02-18 00:00:00.000,San Jose CA; U.S.A. ATP World Tour,HARD,2,Bobby Reynolds,Benedikt Dorsch,Bobby Reynolds,7-5; 6-4,R32,81,13,2,40,61,30,40,16,21,1,1,11,46,61,3,1,41,66,28,41,14,25,1,3,11,42,66
2008-02-18 00:00:00.000,San Jose CA; U.S.A. ATP World Tour,HARD,2,Radek Stepanek,Paul Capdeville,Radek Stepanek,7-6(2); 6-1,R32,76,12,3,43,60,35,43,10,17,0,0,10,45,60,2,5,26,59,17,26,18,33,0,2,9,35,59
2008-02-18 00:00:00.000,San Jose CA; U.S.A. ATP World Tour,HARD,2,Kristof Vliegen,Victor Hanescu,Kristof Vliegen,6-4; 7-6(4),R32,81,14,0,40,61,34,40,12,21,0,1,11,46,61,6,4,52,74,36,52,12,22,5,7,11,48,74
2008-02-18 00:00:00.000,San Jose CA; U.S.A. ATP World Tour,HARD,2,Robby Ginepri,Jesse Witten,Robby Ginepri,6-2; 5-7; 6-4,R32,99,6,2,63,87,44,63,12,24,3,6,15,56,87,4,4,46,85,30,46,19,39,0,5,15,49,85
2008-02-18 00:00:00.000,San Jose CA; U.S.A. ATP World Tour,HARD,2,Jesse Levine,Steve Darcis,Jesse Levine,6-3; 2-6; 6-4,R32,126,9,5,49,90,34,49,18,41,7,11,13,52,90,12,7,62,112,42,62,19,50,11,16,14,61,112
2008-02-18 00:00:00.000,San Jose CA; U.S.A. ATP World Tour,HARD,2,James Blake,Sam Warburg,James Blake,6-3; 6-1,R32,55,9,6,23,44,20,23,12,21,0,0,8,32,44,3,4,27,44,18,27,5,17,1,5,8,23,44
2008-02-18 00:00:00.000,San Jose CA; U.S.A. ATP World Tour,HARD,2,Andy Roddick,Kei Nishikori,Andy Roddick,6-2; 6-4,R16,64,7,1,38,53,28,38,9,15,1,2,9,37,53,2,2,35,58,19,35,12,23,4,8,9,31,58
2008-02-18 00:00:00.000,San Jose CA; U.S.A. ATP World Tour,HARD,2,Mardy Fish,Denis Gremelmayr,Mardy Fish,6-7(4); 6-3; 6-3,R16,107,19,2,51,81,43,51,22,30,2,2,15,65,81,7,2,62,98,46,62,16,36,9,12,15,62,98
2008-02-18 00:00:00.000,San Jose CA; U.S.A. ATP World Tour,HARD,2,John Isner,Tommy Haas,John Isner,4-6; 7-6(6); 6-3,R16,120,22,5,69,97,54,69,16,28,2,4,16,70,97,9,3,67,98,46,67,20,31,8,10,15,66,98
2008-02-18 00:00:00.000,San Jose CA; U.S.A. ATP World Tour,HARD,2,Guillermo Garcia-Lopez,Benjamin Becker,Guillermo Garcia-Lopez,3-6; 7-6(3); 6-4,R16,142,7,5,56,86,43,56,11,30,0,3,15,54,86,16,4,65,123,48,65,25,58,9,12,16,73,123
2008-02-18 00:00:00.000,San Jose CA; U.S.A. ATP World Tour,HARD,2,Yen-Hsun Lu,Wayne Odesnik,Yen-Hsun Lu,6-4; 6-4,R16,93,5,3,42,66,31,42,14,24,4,5,10,45,66,6,2,35,57,26,35,10,22,5,8,10,36,57
2008-02-18 00:00:00.000,San Jose CA; U.S.A. ATP World Tour,HARD,2,Radek Stepanek,Bobby Reynolds,Radek Stepanek,7-5; 7-6(5),R16,92,16,1,44,68,38,44,16,24,2,3,12,54,68,6,2,48,77,39,48,14,29,1,3,12,53,77
2008-02-18 00:00:00.000,San Jose CA; U.S.A. ATP World Tour,HARD,2,Robby Ginepri,Kristof Vliegen,Robby Ginepri,6-2; 6-3,R16,68,3,1,28,54,25,28,14,26,3,3,8,39,54,6,2,40,61,24,40,8,21,7,11,9,32,61
2008-02-18 00:00:00.000,San Jose CA; U.S.A. ATP World Tour,HARD,2,James Blake,Jesse Levine,James Blake,6-3; 6-4,R16,64,9,2,36,64,28,36,17,28,5,5,10,45,64,4,1,26,49,17,26,15,23,1,3,9,32,49
2008-02-18 00:00:00.000,San Jose CA; U.S.A. ATP World Tour,HARD,2,Andy Roddick,Mardy Fish,Andy Roddick,7-6(6); 1-6; 7-5,Q,117,14,1,62,90,43,62,19,28,5,7,15,62,90,28,3,55,103,43,55,26,48,1,2,16,69,103
2008-02-18 00:00:00.000,San Jose CA; U.S.A. ATP World Tour,HARD,2,Guillermo Garcia-Lopez,John Isner,Guillermo Garcia-Lopez,7-6(4); 6-7(1); 7-6(11),Q,188,6,3,84,135,65,84,31,51,5,5,18,96,135,22,3,91,121,73,91,18,30,2,2,18,91,121
2008-02-18 00:00:00.000,San Jose CA; U.S.A. ATP World Tour,HARD,2,Radek Stepanek,Yen-Hsun Lu,Radek Stepanek,6-2; 7-6(5),Q,102,7,3,41,63,31,41,14,22,2,2,10,45,63,5,5,50,82,32,50,16,32,3,5,10,48,82
2008-02-18 00:00:00.000,San Jose CA; U.S.A. ATP World Tour,HARD,2,Robby Ginepri,James Blake,Robby Ginepri,6-2; 6-2,Q,51,4,2,24,43,17,24,13,19,0,1,8,30,43,6,4,28,52,19,28,6,24,8,13,8,25,52
2008-02-18 00:00:00.000,San Jose CA; U.S.A. ATP World Tour,HARD,2,Andy Roddick,Guillermo Garcia-Lopez,Andy Roddick,7-6(2); 6-1,S,93,16,3,44,63,37,44,9,19,1,1,9,46,63,4,2,43,71,25,43,16,28,9,12,10,41,71
2008-02-18 00:00:00.000,San Jose CA; U.S.A. ATP World Tour,HARD,2,Radek Stepanek,Robby Ginepri,Radek Stepanek,6-7(5); 6-4; 6-1,S,122,12,1,57,80,50,57,12,23,3,3,14,62,80,5,1,59,98,37,59,22,39,0,4,15,59,98
2008-02-18 00:00:00.000,San Jose CA; U.S.A. ATP World Tour,HARD,2,Andy Roddick,Radek Stepanek,Andy Roddick,6-4; 7-5,F,80,13,2,40,58,33,40,12,18,0,0,11,45,58,7,3,46,70,35,46,9,24,3,5,11,44,70
2008-02-25 00:00:00.000,Acapulco Mexico ATP World Tour,CLAY,2,David Nalbandian,Boris Pashanski,David Nalbandian,6-2; 7-5,R32,85,9,1,38,66,25,38,15,28,3,5,10,40,66,5,0,46,64,25,46,9,18,1,6,10,34,64
2008-02-25 00:00:00.000,Acapulco Mexico ATP World Tour,CLAY,2,Santiago Ventura,Cesar Ramirez,Santiago Ventura,6-3; 6-1,R32,74,0,1,31,62,23,31,18,31,5,5,8,41,62,0,2,30,49,16,30,11,19,6,10,8,27,49
2008-02-25 00:00:00.000,Acapulco Mexico ATP World Tour,CLAY,2,Peter Luczak,Sergio Roitman,Peter Luczak,6-3; 6-4,R32,81,3,1,40,57,30,40,11,17,4,5,10,41,57,3,1,24,50,17,24,13,26,2,5,9,30,50
2008-02-25 00:00:00.000,Acapulco Mexico ATP World Tour,CLAY,2,Potito Starace,Nicolas Lapentti,Potito Starace,6-4; 6-2,R32,91,5,1,38,55,26,38,10,17,4,5,9,36,55,3,4,30,61,18,30,13,31,8,12,9,31,61
2008-02-25 00:00:00.000,Acapulco Mexico ATP World Tour,CLAY,2,Juan Monaco,Juan Pablo Brzezicki,Juan Monaco,6-3; 2-6; 6-3,R32,112,4,1,53,73,34,53,14,20,5,8,13,48,73,5,0,58,82,36,58,11,24,6,10,13,47,82
2008-02-25 00:00:00.000,Acapulco Mexico ATP World Tour,CLAY,2,Luis Horna,Fabio Fognini,Luis Horna,6-4; 7-5,R32,89,8,2,47,67,34,47,10,20,3,5,11,44,67,2,3,41,65,23,41,16,24,2,6,11,39,65
2008-02-25 00:00:00.000,Acapulco Mexico ATP World Tour,CLAY,2,Agustin Calleri,Bruno Echagaray,Agustin Calleri,6-4; 6-1,R32,85,8,4,31,57,24,31,12,26,1,2,8,36,57,0,2,39,65,21,39,10,26,7,12,9,31,65
2008-02-25 00:00:00.000,Acapulco Mexico ATP World Tour,CLAY,2,Juan Ignacio Chela,Pablo Cuevas,Juan Ignacio Chela,7-6(4); 6-4,R32,97,2,4,34,72,22,34,22,38,2,4,11,44,72,1,1,41,68,24,41,16,27,2,5,11,40,68
2008-02-25 00:00:00.000,Acapulco Mexico ATP World Tour,CLAY,2,Albert Montanes,Igor Andreev,Albert Montanes,7-6(4); 6-3,R32,104,2,5,44,77,29,44,17,33,3,6,10,46,77,4,3,44,65,30,44,4,21,1,6,11,34,65
2008-02-25 00:00:00.000,Acapulco Mexico ATP World Tour,CLAY,2,Marcel Granollers,Bruno Rodriguez,Marcel Granollers,6-3; 6-3,R32,91,4,4,29,54,24,29,12,25,0,1,9,36,54,1,2,36,65,24,36,10,29,6,10,9,34,65
2008-02-25 00:00:00.000,Acapulco Mexico ATP World Tour,CLAY,2,Jose Acasuso,Oscar Hernandez,Jose Acasuso,6-4; 6-0,R32,72,4,2,22,38,19,22,8,16,2,4,8,27,38,1,2,39,56,17,39,6,17,4,10,8,23,56
2008-02-25 00:00:00.000,Acapulco Mexico ATP World Tour,CLAY,2,Guillermo Canas,Carlos Berlocq,Guillermo Canas,6-4; 6-7(5); 6-4,R32,192,1,4,74,113,49,74,19,39,6,10,16,68,113,9,3,63,110,43,63,18,47,8,14,16,61,110
2008-02-25 00:00:00.000,Acapulco Mexico ATP World Tour,CLAY,2,Nicolas Almagro,Jiri Vanek,Nicolas Almagro,6-1; 6-2,R32,54,13,3,25,45,23,25,11,20,1,1,8,34,45,4,3,37,62,24,37,5,25,6,10,7,29,62
2008-02-25 00:00:00.000,Acapulco Mexico ATP World Tour,CLAY,2,Filippo Volandri,Ivo Minar,Filippo Volandri,6-4; 7-5,R32,68,1,0,33,54,28,33,12,21,2,4,11,40,54,5,0,51,68,28,51,10,17,3,7,11,38,68
2008-02-25 00:00:00.000,Acapulco Mexico ATP World Tour,CLAY,2,Nicolas Massu,Martin Vassallo Arguello,Nicolas Massu,6-3; 6-4,R32,117,4,2,34,58,26,34,12,24,1,3,10,38,58,1,3,53,75,29,53,10,22,5,9,9,39,75
2008-02-25 00:00:00.000,Acapulco Mexico ATP World Tour,CLAY,2,Carlos Moya,Werner Eschauer,Carlos Moya,6-4; 6-4,R32,77,5,2,33,52,29,33,8,19,2,4,10,37,52,1,3,39,65,23,39,10,26,1,5,10,33,65
2008-02-25 00:00:00.000,Acapulco Mexico ATP World Tour,CLAY,2,David Nalbandian,Santiago Ventura,David Nalbandian,6-2; 6-3,R16,74,4,3,27,54,18,27,16,27,5,7,8,34,54,3,1,29,53,12,29,8,24,1,7,9,20,53
2008-02-25 00:00:00.000,Acapulco Mexico ATP World Tour,CLAY,2,Potito Starace,Peter Luczak,Potito Starace,6-3; 6-3,R16,99,1,1,39,51,28,39,7,12,1,2,9,35,51,3,2,49,77,29,49,11,28,10,14,9,40,77
2008-02-25 00:00:00.000,Acapulco Mexico ATP World Tour,CLAY,2,Luis Horna,Juan Monaco,Luis Horna,7-6(4); 6-3,R16,93,2,1,44,65,34,44,13,21,0,1,11,47,65,1,0,42,58,28,42,11,16,2,4,10,39,58
2008-02-25 00:00:00.000,Acapulco Mexico ATP World Tour,CLAY,2,Agustin Calleri,Juan Ignacio Chela,Agustin Calleri,7-6(4); 2-6; 6-1,R16,125,8,4,52,85,37,52,12,33,4,9,13,49,85,2,6,59,101,35,59,19,42,6,12,14,54,101
2008-02-25 00:00:00.000,Acapulco Mexico ATP World Tour,CLAY,2,Marcel Granollers,Albert Montanes,Marcel Granollers,6-2; 7-6(6),R16,91,4,2,44,76,31,44,18,32,5,6,10,49,76,1,2,41,56,31,41,6,15,3,6,10,37,56
2008-02-25 00:00:00.000,Acapulco Mexico ATP World Tour,CLAY,2,Jose Acasuso,Guillermo Canas,Jose Acasuso,4-6; 6-2; 6-2,R16,140,4,6,43,92,32,43,26,49,15,17,13,58,92,1,2,50,85,32,50,15,35,5,10,13,47,85
2008-02-25 00:00:00.000,Acapulco Mexico ATP World Tour,CLAY,2,Nicolas Almagro,Filippo Volandri,Nicolas Almagro,6-3; 6-3,R16,70,12,3,30,55,25,30,13,25,4,5,9,38,55,1,0,46,58,24,46,6,12,2,6,9,30,58
2008-02-25 00:00:00.000,Acapulco Mexico ATP World Tour,CLAY,2,Nicolas Massu,Carlos Moya,Nicolas Massu,6-4; 6-2,R16,99,2,2,37,60,30,37,13,23,1,1,9,43,60,4,2,45,66,28,45,9,21,6,9,9,37,66
2008-02-25 00:00:00.000,Acapulco Mexico ATP World Tour,CLAY,2,David Nalbandian,Potito Starace,David Nalbandian,6-3; 6-3,Q,77,4,1,37,53,30,37,10,16,3,3,9,40,53,2,2,44,65,27,44,10,21,6,9,9,37,65
2008-02-25 00:00:00.000,Acapulco Mexico ATP World Tour,CLAY,2,Luis Horna,Agustin Calleri,Luis Horna,6-4; 3-6; 6-3,Q,113,6,2,58,80,45,58,11,22,0,1,14,56,80,14,0,54,85,41,54,16,31,6,8,14,57,85
2008-02-25 00:00:00.000,Acapulco Mexico ATP World Tour,CLAY,2,Jose Acasuso,Marcel Granollers,Jose Acasuso,7-6(2); 6-3,Q,110,5,3,40,77,28,40,22,37,7,9,11,50,77,6,5,35,70,26,35,14,35,7,10,10,40,70
2008-02-25 00:00:00.000,Acapulco Mexico ATP World Tour,CLAY,2,Nicolas Almagro,Nicolas Massu,Nicolas Almagro,4-6; 6-3; 6-3,Q,119,11,2,57,74,47,57,9,17,3,4,14,56,74,3,0,62,85,41,62,11,23,2,5,14,52,85
2008-02-25 00:00:00.000,Acapulco Mexico ATP World Tour,CLAY,2,David Nalbandian,Luis Horna,David Nalbandian,7-5; 6-1,S,81,8,2,31,51,26,31,12,20,1,1,9,38,51,4,4,42,63,26,42,8,21,4,8,10,34,63
2008-02-25 00:00:00.000,Acapulco Mexico ATP World Tour,CLAY,2,Nicolas Almagro,Jose Acasuso,Nicolas Almagro,6-4; 3-6; 7-5,S,133,12,2,56,94,43,56,18,38,6,8,15,61,94,4,2,58,91,44,58,17,33,5,8,16,61,91
2008-02-25 00:00:00.000,Acapulco Mexico ATP World Tour,CLAY,2,Nicolas Almagro,David Nalbandian,Nicolas Almagro,6-1; 7-6(1),F,85,11,1,37,63,31,37,16,26,2,2,10,47,63,3,3,33,65,19,33,18,32,4,6,9,37,65
2008-02-25 00:00:00.000,Memphis TN; U.S.A. ATP World Tour,HARD,2,Andy Roddick,Gilles Muller,Andy Roddick,6-4; 7-6(4),R32,77,17,0,47,62,41,47,9,15,0,0,11,50,62,18,1,57,69,42,57,6,12,2,3,11,48,69
2008-02-25 00:00:00.000,Memphis TN; U.S.A. ATP World Tour,HARD,2,Mardy Fish,Bobby Reynolds,Mardy Fish,6-7(3); 6-4; 6-2,R32,119,16,2,47,85,39,47,25,38,0,0,15,64,85,14,3,74,104,53,74,13,30,4,7,15,66,104
2008-02-25 00:00:00.000,Memphis TN; U.S.A. ATP World Tour,HARD,2,Victor Hanescu,Yen-Hsun Lu,Victor Hanescu,6-3; 2-1 RET,R32,51,10,1,28,39,23,28,6,11,2,2,6,29,39,2,1,26,37,15,26,6,11,1,3,6,21,37
2008-02-25 00:00:00.000,Memphis TN; U.S.A. ATP World Tour,HARD,2,Robin Soderling,Frederic Niemeyer,Robin Soderling,6-2; 6-1,R32,47,16,4,34,50,28,34,8,16,2,2,8,36,50,5,2,29,44,15,29,6,15,5,9,7,21,44
2008-02-25 00:00:00.000,Memphis TN; U.S.A. ATP World Tour,HARD,2,Radek Stepanek,Jesse Levine,Radek Stepanek,6-1; 6-4,R32,57,7,1,28,41,26,28,10,13,0,0,9,36,41,4,5,30,53,20,30,9,23,1,4,8,29,53
2008-02-25 00:00:00.000,Memphis TN; U.S.A. ATP World Tour,HARD,2,Florent Serra,Marcos Daniel,Florent Serra,6-1; 6-2,R32,49,2,0,33,44,26,33,8,11,0,0,8,34,44,4,2,30,46,18,30,3,16,3,7,7,21,46
2008-02-25 00:00:00.000,Memphis TN; U.S.A. ATP World Tour,HARD,2,Chris Guccione,Robert Kendrick,Chris Guccione,7-6(6); 7-6(5),R32,91,17,3,56,97,46,56,21,41,7,7,12,67,97,13,1,45,75,39,45,19,30,0,0,12,58,75
2008-02-25 00:00:00.000,Memphis TN; U.S.A. ATP World Tour,HARD,2,Thomas Johansson,Marat Safin,Thomas Johansson,7-6(5); 7-6(2),R32,102,18,3,50,82,40,50,17,32,4,5,12,57,82,12,3,57,90,38,57,19,33,5,6,12,57,90
2008-02-25 00:00:00.000,Memphis TN; U.S.A. ATP World Tour,HARD,2,Jurgen Melzer,John Isner,Jurgen Melzer,6-7(8); 6-3; 7-6(4),R32,120,19,3,69,97,63,69,16,28,1,1,17,79,97,18,8,68,107,51,68,22,39,0,1,16,73,107
2008-02-25 00:00:00.000,Memphis TN; U.S.A. ATP World Tour,HARD,2,Steve Darcis,Vincent Spadea,Steve Darcis,7-5; 4-6; 7-6(4),R32,119,9,1,58,101,39,58,26,43,6,10,17,65,101,8,4,68,101,50,68,14,33,4,8,17,64,101
2008-02-25 00:00:00.000,Memphis TN; U.S.A. ATP World Tour,HARD,2,Benjamin Becker,Kristof Vliegen,Benjamin Becker,7-5; 7-6(1),R32,97,7,2,48,83,36,48,19,35,6,8,12,55,83,9,2,44,78,29,44,17,34,3,6,12,46,78
2008-02-25 00:00:00.000,Memphis TN; U.S.A. ATP World Tour,HARD,2,Tommy Haas,Diego Hartfield,Tommy Haas,6-3; 6-2,R32,74,2,2,32,56,23,32,13,24,3,5,9,36,56,3,3,34,57,16,34,11,23,5,10,8,27,57
2008-02-25 00:00:00.000,Memphis TN; U.S.A. ATP World Tour,HARD,2,Sam Querrey,Michael Russell,Sam Querrey,3-6; 6-3; 7-5,R32,111,17,4,51,91,42,51,20,40,3,5,15,62,91,1,3,66,97,45,66,16,31,5,8,15,61,97
2008-02-25 00:00:00.000,Memphis TN; U.S.A. ATP World Tour,HARD,2,Jonas Bjorkman,Paul Capdeville,Jonas Bjorkman,6-3; 6-1,R32,53,9,1,28,43,26,28,7,15,0,0,8,33,43,0,0,31,50,18,31,8,19,3,7,8,26,50
2008-02-25 00:00:00.000,Memphis TN; U.S.A. ATP World Tour,HARD,2,Alejandro Falla,Dudi Sela,Alejandro Falla,6-4; 6-2,R32,70,4,2,37,56,28,37,11,19,4,5,9,39,56,0,5,29,59,21,29,9,30,6,10,9,30,59
2008-02-25 00:00:00.000,Memphis TN; U.S.A. ATP World Tour,HARD,2,Donald Young,Sam Warburg,Donald Young,6-4; 6-4,R32,81,5,0,40,62,32,40,13,22,4,4,10,45,62,10,4,53,74,35,53,9,21,5,7,10,44,74
2008-02-25 00:00:00.000,Memphis TN; U.S.A. ATP World Tour,HARD,2,Andy Roddick,Mardy Fish,Andy Roddick,6-4; 6-2,R16,61,14,0,34,44,29,34,8,10,2,2,9,37,44,8,2,23,55,17,23,15,32,0,3,9,32,55
2008-02-25 00:00:00.000,Memphis TN; U.S.A. ATP World Tour,HARD,2,Robin Soderling,Victor Hanescu,Robin Soderling,6-2; 6-1,R16,44,8,0,21,33,18,21,10,12,0,0,7,28,33,1,1,29,43,16,29,4,14,1,6,8,20,43
2008-02-25 00:00:00.000,Memphis TN; U.S.A. ATP World Tour,HARD,2,Radek Stepanek,Florent Serra,Radek Stepanek,7-6(6); 2-6; 7-5,R16,155,13,10,62,116,49,62,21,54,8,12,16,70,116,8,3,75,119,54,75,17,44,8,11,16,71,119
2008-02-25 00:00:00.000,Memphis TN; U.S.A. ATP World Tour,HARD,2,Chris Guccione,Thomas Johansson,Chris Guccione,6-3; 6-4,R16,56,15,0,26,47,26,26,14,21,0,0,10,40,47,4,2,23,53,17,23,17,30,3,5,9,34,53
2008-02-25 00:00:00.000,Memphis TN; U.S.A. ATP World Tour,HARD,2,Steve Darcis,Jurgen Melzer,Steve Darcis,6-3; 7-6(4),R16,77,6,1,47,67,35,47,15,20,2,3,11,50,67,6,0,47,71,35,47,10,24,1,3,10,45,71
2008-02-25 00:00:00.000,Memphis TN; U.S.A. ATP World Tour,HARD,2,Benjamin Becker,Tommy Haas,Benjamin Becker,3-6; 6-2; 7-5,R16,113,8,3,43,80,31,43,24,37,4,6,14,55,80,11,8,59,99,44,59,16,40,5,9,15,60,99
2008-02-25 00:00:00.000,Memphis TN; U.S.A. ATP World Tour,HARD,2,Jonas Bjorkman,Sam Querrey,Jonas Bjorkman,6-4; 4-6; 7-6(4),R16,117,3,2,62,100,47,62,23,38,1,2,16,70,100,26,2,59,94,52,59,17,35,3,4,16,69,94
2008-02-25 00:00:00.000,Memphis TN; U.S.A. ATP World Tour,HARD,2,Donald Young,Alejandro Falla,Donald Young,6-1; 1-6; 6-3,R16,93,5,5,56,92,36,56,16,36,10,14,12,52,92,4,4,56,77,29,56,10,21,7,12,11,39,77
2008-02-25 00:00:00.000,Memphis TN; U.S.A. ATP World Tour,HARD,2,Robin Soderling,Andy Roddick,Robin Soderling,7-6(6); 6-3,Q,86,16,1,37,55,32,37,14,18,0,0,10,46,55,15,2,63,90,45,63,11,27,8,10,11,56,90
2008-02-25 00:00:00.000,Memphis TN; U.S.A. ATP World Tour,HARD,2,Radek Stepanek,Chris Guccione,Radek Stepanek,7-6(4); 6-1,Q,69,5,1,40,54,33,40,12,14,0,0,10,45,54,12,1,48,67,32,48,8,19,5,7,9,40,67
2008-02-25 00:00:00.000,Memphis TN; U.S.A. ATP World Tour,HARD,2,Steve Darcis,Benjamin Becker,Steve Darcis,6-1; 6-0,Q,50,9,0,23,47,20,23,13,24,4,4,7,33,47,2,3,18,36,10,18,4,18,5,10,6,14,36
2008-02-25 00:00:00.000,Memphis TN; U.S.A. ATP World Tour,HARD,2,Jonas Bjorkman,Donald Young,Jonas Bjorkman,1-6; 6-2; 7-6(6),Q,119,1,4,57,97,36,57,18,40,8,12,13,54,97,9,2,69,99,44,69,13,30,7,11,14,57,99
2008-02-25 00:00:00.000,Memphis TN; U.S.A. ATP World Tour,HARD,2,Robin Soderling,Radek Stepanek,Robin Soderling,7-6(2); 6-3,S,77,12,0,39,60,35,39,14,21,2,2,10,49,60,10,3,42,67,35,42,9,25,3,5,11,44,67
2008-02-25 00:00:00.000,Memphis TN; U.S.A. ATP World Tour,HARD,2,Steve Darcis,Jonas Bjorkman,Steve Darcis,4-6; 6-1; 6-4,S,107,7,3,49,83,40,49,18,34,2,3,14,58,83,6,2,57,89,39,57,15,32,8,11,13,54,89
2008-02-25 00:00:00.000,Memphis TN; U.S.A. ATP World Tour,HARD,2,Steve Darcis,Robin Soderling,Steve Darcis,6-3; 7-6(5),F,75,13,3,48,69,39,48,13,21,1,1,11,52,69,14,2,38,60,33,38,10,22,2,3,10,43,60
2008-02-25 00:00:00.000,Zagreb Croatia ATP World Tour,HARD,2,Ivan Ljubicic,Ernests Gulbis,Ivan Ljubicic,6-3; 7-6(7),R32,85,13,1,45,64,39,45,10,19,0,0,11,49,64,7,5,35,73,29,35,19,38,2,3,10,48,73
2008-02-25 00:00:00.000,Zagreb Croatia ATP World Tour,HARD,2,Lovro Zovko,Marc Gicquel,Lovro Zovko,6-3; 7-5,R32,75,10,1,27,59,24,27,17,32,3,4,10,41,59,3,3,37,64,26,37,11,27,6,10,11,37,64
2008-02-25 00:00:00.000,Zagreb Croatia ATP World Tour,HARD,2,Teymuraz Gabashvili,Florian Mayer,Teymuraz Gabashvili,7-6(6); 6-0,R32,65,7,2,35,51,29,35,8,16,0,1,9,37,51,3,1,37,59,21,37,10,22,1,5,9,31,59
2008-02-25 00:00:00.000,Zagreb Croatia ATP World Tour,HARD,2,Rik De Voest,Andreas Seppi,Rik De Voest,6-4; 7-6(3),R32,96,4,0,50,77,39,50,14,27,3,4,11,53,77,3,2,38,74,28,38,19,36,2,4,11,47,74
2008-02-25 00:00:00.000,Zagreb Croatia ATP World Tour,HARD,2,Gilles Simon,Pavol Cervenak,Gilles Simon,7-6(2); 6-1,R32,80,9,1,39,59,26,39,12,20,1,3,9,38,59,4,2,34,65,19,34,12,31,5,10,10,31,65
2008-02-25 00:00:00.000,Zagreb Croatia ATP World Tour,HARD,2,Robin Haase,Michael Berrer,Robin Haase,6-4; 6-3,R32,63,5,0,28,48,25,28,12,20,0,0,9,37,48,2,2,41,61,24,41,12,20,6,9,10,36,61
2008-02-25 00:00:00.000,Zagreb Croatia ATP World Tour,HARD,2,Denis Gremelmayr,Sebastien De Chaunac,Denis Gremelmayr,6-7(2); 6-1; 6-4,R32,115,3,0,63,87,46,63,16,24,2,3,15,62,87,7,1,37,78,28,37,23,41,0,4,14,51,78
2008-02-25 00:00:00.000,Zagreb Croatia ATP World Tour,HARD,2,Mario Ancic,Nicolas Mahut,Mario Ancic,7-6(3); 7-6(6),R32,105,16,1,55,78,49,55,11,23,0,1,12,60,78,16,2,54,79,39,54,16,25,1,2,12,55,79
2008-02-25 00:00:00.000,Zagreb Croatia ATP World Tour,HARD,2,Marin Cilic,Guillermo Garcia-Lopez,Marin Cilic,6-2; 6-2,R32,63,5,2,23,47,18,23,17,24,2,2,8,35,47,0,6,30,52,18,30,7,22,2,6,8,25,52
2008-02-25 00:00:00.000,Zagreb Croatia ATP World Tour,HARD,2,Simone Bolelli,Rainer Schuettler,Simone Bolelli,6-3; 6-2,R32,56,8,2,33,50,28,33,11,17,2,2,9,39,50,3,1,24,38,17,24,7,14,0,3,8,24,38
2008-02-25 00:00:00.000,Zagreb Croatia ATP World Tour,HARD,2,Stefan Koubek,Franko Skugor,Stefan Koubek,2-6; 7-6(2); 6-0,R32,117,7,2,48,79,33,48,17,31,9,13,13,50,79,6,4,36,91,30,36,19,55,4,9,13,49,91
2008-02-25 00:00:00.000,Zagreb Croatia ATP World Tour,HARD,2,Olivier Rochus,Fabrice Santoro,Olivier Rochus,6-3; 2-0 RET,R32,48,2,1,23,33,18,23,6,10,5,5,5,24,33,4,0,19,40,11,19,9,21,3,6,6,20,40
2008-02-25 00:00:00.000,Zagreb Croatia ATP World Tour,HARD,2,Janko Tipsarevic,Mischa Zverev,Janko Tipsarevic,6-3; 6-1,R32,52,11,0,24,42,21,24,11,18,0,0,8,32,42,5,2,27,43,14,27,6,16,2,6,8,20,43
2008-02-25 00:00:00.000,Zagreb Croatia ATP World Tour,HARD,2,Roko Karanusic,Blaz Kavcic,Roko Karanusic,6-7(9); 6-4; 6-4,R32,156,9,3,57,100,40,57,22,43,2,6,16,62,100,1,6,74,110,46,74,17,36,8,14,16,63,110
2008-02-25 00:00:00.000,Zagreb Croatia ATP World Tour,HARD,2,Viktor Troicki,George Bastl,Viktor Troicki,6-3; 7-6(3),R32,114,6,1,41,63,28,41,15,22,3,5,10,43,63,6,2,49,78,30,49,15,29,5,9,11,45,78
2008-02-25 00:00:00.000,Zagreb Croatia ATP World Tour,HARD,2,Sergiy Stakhovsky,Ivo Karlovic,Sergiy Stakhovsky,4-6; 7-6(5); 6-2,R32,139,10,1,62,109,46,62,27,47,6,7,15,73,109,14,3,75,106,54,75,15,31,8,10,15,69,106
2008-02-25 00:00:00.000,Zagreb Croatia ATP World Tour,HARD,2,Ivan Ljubicic,Lovro Zovko,Ivan Ljubicic,6-4; 7-6(3),R16,87,18,0,43,56,41,43,8,13,0,0,11,49,56,9,2,40,75,30,40,20,35,2,3,11,50,75
2008-02-25 00:00:00.000,Zagreb Croatia ATP World Tour,HARD,2,Teymuraz Gabashvili,Rik De Voest,Teymuraz Gabashvili,7-5; 6-1,R16,80,4,0,34,62,28,34,15,28,3,4,10,43,62,6,0,33,62,20,33,13,29,3,7,9,33,62
2008-02-25 00:00:00.000,Zagreb Croatia ATP World Tour,HARD,2,Robin Haase,Gilles Simon,Robin Haase,6-2; 6-4,R16,61,1,1,31,53,24,31,14,22,1,1,9,38,53,1,0,25,49,17,25,9,24,2,5,9,26,49
2008-02-25 00:00:00.000,Zagreb Croatia ATP World Tour,HARD,2,Mario Ancic,Denis Gremelmayr,Mario Ancic,6-3; 6-2,R16,74,7,0,30,44,27,30,9,14,0,0,9,36,44,2,1,31,64,18,31,16,33,9,12,8,34,64
2008-02-25 00:00:00.000,Zagreb Croatia ATP World Tour,HARD,2,Simone Bolelli,Marin Cilic,Simone Bolelli,6-4; 6-3,R16,72,9,1,37,56,32,37,11,19,1,1,10,43,56,8,2,29,53,24,29,9,24,1,3,9,33,53
2008-02-25 00:00:00.000,Zagreb Croatia ATP World Tour,HARD,2,Olivier Rochus,Stefan Koubek,Olivier Rochus,6-2; 6-4,R16,68,3,2,37,58,28,37,11,21,3,4,9,39,58,1,2,25,48,14,25,10,23,1,5,9,24,48
2008-02-25 00:00:00.000,Zagreb Croatia ATP World Tour,HARD,2,Janko Tipsarevic,Roko Karanusic,Janko Tipsarevic,6-3; 6-7(4); 6-4,R16,143,5,0,49,92,39,49,28,43,8,9,15,67,92,7,0,56,104,42,56,26,48,8,12,16,68,104
2008-02-25 00:00:00.000,Zagreb Croatia ATP World Tour,HARD,2,Sergiy Stakhovsky,Viktor Troicki,Sergiy Stakhovsky,7-6(7); 3-6; 6-4,R16,138,6,1,63,87,50,63,11,24,1,4,15,61,87,6,3,74,110,52,74,16,36,4,7,16,68,110
2008-02-25 00:00:00.000,Zagreb Croatia ATP World Tour,HARD,2,Ivan Ljubicic,Teymuraz Gabashvili,Ivan Ljubicic,6-2; 6-7(5); 6-3,Q,125,19,1,60,91,51,60,17,31,2,2,15,68,91,3,2,52,88,37,52,20,36,3,6,14,57,88
2008-02-25 00:00:00.000,Zagreb Croatia ATP World Tour,HARD,2,Mario Ancic,Robin Haase,Mario Ancic,6-3; 3-6; 6-3,Q,107,13,2,48,76,37,48,18,28,2,4,14,55,76,5,1,50,77,33,50,15,27,2,5,13,48,77
2008-02-25 00:00:00.000,Zagreb Croatia ATP World Tour,HARD,2,Simone Bolelli,Olivier Rochus,Simone Bolelli,7-6(5); 6-4,Q,92,4,0,54,74,38,54,12,20,4,5,11,50,74,4,2,38,59,26,38,14,21,0,2,11,40,59
2008-02-25 00:00:00.000,Zagreb Croatia ATP World Tour,HARD,2,Sergiy Stakhovsky,Janko Tipsarevic,Sergiy Stakhovsky,3-6; 6-4; 6-2,Q,108,7,4,54,90,39,54,18,36,5,7,14,57,90,5,3,38,68,31,38,14,30,0,3,13,45,68
2008-02-25 00:00:00.000,Zagreb Croatia ATP World Tour,HARD,2,Ivan Ljubicic,Mario Ancic,Ivan Ljubicic,7-6(2); 6-4,S,120,13,1,50,84,38,50,20,34,6,6,11,58,84,10,2,42,72,33,42,17,30,5,6,11,50,72
2008-02-25 00:00:00.000,Zagreb Croatia ATP World Tour,HARD,2,Sergiy Stakhovsky,Simone Bolelli,Sergiy Stakhovsky,6-4; 6-4,S,78,4,1,33,53,27,33,14,20,0,0,10,41,53,1,1,50,70,35,50,8,20,4,6,10,43,70
2008-02-25 00:00:00.000,Zagreb Croatia ATP World Tour,HARD,2,Sergiy Stakhovsky,Ivan Ljubicic,Sergiy Stakhovsky,7-5; 6-4,F,107,5,3,40,73,30,40,20,33,1,1,11,50,73,9,0,40,69,27,40,18,29,3,5,11,45,69
2008-03-03 00:00:00.000,Dubai U.A.E. ATP World Tour,HARD,2,Andy Murray,Roger Federer,Andy Murray,6-7(6); 6-3; 6-4,R32,115,10,3,53,96,48,53,25,43,0,0,16,73,96,6,2,58,88,44,58,18,30,2,4,15,62,88
2008-03-03 00:00:00.000,Dubai U.A.E. ATP World Tour,HARD,2,Fernando Verdasco,Rainer Schuettler,Fernando Verdasco,7-6(7); 4-6; 6-1,R32,115,12,1,69,95,52,69,15,26,4,6,15,67,95,4,5,51,86,38,51,19,35,0,3,14,57,86
2008-03-03 00:00:00.000,Dubai U.A.E. ATP World Tour,HARD,2,Jan Hernych,Stanislas Wawrinka,Jan Hernych,6-4; 6-4,R32,89,0,0,45,61,28,45,10,16,0,2,10,38,61,10,3,38,60,23,38,10,22,1,5,10,33,60
2008-03-03 00:00:00.000,Dubai U.A.E. ATP World Tour,HARD,2,Nikolay Davydenko,Mohammad Ghareeb,Nikolay Davydenko,6-4; 6-0,R32,57,3,1,28,40,23,28,9,12,0,0,8,32,40,1,2,33,51,21,33,5,18,5,9,8,26,51
2008-03-03 00:00:00.000,Dubai U.A.E. ATP World Tour,HARD,2,David Ferrer,Tommy Haas,David Ferrer,6-3; 6-0,R32,81,0,2,33,53,21,33,11,20,1,2,7,32,53,4,6,35,67,19,35,10,32,4,10,8,29,67
2008-03-03 00:00:00.000,Dubai U.A.E. ATP World Tour,HARD,2,Olivier Rochus,Jarkko Nieminen,Olivier Rochus,6-1; 6-2,R32,55,1,0,24,44,18,24,15,20,3,3,8,33,44,3,3,21,38,10,21,7,17,3,7,7,17,38
2008-03-03 00:00:00.000,Dubai U.A.E. ATP World Tour,HARD,2,Feliciano Lopez,Janko Tipsarevic,Feliciano Lopez,6-3; 4-6; 6-4,R32,109,19,6,45,98,42,45,24,53,1,2,15,66,98,8,2,32,68,25,32,25,36,2,4,14,50,68
2008-03-03 00:00:00.000,Dubai U.A.E. ATP World Tour,HARD,2,Tomas Berdych,Gael Monfils,Tomas Berdych,6-3; 6-2,R32,53,5,1,27,45,20,27,16,18,0,0,9,36,45,8,1,26,40,17,26,6,14,2,5,8,23,40
2008-03-03 00:00:00.000,Dubai U.A.E. ATP World Tour,HARD,2,Richard Gasquet,Dmitry Tursunov,Richard Gasquet,6-4; 6-4,R32,66,11,3,37,58,31,37,10,21,5,6,10,41,58,4,2,27,52,21,27,11,25,2,5,10,32,52
2008-03-03 00:00:00.000,Dubai U.A.E. ATP World Tour,HARD,2,Igor Andreev,Jan Minar,Igor Andreev,6-3; 6-4,R32,66,7,3,31,55,24,31,17,24,2,2,10,41,55,2,2,42,48,30,42,2,6,1,3,9,32,48
2008-03-03 00:00:00.000,Dubai U.A.E. ATP World Tour,HARD,2,Fabrice Santoro,Mikhail Youzhny,Fabrice Santoro,6-3; 6-4,R32,83,6,1,32,55,25,32,15,23,3,4,10,40,55,1,4,32,61,23,32,12,29,5,8,9,35,61
2008-03-03 00:00:00.000,Dubai U.A.E. ATP World Tour,HARD,2,Novak Djokovic,Marin Cilic,Novak Djokovic,6-4; 6-3,R32,78,5,2,34,51,27,34,11,17,0,0,9,38,51,2,4,28,64,19,28,17,36,2,5,10,36,64
2008-03-03 00:00:00.000,Dubai U.A.E. ATP World Tour,HARD,2,Andy Roddick,Juan Carlos Ferrero,Andy Roddick,6-2; 6-4,R32,60,18,0,39,50,31,39,8,11,0,0,9,39,50,2,1,29,50,18,29,11,21,2,5,9,29,50
2008-03-03 00:00:00.000,Dubai U.A.E. ATP World Tour,HARD,2,Paul-Henri Mathieu,Joseph Sirianni,Paul-Henri Mathieu,6-4; 6-4,R32,87,9,2,47,71,34,47,13,24,10,11,10,47,71,3,3,30,60,18,30,17,30,2,5,10,35,60
2008-03-03 00:00:00.000,Dubai U.A.E. ATP World Tour,HARD,2,Mikhail Ledovskikh,Mahmoud-Nader Al Baloushi,Mikhail Ledovskikh,6-1; 6-1,R32,46,6,2,24,34,23,24,5,10,0,0,7,28,34,1,4,35,52,16,35,5,17,5,10,7,21,52
2008-03-03 00:00:00.000,Dubai U.A.E. ATP World Tour,HARD,2,Rafael Nadal,Philipp Kohlschreiber,Rafael Nadal,3-6; 6-1; 6-4,R32,143,5,2,66,89,42,66,12,23,7,10,13,54,89,12,2,53,93,34,53,16,40,8,13,13,50,93
2008-03-03 00:00:00.000,Dubai U.A.E. ATP World Tour,HARD,2,Andy Murray,Fernando Verdasco,Andy Murray,6-3; 3-6; 7-6(5),R16,144,4,1,54,99,41,54,21,45,6,9,15,62,99,5,4,59,96,41,59,22,37,6,9,15,63,96
2008-03-03 00:00:00.000,Dubai U.A.E. ATP World Tour,HARD,2,Nikolay Davydenko,Jan Hernych,Nikolay Davydenko,6-1; 6-4,R16,73,0,2,34,55,23,34,12,21,3,5,9,35,55,0,1,23,46,10,23,10,23,1,6,8,20,46
2008-03-03 00:00:00.000,Dubai U.A.E. ATP World Tour,HARD,2,David Ferrer,Olivier Rochus,David Ferrer,3-6; 7-5; 6-1,R16,152,6,2,69,98,52,69,11,29,7,9,14,63,98,0,2,53,89,34,53,19,36,1,5,14,53,89
2008-03-03 00:00:00.000,Dubai U.A.E. ATP World Tour,HARD,2,Feliciano Lopez,Tomas Berdych,Feliciano Lopez,6-2; 7-5,R16,71,10,1,31,54,26,31,15,23,2,3,10,41,54,1,2,32,56,19,32,11,24,1,5,10,30,56
2008-03-03 00:00:00.000,Dubai U.A.E. ATP World Tour,HARD,2,Igor Andreev,Richard Gasquet,Igor Andreev,6-3; 6-4,R16,77,2,0,36,51,30,36,12,15,1,1,10,42,51,1,3,42,69,34,42,7,27,3,5,9,41,69
2008-03-03 00:00:00.000,Dubai U.A.E. ATP World Tour,HARD,2,Novak Djokovic,Fabrice Santoro,Novak Djokovic,6-3; 7-6(3),R16,96,9,1,41,62,34,41,16,21,3,4,11,50,62,2,1,37,73,26,37,20,36,4,6,10,46,73
2008-03-03 00:00:00.000,Dubai U.A.E. ATP World Tour,HARD,2,Andy Roddick,Paul-Henri Mathieu,Andy Roddick,6-3; 6-4,R16,78,13,1,40,68,34,40,13,28,5,5,10,47,68,2,0,22,51,13,22,19,29,0,2,9,32,51
2008-03-03 00:00:00.000,Dubai U.A.E. ATP World Tour,HARD,2,Rafael Nadal,Mikhail Ledovskikh,Rafael Nadal,6-4; 6-0,R16,71,5,1,29,41,24,29,9,12,0,0,8,33,41,8,3,37,61,23,37,7,24,6,10,8,30,61
2008-03-03 00:00:00.000,Dubai U.A.E. ATP World Tour,HARD,2,Nikolay Davydenko,Andy Murray,Nikolay Davydenko,7-5; 6-4,Q,104,1,4,57,73,39,57,9,16,5,6,11,48,73,6,1,45,73,33,45,11,28,3,6,11,44,73
2008-03-03 00:00:00.000,Dubai U.A.E. ATP World Tour,HARD,2,Feliciano Lopez,David Ferrer,Feliciano Lopez,6-4; 6-3,Q,71,10,2,44,65,34,44,7,21,4,6,10,41,65,1,1,30,50,17,30,8,20,3,7,9,25,50
2008-03-03 00:00:00.000,Dubai U.A.E. ATP World Tour,HARD,2,Novak Djokovic,Igor Andreev,Novak Djokovic,6-2; 6-1,Q,56,1,1,24,38,19,24,10,14,2,2,7,29,38,1,1,34,44,16,34,3,10,1,6,8,19,44
2008-03-03 00:00:00.000,Dubai U.A.E. ATP World Tour,HARD,2,Andy Roddick,Rafael Nadal,Andy Roddick,7-6(5); 6-2,Q,108,17,1,48,71,38,48,13,23,6,6,10,51,71,2,2,58,77,39,58,9,19,7,9,10,48,77
2008-03-03 00:00:00.000,Dubai U.A.E. ATP World Tour,HARD,2,Feliciano Lopez,Nikolay Davydenko,Feliciano Lopez,6-4; 4-6; 7-5,S,145,6,9,51,108,38,51,22,57,4,8,16,60,108,0,3,74,92,49,74,8,18,7,12,16,57,92
2008-03-03 00:00:00.000,Dubai U.A.E. ATP World Tour,HARD,2,Andy Roddick,Novak Djokovic,Andy Roddick,7-6(5); 6-3,S,90,14,2,47,68,39,47,12,21,2,2,11,51,68,9,0,56,76,41,56,8,20,4,5,10,49,76
2008-03-03 00:00:00.000,Dubai U.A.E. ATP World Tour,HARD,2,Andy Roddick,Feliciano Lopez,Andy Roddick,6-7(8); 6-4; 6-2,F,115,22,1,55,84,48,55,19,29,0,0,15,67,84,24,2,62,95,45,62,18,33,4,7,15,63,95
2008-03-03 00:00:00.000,Las Vegas NV; U.S.A. ATP World Tour,HARD,2,Fernando Gonzalez,Dudi Sela,Fernando Gonzalez,6-2; 7-6(2),R32,81,4,4,26,57,20,26,20,31,3,5,10,40,57,2,6,44,76,29,44,10,32,3,7,10,39,76
2008-03-03 00:00:00.000,Las Vegas NV; U.S.A. ATP World Tour,HARD,2,Evgeny Korolev,Sergio Roitman,Evgeny Korolev,6-4; 4-6; 6-3,R32,110,6,9,55,97,42,55,17,42,5,8,15,59,97,2,6,59,86,37,59,14,27,1,5,14,51,86
2008-03-03 00:00:00.000,Las Vegas NV; U.S.A. ATP World Tour,HARD,2,John Isner,Alejandro Falla,John Isner,4-6; 6-3; 6-4,R32,109,17,2,55,95,39,55,26,40,5,6,15,65,95,3,4,52,84,37,52,19,32,3,5,14,56,84
2008-03-03 00:00:00.000,Las Vegas NV; U.S.A. ATP World Tour,HARD,2,Kevin Anderson,Michael Llodra,Kevin Anderson,6-2; 7-6(2),R32,82,10,5,40,67,29,40,18,27,1,2,10,47,67,2,4,33,65,21,33,15,32,3,6,10,36,65
2008-03-03 00:00:00.000,Las Vegas NV; U.S.A. ATP World Tour,HARD,2,Marcos Baghdatis,Vincent Spadea,Marcos Baghdatis,7-6(5); 6-1,R32,71,2,5,31,57,27,31,15,26,0,1,10,42,57,0,5,33,67,21,33,16,34,5,8,9,37,67
2008-03-03 00:00:00.000,Las Vegas NV; U.S.A. ATP World Tour,HARD,2,Robby Ginepri,Xavier Malisse,Robby Ginepri,2-6; 6-3; 6-4,R32,117,2,2,63,109,43,63,19,46,12,16,14,62,109,6,4,43,84,31,43,17,41,6,10,13,48,84
2008-03-03 00:00:00.000,Las Vegas NV; U.S.A. ATP World Tour,HARD,2,Ernests Gulbis,Nicolas Massu,Ernests Gulbis,7-5; 4-6; 6-4,R32,114,19,8,58,104,44,58,25,46,5,6,16,69,104,7,4,55,84,43,55,18,29,3,5,16,61,84
2008-03-03 00:00:00.000,Las Vegas NV; U.S.A. ATP World Tour,HARD,2,Peter Luczak,Mischa Zverev,Peter Luczak,6-2; 1-0 RET,R32,27,4,0,12,19,11,12,5,7,0,0,4,16,19,2,1,20,31,10,20,4,11,3,6,5,14,31
2008-03-03 00:00:00.000,Las Vegas NV; U.S.A. ATP World Tour,HARD,2,Potito Starace,Carlos Berlocq,Potito Starace,7-6(5); 6-0,R32,90,3,0,47,64,33,47,9,17,4,5,9,42,64,1,4,32,66,18,32,14,34,5,9,9,32,66
2008-03-03 00:00:00.000,Las Vegas NV; U.S.A. ATP World Tour,HARD,2,Amer Delic,Jurgen Melzer,Amer Delic,7-5; 7-6(2),R32,88,10,3,43,75,35,43,19,32,4,4,12,54,75,2,0,48,64,35,48,9,16,0,1,12,44,64
2008-03-03 00:00:00.000,Las Vegas NV; U.S.A. ATP World Tour,HARD,2,Chris Guccione,Victor Hanescu,Chris Guccione,6-2; 4-6; 7-6(5),R32,98,12,2,46,85,41,46,23,39,1,2,15,64,85,10,1,61,81,46,61,13,20,1,3,15,59,81
2008-03-03 00:00:00.000,Las Vegas NV; U.S.A. ATP World Tour,HARD,2,Guillermo Canas,Thomas Johansson,Guillermo Canas,6-3; 7-6(3),R32,95,3,4,39,72,32,39,19,33,0,1,11,51,72,4,1,33,62,24,33,16,29,3,5,10,40,62
2008-03-03 00:00:00.000,Las Vegas NV; U.S.A. ATP World Tour,HARD,2,Nicolas Kiefer,Benjamin Becker,Nicolas Kiefer,6-4; 6-3,R32,80,8,6,39,68,25,39,15,29,7,10,10,40,68,4,4,20,52,15,20,12,32,4,9,9,27,52
2008-03-03 00:00:00.000,Las Vegas NV; U.S.A. ATP World Tour,HARD,2,Sam Querrey,Sebastien Grosjean,Sam Querrey,6-2; 4-6; 7-6(8),R32,125,9,7,53,102,42,53,26,49,4,7,15,68,102,0,1,45,109,32,45,36,64,4,8,15,68,109
2008-03-03 00:00:00.000,Las Vegas NV; U.S.A. ATP World Tour,HARD,2,Julien Benneteau,Jonas Bjorkman,Julien Benneteau,6-4; 7-6(4),R32,93,6,5,46,73,34,46,15,27,2,4,11,49,73,4,3,33,66,22,33,18,33,1,4,11,40,66
2008-03-03 00:00:00.000,Las Vegas NV; U.S.A. ATP World Tour,HARD,2,Lleyton Hewitt,Marat Safin,Lleyton Hewitt,6-2; 6-1,R32,57,7,2,23,46,19,23,15,23,2,2,8,34,46,3,3,20,42,8,20,11,22,2,6,7,19,42
2008-03-03 00:00:00.000,Las Vegas NV; U.S.A. ATP World Tour,HARD,2,Evgeny Korolev,Fernando Gonzalez,Evgeny Korolev,6-3; 7-6(4),R16,97,3,2,42,91,26,42,32,49,4,6,11,58,91,4,4,38,65,28,38,11,27,5,8,10,39,65
2008-03-03 00:00:00.000,Las Vegas NV; U.S.A. ATP World Tour,HARD,2,Kevin Anderson,John Isner,Kevin Anderson,7-6(2); 7-5,R16,101,5,3,44,67,37,44,17,23,0,0,12,54,67,11,4,40,85,29,40,25,45,3,4,12,54,85
2008-03-03 00:00:00.000,Las Vegas NV; U.S.A. ATP World Tour,HARD,2,Robby Ginepri,Marcos Baghdatis,Robby Ginepri,7-6(2); 6-3,R16,97,5,2,45,71,34,45,16,26,2,3,11,50,71,6,7,45,89,31,45,22,44,3,5,10,53,89
2008-03-03 00:00:00.000,Las Vegas NV; U.S.A. ATP World Tour,HARD,2,Ernests Gulbis,Peter Luczak,Ernests Gulbis,6-2; 6-1,R16,55,12,5,25,48,22,25,11,23,2,2,7,33,48,2,3,27,48,15,27,8,21,4,9,8,23,48
2008-03-03 00:00:00.000,Las Vegas NV; U.S.A. ATP World Tour,HARD,2,Amer Delic,Potito Starace,Amer Delic,6-3; 3-0 RET,R16,47,1,1,20,35,14,20,11,15,1,1,6,25,35,0,2,19,33,12,19,5,14,1,4,6,17,33
2008-03-03 00:00:00.000,Las Vegas NV; U.S.A. ATP World Tour,HARD,2,Guillermo Canas,Chris Guccione,Guillermo Canas,6-2; 7-5,R16,84,3,2,39,60,28,39,14,21,7,8,10,42,60,8,4,46,81,28,46,15,35,10,14,10,43,81
2008-03-03 00:00:00.000,Las Vegas NV; U.S.A. ATP World Tour,HARD,2,Sam Querrey,Nicolas Kiefer,Sam Querrey,6-3; 6-1,R16,58,6,3,23,53,17,23,17,30,1,2,8,34,53,2,0,27,47,12,27,9,20,1,6,8,21,47
2008-03-03 00:00:00.000,Las Vegas NV; U.S.A. ATP World Tour,HARD,2,Julien Benneteau,Lleyton Hewitt,Julien Benneteau,6-3; 7-5,R16,106,5,3,43,71,32,43,12,28,7,10,11,44,71,2,4,34,74,16,34,20,40,11,16,10,36,74
2008-03-03 00:00:00.000,Las Vegas NV; U.S.A. ATP World Tour,HARD,2,Kevin Anderson,Evgeny Korolev,Kevin Anderson,6-2; 6-0,Q,54,8,1,25,37,20,25,10,12,2,2,7,30,37,2,4,23,48,12,23,9,25,3,8,7,21,48
2008-03-03 00:00:00.000,Las Vegas NV; U.S.A. ATP World Tour,HARD,2,Robby Ginepri,Ernests Gulbis,Robby Ginepri,6-1; 6-2,Q,54,3,6,27,47,24,27,9,20,1,1,8,33,47,5,3,26,50,15,26,9,24,0,4,7,24,50
2008-03-03 00:00:00.000,Las Vegas NV; U.S.A. ATP World Tour,HARD,2,Guillermo Canas,Amer Delic,Guillermo Canas,6-4; 6-4,Q,80,2,0,30,51,26,30,14,21,0,0,10,40,51,3,2,37,64,27,37,14,27,5,7,10,41,64
2008-03-03 00:00:00.000,Las Vegas NV; U.S.A. ATP World Tour,HARD,2,Sam Querrey,Julien Benneteau,Sam Querrey,7-5; 6-2,Q,72,6,1,35,60,26,35,18,25,2,2,10,44,60,0,0,36,56,27,36,8,20,2,5,10,35,56
2008-03-03 00:00:00.000,Las Vegas NV; U.S.A. ATP World Tour,HARD,2,Kevin Anderson,Robby Ginepri,Kevin Anderson,7-6(4); 6-4,S,89,6,0,53,78,40,53,12,25,3,5,11,52,78,5,0,37,60,27,37,14,23,2,5,11,41,60
2008-03-03 00:00:00.000,Las Vegas NV; U.S.A. ATP World Tour,HARD,2,Sam Querrey,Guillermo Canas,Sam Querrey,7-5; 6-2,S,100,6,2,44,85,30,44,20,41,4,6,10,50,85,3,3,35,69,21,35,15,34,4,9,10,36,69
2008-03-03 00:00:00.000,Las Vegas NV; U.S.A. ATP World Tour,HARD,2,Sam Querrey,Kevin Anderson,Sam Querrey,4-6; 6-3; 6-4,F,121,12,5,63,110,51,63,23,47,9,10,15,74,110,7,1,64,89,46,64,11,25,2,4,14,57,89
2008-03-13 00:00:00.000,ATP Masters Series Indian Wells CA; U.S.A. ATP World Tour,HARD,2,Roger Federer,N/A Bye,Roger Federer,,R128,0,0,0,0,0,0,0,0,0,0,0,0,0,0,0,0,0,0,0,0,0,0,0,0,0,0,0
2008-03-13 00:00:00.000,ATP Masters Series Indian Wells CA; U.S.A. ATP World Tour,HARD,2,Guillermo Garcia-Lopez,Sergio Roitman,Guillermo Garcia-Lopez,6-1; 6-4,R128,91,2,6,44,67,32,44,9,23,6,7,8,41,67,0,2,52,83,27,52,14,31,10,15,9,41,83
2008-03-13 00:00:00.000,ATP Masters Series Indian Wells CA; U.S.A. ATP World Tour,HARD,2,Nicolas Mahut,Evgeny Korolev,Nicolas Mahut,3-6; 6-2; 6-2,R128,124,2,3,55,92,33,55,19,37,6,9,12,52,92,1,6,50,89,27,50,21,39,8,14,13,48,89
2008-03-13 00:00:00.000,ATP Masters Series Indian Wells CA; U.S.A. ATP World Tour,HARD,2,Nicolas Almagro,N/A Bye,Nicolas Almagro,,R128,0,0,0,0,0,0,0,0,0,0,0,0,0,0,0,0,0,0,0,0,0,0,0,0,0,0,0
2008-03-13 00:00:00.000,ATP Masters Series Indian Wells CA; U.S.A. ATP World Tour,HARD,2,Ivan Ljubicic,N/A Bye,Ivan Ljubicic,,R128,0,0,0,0,0,0,0,0,0,0,0,0,0,0,0,0,0,0,0,0,0,0,0,0,0,0,0
2008-03-13 00:00:00.000,ATP Masters Series Indian Wells CA; U.S.A. ATP World Tour,HARD,2,Marin Cilic,Kei Nishikori,Marin Cilic,6-2; 6-4,R128,70,5,2,34,54,28,34,10,20,4,5,9,38,54,1,3,36,58,20,36,13,22,7,11,9,33,58
2008-03-13 00:00:00.000,ATP Masters Series Indian Wells CA; U.S.A. ATP World Tour,HARD,2,Nicolas Massu,Janko Tipsarevic,Nicolas Massu,6-4; 3-6; 7-6(4),R128,192,10,4,63,113,43,63,29,50,9,12,15,72,113,20,10,63,128,47,63,32,65,10,13,16,79,128
2008-03-13 00:00:00.000,ATP Masters Series Indian Wells CA; U.S.A. ATP World Tour,HARD,2,Tommy Robredo,N/A Bye,Tommy Robredo,,R128,0,0,0,0,0,0,0,0,0,0,0,0,0,0,0,0,0,0,0,0,0,0,0,0,0,0,0
2008-03-13 00:00:00.000,ATP Masters Series Indian Wells CA; U.S.A. ATP World Tour,HARD,2,Andy Murray,N/A Bye,Andy Murray,,R128,0,0,0,0,0,0,0,0,0,0,0,0,0,0,0,0,0,0,0,0,0,0,0,0,0,0,0
2008-03-13 00:00:00.000,ATP Masters Series Indian Wells CA; U.S.A. ATP World Tour,HARD,2,Jurgen Melzer,Marat Safin,Jurgen Melzer,7-6(5); 2-6; 6-2,R128,114,5,3,50,84,38,50,17,34,1,4,14,55,84,6,7,48,94,36,48,23,46,5,8,14,59,94
2008-03-13 00:00:00.000,ATP Masters Series Indian Wells CA; U.S.A. ATP World Tour,HARD,2,Rik De Voest,Michael Berrer,Rik De Voest,7-6(4); 7-5,R128,104,1,3,53,75,36,53,13,22,2,4,12,49,75,3,6,48,83,31,48,19,35,8,11,12,50,83
2008-03-13 00:00:00.000,ATP Masters Series Indian Wells CA; U.S.A. ATP World Tour,HARD,2,Ivo Karlovic,N/A Bye,Ivo Karlovic,,R128,0,0,0,0,0,0,0,0,0,0,0,0,0,0,0,0,0,0,0,0,0,0,0,0,0,0,0
2008-03-13 00:00:00.000,ATP Masters Series Indian Wells CA; U.S.A. ATP World Tour,HARD,2,Fernando Verdasco,N/A Bye,Fernando Verdasco,,R128,0,0,0,0,0,0,0,0,0,0,0,0,0,0,0,0,0,0,0,0,0,0,0,0,0,0,0
2008-03-13 00:00:00.000,ATP Masters Series Indian Wells CA; U.S.A. ATP World Tour,HARD,2,Victor Hanescu,Albert Montanes,Victor Hanescu,1-6; 6-4; 6-4,R128,101,1,1,62,81,41,62,13,19,4,7,14,54,81,3,1,45,76,31,45,22,31,1,3,13,53,76
2008-03-13 00:00:00.000,ATP Masters Series Indian Wells CA; U.S.A. ATP World Tour,HARD,2,Tommy Haas,Julien Benneteau,Tommy Haas,3-6; 6-0; 6-2,R128,99,2,1,43,69,29,43,14,26,1,4,12,43,69,2,8,45,73,28,45,8,28,8,14,11,36,73
2008-03-13 00:00:00.000,ATP Masters Series Indian Wells CA; U.S.A. ATP World Tour,HARD,2,Andy Roddick,N/A Bye,Andy Roddick,,R128,0,0,0,0,0,0,0,0,0,0,0,0,0,0,0,0,0,0,0,0,0,0,0,0,0,0,0
2008-03-13 00:00:00.000,ATP Masters Series Indian Wells CA; U.S.A. ATP World Tour,HARD,2,Nikolay Davydenko,N/A Bye,Nikolay Davydenko,,R128,0,0,0,0,0,0,0,0,0,0,0,0,0,0,0,0,0,0,0,0,0,0,0,0,0,0,0
2008-03-13 00:00:00.000,ATP Masters Series Indian Wells CA; U.S.A. ATP World Tour,HARD,2,John Isner,Simone Bolelli,John Isner,6-3; 6-7(5); 7-6(2),R128,146,16,2,77,109,62,77,18,32,5,6,17,80,109,10,2,72,110,50,72,26,38,5,7,16,76,110
2008-03-13 00:00:00.000,ATP Masters Series Indian Wells CA; U.S.A. ATP World Tour,HARD,2,Mardy Fish,Florian Mayer,Mardy Fish,7-5; 6-4,R128,95,2,3,47,80,35,47,14,33,8,10,11,49,80,1,1,59,87,36,59,11,28,9,13,11,47,87
2008-03-13 00:00:00.000,ATP Masters Series Indian Wells CA; U.S.A. ATP World Tour,HARD,2,Igor Andreev,N/A Bye,Igor Andreev,,R128,0,0,0,0,0,0,0,0,0,0,0,0,0,0,0,0,0,0,0,0,0,0,0,0,0,0,0
2008-03-13 00:00:00.000,ATP Masters Series Indian Wells CA; U.S.A. ATP World Tour,HARD,2,Lleyton Hewitt,N/A Bye,Lleyton Hewitt,,R128,0,0,0,0,0,0,0,0,0,0,0,0,0,0,0,0,0,0,0,0,0,0,0,0,0,0,0
2008-03-13 00:00:00.000,ATP Masters Series Indian Wells CA; U.S.A. ATP World Tour,HARD,2,Sam Querrey,Luis Horna,Sam Querrey,7-6(5); 6-3,R128,81,12,2,40,67,36,40,16,27,1,1,11,52,67,4,0,46,69,33,46,14,23,4,5,10,47,69
2008-03-13 00:00:00.000,ATP Masters Series Indian Wells CA; U.S.A. ATP World Tour,HARD,2,Gilles Simon,Carlos Berlocq,Gilles Simon,6-2; 6-3,R128,77,0,5,34,61,22,34,17,27,1,2,9,39,61,0,3,43,67,27,43,6,24,6,10,8,33,67
2008-03-13 00:00:00.000,ATP Masters Series Indian Wells CA; U.S.A. ATP World Tour,HARD,2,Mikhail Youzhny,N/A Bye,Mikhail Youzhny,,R128,0,0,0,0,0,0,0,0,0,0,0,0,0,0,0,0,0,0,0,0,0,0,0,0,0,0,0
2008-03-13 00:00:00.000,ATP Masters Series Indian Wells CA; U.S.A. ATP World Tour,HARD,2,Fernando Gonzalez,N/A Bye,Fernando Gonzalez,,R128,0,0,0,0,0,0,0,0,0,0,0,0,0,0,0,0,0,0,0,0,0,0,0,0,0,0,0
2008-03-13 00:00:00.000,ATP Masters Series Indian Wells CA; U.S.A. ATP World Tour,HARD,2,Mario Ancic,Gael Monfils,Mario Ancic,6-3; 6-2,R128,83,2,1,39,54,27,39,9,15,2,3,9,36,54,5,7,32,63,21,32,10,31,5,9,8,31,63
2008-03-13 00:00:00.000,ATP Masters Series Indian Wells CA; U.S.A. ATP World Tour,HARD,2,Thomas Johansson,Yen-Hsun Lu,Thomas Johansson,6-4; 6-7(2); 6-4,R128,155,8,5,70,106,50,70,17,36,6,9,16,67,106,5,12,79,123,56,79,16,44,8,13,16,72,123
2008-03-13 00:00:00.000,ATP Masters Series Indian Wells CA; U.S.A. ATP World Tour,HARD,2,Juan Carlos Ferrero,N/A Bye,Juan Carlos Ferrero,,R128,0,0,0,0,0,0,0,0,0,0,0,0,0,0,0,0,0,0,0,0,0,0,0,0,0,0,0
2008-03-13 00:00:00.000,ATP Masters Series Indian Wells CA; U.S.A. ATP World Tour,HARD,2,Radek Stepanek,N/A Bye,Radek Stepanek,,R128,0,0,0,0,0,0,0,0,0,0,0,0,0,0,0,0,0,0,0,0,0,0,0,0,0,0,0
2008-03-13 00:00:00.000,ATP Masters Series Indian Wells CA; U.S.A. ATP World Tour,HARD,2,Max Mirnyi,Jose Acasuso,Max Mirnyi,7-5; 7-5,R128,93,11,3,50,70,40,50,10,20,3,4,12,50,70,6,3,40,67,27,40,15,27,2,5,12,42,67
2008-03-13 00:00:00.000,ATP Masters Series Indian Wells CA; U.S.A. ATP World Tour,HARD,2,Ernests Gulbis,Oscar Hernandez,Ernests Gulbis,6-2; 6-1,R128,55,6,4,22,38,18,22,10,16,0,0,7,28,38,0,4,34,55,18,34,7,21,5,10,8,25,55
2008-03-13 00:00:00.000,ATP Masters Series Indian Wells CA; U.S.A. ATP World Tour,HARD,2,David Nalbandian,N/A Bye,David Nalbandian,,R128,0,0,0,0,0,0,0,0,0,0,0,0,0,0,0,0,0,0,0,0,0,0,0,0,0,0,0
2008-03-13 00:00:00.000,ATP Masters Series Indian Wells CA; U.S.A. ATP World Tour,HARD,2,David Ferrer,N/A Bye,David Ferrer,,R128,0,0,0,0,0,0,0,0,0,0,0,0,0,0,0,0,0,0,0,0,0,0,0,0,0,0,0
2008-03-13 00:00:00.000,ATP Masters Series Indian Wells CA; U.S.A. ATP World Tour,HARD,2,Olivier Rochus,Arnaud Clement,Olivier Rochus,6-4; 6-4,R128,111,2,2,38,61,27,38,14,23,3,4,10,41,61,7,5,33,77,19,33,24,44,5,8,10,43,77
2008-03-13 00:00:00.000,ATP Masters Series Indian Wells CA; U.S.A. ATP World Tour,HARD,2,Hyung-Taik Lee,Michael Llodra,Hyung-Taik Lee,6-2; 6-3,R128,69,3,3,38,63,28,38,12,25,2,3,9,40,63,1,3,26,43,17,26,5,17,1,5,8,22,43
2008-03-13 00:00:00.000,ATP Masters Series Indian Wells CA; U.S.A. ATP World Tour,HARD,2,Jarkko Nieminen,N/A Bye,Jarkko Nieminen,,R128,0,0,0,0,0,0,0,0,0,0,0,0,0,0,0,0,0,0,0,0,0,0,0,0,0,0,0
2008-03-13 00:00:00.000,ATP Masters Series Indian Wells CA; U.S.A. ATP World Tour,HARD,2,Marcos Baghdatis,N/A Bye,Marcos Baghdatis,,R128,0,0,0,0,0,0,0,0,0,0,0,0,0,0,0,0,0,0,0,0,0,0,0,0,0,0,0
2008-03-13 00:00:00.000,ATP Masters Series Indian Wells CA; U.S.A. ATP World Tour,HARD,2,Wayne Odesnik,Igor Kunitsyn,Wayne Odesnik,2-6; 7-6(3); 6-3,R128,164,7,3,66,96,42,66,15,30,7,12,15,57,96,1,1,65,120,45,65,25,55,15,19,14,70,120
2008-03-13 00:00:00.000,ATP Masters Series Indian Wells CA; U.S.A. ATP World Tour,HARD,2,Stanislas Wawrinka,Jesse Levine,Stanislas Wawrinka,7-5; 4-6; 6-4,R128,156,11,3,57,101,37,57,25,44,4,8,16,62,101,6,3,63,108,43,63,20,45,7,12,16,63,108
2008-03-13 00:00:00.000,ATP Masters Series Indian Wells CA; U.S.A. ATP World Tour,HARD,2,Tomas Berdych,N/A Bye,Tomas Berdych,,R128,0,0,0,0,0,0,0,0,0,0,0,0,0,0,0,0,0,0,0,0,0,0,0,0,0,0,0
2008-03-13 00:00:00.000,ATP Masters Series Indian Wells CA; U.S.A. ATP World Tour,HARD,2,Guillermo Canas,N/A Bye,Guillermo Canas,,R128,0,0,0,0,0,0,0,0,0,0,0,0,0,0,0,0,0,0,0,0,0,0,0,0,0,0,0
2008-03-13 00:00:00.000,ATP Masters Series Indian Wells CA; U.S.A. ATP World Tour,HARD,2,Jonas Bjorkman,Filippo Volandri,Jonas Bjorkman,6-3; 7-6(5),R128,78,10,3,36,61,31,36,15,25,1,2,11,46,61,2,4,32,62,22,32,18,30,2,4,10,40,62
2008-03-13 00:00:00.000,ATP Masters Series Indian Wells CA; U.S.A. ATP World Tour,HARD,2,Robin Haase,Dusan Vemic,Robin Haase,3-6; 6-3; 6-2,R128,92,5,0,43,72,36,43,19,29,6,7,13,55,72,5,4,46,72,31,46,16,26,0,3,13,47,72
2008-03-13 00:00:00.000,ATP Masters Series Indian Wells CA; U.S.A. ATP World Tour,HARD,2,Juan Monaco,N/A Bye,Juan Monaco,,R128,0,0,0,0,0,0,0,0,0,0,0,0,0,0,0,0,0,0,0,0,0,0,0,0,0,0,0
2008-03-13 00:00:00.000,ATP Masters Series Indian Wells CA; U.S.A. ATP World Tour,HARD,2,Philipp Kohlschreiber,N/A Bye,Philipp Kohlschreiber,,R128,0,0,0,0,0,0,0,0,0,0,0,0,0,0,0,0,0,0,0,0,0,0,0,0,0,0,0
2008-03-13 00:00:00.000,ATP Masters Series Indian Wells CA; U.S.A. ATP World Tour,HARD,2,Xavier Malisse,Florent Serra,Xavier Malisse,6-7(5); 6-2; 6-0,R128,119,14,1,49,89,42,49,19,40,3,3,13,61,89,9,4,58,106,35,58,21,48,9,14,13,56,106
2008-03-13 00:00:00.000,ATP Masters Series Indian Wells CA; U.S.A. ATP World Tour,HARD,2,Andreas Seppi,Paul Capdeville,Andreas Seppi,4-6; 7-6(3); 6-2,R128,133,7,4,56,93,37,56,20,37,3,7,15,57,93,8,2,69,98,44,69,14,29,6,11,15,58,98
2008-03-13 00:00:00.000,ATP Masters Series Indian Wells CA; U.S.A. ATP World Tour,HARD,2,Novak Djokovic,N/A Bye,Novak Djokovic,,R128,0,0,0,0,0,0,0,0,0,0,0,0,0,0,0,0,0,0,0,0,0,0,0,0,0,0,0
2008-03-13 00:00:00.000,ATP Masters Series Indian Wells CA; U.S.A. ATP World Tour,HARD,2,Richard Gasquet,N/A Bye,Richard Gasquet,,R128,0,0,0,0,0,0,0,0,0,0,0,0,0,0,0,0,0,0,0,0,0,0,0,0,0,0,0
2008-03-13 00:00:00.000,ATP Masters Series Indian Wells CA; U.S.A. ATP World Tour,HARD,2,Robin Soderling,Sebastien Grosjean,Robin Soderling,6-3; 6-3,R128,87,7,5,26,60,19,26,19,34,2,3,9,38,60,5,1,34,75,26,34,15,41,7,11,9,41,75
2008-03-13 00:00:00.000,ATP Masters Series Indian Wells CA; U.S.A. ATP World Tour,HARD,2,Dmitry Tursunov,Benjamin Becker,Dmitry Tursunov,7-6(4); 6-3,R128,78,6,1,41,67,30,41,16,26,1,2,11,46,67,6,1,36,57,29,36,8,21,0,2,10,37,57
2008-03-13 00:00:00.000,ATP Masters Series Indian Wells CA; U.S.A. ATP World Tour,HARD,2,Juan Ignacio Chela,N/A Bye,Juan Ignacio Chela,,R128,0,0,0,0,0,0,0,0,0,0,0,0,0,0,0,0,0,0,0,0,0,0,0,0,0,0,0
2008-03-13 00:00:00.000,ATP Masters Series Indian Wells CA; U.S.A. ATP World Tour,HARD,2,Carlos Moya,N/A Bye,Carlos Moya,,R128,0,0,0,0,0,0,0,0,0,0,0,0,0,0,0,0,0,0,0,0,0,0,0,0,0,0,0
2008-03-13 00:00:00.000,ATP Masters Series Indian Wells CA; U.S.A. ATP World Tour,HARD,2,Robby Ginepri,Vincent Spadea,Robby Ginepri,6-1; 6-1,R128,64,3,1,33,46,24,33,7,13,0,0,7,31,46,1,1,21,47,11,21,10,26,3,8,7,21,47
2008-03-13 00:00:00.000,ATP Masters Series Indian Wells CA; U.S.A. ATP World Tour,HARD,2,Marc Gicquel,Potito Starace,Marc Gicquel,6-4; 6-3,R128,84,5,2,43,75,29,43,19,32,7,8,10,48,75,2,2,39,61,19,39,14,22,4,7,9,33,61
2008-03-13 00:00:00.000,ATP Masters Series Indian Wells CA; U.S.A. ATP World Tour,HARD,2,James Blake,N/A Bye,James Blake,,R128,0,0,0,0,0,0,0,0,0,0,0,0,0,0,0,0,0,0,0,0,0,0,0,0,0,0,0
2008-03-13 00:00:00.000,ATP Masters Series Indian Wells CA; U.S.A. ATP World Tour,HARD,2,Paul-Henri Mathieu,N/A Bye,Paul-Henri Mathieu,,R128,0,0,0,0,0,0,0,0,0,0,0,0,0,0,0,0,0,0,0,0,0,0,0,0,0,0,0
2008-03-13 00:00:00.000,ATP Masters Series Indian Wells CA; U.S.A. ATP World Tour,HARD,2,Fabio Fognini,Rainer Schuettler,Fabio Fognini,2-6; 6-3; 6-3,R128,124,2,7,55,96,36,55,20,41,8,12,13,56,96,0,4,53,100,32,53,22,47,10,15,13,54,100
2008-03-13 00:00:00.000,ATP Masters Series Indian Wells CA; U.S.A. ATP World Tour,HARD,2,Dudi Sela,Nicolas Kiefer,Dudi Sela,6-4; 6-7(4); 6-3,R128,159,1,2,68,105,46,68,20,37,0,3,16,66,105,5,1,46,96,33,46,24,50,2,7,15,57,96
2008-03-13 00:00:00.000,ATP Masters Series Indian Wells CA; U.S.A. ATP World Tour,HARD,2,Jo-Wilfried Tsonga,N/A Bye,Jo-Wilfried Tsonga,,R128,0,0,0,0,0,0,0,0,0,0,0,0,0,0,0,0,0,0,0,0,0,0,0,0,0,0,0
2008-03-13 00:00:00.000,ATP Masters Series Indian Wells CA; U.S.A. ATP World Tour,HARD,2,Feliciano Lopez,N/A Bye,Feliciano Lopez,,R128,0,0,0,0,0,0,0,0,0,0,0,0,0,0,0,0,0,0,0,0,0,0,0,0,0,0,0
2008-03-13 00:00:00.000,ATP Masters Series Indian Wells CA; U.S.A. ATP World Tour,HARD,2,Donald Young,Bobby Reynolds,Donald Young,6-3; 6-4,R128,61,5,1,27,56,21,27,20,29,2,2,10,41,56,4,3,24,45,18,24,12,21,0,2,9,30,45
2008-03-13 00:00:00.000,ATP Masters Series Indian Wells CA; U.S.A. ATP World Tour,HARD,2,Santiago Giraldo,Werner Eschauer,Santiago Giraldo,7-6(5); 6-4,R128,99,3,1,43,75,31,43,22,32,3,4,11,53,75,10,3,30,68,21,30,22,38,2,4,11,43,68
2008-03-13 00:00:00.000,ATP Masters Series Indian Wells CA; U.S.A. ATP World Tour,HARD,2,Rafael Nadal,N/A Bye,Rafael Nadal,,R128,0,0,0,0,0,0,0,0,0,0,0,0,0,0,0,0,0,0,0,0,0,0,0,0,0,0,0
2008-03-13 00:00:00.000,ATP Masters Series Indian Wells CA; U.S.A. ATP World Tour,HARD,2,Roger Federer,Guillermo Garcia-Lopez,Roger Federer,6-3; 6-2,R64,66,6,0,29,48,22,29,15,19,1,1,9,37,48,2,2,28,57,19,28,13,29,6,9,8,32,57
2008-03-13 00:00:00.000,ATP Masters Series Indian Wells CA; U.S.A. ATP World Tour,HARD,2,Nicolas Mahut,Nicolas Almagro,Nicolas Mahut,7-6(1); 6-2,R64,108,5,0,42,68,30,42,17,26,4,4,10,47,68,8,9,37,81,25,37,24,44,4,6,10,49,81
2008-03-13 00:00:00.000,ATP Masters Series Indian Wells CA; U.S.A. ATP World Tour,HARD,2,Ivan Ljubicic,Marin Cilic,Ivan Ljubicic,7-6(7); 7-5,R64,121,11,2,54,93,39,54,21,39,4,6,12,60,93,4,2,47,81,33,47,17,34,0,3,12,50,81
2008-03-13 00:00:00.000,ATP Masters Series Indian Wells CA; U.S.A. ATP World Tour,HARD,2,Tommy Robredo,Nicolas Massu,Tommy Robredo,6-4; 5-7; 7-6(5),R64,185,0,2,93,126,58,93,19,33,3,6,17,77,126,1,2,73,115,50,73,24,42,8,11,17,74,115
2008-03-13 00:00:00.000,ATP Masters Series Indian Wells CA; U.S.A. ATP World Tour,HARD,2,Andy Murray,Jurgen Melzer,Andy Murray,3-6; 6-3; 6-3,R64,112,3,1,40,75,30,40,18,35,3,6,13,48,75,6,2,60,96,40,60,14,36,9,14,14,54,96
2008-03-13 00:00:00.000,ATP Masters Series Indian Wells CA; U.S.A. ATP World Tour,HARD,2,Ivo Karlovic,Rik De Voest,Ivo Karlovic,6-3; 7-6(2),R64,117,15,0,40,58,37,40,12,18,0,0,11,49,58,4,0,44,73,29,44,18,29,3,4,10,47,73
2008-03-13 00:00:00.000,ATP Masters Series Indian Wells CA; U.S.A. ATP World Tour,HARD,2,Fernando Verdasco,Victor Hanescu,Fernando Verdasco,4-6; 6-4; 6-3,R64,124,0,2,53,71,40,53,13,18,0,2,14,53,71,5,2,103,127,62,103,10,24,15,19,15,72,127
2008-03-13 00:00:00.000,ATP Masters Series Indian Wells CA; U.S.A. ATP World Tour,HARD,2,Tommy Haas,Andy Roddick,Tommy Haas,6-4; 6-4,R64,85,4,0,48,66,34,48,12,18,2,2,10,46,66,6,2,28,52,22,28,14,24,0,2,10,36,52
2008-03-13 00:00:00.000,ATP Masters Series Indian Wells CA; U.S.A. ATP World Tour,HARD,2,Nikolay Davydenko,John Isner,Nikolay Davydenko,6-2; 7-6(3),R64,97,1,1,43,60,35,43,9,17,3,4,10,44,60,7,4,45,77,32,45,13,32,4,7,10,45,77
2008-03-13 00:00:00.000,ATP Masters Series Indian Wells CA; U.S.A. ATP World Tour,HARD,2,Mardy Fish,Igor Andreev,Mardy Fish,6-4; 6-3,R64,79,4,1,29,58,26,29,13,29,3,3,9,39,58,2,3,49,66,30,49,9,17,2,5,10,39,66
2008-03-13 00:00:00.000,ATP Masters Series Indian Wells CA; U.S.A. ATP World Tour,HARD,2,Lleyton Hewitt,Sam Querrey,Lleyton Hewitt,6-4; 6-3,R64,82,7,3,23,48,20,23,15,25,0,1,9,35,48,6,2,44,73,27,44,13,29,6,10,10,40,73
2008-03-13 00:00:00.000,ATP Masters Series Indian Wells CA; U.S.A. ATP World Tour,HARD,2,Mikhail Youzhny,Gilles Simon,Mikhail Youzhny,7-5; 6-4,R64,86,1,1,51,70,40,51,8,19,4,5,11,48,70,0,3,36,68,22,36,19,32,2,5,11,41,68
2008-03-13 00:00:00.000,ATP Masters Series Indian Wells CA; U.S.A. ATP World Tour,HARD,2,Mario Ancic,Fernando Gonzalez,Mario Ancic,7-5; 3-6; 6-3,R64,138,11,3,61,89,44,61,17,28,3,5,15,61,89,3,5,73,109,49,73,16,36,11,14,15,65,109
2008-03-13 00:00:00.000,ATP Masters Series Indian Wells CA; U.S.A. ATP World Tour,HARD,2,Juan Carlos Ferrero,Thomas Johansson,Juan Carlos Ferrero,6-4; 6-4,R64,81,5,0,40,55,28,40,11,15,0,1,10,39,55,3,1,29,51,22,29,10,22,1,4,10,32,51
2008-03-13 00:00:00.000,ATP Masters Series Indian Wells CA; U.S.A. ATP World Tour,HARD,2,Radek Stepanek,Max Mirnyi,Radek Stepanek,6-4; 6-2,R64,75,4,1,31,47,26,31,10,16,0,0,9,36,47,3,3,36,57,22,36,10,21,3,6,9,32,57
2008-03-13 00:00:00.000,ATP Masters Series Indian Wells CA; U.S.A. ATP World Tour,HARD,2,David Nalbandian,Ernests Gulbis,David Nalbandian,6-4; 4-6; 7-6(4),R64,159,4,3,76,124,55,76,19,48,12,16,16,74,124,19,4,64,106,49,64,15,42,7,11,16,64,106
2008-03-13 00:00:00.000,ATP Masters Series Indian Wells CA; U.S.A. ATP World Tour,HARD,2,David Ferrer,Olivier Rochus,David Ferrer,6-2; 6-2,R64,92,5,1,44,68,26,44,15,24,3,4,8,41,68,0,2,39,61,16,39,11,22,3,8,8,27,61
2008-03-13 00:00:00.000,ATP Masters Series Indian Wells CA; U.S.A. ATP World Tour,HARD,2,Hyung-Taik Lee,Jarkko Nieminen,Hyung-Taik Lee,4-6; 7-6(5); 6-3,R64,127,6,7,69,108,43,69,16,39,9,15,15,59,108,3,5,69,109,40,69,15,40,7,14,16,55,109
2008-03-13 00:00:00.000,ATP Masters Series Indian Wells CA; U.S.A. ATP World Tour,HARD,2,Marcos Baghdatis,Wayne Odesnik,Marcos Baghdatis,7-6(2); 1-6; 6-3,R64,160,3,1,54,90,38,54,16,36,8,13,14,54,90,6,0,83,122,48,83,19,39,15,19,14,67,122
2008-03-13 00:00:00.000,ATP Masters Series Indian Wells CA; U.S.A. ATP World Tour,HARD,2,Stanislas Wawrinka,Tomas Berdych,Stanislas Wawrinka,2-6; 7-6(3); 6-4,R64,146,4,4,63,101,45,63,14,38,5,10,15,59,101,7,6,61,90,39,61,14,29,2,6,15,53,90
2008-03-13 00:00:00.000,ATP Masters Series Indian Wells CA; U.S.A. ATP World Tour,HARD,2,Guillermo Canas,Jonas Bjorkman,Guillermo Canas,6-2; 7-6(4),R64,108,3,1,45,78,30,45,17,33,3,5,10,47,78,0,2,37,70,22,37,16,33,2,6,10,38,70
2008-03-13 00:00:00.000,ATP Masters Series Indian Wells CA; U.S.A. ATP World Tour,HARD,2,Juan Monaco,Robin Haase,Juan Monaco,6-2; 6-4,R64,70,2,4,34,54,22,34,13,20,2,4,9,35,54,2,5,28,54,15,28,9,26,5,10,9,24,54
2008-03-13 00:00:00.000,ATP Masters Series Indian Wells CA; U.S.A. ATP World Tour,HARD,2,Philipp Kohlschreiber,Xavier Malisse,Philipp Kohlschreiber,6-2; 5-7; 6-4,R64,127,8,1,59,91,42,59,21,32,4,5,15,63,91,11,4,68,103,49,68,13,35,10,13,15,62,103
2008-03-13 00:00:00.000,ATP Masters Series Indian Wells CA; U.S.A. ATP World Tour,HARD,2,Novak Djokovic,Andreas Seppi,Novak Djokovic,6-3; 7-6(3),R64,100,1,3,39,62,31,39,13,23,1,3,11,44,62,2,3,40,79,30,40,15,39,6,9,10,45,79
2008-03-13 00:00:00.000,ATP Masters Series Indian Wells CA; U.S.A. ATP World Tour,HARD,2,Richard Gasquet,Robin Soderling,Richard Gasquet,6-3; 6-2,R64,52,7,1,29,50,26,29,12,21,1,1,9,38,50,3,4,26,42,18,26,7,16,1,4,8,25,42
2008-03-13 00:00:00.000,ATP Masters Series Indian Wells CA; U.S.A. ATP World Tour,HARD,2,Juan Ignacio Chela,Dmitry Tursunov,Juan Ignacio Chela,6-7(1); 7-6(6); 6-4,R64,161,2,10,64,125,46,64,33,61,7,9,17,79,125,4,6,72,124,52,72,26,52,8,11,17,78,124
2008-03-13 00:00:00.000,ATP Masters Series Indian Wells CA; U.S.A. ATP World Tour,HARD,2,Carlos Moya,Robby Ginepri,Carlos Moya,2-6; 6-2; 6-4,R64,147,2,10,69,119,49,69,22,50,20,22,13,71,119,1,1,62,93,40,62,16,31,8,11,13,56,93
2008-03-13 00:00:00.000,ATP Masters Series Indian Wells CA; U.S.A. ATP World Tour,HARD,2,James Blake,Marc Gicquel,James Blake,6-3; 6-7(5); 6-1,R64,117,7,2,59,99,42,59,21,40,2,5,15,63,99,3,1,50,90,29,50,18,40,3,9,13,47,90
2008-03-13 00:00:00.000,ATP Masters Series Indian Wells CA; U.S.A. ATP World Tour,HARD,2,Paul-Henri Mathieu,Fabio Fognini,Paul-Henri Mathieu,6-1; 7-6(7),R64,87,8,5,32,63,29,32,18,31,3,3,10,47,63,1,3,39,73,25,39,18,34,5,7,9,43,73
2008-03-13 00:00:00.000,ATP Masters Series Indian Wells CA; U.S.A. ATP World Tour,HARD,2,Jo-Wilfried Tsonga,Dudi Sela,Jo-Wilfried Tsonga,6-2; 6-4,R64,80,1,1,29,50,22,29,14,21,0,1,9,36,50,0,2,62,75,32,62,7,13,7,11,9,39,75
2008-03-13 00:00:00.000,ATP Masters Series Indian Wells CA; U.S.A. ATP World Tour,HARD,2,Donald Young,Feliciano Lopez,Donald Young,6-4; 6-7(3); 6-2,R64,116,4,3,68,94,50,68,12,26,4,6,15,62,94,11,5,56,97,39,56,21,41,7,12,15,60,97
2008-03-13 00:00:00.000,ATP Masters Series Indian Wells CA; U.S.A. ATP World Tour,HARD,2,Rafael Nadal,Santiago Giraldo,Rafael Nadal,6-3; 6-3,R64,66,0,1,33,46,24,33,9,13,1,2,9,33,46,0,4,27,49,13,27,12,22,0,4,9,25,49
2008-03-13 00:00:00.000,ATP Masters Series Indian Wells CA; U.S.A. ATP World Tour,HARD,2,Roger Federer,Nicolas Mahut,Roger Federer,6-1; 6-1,R32,53,9,1,24,32,23,24,5,8,0,0,7,28,32,0,5,30,50,14,30,7,20,3,8,7,21,50
2008-03-13 00:00:00.000,ATP Masters Series Indian Wells CA; U.S.A. ATP World Tour,HARD,2,Ivan Ljubicic,Tommy Robredo,Ivan Ljubicic,6-3; 6-4,R32,80,4,1,32,54,25,32,16,22,1,1,10,41,54,1,1,36,57,22,36,12,21,5,7,9,34,57
2008-03-13 00:00:00.000,ATP Masters Series Indian Wells CA; U.S.A. ATP World Tour,HARD,2,Andy Murray,Ivo Karlovic,Andy Murray,7-6(7); 6-7(3); 6-3,R32,140,3,4,69,112,52,69,24,43,2,5,17,76,112,11,2,68,101,50,68,14,33,1,5,16,64,101
2008-03-13 00:00:00.000,ATP Masters Series Indian Wells CA; U.S.A. ATP World Tour,HARD,2,Tommy Haas,Fernando Verdasco,Tommy Haas,7-6(5); 4-6; 6-1,R32,141,4,2,57,95,42,57,18,38,8,11,14,60,95,2,2,70,94,44,70,13,24,5,10,15,57,94
2008-03-13 00:00:00.000,ATP Masters Series Indian Wells CA; U.S.A. ATP World Tour,HARD,2,Mardy Fish,Nikolay Davydenko,Mardy Fish,6-3; 6-2,R32,75,0,1,28,58,22,28,15,30,0,1,9,37,58,4,1,28,46,17,28,7,18,1,5,8,24,46
2008-03-13 00:00:00.000,ATP Masters Series Indian Wells CA; U.S.A. ATP World Tour,HARD,2,Lleyton Hewitt,Mikhail Youzhny,Lleyton Hewitt,7-5; 6-1,R32,97,2,3,21,44,17,21,16,23,0,1,9,33,44,2,5,45,85,26,45,17,40,7,12,10,43,85
2008-03-13 00:00:00.000,ATP Masters Series Indian Wells CA; U.S.A. ATP World Tour,HARD,2,Juan Carlos Ferrero,Mario Ancic,Juan Carlos Ferrero,7-5; 4-6; 7-6(7),R32,181,5,3,71,115,53,71,25,44,6,8,17,78,115,12,2,81,118,55,81,24,37,7,9,17,79,118
2008-03-13 00:00:00.000,ATP Masters Series Indian Wells CA; U.S.A. ATP World Tour,HARD,2,David Nalbandian,Radek Stepanek,David Nalbandian,7-6(1); 0-6; 7-6(6),R32,133,12,4,56,96,42,56,18,40,3,8,15,60,96,12,3,50,87,41,50,20,37,3,5,15,61,87
2008-03-13 00:00:00.000,ATP Masters Series Indian Wells CA; U.S.A. ATP World Tour,HARD,2,Hyung-Taik Lee,David Ferrer,Hyung-Taik Lee,7-6(5); 6-7(5); 7-6(3),R32,170,4,0,76,127,50,76,31,51,4,8,18,81,127,4,1,85,126,59,85,20,41,10,14,18,79,126
2008-03-13 00:00:00.000,ATP Masters Series Indian Wells CA; U.S.A. ATP World Tour,HARD,2,Stanislas Wawrinka,Marcos Baghdatis,Stanislas Wawrinka,6-3; 6-7(1); 6-0,R32,129,5,3,41,81,33,41,21,40,1,3,14,54,81,3,2,43,88,29,43,19,45,5,11,13,48,88
2008-03-13 00:00:00.000,ATP Masters Series Indian Wells CA; U.S.A. ATP World Tour,HARD,2,Guillermo Canas,Juan Monaco,Guillermo Canas,6-3; 6-7(1); 6-2,R32,160,5,4,44,87,33,44,25,43,5,7,14,58,87,1,3,77,105,43,77,14,28,7,13,15,57,105
2008-03-13 00:00:00.000,ATP Masters Series Indian Wells CA; U.S.A. ATP World Tour,HARD,2,Novak Djokovic,Philipp Kohlschreiber,Novak Djokovic,6-3; 6-2,R32,69,3,3,33,49,25,33,11,16,0,0,9,36,49,2,2,22,46,12,22,14,24,4,7,8,26,46
2008-03-13 00:00:00.000,ATP Masters Series Indian Wells CA; U.S.A. ATP World Tour,HARD,2,Richard Gasquet,Juan Ignacio Chela,Richard Gasquet,6-2; 6-1,R32,62,6,0,29,47,23,29,12,18,1,1,8,35,47,2,3,32,46,17,32,4,14,5,9,7,21,46
2008-03-13 00:00:00.000,ATP Masters Series Indian Wells CA; U.S.A. ATP World Tour,HARD,2,James Blake,Carlos Moya,James Blake,6-3; 6-4,R32,75,1,1,34,61,24,34,17,27,4,6,10,41,61,3,2,37,53,19,37,9,16,3,7,9,28,53
2008-03-13 00:00:00.000,ATP Masters Series Indian Wells CA; U.S.A. ATP World Tour,HARD,2,Jo-Wilfried Tsonga,Paul-Henri Mathieu,Jo-Wilfried Tsonga,7-6(5); 6-4,R32,108,15,1,48,58,38,48,6,10,0,1,11,44,58,1,4,37,89,24,37,28,52,5,7,11,52,89
2008-03-13 00:00:00.000,ATP Masters Series Indian Wells CA; U.S.A. ATP World Tour,HARD,2,Rafael Nadal,Donald Young,Rafael Nadal,6-1; 6-3,R32,82,0,1,34,50,26,34,8,16,1,1,8,34,50,2,2,40,69,21,40,15,29,11,15,8,36,69
2008-03-13 00:00:00.000,ATP Masters Series Indian Wells CA; U.S.A. ATP World Tour,HARD,2,Roger Federer,Ivan Ljubicic,Roger Federer,6-3; 6-4,R16,76,6,0,38,51,30,38,8,13,2,3,10,38,51,4,1,43,68,25,43,13,25,8,11,9,38,68
2008-03-13 00:00:00.000,ATP Masters Series Indian Wells CA; U.S.A. ATP World Tour,HARD,2,Tommy Haas,Andy Murray,Tommy Haas,2-6; 7-5; 6-3,R16,132,5,0,58,84,44,58,11,26,9,12,15,55,84,8,2,44,91,35,44,20,47,5,8,14,55,91
2008-03-13 00:00:00.000,ATP Masters Series Indian Wells CA; U.S.A. ATP World Tour,HARD,2,Mardy Fish,Lleyton Hewitt,Mardy Fish,7-5; 3-6; 7-6(4),R16,148,13,1,54,103,41,54,28,49,5,7,16,69,103,14,5,56,103,41,56,31,47,5,7,17,72,103
2008-03-13 00:00:00.000,ATP Masters Series Indian Wells CA; U.S.A. ATP World Tour,HARD,2,David Nalbandian,Juan Carlos Ferrero,David Nalbandian,6-2; 6-2,R16,73,3,2,22,46,16,22,14,24,0,1,8,30,46,1,0,38,55,17,38,8,17,4,9,8,25,55
2008-03-13 00:00:00.000,ATP Masters Series Indian Wells CA; U.S.A. ATP World Tour,HARD,2,Stanislas Wawrinka,Hyung-Taik Lee,Stanislas Wawrinka,6-1; 5-7; 6-4,R16,141,4,0,49,85,39,49,18,36,2,5,15,57,85,1,2,68,105,44,68,16,37,11,16,14,60,105
2008-03-13 00:00:00.000,ATP Masters Series Indian Wells CA; U.S.A. ATP World Tour,HARD,2,Novak Djokovic,Guillermo Canas,Novak Djokovic,6-2; 6-3,R16,85,3,1,35,55,26,35,13,20,5,5,9,39,55,3,1,30,56,24,30,6,26,5,8,8,30,56
2008-03-13 00:00:00.000,ATP Masters Series Indian Wells CA; U.S.A. ATP World Tour,HARD,2,James Blake,Richard Gasquet,James Blake,6-4; 6-2,R16,66,5,0,24,50,20,24,16,26,1,2,9,36,50,5,1,43,65,28,43,7,22,6,10,9,35,65
2008-03-13 00:00:00.000,ATP Masters Series Indian Wells CA; U.S.A. ATP World Tour,HARD,2,Rafael Nadal,Jo-Wilfried Tsonga,Rafael Nadal,6-7(4); 7-6(3); 7-5,R16,183,3,1,74,106,54,74,20,32,4,7,18,74,106,12,7,67,119,51,67,24,52,8,12,18,75,119
2008-03-13 00:00:00.000,ATP Masters Series Indian Wells CA; U.S.A. ATP World Tour,HARD,2,Roger Federer,Tommy Haas,Roger Federer,W/O,Q,0,0,0,0,0,0,0,0,0,0,0,0,0,0,0,0,0,0,0,0,0,0,0,0,0,0,0
2008-03-13 00:00:00.000,ATP Masters Series Indian Wells CA; U.S.A. ATP World Tour,HARD,2,Mardy Fish,David Nalbandian,Mardy Fish,6-3; 6-7(5); 7-6(4),Q,165,23,4,66,119,51,66,29,53,5,8,17,80,119,7,8,68,124,50,68,25,56,12,16,16,75,124
2008-03-13 00:00:00.000,ATP Masters Series Indian Wells CA; U.S.A. ATP World Tour,HARD,2,Novak Djokovic,Stanislas Wawrinka,Novak Djokovic,7-6(5); 6-2,Q,126,7,1,43,66,32,43,10,23,3,6,10,42,66,1,1,53,87,27,53,18,34,10,15,10,45,87
2008-03-13 00:00:00.000,ATP Masters Series Indian Wells CA; U.S.A. ATP World Tour,HARD,2,Rafael Nadal,James Blake,Rafael Nadal,7-5; 3-6; 6-3,Q,126,6,1,70,93,44,70,16,23,6,8,15,60,93,5,2,43,80,33,43,20,37,1,4,15,53,80
2008-03-13 00:00:00.000,ATP Masters Series Indian Wells CA; U.S.A. ATP World Tour,HARD,2,Mardy Fish,Roger Federer,Mardy Fish,6-3; 6-2,S,64,7,1,17,50,15,17,22,33,1,1,9,37,50,2,0,28,53,16,28,14,25,4,7,8,30,53
2008-03-13 00:00:00.000,ATP Masters Series Indian Wells CA; U.S.A. ATP World Tour,HARD,2,Novak Djokovic,Rafael Nadal,Novak Djokovic,6-3; 6-2,S,88,8,0,31,50,25,31,11,19,2,3,9,36,50,2,2,31,51,18,31,8,20,3,7,8,26,51
2008-03-13 00:00:00.000,ATP Masters Series Indian Wells CA; U.S.A. ATP World Tour,HARD,2,Novak Djokovic,Mardy Fish,Novak Djokovic,6-2; 5-7; 6-3,F,125,10,1,53,84,35,53,19,31,3,6,15,54,84,6,4,35,87,26,35,25,52,1,6,14,51,87
2008-03-27 00:00:00.000,ATP Masters Series Miami FL; U.S.A. ATP World Tour,HARD,2,Roger Federer,N/A Bye,Roger Federer,,R128,0,0,0,0,0,0,0,0,0,0,0,0,0,0,0,0,0,0,0,0,0,0,0,0,0,0,0
2008-03-27 00:00:00.000,ATP Masters Series Miami FL; U.S.A. ATP World Tour,HARD,2,Gael Monfils,John Isner,Gael Monfils,6-7(8); 6-3; 6-3,R128,131,8,4,62,104,46,62,25,42,11,13,15,71,104,10,8,61,104,41,61,19,43,4,9,15,60,104
2008-03-27 00:00:00.000,ATP Masters Series Miami FL; U.S.A. ATP World Tour,HARD,2,Robin Soderling,Stefan Koubek,Robin Soderling,6-0; 6-1,R128,38,7,2,19,38,19,19,10,19,1,1,7,29,38,1,1,19,38,10,19,4,19,2,7,6,14,38
2008-03-27 00:00:00.000,ATP Masters Series Miami FL; U.S.A. ATP World Tour,HARD,2,Stanislas Wawrinka,N/A Bye,Stanislas Wawrinka,,R128,0,0,0,0,0,0,0,0,0,0,0,0,0,0,0,0,0,0,0,0,0,0,0,0,0,0,0
2008-03-27 00:00:00.000,ATP Masters Series Miami FL; U.S.A. ATP World Tour,HARD,2,Lleyton Hewitt,N/A Bye,Lleyton Hewitt,,R128,0,0,0,0,0,0,0,0,0,0,0,0,0,0,0,0,0,0,0,0,0,0,0,0,0,0,0
2008-03-27 00:00:00.000,ATP Masters Series Miami FL; U.S.A. ATP World Tour,HARD,2,Jose Acasuso,Santiago Ventura,Jose Acasuso,6-2; 6-4,R128,83,7,7,29,58,23,29,10,29,2,5,9,33,58,5,5,28,68,15,28,17,40,4,10,9,32,68
2008-03-27 00:00:00.000,ATP Masters Series Miami FL; U.S.A. ATP World Tour,HARD,2,Dudi Sela,Hyung-Taik Lee,Dudi Sela,6-4; 6-3,R128,76,0,1,41,66,29,41,15,25,5,5,9,44,66,3,3,37,54,24,37,10,17,2,5,10,34,54
2008-03-27 00:00:00.000,ATP Masters Series Miami FL; U.S.A. ATP World Tour,HARD,2,Tommy Robredo,N/A Bye,Tommy Robredo,,R128,0,0,0,0,0,0,0,0,0,0,0,0,0,0,0,0,0,0,0,0,0,0,0,0,0,0,0
2008-03-27 00:00:00.000,ATP Masters Series Miami FL; U.S.A. ATP World Tour,HARD,2,Jo-Wilfried Tsonga,N/A Bye,Jo-Wilfried Tsonga,,R128,0,0,0,0,0,0,0,0,0,0,0,0,0,0,0,0,0,0,0,0,0,0,0,0,0,0,0
2008-03-27 00:00:00.000,ATP Masters Series Miami FL; U.S.A. ATP World Tour,HARD,2,Jurgen Melzer,Michael Llodra,Jurgen Melzer,7-6(6); 7-6(5),R128,107,7,3,51,92,32,51,28,41,5,6,12,60,92,10,5,51,80,37,51,16,29,3,4,12,53,80
2008-03-27 00:00:00.000,ATP Masters Series Miami FL; U.S.A. ATP World Tour,HARD,2,Julien Benneteau,Rainer Schuettler,Julien Benneteau,1-6; 6-1; 6-2,R128,89,2,5,45,74,37,45,10,29,1,3,11,47,74,0,4,33,57,24,33,9,24,1,5,11,33,57
2008-03-27 00:00:00.000,ATP Masters Series Miami FL; U.S.A. ATP World Tour,HARD,2,Ivo Karlovic,N/A Bye,Ivo Karlovic,,R128,0,0,0,0,0,0,0,0,0,0,0,0,0,0,0,0,0,0,0,0,0,0,0,0,0,0,0
2008-03-27 00:00:00.000,ATP Masters Series Miami FL; U.S.A. ATP World Tour,HARD,2,Juan Ignacio Chela,N/A Bye,Juan Ignacio Chela,,R128,0,0,0,0,0,0,0,0,0,0,0,0,0,0,0,0,0,0,0,0,0,0,0,0,0,0,0
2008-03-27 00:00:00.000,ATP Masters Series Miami FL; U.S.A. ATP World Tour,HARD,2,Ivo Minar,Olivier Rochus,Ivo Minar,6-3; 6-2,R128,71,7,0,28,52,22,28,13,24,2,3,9,35,52,2,3,34,57,19,34,9,23,3,7,8,28,57
2008-03-27 00:00:00.000,ATP Masters Series Miami FL; U.S.A. ATP World Tour,HARD,2,Viktor Troicki,Victor Hanescu,Viktor Troicki,6-4; 6-1,R128,68,3,0,22,40,17,22,13,18,0,1,8,30,40,2,2,42,67,24,42,9,25,10,15,9,33,67
2008-03-27 00:00:00.000,ATP Masters Series Miami FL; U.S.A. ATP World Tour,HARD,2,Andy Roddick,N/A Bye,Andy Roddick,,R128,0,0,0,0,0,0,0,0,0,0,0,0,0,0,0,0,0,0,0,0,0,0,0,0,0,0,0
2008-03-27 00:00:00.000,ATP Masters Series Miami FL; U.S.A. ATP World Tour,HARD,2,Nikolay Davydenko,N/A Bye,Nikolay Davydenko,,R128,0,0,0,0,0,0,0,0,0,0,0,0,0,0,0,0,0,0,0,0,0,0,0,0,0,0,0
2008-03-27 00:00:00.000,ATP Masters Series Miami FL; U.S.A. ATP World Tour,HARD,2,Ernests Gulbis,Dominik Hrbaty,Ernests Gulbis,6-3; 4-6; 6-1,R128,110,10,7,45,90,33,45,21,45,6,9,13,54,90,4,10,54,86,34,54,11,32,6,12,13,45,86
2008-03-27 00:00:00.000,ATP Masters Series Miami FL; U.S.A. ATP World Tour,HARD,2,Simone Bolelli,Santiago Giraldo,Simone Bolelli,6-3; 7-5,R128,89,3,3,49,81,36,49,16,32,4,5,11,52,81,6,1,39,59,27,39,7,20,1,4,10,34,59
2008-03-27 00:00:00.000,ATP Masters Series Miami FL; U.S.A. ATP World Tour,HARD,2,Philipp Kohlschreiber,N/A Bye,Philipp Kohlschreiber,,R128,0,0,0,0,0,0,0,0,0,0,0,0,0,0,0,0,0,0,0,0,0,0,0,0,0,0,0
2008-03-27 00:00:00.000,ATP Masters Series Miami FL; U.S.A. ATP World Tour,HARD,2,Juan Monaco,N/A Bye,Juan Monaco,,R128,0,0,0,0,0,0,0,0,0,0,0,0,0,0,0,0,0,0,0,0,0,0,0,0,0,0,0
2008-03-27 00:00:00.000,ATP Masters Series Miami FL; U.S.A. ATP World Tour,HARD,2,Ryan Sweeting,Filippo Volandri,Ryan Sweeting,6-3; 6-2,R128,72,1,3,41,59,31,41,9,18,5,6,9,40,59,0,2,36,60,19,36,11,24,5,9,8,30,60
2008-03-27 00:00:00.000,ATP Masters Series Miami FL; U.S.A. ATP World Tour,HARD,2,Mario Ancic,Gilles Simon,Mario Ancic,6-2; 6-7(2); 6-3,R128,143,4,1,66,102,48,66,17,36,5,7,15,65,102,3,3,65,105,42,65,15,40,9,14,14,57,105
2008-03-27 00:00:00.000,ATP Masters Series Miami FL; U.S.A. ATP World Tour,HARD,2,Andy Murray,N/A Bye,Andy Murray,,R128,0,0,0,0,0,0,0,0,0,0,0,0,0,0,0,0,0,0,0,0,0,0,0,0,0,0,0
2008-03-27 00:00:00.000,ATP Masters Series Miami FL; U.S.A. ATP World Tour,HARD,2,Mikhail Youzhny,N/A Bye,Mikhail Youzhny,,R128,0,0,0,0,0,0,0,0,0,0,0,0,0,0,0,0,0,0,0,0,0,0,0,0,0,0,0
2008-03-27 00:00:00.000,ATP Masters Series Miami FL; U.S.A. ATP World Tour,HARD,2,Bobby Reynolds,Marat Safin,Bobby Reynolds,7-6(3); 4-6; 7-6(5),R128,137,19,3,61,98,49,61,23,37,3,5,17,72,98,19,7,63,117,50,63,25,54,9,10,17,75,117
2008-03-27 00:00:00.000,ATP Masters Series Miami FL; U.S.A. ATP World Tour,HARD,2,Arnaud Clement,Mardy Fish,Arnaud Clement,6-3; 6-3,R128,69,9,3,25,52,21,25,18,27,4,4,9,39,52,8,0,26,55,21,26,12,29,3,6,9,33,55
2008-03-27 00:00:00.000,ATP Masters Series Miami FL; U.S.A. ATP World Tour,HARD,2,Nicolas Almagro,N/A Bye,Nicolas Almagro,,R128,0,0,0,0,0,0,0,0,0,0,0,0,0,0,0,0,0,0,0,0,0,0,0,0,0,0,0
2008-03-27 00:00:00.000,ATP Masters Series Miami FL; U.S.A. ATP World Tour,HARD,2,Fernando Verdasco,N/A Bye,Fernando Verdasco,,R128,0,0,0,0,0,0,0,0,0,0,0,0,0,0,0,0,0,0,0,0,0,0,0,0,0,0,0
2008-03-27 00:00:00.000,ATP Masters Series Miami FL; U.S.A. ATP World Tour,HARD,2,Janko Tipsarevic,Yen-Hsun Lu,Janko Tipsarevic,6-1; 4-6; 6-4,R128,109,8,0,46,73,37,46,18,27,0,1,14,55,73,5,3,47,72,33,47,10,25,2,5,13,43,72
2008-03-27 00:00:00.000,ATP Masters Series Miami FL; U.S.A. ATP World Tour,HARD,2,Thomas Johansson,Igor Kunitsyn,Thomas Johansson,4-6; 6-1; 6-2,R128,105,9,3,51,81,37,51,12,30,6,9,12,49,81,4,2,39,73,23,39,11,34,1,8,13,34,73
2008-03-27 00:00:00.000,ATP Masters Series Miami FL; U.S.A. ATP World Tour,HARD,2,David Ferrer,N/A Bye,David Ferrer,,R128,0,0,0,0,0,0,0,0,0,0,0,0,0,0,0,0,0,0,0,0,0,0,0,0,0,0,0
2008-03-27 00:00:00.000,ATP Masters Series Miami FL; U.S.A. ATP World Tour,HARD,2,Richard Gasquet,N/A Bye,Richard Gasquet,,R128,0,0,0,0,0,0,0,0,0,0,0,0,0,0,0,0,0,0,0,0,0,0,0,0,0,0,0
2008-03-27 00:00:00.000,ATP Masters Series Miami FL; U.S.A. ATP World Tour,HARD,2,Dmitry Tursunov,Evgeny Korolev,Dmitry Tursunov,4-6; 6-3; 6-2,R128,104,16,2,53,80,39,53,17,27,3,4,14,56,80,6,9,52,93,36,52,20,41,5,8,13,56,93
2008-03-27 00:00:00.000,ATP Masters Series Miami FL; U.S.A. ATP World Tour,HARD,2,Juan Martin Del Potro,Jesse Levine,Juan Martin Del Potro,7-5; 6-1,R128,76,3,3,41,66,29,41,15,25,5,6,10,44,66,2,5,28,51,18,28,10,23,2,6,9,28,51
2008-03-27 00:00:00.000,ATP Masters Series Miami FL; U.S.A. ATP World Tour,HARD,2,Feliciano Lopez,N/A Bye,Feliciano Lopez,,R128,0,0,0,0,0,0,0,0,0,0,0,0,0,0,0,0,0,0,0,0,0,0,0,0,0,0,0
2008-03-27 00:00:00.000,ATP Masters Series Miami FL; U.S.A. ATP World Tour,HARD,2,Juan Carlos Ferrero,N/A Bye,Juan Carlos Ferrero,,R128,0,0,0,0,0,0,0,0,0,0,0,0,0,0,0,0,0,0,0,0,0,0,0,0,0,0,0
2008-03-27 00:00:00.000,ATP Masters Series Miami FL; U.S.A. ATP World Tour,HARD,2,Albert Montanes,Kei Nishikori,Albert Montanes,7-5; 6-2,R128,90,3,2,42,67,31,42,13,25,2,3,10,44,67,3,4,51,84,31,51,14,33,3,7,10,45,84
2008-03-27 00:00:00.000,ATP Masters Series Miami FL; U.S.A. ATP World Tour,HARD,2,Sam Querrey,Carlos Berlocq,Sam Querrey,7-6(4); 6-3,R128,82,8,3,49,75,35,49,15,26,2,4,11,50,75,2,1,36,63,22,36,16,27,0,3,10,38,63
2008-03-27 00:00:00.000,ATP Masters Series Miami FL; U.S.A. ATP World Tour,HARD,2,Tomas Berdych,N/A Bye,Tomas Berdych,,R128,0,0,0,0,0,0,0,0,0,0,0,0,0,0,0,0,0,0,0,0,0,0,0,0,0,0,0
2008-03-27 00:00:00.000,ATP Masters Series Miami FL; U.S.A. ATP World Tour,HARD,2,Guillermo Canas,N/A Bye,Guillermo Canas,,R128,0,0,0,0,0,0,0,0,0,0,0,0,0,0,0,0,0,0,0,0,0,0,0,0,0,0,0
2008-03-27 00:00:00.000,ATP Masters Series Miami FL; U.S.A. ATP World Tour,HARD,2,Sam Warburg,Potito Starace,Sam Warburg,7-6(2); 6-2,R128,75,6,0,31,53,27,31,19,22,1,1,10,46,53,5,2,47,62,31,47,8,15,2,4,10,39,62
2008-03-27 00:00:00.000,ATP Masters Series Miami FL; U.S.A. ATP World Tour,HARD,2,Pablo Cuevas,Vincent Spadea,Pablo Cuevas,6-4; 6-2,R128,73,6,2,38,63,27,38,17,25,4,4,9,44,63,4,3,36,62,27,36,10,26,7,10,9,37,62
2008-03-27 00:00:00.000,ATP Masters Series Miami FL; U.S.A. ATP World Tour,HARD,2,Fernando Gonzalez,N/A Bye,Fernando Gonzalez,,R128,0,0,0,0,0,0,0,0,0,0,0,0,0,0,0,0,0,0,0,0,0,0,0,0,0,0,0
2008-03-27 00:00:00.000,ATP Masters Series Miami FL; U.S.A. ATP World Tour,HARD,2,Igor Andreev,N/A Bye,Igor Andreev,,R128,0,0,0,0,0,0,0,0,0,0,0,0,0,0,0,0,0,0,0,0,0,0,0,0,0,0,0
2008-03-27 00:00:00.000,ATP Masters Series Miami FL; U.S.A. ATP World Tour,HARD,2,Michael Berrer,Robin Haase,Michael Berrer,6-4; 6-4,R128,85,3,2,35,58,24,35,12,23,4,7,10,36,58,4,2,35,68,21,35,13,33,0,5,10,34,68
2008-03-27 00:00:00.000,ATP Masters Series Miami FL; U.S.A. ATP World Tour,HARD,2,Kevin Anderson,Agustin Calleri,Kevin Anderson,7-6(5); 3-6; 7-6(4),R128,132,19,1,76,112,57,76,20,36,4,7,17,77,112,9,7,54,106,43,54,31,52,4,5,16,74,106
2008-03-27 00:00:00.000,ATP Masters Series Miami FL; U.S.A. ATP World Tour,HARD,2,Novak Djokovic,N/A Bye,Novak Djokovic,,R128,0,0,0,0,0,0,0,0,0,0,0,0,0,0,0,0,0,0,0,0,0,0,0,0,0,0,0
2008-03-27 00:00:00.000,ATP Masters Series Miami FL; U.S.A. ATP World Tour,HARD,2,David Nalbandian,N/A Bye,David Nalbandian,,R128,0,0,0,0,0,0,0,0,0,0,0,0,0,0,0,0,0,0,0,0,0,0,0,0,0,0,0
2008-03-27 00:00:00.000,ATP Masters Series Miami FL; U.S.A. ATP World Tour,HARD,2,Xavier Malisse,Oscar Hernandez,Xavier Malisse,6-1; 6-1,R128,58,5,0,20,36,17,20,11,16,0,0,7,28,36,0,1,31,48,14,31,7,17,2,7,7,21,48
2008-03-27 00:00:00.000,ATP Masters Series Miami FL; U.S.A. ATP World Tour,HARD,2,Sebastien Grosjean,Gustavo Kuerten,Sebastien Grosjean,6-1; 7-5,R128,76,2,0,29,50,24,29,17,21,3,3,10,41,50,1,2,29,63,20,29,15,34,3,6,9,35,63
2008-03-27 00:00:00.000,ATP Masters Series Miami FL; U.S.A. ATP World Tour,HARD,2,Radek Stepanek,N/A Bye,Radek Stepanek,,R128,0,0,0,0,0,0,0,0,0,0,0,0,0,0,0,0,0,0,0,0,0,0,0,0,0,0,0
2008-03-27 00:00:00.000,ATP Masters Series Miami FL; U.S.A. ATP World Tour,HARD,2,Ivan Ljubicic,N/A Bye,Ivan Ljubicic,,R128,0,0,0,0,0,0,0,0,0,0,0,0,0,0,0,0,0,0,0,0,0,0,0,0,0,0,0
2008-03-27 00:00:00.000,ATP Masters Series Miami FL; U.S.A. ATP World Tour,HARD,2,Fabrice Santoro,Jonas Bjorkman,Fabrice Santoro,6-1; 6-0,R128,46,3,0,12,30,11,12,13,18,0,0,6,24,30,0,4,25,38,10,25,1,13,3,9,7,11,38
2008-03-27 00:00:00.000,ATP Masters Series Miami FL; U.S.A. ATP World Tour,HARD,2,Andreas Seppi,Marc Gicquel,Andreas Seppi,2-6; 6-4; 6-2,R128,112,4,6,36,84,20,36,22,48,9,16,13,42,84,8,2,47,80,25,47,11,33,4,12,13,36,80
2008-03-27 00:00:00.000,ATP Masters Series Miami FL; U.S.A. ATP World Tour,HARD,2,James Blake,N/A Bye,James Blake,,R128,0,0,0,0,0,0,0,0,0,0,0,0,0,0,0,0,0,0,0,0,0,0,0,0,0,0,0
2008-03-27 00:00:00.000,ATP Masters Series Miami FL; U.S.A. ATP World Tour,HARD,2,Paul-Henri Mathieu,N/A Bye,Paul-Henri Mathieu,,R128,0,0,0,0,0,0,0,0,0,0,0,0,0,0,0,0,0,0,0,0,0,0,0,0,0,0,0
2008-03-27 00:00:00.000,ATP Masters Series Miami FL; U.S.A. ATP World Tour,HARD,2,Marin Cilic,Kristof Vliegen,Marin Cilic,6-3; 6-2,R128,73,6,2,35,56,26,35,13,21,3,3,9,39,56,3,1,42,65,27,42,9,23,9,12,8,36,65
2008-03-27 00:00:00.000,ATP Masters Series Miami FL; U.S.A. ATP World Tour,HARD,2,Nicolas Mahut,Florian Mayer,Nicolas Mahut,7-6(6); 6-3,R128,92,10,1,52,81,34,52,14,29,6,9,11,48,81,1,0,37,59,25,37,6,22,2,6,10,31,59
2008-03-27 00:00:00.000,ATP Masters Series Miami FL; U.S.A. ATP World Tour,HARD,2,Carlos Moya,N/A Bye,Carlos Moya,,R128,0,0,0,0,0,0,0,0,0,0,0,0,0,0,0,0,0,0,0,0,0,0,0,0,0,0,0
2008-03-27 00:00:00.000,ATP Masters Series Miami FL; U.S.A. ATP World Tour,HARD,2,Jarkko Nieminen,N/A Bye,Jarkko Nieminen,,R128,0,0,0,0,0,0,0,0,0,0,0,0,0,0,0,0,0,0,0,0,0,0,0,0,0,0,0
2008-03-27 00:00:00.000,ATP Masters Series Miami FL; U.S.A. ATP World Tour,HARD,2,Nicolas Kiefer,Guillermo Garcia-Lopez,Nicolas Kiefer,4-6; 7-6(9); 6-4,R128,141,10,2,53,100,40,53,28,47,2,5,16,68,100,7,8,53,99,41,53,25,46,2,5,16,66,99
2008-03-27 00:00:00.000,ATP Masters Series Miami FL; U.S.A. ATP World Tour,HARD,2,Benjamin Becker,Sergio Roitman,Benjamin Becker,6-3; 6-4,R128,74,6,2,40,64,31,40,9,24,2,3,10,40,64,6,0,28,47,20,28,10,19,1,4,9,30,47
2008-03-27 00:00:00.000,ATP Masters Series Miami FL; U.S.A. ATP World Tour,HARD,2,Rafael Nadal,N/A Bye,Rafael Nadal,,R128,0,0,0,0,0,0,0,0,0,0,0,0,0,0,0,0,0,0,0,0,0,0,0,0,0,0,0
2008-03-27 00:00:00.000,ATP Masters Series Miami FL; U.S.A. ATP World Tour,HARD,2,Roger Federer,Gael Monfils,Roger Federer,6-3; 6-4,R64,67,2,1,46,67,35,46,13,21,7,7,10,48,67,8,2,31,52,23,31,9,21,0,2,9,32,52
2008-03-27 00:00:00.000,ATP Masters Series Miami FL; U.S.A. ATP World Tour,HARD,2,Robin Soderling,Stanislas Wawrinka,Robin Soderling,3-6; 6-4; 6-3,R64,112,8,3,53,86,43,53,15,33,5,6,14,58,86,5,3,38,74,29,38,21,36,0,2,14,50,74
2008-03-27 00:00:00.000,ATP Masters Series Miami FL; U.S.A. ATP World Tour,HARD,2,Jose Acasuso,Lleyton Hewitt,Jose Acasuso,6-3; 7-6(4),R64,113,13,4,40,82,31,40,26,42,3,3,11,57,82,9,2,37,64,29,37,14,27,4,5,10,43,64
2008-03-27 00:00:00.000,ATP Masters Series Miami FL; U.S.A. ATP World Tour,HARD,2,Dudi Sela,Tommy Robredo,Dudi Sela,7-6(5); 6-1,R64,91,1,0,55,66,38,55,4,11,5,7,10,42,66,0,0,38,67,23,38,12,29,5,9,9,35,67
2008-03-27 00:00:00.000,ATP Masters Series Miami FL; U.S.A. ATP World Tour,HARD,2,Jo-Wilfried Tsonga,Jurgen Melzer,Jo-Wilfried Tsonga,6-7(4); 7-5; 6-1,R64,123,5,3,54,89,44,54,22,35,3,4,16,66,89,3,5,66,101,41,66,20,35,3,7,15,61,101
2008-03-27 00:00:00.000,ATP Masters Series Miami FL; U.S.A. ATP World Tour,HARD,2,Julien Benneteau,Ivo Karlovic,Julien Benneteau,3-6; 6-4; 7-6(2),R64,130,3,3,43,88,33,43,31,45,2,4,16,64,88,22,1,66,101,48,66,21,35,5,6,15,69,101
2008-03-27 00:00:00.000,ATP Masters Series Miami FL; U.S.A. ATP World Tour,HARD,2,Ivo Minar,Juan Ignacio Chela,Ivo Minar,6-3; 5-7; 6-3,R64,129,6,2,52,99,32,52,29,47,6,10,15,61,99,4,2,44,88,29,44,20,44,6,12,15,49,88
2008-03-27 00:00:00.000,ATP Masters Series Miami FL; U.S.A. ATP World Tour,HARD,2,Andy Roddick,Viktor Troicki,Andy Roddick,5-7; 6-2; 6-4,R64,134,13,5,51,89,41,51,21,38,5,7,15,62,89,5,6,55,100,37,55,23,45,6,10,15,60,100
2008-03-27 00:00:00.000,ATP Masters Series Miami FL; U.S.A. ATP World Tour,HARD,2,Nikolay Davydenko,Ernests Gulbis,Nikolay Davydenko,3-6; 7-6(6); 7-6(3),R64,161,6,3,66,105,43,66,22,39,3,7,16,65,105,8,7,74,128,49,74,28,54,6,9,17,77,128
2008-03-27 00:00:00.000,ATP Masters Series Miami FL; U.S.A. ATP World Tour,HARD,2,Simone Bolelli,Philipp Kohlschreiber,Simone Bolelli,6-4; 6-3,R64,78,3,1,45,66,33,45,13,21,3,4,10,46,66,4,3,37,58,27,37,7,21,4,7,9,34,58
2008-03-27 00:00:00.000,ATP Masters Series Miami FL; U.S.A. ATP World Tour,HARD,2,Juan Monaco,Ryan Sweeting,Juan Monaco,6-3; 7-5,R64,91,4,2,41,60,32,41,11,19,1,2,11,43,60,6,4,46,74,31,46,12,28,7,10,10,43,74
2008-03-27 00:00:00.000,ATP Masters Series Miami FL; U.S.A. ATP World Tour,HARD,2,Mario Ancic,Andy Murray,Mario Ancic,6-2; 2-6; 7-6(7),R64,149,6,2,51,95,38,51,18,44,5,9,14,56,95,2,3,43,94,25,43,26,51,7,11,14,51,94
2008-03-27 00:00:00.000,ATP Masters Series Miami FL; U.S.A. ATP World Tour,HARD,2,Mikhail Youzhny,Bobby Reynolds,Mikhail Youzhny,6-2; 6-2,R64,64,7,2,35,46,27,35,6,11,0,0,8,33,46,5,3,34,53,21,34,5,19,7,11,8,26,53
2008-03-27 00:00:00.000,ATP Masters Series Miami FL; U.S.A. ATP World Tour,HARD,2,Nicolas Almagro,Arnaud Clement,Nicolas Almagro,6-2; 6-2,R64,63,13,5,27,54,22,27,16,27,7,7,8,38,54,3,2,21,39,12,21,8,18,0,4,8,20,39
2008-03-27 00:00:00.000,ATP Masters Series Miami FL; U.S.A. ATP World Tour,HARD,2,Janko Tipsarevic,Fernando Verdasco,Janko Tipsarevic,6-4; 7-6(4),R64,97,7,4,33,56,27,33,15,23,0,2,11,42,56,5,6,43,75,28,43,16,32,5,8,11,44,75
2008-03-27 00:00:00.000,ATP Masters Series Miami FL; U.S.A. ATP World Tour,HARD,2,Thomas Johansson,David Ferrer,Thomas Johansson,6-4; 7-5,R64,104,9,3,40,84,31,40,20,44,7,9,11,51,84,2,3,39,71,22,39,18,32,3,7,11,40,71
2008-03-27 00:00:00.000,ATP Masters Series Miami FL; U.S.A. ATP World Tour,HARD,2,Dmitry Tursunov,Richard Gasquet,Dmitry Tursunov,6-3; 6-7(2); 7-6(5),R64,149,12,5,54,113,40,54,32,59,8,11,17,72,113,10,2,59,102,43,59,21,43,1,5,16,64,102
2008-03-27 00:00:00.000,ATP Masters Series Miami FL; U.S.A. ATP World Tour,HARD,2,Feliciano Lopez,Juan Martin Del Potro,Feliciano Lopez,6-4; 6-2,R64,65,8,4,35,56,29,35,8,21,2,3,9,37,56,1,2,32,44,19,32,5,12,1,5,9,24,44
2008-03-27 00:00:00.000,ATP Masters Series Miami FL; U.S.A. ATP World Tour,HARD,2,Juan Carlos Ferrero,Albert Montanes,Juan Carlos Ferrero,6-3; 6-2,R64,65,8,1,27,55,21,27,20,28,3,3,9,41,55,2,4,26,44,18,26,7,18,3,6,8,25,44
2008-03-27 00:00:00.000,ATP Masters Series Miami FL; U.S.A. ATP World Tour,HARD,2,Tomas Berdych,Sam Querrey,Tomas Berdych,6-1; 6-2,R64,60,5,0,20,43,18,20,15,23,1,1,8,33,43,5,2,37,59,17,37,12,22,9,13,7,29,59
2008-03-27 00:00:00.000,ATP Masters Series Miami FL; U.S.A. ATP World Tour,HARD,2,Guillermo Canas,Sam Warburg,Guillermo Canas,6-3; 4-6; 7-5,R64,151,13,5,64,119,47,64,28,55,9,11,15,75,119,7,4,57,88,44,57,12,31,2,6,16,56,88
2008-03-27 00:00:00.000,ATP Masters Series Miami FL; U.S.A. ATP World Tour,HARD,2,Fernando Gonzalez,Pablo Cuevas,Fernando Gonzalez,6-3; 6-3,R64,71,3,2,32,51,26,32,12,19,0,0,9,38,51,5,1,48,75,25,48,16,27,5,8,9,41,75
2008-03-27 00:00:00.000,ATP Masters Series Miami FL; U.S.A. ATP World Tour,HARD,2,Igor Andreev,Michael Berrer,Igor Andreev,6-2; 6-1,R64,71,5,0,38,50,29,38,6,12,2,2,8,35,50,3,2,35,56,18,35,9,21,4,8,7,27,56
2008-03-27 00:00:00.000,ATP Masters Series Miami FL; U.S.A. ATP World Tour,HARD,2,Kevin Anderson,Novak Djokovic,Kevin Anderson,7-6(1); 3-6; 6-4,R64,142,6,5,70,107,51,70,19,37,3,6,16,70,107,4,1,50,89,34,50,22,39,3,5,15,56,89
2008-03-27 00:00:00.000,ATP Masters Series Miami FL; U.S.A. ATP World Tour,HARD,2,Xavier Malisse,David Nalbandian,Xavier Malisse,6-1; 6-4,R64,71,3,1,36,51,24,36,8,15,6,8,8,32,51,0,2,24,49,14,24,8,25,2,8,9,22,49
2008-03-27 00:00:00.000,ATP Masters Series Miami FL; U.S.A. ATP World Tour,HARD,2,Radek Stepanek,Sebastien Grosjean,Radek Stepanek,6-3; 6-3,R64,77,3,2,44,61,33,44,9,17,4,4,9,42,61,2,1,35,53,21,35,10,18,1,4,9,31,53
2008-03-27 00:00:00.000,ATP Masters Series Miami FL; U.S.A. ATP World Tour,HARD,2,Fabrice Santoro,Ivan Ljubicic,Fabrice Santoro,7-6(4); 2-6; 6-3,R64,124,3,1,50,92,36,50,26,42,4,7,15,62,92,14,2,52,87,42,52,17,35,2,4,14,59,87
2008-03-27 00:00:00.000,ATP Masters Series Miami FL; U.S.A. ATP World Tour,HARD,2,James Blake,Andreas Seppi,James Blake,7-5; 6-3,R64,67,7,3,37,67,28,37,16,30,2,3,11,44,67,6,5,32,53,22,32,12,21,3,6,10,34,53
2008-03-27 00:00:00.000,ATP Masters Series Miami FL; U.S.A. ATP World Tour,HARD,2,Paul-Henri Mathieu,Marin Cilic,Paul-Henri Mathieu,4-6; 6-1; 6-4,R64,125,3,6,46,92,35,46,21,46,4,7,14,56,92,7,7,39,82,26,39,20,43,7,12,13,46,82
2008-03-27 00:00:00.000,ATP Masters Series Miami FL; U.S.A. ATP World Tour,HARD,2,Carlos Moya,Nicolas Mahut,Carlos Moya,7-6(10); 6-4,R64,101,5,2,48,70,37,48,14,22,0,1,11,51,70,5,4,51,80,37,51,14,29,3,5,11,51,80
2008-03-27 00:00:00.000,ATP Masters Series Miami FL; U.S.A. ATP World Tour,HARD,2,Nicolas Kiefer,Jarkko Nieminen,Nicolas Kiefer,6-3; 6-2,R64,61,8,2,28,51,26,28,13,23,5,5,9,39,51,4,1,28,42,19,28,6,14,1,4,8,25,42
2008-03-27 00:00:00.000,ATP Masters Series Miami FL; U.S.A. ATP World Tour,HARD,2,Rafael Nadal,Benjamin Becker,Rafael Nadal,7-5; 6-2,R64,81,8,1,33,52,24,33,15,19,2,3,10,39,52,8,1,25,54,15,25,15,29,1,5,10,30,54
2008-03-27 00:00:00.000,ATP Masters Series Miami FL; U.S.A. ATP World Tour,HARD,2,Roger Federer,Robin Soderling,Roger Federer,6-4; 3-0 RET,R32,47,6,1,29,41,23,29,6,12,3,4,7,29,41,0,2,17,33,10,17,5,16,2,5,6,15,33
2008-03-27 00:00:00.000,ATP Masters Series Miami FL; U.S.A. ATP World Tour,HARD,2,Jose Acasuso,Dudi Sela,Jose Acasuso,6-4; 6-4,R32,86,7,2,33,65,28,33,15,32,2,3,10,43,65,1,1,41,61,26,41,10,20,4,7,10,36,61
2008-03-27 00:00:00.000,ATP Masters Series Miami FL; U.S.A. ATP World Tour,HARD,2,Julien Benneteau,Jo-Wilfried Tsonga,Julien Benneteau,6-3; 6-3,R32,86,4,3,29,60,21,29,21,31,4,4,9,42,60,4,2,34,60,24,34,10,26,8,11,9,34,60
2008-03-27 00:00:00.000,ATP Masters Series Miami FL; U.S.A. ATP World Tour,HARD,2,Andy Roddick,Ivo Minar,Andy Roddick,7-6(4); 6-4,R32,99,10,0,37,65,30,37,16,28,0,1,11,46,65,4,1,48,88,31,48,22,40,7,9,11,53,88
2008-03-27 00:00:00.000,ATP Masters Series Miami FL; U.S.A. ATP World Tour,HARD,2,Nikolay Davydenko,Simone Bolelli,Nikolay Davydenko,6-7(5); 7-5; 6-1,R32,158,4,2,65,115,52,65,27,50,6,6,16,79,115,5,2,72,102,47,72,17,30,8,11,15,64,102
2008-03-27 00:00:00.000,ATP Masters Series Miami FL; U.S.A. ATP World Tour,HARD,2,Mario Ancic,Juan Monaco,Mario Ancic,7-6(5); 4-6; 6-1,R32,160,8,4,56,101,45,56,20,45,3,6,15,65,101,1,7,67,103,46,67,14,36,6,10,14,60,103
2008-03-27 00:00:00.000,ATP Masters Series Miami FL; U.S.A. ATP World Tour,HARD,2,Mikhail Youzhny,Nicolas Almagro,Mikhail Youzhny,7-6(4); 3-6; 7-6(6),R32,163,6,5,78,130,51,78,23,52,17,23,16,74,130,10,5,66,122,46,66,25,56,11,16,17,71,122
2008-03-27 00:00:00.000,ATP Masters Series Miami FL; U.S.A. ATP World Tour,HARD,2,Janko Tipsarevic,Thomas Johansson,Janko Tipsarevic,6-4; 6-4,R32,91,16,3,32,66,28,32,20,34,5,5,10,48,66,7,4,28,59,20,28,16,31,3,5,10,36,59
2008-03-27 00:00:00.000,ATP Masters Series Miami FL; U.S.A. ATP World Tour,HARD,2,Dmitry Tursunov,Feliciano Lopez,Dmitry Tursunov,4-6; 6-3; 6-4,R32,131,14,2,50,93,41,50,23,43,2,3,15,64,93,15,0,46,79,33,46,21,33,1,3,14,54,79
2008-03-27 00:00:00.000,ATP Masters Series Miami FL; U.S.A. ATP World Tour,HARD,2,Tomas Berdych,Juan Carlos Ferrero,Tomas Berdych,6-1; 6-3,R32,65,6,1,24,45,19,24,12,21,1,2,8,31,45,1,2,23,46,13,23,5,23,2,7,8,18,46
2008-03-27 00:00:00.000,ATP Masters Series Miami FL; U.S.A. ATP World Tour,HARD,2,Guillermo Canas,Fernando Gonzalez,Guillermo Canas,7-6(6); 7-5,R32,136,10,1,45,81,35,45,22,36,6,7,12,57,81,2,3,47,86,30,47,22,39,1,3,12,52,86
2008-03-27 00:00:00.000,ATP Masters Series Miami FL; U.S.A. ATP World Tour,HARD,2,Igor Andreev,Kevin Anderson,Igor Andreev,6-4; 6-7(4); 6-4,R32,141,8,3,59,94,46,59,24,35,2,2,16,70,94,2,5,64,110,43,64,30,46,3,5,16,73,110
2008-03-27 00:00:00.000,ATP Masters Series Miami FL; U.S.A. ATP World Tour,HARD,2,Radek Stepanek,Xavier Malisse,Radek Stepanek,6-3; 7-6(4),R32,100,5,2,38,70,29,38,22,32,3,3,11,51,70,7,1,42,75,29,42,18,33,5,6,10,47,75
2008-03-27 00:00:00.000,ATP Masters Series Miami FL; U.S.A. ATP World Tour,HARD,2,James Blake,Fabrice Santoro,James Blake,6-3; 6-7(4); 6-4,R32,136,6,5,60,114,45,60,22,54,4,8,16,67,114,5,1,58,105,34,58,24,47,7,13,15,58,105
2008-03-27 00:00:00.000,ATP Masters Series Miami FL; U.S.A. ATP World Tour,HARD,2,Paul-Henri Mathieu,Carlos Moya,Paul-Henri Mathieu,7-6(1); 7-5,R32,111,4,2,40,75,31,40,21,35,0,1,12,52,75,11,1,46,70,33,46,12,24,0,2,12,45,70
2008-03-27 00:00:00.000,ATP Masters Series Miami FL; U.S.A. ATP World Tour,HARD,2,Rafael Nadal,Nicolas Kiefer,Rafael Nadal,6-2; 6-4,R32,110,6,0,34,52,27,34,12,18,0,0,9,39,52,8,0,31,56,21,31,9,25,1,4,9,30,56
2008-03-27 00:00:00.000,ATP Masters Series Miami FL; U.S.A. ATP World Tour,HARD,2,Roger Federer,Jose Acasuso,Roger Federer,7-6(5); 6-2,R16,75,12,4,39,55,36,39,9,16,0,0,10,45,55,5,6,33,63,22,33,17,30,5,7,10,39,63
2008-03-27 00:00:00.000,ATP Masters Series Miami FL; U.S.A. ATP World Tour,HARD,2,Andy Roddick,Julien Benneteau,Andy Roddick,4-6; 6-3; 6-2,R16,128,11,1,49,84,43,49,17,35,3,4,14,60,84,6,7,39,89,29,39,24,50,5,8,13,53,89
2008-03-27 00:00:00.000,ATP Masters Series Miami FL; U.S.A. ATP World Tour,HARD,2,Nikolay Davydenko,Mario Ancic,Nikolay Davydenko,4-6; 6-3; 7-5,R16,150,4,4,60,93,38,60,20,33,2,6,16,58,93,4,2,49,92,36,49,17,43,1,6,15,53,92
2008-03-27 00:00:00.000,ATP Masters Series Miami FL; U.S.A. ATP World Tour,HARD,2,Janko Tipsarevic,Mikhail Youzhny,Janko Tipsarevic,3-6; 6-0; 6-3,R16,118,3,1,36,70,28,36,18,34,3,5,12,46,70,1,4,36,82,27,36,17,46,7,12,12,44,82
2008-03-27 00:00:00.000,ATP Masters Series Miami FL; U.S.A. ATP World Tour,HARD,2,Tomas Berdych,Dmitry Tursunov,Tomas Berdych,6-2; 6-2,R16,65,8,4,26,49,23,26,11,23,1,1,8,34,49,6,1,27,42,19,27,3,15,0,4,8,22,42
2008-03-27 00:00:00.000,ATP Masters Series Miami FL; U.S.A. ATP World Tour,HARD,2,Igor Andreev,Guillermo Canas,Igor Andreev,6-4; 7-6(6),R16,124,6,1,49,80,33,49,18,31,3,5,11,51,80,4,2,42,74,26,42,18,32,3,6,11,44,74
2008-03-27 00:00:00.000,ATP Masters Series Miami FL; U.S.A. ATP World Tour,HARD,2,James Blake,Radek Stepanek,James Blake,6-3; 6-4,R16,83,7,1,35,64,25,35,13,29,1,3,10,38,64,5,1,43,58,23,43,8,15,5,9,9,31,58
2008-03-27 00:00:00.000,ATP Masters Series Miami FL; U.S.A. ATP World Tour,HARD,2,Rafael Nadal,Paul-Henri Mathieu,Rafael Nadal,6-4; 6-4,R16,90,3,1,42,55,36,42,4,13,0,1,10,40,55,4,1,38,62,22,38,16,24,8,11,10,38,62
2008-03-27 00:00:00.000,ATP Masters Series Miami FL; U.S.A. ATP World Tour,HARD,2,Andy Roddick,Roger Federer,Andy Roddick,7-6(4); 4-6; 6-3,Q,115,17,1,70,101,54,70,15,31,2,3,16,69,101,7,1,54,85,40,54,19,31,0,1,15,59,85
2008-03-27 00:00:00.000,ATP Masters Series Miami FL; U.S.A. ATP World Tour,HARD,2,Nikolay Davydenko,Janko Tipsarevic,Nikolay Davydenko,6-2; 6-1,Q,72,9,3,32,53,22,32,13,21,1,2,8,35,53,3,1,23,45,14,23,5,22,1,6,7,19,45
2008-03-27 00:00:00.000,ATP Masters Series Miami FL; U.S.A. ATP World Tour,HARD,2,Tomas Berdych,Igor Andreev,Tomas Berdych,6-4; 6-4,Q,78,4,0,33,55,25,33,17,22,3,3,10,42,55,3,0,37,53,29,37,8,16,0,2,10,37,53
2008-03-27 00:00:00.000,ATP Masters Series Miami FL; U.S.A. ATP World Tour,HARD,2,Rafael Nadal,James Blake,Rafael Nadal,3-6; 6-3; 6-1,Q,121,3,0,47,66,31,47,16,19,2,3,12,47,66,9,5,51,100,37,51,20,49,15,19,13,57,100
2008-03-27 00:00:00.000,ATP Masters Series Miami FL; U.S.A. ATP World Tour,HARD,2,Nikolay Davydenko,Andy Roddick,Nikolay Davydenko,7-6(5); 6-2,S,89,6,0,39,52,34,39,5,13,0,1,10,39,52,9,1,53,74,35,53,8,21,5,8,10,43,74
2008-03-27 00:00:00.000,ATP Masters Series Miami FL; U.S.A. ATP World Tour,HARD,2,Rafael Nadal,Tomas Berdych,Rafael Nadal,7-6(6); 6-2,S,102,6,2,43,63,33,43,14,20,3,4,10,47,63,5,1,35,64,25,35,12,29,2,5,10,37,64
2008-03-27 00:00:00.000,ATP Masters Series Miami FL; U.S.A. ATP World Tour,HARD,2,Nikolay Davydenko,Rafael Nadal,Nikolay Davydenko,6-4; 6-2,F,91,3,2,30,47,24,30,10,17,2,3,9,34,47,0,1,35,50,21,35,6,15,2,6,9,27,50
2008-04-14 00:00:00.000,Estoril Portugal ATP World Tour,CLAY,2,Roger Federer,Olivier Rochus,Roger Federer,4-6; 6-3; 6-2,R32,120,17,3,46,79,41,46,16,33,1,2,14,57,79,1,5,74,110,44,74,20,36,10,13,13,64,110
2008-04-14 00:00:00.000,Estoril Portugal ATP World Tour,CLAY,2,Victor Hanescu,Olivier Patience,Victor Hanescu,6-1; 7-6(2),R32,72,0,2,38,55,30,38,12,17,0,1,10,42,55,2,4,35,57,24,35,8,22,1,4,9,32,57
2008-04-14 00:00:00.000,Estoril Portugal ATP World Tour,CLAY,2,Joao Sousa,Oliver Marach,Joao Sousa,6-1; 6-3,R32,57,4,0,24,44,17,24,14,20,3,4,8,31,44,1,1,16,41,7,16,11,25,3,8,8,18,41
2008-04-14 00:00:00.000,Estoril Portugal ATP World Tour,CLAY,2,Frederico Gil,Nicolas Mahut,Frederico Gil,6-0; 6-3,R32,68,3,1,27,46,21,27,11,19,0,0,8,32,46,1,4,25,49,16,25,7,24,5,9,7,23,49
2008-04-14 00:00:00.000,Estoril Portugal ATP World Tour,CLAY,2,Denis Gremelmayr,Jarkko Nieminen,Denis Gremelmayr,3-6; 6-1; 6-2,R32,86,6,1,36,67,28,36,16,31,2,5,12,44,67,0,2,67,92,38,67,11,25,12,18,12,49,92
2008-04-14 00:00:00.000,Estoril Portugal ATP World Tour,CLAY,2,Teymuraz Gabashvili,Florian Mayer,Teymuraz Gabashvili,7-5; 7-5,R32,109,3,5,50,92,30,50,22,42,10,14,12,52,92,0,3,51,84,25,51,16,33,4,10,12,41,84
2008-04-14 00:00:00.000,Estoril Portugal ATP World Tour,CLAY,2,Jiri Vanek,Philipp Petzschner,Jiri Vanek,4-6; 6-3; 6-4,R32,139,2,6,47,96,35,47,26,49,9,12,14,61,96,2,4,50,98,36,50,18,48,3,8,15,54,98
2008-04-14 00:00:00.000,Estoril Portugal ATP World Tour,CLAY,2,Michael Berrer,Gastao Elias,Michael Berrer,6-4; 7-5,R32,106,2,4,39,64,29,39,9,25,2,5,11,38,64,4,3,35,74,17,35,23,39,2,7,11,40,74
2008-04-14 00:00:00.000,Estoril Portugal ATP World Tour,CLAY,2,Gilles Simon,Roko Karanusic,Gilles Simon,7-5; 7-5,R32,95,3,1,38,65,27,38,15,27,1,4,12,42,65,1,1,42,80,25,42,19,38,8,13,12,44,80
2008-04-14 00:00:00.000,Estoril Portugal ATP World Tour,CLAY,2,Flavio Cipolla,Edouard Roger-Vasselin,Flavio Cipolla,6-4; 5-7; 6-4,R32,166,0,1,86,114,54,86,13,28,13,18,16,67,114,1,4,81,124,52,81,16,43,14,20,16,68,124
2008-04-14 00:00:00.000,Estoril Portugal ATP World Tour,CLAY,2,Florent Serra,Gianluca Naso,Florent Serra,6-1; 6-2,R32,72,2,1,40,56,29,40,6,16,2,3,8,35,56,2,2,27,54,14,27,9,27,4,9,7,23,54
2008-04-14 00:00:00.000,Estoril Portugal ATP World Tour,CLAY,2,Rui Machado,Ivo Karlovic,Rui Machado,6-4; 1-0 RET,R32,43,0,2,16,23,13,16,5,7,0,1,5,18,23,5,1,18,35,14,18,4,17,1,4,6,18,35
2008-04-14 00:00:00.000,Estoril Portugal ATP World Tour,CLAY,2,Marc Gicquel,Boris Pashanski,Marc Gicquel,6-4; 6-3,R32,78,12,1,30,50,26,30,10,20,1,2,9,36,50,1,4,22,60,14,22,18,38,3,7,10,32,60
2008-04-14 00:00:00.000,Estoril Portugal ATP World Tour,CLAY,2,Thierry Ascione,Alexander Kudryavtsev,Thierry Ascione,6-1; 6-4,R32,64,0,0,31,52,20,31,16,21,3,4,9,36,52,2,3,27,55,16,27,12,28,5,9,8,28,55
2008-04-14 00:00:00.000,Estoril Portugal ATP World Tour,CLAY,2,Ivo Minar,Martin Vassallo Arguello,Ivo Minar,7-5; 6-1,R32,90,2,2,34,66,21,34,18,32,2,5,10,39,66,0,0,38,57,14,38,11,19,2,8,9,25,57
2008-04-14 00:00:00.000,Estoril Portugal ATP World Tour,CLAY,2,Nikolay Davydenko,Jurgen Melzer,Nikolay Davydenko,6-3; 6-1,R32,60,0,1,31,40,23,31,5,9,0,1,8,28,40,1,2,36,59,18,36,9,23,7,12,8,27,59
2008-04-14 00:00:00.000,Estoril Portugal ATP World Tour,CLAY,2,Roger Federer,Victor Hanescu,Roger Federer,6-3; 6-2,R16,60,3,1,26,48,22,26,15,22,0,0,9,37,48,1,0,35,51,18,35,9,16,2,5,8,27,51
2008-04-14 00:00:00.000,Estoril Portugal ATP World Tour,CLAY,2,Frederico Gil,Joao Sousa,Frederico Gil,7-6(5); 6-2,R16,120,2,0,44,61,36,44,11,17,2,2,10,47,61,3,3,47,75,30,47,17,28,4,6,10,47,75
2008-04-14 00:00:00.000,Estoril Portugal ATP World Tour,CLAY,2,Denis Gremelmayr,Teymuraz Gabashvili,Denis Gremelmayr,7-6(6); 6-1,R16,100,2,1,33,60,23,33,14,27,1,4,10,37,60,5,5,38,74,22,38,14,36,12,17,9,36,74
2008-04-14 00:00:00.000,Estoril Portugal ATP World Tour,CLAY,2,Jiri Vanek,Michael Berrer,Jiri Vanek,6-3; 3-6; 7-5,R16,143,2,3,48,90,31,48,27,42,2,5,15,58,90,2,6,60,98,44,60,16,38,6,10,15,60,98
2008-04-14 00:00:00.000,Estoril Portugal ATP World Tour,CLAY,2,Flavio Cipolla,Gilles Simon,Flavio Cipolla,6-2; 5-3 RET,R16,73,1,5,46,63,32,46,6,17,6,8,8,38,63,3,3,24,41,11,24,4,17,0,5,8,15,41
2008-04-14 00:00:00.000,Estoril Portugal ATP World Tour,CLAY,2,Florent Serra,Rui Machado,Florent Serra,7-6(5); 6-1,R16,106,1,0,47,75,29,47,15,28,2,4,9,44,75,0,4,44,81,23,44,17,37,6,11,10,40,81
2008-04-14 00:00:00.000,Estoril Portugal ATP World Tour,CLAY,2,Marc Gicquel,Thierry Ascione,Marc Gicquel,7-6(2); 6-3,R16,97,7,3,33,75,25,33,22,42,4,7,11,47,75,2,1,46,70,29,46,9,24,2,6,10,38,70
2008-04-14 00:00:00.000,Estoril Portugal ATP World Tour,CLAY,2,Nikolay Davydenko,Ivo Minar,Nikolay Davydenko,2-6; 6-2; 6-4,R16,112,3,4,57,85,41,57,9,28,3,7,13,50,85,5,1,49,74,34,49,7,25,2,7,13,41,74
2008-04-14 00:00:00.000,Estoril Portugal ATP World Tour,CLAY,2,Roger Federer,Frederico Gil,Roger Federer,6-4; 6-1,Q,94,5,1,35,50,26,35,7,15,3,5,9,33,50,0,1,34,44,14,34,4,10,2,7,8,18,44
2008-04-14 00:00:00.000,Estoril Portugal ATP World Tour,CLAY,2,Denis Gremelmayr,Jiri Vanek,Denis Gremelmayr,6-2; 3-6; 6-2,Q,94,4,1,38,65,27,38,20,27,3,4,12,47,65,4,1,44,78,30,44,17,34,6,10,13,47,78
2008-04-14 00:00:00.000,Estoril Portugal ATP World Tour,CLAY,2,Florent Serra,Flavio Cipolla,Florent Serra,6-1; 6-1,Q,62,1,1,34,58,26,34,12,24,9,9,7,38,58,0,5,44,56,22,44,3,12,9,14,7,25,56
2008-04-14 00:00:00.000,Estoril Portugal ATP World Tour,CLAY,2,Nikolay Davydenko,Marc Gicquel,Nikolay Davydenko,6-4; 5-7; 6-3,Q,150,4,3,53,96,38,53,21,43,7,11,15,59,96,1,1,61,111,40,61,20,50,2,8,16,60,111
2008-04-14 00:00:00.000,Estoril Portugal ATP World Tour,CLAY,2,Roger Federer,Denis Gremelmayr,Roger Federer,2-6; 7-5; 6-1,S,93,10,0,51,73,36,51,14,22,1,4,14,50,73,3,4,44,81,30,44,15,37,2,6,13,45,81
2008-04-14 00:00:00.000,Estoril Portugal ATP World Tour,CLAY,2,Nikolay Davydenko,Florent Serra,Nikolay Davydenko,6-2; 6-2,S,72,1,3,35,60,26,35,13,25,7,8,8,39,60,0,0,35,44,16,35,4,9,3,8,8,20,44
2008-04-14 00:00:00.000,Estoril Portugal ATP World Tour,CLAY,2,Roger Federer,Nikolay Davydenko,Roger Federer,7-6(5); 1-2 RET,F,79,5,0,36,58,26,36,11,22,4,5,8,37,58,3,1,39,53,26,39,9,14,5,5,7,35,53
2008-04-14 00:00:00.000,Houston TX; U.S.A. ATP World Tour,CLAY,2,James Blake,Kei Nishikori,James Blake,6-4; 6-4,R32,87,4,0,30,59,19,30,18,29,2,4,10,37,59,4,2,43,84,22,43,22,41,7,11,10,44,84
2008-04-14 00:00:00.000,Houston TX; U.S.A. ATP World Tour,CLAY,2,Ryan Harrison,Pablo Cuevas,Ryan Harrison,6-4; 6-3,R32,58,6,1,29,49,22,29,11,20,1,3,10,33,49,1,2,29,51,18,29,10,22,2,6,9,28,51
2008-04-14 00:00:00.000,Houston TX; U.S.A. ATP World Tour,CLAY,2,Paul Capdeville,Diego Hartfield,Paul Capdeville,6-0; 6-4,R32,98,1,3,43,90,26,43,23,47,17,19,8,49,90,0,1,34,48,16,34,3,14,1,7,8,19,48
2008-04-14 00:00:00.000,Houston TX; U.S.A. ATP World Tour,CLAY,2,Agustin Calleri,Vincent Spadea,Agustin Calleri,6-4; 6-3,R32,82,4,4,27,68,20,27,23,41,3,4,9,43,68,0,4,39,62,24,39,9,23,4,8,10,33,62
2008-04-14 00:00:00.000,Houston TX; U.S.A. ATP World Tour,CLAY,2,Mardy Fish,Rainer Schuettler,Mardy Fish,7-6(4); 6-3,R32,82,11,3,32,62,27,32,20,30,0,1,11,47,62,2,3,42,66,32,42,8,24,3,5,10,40,66
2008-04-14 00:00:00.000,Houston TX; U.S.A. ATP World Tour,CLAY,2,Hugo Armando,Carlos Berlocq,Hugo Armando,6-3; 4-6; 7-5,R32,165,2,2,71,103,42,71,17,32,6,11,16,59,103,3,0,67,98,40,67,14,31,5,11,15,54,98
2008-04-14 00:00:00.000,Houston TX; U.S.A. ATP World Tour,CLAY,2,Donald Young,Fernando Vicente,Donald Young,6-3; 7-6(5),R32,102,0,4,54,82,36,54,11,28,10,14,11,47,82,0,1,34,68,21,34,15,34,5,10,10,36,68
2008-04-14 00:00:00.000,Houston TX; U.S.A. ATP World Tour,CLAY,2,Oscar Hernandez,Juan Pablo Brzezicki,Oscar Hernandez,3-6; 6-3; 6-2,R32,90,1,3,44,72,33,44,14,28,1,4,13,47,72,1,9,50,84,31,50,13,34,4,9,13,44,84
2008-04-14 00:00:00.000,Houston TX; U.S.A. ATP World Tour,CLAY,2,Marcel Granollers,Ernests Gulbis,Marcel Granollers,6-2; 6-0,R32,50,0,6,22,41,20,22,9,19,0,0,7,29,41,0,4,19,36,8,19,6,17,2,7,7,14,36
2008-04-14 00:00:00.000,Houston TX; U.S.A. ATP World Tour,CLAY,2,Peter Luczak,Harel Levy,Peter Luczak,6-4; 6-4,R32,84,3,3,44,69,30,44,14,25,12,13,10,44,69,4,3,30,57,23,30,13,27,2,5,10,36,57
2008-04-14 00:00:00.000,Houston TX; U.S.A. ATP World Tour,CLAY,2,Marcos Daniel,Viktor Troicki,Marcos Daniel,6-3; 6-4,R32,83,4,2,36,53,29,36,12,17,2,2,10,41,53,4,0,40,57,25,40,11,17,4,6,9,36,57
2008-04-14 00:00:00.000,Houston TX; U.S.A. ATP World Tour,CLAY,2,Nicolas Massu,Sam Querrey,Nicolas Massu,5-7; 6-4; 6-4,R32,168,4,3,68,98,47,68,15,30,3,7,16,62,98,8,8,54,121,37,54,31,67,15,20,16,68,121
2008-04-14 00:00:00.000,Houston TX; U.S.A. ATP World Tour,CLAY,2,Dudi Sela,Robby Ginepri,Dudi Sela,7-6(5); 6-2,R32,86,4,3,48,74,32,48,12,26,5,7,10,44,74,1,2,49,70,29,49,10,21,3,7,10,39,70
2008-04-14 00:00:00.000,Houston TX; U.S.A. ATP World Tour,CLAY,2,Wayne Odesnik,Amer Delic,Wayne Odesnik,6-3; 6-3,R32,91,2,1,52,73,41,52,8,21,7,7,9,49,73,5,3,43,66,28,43,8,23,5,8,9,36,66
2008-04-14 00:00:00.000,Houston TX; U.S.A. ATP World Tour,CLAY,2,Sergio Roitman,John Isner,Sergio Roitman,3-6; 7-6(6); 6-3,R32,132,3,0,66,92,51,66,13,26,6,7,14,64,92,12,1,70,108,47,70,23,38,8,10,16,70,108
2008-04-14 00:00:00.000,Houston TX; U.S.A. ATP World Tour,CLAY,2,Igor Kunitsyn,Tommy Haas,Igor Kunitsyn,5-7; 6-4; 6-4,R32,168,1,6,68,111,40,68,21,43,9,15,16,61,111,7,12,63,129,36,63,31,66,8,15,16,67,129
2008-04-14 00:00:00.000,Houston TX; U.S.A. ATP World Tour,CLAY,2,James Blake,Ryan Harrison,James Blake,6-3; 6-2,R16,51,2,3,19,37,15,19,10,18,0,2,8,25,37,0,5,24,49,15,24,7,25,1,7,9,22,49
2008-04-14 00:00:00.000,Houston TX; U.S.A. ATP World Tour,CLAY,2,Agustin Calleri,Paul Capdeville,Agustin Calleri,6-2; 6-1,R16,59,4,5,25,51,23,25,14,26,1,1,8,37,51,0,1,33,53,19,33,6,20,11,15,7,25,53
2008-04-14 00:00:00.000,Houston TX; U.S.A. ATP World Tour,CLAY,2,Mardy Fish,Hugo Armando,Mardy Fish,6-3; 6-2,R16,79,9,2,37,66,28,37,14,29,5,6,9,42,66,0,4,33,54,18,33,10,21,3,7,8,28,54
2008-04-14 00:00:00.000,Houston TX; U.S.A. ATP World Tour,CLAY,2,Oscar Hernandez,Donald Young,Oscar Hernandez,6-4; 6-4,R16,96,4,3,46,66,36,46,10,20,6,6,10,46,66,2,1,48,75,30,48,13,27,7,9,10,43,75
2008-04-14 00:00:00.000,Houston TX; U.S.A. ATP World Tour,CLAY,2,Marcel Granollers,Peter Luczak,Marcel Granollers,6-3; 6-2,R16,91,4,3,41,70,25,41,17,29,7,8,9,42,70,0,1,33,52,16,33,9,19,3,7,8,25,52
2008-04-14 00:00:00.000,Houston TX; U.S.A. ATP World Tour,CLAY,2,Marcos Daniel,Nicolas Massu,Marcos Daniel,7-6(3); 6-2,R16,111,3,0,53,78,41,53,13,25,4,4,10,54,78,2,3,36,65,25,36,16,29,4,6,10,41,65
2008-04-14 00:00:00.000,Houston TX; U.S.A. ATP World Tour,CLAY,2,Wayne Odesnik,Dudi Sela,Wayne Odesnik,6-3; 7-5,R16,83,1,1,38,64,27,38,14,26,3,5,11,41,64,0,2,28,59,17,28,14,31,5,9,10,31,59
2008-04-14 00:00:00.000,Houston TX; U.S.A. ATP World Tour,CLAY,2,Sergio Roitman,Igor Kunitsyn,Sergio Roitman,6-3; 7-6(3),R16,115,0,3,52,72,31,52,12,20,4,7,10,43,72,1,1,56,85,32,56,12,29,10,15,11,44,85
2008-04-14 00:00:00.000,Houston TX; U.S.A. ATP World Tour,CLAY,2,James Blake,Agustin Calleri,James Blake,6-4; 6-3,Q,67,7,1,33,54,25,33,17,21,2,2,10,42,54,3,4,25,55,18,25,16,30,0,2,9,34,55
2008-04-14 00:00:00.000,Houston TX; U.S.A. ATP World Tour,CLAY,2,Oscar Hernandez,Mardy Fish,Oscar Hernandez,6-2; 7-6(5),Q,107,3,2,33,55,25,33,13,22,2,4,10,38,55,7,4,36,86,28,36,19,50,6,10,10,47,86
2008-04-14 00:00:00.000,Houston TX; U.S.A. ATP World Tour,CLAY,2,Marcel Granollers,Marcos Daniel,Marcel Granollers,6-3; 6-2,Q,77,2,5,25,52,19,25,14,27,1,2,8,33,52,1,3,34,55,18,34,8,21,2,7,9,26,55
2008-04-14 00:00:00.000,Houston TX; U.S.A. ATP World Tour,CLAY,2,Wayne Odesnik,Sergio Roitman,Wayne Odesnik,2-6; 7-6(4); 6-1,Q,159,2,3,51,88,31,51,16,37,5,11,13,47,88,3,5,52,96,28,52,19,44,9,16,14,47,96
2008-04-14 00:00:00.000,Houston TX; U.S.A. ATP World Tour,CLAY,2,James Blake,Oscar Hernandez,James Blake,6-3; 7-6(3),S,95,4,2,30,68,24,30,23,38,2,3,11,47,68,3,3,48,72,32,48,13,24,4,6,10,45,72
2008-04-14 00:00:00.000,Houston TX; U.S.A. ATP World Tour,CLAY,2,Marcel Granollers,Wayne Odesnik,Marcel Granollers,3-6; 7-5; 6-3,S,135,5,5,46,88,35,46,27,42,4,6,15,62,88,3,0,59,92,40,59,19,33,2,5,15,59,92
2008-04-14 00:00:00.000,Houston TX; U.S.A. ATP World Tour,CLAY,2,Marcel Granollers,James Blake,Marcel Granollers,6-4; 1-6; 7-5,F,132,1,6,51,85,32,51,13,34,2,8,15,45,85,5,4,44,89,31,44,21,45,8,13,14,52,89
2008-04-14 00:00:00.000,Valencia Spain ATP World Tour,CLAY,2,David Ferrer,Ivan Navarro,David Ferrer,6-3; 6-4,R32,93,2,1,46,62,33,46,9,16,2,3,10,42,62,4,3,52,73,35,52,6,21,8,11,9,41,73
2008-04-14 00:00:00.000,Valencia Spain ATP World Tour,CLAY,2,Pablo Andujar,Kristof Vliegen,Pablo Andujar,6-4; 6-1,R32,69,1,0,42,51,33,42,3,9,1,2,9,36,51,1,0,31,57,19,31,12,26,8,12,8,31,57
2008-04-14 00:00:00.000,Valencia Spain ATP World Tour,CLAY,2,Mischa Zverev,Luis Horna,Mischa Zverev,6-3; 6-7(5); 6-4,R32,132,9,1,65,90,50,65,16,25,2,2,15,66,90,3,2,87,113,62,87,10,26,11,14,16,72,113
2008-04-14 00:00:00.000,Valencia Spain ATP World Tour,CLAY,2,Fernando Verdasco,Nicolas Lapentti,Fernando Verdasco,5-7; 6-3; 6-4,R32,159,4,2,92,113,63,92,10,21,8,9,16,73,113,2,0,58,92,44,58,16,34,3,5,15,60,92
2008-04-14 00:00:00.000,Valencia Spain ATP World Tour,CLAY,2,Tommy Robredo,Albert Montanes,Tommy Robredo,6-3; 7-5,R32,102,2,0,47,66,33,47,10,19,1,3,11,43,66,0,4,38,69,25,38,12,31,7,11,10,37,69
2008-04-14 00:00:00.000,Valencia Spain ATP World Tour,CLAY,2,Santiago Ventura,David Marrero,Santiago Ventura,7-6(3); 7-6(6),R32,152,7,0,44,89,34,44,26,45,2,3,12,60,89,5,1,63,96,45,63,17,33,3,4,12,62,96
2008-04-14 00:00:00.000,Valencia Spain ATP World Tour,CLAY,2,Gael Monfils,Maximo Gonzalez,Gael Monfils,6-3; 6-4,R32,89,5,1,29,49,21,29,13,20,2,4,9,34,49,0,3,39,74,22,39,16,35,10,15,10,38,74
2008-04-14 00:00:00.000,Valencia Spain ATP World Tour,CLAY,2,Potito Starace,Simone Bolelli,Potito Starace,6-3; 6-1,R32,65,1,1,40,49,29,40,6,9,2,2,8,35,49,0,0,34,51,16,34,8,17,4,8,8,24,51
2008-04-14 00:00:00.000,Valencia Spain ATP World Tour,CLAY,2,Evgeny Korolev,Igor Andreev,Evgeny Korolev,6-4; 4-6; 7-6(4),R32,148,2,1,71,105,53,71,20,34,5,6,16,73,105,8,2,76,122,52,76,26,46,7,8,16,78,122
2008-04-14 00:00:00.000,Valencia Spain ATP World Tour,CLAY,2,Daniel Gimeno-Traver,Sergiy Stakhovsky,Daniel Gimeno-Traver,6-4; 6-4,R32,75,2,0,32,46,29,32,11,14,0,0,10,40,46,3,2,47,69,32,47,11,22,3,5,10,43,69
2008-04-14 00:00:00.000,Valencia Spain ATP World Tour,CLAY,2,Robin Haase,Yuri Schukin,Robin Haase,6-4; 4-1 RET,R32,65,9,0,32,44,24,32,6,12,4,6,8,30,44,1,0,34,59,16,34,11,25,3,7,7,27,59
2008-04-14 00:00:00.000,Valencia Spain ATP World Tour,CLAY,2,Marat Safin,Juan Carlos Ferrero,Marat Safin,6-3; 5-7; 6-4,R32,129,8,3,56,91,45,56,18,35,4,6,16,63,91,4,2,62,85,41,62,12,23,0,3,15,53,85
2008-04-14 00:00:00.000,Valencia Spain ATP World Tour,CLAY,2,Nicolas Almagro,Miguel Angel Lopez Jaen,Nicolas Almagro,7-5; 6-3,R32,100,13,6,46,91,37,46,20,45,6,7,11,57,91,3,0,45,72,35,45,8,27,5,8,10,43,72
2008-04-14 00:00:00.000,Valencia Spain ATP World Tour,CLAY,2,Eduardo Schwank,Christophe Rochus,Eduardo Schwank,6-2; 2-0 RET,R32,50,4,1,30,43,22,30,5,13,1,1,5,27,43,0,1,15,30,11,15,3,15,2,5,5,14,30
2008-04-14 00:00:00.000,Valencia Spain ATP World Tour,CLAY,2,Guillermo Garcia-Lopez,Steve Darcis,Guillermo Garcia-Lopez,6-4 RET,R32,43,0,2,19,31,10,19,8,12,3,4,5,18,31,1,0,13,27,7,13,8,14,2,4,5,15,27
2008-04-14 00:00:00.000,Valencia Spain ATP World Tour,CLAY,2,Juan Monaco,Werner Eschauer,Juan Monaco,6-7(5); 6-4; 6-4,R32,166,3,3,69,113,43,69,22,44,5,11,16,65,113,4,7,69,132,45,69,24,63,12,20,16,69,132
2008-04-14 00:00:00.000,Valencia Spain ATP World Tour,CLAY,2,David Ferrer,Pablo Andujar,David Ferrer,6-3; 6-4,R16,83,2,0,36,55,26,36,7,19,1,3,9,33,55,1,1,36,57,24,36,6,21,5,10,10,30,57
2008-04-14 00:00:00.000,Valencia Spain ATP World Tour,CLAY,2,Fernando Verdasco,Mischa Zverev,Fernando Verdasco,6-4; 6-2,R16,97,1,2,40,46,29,40,3,6,1,3,9,32,46,1,2,37,64,18,37,13,27,3,8,9,31,64
2008-04-14 00:00:00.000,Valencia Spain ATP World Tour,CLAY,2,Tommy Robredo,Santiago Ventura,Tommy Robredo,6-7(7); 6-3; 6-4,R16,157,2,2,73,103,57,73,18,30,1,1,16,75,103,0,3,74,110,50,74,20,36,6,8,15,70,110
2008-04-14 00:00:00.000,Valencia Spain ATP World Tour,CLAY,2,Potito Starace,Gael Monfils,Potito Starace,7-5; 6-1,R16,92,0,0,56,67,35,56,6,11,8,10,9,41,67,5,1,39,56,22,39,5,17,3,9,10,27,56
2008-04-14 00:00:00.000,Valencia Spain ATP World Tour,CLAY,2,Evgeny Korolev,Daniel Gimeno-Traver,Evgeny Korolev,6-7(8); 7-6(2); 6-3,R16,161,4,3,75,121,54,75,24,46,4,6,17,78,121,6,2,69,101,50,69,17,32,1,4,16,67,101
2008-04-14 00:00:00.000,Valencia Spain ATP World Tour,CLAY,2,Robin Haase,Marat Safin,Robin Haase,2-6; 7-6(9); 6-4,R16,147,2,3,59,98,39,59,22,39,2,6,15,61,98,5,4,68,121,50,68,25,53,8,11,15,75,121
2008-04-14 00:00:00.000,Valencia Spain ATP World Tour,CLAY,2,Nicolas Almagro,Eduardo Schwank,Nicolas Almagro,6-3; 6-4,R16,79,6,0,41,56,31,41,10,15,2,3,10,41,56,0,2,34,57,21,34,13,23,6,9,9,34,57
2008-04-14 00:00:00.000,Valencia Spain ATP World Tour,CLAY,2,Juan Monaco,Guillermo Garcia-Lopez,Juan Monaco,6-4; 6-4,R16,90,1,0,46,58,32,46,8,12,1,2,10,40,58,1,1,45,68,33,45,8,23,6,9,10,41,68
2008-04-14 00:00:00.000,Valencia Spain ATP World Tour,CLAY,2,David Ferrer,Fernando Verdasco,David Ferrer,6-3; 1-6; 7-5,Q,129,0,2,56,83,34,56,12,27,3,8,14,46,83,0,7,78,106,45,78,14,28,6,11,14,59,106
2008-04-14 00:00:00.000,Valencia Spain ATP World Tour,CLAY,2,Tommy Robredo,Potito Starace,Tommy Robredo,6-3; 3-0 RET,Q,63,1,0,38,47,28,38,5,9,4,4,6,33,47,0,0,30,39,16,30,4,9,4,7,6,20,39
2008-04-14 00:00:00.000,Valencia Spain ATP World Tour,CLAY,2,Evgeny Korolev,Robin Haase,Evgeny Korolev,7-5; 6-4,Q,113,6,2,60,89,36,60,13,29,8,12,11,49,89,6,0,54,80,28,54,10,26,6,12,11,38,80
2008-04-14 00:00:00.000,Valencia Spain ATP World Tour,CLAY,2,Nicolas Almagro,Juan Monaco,Nicolas Almagro,6-3; 6-2,Q,74,2,3,35,66,25,35,18,31,5,6,9,43,66,1,2,30,46,16,30,8,16,0,4,8,24,46
2008-04-14 00:00:00.000,Valencia Spain ATP World Tour,CLAY,2,David Ferrer,Tommy Robredo,David Ferrer,2-6; 6-2; 6-3,S,137,0,1,59,87,37,59,15,28,8,11,13,52,87,0,0,64,89,39,64,12,25,7,11,12,51,89
2008-04-14 00:00:00.000,Valencia Spain ATP World Tour,CLAY,2,Nicolas Almagro,Evgeny Korolev,Nicolas Almagro,6-1; 6-4,S,60,10,3,36,55,27,36,12,19,1,1,9,39,55,2,3,26,40,15,26,7,14,0,3,8,22,40
2008-04-14 00:00:00.000,Valencia Spain ATP World Tour,CLAY,2,David Ferrer,Nicolas Almagro,David Ferrer,4-6; 6-2; 7-6(2),F,125,0,4,59,92,43,59,16,33,2,5,15,59,92,11,6,58,90,41,58,13,32,0,4,15,54,90
2008-04-20 00:00:00.000,ATP Masters Series Monte Carlo Monaco ATP World Tour,CLAY,2,Roger Federer,N/A Bye,Roger Federer,,R64,0,0,0,0,0,0,0,0,0,0,0,0,0,0,0,0,0,0,0,0,0,0,0,0,0,0,0
2008-04-20 00:00:00.000,ATP Masters Series Monte Carlo Monaco ATP World Tour,CLAY,2,Ruben Ramirez Hidalgo,Gilles Simon,Ruben Ramirez Hidalgo,6-1; 6-1,R64,58,2,3,22,52,20,22,16,30,3,3,7,36,52,1,0,32,46,14,32,4,14,3,8,7,18,46
2008-04-20 00:00:00.000,ATP Masters Series Monte Carlo Monaco ATP World Tour,CLAY,2,Gael Monfils,Fernando Verdasco,Gael Monfils,7-5; 6-4,R64,79,6,2,31,57,26,31,17,26,0,1,11,43,57,1,3,49,66,31,49,10,17,7,10,11,41,66
2008-04-20 00:00:00.000,ATP Masters Series Monte Carlo Monaco ATP World Tour,CLAY,2,Ivo Karlovic,Sebastien Grosjean,Ivo Karlovic,4-6; 6-4; 4-1 RET,R64,108,7,5,50,87,42,50,16,37,6,7,13,58,87,0,0,53,71,36,53,11,18,5,7,12,47,71
2008-04-20 00:00:00.000,ATP Masters Series Monte Carlo Monaco ATP World Tour,CLAY,2,Tommy Robredo,Stanislas Wawrinka,Tommy Robredo,6-4; 7-5,R64,97,0,0,41,61,23,41,12,20,3,7,11,35,61,2,2,38,67,20,38,12,29,3,9,11,32,67
2008-04-20 00:00:00.000,ATP Masters Series Monte Carlo Monaco ATP World Tour,CLAY,2,Robin Soderling,Radek Stepanek,Robin Soderling,6-4; 6-7(6); 6-3,R64,139,10,6,53,95,40,53,22,42,0,2,15,62,95,7,3,62,112,37,62,28,50,7,12,16,65,112
2008-04-20 00:00:00.000,ATP Masters Series Monte Carlo Monaco ATP World Tour,CLAY,2,Olivier Rochus,Tommy Haas,Olivier Rochus,6-1; 3-0 RET,R64,49,0,0,26,35,19,26,5,9,4,4,5,24,35,3,2,17,32,9,17,3,15,2,6,5,12,32
2008-04-20 00:00:00.000,ATP Masters Series Monte Carlo Monaco ATP World Tour,CLAY,2,David Nalbandian,N/A Bye,David Nalbandian,,R64,0,0,0,0,0,0,0,0,0,0,0,0,0,0,0,0,0,0,0,0,0,0,0,0,0,0,0
2008-04-20 00:00:00.000,ATP Masters Series Monte Carlo Monaco ATP World Tour,CLAY,2,Novak Djokovic,N/A Bye,Novak Djokovic,,R64,0,0,0,0,0,0,0,0,0,0,0,0,0,0,0,0,0,0,0,0,0,0,0,0,0,0,0
2008-04-20 00:00:00.000,ATP Masters Series Monte Carlo Monaco ATP World Tour,CLAY,2,Ivan Ljubicic,Gustavo Kuerten,Ivan Ljubicic,6-1; 6-2,R64,52,7,0,19,40,15,19,17,21,0,0,8,32,40,1,3,28,52,19,28,7,24,4,8,7,26,52
2008-04-20 00:00:00.000,ATP Masters Series Monte Carlo Monaco ATP World Tour,CLAY,2,Filippo Volandri,Nicolas Mahut,Filippo Volandri,6-2; 6-3,R64,68,0,2,31,48,23,31,12,17,2,3,9,35,48,5,6,41,66,25,41,8,25,5,9,8,33,66
2008-04-20 00:00:00.000,ATP Masters Series Monte Carlo Monaco ATP World Tour,CLAY,2,Andy Murray,Feliciano Lopez,Andy Murray,7-6(5); 6-4,R64,94,2,1,44,68,34,44,14,24,2,3,11,48,68,2,2,44,70,30,44,15,26,1,3,11,45,70
2008-04-20 00:00:00.000,ATP Masters Series Monte Carlo Monaco ATP World Tour,CLAY,2,Sam Querrey,Carlos Moya,Sam Querrey,6-3; 1-6; 6-3,R64,98,4,3,42,86,32,42,22,44,2,4,13,54,86,2,1,38,68,27,38,19,30,4,6,12,46,68
2008-04-20 00:00:00.000,ATP Masters Series Monte Carlo Monaco ATP World Tour,CLAY,2,Andreas Seppi,Agustin Calleri,Andreas Seppi,6-4; 6-3,R64,85,4,3,39,57,27,39,7,18,3,5,9,34,57,4,5,40,78,28,40,11,38,9,14,10,39,78
2008-04-20 00:00:00.000,ATP Masters Series Monte Carlo Monaco ATP World Tour,CLAY,2,Kristof Vliegen,Fabrice Santoro,Kristof Vliegen,7-6(4); 6-1,R64,101,7,2,45,73,32,45,11,28,4,6,9,43,73,1,3,53,92,29,53,17,39,10,15,10,46,92
2008-04-20 00:00:00.000,ATP Masters Series Monte Carlo Monaco ATP World Tour,CLAY,2,Richard Gasquet,N/A Bye,Richard Gasquet,,R64,0,0,0,0,0,0,0,0,0,0,0,0,0,0,0,0,0,0,0,0,0,0,0,0,0,0,0
2008-04-20 00:00:00.000,ATP Masters Series Monte Carlo Monaco ATP World Tour,CLAY,2,Mikhail Youzhny,N/A Bye,Mikhail Youzhny,,R64,0,0,0,0,0,0,0,0,0,0,0,0,0,0,0,0,0,0,0,0,0,0,0,0,0,0,0
2008-04-20 00:00:00.000,ATP Masters Series Monte Carlo Monaco ATP World Tour,CLAY,2,Igor Andreev,Dmitry Tursunov,Igor Andreev,7-5; 6-3,R64,97,5,2,42,70,31,42,15,28,1,2,10,46,70,6,6,35,71,28,35,12,36,4,8,11,40,71
2008-04-20 00:00:00.000,ATP Masters Series Monte Carlo Monaco ATP World Tour,CLAY,2,Nicolas Almagro,Jean-Rene Lisnard,Nicolas Almagro,6-4; 6-4,R64,87,3,1,32,54,24,32,14,22,0,1,10,38,54,3,1,43,78,27,43,16,35,4,7,10,43,78
2008-04-20 00:00:00.000,ATP Masters Series Monte Carlo Monaco ATP World Tour,CLAY,2,Juan Monaco,Hyung-Taik Lee,Juan Monaco,6-0; 7-5,R64,75,2,0,42,55,25,42,9,13,4,6,9,34,55,1,5,33,61,17,33,10,28,3,9,9,27,61
2008-04-20 00:00:00.000,ATP Masters Series Monte Carlo Monaco ATP World Tour,CLAY,2,Philipp Kohlschreiber,Jose Acasuso,Philipp Kohlschreiber,7-6(4); 6-3,R64,104,1,2,50,73,33,50,8,23,5,9,11,41,73,3,3,46,86,29,46,15,40,10,15,10,44,86
2008-04-20 00:00:00.000,ATP Masters Series Monte Carlo Monaco ATP World Tour,CLAY,2,Nicolas Kiefer,Marin Cilic,Nicolas Kiefer,3-6; 7-6(4); 6-3,R64,163,1,3,51,99,35,51,24,48,3,6,14,59,99,4,4,63,116,38,63,28,53,6,10,16,66,116
2008-04-20 00:00:00.000,ATP Masters Series Monte Carlo Monaco ATP World Tour,CLAY,2,Simone Bolelli,Juan Ignacio Chela,Simone Bolelli,6-2; 6-2,R64,75,1,0,31,50,22,31,14,19,1,1,8,36,50,0,6,22,50,14,22,12,28,3,7,8,26,50
2008-04-20 00:00:00.000,ATP Masters Series Monte Carlo Monaco ATP World Tour,CLAY,2,Nikolay Davydenko,N/A Bye,Nikolay Davydenko,,R64,0,0,0,0,0,0,0,0,0,0,0,0,0,0,0,0,0,0,0,0,0,0,0,0,0,0,0
2008-04-20 00:00:00.000,ATP Masters Series Monte Carlo Monaco ATP World Tour,CLAY,2,David Ferrer,N/A Bye,David Ferrer,,R64,0,0,0,0,0,0,0,0,0,0,0,0,0,0,0,0,0,0,0,0,0,0,0,0,0,0,0
2008-04-20 00:00:00.000,ATP Masters Series Monte Carlo Monaco ATP World Tour,CLAY,2,Marat Safin,Xavier Malisse,Marat Safin,6-3; 6-2,R64,79,7,0,28,53,20,28,15,25,3,4,9,35,53,2,1,29,47,19,29,6,18,0,4,8,25,47
2008-04-20 00:00:00.000,ATP Masters Series Monte Carlo Monaco ATP World Tour,CLAY,2,Nicolas Lapentti,Potito Starace,Nicolas Lapentti,7-6(3); 6-7(2); 6-4,R64,200,3,3,85,121,51,85,21,36,8,12,17,72,121,4,3,91,134,58,91,19,43,9,14,17,77,134
2008-04-20 00:00:00.000,ATP Masters Series Monte Carlo Monaco ATP World Tour,CLAY,2,Janko Tipsarevic,Paul-Henri Mathieu,Janko Tipsarevic,6-4; 2-6; 6-3,R64,138,4,5,40,79,30,40,21,39,0,2,13,51,79,5,6,54,90,40,54,17,36,5,8,14,57,90
2008-04-20 00:00:00.000,ATP Masters Series Monte Carlo Monaco ATP World Tour,CLAY,2,Juan Carlos Ferrero,Michael Llodra,Juan Carlos Ferrero,6-7(5); 6-1; 6-1,R64,122,1,1,64,85,46,64,13,21,7,9,13,59,85,6,8,52,111,31,52,25,59,5,12,13,56,111
2008-04-20 00:00:00.000,ATP Masters Series Monte Carlo Monaco ATP World Tour,CLAY,2,Jarkko Nieminen,Marc Gicquel,Jarkko Nieminen,6-0; 6-4,R64,81,0,1,28,38,23,28,5,10,3,5,8,28,38,3,2,22,45,10,22,6,23,4,10,8,16,45
2008-04-20 00:00:00.000,ATP Masters Series Monte Carlo Monaco ATP World Tour,CLAY,2,Mario Ancic,Ivo Minar,Mario Ancic,6-3; 6-4,R64,77,2,3,30,53,22,30,14,23,1,2,9,36,53,3,0,38,66,23,38,14,28,3,7,10,37,66
2008-04-20 00:00:00.000,ATP Masters Series Monte Carlo Monaco ATP World Tour,CLAY,2,Rafael Nadal,N/A Bye,Rafael Nadal,,R64,0,0,0,0,0,0,0,0,0,0,0,0,0,0,0,0,0,0,0,0,0,0,0,0,0,0,0
2008-04-20 00:00:00.000,ATP Masters Series Monte Carlo Monaco ATP World Tour,CLAY,2,Roger Federer,Ruben Ramirez Hidalgo,Roger Federer,6-1; 3-6; 7-6(1),R32,124,5,3,57,92,39,57,19,35,4,7,14,58,92,2,8,55,101,36,55,20,46,3,7,14,56,101
2008-04-20 00:00:00.000,ATP Masters Series Monte Carlo Monaco ATP World Tour,CLAY,2,Gael Monfils,Ivo Karlovic,Gael Monfils,7-6(8); 6-1,R32,87,5,2,42,58,34,42,9,16,0,1,10,43,58,0,3,44,73,28,44,10,29,3,6,9,38,73
2008-04-20 00:00:00.000,ATP Masters Series Monte Carlo Monaco ATP World Tour,CLAY,2,Tommy Robredo,Robin Soderling,Tommy Robredo,6-4; 7-6(3),R32,118,0,1,79,99,49,79,8,20,13,16,11,57,99,5,5,49,86,32,49,14,37,10,14,11,46,86
2008-04-20 00:00:00.000,ATP Masters Series Monte Carlo Monaco ATP World Tour,CLAY,2,David Nalbandian,Olivier Rochus,David Nalbandian,6-4; 6-3,R32,88,3,2,43,61,28,43,13,18,5,6,10,41,61,1,2,46,65,28,46,9,19,8,11,9,37,65
2008-04-20 00:00:00.000,ATP Masters Series Monte Carlo Monaco ATP World Tour,CLAY,2,Novak Djokovic,Ivan Ljubicic,Novak Djokovic,6-3; 6-3,R32,82,3,0,40,63,26,40,14,23,7,8,9,40,63,2,4,29,52,19,29,8,23,1,5,9,27,52
2008-04-20 00:00:00.000,ATP Masters Series Monte Carlo Monaco ATP World Tour,CLAY,2,Andy Murray,Filippo Volandri,Andy Murray,6-4; 6-1,R32,85,5,0,40,72,23,40,21,32,8,9,9,44,72,0,0,28,49,15,28,7,21,4,8,8,22,49
2008-04-20 00:00:00.000,ATP Masters Series Monte Carlo Monaco ATP World Tour,CLAY,2,Sam Querrey,Andreas Seppi,Sam Querrey,6-1; 7-5,R32,80,7,0,36,61,23,36,18,25,3,4,10,41,61,0,0,32,60,18,32,15,28,7,11,9,33,60
2008-04-20 00:00:00.000,ATP Masters Series Monte Carlo Monaco ATP World Tour,CLAY,2,Richard Gasquet,Kristof Vliegen,Richard Gasquet,6-1; 6-2,R32,62,1,2,18,40,15,18,17,22,0,0,8,32,40,4,1,49,68,28,49,5,19,9,13,7,33,68
2008-04-20 00:00:00.000,ATP Masters Series Monte Carlo Monaco ATP World Tour,CLAY,2,Igor Andreev,Mikhail Youzhny,Igor Andreev,6-3 RET,R32,36,2,1,23,31,17,23,3,8,0,1,5,20,31,0,0,25,28,13,25,1,3,0,2,4,14,28
2008-04-20 00:00:00.000,ATP Masters Series Monte Carlo Monaco ATP World Tour,CLAY,2,Nicolas Almagro,Juan Monaco,Nicolas Almagro,6-2; 3-0 RET,R32,51,3,1,14,37,11,14,14,23,3,4,6,25,37,0,3,16,29,6,16,4,13,3,7,5,10,29
2008-04-20 00:00:00.000,ATP Masters Series Monte Carlo Monaco ATP World Tour,CLAY,2,Philipp Kohlschreiber,Nicolas Kiefer,Philipp Kohlschreiber,6-2; 6-4,R32,87,3,0,32,49,24,32,11,17,1,2,9,35,49,7,4,30,68,15,30,21,38,6,10,9,36,68
2008-04-20 00:00:00.000,ATP Masters Series Monte Carlo Monaco ATP World Tour,CLAY,2,Nikolay Davydenko,Simone Bolelli,Nikolay Davydenko,6-2; 7-6(5),R32,118,1,3,45,67,31,45,9,22,2,5,10,40,67,0,2,58,86,34,58,11,28,11,16,10,45,86
2008-04-20 00:00:00.000,ATP Masters Series Monte Carlo Monaco ATP World Tour,CLAY,2,David Ferrer,Marat Safin,David Ferrer,6-2; 6-3,R32,77,1,0,33,49,26,33,11,16,0,1,9,37,49,5,4,28,60,18,28,12,32,5,9,8,30,60
2008-04-20 00:00:00.000,ATP Masters Series Monte Carlo Monaco ATP World Tour,CLAY,2,Janko Tipsarevic,Nicolas Lapentti,Janko Tipsarevic,5-7; 7-6(5); 6-4,R32,184,7,5,62,123,52,62,27,61,3,5,17,79,123,4,0,62,92,51,62,16,30,2,4,17,67,92
2008-04-20 00:00:00.000,ATP Masters Series Monte Carlo Monaco ATP World Tour,CLAY,2,Juan Carlos Ferrero,Jarkko Nieminen,Juan Carlos Ferrero,6-3; 6-3,R32,87,5,2,46,69,35,46,9,23,5,6,9,44,69,2,1,49,69,24,49,11,20,10,14,9,35,69
2008-04-20 00:00:00.000,ATP Masters Series Monte Carlo Monaco ATP World Tour,CLAY,2,Rafael Nadal,Mario Ancic,Rafael Nadal,6-0; 6-3,R32,76,1,0,35,40,25,35,4,5,0,1,8,29,40,3,5,27,53,13,27,9,26,3,8,7,22,53
2008-04-20 00:00:00.000,ATP Masters Series Monte Carlo Monaco ATP World Tour,CLAY,2,Roger Federer,Gael Monfils,Roger Federer,6-3; 6-4,R16,71,0,0,36,57,22,36,17,21,0,1,10,39,57,7,4,33,55,21,33,12,22,5,8,9,33,55
2008-04-20 00:00:00.000,ATP Masters Series Monte Carlo Monaco ATP World Tour,CLAY,2,David Nalbandian,Tommy Robredo,David Nalbandian,6-1; 6-0,R16,60,1,3,26,41,24,26,7,15,3,3,7,31,41,0,3,29,45,14,29,5,16,2,7,6,19,45
2008-04-20 00:00:00.000,ATP Masters Series Monte Carlo Monaco ATP World Tour,CLAY,2,Novak Djokovic,Andy Murray,Novak Djokovic,6-0; 6-4,R16,78,0,0,20,45,14,20,17,25,4,5,8,31,45,3,5,25,60,14,25,14,35,5,10,8,28,60
2008-04-20 00:00:00.000,ATP Masters Series Monte Carlo Monaco ATP World Tour,CLAY,2,Sam Querrey,Richard Gasquet,Sam Querrey,2-6; 6-4; 6-3,R16,95,11,3,54,85,44,54,14,31,8,10,14,58,85,7,2,42,75,31,42,20,33,2,4,13,51,75
2008-04-20 00:00:00.000,ATP Masters Series Monte Carlo Monaco ATP World Tour,CLAY,2,Igor Andreev,Nicolas Almagro,Igor Andreev,7-5; 4-6; 6-4,R16,148,7,1,62,90,42,62,19,28,2,5,16,61,90,3,2,63,115,41,63,26,52,8,12,16,67,115
2008-04-20 00:00:00.000,ATP Masters Series Monte Carlo Monaco ATP World Tour,CLAY,2,Nikolay Davydenko,Philipp Kohlschreiber,Nikolay Davydenko,3-6; 7-5; 6-2,R16,131,6,2,51,84,31,51,17,33,3,9,15,48,84,1,1,62,89,34,62,10,27,5,12,14,44,89
2008-04-20 00:00:00.000,ATP Masters Series Monte Carlo Monaco ATP World Tour,CLAY,2,David Ferrer,Janko Tipsarevic,David Ferrer,6-4; 6-0,R16,67,1,0,33,47,23,33,7,14,1,3,8,30,47,1,3,14,48,7,14,13,34,2,8,8,20,48
2008-04-20 00:00:00.000,ATP Masters Series Monte Carlo Monaco ATP World Tour,CLAY,2,Rafael Nadal,Juan Carlos Ferrero,Rafael Nadal,6-4; 6-1,R16,106,3,0,34,51,23,34,9,17,0,2,9,32,51,1,0,36,67,19,36,14,31,10,15,8,33,67
2008-04-20 00:00:00.000,ATP Masters Series Monte Carlo Monaco ATP World Tour,CLAY,2,Roger Federer,David Nalbandian,Roger Federer,5-7; 6-2; 6-2,Q,128,9,2,46,88,34,46,24,42,3,5,14,58,88,2,5,54,93,35,54,15,39,0,5,14,50,93
2008-04-20 00:00:00.000,ATP Masters Series Monte Carlo Monaco ATP World Tour,CLAY,2,Novak Djokovic,Sam Querrey,Novak Djokovic,6-4; 6-0,Q,60,5,1,33,41,29,33,4,8,0,0,8,33,41,1,2,31,57,16,31,12,26,6,10,8,28,57
2008-04-20 00:00:00.000,ATP Masters Series Monte Carlo Monaco ATP World Tour,CLAY,2,Nikolay Davydenko,Igor Andreev,Nikolay Davydenko,6-3; 4-6; 7-5,Q,164,1,1,65,106,36,65,19,41,13,20,15,55,106,0,5,73,113,39,73,16,40,9,18,16,55,113
2008-04-20 00:00:00.000,ATP Masters Series Monte Carlo Monaco ATP World Tour,CLAY,2,Rafael Nadal,David Ferrer,Rafael Nadal,6-1; 7-5,Q,100,0,1,38,52,26,38,7,14,2,4,9,33,52,0,2,48,71,25,48,8,23,2,8,10,33,71
2008-04-20 00:00:00.000,ATP Masters Series Monte Carlo Monaco ATP World Tour,CLAY,2,Roger Federer,Novak Djokovic,Roger Federer,6-3; 3-2 RET,S,72,1,0,22,42,18,22,10,20,3,4,7,28,42,2,3,37,62,22,37,10,25,2,5,7,32,62
2008-04-20 00:00:00.000,ATP Masters Series Monte Carlo Monaco ATP World Tour,CLAY,2,Rafael Nadal,Nikolay Davydenko,Rafael Nadal,6-3; 6-2,S,101,0,1,37,54,22,37,12,17,4,5,8,34,54,0,5,37,60,20,37,7,23,2,7,9,27,60
2008-04-20 00:00:00.000,ATP Masters Series Monte Carlo Monaco ATP World Tour,CLAY,2,Rafael Nadal,Roger Federer,Rafael Nadal,7-5; 7-5,F,103,1,2,51,63,32,51,5,12,1,5,12,37,63,5,0,47,75,28,47,8,28,1,7,12,36,75
2008-04-28 00:00:00.000,Barcelona Spain ATP World Tour,CLAY,2,Rafael Nadal,N/A Bye,Rafael Nadal,,R64,0,0,0,0,0,0,0,0,0,0,0,0,0,0,0,0,0,0,0,0,0,0,0,0,0,0,0
2008-04-28 00:00:00.000,Barcelona Spain ATP World Tour,CLAY,2,Potito Starace,Peter Luczak,Potito Starace,7-6(4); 6-1,R64,90,3,0,43,57,34,43,11,14,0,0,10,45,57,3,1,40,62,28,40,11,22,2,4,9,39,62
2008-04-28 00:00:00.000,Barcelona Spain ATP World Tour,CLAY,2,Alberto Martin,Matteo Marrai,Alberto Martin,6-3; 6-3,R64,70,4,2,27,51,17,27,14,24,1,3,9,31,51,3,0,36,57,20,36,8,21,8,13,9,28,57
2008-04-28 00:00:00.000,Barcelona Spain ATP World Tour,CLAY,2,Feliciano Lopez,Jose Acasuso,Feliciano Lopez,5-2 RET,R64,36,2,0,5,14,5,5,7,9,0,0,3,12,14,1,2,10,25,6,10,7,15,1,3,4,13,25
2008-04-28 00:00:00.000,Barcelona Spain ATP World Tour,CLAY,2,Juan Ignacio Chela,Guillermo Garcia-Lopez,Juan Ignacio Chela,6-7(2); 6-4; 6-2,R64,173,0,7,76,111,43,76,12,35,9,16,15,55,111,0,6,68,105,37,68,11,37,10,20,15,48,105
2008-04-28 00:00:00.000,Barcelona Spain ATP World Tour,CLAY,2,Marc Lopez,Ivo Minar,Marc Lopez,3-1 RET,R64,24,1,0,8,12,8,8,1,4,1,1,2,9,12,0,1,7,15,4,7,3,8,0,1,2,7,15
2008-04-28 00:00:00.000,Barcelona Spain ATP World Tour,CLAY,2,Ernests Gulbis,Janko Tipsarevic,Ernests Gulbis,6-4; 4-2 RET,R64,65,6,2,30,47,23,30,8,17,3,5,8,31,47,2,0,30,46,16,30,7,16,4,8,8,23,46
2008-04-28 00:00:00.000,Barcelona Spain ATP World Tour,CLAY,2,Carlos Moya,N/A Bye,Carlos Moya,,R64,0,0,0,0,0,0,0,0,0,0,0,0,0,0,0,0,0,0,0,0,0,0,0,0,0,0,0
2008-04-28 00:00:00.000,Barcelona Spain ATP World Tour,CLAY,2,James Blake,N/A Bye,James Blake,,R64,0,0,0,0,0,0,0,0,0,0,0,0,0,0,0,0,0,0,0,0,0,0,0,0,0,0,0
2008-04-28 00:00:00.000,Barcelona Spain ATP World Tour,CLAY,2,Denis Gremelmayr,Ruben Ramirez Hidalgo,Denis Gremelmayr,7-6(7); 2-1 RET,R64,93,4,2,39,59,28,39,10,20,2,3,7,38,59,0,0,32,57,24,32,10,25,1,3,8,34,57
2008-04-28 00:00:00.000,Barcelona Spain ATP World Tour,CLAY,2,Marcos Daniel,Ivan Navarro,Marcos Daniel,6-1; 6-4,R64,69,4,0,28,46,24,28,12,18,0,0,9,36,46,1,3,30,47,21,30,6,17,2,5,8,27,47
2008-04-28 00:00:00.000,Barcelona Spain ATP World Tour,CLAY,2,Dmitry Tursunov,Kevin Anderson,Dmitry Tursunov,6-4; 6-3,R64,81,9,0,33,53,27,33,14,20,0,0,10,41,53,10,2,52,78,33,52,13,26,8,10,9,46,78
2008-04-28 00:00:00.000,Barcelona Spain ATP World Tour,CLAY,2,Nicolas Almagro,Viktor Troicki,Nicolas Almagro,6-2 RET,R64,27,2,0,14,20,13,14,3,6,0,0,4,16,20,0,1,13,18,8,13,1,5,0,2,4,9,18
2008-04-28 00:00:00.000,Barcelona Spain ATP World Tour,CLAY,2,Filippo Volandri,Jurgen Melzer,Filippo Volandri,6-2; 6-4,R64,67,0,3,51,64,32,51,5,13,6,9,9,37,64,0,2,29,49,13,29,7,20,2,8,9,20,49
2008-04-28 00:00:00.000,Barcelona Spain ATP World Tour,CLAY,2,Mario Ancic,Mischa Zverev,Mario Ancic,6-1; 6-0,R64,42,6,1,20,28,19,20,5,8,0,0,6,24,28,0,1,28,40,12,28,0,12,1,7,7,12,40
2008-04-28 00:00:00.000,Barcelona Spain ATP World Tour,CLAY,2,Andy Murray,N/A Bye,Andy Murray,,R64,0,0,0,0,0,0,0,0,0,0,0,0,0,0,0,0,0,0,0,0,0,0,0,0,0,0,0
2008-04-28 00:00:00.000,Barcelona Spain ATP World Tour,CLAY,2,Ivo Karlovic,N/A Bye,Ivo Karlovic,,R64,0,0,0,0,0,0,0,0,0,0,0,0,0,0,0,0,0,0,0,0,0,0,0,0,0,0,0
2008-04-28 00:00:00.000,Barcelona Spain ATP World Tour,CLAY,2,Albert Montanes,Marcel Granollers,Albert Montanes,3-6; 6-3; 6-2,R64,112,2,8,47,93,31,47,21,46,8,13,13,52,93,4,14,42,87,23,42,20,45,8,15,13,43,87
2008-04-28 00:00:00.000,Barcelona Spain ATP World Tour,CLAY,2,Pablo Cuevas,Juan Pablo Brzezicki,Pablo Cuevas,6-3; 7-6(3),R64,82,9,1,48,72,34,48,15,24,3,5,11,49,72,2,4,41,67,25,41,12,26,3,6,10,37,67
2008-04-28 00:00:00.000,Barcelona Spain ATP World Tour,CLAY,2,Mikhail Kukushkin,Jarkko Nieminen,Mikhail Kukushkin,6-4; 6-4,R64,86,2,1,40,58,27,40,11,18,3,5,10,38,58,4,2,49,84,28,49,17,35,9,13,10,45,84
2008-04-28 00:00:00.000,Barcelona Spain ATP World Tour,CLAY,2,Stanislas Wawrinka,Jose Antonio Sanchez-de Luna,Stanislas Wawrinka,6-3; 6-3,R64,81,1,1,26,51,18,26,15,25,3,5,9,33,51,0,2,42,61,24,42,6,19,5,10,9,30,61
2008-04-28 00:00:00.000,Barcelona Spain ATP World Tour,CLAY,2,Yuri Schukin,Robby Ginepri,Yuri Schukin,6-4; 6-2,R64,83,3,4,50,74,32,50,14,24,8,9,9,46,74,2,1,35,46,23,35,4,11,2,6,9,27,46
2008-04-28 00:00:00.000,Barcelona Spain ATP World Tour,CLAY,2,Agustin Calleri,Thomas Johansson,Agustin Calleri,6-1; 6-3,R64,62,6,0,24,46,19,24,15,22,2,2,8,34,46,4,2,40,61,22,40,8,21,8,12,8,30,61
2008-04-28 00:00:00.000,Barcelona Spain ATP World Tour,CLAY,2,David Nalbandian,N/A Bye,David Nalbandian,,R64,0,0,0,0,0,0,0,0,0,0,0,0,0,0,0,0,0,0,0,0,0,0,0,0,0,0,0
2008-04-28 00:00:00.000,Barcelona Spain ATP World Tour,CLAY,2,Tommy Robredo,N/A Bye,Tommy Robredo,,R64,0,0,0,0,0,0,0,0,0,0,0,0,0,0,0,0,0,0,0,0,0,0,0,0,0,0,0
2008-04-28 00:00:00.000,Barcelona Spain ATP World Tour,CLAY,2,Robin Haase,Max Mirnyi,Robin Haase,6-2; 6-2,R64,54,3,0,28,44,21,28,12,16,2,2,8,33,44,0,0,34,44,19,34,3,10,1,5,8,22,44
2008-04-28 00:00:00.000,Barcelona Spain ATP World Tour,CLAY,2,Teymuraz Gabashvili,Guillermo Coria,Teymuraz Gabashvili,5-7; 6-4; 6-4,R64,135,5,3,59,99,39,59,20,40,5,10,16,59,99,2,9,83,113,50,83,12,30,13,19,16,62,113
2008-04-28 00:00:00.000,Barcelona Spain ATP World Tour,CLAY,2,Guillermo Canas,Oscar Hernandez,Guillermo Canas,6-1; 6-4,R64,93,4,1,24,56,18,24,19,32,2,3,9,37,56,0,2,36,51,21,36,4,15,3,7,8,25,51
2008-04-28 00:00:00.000,Barcelona Spain ATP World Tour,CLAY,2,Nicolas Lapentti,Fernando Verdasco,Nicolas Lapentti,6-3; 6-4,R64,111,5,2,51,78,35,51,13,27,7,8,10,48,78,0,1,45,58,24,45,8,13,4,7,9,32,58
2008-04-28 00:00:00.000,Barcelona Spain ATP World Tour,CLAY,2,Daniel Gimeno-Traver,Santiago Ventura,Daniel Gimeno-Traver,6-2; 6-1,R64,61,5,0,30,37,24,30,5,7,1,1,7,29,37,0,2,49,65,22,49,7,16,6,11,8,29,65
2008-04-28 00:00:00.000,Barcelona Spain ATP World Tour,CLAY,2,Gabriel Trujillo-Soler,Werner Eschauer,Gabriel Trujillo-Soler,6-4; 4-6; 6-2,R64,100,7,1,57,79,41,57,16,22,5,6,14,57,79,2,4,44,79,31,44,20,35,2,5,14,51,79
2008-04-28 00:00:00.000,Barcelona Spain ATP World Tour,CLAY,2,David Ferrer,N/A Bye,David Ferrer,,R64,0,0,0,0,0,0,0,0,0,0,0,0,0,0,0,0,0,0,0,0,0,0,0,0,0,0,0
2008-04-28 00:00:00.000,Barcelona Spain ATP World Tour,CLAY,2,Rafael Nadal,Potito Starace,Rafael Nadal,6-4; 6-2,R32,78,2,1,35,48,26,35,11,13,2,3,9,37,48,2,1,44,55,22,44,7,11,4,8,9,29,55
2008-04-28 00:00:00.000,Barcelona Spain ATP World Tour,CLAY,2,Feliciano Lopez,Alberto Martin,Feliciano Lopez,3-6; 6-2; 6-4,R32,120,12,3,55,94,41,55,17,39,9,12,14,58,94,3,2,43,87,30,43,22,44,2,6,13,52,87
2008-04-28 00:00:00.000,Barcelona Spain ATP World Tour,CLAY,2,Juan Ignacio Chela,Marc Lopez,Juan Ignacio Chela,5-1 RET,R32,37,0,1,11,21,8,11,6,10,1,1,3,14,21,0,0,15,21,7,15,2,6,2,4,3,9,21
2008-04-28 00:00:00.000,Barcelona Spain ATP World Tour,CLAY,2,Ernests Gulbis,Carlos Moya,Ernests Gulbis,4-6; 6-1; 6-4,R32,106,6,2,48,87,39,48,20,39,5,6,14,59,87,2,1,52,77,36,52,15,25,4,7,13,51,77
2008-04-28 00:00:00.000,Barcelona Spain ATP World Tour,CLAY,2,Denis Gremelmayr,James Blake,Denis Gremelmayr,6-1; 6-4,R32,68,5,1,27,52,20,27,18,25,1,1,9,38,52,1,3,19,50,13,19,14,31,1,4,8,27,50
2008-04-28 00:00:00.000,Barcelona Spain ATP World Tour,CLAY,2,Dmitry Tursunov,Marcos Daniel,Dmitry Tursunov,6-4; 6-3,R32,75,4,0,39,58,33,39,10,19,3,3,9,43,58,2,1,31,58,21,31,14,27,4,7,10,35,58
2008-04-28 00:00:00.000,Barcelona Spain ATP World Tour,CLAY,2,Nicolas Almagro,Filippo Volandri,Nicolas Almagro,6-4; 7-6(5),R32,91,16,1,39,65,32,39,10,26,0,2,11,42,65,1,2,51,66,32,51,7,15,1,4,11,39,66
2008-04-28 00:00:00.000,Barcelona Spain ATP World Tour,CLAY,2,Mario Ancic,Andy Murray,Mario Ancic,6-4; 6-4,R32,101,3,1,48,77,34,48,15,29,5,6,10,49,77,2,4,46,66,30,46,7,20,3,6,10,37,66
2008-04-28 00:00:00.000,Barcelona Spain ATP World Tour,CLAY,2,Albert Montanes,Ivo Karlovic,Albert Montanes,6-7(7); 6-3; 7-5,R32,134,6,2,86,118,68,86,17,32,8,8,17,85,118,17,0,55,96,46,55,23,41,7,9,16,69,96
2008-04-28 00:00:00.000,Barcelona Spain ATP World Tour,CLAY,2,Mikhail Kukushkin,Pablo Cuevas,Mikhail Kukushkin,6-0; 6-4,R32,63,2,1,33,51,23,33,13,18,2,2,8,36,51,0,1,26,49,12,26,13,23,2,6,8,25,49
2008-04-28 00:00:00.000,Barcelona Spain ATP World Tour,CLAY,2,Stanislas Wawrinka,Yuri Schukin,Stanislas Wawrinka,6-3; 6-4,R32,85,5,2,37,58,31,37,10,21,2,2,10,41,58,0,1,40,65,26,40,10,25,2,4,9,36,65
2008-04-28 00:00:00.000,Barcelona Spain ATP World Tour,CLAY,2,David Nalbandian,Agustin Calleri,David Nalbandian,1-6; 7-6(2); 6-3,R32,119,2,4,50,77,31,50,13,27,1,5,13,44,77,11,8,47,101,37,47,21,54,2,6,15,58,101
2008-04-28 00:00:00.000,Barcelona Spain ATP World Tour,CLAY,2,Tommy Robredo,Robin Haase,Tommy Robredo,6-2; 6-4,R32,73,1,0,38,45,29,38,5,7,2,3,9,34,45,1,1,46,66,28,46,7,20,7,11,9,35,66
2008-04-28 00:00:00.000,Barcelona Spain ATP World Tour,CLAY,2,Guillermo Canas,Teymuraz Gabashvili,Guillermo Canas,6-1; 6-2,R32,79,5,1,22,43,17,22,13,21,0,0,7,30,43,1,6,36,60,17,36,9,24,7,12,8,26,60
2008-04-28 00:00:00.000,Barcelona Spain ATP World Tour,CLAY,2,Nicolas Lapentti,Daniel Gimeno-Traver,Nicolas Lapentti,6-3; 6-7(5); 7-5,R32,173,0,2,59,98,34,59,21,39,4,9,16,55,98,2,1,76,124,38,76,23,48,9,17,17,61,124
2008-04-28 00:00:00.000,Barcelona Spain ATP World Tour,CLAY,2,David Ferrer,Gabriel Trujillo-Soler,David Ferrer,6-1; 6-1,R32,50,1,1,24,39,19,24,10,15,1,1,7,29,39,1,2,21,40,10,21,6,19,2,7,7,16,40
2008-04-28 00:00:00.000,Barcelona Spain ATP World Tour,CLAY,2,Rafael Nadal,Feliciano Lopez,Rafael Nadal,6-4; 6-3,R16,106,3,1,33,50,26,33,12,17,0,0,9,38,50,4,1,56,86,34,56,14,30,6,9,10,48,86
2008-04-28 00:00:00.000,Barcelona Spain ATP World Tour,CLAY,2,Juan Ignacio Chela,Ernests Gulbis,Juan Ignacio Chela,2-6; 6-4; 6-3,R16,106,2,4,43,75,29,43,20,32,3,5,13,49,75,7,2,45,81,31,45,22,36,5,8,14,53,81
2008-04-28 00:00:00.000,Barcelona Spain ATP World Tour,CLAY,2,Denis Gremelmayr,Dmitry Tursunov,Denis Gremelmayr,6-4; 6-0,R16,63,6,0,33,50,24,33,9,17,4,5,8,33,50,3,3,23,45,14,23,6,22,0,5,8,20,45
2008-04-28 00:00:00.000,Barcelona Spain ATP World Tour,CLAY,2,Nicolas Almagro,Mario Ancic,Nicolas Almagro,7-6(5); 6-2,R16,97,5,0,37,64,32,37,17,27,2,2,10,49,64,5,1,47,73,32,47,16,26,4,6,10,48,73
2008-04-28 00:00:00.000,Barcelona Spain ATP World Tour,CLAY,2,Albert Montanes,Mikhail Kukushkin,Albert Montanes,6-3; 3-6; 6-3,R16,114,1,1,48,77,38,48,12,29,1,4,14,50,77,3,0,42,80,26,42,20,38,6,10,13,46,80
2008-04-28 00:00:00.000,Barcelona Spain ATP World Tour,CLAY,2,Stanislas Wawrinka,David Nalbandian,Stanislas Wawrinka,6-3; 6-1,R16,85,1,1,32,59,20,32,19,27,9,10,8,39,59,0,2,32,59,14,32,12,27,5,10,8,26,59
2008-04-28 00:00:00.000,Barcelona Spain ATP World Tour,CLAY,2,Tommy Robredo,Guillermo Canas,Tommy Robredo,6-1; 7-5,R16,79,3,0,45,52,34,45,3,7,1,2,10,37,52,1,1,20,48,13,20,13,28,1,5,9,26,48
2008-04-28 00:00:00.000,Barcelona Spain ATP World Tour,CLAY,2,David Ferrer,Nicolas Lapentti,David Ferrer,4-6; 6-4; 6-3,R16,151,2,2,56,98,39,56,24,42,7,9,15,63,98,3,3,52,87,39,52,14,35,2,5,14,53,87
2008-04-28 00:00:00.000,Barcelona Spain ATP World Tour,CLAY,2,Rafael Nadal,Juan Ignacio Chela,Rafael Nadal,6-4; 6-2,Q,102,0,0,34,51,27,34,6,17,0,1,9,33,51,0,2,44,70,23,44,15,26,7,11,9,38,70
2008-04-28 00:00:00.000,Barcelona Spain ATP World Tour,CLAY,2,Denis Gremelmayr,Nicolas Almagro,Denis Gremelmayr,6-2; 3-6; 7-6(7),Q,129,3,5,60,105,38,60,24,45,5,8,14,62,105,11,0,48,83,39,48,18,35,3,7,15,57,83
2008-04-28 00:00:00.000,Barcelona Spain ATP World Tour,CLAY,2,Stanislas Wawrinka,Albert Montanes,Stanislas Wawrinka,6-3; 6-7(6); 6-4,Q,166,2,4,64,118,42,64,30,54,4,6,16,72,118,1,6,51,92,38,51,20,41,4,8,15,58,92
2008-04-28 00:00:00.000,Barcelona Spain ATP World Tour,CLAY,2,David Ferrer,Tommy Robredo,David Ferrer,7-6(4); 6-4,Q,126,1,0,48,78,32,48,15,30,5,8,11,47,78,2,2,50,88,31,50,17,38,9,13,11,48,88
2008-04-28 00:00:00.000,Barcelona Spain ATP World Tour,CLAY,2,Rafael Nadal,Denis Gremelmayr,Rafael Nadal,6-1; 6-0,S,51,3,0,23,33,20,23,8,10,0,0,7,28,33,0,1,18,32,9,18,1,14,2,7,6,10,32
2008-04-28 00:00:00.000,Barcelona Spain ATP World Tour,CLAY,2,David Ferrer,Stanislas Wawrinka,David Ferrer,7-6(8); 6-3,S,114,2,1,47,72,32,47,18,25,1,2,10,50,72,3,2,47,84,30,47,20,37,5,8,11,50,84
2008-04-28 00:00:00.000,Barcelona Spain ATP World Tour,CLAY,2,Rafael Nadal,David Ferrer,Rafael Nadal,6-1; 4-6; 6-1,F,134,3,3,51,74,32,51,16,23,5,7,12,48,74,2,1,61,87,34,61,10,26,4,10,12,44,87
2008-04-28 00:00:00.000,Munich Germany ATP World Tour,CLAY,2,Paul-Henri Mathieu,Daniel Brands,Paul-Henri Mathieu,6-3; 6-3,R32,72,4,1,35,61,29,35,14,26,2,2,9,43,61,5,3,26,44,20,26,5,18,0,3,9,25,44
2008-04-28 00:00:00.000,Munich Germany ATP World Tour,CLAY,2,Gianluca Naso,Rainer Schuettler,Gianluca Naso,6-7(2); 6-3; 6-4,R32,154,6,4,65,134,45,65,38,69,9,10,16,83,134,6,6,64,111,49,64,25,47,5,8,15,74,111
2008-04-28 00:00:00.000,Munich Germany ATP World Tour,CLAY,2,Philipp Petzschner,Evgeny Korolev,Philipp Petzschner,6-4; 0-6; 6-2,R32,102,1,4,45,67,28,45,12,22,4,8,12,40,67,3,6,43,85,30,43,18,42,5,9,12,48,85
2008-04-28 00:00:00.000,Munich Germany ATP World Tour,CLAY,2,Marin Cilic,Olivier Rochus,Marin Cilic,6-4; 6-4,R32,84,10,0,32,57,26,32,15,25,1,2,10,41,57,1,6,38,62,24,38,11,24,6,9,10,35,62
2008-04-28 00:00:00.000,Munich Germany ATP World Tour,CLAY,2,Julio Silva,Matthias Bachinger,Julio Silva,3-6; 6-2; 6-3,R32,87,7,0,56,76,37,56,13,20,8,11,13,50,76,7,4,41,73,32,41,12,32,4,9,13,44,73
2008-04-28 00:00:00.000,Munich Germany ATP World Tour,CLAY,2,Hyung-Taik Lee,Rainer Eitzinger,Hyung-Taik Lee,1-6; 7-5; 6-2,R32,120,0,3,66,101,40,66,19,35,10,13,13,59,101,0,2,61,85,36,61,15,24,2,6,14,51,85
2008-04-28 00:00:00.000,Munich Germany ATP World Tour,CLAY,2,Simone Bolelli,Marc Gicquel,Simone Bolelli,6-4; 6-2,R32,75,5,1,38,52,28,38,9,14,0,0,9,37,52,6,3,46,72,27,46,14,26,11,14,9,41,72
2008-04-28 00:00:00.000,Munich Germany ATP World Tour,CLAY,2,Andreas Seppi,Roko Karanusic,Andreas Seppi,6-3; 6-3,R32,75,3,4,41,65,30,41,11,24,6,8,9,41,65,1,0,43,69,20,43,13,26,9,14,9,33,69
2008-04-28 00:00:00.000,Munich Germany ATP World Tour,CLAY,2,Steve Darcis,Benjamin Becker,Steve Darcis,6-3; 6-4,R32,66,6,1,35,52,29,35,11,17,0,0,10,40,52,2,0,23,48,16,23,15,25,1,3,9,31,48
2008-04-28 00:00:00.000,Munich Germany ATP World Tour,CLAY,2,Younes El Aynaoui,Alexandre Sidorenko,Younes El Aynaoui,6-4; 7-6(6),R32,92,14,3,51,80,40,51,15,29,1,1,11,55,80,3,3,41,64,33,41,12,23,1,2,11,45,64
2008-04-28 00:00:00.000,Munich Germany ATP World Tour,CLAY,2,Juan Martin Del Potro,Arnaud Clement,Juan Martin Del Potro,6-3; 6-1,R32,76,12,3,29,57,22,29,17,28,7,7,8,39,57,4,3,29,48,21,29,5,19,2,6,8,26,48
2008-04-28 00:00:00.000,Munich Germany ATP World Tour,CLAY,2,Igor Andreev,Gael Monfils,Igor Andreev,6-3; 6-4,R32,90,0,0,37,61,26,37,18,24,4,4,10,44,61,7,4,37,75,28,37,16,38,9,11,9,44,75
2008-04-28 00:00:00.000,Munich Germany ATP World Tour,CLAY,2,Michael Berrer,Ivo Klec,Michael Berrer,6-1; 7-6(6),R32,111,2,4,54,85,37,54,16,31,3,4,10,53,85,1,0,39,65,29,39,8,26,6,9,9,37,65
2008-04-28 00:00:00.000,Munich Germany ATP World Tour,CLAY,2,Marat Safin,Carlos Berlocq,Marat Safin,6-3; 3-6; 6-4,R32,126,10,4,56,98,41,56,20,42,8,10,14,61,98,0,4,56,83,36,56,14,27,3,6,14,50,83
2008-04-28 00:00:00.000,Munich Germany ATP World Tour,CLAY,2,Kristof Vliegen,Sergio Roitman,Kristof Vliegen,7-6(3); 6-3,R32,98,10,2,45,82,36,45,19,37,6,6,11,55,82,4,3,45,65,33,45,11,20,5,6,10,44,65
2008-04-28 00:00:00.000,Munich Germany ATP World Tour,CLAY,2,Fernando Gonzalez,Dudi Sela,Fernando Gonzalez,6-3; 6-4,R32,75,5,1,30,59,25,30,19,29,4,4,10,44,59,0,3,41,58,29,41,8,17,3,5,9,37,58
2008-04-28 00:00:00.000,Munich Germany ATP World Tour,CLAY,2,Paul-Henri Mathieu,Gianluca Naso,Paul-Henri Mathieu,6-3; 6-4,R16,93,12,2,36,64,32,36,14,28,2,2,10,46,64,5,1,57,87,37,57,12,30,15,17,9,49,87
2008-04-28 00:00:00.000,Munich Germany ATP World Tour,CLAY,2,Marin Cilic,Philipp Petzschner,Marin Cilic,6-4; 7-6(7),R16,114,6,7,61,102,43,61,21,41,13,14,11,64,102,1,2,42,76,28,42,19,34,2,4,11,47,76
2008-04-28 00:00:00.000,Munich Germany ATP World Tour,CLAY,2,Hyung-Taik Lee,Julio Silva,Hyung-Taik Lee,6-1; 6-4,R16,69,2,0,41,58,28,41,11,17,2,3,9,39,58,3,2,39,56,21,39,7,17,8,12,8,28,56
2008-04-28 00:00:00.000,Munich Germany ATP World Tour,CLAY,2,Simone Bolelli,Andreas Seppi,Simone Bolelli,6-4; 7-5,R16,94,6,1,57,75,42,57,11,18,6,6,11,53,75,3,4,35,67,29,35,14,32,3,5,11,43,67
2008-04-28 00:00:00.000,Munich Germany ATP World Tour,CLAY,2,Younes El Aynaoui,Steve Darcis,Younes El Aynaoui,6-4; 3-6; 6-3,R16,98,7,1,64,89,49,64,11,25,4,5,14,60,89,4,0,44,75,33,44,20,31,1,3,14,53,75
2008-04-28 00:00:00.000,Munich Germany ATP World Tour,CLAY,2,Juan Martin Del Potro,Igor Andreev,Juan Martin Del Potro,1-6; 6-0; 6-4,R16,109,2,4,39,68,29,39,10,29,4,8,11,39,68,5,2,56,77,32,56,7,21,9,15,12,39,77
2008-04-28 00:00:00.000,Munich Germany ATP World Tour,CLAY,2,Marat Safin,Michael Berrer,Marat Safin,7-6(4); 6-7(5); 6-3,R16,161,12,2,56,114,39,56,39,58,2,4,17,78,114,3,2,83,105,58,83,9,22,6,9,16,67,105
2008-04-28 00:00:00.000,Munich Germany ATP World Tour,CLAY,2,Fernando Gonzalez,Kristof Vliegen,Fernando Gonzalez,1-6; 7-5; 6-3,R16,111,5,5,60,94,38,60,15,34,11,16,14,53,94,6,1,52,82,36,52,13,30,4,9,14,49,82
2008-04-28 00:00:00.000,Munich Germany ATP World Tour,CLAY,2,Paul-Henri Mathieu,Marin Cilic,Paul-Henri Mathieu,6-2; 4-6; 6-3,Q,122,3,0,45,83,37,45,21,38,3,5,14,58,83,9,1,43,82,28,43,22,39,8,12,13,50,82
2008-04-28 00:00:00.000,Munich Germany ATP World Tour,CLAY,2,Simone Bolelli,Hyung-Taik Lee,Simone Bolelli,6-4; 7-6(3),Q,87,7,1,44,60,37,44,11,16,3,4,11,48,60,5,0,33,62,22,33,20,29,0,2,11,42,62
2008-04-28 00:00:00.000,Munich Germany ATP World Tour,CLAY,2,Younes El Aynaoui,Juan Martin Del Potro,Younes El Aynaoui,6-4; 6-4,Q,80,7,1,33,53,29,33,11,20,1,2,10,40,53,1,1,44,58,26,44,7,14,2,5,10,33,58
2008-04-28 00:00:00.000,Munich Germany ATP World Tour,CLAY,2,Fernando Gonzalez,Marat Safin,Fernando Gonzalez,6-3; 7-5,Q,129,2,2,48,77,34,48,17,29,5,6,11,51,77,1,1,33,56,23,33,10,23,0,3,10,33,56
2008-04-28 00:00:00.000,Munich Germany ATP World Tour,CLAY,2,Simone Bolelli,Paul-Henri Mathieu,Simone Bolelli,7-6(1); 4-6; 7-6(4),S,186,15,3,88,128,61,88,20,40,4,7,17,81,128,6,3,69,111,50,69,22,42,5,7,17,72,111
2008-04-28 00:00:00.000,Munich Germany ATP World Tour,CLAY,2,Fernando Gonzalez,Younes El Aynaoui,Fernando Gonzalez,3-6; 6-4; 6-3,S,112,2,3,53,83,41,53,16,30,3,5,14,57,83,7,3,57,84,42,57,12,27,1,4,14,54,84
2008-04-28 00:00:00.000,Munich Germany ATP World Tour,CLAY,2,Fernando Gonzalez,Simone Bolelli,Fernando Gonzalez,7-6(4); 6-7(4); 6-3,F,156,4,3,69,105,55,69,22,36,3,3,16,77,105,6,2,89,125,60,89,21,36,4,6,17,81,125
2008-05-05 00:00:00.000,ATP Masters Series Rome Italy ATP World Tour,CLAY,2,Roger Federer,N/A Bye,Roger Federer,,R64,0,0,0,0,0,0,0,0,0,0,0,0,0,0,0,0,0,0,0,0,0,0,0,0,0,0,0
2008-05-05 00:00:00.000,ATP Masters Series Rome Italy ATP World Tour,CLAY,2,Guillermo Canas,Gianluca Naso,Guillermo Canas,6-7(8); 6-3; 6-2,R64,157,8,4,78,118,59,78,18,40,12,13,15,77,118,2,4,55,93,38,55,21,38,4,8,14,59,93
2008-05-05 00:00:00.000,ATP Masters Series Rome Italy ATP World Tour,CLAY,2,Potito Starace,Marin Cilic,Potito Starace,6-4; 2-6; 6-4,R64,133,2,1,55,84,36,55,11,29,6,11,14,47,84,3,2,47,92,27,47,25,45,5,10,14,52,92
2008-05-05 00:00:00.000,ATP Masters Series Rome Italy ATP World Tour,CLAY,2,Ivo Karlovic,Paul-Henri Mathieu,Ivo Karlovic,7-6(4); 6-2,R64,89,13,2,38,60,30,38,12,22,0,0,10,42,60,1,3,37,62,22,37,13,25,1,3,10,35,62
2008-05-05 00:00:00.000,ATP Masters Series Rome Italy ATP World Tour,CLAY,2,Luis Horna,Richard Gasquet,Luis Horna,6-4; 6-1,R64,60,0,0,27,41,21,27,11,14,0,0,8,32,41,8,4,23,45,17,23,9,22,3,7,9,26,45
2008-05-05 00:00:00.000,ATP Masters Series Rome Italy ATP World Tour,CLAY,2,Jose Acasuso,Dmitry Tursunov,Jose Acasuso,6-4; 6-2,R64,115,3,4,39,75,25,39,19,36,9,11,9,44,75,5,2,39,71,24,39,11,32,10,15,9,35,71
2008-05-05 00:00:00.000,ATP Masters Series Rome Italy ATP World Tour,CLAY,2,Radek Stepanek,Jarkko Nieminen,Radek Stepanek,6-3; 3-6; 6-3,R64,104,3,3,46,81,41,46,16,35,1,2,14,57,81,3,1,43,73,32,43,18,30,2,4,13,50,73
2008-05-05 00:00:00.000,ATP Masters Series Rome Italy ATP World Tour,CLAY,2,David Ferrer,N/A Bye,David Ferrer,,R64,0,0,0,0,0,0,0,0,0,0,0,0,0,0,0,0,0,0,0,0,0,0,0,0,0,0,0
2008-05-05 00:00:00.000,ATP Masters Series Rome Italy ATP World Tour,CLAY,2,Novak Djokovic,N/A Bye,Novak Djokovic,,R64,0,0,0,0,0,0,0,0,0,0,0,0,0,0,0,0,0,0,0,0,0,0,0,0,0,0,0
2008-05-05 00:00:00.000,ATP Masters Series Rome Italy ATP World Tour,CLAY,2,Steve Darcis,Ivan Ljubicic,Steve Darcis,7-5; 7-6(5),R64,123,6,1,52,94,39,52,22,42,6,7,12,61,94,11,4,50,89,38,50,17,39,9,11,12,55,89
2008-05-05 00:00:00.000,ATP Masters Series Rome Italy ATP World Tour,CLAY,2,Igor Andreev,Hyung-Taik Lee,Igor Andreev,6-4; 7-5,R64,83,7,1,45,61,32,45,11,16,5,6,11,43,61,1,2,50,72,33,50,9,22,2,5,11,42,72
2008-05-05 00:00:00.000,ATP Masters Series Rome Italy ATP World Tour,CLAY,2,Juan Monaco,Pablo Cuevas,Juan Monaco,6-0; 6-4,R64,72,1,0,28,48,19,28,13,20,2,3,8,32,48,1,3,21,45,11,21,10,24,6,11,8,21,45
2008-05-05 00:00:00.000,ATP Masters Series Rome Italy ATP World Tour,CLAY,2,Fernando Gonzalez,Janko Tipsarevic,Fernando Gonzalez,3-6; 7-6(0); 7-6(6),R64,160,7,4,60,101,50,60,17,41,4,9,17,67,101,6,4,61,109,46,61,21,48,4,7,16,67,109
2008-05-05 00:00:00.000,ATP Masters Series Rome Italy ATP World Tour,CLAY,2,Evgeny Korolev,Robin Soderling,Evgeny Korolev,1-6; 6-3; 6-4,R64,116,8,4,68,84,46,68,8,16,7,9,13,54,84,16,5,71,80,50,71,2,9,5,7,13,52,80
2008-05-05 00:00:00.000,ATP Masters Series Rome Italy ATP World Tour,CLAY,2,Nicolas Almagro,Flavio Cipolla,Nicolas Almagro,6-1; 6-3,R64,59,6,1,21,39,16,21,13,18,0,1,8,29,39,0,1,32,53,13,32,11,21,7,12,8,24,53
2008-05-05 00:00:00.000,ATP Masters Series Rome Italy ATP World Tour,CLAY,2,David Nalbandian,N/A Bye,David Nalbandian,,R64,0,0,0,0,0,0,0,0,0,0,0,0,0,0,0,0,0,0,0,0,0,0,0,0,0,0,0
2008-05-05 00:00:00.000,ATP Masters Series Rome Italy ATP World Tour,CLAY,2,Andy Roddick,N/A Bye,Andy Roddick,,R64,0,0,0,0,0,0,0,0,0,0,0,0,0,0,0,0,0,0,0,0,0,0,0,0,0,0,0
2008-05-05 00:00:00.000,ATP Masters Series Rome Italy ATP World Tour,CLAY,2,Mardy Fish,Michael Llodra,Mardy Fish,7-5; 3-6; 7-6(2),R64,142,3,4,41,100,28,41,40,59,7,9,16,68,100,8,3,62,119,46,62,30,57,10,12,17,76,119
2008-05-05 00:00:00.000,ATP Masters Series Rome Italy ATP World Tour,CLAY,2,Simone Bolelli,Olivier Patience,Simone Bolelli,6-0; 6-3,R64,62,1,1,36,51,28,36,9,15,2,2,8,37,51,2,2,25,42,11,25,9,17,1,5,7,20,42
2008-05-05 00:00:00.000,ATP Masters Series Rome Italy ATP World Tour,CLAY,2,Gilles Simon,Jo-Wilfried Tsonga,Gilles Simon,6-2; 4-6; 7-6(6),R64,140,0,1,53,99,34,53,28,46,4,6,15,62,99,3,1,58,98,40,58,19,40,2,5,15,59,98
2008-05-05 00:00:00.000,ATP Masters Series Rome Italy ATP World Tour,CLAY,2,Tommy Robredo,Juan Ignacio Chela,Tommy Robredo,6-4; 6-1,R64,79,3,1,26,43,19,26,8,17,0,2,8,27,43,1,3,33,62,17,33,10,29,4,10,9,27,62
2008-05-05 00:00:00.000,ATP Masters Series Rome Italy ATP World Tour,CLAY,2,Nicolas Mahut,Thomas Fabbiano,Nicolas Mahut,6-7(5); 6-4; 7-5,R64,153,9,4,71,116,53,71,26,45,5,6,17,79,116,3,6,77,111,51,77,18,34,2,5,17,69,111
2008-05-05 00:00:00.000,ATP Masters Series Rome Italy ATP World Tour,CLAY,2,Mario Ancic,Feliciano Lopez,Mario Ancic,6-4; 6-4,R64,129,4,0,44,76,30,44,21,32,12,12,10,51,76,5,1,56,87,36,56,15,31,6,8,10,51,87
2008-05-05 00:00:00.000,ATP Masters Series Rome Italy ATP World Tour,CLAY,2,Nikolay Davydenko,N/A Bye,Nikolay Davydenko,,R64,0,0,0,0,0,0,0,0,0,0,0,0,0,0,0,0,0,0,0,0,0,0,0,0,0,0,0
2008-05-05 00:00:00.000,ATP Masters Series Rome Italy ATP World Tour,CLAY,2,James Blake,N/A Bye,James Blake,,R64,0,0,0,0,0,0,0,0,0,0,0,0,0,0,0,0,0,0,0,0,0,0,0,0,0,0,0
2008-05-05 00:00:00.000,ATP Masters Series Rome Italy ATP World Tour,CLAY,2,Andreas Seppi,Fabrice Santoro,Andreas Seppi,6-4; 6-2,R64,79,2,3,43,65,33,43,7,22,7,8,9,40,65,2,0,27,51,16,27,11,24,3,7,9,27,51
2008-05-05 00:00:00.000,ATP Masters Series Rome Italy ATP World Tour,CLAY,2,Nicolas Lapentti,Filippo Volandri,Nicolas Lapentti,7-6(6); 2-6; 6-2,R64,153,4,2,52,96,30,52,20,44,5,11,14,50,96,0,6,60,97,31,60,22,37,5,11,14,53,97
2008-05-05 00:00:00.000,ATP Masters Series Rome Italy ATP World Tour,CLAY,2,Fernando Verdasco,Carlos Moya,Fernando Verdasco,6-3; 6-4,R64,80,0,1,44,54,29,44,6,10,6,8,9,35,54,2,1,30,56,17,30,11,26,3,8,10,28,56
2008-05-05 00:00:00.000,ATP Masters Series Rome Italy ATP World Tour,CLAY,2,Andy Murray,Juan Martin Del Potro,Andy Murray,5-7; 6-4; 1-0 RET,R64,128,2,1,41,71,27,41,14,30,2,6,11,41,71,1,1,54,82,30,54,11,28,2,7,12,41,82
2008-05-05 00:00:00.000,ATP Masters Series Rome Italy ATP World Tour,CLAY,2,Stanislas Wawrinka,Marat Safin,Stanislas Wawrinka,6-7(5); 6-2; 6-1,R64,136,5,5,58,90,37,58,13,32,9,13,13,50,90,5,5,51,96,32,51,11,45,7,16,14,43,96
2008-05-05 00:00:00.000,ATP Masters Series Rome Italy ATP World Tour,CLAY,2,Juan Carlos Ferrero,Nicolas Kiefer,Juan Carlos Ferrero,6-7(5); 6-3; 6-4,R64,149,8,1,58,88,46,58,20,30,4,5,16,66,88,10,6,37,102,28,37,34,65,1,4,15,62,102
2008-05-05 00:00:00.000,ATP Masters Series Rome Italy ATP World Tour,CLAY,2,Rafael Nadal,N/A Bye,Rafael Nadal,,R64,0,0,0,0,0,0,0,0,0,0,0,0,0,0,0,0,0,0,0,0,0,0,0,0,0,0,0
2008-05-05 00:00:00.000,ATP Masters Series Rome Italy ATP World Tour,CLAY,2,Roger Federer,Guillermo Canas,Roger Federer,6-3; 6-3,R32,83,8,0,29,51,22,29,17,22,1,1,9,39,51,0,2,39,61,25,39,9,22,4,7,9,34,61
2008-05-05 00:00:00.000,ATP Masters Series Rome Italy ATP World Tour,CLAY,2,Ivo Karlovic,Potito Starace,Ivo Karlovic,6-3; 6-7(5); 7-6(3),R32,155,18,2,73,98,60,73,15,25,2,3,17,75,98,1,3,85,116,56,85,20,31,7,9,16,76,116
2008-05-05 00:00:00.000,ATP Masters Series Rome Italy ATP World Tour,CLAY,2,Luis Horna,Jose Acasuso,Luis Horna,6-3; 7-6(1),R32,100,11,1,55,72,39,55,9,17,4,6,11,48,72,3,1,37,70,23,37,17,33,4,7,10,40,70
2008-05-05 00:00:00.000,ATP Masters Series Rome Italy ATP World Tour,CLAY,2,Radek Stepanek,David Ferrer,Radek Stepanek,4-6; 6-2; 6-1,R32,105,2,2,46,74,34,46,17,28,2,3,12,51,74,0,1,44,70,27,44,10,26,2,7,13,37,70
2008-05-05 00:00:00.000,ATP Masters Series Rome Italy ATP World Tour,CLAY,2,Novak Djokovic,Steve Darcis,Novak Djokovic,6-4; 6-0,R32,73,3,2,36,55,26,36,11,19,4,5,8,37,55,2,0,25,49,14,25,7,24,1,6,8,21,49
2008-05-05 00:00:00.000,ATP Masters Series Rome Italy ATP World Tour,CLAY,2,Igor Andreev,Juan Monaco,Igor Andreev,4-6; 6-1; 6-4,R32,138,7,3,69,100,46,69,12,31,10,14,14,58,100,0,3,56,80,33,56,9,24,4,10,13,42,80
2008-05-05 00:00:00.000,ATP Masters Series Rome Italy ATP World Tour,CLAY,2,Fernando Gonzalez,Evgeny Korolev,Fernando Gonzalez,6-3; 6-2,R32,62,0,0,41,51,33,41,5,10,0,0,9,38,51,2,1,34,47,24,34,2,13,1,4,8,26,47
2008-05-05 00:00:00.000,ATP Masters Series Rome Italy ATP World Tour,CLAY,2,Nicolas Almagro,David Nalbandian,Nicolas Almagro,6-4; 7-5,R32,97,7,3,44,62,30,44,11,18,0,2,11,41,62,1,4,50,83,33,50,13,33,8,12,11,46,83
2008-05-05 00:00:00.000,ATP Masters Series Rome Italy ATP World Tour,CLAY,2,Andy Roddick,Mardy Fish,Andy Roddick,6-1; 6-4,R32,67,4,0,30,52,20,30,17,22,1,1,9,37,52,5,3,20,46,15,20,12,26,4,7,8,27,46
2008-05-05 00:00:00.000,ATP Masters Series Rome Italy ATP World Tour,CLAY,2,Simone Bolelli,Gilles Simon,Simone Bolelli,6-4; 6-4,R32,89,2,1,47,67,31,47,12,20,3,4,10,43,67,2,0,34,56,22,34,13,22,1,4,10,35,56
2008-05-05 00:00:00.000,ATP Masters Series Rome Italy ATP World Tour,CLAY,2,Tommy Robredo,Nicolas Mahut,Tommy Robredo,7-5; 7-6(5),R32,118,2,2,55,71,46,55,9,16,5,5,12,55,71,2,2,56,83,41,56,14,27,5,6,12,55,83
2008-05-05 00:00:00.000,ATP Masters Series Rome Italy ATP World Tour,CLAY,2,Nikolay Davydenko,Mario Ancic,Nikolay Davydenko,6-2; 6-2,R32,72,0,1,30,45,24,30,8,15,0,0,8,32,45,1,1,37,46,19,37,3,9,4,8,8,22,46
2008-05-05 00:00:00.000,ATP Masters Series Rome Italy ATP World Tour,CLAY,2,James Blake,Andreas Seppi,James Blake,7-6(5); 3-6; 6-1,R32,135,6,2,43,87,26,43,23,44,2,6,14,49,87,6,6,61,116,38,61,24,55,7,12,14,62,116
2008-05-05 00:00:00.000,ATP Masters Series Rome Italy ATP World Tour,CLAY,2,Fernando Verdasco,Nicolas Lapentti,Fernando Verdasco,6-2; 5-7; 6-2,R32,154,3,3,69,93,45,69,14,24,9,12,14,59,93,1,1,41,77,25,41,18,36,3,9,14,43,77
2008-05-05 00:00:00.000,ATP Masters Series Rome Italy ATP World Tour,CLAY,2,Stanislas Wawrinka,Andy Murray,Stanislas Wawrinka,6-2; 7-6(5),R32,105,1,1,51,70,34,51,14,19,1,2,10,48,70,0,2,39,72,25,39,16,33,6,9,10,41,72
2008-05-05 00:00:00.000,ATP Masters Series Rome Italy ATP World Tour,CLAY,2,Juan Carlos Ferrero,Rafael Nadal,Juan Carlos Ferrero,7-5; 6-1,R32,114,3,2,38,65,27,38,18,27,5,5,10,45,65,1,1,33,55,21,33,12,22,3,6,9,33,55
2008-05-05 00:00:00.000,ATP Masters Series Rome Italy ATP World Tour,CLAY,2,Roger Federer,Ivo Karlovic,Roger Federer,7-6(4); 6-3,R16,93,2,0,32,55,26,32,19,23,2,2,10,45,55,12,0,53,82,41,53,10,29,10,12,11,51,82
2008-05-05 00:00:00.000,ATP Masters Series Rome Italy ATP World Tour,CLAY,2,Radek Stepanek,Luis Horna,Radek Stepanek,6-4; 1-6; 6-3,R16,123,5,5,54,83,39,54,14,29,3,5,13,53,83,4,2,52,69,33,52,14,17,0,2,13,47,69
2008-05-05 00:00:00.000,ATP Masters Series Rome Italy ATP World Tour,CLAY,2,Novak Djokovic,Igor Andreev,Novak Djokovic,6-3; 3-6; 6-3,R16,162,1,3,75,111,47,75,21,36,9,11,14,68,111,3,8,63,93,41,63,16,30,2,5,13,57,93
2008-05-05 00:00:00.000,ATP Masters Series Rome Italy ATP World Tour,CLAY,2,Nicolas Almagro,Fernando Gonzalez,Nicolas Almagro,W/O,R16,0,0,0,0,0,0,0,0,0,0,0,0,0,0,0,0,0,0,0,0,0,0,0,0,0,0,0
2008-05-05 00:00:00.000,ATP Masters Series Rome Italy ATP World Tour,CLAY,2,Andy Roddick,Simone Bolelli,Andy Roddick,7-6(5); 6-3,R16,117,8,5,45,69,35,45,12,24,4,5,10,47,69,2,1,61,90,35,61,15,29,6,9,11,50,90
2008-05-05 00:00:00.000,ATP Masters Series Rome Italy ATP World Tour,CLAY,2,Tommy Robredo,Nikolay Davydenko,Tommy Robredo,4-6; 6-2; 7-6(4),R16,161,6,3,69,102,40,69,16,33,9,15,15,56,102,0,5,86,106,45,86,9,20,9,16,15,54,106
2008-05-05 00:00:00.000,ATP Masters Series Rome Italy ATP World Tour,CLAY,2,James Blake,Fernando Verdasco,James Blake,5-7; 7-5; 6-2,R16,155,5,4,73,119,45,73,26,46,10,13,16,71,119,7,1,76,95,47,76,11,19,8,13,16,58,95
2008-05-05 00:00:00.000,ATP Masters Series Rome Italy ATP World Tour,CLAY,2,Stanislas Wawrinka,Juan Carlos Ferrero,Stanislas Wawrinka,6-4; 6-3,R16,85,3,0,32,48,24,32,12,16,0,1,10,36,48,0,0,41,62,28,41,8,21,5,8,9,36,62
2008-05-05 00:00:00.000,ATP Masters Series Rome Italy ATP World Tour,CLAY,2,Radek Stepanek,Roger Federer,Radek Stepanek,7-6(4); 7-6(7),Q,115,8,4,61,94,45,61,15,33,3,5,12,60,94,7,1,48,76,41,48,13,28,1,3,12,54,76
2008-05-05 00:00:00.000,ATP Masters Series Rome Italy ATP World Tour,CLAY,2,Novak Djokovic,Nicolas Almagro,Novak Djokovic,6-1; 1-0 RET,Q,34,0,1,19,27,14,19,5,8,1,1,4,19,27,1,0,13,20,5,13,2,7,1,4,4,7,20
2008-05-05 00:00:00.000,ATP Masters Series Rome Italy ATP World Tour,CLAY,2,Andy Roddick,Tommy Robredo,Andy Roddick,6-3; 4-6; 7-6(4),Q,133,11,7,67,108,51,67,21,41,5,7,16,72,108,6,1,74,95,54,74,11,21,8,10,15,65,95
2008-05-05 00:00:00.000,ATP Masters Series Rome Italy ATP World Tour,CLAY,2,Stanislas Wawrinka,James Blake,Stanislas Wawrinka,6-7(5); 7-6(5); 6-1,Q,152,4,2,66,99,48,66,20,33,3,6,15,68,99,4,1,63,112,39,63,28,49,3,9,16,67,112
2008-05-05 00:00:00.000,ATP Masters Series Rome Italy ATP World Tour,CLAY,2,Novak Djokovic,Radek Stepanek,Novak Djokovic,6-0; 1-0 RET,S,34,2,0,13,19,11,13,5,6,0,0,4,16,19,0,2,10,16,3,10,1,6,0,3,3,4,16
2008-05-05 00:00:00.000,ATP Masters Series Rome Italy ATP World Tour,CLAY,2,Stanislas Wawrinka,Andy Roddick,Stanislas Wawrinka,3-0 RET,S,29,1,1,7,12,5,7,3,5,0,0,2,8,12,0,1,2,5,0,2,0,3,0,1,1,0,5
2008-05-05 00:00:00.000,ATP Masters Series Rome Italy ATP World Tour,CLAY,2,Novak Djokovic,Stanislas Wawrinka,Novak Djokovic,4-6; 6-3; 6-3,F,124,0,1,48,71,40,48,15,23,2,3,14,55,71,2,3,55,87,36,55,19,32,3,6,14,55,87
2008-05-11 00:00:00.000,ATP Masters Series Hamburg Germany ATP World Tour,CLAY,2,Roger Federer,N/A Bye,Roger Federer,,R64,0,0,0,0,0,0,0,0,0,0,0,0,0,0,0,0,0,0,0,0,0,0,0,0,0,0,0
2008-05-11 00:00:00.000,ATP Masters Series Hamburg Germany ATP World Tour,CLAY,2,Jarkko Nieminen,Rainer Schuettler,Jarkko Nieminen,6-1; 6-3,R64,68,1,0,32,44,26,32,7,12,0,0,8,33,44,1,3,26,48,14,26,9,22,2,6,8,23,48
2008-05-11 00:00:00.000,ATP Masters Series Hamburg Germany ATP World Tour,CLAY,2,Robin Soderling,Igor Andreev,Robin Soderling,4-6; 6-3; 6-3,R64,121,4,4,53,90,42,53,17,37,4,6,14,59,90,7,3,55,90,38,55,16,35,3,7,14,54,90
2008-05-11 00:00:00.000,ATP Masters Series Hamburg Germany ATP World Tour,CLAY,2,Jo-Wilfried Tsonga,Nicolas Mahut,Jo-Wilfried Tsonga,0-6; 7-6(5); 6-2,R64,114,5,1,56,81,37,56,16,25,2,5,13,53,81,5,3,60,85,43,60,13,25,3,5,13,56,85
2008-05-11 00:00:00.000,ATP Masters Series Hamburg Germany ATP World Tour,CLAY,2,Fernando Verdasco,Mikhail Youzhny,Fernando Verdasco,6-3; 6-2,R64,76,6,2,30,47,23,30,11,17,1,2,9,34,47,1,2,32,51,18,32,7,19,4,8,8,25,51
2008-05-11 00:00:00.000,ATP Masters Series Hamburg Germany ATP World Tour,CLAY,2,Michael Llodra,Guillermo Canas,Michael Llodra,7-6(7); 6-2,R64,98,2,4,30,65,23,30,20,35,1,3,10,43,65,6,4,43,76,23,43,20,33,8,12,10,43,76
2008-05-11 00:00:00.000,ATP Masters Series Hamburg Germany ATP World Tour,CLAY,2,Ivo Minar,Feliciano Lopez,Ivo Minar,6-3; 6-4,R64,74,3,0,38,56,30,38,11,18,0,0,10,41,56,5,2,48,70,30,48,11,22,6,8,9,41,70
2008-05-11 00:00:00.000,ATP Masters Series Hamburg Germany ATP World Tour,CLAY,2,David Ferrer,N/A Bye,David Ferrer,,R64,0,0,0,0,0,0,0,0,0,0,0,0,0,0,0,0,0,0,0,0,0,0,0,0,0,0,0
2008-05-11 00:00:00.000,ATP Masters Series Hamburg Germany ATP World Tour,CLAY,2,Nikolay Davydenko,N/A Bye,Nikolay Davydenko,,R64,0,0,0,0,0,0,0,0,0,0,0,0,0,0,0,0,0,0,0,0,0,0,0,0,0,0,0
2008-05-11 00:00:00.000,ATP Masters Series Hamburg Germany ATP World Tour,CLAY,2,Ivan Ljubicic,Steve Darcis,Ivan Ljubicic,6-7(6); 7-5; 7-6(4),R64,182,16,0,70,126,54,70,28,56,9,12,18,82,126,3,0,94,145,63,94,24,51,9,13,18,87,145
2008-05-11 00:00:00.000,ATP Masters Series Hamburg Germany ATP World Tour,CLAY,2,Stanislas Wawrinka,Alberto Martin,Stanislas Wawrinka,6-3; 6-3,R64,89,0,2,38,68,28,38,15,30,6,7,9,43,68,2,3,40,68,25,40,11,28,6,10,9,36,68
2008-05-11 00:00:00.000,ATP Masters Series Hamburg Germany ATP World Tour,CLAY,2,Nicolas Kiefer,Paul-Henri Mathieu,Nicolas Kiefer,6-4; 6-4,R64,100,13,3,41,69,33,41,12,28,4,5,10,45,69,3,0,39,64,24,39,13,25,4,7,10,37,64
2008-05-11 00:00:00.000,ATP Masters Series Hamburg Germany ATP World Tour,CLAY,2,Juan Monaco,Filippo Volandri,Juan Monaco,6-1; 4-0 RET,R64,58,3,1,24,43,18,24,11,19,3,3,6,29,43,0,1,22,31,10,22,2,9,6,10,5,12,31
2008-05-11 00:00:00.000,ATP Masters Series Hamburg Germany ATP World Tour,CLAY,2,Simone Bolelli,Marcel Granollers,Simone Bolelli,7-5; 6-2,R64,93,3,0,38,56,27,38,13,18,1,2,10,40,56,1,5,40,67,26,40,9,27,9,13,10,35,67
2008-05-11 00:00:00.000,ATP Masters Series Hamburg Germany ATP World Tour,CLAY,2,Andreas Seppi,Michael Berrer,Andreas Seppi,6-3; 6-0,R64,56,3,0,31,44,24,31,9,13,0,0,8,33,44,1,1,28,43,14,28,6,15,2,6,7,20,43
2008-05-11 00:00:00.000,ATP Masters Series Hamburg Germany ATP World Tour,CLAY,2,Richard Gasquet,N/A Bye,Richard Gasquet,,R64,0,0,0,0,0,0,0,0,0,0,0,0,0,0,0,0,0,0,0,0,0,0,0,0,0,0,0
2008-05-11 00:00:00.000,ATP Masters Series Hamburg Germany ATP World Tour,CLAY,2,James Blake,N/A Bye,James Blake,,R64,0,0,0,0,0,0,0,0,0,0,0,0,0,0,0,0,0,0,0,0,0,0,0,0,0,0,0
2008-05-11 00:00:00.000,ATP Masters Series Hamburg Germany ATP World Tour,CLAY,2,Janko Tipsarevic,Andreas Beck,Janko Tipsarevic,3-6; 6-3; 6-1,R64,106,15,2,47,74,34,47,14,27,2,5,12,48,74,5,0,51,77,28,51,14,26,2,7,12,42,77
2008-05-11 00:00:00.000,ATP Masters Series Hamburg Germany ATP World Tour,CLAY,2,Albert Montanes,Mardy Fish,Albert Montanes,6-1; 6-3,R64,63,0,7,27,53,20,27,14,26,4,5,8,34,53,3,1,16,45,13,16,9,29,4,9,8,22,45
2008-05-11 00:00:00.000,ATP Masters Series Hamburg Germany ATP World Tour,CLAY,2,Jose Acasuso,Kristof Vliegen,Jose Acasuso,5-2 RET,R64,35,1,2,9,20,6,9,5,11,0,1,3,11,20,0,0,20,27,9,20,2,7,1,4,4,11,27
2008-05-11 00:00:00.000,ATP Masters Series Hamburg Germany ATP World Tour,CLAY,2,Tommy Robredo,Philipp Kohlschreiber,Tommy Robredo,2-6; 7-6(5); 6-3,R64,151,3,2,71,107,47,71,15,36,9,14,15,62,107,3,1,51,91,32,51,23,40,4,8,14,55,91
2008-05-11 00:00:00.000,ATP Masters Series Hamburg Germany ATP World Tour,CLAY,2,Ivo Karlovic,Mischa Zverev,Ivo Karlovic,7-6(4); 7-6(3),R64,92,14,0,54,77,40,54,18,23,0,0,12,58,77,4,2,53,75,40,53,15,22,0,0,12,55,75
2008-05-11 00:00:00.000,ATP Masters Series Hamburg Germany ATP World Tour,CLAY,2,Juan Ignacio Chela,Jose Antonio Sanchez-de Luna,Juan Ignacio Chela,6-3; 6-3,R64,97,0,5,54,74,29,54,9,20,7,11,9,38,74,0,2,45,62,22,45,4,17,7,14,9,26,62
2008-05-11 00:00:00.000,ATP Masters Series Hamburg Germany ATP World Tour,CLAY,2,Novak Djokovic,N/A Bye,Novak Djokovic,,R64,0,0,0,0,0,0,0,0,0,0,0,0,0,0,0,0,0,0,0,0,0,0,0,0,0,0,0
2008-05-11 00:00:00.000,ATP Masters Series Hamburg Germany ATP World Tour,CLAY,2,Tomas Berdych,N/A Bye,Tomas Berdych,,R64,0,0,0,0,0,0,0,0,0,0,0,0,0,0,0,0,0,0,0,0,0,0,0,0,0,0,0
2008-05-11 00:00:00.000,ATP Masters Series Hamburg Germany ATP World Tour,CLAY,2,Marat Safin,Marin Cilic,Marat Safin,7-5; 6-2,R64,89,8,3,42,79,32,42,19,37,8,8,10,51,79,5,3,33,55,26,33,9,22,0,3,10,35,55
2008-05-11 00:00:00.000,ATP Masters Series Hamburg Germany ATP World Tour,CLAY,2,Olivier Rochus,Gianluca Naso,Olivier Rochus,7-6(11); 2-6; 6-4,R64,154,4,2,93,131,61,93,18,38,15,18,15,79,131,12,6,50,92,41,50,22,42,0,2,15,63,92
2008-05-11 00:00:00.000,ATP Masters Series Hamburg Germany ATP World Tour,CLAY,2,Carlos Moya,Julien Benneteau,Carlos Moya,3-6; 6-4; 7-6(7),R64,140,2,5,60,103,42,60,20,43,8,12,15,62,103,3,6,57,91,41,57,18,34,3,7,16,59,91
2008-05-11 00:00:00.000,ATP Masters Series Hamburg Germany ATP World Tour,CLAY,2,Andy Murray,Dmitry Tursunov,Andy Murray,6-4; 6-1,R64,92,1,1,33,52,22,33,15,19,3,3,8,37,52,1,4,40,77,25,40,15,37,5,9,9,40,77
2008-05-11 00:00:00.000,ATP Masters Series Hamburg Germany ATP World Tour,CLAY,2,Gilles Simon,Xavier Malisse,Gilles Simon,6-4; 7-5,R64,86,2,2,37,66,24,37,15,29,2,5,11,39,66,3,0,40,75,24,40,14,35,5,10,11,38,75
2008-05-11 00:00:00.000,ATP Masters Series Hamburg Germany ATP World Tour,CLAY,2,Potito Starace,Luis Horna,Potito Starace,6-3; 4-2 RET,R64,60,0,0,30,35,23,30,3,5,0,1,7,26,35,1,1,29,40,15,29,4,11,1,5,8,19,40
2008-05-11 00:00:00.000,ATP Masters Series Hamburg Germany ATP World Tour,CLAY,2,Rafael Nadal,N/A Bye,Rafael Nadal,,R64,0,0,0,0,0,0,0,0,0,0,0,0,0,0,0,0,0,0,0,0,0,0,0,0,0,0,0
2008-05-11 00:00:00.000,ATP Masters Series Hamburg Germany ATP World Tour,CLAY,2,Roger Federer,Jarkko Nieminen,Roger Federer,6-1; 6-3,R32,58,2,0,33,42,22,33,5,9,0,2,8,27,42,1,4,39,59,21,39,2,20,5,11,8,23,59
2008-05-11 00:00:00.000,ATP Masters Series Hamburg Germany ATP World Tour,CLAY,2,Robin Soderling,Jo-Wilfried Tsonga,Robin Soderling,6-2; 7-5,R32,72,6,2,39,58,31,39,9,19,0,1,10,40,58,4,1,42,58,25,42,7,16,4,8,10,32,58
2008-05-11 00:00:00.000,ATP Masters Series Hamburg Germany ATP World Tour,CLAY,2,Fernando Verdasco,Michael Llodra,Fernando Verdasco,6-2; 6-0,R32,51,2,2,32,42,26,32,5,10,0,0,7,31,42,3,2,36,47,15,36,3,11,3,8,7,18,47
2008-05-11 00:00:00.000,ATP Masters Series Hamburg Germany ATP World Tour,CLAY,2,David Ferrer,Ivo Minar,David Ferrer,6-3; 6-3,R32,76,0,1,36,54,25,36,9,18,2,4,9,34,54,1,1,38,55,19,38,7,17,2,7,9,26,55
2008-05-11 00:00:00.000,ATP Masters Series Hamburg Germany ATP World Tour,CLAY,2,Nikolay Davydenko,Ivan Ljubicic,Nikolay Davydenko,6-4; 6-1,R32,85,0,0,35,43,22,35,5,8,0,2,8,27,43,6,1,44,71,27,44,5,27,9,15,9,32,71
2008-05-11 00:00:00.000,ATP Masters Series Hamburg Germany ATP World Tour,CLAY,2,Nicolas Kiefer,Stanislas Wawrinka,Nicolas Kiefer,7-5; 7-5,R32,143,3,1,37,79,29,37,22,42,4,6,12,51,79,1,1,61,89,33,61,18,28,7,11,12,51,89
2008-05-11 00:00:00.000,ATP Masters Series Hamburg Germany ATP World Tour,CLAY,2,Juan Monaco,Simone Bolelli,Juan Monaco,6-2; 6-1,R32,66,3,0,35,49,27,35,9,14,5,5,8,36,49,3,2,30,49,16,30,8,19,7,11,7,24,49
2008-05-11 00:00:00.000,ATP Masters Series Hamburg Germany ATP World Tour,CLAY,2,Andreas Seppi,Richard Gasquet,Andreas Seppi,6-3; 6-2,R32,72,3,2,32,45,27,32,9,13,2,2,8,36,45,4,3,32,56,22,32,8,24,4,8,9,30,56
2008-05-11 00:00:00.000,ATP Masters Series Hamburg Germany ATP World Tour,CLAY,2,Janko Tipsarevic,James Blake,Janko Tipsarevic,4-6; 6-3; 6-3,R32,119,11,0,50,94,42,50,22,44,2,3,14,64,94,6,4,47,87,37,47,19,40,1,4,14,56,87
2008-05-11 00:00:00.000,ATP Masters Series Hamburg Germany ATP World Tour,CLAY,2,Albert Montanes,Jose Acasuso,Albert Montanes,7-6(3); 6-3,R32,95,2,2,40,67,30,40,11,27,4,7,10,41,67,2,10,39,79,30,39,9,40,7,12,11,39,79
2008-05-11 00:00:00.000,ATP Masters Series Hamburg Germany ATP World Tour,CLAY,2,Ivo Karlovic,Tommy Robredo,Ivo Karlovic,3-6; 6-2; 7-6(3),R32,116,20,2,65,99,49,65,18,34,5,8,15,67,99,1,0,65,76,46,65,5,11,3,6,14,51,76
2008-05-11 00:00:00.000,ATP Masters Series Hamburg Germany ATP World Tour,CLAY,2,Novak Djokovic,Juan Ignacio Chela,Novak Djokovic,6-3; 6-1,R32,66,4,2,32,46,26,32,6,14,2,3,8,32,46,0,1,32,57,17,32,9,25,2,7,8,26,57
2008-05-11 00:00:00.000,ATP Masters Series Hamburg Germany ATP World Tour,CLAY,2,Marat Safin,Tomas Berdych,Marat Safin,7-5; 6-4,R32,91,4,3,47,77,34,47,15,30,3,4,11,49,77,2,3,31,54,22,31,12,23,1,4,11,34,54
2008-05-11 00:00:00.000,ATP Masters Series Hamburg Germany ATP World Tour,CLAY,2,Carlos Moya,Olivier Rochus,Carlos Moya,7-5; 6-3,R32,93,5,1,26,59,20,26,23,33,1,2,11,43,59,0,1,38,63,21,38,14,25,3,6,10,35,63
2008-05-11 00:00:00.000,ATP Masters Series Hamburg Germany ATP World Tour,CLAY,2,Andy Murray,Gilles Simon,Andy Murray,6-3; 6-3,R32,77,0,1,24,53,20,24,16,29,3,4,9,36,53,0,4,29,59,16,29,14,30,5,9,9,30,59
2008-05-11 00:00:00.000,ATP Masters Series Hamburg Germany ATP World Tour,CLAY,2,Rafael Nadal,Potito Starace,Rafael Nadal,6-4; 7-6(6),R32,128,2,2,53,65,37,53,5,12,0,2,11,42,65,0,3,66,85,41,66,6,19,4,7,11,47,85
2008-05-11 00:00:00.000,ATP Masters Series Hamburg Germany ATP World Tour,CLAY,2,Roger Federer,Robin Soderling,Roger Federer,6-3; 6-2,R16,64,6,0,25,48,21,25,16,23,2,2,9,37,48,6,0,37,56,22,37,9,19,6,9,8,31,56
2008-05-11 00:00:00.000,ATP Masters Series Hamburg Germany ATP World Tour,CLAY,2,Fernando Verdasco,David Ferrer,Fernando Verdasco,7-6(4); 6-2,R16,130,6,2,66,84,40,66,9,18,7,10,10,49,84,2,3,63,97,37,63,12,34,11,16,10,49,97
2008-05-11 00:00:00.000,ATP Masters Series Hamburg Germany ATP World Tour,CLAY,2,Nicolas Kiefer,Nikolay Davydenko,Nicolas Kiefer,7-5; 6-3,R16,115,8,1,47,79,32,47,21,32,4,5,11,53,79,0,2,36,60,24,36,11,24,2,5,10,35,60
2008-05-11 00:00:00.000,ATP Masters Series Hamburg Germany ATP World Tour,CLAY,2,Andreas Seppi,Juan Monaco,Andreas Seppi,6-0; 6-3,R16,72,1,1,26,44,18,26,9,18,2,4,7,27,44,0,2,30,50,10,30,7,20,1,8,8,17,50
2008-05-11 00:00:00.000,ATP Masters Series Hamburg Germany ATP World Tour,CLAY,2,Albert Montanes,Janko Tipsarevic,Albert Montanes,6-2; 6-1,R16,63,5,0,26,37,19,26,9,11,0,0,7,28,37,4,2,22,52,14,22,9,30,1,6,8,23,52
2008-05-11 00:00:00.000,ATP Masters Series Hamburg Germany ATP World Tour,CLAY,2,Novak Djokovic,Ivo Karlovic,Novak Djokovic,7-6(3); 6-3,R16,98,4,2,54,78,39,54,14,24,3,4,11,53,78,12,0,41,64,30,41,10,23,1,3,10,40,64
2008-05-11 00:00:00.000,ATP Masters Series Hamburg Germany ATP World Tour,CLAY,2,Carlos Moya,Marat Safin,Carlos Moya,6-2; 6-7(3); 6-1,R16,147,5,1,61,99,38,61,27,38,4,5,14,65,99,4,1,45,85,32,45,17,40,5,10,13,49,85
2008-05-11 00:00:00.000,ATP Masters Series Hamburg Germany ATP World Tour,CLAY,2,Rafael Nadal,Andy Murray,Rafael Nadal,6-3; 6-2,R16,78,1,0,34,43,25,34,6,9,2,3,8,31,43,3,0,40,64,21,40,11,24,3,8,9,32,64
2008-05-11 00:00:00.000,ATP Masters Series Hamburg Germany ATP World Tour,CLAY,2,Roger Federer,Fernando Verdasco,Roger Federer,6-3; 6-3,Q,81,2,1,38,55,28,38,11,17,3,3,9,39,55,1,4,43,60,28,43,7,17,5,8,9,35,60
2008-05-11 00:00:00.000,ATP Masters Series Hamburg Germany ATP World Tour,CLAY,2,Andreas Seppi,Nicolas Kiefer,Andreas Seppi,6-3; 5-7; 7-5,Q,193,1,5,73,119,46,73,23,46,10,14,16,69,119,8,3,49,112,32,49,31,63,7,13,17,63,112
2008-05-11 00:00:00.000,ATP Masters Series Hamburg Germany ATP World Tour,CLAY,2,Novak Djokovic,Albert Montanes,Novak Djokovic,6-2; 6-3,Q,77,4,0,48,62,33,48,8,14,3,4,9,41,62,0,2,37,56,20,37,8,19,3,7,8,28,56
2008-05-11 00:00:00.000,ATP Masters Series Hamburg Germany ATP World Tour,CLAY,2,Rafael Nadal,Carlos Moya,Rafael Nadal,6-1; 6-3,Q,75,0,0,41,51,27,41,8,10,2,3,8,35,51,3,0,32,49,17,32,6,17,4,9,8,23,49
2008-05-11 00:00:00.000,ATP Masters Series Hamburg Germany ATP World Tour,CLAY,2,Roger Federer,Andreas Seppi,Roger Federer,6-3; 6-1,S,79,1,0,24,46,19,24,14,22,1,1,8,33,46,2,1,44,73,26,44,12,29,10,14,8,38,73
2008-05-11 00:00:00.000,ATP Masters Series Hamburg Germany ATP World Tour,CLAY,2,Rafael Nadal,Novak Djokovic,Rafael Nadal,7-5; 2-6; 6-2,S,183,3,2,82,110,47,82,14,28,15,19,14,61,110,0,0,60,93,35,60,15,33,4,9,14,50,93
2008-05-11 00:00:00.000,ATP Masters Series Hamburg Germany ATP World Tour,CLAY,2,Rafael Nadal,Roger Federer,Rafael Nadal,7-5; 6-7(3); 6-3,F,172,3,3,77,101,51,77,8,24,3,7,17,59,101,7,0,72,118,48,72,16,46,11,17,16,64,118
2008-05-18 00:00:00.000,Casablanca Morocco ATP World Tour,CLAY,2,Jo-Wilfried Tsonga,Albert Montanes,Jo-Wilfried Tsonga,6-4; 7-6(10),R32,96,4,1,52,70,43,52,10,18,0,0,11,53,70,3,2,55,82,39,55,14,27,2,3,11,53,82
2008-05-18 00:00:00.000,Casablanca Morocco ATP World Tour,CLAY,2,Lamine Ouahab,Martin Vassallo Arguello,Lamine Ouahab,7-5; 6-2,R32,86,1,0,40,62,30,40,11,22,3,4,10,41,62,4,2,53,68,32,53,5,15,5,9,10,37,68
2008-05-18 00:00:00.000,Casablanca Morocco ATP World Tour,CLAY,2,Santiago Ventura,Arnaud Clement,Santiago Ventura,7-6(6); 6-1,R32,89,7,0,31,62,21,31,24,31,1,2,10,45,62,6,0,27,58,21,27,13,31,1,4,9,34,58
2008-05-18 00:00:00.000,Casablanca Morocco ATP World Tour,CLAY,2,Rainer Schuettler,Chris Guccione,Rainer Schuettler,6-4; 6-7(5); 6-2,R32,121,3,3,64,86,51,64,10,22,4,6,15,61,86,14,2,67,104,44,67,16,37,9,14,15,60,104
2008-05-18 00:00:00.000,Casablanca Morocco ATP World Tour,CLAY,2,Marc Gicquel,Ruben Ramirez Hidalgo,Marc Gicquel,6-3; 6-0,R32,57,8,1,19,42,17,19,13,23,2,2,7,30,42,3,2,23,48,11,23,10,25,1,6,8,21,48
2008-05-18 00:00:00.000,Casablanca Morocco ATP World Tour,CLAY,2,Guillermo Coria,Peter Polansky,Guillermo Coria,4-6; 6-4; 6-3,R32,127,2,7,59,93,41,59,17,34,6,9,14,58,93,10,2,57,95,38,57,14,38,6,11,15,52,95
2008-05-18 00:00:00.000,Casablanca Morocco ATP World Tour,CLAY,2,Boris Pashanski,Benjamin Becker,Boris Pashanski,2-6; 6-3; 7-6(3),R32,103,4,4,58,89,46,58,18,31,2,4,15,64,89,9,2,48,78,36,48,22,30,2,3,14,58,78
2008-05-18 00:00:00.000,Casablanca Morocco ATP World Tour,CLAY,2,Gilles Simon,Florent Serra,Gilles Simon,6-2; 5-7; 6-3,R32,142,6,2,59,107,35,59,25,48,9,14,15,60,107,0,0,59,99,32,59,19,40,9,16,14,51,99
2008-05-18 00:00:00.000,Casablanca Morocco ATP World Tour,CLAY,2,Younes El Aynaoui,Victor Hanescu,Younes El Aynaoui,6-2; 6-7(6); 6-3,R32,130,12,8,71,109,53,71,19,38,10,11,15,72,109,9,2,58,84,39,58,13,26,4,8,14,52,84
2008-05-18 00:00:00.000,Casablanca Morocco ATP World Tour,CLAY,2,Dominik Hrbaty,Peter Luczak,Dominik Hrbaty,2-1 RET,R32,10,0,1,7,11,5,7,1,4,0,1,2,6,11,0,2,1,4,0,1,0,3,0,1,1,0,4
2008-05-18 00:00:00.000,Casablanca Morocco ATP World Tour,CLAY,2,Olivier Patience,Marcos Daniel,Olivier Patience,6-7(5); 7-6(0); 6-4,R32,151,11,2,74,115,54,74,24,41,4,6,17,78,115,12,0,65,111,50,65,25,46,10,13,17,75,111
2008-05-18 00:00:00.000,Casablanca Morocco ATP World Tour,CLAY,2,Agustin Calleri,Thierry Ascione,Agustin Calleri,3-6; 6-1; 6-2,R32,120,12,5,40,78,33,40,18,38,5,7,12,51,78,0,4,70,99,37,70,14,29,12,17,12,51,99
2008-05-18 00:00:00.000,Casablanca Morocco ATP World Tour,CLAY,2,Julien Benneteau,Florian Mayer,Julien Benneteau,2-6; 6-3; 6-4,R32,109,2,1,60,92,34,60,19,32,3,7,14,53,92,5,0,47,74,32,47,14,27,3,7,13,46,74
2008-05-18 00:00:00.000,Casablanca Morocco ATP World Tour,CLAY,2,Pablo Cuevas,Woong-Sun Jun,Pablo Cuevas,6-4; 6-1,R32,65,7,1,37,56,28,37,12,19,3,3,9,40,56,1,2,23,44,15,23,12,21,3,6,8,27,44
2008-05-18 00:00:00.000,Casablanca Morocco ATP World Tour,CLAY,2,Oscar Hernandez,Frank Dancevic,Oscar Hernandez,6-7(4); 6-4; 7-6(5),R32,174,3,2,84,121,57,84,22,37,6,8,17,79,121,10,2,86,134,66,86,17,48,12,15,17,83,134
2008-05-18 00:00:00.000,Casablanca Morocco ATP World Tour,CLAY,2,Gael Monfils,Guillermo Garcia-Lopez,Gael Monfils,6-7(8); 7-5; 6-0,R32,124,8,5,54,88,41,54,20,34,2,4,15,61,88,1,3,51,92,34,51,17,41,3,9,15,51,92
2008-05-18 00:00:00.000,Casablanca Morocco ATP World Tour,CLAY,2,Jo-Wilfried Tsonga,Lamine Ouahab,Jo-Wilfried Tsonga,6-3; 6-2,R16,68,7,0,43,56,34,43,8,13,1,1,9,42,56,2,1,34,51,21,34,8,17,1,4,8,29,51
2008-05-18 00:00:00.000,Casablanca Morocco ATP World Tour,CLAY,2,Santiago Ventura,Rainer Schuettler,Santiago Ventura,2-6; 6-4; 6-0,R16,111,4,3,43,75,32,43,15,32,2,5,12,47,75,2,0,51,73,27,51,12,22,2,7,12,39,73
2008-05-18 00:00:00.000,Casablanca Morocco ATP World Tour,CLAY,2,Marc Gicquel,Guillermo Coria,Marc Gicquel,6-1; 2-6; 7-6(2),R16,108,5,1,62,93,40,62,15,31,6,9,14,55,93,4,8,52,78,35,52,12,26,0,3,13,47,78
2008-05-18 00:00:00.000,Casablanca Morocco ATP World Tour,CLAY,2,Gilles Simon,Boris Pashanski,Gilles Simon,3-6; 6-4; 6-3,R16,148,5,3,55,88,38,55,14,33,5,9,14,52,88,2,3,54,104,33,54,22,50,6,11,14,55,104
2008-05-18 00:00:00.000,Casablanca Morocco ATP World Tour,CLAY,2,Younes El Aynaoui,Dominik Hrbaty,Younes El Aynaoui,6-3; 7-5,R16,96,10,0,34,64,26,34,14,30,2,5,11,40,64,4,7,41,66,28,41,6,25,1,6,10,34,66
2008-05-18 00:00:00.000,Casablanca Morocco ATP World Tour,CLAY,2,Agustin Calleri,Olivier Patience,Agustin Calleri,6-2; 7-5,R16,77,12,2,32,58,28,32,14,26,4,5,10,42,58,1,2,45,64,26,45,10,19,5,9,10,36,64
2008-05-18 00:00:00.000,Casablanca Morocco ATP World Tour,CLAY,2,Julien Benneteau,Pablo Cuevas,Julien Benneteau,6-4; 6-4,R16,67,4,3,35,50,26,35,11,15,1,2,10,37,50,2,1,31,55,19,31,14,24,2,5,10,33,55
2008-05-18 00:00:00.000,Casablanca Morocco ATP World Tour,CLAY,2,Oscar Hernandez,Gael Monfils,Oscar Hernandez,6-3; 6-2,R16,72,2,1,43,56,31,43,10,13,2,2,9,41,56,1,1,33,45,21,33,6,12,3,6,8,27,45
2008-05-18 00:00:00.000,Casablanca Morocco ATP World Tour,CLAY,2,Jo-Wilfried Tsonga,Santiago Ventura,Jo-Wilfried Tsonga,6-3; 6-3,Q,71,7,0,33,47,29,33,8,14,2,2,9,37,47,2,4,30,64,20,30,16,34,5,8,9,36,64
2008-05-18 00:00:00.000,Casablanca Morocco ATP World Tour,CLAY,2,Gilles Simon,Marc Gicquel,Gilles Simon,6-3; 6-2,Q,81,5,6,41,78,31,41,17,37,5,6,9,48,78,4,4,25,53,18,25,9,28,6,10,8,27,53
2008-05-18 00:00:00.000,Casablanca Morocco ATP World Tour,CLAY,2,Agustin Calleri,Younes El Aynaoui,Agustin Calleri,W/O,Q,0,0,0,0,0,0,0,0,0,0,0,0,0,0,0,0,0,0,0,0,0,0,0,0,0,0,0
2008-05-18 00:00:00.000,Casablanca Morocco ATP World Tour,CLAY,2,Julien Benneteau,Oscar Hernandez,Julien Benneteau,6-3; 5-2 RET,Q,74,5,2,39,48,28,39,5,9,2,3,8,33,48,1,2,41,54,22,41,5,13,3,7,8,27,54
2008-05-18 00:00:00.000,Casablanca Morocco ATP World Tour,CLAY,2,Gilles Simon,Jo-Wilfried Tsonga,Gilles Simon,W/O,S,0,0,0,0,0,0,0,0,0,0,0,0,0,0,0,0,0,0,0,0,0,0,0,0,0,0,0
2008-05-18 00:00:00.000,Casablanca Morocco ATP World Tour,CLAY,2,Julien Benneteau,Agustin Calleri,Julien Benneteau,1-6; 6-1; 6-3,S,99,6,1,48,74,31,48,12,26,3,7,12,43,74,8,2,46,72,29,46,8,26,5,10,11,37,72
2008-05-18 00:00:00.000,Casablanca Morocco ATP World Tour,CLAY,2,Gilles Simon,Julien Benneteau,Gilles Simon,7-5; 6-2,F,77,3,0,34,51,29,34,9,17,1,2,10,38,51,3,3,48,70,29,48,9,22,4,8,10,38,70
2008-05-18 00:00:00.000,Poertschach Austria ATP World Tour,CLAY,2,Nikolay Davydenko,Rainer Eitzinger,Nikolay Davydenko,6-1; 6-1,R32,57,3,0,33,43,25,33,6,10,2,2,7,31,43,0,1,34,47,14,34,4,13,3,8,7,18,47
2008-05-18 00:00:00.000,Poertschach Austria ATP World Tour,CLAY,2,John Isner,Simone Vagnozzi,John Isner,6-3; 6-2,R32,53,11,0,37,54,28,37,10,17,1,1,9,38,54,2,0,34,40,20,34,3,6,0,3,8,23,40
2008-05-18 00:00:00.000,Poertschach Austria ATP World Tour,CLAY,2,Dudi Sela,Mischa Zverev,Dudi Sela,7-6(2); 6-0,R32,94,1,3,43,67,31,43,14,24,6,7,9,45,67,0,1,33,58,18,33,12,25,2,6,9,30,58
2008-05-18 00:00:00.000,Poertschach Austria ATP World Tour,CLAY,2,Andreas Seppi,Ernests Gulbis,Andreas Seppi,1-6; 6-4; 6-3,R32,101,3,1,30,74,23,30,24,44,1,4,13,47,74,9,4,46,74,37,46,13,28,2,5,13,50,74
2008-05-18 00:00:00.000,Poertschach Austria ATP World Tour,CLAY,2,Igor Kunitsyn,Mardy Fish,Igor Kunitsyn,6-1; 6-1,R32,54,6,0,24,40,19,24,10,16,0,0,7,29,40,2,2,16,35,7,16,7,19,1,6,7,14,35
2008-05-18 00:00:00.000,Poertschach Austria ATP World Tour,CLAY,2,Blaz Kavcic,Teymuraz Gabashvili,Blaz Kavcic,4-6; 6-4; 7-6(3),R32,141,8,11,58,104,45,58,20,46,10,14,16,65,104,2,1,62,101,42,62,22,39,6,10,16,64,101
2008-05-18 00:00:00.000,Poertschach Austria ATP World Tour,CLAY,2,Jurgen Melzer,Donald Young,Jurgen Melzer,7-5; 6-2,R32,85,3,3,36,60,26,36,9,24,1,4,10,35,60,1,4,49,85,25,49,14,36,10,16,10,39,85
2008-05-18 00:00:00.000,Poertschach Austria ATP World Tour,CLAY,2,Robin Haase,Sergio Roitman,Robin Haase,7-6(7); 6-4,R32,93,8,3,53,79,40,53,10,26,2,4,11,50,79,1,1,49,79,32,49,16,30,4,7,11,48,79
2008-05-18 00:00:00.000,Poertschach Austria ATP World Tour,CLAY,2,Sam Querrey,Oliver Marach,Sam Querrey,3-6; 6-4; 6-4,R32,120,11,4,53,88,44,53,14,35,5,7,15,58,88,4,3,60,90,45,60,14,30,6,8,14,59,90
2008-05-18 00:00:00.000,Poertschach Austria ATP World Tour,CLAY,2,Daniel Gimeno-Traver,Werner Eschauer,Daniel Gimeno-Traver,6-4; 6-2,R32,64,4,0,32,47,20,32,13,15,3,4,9,33,47,2,3,31,56,17,31,11,25,4,8,9,28,56
2008-05-18 00:00:00.000,Poertschach Austria ATP World Tour,CLAY,2,Ivan Navarro,Vincent Spadea,Ivan Navarro,6-4; 6-4,R32,79,4,2,44,58,32,44,9,14,0,1,10,41,58,4,5,38,64,24,38,14,26,1,4,10,38,64
2008-05-18 00:00:00.000,Poertschach Austria ATP World Tour,CLAY,2,Ivan Ljubicic,Jan Hajek,Ivan Ljubicic,4-6; 6-0; 6-3,R32,98,12,0,55,88,43,55,16,33,5,6,13,59,88,2,1,37,66,24,37,12,29,0,4,12,36,66
2008-05-18 00:00:00.000,Poertschach Austria ATP World Tour,CLAY,2,Robby Ginepri,Mario Ancic,Robby Ginepri,4-6; 6-3; 7-6(8),R32,132,5,1,64,99,43,64,21,35,3,6,16,64,99,12,5,65,96,51,65,11,31,3,6,15,62,96
2008-05-18 00:00:00.000,Poertschach Austria ATP World Tour,CLAY,2,Olivier Rochus,Michal Przysiezny,Olivier Rochus,6-2; 6-4,R32,76,5,0,40,56,30,40,10,16,1,1,9,40,56,9,3,31,55,22,31,11,24,2,5,9,33,55
2008-05-18 00:00:00.000,Poertschach Austria ATP World Tour,CLAY,2,Jiri Vanek,Martin Verkerk,Jiri Vanek,7-5; 4-6; 6-2,R32,112,15,2,56,80,44,56,13,24,2,4,15,57,80,15,4,57,94,44,57,15,37,2,6,15,59,94
2008-05-18 00:00:00.000,Poertschach Austria ATP World Tour,CLAY,2,Juan Monaco,Carlos Berlocq,Juan Monaco,4-1 RET,R32,17,2,2,5,10,5,5,3,5,0,0,2,8,10,1,1,12,15,6,12,0,3,0,2,3,6,15
2008-05-18 00:00:00.000,Poertschach Austria ATP World Tour,CLAY,2,Nikolay Davydenko,John Isner,Nikolay Davydenko,6-2; 6-7(6); 6-3,R16,119,1,2,64,86,51,64,17,22,2,2,15,68,86,21,6,51,86,42,51,14,35,2,5,14,56,86
2008-05-18 00:00:00.000,Poertschach Austria ATP World Tour,CLAY,2,Andreas Seppi,Dudi Sela,Andreas Seppi,7-5; 6-1,R16,75,4,1,41,66,30,41,14,25,9,9,9,44,66,2,0,43,63,24,43,10,20,4,8,10,34,63
2008-05-18 00:00:00.000,Poertschach Austria ATP World Tour,CLAY,2,Igor Kunitsyn,Blaz Kavcic,Igor Kunitsyn,6-1; 6-4,R16,81,2,0,27,58,16,27,22,31,4,5,9,38,58,1,2,28,56,18,28,9,28,3,7,8,27,56
2008-05-18 00:00:00.000,Poertschach Austria ATP World Tour,CLAY,2,Jurgen Melzer,Robin Haase,Jurgen Melzer,6-3; 4-6; 6-2,R16,101,3,1,41,75,25,41,21,34,2,5,13,46,75,5,5,46,82,27,46,18,36,5,11,14,45,82
2008-05-18 00:00:00.000,Poertschach Austria ATP World Tour,CLAY,2,Daniel Gimeno-Traver,Sam Querrey,Daniel Gimeno-Traver,6-1; 6-3,R16,54,4,2,30,46,26,30,8,16,1,1,8,34,46,1,2,24,44,14,24,9,20,0,4,8,23,44
2008-05-18 00:00:00.000,Poertschach Austria ATP World Tour,CLAY,2,Ivan Ljubicic,Ivan Navarro,Ivan Ljubicic,7-6(3); 6-4,R16,76,15,1,39,60,36,39,14,21,0,0,11,50,60,6,1,41,58,32,41,12,17,0,1,11,44,58
2008-05-18 00:00:00.000,Poertschach Austria ATP World Tour,CLAY,2,Robby Ginepri,Olivier Rochus,Robby Ginepri,4-6; 6-2; 6-3,R16,131,8,1,60,100,36,60,20,40,15,19,14,56,100,2,4,47,80,27,47,13,33,4,10,13,40,80
2008-05-18 00:00:00.000,Poertschach Austria ATP World Tour,CLAY,2,Juan Monaco,Jiri Vanek,Juan Monaco,6-2; 6-2,R16,59,6,0,25,42,22,25,9,17,0,1,8,31,42,1,3,36,56,19,36,6,20,6,11,8,25,56
2008-05-18 00:00:00.000,Poertschach Austria ATP World Tour,CLAY,2,Nikolay Davydenko,Andreas Seppi,Nikolay Davydenko,6-3; 1-6; 6-3,Q,97,5,0,53,72,37,53,12,19,1,3,13,49,72,1,2,30,66,22,30,21,36,2,4,12,43,66
2008-05-18 00:00:00.000,Poertschach Austria ATP World Tour,CLAY,2,Igor Kunitsyn,Jurgen Melzer,Igor Kunitsyn,6-4; 3-6; 6-3,Q,138,3,1,55,98,39,55,21,43,10,14,14,60,98,7,0,53,95,33,53,20,42,6,11,14,53,95
2008-05-18 00:00:00.000,Poertschach Austria ATP World Tour,CLAY,2,Ivan Ljubicic,Daniel Gimeno-Traver,Ivan Ljubicic,6-3; 4-6; 7-6(6),Q,131,15,0,64,102,56,64,18,38,4,5,16,74,102,7,4,63,99,49,63,20,36,3,4,15,69,99
2008-05-18 00:00:00.000,Poertschach Austria ATP World Tour,CLAY,2,Juan Monaco,Robby Ginepri,Juan Monaco,7-5; 7-6(3),Q,106,3,4,52,85,33,52,17,33,7,11,12,50,85,5,1,51,82,30,51,14,31,6,11,12,44,82
2008-05-18 00:00:00.000,Poertschach Austria ATP World Tour,CLAY,2,Nikolay Davydenko,Igor Kunitsyn,Nikolay Davydenko,6-3; 6-2,S,83,2,0,27,49,21,27,14,22,1,2,9,35,49,0,1,35,60,20,35,10,25,5,9,8,30,60
2008-05-18 00:00:00.000,Poertschach Austria ATP World Tour,CLAY,2,Juan Monaco,Ivan Ljubicic,Juan Monaco,6-4; 6-7(4); 7-6(4),S,175,5,3,74,121,49,74,27,47,9,11,17,76,121,12,3,57,107,43,57,25,50,1,4,17,68,107
2008-05-18 00:00:00.000,Poertschach Austria ATP World Tour,CLAY,2,Nikolay Davydenko,Juan Monaco,Nikolay Davydenko,6-2; 2-6; 6-2,F,125,5,2,38,78,24,38,23,40,4,7,12,47,78,3,2,41,73,27,41,13,32,5,10,12,40,73
2008-05-25 00:00:00.000,Roland Garros France Grand Slams,CLAY,3,Roger Federer,Sam Querrey,Roger Federer,6-4; 6-4; 6-3,R128,95,5,1,53,79,42,53,14,26,1,2,14,56,79,6,4,41,92,26,41,28,51,7,12,15,54,92
2008-05-25 00:00:00.000,Roland Garros France Grand Slams,CLAY,3,Albert Montanes,Kristof Vliegen,Albert Montanes,7-6(5); 7-6(2); 7-6(3),R128,147,6,2,72,112,61,72,20,40,4,7,18,81,112,8,2,67,114,48,67,24,47,0,3,18,72,114
2008-05-25 00:00:00.000,Roland Garros France Grand Slams,CLAY,3,David Marrero,Victor Crivoi,David Marrero,6-3; 6-3; 5-7; 6-4,R128,153,5,1,81,118,55,81,30,37,5,7,20,85,118,14,3,86,114,57,86,16,28,10,15,20,73,114
2008-05-25 00:00:00.000,Roland Garros France Grand Slams,CLAY,3,Mario Ancic,Andreas Seppi,Mario Ancic,6-2; 7-6(1); 6-2,R128,137,9,1,56,83,41,56,17,27,6,8,14,58,83,4,4,72,103,38,72,14,31,7,13,14,52,103
2008-05-25 00:00:00.000,Roland Garros France Grand Slams,CLAY,3,Alejandro Falla,Ivo Karlovic,Alejandro Falla,3-6; 7-6(4); 7-6(6); 5-7; 6-4,R128,216,9,2,122,174,90,122,31,52,8,11,27,121,174,35,5,103,163,82,103,37,60,3,5,28,119,163
2008-05-25 00:00:00.000,Roland Garros France Grand Slams,CLAY,3,Julien Benneteau,Vincent Spadea,Julien Benneteau,6-4; 6-4; 3-6; 3-6; 6-3,R128,191,5,9,71,126,49,71,28,55,4,10,23,77,126,9,4,101,166,66,101,30,65,9,16,24,96,166
2008-05-25 00:00:00.000,Roland Garros France Grand Slams,CLAY,3,Paul Capdeville,Mischa Zverev,Paul Capdeville,6-1; 6-4; 6-2,R128,80,3,2,61,82,45,61,11,21,9,10,13,56,82,2,2,42,64,28,42,5,22,2,8,12,33,64
2008-05-25 00:00:00.000,Roland Garros France Grand Slams,CLAY,3,Robin Soderling,Juan Monaco,Robin Soderling,6-2; 6-3; 6-1,R128,102,9,0,41,69,33,41,17,28,2,2,12,50,69,3,0,62,90,34,62,12,28,3,9,12,46,90
2008-05-25 00:00:00.000,Roland Garros France Grand Slams,CLAY,3,Stanislas Wawrinka,Philipp Kohlschreiber,Stanislas Wawrinka,6-3; 6-4; 6-3,R128,108,7,3,52,79,36,52,17,27,3,6,14,53,79,0,3,53,88,31,53,15,35,7,14,14,46,88
2008-05-25 00:00:00.000,Roland Garros France Grand Slams,CLAY,3,Marin Cilic,Robin Haase,Marin Cilic,7-6(6); 6-2; 7-6(4),R128,167,7,5,74,136,52,74,35,62,14,16,16,87,136,5,5,75,128,51,75,26,53,5,9,16,77,128
2008-05-25 00:00:00.000,Roland Garros France Grand Slams,CLAY,3,Pablo Andujar,Filippo Volandri,Pablo Andujar,6-7(6); 6-2; 6-3; 6-3,R128,195,1,1,98,129,61,98,16,31,8,13,19,77,129,1,9,131,179,69,131,20,48,24,34,19,89,179
2008-05-25 00:00:00.000,Roland Garros France Grand Slams,CLAY,3,Fernando Gonzalez,Pablo Cuevas,Fernando Gonzalez,6-3; 6-3; 6-1,R128,94,10,4,50,81,41,50,17,31,2,2,13,58,81,4,3,54,77,29,54,10,23,5,10,12,39,77
2008-05-25 00:00:00.000,Roland Garros France Grand Slams,CLAY,3,Igor Andreev,Potito Starace,Igor Andreev,6-1; 6-7(3); 6-1; 6-4,R128,140,14,1,76,101,59,76,14,25,1,3,19,73,101,4,1,76,117,42,76,23,41,8,15,17,65,117
2008-05-25 00:00:00.000,Roland Garros France Grand Slams,CLAY,3,Robby Ginepri,Donald Young,Robby Ginepri,6-2; 3-6; 7-6(4); 6-2,R128,148,12,2,75,111,56,75,21,36,2,4,18,77,111,1,7,76,137,45,76,34,61,9,14,19,79,137
2008-05-25 00:00:00.000,Roland Garros France Grand Slams,CLAY,3,Victor Hanescu,Dudi Sela,Victor Hanescu,4-6; 6-2; 4-6; 6-4; 6-3,R128,213,7,1,115,157,73,115,25,42,12,18,24,98,157,2,5,98,157,63,98,25,59,11,19,23,88,157
2008-05-25 00:00:00.000,Roland Garros France Grand Slams,CLAY,3,Florent Serra,Santiago Giraldo,Florent Serra,6-4; 6-3; 6-2,R128,94,3,1,45,70,35,45,21,25,1,2,14,56,70,4,0,42,82,24,42,22,40,3,8,13,46,82
2008-05-25 00:00:00.000,Roland Garros France Grand Slams,CLAY,3,Nikolay Davydenko,Thomas Johansson,Nikolay Davydenko,6-3; 6-3; 6-3,R128,106,9,2,53,73,44,53,12,20,1,1,13,56,73,6,0,45,81,35,45,13,36,5,10,14,48,81
2008-05-25 00:00:00.000,Roland Garros France Grand Slams,CLAY,3,Marat Safin,Jean-Rene Lisnard,Marat Safin,6-7(5); 6-1; 6-3; 6-2,R128,171,15,4,80,115,61,80,18,35,1,2,18,79,115,2,7,83,143,53,83,25,60,9,16,18,78,143
2008-05-25 00:00:00.000,Roland Garros France Grand Slams,CLAY,3,Diego Junqueira,Adrian Mannarino,Diego Junqueira,6-1; 6-2; 6-2,R128,84,2,1,42,63,36,42,14,21,0,0,12,50,63,2,4,39,62,19,39,11,23,2,8,11,30,62
2008-05-25 00:00:00.000,Roland Garros France Grand Slams,CLAY,3,Ivan Ljubicic,Eric Prodon,Ivan Ljubicic,7-5; 7-6(6); 7-6(4),R128,140,29,1,65,101,57,65,24,36,0,0,18,81,101,8,1,79,131,53,79,33,52,6,7,18,86,131
2008-05-25 00:00:00.000,Roland Garros France Grand Slams,CLAY,3,Marcos Daniel,Juan Carlos Ferrero,Marcos Daniel,6-7(5); 2-2 RET,R128,93,7,1,36,64,25,36,14,28,4,6,8,39,64,2,2,47,64,28,47,9,17,0,2,8,37,64
2008-05-25 00:00:00.000,Roland Garros France Grand Slams,CLAY,3,Jurgen Melzer,Peter Luczak,Jurgen Melzer,6-3; 6-2; 6-4,R128,113,12,1,48,83,37,48,22,35,1,2,14,59,83,1,4,51,96,29,51,24,45,6,11,13,53,96
2008-05-25 00:00:00.000,Roland Garros France Grand Slams,CLAY,3,Gael Monfils,Arnaud Clement,Gael Monfils,7-5; 6-3; 6-1,R128,110,12,7,41,75,32,41,15,34,0,4,14,47,75,1,1,47,88,26,47,13,41,6,15,14,39,88
2008-05-25 00:00:00.000,Roland Garros France Grand Slams,CLAY,3,Luis Horna,Scoville Jenkins,Luis Horna,6-4; 5-7; 6-3; 6-0,R128,166,2,2,73,97,55,73,11,24,2,5,18,66,97,9,7,77,129,48,77,22,52,15,23,19,70,129
2008-05-25 00:00:00.000,Roland Garros France Grand Slams,CLAY,3,Tommy Robredo,Guillermo Coria,Tommy Robredo,5-7; 6-4; 6-1; 6-4,R128,165,5,0,92,128,59,92,13,36,5,11,19,72,128,0,14,77,117,44,77,13,40,11,21,20,57,117
2008-05-25 00:00:00.000,Roland Garros France Grand Slams,CLAY,3,Marc Gicquel,Viktor Troicki,Marc Gicquel,6-4; 6-3; 4-6; 7-5,R128,186,2,4,76,131,51,76,29,55,14,19,20,80,131,7,2,62,119,39,62,31,57,4,12,21,70,119
2008-05-25 00:00:00.000,Roland Garros France Grand Slams,CLAY,3,Jiri Vanek,Jesse Huta Galung,Jiri Vanek,6-3; 7-5; 6-2,R128,125,8,1,77,103,52,77,15,26,3,4,15,67,103,9,1,48,90,31,48,22,42,10,15,14,53,90
2008-05-25 00:00:00.000,Roland Garros France Grand Slams,CLAY,3,Radek Stepanek,Gilles Simon,Radek Stepanek,6-2; 6-4; 6-1,R128,117,2,4,48,84,40,48,14,36,6,7,12,54,84,0,2,38,80,17,38,22,42,3,10,13,39,80
2008-05-25 00:00:00.000,Roland Garros France Grand Slams,CLAY,3,Lleyton Hewitt,Nicolas Mahut,Lleyton Hewitt,6-4; 6-2; 6-4,R128,121,7,4,51,83,40,51,19,32,2,3,14,59,83,6,3,60,88,36,60,14,28,5,10,14,50,88
2008-05-25 00:00:00.000,Roland Garros France Grand Slams,CLAY,3,Mardy Fish,Agustin Calleri,Mardy Fish,6-7(6); 6-4; 6-2; 6-4,R128,171,13,0,70,135,54,70,34,65,4,6,20,88,135,11,7,82,139,57,82,24,57,9,15,20,81,139
2008-05-25 00:00:00.000,Roland Garros France Grand Slams,CLAY,3,Fabrice Santoro,Evgeny Korolev,Fabrice Santoro,7-6(3); 6-1; 6-4,R128,124,10,2,48,96,40,48,24,48,6,8,14,64,96,2,6,53,93,31,53,19,40,5,11,15,50,93
2008-05-25 00:00:00.000,Roland Garros France Grand Slams,CLAY,3,David Ferrer,Steve Darcis,David Ferrer,6-3; 6-4; 6-3,R128,134,2,1,67,95,45,67,17,28,6,7,14,62,95,3,1,60,106,40,60,19,46,5,10,14,59,106
2008-05-25 00:00:00.000,Roland Garros France Grand Slams,CLAY,3,James Blake,Rainer Schuettler,James Blake,6-4; 6-1; 7-6(3),R128,112,10,2,59,96,43,59,22,37,3,5,15,65,96,6,5,60,102,35,60,21,42,8,13,14,56,102
2008-05-25 00:00:00.000,Roland Garros France Grand Slams,CLAY,3,Ernests Gulbis,Simon Greul,Ernests Gulbis,6-4; 6-0; 6-4,R128,96,9,2,44,70,35,44,17,26,1,2,13,52,70,4,0,41,78,23,41,17,37,6,12,13,40,78
2008-05-25 00:00:00.000,Roland Garros France Grand Slams,CLAY,3,Bobby Reynolds,Thierry Ascione,Bobby Reynolds,7-6(2); 4-6; 6-3; 6-2,R128,172,20,3,81,131,62,81,24,50,2,4,20,86,131,4,3,73,119,53,73,20,46,2,6,19,73,119
2008-05-25 00:00:00.000,Roland Garros France Grand Slams,CLAY,3,Nicolas Lapentti,Janko Tipsarevic,Nicolas Lapentti,6-4; 4-6; 6-1; 7-6(7),R128,221,6,0,86,135,59,86,31,49,7,10,20,90,135,12,3,80,132,56,80,24,52,8,13,19,80,132
2008-05-25 00:00:00.000,Roland Garros France Grand Slams,CLAY,3,Simone Bolelli,Marcos Baghdatis,Simone Bolelli,6-2; 6-4; 6-2,R128,130,2,0,46,71,34,46,17,25,1,2,13,51,71,5,8,59,120,37,59,24,61,10,16,13,61,120
2008-05-25 00:00:00.000,Roland Garros France Grand Slams,CLAY,3,Juan Martin Del Potro,Josselin Ouanna,Juan Martin Del Potro,6-3; 6-2; 6-3,R128,121,8,3,46,82,41,46,18,36,5,5,13,59,82,5,2,39,86,29,39,17,47,4,9,13,46,86
2008-05-25 00:00:00.000,Roland Garros France Grand Slams,CLAY,3,Michael Llodra,Olivier Patience,Michael Llodra,3-6; 7-6(1); 6-3; 7-5,R128,157,21,6,82,122,65,82,24,40,4,5,20,89,122,6,6,104,149,72,104,24,45,4,7,22,96,149
2008-05-25 00:00:00.000,Roland Garros France Grand Slams,CLAY,3,Tomas Berdych,Robert Smeets,Tomas Berdych,6-1; 6-0; 6-0,R128,67,8,0,30,49,28,30,12,19,0,0,10,40,49,0,6,26,56,9,26,9,30,3,11,9,18,56
2008-05-25 00:00:00.000,Roland Garros France Grand Slams,CLAY,3,Eduardo Schwank,Carlos Moya,Eduardo Schwank,7-6(4); 6-2; 6-7(1); 4-6; 6-3,R128,238,5,3,91,155,64,91,51,64,7,8,26,115,155,10,2,98,164,71,98,39,66,4,7,25,110,164
2008-05-25 00:00:00.000,Roland Garros France Grand Slams,CLAY,3,Marcel Granollers,Michael Berrer,Marcel Granollers,6-3; 3-6; 6-2; 6-3,R128,154,5,5,77,119,53,77,23,42,9,12,18,76,119,5,2,77,99,47,77,13,22,4,10,17,60,99
2008-05-25 00:00:00.000,Roland Garros France Grand Slams,CLAY,3,Oscar Hernandez,Ivo Minar,Oscar Hernandez,4-6; 7-6(5); 6-3; 7-5,R128,218,4,2,98,150,62,98,31,52,1,5,22,93,150,6,2,84,129,59,84,20,45,2,7,21,79,129
2008-05-25 00:00:00.000,Roland Garros France Grand Slams,CLAY,3,Paul-Henri Mathieu,Gustavo Kuerten,Paul-Henri Mathieu,6-3; 6-4; 6-2,R128,109,6,1,48,76,40,48,17,28,2,3,14,57,76,9,2,47,89,32,47,18,42,6,11,13,50,89
2008-05-25 00:00:00.000,Roland Garros France Grand Slams,CLAY,3,Wayne Odesnik,Guillermo Canas,Wayne Odesnik,7-6(6); 7-6(3); 7-6(8),R128,227,5,1,99,146,67,99,27,47,9,11,18,94,146,10,3,65,132,49,65,35,67,7,9,18,84,132
2008-05-25 00:00:00.000,Roland Garros France Grand Slams,CLAY,3,Hyung-Taik Lee,Jonas Bjorkman,Hyung-Taik Lee,6-4; 6-4; 6-3,R128,129,4,3,57,91,44,57,17,34,5,6,14,61,91,3,2,76,104,51,76,7,28,8,13,15,58,104
2008-05-25 00:00:00.000,Roland Garros France Grand Slams,CLAY,3,Miguel Angel Lopez Jaen,Frank Dancevic,Miguel Angel Lopez Jaen,7-6(6); 3-6; 7-5; 7-6(2),R128,201,9,3,100,154,68,100,28,54,3,8,22,96,154,18,1,95,156,68,95,30,61,6,11,23,98,156
2008-05-25 00:00:00.000,Roland Garros France Grand Slams,CLAY,3,Novak Djokovic,Denis Gremelmayr,Novak Djokovic,4-6; 6-3; 7-5; 6-2,R128,149,5,3,75,112,50,75,22,37,3,7,20,72,112,3,5,46,100,30,46,29,54,5,12,19,59,100
2008-05-25 00:00:00.000,Roland Garros France Grand Slams,CLAY,3,David Nalbandian,Carlos Berlocq,David Nalbandian,6-2; 6-4; 6-1,R128,113,1,1,49,85,35,49,18,36,3,5,12,53,85,0,1,71,84,35,71,3,13,10,18,13,38,84
2008-05-25 00:00:00.000,Roland Garros France Grand Slams,CLAY,3,Jeremy Chardy,Frederico Gil,Jeremy Chardy,6-3; 6-2; 7-6(1),R128,107,9,3,55,78,46,55,13,23,2,4,15,59,78,2,3,64,99,43,64,12,35,8,13,14,55,99
2008-05-25 00:00:00.000,Roland Garros France Grand Slams,CLAY,3,Guillermo Garcia-Lopez,Sergio Roitman,Guillermo Garcia-Lopez,6-2; 6-4; 7-6(5),R128,132,3,3,66,103,43,66,23,37,6,9,15,66,103,1,1,53,84,32,53,17,31,3,9,15,49,84
2008-05-25 00:00:00.000,Roland Garros France Grand Slams,CLAY,3,Dmitry Tursunov,Daniel Brands,Dmitry Tursunov,6-2; 6-4; 7-5,R128,111,13,3,51,91,38,51,26,40,5,6,15,64,91,5,8,47,90,31,47,22,43,5,10,15,53,90
2008-05-25 00:00:00.000,Roland Garros France Grand Slams,CLAY,3,Nicolas Almagro,Boris Pashanski,Nicolas Almagro,6-4; 7-5; 6-1,R128,114,20,1,58,92,47,58,19,34,7,7,14,66,92,4,5,46,91,31,46,22,45,3,8,15,53,91
2008-05-25 00:00:00.000,Roland Garros France Grand Slams,CLAY,3,Sebastian Decoud,Olivier Rochus,Sebastian Decoud,3-6; 6-4; 6-3; 6-7(8); 6-1,R128,232,14,2,122,163,84,122,20,41,10,12,24,104,163,4,3,102,144,66,102,25,42,7,12,23,91,144
2008-05-25 00:00:00.000,Roland Garros France Grand Slams,CLAY,3,Jose Acasuso,Dominik Hrbaty,Jose Acasuso,6-4; 6-2; 6-4,R128,138,4,2,41,77,30,41,22,36,1,3,14,52,77,1,5,58,106,36,58,19,48,4,10,14,55,106
2008-05-25 00:00:00.000,Roland Garros France Grand Slams,CLAY,3,Andy Murray,Jonathan Eysseric,Andy Murray,6-2; 1-6; 4-6; 6-0; 6-2,R128,164,3,0,72,113,49,72,18,41,8,15,19,67,113,1,7,66,132,41,66,25,66,6,17,20,66,132
2008-05-25 00:00:00.000,Roland Garros France Grand Slams,CLAY,3,Mikhail Youzhny,Benjamin Becker,Mikhail Youzhny,6-1; 6-3; 7-6(4),R128,134,6,1,49,84,39,49,25,35,5,6,14,64,84,7,1,45,98,31,45,23,53,11,16,14,54,98
2008-05-25 00:00:00.000,Roland Garros France Grand Slams,CLAY,3,Maximo Gonzalez,Roko Karanusic,Maximo Gonzalez,6-3; 7-5; 4-6; 3-6; 6-2,R128,215,2,5,108,168,67,108,28,60,17,25,24,95,168,6,3,81,155,49,81,33,74,12,22,24,82,155
2008-05-25 00:00:00.000,Roland Garros France Grand Slams,CLAY,3,Juan Ignacio Chela,John Isner,Juan Ignacio Chela,2-6; 3-6; 7-5; 6-3; 6-4,R128,207,4,3,130,168,91,130,20,38,17,20,24,111,168,15,7,102,151,82,102,22,49,10,13,24,104,151
2008-05-25 00:00:00.000,Roland Garros France Grand Slams,CLAY,3,Fernando Verdasco,Santiago Ventura,Fernando Verdasco,4-6; 6-3; 6-4; 6-7(6); 6-1,R128,220,1,7,117,164,78,117,24,47,9,14,25,102,164,10,6,82,164,57,82,35,82,6,14,23,92,164
2008-05-25 00:00:00.000,Roland Garros France Grand Slams,CLAY,3,Jarkko Nieminen,Marc Lopez,Jarkko Nieminen,2-6; 6-3; 6-4; 6-3,R128,167,8,4,97,131,61,97,18,34,14,18,18,79,131,1,0,64,104,42,64,18,40,7,13,18,60,104
2008-05-25 00:00:00.000,Roland Garros France Grand Slams,CLAY,3,Martin Vassallo Arguello,Feliciano Lopez,Martin Vassallo Arguello,7-6(1); 6-4; 3-6; 4-6; 6-3,R128,214,7,5,128,171,82,128,27,43,10,13,25,109,171,13,5,97,150,69,97,31,53,7,10,25,100,150
2008-05-25 00:00:00.000,Roland Garros France Grand Slams,CLAY,3,Nicolas Devilder,Chris Guccione,Nicolas Devilder,6-4; 6-1; 6-4,R128,105,3,4,48,77,39,48,17,29,1,2,14,56,77,12,2,59,97,38,59,17,38,7,12,13,55,97
2008-05-25 00:00:00.000,Roland Garros France Grand Slams,CLAY,3,Rafael Nadal,Thomaz Bellucci,Rafael Nadal,7-5; 6-3; 6-1,R128,154,2,1,67,90,46,67,14,23,2,4,14,60,90,3,5,49,91,25,49,22,42,6,13,14,47,91
2008-05-25 00:00:00.000,Roland Garros France Grand Slams,CLAY,3,Roger Federer,Albert Montanes,Roger Federer,6-7(5); 6-1; 6-0; 6-4,R64,145,13,1,76,110,65,76,18,34,6,6,18,83,110,2,8,83,135,49,83,25,52,12,18,17,74,135
2008-05-25 00:00:00.000,Roland Garros France Grand Slams,CLAY,3,Mario Ancic,David Marrero,Mario Ancic,4-6; 6-0; 6-3; 6-2,R64,162,17,1,67,105,52,67,22,38,9,10,17,74,105,1,2,54,108,33,54,26,54,5,11,16,59,108
2008-05-25 00:00:00.000,Roland Garros France Grand Slams,CLAY,3,Julien Benneteau,Alejandro Falla,Julien Benneteau,1-6; 7-6(6); 6-3; 6-7(4); 6-0,R64,228,5,3,124,169,82,124,23,45,11,17,24,105,169,5,1,91,151,57,91,29,60,8,15,22,86,151
2008-05-25 00:00:00.000,Roland Garros France Grand Slams,CLAY,3,Robin Soderling,Paul Capdeville,Robin Soderling,6-3; 6-2; 6-4,R64,102,12,2,61,90,47,61,13,29,8,9,14,60,90,3,1,61,89,38,61,12,28,5,10,13,50,89
2008-05-25 00:00:00.000,Roland Garros France Grand Slams,CLAY,3,Stanislas Wawrinka,Marin Cilic,Stanislas Wawrinka,7-6(3); 7-6(4); 6-1,R64,164,3,1,62,103,43,62,26,41,2,6,16,69,103,6,6,49,107,36,49,23,58,6,12,15,59,107
2008-05-25 00:00:00.000,Roland Garros France Grand Slams,CLAY,3,Fernando Gonzalez,Pablo Andujar,Fernando Gonzalez,7-5; 6-0; 6-7(4); 7-6(3),R64,168,15,5,83,138,61,83,32,55,7,9,21,93,138,6,1,127,144,76,127,9,17,9,15,21,85,144
2008-05-25 00:00:00.000,Roland Garros France Grand Slams,CLAY,3,Robby Ginepri,Igor Andreev,Robby Ginepri,4-6; 6-2; 7-6(5); 6-2,R64,170,4,1,89,122,63,89,21,33,5,7,19,84,122,10,2,82,130,57,82,22,48,9,14,19,79,130
2008-05-25 00:00:00.000,Roland Garros France Grand Slams,CLAY,3,Florent Serra,Victor Hanescu,Florent Serra,6-4; 6-3; 6-7(5); 7-6(5),R64,181,4,4,79,139,60,79,33,60,8,13,22,93,139,11,2,115,155,79,115,12,40,11,18,21,91,155
2008-05-25 00:00:00.000,Roland Garros France Grand Slams,CLAY,3,Nikolay Davydenko,Marat Safin,Nikolay Davydenko,7-6(4); 6-2; 6-2,R64,136,9,2,60,85,45,60,15,25,3,4,14,60,85,6,2,60,110,41,60,18,50,8,13,14,59,110
2008-05-25 00:00:00.000,Roland Garros France Grand Slams,CLAY,3,Ivan Ljubicic,Diego Junqueira,Ivan Ljubicic,6-3; 6-4; 6-2,R64,107,13,2,49,81,43,49,16,32,3,3,14,59,81,2,3,40,79,29,40,19,39,8,12,13,48,79
2008-05-25 00:00:00.000,Roland Garros France Grand Slams,CLAY,3,Jurgen Melzer,Marcos Daniel,Jurgen Melzer,4-6; 6-3; 2-6; 6-3; 6-4,R64,194,9,4,87,134,66,87,25,47,9,12,23,91,134,6,1,109,155,76,109,24,46,13,17,23,100,155
2008-05-25 00:00:00.000,Roland Garros France Grand Slams,CLAY,3,Gael Monfils,Luis Horna,Gael Monfils,7-6(5); 6-4; 7-5,R64,179,5,15,59,120,45,59,30,61,5,8,17,75,120,0,4,84,113,52,84,14,29,5,10,17,66,113
2008-05-25 00:00:00.000,Roland Garros France Grand Slams,CLAY,3,Tommy Robredo,Marc Gicquel,Tommy Robredo,6-7(7); 6-4; 6-4; 6-4,R64,225,2,0,110,147,74,110,23,37,4,7,21,97,147,5,4,86,164,62,86,36,78,18,24,21,98,164
2008-05-25 00:00:00.000,Roland Garros France Grand Slams,CLAY,3,Radek Stepanek,Jiri Vanek,Radek Stepanek,6-1; 6-0; 6-7(7); 6-3,R64,143,11,2,65,102,52,65,20,37,2,2,16,72,102,8,4,72,128,51,72,20,56,11,19,18,71,128
2008-05-25 00:00:00.000,Roland Garros France Grand Slams,CLAY,3,Lleyton Hewitt,Mardy Fish,Lleyton Hewitt,6-4; 6-3; 6-2,R64,126,8,1,38,72,25,38,19,34,3,7,13,44,72,6,7,39,102,24,39,23,63,11,20,14,47,102
2008-05-25 00:00:00.000,Roland Garros France Grand Slams,CLAY,3,David Ferrer,Fabrice Santoro,David Ferrer,6-0; 6-1; 6-0,R64,84,2,0,49,54,39,49,4,5,2,2,10,43,54,0,1,37,67,16,37,9,30,4,12,9,25,67
2008-05-25 00:00:00.000,Roland Garros France Grand Slams,CLAY,3,Ernests Gulbis,James Blake,Ernests Gulbis,7-6(2); 3-6; 7-5; 6-3,R64,156,11,4,77,124,59,77,30,47,5,7,21,89,124,4,0,88,144,57,88,34,56,7,10,21,91,144
2008-05-25 00:00:00.000,Roland Garros France Grand Slams,CLAY,3,Nicolas Lapentti,Bobby Reynolds,Nicolas Lapentti,7-5; 6-4; 5-7; 7-5,R64,221,10,4,95,146,70,95,26,51,6,9,23,96,146,6,8,90,149,63,90,29,59,6,11,23,92,149
2008-05-25 00:00:00.000,Roland Garros France Grand Slams,CLAY,3,Simone Bolelli,Juan Martin Del Potro,Simone Bolelli,3-6; 7-6(0); 7-5; 6-2,R64,190,7,3,92,134,65,92,24,42,12,15,20,89,134,12,3,66,117,48,66,27,51,3,8,21,75,117
2008-05-25 00:00:00.000,Roland Garros France Grand Slams,CLAY,3,Michael Llodra,Tomas Berdych,Michael Llodra,6-3; 4-6; 5-7; 6-3; 6-4,R64,186,10,6,94,157,72,94,29,63,10,13,25,101,157,12,4,78,120,66,78,21,42,5,10,25,87,120
2008-05-25 00:00:00.000,Roland Garros France Grand Slams,CLAY,3,Eduardo Schwank,Marcel Granollers,Eduardo Schwank,6-7(5); 6-2; 6-4; 6-4,R64,193,5,2,89,130,67,89,29,41,5,5,20,96,130,5,0,102,142,65,102,24,40,9,13,20,89,142
2008-05-25 00:00:00.000,Roland Garros France Grand Slams,CLAY,3,Paul-Henri Mathieu,Oscar Hernandez,Paul-Henri Mathieu,2-6; 1-6; 6-4; 6-3; 6-2,R64,251,4,8,86,147,58,86,28,61,16,22,21,86,147,4,4,96,157,58,96,29,61,14,20,21,87,157
2008-05-25 00:00:00.000,Roland Garros France Grand Slams,CLAY,3,Wayne Odesnik,Hyung-Taik Lee,Wayne Odesnik,6-2; 4-6; 6-3; 6-2,R64,140,11,1,74,118,58,74,22,44,4,5,18,80,118,4,2,76,109,49,76,15,33,8,13,17,64,109
2008-05-25 00:00:00.000,Roland Garros France Grand Slams,CLAY,3,Novak Djokovic,Miguel Angel Lopez Jaen,Novak Djokovic,6-1; 6-1; 6-3,R64,80,3,2,45,68,36,45,15,23,0,0,12,51,68,6,2,46,69,26,46,6,23,4,10,11,32,69
2008-05-25 00:00:00.000,Roland Garros France Grand Slams,CLAY,3,Jeremy Chardy,David Nalbandian,Jeremy Chardy,3-6; 4-6; 6-2; 6-1; 6-2,R64,183,18,10,88,161,62,88,34,73,10,14,21,96,161,10,4,72,131,48,72,27,59,10,18,21,75,131
2008-05-25 00:00:00.000,Roland Garros France Grand Slams,CLAY,3,Dmitry Tursunov,Guillermo Garcia-Lopez,Dmitry Tursunov,7-6(4); 6-0; 6-0,R64,139,11,1,65,110,43,65,23,45,12,13,12,66,110,1,2,53,81,23,53,14,28,8,15,12,37,81
2008-05-25 00:00:00.000,Roland Garros France Grand Slams,CLAY,3,Nicolas Almagro,Sebastian Decoud,Nicolas Almagro,7-6(2); 6-2; 6-1,R64,118,18,2,33,71,30,33,26,38,0,1,13,56,71,3,3,59,95,39,59,14,36,7,13,14,53,95
2008-05-25 00:00:00.000,Roland Garros France Grand Slams,CLAY,3,Andy Murray,Jose Acasuso,Andy Murray,6-4; 6-0; 6-4,R64,98,9,0,56,84,45,56,15,28,6,6,13,60,84,0,9,44,83,34,44,12,39,3,8,13,46,83
2008-05-25 00:00:00.000,Roland Garros France Grand Slams,CLAY,3,Mikhail Youzhny,Maximo Gonzalez,Mikhail Youzhny,6-3; 6-2; 6-2,R64,108,3,2,52,83,38,52,22,31,3,3,13,60,83,0,0,52,90,30,52,18,38,7,12,12,48,90
2008-05-25 00:00:00.000,Roland Garros France Grand Slams,CLAY,3,Fernando Verdasco,Juan Ignacio Chela,Fernando Verdasco,7-5; 4-6; 6-3; 7-5,R64,206,5,10,102,148,65,102,18,46,12,20,22,83,148,2,3,107,151,53,107,25,44,14,24,21,78,151
2008-05-25 00:00:00.000,Roland Garros France Grand Slams,CLAY,3,Jarkko Nieminen,Martin Vassallo Arguello,Jarkko Nieminen,7-5; 6-1; 3-6; 7-6(2),R64,178,0,1,91,124,63,91,17,33,0,3,20,80,124,2,3,83,128,52,83,25,45,5,10,20,77,128
2008-05-25 00:00:00.000,Roland Garros France Grand Slams,CLAY,3,Rafael Nadal,Nicolas Devilder,Rafael Nadal,6-4; 6-0; 6-1,R64,114,1,1,51,74,35,51,15,23,7,8,12,50,74,1,3,52,69,25,52,5,17,2,9,11,30,69
2008-05-25 00:00:00.000,Roland Garros France Grand Slams,CLAY,3,Roger Federer,Mario Ancic,Roger Federer,6-3; 6-4; 6-2,R32,96,8,1,45,71,36,45,20,26,2,3,14,56,71,2,0,47,75,31,47,10,28,2,7,13,41,75
2008-05-25 00:00:00.000,Roland Garros France Grand Slams,CLAY,3,Julien Benneteau,Robin Soderling,Julien Benneteau,1-6; 7-6(6); 6-0; 6-1,R32,143,3,3,63,96,40,63,22,33,8,11,15,62,96,5,2,80,108,47,80,12,28,7,14,17,59,108
2008-05-25 00:00:00.000,Roland Garros France Grand Slams,CLAY,3,Fernando Gonzalez,Stanislas Wawrinka,Fernando Gonzalez,5-7; 2-6; 6-4; 6-4; 6-4,R32,199,5,2,100,141,77,100,19,41,8,12,25,96,141,9,1,102,153,76,102,27,51,10,14,25,103,153
2008-05-25 00:00:00.000,Roland Garros France Grand Slams,CLAY,3,Robby Ginepri,Florent Serra,Robby Ginepri,6-4; 6-4; 6-4,R32,104,3,0,56,86,42,56,20,30,6,7,15,62,86,2,2,67,95,47,67,11,28,7,11,15,58,95
2008-05-25 00:00:00.000,Roland Garros France Grand Slams,CLAY,3,Ivan Ljubicic,Nikolay Davydenko,Ivan Ljubicic,4-6; 2-6; 6-3; 6-2; 6-4,R32,193,15,2,88,149,62,88,31,61,7,11,23,93,149,8,2,80,110,55,80,20,30,0,5,22,75,110
2008-05-25 00:00:00.000,Roland Garros France Grand Slams,CLAY,3,Gael Monfils,Jurgen Melzer,Gael Monfils,4-6; 7-5; 4-6; 6-0; 6-2,R32,180,19,6,95,148,70,95,26,53,15,18,23,96,148,1,3,76,126,46,76,28,50,5,12,23,74,126
2008-05-25 00:00:00.000,Roland Garros France Grand Slams,CLAY,3,Radek Stepanek,Tommy Robredo,Radek Stepanek,6-3; 6-2; 6-1,R32,109,4,3,45,73,39,45,15,28,4,4,12,54,73,1,0,53,77,30,53,11,24,6,12,12,41,77
2008-05-25 00:00:00.000,Roland Garros France Grand Slams,CLAY,3,David Ferrer,Lleyton Hewitt,David Ferrer,6-2; 3-6; 3-6; 6-3; 6-4,R32,215,8,4,83,136,59,83,27,53,5,10,23,86,136,8,4,82,147,52,82,33,65,9,15,22,85,147
2008-05-25 00:00:00.000,Roland Garros France Grand Slams,CLAY,3,Ernests Gulbis,Nicolas Lapentti,Ernests Gulbis,6-3; 7-5; 6-2,R32,127,8,3,41,77,32,41,24,36,0,2,15,56,77,0,3,58,98,32,58,20,40,9,15,14,52,98
2008-05-25 00:00:00.000,Roland Garros France Grand Slams,CLAY,3,Michael Llodra,Simone Bolelli,Michael Llodra,7-6(2); 6-4; 7-6(5),R32,155,17,2,74,115,62,74,23,41,5,6,17,85,115,2,2,92,118,64,92,15,26,6,8,17,79,118
2008-05-25 00:00:00.000,Roland Garros France Grand Slams,CLAY,3,Paul-Henri Mathieu,Eduardo Schwank,Paul-Henri Mathieu,6-2; 6-3; 3-6; 7-6(9),R32,182,7,1,70,113,52,70,25,43,1,5,19,77,113,8,6,81,131,51,81,23,50,7,13,19,74,131
2008-05-25 00:00:00.000,Roland Garros France Grand Slams,CLAY,3,Novak Djokovic,Wayne Odesnik,Novak Djokovic,7-5; 6-4; 6-2,R32,137,10,0,59,85,42,59,15,26,3,6,15,57,85,10,3,62,119,37,62,24,57,5,12,15,61,119
2008-05-25 00:00:00.000,Roland Garros France Grand Slams,CLAY,3,Jeremy Chardy,Dmitry Tursunov,Jeremy Chardy,7-6(1); 6-3; 6-4,R32,124,8,3,63,98,49,63,20,35,1,2,16,69,98,11,3,56,103,44,56,17,47,3,6,15,61,103
2008-05-25 00:00:00.000,Roland Garros France Grand Slams,CLAY,3,Nicolas Almagro,Andy Murray,Nicolas Almagro,6-3; 6-7(3); 6-3; 7-5,R32,169,21,5,71,126,57,71,34,55,3,5,22,91,126,10,9,67,136,51,67,30,69,12,17,20,81,136
2008-05-25 00:00:00.000,Roland Garros France Grand Slams,CLAY,3,Fernando Verdasco,Mikhail Youzhny,Fernando Verdasco,7-6(5); 5-7; 7-5; 6-1,R32,204,3,4,110,131,72,110,11,21,3,9,22,83,131,8,6,70,132,47,70,25,62,3,11,21,72,132
2008-05-25 00:00:00.000,Roland Garros France Grand Slams,CLAY,3,Rafael Nadal,Jarkko Nieminen,Rafael Nadal,6-1; 6-3; 6-1,R32,118,3,1,55,78,40,55,11,23,7,8,12,51,78,0,0,49,74,26,49,5,25,6,13,11,31,74
2008-05-25 00:00:00.000,Roland Garros France Grand Slams,CLAY,3,Roger Federer,Julien Benneteau,Roger Federer,6-4; 7-5; 7-5,R16,146,6,3,52,98,40,52,26,46,7,10,17,66,98,5,1,74,118,38,74,28,44,10,16,17,66,118
2008-05-25 00:00:00.000,Roland Garros France Grand Slams,CLAY,3,Fernando Gonzalez,Robby Ginepri,Fernando Gonzalez,7-6(4); 6-3; 6-1,R16,113,10,1,64,88,44,64,16,24,4,6,14,60,88,2,2,61,99,31,61,20,38,8,14,14,51,99
2008-05-25 00:00:00.000,Roland Garros France Grand Slams,CLAY,3,Gael Monfils,Ivan Ljubicic,Gael Monfils,7-6(1); 4-6; 6-3; 6-2,R16,171,12,4,64,114,53,64,25,50,1,4,20,78,114,10,3,70,117,49,70,22,47,5,10,19,71,117
2008-05-25 00:00:00.000,Roland Garros France Grand Slams,CLAY,3,David Ferrer,Radek Stepanek,David Ferrer,4-6; 6-2; 1-6; 6-3; 6-3,R16,172,2,2,91,123,54,91,19,32,8,16,22,73,123,4,9,53,118,36,53,27,65,2,11,21,63,118
2008-05-25 00:00:00.000,Roland Garros France Grand Slams,CLAY,3,Ernests Gulbis,Michael Llodra,Ernests Gulbis,6-4; 7-6(4); 6-3,R16,129,11,2,55,95,44,55,26,40,3,4,16,70,95,2,6,62,102,40,62,20,40,7,10,15,60,102
2008-05-25 00:00:00.000,Roland Garros France Grand Slams,CLAY,3,Novak Djokovic,Paul-Henri Mathieu,Novak Djokovic,6-4; 6-3; 6-4,R16,140,14,1,54,77,45,54,11,23,7,8,14,56,77,8,4,63,111,45,63,18,48,7,12,15,63,111
2008-05-25 00:00:00.000,Roland Garros France Grand Slams,CLAY,3,Nicolas Almagro,Jeremy Chardy,Nicolas Almagro,7-6(0); 7-6(7); 7-5,R16,168,19,4,69,124,55,69,32,55,6,7,18,87,124,10,12,92,160,67,92,29,68,15,17,18,96,160
2008-05-25 00:00:00.000,Roland Garros France Grand Slams,CLAY,3,Rafael Nadal,Fernando Verdasco,Rafael Nadal,6-1; 6-0; 6-2,R16,114,1,1,44,69,30,44,15,25,3,5,11,45,69,1,6,47,70,20,47,7,23,6,15,10,27,70
2008-05-25 00:00:00.000,Roland Garros France Grand Slams,CLAY,3,Roger Federer,Fernando Gonzalez,Roger Federer,2-6; 6-2; 6-3; 6-4,Q,121,11,0,62,96,44,62,24,34,3,6,18,68,96,3,0,72,100,40,72,17,28,8,13,17,57,100
2008-05-25 00:00:00.000,Roland Garros France Grand Slams,CLAY,3,Gael Monfils,David Ferrer,Gael Monfils,6-3; 3-6; 6-3; 6-1,Q,147,10,5,55,100,44,55,24,45,5,7,17,68,100,1,1,67,104,40,67,20,37,7,13,17,60,104
2008-05-25 00:00:00.000,Roland Garros France Grand Slams,CLAY,3,Novak Djokovic,Ernests Gulbis,Novak Djokovic,7-5; 7-6(3); 7-5,Q,187,6,1,82,125,58,82,24,43,4,6,18,82,125,12,7,85,138,58,85,24,53,12,16,18,82,138
2008-05-25 00:00:00.000,Roland Garros France Grand Slams,CLAY,3,Rafael Nadal,Nicolas Almagro,Rafael Nadal,6-1; 6-1; 6-1,Q,104,1,1,44,65,36,44,11,21,5,5,10,47,65,3,3,25,65,13,25,14,40,5,13,11,27,65
2008-05-25 00:00:00.000,Roland Garros France Grand Slams,CLAY,3,Roger Federer,Gael Monfils,Roger Federer,6-2; 5-7; 6-3; 7-5,S,185,2,1,97,136,67,97,20,39,10,13,20,87,136,10,5,89,150,62,89,22,61,8,15,21,84,150
2008-05-25 00:00:00.000,Roland Garros France Grand Slams,CLAY,3,Rafael Nadal,Novak Djokovic,Rafael Nadal,6-4; 6-2; 7-6(3),S,169,0,0,71,98,47,71,19,27,4,6,15,66,98,2,1,54,100,31,54,27,46,9,14,15,58,100
2008-05-25 00:00:00.000,Roland Garros France Grand Slams,CLAY,3,Rafael Nadal,Roger Federer,Rafael Nadal,6-1; 6-3; 6-0,F,108,0,0,50,67,35,50,11,17,3,4,11,46,67,2,0,53,77,26,53,5,24,9,17,11,31,77
2008-06-09 00:00:00.000,Halle Germany ATP World Tour,GRASS,2,Roger Federer,Michael Berrer,Roger Federer,6-4; 6-2,R32,62,11,1,37,48,33,37,5,11,1,1,9,38,48,2,3,39,58,28,39,6,19,3,6,9,34,58
2008-06-09 00:00:00.000,Halle Germany ATP World Tour,GRASS,2,Jan Vacek,Scott Lipsky,Jan Vacek,3-6; 6-3; 6-2,R32,84,3,4,47,77,35,47,17,30,0,1,13,52,77,8,3,48,77,33,48,15,29,1,4,13,48,77
2008-06-09 00:00:00.000,Halle Germany ATP World Tour,GRASS,2,Fabrice Santoro,Rainer Schuettler,Fabrice Santoro,7-6(4); 6-4,R32,115,4,2,52,84,37,52,16,32,7,8,11,53,84,3,1,47,86,29,47,20,39,8,10,11,49,86
2008-06-09 00:00:00.000,Halle Germany ATP World Tour,GRASS,2,Marcos Baghdatis,Jan Hernych,Marcos Baghdatis,6-4; 7-5,R32,73,6,6,27,58,23,27,21,31,0,0,11,44,58,3,1,50,68,34,50,10,18,1,3,11,44,68
2008-06-09 00:00:00.000,Halle Germany ATP World Tour,GRASS,2,Mikhail Youzhny,Dmitry Tursunov,Mikhail Youzhny,6-3; 6-1,R32,68,3,0,29,52,22,29,15,23,3,3,8,37,52,3,2,36,53,24,36,4,17,5,9,8,28,53
2008-06-09 00:00:00.000,Halle Germany ATP World Tour,GRASS,2,Nicolas Kiefer,Robin Haase,Nicolas Kiefer,4-6; 6-3; 6-2,R32,96,11,3,46,76,40,46,18,30,3,4,14,58,76,7,2,36,74,29,36,19,38,2,5,13,48,74
2008-06-09 00:00:00.000,Halle Germany ATP World Tour,GRASS,2,Steve Darcis,Olivier Rochus,Steve Darcis,6-1; 6-4,R32,53,6,1,31,56,24,31,16,25,1,1,9,40,56,1,0,28,45,15,28,10,17,2,5,8,25,45
2008-06-09 00:00:00.000,Halle Germany ATP World Tour,GRASS,2,Michael Llodra,Ivan Ljubicic,Michael Llodra,6-7(6); 7-6(5); 7-5,R32,152,20,7,81,126,65,81,23,45,8,8,18,88,126,19,3,73,112,61,73,19,39,3,4,18,80,112
2008-06-09 00:00:00.000,Halle Germany ATP World Tour,GRASS,2,Tommy Haas,Radek Stepanek,Tommy Haas,6-7(0); 7-6(3); 6-4,R32,138,19,3,78,112,60,78,18,34,4,4,17,78,112,12,4,66,100,54,66,19,34,1,2,17,73,100
2008-06-09 00:00:00.000,Halle Germany ATP World Tour,GRASS,2,Philipp Kohlschreiber,Julien Benneteau,Philipp Kohlschreiber,6-4; 6-1,R32,69,6,2,30,52,26,30,12,22,2,2,9,38,52,6,4,38,51,24,38,4,13,3,6,8,28,51
2008-06-09 00:00:00.000,Halle Germany ATP World Tour,GRASS,2,Robin Soderling,Philipp Petzschner,Robin Soderling,6-4; 4-6; 6-4,R32,110,11,3,62,88,47,62,12,26,3,5,15,59,88,10,10,52,101,40,52,23,49,3,6,15,63,101
2008-06-09 00:00:00.000,Halle Germany ATP World Tour,GRASS,2,Tomas Berdych,Thomas Johansson,Tomas Berdych,6-3; 7-5,R32,78,9,1,36,60,31,36,12,24,2,3,11,43,60,11,3,36,70,27,36,14,34,8,11,10,41,70
2008-06-09 00:00:00.000,Halle Germany ATP World Tour,GRASS,2,Mischa Zverev,Jarkko Nieminen,Mischa Zverev,2-6; 6-4; 6-2,R32,80,4,0,62,85,41,62,17,23,10,12,13,58,85,3,2,47,70,31,47,15,23,2,5,13,46,70
2008-06-09 00:00:00.000,Halle Germany ATP World Tour,GRASS,2,Andreas Beck,Marc Gicquel,Andreas Beck,6-7(4); 7-6(4); 6-3,R32,154,14,11,79,127,57,79,26,48,3,4,17,83,127,19,2,66,105,53,66,21,39,3,5,16,74,105
2008-06-09 00:00:00.000,Halle Germany ATP World Tour,GRASS,2,Benjamin Becker,Denis Gremelmayr,Benjamin Becker,6-4; 6-2,R32,68,8,3,28,52,26,28,13,24,1,1,9,39,52,7,5,38,67,25,38,12,29,5,8,9,37,67
2008-06-09 00:00:00.000,Halle Germany ATP World Tour,GRASS,2,James Blake,Bjorn Phau,James Blake,6-4; 6-1,R32,50,8,2,25,41,21,25,12,16,0,0,8,33,41,2,2,18,47,10,18,15,29,0,4,9,25,47
2008-06-09 00:00:00.000,Halle Germany ATP World Tour,GRASS,2,Roger Federer,Jan Vacek,Roger Federer,7-5; 6-3,R16,70,5,0,43,56,35,43,9,13,0,0,11,44,56,2,3,39,70,29,39,14,31,5,7,10,43,70
2008-06-09 00:00:00.000,Halle Germany ATP World Tour,GRASS,2,Marcos Baghdatis,Fabrice Santoro,Marcos Baghdatis,6-4; 6-3,R16,73,8,3,31,55,26,31,11,24,1,3,10,37,55,0,2,38,58,25,38,7,20,1,5,9,32,58
2008-06-09 00:00:00.000,Halle Germany ATP World Tour,GRASS,2,Nicolas Kiefer,Mikhail Youzhny,Nicolas Kiefer,6-2; 5-7; 6-3,R16,136,7,2,55,85,39,55,17,30,4,7,15,56,85,4,2,63,89,34,63,15,26,2,7,14,49,89
2008-06-09 00:00:00.000,Halle Germany ATP World Tour,GRASS,2,Michael Llodra,Steve Darcis,Michael Llodra,7-6(6); 7-6(3),R16,101,9,0,47,74,39,47,21,27,0,0,12,60,74,2,0,70,105,43,70,23,35,3,3,12,66,105
2008-06-09 00:00:00.000,Halle Germany ATP World Tour,GRASS,2,Philipp Kohlschreiber,Tommy Haas,Philipp Kohlschreiber,7-5; 5-7; 7-6(5),R16,148,7,3,64,103,48,64,28,39,4,6,18,76,103,13,8,64,111,49,64,27,47,3,5,18,76,111
2008-06-09 00:00:00.000,Halle Germany ATP World Tour,GRASS,2,Robin Soderling,Tomas Berdych,Robin Soderling,6-2; 7-5,R16,64,13,0,32,49,28,32,12,17,0,0,10,40,49,8,0,41,63,26,41,10,22,2,5,10,36,63
2008-06-09 00:00:00.000,Halle Germany ATP World Tour,GRASS,2,Andreas Beck,Mischa Zverev,Andreas Beck,6-7(5); 7-6(5); 6-1,R16,114,9,5,70,101,55,70,17,31,7,8,16,72,101,16,2,63,93,48,63,14,30,1,4,15,62,93
2008-06-09 00:00:00.000,Halle Germany ATP World Tour,GRASS,2,James Blake,Benjamin Becker,James Blake,4-6; 7-5; 6-3,R16,113,12,2,50,83,39,50,21,33,2,4,16,60,83,11,8,59,104,47,59,18,45,9,12,15,65,104
2008-06-09 00:00:00.000,Halle Germany ATP World Tour,GRASS,2,Roger Federer,Marcos Baghdatis,Roger Federer,6-4; 6-4,Q,72,0,0,45,58,33,45,10,13,4,4,10,43,58,4,3,32,61,26,32,13,29,2,4,10,39,61
2008-06-09 00:00:00.000,Halle Germany ATP World Tour,GRASS,2,Nicolas Kiefer,Michael Llodra,Nicolas Kiefer,4-0 RET,Q,20,2,1,7,11,5,7,3,4,0,0,2,8,11,0,2,2,8,0,2,0,6,0,2,2,0,8
2008-06-09 00:00:00.000,Halle Germany ATP World Tour,GRASS,2,Philipp Kohlschreiber,Robin Soderling,Philipp Kohlschreiber,6-4; 7-6(4),Q,91,12,3,46,71,35,46,16,25,3,3,11,51,71,8,0,45,77,32,45,19,32,3,4,11,51,77
2008-06-09 00:00:00.000,Halle Germany ATP World Tour,GRASS,2,James Blake,Andreas Beck,James Blake,7-6(4); 7-6(5),Q,105,13,3,48,77,39,48,16,29,2,4,12,55,77,9,6,78,105,52,78,15,27,10,12,12,67,105
2008-06-09 00:00:00.000,Halle Germany ATP World Tour,GRASS,2,Roger Federer,Nicolas Kiefer,Roger Federer,6-1; 6-4,S,65,7,1,37,59,27,37,13,22,4,4,9,40,59,4,3,18,40,15,18,9,22,0,3,8,24,40
2008-06-09 00:00:00.000,Halle Germany ATP World Tour,GRASS,2,Philipp Kohlschreiber,James Blake,Philipp Kohlschreiber,6-3; 7-5,S,72,7,1,34,57,23,34,16,23,3,4,10,39,57,5,2,35,64,24,35,13,29,2,6,11,37,64
2008-06-09 00:00:00.000,Halle Germany ATP World Tour,GRASS,2,Roger Federer,Philipp Kohlschreiber,Roger Federer,6-3; 6-4,F,74,6,0,36,51,31,36,10,15,2,2,10,41,51,6,2,40,65,28,40,12,25,2,4,9,40,65
2008-06-09 00:00:00.000,London / Queen's Club Great Britain ATP World Tour,GRASS,2,Rafael Nadal,N/A Bye,Rafael Nadal,,R64,0,0,0,0,0,0,0,0,0,0,0,0,0,0,0,0,0,0,0,0,0,0,0,0,0,0,0
2008-06-09 00:00:00.000,London / Queen's Club Great Britain ATP World Tour,GRASS,2,Jonas Bjorkman,Igor Kunitsyn,Jonas Bjorkman,7-6(3); 4-6; 6-4,R64,146,2,5,56,107,40,56,26,51,5,10,16,66,107,6,2,67,113,41,67,24,46,5,10,16,65,113
2008-06-09 00:00:00.000,London / Queen's Club Great Britain ATP World Tour,GRASS,2,Kei Nishikori,Alejandro Falla,Kei Nishikori,2-6; 6-4; 6-2,R64,102,3,2,48,78,37,48,16,30,4,6,13,53,78,7,2,41,80,31,41,19,39,5,8,13,50,80
2008-06-09 00:00:00.000,London / Queen's Club Great Britain ATP World Tour,GRASS,2,Olivier Patience,Sam Querrey,Olivier Patience,7-5; 5-7; 6-4,R64,123,4,5,62,100,47,62,16,38,5,9,17,63,100,14,4,69,115,50,69,17,46,7,12,17,67,115
2008-06-09 00:00:00.000,London / Queen's Club Great Britain ATP World Tour,GRASS,2,Fernando Gonzalez,Richard Bloomfield,Fernando Gonzalez,7-6(5); 6-3,R64,92,9,2,42,64,35,42,14,22,0,0,11,49,64,8,9,48,81,33,48,20,33,5,6,10,53,81
2008-06-09 00:00:00.000,London / Queen's Club Great Britain ATP World Tour,GRASS,2,Marat Safin,James Ward,Marat Safin,4-6; 6-1; 6-4,R64,112,6,1,52,92,42,52,20,40,5,6,14,62,92,3,6,40,81,25,40,24,41,3,6,13,49,81
2008-06-09 00:00:00.000,London / Queen's Club Great Britain ATP World Tour,GRASS,2,Joseph Sirianni,Alex Bogdanovic,Joseph Sirianni,6-3; 6-3,R64,82,3,2,42,72,35,42,12,30,6,6,9,47,72,3,3,32,61,21,32,13,29,5,8,9,34,61
2008-06-09 00:00:00.000,London / Queen's Club Great Britain ATP World Tour,GRASS,2,Ivo Karlovic,N/A Bye,Ivo Karlovic,,R64,0,0,0,0,0,0,0,0,0,0,0,0,0,0,0,0,0,0,0,0,0,0,0,0,0,0,0
2008-06-09 00:00:00.000,London / Queen's Club Great Britain ATP World Tour,GRASS,2,Andy Roddick,N/A Bye,Andy Roddick,,R64,0,0,0,0,0,0,0,0,0,0,0,0,0,0,0,0,0,0,0,0,0,0,0,0,0,0,0
2008-06-09 00:00:00.000,London / Queen's Club Great Britain ATP World Tour,GRASS,2,Robby Ginepri,Vincent Spadea,Robby Ginepri,6-4; 7-6(4),R64,77,13,1,47,65,40,47,10,18,1,1,11,50,65,9,2,48,76,38,48,12,28,4,5,11,50,76
2008-06-09 00:00:00.000,London / Queen's Club Great Britain ATP World Tour,GRASS,2,Chris Guccione,Yen-Hsun Lu,Chris Guccione,6-4; 6-7(2); 7-5,R64,134,19,2,75,105,60,75,16,30,4,4,17,76,105,13,5,66,108,50,66,25,42,5,7,17,75,108
2008-06-09 00:00:00.000,London / Queen's Club Great Britain ATP World Tour,GRASS,2,Mardy Fish,Edouard Roger-Vasselin,Mardy Fish,6-1; 6-4,R64,54,12,2,29,39,25,29,7,10,0,0,8,32,39,2,1,38,59,22,38,8,21,4,8,9,30,59
2008-06-09 00:00:00.000,London / Queen's Club Great Britain ATP World Tour,GRASS,2,Andreas Seppi,Arnaud Clement,Andreas Seppi,6-3; 4-6; 6-1,R64,106,6,4,49,74,37,49,13,25,3,5,13,50,74,7,4,49,88,31,49,18,39,9,14,13,49,88
2008-06-09 00:00:00.000,London / Queen's Club Great Britain ATP World Tour,GRASS,2,Ernests Gulbis,Kristof Vliegen,Ernests Gulbis,6-4; 7-5,R64,85,5,2,46,68,35,46,13,22,0,0,11,48,68,6,1,38,69,28,38,16,31,2,4,11,44,69
2008-06-09 00:00:00.000,London / Queen's Club Great Britain ATP World Tour,GRASS,2,Sebastien Grosjean,Rik De Voest,Sebastien Grosjean,7-6(6); 6-1,R64,90,2,2,37,70,25,37,16,33,5,7,9,41,70,1,3,38,67,24,38,10,29,4,9,10,34,67
2008-06-09 00:00:00.000,London / Queen's Club Great Britain ATP World Tour,GRASS,2,Andy Murray,N/A Bye,Andy Murray,,R64,0,0,0,0,0,0,0,0,0,0,0,0,0,0,0,0,0,0,0,0,0,0,0,0,0,0,0
2008-06-09 00:00:00.000,London / Queen's Club Great Britain ATP World Tour,GRASS,2,Richard Gasquet,N/A Bye,Richard Gasquet,,R64,0,0,0,0,0,0,0,0,0,0,0,0,0,0,0,0,0,0,0,0,0,0,0,0,0,0,0
2008-06-09 00:00:00.000,London / Queen's Club Great Britain ATP World Tour,GRASS,2,Simone Bolelli,Frank Dancevic,Simone Bolelli,2-2 RET,R64,28,1,0,7,10,5,7,3,3,0,0,2,8,10,2,0,15,25,11,15,5,10,2,2,2,16,25
2008-06-09 00:00:00.000,London / Queen's Club Great Britain ATP World Tour,GRASS,2,Mario Ancic,Nicolas Lapentti,Mario Ancic,7-5; 6-3,R64,91,17,2,47,67,34,47,13,20,0,1,11,47,67,0,5,41,67,30,41,7,26,7,10,10,37,67
2008-06-09 00:00:00.000,London / Queen's Club Great Britain ATP World Tour,GRASS,2,Fernando Verdasco,Hyung-Taik Lee,Fernando Verdasco,5-3 RET,R64,35,4,2,20,26,14,20,4,6,5,5,4,18,26,2,0,17,24,13,17,2,7,2,3,4,15,24
2008-06-09 00:00:00.000,London / Queen's Club Great Britain ATP World Tour,GRASS,2,Nicolas Mahut,Feliciano Lopez,Nicolas Mahut,6-3; 6-7(4); 7-6(4),R64,142,27,5,83,119,68,83,16,36,3,3,17,84,119,19,6,71,106,54,71,18,35,3,4,16,72,106
2008-06-09 00:00:00.000,London / Queen's Club Great Britain ATP World Tour,GRASS,2,John Isner,Kevin Anderson,John Isner,7-6(5); 6-4,R64,73,11,1,52,64,40,52,9,12,0,0,11,49,64,9,2,49,67,38,49,11,18,2,3,11,49,67
2008-06-09 00:00:00.000,London / Queen's Club Great Britain ATP World Tour,GRASS,2,Viktor Troicki,Dudi Sela,Viktor Troicki,6-4; 6-4,R64,79,3,0,39,58,27,39,12,19,3,5,10,39,58,1,2,41,60,27,41,7,19,3,7,10,34,60
2008-06-09 00:00:00.000,London / Queen's Club Great Britain ATP World Tour,GRASS,2,David Nalbandian,N/A Bye,David Nalbandian,,R64,0,0,0,0,0,0,0,0,0,0,0,0,0,0,0,0,0,0,0,0,0,0,0,0,0,0,0
2008-06-09 00:00:00.000,London / Queen's Club Great Britain ATP World Tour,GRASS,2,Paul-Henri Mathieu,N/A Bye,Paul-Henri Mathieu,,R64,0,0,0,0,0,0,0,0,0,0,0,0,0,0,0,0,0,0,0,0,0,0,0,0,0,0,0
2008-06-09 00:00:00.000,London / Queen's Club Great Britain ATP World Tour,GRASS,2,Marin Cilic,Jurgen Melzer,Marin Cilic,7-6(2); 7-6(5),R64,96,9,3,53,84,43,53,19,31,4,5,12,62,84,6,4,51,74,41,51,13,23,4,5,12,54,74
2008-06-09 00:00:00.000,London / Queen's Club Great Britain ATP World Tour,GRASS,2,Xavier Malisse,Daniel Evans,Xavier Malisse,6-1; 6-1,R64,50,4,0,18,33,17,18,11,15,0,0,7,28,33,1,4,29,49,14,29,7,20,2,7,7,21,49
2008-06-09 00:00:00.000,London / Queen's Club Great Britain ATP World Tour,GRASS,2,Lleyton Hewitt,Josh Goodall,Lleyton Hewitt,6-4; 6-4,R64,73,13,2,30,54,28,30,15,24,0,0,10,43,54,13,4,30,58,23,30,15,28,0,2,10,38,58
2008-06-09 00:00:00.000,London / Queen's Club Great Britain ATP World Tour,GRASS,2,Janko Tipsarevic,Ivan Navarro,Janko Tipsarevic,7-6(2); 6-4,R64,90,1,0,36,67,25,36,26,31,0,1,11,51,67,17,3,43,63,34,43,10,20,2,4,11,44,63
2008-06-09 00:00:00.000,London / Queen's Club Great Britain ATP World Tour,GRASS,2,Ivo Minar,Bobby Reynolds,Ivo Minar,6-1; 7-5,R64,70,12,1,45,69,33,45,12,24,5,6,10,45,69,9,3,29,57,23,29,7,28,4,8,9,30,57
2008-06-09 00:00:00.000,London / Queen's Club Great Britain ATP World Tour,GRASS,2,Roko Karanusic,Flavio Cipolla,Roko Karanusic,6-4; 6-3,R64,83,1,2,31,60,16,31,14,29,4,8,9,30,60,0,5,48,69,22,48,8,21,7,14,10,30,69
2008-06-09 00:00:00.000,London / Queen's Club Great Britain ATP World Tour,GRASS,2,Novak Djokovic,N/A Bye,Novak Djokovic,,R64,0,0,0,0,0,0,0,0,0,0,0,0,0,0,0,0,0,0,0,0,0,0,0,0,0,0,0
2008-06-09 00:00:00.000,London / Queen's Club Great Britain ATP World Tour,GRASS,2,Rafael Nadal,Jonas Bjorkman,Rafael Nadal,6-2; 6-2,R32,65,2,1,26,43,25,26,9,17,1,1,8,34,43,4,2,35,57,23,35,7,22,2,6,8,30,57
2008-06-09 00:00:00.000,London / Queen's Club Great Britain ATP World Tour,GRASS,2,Kei Nishikori,Olivier Patience,Kei Nishikori,7-6(8); 6-3,R32,95,4,2,37,70,26,37,19,33,0,2,11,45,70,0,1,51,78,27,51,16,27,4,7,10,43,78
2008-06-09 00:00:00.000,London / Queen's Club Great Britain ATP World Tour,GRASS,2,Fernando Gonzalez,Marat Safin,Fernando Gonzalez,6-3; 7-6(3),R32,67,6,0,40,59,33,40,12,19,0,0,10,45,59,7,1,43,61,31,43,10,18,1,3,11,41,61
2008-06-09 00:00:00.000,London / Queen's Club Great Britain ATP World Tour,GRASS,2,Ivo Karlovic,Joseph Sirianni,Ivo Karlovic,6-3; 6-2,R32,57,19,2,29,48,26,29,12,19,1,1,9,38,48,0,2,27,48,19,27,8,21,4,7,8,27,48
2008-06-09 00:00:00.000,London / Queen's Club Great Britain ATP World Tour,GRASS,2,Andy Roddick,Robby Ginepri,Andy Roddick,6-7(6); 6-1; 6-1,R32,85,15,1,47,72,41,47,14,25,0,0,13,55,72,4,2,51,78,36,51,10,27,4,9,13,46,78
2008-06-09 00:00:00.000,London / Queen's Club Great Britain ATP World Tour,GRASS,2,Mardy Fish,Chris Guccione,Mardy Fish,4-6; 7-6(0); 6-4,R32,116,16,4,38,91,32,38,34,53,0,1,16,66,91,15,2,70,99,53,70,16,29,1,2,16,69,99
2008-06-09 00:00:00.000,London / Queen's Club Great Britain ATP World Tour,GRASS,2,Ernests Gulbis,Andreas Seppi,Ernests Gulbis,6-3; 6-7(7); 6-3,R32,120,13,1,81,113,61,81,16,32,10,11,16,77,113,6,1,62,96,44,62,20,34,10,13,14,64,96
2008-06-09 00:00:00.000,London / Queen's Club Great Britain ATP World Tour,GRASS,2,Andy Murray,Sebastien Grosjean,Andy Murray,2-0 RET,R32,15,3,0,6,8,3,6,2,2,1,1,1,5,8,1,1,10,14,6,10,0,4,3,4,1,6,14
2008-06-09 00:00:00.000,London / Queen's Club Great Britain ATP World Tour,GRASS,2,Richard Gasquet,Simone Bolelli,Richard Gasquet,6-3; 6-3,R32,66,4,0,37,56,26,37,12,19,2,3,9,38,56,3,0,33,52,20,33,8,19,6,10,9,28,52
2008-06-09 00:00:00.000,London / Queen's Club Great Britain ATP World Tour,GRASS,2,Mario Ancic,Fernando Verdasco,Mario Ancic,7-6(6); 6-4,R32,93,10,2,43,69,35,43,15,26,3,4,11,50,69,8,5,45,68,33,45,12,23,4,6,11,45,68
2008-06-09 00:00:00.000,London / Queen's Club Great Britain ATP World Tour,GRASS,2,Nicolas Mahut,John Isner,Nicolas Mahut,7-5; 6-4,R32,72,15,6,36,61,32,36,16,25,1,1,11,48,61,8,1,40,55,31,40,8,15,2,4,11,39,55
2008-06-09 00:00:00.000,London / Queen's Club Great Britain ATP World Tour,GRASS,2,David Nalbandian,Viktor Troicki,David Nalbandian,6-4; 7-6(4),R32,99,3,3,48,76,38,48,18,28,4,4,11,56,76,11,1,49,74,34,49,14,25,4,5,11,48,74
2008-06-09 00:00:00.000,London / Queen's Club Great Britain ATP World Tour,GRASS,2,Paul-Henri Mathieu,Marin Cilic,Paul-Henri Mathieu,6-3; 3-6; 6-4,R32,107,6,4,44,81,37,44,19,37,1,3,14,56,81,16,6,47,81,43,47,10,34,4,7,14,53,81
2008-06-09 00:00:00.000,London / Queen's Club Great Britain ATP World Tour,GRASS,2,Lleyton Hewitt,Xavier Malisse,Lleyton Hewitt,6-3; 6-2,R32,67,4,1,45,64,30,45,13,19,3,3,9,43,64,5,1,28,45,20,28,5,17,3,6,8,25,45
2008-06-09 00:00:00.000,London / Queen's Club Great Britain ATP World Tour,GRASS,2,Janko Tipsarevic,Ivo Minar,Janko Tipsarevic,3-6; 6-3; 6-4,R32,107,13,3,53,81,39,53,14,28,4,7,14,53,81,9,3,63,99,42,63,16,36,6,10,14,58,99
2008-06-09 00:00:00.000,London / Queen's Club Great Britain ATP World Tour,GRASS,2,Novak Djokovic,Roko Karanusic,Novak Djokovic,6-2; 7-6(7),R32,79,3,1,41,62,28,41,16,21,1,2,10,44,62,3,0,33,68,22,33,18,35,4,7,10,40,68
2008-06-09 00:00:00.000,London / Queen's Club Great Britain ATP World Tour,GRASS,2,Rafael Nadal,Kei Nishikori,Rafael Nadal,6-4; 3-6; 6-3,R16,124,9,2,62,93,46,62,17,31,5,6,14,63,93,5,5,57,88,43,57,15,31,2,4,14,58,88
2008-06-09 00:00:00.000,London / Queen's Club Great Britain ATP World Tour,GRASS,2,Ivo Karlovic,Fernando Gonzalez,Ivo Karlovic,6-3; 7-5,R16,56,10,0,38,48,35,38,9,10,0,0,11,44,48,3,3,38,56,28,38,7,18,0,2,10,35,56
2008-06-09 00:00:00.000,London / Queen's Club Great Britain ATP World Tour,GRASS,2,Andy Roddick,Mardy Fish,Andy Roddick,7-6(5) RET,R16,59,8,0,32,40,25,32,7,8,2,2,6,32,40,11,1,26,50,23,26,11,24,3,3,6,34,50
2008-06-09 00:00:00.000,London / Queen's Club Great Britain ATP World Tour,GRASS,2,Andy Murray,Ernests Gulbis,Andy Murray,5-7; 6-1; 6-4,R16,120,4,1,57,89,45,57,17,32,3,4,15,62,89,10,2,57,87,41,57,13,30,4,7,14,54,87
2008-06-09 00:00:00.000,London / Queen's Club Great Britain ATP World Tour,GRASS,2,Richard Gasquet,Mario Ancic,Richard Gasquet,7-6(5); 6-4,R16,98,6,0,47,76,35,47,20,29,1,1,11,55,76,10,5,43,79,32,43,21,36,9,10,11,53,79
2008-06-09 00:00:00.000,London / Queen's Club Great Britain ATP World Tour,GRASS,2,David Nalbandian,Nicolas Mahut,David Nalbandian,6-4; 6-1,R16,54,6,0,28,39,25,28,8,11,0,0,8,33,39,10,2,34,47,23,34,3,13,0,4,9,26,47
2008-06-09 00:00:00.000,London / Queen's Club Great Britain ATP World Tour,GRASS,2,Lleyton Hewitt,Paul-Henri Mathieu,Lleyton Hewitt,6-4; 6-4,R16,80,11,2,41,58,31,41,8,17,2,3,10,39,58,6,1,37,70,23,37,15,33,6,9,10,38,70
2008-06-09 00:00:00.000,London / Queen's Club Great Britain ATP World Tour,GRASS,2,Novak Djokovic,Janko Tipsarevic,Novak Djokovic,2-6; 6-1; 6-4,R16,103,15,4,60,87,47,60,10,27,5,8,13,57,87,8,0,51,73,33,51,10,22,3,7,12,43,73
2008-06-09 00:00:00.000,London / Queen's Club Great Britain ATP World Tour,GRASS,2,Rafael Nadal,Ivo Karlovic,Rafael Nadal,6-7(5); 7-6(5); 7-6(4),Q,144,6,3,80,113,65,80,25,33,0,0,18,90,113,35,1,80,108,69,80,19,28,2,2,18,88,108
2008-06-09 00:00:00.000,London / Queen's Club Great Britain ATP World Tour,GRASS,2,Andy Roddick,Andy Murray,Andy Roddick,W/O,Q,0,0,0,0,0,0,0,0,0,0,0,0,0,0,0,0,0,0,0,0,0,0,0,0,0,0,0
2008-06-09 00:00:00.000,London / Queen's Club Great Britain ATP World Tour,GRASS,2,David Nalbandian,Richard Gasquet,David Nalbandian,6-4; 3-6; 7-6(3),Q,114,6,4,64,88,52,64,12,24,1,2,15,64,88,15,1,55,96,40,55,25,41,0,1,16,65,96
2008-06-09 00:00:00.000,London / Queen's Club Great Britain ATP World Tour,GRASS,2,Novak Djokovic,Lleyton Hewitt,Novak Djokovic,6-2; 6-2,Q,72,13,2,48,62,34,48,7,14,3,3,8,41,62,4,2,33,57,22,33,8,24,2,6,8,30,57
2008-06-09 00:00:00.000,London / Queen's Club Great Britain ATP World Tour,GRASS,2,Rafael Nadal,Andy Roddick,Rafael Nadal,7-5; 6-4,S,87,7,0,45,61,35,45,12,16,4,4,11,47,61,14,3,46,71,34,46,13,25,5,7,11,47,71
2008-06-09 00:00:00.000,London / Queen's Club Great Britain ATP World Tour,GRASS,2,Novak Djokovic,David Nalbandian,Novak Djokovic,6-1; 6-0,S,48,5,1,20,32,17,20,7,12,0,0,6,24,32,1,5,24,44,12,24,5,20,4,10,7,17,44
2008-06-09 00:00:00.000,London / Queen's Club Great Britain ATP World Tour,GRASS,2,Rafael Nadal,Novak Djokovic,Rafael Nadal,7-6(6); 7-5,F,136,3,0,50,82,34,50,16,32,5,8,12,50,82,4,0,69,90,42,69,10,21,9,13,12,52,90
2008-06-09 00:00:00.000,Warsaw Poland ATP World Tour,CLAY,2,Nikolay Davydenko,Pablo Cuevas,Nikolay Davydenko,6-3; 6-2,R32,66,3,3,22,45,20,22,13,23,0,0,8,33,45,4,5,23,49,15,23,12,26,2,6,9,27,49
2008-06-09 00:00:00.000,Warsaw Poland ATP World Tour,CLAY,2,Jiri Vanek,Carlos Berlocq,Jiri Vanek,1-6; 6-2; 7-6(5),R32,167,4,1,58,95,40,58,14,37,9,13,13,54,95,3,3,70,106,45,70,16,36,8,12,14,61,106
2008-06-09 00:00:00.000,Warsaw Poland ATP World Tour,CLAY,2,Evgeny Korolev,Victor Hanescu,Evgeny Korolev,6-4; 6-2,R32,73,3,3,38,57,27,38,10,19,2,4,9,37,57,2,0,33,54,22,33,4,21,6,11,9,26,54
2008-06-09 00:00:00.000,Warsaw Poland ATP World Tour,CLAY,2,Potito Starace,Dawid Olejniczak,Potito Starace,6-2; 6-3,R32,68,2,0,36,44,25,36,6,8,1,2,8,31,44,2,5,32,55,20,32,8,23,6,11,9,28,55
2008-06-09 00:00:00.000,Warsaw Poland ATP World Tour,CLAY,2,Christophe Rochus,Gilles Simon,Christophe Rochus,6-1; 3-6; 6-3,R32,115,3,1,52,94,36,52,23,42,3,5,13,59,94,11,4,41,80,32,41,16,39,8,12,12,48,80
2008-06-09 00:00:00.000,Warsaw Poland ATP World Tour,CLAY,2,Fabio Fognini,Guillermo Garcia-Lopez,Fabio Fognini,7-5; 0-6; 6-4,R32,135,3,7,42,85,35,42,15,43,2,7,14,50,85,2,5,52,90,37,52,18,38,5,9,14,55,90
2008-06-09 00:00:00.000,Warsaw Poland ATP World Tour,CLAY,2,Santiago Ventura,Boris Pashanski,Santiago Ventura,6-4; 6-2,R32,92,4,1,31,68,24,31,19,37,7,8,9,43,68,1,2,36,57,21,36,8,21,4,8,9,29,57
2008-06-09 00:00:00.000,Warsaw Poland ATP World Tour,CLAY,2,Guillermo Canas,Luis Horna,Guillermo Canas,6-2; 6-7(5); 6-4,R32,141,6,2,58,102,40,58,29,44,5,6,15,69,102,5,7,52,83,35,52,17,31,2,6,15,52,83
2008-06-09 00:00:00.000,Warsaw Poland ATP World Tour,CLAY,2,Marcel Granollers,Michal Mertinak,Marcel Granollers,7-6(2); 6-4,R32,126,4,3,57,96,34,57,25,39,11,13,11,59,96,1,4,41,76,29,41,13,35,2,5,11,42,76
2008-06-09 00:00:00.000,Warsaw Poland ATP World Tour,CLAY,2,Marcos Daniel,Filippo Volandri,Marcos Daniel,6-3; 6-4,R32,79,5,3,28,52,23,28,17,24,0,0,10,40,52,3,2,54,68,34,54,7,14,8,10,9,41,68
2008-06-09 00:00:00.000,Warsaw Poland ATP World Tour,CLAY,2,Florent Serra,Guillermo Coria,Florent Serra,6-3 RET,R32,46,2,0,19,32,10,19,6,13,0,2,5,16,32,0,3,17,26,7,17,3,9,2,5,4,10,26
2008-06-09 00:00:00.000,Warsaw Poland ATP World Tour,CLAY,2,Juan Monaco,Jerzy Janowicz,Juan Monaco,6-4; 6-3,R32,75,5,3,30,50,26,30,12,20,3,4,9,38,50,8,1,38,72,26,38,13,34,3,7,10,39,72
2008-06-09 00:00:00.000,Warsaw Poland ATP World Tour,CLAY,2,Albert Montanes,David Skoch,Albert Montanes,7-6(4); 6-4,R32,76,7,4,30,60,24,30,20,30,2,4,11,44,60,3,1,57,79,35,57,12,22,2,5,11,47,79
2008-06-09 00:00:00.000,Warsaw Poland ATP World Tour,CLAY,2,Oscar Hernandez,Sergio Roitman,Oscar Hernandez,3-6; 6-4; 6-0,R32,107,1,2,63,83,44,63,8,20,3,6,13,52,83,3,2,40,76,26,40,15,36,5,10,12,41,76
2008-06-09 00:00:00.000,Warsaw Poland ATP World Tour,CLAY,2,Wayne Odesnik,Ricardas Berankis,Wayne Odesnik,6-4; 6-3,R32,84,3,3,39,59,29,39,10,20,5,6,9,39,59,3,4,35,65,23,35,11,30,3,7,10,34,65
2008-06-09 00:00:00.000,Warsaw Poland ATP World Tour,CLAY,2,Tommy Robredo,Michal Przysiezny,Tommy Robredo,7-5; 6-2,R32,90,4,1,39,56,31,39,12,17,1,1,10,43,56,5,1,44,72,28,44,13,28,6,9,10,41,72
2008-06-09 00:00:00.000,Warsaw Poland ATP World Tour,CLAY,2,Nikolay Davydenko,Jiri Vanek,Nikolay Davydenko,4-6; 7-5; 6-1,R16,132,6,2,49,86,38,49,19,37,1,4,15,57,86,5,4,64,108,39,64,18,44,14,19,14,57,108
2008-06-09 00:00:00.000,Warsaw Poland ATP World Tour,CLAY,2,Evgeny Korolev,Potito Starace,Evgeny Korolev,7-5; 4-0 RET,R16,72,3,2,21,42,19,21,15,21,2,2,8,34,42,1,1,42,58,26,42,5,16,4,7,8,31,58
2008-06-09 00:00:00.000,Warsaw Poland ATP World Tour,CLAY,2,Fabio Fognini,Christophe Rochus,Fabio Fognini,5-4 RET,R16,47,4,2,15,29,10,15,5,14,1,3,4,15,29,0,1,23,39,11,23,8,16,3,6,5,19,39
2008-06-09 00:00:00.000,Warsaw Poland ATP World Tour,CLAY,2,Guillermo Canas,Santiago Ventura,Guillermo Canas,6-2; 1-6; 6-3,R16,103,2,5,46,84,28,46,19,38,6,10,12,47,84,1,3,39,65,24,39,11,26,0,5,12,35,65
2008-06-09 00:00:00.000,Warsaw Poland ATP World Tour,CLAY,2,Marcel Granollers,Marcos Daniel,Marcel Granollers,6-2; 6-4,R16,82,2,3,26,51,19,26,16,25,3,4,9,35,51,2,2,41,62,24,41,9,21,5,9,9,33,62
2008-06-09 00:00:00.000,Warsaw Poland ATP World Tour,CLAY,2,Juan Monaco,Florent Serra,Juan Monaco,7-5; 6-3,R16,88,3,1,24,56,19,24,14,32,3,7,10,33,56,0,1,38,68,15,38,15,30,4,11,11,30,68
2008-06-09 00:00:00.000,Warsaw Poland ATP World Tour,CLAY,2,Oscar Hernandez,Albert Montanes,Oscar Hernandez,6-3; 6-2,R16,78,0,1,40,51,31,40,4,11,3,5,9,35,51,2,3,26,49,13,26,9,23,8,13,8,22,49
2008-06-09 00:00:00.000,Warsaw Poland ATP World Tour,CLAY,2,Tommy Robredo,Wayne Odesnik,Tommy Robredo,6-4; 1-1 RET,R16,60,1,1,24,38,15,24,7,14,0,2,6,22,38,2,2,17,43,8,17,11,26,5,8,6,19,43
2008-06-09 00:00:00.000,Warsaw Poland ATP World Tour,CLAY,2,Nikolay Davydenko,Evgeny Korolev,Nikolay Davydenko,6-4; 6-2,Q,97,2,0,27,53,20,27,17,26,3,4,9,37,53,1,7,43,73,25,43,13,30,6,10,9,38,73
2008-06-09 00:00:00.000,Warsaw Poland ATP World Tour,CLAY,2,Fabio Fognini,Guillermo Canas,Fabio Fognini,7-5; 7-5,Q,104,3,2,39,74,28,39,19,35,1,4,12,47,74,7,3,35,66,24,35,15,31,3,8,12,39,66
2008-06-09 00:00:00.000,Warsaw Poland ATP World Tour,CLAY,2,Juan Monaco,Marcel Granollers,Juan Monaco,6-4; 6-3,Q,94,2,1,30,51,19,30,8,21,3,7,9,27,51,2,3,34,74,20,34,13,40,7,14,10,33,74
2008-06-09 00:00:00.000,Warsaw Poland ATP World Tour,CLAY,2,Tommy Robredo,Oscar Hernandez,Tommy Robredo,4-6; 6-2; 6-2,Q,143,1,2,56,97,37,56,24,41,9,11,13,61,97,3,5,60,95,35,60,16,35,6,11,13,51,95
2008-06-09 00:00:00.000,Warsaw Poland ATP World Tour,CLAY,2,Nikolay Davydenko,Fabio Fognini,Nikolay Davydenko,6-2; 6-3,S,76,4,2,28,46,23,28,10,18,1,1,8,33,46,2,3,33,67,17,33,17,34,8,12,9,34,67
2008-06-09 00:00:00.000,Warsaw Poland ATP World Tour,CLAY,2,Tommy Robredo,Juan Monaco,Tommy Robredo,6-4; 6-4,S,90,1,1,52,69,36,52,9,17,10,11,10,45,69,0,2,35,55,20,35,12,20,0,3,10,32,55
2008-06-09 00:00:00.000,Warsaw Poland ATP World Tour,CLAY,2,Nikolay Davydenko,Tommy Robredo,Nikolay Davydenko,6-3; 6-3,F,95,3,2,44,68,29,44,13,24,6,7,9,42,68,2,1,42,60,25,42,7,18,3,7,9,32,60
2008-06-15 00:00:00.000,s-Hertogenbosch The Netherlands ATP World Tour,GRASS,2,David Ferrer,Jesse Huta Galung,David Ferrer,6-2; 6-3,R32,61,1,2,36,49,27,36,8,13,1,1,8,35,49,3,3,29,50,16,29,11,21,3,7,9,27,50
2008-06-15 00:00:00.000,s-Hertogenbosch The Netherlands ATP World Tour,GRASS,2,Massimo Dell'Acqua,Fabio Fognini,Massimo Dell'Acqua,7-6(4); 6-2,R32,67,12,2,36,56,30,36,14,20,0,1,10,44,56,5,3,34,57,24,34,13,23,0,3,10,37,57
2008-06-15 00:00:00.000,s-Hertogenbosch The Netherlands ATP World Tour,GRASS,2,Steve Darcis,Florent Serra,Steve Darcis,7-5; 6-3,R32,72,7,2,38,69,30,38,16,31,2,3,11,46,69,1,0,31,54,23,31,11,23,2,5,10,34,54
2008-06-15 00:00:00.000,s-Hertogenbosch The Netherlands ATP World Tour,GRASS,2,Mario Ancic,Ivo Minar,Mario Ancic,6-1; 7-6(0),R32,68,3,0,37,50,30,37,9,13,0,0,9,39,50,1,0,62,78,32,62,10,16,4,7,10,42,78
2008-06-15 00:00:00.000,s-Hertogenbosch The Netherlands ATP World Tour,GRASS,2,Arnaud Clement,Benjamin Becker,Arnaud Clement,6-3; 3-6; 6-4,R32,115,5,5,42,79,34,42,21,37,5,7,14,55,79,10,8,42,83,34,42,17,41,1,4,14,51,83
2008-06-15 00:00:00.000,s-Hertogenbosch The Netherlands ATP World Tour,GRASS,2,Marcel Granollers,Kristof Vliegen,Marcel Granollers,6-0; 1-0 RET,R32,27,2,0,17,20,12,17,2,3,1,1,3,14,20,1,0,9,24,2,9,5,15,2,6,4,7,24
2008-06-15 00:00:00.000,s-Hertogenbosch The Netherlands ATP World Tour,GRASS,2,Rainer Schuettler,Michael Berrer,Rainer Schuettler,6-7(4); 6-4; 6-4,R32,146,8,1,53,97,48,53,26,44,2,2,16,74,97,10,4,64,116,49,64,29,52,4,6,16,78,116
2008-06-15 00:00:00.000,s-Hertogenbosch The Netherlands ATP World Tour,GRASS,2,Juan Martin Del Potro,Fabrice Santoro,Juan Martin Del Potro,6-3; 6-1,R32,60,4,0,29,44,26,29,8,15,3,3,8,34,44,0,3,26,42,16,26,6,16,2,6,8,22,42
2008-06-15 00:00:00.000,s-Hertogenbosch The Netherlands ATP World Tour,GRASS,2,Guillermo Canas,Mischa Zverev,Guillermo Canas,5-7; 6-3; 6-3,R32,128,6,2,54,96,34,54,25,42,4,7,15,59,96,5,2,68,106,46,68,16,38,10,15,15,62,106
2008-06-15 00:00:00.000,s-Hertogenbosch The Netherlands ATP World Tour,GRASS,2,Rohan Bopanna,Martin Verkerk,Rohan Bopanna,6-7(8); 7-6(2); 6-4,R32,123,21,3,56,98,52,56,27,42,0,0,17,79,98,22,10,68,106,55,68,22,38,1,2,17,77,106
2008-06-15 00:00:00.000,s-Hertogenbosch The Netherlands ATP World Tour,GRASS,2,Viktor Troicki,Denis Gremelmayr,Viktor Troicki,6-3; 7-5,R32,69,9,4,36,58,32,36,13,22,0,0,11,45,58,6,2,45,67,32,45,9,22,10,12,10,41,67
2008-06-15 00:00:00.000,s-Hertogenbosch The Netherlands ATP World Tour,GRASS,2,Ivan Ljubicic,Robin Haase,Ivan Ljubicic,6-3; 7-6(5),R32,78,8,2,37,66,28,37,17,29,0,1,11,45,66,8,6,30,61,24,30,14,31,0,2,10,38,61
2008-06-15 00:00:00.000,s-Hertogenbosch The Netherlands ATP World Tour,GRASS,2,Igor Andreev,Grigor Dimitrov,Igor Andreev,6-1; 6-3,R32,51,5,2,26,43,24,26,10,17,3,3,8,34,43,1,3,34,48,20,34,5,14,2,6,8,25,48
2008-06-15 00:00:00.000,s-Hertogenbosch The Netherlands ATP World Tour,GRASS,2,Jurgen Melzer,Victor Hanescu,Jurgen Melzer,6-7(11); 6-2; 6-4,R32,125,5,3,72,107,58,72,21,35,8,8,15,79,107,10,0,66,94,49,66,15,28,5,8,15,64,94
2008-06-15 00:00:00.000,s-Hertogenbosch The Netherlands ATP World Tour,GRASS,2,Marc Gicquel,Matwe Middelkoop,Marc Gicquel,6-4; 6-1,R32,66,5,3,29,47,26,29,9,18,3,3,8,35,47,4,3,28,62,15,28,17,34,1,5,9,32,62
2008-06-15 00:00:00.000,s-Hertogenbosch The Netherlands ATP World Tour,GRASS,2,Richard Gasquet,Olivier Rochus,Richard Gasquet,6-2; 7-6(3),R32,94,7,3,38,59,32,38,9,21,0,1,10,41,59,1,1,55,86,29,55,17,31,10,13,10,46,86
2008-06-15 00:00:00.000,s-Hertogenbosch The Netherlands ATP World Tour,GRASS,2,David Ferrer,Massimo Dell'Acqua,David Ferrer,6-2; 7-6(3),R16,82,7,2,46,67,35,46,12,21,5,6,10,47,67,7,6,38,64,28,38,8,26,2,5,10,36,64
2008-06-15 00:00:00.000,s-Hertogenbosch The Netherlands ATP World Tour,GRASS,2,Mario Ancic,Steve Darcis,Mario Ancic,6-2; 6-4,R16,78,4,3,34,61,27,34,16,27,7,7,9,43,61,8,0,41,63,28,41,9,22,5,8,9,37,63
2008-06-15 00:00:00.000,s-Hertogenbosch The Netherlands ATP World Tour,GRASS,2,Arnaud Clement,Marcel Granollers,Arnaud Clement,6-7(6); 6-3; 6-3,R16,138,7,1,68,109,46,68,24,41,16,18,15,70,109,2,3,49,84,30,49,21,35,3,8,15,51,84
2008-06-15 00:00:00.000,s-Hertogenbosch The Netherlands ATP World Tour,GRASS,2,Juan Martin Del Potro,Rainer Schuettler,Juan Martin Del Potro,7-6(3); 4-3,R16,90,13,2,39,58,34,39,13,19,4,4,10,47,58,2,0,43,70,31,43,17,27,5,5,9,48,70
2008-06-15 00:00:00.000,s-Hertogenbosch The Netherlands ATP World Tour,GRASS,2,Guillermo Canas,Rohan Bopanna,Guillermo Canas,6-2; 6-4,R16,62,5,2,31,48,28,31,8,17,0,0,9,36,48,6,1,27,50,18,27,13,23,4,7,9,31,50
2008-06-15 00:00:00.000,s-Hertogenbosch The Netherlands ATP World Tour,GRASS,2,Viktor Troicki,Ivan Ljubicic,Viktor Troicki,5-7; 6-4; 7-6(5),R16,138,9,6,52,90,47,52,22,38,0,1,17,69,90,25,6,73,118,57,73,22,45,10,11,17,79,118
2008-06-15 00:00:00.000,s-Hertogenbosch The Netherlands ATP World Tour,GRASS,2,Jurgen Melzer,Igor Andreev,Jurgen Melzer,6-4; 1-6; 6-1,R16,98,7,4,42,71,33,42,15,29,4,6,12,48,71,4,4,47,85,32,47,18,38,7,10,12,50,85
2008-06-15 00:00:00.000,s-Hertogenbosch The Netherlands ATP World Tour,GRASS,2,Marc Gicquel,Richard Gasquet,Marc Gicquel,7-5; 7-6(6),R16,102,9,2,48,85,38,48,23,37,7,7,12,61,85,6,1,45,64,36,45,14,19,1,2,12,50,64
2008-06-15 00:00:00.000,s-Hertogenbosch The Netherlands ATP World Tour,GRASS,2,David Ferrer,Mario Ancic,David Ferrer,6-4; 7-6(4),Q,95,1,2,53,75,40,53,13,22,1,1,11,53,75,4,4,43,74,34,43,13,31,5,6,11,47,74
2008-06-15 00:00:00.000,s-Hertogenbosch The Netherlands ATP World Tour,GRASS,2,Juan Martin Del Potro,Arnaud Clement,Juan Martin Del Potro,2-6; 6-3; 6-1,Q,122,13,6,52,81,32,52,15,29,6,10,12,47,81,8,4,38,79,22,38,18,41,5,11,12,40,79
2008-06-15 00:00:00.000,s-Hertogenbosch The Netherlands ATP World Tour,GRASS,2,Guillermo Canas,Viktor Troicki,Guillermo Canas,6-2; 6-2,Q,67,5,3,25,42,21,25,11,17,1,2,8,32,42,3,3,32,57,16,32,10,25,2,7,8,26,57
2008-06-15 00:00:00.000,s-Hertogenbosch The Netherlands ATP World Tour,GRASS,2,Marc Gicquel,Jurgen Melzer,Marc Gicquel,6-3; 6-4,Q,100,5,0,37,58,30,37,12,21,5,6,10,42,58,5,4,36,60,25,36,10,24,6,9,9,35,60
2008-06-15 00:00:00.000,s-Hertogenbosch The Netherlands ATP World Tour,GRASS,2,David Ferrer,Juan Martin Del Potro,David Ferrer,7-6(4); 6-1,S,87,6,1,60,78,42,60,11,18,6,6,10,53,78,2,1,30,52,23,30,12,22,1,3,9,35,52
2008-06-15 00:00:00.000,s-Hertogenbosch The Netherlands ATP World Tour,GRASS,2,Marc Gicquel,Guillermo Canas,Marc Gicquel,3-6; 6-0; 6-4,S,114,4,0,51,87,36,51,18,36,8,10,13,54,87,9,4,25,68,19,25,22,43,1,5,12,41,68
2008-06-15 00:00:00.000,s-Hertogenbosch The Netherlands ATP World Tour,GRASS,2,David Ferrer,Marc Gicquel,David Ferrer,6-4; 6-2,F,82,12,0,43,65,30,43,14,22,2,2,9,44,65,7,0,43,63,28,43,8,20,4,7,9,36,63
2008-06-16 00:00:00.000,Nottingham Great Britain ATP World Tour,GRASS,2,Radek Stepanek,John Isner,Radek Stepanek,6-3; 6-2,R32,50,8,1,34,46,29,34,8,12,0,0,9,37,46,7,4,31,43,20,31,4,12,0,3,8,24,43
2008-06-16 00:00:00.000,Nottingham Great Britain ATP World Tour,GRASS,2,Vincent Spadea,Alexander Slabinsky,Vincent Spadea,6-1; 7-5,R32,57,6,0,35,52,29,35,11,17,0,0,10,40,52,5,2,31,57,21,31,14,26,2,5,9,35,57
2008-06-16 00:00:00.000,Nottingham Great Britain ATP World Tour,GRASS,2,Julien Benneteau,Simone Bolelli,Julien Benneteau,6-1; 6-4,R32,67,7,2,29,45,26,29,10,16,0,0,9,36,45,3,0,43,57,27,43,4,14,1,4,8,31,57
2008-06-16 00:00:00.000,Nottingham Great Britain ATP World Tour,GRASS,2,Gael Monfils,Chris Guccione,Gael Monfils,7-6(4); 6-4,R32,73,11,3,42,71,34,42,20,29,4,4,11,54,71,6,2,48,77,35,48,15,29,4,5,11,50,77
2008-06-16 00:00:00.000,Nottingham Great Britain ATP World Tour,GRASS,2,Ivo Karlovic,Jonas Bjorkman,Ivo Karlovic,6-3; 6-4,R32,65,15,0,39,52,33,39,7,13,0,0,10,40,52,0,1,26,51,18,26,17,25,1,3,9,35,51
2008-06-16 00:00:00.000,Nottingham Great Britain ATP World Tour,GRASS,2,Sam Querrey,Alejandro Falla,Sam Querrey,6-3; 6-4,R32,64,10,1,35,55,29,35,12,20,0,0,10,41,55,7,3,31,58,22,31,11,27,3,5,9,33,58
2008-06-16 00:00:00.000,Nottingham Great Britain ATP World Tour,GRASS,2,Eduardo Schwank,Frederik Nielsen,Eduardo Schwank,6-3; 6-3,R32,78,2,2,49,75,38,49,7,26,4,5,9,45,75,1,3,33,55,22,33,7,22,2,6,9,29,55
2008-06-16 00:00:00.000,Nottingham Great Britain ATP World Tour,GRASS,2,Andreas Seppi,Dudi Sela,Andreas Seppi,3-6; 6-4; 7-5,R32,130,7,2,54,90,37,54,13,36,7,13,16,50,90,3,4,59,107,36,59,19,48,3,9,15,55,107
2008-06-16 00:00:00.000,Nottingham Great Britain ATP World Tour,GRASS,2,Gilles Simon,Donald Young,Gilles Simon,6-1; 6-4,R32,49,4,2,34,51,28,34,11,17,4,4,9,39,51,1,0,33,48,22,33,6,15,3,6,8,28,48
2008-06-16 00:00:00.000,Nottingham Great Britain ATP World Tour,GRASS,2,Samuel Groth,Jamie Baker,Samuel Groth,7-6(7); 6-3,R32,74,20,3,35,60,31,35,18,25,0,0,11,49,60,0,3,41,64,30,41,13,23,1,2,10,43,64
2008-06-16 00:00:00.000,Nottingham Great Britain ATP World Tour,GRASS,2,Bobby Reynolds,Nicolas Mahut,Bobby Reynolds,7-5; 4-6; 6-4,R32,121,19,1,53,87,40,53,18,34,3,6,16,58,87,15,12,52,95,43,52,17,43,9,13,16,60,95
2008-06-16 00:00:00.000,Nottingham Great Britain ATP World Tour,GRASS,2,Fernando Verdasco,Marcos Daniel,Fernando Verdasco,6-4; 7-6(3),R32,80,4,3,47,67,34,47,12,20,3,5,11,46,67,8,1,46,68,34,46,8,22,3,6,11,42,68
2008-06-16 00:00:00.000,Nottingham Great Britain ATP World Tour,GRASS,2,Dmitry Tursunov,Yen-Hsun Lu,Dmitry Tursunov,7-5; 6-4,R32,71,4,1,35,52,27,35,13,17,0,1,11,40,52,1,3,46,70,33,46,11,24,7,10,11,44,70
2008-06-16 00:00:00.000,Nottingham Great Britain ATP World Tour,GRASS,2,Thomas Johansson,Kei Nishikori,Thomas Johansson,7-5 RET,R32,48,6,2,22,37,19,22,8,15,1,1,6,27,37,2,1,25,43,18,25,9,18,3,4,6,27,43
2008-06-16 00:00:00.000,Nottingham Great Britain ATP World Tour,GRASS,2,Alex Bogdanovic,James Ward,Alex Bogdanovic,6-3; 6-4,R32,69,12,3,40,60,32,40,10,20,1,2,10,42,60,4,3,34,56,23,34,10,22,3,6,9,33,56
2008-06-16 00:00:00.000,Nottingham Great Britain ATP World Tour,GRASS,2,Marin Cilic,Paul-Henri Mathieu,Marin Cilic,1-6; 6-4; 6-3,R32,100,15,4,39,75,30,39,21,36,2,4,13,51,75,10,3,44,77,32,44,19,33,1,3,13,51,77
2008-06-16 00:00:00.000,Nottingham Great Britain ATP World Tour,GRASS,2,Vincent Spadea,Radek Stepanek,Vincent Spadea,W/O,R16,0,0,0,0,0,0,0,0,0,0,0,0,0,0,0,0,0,0,0,0,0,0,0,0,0,0,0
2008-06-16 00:00:00.000,Nottingham Great Britain ATP World Tour,GRASS,2,Gael Monfils,Julien Benneteau,Gael Monfils,3-6; 6-4; 6-2,R16,104,8,1,53,75,41,53,9,22,3,5,13,50,75,2,2,55,86,38,55,15,31,6,10,14,53,86
2008-06-16 00:00:00.000,Nottingham Great Britain ATP World Tour,GRASS,2,Ivo Karlovic,Sam Querrey,Ivo Karlovic,7-6(3); 7-6(14),R16,111,27,2,54,82,48,54,17,28,0,0,12,65,82,9,2,70,100,54,70,15,30,2,2,12,69,100
2008-06-16 00:00:00.000,Nottingham Great Britain ATP World Tour,GRASS,2,Andreas Seppi,Eduardo Schwank,Andreas Seppi,6-1; 4-6; 7-6(7),R16,131,4,3,68,103,50,68,18,35,6,8,15,68,103,8,6,65,94,42,65,15,29,8,11,14,57,94
2008-06-16 00:00:00.000,Nottingham Great Britain ATP World Tour,GRASS,2,Gilles Simon,Samuel Groth,Gilles Simon,6-7(1); 6-4; 6-4,R16,122,6,1,64,104,45,64,24,40,3,4,16,69,104,18,9,59,116,51,59,23,57,11,14,16,74,116
2008-06-16 00:00:00.000,Nottingham Great Britain ATP World Tour,GRASS,2,Fernando Verdasco,Bobby Reynolds,Fernando Verdasco,6-2; 6-3,R16,59,3,0,35,45,27,35,7,10,3,3,8,34,45,6,2,36,59,25,36,7,23,1,5,9,32,59
2008-06-16 00:00:00.000,Nottingham Great Britain ATP World Tour,GRASS,2,Thomas Johansson,Dmitry Tursunov,Thomas Johansson,W/O,R16,0,0,0,0,0,0,0,0,0,0,0,0,0,0,0,0,0,0,0,0,0,0,0,0,0,0,0
2008-06-16 00:00:00.000,Nottingham Great Britain ATP World Tour,GRASS,2,Marin Cilic,Alex Bogdanovic,Marin Cilic,6-4; 6-4,R16,83,10,1,46,77,31,46,15,31,3,5,10,46,77,2,6,34,60,22,34,11,26,4,8,10,33,60
2008-06-16 00:00:00.000,Nottingham Great Britain ATP World Tour,GRASS,2,Gael Monfils,Vincent Spadea,Gael Monfils,7-6(4); 6-2,Q,77,7,1,45,67,37,45,11,22,2,3,10,48,67,2,1,45,71,26,45,16,26,2,5,10,42,71
2008-06-16 00:00:00.000,Nottingham Great Britain ATP World Tour,GRASS,2,Ivo Karlovic,Andreas Seppi,Ivo Karlovic,6-3; 3-6; 6-4,Q,111,19,4,58,83,49,58,9,25,2,3,14,58,83,6,3,48,88,33,48,23,40,1,3,14,56,88
2008-06-16 00:00:00.000,Nottingham Great Britain ATP World Tour,GRASS,2,Fernando Verdasco,Gilles Simon,Fernando Verdasco,6-3; 2-6; 6-3,Q,96,4,5,56,82,35,56,13,26,5,8,13,48,82,3,4,41,73,24,41,19,32,1,5,13,43,73
2008-06-16 00:00:00.000,Nottingham Great Britain ATP World Tour,GRASS,2,Marin Cilic,Thomas Johansson,Marin Cilic,6-1; 6-2,Q,55,4,0,22,48,21,22,13,26,1,1,8,34,48,1,1,24,46,13,24,9,22,3,7,7,22,46
2008-06-16 00:00:00.000,Nottingham Great Britain ATP World Tour,GRASS,2,Ivo Karlovic,Gael Monfils,Ivo Karlovic,7-6(4); 7-6(4),S,104,11,3,47,71,39,47,16,24,1,3,12,55,71,0,4,64,94,40,64,16,30,4,6,12,56,94
2008-06-16 00:00:00.000,Nottingham Great Britain ATP World Tour,GRASS,2,Fernando Verdasco,Marin Cilic,Fernando Verdasco,6-3; 6-1,S,63,3,0,33,42,26,33,7,9,2,2,8,33,42,1,2,31,60,16,31,14,29,4,8,8,30,60
2008-06-16 00:00:00.000,Nottingham Great Britain ATP World Tour,GRASS,2,Ivo Karlovic,Fernando Verdasco,Ivo Karlovic,7-5; 6-7(4); 7-6(8),F,142,29,2,74,112,63,74,22,38,1,2,18,85,112,4,6,82,104,70,82,9,22,2,4,18,79,104
2008-06-23 00:00:00.000,Wimbledon Great Britain Grand Slams,GRASS,3,Roger Federer,Dominik Hrbaty,Roger Federer,6-3; 6-2; 6-2,R128,80,10,0,54,78,42,54,15,24,0,0,13,57,78,2,7,39,69,24,39,12,30,6,11,12,36,69
2008-06-23 00:00:00.000,Wimbledon Great Britain Grand Slams,GRASS,3,Robin Soderling,Kevin Kim,Robin Soderling,7-5; 0-6; 6-3; 6-4,R128,140,9,2,57,111,45,57,28,54,5,9,19,73,111,12,6,91,141,64,91,21,50,11,15,18,85,141
2008-06-23 00:00:00.000,Wimbledon Great Britain Grand Slams,GRASS,3,Marc Gicquel,Kei Nishikori,Marc Gicquel,4-6; 7-5 RET,R128,75,4,1,36,59,32,36,13,23,0,1,11,45,59,5,3,47,64,36,47,9,17,2,3,11,45,64
2008-06-23 00:00:00.000,Wimbledon Great Britain Grand Slams,GRASS,3,Ilija Bozoljac,Chris Guccione,Ilija Bozoljac,3-6; 6-4; 6-4; 6-3,R128,116,20,6,59,107,52,59,26,48,4,5,19,78,107,9,4,62,104,48,62,22,42,1,4,19,70,104
2008-06-23 00:00:00.000,Wimbledon Great Britain Grand Slams,GRASS,3,Lleyton Hewitt,Robin Haase,Lleyton Hewitt,6-7(4); 6-3; 6-3; 6-7(1); 6-2,R128,217,18,8,80,144,68,80,39,64,3,4,25,107,144,27,9,98,181,72,98,39,83,10,16,25,111,181
2008-06-23 00:00:00.000,Wimbledon Great Britain Grand Slams,GRASS,3,Albert Montanes,Carlos Berlocq,Albert Montanes,6-3; 7-6(2); 6-4,R128,111,2,5,70,104,52,70,18,34,6,8,15,70,104,1,2,55,93,42,55,13,38,6,11,16,55,93
2008-06-23 00:00:00.000,Wimbledon Great Britain Grand Slams,GRASS,3,Simone Bolelli,Alex Bogdanovic,Simone Bolelli,7-6(4); 4-6; 6-3; 7-6(4),R128,186,18,2,109,161,82,109,27,52,5,6,22,109,161,13,6,81,129,62,81,32,48,5,6,21,94,129
2008-06-23 00:00:00.000,Wimbledon Great Britain Grand Slams,GRASS,3,Fernando Gonzalez,Robby Ginepri,Fernando Gonzalez,7-6(3); 7-5; 7-5,R128,131,17,5,65,114,52,65,27,49,6,7,18,79,114,11,3,80,124,58,80,19,44,9,12,18,77,124
2008-06-23 00:00:00.000,Wimbledon Great Britain Grand Slams,GRASS,3,Tomas Berdych,Evgeny Korolev,Tomas Berdych,4-6; 6-1; 6-4; 3-6; 7-5,R128,181,26,6,89,154,68,89,30,65,9,13,24,98,154,22,8,75,140,61,75,25,65,7,13,24,86,140
2008-06-23 00:00:00.000,Wimbledon Great Britain Grand Slams,GRASS,3,Victor Hanescu,Alejandro Falla,Victor Hanescu,6-3; 6-7(2); 6-0; 6-4,R128,164,10,3,76,112,55,76,17,36,2,5,19,72,112,4,2,79,135,52,79,24,56,16,24,18,76,135
2008-06-23 00:00:00.000,Wimbledon Great Britain Grand Slams,GRASS,3,Olivier Rochus,Dudi Sela,Olivier Rochus,6-4; 7-5; 6-4,R128,129,0,3,63,109,47,63,23,46,9,12,16,70,109,5,1,48,86,32,48,18,38,4,10,16,50,86
2008-06-23 00:00:00.000,Wimbledon Great Britain Grand Slams,GRASS,3,Fernando Verdasco,Philipp Kohlschreiber,Fernando Verdasco,6-4; 6-3; 6-2,R128,99,2,3,55,74,38,55,13,19,1,3,14,51,74,2,5,44,86,29,44,16,42,10,16,13,45,86
2008-06-23 00:00:00.000,Wimbledon Great Britain Grand Slams,GRASS,3,Mario Ancic,Michael Llodra,Mario Ancic,6-4; 7-6(7); 2-0 RET,R128,94,18,3,43,66,39,43,17,23,0,0,12,56,66,0,5,58,86,37,58,17,28,4,6,12,54,86
2008-06-23 00:00:00.000,Wimbledon Great Britain Grand Slams,GRASS,3,Philipp Petzschner,Hyung-Taik Lee,Philipp Petzschner,6-7(4); 6-1; 6-4 RET,R128,89,19,6,42,83,37,42,25,41,0,0,14,62,83,1,5,65,100,44,65,16,35,6,9,14,60,100
2008-06-23 00:00:00.000,Wimbledon Great Britain Grand Slams,GRASS,3,Igor Andreev,Jiri Vanek,Igor Andreev,6-7(6); 7-6(2); 6-2; 6-2,R128,150,23,3,64,108,56,64,27,44,1,3,20,83,108,10,8,99,160,66,99,26,61,14,20,20,92,160
2008-06-23 00:00:00.000,Wimbledon Great Britain Grand Slams,GRASS,3,David Ferrer,Sergiy Stakhovsky,David Ferrer,7-6(6); 6-3; 1-3 RET,R128,118,3,2,59,81,45,59,12,22,1,2,13,57,81,4,3,70,95,52,70,9,25,5,6,12,61,95
2008-06-23 00:00:00.000,Wimbledon Great Britain Grand Slams,GRASS,3,Novak Djokovic,Michael Berrer,Novak Djokovic,7-5; 2-6; 6-3; 6-0,R128,127,13,5,67,94,53,67,15,27,3,5,18,68,94,10,7,75,113,54,75,12,38,11,16,17,66,113
2008-06-23 00:00:00.000,Wimbledon Great Britain Grand Slams,GRASS,3,Marat Safin,Fabio Fognini,Marat Safin,6-1; 6-2; 7-6(3),R128,100,9,3,55,88,36,55,20,33,2,5,14,56,88,2,5,44,93,29,44,20,49,4,11,13,49,93
2008-06-23 00:00:00.000,Wimbledon Great Britain Grand Slams,GRASS,3,Florent Serra,Yen-Hsun Lu,Florent Serra,6-4; 6-4; 6-7(3); 6-3,R128,193,6,1,97,144,66,97,25,47,9,11,21,91,144,10,8,99,155,66,99,26,56,11,16,20,92,155
2008-06-23 00:00:00.000,Wimbledon Great Britain Grand Slams,GRASS,3,Andreas Seppi,Tobias Kamke,Andreas Seppi,5-7; 6-3; 6-2; 6-4,R128,157,6,3,64,113,52,64,27,49,6,9,20,79,113,3,11,74,127,48,74,24,53,2,8,19,72,127
2008-06-23 00:00:00.000,Wimbledon Great Britain Grand Slams,GRASS,3,Juan Carlos Ferrero,Sam Querrey,Juan Carlos Ferrero,2-6; 6-4; 6-4; 6-4,R128,145,7,5,90,124,65,90,18,34,8,10,19,83,124,16,5,77,126,58,77,20,49,10,13,19,78,126
2008-06-23 00:00:00.000,Wimbledon Great Britain Grand Slams,GRASS,3,Mischa Zverev,Alexander Peya,Mischa Zverev,6-3; 6-4; 6-4,R128,86,8,1,53,72,46,53,14,19,0,0,15,60,72,4,5,55,83,42,55,12,28,4,7,14,54,83
2008-06-23 00:00:00.000,Wimbledon Great Britain Grand Slams,GRASS,3,Juan Martin Del Potro,Pavel Snobel,Juan Martin Del Potro,6-4; 6-2; 6-3,R128,102,3,1,44,74,30,44,22,30,4,5,13,52,74,5,7,47,96,30,47,20,49,10,16,14,50,96
2008-06-23 00:00:00.000,Wimbledon Great Britain Grand Slams,GRASS,3,Stanislas Wawrinka,Marcos Daniel,Stanislas Wawrinka,6-3; 6-2; 7-5,R128,94,9,5,45,78,40,45,19,33,2,3,15,59,78,5,0,61,87,36,61,13,26,7,12,14,49,87
2008-06-23 00:00:00.000,Wimbledon Great Britain Grand Slams,GRASS,3,Marcos Baghdatis,Steve Darcis,Marcos Baghdatis,6-3; 6-2; 6-7(5); 6-3,R128,162,9,8,64,121,53,64,32,57,7,8,20,85,121,3,3,85,139,54,85,27,54,4,9,18,81,139
2008-06-23 00:00:00.000,Wimbledon Great Britain Grand Slams,GRASS,3,Thomas Johansson,Vincent Spadea,Thomas Johansson,6-7(8); 6-7(5); 6-3; 6-4; 6-3,R128,210,13,7,122,186,89,122,32,64,12,15,26,121,186,13,4,115,177,81,115,32,62,10,17,26,113,177
2008-06-23 00:00:00.000,Wimbledon Great Britain Grand Slams,GRASS,3,Thomaz Bellucci,Igor Kunitsyn,Thomaz Bellucci,7-6(5); 7-6(5); 3-6; 6-2,R128,157,17,5,76,126,56,76,29,50,4,7,20,85,126,3,8,95,150,66,95,25,55,9,13,21,91,150
2008-06-23 00:00:00.000,Wimbledon Great Britain Grand Slams,GRASS,3,Simon Stadler,Ivo Karlovic,Simon Stadler,4-6; 7-6(4); 6-3; 7-5,R128,166,5,6,102,152,75,102,30,50,10,12,22,105,152,23,4,88,127,73,88,15,39,5,8,21,88,127
2008-06-23 00:00:00.000,Wimbledon Great Britain Grand Slams,GRASS,3,Feliciano Lopez,Brian Dabul,Feliciano Lopez,7-6(1); 3-6; 6-3; 6-4,R128,164,29,7,85,123,71,85,14,38,5,7,20,85,123,5,0,112,140,76,112,13,28,10,13,20,89,140
2008-06-23 00:00:00.000,Wimbledon Great Britain Grand Slams,GRASS,3,Roko Karanusic,Luis Horna,Roko Karanusic,7-6(4); 6-3; 6-1,R128,118,8,2,63,87,50,63,14,24,0,1,14,64,87,1,2,65,102,38,65,17,37,10,15,14,55,102
2008-06-23 00:00:00.000,Wimbledon Great Britain Grand Slams,GRASS,3,Bobby Reynolds,Filippo Volandri,Bobby Reynolds,6-2; 6-2 RET,R128,68,11,1,27,44,25,27,8,17,1,1,8,33,44,1,6,47,74,30,47,8,27,15,19,8,38,74
2008-06-23 00:00:00.000,Wimbledon Great Britain Grand Slams,GRASS,3,Frank Dancevic,David Nalbandian,Frank Dancevic,6-4; 6-2; 6-4,R128,96,16,0,53,81,40,53,18,28,4,5,14,58,81,3,4,45,74,32,45,13,29,3,8,14,45,74
2008-06-23 00:00:00.000,Wimbledon Great Britain Grand Slams,GRASS,3,Andy Roddick,Eduardo Schwank,Andy Roddick,7-5; 6-4; 7-6(0),R128,135,15,3,64,96,52,64,21,32,0,0,17,73,96,5,6,75,121,51,75,24,46,10,12,17,75,121
2008-06-23 00:00:00.000,Wimbledon Great Britain Grand Slams,GRASS,3,Janko Tipsarevic,Thierry Ascione,Janko Tipsarevic,7-6(4); 6-4; 6-2,R128,102,18,2,50,79,42,50,19,29,0,1,15,61,79,2,2,56,92,39,56,15,36,3,7,15,54,92
2008-06-23 00:00:00.000,Wimbledon Great Britain Grand Slams,GRASS,3,Chris Eaton,Boris Pashanski,Chris Eaton,6-3; 7-6(6); 6-4,R128,113,26,2,66,91,58,66,14,25,1,1,16,72,91,2,2,74,99,52,74,16,25,3,5,15,68,99
2008-06-23 00:00:00.000,Wimbledon Great Britain Grand Slams,GRASS,3,Dmitry Tursunov,Nicolas Mahut,Dmitry Tursunov,6-4; 6-7(8); 7-6(7); 3-6; 7-5,R128,232,27,5,96,170,80,96,47,74,3,4,27,127,170,32,13,115,178,94,115,35,63,9,11,28,129,178
2008-06-23 00:00:00.000,Wimbledon Great Britain Grand Slams,GRASS,3,Nicolas Almagro,Marcel Granollers,Nicolas Almagro,4-6; 6-3; 7-5; 6-2,R128,128,8,4,62,116,46,62,32,54,9,12,20,78,116,5,4,66,100,47,66,17,34,8,14,19,64,100
2008-06-23 00:00:00.000,Wimbledon Great Britain Grand Slams,GRASS,3,Guillermo Garcia-Lopez,Izak Van der Merwe,Guillermo Garcia-Lopez,7-5; 6-2; 6-2,R128,117,1,4,69,102,49,69,15,33,5,7,14,64,102,7,2,46,78,30,46,12,32,3,10,14,42,78
2008-06-23 00:00:00.000,Wimbledon Great Britain Grand Slams,GRASS,3,Rainer Schuettler,Santiago Ventura,Rainer Schuettler,6-3; 6-2; 6-4,R128,119,8,3,52,84,43,52,19,32,3,3,14,62,84,5,3,40,87,27,40,23,47,6,10,13,50,87
2008-06-23 00:00:00.000,Wimbledon Great Britain Grand Slams,GRASS,3,James Blake,Christophe Rochus,James Blake,3-6; 6-3; 6-1; 6-4,R128,108,19,7,61,107,49,61,21,46,10,13,17,70,107,3,0,78,108,44,78,15,30,5,12,18,59,108
2008-06-23 00:00:00.000,Wimbledon Great Britain Grand Slams,GRASS,3,Paul-Henri Mathieu,Oscar Hernandez,Paul-Henri Mathieu,3-6; 6-2; 6-0; 6-2,R128,121,8,1,51,86,44,51,18,35,3,5,16,62,86,2,3,60,96,36,60,12,36,5,12,15,48,96
2008-06-23 00:00:00.000,Wimbledon Great Britain Grand Slams,GRASS,3,Jeremy Chardy,Frederico Gil,Jeremy Chardy,7-5; 6-7(1); 4-6; 6-4; 6-3,R128,180,23,13,102,161,86,102,27,59,5,6,27,113,161,5,8,111,160,83,111,27,49,10,13,26,110,160
2008-06-23 00:00:00.000,Wimbledon Great Britain Grand Slams,GRASS,3,Marin Cilic,Edouard Roger-Vasselin,Marin Cilic,6-4; 6-3; 7-6(4),R128,114,12,3,53,88,46,53,23,35,1,2,16,69,88,4,2,59,95,41,59,22,36,6,9,15,63,95
2008-06-23 00:00:00.000,Wimbledon Great Britain Grand Slams,GRASS,3,Jarkko Nieminen,Wayne Odesnik,Jarkko Nieminen,6-3 RET,R128,35,3,0,20,28,14,20,3,8,0,1,5,17,28,1,0,18,24,9,18,3,6,1,3,4,12,24
2008-06-23 00:00:00.000,Wimbledon Great Britain Grand Slams,GRASS,3,Jurgen Melzer,Ivan Ljubicic,Jurgen Melzer,6-4; 7-6(7); 4-6; 2-6; 6-3,R128,194,15,1,101,174,78,101,42,73,12,15,25,120,174,33,5,101,148,80,101,28,47,10,12,24,108,148
2008-06-23 00:00:00.000,Wimbledon Great Britain Grand Slams,GRASS,3,Jesse Levine,Donald Young,Jesse Levine,4-6; 6-2; 6-3; 6-4,R128,130,8,8,57,110,38,57,29,53,6,12,19,67,110,5,4,61,107,31,61,24,46,3,12,18,55,107
2008-06-23 00:00:00.000,Wimbledon Great Britain Grand Slams,GRASS,3,Arnaud Clement,Jonas Bjorkman,Arnaud Clement,4-6; 7-6(2); 6-4; 7-6(4),R128,208,11,9,90,151,69,90,35,61,8,9,22,104,151,14,0,86,142,65,86,31,56,6,7,22,96,142
2008-06-23 00:00:00.000,Wimbledon Great Britain Grand Slams,GRASS,3,Benjamin Becker,Nikolay Davydenko,Benjamin Becker,6-4; 6-4; 6-4,R128,104,10,1,49,79,42,49,18,30,1,2,15,60,79,7,5,57,88,41,57,12,31,1,5,15,53,88
2008-06-23 00:00:00.000,Wimbledon Great Britain Grand Slams,GRASS,3,Richard Gasquet,Mardy Fish,Richard Gasquet,6-3; 6-4; 6-2,R128,112,10,3,54,92,42,54,21,38,1,1,14,63,92,8,2,39,82,22,39,26,43,2,6,13,48,82
2008-06-23 00:00:00.000,Wimbledon Great Britain Grand Slams,GRASS,3,Sebastien Grosjean,Potito Starace,Sebastien Grosjean,6-2; 7-5; 6-1,R128,82,8,0,42,69,37,42,19,27,3,4,14,56,69,0,1,49,71,27,49,12,22,4,10,13,39,71
2008-06-23 00:00:00.000,Wimbledon Great Britain Grand Slams,GRASS,3,Agustin Calleri,Kevin Anderson,Agustin Calleri,4-6; 7-5; 7-5; 6-1,R128,125,11,5,70,118,59,70,28,48,6,7,21,87,118,15,6,67,105,54,67,19,38,1,5,20,73,105
2008-06-23 00:00:00.000,Wimbledon Great Britain Grand Slams,GRASS,3,Gilles Simon,Dawid Olejniczak,Gilles Simon,6-3; 6-4; 6-2,R128,94,8,2,49,84,40,49,21,35,2,2,14,61,84,5,5,49,91,36,49,16,42,5,9,13,52,91
2008-06-23 00:00:00.000,Wimbledon Great Britain Grand Slams,GRASS,3,Tommy Robredo,Kristof Vliegen,Tommy Robredo,6-1; 6-3; 6-7(4); 6-4,R128,165,7,4,79,126,59,79,28,47,6,7,19,87,126,17,8,70,126,51,70,24,56,4,10,19,75,126
2008-06-23 00:00:00.000,Wimbledon Great Britain Grand Slams,GRASS,3,Tommy Haas,Guillermo Canas,Tommy Haas,3-6; 6-4; 6-4; 6-4,R128,154,3,3,63,112,41,63,31,49,3,8,20,72,112,12,10,67,126,46,67,27,59,6,12,19,73,126
2008-06-23 00:00:00.000,Wimbledon Great Britain Grand Slams,GRASS,3,Xavier Malisse,Denis Gremelmayr,Xavier Malisse,6-3; 6-4; 6-2,R128,79,7,2,49,74,41,49,16,25,1,1,14,57,74,9,6,39,69,28,39,16,30,3,7,13,44,69
2008-06-23 00:00:00.000,Wimbledon Great Britain Grand Slams,GRASS,3,Andy Murray,Fabrice Santoro,Andy Murray,6-3; 6-4; 7-6(5),R128,134,8,1,51,83,43,51,20,32,0,2,15,63,83,1,3,77,127,54,77,20,50,10,15,16,74,127
2008-06-23 00:00:00.000,Wimbledon Great Britain Grand Slams,GRASS,3,Radek Stepanek,Jan Hernych,Radek Stepanek,6-3; 7-5; 6-0,R128,114,7,2,45,73,38,45,14,28,5,6,13,52,73,1,5,70,103,35,70,17,33,4,11,14,52,103
2008-06-23 00:00:00.000,Wimbledon Great Britain Grand Slams,GRASS,3,Viktor Troicki,Nicolas Lapentti,Viktor Troicki,6-3; 4-0 RET,R128,53,4,2,21,39,16,21,12,18,0,0,7,28,39,0,2,31,42,15,31,4,11,1,4,6,19,42
2008-06-23 00:00:00.000,Wimbledon Great Britain Grand Slams,GRASS,3,Stefano Galvani,Jamie Baker,Stefano Galvani,6-4; 6-2; 6-3,R128,97,4,1,42,64,32,42,15,22,2,4,13,47,64,5,3,61,91,32,61,10,30,5,12,14,42,91
2008-06-23 00:00:00.000,Wimbledon Great Britain Grand Slams,GRASS,3,Mikhail Youzhny,Sergio Roitman,Mikhail Youzhny,6-1; 6-4; 6-0,R128,83,10,0,52,74,43,52,11,22,3,3,12,54,74,1,4,55,76,32,55,5,21,3,9,11,37,76
2008-06-23 00:00:00.000,Wimbledon Great Britain Grand Slams,GRASS,3,Nicolas Kiefer,Julien Benneteau,Nicolas Kiefer,6-1; 7-5; 6-3,R128,111,10,1,45,75,39,45,18,30,1,1,14,57,75,1,2,52,87,30,52,18,35,7,12,14,48,87
2008-06-23 00:00:00.000,Wimbledon Great Britain Grand Slams,GRASS,3,Martin Vassallo Arguello,Ivo Minar,Martin Vassallo Arguello,6-4; 2-6; 2-6; 6-2; 6-2,R128,161,4,6,81,124,55,81,23,43,3,7,21,78,124,15,4,81,130,59,81,24,49,4,9,21,83,130
2008-06-23 00:00:00.000,Wimbledon Great Britain Grand Slams,GRASS,3,Ernests Gulbis,John Isner,Ernests Gulbis,7-5; 7-5; 6-7(3); 7-6(6),R128,174,15,3,92,134,78,92,29,42,2,2,24,107,134,31,5,99,157,74,99,33,58,4,6,24,107,157
2008-06-23 00:00:00.000,Wimbledon Great Britain Grand Slams,GRASS,3,Rafael Nadal,Andreas Beck,Rafael Nadal,6-4; 6-4; 7-6(0),R128,141,17,4,65,87,57,65,11,22,0,0,16,68,87,4,5,66,110,47,66,20,44,7,9,16,67,110
2008-06-23 00:00:00.000,Wimbledon Great Britain Grand Slams,GRASS,3,Roger Federer,Robin Soderling,Roger Federer,6-3; 6-4; 7-6(3),R64,121,15,0,58,96,47,58,22,38,3,4,16,69,96,6,5,63,114,44,63,25,51,5,8,15,69,114
2008-06-23 00:00:00.000,Wimbledon Great Britain Grand Slams,GRASS,3,Marc Gicquel,Ilija Bozoljac,Marc Gicquel,4-6; 5-7; 7-6(1); 7-6(0); 6-3,R64,212,16,2,101,162,79,101,41,61,5,7,28,120,162,31,13,92,176,75,92,46,84,10,11,27,121,176
2008-06-23 00:00:00.000,Wimbledon Great Britain Grand Slams,GRASS,3,Lleyton Hewitt,Albert Montanes,Lleyton Hewitt,7-6(4); 6-0; 6-2,R64,112,9,0,41,81,35,41,25,40,4,4,13,60,81,7,6,48,92,34,48,18,44,5,10,13,52,92
2008-06-23 00:00:00.000,Wimbledon Great Britain Grand Slams,GRASS,3,Simone Bolelli,Fernando Gonzalez,Simone Bolelli,7-6(8); 7-6(7); 3-6; 7-6(4),R64,182,8,4,98,153,72,98,36,55,11,14,22,108,153,18,7,90,144,72,90,31,54,1,3,23,103,144
2008-06-23 00:00:00.000,Wimbledon Great Britain Grand Slams,GRASS,3,Tomas Berdych,Victor Hanescu,Tomas Berdych,6-7(5); 7-6(6); 6-1; 6-2,R64,135,13,4,64,108,59,64,28,44,2,2,19,87,108,11,5,81,121,57,81,20,40,4,9,20,77,121
2008-06-23 00:00:00.000,Wimbledon Great Britain Grand Slams,GRASS,3,Fernando Verdasco,Olivier Rochus,Fernando Verdasco,7-6(4); 6-7(5); 6-1; 6-1,R64,153,15,3,82,120,55,82,22,38,4,9,19,77,120,2,3,77,121,42,77,17,44,6,16,19,59,121
2008-06-23 00:00:00.000,Wimbledon Great Britain Grand Slams,GRASS,3,Mario Ancic,Philipp Petzschner,Mario Ancic,6-1; 6-4; 6-7(1); 4-6; 6-3,R64,199,20,4,101,160,76,101,33,59,6,7,25,109,160,12,8,74,151,61,74,37,77,10,14,23,98,151
2008-06-23 00:00:00.000,Wimbledon Great Britain Grand Slams,GRASS,3,David Ferrer,Igor Andreev,David Ferrer,3-6; 6-3; 6-4; 6-2,R64,131,0,1,58,95,44,58,24,37,1,3,18,68,95,2,2,74,109,54,74,13,35,4,9,18,67,109
2008-06-23 00:00:00.000,Wimbledon Great Britain Grand Slams,GRASS,3,Marat Safin,Novak Djokovic,Marat Safin,6-4; 7-6(3); 6-2,R64,122,7,3,54,95,43,54,25,41,0,1,15,68,95,4,10,63,97,46,63,12,34,8,12,15,58,97
2008-06-23 00:00:00.000,Wimbledon Great Britain Grand Slams,GRASS,3,Andreas Seppi,Florent Serra,Andreas Seppi,6-3; 6-7(4); 6-2; 6-7(5); 6-4,R64,182,19,4,101,155,79,101,30,54,4,5,25,109,155,9,2,120,162,85,120,23,42,14,20,26,108,162
2008-06-23 00:00:00.000,Wimbledon Great Britain Grand Slams,GRASS,3,Mischa Zverev,Juan Carlos Ferrero,Mischa Zverev,6-4; 6-4; 2-1 RET,R64,82,12,4,53,76,44,53,10,23,4,4,11,54,76,4,2,51,70,31,51,11,19,3,6,12,42,70
2008-06-23 00:00:00.000,Wimbledon Great Britain Grand Slams,GRASS,3,Stanislas Wawrinka,Juan Martin Del Potro,Stanislas Wawrinka,7-6(5); 6-3; 7-5,R64,150,14,2,58,98,44,58,23,40,3,5,16,67,98,3,2,74,114,48,74,22,40,3,8,17,70,114
2008-06-23 00:00:00.000,Wimbledon Great Britain Grand Slams,GRASS,3,Marcos Baghdatis,Thomas Johansson,Marcos Baghdatis,6-4; 6-4; 6-4,R64,105,9,0,39,80,33,39,25,41,2,3,15,58,80,7,4,50,97,36,50,21,47,4,8,15,57,97
2008-06-23 00:00:00.000,Wimbledon Great Britain Grand Slams,GRASS,3,Simon Stadler,Thomaz Bellucci,Simon Stadler,3-6; 6-3; 6-1; 6-7(5); 8-6,R64,222,3,4,113,153,85,113,20,40,5,8,25,105,153,9,15,107,198,75,107,40,91,16,23,26,115,198
2008-06-23 00:00:00.000,Wimbledon Great Britain Grand Slams,GRASS,3,Feliciano Lopez,Roko Karanusic,Feliciano Lopez,6-3; 6-3; 6-4,R64,80,15,1,48,72,38,48,20,24,1,1,14,58,72,7,1,52,85,35,52,16,33,2,6,14,51,85
2008-06-23 00:00:00.000,Wimbledon Great Britain Grand Slams,GRASS,3,Bobby Reynolds,Frank Dancevic,Bobby Reynolds,4-6; 7-6(10); 6-4; 6-4,R64,146,27,7,78,120,68,78,22,42,1,4,21,90,120,13,3,88,134,60,88,27,46,2,6,21,87,134
2008-06-23 00:00:00.000,Wimbledon Great Britain Grand Slams,GRASS,3,Janko Tipsarevic,Andy Roddick,Janko Tipsarevic,6-7(5); 7-5; 6-4; 7-6(4),R64,187,14,3,91,162,71,91,44,71,8,8,23,115,162,27,4,91,128,78,91,19,37,0,2,23,97,128
2008-06-23 00:00:00.000,Wimbledon Great Britain Grand Slams,GRASS,3,Dmitry Tursunov,Chris Eaton,Dmitry Tursunov,7-6(2); 6-2; 6-4,R64,116,5,7,59,102,47,59,24,43,2,2,15,71,102,12,9,49,88,39,49,18,39,3,6,15,57,88
2008-06-23 00:00:00.000,Wimbledon Great Britain Grand Slams,GRASS,3,Guillermo Garcia-Lopez,Nicolas Almagro,Guillermo Garcia-Lopez,6-3; 3-6; 5-7; 6-1; 6-2,R64,161,12,9,83,131,68,83,19,48,3,7,23,87,131,13,6,64,125,45,64,31,61,8,15,22,76,125
2008-06-23 00:00:00.000,Wimbledon Great Britain Grand Slams,GRASS,3,Rainer Schuettler,James Blake,Rainer Schuettler,6-3; 6-7(8); 4-6; 6-4; 6-4,R64,200,9,6,96,165,74,96,38,69,10,13,26,112,165,18,6,113,178,80,113,31,65,9,14,25,111,178
2008-06-23 00:00:00.000,Wimbledon Great Britain Grand Slams,GRASS,3,Paul-Henri Mathieu,Jeremy Chardy,Paul-Henri Mathieu,6-3; 7-5; 7-6(1),R64,125,6,6,60,101,48,60,24,41,5,7,17,72,101,13,9,51,101,39,51,21,50,2,6,16,60,101
2008-06-23 00:00:00.000,Wimbledon Great Britain Grand Slams,GRASS,3,Marin Cilic,Jarkko Nieminen,Marin Cilic,6-4; 3-6; 6-3; 6-7(6); 7-5,R64,197,19,5,90,157,72,90,38,67,10,14,26,110,157,3,4,114,166,67,114,33,52,10,16,26,100,166
2008-06-23 00:00:00.000,Wimbledon Great Britain Grand Slams,GRASS,3,Jurgen Melzer,Jesse Levine,Jurgen Melzer,4-6; 6-2; 3-6; 6-4; 6-1,R64,152,14,2,74,112,58,74,22,38,1,4,22,80,112,8,7,97,148,67,97,19,51,10,16,22,86,148
2008-06-23 00:00:00.000,Wimbledon Great Britain Grand Slams,GRASS,3,Arnaud Clement,Benjamin Becker,Arnaud Clement,7-6(7); 7-6(3); 6-3,R64,151,5,1,52,107,44,52,38,55,2,3,17,82,107,16,4,63,111,50,63,25,48,5,7,16,75,111
2008-06-23 00:00:00.000,Wimbledon Great Britain Grand Slams,GRASS,3,Richard Gasquet,Sebastien Grosjean,Richard Gasquet,6-2; 6-2 RET,R64,56,3,2,34,44,28,34,5,10,2,2,8,33,44,3,0,30,50,16,30,8,20,2,6,8,24,50
2008-06-23 00:00:00.000,Wimbledon Great Britain Grand Slams,GRASS,3,Gilles Simon,Agustin Calleri,Gilles Simon,5-7; 6-2; 6-3; 6-4,R64,118,6,1,70,112,57,70,24,42,0,1,20,81,112,10,4,67,115,48,67,26,48,4,8,19,74,115
2008-06-23 00:00:00.000,Wimbledon Great Britain Grand Slams,GRASS,3,Tommy Haas,Tommy Robredo,Tommy Haas,6-4; 6-4; 6-3,R64,124,7,6,55,76,49,55,9,21,0,1,15,58,76,7,1,71,129,45,71,26,58,17,21,14,71,129
2008-06-23 00:00:00.000,Wimbledon Great Britain Grand Slams,GRASS,3,Andy Murray,Xavier Malisse,Andy Murray,6-4; 6-2; 6-2,R64,95,17,2,55,82,45,55,13,27,2,3,13,58,82,2,2,53,84,32,53,11,31,5,11,13,43,84
2008-06-23 00:00:00.000,Wimbledon Great Britain Grand Slams,GRASS,3,Radek Stepanek,Viktor Troicki,Radek Stepanek,6-7(1); 6-7(3); 6-3; 6-1; 6-2,R64,196,15,8,107,159,77,107,30,52,8,10,24,107,159,14,7,111,163,74,111,24,52,11,19,24,98,163
2008-06-23 00:00:00.000,Wimbledon Great Britain Grand Slams,GRASS,3,Mikhail Youzhny,Stefano Galvani,Mikhail Youzhny,4-6; 6-4; 6-3; 3-6; 6-3,R64,205,12,7,89,147,68,89,30,58,6,10,24,98,147,5,6,98,157,67,98,30,59,6,11,23,97,157
2008-06-23 00:00:00.000,Wimbledon Great Britain Grand Slams,GRASS,3,Nicolas Kiefer,Martin Vassallo Arguello,Nicolas Kiefer,6-0; 6-3; 6-1,R64,94,10,2,35,60,31,35,14,25,1,1,11,45,60,3,5,49,74,24,49,9,25,10,17,11,33,74
2008-06-23 00:00:00.000,Wimbledon Great Britain Grand Slams,GRASS,3,Rafael Nadal,Ernests Gulbis,Rafael Nadal,5-7; 6-2; 7-6(2); 6-3,R64,178,4,1,81,122,65,81,25,41,1,2,21,90,122,15,3,82,120,62,82,17,38,4,7,20,79,120
2008-06-23 00:00:00.000,Wimbledon Great Britain Grand Slams,GRASS,3,Roger Federer,Marc Gicquel,Roger Federer,6-3; 6-3; 6-1,R32,82,10,1,49,68,41,49,11,19,2,3,13,52,68,5,1,55,82,35,55,7,27,7,13,12,42,82
2008-06-23 00:00:00.000,Wimbledon Great Britain Grand Slams,GRASS,3,Lleyton Hewitt,Simone Bolelli,Lleyton Hewitt,6-1; 6-3; 7-6(2),R32,125,14,0,40,76,37,40,24,36,0,0,14,61,76,12,4,64,102,43,64,14,38,8,12,14,57,102
2008-06-23 00:00:00.000,Wimbledon Great Britain Grand Slams,GRASS,3,Fernando Verdasco,Tomas Berdych,Fernando Verdasco,6-4; 6-4; 6-0,R32,100,11,0,42,69,38,42,17,27,0,0,13,55,69,4,2,44,85,29,44,20,41,5,10,13,49,85
2008-06-23 00:00:00.000,Wimbledon Great Britain Grand Slams,GRASS,3,Mario Ancic,David Ferrer,Mario Ancic,6-4; 6-4; 6-7(5); 7-6(3),R32,191,23,3,87,144,73,87,33,57,6,6,22,106,144,5,3,92,131,71,92,20,39,2,4,22,91,131
2008-06-23 00:00:00.000,Wimbledon Great Britain Grand Slams,GRASS,3,Marat Safin,Andreas Seppi,Marat Safin,7-6(5); 3-6; 7-6(3); 6-4,R32,176,16,5,78,134,62,78,28,56,4,8,21,90,134,4,4,93,143,65,93,28,50,3,7,22,93,143
2008-06-23 00:00:00.000,Wimbledon Great Britain Grand Slams,GRASS,3,Stanislas Wawrinka,Mischa Zverev,Stanislas Wawrinka,7-5; 6-1 RET,R32,82,8,4,39,69,30,39,17,30,4,4,10,47,69,1,1,42,61,26,42,11,19,4,7,9,37,61
2008-06-23 00:00:00.000,Wimbledon Great Britain Grand Slams,GRASS,3,Marcos Baghdatis,Simon Stadler,Marcos Baghdatis,7-6(2); 6-4; 6-2,R32,120,5,2,60,100,45,60,23,40,3,4,15,68,100,0,2,67,93,45,67,13,26,4,8,15,58,93
2008-06-23 00:00:00.000,Wimbledon Great Britain Grand Slams,GRASS,3,Feliciano Lopez,Bobby Reynolds,Feliciano Lopez,6-4; 7-5; 4-6; 6-4,R32,135,24,0,74,108,62,74,21,34,2,3,21,83,108,17,2,77,120,57,77,24,43,3,6,21,81,120
2008-06-23 00:00:00.000,Wimbledon Great Britain Grand Slams,GRASS,3,Janko Tipsarevic,Dmitry Tursunov,Janko Tipsarevic,7-6(1); 7-6(3); 6-3,R32,143,13,4,71,113,59,71,25,42,7,7,17,84,113,16,5,63,105,50,63,25,42,6,7,16,75,105
2008-06-23 00:00:00.000,Wimbledon Great Britain Grand Slams,GRASS,3,Rainer Schuettler,Guillermo Garcia-Lopez,Rainer Schuettler,6-2; 6-3; 6-4,R32,123,4,2,41,79,30,41,21,38,2,5,14,51,79,0,4,56,87,31,56,12,31,7,14,13,43,87
2008-06-23 00:00:00.000,Wimbledon Great Britain Grand Slams,GRASS,3,Marin Cilic,Paul-Henri Mathieu,Marin Cilic,6-7(5); 6-3; 6-4; 7-6(7),R32,179,18,5,90,146,70,90,33,56,5,6,22,103,146,6,2,72,126,51,72,35,54,1,4,21,86,126
2008-06-23 00:00:00.000,Wimbledon Great Britain Grand Slams,GRASS,3,Arnaud Clement,Jurgen Melzer,Arnaud Clement,4-6; 6-3; 6-4; 6-4,R32,157,16,3,68,121,51,68,33,53,5,7,20,84,121,16,4,62,115,47,62,25,53,5,9,19,72,115
2008-06-23 00:00:00.000,Wimbledon Great Britain Grand Slams,GRASS,3,Richard Gasquet,Gilles Simon,Richard Gasquet,6-3; 6-3; 6-7(3); 6-3,R32,151,14,2,83,133,60,83,23,50,2,6,20,83,133,5,3,75,123,44,75,23,48,2,10,19,67,123
2008-06-23 00:00:00.000,Wimbledon Great Britain Grand Slams,GRASS,3,Andy Murray,Tommy Haas,Andy Murray,6-4; 6-7(4); 6-3; 6-2,R32,155,14,4,68,127,55,68,33,59,3,4,20,88,127,11,6,68,109,54,68,16,41,7,12,19,70,109
2008-06-23 00:00:00.000,Wimbledon Great Britain Grand Slams,GRASS,3,Mikhail Youzhny,Radek Stepanek,Mikhail Youzhny,7-5; 6-7(5); 6-4; 6-7(4); 6-3,R32,255,12,2,131,209,96,131,43,78,14,15,28,139,209,17,7,105,157,81,105,28,52,6,10,27,109,157
2008-06-23 00:00:00.000,Wimbledon Great Britain Grand Slams,GRASS,3,Rafael Nadal,Nicolas Kiefer,Rafael Nadal,7-6(3); 6-2; 6-3,R32,142,5,1,68,87,51,68,13,19,1,2,15,64,87,13,2,46,88,38,46,14,42,2,6,14,52,88
2008-06-23 00:00:00.000,Wimbledon Great Britain Grand Slams,GRASS,3,Roger Federer,Lleyton Hewitt,Roger Federer,7-6(7); 6-2; 6-4,R16,110,21,3,60,98,51,60,20,38,8,8,15,71,98,8,1,54,87,42,54,16,33,0,3,15,58,87
2008-06-23 00:00:00.000,Wimbledon Great Britain Grand Slams,GRASS,3,Mario Ancic,Fernando Verdasco,Mario Ancic,3-6; 4-6; 6-3; 6-4; 13-11,R16,230,15,6,111,183,86,111,35,72,5,9,31,121,183,10,14,122,172,90,122,26,50,3,8,31,116,172
2008-06-23 00:00:00.000,Wimbledon Great Britain Grand Slams,GRASS,3,Marat Safin,Stanislas Wawrinka,Marat Safin,6-4; 6-3; 5-7; 6-1,R16,161,6,5,66,126,49,66,33,60,11,14,19,82,126,8,8,63,114,40,63,21,51,6,13,19,61,114
2008-06-23 00:00:00.000,Wimbledon Great Britain Grand Slams,GRASS,3,Feliciano Lopez,Marcos Baghdatis,Feliciano Lopez,5-7; 6-2; 3-6; 7-6(4); 8-6,R16,222,25,3,106,171,83,106,38,65,10,12,27,121,171,18,5,98,173,76,98,42,75,7,10,28,118,173
2008-06-23 00:00:00.000,Wimbledon Great Britain Grand Slams,GRASS,3,Rainer Schuettler,Janko Tipsarevic,Rainer Schuettler,6-4; 3-6; 6-4; 7-6(4),R16,186,11,5,74,129,62,74,29,55,4,5,20,91,129,20,4,78,135,63,78,30,57,9,11,21,93,135
2008-06-23 00:00:00.000,Wimbledon Great Britain Grand Slams,GRASS,3,Arnaud Clement,Marin Cilic,Arnaud Clement,6-3; 7-5; 6-2,R16,118,6,0,58,94,43,58,21,36,3,4,15,64,94,16,3,48,87,36,48,16,39,4,9,14,52,87
2008-06-23 00:00:00.000,Wimbledon Great Britain Grand Slams,GRASS,3,Andy Murray,Richard Gasquet,Andy Murray,5-7; 3-6; 7-6(3); 6-2; 6-4,R16,238,15,6,103,187,78,103,43,84,15,18,25,121,187,12,6,114,188,85,114,32,74,11,15,26,117,188
2008-06-23 00:00:00.000,Wimbledon Great Britain Grand Slams,GRASS,3,Rafael Nadal,Mikhail Youzhny,Rafael Nadal,6-3; 6-3; 6-1,R16,131,3,1,49,70,38,49,13,21,3,4,13,51,70,4,5,60,95,35,60,12,35,10,16,12,47,95
2008-06-23 00:00:00.000,Wimbledon Great Britain Grand Slams,GRASS,3,Roger Federer,Mario Ancic,Roger Federer,6-1; 7-5; 6-4,Q,102,15,0,49,71,43,49,18,22,0,0,15,61,71,9,2,58,95,41,58,17,37,6,10,14,58,95
2008-06-23 00:00:00.000,Wimbledon Great Britain Grand Slams,GRASS,3,Marat Safin,Feliciano Lopez,Marat Safin,3-6; 7-5; 7-6(1); 6-3,Q,160,18,3,69,122,53,69,31,53,5,8,20,84,122,17,6,74,127,57,74,22,53,3,8,22,79,127
2008-06-23 00:00:00.000,Wimbledon Great Britain Grand Slams,GRASS,3,Rainer Schuettler,Arnaud Clement,Rainer Schuettler,6-3; 5-7; 7-6(6); 6-7(7); 8-6,Q,312,13,7,116,202,79,116,46,86,8,15,30,125,202,9,5,118,214,74,118,52,96,11,19,29,126,214
2008-06-23 00:00:00.000,Wimbledon Great Britain Grand Slams,GRASS,3,Rafael Nadal,Andy Murray,Rafael Nadal,6-3; 6-2; 6-4,Q,115,4,1,41,66,36,41,20,25,0,0,14,56,66,5,2,46,91,31,46,18,45,6,10,13,49,91
2008-06-23 00:00:00.000,Wimbledon Great Britain Grand Slams,GRASS,3,Roger Federer,Marat Safin,Roger Federer,6-3; 7-6(3); 6-4,S,103,15,0,60,90,46,60,24,30,2,2,16,70,90,13,0,62,93,46,62,17,31,3,5,15,63,93
2008-06-23 00:00:00.000,Wimbledon Great Britain Grand Slams,GRASS,3,Rafael Nadal,Rainer Schuettler,Rafael Nadal,6-1; 7-6(3); 6-4,S,122,6,1,60,75,49,60,10,15,1,2,14,59,75,3,0,60,89,39,60,13,29,7,12,15,52,89
2008-06-23 00:00:00.000,Wimbledon Great Britain Grand Slams,GRASS,3,Rafael Nadal,Roger Federer,Rafael Nadal,6-4; 6-4; 6-7(5); 6-7(8); 9-7,F,288,6,3,160,218,111,160,34,58,12,13,30,145,218,25,2,127,195,92,127,39,68,9,13,30,131,195
2008-07-07 00:00:00.000,Bsstad Sweden ATP World Tour,CLAY,2,David Ferrer,N/A Bye,David Ferrer,,R32,0,0,0,0,0,0,0,0,0,0,0,0,0,0,0,0,0,0,0,0,0,0,0,0,0,0,0
2008-07-07 00:00:00.000,Bsstad Sweden ATP World Tour,CLAY,2,Boris Pashanski,Nicolas Massu,Boris Pashanski,6-2; 6-3,R32,82,1,0,38,59,29,38,12,21,4,4,9,41,59,1,2,19,46,13,19,11,27,3,6,8,24,46
2008-07-07 00:00:00.000,Bsstad Sweden ATP World Tour,CLAY,2,Olivier Rochus,Marc Gicquel,Olivier Rochus,6-3; 6-4,R32,71,3,3,35,67,23,35,21,32,8,9,10,44,67,9,0,37,55,26,37,5,18,4,7,9,31,55
2008-07-07 00:00:00.000,Bsstad Sweden ATP World Tour,CLAY,2,Robin Soderling,Fabio Fognini,Robin Soderling,6-1; 6-7(4); 7-5,R32,141,13,1,60,106,42,60,30,46,7,9,16,72,106,3,1,49,101,37,49,22,52,5,10,15,59,101
2008-07-07 00:00:00.000,Bsstad Sweden ATP World Tour,CLAY,2,Tommy Robredo,N/A Bye,Tommy Robredo,,R32,0,0,0,0,0,0,0,0,0,0,0,0,0,0,0,0,0,0,0,0,0,0,0,0,0,0,0
2008-07-07 00:00:00.000,Bsstad Sweden ATP World Tour,CLAY,2,Jonas Bjorkman,Marcel Granollers,Jonas Bjorkman,6-3; 6-1,R32,65,2,0,19,37,18,19,14,18,0,0,8,32,37,2,1,44,61,26,44,6,17,8,12,8,32,61
2008-07-07 00:00:00.000,Bsstad Sweden ATP World Tour,CLAY,2,Steve Darcis,Daniel Koellerer,Steve Darcis,7-6(4); 6-0,R32,67,4,1,53,57,39,53,3,4,1,2,9,42,57,1,2,51,60,26,51,5,9,1,5,9,31,60
2008-07-07 00:00:00.000,Bsstad Sweden ATP World Tour,CLAY,2,Jarkko Nieminen,Sergio Roitman,Jarkko Nieminen,6-4; 6-2,R32,70,0,1,48,67,36,48,10,19,5,5,9,46,67,2,2,42,65,33,42,4,23,6,9,9,37,65
2008-07-07 00:00:00.000,Bsstad Sweden ATP World Tour,CLAY,2,Potito Starace,Carlos Moya,Potito Starace,6-7(4); 7-6(6); 6-4,R32,178,1,2,91,125,57,91,22,34,6,8,17,79,125,5,4,72,119,49,72,29,47,6,9,17,78,119
2008-07-07 00:00:00.000,Bsstad Sweden ATP World Tour,CLAY,2,Marat Safin,Marc Lopez,Marat Safin,7-6(6); 7-5,R32,141,6,1,41,79,32,41,21,38,3,5,12,53,79,1,1,65,116,38,65,24,51,12,15,12,62,116
2008-07-07 00:00:00.000,Bsstad Sweden ATP World Tour,CLAY,2,Thomas Johansson,Filip Prpic,Thomas Johansson,7-6(4); 6-3,R32,97,8,2,43,75,31,43,19,32,2,3,11,50,75,5,6,46,75,33,46,13,29,6,8,10,46,75
2008-07-07 00:00:00.000,Bsstad Sweden ATP World Tour,CLAY,2,Tomas Berdych,N/A Bye,Tomas Berdych,,R32,0,0,0,0,0,0,0,0,0,0,0,0,0,0,0,0,0,0,0,0,0,0,0,0,0,0,0
2008-07-07 00:00:00.000,Bsstad Sweden ATP World Tour,CLAY,2,Michael Ryderstedt,Tim Goransson,Michael Ryderstedt,6-1; 6-2,R32,80,4,0,33,51,22,33,15,18,3,3,8,37,51,5,4,31,64,18,31,14,33,6,10,7,32,64
2008-07-07 00:00:00.000,Bsstad Sweden ATP World Tour,CLAY,2,Bjorn Rehnquist,Michal Przysiezny,Bjorn Rehnquist,7-5; 6-2,R32,93,1,2,32,56,22,32,15,24,5,7,10,37,56,1,5,39,72,22,39,14,33,5,10,10,36,72
2008-07-07 00:00:00.000,Bsstad Sweden ATP World Tour,CLAY,2,Ervin Eleskovic,Filippo Volandri,Ervin Eleskovic,6-4; 6-4,R32,91,9,1,41,66,32,41,11,25,6,7,10,43,66,0,0,61,79,37,61,7,18,8,11,10,44,79
2008-07-07 00:00:00.000,Bsstad Sweden ATP World Tour,CLAY,2,Fernando Verdasco,N/A Bye,Fernando Verdasco,,R32,0,0,0,0,0,0,0,0,0,0,0,0,0,0,0,0,0,0,0,0,0,0,0,0,0,0,0
2008-07-07 00:00:00.000,Bsstad Sweden ATP World Tour,CLAY,2,David Ferrer,Boris Pashanski,David Ferrer,7-5; 6-1,R16,86,1,3,29,51,20,29,15,22,1,3,10,35,51,2,7,40,75,24,40,12,35,6,11,9,36,75
2008-07-07 00:00:00.000,Bsstad Sweden ATP World Tour,CLAY,2,Robin Soderling,Olivier Rochus,Robin Soderling,6-3; 6-3,R16,72,11,2,30,55,26,30,13,25,4,4,9,39,55,4,1,39,56,25,39,8,17,5,8,9,33,56
2008-07-07 00:00:00.000,Bsstad Sweden ATP World Tour,CLAY,2,Tommy Robredo,Jonas Bjorkman,Tommy Robredo,6-2; 6-3,R16,67,2,1,27,39,21,27,9,12,0,1,8,30,39,0,3,37,57,26,37,3,20,6,11,9,29,57
2008-07-07 00:00:00.000,Bsstad Sweden ATP World Tour,CLAY,2,Jarkko Nieminen,Steve Darcis,Jarkko Nieminen,6-3; 6-1,R16,56,0,0,29,41,23,29,9,12,0,0,8,32,41,3,2,27,45,19,27,3,18,0,4,8,22,45
2008-07-07 00:00:00.000,Bsstad Sweden ATP World Tour,CLAY,2,Potito Starace,Marat Safin,Potito Starace,7-6(4); 3-6; 6-4,R16,131,2,0,74,101,47,74,19,27,3,5,16,66,101,11,4,54,90,45,54,17,36,3,4,15,62,90
2008-07-07 00:00:00.000,Bsstad Sweden ATP World Tour,CLAY,2,Tomas Berdych,Thomas Johansson,Tomas Berdych,7-6(2); 6-2,R16,76,12,0,39,55,34,39,13,16,1,1,10,47,55,4,1,51,71,33,51,9,20,4,6,10,42,71
2008-07-07 00:00:00.000,Bsstad Sweden ATP World Tour,CLAY,2,Bjorn Rehnquist,Michael Ryderstedt,Bjorn Rehnquist,6-3; 7-5,R16,110,2,3,37,64,26,37,16,27,1,4,11,42,64,0,3,37,66,21,37,12,29,8,13,10,33,66
2008-07-07 00:00:00.000,Bsstad Sweden ATP World Tour,CLAY,2,Fernando Verdasco,Ervin Eleskovic,Fernando Verdasco,6-0; 4-2 RET,R16,43,2,1,29,35,22,29,4,6,2,2,6,26,35,2,5,22,35,11,22,3,13,5,9,6,14,35
2008-07-07 00:00:00.000,Bsstad Sweden ATP World Tour,CLAY,2,David Ferrer,Robin Soderling,David Ferrer,7-5; 6-7(3); 6-1,Q,163,4,4,79,131,50,79,27,52,13,16,16,77,131,0,6,58,106,37,58,23,48,7,13,15,60,106
2008-07-07 00:00:00.000,Bsstad Sweden ATP World Tour,CLAY,2,Tommy Robredo,Jarkko Nieminen,Tommy Robredo,6-2; 7-6(4),Q,92,4,0,44,60,33,44,9,16,0,2,10,42,60,0,3,41,64,27,41,9,23,4,8,10,36,64
2008-07-07 00:00:00.000,Bsstad Sweden ATP World Tour,CLAY,2,Tomas Berdych,Potito Starace,Tomas Berdych,6-3; 6-2,Q,57,7,1,31,46,26,31,11,15,0,0,9,37,46,1,0,38,43,23,38,2,5,3,6,8,25,43
2008-07-07 00:00:00.000,Bsstad Sweden ATP World Tour,CLAY,2,Fernando Verdasco,Bjorn Rehnquist,Fernando Verdasco,2-6; 6-1; 6-0,Q,108,1,6,53,74,33,53,9,21,8,11,10,42,74,0,4,60,79,32,60,4,19,8,15,11,36,79
2008-07-07 00:00:00.000,Bsstad Sweden ATP World Tour,CLAY,2,Tommy Robredo,David Ferrer,Tommy Robredo,2-6; 6-1; 6-2,S,126,1,0,63,85,40,63,11,22,5,7,12,51,85,0,1,44,69,28,44,11,25,7,11,11,39,69
2008-07-07 00:00:00.000,Bsstad Sweden ATP World Tour,CLAY,2,Tomas Berdych,Fernando Verdasco,Tomas Berdych,2-6; 6-3; 6-2,S,113,8,4,61,91,43,61,14,30,5,7,13,57,91,4,10,54,81,42,54,7,27,3,6,12,49,81
2008-07-07 00:00:00.000,Bsstad Sweden ATP World Tour,CLAY,2,Tommy Robredo,Tomas Berdych,Tommy Robredo,6-4; 6-1,F,74,4,1,45,55,30,45,5,10,4,5,8,35,55,2,1,30,47,17,30,5,17,2,7,9,22,47
2008-07-07 00:00:00.000,Gstaad Switzerland ATP World Tour,CLAY,2,Stanislas Wawrinka,N/A Bye,Stanislas Wawrinka,,R32,0,0,0,0,0,0,0,0,0,0,0,0,0,0,0,0,0,0,0,0,0,0,0,0,0,0,0
2008-07-07 00:00:00.000,Gstaad Switzerland ATP World Tour,CLAY,2,Stephane Bohli,Robin Roshardt,Stephane Bohli,6-2; 4-6; 6-4,R32,106,9,2,40,75,32,40,18,35,1,4,14,50,75,1,4,36,94,25,36,29,58,6,11,14,54,94
2008-07-07 00:00:00.000,Gstaad Switzerland ATP World Tour,CLAY,2,Kristof Vliegen,Martin Vassallo Arguello,Kristof Vliegen,6-3; 6-4,R32,83,5,2,37,64,29,37,17,27,1,1,10,46,64,3,2,43,68,29,43,12,25,8,10,9,41,68
2008-07-07 00:00:00.000,Gstaad Switzerland ATP World Tour,CLAY,2,Guillermo Canas,Ivo Minar,Guillermo Canas,7-6(9); 6-3,R32,105,4,4,43,88,32,43,24,45,1,2,11,56,88,2,3,44,80,27,44,23,36,5,7,10,50,80
2008-07-07 00:00:00.000,Gstaad Switzerland ATP World Tour,CLAY,2,Ivo Karlovic,N/A Bye,Ivo Karlovic,,R32,0,0,0,0,0,0,0,0,0,0,0,0,0,0,0,0,0,0,0,0,0,0,0,0,0,0,0
2008-07-07 00:00:00.000,Gstaad Switzerland ATP World Tour,CLAY,2,Victor Hanescu,Olivier Patience,Victor Hanescu,7-6(4); 6-2,R32,76,3,1,41,63,31,41,16,22,1,1,10,47,63,2,1,35,62,23,35,16,27,2,4,10,39,62
2008-07-07 00:00:00.000,Gstaad Switzerland ATP World Tour,CLAY,2,Jeremy Chardy,Luis Horna,Jeremy Chardy,7-6(5); 6-7(6); 7-5,R32,151,22,10,73,128,61,73,26,55,6,7,18,87,128,7,4,78,120,57,78,26,42,6,8,18,83,120
2008-07-07 00:00:00.000,Gstaad Switzerland ATP World Tour,CLAY,2,Dominik Meffert,Andreas Seppi,Dominik Meffert,6-2; 5-7; 6-4,R32,137,8,6,73,111,49,73,17,38,10,13,15,66,111,7,10,51,110,35,51,26,59,9,14,15,61,110
2008-07-07 00:00:00.000,Gstaad Switzerland ATP World Tour,CLAY,2,Nicolas Kiefer,Gianluca Naso,Nicolas Kiefer,6-3; 6-2,R32,78,7,2,27,57,22,27,17,30,2,3,9,39,57,4,1,27,53,18,27,7,26,5,9,8,25,53
2008-07-07 00:00:00.000,Gstaad Switzerland ATP World Tour,CLAY,2,Guillermo Garcia-Lopez,Michael Lammer,Guillermo Garcia-Lopez,5-7; 6-3; 6-2,R32,146,5,6,69,106,46,69,18,37,4,7,15,64,106,5,2,53,93,35,53,16,40,9,14,14,51,93
2008-07-07 00:00:00.000,Gstaad Switzerland ATP World Tour,CLAY,2,Flavio Cipolla,Jiri Vanek,Flavio Cipolla,5-7; 6-4; 6-4,R32,149,1,2,70,103,45,70,15,33,7,11,16,60,103,5,3,66,111,47,66,17,45,13,18,16,64,111
2008-07-07 00:00:00.000,Gstaad Switzerland ATP World Tour,CLAY,2,Mikhail Youzhny,N/A Bye,Mikhail Youzhny,,R32,0,0,0,0,0,0,0,0,0,0,0,0,0,0,0,0,0,0,0,0,0,0,0,0,0,0,0
2008-07-07 00:00:00.000,Gstaad Switzerland ATP World Tour,CLAY,2,Igor Andreev,Marcos Daniel,Igor Andreev,6-4; 7-5,R32,84,6,5,41,65,36,41,12,24,5,5,11,48,65,6,1,43,72,32,43,13,29,2,4,11,45,72
2008-07-07 00:00:00.000,Gstaad Switzerland ATP World Tour,CLAY,2,Florent Serra,Daniel Gimeno-Traver,Florent Serra,7-6(2); 7-6(5),R32,103,1,2,48,83,35,48,19,35,4,6,12,54,83,10,4,43,86,29,43,22,43,6,8,12,51,86
2008-07-07 00:00:00.000,Gstaad Switzerland ATP World Tour,CLAY,2,Marin Cilic,Josselin Ouanna,Marin Cilic,6-3; 6-4,R32,67,13,3,27,54,24,27,18,27,1,1,10,42,54,4,2,32,66,21,32,18,34,3,5,9,39,66
2008-07-07 00:00:00.000,Gstaad Switzerland ATP World Tour,CLAY,2,Paul-Henri Mathieu,N/A Bye,Paul-Henri Mathieu,,R32,0,0,0,0,0,0,0,0,0,0,0,0,0,0,0,0,0,0,0,0,0,0,0,0,0,0,0
2008-07-07 00:00:00.000,Gstaad Switzerland ATP World Tour,CLAY,2,Stanislas Wawrinka,Stephane Bohli,Stanislas Wawrinka,7-6(6); 5-7; 7-6(3),R16,165,13,5,68,111,54,68,26,43,3,4,18,80,111,4,6,61,123,45,61,38,62,3,3,18,83,123
2008-07-07 00:00:00.000,Gstaad Switzerland ATP World Tour,CLAY,2,Guillermo Canas,Kristof Vliegen,Guillermo Canas,W/O,R16,0,0,0,0,0,0,0,0,0,0,0,0,0,0,0,0,0,0,0,0,0,0,0,0,0,0,0
2008-07-07 00:00:00.000,Gstaad Switzerland ATP World Tour,CLAY,2,Victor Hanescu,Ivo Karlovic,Victor Hanescu,6-7(4); 7-6(3); 7-6(11),R16,152,9,0,81,114,68,81,26,33,1,1,18,94,114,28,4,89,131,78,89,20,42,4,4,18,98,131
2008-07-07 00:00:00.000,Gstaad Switzerland ATP World Tour,CLAY,2,Jeremy Chardy,Dominik Meffert,Jeremy Chardy,6-7(1); 7-6(5); 7-6(4),R16,166,19,9,65,130,58,65,31,65,6,8,18,89,130,6,9,69,123,50,69,34,54,4,6,18,84,123
2008-07-07 00:00:00.000,Gstaad Switzerland ATP World Tour,CLAY,2,Guillermo Garcia-Lopez,Nicolas Kiefer,Guillermo Garcia-Lopez,W/O,R16,0,0,0,0,0,0,0,0,0,0,0,0,0,0,0,0,0,0,0,0,0,0,0,0,0,0,0
2008-07-07 00:00:00.000,Gstaad Switzerland ATP World Tour,CLAY,2,Mikhail Youzhny,Flavio Cipolla,Mikhail Youzhny,6-3; 6-2,R16,92,6,8,52,89,37,52,16,37,12,13,9,53,89,0,5,37,58,20,37,8,21,7,11,8,28,58
2008-07-07 00:00:00.000,Gstaad Switzerland ATP World Tour,CLAY,2,Igor Andreev,Florent Serra,Igor Andreev,7-5; 6-4,R16,70,12,5,30,57,26,30,17,27,3,4,11,43,57,2,4,38,69,27,38,14,31,0,3,11,41,69
2008-07-07 00:00:00.000,Gstaad Switzerland ATP World Tour,CLAY,2,Marin Cilic,Paul-Henri Mathieu,Marin Cilic,6-3; 6-4,R16,84,11,4,23,53,21,23,20,30,3,3,10,41,53,3,3,29,70,19,29,23,41,8,10,9,42,70
2008-07-07 00:00:00.000,Gstaad Switzerland ATP World Tour,CLAY,2,Stanislas Wawrinka,Guillermo Canas,Stanislas Wawrinka,4-6; 6-4; 7-6(2),Q,152,6,6,60,91,44,60,16,31,2,6,16,60,91,17,4,61,113,43,61,23,52,8,12,16,66,113
2008-07-07 00:00:00.000,Gstaad Switzerland ATP World Tour,CLAY,2,Victor Hanescu,Jeremy Chardy,Victor Hanescu,6-3; 7-6(3),Q,77,4,1,46,61,38,46,12,15,3,3,11,50,61,2,2,33,57,25,33,16,24,1,2,10,41,57
2008-07-07 00:00:00.000,Gstaad Switzerland ATP World Tour,CLAY,2,Guillermo Garcia-Lopez,Mikhail Youzhny,Guillermo Garcia-Lopez,4-6; 7-5; 6-3,Q,128,4,4,54,98,41,54,24,44,7,9,16,65,98,7,2,42,84,31,42,26,42,4,7,15,57,84
2008-07-07 00:00:00.000,Gstaad Switzerland ATP World Tour,CLAY,2,Igor Andreev,Marin Cilic,Igor Andreev,7-6(4); 6-3,Q,85,6,4,51,79,41,51,14,28,4,4,11,55,79,12,6,32,64,24,32,18,32,2,3,10,42,64
2008-07-07 00:00:00.000,Gstaad Switzerland ATP World Tour,CLAY,2,Victor Hanescu,Stanislas Wawrinka,Victor Hanescu,6-3; 3-6; 6-4,S,124,12,2,52,80,38,52,14,28,2,4,14,52,80,6,1,61,97,40,61,20,36,8,11,14,60,97
2008-07-07 00:00:00.000,Gstaad Switzerland ATP World Tour,CLAY,2,Igor Andreev,Guillermo Garcia-Lopez,Igor Andreev,7-6(2); 5-7; 7-6(5),S,182,8,3,66,106,55,66,25,40,3,4,18,80,106,3,7,69,129,52,69,33,60,7,7,18,85,129
2008-07-07 00:00:00.000,Gstaad Switzerland ATP World Tour,CLAY,2,Victor Hanescu,Igor Andreev,Victor Hanescu,6-3; 6-4,F,70,1,1,37,52,29,37,11,15,0,0,10,40,52,2,0,38,57,26,38,11,19,3,5,9,37,57
2008-07-07 00:00:00.000,Newport RI; U.S.A. ATP World Tour,GRASS,2,Mardy Fish,N/A Bye,Mardy Fish,,R32,0,0,0,0,0,0,0,0,0,0,0,0,0,0,0,0,0,0,0,0,0,0,0,0,0,0,0
2008-07-07 00:00:00.000,Newport RI; U.S.A. ATP World Tour,GRASS,2,Rohan Bopanna,Kevin Kim,Rohan Bopanna,6-3; 6-4,R32,72,15,7,37,79,28,37,20,42,8,9,10,48,79,1,9,19,65,13,19,24,46,7,10,9,37,65
2008-07-07 00:00:00.000,Newport RI; U.S.A. ATP World Tour,GRASS,2,Prakash Amritraj,Joseph Sirianni,Prakash Amritraj,6-7(3); 6-4; 6-4,R32,120,4,6,55,96,45,55,24,41,3,3,16,69,96,6,6,52,98,40,52,28,46,5,7,16,68,98
2008-07-07 00:00:00.000,Newport RI; U.S.A. ATP World Tour,GRASS,2,Jesse Levine,John Isner,Jesse Levine,6-3; 6-1,R32,54,1,4,27,44,14,27,7,17,1,5,8,21,44,7,4,30,49,24,30,10,19,0,0,8,34,49
2008-07-07 00:00:00.000,Newport RI; U.S.A. ATP World Tour,GRASS,2,Igor Kunitsyn,N/A Bye,Igor Kunitsyn,,R32,0,0,0,0,0,0,0,0,0,0,0,0,0,0,0,0,0,0,0,0,0,0,0,0,0,0,0
2008-07-07 00:00:00.000,Newport RI; U.S.A. ATP World Tour,GRASS,2,Mikhail Ledovskikh,Kristian Pless,Mikhail Ledovskikh,4-6; 7-5; 6-4,R32,103,7,8,53,98,37,53,17,45,4,11,16,54,98,4,22,51,98,39,51,9,47,9,17,16,48,98
2008-07-07 00:00:00.000,Newport RI; U.S.A. ATP World Tour,GRASS,2,Brendan Evans,Paul Capdeville,Brendan Evans,6-4; 3-6; 6-1,R32,94,7,6,66,97,41,66,19,31,10,12,13,60,97,9,4,39,75,25,39,22,36,4,8,13,47,75
2008-07-07 00:00:00.000,Newport RI; U.S.A. ATP World Tour,GRASS,2,Frank Dancevic,Taylor Dent,Frank Dancevic,3-6; 7-5; 6-1,R32,101,6,9,56,95,43,56,16,39,8,11,14,59,95,8,11,51,89,35,51,17,38,6,11,14,52,89
2008-07-07 00:00:00.000,Newport RI; U.S.A. ATP World Tour,GRASS,2,Donald Young,Woong-Sun Jun,Donald Young,6-3; 2-6; 6-4,R32,98,3,7,50,93,37,50,22,43,6,8,14,59,93,3,5,44,78,37,44,16,34,1,3,13,53,78
2008-07-07 00:00:00.000,Newport RI; U.S.A. ATP World Tour,GRASS,2,Alexander Peya,Philipp Petzschner,Alexander Peya,6-7(3); 6-3; 7-5,R32,120,2,1,80,105,54,80,13,25,7,9,16,67,105,1,7,60,110,38,60,28,50,8,13,17,66,110
2008-07-07 00:00:00.000,Newport RI; U.S.A. ATP World Tour,GRASS,2,Vincent Spadea,Simon Stadler,Vincent Spadea,6-2; 3-6; 6-4,R32,89,3,4,47,76,32,47,12,29,2,7,14,44,76,1,3,54,82,31,54,12,28,4,10,13,43,82
2008-07-07 00:00:00.000,Newport RI; U.S.A. ATP World Tour,GRASS,2,Nicolas Mahut,N/A Bye,Nicolas Mahut,,R32,0,0,0,0,0,0,0,0,0,0,0,0,0,0,0,0,0,0,0,0,0,0,0,0,0,0,0
2008-07-07 00:00:00.000,Newport RI; U.S.A. ATP World Tour,GRASS,2,Kevin Anderson,Gilles Muller,Kevin Anderson,6-7(3); 6-3; 6-3,R32,123,11,4,49,84,40,49,22,35,3,4,15,62,84,14,6,55,110,41,55,25,55,7,11,15,66,110
2008-07-07 00:00:00.000,Newport RI; U.S.A. ATP World Tour,GRASS,2,Ivan Navarro,Rik De Voest,Ivan Navarro,7-5; 6-4,R32,78,2,4,34,57,28,34,15,23,0,1,11,43,57,0,2,42,67,25,42,14,25,3,6,11,39,67
2008-07-07 00:00:00.000,Newport RI; U.S.A. ATP World Tour,GRASS,2,Aisam-Ul-Haq Qureshi,Benjamin Becker,Aisam-Ul-Haq Qureshi,7-5; 7-6(5),R32,91,7,4,43,72,39,43,17,29,2,2,12,56,72,14,5,37,73,32,37,21,36,2,3,12,53,73
2008-07-07 00:00:00.000,Newport RI; U.S.A. ATP World Tour,GRASS,2,Fabrice Santoro,N/A Bye,Fabrice Santoro,,R32,0,0,0,0,0,0,0,0,0,0,0,0,0,0,0,0,0,0,0,0,0,0,0,0,0,0,0
2008-07-07 00:00:00.000,Newport RI; U.S.A. ATP World Tour,GRASS,2,Rohan Bopanna,Mardy Fish,Rohan Bopanna,7-6(6); 7-5,R16,93,14,5,45,88,38,45,19,43,7,9,12,57,88,8,3,32,71,27,32,20,39,1,4,12,47,71
2008-07-07 00:00:00.000,Newport RI; U.S.A. ATP World Tour,GRASS,2,Prakash Amritraj,Jesse Levine,Prakash Amritraj,7-5; 6-3,R16,90,5,2,32,55,27,32,13,23,1,2,10,40,55,8,10,43,87,27,43,21,44,12,16,11,48,87
2008-07-07 00:00:00.000,Newport RI; U.S.A. ATP World Tour,GRASS,2,Igor Kunitsyn,Mikhail Ledovskikh,Igor Kunitsyn,6-1; 6-1,R16,50,0,1,22,39,18,22,9,17,0,1,7,27,39,3,5,26,47,13,26,5,21,3,9,7,18,47
2008-07-07 00:00:00.000,Newport RI; U.S.A. ATP World Tour,GRASS,2,Frank Dancevic,Brendan Evans,Frank Dancevic,5-7; 6-4; 7-6(3),R16,126,16,3,73,123,52,73,31,50,10,11,17,83,123,5,5,71,105,54,71,19,34,11,12,17,73,105
2008-07-07 00:00:00.000,Newport RI; U.S.A. ATP World Tour,GRASS,2,Alexander Peya,Donald Young,Alexander Peya,7-6(4); 6-3,R16,72,2,2,50,73,39,50,15,23,2,2,11,54,73,4,4,38,68,30,38,15,30,4,5,10,45,68
2008-07-07 00:00:00.000,Newport RI; U.S.A. ATP World Tour,GRASS,2,Vincent Spadea,Nicolas Mahut,Vincent Spadea,6-2; 6-3,R16,61,4,1,28,52,23,28,15,24,1,1,9,38,52,0,3,27,48,17,27,12,21,4,7,8,29,48
2008-07-07 00:00:00.000,Newport RI; U.S.A. ATP World Tour,GRASS,2,Ivan Navarro,Kevin Anderson,Ivan Navarro,7-6(3); 3-6; 6-4,R16,135,9,2,66,113,47,66,27,47,5,7,16,74,113,9,2,60,92,44,60,21,32,3,4,15,65,92
2008-07-07 00:00:00.000,Newport RI; U.S.A. ATP World Tour,GRASS,2,Fabrice Santoro,Aisam-Ul-Haq Qureshi,Fabrice Santoro,7-6(4); 6-2,R16,85,3,1,31,53,26,31,17,22,0,0,10,43,53,2,3,40,70,29,40,12,30,4,6,10,41,70
2008-07-07 00:00:00.000,Newport RI; U.S.A. ATP World Tour,GRASS,2,Prakash Amritraj,Rohan Bopanna,Prakash Amritraj,6-4; 6-3,Q,60,9,0,29,50,27,29,14,21,0,0,10,41,50,9,6,27,49,23,27,8,22,3,5,9,31,49
2008-07-07 00:00:00.000,Newport RI; U.S.A. ATP World Tour,GRASS,2,Frank Dancevic,Igor Kunitsyn,Frank Dancevic,7-5; 6-3,Q,78,6,2,50,82,37,50,18,32,6,6,11,55,82,2,5,30,62,22,30,18,32,4,6,10,40,62
2008-07-07 00:00:00.000,Newport RI; U.S.A. ATP World Tour,GRASS,2,Vincent Spadea,Alexander Peya,Vincent Spadea,7-6(3); 7-5,Q,105,4,1,47,83,40,47,15,36,4,6,12,55,83,5,4,47,83,39,47,12,36,5,8,12,51,83
2008-07-07 00:00:00.000,Newport RI; U.S.A. ATP World Tour,GRASS,2,Fabrice Santoro,Ivan Navarro,Fabrice Santoro,6-3; 7-6(4),Q,110,2,1,43,72,27,43,20,29,1,2,11,47,72,5,3,51,89,31,51,19,38,7,9,10,50,89
2008-07-07 00:00:00.000,Newport RI; U.S.A. ATP World Tour,GRASS,2,Prakash Amritraj,Frank Dancevic,Prakash Amritraj,7-6(4); 4-6; 6-3,S,139,7,4,65,103,51,65,22,38,2,3,16,73,103,13,1,79,116,58,79,21,37,13,14,15,79,116
2008-07-07 00:00:00.000,Newport RI; U.S.A. ATP World Tour,GRASS,2,Fabrice Santoro,Vincent Spadea,Fabrice Santoro,7-6(4); 6-1,S,78,2,1,46,65,37,46,9,19,3,4,10,46,65,2,1,36,57,25,36,9,21,1,4,9,34,57
2008-07-07 00:00:00.000,Newport RI; U.S.A. ATP World Tour,GRASS,2,Fabrice Santoro,Prakash Amritraj,Fabrice Santoro,6-3; 7-5,F,75,2,0,38,54,29,38,13,16,0,1,11,42,54,4,3,32,56,19,32,17,24,2,5,10,36,56
2008-07-07 00:00:00.000,Stuttgart Germany ATP World Tour,CLAY,2,Jan Hernych,N/A Bye,Jan Hernych,,R32,0,0,0,0,0,0,0,0,0,0,0,0,0,0,0,0,0,0,0,0,0,0,0,0,0,0,0
2008-07-07 00:00:00.000,Stuttgart Germany ATP World Tour,CLAY,2,Brian Dabul,Denis Gremelmayr,Brian Dabul,6-3; 5-7; 6-3,R32,152,3,2,75,102,43,75,16,27,6,10,15,59,102,2,4,73,116,41,73,20,43,13,19,15,61,116
2008-07-07 00:00:00.000,Stuttgart Germany ATP World Tour,CLAY,2,Andreas Beck,Daniel Brands,Andreas Beck,3-6; 6-3; 6-4,R32,117,4,2,64,102,46,64,20,38,4,5,14,66,102,13,5,72,94,55,72,6,22,7,9,14,61,94
2008-07-07 00:00:00.000,Stuttgart Germany ATP World Tour,CLAY,2,Eduardo Schwank,Guillermo Coria,Eduardo Schwank,0-6; 6-1; 6-2,R32,116,5,1,51,71,30,51,9,20,2,6,10,39,71,0,19,37,72,21,37,12,35,2,8,11,33,72
2008-07-07 00:00:00.000,Stuttgart Germany ATP World Tour,CLAY,2,Philipp Kohlschreiber,N/A Bye,Philipp Kohlschreiber,,R32,0,0,0,0,0,0,0,0,0,0,0,0,0,0,0,0,0,0,0,0,0,0,0,0,0,0,0
2008-07-07 00:00:00.000,Stuttgart Germany ATP World Tour,CLAY,2,Yuri Schukin,Carlos Berlocq,Yuri Schukin,4-6; 7-5; 6-3,R32,162,0,2,68,94,36,68,14,26,6,12,15,50,94,4,1,77,115,45,77,17,38,5,13,16,62,115
2008-07-07 00:00:00.000,Stuttgart Germany ATP World Tour,CLAY,2,Juan Martin Del Potro,Evgeny Korolev,Juan Martin Del Potro,6-3; 7-5,R32,93,5,5,33,61,24,33,18,28,1,3,11,42,61,2,6,34,58,22,34,10,24,6,10,10,32,58
2008-07-07 00:00:00.000,Stuttgart Germany ATP World Tour,CLAY,2,Simone Bolelli,Mischa Zverev,Simone Bolelli,6-7(6); 6-4; 6-2,R32,152,3,1,81,108,61,81,13,27,4,4,15,74,108,7,1,66,104,46,66,18,38,5,8,15,64,104
2008-07-07 00:00:00.000,Stuttgart Germany ATP World Tour,CLAY,2,Agustin Calleri,Jurgen Melzer,Agustin Calleri,7-6(3); 6-4,R32,84,8,5,33,65,26,33,19,32,2,4,11,45,65,5,2,47,71,29,47,13,24,4,7,11,42,71
2008-07-07 00:00:00.000,Stuttgart Germany ATP World Tour,CLAY,2,Pablo Cuevas,Santiago Giraldo,Pablo Cuevas,4-6; 6-4; 7-6(11),R32,158,9,7,63,130,42,63,29,67,7,13,16,71,130,11,5,60,109,40,60,25,49,7,13,16,65,109
2008-07-07 00:00:00.000,Stuttgart Germany ATP World Tour,CLAY,2,Michael Berrer,Eric Prodon,Michael Berrer,6-3; 6-4,R32,70,12,11,38,69,32,38,11,31,10,12,10,43,69,4,3,30,47,20,30,5,17,2,6,9,25,47
2008-07-07 00:00:00.000,Stuttgart Germany ATP World Tour,CLAY,2,Nicolas Almagro,N/A Bye,Nicolas Almagro,,R32,0,0,0,0,0,0,0,0,0,0,0,0,0,0,0,0,0,0,0,0,0,0,0,0,0,0,0
2008-07-07 00:00:00.000,Stuttgart Germany ATP World Tour,CLAY,2,Albert Montanes,Jose Acasuso,Albert Montanes,6-3; 7-6(5),R32,94,6,4,35,70,27,35,22,35,0,1,11,49,70,2,6,38,64,28,38,11,26,3,5,10,39,64
2008-07-07 00:00:00.000,Stuttgart Germany ATP World Tour,CLAY,2,Oscar Hernandez,Santiago Ventura,Oscar Hernandez,6-1; 6-4,R32,85,3,2,39,53,28,39,8,14,1,2,9,36,53,3,5,34,70,21,34,13,36,12,16,8,34,70
2008-07-07 00:00:00.000,Stuttgart Germany ATP World Tour,CLAY,2,Lukas Rosol,Martin Fischer,Lukas Rosol,6-2; 6-4,R32,66,3,4,30,54,23,30,11,24,2,4,9,34,54,4,3,28,50,16,28,9,22,1,6,9,25,50
2008-07-07 00:00:00.000,Stuttgart Germany ATP World Tour,CLAY,2,Richard Gasquet,N/A Bye,Richard Gasquet,,R32,0,0,0,0,0,0,0,0,0,0,0,0,0,0,0,0,0,0,0,0,0,0,0,0,0,0,0
2008-07-07 00:00:00.000,Stuttgart Germany ATP World Tour,CLAY,2,Jan Hernych,Brian Dabul,Jan Hernych,7-6(5); 0-6; 7-6(5),R16,150,7,1,73,100,48,73,15,27,4,8,15,63,100,6,1,62,101,44,62,25,39,5,6,15,69,101
2008-07-07 00:00:00.000,Stuttgart Germany ATP World Tour,CLAY,2,Eduardo Schwank,Andreas Beck,Eduardo Schwank,7-6(5); 6-2,R16,93,11,1,45,67,39,45,11,22,1,1,10,50,67,7,5,39,69,30,39,11,30,2,4,10,41,69
2008-07-07 00:00:00.000,Stuttgart Germany ATP World Tour,CLAY,2,Philipp Kohlschreiber,Yuri Schukin,Philipp Kohlschreiber,6-3; 6-3,R16,81,4,4,30,52,22,30,12,22,1,2,9,34,52,3,3,44,72,23,44,13,28,5,9,9,36,72
2008-07-07 00:00:00.000,Stuttgart Germany ATP World Tour,CLAY,2,Juan Martin Del Potro,Simone Bolelli,Juan Martin Del Potro,6-3; 3-6; 6-3,R16,121,4,6,36,76,32,36,20,40,0,2,14,52,76,7,4,64,95,46,64,13,31,10,13,13,59,95
2008-07-07 00:00:00.000,Stuttgart Germany ATP World Tour,CLAY,2,Agustin Calleri,Pablo Cuevas,Agustin Calleri,5-7; 7-5; 6-1,R16,108,10,3,52,88,42,52,18,36,3,5,15,60,88,7,3,55,95,37,55,21,40,3,8,16,58,95
2008-07-07 00:00:00.000,Stuttgart Germany ATP World Tour,CLAY,2,Michael Berrer,Nicolas Almagro,Michael Berrer,7-5 RET,R16,44,0,0,14,28,12,14,12,14,0,0,6,24,28,6,2,21,37,17,21,10,16,1,2,6,27,37
2008-07-07 00:00:00.000,Stuttgart Germany ATP World Tour,CLAY,2,Albert Montanes,Oscar Hernandez,Albert Montanes,7-6(4); 6-4,R16,113,8,1,34,64,27,34,20,30,1,2,11,47,64,1,2,55,80,36,55,12,25,4,6,11,48,80
2008-07-07 00:00:00.000,Stuttgart Germany ATP World Tour,CLAY,2,Richard Gasquet,Lukas Rosol,Richard Gasquet,6-7(7); 6-2; 6-2,R16,112,12,2,54,88,40,54,15,34,3,6,14,55,88,3,5,42,94,27,42,22,52,3,10,14,49,94
2008-07-07 00:00:00.000,Stuttgart Germany ATP World Tour,CLAY,2,Eduardo Schwank,Jan Hernych,Eduardo Schwank,6-0; 4-6; 6-3,Q,115,1,2,48,78,37,48,15,30,5,7,13,52,78,4,1,59,91,34,59,15,32,10,15,12,49,91
2008-07-07 00:00:00.000,Stuttgart Germany ATP World Tour,CLAY,2,Juan Martin Del Potro,Philipp Kohlschreiber,Juan Martin Del Potro,7-6(3); 6-3,Q,132,9,2,31,66,28,31,24,35,4,4,11,52,66,4,2,34,59,28,34,14,25,0,1,10,42,59
2008-07-07 00:00:00.000,Stuttgart Germany ATP World Tour,CLAY,2,Agustin Calleri,Michael Berrer,Agustin Calleri,6-4; 6-2,Q,66,9,4,29,45,28,29,8,16,0,0,9,36,45,3,5,40,65,27,40,10,25,4,7,9,37,65
2008-07-07 00:00:00.000,Stuttgart Germany ATP World Tour,CLAY,2,Richard Gasquet,Albert Montanes,Richard Gasquet,6-3; 7-6(5),Q,96,7,4,38,73,27,38,23,35,7,8,10,50,73,3,7,39,75,29,39,15,36,3,6,11,44,75
2008-07-07 00:00:00.000,Stuttgart Germany ATP World Tour,CLAY,2,Juan Martin Del Potro,Eduardo Schwank,Juan Martin Del Potro,6-2; 6-4,S,87,4,3,34,56,25,34,14,22,0,0,9,39,56,0,4,34,60,25,34,10,26,2,5,9,35,60
2008-07-07 00:00:00.000,Stuttgart Germany ATP World Tour,CLAY,2,Richard Gasquet,Agustin Calleri,Richard Gasquet,6-7(3); 6-2; 6-3,S,125,10,0,48,85,38,48,23,37,3,4,14,61,85,10,4,62,107,38,62,23,45,11,16,15,61,107
2008-07-07 00:00:00.000,Stuttgart Germany ATP World Tour,CLAY,2,Juan Martin Del Potro,Richard Gasquet,Juan Martin Del Potro,6-4; 7-5,F,95,2,1,31,53,22,31,17,22,0,2,11,39,53,5,1,39,69,26,39,14,30,2,6,11,40,69
2008-07-14 00:00:00.000,Amersfoort The Netherlands ATP World Tour,CLAY,2,Marc Gicquel,N/A Bye,Marc Gicquel,,R32,0,0,0,0,0,0,0,0,0,0,0,0,0,0,0,0,0,0,0,0,0,0,0,0,0,0,0
2008-07-14 00:00:00.000,Amersfoort The Netherlands ATP World Tour,CLAY,2,Thiemo de Bakker,Adrian Cruciat,Thiemo de Bakker,7-5; 6-4,R32,84,10,1,34,66,24,34,22,32,4,5,11,46,66,6,2,45,69,33,45,8,24,5,8,11,41,69
2008-07-14 00:00:00.000,Amersfoort The Netherlands ATP World Tour,CLAY,2,Teymuraz Gabashvili,Thierry Ascione,Teymuraz Gabashvili,6-2; 7-6(1),R32,87,7,1,40,62,30,40,14,22,1,2,10,44,62,6,0,39,69,24,39,14,30,5,8,10,38,69
2008-07-14 00:00:00.000,Amersfoort The Netherlands ATP World Tour,CLAY,2,Martin Vassallo Arguello,Alberto Brizzi,Martin Vassallo Arguello,6-4; 6-3,R32,97,3,2,51,77,36,51,12,26,12,13,10,48,77,0,5,51,70,33,51,6,19,7,10,9,39,70
2008-07-14 00:00:00.000,Amersfoort The Netherlands ATP World Tour,CLAY,2,Steve Darcis,N/A Bye,Steve Darcis,,R32,0,0,0,0,0,0,0,0,0,0,0,0,0,0,0,0,0,0,0,0,0,0,0,0,0,0,0
2008-07-14 00:00:00.000,Amersfoort The Netherlands ATP World Tour,CLAY,2,Alberto Martin,Yuri Schukin,Alberto Martin,7-6(8); 6-4,R32,103,7,6,41,71,33,41,12,30,1,4,11,45,71,0,4,52,83,28,52,16,31,7,11,11,44,83
2008-07-14 00:00:00.000,Amersfoort The Netherlands ATP World Tour,CLAY,2,Christophe Rochus,David Marrero,Christophe Rochus,7-5; 6-2,R32,87,5,2,39,68,28,39,16,29,6,8,10,44,68,8,2,42,65,24,42,9,23,6,11,10,33,65
2008-07-14 00:00:00.000,Amersfoort The Netherlands ATP World Tour,CLAY,2,Philipp Petzschner,Florent Serra,Philipp Petzschner,2-6; 6-4; 6-4,R32,96,6,3,49,82,37,49,16,33,5,8,14,53,82,2,2,58,85,44,58,9,27,4,7,14,53,85
2008-07-14 00:00:00.000,Amersfoort The Netherlands ATP World Tour,CLAY,2,Jesse Huta Galung,Santiago Ventura,Jesse Huta Galung,6-1; 1-0 RET,R32,36,2,1,17,32,14,17,8,15,0,0,4,22,32,0,0,21,28,8,21,3,7,1,4,4,11,28
2008-07-14 00:00:00.000,Amersfoort The Netherlands ATP World Tour,CLAY,2,Oscar Hernandez,Denis Matsukevich,Oscar Hernandez,6-1; 6-3,R32,73,2,0,32,41,21,32,7,9,0,1,8,28,41,0,2,36,59,16,36,12,23,3,8,8,28,59
2008-07-14 00:00:00.000,Amersfoort The Netherlands ATP World Tour,CLAY,2,Ivan Navarro,Igor Sijsling,Ivan Navarro,6-3; 6-1,R32,59,6,2,27,41,24,27,8,14,0,0,8,32,41,2,2,21,44,13,21,8,23,0,4,8,21,44
2008-07-14 00:00:00.000,Amersfoort The Netherlands ATP World Tour,CLAY,2,Marcel Granollers,N/A Bye,Marcel Granollers,,R32,0,0,0,0,0,0,0,0,0,0,0,0,0,0,0,0,0,0,0,0,0,0,0,0,0,0,0
2008-07-14 00:00:00.000,Amersfoort The Netherlands ATP World Tour,CLAY,2,Albert Montanes,Kristof Vliegen,Albert Montanes,6-4; 6-2,R32,57,7,4,36,55,27,36,7,19,6,9,9,34,55,0,2,42,61,18,42,9,19,5,11,9,27,61
2008-07-14 00:00:00.000,Amersfoort The Netherlands ATP World Tour,CLAY,2,Pablo Cuevas,Werner Eschauer,Pablo Cuevas,7-5; 6-2,R32,91,3,0,42,69,30,42,17,27,4,5,10,47,69,1,2,32,61,21,32,14,29,4,8,10,35,61
2008-07-14 00:00:00.000,Amersfoort The Netherlands ATP World Tour,CLAY,2,Edouard Roger-Vasselin,Martin Verkerk,Edouard Roger-Vasselin,2-6; 7-6(9); 4-3 RET,R32,124,7,5,57,91,42,57,16,34,7,10,13,58,91,10,2,55,84,39,55,17,29,0,2,14,56,84
2008-07-14 00:00:00.000,Amersfoort The Netherlands ATP World Tour,CLAY,2,Jose Acasuso,N/A Bye,Jose Acasuso,,R32,0,0,0,0,0,0,0,0,0,0,0,0,0,0,0,0,0,0,0,0,0,0,0,0,0,0,0
2008-07-14 00:00:00.000,Amersfoort The Netherlands ATP World Tour,CLAY,2,Marc Gicquel,Thiemo de Bakker,Marc Gicquel,7-6(6); 6-3,R16,101,3,3,39,62,31,39,14,23,3,4,10,45,62,5,1,45,77,34,45,14,32,4,7,11,48,77
2008-07-14 00:00:00.000,Amersfoort The Netherlands ATP World Tour,CLAY,2,Teymuraz Gabashvili,Martin Vassallo Arguello,Teymuraz Gabashvili,6-4; 6-0,R16,79,4,4,32,53,25,32,12,21,3,3,8,37,53,2,1,42,55,19,42,8,13,2,6,8,27,55
2008-07-14 00:00:00.000,Amersfoort The Netherlands ATP World Tour,CLAY,2,Steve Darcis,Alberto Martin,Steve Darcis,6-1; 7-6(5),R16,87,3,4,44,75,30,44,15,31,5,7,10,45,75,0,1,35,60,20,35,12,25,5,9,9,32,60
2008-07-14 00:00:00.000,Amersfoort The Netherlands ATP World Tour,CLAY,2,Christophe Rochus,Philipp Petzschner,Christophe Rochus,6-3; 6-4,R16,65,1,0,40,55,33,40,7,15,1,2,10,40,55,10,2,27,65,20,27,17,38,5,8,9,37,65
2008-07-14 00:00:00.000,Amersfoort The Netherlands ATP World Tour,CLAY,2,Oscar Hernandez,Jesse Huta Galung,Oscar Hernandez,6-3; 6-2,R16,82,2,1,40,60,31,40,10,20,1,1,9,41,60,2,2,23,52,15,23,14,29,5,8,8,29,52
2008-07-14 00:00:00.000,Amersfoort The Netherlands ATP World Tour,CLAY,2,Marcel Granollers,Ivan Navarro,Marcel Granollers,6-4; 6-4,R16,98,1,1,42,66,31,42,13,24,8,9,10,44,66,4,3,33,60,22,33,13,27,4,7,10,35,60
2008-07-14 00:00:00.000,Amersfoort The Netherlands ATP World Tour,CLAY,2,Albert Montanes,Pablo Cuevas,Albert Montanes,6-4; 6-4,R16,94,2,3,47,76,36,47,15,29,5,5,10,51,76,1,0,43,70,23,43,19,27,9,11,10,42,70
2008-07-14 00:00:00.000,Amersfoort The Netherlands ATP World Tour,CLAY,2,Jose Acasuso,Edouard Roger-Vasselin,Jose Acasuso,6-3; 6-4,R16,86,5,0,32,58,26,32,15,26,1,2,10,41,58,2,1,37,62,24,37,10,25,8,11,9,34,62
2008-07-14 00:00:00.000,Amersfoort The Netherlands ATP World Tour,CLAY,2,Marc Gicquel,Teymuraz Gabashvili,Marc Gicquel,6-4; 6-1,Q,63,5,1,25,44,22,25,9,19,0,1,8,31,44,1,4,32,52,16,32,7,20,5,10,9,23,52
2008-07-14 00:00:00.000,Amersfoort The Netherlands ATP World Tour,CLAY,2,Steve Darcis,Christophe Rochus,Steve Darcis,7-5; 6-3,Q,68,8,2,31,56,26,31,15,25,1,2,11,41,56,1,1,38,58,22,38,13,20,2,5,10,35,58
2008-07-14 00:00:00.000,Amersfoort The Netherlands ATP World Tour,CLAY,2,Oscar Hernandez,Marcel Granollers,Oscar Hernandez,7-5; 6-2,Q,101,2,2,45,63,29,45,11,18,2,4,10,40,63,3,1,37,58,24,37,6,21,4,9,10,30,58
2008-07-14 00:00:00.000,Amersfoort The Netherlands ATP World Tour,CLAY,2,Albert Montanes,Jose Acasuso,Albert Montanes,6-0; 6-2,Q,49,1,0,24,38,20,24,10,14,1,1,7,30,38,1,3,22,38,9,22,5,16,2,7,7,14,38
2008-07-14 00:00:00.000,Amersfoort The Netherlands ATP World Tour,CLAY,2,Steve Darcis,Marc Gicquel,Steve Darcis,7-6(3); 3-6; 7-5,S,130,4,4,59,105,46,59,25,46,7,9,16,71,105,5,2,59,102,49,59,20,43,1,3,17,69,102
2008-07-14 00:00:00.000,Amersfoort The Netherlands ATP World Tour,CLAY,2,Albert Montanes,Oscar Hernandez,Albert Montanes,6-1; 6-3,S,78,2,0,28,51,21,28,14,23,5,5,8,35,51,0,3,42,62,24,42,8,20,8,12,8,32,62
2008-07-14 00:00:00.000,Amersfoort The Netherlands ATP World Tour,CLAY,2,Albert Montanes,Steve Darcis,Albert Montanes,1-6; 7-5; 6-3,F,107,3,4,53,80,40,53,13,27,1,4,14,53,80,9,5,52,81,36,52,14,29,2,5,14,50,81
2008-07-14 00:00:00.000,Indianapolis IN; U.S.A. ATP World Tour,HARD,2,James Blake,Dudi Sela,James Blake,7-6(2); 6-2,R32,77,5,4,34,69,25,34,16,35,1,4,10,41,69,3,3,41,72,23,41,11,31,8,13,10,34,72
2008-07-14 00:00:00.000,Indianapolis IN; U.S.A. ATP World Tour,HARD,2,Woong-Sun Jun,Chris Guccione,Woong-Sun Jun,6-4; 7-6(4),R32,83,5,2,44,70,38,44,12,26,3,4,11,50,70,3,5,46,79,38,46,14,33,7,9,11,52,79
2008-07-14 00:00:00.000,Indianapolis IN; U.S.A. ATP World Tour,HARD,2,Yen-Hsun Lu,Justin O'Neal,Yen-Hsun Lu,7-6(2); 7-6(12),R32,114,5,4,48,82,37,48,19,34,3,6,12,56,82,7,3,57,88,42,57,11,31,4,7,12,53,88
2008-07-14 00:00:00.000,Indianapolis IN; U.S.A. ATP World Tour,HARD,2,Rajeev Ram,Fabrice Santoro,Rajeev Ram,7-6(6); 6-4,R32,105,4,1,57,84,42,57,14,27,1,2,11,56,84,2,4,43,71,32,43,15,28,4,6,11,47,71
2008-07-14 00:00:00.000,Indianapolis IN; U.S.A. ATP World Tour,HARD,2,Dmitry Tursunov,Igor Kunitsyn,Dmitry Tursunov,6-3; 7-5,R32,86,6,4,28,70,26,28,21,42,6,7,11,47,70,7,3,30,67,24,30,15,37,6,9,10,39,67
2008-07-14 00:00:00.000,Indianapolis IN; U.S.A. ATP World Tour,HARD,2,Wayne Odesnik,Aisam-Ul-Haq Qureshi,Wayne Odesnik,6-4; 7-5,R32,77,2,3,27,55,24,27,17,28,1,2,11,41,55,17,5,36,64,27,36,11,28,3,6,11,38,64
2008-07-14 00:00:00.000,Indianapolis IN; U.S.A. ATP World Tour,HARD,2,Joseph Sirianni,Mikhail Ledovskikh,Joseph Sirianni,6-3; 1-2 RET,R32,71,2,0,19,34,14,19,6,15,1,3,6,20,34,6,4,26,61,16,26,15,35,11,14,6,31,61
2008-07-14 00:00:00.000,Indianapolis IN; U.S.A. ATP World Tour,HARD,2,Paul Capdeville,Robby Ginepri,Paul Capdeville,6-4; 6-2,R32,75,6,3,38,56,25,38,8,18,3,6,9,33,56,1,2,33,68,14,33,17,35,9,15,9,31,68
2008-07-14 00:00:00.000,Indianapolis IN; U.S.A. ATP World Tour,HARD,2,Alejandro Falla,Thomaz Bellucci,Alejandro Falla,3-6; 6-4; 6-1,R32,126,3,5,52,87,35,52,15,35,5,9,13,50,87,2,7,53,98,31,53,18,45,6,12,13,49,98
2008-07-14 00:00:00.000,Indianapolis IN; U.S.A. ATP World Tour,HARD,2,Bobby Reynolds,Frank Dancevic,Bobby Reynolds,6-7(6); 6-3; 6-2,R32,113,17,8,59,112,45,59,27,53,5,6,15,72,112,12,7,49,94,36,49,22,45,6,10,14,58,94
2008-07-14 00:00:00.000,Indianapolis IN; U.S.A. ATP World Tour,HARD,2,Vincent Spadea,Donald Young,Vincent Spadea,6-2; 6-4,R32,52,2,2,18,45,18,18,18,27,0,0,9,36,45,1,0,28,52,19,28,11,24,4,7,9,30,52
2008-07-14 00:00:00.000,Indianapolis IN; U.S.A. ATP World Tour,HARD,2,Sam Querrey,Go Soeda,Sam Querrey,6-4; 6-4,R32,74,3,1,26,50,20,26,17,24,1,2,10,37,50,2,1,41,71,30,41,11,30,6,9,10,41,71
2008-07-14 00:00:00.000,Indianapolis IN; U.S.A. ATP World Tour,HARD,2,Tommy Haas,Jesse Levine,Tommy Haas,7-6(4); 6-2,R32,96,6,6,37,75,31,37,20,38,8,9,10,51,75,4,6,41,70,32,41,7,29,1,4,10,39,70
2008-07-14 00:00:00.000,Indianapolis IN; U.S.A. ATP World Tour,HARD,2,John Isner,Robert Kendrick,John Isner,7-5; 6-4,R32,94,23,5,57,86,42,57,13,29,11,11,11,55,86,9,5,41,72,34,41,15,31,4,6,11,49,72
2008-07-14 00:00:00.000,Indianapolis IN; U.S.A. ATP World Tour,HARD,2,Benjamin Becker,Kristian Pless,Benjamin Becker,6-3; 6-4,R32,85,10,2,38,73,29,38,19,35,6,7,9,48,73,6,14,42,82,29,42,17,40,9,13,10,46,82
2008-07-14 00:00:00.000,Indianapolis IN; U.S.A. ATP World Tour,HARD,2,Gilles Simon,Nicolas Mahut,Gilles Simon,6-2; 3-6; 6-3,R32,111,2,5,31,81,22,31,30,50,2,3,13,52,81,8,1,47,83,30,47,20,36,2,5,13,50,83
2008-07-14 00:00:00.000,Indianapolis IN; U.S.A. ATP World Tour,HARD,2,James Blake,Woong-Sun Jun,James Blake,6-3; 7-5,R16,72,10,3,38,77,33,38,19,39,7,8,11,52,77,7,4,37,58,26,37,9,21,6,9,10,35,58
2008-07-14 00:00:00.000,Indianapolis IN; U.S.A. ATP World Tour,HARD,2,Yen-Hsun Lu,Rajeev Ram,Yen-Hsun Lu,6-1; 7-6(1),R16,103,6,4,37,70,28,37,15,33,6,8,10,43,70,6,1,35,67,24,35,9,32,2,6,9,33,67
2008-07-14 00:00:00.000,Indianapolis IN; U.S.A. ATP World Tour,HARD,2,Dmitry Tursunov,Wayne Odesnik,Dmitry Tursunov,W/O,R16,0,0,0,0,0,0,0,0,0,0,0,0,0,0,0,0,0,0,0,0,0,0,0,0,0,0,0
2008-07-14 00:00:00.000,Indianapolis IN; U.S.A. ATP World Tour,HARD,2,Paul Capdeville,Joseph Sirianni,Paul Capdeville,6-3; 6-4,R16,75,4,0,27,50,23,27,16,23,5,6,10,39,50,2,5,32,59,22,32,12,27,6,9,9,34,59
2008-07-14 00:00:00.000,Indianapolis IN; U.S.A. ATP World Tour,HARD,2,Bobby Reynolds,Alejandro Falla,Bobby Reynolds,6-1; 6-1,R16,63,5,3,30,56,21,30,13,26,4,5,7,34,56,2,5,20,47,12,20,5,27,4,10,7,17,47
2008-07-14 00:00:00.000,Indianapolis IN; U.S.A. ATP World Tour,HARD,2,Sam Querrey,Vincent Spadea,Sam Querrey,4-6; 6-3; 6-4,R16,99,10,2,50,84,40,50,20,34,0,1,15,60,84,6,5,46,94,30,46,28,48,9,11,14,58,94
2008-07-14 00:00:00.000,Indianapolis IN; U.S.A. ATP World Tour,HARD,2,Tommy Haas,John Isner,Tommy Haas,6-3; 6-4,R16,76,7,1,27,53,22,27,21,26,3,3,10,43,53,8,1,30,49,21,30,11,19,4,6,9,32,49
2008-07-14 00:00:00.000,Indianapolis IN; U.S.A. ATP World Tour,HARD,2,Gilles Simon,Benjamin Becker,Gilles Simon,7-5; 3-6; 6-0,R16,106,8,4,38,75,28,38,20,37,3,6,13,48,75,5,3,43,98,26,43,25,55,7,13,14,51,98
2008-07-14 00:00:00.000,Indianapolis IN; U.S.A. ATP World Tour,HARD,2,James Blake,Yen-Hsun Lu,James Blake,6-2; 6-0,Q,45,7,3,20,35,20,20,8,15,0,0,7,28,35,2,5,21,41,8,21,10,20,3,8,7,18,41
2008-07-14 00:00:00.000,Indianapolis IN; U.S.A. ATP World Tour,HARD,2,Dmitry Tursunov,Paul Capdeville,Dmitry Tursunov,3-6; 6-3; 6-1,Q,82,12,9,30,72,24,30,25,42,1,3,13,49,72,4,2,36,64,22,36,16,28,0,4,12,38,64
2008-07-14 00:00:00.000,Indianapolis IN; U.S.A. ATP World Tour,HARD,2,Sam Querrey,Bobby Reynolds,Sam Querrey,6-1; 3-6; 6-3,Q,76,17,5,49,72,38,49,11,23,3,5,13,49,72,8,2,43,62,27,43,11,19,2,6,12,38,62
2008-07-14 00:00:00.000,Indianapolis IN; U.S.A. ATP World Tour,HARD,2,Gilles Simon,Tommy Haas,Gilles Simon,4-6; 6-4; 6-2,Q,122,7,5,40,80,29,40,25,40,1,3,14,54,80,7,5,50,99,33,50,26,49,8,12,14,59,99
2008-07-14 00:00:00.000,Indianapolis IN; U.S.A. ATP World Tour,HARD,2,Dmitry Tursunov,James Blake,Dmitry Tursunov,4-6; 6-3; 6-4,S,116,8,3,55,93,40,55,20,38,3,5,15,60,93,3,2,37,85,27,37,25,48,0,3,14,52,85
2008-07-14 00:00:00.000,Indianapolis IN; U.S.A. ATP World Tour,HARD,2,Gilles Simon,Sam Querrey,Gilles Simon,6-3; 4-6; 6-4,S,126,11,6,66,114,43,66,24,48,16,19,14,67,114,3,3,46,84,32,46,19,38,3,8,15,51,84
2008-07-14 00:00:00.000,Indianapolis IN; U.S.A. ATP World Tour,HARD,2,Gilles Simon,Dmitry Tursunov,Gilles Simon,6-4; 6-4,F,95,4,2,47,72,33,47,16,25,9,9,10,49,72,9,6,39,68,30,39,10,29,4,6,10,40,68
2008-07-14 00:00:00.000,Kitzbnhel Austria ATP World Tour,CLAY,2,Nicolas Devilder,Matthias Bachinger,Nicolas Devilder,6-3; 6-3,R32,85,2,2,26,61,16,26,22,35,5,7,9,38,61,4,7,42,82,28,42,12,40,8,13,9,40,82
2008-07-14 00:00:00.000,Kitzbnhel Austria ATP World Tour,CLAY,2,Alexander Peya,Guillermo Coria,Alexander Peya,5-7 RET,R32,49,2,2,15,35,11,15,9,20,1,3,6,20,35,0,7,27,45,21,27,9,18,8,9,6,30,45
2008-07-14 00:00:00.000,Kitzbnhel Austria ATP World Tour,CLAY,2,Sergio Roitman,Martin Fischer,Sergio Roitman,6-4; 6-2,R32,66,1,2,35,53,25,35,11,18,0,1,9,36,53,2,0,38,58,19,38,12,20,5,9,9,31,58
2008-07-14 00:00:00.000,Kitzbnhel Austria ATP World Tour,CLAY,2,Juan Martin Del Potro,Josselin Ouanna,Juan Martin Del Potro,6-3; 6-3,R32,74,1,4,33,50,22,33,11,17,2,3,9,33,50,4,0,30,54,17,30,11,24,2,6,9,28,54
2008-07-14 00:00:00.000,Kitzbnhel Austria ATP World Tour,CLAY,2,Guillermo Garcia-Lopez,Agustin Calleri,Guillermo Garcia-Lopez,6-4; 6-4,R32,103,5,2,39,66,28,39,16,27,2,3,10,44,66,3,2,67,95,43,67,10,28,11,14,10,53,95
2008-07-14 00:00:00.000,Kitzbnhel Austria ATP World Tour,CLAY,2,Victor Hanescu,Pablo Andujar,Victor Hanescu,6-3; 1-6; 7-6(2),R32,143,3,3,65,111,48,65,17,46,8,11,14,65,111,0,4,74,98,47,74,13,24,6,8,14,60,98
2008-07-14 00:00:00.000,Kitzbnhel Austria ATP World Tour,CLAY,2,Brian Dabul,Stephane Bohli,Brian Dabul,6-1; 6-1,R32,53,2,3,24,38,20,24,9,14,2,2,7,29,38,4,4,29,52,11,29,12,23,7,12,7,23,52
2008-07-14 00:00:00.000,Kitzbnhel Austria ATP World Tour,CLAY,2,Ivo Minar,Olivier Rochus,Ivo Minar,3-6; 6-4; 6-0,R32,100,6,6,43,75,31,43,14,32,2,5,12,45,75,1,3,37,76,23,37,15,39,2,8,13,38,76
2008-07-14 00:00:00.000,Kitzbnhel Austria ATP World Tour,CLAY,2,Eduardo Schwank,Michael Berrer,Eduardo Schwank,6-4; 6-1,R32,68,4,1,32,48,25,32,9,16,1,1,8,34,48,2,2,36,61,23,36,9,25,4,8,9,32,61
2008-07-14 00:00:00.000,Kitzbnhel Austria ATP World Tour,CLAY,2,Daniel Brands,Eric Prodon,Daniel Brands,6-3; 6-4,R32,51,15,0,32,51,30,32,11,19,0,0,10,41,51,4,2,29,51,23,29,11,22,0,2,9,34,51
2008-07-14 00:00:00.000,Kitzbnhel Austria ATP World Tour,CLAY,2,Daniel Koellerer,Philipp Oswald,Daniel Koellerer,7-6(5); 7-6(4),R32,123,2,2,49,80,34,49,15,31,4,8,12,49,80,9,7,58,91,36,58,13,33,3,7,12,49,91
2008-07-14 00:00:00.000,Kitzbnhel Austria ATP World Tour,CLAY,2,Potito Starace,Santiago Giraldo,Potito Starace,6-1; 6-2,R32,65,1,0,39,53,30,39,7,14,7,7,8,37,53,0,1,17,41,9,17,10,24,3,7,7,19,41
2008-07-14 00:00:00.000,Kitzbnhel Austria ATP World Tour,CLAY,2,Jurgen Melzer,Luis Horna,Jurgen Melzer,6-3; 6-1,R32,53,2,1,21,42,16,21,13,21,1,2,8,29,42,3,5,28,46,14,28,6,18,2,7,8,20,46
2008-07-14 00:00:00.000,Kitzbnhel Austria ATP World Tour,CLAY,2,Leonardo Mayer,Denis Gremelmayr,Leonardo Mayer,6-1; 7-6(3),R32,67,13,3,32,54,28,32,13,22,0,2,10,41,54,2,2,39,61,23,39,9,22,8,12,9,32,61
2008-07-14 00:00:00.000,Kitzbnhel Austria ATP World Tour,CLAY,2,Jan Hernych,Ruben Ramirez Hidalgo,Jan Hernych,7-5; 7-5,R32,101,1,2,45,70,32,45,11,25,3,7,12,43,70,0,9,44,82,26,44,14,38,12,18,12,40,82
2008-07-14 00:00:00.000,Kitzbnhel Austria ATP World Tour,CLAY,2,Rainer Schuettler,Andreas Beck,Rainer Schuettler,3-6; 7-6(5); 6-2,R32,139,10,2,39,89,33,39,30,50,2,3,14,63,89,6,9,61,105,43,61,25,44,5,7,15,68,105
2008-07-14 00:00:00.000,Kitzbnhel Austria ATP World Tour,CLAY,2,Nicolas Devilder,Alexander Peya,Nicolas Devilder,6-4; 6-4,R16,93,4,1,47,67,32,47,10,20,3,5,10,42,67,3,2,27,55,18,27,12,28,2,6,10,30,55
2008-07-14 00:00:00.000,Kitzbnhel Austria ATP World Tour,CLAY,2,Juan Martin Del Potro,Sergio Roitman,Juan Martin Del Potro,6-2; 6-4,R16,80,6,3,35,64,27,35,16,29,5,5,9,43,64,1,2,28,45,16,28,10,17,0,3,9,26,45
2008-07-14 00:00:00.000,Kitzbnhel Austria ATP World Tour,CLAY,2,Victor Hanescu,Guillermo Garcia-Lopez,Victor Hanescu,6-2; 6-1,R16,61,2,1,22,35,19,22,9,13,0,0,7,28,35,1,6,32,53,18,32,6,21,3,8,8,24,53
2008-07-14 00:00:00.000,Kitzbnhel Austria ATP World Tour,CLAY,2,Brian Dabul,Ivo Minar,Brian Dabul,6-4; 6-3,R16,81,2,0,37,53,25,37,9,16,0,2,9,34,53,2,5,38,71,23,38,13,33,2,7,10,36,71
2008-07-14 00:00:00.000,Kitzbnhel Austria ATP World Tour,CLAY,2,Eduardo Schwank,Daniel Brands,Eduardo Schwank,6-1; 6-4,R16,67,3,2,22,48,18,22,18,26,0,0,9,36,48,2,6,36,62,24,36,10,26,6,9,8,34,62
2008-07-14 00:00:00.000,Kitzbnhel Austria ATP World Tour,CLAY,2,Potito Starace,Daniel Koellerer,Potito Starace,6-4; 6-3,R16,98,1,1,53,70,36,53,11,17,8,9,10,47,70,0,3,35,55,20,35,12,20,2,5,9,32,55
2008-07-14 00:00:00.000,Kitzbnhel Austria ATP World Tour,CLAY,2,Jurgen Melzer,Leonardo Mayer,Jurgen Melzer,6-4; 6-2,R16,61,3,2,32,50,30,32,8,18,0,0,9,38,50,2,4,21,46,18,21,11,25,1,4,9,29,46
2008-07-14 00:00:00.000,Kitzbnhel Austria ATP World Tour,CLAY,2,Rainer Schuettler,Jan Hernych,Rainer Schuettler,2-6; 6-4; 7-5,R16,121,4,7,54,102,35,54,23,48,4,9,15,58,102,0,4,50,86,32,50,17,36,4,9,15,49,86
2008-07-14 00:00:00.000,Kitzbnhel Austria ATP World Tour,CLAY,2,Juan Martin Del Potro,Nicolas Devilder,Juan Martin Del Potro,6-2; 6-3,Q,72,1,1,27,44,21,27,9,17,0,1,8,30,44,2,3,26,58,12,26,14,32,6,11,9,26,58
2008-07-14 00:00:00.000,Kitzbnhel Austria ATP World Tour,CLAY,2,Victor Hanescu,Brian Dabul,Victor Hanescu,6-3; 6-4,Q,73,7,2,34,53,31,34,10,19,1,1,10,41,53,2,0,40,58,29,40,7,18,5,7,9,36,58
2008-07-14 00:00:00.000,Kitzbnhel Austria ATP World Tour,CLAY,2,Potito Starace,Eduardo Schwank,Potito Starace,6-1; 6-2,Q,58,3,3,35,46,29,35,5,11,1,1,8,34,46,2,1,29,39,16,29,2,10,2,6,7,18,39
2008-07-14 00:00:00.000,Kitzbnhel Austria ATP World Tour,CLAY,2,Jurgen Melzer,Rainer Schuettler,Jurgen Melzer,2-6; 7-5; 7-5,Q,142,4,4,54,91,34,54,21,37,1,5,16,55,91,6,2,63,109,47,63,20,46,10,14,16,67,109
2008-07-14 00:00:00.000,Kitzbnhel Austria ATP World Tour,CLAY,2,Juan Martin Del Potro,Victor Hanescu,Juan Martin Del Potro,6-3; 7-6(5),S,100,6,5,40,77,33,40,21,37,5,5,10,54,77,1,2,37,68,27,37,19,31,1,3,11,46,68
2008-07-14 00:00:00.000,Kitzbnhel Austria ATP World Tour,CLAY,2,Jurgen Melzer,Potito Starace,Jurgen Melzer,6-4; 6-7(6); 6-3,S,124,8,6,61,107,48,61,24,46,6,8,16,72,107,2,1,74,100,46,74,17,26,6,10,15,63,100
2008-07-14 00:00:00.000,Kitzbnhel Austria ATP World Tour,CLAY,2,Juan Martin Del Potro,Jurgen Melzer,Juan Martin Del Potro,6-2; 6-1,F,59,4,1,20,35,17,20,12,15,1,1,7,29,35,2,6,28,51,13,28,11,23,5,10,8,24,51
2008-07-14 00:00:00.000,Umag Croatia ATP World Tour,CLAY,2,Fernando Verdasco,N/A Bye,Fernando Verdasco,,R32,0,0,0,0,0,0,0,0,0,0,0,0,0,0,0,0,0,0,0,0,0,0,0,0,0,0,0
2008-07-14 00:00:00.000,Umag Croatia ATP World Tour,CLAY,2,Mathieu Montcourt,Antonio Veic,Mathieu Montcourt,6-4; 6-2,R32,89,0,3,43,52,28,43,4,9,1,3,9,32,52,0,5,35,67,22,35,11,32,9,14,9,33,67
2008-07-14 00:00:00.000,Umag Croatia ATP World Tour,CLAY,2,Mischa Zverev,Luka Belic,Mischa Zverev,6-2; 6-3,R32,73,3,0,36,59,25,36,14,23,4,5,9,39,59,2,3,32,56,19,32,8,24,3,7,8,27,56
2008-07-14 00:00:00.000,Umag Croatia ATP World Tour,CLAY,2,Marcos Daniel,Carlos Berlocq,Marcos Daniel,6-3; 4-6; 6-4,R32,136,0,1,44,84,26,44,20,40,2,8,15,46,84,1,2,50,87,29,50,16,37,8,15,14,45,87
2008-07-14 00:00:00.000,Umag Croatia ATP World Tour,CLAY,2,Carlos Moya,N/A Bye,Carlos Moya,,R32,0,0,0,0,0,0,0,0,0,0,0,0,0,0,0,0,0,0,0,0,0,0,0,0,0,0,0
2008-07-14 00:00:00.000,Umag Croatia ATP World Tour,CLAY,2,Viktor Troicki,Jiri Vanek,Viktor Troicki,6-3; 6-1,R32,62,1,2,21,36,19,21,11,15,0,1,8,30,36,1,0,34,59,17,34,10,25,5,10,8,27,59
2008-07-14 00:00:00.000,Umag Croatia ATP World Tour,CLAY,2,Filippo Volandri,Flavio Cipolla,Filippo Volandri,6-1; 6-4,R32,75,0,1,41,59,28,41,10,18,4,6,9,38,59,0,2,37,50,20,37,4,13,6,11,8,24,50
2008-07-14 00:00:00.000,Umag Croatia ATP World Tour,CLAY,2,Fabio Fognini,Ricardas Berankis,Fabio Fognini,6-3; 6-2,R32,62,5,0,27,48,22,27,12,21,3,3,8,34,48,0,3,19,50,11,19,14,31,1,5,9,25,50
2008-07-14 00:00:00.000,Umag Croatia ATP World Tour,CLAY,2,Guillermo Canas,Nicolas Massu,Guillermo Canas,7-5; 6-2,R32,105,4,4,32,60,23,32,10,28,4,8,10,33,60,0,7,39,64,21,39,5,25,1,8,10,26,64
2008-07-14 00:00:00.000,Umag Croatia ATP World Tour,CLAY,2,Boris Pashanski,Gianluca Naso,Boris Pashanski,6-3; 2-6; 7-6(9),R32,151,7,2,73,123,48,73,26,50,7,10,15,74,123,6,1,57,93,42,57,18,36,3,5,14,60,93
2008-07-14 00:00:00.000,Umag Croatia ATP World Tour,CLAY,2,Daniel Gimeno-Traver,Olivier Patience,Daniel Gimeno-Traver,6-2; 6-2,R32,70,1,1,29,50,24,29,11,21,6,6,8,35,50,3,1,32,49,18,32,7,17,6,10,8,25,49
2008-07-14 00:00:00.000,Umag Croatia ATP World Tour,CLAY,2,Igor Andreev,N/A Bye,Igor Andreev,,R32,0,0,0,0,0,0,0,0,0,0,0,0,0,0,0,0,0,0,0,0,0,0,0,0,0,0,0
2008-07-14 00:00:00.000,Umag Croatia ATP World Tour,CLAY,2,Ivan Ljubicic,Mikhail Kukushkin,Ivan Ljubicic,6-1; 6-2,R32,52,8,0,21,38,21,21,12,17,0,0,8,33,38,0,2,19,39,10,19,9,20,1,5,7,19,39
2008-07-14 00:00:00.000,Umag Croatia ATP World Tour,CLAY,2,Roko Karanusic,Francesco Piccari,Roko Karanusic,6-2; 6-2,R32,55,3,0,24,40,17,24,15,16,0,0,8,32,40,1,0,23,44,11,23,10,21,2,6,8,21,44
2008-07-14 00:00:00.000,Umag Croatia ATP World Tour,CLAY,2,Maximo Gonzalez,Filip Prpic,Maximo Gonzalez,7-5; 6-3,R32,98,3,2,44,67,30,44,9,23,7,10,10,39,67,0,4,41,72,24,41,9,31,4,10,11,33,72
2008-07-14 00:00:00.000,Umag Croatia ATP World Tour,CLAY,2,Ivo Karlovic,N/A Bye,Ivo Karlovic,,R32,0,0,0,0,0,0,0,0,0,0,0,0,0,0,0,0,0,0,0,0,0,0,0,0,0,0,0
2008-07-14 00:00:00.000,Umag Croatia ATP World Tour,CLAY,2,Fernando Verdasco,Mathieu Montcourt,Fernando Verdasco,7-6(5); 6-1,R16,87,1,7,41,61,25,41,8,20,1,5,10,33,61,0,4,36,59,15,36,8,23,6,12,9,23,59
2008-07-14 00:00:00.000,Umag Croatia ATP World Tour,CLAY,2,Mischa Zverev,Marcos Daniel,Mischa Zverev,6-4; 6-2,R16,87,2,2,27,54,24,27,15,27,0,0,9,39,54,2,5,52,70,32,52,7,18,5,8,9,39,70
2008-07-14 00:00:00.000,Umag Croatia ATP World Tour,CLAY,2,Carlos Moya,Viktor Troicki,Carlos Moya,3-6; 7-6(2); 7-5,R16,165,3,5,50,113,35,50,32,63,6,10,16,67,113,8,1,71,111,49,71,20,40,7,11,17,69,111
2008-07-14 00:00:00.000,Umag Croatia ATP World Tour,CLAY,2,Fabio Fognini,Filippo Volandri,Fabio Fognini,6-4; 6-4,R16,79,4,3,35,60,25,35,9,25,4,7,10,34,60,0,1,42,66,26,42,9,24,5,10,10,35,66
2008-07-14 00:00:00.000,Umag Croatia ATP World Tour,CLAY,2,Guillermo Canas,Boris Pashanski,Guillermo Canas,6-7(3); 6-3; 7-5,R16,166,6,1,47,93,32,47,23,46,1,6,16,55,93,6,5,50,109,31,50,26,59,3,11,17,57,109
2008-07-14 00:00:00.000,Umag Croatia ATP World Tour,CLAY,2,Igor Andreev,Daniel Gimeno-Traver,Igor Andreev,6-2; 7-6(3),R16,99,4,2,39,63,28,39,15,24,1,3,10,43,63,2,2,40,76,26,40,15,36,5,9,10,41,76
2008-07-14 00:00:00.000,Umag Croatia ATP World Tour,CLAY,2,Roko Karanusic,Ivan Ljubicic,Roko Karanusic,W/O,R16,0,0,0,0,0,0,0,0,0,0,0,0,0,0,0,0,0,0,0,0,0,0,0,0,0,0,0
2008-07-14 00:00:00.000,Umag Croatia ATP World Tour,CLAY,2,Maximo Gonzalez,Ivo Karlovic,Maximo Gonzalez,3-6; 6-3; 6-4,R16,133,1,5,57,90,40,57,19,33,4,6,14,59,90,15,2,53,87,37,53,17,34,4,7,14,54,87
2008-07-14 00:00:00.000,Umag Croatia ATP World Tour,CLAY,2,Fernando Verdasco,Mischa Zverev,Fernando Verdasco,7-5; 7-5,Q,99,2,7,51,76,30,51,16,25,3,5,12,46,76,4,0,48,82,28,48,18,34,8,12,12,46,82
2008-07-14 00:00:00.000,Umag Croatia ATP World Tour,CLAY,2,Fabio Fognini,Carlos Moya,Fabio Fognini,6-4; 6-3,Q,77,1,4,28,53,22,28,12,25,2,5,9,34,53,2,2,36,64,18,36,14,28,7,13,10,32,64
2008-07-14 00:00:00.000,Umag Croatia ATP World Tour,CLAY,2,Igor Andreev,Guillermo Canas,Igor Andreev,7-5; 6-4,Q,124,7,0,38,60,32,38,14,22,3,4,11,46,60,3,2,41,66,28,41,10,25,0,3,11,38,66
2008-07-14 00:00:00.000,Umag Croatia ATP World Tour,CLAY,2,Maximo Gonzalez,Roko Karanusic,Maximo Gonzalez,2-6; 6-3; 7-6(4),Q,162,0,4,67,109,46,67,18,42,5,9,15,64,109,1,3,54,98,35,54,23,44,6,9,14,58,98
2008-07-14 00:00:00.000,Umag Croatia ATP World Tour,CLAY,2,Fernando Verdasco,Fabio Fognini,Fernando Verdasco,6-1; 6-3,S,59,0,3,34,43,26,34,5,9,0,1,8,31,43,0,5,25,46,14,25,6,21,2,7,8,20,46
2008-07-14 00:00:00.000,Umag Croatia ATP World Tour,CLAY,2,Igor Andreev,Maximo Gonzalez,Igor Andreev,6-2; 7-6(2),S,98,1,2,39,59,25,39,14,20,4,7,10,39,59,0,2,43,69,27,43,7,26,7,12,10,34,69
2008-07-14 00:00:00.000,Umag Croatia ATP World Tour,CLAY,2,Fernando Verdasco,Igor Andreev,Fernando Verdasco,3-6; 6-4; 7-6(4),F,171,2,4,69,99,47,69,17,30,2,6,16,64,99,4,7,62,116,37,62,33,54,11,14,15,70,116
2008-07-21 00:00:00.000,ATP Masters Series Canada Toronto; Canada ATP World Tour,HARD,2,Roger Federer,N/A Bye,Roger Federer,,R64,0,0,0,0,0,0,0,0,0,0,0,0,0,0,0,0,0,0,0,0,0,0,0,0,0,0,0
2008-07-21 00:00:00.000,ATP Masters Series Canada Toronto; Canada ATP World Tour,HARD,2,Gilles Simon,Donald Young,Gilles Simon,6-1; 6-3,R64,59,0,2,26,52,18,26,15,26,3,4,8,33,52,0,1,25,47,11,25,9,22,4,9,8,20,47
2008-07-21 00:00:00.000,ATP Masters Series Canada Toronto; Canada ATP World Tour,HARD,2,Jose Acasuso,Ernests Gulbis,Jose Acasuso,6-7(1); 6-3; 7-5,R64,134,4,2,65,118,45,65,29,53,8,10,17,74,118,19,5,57,93,46,57,13,36,6,10,16,59,93
2008-07-21 00:00:00.000,ATP Masters Series Canada Toronto; Canada ATP World Tour,HARD,2,Fernando Gonzalez,Julien Benneteau,Fernando Gonzalez,6-2; 6-1,R64,66,3,2,37,68,29,37,15,31,10,10,8,44,68,3,3,26,39,16,26,3,13,1,5,7,19,39
2008-07-21 00:00:00.000,ATP Masters Series Canada Toronto; Canada ATP World Tour,HARD,2,Tommy Robredo,Frederic Niemeyer,Tommy Robredo,7-6(4); 6-1,R64,93,7,0,52,77,38,52,15,25,6,6,10,53,77,8,1,38,62,25,38,13,24,2,4,9,38,62
2008-07-21 00:00:00.000,ATP Masters Series Canada Toronto; Canada ATP World Tour,HARD,2,Marin Cilic,Lukas Dlouhy,Marin Cilic,6-3; 4-6; 6-3,R64,101,14,4,46,78,36,46,14,32,1,4,14,50,78,7,8,59,98,43,59,14,39,9,14,14,57,98
2008-07-21 00:00:00.000,ATP Masters Series Canada Toronto; Canada ATP World Tour,HARD,2,Nicolas Mahut,Janko Tipsarevic,Nicolas Mahut,6-3; 6-7(5); 6-2,R64,140,8,5,54,90,41,54,23,36,1,2,15,64,90,15,4,50,102,36,50,24,52,8,12,14,60,102
2008-07-21 00:00:00.000,ATP Masters Series Canada Toronto; Canada ATP World Tour,HARD,2,Andy Roddick,N/A Bye,Andy Roddick,,R64,0,0,0,0,0,0,0,0,0,0,0,0,0,0,0,0,0,0,0,0,0,0,0,0,0,0,0
2008-07-21 00:00:00.000,ATP Masters Series Canada Toronto; Canada ATP World Tour,HARD,2,Nikolay Davydenko,N/A Bye,Nikolay Davydenko,,R64,0,0,0,0,0,0,0,0,0,0,0,0,0,0,0,0,0,0,0,0,0,0,0,0,0,0,0
2008-07-21 00:00:00.000,ATP Masters Series Canada Toronto; Canada ATP World Tour,HARD,2,Tommy Haas,Carlos Moya,Tommy Haas,6-3; 6-2,R64,54,4,1,28,42,26,28,10,14,0,0,9,36,42,6,2,30,46,19,30,6,16,2,5,8,25,46
2008-07-21 00:00:00.000,ATP Masters Series Canada Toronto; Canada ATP World Tour,HARD,2,Nicolas Kiefer,Mardy Fish,Nicolas Kiefer,7-5; 7-6(4),R64,114,6,0,42,71,35,42,14,29,6,8,12,49,71,7,2,51,82,33,51,18,31,6,9,12,51,82
2008-07-21 00:00:00.000,ATP Masters Series Canada Toronto; Canada ATP World Tour,HARD,2,Mikhail Youzhny,Andreas Seppi,Mikhail Youzhny,7-6(1); 6-2,R64,94,4,2,37,68,26,37,16,31,5,7,10,42,68,4,5,30,61,20,30,12,31,1,5,10,32,61
2008-07-21 00:00:00.000,ATP Masters Series Canada Toronto; Canada ATP World Tour,HARD,2,Feliciano Lopez,Radek Stepanek,Feliciano Lopez,4-6; 6-3; 6-4,R64,121,10,1,65,98,47,65,18,33,6,8,15,65,98,3,0,53,74,37,53,13,21,1,4,14,50,74
2008-07-21 00:00:00.000,ATP Masters Series Canada Toronto; Canada ATP World Tour,HARD,2,Dmitry Tursunov,Nicolas Lapentti,Dmitry Tursunov,6-3; 6-4,R64,72,4,2,36,56,32,36,12,20,1,1,10,44,56,4,0,28,53,19,28,15,25,3,5,9,34,53
2008-07-21 00:00:00.000,ATP Masters Series Canada Toronto; Canada ATP World Tour,HARD,2,Jonas Bjorkman,Arnaud Clement,Jonas Bjorkman,6-3; 3-6; 6-0,R64,113,8,2,40,84,33,40,21,44,3,4,12,54,84,3,3,38,67,27,38,11,29,2,6,12,38,67
2008-07-21 00:00:00.000,ATP Masters Series Canada Toronto; Canada ATP World Tour,HARD,2,James Blake,N/A Bye,James Blake,,R64,0,0,0,0,0,0,0,0,0,0,0,0,0,0,0,0,0,0,0,0,0,0,0,0,0,0,0
2008-07-21 00:00:00.000,ATP Masters Series Canada Toronto; Canada ATP World Tour,HARD,2,Andy Murray,N/A Bye,Andy Murray,,R64,0,0,0,0,0,0,0,0,0,0,0,0,0,0,0,0,0,0,0,0,0,0,0,0,0,0,0
2008-07-21 00:00:00.000,ATP Masters Series Canada Toronto; Canada ATP World Tour,HARD,2,Thomas Johansson,Andrey Golubev,Thomas Johansson,7-6(4); 6-1,R64,85,7,1,44,59,35,44,8,15,1,2,10,43,59,12,6,34,72,25,34,16,38,3,6,9,41,72
2008-07-21 00:00:00.000,ATP Masters Series Canada Toronto; Canada ATP World Tour,HARD,2,Marat Safin,Sam Querrey,Marat Safin,6-3; 6-3,R64,67,2,0,24,53,18,24,21,29,5,5,9,39,53,5,5,35,59,23,35,10,24,3,6,9,33,59
2008-07-21 00:00:00.000,ATP Masters Series Canada Toronto; Canada ATP World Tour,HARD,2,Stanislas Wawrinka,Simone Bolelli,Stanislas Wawrinka,6-4; 7-6(4),R64,96,4,1,36,56,28,36,13,20,0,2,11,41,56,1,1,55,85,34,55,16,30,5,8,11,50,85
2008-07-21 00:00:00.000,ATP Masters Series Canada Toronto; Canada ATP World Tour,HARD,2,Fernando Verdasco,Thomaz Bellucci,Fernando Verdasco,1-6; 6-3; 6-2,R64,109,4,7,44,66,30,44,9,22,1,5,12,39,66,5,1,39,90,30,39,18,51,10,15,12,48,90
2008-07-21 00:00:00.000,ATP Masters Series Canada Toronto; Canada ATP World Tour,HARD,2,Robin Soderling,Guillermo Canas,Robin Soderling,7-5; 6-1,R64,86,11,1,34,55,27,34,12,21,1,2,10,39,55,3,2,25,61,13,25,17,36,4,8,9,30,61
2008-07-21 00:00:00.000,ATP Masters Series Canada Toronto; Canada ATP World Tour,HARD,2,Frank Dancevic,Mario Ancic,Frank Dancevic,6-3; 6-4,R64,83,3,1,32,54,26,32,11,22,0,1,10,37,54,9,7,40,64,29,40,7,24,6,9,9,36,64
2008-07-21 00:00:00.000,ATP Masters Series Canada Toronto; Canada ATP World Tour,HARD,2,Novak Djokovic,N/A Bye,Novak Djokovic,,R64,0,0,0,0,0,0,0,0,0,0,0,0,0,0,0,0,0,0,0,0,0,0,0,0,0,0,0
2008-07-21 00:00:00.000,ATP Masters Series Canada Toronto; Canada ATP World Tour,HARD,2,David Ferrer,N/A Bye,David Ferrer,,R64,0,0,0,0,0,0,0,0,0,0,0,0,0,0,0,0,0,0,0,0,0,0,0,0,0,0,0
2008-07-21 00:00:00.000,ATP Masters Series Canada Toronto; Canada ATP World Tour,HARD,2,Robby Ginepri,Paul-Henri Mathieu,Robby Ginepri,6-3; 4-6; 6-4,R64,121,9,3,56,90,43,56,17,34,4,6,15,60,90,8,5,44,83,30,44,21,39,4,7,14,51,83
2008-07-21 00:00:00.000,ATP Masters Series Canada Toronto; Canada ATP World Tour,HARD,2,Alexander Kudryavtsev,Philipp Kohlschreiber,Alexander Kudryavtsev,6-2; 7-6(7),R64,83,7,1,40,69,30,40,20,29,3,3,10,50,69,4,3,39,64,30,39,13,25,4,6,10,43,64
2008-07-21 00:00:00.000,ATP Masters Series Canada Toronto; Canada ATP World Tour,HARD,2,Richard Gasquet,Michael Llodra,Richard Gasquet,6-2; 4-6; 6-3,R64,105,7,1,45,79,32,45,21,34,3,5,13,53,79,8,5,49,84,31,49,19,35,4,9,14,50,84
2008-07-21 00:00:00.000,ATP Masters Series Canada Toronto; Canada ATP World Tour,HARD,2,Tomas Berdych,Jarkko Nieminen,Tomas Berdych,6-3; 6-1,R64,51,12,1,32,50,25,32,11,18,2,2,8,36,50,0,2,33,44,18,33,3,11,2,6,8,21,44
2008-07-21 00:00:00.000,ATP Masters Series Canada Toronto; Canada ATP World Tour,HARD,2,Igor Andreev,Gael Monfils,Igor Andreev,7-6(5); 7-6(3),R64,111,2,3,49,78,36,49,21,29,0,1,12,57,78,7,3,44,84,36,44,21,40,6,7,12,57,84
2008-07-21 00:00:00.000,ATP Masters Series Canada Toronto; Canada ATP World Tour,HARD,2,Jesse Levine,Peter Polansky,Jesse Levine,6-2; 6-4,R64,80,2,0,32,57,18,32,16,25,6,8,9,34,57,1,0,35,60,15,35,14,25,7,12,9,29,60
2008-07-21 00:00:00.000,ATP Masters Series Canada Toronto; Canada ATP World Tour,HARD,2,Rafael Nadal,N/A Bye,Rafael Nadal,,R64,0,0,0,0,0,0,0,0,0,0,0,0,0,0,0,0,0,0,0,0,0,0,0,0,0,0,0
2008-07-21 00:00:00.000,ATP Masters Series Canada Toronto; Canada ATP World Tour,HARD,2,Gilles Simon,Roger Federer,Gilles Simon,2-6; 7-5; 6-4,R32,122,0,0,51,86,34,51,18,35,5,10,15,52,86,6,1,48,91,30,48,21,43,7,12,15,51,91
2008-07-21 00:00:00.000,ATP Masters Series Canada Toronto; Canada ATP World Tour,HARD,2,Jose Acasuso,Fernando Gonzalez,Jose Acasuso,6-3; 3-6; 6-3,R32,135,7,5,62,102,39,62,22,40,7,10,14,61,102,3,4,52,78,35,52,12,26,8,12,13,47,78
2008-07-21 00:00:00.000,ATP Masters Series Canada Toronto; Canada ATP World Tour,HARD,2,Marin Cilic,Tommy Robredo,Marin Cilic,6-3; 6-4,R32,74,7,2,33,55,25,33,14,22,0,1,10,39,55,1,0,45,56,25,45,6,11,5,8,9,31,56
2008-07-21 00:00:00.000,ATP Masters Series Canada Toronto; Canada ATP World Tour,HARD,2,Andy Roddick,Nicolas Mahut,Andy Roddick,6-1; 6-7(6); 6-3,R32,110,18,2,58,85,46,58,22,27,5,5,15,68,85,7,3,51,81,39,51,13,30,4,7,13,52,81
2008-07-21 00:00:00.000,ATP Masters Series Canada Toronto; Canada ATP World Tour,HARD,2,Nikolay Davydenko,Tommy Haas,Nikolay Davydenko,6-3; 7-6(6),R32,102,4,3,39,61,29,39,17,22,2,2,10,46,61,2,1,45,73,32,45,14,28,4,6,11,46,73
2008-07-21 00:00:00.000,ATP Masters Series Canada Toronto; Canada ATP World Tour,HARD,2,Nicolas Kiefer,Mikhail Youzhny,Nicolas Kiefer,7-6(4); 7-5,R32,139,11,2,50,84,39,50,17,34,5,6,12,56,84,4,0,56,88,38,56,15,32,4,6,12,53,88
2008-07-21 00:00:00.000,ATP Masters Series Canada Toronto; Canada ATP World Tour,HARD,2,Dmitry Tursunov,Feliciano Lopez,Dmitry Tursunov,6-3; 7-6(6),R32,99,7,4,49,86,37,49,22,37,4,4,11,59,86,8,2,42,66,28,42,16,24,1,2,10,44,66
2008-07-21 00:00:00.000,ATP Masters Series Canada Toronto; Canada ATP World Tour,HARD,2,James Blake,Jonas Bjorkman,James Blake,1-6; 6-1; 6-2,R32,78,4,3,34,66,27,34,16,32,1,3,11,43,66,1,5,29,58,20,29,13,29,4,8,11,33,58
2008-07-21 00:00:00.000,ATP Masters Series Canada Toronto; Canada ATP World Tour,HARD,2,Andy Murray,Thomas Johansson,Andy Murray,6-4; 6-4,R32,96,12,3,48,77,34,48,9,29,3,6,10,43,77,1,2,43,77,24,43,14,34,6,11,10,38,77
2008-07-21 00:00:00.000,ATP Masters Series Canada Toronto; Canada ATP World Tour,HARD,2,Stanislas Wawrinka,Marat Safin,Stanislas Wawrinka,6-3; 6-4,R32,92,0,3,47,68,35,47,11,21,6,6,10,46,68,5,1,27,52,22,27,10,25,3,5,9,32,52
2008-07-21 00:00:00.000,ATP Masters Series Canada Toronto; Canada ATP World Tour,HARD,2,Robin Soderling,Fernando Verdasco,Robin Soderling,6-4; 6-7(4); 6-4,R32,136,3,1,57,97,44,57,22,40,0,2,16,66,97,8,12,76,103,57,76,7,27,3,7,16,64,103
2008-07-21 00:00:00.000,ATP Masters Series Canada Toronto; Canada ATP World Tour,HARD,2,Novak Djokovic,Frank Dancevic,Novak Djokovic,6-4; 6-4,R32,77,3,1,36,58,29,36,13,22,2,3,10,42,58,3,0,41,56,26,41,8,15,2,5,10,34,56
2008-07-21 00:00:00.000,ATP Masters Series Canada Toronto; Canada ATP World Tour,HARD,2,David Ferrer,Robby Ginepri,David Ferrer,6-4; 6-4,R32,85,4,0,36,56,30,36,11,20,0,0,10,41,56,1,4,50,76,34,50,12,26,3,5,10,46,76
2008-07-21 00:00:00.000,ATP Masters Series Canada Toronto; Canada ATP World Tour,HARD,2,Richard Gasquet,Alexander Kudryavtsev,Richard Gasquet,7-5; 6-3,R32,70,10,0,36,56,31,36,11,20,0,1,11,42,56,5,5,41,70,29,41,12,29,2,5,10,41,70
2008-07-21 00:00:00.000,ATP Masters Series Canada Toronto; Canada ATP World Tour,HARD,2,Igor Andreev,Tomas Berdych,Igor Andreev,6-4; 3-6; 6-4,R32,109,4,0,48,79,38,48,18,31,0,1,14,56,79,11,2,47,79,39,47,15,32,1,3,15,54,79
2008-07-21 00:00:00.000,ATP Masters Series Canada Toronto; Canada ATP World Tour,HARD,2,Rafael Nadal,Jesse Levine,Rafael Nadal,6-4; 6-2,R32,97,2,3,51,67,34,51,8,16,6,7,9,42,67,2,4,30,60,23,30,11,30,3,7,9,34,60
2008-07-21 00:00:00.000,ATP Masters Series Canada Toronto; Canada ATP World Tour,HARD,2,Gilles Simon,Jose Acasuso,Gilles Simon,6-3; 6-4,R16,97,3,1,42,72,33,42,17,30,7,7,10,50,72,2,0,38,71,28,38,13,33,5,7,9,41,71
2008-07-21 00:00:00.000,ATP Masters Series Canada Toronto; Canada ATP World Tour,HARD,2,Marin Cilic,Andy Roddick,Marin Cilic,6-4; 4-6; 6-4,R16,115,7,3,41,82,30,41,26,41,2,5,15,56,82,13,2,61,88,41,61,14,27,5,9,15,55,88
2008-07-21 00:00:00.000,ATP Masters Series Canada Toronto; Canada ATP World Tour,HARD,2,Nicolas Kiefer,Nikolay Davydenko,Nicolas Kiefer,4-6; 6-4; 6-4,R16,180,10,0,53,89,42,53,17,36,2,4,15,59,89,6,1,61,92,44,61,17,31,4,7,15,61,92
2008-07-21 00:00:00.000,ATP Masters Series Canada Toronto; Canada ATP World Tour,HARD,2,James Blake,Dmitry Tursunov,James Blake,4-6; 6-1; 6-4,R16,109,5,1,45,80,34,45,14,35,3,6,13,48,80,9,6,49,90,33,49,16,41,4,10,14,49,90
2008-07-21 00:00:00.000,ATP Masters Series Canada Toronto; Canada ATP World Tour,HARD,2,Andy Murray,Stanislas Wawrinka,Andy Murray,6-2; 0-6; 6-4,R16,114,0,3,40,73,29,40,17,33,4,7,12,46,73,6,1,61,79,39,61,8,18,5,8,12,47,79
2008-07-21 00:00:00.000,ATP Masters Series Canada Toronto; Canada ATP World Tour,HARD,2,Novak Djokovic,Robin Soderling,Novak Djokovic,6-4; 6-4,R16,80,6,1,37,60,30,37,15,23,4,4,10,45,60,9,4,41,56,30,41,7,15,3,5,10,37,56
2008-07-21 00:00:00.000,ATP Masters Series Canada Toronto; Canada ATP World Tour,HARD,2,Richard Gasquet,David Ferrer,Richard Gasquet,6-3; 6-3,R16,82,6,1,29,50,27,29,9,21,3,4,9,36,50,0,1,37,66,23,37,13,29,4,8,9,36,66
2008-07-21 00:00:00.000,ATP Masters Series Canada Toronto; Canada ATP World Tour,HARD,2,Rafael Nadal,Igor Andreev,Rafael Nadal,6-2; 7-6(1),R16,111,4,2,42,54,36,42,8,12,0,0,10,44,54,1,0,50,79,32,50,15,29,7,9,10,47,79
2008-07-21 00:00:00.000,ATP Masters Series Canada Toronto; Canada ATP World Tour,HARD,2,Gilles Simon,Marin Cilic,Gilles Simon,3-6; 6-2; 6-3,Q,142,3,2,70,101,48,70,17,31,8,9,13,65,101,8,4,42,99,28,42,32,57,12,15,13,60,99
2008-07-21 00:00:00.000,ATP Masters Series Canada Toronto; Canada ATP World Tour,HARD,2,Nicolas Kiefer,James Blake,Nicolas Kiefer,6-1; 6-2,Q,60,4,0,20,39,15,20,15,19,1,1,7,30,39,2,1,26,53,14,26,11,27,2,7,8,25,53
2008-07-21 00:00:00.000,ATP Masters Series Canada Toronto; Canada ATP World Tour,HARD,2,Andy Murray,Novak Djokovic,Andy Murray,6-3; 7-6(3),Q,105,2,0,30,73,21,30,27,43,3,5,11,48,73,3,2,39,64,26,39,12,25,3,6,10,38,64
2008-07-21 00:00:00.000,ATP Masters Series Canada Toronto; Canada ATP World Tour,HARD,2,Rafael Nadal,Richard Gasquet,Rafael Nadal,6-7(12); 6-2; 6-1,Q,140,0,1,71,92,48,71,14,21,3,5,14,62,92,10,4,47,85,28,47,17,38,4,10,13,45,85
2008-07-21 00:00:00.000,ATP Masters Series Canada Toronto; Canada ATP World Tour,HARD,2,Nicolas Kiefer,Gilles Simon,Nicolas Kiefer,6-7(4); 6-3; 7-6(5),S,179,11,4,59,121,50,59,28,62,10,13,17,78,121,5,1,63,106,43,63,25,43,4,8,16,68,106
2008-07-21 00:00:00.000,ATP Masters Series Canada Toronto; Canada ATP World Tour,HARD,2,Rafael Nadal,Andy Murray,Rafael Nadal,7-6(2); 6-3,S,122,1,1,59,84,37,59,17,25,2,3,11,54,84,5,0,33,61,22,33,16,28,0,2,10,38,61
2008-07-21 00:00:00.000,ATP Masters Series Canada Toronto; Canada ATP World Tour,HARD,2,Rafael Nadal,Nicolas Kiefer,Rafael Nadal,6-3; 6-2,F,90,2,1,34,52,26,34,12,18,3,3,8,38,52,7,5,24,51,20,24,8,27,0,4,9,28,51
2008-07-28 00:00:00.000,ATP Masters Series Cincinnati OH; U.S.A. ATP World Tour,HARD,2,Roger Federer,N/A Bye,Roger Federer,,R64,0,0,0,0,0,0,0,0,0,0,0,0,0,0,0,0,0,0,0,0,0,0,0,0,0,0,0
2008-07-28 00:00:00.000,ATP Masters Series Cincinnati OH; U.S.A. ATP World Tour,HARD,2,Robby Ginepri,Jonas Bjorkman,Robby Ginepri,6-0; 7-6(5),R64,79,8,1,43,66,35,43,11,23,0,1,9,46,66,3,1,34,54,20,34,11,20,2,6,9,31,54
2008-07-28 00:00:00.000,ATP Masters Series Cincinnati OH; U.S.A. ATP World Tour,HARD,2,Jose Acasuso,Paul Capdeville,Jose Acasuso,5-7; 6-2; 6-2,R64,116,9,2,46,79,36,46,16,33,5,8,14,52,79,7,4,62,100,37,62,16,38,8,14,14,53,100
2008-07-28 00:00:00.000,ATP Masters Series Cincinnati OH; U.S.A. ATP World Tour,HARD,2,Ivo Karlovic,Thomaz Bellucci,Ivo Karlovic,6-3; 6-4,R64,70,18,3,40,58,35,40,8,18,5,5,10,43,58,4,1,33,53,23,33,11,20,4,6,9,34,53
2008-07-28 00:00:00.000,ATP Masters Series Cincinnati OH; U.S.A. ATP World Tour,HARD,2,Tommy Robredo,Mardy Fish,Tommy Robredo,6-2; 6-2,R64,63,2,0,18,38,14,18,18,20,0,0,8,32,38,9,6,25,52,19,25,8,27,5,9,8,27,52
2008-07-28 00:00:00.000,ATP Masters Series Cincinnati OH; U.S.A. ATP World Tour,HARD,2,Robin Soderling,Julien Benneteau,Robin Soderling,6-0; 6-3,R64,57,8,3,30,48,28,30,6,18,5,5,7,34,48,2,1,35,52,19,35,5,17,3,8,8,24,52
2008-07-28 00:00:00.000,ATP Masters Series Cincinnati OH; U.S.A. ATP World Tour,HARD,2,Philipp Kohlschreiber,Michael Yani,Philipp Kohlschreiber,6-3; 6-4,R64,71,6,0,44,57,35,44,8,13,1,1,10,43,57,8,1,35,51,23,35,11,16,0,2,9,34,51
2008-07-28 00:00:00.000,ATP Masters Series Cincinnati OH; U.S.A. ATP World Tour,HARD,2,Woong-Sun Jun,N/A Bye,Woong-Sun Jun,,R64,0,0,0,0,0,0,0,0,0,0,0,0,0,0,0,0,0,0,0,0,0,0,0,0,0,0,0
2008-07-28 00:00:00.000,ATP Masters Series Cincinnati OH; U.S.A. ATP World Tour,HARD,2,Nikolay Davydenko,N/A Bye,Nikolay Davydenko,,R64,0,0,0,0,0,0,0,0,0,0,0,0,0,0,0,0,0,0,0,0,0,0,0,0,0,0,0
2008-07-28 00:00:00.000,ATP Masters Series Cincinnati OH; U.S.A. ATP World Tour,HARD,2,Carlos Moya,Janko Tipsarevic,Carlos Moya,7-6(5); 7-5,R64,123,4,5,52,93,39,52,23,41,5,6,12,62,93,9,6,35,79,30,35,22,44,5,7,12,52,79
2008-07-28 00:00:00.000,ATP Masters Series Cincinnati OH; U.S.A. ATP World Tour,HARD,2,John Isner,Andrea Stoppini,John Isner,7-6(2); 6-3,R64,74,17,1,39,57,39,39,9,18,0,0,11,48,57,6,3,38,62,31,38,11,24,3,4,10,42,62
2008-07-28 00:00:00.000,ATP Masters Series Cincinnati OH; U.S.A. ATP World Tour,HARD,2,Igor Andreev,Radek Stepanek,Igor Andreev,7-6(4); 6-7(4); 7-6(3),R64,171,25,5,72,119,58,72,28,47,5,7,18,86,119,13,8,79,125,64,79,20,46,4,6,18,84,125
2008-07-28 00:00:00.000,ATP Masters Series Cincinnati OH; U.S.A. ATP World Tour,HARD,2,Richard Gasquet,Michael Llodra,Richard Gasquet,3-6; 6-1; 1-0 RET,R64,71,5,1,39,58,26,39,9,19,3,5,8,35,58,1,3,27,46,20,27,6,19,2,6,9,26,46
2008-07-28 00:00:00.000,ATP Masters Series Cincinnati OH; U.S.A. ATP World Tour,HARD,2,Dmitry Tursunov,Marat Safin,Dmitry Tursunov,7-6(5); 6-4,R64,91,6,3,39,62,36,39,15,23,2,2,11,51,62,7,9,31,71,26,31,25,40,6,7,11,51,71
2008-07-28 00:00:00.000,ATP Masters Series Cincinnati OH; U.S.A. ATP World Tour,HARD,2,Sam Querrey,Paul-Henri Mathieu,Sam Querrey,6-4; 4-6; 6-3,R64,112,20,3,56,85,47,56,14,29,3,5,15,61,85,12,7,45,88,36,45,19,43,2,5,14,55,88
2008-07-28 00:00:00.000,ATP Masters Series Cincinnati OH; U.S.A. ATP World Tour,HARD,2,Andy Murray,N/A Bye,Andy Murray,,R64,0,0,0,0,0,0,0,0,0,0,0,0,0,0,0,0,0,0,0,0,0,0,0,0,0,0,0
2008-07-28 00:00:00.000,ATP Masters Series Cincinnati OH; U.S.A. ATP World Tour,HARD,2,James Blake,N/A Bye,James Blake,,R64,0,0,0,0,0,0,0,0,0,0,0,0,0,0,0,0,0,0,0,0,0,0,0,0,0,0,0
2008-07-28 00:00:00.000,ATP Masters Series Cincinnati OH; U.S.A. ATP World Tour,HARD,2,Gilles Simon,Rajeev Ram,Gilles Simon,7-6(5); 6-4,R64,88,3,0,45,64,31,45,12,19,1,3,11,43,64,5,1,44,75,28,44,17,31,1,4,11,45,75
2008-07-28 00:00:00.000,ATP Masters Series Cincinnati OH; U.S.A. ATP World Tour,HARD,2,Ernests Gulbis,Jarkko Nieminen,Ernests Gulbis,7-6(7); 6-2,R64,85,13,4,35,69,30,35,17,34,1,1,10,47,69,0,1,53,70,32,53,9,17,5,7,10,41,70
2008-07-28 00:00:00.000,ATP Masters Series Cincinnati OH; U.S.A. ATP World Tour,HARD,2,Arnaud Clement,Thomas Johansson,Arnaud Clement,7-6(4); 6-7(5); 6-3,R64,156,25,2,60,107,48,60,25,47,4,6,17,73,107,28,9,64,116,49,64,25,52,9,12,16,74,116
2008-07-28 00:00:00.000,ATP Masters Series Cincinnati OH; U.S.A. ATP World Tour,HARD,2,Tomas Berdych,Fernando Gonzalez,Tomas Berdych,6-3; 3-6; 6-3,R64,100,6,2,39,75,31,39,19,36,0,2,14,50,75,7,3,42,68,31,42,16,26,2,5,13,47,68
2008-07-28 00:00:00.000,ATP Masters Series Cincinnati OH; U.S.A. ATP World Tour,HARD,2,Andreas Seppi,Feliciano Lopez,Andreas Seppi,7-5; 7-5,R64,102,9,2,50,92,36,50,20,42,8,10,12,56,92,11,4,38,62,28,38,11,24,4,8,12,39,62
2008-07-28 00:00:00.000,ATP Masters Series Cincinnati OH; U.S.A. ATP World Tour,HARD,2,Simone Bolelli,Kevin Anderson,Simone Bolelli,6-3; 7-6(1),R64,89,5,2,42,68,31,42,20,26,1,1,11,51,68,11,5,44,68,32,44,13,24,4,5,10,45,68
2008-07-28 00:00:00.000,ATP Masters Series Cincinnati OH; U.S.A. ATP World Tour,HARD,2,Novak Djokovic,N/A Bye,Novak Djokovic,,R64,0,0,0,0,0,0,0,0,0,0,0,0,0,0,0,0,0,0,0,0,0,0,0,0,0,0,0
2008-07-28 00:00:00.000,ATP Masters Series Cincinnati OH; U.S.A. ATP World Tour,HARD,2,David Ferrer,N/A Bye,David Ferrer,,R64,0,0,0,0,0,0,0,0,0,0,0,0,0,0,0,0,0,0,0,0,0,0,0,0,0,0,0
2008-07-28 00:00:00.000,ATP Masters Series Cincinnati OH; U.S.A. ATP World Tour,HARD,2,Nicolas Lapentti,Marin Cilic,Nicolas Lapentti,7-6(5); 6-2,R64,86,3,4,41,67,35,41,11,26,2,3,10,46,67,3,4,23,54,20,23,16,31,1,4,10,36,54
2008-07-28 00:00:00.000,ATP Masters Series Cincinnati OH; U.S.A. ATP World Tour,HARD,2,Chris Guccione,Jesse Levine,Chris Guccione,6-3; 6-4,R64,65,17,0,33,55,29,33,14,22,3,3,10,43,55,2,3,36,53,23,36,9,17,2,4,9,32,53
2008-07-28 00:00:00.000,ATP Masters Series Cincinnati OH; U.S.A. ATP World Tour,HARD,2,Fernando Verdasco,Victor Estrella Burgos,Fernando Verdasco,6-3; 7-5,R64,99,7,9,46,67,40,46,6,21,5,5,10,46,67,2,2,60,83,35,60,12,23,5,8,11,47,83
2008-07-28 00:00:00.000,ATP Masters Series Cincinnati OH; U.S.A. ATP World Tour,HARD,2,Tommy Haas,Mikhail Youzhny,Tommy Haas,7-6(2); 2-6; 6-4,R64,129,17,8,52,84,48,52,13,32,3,5,15,61,84,9,8,59,92,44,59,21,33,4,5,15,65,92
2008-07-28 00:00:00.000,ATP Masters Series Cincinnati OH; U.S.A. ATP World Tour,HARD,2,Gael Monfils,Donald Young,Gael Monfils,6-1; 6-1,R64,53,6,3,27,49,24,27,11,22,5,5,7,35,49,0,4,29,48,15,29,6,19,4,9,7,21,48
2008-07-28 00:00:00.000,ATP Masters Series Cincinnati OH; U.S.A. ATP World Tour,HARD,2,Florent Serra,Benjamin Becker,Florent Serra,4-6; 7-6(6); 6-4,R64,126,15,1,55,97,40,55,25,42,0,3,16,65,97,16,7,44,102,36,44,28,58,5,8,16,64,102
2008-07-28 00:00:00.000,ATP Masters Series Cincinnati OH; U.S.A. ATP World Tour,HARD,2,Rafael Nadal,N/A Bye,Rafael Nadal,,R64,0,0,0,0,0,0,0,0,0,0,0,0,0,0,0,0,0,0,0,0,0,0,0,0,0,0,0
2008-07-28 00:00:00.000,ATP Masters Series Cincinnati OH; U.S.A. ATP World Tour,HARD,2,Roger Federer,Robby Ginepri,Roger Federer,6-7(2); 7-6(5); 6-0,R32,133,21,2,60,94,50,60,16,34,3,6,15,66,94,7,4,79,130,51,79,21,51,10,16,15,72,130
2008-07-28 00:00:00.000,ATP Masters Series Cincinnati OH; U.S.A. ATP World Tour,HARD,2,Ivo Karlovic,Jose Acasuso,Ivo Karlovic,6-3; 7-6(3),R32,85,17,0,39,57,37,39,12,18,0,0,11,49,57,2,3,33,70,29,33,16,37,4,5,10,45,70
2008-07-28 00:00:00.000,ATP Masters Series Cincinnati OH; U.S.A. ATP World Tour,HARD,2,Robin Soderling,Tommy Robredo,Robin Soderling,7-6(6); 6-4,R32,95,10,1,37,64,30,37,21,27,0,0,11,51,64,5,2,44,63,37,44,13,19,1,2,11,50,63
2008-07-28 00:00:00.000,ATP Masters Series Cincinnati OH; U.S.A. ATP World Tour,HARD,2,Philipp Kohlschreiber,Woong-Sun Jun,Philipp Kohlschreiber,6-2; 6-2,R32,61,6,1,34,45,27,34,7,11,1,1,8,34,45,0,0,27,44,18,27,3,17,3,7,8,21,44
2008-07-28 00:00:00.000,ATP Masters Series Cincinnati OH; U.S.A. ATP World Tour,HARD,2,Carlos Moya,Nikolay Davydenko,Carlos Moya,7-6(8); 4-6; 6-2,R32,147,6,4,58,100,43,58,24,42,5,7,15,67,100,9,2,58,96,42,58,21,38,8,11,15,63,96
2008-07-28 00:00:00.000,ATP Masters Series Cincinnati OH; U.S.A. ATP World Tour,HARD,2,Igor Andreev,John Isner,Igor Andreev,3-6; 7-6(8); 7-5,R32,144,15,3,79,119,59,79,21,40,7,8,16,80,119,27,2,68,98,57,68,19,30,1,2,17,76,98
2008-07-28 00:00:00.000,ATP Masters Series Cincinnati OH; U.S.A. ATP World Tour,HARD,2,Dmitry Tursunov,Richard Gasquet,Dmitry Tursunov,7-6(8); 6-0,R32,77,5,3,28,53,25,28,18,25,2,2,9,43,53,8,2,41,67,30,41,10,26,5,8,9,40,67
2008-07-28 00:00:00.000,ATP Masters Series Cincinnati OH; U.S.A. ATP World Tour,HARD,2,Andy Murray,Sam Querrey,Andy Murray,7-6(3); 6-1,R32,77,11,5,34,55,28,34,10,21,0,2,10,38,55,7,3,43,76,27,43,11,33,6,10,9,38,76
2008-07-28 00:00:00.000,ATP Masters Series Cincinnati OH; U.S.A. ATP World Tour,HARD,2,James Blake,Gilles Simon,James Blake,6-4; 6-3,R32,61,5,4,32,54,28,32,10,22,1,2,10,38,54,1,0,44,58,23,44,10,14,3,6,9,33,58
2008-07-28 00:00:00.000,ATP Masters Series Cincinnati OH; U.S.A. ATP World Tour,HARD,2,Ernests Gulbis,Arnaud Clement,Ernests Gulbis,6-4; 3-6; 7-6(5),R32,149,12,6,55,91,39,55,19,36,3,6,15,58,91,6,3,58,107,46,58,21,49,4,7,16,67,107
2008-07-28 00:00:00.000,ATP Masters Series Cincinnati OH; U.S.A. ATP World Tour,HARD,2,Andreas Seppi,Tomas Berdych,Andreas Seppi,5-7; 7-5; 7-5,R32,141,9,5,59,100,48,59,23,41,2,4,18,71,100,19,3,63,113,51,63,23,50,4,7,18,74,113
2008-07-28 00:00:00.000,ATP Masters Series Cincinnati OH; U.S.A. ATP World Tour,HARD,2,Novak Djokovic,Simone Bolelli,Novak Djokovic,7-6(2); 7-6(2),R32,114,9,5,54,97,45,54,21,43,10,12,12,66,97,2,0,49,72,37,49,11,23,0,2,12,48,72
2008-07-28 00:00:00.000,ATP Masters Series Cincinnati OH; U.S.A. ATP World Tour,HARD,2,Nicolas Lapentti,David Ferrer,Nicolas Lapentti,7-6(2); 3-6; 6-3,R32,146,2,2,56,104,42,56,24,48,8,11,15,66,104,2,2,51,83,33,51,24,32,3,6,15,57,83
2008-07-28 00:00:00.000,ATP Masters Series Cincinnati OH; U.S.A. ATP World Tour,HARD,2,Fernando Verdasco,Chris Guccione,Fernando Verdasco,7-6(4); 7-6(4),R32,96,2,6,56,80,49,56,13,24,3,3,12,62,80,13,1,51,78,44,51,15,27,1,1,12,59,78
2008-07-28 00:00:00.000,ATP Masters Series Cincinnati OH; U.S.A. ATP World Tour,HARD,2,Tommy Haas,Gael Monfils,Tommy Haas,5-1 RET,R32,26,3,0,13,21,10,13,5,8,2,2,3,15,21,1,1,13,22,8,13,2,9,1,3,3,10,22
2008-07-28 00:00:00.000,ATP Masters Series Cincinnati OH; U.S.A. ATP World Tour,HARD,2,Rafael Nadal,Florent Serra,Rafael Nadal,6-0; 6-1,R32,46,3,2,25,37,21,25,7,12,0,0,7,28,37,1,3,14,33,5,14,6,19,6,11,6,11,33
2008-07-28 00:00:00.000,ATP Masters Series Cincinnati OH; U.S.A. ATP World Tour,HARD,2,Ivo Karlovic,Roger Federer,Ivo Karlovic,7-6(6); 4-6; 7-6(5),R16,130,22,1,78,110,62,78,22,32,2,3,17,84,110,6,0,66,97,58,66,22,31,2,2,17,80,97
2008-07-28 00:00:00.000,ATP Masters Series Cincinnati OH; U.S.A. ATP World Tour,HARD,2,Philipp Kohlschreiber,Robin Soderling,Philipp Kohlschreiber,7-6(4); 5-7; 7-6(8),R16,144,22,1,77,113,55,77,26,36,1,2,18,81,113,23,4,79,124,57,79,28,45,6,6,18,85,124
2008-07-28 00:00:00.000,ATP Masters Series Cincinnati OH; U.S.A. ATP World Tour,HARD,2,Carlos Moya,Igor Andreev,Carlos Moya,6-4; 7-6(2),R16,99,5,3,47,74,35,47,15,27,7,8,11,50,74,6,7,39,67,34,39,12,28,2,4,11,46,67
2008-07-28 00:00:00.000,ATP Masters Series Cincinnati OH; U.S.A. ATP World Tour,HARD,2,Andy Murray,Dmitry Tursunov,Andy Murray,6-3; 6-3,R16,69,5,2,28,53,24,28,12,25,2,3,9,36,53,6,5,30,50,20,30,9,20,3,7,9,29,50
2008-07-28 00:00:00.000,ATP Masters Series Cincinnati OH; U.S.A. ATP World Tour,HARD,2,Ernests Gulbis,James Blake,Ernests Gulbis,6-4; 1-6; 6-3,R16,108,10,3,47,85,35,47,20,38,2,4,13,55,85,6,2,35,77,25,35,26,42,1,3,13,51,77
2008-07-28 00:00:00.000,ATP Masters Series Cincinnati OH; U.S.A. ATP World Tour,HARD,2,Novak Djokovic,Andreas Seppi,Novak Djokovic,6-1; 6-2,R16,59,8,1,23,41,19,23,11,18,0,1,8,30,41,0,5,27,49,17,27,4,22,5,10,7,21,49
2008-07-28 00:00:00.000,ATP Masters Series Cincinnati OH; U.S.A. ATP World Tour,HARD,2,Nicolas Lapentti,Fernando Verdasco,Nicolas Lapentti,6-3; 7-5,R16,94,3,0,49,67,38,49,7,18,2,3,11,45,67,3,6,32,58,23,32,13,26,1,4,10,36,58
2008-07-28 00:00:00.000,ATP Masters Series Cincinnati OH; U.S.A. ATP World Tour,HARD,2,Rafael Nadal,Tommy Haas,Rafael Nadal,6-4; 7-6(0),R16,122,8,3,49,77,35,49,16,28,2,3,11,51,77,7,4,38,69,22,38,21,31,4,6,11,43,69
2008-07-28 00:00:00.000,ATP Masters Series Cincinnati OH; U.S.A. ATP World Tour,HARD,2,Ivo Karlovic,Philipp Kohlschreiber,Ivo Karlovic,7-6(6); 7-6(3),Q,104,24,2,53,74,43,53,15,21,0,0,12,58,74,6,3,47,79,37,47,18,32,1,1,12,55,79
2008-07-28 00:00:00.000,ATP Masters Series Cincinnati OH; U.S.A. ATP World Tour,HARD,2,Andy Murray,Carlos Moya,Andy Murray,2-6; 6-3; 6-1,Q,96,12,6,30,65,25,30,18,35,4,7,12,43,65,4,1,44,72,28,44,8,28,4,9,12,36,72
2008-07-28 00:00:00.000,ATP Masters Series Cincinnati OH; U.S.A. ATP World Tour,HARD,2,Novak Djokovic,Ernests Gulbis,Novak Djokovic,6-3; 6-4,Q,94,6,1,43,64,33,43,12,21,3,3,10,45,64,3,4,42,68,27,42,14,26,3,5,9,41,68
2008-07-28 00:00:00.000,ATP Masters Series Cincinnati OH; U.S.A. ATP World Tour,HARD,2,Rafael Nadal,Nicolas Lapentti,Rafael Nadal,7-6(3); 6-1,Q,108,3,0,42,63,35,42,13,21,3,3,10,48,63,3,1,31,54,19,31,16,23,0,2,9,35,54
2008-07-28 00:00:00.000,ATP Masters Series Cincinnati OH; U.S.A. ATP World Tour,HARD,2,Andy Murray,Ivo Karlovic,Andy Murray,6-4; 6-4,S,82,1,1,41,53,33,41,5,12,3,5,10,38,53,6,0,49,71,30,49,9,22,9,13,10,39,71
2008-07-28 00:00:00.000,ATP Masters Series Cincinnati OH; U.S.A. ATP World Tour,HARD,2,Novak Djokovic,Rafael Nadal,Novak Djokovic,6-1; 7-5,S,86,4,0,32,57,23,32,19,25,1,1,10,42,57,2,1,26,45,19,26,9,19,1,4,9,28,45
2008-07-28 00:00:00.000,ATP Masters Series Cincinnati OH; U.S.A. ATP World Tour,HARD,2,Andy Murray,Novak Djokovic,Andy Murray,7-6(4); 7-6(5),F,143,1,2,46,88,32,46,26,42,3,5,12,58,88,6,6,55,96,36,55,21,41,2,4,12,57,96
2008-08-04 00:00:00.000,Los Angeles CA; USA ATP World Tour,HARD,2,Andy Roddick,N/A Bye,Andy Roddick,,R32,0,0,0,0,0,0,0,0,0,0,0,0,0,0,0,0,0,0,0,0,0,0,0,0,0,0,0
2008-08-04 00:00:00.000,Los Angeles CA; USA ATP World Tour,HARD,2,Dusan Vemic,Sam Warburg,Dusan Vemic,3-6; 7-6(5); 6-4,R32,174,10,10,73,109,50,73,15,36,11,15,15,65,109,8,6,73,115,49,73,19,42,9,13,16,68,115
2008-08-04 00:00:00.000,Los Angeles CA; USA ATP World Tour,HARD,2,Marc Gicquel,Zack Fleishman,Marc Gicquel,6-3; 6-0,R32,50,2,3,28,48,23,28,12,20,1,1,8,35,48,4,4,20,37,8,20,8,17,1,5,7,16,37
2008-08-04 00:00:00.000,Los Angeles CA; USA ATP World Tour,HARD,2,Donald Young,Tommy Haas,Donald Young,6-2; 6-4,R32,83,2,6,26,52,21,26,12,26,1,2,9,33,52,5,2,31,63,20,31,14,32,5,9,9,34,63
2008-08-04 00:00:00.000,Los Angeles CA; USA ATP World Tour,HARD,2,Feliciano Lopez,N/A Bye,Feliciano Lopez,,R32,0,0,0,0,0,0,0,0,0,0,0,0,0,0,0,0,0,0,0,0,0,0,0,0,0,0,0
2008-08-04 00:00:00.000,Los Angeles CA; USA ATP World Tour,HARD,2,Denis Gremelmayr,Fabio Fognini,Denis Gremelmayr,6-4; 6-2,R32,60,4,3,24,49,16,24,16,25,4,6,9,32,49,2,3,26,49,16,26,8,23,1,6,9,24,49
2008-08-04 00:00:00.000,Los Angeles CA; USA ATP World Tour,HARD,2,Wayne Odesnik,Bobby Reynolds,Wayne Odesnik,4-6; 6-1; 6-4,R32,118,9,1,53,85,34,53,23,32,5,7,14,57,85,4,6,51,81,34,51,13,30,6,10,13,47,81
2008-08-04 00:00:00.000,Los Angeles CA; USA ATP World Tour,HARD,2,Marat Safin,John Isner,Marat Safin,6-3; 6-4,R32,77,9,2,32,58,28,32,15,26,1,1,10,43,58,11,2,38,60,29,38,8,22,3,5,9,37,60
2008-08-04 00:00:00.000,Los Angeles CA; USA ATP World Tour,HARD,2,Carlos Moya,Xavier Malisse,Carlos Moya,6-2; 1-6; 7-6(5),R32,127,2,2,43,94,29,43,29,51,8,11,13,58,94,9,2,64,100,43,64,18,36,9,12,14,61,100
2008-08-04 00:00:00.000,Los Angeles CA; USA ATP World Tour,HARD,2,Amer Delic,Dudi Sela,Amer Delic,6-4; 6-4,R32,79,4,4,43,73,34,43,14,30,5,5,10,48,73,0,5,45,77,29,45,17,32,4,6,10,46,77
2008-08-04 00:00:00.000,Los Angeles CA; USA ATP World Tour,HARD,2,Andrea Stoppini,Igor Kunitsyn,Andrea Stoppini,6-1; 6-3,R32,61,2,2,30,49,21,30,7,19,4,7,8,28,49,0,3,26,49,12,26,6,23,3,10,8,18,49
2008-08-04 00:00:00.000,Los Angeles CA; USA ATP World Tour,HARD,2,Juan Martin Del Potro,N/A Bye,Juan Martin Del Potro,,R32,0,0,0,0,0,0,0,0,0,0,0,0,0,0,0,0,0,0,0,0,0,0,0,0,0,0,0
2008-08-04 00:00:00.000,Los Angeles CA; USA ATP World Tour,HARD,2,Mardy Fish,Alejandro Falla,Mardy Fish,6-2; 6-2,R32,62,4,1,20,46,17,20,17,26,3,3,8,34,46,0,3,22,52,11,22,16,30,3,7,8,27,52
2008-08-04 00:00:00.000,Los Angeles CA; USA ATP World Tour,HARD,2,Vincent Spadea,Sebastien Grosjean,Vincent Spadea,6-3; 3-6; 6-3,R32,118,2,4,54,98,36,54,23,44,7,10,14,59,98,1,3,46,83,33,46,17,37,3,7,13,50,83
2008-08-04 00:00:00.000,Los Angeles CA; USA ATP World Tour,HARD,2,Florent Serra,Andrey Golubev,Florent Serra,6-4; 6-1,R32,56,1,1,32,48,26,32,8,16,0,1,9,34,48,1,1,24,41,14,24,6,17,0,4,8,20,41
2008-08-04 00:00:00.000,Los Angeles CA; USA ATP World Tour,HARD,2,Fernando Verdasco,N/A Bye,Fernando Verdasco,,R32,0,0,0,0,0,0,0,0,0,0,0,0,0,0,0,0,0,0,0,0,0,0,0,0,0,0,0
2008-08-04 00:00:00.000,Los Angeles CA; USA ATP World Tour,HARD,2,Andy Roddick,Dusan Vemic,Andy Roddick,6-2; 6-2,R16,73,8,4,31,47,27,31,7,16,4,4,8,34,47,4,2,43,61,25,43,7,18,4,8,8,32,61
2008-08-04 00:00:00.000,Los Angeles CA; USA ATP World Tour,HARD,2,Marc Gicquel,Donald Young,Marc Gicquel,6-3; 6-3,R16,71,5,2,35,60,26,35,15,25,2,2,9,41,60,4,2,32,53,23,32,10,21,4,7,9,33,53
2008-08-04 00:00:00.000,Los Angeles CA; USA ATP World Tour,HARD,2,Denis Gremelmayr,Feliciano Lopez,Denis Gremelmayr,7-5; 7-5,R16,115,5,1,41,81,29,41,23,40,7,8,12,52,81,11,4,43,79,28,43,19,36,5,8,12,47,79
2008-08-04 00:00:00.000,Los Angeles CA; USA ATP World Tour,HARD,2,Marat Safin,Wayne Odesnik,Marat Safin,6-3; 6-2,R16,80,11,3,32,61,25,32,11,29,3,5,9,36,61,0,4,23,48,12,23,10,25,1,6,8,22,48
2008-08-04 00:00:00.000,Los Angeles CA; USA ATP World Tour,HARD,2,Amer Delic,Carlos Moya,Amer Delic,6-2; 6-7(5); 7-6(5),R16,139,14,3,76,116,57,76,20,40,6,8,16,77,116,6,5,59,97,45,59,20,38,0,4,16,65,97
2008-08-04 00:00:00.000,Los Angeles CA; USA ATP World Tour,HARD,2,Juan Martin Del Potro,Andrea Stoppini,Juan Martin Del Potro,6-4; 6-2,R16,70,3,2,30,46,24,30,11,16,1,2,9,35,46,3,4,41,66,22,41,13,25,7,11,9,35,66
2008-08-04 00:00:00.000,Los Angeles CA; USA ATP World Tour,HARD,2,Mardy Fish,Vincent Spadea,Mardy Fish,6-7(5); 6-1; 6-0,R16,111,14,2,45,94,36,45,25,49,8,9,13,61,94,3,9,42,85,27,42,17,43,5,11,12,44,85
2008-08-04 00:00:00.000,Los Angeles CA; USA ATP World Tour,HARD,2,Florent Serra,Fernando Verdasco,Florent Serra,6-2; 7-6(4),R16,109,2,0,58,79,40,58,8,21,5,7,10,48,79,0,10,56,81,35,56,7,25,3,7,10,42,81
2008-08-04 00:00:00.000,Los Angeles CA; USA ATP World Tour,HARD,2,Andy Roddick,Marc Gicquel,Andy Roddick,6-3; 6-1,Q,66,6,0,33,47,26,33,8,14,1,1,8,34,47,6,3,28,53,17,28,11,25,5,9,8,28,53
2008-08-04 00:00:00.000,Los Angeles CA; USA ATP World Tour,HARD,2,Denis Gremelmayr,Marat Safin,Denis Gremelmayr,3-6; 6-3; 6-2,Q,106,3,2,46,74,32,46,17,28,2,4,13,49,74,5,5,42,82,31,42,16,40,4,8,13,47,82
2008-08-04 00:00:00.000,Los Angeles CA; USA ATP World Tour,HARD,2,Juan Martin Del Potro,Amer Delic,Juan Martin Del Potro,7-6(6); 6-2,Q,89,7,2,44,60,34,44,11,16,4,5,10,45,60,3,1,40,70,26,40,14,30,3,6,10,40,70
2008-08-04 00:00:00.000,Los Angeles CA; USA ATP World Tour,HARD,2,Mardy Fish,Florent Serra,Mardy Fish,6-4; 6-4,Q,76,8,3,35,64,26,35,17,29,1,2,10,43,64,3,1,49,61,29,49,8,12,2,5,10,37,61
2008-08-04 00:00:00.000,Los Angeles CA; USA ATP World Tour,HARD,2,Andy Roddick,Denis Gremelmayr,Andy Roddick,6-2; 6-2,S,62,6,0,32,46,24,32,11,14,4,4,8,35,46,4,2,32,47,19,32,7,15,7,11,8,26,47
2008-08-04 00:00:00.000,Los Angeles CA; USA ATP World Tour,HARD,2,Juan Martin Del Potro,Mardy Fish,Juan Martin Del Potro,6-2; 6-1,S,82,1,2,32,48,24,32,9,16,2,2,7,33,48,4,1,30,64,19,30,12,34,8,13,8,31,64
2008-08-04 00:00:00.000,Los Angeles CA; USA ATP World Tour,HARD,2,Juan Martin Del Potro,Andy Roddick,Juan Martin Del Potro,6-1; 7-6(2),F,89,1,1,43,58,36,43,8,15,0,0,9,44,58,4,2,40,64,28,40,10,24,1,4,10,38,64
2008-08-10 00:00:00.000,Washington DC; USA ATP World Tour,HARD,2,Andy Roddick,Ramon Delgado,Andy Roddick,6-3; 7-6(4),R32,87,21,8,45,73,35,45,14,28,1,3,11,49,73,7,4,35,65,29,35,10,30,2,5,10,39,65
2008-08-10 00:00:00.000,Washington DC; USA ATP World Tour,HARD,2,Eduardo Schwank,Sebastien Grosjean,Eduardo Schwank,6-3; 4-6; 6-3,R32,120,5,4,52,84,37,52,21,32,6,8,14,58,84,1,1,47,81,33,47,16,34,2,6,14,49,81
2008-08-10 00:00:00.000,Washington DC; USA ATP World Tour,HARD,2,Viktor Troicki,Denis Gremelmayr,Viktor Troicki,6-4; 6-2,R32,70,5,0,32,51,26,32,11,19,0,0,9,37,51,4,2,29,56,17,29,14,27,0,3,9,31,56
2008-08-10 00:00:00.000,Washington DC; USA ATP World Tour,HARD,2,Bobby Reynolds,Marc Gicquel,Bobby Reynolds,7-6(2); 3-6; 6-4,R32,121,12,2,56,102,41,56,26,46,5,8,15,67,102,8,4,51,88,41,51,16,37,1,4,16,57,88
2008-08-10 00:00:00.000,Washington DC; USA ATP World Tour,HARD,2,Robert Kendrick,Feliciano Lopez,Robert Kendrick,6-3; 7-5,R32,66,13,4,40,57,37,40,8,17,2,3,11,45,57,8,3,37,57,25,37,10,20,1,4,10,35,57
2008-08-10 00:00:00.000,Washington DC; USA ATP World Tour,HARD,2,Somdev Devvarman,Taylor Dent,Somdev Devvarman,7-6(3); 2-6; 6-1,R32,107,1,1,60,80,42,60,12,20,1,4,14,54,80,4,4,58,92,41,58,15,34,1,4,13,56,92
2008-08-10 00:00:00.000,Washington DC; USA ATP World Tour,HARD,2,Igor Kunitsyn,Mischa Zverev,Igor Kunitsyn,6-7(6); 6-4; 6-2,R32,122,4,1,68,90,50,68,14,22,1,2,15,64,90,11,3,66,113,49,66,18,47,10,14,15,67,113
2008-08-10 00:00:00.000,Washington DC; USA ATP World Tour,HARD,2,Fabio Fognini,Marat Safin,Fabio Fognini,7-5 RET,R32,56,1,2,17,35,12,17,10,18,2,3,6,22,35,3,2,19,43,13,19,12,24,4,6,6,25,43
2008-08-10 00:00:00.000,Washington DC; USA ATP World Tour,HARD,2,Alejandro Falla,Mardy Fish,Alejandro Falla,5-7; 6-4; 6-2,R32,127,7,4,47,89,35,47,22,42,2,5,15,57,89,6,8,29,84,23,29,24,55,2,7,15,47,84
2008-08-10 00:00:00.000,Washington DC; USA ATP World Tour,HARD,2,Florent Serra,Uladzimir Ignatik,Florent Serra,7-6(3); 6-3,R32,74,5,1,40,68,32,40,18,28,2,4,11,50,68,4,5,40,60,26,40,9,20,3,6,10,35,60
2008-08-10 00:00:00.000,Washington DC; USA ATP World Tour,HARD,2,Nicolas Mahut,Wayne Odesnik,Nicolas Mahut,4-6; 6-4; 6-4,R32,145,17,2,52,87,41,52,19,35,3,5,15,60,87,8,5,80,130,54,80,20,50,12,15,15,74,130
2008-08-10 00:00:00.000,Washington DC; USA ATP World Tour,HARD,2,Tommy Haas,Rik De Voest,Tommy Haas,6-4; 4-6; 6-1,R32,101,7,2,40,64,31,40,14,24,1,3,13,45,64,4,4,47,88,29,47,22,41,7,12,14,51,88
2008-08-10 00:00:00.000,Washington DC; USA ATP World Tour,HARD,2,John Isner,Marcel Granollers,John Isner,6-3; 6-7(5); 7-6(1),R32,128,12,7,81,110,61,81,15,29,4,6,17,76,110,6,7,53,93,41,53,22,40,1,4,16,63,93
2008-08-10 00:00:00.000,Washington DC; USA ATP World Tour,HARD,2,Donald Young,Luis Horna,Donald Young,6-3; 6-1,R32,61,4,2,23,44,20,23,13,21,1,1,8,33,44,2,1,35,57,20,35,10,22,6,10,8,30,57
2008-08-10 00:00:00.000,Washington DC; USA ATP World Tour,HARD,2,Dudi Sela,Vincent Spadea,Dudi Sela,7-6(6); 6-3,R32,87,2,2,44,71,34,44,14,27,5,6,10,48,71,2,1,43,73,24,43,18,30,1,4,11,42,73
2008-08-10 00:00:00.000,Washington DC; USA ATP World Tour,HARD,2,Juan Martin Del Potro,Jesse Levine,Juan Martin Del Potro,6-2; 6-3,R32,73,6,1,36,52,25,36,8,16,2,4,9,33,52,0,4,32,59,16,32,10,27,6,11,8,26,59
2008-08-10 00:00:00.000,Washington DC; USA ATP World Tour,HARD,2,Andy Roddick,Eduardo Schwank,Andy Roddick,4-6; 6-4; 7-6(2),R16,163,12,7,61,105,44,61,26,44,8,11,16,70,105,12,2,89,135,57,89,24,46,13,16,16,81,135
2008-08-10 00:00:00.000,Washington DC; USA ATP World Tour,HARD,2,Viktor Troicki,Bobby Reynolds,Viktor Troicki,6-4; 1-6; 6-4,R16,112,10,2,51,82,37,51,13,31,9,12,13,50,82,4,3,56,93,39,56,18,37,8,11,14,57,93
2008-08-10 00:00:00.000,Washington DC; USA ATP World Tour,HARD,2,Somdev Devvarman,Robert Kendrick,Somdev Devvarman,6-2; 6-7(5); 7-5,R16,142,2,1,69,106,53,69,19,37,2,3,16,72,106,7,3,61,117,48,61,23,56,9,13,16,71,117
2008-08-10 00:00:00.000,Washington DC; USA ATP World Tour,HARD,2,Igor Kunitsyn,Fabio Fognini,Igor Kunitsyn,2-6; 6-2; 7-6(6),R16,136,0,1,63,86,37,63,13,23,1,6,14,50,86,5,7,50,113,40,50,19,63,10,15,14,59,113
2008-08-10 00:00:00.000,Washington DC; USA ATP World Tour,HARD,2,Alejandro Falla,Florent Serra,Alejandro Falla,7-6(2); 7-6(11),R16,145,4,3,57,117,39,57,33,60,11,14,12,72,117,1,2,60,93,41,60,17,33,8,11,12,58,93
2008-08-10 00:00:00.000,Washington DC; USA ATP World Tour,HARD,2,Tommy Haas,Nicolas Mahut,Tommy Haas,7-6(4); 6-3,R16,95,12,7,39,63,35,39,11,24,5,6,10,46,63,7,4,52,87,34,52,14,35,6,9,11,48,87
2008-08-10 00:00:00.000,Washington DC; USA ATP World Tour,HARD,2,John Isner,Donald Young,John Isner,6-4; 7-6(4),R16,77,17,3,48,66,38,48,12,18,0,0,11,50,66,3,0,35,61,28,35,17,26,0,1,11,45,61
2008-08-10 00:00:00.000,Washington DC; USA ATP World Tour,HARD,2,Juan Martin Del Potro,Dudi Sela,Juan Martin Del Potro,6-0; 5-7; 6-2,R16,109,2,2,46,74,36,46,15,28,0,2,13,51,74,2,7,43,84,24,43,17,41,9,15,13,41,84
2008-08-10 00:00:00.000,Washington DC; USA ATP World Tour,HARD,2,Viktor Troicki,Andy Roddick,Viktor Troicki,0-6; 6-2; 6-4,Q,101,11,4,47,79,34,47,14,32,5,8,12,48,79,13,3,44,72,33,44,14,28,3,6,12,47,72
2008-08-10 00:00:00.000,Washington DC; USA ATP World Tour,HARD,2,Igor Kunitsyn,Somdev Devvarman,Igor Kunitsyn,6-4; 6-1,Q,83,2,0,34,55,21,34,11,21,0,3,9,32,55,0,0,31,54,17,31,6,23,3,9,8,23,54
2008-08-10 00:00:00.000,Washington DC; USA ATP World Tour,HARD,2,Tommy Haas,Alejandro Falla,Tommy Haas,7-5; 6-1,Q,83,8,2,33,66,29,33,13,33,6,8,10,42,66,3,2,28,55,16,28,12,27,7,12,9,28,55
2008-08-10 00:00:00.000,Washington DC; USA ATP World Tour,HARD,2,Juan Martin Del Potro,John Isner,Juan Martin Del Potro,6-4; 6-4,Q,70,6,0,30,49,25,30,15,19,0,0,10,40,49,7,1,36,51,28,36,7,15,0,2,10,35,51
2008-08-10 00:00:00.000,Washington DC; USA ATP World Tour,HARD,2,Viktor Troicki,Igor Kunitsyn,Viktor Troicki,6-4; 6-2,S,76,7,0,29,47,24,29,11,18,1,2,9,35,47,0,0,44,61,23,44,8,17,5,9,9,31,61
2008-08-10 00:00:00.000,Washington DC; USA ATP World Tour,HARD,2,Juan Martin Del Potro,Tommy Haas,Juan Martin Del Potro,6-2; 6-1,S,83,4,2,30,55,26,30,9,25,1,1,7,35,55,5,3,36,57,17,36,9,21,5,10,8,26,57
2008-08-10 00:00:00.000,Washington DC; USA ATP World Tour,HARD,2,Juan Martin Del Potro,Viktor Troicki,Juan Martin Del Potro,6-3; 6-3,F,93,5,7,37,68,30,37,14,31,6,7,9,44,68,9,4,32,59,25,32,7,27,5,9,9,32,59
2008-08-11 00:00:00.000,Beijing Olympics China ATP World Tour,HARD,2,Roger Federer,Dmitry Tursunov,Roger Federer,6-4; 6-2,R64,66,5,0,32,52,28,32,12,20,2,2,9,40,52,3,4,17,46,14,17,13,29,3,6,9,27,46
2008-08-11 00:00:00.000,Beijing Olympics China ATP World Tour,HARD,2,Rafael Arevalo,Hyung-Taik Lee,Rafael Arevalo,4-6; 6-3; 6-4,R64,129,5,4,59,91,42,59,19,32,5,7,15,61,91,2,1,57,90,36,57,21,33,5,8,14,57,90
2008-08-11 00:00:00.000,Beijing Olympics China ATP World Tour,HARD,2,Andreas Seppi,Tommy Robredo,Andreas Seppi,6-4; 4-6; 8-6,R64,150,1,6,63,106,41,63,25,43,5,9,17,66,106,5,6,50,93,36,50,21,43,0,5,17,57,93
2008-08-11 00:00:00.000,Beijing Olympics China ATP World Tour,HARD,2,Tomas Berdych,Xin-Yuan Yu,Tomas Berdych,6-1; 6-2,R64,55,8,2,23,36,21,23,7,13,0,0,7,28,36,3,3,29,50,16,29,7,21,3,8,8,23,50
2008-08-11 00:00:00.000,Beijing Olympics China ATP World Tour,HARD,2,Gilles Simon,Robin Soderling,Gilles Simon,6-4; 6-4,R64,74,1,2,26,52,19,26,16,26,0,2,10,35,52,8,1,33,63,22,33,13,30,5,9,10,35,63
2008-08-11 00:00:00.000,Beijing Olympics China ATP World Tour,HARD,2,Guillermo Canas,Frederic Niemeyer,Guillermo Canas,3-6; 4-2 RET,R64,79,1,7,14,46,10,14,17,32,5,7,7,27,46,5,7,35,61,24,35,12,26,8,10,8,36,61
2008-08-11 00:00:00.000,Beijing Olympics China ATP World Tour,HARD,2,Dominik Hrbaty,Thomaz Bellucci,Dominik Hrbaty,2-6; 6-4; 6-2,R64,112,5,4,51,85,35,51,18,34,7,10,13,53,85,8,2,37,74,28,37,18,37,2,6,13,46,74
2008-08-11 00:00:00.000,Beijing Olympics China ATP World Tour,HARD,2,James Blake,Chris Guccione,James Blake,6-3; 7-6(3),R64,73,2,4,39,67,33,39,18,28,1,1,11,51,67,11,0,36,59,27,36,15,23,0,1,10,42,59
2008-08-11 00:00:00.000,Beijing Olympics China ATP World Tour,HARD,2,Nikolay Davydenko,Ernests Gulbis,Nikolay Davydenko,6-4; 6-2,R64,81,5,1,27,46,21,27,13,19,0,1,9,34,46,4,2,40,61,25,40,6,21,9,13,9,31,61
2008-08-11 00:00:00.000,Beijing Olympics China ATP World Tour,HARD,2,Paul-Henri Mathieu,Nicolas Lapentti,Paul-Henri Mathieu,7-6(4); 6-2,R64,99,5,6,38,65,31,38,15,27,0,0,10,46,65,4,1,40,60,27,40,10,20,0,2,10,37,60
2008-08-11 00:00:00.000,Beijing Olympics China ATP World Tour,HARD,2,Kevin Anderson,Komlavi Loglo,Kevin Anderson,6-3; 6-2,R64,59,3,2,22,44,20,22,16,22,0,0,9,36,44,1,0,29,44,17,29,9,15,1,4,8,26,44
2008-08-11 00:00:00.000,Beijing Olympics China ATP World Tour,HARD,2,Nicolas Kiefer,Max Mirnyi,Nicolas Kiefer,6-3; 6-1,R64,71,7,2,32,50,28,32,8,18,2,2,8,36,50,4,2,30,51,15,30,10,21,2,6,8,25,51
2008-08-11 00:00:00.000,Beijing Olympics China ATP World Tour,HARD,2,Fernando Gonzalez,Peng Sun,Fernando Gonzalez,6-4; 6-4,R64,68,10,1,30,48,25,30,15,18,0,0,10,40,48,1,2,26,54,16,26,21,28,2,4,10,37,54
2008-08-11 00:00:00.000,Beijing Olympics China ATP World Tour,HARD,2,Marin Cilic,Juan Monaco,Marin Cilic,6-4; 6-7(5); 6-3,R64,167,6,3,41,89,34,41,29,48,3,4,15,63,89,0,4,68,112,40,68,28,44,7,11,16,68,112
2008-08-11 00:00:00.000,Beijing Olympics China ATP World Tour,HARD,2,Olivier Rochus,Ivo Minar,Olivier Rochus,6-3; 3-6; 6-3,R64,118,6,5,54,89,40,54,21,35,4,5,14,61,89,6,0,57,79,37,57,14,22,1,3,13,51,79
2008-08-11 00:00:00.000,Beijing Olympics China ATP World Tour,HARD,2,Janko Tipsarevic,David Ferrer,Janko Tipsarevic,7-6(8); 6-2,R64,129,5,2,32,66,26,32,19,34,1,2,10,45,66,2,4,52,93,32,52,20,41,10,13,10,52,93
2008-08-11 00:00:00.000,Beijing Olympics China ATP World Tour,HARD,2,David Nalbandian,Shao-Xuan Zeng,David Nalbandian,6-2; 6-1,R64,66,3,6,22,52,17,22,15,30,5,6,7,32,52,3,4,30,53,14,30,7,23,3,9,8,21,53
2008-08-11 00:00:00.000,Beijing Olympics China ATP World Tour,HARD,2,Nicolas Massu,Steve Darcis,Nicolas Massu,6-4; 7-5,R64,98,4,2,48,69,34,48,13,21,5,7,11,47,69,3,1,36,63,25,36,11,27,4,8,11,36,63
2008-08-11 00:00:00.000,Beijing Olympics China ATP World Tour,HARD,2,Victor Hanescu,Simone Bolelli,Victor Hanescu,7-5; 3-6; 6-4,R64,135,7,1,63,101,45,63,20,38,7,10,16,65,101,5,1,61,91,41,61,16,30,4,7,15,57,91
2008-08-11 00:00:00.000,Beijing Olympics China ATP World Tour,HARD,2,Gael Monfils,Nicolas Almagro,Gael Monfils,6-4; 3-6; 6-3,R64,115,13,2,49,80,42,49,12,31,4,7,14,54,80,2,3,48,86,30,48,23,38,5,9,14,53,86
2008-08-11 00:00:00.000,Beijing Olympics China ATP World Tour,HARD,2,Mikhail Youzhny,Jiri Vanek,Mikhail Youzhny,6-4; 6-1,R64,64,6,1,26,48,23,26,11,22,0,1,9,34,48,7,0,39,58,22,39,6,19,5,9,8,28,58
2008-08-11 00:00:00.000,Beijing Olympics China ATP World Tour,HARD,2,Thomas Johansson,Jarkko Nieminen,Thomas Johansson,4-6; 6-4; 6-4,R64,138,11,2,46,102,35,46,27,56,9,12,15,62,102,1,2,71,102,48,71,15,31,9,13,15,63,102
2008-08-11 00:00:00.000,Beijing Olympics China ATP World Tour,HARD,2,Rainer Schuettler,Kei Nishikori,Rainer Schuettler,6-4; 6-7(5); 6-3,R64,168,4,3,60,101,44,60,20,41,9,12,15,64,101,5,6,65,116,42,65,21,51,10,16,16,63,116
2008-08-11 00:00:00.000,Beijing Olympics China ATP World Tour,HARD,2,Novak Djokovic,Robby Ginepri,Novak Djokovic,6-4; 6-4,R64,72,6,1,38,51,28,38,7,13,1,3,10,35,51,3,4,30,58,18,30,15,28,1,5,10,33,58
2008-08-11 00:00:00.000,Beijing Olympics China ATP World Tour,HARD,2,Yen-Hsun Lu,Andy Murray,Yen-Hsun Lu,7-6(5); 6-4,R64,130,1,5,51,91,39,51,14,40,8,11,11,53,91,3,2,56,92,33,56,17,36,7,11,11,50,92
2008-08-11 00:00:00.000,Beijing Olympics China ATP World Tour,HARD,2,Agustin Calleri,Devin Mullings,Agustin Calleri,6-1; 6-1,R64,60,4,2,25,48,21,25,13,23,4,4,7,34,48,0,3,38,53,18,38,5,15,7,12,7,23,53
2008-08-11 00:00:00.000,Beijing Olympics China ATP World Tour,HARD,2,Jurgen Melzer,Marcos Daniel,Jurgen Melzer,6-7(9); 6-1; 8-6,R64,145,10,3,69,104,53,69,19,35,3,6,17,72,104,6,4,58,113,39,58,24,55,7,13,16,63,113
2008-08-11 00:00:00.000,Beijing Olympics China ATP World Tour,HARD,2,Stanislas Wawrinka,Frank Dancevic,Stanislas Wawrinka,4-6; 6-3; 6-2,R64,113,3,3,40,73,32,40,21,33,1,3,14,53,73,3,4,43,84,31,43,17,41,7,11,13,48,84
2008-08-11 00:00:00.000,Beijing Olympics China ATP World Tour,HARD,2,Michael Llodra,Radek Stepanek,Michael Llodra,4-6; 7-6(5); 11-9,R64,167,20,6,74,118,59,74,24,44,2,5,21,83,118,14,6,76,126,60,76,25,50,8,11,21,85,126
2008-08-11 00:00:00.000,Beijing Olympics China ATP World Tour,HARD,2,Igor Andreev,Sam Querrey,Igor Andreev,6-4; 6-4,R64,73,5,2,33,58,26,33,16,25,2,2,10,42,58,5,0,32,51,28,32,8,19,2,4,10,36,51
2008-08-11 00:00:00.000,Beijing Olympics China ATP World Tour,HARD,2,Lleyton Hewitt,Jonas Bjorkman,Lleyton Hewitt,7-5; 7-6(2),R64,118,5,3,31,70,24,31,21,39,1,4,12,45,70,6,5,44,87,28,44,20,43,2,6,12,48,87
2008-08-11 00:00:00.000,Beijing Olympics China ATP World Tour,HARD,2,Rafael Nadal,Potito Starace,Rafael Nadal,6-2; 3-6; 6-2,R64,135,4,1,40,63,33,40,13,23,2,3,12,46,63,1,1,74,99,44,74,12,25,9,13,13,56,99
2008-08-11 00:00:00.000,Beijing Olympics China ATP World Tour,HARD,2,Roger Federer,Rafael Arevalo,Roger Federer,6-2; 6-4,R32,77,7,0,27,47,21,27,16,20,1,1,9,37,47,0,2,45,59,26,45,8,14,7,10,9,34,59
2008-08-11 00:00:00.000,Beijing Olympics China ATP World Tour,HARD,2,Tomas Berdych,Andreas Seppi,Tomas Berdych,6-3; 7-6(4),R32,98,14,3,35,61,31,35,15,26,0,1,11,46,61,4,6,34,75,28,34,18,41,5,7,10,46,75
2008-08-11 00:00:00.000,Beijing Olympics China ATP World Tour,HARD,2,Gilles Simon,Guillermo Canas,Gilles Simon,7-5; 6-1,R32,88,2,2,32,56,25,32,15,24,0,1,10,40,56,2,3,34,66,21,34,13,32,4,8,9,34,66
2008-08-11 00:00:00.000,Beijing Olympics China ATP World Tour,HARD,2,James Blake,Dominik Hrbaty,James Blake,7-6(3); 4-6; 6-3,R32,128,6,3,52,108,30,52,31,56,8,13,15,61,108,1,10,61,106,39,61,18,45,8,14,16,57,106
2008-08-11 00:00:00.000,Beijing Olympics China ATP World Tour,HARD,2,Paul-Henri Mathieu,Nikolay Davydenko,Paul-Henri Mathieu,7-5; 6-3,R32,92,4,3,25,57,23,25,18,32,0,1,11,41,57,5,3,30,57,24,30,11,27,3,6,10,35,57
2008-08-11 00:00:00.000,Beijing Olympics China ATP World Tour,HARD,2,Nicolas Kiefer,Kevin Anderson,Nicolas Kiefer,6-4; 6-7(4); 6-4,R32,201,13,2,50,101,44,50,26,51,3,4,16,70,101,14,6,74,122,55,74,19,48,10,13,16,74,122
2008-08-11 00:00:00.000,Beijing Olympics China ATP World Tour,HARD,2,Fernando Gonzalez,Marin Cilic,Fernando Gonzalez,6-4; 6-2,R32,71,3,2,35,56,27,35,15,21,3,3,9,42,56,5,5,22,51,20,22,11,29,1,4,9,31,51
2008-08-11 00:00:00.000,Beijing Olympics China ATP World Tour,HARD,2,Olivier Rochus,Janko Tipsarevic,Olivier Rochus,7-6(5); 2-3 RET,R32,118,1,1,32,64,18,32,18,32,7,10,8,36,64,6,5,26,57,20,26,12,31,2,5,9,32,57
2008-08-11 00:00:00.000,Beijing Olympics China ATP World Tour,HARD,2,David Nalbandian,Nicolas Massu,David Nalbandian,7-6(0); 6-1,R32,86,8,4,38,64,32,38,13,26,1,2,10,45,64,5,4,32,55,20,32,11,23,1,4,9,31,55
2008-08-11 00:00:00.000,Beijing Olympics China ATP World Tour,HARD,2,Gael Monfils,Victor Hanescu,Gael Monfils,6-4; 7-6(5),R32,98,9,1,44,68,33,44,13,24,2,4,11,46,68,0,0,46,62,33,46,7,16,1,4,11,40,62
2008-08-11 00:00:00.000,Beijing Olympics China ATP World Tour,HARD,2,Mikhail Youzhny,Thomas Johansson,Mikhail Youzhny,7-5; 6-2,R32,106,5,4,36,70,27,36,16,34,4,5,10,43,70,5,4,43,87,26,43,19,44,9,13,10,45,87
2008-08-11 00:00:00.000,Beijing Olympics China ATP World Tour,HARD,2,Novak Djokovic,Rainer Schuettler,Novak Djokovic,6-4; 6-2,R32,74,5,2,31,43,29,31,5,12,0,1,9,34,43,2,3,37,64,25,37,9,27,7,11,9,34,64
2008-08-11 00:00:00.000,Beijing Olympics China ATP World Tour,HARD,2,Yen-Hsun Lu,Agustin Calleri,Yen-Hsun Lu,6-4; 6-4,R32,82,3,1,27,50,22,27,17,23,0,1,10,39,50,5,6,40,68,29,40,10,28,7,10,10,39,68
2008-08-11 00:00:00.000,Beijing Olympics China ATP World Tour,HARD,2,Jurgen Melzer,Stanislas Wawrinka,Jurgen Melzer,6-4; 6-0,R32,65,1,0,35,53,25,35,12,18,1,1,8,37,53,2,2,32,47,16,32,7,15,2,6,8,23,47
2008-08-11 00:00:00.000,Beijing Olympics China ATP World Tour,HARD,2,Igor Andreev,Michael Llodra,Igor Andreev,6-4; 3-6; 6-1,R32,119,8,2,50,81,36,50,19,31,2,3,13,55,81,9,2,59,89,38,59,15,30,6,9,13,53,89
2008-08-11 00:00:00.000,Beijing Olympics China ATP World Tour,HARD,2,Rafael Nadal,Lleyton Hewitt,Rafael Nadal,6-1; 6-2,R32,91,4,2,38,56,25,38,11,18,5,6,8,36,56,2,0,25,54,17,25,6,29,4,9,7,23,54
2008-08-11 00:00:00.000,Beijing Olympics China ATP World Tour,HARD,2,Roger Federer,Tomas Berdych,Roger Federer,6-3; 7-6(4),R16,90,11,3,37,61,32,37,12,24,1,3,11,44,61,4,4,33,75,20,33,22,42,6,9,10,42,75
2008-08-11 00:00:00.000,Beijing Olympics China ATP World Tour,HARD,2,James Blake,Gilles Simon,James Blake,6-4; 6-2,R16,76,7,6,45,84,37,45,16,39,8,8,9,53,84,1,3,22,52,15,22,16,30,2,5,9,31,52
2008-08-11 00:00:00.000,Beijing Olympics China ATP World Tour,HARD,2,Paul-Henri Mathieu,Nicolas Kiefer,Paul-Henri Mathieu,6-3; 7-5,R16,104,3,5,25,59,24,25,18,34,1,2,11,42,59,4,3,33,71,21,33,19,38,3,6,10,40,71
2008-08-11 00:00:00.000,Beijing Olympics China ATP World Tour,HARD,2,Fernando Gonzalez,Olivier Rochus,Fernando Gonzalez,6-0; 6-3,R16,58,3,0,30,47,24,30,10,17,0,0,8,34,47,2,3,24,39,12,24,5,15,2,6,7,17,39
2008-08-11 00:00:00.000,Beijing Olympics China ATP World Tour,HARD,2,Gael Monfils,David Nalbandian,Gael Monfils,6-4; 6-4,R16,91,12,4,28,55,22,28,17,27,3,4,10,39,55,0,5,29,66,20,29,19,37,3,6,10,39,66
2008-08-11 00:00:00.000,Beijing Olympics China ATP World Tour,HARD,2,Novak Djokovic,Mikhail Youzhny,Novak Djokovic,7-6(3); 6-3,R16,97,4,0,40,54,35,40,9,14,0,0,10,44,54,6,4,39,71,28,39,15,32,2,4,11,43,71
2008-08-11 00:00:00.000,Beijing Olympics China ATP World Tour,HARD,2,Jurgen Melzer,Yen-Hsun Lu,Jurgen Melzer,6-2; 6-4,R16,66,4,0,37,55,27,37,13,18,0,0,9,40,55,1,1,29,48,17,29,11,19,1,4,9,28,48
2008-08-11 00:00:00.000,Beijing Olympics China ATP World Tour,HARD,2,Rafael Nadal,Igor Andreev,Rafael Nadal,6-4; 6-2,R16,95,4,0,37,55,28,37,11,18,4,4,9,39,55,5,3,35,55,23,35,6,20,3,6,9,29,55
2008-08-11 00:00:00.000,Beijing Olympics China ATP World Tour,HARD,2,James Blake,Roger Federer,James Blake,6-4; 7-6(2),Q,91,2,2,36,65,27,36,20,29,0,1,11,47,65,3,2,48,89,33,48,19,41,4,6,11,52,89
2008-08-11 00:00:00.000,Beijing Olympics China ATP World Tour,HARD,2,Fernando Gonzalez,Paul-Henri Mathieu,Fernando Gonzalez,6-4; 6-4,Q,104,3,2,30,59,24,30,17,29,1,2,10,41,59,5,9,37,82,23,37,23,45,5,8,10,46,82
2008-08-11 00:00:00.000,Beijing Olympics China ATP World Tour,HARD,2,Novak Djokovic,Gael Monfils,Novak Djokovic,4-6; 6-1; 6-4,Q,142,4,1,69,100,48,69,15,31,5,7,14,63,100,6,3,46,83,30,46,18,37,2,6,13,48,83
2008-08-11 00:00:00.000,Beijing Olympics China ATP World Tour,HARD,2,Rafael Nadal,Jurgen Melzer,Rafael Nadal,6-0; 6-4,Q,64,0,0,24,38,17,24,12,14,0,1,8,29,38,6,1,30,49,18,30,5,19,2,7,8,23,49
2008-08-11 00:00:00.000,Beijing Olympics China ATP World Tour,HARD,2,Fernando Gonzalez,James Blake,Fernando Gonzalez,4-6; 7-5; 11-9,S,173,12,4,99,138,74,99,18,39,7,9,21,92,138,11,4,77,133,61,77,28,56,4,7,21,89,133
2008-08-11 00:00:00.000,Beijing Olympics China ATP World Tour,HARD,2,Rafael Nadal,Novak Djokovic,Rafael Nadal,6-4; 1-6; 6-4,S,131,3,1,54,75,33,54,14,21,1,4,13,47,75,9,5,54,85,39,54,15,31,4,7,14,54,85
2008-08-11 00:00:00.000,Beijing Olympics China ATP World Tour,HARD,2,Rafael Nadal,Fernando Gonzalez,Rafael Nadal,6-3; 7-6(2); 6-3,F,143,4,3,63,87,54,63,15,24,4,4,16,69,87,9,1,71,107,50,71,14,36,8,10,14,64,107
2008-08-17 00:00:00.000,New Haven CT; U.S.A. ATP World Tour,HARD,2,Fernando Verdasco,N/A Bye,Fernando Verdasco,,R64,0,0,0,0,0,0,0,0,0,0,0,0,0,0,0,0,0,0,0,0,0,0,0,0,0,0,0
2008-08-17 00:00:00.000,New Haven CT; U.S.A. ATP World Tour,HARD,2,Dudi Sela,Donald Young,Dudi Sela,6-4; 6-2,R64,70,2,1,30,50,25,30,13,20,0,0,9,38,50,1,5,46,71,28,46,11,25,7,10,9,39,71
2008-08-17 00:00:00.000,New Haven CT; U.S.A. ATP World Tour,HARD,2,Ivo Minar,Nicolas Mahut,Ivo Minar,5-7; 6-3; 6-3,R64,105,4,3,49,86,37,49,21,37,3,6,15,58,86,6,5,56,91,38,56,17,35,4,9,15,55,91
2008-08-17 00:00:00.000,New Haven CT; U.S.A. ATP World Tour,HARD,2,Eduardo Schwank,N/A Bye,Eduardo Schwank,,R64,0,0,0,0,0,0,0,0,0,0,0,0,0,0,0,0,0,0,0,0,0,0,0,0,0,0,0
2008-08-17 00:00:00.000,New Haven CT; U.S.A. ATP World Tour,HARD,2,Agustin Calleri,N/A Bye,Agustin Calleri,,R64,0,0,0,0,0,0,0,0,0,0,0,0,0,0,0,0,0,0,0,0,0,0,0,0,0,0,0
2008-08-17 00:00:00.000,New Haven CT; U.S.A. ATP World Tour,HARD,2,Robby Ginepri,Luis Horna,Robby Ginepri,7-6(4); 6-2,R64,68,8,1,36,54,29,36,12,18,1,2,10,41,54,3,3,33,58,20,33,14,25,2,5,10,34,58
2008-08-17 00:00:00.000,New Haven CT; U.S.A. ATP World Tour,HARD,2,Mischa Zverev,Florent Serra,Mischa Zverev,6-2; 7-6(6),R64,83,14,3,28,56,25,28,20,28,0,0,10,45,56,0,0,56,92,35,56,19,36,6,8,10,54,92
2008-08-17 00:00:00.000,New Haven CT; U.S.A. ATP World Tour,HARD,2,Juan Monaco,N/A Bye,Juan Monaco,,R64,0,0,0,0,0,0,0,0,0,0,0,0,0,0,0,0,0,0,0,0,0,0,0,0,0,0,0
2008-08-17 00:00:00.000,New Haven CT; U.S.A. ATP World Tour,HARD,2,Jesse Levine,N/A Bye,Jesse Levine,,R64,0,0,0,0,0,0,0,0,0,0,0,0,0,0,0,0,0,0,0,0,0,0,0,0,0,0,0
2008-08-17 00:00:00.000,New Haven CT; U.S.A. ATP World Tour,HARD,2,Guillermo Garcia-Lopez,Chris Guccione,Guillermo Garcia-Lopez,7-5; 6-3,R64,81,0,4,27,56,20,27,20,29,2,3,10,40,56,8,3,38,68,27,38,12,30,3,7,11,39,68
2008-08-17 00:00:00.000,New Haven CT; U.S.A. ATP World Tour,HARD,2,Steve Darcis,Vincent Spadea,Steve Darcis,7-5; 5-0 RET,R64,62,5,1,20,46,18,20,14,26,0,1,8,32,46,0,2,33,56,17,33,11,23,3,8,9,28,56
2008-08-17 00:00:00.000,New Haven CT; U.S.A. ATP World Tour,HARD,2,Marcel Granollers,N/A Bye,Marcel Granollers,,R64,0,0,0,0,0,0,0,0,0,0,0,0,0,0,0,0,0,0,0,0,0,0,0,0,0,0,0
2008-08-17 00:00:00.000,New Haven CT; U.S.A. ATP World Tour,HARD,2,Marc Gicquel,N/A Bye,Marc Gicquel,,R64,0,0,0,0,0,0,0,0,0,0,0,0,0,0,0,0,0,0,0,0,0,0,0,0,0,0,0
2008-08-17 00:00:00.000,New Haven CT; U.S.A. ATP World Tour,HARD,2,Albert Montanes,Nicolas Devilder,Albert Montanes,7-6(5); 7-5,R64,117,1,3,34,72,26,34,18,38,1,3,12,44,72,6,9,48,101,33,48,24,53,12,15,12,57,101
2008-08-17 00:00:00.000,New Haven CT; U.S.A. ATP World Tour,HARD,2,Wayne Odesnik,Sebastien Grosjean,Wayne Odesnik,7-5; 6-4,R64,87,7,4,54,77,38,54,7,23,4,7,11,45,77,4,5,33,62,24,33,10,29,2,7,11,34,62
2008-08-17 00:00:00.000,New Haven CT; U.S.A. ATP World Tour,HARD,2,Mardy Fish,N/A Bye,Mardy Fish,,R64,0,0,0,0,0,0,0,0,0,0,0,0,0,0,0,0,0,0,0,0,0,0,0,0,0,0,0
2008-08-17 00:00:00.000,New Haven CT; U.S.A. ATP World Tour,HARD,2,Marin Cilic,N/A Bye,Marin Cilic,,R64,0,0,0,0,0,0,0,0,0,0,0,0,0,0,0,0,0,0,0,0,0,0,0,0,0,0,0
2008-08-17 00:00:00.000,New Haven CT; U.S.A. ATP World Tour,HARD,2,Viktor Troicki,Alex Bogomolov Jr.,Viktor Troicki,7-5; 2-6; 6-1,R64,115,10,2,33,80,28,33,21,47,6,9,13,49,80,4,1,59,90,34,59,18,31,5,10,14,52,90
2008-08-17 00:00:00.000,New Haven CT; U.S.A. ATP World Tour,HARD,2,Arnaud Clement,Thomaz Bellucci,Arnaud Clement,6-4; 6-4,R64,90,2,1,25,54,20,25,19,29,2,3,10,39,54,4,1,52,76,28,52,14,24,7,10,10,42,76
2008-08-17 00:00:00.000,New Haven CT; U.S.A. ATP World Tour,HARD,2,Jurgen Melzer,N/A Bye,Jurgen Melzer,,R64,0,0,0,0,0,0,0,0,0,0,0,0,0,0,0,0,0,0,0,0,0,0,0,0,0,0,0
2008-08-17 00:00:00.000,New Haven CT; U.S.A. ATP World Tour,HARD,2,Victor Hanescu,N/A Bye,Victor Hanescu,,R64,0,0,0,0,0,0,0,0,0,0,0,0,0,0,0,0,0,0,0,0,0,0,0,0,0,0,0
2008-08-17 00:00:00.000,New Haven CT; U.S.A. ATP World Tour,HARD,2,Denis Gremelmayr,Marcos Daniel,Denis Gremelmayr,3-6; 6-3; 6-3,R64,128,15,9,55,97,43,55,18,42,8,9,13,61,97,7,2,51,89,36,51,20,38,5,8,14,56,89
2008-08-17 00:00:00.000,New Haven CT; U.S.A. ATP World Tour,HARD,2,Olivier Rochus,Evgeny Korolev,Olivier Rochus,6-4; 6-4,R64,95,2,3,30,56,22,30,16,26,1,2,10,38,56,11,11,41,93,31,41,22,52,13,16,10,53,93
2008-08-17 00:00:00.000,New Haven CT; U.S.A. ATP World Tour,HARD,2,Igor Andreev,N/A Bye,Igor Andreev,,R64,0,0,0,0,0,0,0,0,0,0,0,0,0,0,0,0,0,0,0,0,0,0,0,0,0,0,0
2008-08-17 00:00:00.000,New Haven CT; U.S.A. ATP World Tour,HARD,2,Andreas Seppi,N/A Bye,Andreas Seppi,,R64,0,0,0,0,0,0,0,0,0,0,0,0,0,0,0,0,0,0,0,0,0,0,0,0,0,0,0
2008-08-17 00:00:00.000,New Haven CT; U.S.A. ATP World Tour,HARD,2,Potito Starace,Jiri Vanek,Potito Starace,6-2; 7-6(7),R64,78,6,3,47,64,34,47,11,17,2,3,10,45,64,9,5,29,66,23,29,18,37,3,6,10,41,66
2008-08-17 00:00:00.000,New Haven CT; U.S.A. ATP World Tour,HARD,2,Fabio Fognini,Nicolas Lapentti,Fabio Fognini,6-4; 4-4 RET,R64,91,3,4,30,60,20,30,18,30,1,3,9,38,60,3,1,32,55,18,32,14,23,0,3,9,32,55
2008-08-17 00:00:00.000,New Haven CT; U.S.A. ATP World Tour,HARD,2,Simone Bolelli,N/A Bye,Simone Bolelli,,R64,0,0,0,0,0,0,0,0,0,0,0,0,0,0,0,0,0,0,0,0,0,0,0,0,0,0,0
2008-08-17 00:00:00.000,New Haven CT; U.S.A. ATP World Tour,HARD,2,Jose Acasuso,N/A Bye,Jose Acasuso,,R64,0,0,0,0,0,0,0,0,0,0,0,0,0,0,0,0,0,0,0,0,0,0,0,0,0,0,0
2008-08-17 00:00:00.000,New Haven CT; U.S.A. ATP World Tour,HARD,2,Luka Gregorc,Ramon Delgado,Luka Gregorc,6-2; 3-6; 6-0,R64,76,9,2,35,53,28,35,11,18,0,2,11,39,53,3,3,33,66,19,33,13,33,4,10,12,32,66
2008-08-17 00:00:00.000,New Haven CT; U.S.A. ATP World Tour,HARD,2,John Isner,Igor Kunitsyn,John Isner,6-4; 6-4,R64,71,9,1,34,49,29,34,11,15,0,0,10,40,49,0,1,47,64,33,47,8,17,3,5,10,41,64
2008-08-17 00:00:00.000,New Haven CT; U.S.A. ATP World Tour,HARD,2,Ivo Karlovic,N/A Bye,Ivo Karlovic,,R64,0,0,0,0,0,0,0,0,0,0,0,0,0,0,0,0,0,0,0,0,0,0,0,0,0,0,0
2008-08-17 00:00:00.000,New Haven CT; U.S.A. ATP World Tour,HARD,2,Fernando Verdasco,Dudi Sela,Fernando Verdasco,6-4; 6-4,R32,80,1,6,48,62,32,48,7,14,2,4,10,39,62,1,1,37,60,20,37,12,23,2,6,10,32,60
2008-08-17 00:00:00.000,New Haven CT; U.S.A. ATP World Tour,HARD,2,Ivo Minar,Eduardo Schwank,Ivo Minar,7-5; 6-3,R32,82,2,1,35,54,27,35,13,19,3,4,10,40,54,5,4,36,68,25,36,15,32,2,6,11,40,68
2008-08-17 00:00:00.000,New Haven CT; U.S.A. ATP World Tour,HARD,2,Robby Ginepri,Agustin Calleri,Robby Ginepri,6-2; 4-6; 6-2,R32,94,5,3,53,81,40,53,13,28,1,3,13,53,81,6,8,36,81,25,36,18,45,9,14,13,43,81
2008-08-17 00:00:00.000,New Haven CT; U.S.A. ATP World Tour,HARD,2,Mischa Zverev,Juan Monaco,Mischa Zverev,6-3; 6-3,R32,73,2,3,29,56,24,29,13,27,3,4,9,37,56,1,2,34,55,18,34,12,21,4,8,9,30,55
2008-08-17 00:00:00.000,New Haven CT; U.S.A. ATP World Tour,HARD,2,Jesse Levine,Guillermo Garcia-Lopez,Jesse Levine,6-0; 6-3,R32,66,1,7,28,59,21,28,14,31,5,6,8,35,59,1,4,23,41,12,23,5,18,2,7,7,17,41
2008-08-17 00:00:00.000,New Haven CT; U.S.A. ATP World Tour,HARD,2,Steve Darcis,Marcel Granollers,Steve Darcis,6-2; 6-2,R32,55,5,2,16,41,14,16,19,25,1,1,8,33,41,1,3,27,53,16,27,12,26,8,12,8,28,53
2008-08-17 00:00:00.000,New Haven CT; U.S.A. ATP World Tour,HARD,2,Marc Gicquel,Albert Montanes,Marc Gicquel,7-5; 6-3,R32,67,11,2,33,54,29,33,13,21,2,2,10,42,54,1,8,45,76,31,45,13,31,5,8,11,44,76
2008-08-17 00:00:00.000,New Haven CT; U.S.A. ATP World Tour,HARD,2,Mardy Fish,Wayne Odesnik,Mardy Fish,6-1; 4-6; 6-1,R32,99,13,2,37,78,31,37,20,41,5,7,12,51,78,3,9,39,70,23,39,13,31,5,11,12,36,70
2008-08-17 00:00:00.000,New Haven CT; U.S.A. ATP World Tour,HARD,2,Marin Cilic,Viktor Troicki,Marin Cilic,2-1 RET,R32,18,1,0,6,15,4,6,6,9,1,1,2,10,15,0,0,3,5,2,3,2,2,0,0,1,4,5
2008-08-17 00:00:00.000,New Haven CT; U.S.A. ATP World Tour,HARD,2,Jurgen Melzer,Arnaud Clement,Jurgen Melzer,7-6(1); 7-5,R32,112,8,6,51,96,34,51,28,45,8,10,12,62,96,5,4,50,85,35,50,16,35,7,10,12,51,85
2008-08-17 00:00:00.000,New Haven CT; U.S.A. ATP World Tour,HARD,2,Victor Hanescu,Denis Gremelmayr,Victor Hanescu,6-7(5); 7-6(3); 6-2,R32,140,6,1,86,111,62,86,15,25,7,8,16,77,111,11,4,68,114,44,68,26,46,6,9,16,70,114
2008-08-17 00:00:00.000,New Haven CT; U.S.A. ATP World Tour,HARD,2,Igor Andreev,Olivier Rochus,Igor Andreev,6-3; 6-4,R32,81,9,2,32,58,26,32,16,26,1,1,10,42,58,0,1,38,58,27,38,9,20,3,5,9,36,58
2008-08-17 00:00:00.000,New Haven CT; U.S.A. ATP World Tour,HARD,2,Andreas Seppi,Potito Starace,Andreas Seppi,4-6; 6-4; 6-4,R32,133,1,5,56,92,42,56,11,36,5,9,15,53,92,6,1,71,101,41,71,13,30,5,10,15,54,101
2008-08-17 00:00:00.000,New Haven CT; U.S.A. ATP World Tour,HARD,2,Fabio Fognini,Simone Bolelli,Fabio Fognini,6-2; 5-7; 6-4,R32,132,5,7,52,94,43,52,19,42,7,9,15,62,94,5,4,49,81,33,49,17,32,0,4,15,50,81
2008-08-17 00:00:00.000,New Haven CT; U.S.A. ATP World Tour,HARD,2,Luka Gregorc,Jose Acasuso,Luka Gregorc,6-4; 6-4,R32,95,5,1,35,66,18,35,17,31,1,5,10,35,66,0,3,36,68,22,36,9,32,0,6,10,31,68
2008-08-17 00:00:00.000,New Haven CT; U.S.A. ATP World Tour,HARD,2,Ivo Karlovic,John Isner,Ivo Karlovic,6-7(4); 6-3; 6-4,R32,117,17,1,51,90,45,51,24,39,0,0,16,69,90,13,2,71,106,57,71,12,35,4,6,15,69,106
2008-08-17 00:00:00.000,New Haven CT; U.S.A. ATP World Tour,HARD,2,Fernando Verdasco,Ivo Minar,Fernando Verdasco,6-3; 6-1,R16,54,4,2,28,40,24,28,8,12,0,0,8,32,40,1,2,27,47,12,27,13,20,3,7,8,25,47
2008-08-17 00:00:00.000,New Haven CT; U.S.A. ATP World Tour,HARD,2,Mischa Zverev,Robby Ginepri,Mischa Zverev,1-6; 6-3; 6-1,R16,94,6,3,47,72,32,47,8,25,5,9,11,40,72,3,2,55,87,34,55,11,32,7,13,12,45,87
2008-08-17 00:00:00.000,New Haven CT; U.S.A. ATP World Tour,HARD,2,Jesse Levine,Steve Darcis,Jesse Levine,2-0 RET,R16,7,1,0,3,8,1,3,4,5,1,1,1,5,8,0,2,2,4,0,2,0,2,0,1,1,0,4
2008-08-17 00:00:00.000,New Haven CT; U.S.A. ATP World Tour,HARD,2,Mardy Fish,Marc Gicquel,Mardy Fish,6-4; 6-3,R16,64,12,0,25,55,22,25,22,30,3,3,10,44,55,6,3,34,53,26,34,9,19,2,4,9,35,53
2008-08-17 00:00:00.000,New Haven CT; U.S.A. ATP World Tour,HARD,2,Marin Cilic,Jurgen Melzer,Marin Cilic,5-7; 6-4; 7-5,R16,157,8,6,69,130,49,69,34,61,11,13,17,83,130,7,3,76,103,51,76,14,27,3,6,17,65,103
2008-08-17 00:00:00.000,New Haven CT; U.S.A. ATP World Tour,HARD,2,Igor Andreev,Victor Hanescu,Igor Andreev,6-4; 7-5,R16,96,5,3,47,73,30,47,18,26,4,6,11,48,73,1,1,52,74,32,52,9,22,4,8,11,41,74
2008-08-17 00:00:00.000,New Haven CT; U.S.A. ATP World Tour,HARD,2,Andreas Seppi,Fabio Fognini,Andreas Seppi,6-4; 6-2,R16,86,0,2,32,58,17,32,16,26,6,9,9,33,58,2,3,45,65,25,45,4,20,9,15,9,29,65
2008-08-17 00:00:00.000,New Haven CT; U.S.A. ATP World Tour,HARD,2,Luka Gregorc,Ivo Karlovic,Luka Gregorc,7-6(4); 4-6; 6-2,R16,116,9,6,57,97,43,57,23,40,3,5,15,66,97,12,3,46,82,37,46,16,36,0,3,15,53,82
2008-08-17 00:00:00.000,New Haven CT; U.S.A. ATP World Tour,HARD,2,Fernando Verdasco,Mischa Zverev,Fernando Verdasco,6-2; 7-6(4),Q,78,2,4,57,66,42,57,3,9,3,5,10,45,66,6,0,36,60,21,36,13,24,3,7,10,34,60
2008-08-17 00:00:00.000,New Haven CT; U.S.A. ATP World Tour,HARD,2,Mardy Fish,Jesse Levine,Mardy Fish,6-3; 7-6(4),Q,100,12,6,37,67,33,37,17,30,0,0,11,50,67,5,5,65,97,44,65,14,32,13,14,10,58,97
2008-08-17 00:00:00.000,New Haven CT; U.S.A. ATP World Tour,HARD,2,Marin Cilic,Igor Andreev,Marin Cilic,6-3; 6-2,Q,83,3,3,25,59,21,25,18,34,3,3,8,39,59,1,1,43,64,23,43,10,21,5,9,9,33,64
2008-08-17 00:00:00.000,New Haven CT; U.S.A. ATP World Tour,HARD,2,Luka Gregorc,Andreas Seppi,Luka Gregorc,4-6; 6-4; 7-5,Q,138,14,9,63,106,46,63,18,43,5,9,16,64,106,4,5,48,93,31,48,24,45,5,10,16,55,93
2008-08-17 00:00:00.000,New Haven CT; U.S.A. ATP World Tour,HARD,2,Mardy Fish,Fernando Verdasco,Mardy Fish,6-0; 1-6; 6-3,S,88,7,3,31,67,23,31,17,36,4,7,11,40,67,0,9,45,66,28,45,8,21,6,11,11,36,66
2008-08-17 00:00:00.000,New Haven CT; U.S.A. ATP World Tour,HARD,2,Marin Cilic,Luka Gregorc,Marin Cilic,6-3; 6-3,S,74,5,0,25,48,19,25,16,23,1,2,9,35,48,7,7,34,65,24,34,10,31,7,11,9,34,65
2008-08-17 00:00:00.000,New Haven CT; U.S.A. ATP World Tour,HARD,2,Marin Cilic,Mardy Fish,Marin Cilic,6-4; 4-6; 6-2,F,115,11,0,43,76,31,43,19,33,2,5,14,50,76,5,3,41,79,29,41,18,38,1,6,14,47,79
2008-08-25 00:00:00.000,US Open NY; U.S.A. Grand Slams,HARD,3,Rafael Nadal,Bjorn Phau,Rafael Nadal,7-6(4); 6-3; 7-6(4),R128,179,7,2,77,107,58,77,19,30,2,3,17,77,107,6,4,67,132,49,67,30,65,11,13,16,79,132
2008-08-25 00:00:00.000,US Open NY; U.S.A. Grand Slams,HARD,3,Ryler DeHeart,Olivier Rochus,Ryler DeHeart,7-6(4); 5-7; 6-4; 3-6; 6-4,R128,223,19,8,87,166,64,87,44,79,11,15,26,108,166,4,4,108,185,73,108,47,77,7,11,27,120,185
2008-08-25 00:00:00.000,US Open NY; U.S.A. Grand Slams,HARD,3,Viktor Troicki,Carsten Ball,Viktor Troicki,7-6(3); 6-0; 6-1,R128,91,6,1,45,75,39,45,18,30,2,2,13,57,75,10,6,51,89,33,51,15,38,6,11,12,48,89
2008-08-25 00:00:00.000,US Open NY; U.S.A. Grand Slams,HARD,3,Philipp Kohlschreiber,Luis Horna,Philipp Kohlschreiber,6-2; 6-3; 6-2,R128,97,7,4,31,66,26,31,25,35,0,0,12,51,66,5,5,48,84,30,48,15,36,5,11,13,45,84
2008-08-25 00:00:00.000,US Open NY; U.S.A. Grand Slams,HARD,3,Sam Querrey,Tomas Berdych,Sam Querrey,6-3; 6-1; 6-2,R128,87,11,1,40,65,35,40,12,25,2,3,12,47,65,5,3,44,81,23,44,17,37,6,13,12,40,81
2008-08-25 00:00:00.000,US Open NY; U.S.A. Grand Slams,HARD,3,Nicolas Devilder,Pablo Andujar,Nicolas Devilder,6-4; 6-2; 6-2,R128,104,2,8,48,79,36,48,13,31,2,5,13,49,79,3,9,55,95,31,55,14,40,11,19,13,45,95
2008-08-25 00:00:00.000,US Open NY; U.S.A. Grand Slams,HARD,3,Florent Serra,Rainer Schuettler,Florent Serra,7-6(8); 6-0; 2-0 RET,R128,80,1,1,45,63,33,45,15,18,2,3,10,48,63,1,4,42,64,28,42,10,22,5,10,10,38,64
2008-08-25 00:00:00.000,US Open NY; U.S.A. Grand Slams,HARD,3,Ivo Karlovic,Jan Minar,Ivo Karlovic,7-5; 6-1; 6-4,R128,119,28,7,55,95,49,55,17,40,5,6,15,66,95,0,6,60,99,39,60,17,39,7,12,14,56,99
2008-08-25 00:00:00.000,US Open NY; U.S.A. Grand Slams,HARD,3,James Blake,Donald Young,James Blake,6-1; 3-6; 6-1; 4-6; 6-4,R128,169,7,5,91,156,68,91,33,65,10,13,22,101,156,6,6,82,138,52,82,27,56,9,15,21,79,138
2008-08-25 00:00:00.000,US Open NY; U.S.A. Grand Slams,HARD,3,Steve Darcis,Denis Gremelmayr,Steve Darcis,6-1; 6-7(6); 7-6(4); 6-4,R128,165,9,5,74,138,55,74,35,64,4,7,20,90,138,16,7,64,128,43,64,33,64,0,7,21,76,128
2008-08-25 00:00:00.000,US Open NY; U.S.A. Grand Slams,HARD,3,Mardy Fish,Robert Smeets,Mardy Fish,7-6(4); 6-7(3); 6-3; 6-4,R128,198,15,7,76,157,60,76,42,81,6,8,22,102,157,7,4,78,145,54,78,37,67,8,12,21,91,145
2008-08-25 00:00:00.000,US Open NY; U.S.A. Grand Slams,HARD,3,Paul-Henri Mathieu,Sebastien Grosjean,Paul-Henri Mathieu,6-7(4); 7-6(5); 6-3; 6-2,R128,170,7,4,74,133,54,74,41,59,4,5,21,95,133,22,4,69,128,56,69,28,59,3,7,20,84,128
2008-08-25 00:00:00.000,US Open NY; U.S.A. Grand Slams,HARD,3,Gael Monfils,Pablo Cuevas,Gael Monfils,6-4; 6-4; 6-1,R128,94,11,5,44,74,37,44,17,30,3,4,13,54,74,4,2,46,83,27,46,18,37,1,7,14,45,83
2008-08-25 00:00:00.000,US Open NY; U.S.A. Grand Slams,HARD,3,Evgeny Korolev,Robin Soderling,Evgeny Korolev,7-6(4); 6-3; 7-6(9),R128,141,15,7,75,132,61,75,26,57,11,14,17,87,132,18,8,57,116,47,57,28,59,9,13,16,75,116
2008-08-25 00:00:00.000,US Open NY; U.S.A. Grand Slams,HARD,3,Andrey Golubev,Brendan Evans,Andrey Golubev,6-4; 6-3; 6-2,R128,91,7,3,31,70,25,31,30,39,1,1,13,55,70,9,3,56,86,39,56,10,30,6,11,14,49,86
2008-08-25 00:00:00.000,US Open NY; U.S.A. Grand Slams,HARD,3,David Nalbandian,Marcos Daniel,David Nalbandian,6-1; 6-2; 6-4,R128,100,14,6,39,72,35,39,21,33,2,2,13,56,72,7,2,41,80,26,41,17,39,4,9,12,43,80
2008-08-25 00:00:00.000,US Open NY; U.S.A. Grand Slams,HARD,3,David Ferrer,Martin Vassallo Arguello,David Ferrer,7-6(1); 6-2; 6-2,R128,131,2,2,44,75,34,44,24,31,0,1,14,58,75,2,5,54,86,34,54,13,32,3,8,14,47,86
2008-08-25 00:00:00.000,US Open NY; U.S.A. Grand Slams,HARD,3,Andreas Beck,John Isner,Andreas Beck,7-6(5); 6-4; 7-6(3),R128,137,9,5,70,115,57,70,28,45,5,5,17,85,115,26,3,71,101,58,71,13,30,1,2,17,71,101
2008-08-25 00:00:00.000,US Open NY; U.S.A. Grand Slams,HARD,3,Roko Karanusic,Ryan Sweeting,Roko Karanusic,7-5; 7-5; 3-6; 6-2,R128,149,12,2,77,114,57,77,21,37,2,4,20,78,114,6,4,111,148,69,111,18,37,12,17,21,87,148
2008-08-25 00:00:00.000,US Open NY; U.S.A. Grand Slams,HARD,3,Kei Nishikori,Juan Monaco,Kei Nishikori,6-2; 6-2; 5-7; 6-2,R128,173,3,9,71,136,55,71,30,65,9,11,18,85,136,3,4,83,115,46,83,18,32,7,14,18,64,115
2008-08-25 00:00:00.000,US Open NY; U.S.A. Grand Slams,HARD,3,Juan Martin Del Potro,Guillermo Canas,Juan Martin Del Potro,4-6; 7-6(0); 6-4; 6-1,R128,204,3,4,73,118,53,73,22,45,8,13,19,75,118,7,9,65,140,39,65,33,75,12,20,20,72,140
2008-08-25 00:00:00.000,US Open NY; U.S.A. Grand Slams,HARD,3,Thomaz Bellucci,Oscar Hernandez,Thomaz Bellucci,6-3; 6-7(5); 6-4; 7-5,R128,192,7,6,77,144,55,77,31,67,9,14,21,86,144,3,5,93,153,55,93,28,60,12,21,22,83,153
2008-08-25 00:00:00.000,US Open NY; U.S.A. Grand Slams,HARD,3,Jose Acasuso,Michael Berrer,Jose Acasuso,6-4; 6-2; 6-2,R128,116,8,4,52,79,43,52,14,27,1,1,13,57,79,7,10,37,85,27,37,20,48,8,13,13,47,85
2008-08-25 00:00:00.000,US Open NY; U.S.A. Grand Slams,HARD,3,Gilles Simon,Marcel Granollers,Gilles Simon,6-4; 6-3; 5-7; 6-2,R128,154,6,1,56,102,41,56,35,46,1,3,20,76,102,7,5,67,121,50,67,23,54,7,12,19,73,121
2008-08-25 00:00:00.000,US Open NY; U.S.A. Grand Slams,HARD,3,Stanislas Wawrinka,Simone Bolelli,Stanislas Wawrinka,7-6(5); 6-3; 6-3,R128,131,8,4,72,110,55,72,20,38,7,8,15,75,110,3,2,56,86,39,56,16,30,3,7,15,55,86
2008-08-25 00:00:00.000,US Open NY; U.S.A. Grand Slams,HARD,3,Wayne Odesnik,Fabio Fognini,Wayne Odesnik,2-6; 6-0; 4-6; 6-3; 6-4,R128,180,7,6,87,139,60,87,25,52,12,17,22,85,139,5,12,76,139,56,76,25,63,9,16,21,81,139
2008-08-25 00:00:00.000,US Open NY; U.S.A. Grand Slams,HARD,3,Yen-Hsun Lu,Nicolas Lapentti,Yen-Hsun Lu,6-4; 1-6; 4-6; 6-4; 6-3,R128,236,4,11,99,163,61,99,32,64,20,27,23,93,163,13,4,104,159,71,104,21,55,13,20,23,92,159
2008-08-25 00:00:00.000,US Open NY; U.S.A. Grand Slams,HARD,3,Flavio Cipolla,Jan Hernych,Flavio Cipolla,6-7(2); 6-4; 2-6; 7-6(0); 7-6(4),R128,245,2,14,124,186,78,124,25,62,7,16,27,103,186,4,9,108,192,62,108,48,84,16,24,27,110,192
2008-08-25 00:00:00.000,US Open NY; U.S.A. Grand Slams,HARD,3,Jurgen Melzer,Feliciano Lopez,Jurgen Melzer,4-6; 7-6(5); 6-2; 2-6; 6-4,R128,185,9,5,91,150,63,91,32,59,7,12,24,95,150,15,9,78,140,59,78,31,62,4,9,24,90,140
2008-08-25 00:00:00.000,US Open NY; U.S.A. Grand Slams,HARD,3,Jiri Vanek,Stephane Bohli,Jiri Vanek,3-6; 6-3; 6-2; 7-5,R128,145,18,3,66,110,53,66,24,44,2,4,19,77,110,15,3,52,110,39,52,29,58,6,11,19,68,110
2008-08-25 00:00:00.000,US Open NY; U.S.A. Grand Slams,HARD,3,Michael Llodra,Teymuraz Gabashvili,Michael Llodra,6-3; 5-7; 7-6(5); 7-6(4),R128,204,17,6,81,145,61,81,43,64,4,6,23,104,145,13,12,91,164,64,91,41,73,15,17,22,105,164
2008-08-25 00:00:00.000,US Open NY; U.S.A. Grand Slams,HARD,3,Andy Murray,Sergio Roitman,Andy Murray,6-3; 6-4; 6-0,R128,94,9,3,41,85,33,41,26,44,2,2,13,59,85,3,2,49,73,29,49,11,24,7,12,12,40,73
2008-08-25 00:00:00.000,US Open NY; U.S.A. Grand Slams,HARD,3,Andy Roddick,Fabrice Santoro,Andy Roddick,6-2; 6-2; 6-2,R128,87,15,2,37,60,34,37,15,23,0,0,12,49,60,7,2,40,74,26,40,14,34,3,9,12,40,74
2008-08-25 00:00:00.000,US Open NY; U.S.A. Grand Slams,HARD,3,Ernests Gulbis,Thomas Johansson,Ernests Gulbis,7-5; 6-1; 7-6(3),R128,130,18,8,75,116,57,75,23,41,8,9,16,80,116,8,4,46,94,34,46,22,48,6,10,15,56,94
2008-08-25 00:00:00.000,US Open NY; U.S.A. Grand Slams,HARD,3,Guillermo Garcia-Lopez,Dominik Hrbaty,Guillermo Garcia-Lopez,4-6; 6-3; 6-4; 6-4,R128,169,2,12,62,122,42,62,24,60,4,12,20,66,122,3,10,80,137,51,80,20,57,10,20,19,71,137
2008-08-25 00:00:00.000,US Open NY; U.S.A. Grand Slams,HARD,3,Andreas Seppi,Hyung-Taik Lee,Andreas Seppi,6-3; 7-5; 3-6; 3-6; 6-3,R128,177,11,9,81,145,56,81,30,64,5,13,24,86,145,6,7,94,145,58,94,22,51,6,15,24,80,145
2008-08-25 00:00:00.000,US Open NY; U.S.A. Grand Slams,HARD,3,Ivo Minar,Nicolas Kiefer,Ivo Minar,4-6; 6-1; 6-4; 4-1 RET,R128,144,9,2,48,89,39,48,23,41,7,9,16,62,89,6,6,51,111,33,51,26,60,6,12,16,59,111
2008-08-25 00:00:00.000,US Open NY; U.S.A. Grand Slams,HARD,3,Jarkko Nieminen,Scoville Jenkins,Jarkko Nieminen,6-3; 6-3; 7-5,R128,125,5,2,59,91,45,59,18,32,8,10,15,63,91,9,6,58,102,39,58,16,44,8,14,15,55,102
2008-08-25 00:00:00.000,US Open NY; U.S.A. Grand Slams,HARD,3,Bobby Reynolds,Tomas Zib,Bobby Reynolds,6-4; 6-7(3); 2-6; 6-4; 7-6(4),R128,257,33,7,84,169,61,84,45,85,13,19,26,106,169,12,5,129,206,82,129,40,77,20,26,26,122,206
2008-08-25 00:00:00.000,US Open NY; U.S.A. Grand Slams,HARD,3,Fernando Gonzalez,Ivan Navarro,Fernando Gonzalez,7-6(3); 6-3; 4-6; 7-6(5),R128,176,14,4,88,138,71,88,29,50,2,3,22,100,138,21,5,92,141,71,92,28,49,6,7,21,99,141
2008-08-25 00:00:00.000,US Open NY; U.S.A. Grand Slams,HARD,3,Tommy Robredo,Mischa Zverev,Tommy Robredo,7-6(4); 6-2; 6-1,R128,103,2,2,51,82,40,51,19,31,5,6,13,59,82,3,5,47,90,29,47,20,43,5,11,14,49,90
2008-08-25 00:00:00.000,US Open NY; U.S.A. Grand Slams,HARD,3,Marat Safin,Vincent Spadea,Marat Safin,3-6; 6-2; 6-3; 4-6; 6-4,R128,155,7,10,75,136,57,75,30,61,2,6,23,87,136,6,6,74,129,52,74,29,55,5,11,23,81,129
2008-08-25 00:00:00.000,US Open NY; U.S.A. Grand Slams,HARD,3,Carlos Moya,Aisam-Ul-Haq Qureshi,Carlos Moya,6-4; 6-7(5); 7-6(2); 6-2,R128,165,18,8,78,111,71,78,23,33,0,0,21,94,111,33,4,83,137,67,83,23,54,3,6,21,90,137
2008-08-25 00:00:00.000,US Open NY; U.S.A. Grand Slams,HARD,3,Jo-Wilfried Tsonga,Santiago Ventura,Jo-Wilfried Tsonga,6-7(3); 6-4; 6-2; 6-3,R128,159,11,6,69,117,54,69,27,48,4,6,19,81,117,9,11,66,130,48,66,27,64,2,9,20,75,130
2008-08-25 00:00:00.000,US Open NY; U.S.A. Grand Slams,HARD,3,Marin Cilic,Julien Benneteau,Marin Cilic,4-6; 7-5; 6-3; 6-7(7); 6-2,R128,260,28,7,94,161,72,94,30,67,6,11,26,102,161,3,9,122,182,76,122,27,60,18,26,25,103,182
2008-08-25 00:00:00.000,US Open NY; U.S.A. Grand Slams,HARD,3,Robby Ginepri,Amer Delic,Robby Ginepri,6-1; 6-2; 7-6(5),R128,110,8,2,55,96,41,55,27,41,1,1,14,68,96,13,6,45,88,33,45,20,43,3,7,13,53,88
2008-08-25 00:00:00.000,US Open NY; U.S.A. Grand Slams,HARD,3,Robert Kendrick,Nicolas Mahut,Robert Kendrick,7-6(3); 6-4; 5-7; 7-5,R128,164,28,7,77,129,63,77,35,52,3,4,23,98,129,19,11,85,145,69,85,31,60,3,5,23,100,145
2008-08-25 00:00:00.000,US Open NY; U.S.A. Grand Slams,HARD,3,Novak Djokovic,Arnaud Clement,Novak Djokovic,6-3; 6-3; 6-4,R128,120,15,2,55,85,44,55,19,30,4,4,14,63,85,6,3,48,84,31,48,20,36,3,7,14,51,84
2008-08-25 00:00:00.000,US Open NY; U.S.A. Grand Slams,HARD,3,Nikolay Davydenko,Dudi Sela,Nikolay Davydenko,6-3; 6-3; 6-3,R128,122,3,3,47,80,31,47,24,33,5,6,13,55,80,1,4,55,86,34,55,11,31,4,10,14,45,86
2008-08-25 00:00:00.000,US Open NY; U.S.A. Grand Slams,HARD,3,Agustin Calleri,Austin Krajicek,Agustin Calleri,6-2; 6-2; 6-1,R128,78,17,2,34,56,34,34,10,22,0,0,11,44,56,5,9,49,78,26,49,8,29,2,9,12,34,78
2008-08-25 00:00:00.000,US Open NY; U.S.A. Grand Slams,HARD,3,Victor Hanescu,Albert Montanes,Victor Hanescu,7-6(5); 6-3; 2-6; 6-3,R128,128,13,3,76,107,56,76,21,31,6,9,19,77,107,3,2,63,110,44,63,27,47,1,5,19,71,110
2008-08-25 00:00:00.000,US Open NY; U.S.A. Grand Slams,HARD,3,Dmitry Tursunov,Eduardo Schwank,Dmitry Tursunov,7-5; 4-6; 7-5; 7-6(5),R128,186,13,11,69,135,59,69,34,66,3,6,23,93,135,13,3,104,163,74,104,28,59,10,14,23,102,163
2008-08-25 00:00:00.000,US Open NY; U.S.A. Grand Slams,HARD,3,Nicolas Almagro,Frank Dancevic,Nicolas Almagro,6-3; 6-4; 7-5,R128,104,20,3,59,97,48,59,23,38,2,2,16,71,97,10,2,53,95,42,53,19,42,3,6,15,61,95
2008-08-25 00:00:00.000,US Open NY; U.S.A. Grand Slams,HARD,3,Sam Warburg,Janko Tipsarevic,Sam Warburg,6-2; 1-0 RET,R128,32,6,0,14,20,12,14,4,6,0,0,4,16,20,2,3,17,27,10,17,2,10,1,4,5,12,27
2008-08-25 00:00:00.000,US Open NY; U.S.A. Grand Slams,HARD,3,Gilles Muller,Laurent Recouderc,Gilles Muller,6-4; 6-0; 4-6; 6-4,R128,136,18,5,59,103,48,59,24,44,4,6,18,72,103,5,6,72,120,49,72,19,48,8,14,18,68,120
2008-08-25 00:00:00.000,US Open NY; U.S.A. Grand Slams,HARD,3,Tommy Haas,Richard Gasquet,Tommy Haas,6-7(3); 6-4; 5-7; 7-5; 6-2,R128,217,14,4,98,167,67,98,47,69,3,6,27,114,167,20,8,92,169,65,92,46,77,6,12,27,111,169
2008-08-25 00:00:00.000,US Open NY; U.S.A. Grand Slams,HARD,3,Fernando Verdasco,Igor Kunitsyn,Fernando Verdasco,6-3; 6-4; 6-1,R128,96,4,2,61,77,44,61,13,16,5,5,13,57,77,1,1,57,80,32,57,13,23,4,9,13,45,80
2008-08-25 00:00:00.000,US Open NY; U.S.A. Grand Slams,HARD,3,Rui Machado,Rik De Voest,Rui Machado,6-4; 7-6(7); 6-1,R128,132,2,2,75,108,56,75,18,33,6,7,15,74,108,1,4,50,96,37,50,20,46,4,8,14,57,96
2008-08-25 00:00:00.000,US Open NY; U.S.A. Grand Slams,HARD,3,Jeremy Chardy,Frederico Gil,Jeremy Chardy,3-6; 6-3; 6-2; 6-3,R128,129,11,1,69,99,48,69,20,30,4,6,17,68,99,6,3,78,115,49,78,20,37,10,16,18,69,115
2008-08-25 00:00:00.000,US Open NY; U.S.A. Grand Slams,HARD,3,Igor Andreev,Marc Gicquel,Igor Andreev,7-6(3); 6-4; 6-4,R128,122,19,1,56,99,43,56,24,43,0,2,16,67,99,2,6,57,101,40,57,23,44,10,14,16,63,101
2008-08-25 00:00:00.000,US Open NY; U.S.A. Grand Slams,HARD,3,Radek Stepanek,Potito Starace,Radek Stepanek,7-5; 6-3; 6-1,R128,108,15,2,54,79,48,54,12,25,1,1,14,60,79,2,3,65,94,36,65,17,29,6,11,14,53,94
2008-08-25 00:00:00.000,US Open NY; U.S.A. Grand Slams,HARD,3,Chris Guccione,Jesse Levine,Chris Guccione,6-3; 3-6; 7-6(6); 7-6(6),R128,164,32,3,76,120,65,76,30,44,2,3,21,95,120,19,8,116,169,82,116,29,53,15,16,21,111,169
2008-08-25 00:00:00.000,US Open NY; U.S.A. Grand Slams,HARD,3,Thiago Alves,Paul Capdeville,Thiago Alves,4-6; 1-6; 6-1; 7-6(2); 6-4,R128,222,8,2,105,172,72,105,28,67,8,14,23,100,172,8,7,87,153,60,87,27,66,8,14,23,87,153
2008-08-25 00:00:00.000,US Open NY; U.S.A. Grand Slams,HARD,3,Roger Federer,Maximo Gonzalez,Roger Federer,6-3; 6-0; 6-3,R128,82,14,1,57,76,42,57,10,19,6,7,12,52,76,1,3,50,75,28,50,8,25,6,13,12,36,75
2008-08-25 00:00:00.000,US Open NY; U.S.A. Grand Slams,HARD,3,Rafael Nadal,Ryler DeHeart,Rafael Nadal,6-1; 6-2; 6-4,R64,101,1,3,47,67,38,47,12,20,0,1,13,50,67,4,2,42,73,25,42,12,31,6,12,12,37,73
2008-08-25 00:00:00.000,US Open NY; U.S.A. Grand Slams,HARD,3,Viktor Troicki,Philipp Kohlschreiber,Viktor Troicki,2-6; 6-3; 6-4; 3-0 RET,R64,133,9,5,55,85,39,55,17,30,5,8,15,56,85,4,3,64,112,40,64,23,48,6,11,15,63,112
2008-08-25 00:00:00.000,US Open NY; U.S.A. Grand Slams,HARD,3,Sam Querrey,Nicolas Devilder,Sam Querrey,7-6(6); 6-4; 4-6; 6-3,R64,187,17,3,85,148,64,85,36,63,9,11,21,100,148,6,2,96,144,69,96,24,48,8,11,20,93,144
2008-08-25 00:00:00.000,US Open NY; U.S.A. Grand Slams,HARD,3,Ivo Karlovic,Florent Serra,Ivo Karlovic,7-6(5); 6-4; 6-2,R64,95,42,2,67,86,60,67,8,19,1,1,15,68,86,0,3,61,88,42,61,18,27,4,7,15,60,88
2008-08-25 00:00:00.000,US Open NY; U.S.A. Grand Slams,HARD,3,James Blake,Steve Darcis,James Blake,4-6; 6-3; 1-0 RET,R64,88,8,3,39,69,29,39,13,30,7,9,10,42,69,2,4,49,88,31,49,17,39,13,16,10,48,88
2008-08-25 00:00:00.000,US Open NY; U.S.A. Grand Slams,HARD,3,Mardy Fish,Paul-Henri Mathieu,Mardy Fish,6-2; 3-6; 6-3; 6-4,R64,137,27,0,56,100,47,56,25,44,0,1,18,72,100,8,8,48,100,31,48,35,52,4,8,18,66,100
2008-08-25 00:00:00.000,US Open NY; U.S.A. Grand Slams,HARD,3,Gael Monfils,Evgeny Korolev,Gael Monfils,6-2; 6-3; 3-6; 6-4,R64,142,13,8,69,111,51,69,20,42,4,7,18,71,111,5,6,64,125,49,64,22,61,9,15,18,71,125
2008-08-25 00:00:00.000,US Open NY; U.S.A. Grand Slams,HARD,3,David Nalbandian,Andrey Golubev,David Nalbandian,6-2; 6-4; 6-2,R64,118,5,2,42,76,37,42,17,34,3,4,13,54,76,4,11,49,95,32,49,16,46,3,9,13,48,95
2008-08-25 00:00:00.000,US Open NY; U.S.A. Grand Slams,HARD,3,David Ferrer,Andreas Beck,David Ferrer,4-6; 7-5; 6-3; 7-6(5),R64,177,11,3,83,123,63,83,25,40,3,6,22,88,123,9,9,81,144,53,81,36,63,10,14,21,89,144
2008-08-25 00:00:00.000,US Open NY; U.S.A. Grand Slams,HARD,3,Kei Nishikori,Roko Karanusic,Kei Nishikori,6-1; 7-5 RET,R64,65,1,5,32,57,26,32,14,25,3,4,10,40,57,6,5,37,61,23,37,7,24,6,10,9,30,61
2008-08-25 00:00:00.000,US Open NY; U.S.A. Grand Slams,HARD,3,Juan Martin Del Potro,Thomaz Bellucci,Juan Martin Del Potro,4-6; 6-1; 7-5; 6-3,R64,183,7,2,67,119,49,67,28,52,6,9,19,77,119,6,0,69,119,41,69,27,50,7,14,19,68,119
2008-08-25 00:00:00.000,US Open NY; U.S.A. Grand Slams,HARD,3,Gilles Simon,Jose Acasuso,Gilles Simon,6-4; 6-1; 6-4,R64,104,5,4,48,92,34,48,26,44,7,9,14,60,92,4,6,32,73,24,32,13,41,1,7,13,37,73
2008-08-25 00:00:00.000,US Open NY; U.S.A. Grand Slams,HARD,3,Stanislas Wawrinka,Wayne Odesnik,Stanislas Wawrinka,6-4; 7-6(6); 6-2,R64,136,17,5,60,108,47,60,25,48,7,9,15,72,108,3,5,55,84,41,55,12,29,1,6,15,53,84
2008-08-25 00:00:00.000,US Open NY; U.S.A. Grand Slams,HARD,3,Flavio Cipolla,Yen-Hsun Lu,Flavio Cipolla,6-1; 4-6; 7-6(2); 6-4,R64,188,2,4,87,126,58,87,25,39,7,10,19,83,126,4,3,82,130,53,82,22,48,7,13,20,75,130
2008-08-25 00:00:00.000,US Open NY; U.S.A. Grand Slams,HARD,3,Jurgen Melzer,Jiri Vanek,Jurgen Melzer,6-0; 6-2; 6-2,R64,66,18,1,44,62,38,44,9,18,1,1,11,47,62,2,6,37,66,18,37,11,29,2,9,11,29,66
2008-08-25 00:00:00.000,US Open NY; U.S.A. Grand Slams,HARD,3,Andy Murray,Michael Llodra,Andy Murray,6-4; 1-6; 7-5; 7-6(7),R64,152,11,2,73,127,55,73,25,54,5,9,20,80,127,12,3,83,120,60,83,18,37,2,6,21,78,120
2008-08-25 00:00:00.000,US Open NY; U.S.A. Grand Slams,HARD,3,Andy Roddick,Ernests Gulbis,Andy Roddick,3-6; 7-5; 6-2; 7-5,R64,171,22,3,73,120,58,73,26,47,3,5,20,84,120,19,10,77,145,59,77,32,68,9,14,21,91,145
2008-08-25 00:00:00.000,US Open NY; U.S.A. Grand Slams,HARD,3,Andreas Seppi,Guillermo Garcia-Lopez,Andreas Seppi,6-2; 4-6; 6-2; 6-2,R64,147,3,6,68,115,46,68,27,47,9,12,17,73,115,0,6,63,106,35,63,21,43,4,12,17,56,106
2008-08-25 00:00:00.000,US Open NY; U.S.A. Grand Slams,HARD,3,Jarkko Nieminen,Ivo Minar,Jarkko Nieminen,6-7(2); 3-6; 6-4; 6-3; 6-2,R64,187,7,2,114,171,72,114,35,57,13,16,24,107,171,5,5,90,140,61,90,25,50,4,10,24,86,140
2008-08-25 00:00:00.000,US Open NY; U.S.A. Grand Slams,HARD,3,Fernando Gonzalez,Bobby Reynolds,Fernando Gonzalez,7-6(6); 6-4; 6-4,R64,127,8,4,50,88,39,50,25,38,2,4,16,64,88,8,3,68,103,39,68,21,35,3,7,16,60,103
2008-08-25 00:00:00.000,US Open NY; U.S.A. Grand Slams,HARD,3,Tommy Robredo,Marat Safin,Tommy Robredo,4-6; 7-6(4); 6-4; 6-0,R64,168,5,3,80,116,59,80,21,36,2,4,19,80,116,9,7,65,124,46,65,30,59,7,12,19,76,124
2008-08-25 00:00:00.000,US Open NY; U.S.A. Grand Slams,HARD,3,Jo-Wilfried Tsonga,Carlos Moya,Jo-Wilfried Tsonga,4-6; 6-3; 6-4; 6-4,R64,157,20,2,83,118,64,83,19,35,5,7,20,83,118,5,3,60,111,42,60,29,51,6,10,19,71,111
2008-08-25 00:00:00.000,US Open NY; U.S.A. Grand Slams,HARD,3,Marin Cilic,Robby Ginepri,Marin Cilic,6-4; 2-6; 6-2; 7-5,R64,154,12,4,65,109,46,65,27,44,3,6,19,73,109,7,1,75,122,52,75,21,47,9,14,19,73,122
2008-08-25 00:00:00.000,US Open NY; U.S.A. Grand Slams,HARD,3,Novak Djokovic,Robert Kendrick,Novak Djokovic,7-6(8); 6-4; 6-4,R64,126,11,0,77,106,56,77,20,29,4,4,16,76,106,19,7,58,102,46,58,21,44,1,3,16,67,102
2008-08-25 00:00:00.000,US Open NY; U.S.A. Grand Slams,HARD,3,Nikolay Davydenko,Agustin Calleri,Nikolay Davydenko,6-4; 6-4; 7-6(2),R64,152,6,0,69,101,52,69,18,32,3,4,16,70,101,12,3,44,104,36,44,29,60,6,9,16,65,104
2008-08-25 00:00:00.000,US Open NY; U.S.A. Grand Slams,HARD,3,Dmitry Tursunov,Victor Hanescu,Dmitry Tursunov,6-7(2); 6-3; 6-4; 6-2,R64,163,16,4,83,132,64,83,28,49,5,5,20,92,132,9,4,98,135,70,98,15,37,12,16,19,85,135
2008-08-25 00:00:00.000,US Open NY; U.S.A. Grand Slams,HARD,3,Nicolas Almagro,Sam Warburg,Nicolas Almagro,6-3; 6-4; 6-4,R64,129,15,3,56,88,46,56,18,32,4,5,15,64,88,6,5,77,102,47,77,13,25,8,12,14,60,102
2008-08-25 00:00:00.000,US Open NY; U.S.A. Grand Slams,HARD,3,Gilles Muller,Tommy Haas,Gilles Muller,2-6; 2-6; 7-6(5); 6-3; 6-3,R64,191,36,7,95,153,74,95,22,58,11,17,23,96,153,15,5,79,132,57,79,33,53,7,12,23,90,132
2008-08-25 00:00:00.000,US Open NY; U.S.A. Grand Slams,HARD,3,Fernando Verdasco,Rui Machado,Fernando Verdasco,6-7(5); 7-6(5); 6-4; 6-7(6); 6-0,R64,143,4,3,133,172,95,133,23,39,4,7,26,118,172,5,3,119,192,79,119,35,73,10,17,26,114,192
2008-08-25 00:00:00.000,US Open NY; U.S.A. Grand Slams,HARD,3,Igor Andreev,Jeremy Chardy,Igor Andreev,7-6(3); 6-4; 6-3,R64,117,9,2,53,91,46,53,27,38,1,1,16,73,91,8,2,66,94,53,66,12,28,9,11,15,65,94
2008-08-25 00:00:00.000,US Open NY; U.S.A. Grand Slams,HARD,3,Radek Stepanek,Chris Guccione,Radek Stepanek,6-4; 6-4; 6-7(3); 6-2,R64,151,14,2,74,107,63,74,20,33,0,0,20,83,107,19,6,73,115,56,73,20,42,5,9,20,76,115
2008-08-25 00:00:00.000,US Open NY; U.S.A. Grand Slams,HARD,3,Roger Federer,Thiago Alves,Roger Federer,6-3; 7-5; 6-4,R64,134,19,2,61,95,49,61,19,34,2,3,16,68,95,2,2,68,125,41,68,30,57,11,15,15,71,125
2008-08-25 00:00:00.000,US Open NY; U.S.A. Grand Slams,HARD,3,Rafael Nadal,Viktor Troicki,Rafael Nadal,6-4; 6-3; 6-0,R32,115,5,3,49,75,34,49,17,26,2,3,13,51,75,11,2,51,74,33,51,5,23,4,10,12,38,74
2008-08-25 00:00:00.000,US Open NY; U.S.A. Grand Slams,HARD,3,Sam Querrey,Ivo Karlovic,Sam Querrey,7-6(5); 7-6(5); 6-2,R32,133,20,2,73,109,63,73,19,36,3,3,16,82,109,24,5,68,106,53,68,20,38,5,7,16,73,106
2008-08-25 00:00:00.000,US Open NY; U.S.A. Grand Slams,HARD,3,Mardy Fish,James Blake,Mardy Fish,6-3; 6-3; 7-6(4),R32,122,16,4,56,98,47,56,19,42,2,4,15,66,98,7,3,55,101,38,55,23,46,8,13,15,61,101
2008-08-25 00:00:00.000,US Open NY; U.S.A. Grand Slams,HARD,3,Gael Monfils,David Nalbandian,Gael Monfils,6-3; 6-4; 6-2,R32,139,12,6,58,94,42,58,18,36,7,9,14,60,94,3,4,44,99,22,44,30,55,16,22,13,52,99
2008-08-25 00:00:00.000,US Open NY; U.S.A. Grand Slams,HARD,3,Kei Nishikori,David Ferrer,Kei Nishikori,6-4; 6-4; 3-6; 2-6; 7-5,R32,214,4,7,100,155,64,100,28,55,6,14,24,92,155,5,5,90,155,56,90,36,65,12,20,25,92,155
2008-08-25 00:00:00.000,US Open NY; U.S.A. Grand Slams,HARD,3,Juan Martin Del Potro,Gilles Simon,Juan Martin Del Potro,6-4; 6-7(4); 6-1; 3-6; 6-3,R32,225,10,7,90,144,68,90,31,54,3,5,24,99,144,16,5,77,155,57,77,39,78,9,14,23,96,155
2008-08-25 00:00:00.000,US Open NY; U.S.A. Grand Slams,HARD,3,Stanislas Wawrinka,Flavio Cipolla,Stanislas Wawrinka,5-7; 6-7(4); 6-4; 6-0; 6-4,R32,251,10,2,78,153,56,78,36,75,8,15,25,92,153,0,7,105,154,61,105,22,49,6,17,25,83,154
2008-08-25 00:00:00.000,US Open NY; U.S.A. Grand Slams,HARD,3,Andy Murray,Jurgen Melzer,Andy Murray,6-7(5); 4-6; 7-6(5); 6-1; 6-3,R32,231,18,2,79,145,65,79,40,66,7,9,25,105,145,15,9,124,206,83,124,37,82,14,19,25,120,206
2008-08-25 00:00:00.000,US Open NY; U.S.A. Grand Slams,HARD,3,Andy Roddick,Andreas Seppi,Andy Roddick,6-2; 7-5; 7-6(4),R32,123,19,5,66,89,56,66,12,23,1,2,16,68,89,3,3,75,105,50,75,15,30,5,9,16,65,105
2008-08-25 00:00:00.000,US Open NY; U.S.A. Grand Slams,HARD,3,Fernando Gonzalez,Jarkko Nieminen,Fernando Gonzalez,7-5; 6-4; 6-7(3); 6-1,R32,159,12,6,67,116,53,67,28,49,2,4,20,81,116,3,3,88,145,53,88,26,57,11,18,21,79,145
2008-08-25 00:00:00.000,US Open NY; U.S.A. Grand Slams,HARD,3,Tommy Robredo,Jo-Wilfried Tsonga,Tommy Robredo,7-6(2); 6-2; 6-3,R32,138,3,1,78,94,56,78,13,16,4,5,15,69,94,5,4,75,117,46,75,18,42,2,6,14,64,117
2008-08-25 00:00:00.000,US Open NY; U.S.A. Grand Slams,HARD,3,Novak Djokovic,Marin Cilic,Novak Djokovic,6-7(7); 7-5; 6-4; 7-6(0),R32,232,8,3,104,149,74,104,26,45,6,10,23,100,149,20,12,81,161,65,81,32,80,7,13,23,97,161
2008-08-25 00:00:00.000,US Open NY; U.S.A. Grand Slams,HARD,3,Nikolay Davydenko,Dmitry Tursunov,Nikolay Davydenko,6-2; 7-6(3); 6-3,R32,145,2,2,63,95,46,63,20,32,6,7,15,66,95,7,5,56,101,36,56,23,45,7,11,14,59,101
2008-08-25 00:00:00.000,US Open NY; U.S.A. Grand Slams,HARD,3,Gilles Muller,Nicolas Almagro,Gilles Muller,6-7(3); 3-6; 7-6(5); 7-6(6); 7-5,R32,234,38,5,119,183,97,119,34,64,9,10,28,131,183,22,5,108,179,91,108,44,71,7,8,29,135,179
2008-08-25 00:00:00.000,US Open NY; U.S.A. Grand Slams,HARD,3,Igor Andreev,Fernando Verdasco,Igor Andreev,6-2; 6-4; 6-4,R32,104,10,4,41,70,39,41,17,29,0,0,14,56,70,4,3,72,85,45,72,6,13,7,11,14,51,85
2008-08-25 00:00:00.000,US Open NY; U.S.A. Grand Slams,HARD,3,Roger Federer,Radek Stepanek,Roger Federer,6-3; 6-3; 6-2,R32,96,12,3,55,76,41,55,14,21,1,2,13,55,76,1,5,57,86,36,57,9,29,5,11,13,45,86
2008-08-25 00:00:00.000,US Open NY; U.S.A. Grand Slams,HARD,3,Rafael Nadal,Sam Querrey,Rafael Nadal,6-2; 5-7; 7-6(2); 6-3,R16,192,5,6,89,134,64,89,22,45,12,16,21,86,134,20,8,72,124,55,72,20,52,6,12,20,75,124
2008-08-25 00:00:00.000,US Open NY; U.S.A. Grand Slams,HARD,3,Mardy Fish,Gael Monfils,Mardy Fish,7-5; 6-2; 6-2,R16,118,5,5,45,96,36,45,28,51,6,7,14,64,96,6,4,62,88,37,62,10,26,7,13,14,47,88
2008-08-25 00:00:00.000,US Open NY; U.S.A. Grand Slams,HARD,3,Juan Martin Del Potro,Kei Nishikori,Juan Martin Del Potro,6-3; 6-4; 6-3,R16,128,6,3,47,81,33,47,19,34,2,5,14,52,81,3,2,52,93,28,52,21,41,3,10,14,49,93
2008-08-25 00:00:00.000,US Open NY; U.S.A. Grand Slams,HARD,3,Andy Murray,Stanislas Wawrinka,Andy Murray,6-1; 6-3; 6-3,R16,109,9,2,43,78,35,43,18,35,3,3,12,53,78,3,0,53,86,34,53,11,33,7,13,13,45,86
2008-08-25 00:00:00.000,US Open NY; U.S.A. Grand Slams,HARD,3,Andy Roddick,Fernando Gonzalez,Andy Roddick,6-2; 6-4; 6-1,R16,87,8,0,40,62,37,40,16,22,1,1,13,53,62,1,6,42,79,25,42,19,37,7,12,12,44,79
2008-08-25 00:00:00.000,US Open NY; U.S.A. Grand Slams,HARD,3,Novak Djokovic,Tommy Robredo,Novak Djokovic,4-6; 6-2; 6-3; 5-7; 6-3,R16,223,11,4,91,140,68,91,26,49,2,5,24,94,140,8,5,102,153,67,102,26,51,7,13,24,93,153
2008-08-25 00:00:00.000,US Open NY; U.S.A. Grand Slams,HARD,3,Gilles Muller,Nikolay Davydenko,Gilles Muller,6-4; 4-6; 6-3; 7-6(10),R16,187,22,5,84,142,71,84,26,58,13,15,21,97,142,5,5,95,126,65,95,20,31,3,6,20,85,126
2008-08-25 00:00:00.000,US Open NY; U.S.A. Grand Slams,HARD,3,Roger Federer,Igor Andreev,Roger Federer,6-7(5); 7-6(5); 6-3; 3-6; 6-3,R16,211,10,5,114,168,86,114,31,54,13,15,26,117,168,8,7,100,165,78,100,32,65,4,7,25,110,165
2008-08-25 00:00:00.000,US Open NY; U.S.A. Grand Slams,HARD,3,Rafael Nadal,Mardy Fish,Rafael Nadal,3-6; 6-1; 6-4; 6-2,Q,158,3,0,68,94,50,68,18,26,0,1,17,68,94,14,1,55,110,40,55,26,55,7,12,17,66,110
2008-08-25 00:00:00.000,US Open NY; U.S.A. Grand Slams,HARD,3,Andy Murray,Juan Martin Del Potro,Andy Murray,7-6(2); 7-6(1); 4-6; 7-5,Q,237,9,8,81,144,58,81,29,63,11,18,23,87,144,3,5,99,159,60,99,32,60,8,15,23,92,159
2008-08-25 00:00:00.000,US Open NY; U.S.A. Grand Slams,HARD,3,Novak Djokovic,Andy Roddick,Novak Djokovic,6-2; 6-3; 3-6; 7-6(5),Q,154,15,2,70,108,50,70,27,38,7,10,19,77,108,14,7,80,116,56,80,17,36,0,5,19,73,116
2008-08-25 00:00:00.000,US Open NY; U.S.A. Grand Slams,HARD,3,Roger Federer,Gilles Muller,Roger Federer,7-6(5); 6-4; 7-6(5),Q,144,8,0,63,103,54,63,26,40,2,2,17,80,103,16,4,76,121,59,76,25,45,10,11,17,84,121
2008-08-25 00:00:00.000,US Open NY; U.S.A. Grand Slams,HARD,3,Andy Murray,Rafael Nadal,Andy Murray,6-2; 7-6(5); 4-6; 6-4,S,211,21,3,70,108,55,70,24,38,1,3,20,79,108,7,2,120,167,71,120,26,47,16,20,20,97,167
2008-08-25 00:00:00.000,US Open NY; U.S.A. Grand Slams,HARD,3,Roger Federer,Novak Djokovic,Roger Federer,6-3; 5-7; 7-5; 6-2,S,164,20,1,80,125,61,80,27,45,2,4,21,88,125,6,5,80,124,57,80,20,44,7,12,20,77,124
2008-08-25 00:00:00.000,US Open NY; U.S.A. Grand Slams,HARD,3,Roger Federer,Andy Murray,Roger Federer,6-2; 7-5; 6-2,F,111,3,0,47,81,37,47,16,34,3,5,14,53,81,3,3,45,81,23,45,17,36,3,10,14,40,81
2008-09-08 00:00:00.000,Bucharest Romania ATP World Tour,CLAY,2,Richard Gasquet,Oscar Hernandez,Richard Gasquet,3-6; 6-4; 6-4,R32,139,10,2,54,87,39,54,17,33,2,5,15,56,87,6,2,48,84,38,48,17,36,5,8,14,55,84
2008-09-08 00:00:00.000,Bucharest Romania ATP World Tour,CLAY,2,Victor Crivoi,Ruben Ramirez Hidalgo,Victor Crivoi,3-6; 6-3; 6-4,R32,151,4,3,58,99,37,58,24,41,12,15,14,61,99,5,3,57,90,37,57,16,33,3,7,14,53,90
2008-09-08 00:00:00.000,Bucharest Romania ATP World Tour,CLAY,2,Adrian Cruciat,Filippo Volandri,Adrian Cruciat,7-5; 4-0 RET,R32,77,3,1,30,49,23,30,12,19,3,3,8,35,49,0,4,34,46,22,34,5,12,4,7,8,27,46
2008-09-08 00:00:00.000,Bucharest Romania ATP World Tour,CLAY,2,Teymuraz Gabashvili,Ernests Gulbis,Teymuraz Gabashvili,6-2; 2-6; 6-4,R32,113,2,7,64,94,49,64,10,30,8,10,13,59,94,6,2,51,80,32,51,16,29,7,10,13,48,80
2008-09-08 00:00:00.000,Bucharest Romania ATP World Tour,CLAY,2,Nicolas Almagro,Somdev Devvarman,Nicolas Almagro,6-7(6); 6-2; 7-5,R32,146,11,4,60,111,48,60,26,51,4,6,16,74,111,5,0,73,112,41,73,26,39,6,11,16,67,112
2008-09-08 00:00:00.000,Bucharest Romania ATP World Tour,CLAY,2,Guillermo Garcia-Lopez,Mischa Zverev,Guillermo Garcia-Lopez,6-4; 3-6; 6-0,R32,110,1,7,54,80,35,54,13,26,7,10,12,48,80,7,2,52,79,33,52,9,27,8,14,13,42,79
2008-09-08 00:00:00.000,Bucharest Romania ATP World Tour,CLAY,2,Pablo Andujar,Brian Dabul,Pablo Andujar,4-6; 6-2; 6-4,R32,138,5,5,69,89,48,69,11,20,4,6,14,59,89,2,0,56,85,34,56,17,29,4,8,14,51,85
2008-09-08 00:00:00.000,Bucharest Romania ATP World Tour,CLAY,2,Carlos Moya,Alberto Martin,Carlos Moya,6-4; 6-7(4); 6-4,R32,148,5,2,52,100,39,52,28,48,2,4,16,67,100,1,1,72,110,48,72,21,38,4,8,16,69,110
2008-09-08 00:00:00.000,Bucharest Romania ATP World Tour,CLAY,2,Jose Acasuso,Diego Junqueira,Jose Acasuso,6-2; 6-4,R32,106,4,1,37,61,28,37,14,24,2,3,9,42,61,2,3,54,80,32,54,11,26,10,14,9,43,80
2008-09-08 00:00:00.000,Bucharest Romania ATP World Tour,CLAY,2,Martin Vassallo Arguello,Victor Hanescu,Martin Vassallo Arguello,4-6; 7-5; 6-4,R32,141,4,4,73,96,47,73,12,23,2,6,16,59,96,1,4,69,99,38,69,20,30,8,13,16,58,99
2008-09-08 00:00:00.000,Bucharest Romania ATP World Tour,CLAY,2,Denis Gremelmayr,Jeremy Chardy,Denis Gremelmayr,6-1; 5-7; 6-4,R32,125,4,3,56,93,41,56,18,37,6,9,15,59,93,5,5,44,85,29,44,20,41,7,12,14,49,85
2008-09-08 00:00:00.000,Bucharest Romania ATP World Tour,CLAY,2,Ivan Navarro,Paul-Henri Mathieu,Ivan Navarro,6-4; 6-7(5); 6-3,R32,156,14,7,62,104,48,62,19,42,3,4,16,67,104,5,2,57,92,42,57,16,35,2,5,15,58,92
2008-09-08 00:00:00.000,Bucharest Romania ATP World Tour,CLAY,2,Potito Starace,Marcel Granollers,Potito Starace,6-2; 6-4,R32,81,1,0,46,55,35,46,3,9,2,3,9,38,55,2,0,46,62,24,46,10,16,10,14,9,34,62
2008-09-08 00:00:00.000,Bucharest Romania ATP World Tour,CLAY,2,Florent Serra,Nicolas Devilder,Florent Serra,3-6; 7-6(6); 7-6(4),R32,179,3,2,65,114,44,65,21,49,6,11,16,65,114,6,10,64,136,39,64,38,72,11,15,17,77,136
2008-09-08 00:00:00.000,Bucharest Romania ATP World Tour,CLAY,2,Albert Montanes,Hyung-Taik Lee,Albert Montanes,6-1; 7-6(4),R32,75,3,1,31,60,25,31,19,29,1,2,10,44,60,0,2,37,58,23,37,10,21,2,5,9,33,58
2008-09-08 00:00:00.000,Bucharest Romania ATP World Tour,CLAY,2,Gilles Simon,Evgeny Korolev,Gilles Simon,6-1; 6-2,R32,63,4,1,35,53,23,35,11,18,3,4,8,34,53,2,3,33,58,16,33,9,25,7,12,7,25,58
2008-09-08 00:00:00.000,Bucharest Romania ATP World Tour,CLAY,2,Richard Gasquet,Victor Crivoi,Richard Gasquet,6-3; 6-2,R16,65,3,1,23,41,20,23,10,18,1,2,8,30,41,1,2,37,56,17,37,9,19,4,9,9,26,56
2008-09-08 00:00:00.000,Bucharest Romania ATP World Tour,CLAY,2,Teymuraz Gabashvili,Adrian Cruciat,Teymuraz Gabashvili,6-1; 6-2,R16,59,4,3,33,50,25,33,12,17,4,4,8,37,50,3,0,25,42,15,25,5,17,2,6,7,20,42
2008-09-08 00:00:00.000,Bucharest Romania ATP World Tour,CLAY,2,Guillermo Garcia-Lopez,Nicolas Almagro,Guillermo Garcia-Lopez,6-4; 7-5,R16,98,2,1,41,60,32,41,13,19,3,3,11,45,60,6,2,52,80,38,52,11,28,2,4,11,49,80
2008-09-08 00:00:00.000,Bucharest Romania ATP World Tour,CLAY,2,Carlos Moya,Pablo Andujar,Carlos Moya,6-3; 7-6(6),R16,98,3,2,52,69,37,52,10,17,0,1,11,47,69,0,5,57,81,38,57,11,24,5,7,10,49,81
2008-09-08 00:00:00.000,Bucharest Romania ATP World Tour,CLAY,2,Jose Acasuso,Martin Vassallo Arguello,Jose Acasuso,6-4; 7-5,R16,120,5,3,41,72,29,41,13,31,5,8,11,42,72,1,5,52,74,29,52,9,22,5,10,11,38,74
2008-09-08 00:00:00.000,Bucharest Romania ATP World Tour,CLAY,2,Ivan Navarro,Denis Gremelmayr,Ivan Navarro,6-3; 1-0 RET,R16,55,1,1,20,30,15,20,7,10,3,3,5,22,30,2,0,28,41,16,28,5,13,4,6,5,21,41
2008-09-08 00:00:00.000,Bucharest Romania ATP World Tour,CLAY,2,Florent Serra,Potito Starace,Florent Serra,7-5; 0-6; 6-4,R16,129,3,1,58,81,38,58,14,23,4,8,14,52,81,8,2,79,114,52,79,17,35,13,16,14,69,114
2008-09-08 00:00:00.000,Bucharest Romania ATP World Tour,CLAY,2,Gilles Simon,Albert Montanes,Gilles Simon,6-3; 6-4,R16,93,8,0,34,62,27,34,17,28,3,3,10,44,62,2,5,36,68,24,36,16,32,8,10,9,40,68
2008-09-08 00:00:00.000,Bucharest Romania ATP World Tour,CLAY,2,Richard Gasquet,Teymuraz Gabashvili,Richard Gasquet,6-7(6); 6-1; 6-1,Q,109,8,1,47,79,37,47,19,32,0,1,13,56,79,3,4,49,79,30,49,12,30,2,8,13,42,79
2008-09-08 00:00:00.000,Bucharest Romania ATP World Tour,CLAY,2,Carlos Moya,Guillermo Garcia-Lopez,Carlos Moya,5-7; 6-3; 6-4,Q,154,10,3,58,90,44,58,22,32,1,2,16,66,90,1,1,78,107,51,78,18,29,4,6,15,69,107
2008-09-08 00:00:00.000,Bucharest Romania ATP World Tour,CLAY,2,Jose Acasuso,Ivan Navarro,Jose Acasuso,6-4; 6-4,Q,101,2,2,41,58,30,41,12,17,2,2,10,42,58,8,2,47,71,32,47,13,24,4,6,10,45,71
2008-09-08 00:00:00.000,Bucharest Romania ATP World Tour,CLAY,2,Gilles Simon,Florent Serra,Gilles Simon,6-2; 6-3,Q,73,0,1,23,50,15,23,12,27,2,5,8,27,50,1,4,24,54,11,24,6,30,3,10,9,17,54
2008-09-08 00:00:00.000,Bucharest Romania ATP World Tour,CLAY,2,Carlos Moya,Richard Gasquet,Carlos Moya,6-2; 6-4,S,78,3,2,32,48,27,32,11,16,2,2,9,38,48,4,5,40,66,27,40,8,26,5,8,9,35,66
2008-09-08 00:00:00.000,Bucharest Romania ATP World Tour,CLAY,2,Gilles Simon,Jose Acasuso,Gilles Simon,4-6; 7-6(4); 6-4,S,174,6,3,67,121,46,67,26,54,6,10,16,72,121,1,5,52,111,36,52,27,59,8,12,16,63,111
2008-09-08 00:00:00.000,Bucharest Romania ATP World Tour,CLAY,2,Gilles Simon,Carlos Moya,Gilles Simon,6-3; 6-4,F,90,0,3,32,66,30,32,16,34,6,6,10,46,66,1,0,48,67,32,48,8,19,5,7,9,40,67
2008-09-22 00:00:00.000,Bangkok Thailand ATP World Tour,HARD,2,Novak Djokovic,N/A Bye,Novak Djokovic,,R32,0,0,0,0,0,0,0,0,0,0,0,0,0,0,0,0,0,0,0,0,0,0,0,0,0,0,0
2008-09-22 00:00:00.000,Bangkok Thailand ATP World Tour,HARD,2,Simon Stadler,Julien Benneteau,Simon Stadler,7-5; 6-1,R32,77,3,0,42,58,30,42,10,16,1,2,10,40,58,1,3,43,57,24,43,6,14,5,9,9,30,57
2008-09-22 00:00:00.000,Bangkok Thailand ATP World Tour,HARD,2,Teymuraz Gabashvili,Michael Berrer,Teymuraz Gabashvili,6-4; 6-3,R32,76,6,1,42,54,36,42,5,12,0,0,10,41,54,4,3,36,61,24,36,13,25,2,4,9,37,61
2008-09-22 00:00:00.000,Bangkok Thailand ATP World Tour,HARD,2,Robin Soderling,Aisam-Ul-Haq Qureshi,Robin Soderling,6-2; 6-4,R32,69,14,2,40,56,32,40,9,16,4,4,9,41,56,7,3,33,50,23,33,6,17,5,8,9,29,50
2008-09-22 00:00:00.000,Bangkok Thailand ATP World Tour,HARD,2,Tomas Berdych,N/A Bye,Tomas Berdych,,R32,0,0,0,0,0,0,0,0,0,0,0,0,0,0,0,0,0,0,0,0,0,0,0,0,0,0,0
2008-09-22 00:00:00.000,Bangkok Thailand ATP World Tour,HARD,2,Simone Bolelli,Thomaz Bellucci,Simone Bolelli,6-3; 6-3,R32,69,3,0,34,51,29,34,8,17,0,0,9,37,51,5,0,28,51,18,28,11,23,0,3,9,29,51
2008-09-22 00:00:00.000,Bangkok Thailand ATP World Tour,HARD,2,Nicolas Mahut,Danai Udomchoke,Nicolas Mahut,6-2; 6-7(5); 6-2,R32,137,6,1,56,90,42,56,14,34,3,6,14,56,90,5,9,65,99,37,65,13,34,8,15,14,50,99
2008-09-22 00:00:00.000,Bangkok Thailand ATP World Tour,HARD,2,Jarkko Nieminen,Marko Djokovic,Jarkko Nieminen,6-2; 6-0,R32,47,1,0,26,34,22,26,6,8,0,0,7,28,34,0,2,29,41,13,29,3,12,2,7,7,16,41
2008-09-22 00:00:00.000,Bangkok Thailand ATP World Tour,HARD,2,Philipp Petzschner,Marat Safin,Philipp Petzschner,6-4; 7-6(4),R32,104,13,4,45,81,30,45,19,36,2,5,11,49,81,5,3,42,84,30,42,18,42,5,9,11,48,84
2008-09-22 00:00:00.000,Bangkok Thailand ATP World Tour,HARD,2,Mischa Zverev,Robert Smeets,Mischa Zverev,6-4; 6-4,R32,63,9,0,45,56,32,45,9,11,2,2,10,41,56,6,0,30,58,24,30,14,28,4,6,10,38,58
2008-09-22 00:00:00.000,Bangkok Thailand ATP World Tour,HARD,2,Robert Kendrick,George Bastl,Robert Kendrick,6-3; 7-6(4),R32,81,14,2,49,66,42,49,11,17,1,1,11,53,66,7,0,47,63,36,47,9,16,3,4,10,45,63
2008-09-22 00:00:00.000,Bangkok Thailand ATP World Tour,HARD,2,Gael Monfils,N/A Bye,Gael Monfils,,R32,0,0,0,0,0,0,0,0,0,0,0,0,0,0,0,0,0,0,0,0,0,0,0,0,0,0,0
2008-09-22 00:00:00.000,Bangkok Thailand ATP World Tour,HARD,2,Jurgen Melzer,Donald Young,Jurgen Melzer,6-3; 6-3,R32,71,3,1,28,45,23,28,9,17,0,1,9,32,45,3,2,38,69,22,38,17,31,9,13,9,39,69
2008-09-22 00:00:00.000,Bangkok Thailand ATP World Tour,HARD,2,Viktor Troicki,Fabrice Santoro,Viktor Troicki,7-6(4); 6-2,R32,95,3,0,48,68,31,48,14,20,1,2,10,45,68,3,0,46,73,26,46,16,27,4,7,10,42,73
2008-09-22 00:00:00.000,Bangkok Thailand ATP World Tour,HARD,2,Lukas Dlouhy,Benjamin Becker,Lukas Dlouhy,6-4; 7-6(4),R32,77,10,6,57,78,46,57,6,21,3,5,11,52,78,8,0,37,70,27,37,17,33,2,5,11,44,70
2008-09-22 00:00:00.000,Bangkok Thailand ATP World Tour,HARD,2,Jo-Wilfried Tsonga,N/A Bye,Jo-Wilfried Tsonga,,R32,0,0,0,0,0,0,0,0,0,0,0,0,0,0,0,0,0,0,0,0,0,0,0,0,0,0,0
2008-09-22 00:00:00.000,Bangkok Thailand ATP World Tour,HARD,2,Novak Djokovic,Simon Stadler,Novak Djokovic,6-1; 6-3,R16,66,5,1,30,51,19,30,16,21,1,2,8,35,51,1,2,47,55,22,47,2,8,4,9,8,24,55
2008-09-22 00:00:00.000,Bangkok Thailand ATP World Tour,HARD,2,Robin Soderling,Teymuraz Gabashvili,Robin Soderling,6-1; 6-3,R16,47,11,1,23,37,21,23,11,14,0,0,8,32,37,4,3,30,48,19,30,5,18,4,8,8,24,48
2008-09-22 00:00:00.000,Bangkok Thailand ATP World Tour,HARD,2,Tomas Berdych,Simone Bolelli,Tomas Berdych,7-5; 6-1,R16,83,10,2,39,62,29,39,14,23,3,4,10,43,62,5,3,37,61,21,37,11,24,4,8,9,32,61
2008-09-22 00:00:00.000,Bangkok Thailand ATP World Tour,HARD,2,Nicolas Mahut,Jarkko Nieminen,Nicolas Mahut,6-4; 3-6; 6-3,R16,105,4,0,44,72,35,44,19,28,0,2,14,54,72,4,2,52,86,37,52,16,34,6,9,14,53,86
2008-09-22 00:00:00.000,Bangkok Thailand ATP World Tour,HARD,2,Philipp Petzschner,Mischa Zverev,Philipp Petzschner,7-6(3); 3-6; 6-1,R16,106,12,1,61,96,45,61,19,35,6,8,14,64,96,4,2,60,86,37,60,17,26,6,9,14,54,86
2008-09-22 00:00:00.000,Bangkok Thailand ATP World Tour,HARD,2,Gael Monfils,Robert Kendrick,Gael Monfils,6-4; 7-6(4),R16,74,4,2,40,64,31,40,13,24,1,3,11,44,64,8,2,38,70,28,38,17,32,4,7,11,45,70
2008-09-22 00:00:00.000,Bangkok Thailand ATP World Tour,HARD,2,Jurgen Melzer,Viktor Troicki,Jurgen Melzer,6-4; 7-6(4),R16,86,1,2,39,67,35,39,15,28,1,1,11,50,67,4,0,44,59,36,44,8,15,0,1,11,44,59
2008-09-22 00:00:00.000,Bangkok Thailand ATP World Tour,HARD,2,Jo-Wilfried Tsonga,Lukas Dlouhy,Jo-Wilfried Tsonga,7-6(9); 3-6; 7-6(1),R16,116,21,2,67,100,51,67,18,33,2,5,16,69,100,5,4,70,108,51,70,20,38,2,4,17,71,108
2008-09-22 00:00:00.000,Bangkok Thailand ATP World Tour,HARD,2,Novak Djokovic,Robin Soderling,Novak Djokovic,6-4; 7-5,Q,88,9,0,48,68,36,48,11,20,4,5,11,47,68,12,2,46,69,36,46,7,23,6,9,11,43,69
2008-09-22 00:00:00.000,Bangkok Thailand ATP World Tour,HARD,2,Tomas Berdych,Nicolas Mahut,Tomas Berdych,7-6(6); 6-3,Q,104,11,0,47,68,36,47,14,21,2,2,10,50,68,10,5,65,91,43,65,11,26,9,11,11,54,91
2008-09-22 00:00:00.000,Bangkok Thailand ATP World Tour,HARD,2,Gael Monfils,Philipp Petzschner,Gael Monfils,7-6(6); 6-4,Q,141,9,1,47,68,38,47,11,21,1,2,11,49,68,3,2,41,67,31,41,14,26,4,6,11,45,67
2008-09-22 00:00:00.000,Bangkok Thailand ATP World Tour,HARD,2,Jo-Wilfried Tsonga,Jurgen Melzer,Jo-Wilfried Tsonga,6-3; 6-2,Q,60,13,1,31,47,25,31,13,16,1,1,9,38,47,2,1,33,50,20,33,10,17,3,6,8,30,50
2008-09-22 00:00:00.000,Bangkok Thailand ATP World Tour,HARD,2,Novak Djokovic,Tomas Berdych,Novak Djokovic,7-5; 6-1,S,81,6,2,42,64,31,42,13,22,3,3,10,44,64,1,3,26,49,18,26,10,23,0,3,9,28,49
2008-09-22 00:00:00.000,Bangkok Thailand ATP World Tour,HARD,2,Jo-Wilfried Tsonga,Gael Monfils,Jo-Wilfried Tsonga,6-0; 6-3,S,60,7,2,26,43,22,26,11,17,1,1,8,33,43,5,1,24,40,16,24,5,16,2,6,7,21,40
2008-09-22 00:00:00.000,Bangkok Thailand ATP World Tour,HARD,2,Jo-Wilfried Tsonga,Novak Djokovic,Jo-Wilfried Tsonga,7-6(4); 6-4,F,101,8,1,41,71,32,41,16,30,5,6,11,48,71,3,1,44,71,31,44,14,27,1,3,11,45,71
2008-09-22 00:00:00.000,Beijing China ATP World Tour,HARD,2,David Ferrer,N/A Bye,David Ferrer,,R32,0,0,0,0,0,0,0,0,0,0,0,0,0,0,0,0,0,0,0,0,0,0,0,0,0,0,0
2008-09-22 00:00:00.000,Beijing China ATP World Tour,HARD,2,Dudi Sela,Nicolas Devilder,Dudi Sela,6-4; 6-3,R32,70,1,2,31,53,26,31,13,22,3,3,9,39,53,3,8,32,64,23,32,11,32,2,5,10,34,64
2008-09-22 00:00:00.000,Beijing China ATP World Tour,HARD,2,Ivo Minar,Hyung-Taik Lee,Ivo Minar,6-3; 3-6; 6-2,R32,91,3,0,41,68,30,41,16,27,2,5,13,46,68,2,3,47,84,27,47,18,37,10,15,13,45,84
2008-09-22 00:00:00.000,Beijing China ATP World Tour,HARD,2,Tommy Robredo,Guillermo Garcia-Lopez,Tommy Robredo,6-4; 7-5,R32,118,3,4,44,77,31,44,15,33,4,6,11,46,77,1,3,42,83,25,42,20,41,11,15,11,45,83
2008-09-22 00:00:00.000,Beijing China ATP World Tour,HARD,2,Richard Gasquet,N/A Bye,Richard Gasquet,,R32,0,0,0,0,0,0,0,0,0,0,0,0,0,0,0,0,0,0,0,0,0,0,0,0,0,0,0
2008-09-22 00:00:00.000,Beijing China ATP World Tour,HARD,2,Yen-Hsun Lu,Jun-Chao Xu,Yen-Hsun Lu,6-4; 6-3,R32,83,4,3,27,55,24,27,15,28,0,0,9,39,55,2,2,37,65,21,37,16,28,5,8,10,37,65
2008-09-22 00:00:00.000,Beijing China ATP World Tour,HARD,2,Jean-Claude Scherrer,Peng Sun,Jean-Claude Scherrer,6-4; 7-6(7),R32,95,12,1,59,75,45,59,9,16,0,0,11,54,75,2,7,55,86,43,55,14,31,8,9,11,57,86
2008-09-22 00:00:00.000,Beijing China ATP World Tour,HARD,2,Rainer Schuettler,Ivan Navarro,Rainer Schuettler,2-6; 6-3; 6-4,R32,110,1,6,50,84,35,50,22,34,4,6,14,57,84,8,5,39,75,35,39,15,36,3,5,13,50,75
2008-09-22 00:00:00.000,Beijing China ATP World Tour,HARD,2,Sam Querrey,Jesse Levine,Sam Querrey,1-6; 6-2; 7-6(4),R32,103,6,4,59,91,41,59,17,32,1,5,14,58,91,5,2,63,85,41,63,9,22,2,5,13,50,85
2008-09-22 00:00:00.000,Beijing China ATP World Tour,HARD,2,Bjorn Phau,Hyun-Woo Nam,Bjorn Phau,6-1; 6-3,R32,67,4,2,29,46,25,29,11,17,6,6,8,36,46,1,2,41,64,20,41,12,23,5,9,8,32,64
2008-09-22 00:00:00.000,Beijing China ATP World Tour,HARD,2,Go Soeda,Yan Bai,Go Soeda,6-4; 7-5,R32,106,2,1,39,72,26,39,19,33,6,8,11,45,72,1,4,45,84,28,45,17,39,8,12,11,45,84
2008-09-22 00:00:00.000,Beijing China ATP World Tour,HARD,2,Fernando Gonzalez,N/A Bye,Fernando Gonzalez,,R32,0,0,0,0,0,0,0,0,0,0,0,0,0,0,0,0,0,0,0,0,0,0,0,0,0,0,0
2008-09-22 00:00:00.000,Beijing China ATP World Tour,HARD,2,Fernando Verdasco,Bobby Reynolds,Fernando Verdasco,6-3; 6-3,R32,65,1,2,35,44,27,35,5,9,0,1,9,32,44,7,4,35,63,22,35,11,28,6,10,9,33,63
2008-09-22 00:00:00.000,Beijing China ATP World Tour,HARD,2,Juan Carlos Ferrero,Alexander Kudryavtsev,Juan Carlos Ferrero,6-4; 6-3,R32,70,5,1,39,55,27,39,10,16,0,1,10,37,55,8,4,28,67,20,28,18,39,0,3,9,38,67
2008-09-22 00:00:00.000,Beijing China ATP World Tour,HARD,2,Brendan Evans,Roko Karanusic,Brendan Evans,7-6(5); 1-6; 7-6(10),R32,118,10,4,77,109,58,77,10,32,4,8,15,68,109,5,1,89,116,60,89,17,27,8,10,16,77,116
2008-09-22 00:00:00.000,Beijing China ATP World Tour,HARD,2,Andy Roddick,N/A Bye,Andy Roddick,,R32,0,0,0,0,0,0,0,0,0,0,0,0,0,0,0,0,0,0,0,0,0,0,0,0,0,0,0
2008-09-22 00:00:00.000,Beijing China ATP World Tour,HARD,2,Dudi Sela,David Ferrer,Dudi Sela,6-3; 6-3,R16,69,2,2,39,61,29,39,13,22,6,7,9,42,61,3,2,27,50,18,27,9,23,0,4,9,27,50
2008-09-22 00:00:00.000,Beijing China ATP World Tour,HARD,2,Tommy Robredo,Ivo Minar,Tommy Robredo,6-2; 6-3,R16,64,8,1,32,48,26,32,9,16,1,1,8,35,48,1,3,35,65,20,35,15,30,4,8,9,35,65
2008-09-22 00:00:00.000,Beijing China ATP World Tour,HARD,2,Richard Gasquet,Yen-Hsun Lu,Richard Gasquet,7-5; 6-1,R16,80,12,2,42,69,34,42,14,27,3,3,10,48,69,1,2,33,57,24,33,9,24,5,8,9,33,57
2008-09-22 00:00:00.000,Beijing China ATP World Tour,HARD,2,Rainer Schuettler,Jean-Claude Scherrer,Rainer Schuettler,6-1; 6-4,R16,76,4,2,41,66,33,41,13,25,6,6,9,46,66,2,2,38,55,26,38,5,17,5,8,8,31,55
2008-09-22 00:00:00.000,Beijing China ATP World Tour,HARD,2,Bjorn Phau,Sam Querrey,Bjorn Phau,5-7; 6-3; 6-4,R16,122,6,7,50,102,40,50,27,52,7,10,16,67,102,9,2,69,112,42,69,22,43,12,16,15,64,112
2008-09-22 00:00:00.000,Beijing China ATP World Tour,HARD,2,Fernando Gonzalez,Go Soeda,Fernando Gonzalez,3-6; 7-6(4); 6-1,R16,101,6,2,41,66,27,41,12,25,2,5,11,39,66,3,3,45,79,33,45,13,34,1,4,12,46,79
2008-09-22 00:00:00.000,Beijing China ATP World Tour,HARD,2,Juan Carlos Ferrero,Fernando Verdasco,Juan Carlos Ferrero,7-5; 6-4,R16,80,2,0,36,60,28,36,15,24,1,2,11,43,60,6,4,49,62,32,49,7,13,5,8,11,39,62
2008-09-22 00:00:00.000,Beijing China ATP World Tour,HARD,2,Andy Roddick,Brendan Evans,Andy Roddick,6-4; 6-3,R16,57,17,2,35,55,27,35,13,20,2,3,10,40,55,1,1,30,53,20,30,12,23,2,5,9,32,53
2008-09-22 00:00:00.000,Beijing China ATP World Tour,HARD,2,Dudi Sela,Tommy Robredo,Dudi Sela,6-4; 6-1,Q,79,3,1,28,44,22,28,10,16,5,6,8,32,44,1,1,50,75,30,50,6,25,8,13,9,36,75
2008-09-22 00:00:00.000,Beijing China ATP World Tour,HARD,2,Rainer Schuettler,Richard Gasquet,Rainer Schuettler,4-6; 6-3; 6-4,Q,141,6,4,61,101,43,61,19,40,7,10,15,62,101,12,6,54,104,39,54,20,50,7,11,14,59,104
2008-09-22 00:00:00.000,Beijing China ATP World Tour,HARD,2,Bjorn Phau,Fernando Gonzalez,Bjorn Phau,6-3; 4-6; 6-3,Q,110,5,1,38,76,28,38,21,38,3,6,14,49,76,4,3,56,83,37,56,12,27,10,15,14,49,83
2008-09-22 00:00:00.000,Beijing China ATP World Tour,HARD,2,Andy Roddick,Juan Carlos Ferrero,Andy Roddick,2-6; 6-3; 6-4,Q,56,12,4,32,50,24,32,7,18,1,3,7,31,50,0,1,31,43,21,31,5,12,1,2,6,26,43
2008-09-22 00:00:00.000,Beijing China ATP World Tour,HARD,2,Dudi Sela,Rainer Schuettler,Dudi Sela,6-3; 6-3,S,70,0,0,26,49,21,26,13,23,0,1,9,34,49,0,2,29,49,14,29,11,20,3,7,9,25,49
2008-09-22 00:00:00.000,Beijing China ATP World Tour,HARD,2,Andy Roddick,Bjorn Phau,Andy Roddick,6-2; 6-7(4); 6-1,S,103,16,1,54,70,48,54,9,16,0,0,13,57,70,2,7,47,98,31,47,26,51,2,7,14,57,98
2008-09-22 00:00:00.000,Beijing China ATP World Tour,HARD,2,Andy Roddick,Dudi Sela,Andy Roddick,6-4; 6-7(6); 6-3,F,121,17,2,73,109,56,73,20,36,9,10,16,76,109,2,1,58,91,43,58,20,33,7,10,15,63,91
2008-09-29 00:00:00.000,Metz France ATP World Tour,HARD,2,Ivo Karlovic,Marcos Baghdatis,Ivo Karlovic,4-6; 2-1 RET,R32,57,6,0,27,45,17,27,13,18,2,3,7,30,45,5,2,18,34,14,18,13,16,0,0,6,27,34
2008-09-29 00:00:00.000,Metz France ATP World Tour,HARD,2,Carlos Moya,Albert Montanes,Carlos Moya,6-1; 4-6; 6-4,R32,91,10,3,49,84,39,49,21,35,2,3,14,60,84,4,3,46,89,27,46,26,43,8,11,13,53,89
2008-09-29 00:00:00.000,Metz France ATP World Tour,HARD,2,Jose Acasuso,Guillermo Canas,Jose Acasuso,6-3; 2-6; 6-3,R32,140,8,2,40,88,29,40,25,48,7,10,13,54,88,11,5,44,96,33,44,22,52,8,12,13,55,96
2008-09-29 00:00:00.000,Metz France ATP World Tour,HARD,2,Dmitry Tursunov,Thierry Ascione,Dmitry Tursunov,6-7(3); 6-2; 6-4,R32,110,14,5,50,93,40,50,27,43,4,4,15,67,93,5,2,58,94,44,58,18,36,5,8,15,62,94
2008-09-29 00:00:00.000,Metz France ATP World Tour,HARD,2,Eduardo Schwank,Nicolas Almagro,Eduardo Schwank,7-6(5); 6-2,R32,91,10,1,44,73,32,44,16,29,2,3,10,48,73,1,1,50,72,31,50,12,22,8,11,10,43,72
2008-09-29 00:00:00.000,Metz France ATP World Tour,HARD,2,Victor Hanescu,Ivan Ljubicic,Victor Hanescu,6-1; 7-6(4),R32,78,7,1,34,64,28,34,17,30,1,2,10,45,64,7,4,26,53,20,26,12,27,0,3,9,32,53
2008-09-29 00:00:00.000,Metz France ATP World Tour,HARD,2,Michael Llodra,Feliciano Lopez,Michael Llodra,7-6(11); 6-7(6); 6-3,R32,149,20,4,72,107,58,72,25,35,0,0,17,83,107,17,5,82,137,62,82,26,55,7,8,16,88,137
2008-09-29 00:00:00.000,Metz France ATP World Tour,HARD,2,Radek Stepanek,Julien Benneteau,Radek Stepanek,6-3; 6-3,R32,71,7,1,34,58,26,34,15,24,2,2,9,41,58,4,3,35,51,23,35,7,16,3,6,9,30,51
2008-09-29 00:00:00.000,Metz France ATP World Tour,HARD,2,Ernests Gulbis,Mario Ancic,Ernests Gulbis,7-6(3); 6-4,R32,100,11,8,44,74,37,44,12,30,4,6,11,49,74,4,2,49,77,28,49,18,28,4,7,11,46,77
2008-09-29 00:00:00.000,Metz France ATP World Tour,HARD,2,Janko Tipsarevic,Jeremy Chardy,Janko Tipsarevic,7-6(5); 7-5,R32,115,15,1,44,84,37,44,22,40,4,4,12,59,84,8,7,50,84,37,50,16,34,2,3,12,53,84
2008-09-29 00:00:00.000,Metz France ATP World Tour,HARD,2,Romain Jouan,Agustin Calleri,Romain Jouan,5-7; 6-1; 6-2,R32,86,9,4,52,96,39,52,25,44,6,7,14,64,96,14,1,41,72,31,41,13,31,4,8,13,44,72
2008-09-29 00:00:00.000,Metz France ATP World Tour,HARD,2,Paul-Henri Mathieu,Nicolas Devilder,Paul-Henri Mathieu,6-0; 6-2,R32,60,3,2,32,48,25,32,8,16,3,3,7,33,48,4,2,30,52,14,30,10,22,6,11,7,24,52
2008-09-29 00:00:00.000,Metz France ATP World Tour,HARD,2,Adrian Mannarino,Andreas Seppi,Adrian Mannarino,6-4; 6-2,R32,72,3,2,31,54,23,31,13,23,6,7,9,36,54,1,4,31,57,21,31,9,26,1,5,9,30,57
2008-09-29 00:00:00.000,Metz France ATP World Tour,HARD,2,Rik De Voest,Arnaud Clement,Rik De Voest,4-6; 6-2; 7-5,R32,155,12,6,44,90,33,44,21,46,4,9,15,54,90,9,4,55,91,35,55,13,36,4,11,15,48,91
2008-09-29 00:00:00.000,Metz France ATP World Tour,HARD,2,Marc Gicquel,Marcel Granollers,Marc Gicquel,6-3; 6-2,R32,55,9,0,27,46,22,27,16,19,0,0,9,38,46,1,1,26,47,13,26,13,21,4,7,8,26,47
2008-09-29 00:00:00.000,Metz France ATP World Tour,HARD,2,Nicolas Mahut,Gilles Simon,Nicolas Mahut,6-4; 3-6; 6-1,R32,96,8,0,45,73,31,45,21,28,4,5,13,52,73,3,3,34,69,26,34,19,35,0,3,13,45,69
2008-09-29 00:00:00.000,Metz France ATP World Tour,HARD,2,Carlos Moya,Ivo Karlovic,Carlos Moya,6-3; 7-6(4),R16,72,5,1,36,56,33,36,17,20,0,0,11,50,56,18,1,42,59,35,42,9,17,2,3,10,44,59
2008-09-29 00:00:00.000,Metz France ATP World Tour,HARD,2,Dmitry Tursunov,Jose Acasuso,Dmitry Tursunov,6-2; 6-2,R16,48,10,1,28,40,25,28,8,12,1,1,8,33,40,5,0,26,43,15,26,6,17,0,4,8,21,43
2008-09-29 00:00:00.000,Metz France ATP World Tour,HARD,2,Eduardo Schwank,Victor Hanescu,Eduardo Schwank,7-6(6); 6-7(5); 6-3,R16,158,8,5,69,117,56,69,28,48,11,11,17,84,117,7,2,68,107,55,68,19,39,3,4,16,74,107
2008-09-29 00:00:00.000,Metz France ATP World Tour,HARD,2,Radek Stepanek,Michael Llodra,Radek Stepanek,6-7(5); 6-1; 7-6(0),R16,130,12,4,72,103,57,72,14,31,1,2,16,71,103,19,6,62,110,48,62,20,48,7,10,15,68,110
2008-09-29 00:00:00.000,Metz France ATP World Tour,HARD,2,Janko Tipsarevic,Ernests Gulbis,Janko Tipsarevic,6-4; 6-4,R16,76,9,4,40,59,31,40,9,19,2,3,10,40,59,9,3,35,58,28,35,7,23,4,7,10,35,58
2008-09-29 00:00:00.000,Metz France ATP World Tour,HARD,2,Paul-Henri Mathieu,Romain Jouan,Paul-Henri Mathieu,6-3; 6-3,R16,69,3,1,24,45,20,24,16,21,0,0,9,36,45,13,1,36,67,25,36,13,31,6,9,9,38,67
2008-09-29 00:00:00.000,Metz France ATP World Tour,HARD,2,Adrian Mannarino,Rik De Voest,Adrian Mannarino,6-4; 7-5,R16,83,7,0,45,67,34,45,11,22,0,1,11,45,67,8,1,32,60,24,32,16,28,1,4,11,40,60
2008-09-29 00:00:00.000,Metz France ATP World Tour,HARD,2,Marc Gicquel,Nicolas Mahut,Marc Gicquel,6-3; 7-6(4),R16,91,10,0,48,79,39,48,16,31,3,3,11,55,79,7,2,39,55,32,39,9,16,1,2,10,41,55
2008-09-29 00:00:00.000,Metz France ATP World Tour,HARD,2,Dmitry Tursunov,Carlos Moya,Dmitry Tursunov,6-3; 6-3,Q,72,9,1,35,58,28,35,14,23,4,4,9,42,58,4,4,33,57,20,33,13,24,7,10,9,33,57
2008-09-29 00:00:00.000,Metz France ATP World Tour,HARD,2,Radek Stepanek,Eduardo Schwank,Radek Stepanek,3-6; 7-6(4); 6-4,Q,146,5,2,69,94,55,69,11,25,1,2,15,66,94,6,3,64,105,47,64,26,41,9,10,16,73,105
2008-09-29 00:00:00.000,Metz France ATP World Tour,HARD,2,Paul-Henri Mathieu,Janko Tipsarevic,Paul-Henri Mathieu,7-6(4); 6-3,Q,97,12,0,51,74,42,51,14,23,5,5,11,56,74,13,2,42,66,33,42,13,24,4,5,10,46,66
2008-09-29 00:00:00.000,Metz France ATP World Tour,HARD,2,Adrian Mannarino,Marc Gicquel,Adrian Mannarino,6-4; 7-6(3),Q,92,2,0,40,63,31,40,16,23,2,3,11,47,63,9,1,47,77,34,47,13,30,5,7,11,47,77
2008-09-29 00:00:00.000,Metz France ATP World Tour,HARD,2,Dmitry Tursunov,Radek Stepanek,Dmitry Tursunov,6-3; 6-4,S,80,7,1,39,66,32,39,15,27,5,5,10,47,66,3,1,40,55,30,40,5,15,4,6,9,35,55
2008-09-29 00:00:00.000,Metz France ATP World Tour,HARD,2,Paul-Henri Mathieu,Adrian Mannarino,Paul-Henri Mathieu,7-6(8); 7-6(1),S,144,4,2,52,91,38,52,23,39,5,7,12,61,91,5,3,56,104,36,56,26,48,4,6,12,62,104
2008-09-29 00:00:00.000,Metz France ATP World Tour,HARD,2,Dmitry Tursunov,Paul-Henri Mathieu,Dmitry Tursunov,7-6(6); 1-6; 6-4,F,144,11,5,58,102,41,58,22,44,5,9,15,63,102,6,0,53,93,39,53,23,40,6,8,14,62,93
2008-09-29 00:00:00.000,Tokyo Japan ATP World Tour,HARD,2,David Ferrer,N/A Bye,David Ferrer,,R64,0,0,0,0,0,0,0,0,0,0,0,0,0,0,0,0,0,0,0,0,0,0,0,0,0,0,0
2008-09-29 00:00:00.000,Tokyo Japan ATP World Tour,HARD,2,Jesse Levine,Danai Udomchoke,Jesse Levine,4-6; 6-1; 6-0,R64,79,4,4,44,65,33,44,12,21,3,5,12,45,65,6,5,49,73,27,49,9,24,5,11,11,36,73
2008-09-29 00:00:00.000,Tokyo Japan ATP World Tour,HARD,2,Takao Suzuki,Yuichi Sugita,Takao Suzuki,6-3; 7-6(6),R64,103,10,1,49,74,35,49,14,25,3,4,10,49,74,2,2,55,83,36,55,9,28,6,9,11,45,83
2008-09-29 00:00:00.000,Tokyo Japan ATP World Tour,HARD,2,Simone Bolelli,N/A Bye,Simone Bolelli,,R64,0,0,0,0,0,0,0,0,0,0,0,0,0,0,0,0,0,0,0,0,0,0,0,0,0,0,0
2008-09-29 00:00:00.000,Tokyo Japan ATP World Tour,HARD,2,Jarkko Nieminen,N/A Bye,Jarkko Nieminen,,R64,0,0,0,0,0,0,0,0,0,0,0,0,0,0,0,0,0,0,0,0,0,0,0,0,0,0,0
2008-09-29 00:00:00.000,Tokyo Japan ATP World Tour,HARD,2,Cecil Mamiit,Brendan Evans,Cecil Mamiit,3-6; 7-5; 6-4,R64,101,9,2,55,85,42,55,19,30,2,3,15,61,85,9,2,67,97,49,67,16,30,4,6,16,65,97
2008-09-29 00:00:00.000,Tokyo Japan ATP World Tour,HARD,2,Dudi Sela,Bjorn Phau,Dudi Sela,7-5; 6-1,R64,75,8,1,39,57,29,39,13,18,6,7,10,42,57,2,4,34,65,21,34,12,31,7,11,9,33,65
2008-09-29 00:00:00.000,Tokyo Japan ATP World Tour,HARD,2,Juan Martin Del Potro,N/A Bye,Juan Martin Del Potro,,R64,0,0,0,0,0,0,0,0,0,0,0,0,0,0,0,0,0,0,0,0,0,0,0,0,0,0,0
2008-09-29 00:00:00.000,Tokyo Japan ATP World Tour,HARD,2,Richard Gasquet,N/A Bye,Richard Gasquet,,R64,0,0,0,0,0,0,0,0,0,0,0,0,0,0,0,0,0,0,0,0,0,0,0,0,0,0,0
2008-09-29 00:00:00.000,Tokyo Japan ATP World Tour,HARD,2,Martin Slanar,Donald Young,Martin Slanar,4-6; 6-3; 6-2,R64,113,7,5,52,90,39,52,18,38,3,5,14,57,90,2,4,60,104,39,60,18,44,9,13,13,57,104
2008-09-29 00:00:00.000,Tokyo Japan ATP World Tour,HARD,2,Kei Nishikori,Robert Kendrick,Kei Nishikori,7-6(3); 6-7(5); 6-2,R64,124,11,4,66,100,54,66,20,34,2,2,16,74,100,18,2,60,99,45,60,22,39,1,3,16,67,99
2008-09-29 00:00:00.000,Tokyo Japan ATP World Tour,HARD,2,Guillermo Garcia-Lopez,N/A Bye,Guillermo Garcia-Lopez,,R64,0,0,0,0,0,0,0,0,0,0,0,0,0,0,0,0,0,0,0,0,0,0,0,0,0,0,0
2008-09-29 00:00:00.000,Tokyo Japan ATP World Tour,HARD,2,Rainer Schuettler,N/A Bye,Rainer Schuettler,,R64,0,0,0,0,0,0,0,0,0,0,0,0,0,0,0,0,0,0,0,0,0,0,0,0,0,0,0
2008-09-29 00:00:00.000,Tokyo Japan ATP World Tour,HARD,2,Hyung-Taik Lee,Satoshi Iwabuchi,Hyung-Taik Lee,6-1; 6-4,R64,65,4,0,29,44,21,29,8,15,1,3,8,29,44,5,5,44,63,22,44,5,19,6,12,9,27,63
2008-09-29 00:00:00.000,Tokyo Japan ATP World Tour,HARD,2,Flavio Cipolla,Ivan Navarro,Flavio Cipolla,7-6(5); 7-6(4),R64,120,0,3,62,86,44,62,14,24,6,8,12,58,86,4,3,54,86,39,54,17,32,3,5,12,56,86
2008-09-29 00:00:00.000,Tokyo Japan ATP World Tour,HARD,2,Mikhail Youzhny,N/A Bye,Mikhail Youzhny,,R64,0,0,0,0,0,0,0,0,0,0,0,0,0,0,0,0,0,0,0,0,0,0,0,0,0,0,0
2008-09-29 00:00:00.000,Tokyo Japan ATP World Tour,HARD,2,Tommy Robredo,N/A Bye,Tommy Robredo,,R64,0,0,0,0,0,0,0,0,0,0,0,0,0,0,0,0,0,0,0,0,0,0,0,0,0,0,0
2008-09-29 00:00:00.000,Tokyo Japan ATP World Tour,HARD,2,Joseph Sirianni,Yuichi Ito,Joseph Sirianni,6-3; 6-2,R64,70,4,2,35,56,24,35,14,21,2,3,9,38,56,1,0,35,53,20,35,7,18,2,6,8,27,53
2008-09-29 00:00:00.000,Tokyo Japan ATP World Tour,HARD,2,Roko Karanusic,Hiroki Kondo,Roko Karanusic,6-2; 6-2,R64,56,3,1,20,40,19,20,13,20,0,0,8,32,40,2,1,22,46,13,22,11,24,1,5,8,24,46
2008-09-29 00:00:00.000,Tokyo Japan ATP World Tour,HARD,2,Tomas Berdych,N/A Bye,Tomas Berdych,,R64,0,0,0,0,0,0,0,0,0,0,0,0,0,0,0,0,0,0,0,0,0,0,0,0,0,0,0
2008-09-29 00:00:00.000,Tokyo Japan ATP World Tour,HARD,2,Sam Querrey,N/A Bye,Sam Querrey,,R64,0,0,0,0,0,0,0,0,0,0,0,0,0,0,0,0,0,0,0,0,0,0,0,0,0,0,0
2008-09-29 00:00:00.000,Tokyo Japan ATP World Tour,HARD,2,Amer Delic,Go Soeda,Amer Delic,6-4; 6-2,R64,70,14,1,38,54,28,38,11,16,5,5,9,39,54,3,2,43,62,30,43,7,19,3,6,9,37,62
2008-09-29 00:00:00.000,Tokyo Japan ATP World Tour,HARD,2,Yen-Hsun Lu,Luka Gregorc,Yen-Hsun Lu,6-4; 7-6(5),R64,102,3,5,45,74,34,45,15,29,4,5,11,49,74,8,3,62,89,41,62,11,27,8,10,11,52,89
2008-09-29 00:00:00.000,Tokyo Japan ATP World Tour,HARD,2,Fernando Gonzalez,N/A Bye,Fernando Gonzalez,,R64,0,0,0,0,0,0,0,0,0,0,0,0,0,0,0,0,0,0,0,0,0,0,0,0,0,0,0
2008-09-29 00:00:00.000,Tokyo Japan ATP World Tour,HARD,2,Jo-Wilfried Tsonga,N/A Bye,Jo-Wilfried Tsonga,,R64,0,0,0,0,0,0,0,0,0,0,0,0,0,0,0,0,0,0,0,0,0,0,0,0,0,0,0
2008-09-29 00:00:00.000,Tokyo Japan ATP World Tour,HARD,2,Bobby Reynolds,Tatsuma Ito,Bobby Reynolds,6-3; 6-1,R64,71,9,1,38,59,27,38,10,21,4,5,8,37,59,2,4,32,52,14,32,9,20,2,7,8,23,52
2008-09-29 00:00:00.000,Tokyo Japan ATP World Tour,HARD,2,Wayne Odesnik,Kevin Kim,Wayne Odesnik,6-4; 6-3,R64,71,7,1,36,54,31,36,10,18,0,0,10,41,54,6,0,30,60,21,30,16,30,5,7,9,37,60
2008-09-29 00:00:00.000,Tokyo Japan ATP World Tour,HARD,2,Viktor Troicki,N/A Bye,Viktor Troicki,,R64,0,0,0,0,0,0,0,0,0,0,0,0,0,0,0,0,0,0,0,0,0,0,0,0,0,0,0
2008-09-29 00:00:00.000,Tokyo Japan ATP World Tour,HARD,2,Jurgen Melzer,N/A Bye,Jurgen Melzer,,R64,0,0,0,0,0,0,0,0,0,0,0,0,0,0,0,0,0,0,0,0,0,0,0,0,0,0,0
2008-09-29 00:00:00.000,Tokyo Japan ATP World Tour,HARD,2,Simon Stadler,Philipp Petzschner,Simon Stadler,6-2; 6-4,R64,69,1,2,48,70,30,48,11,22,7,9,9,41,70,1,9,27,62,21,27,10,35,4,9,9,31,62
2008-09-29 00:00:00.000,Tokyo Japan ATP World Tour,HARD,2,Ivo Minar,Mischa Zverev,Ivo Minar,7-6(9); 2-6; 6-2,R64,95,12,0,72,96,53,72,11,24,6,8,14,64,96,4,1,64,90,49,64,12,26,3,5,14,61,90
2008-09-29 00:00:00.000,Tokyo Japan ATP World Tour,HARD,2,Andy Roddick,N/A Bye,Andy Roddick,,R64,0,0,0,0,0,0,0,0,0,0,0,0,0,0,0,0,0,0,0,0,0,0,0,0,0,0,0
2008-09-29 00:00:00.000,Tokyo Japan ATP World Tour,HARD,2,David Ferrer,Jesse Levine,David Ferrer,6-4; 4-6; 6-1,R32,108,5,2,47,69,38,47,13,22,1,3,14,51,69,4,2,58,90,32,58,18,32,9,13,13,50,90
2008-09-29 00:00:00.000,Tokyo Japan ATP World Tour,HARD,2,Takao Suzuki,Simone Bolelli,Takao Suzuki,7-6(5); 4-6; 7-6(5),R32,147,17,1,63,102,54,63,23,39,2,3,17,77,102,17,3,78,105,61,78,16,27,2,2,17,77,105
2008-09-29 00:00:00.000,Tokyo Japan ATP World Tour,HARD,2,Jarkko Nieminen,Cecil Mamiit,Jarkko Nieminen,7-6(7); 6-4,R32,88,6,2,54,70,35,54,8,16,1,4,11,43,70,2,2,44,77,30,44,13,33,5,9,11,43,77
2008-09-29 00:00:00.000,Tokyo Japan ATP World Tour,HARD,2,Juan Martin Del Potro,Dudi Sela,Juan Martin Del Potro,7-5; 6-0,R32,69,6,0,36,51,26,36,10,15,2,3,9,36,51,1,6,34,55,19,34,7,21,4,9,9,26,55
2008-09-29 00:00:00.000,Tokyo Japan ATP World Tour,HARD,2,Richard Gasquet,Martin Slanar,Richard Gasquet,6-4; 6-2,R32,83,6,3,31,63,22,31,18,32,8,10,9,40,63,5,7,35,67,19,35,12,32,2,7,9,31,67
2008-09-29 00:00:00.000,Tokyo Japan ATP World Tour,HARD,2,Kei Nishikori,Guillermo Garcia-Lopez,Kei Nishikori,6-4; 6-4,R32,112,3,3,34,58,26,34,14,24,2,3,10,40,58,3,8,64,106,39,64,19,42,13,16,10,58,106
2008-09-29 00:00:00.000,Tokyo Japan ATP World Tour,HARD,2,Rainer Schuettler,Hyung-Taik Lee,Rainer Schuettler,6-3; 6-7(3); 6-3,R32,135,10,3,68,116,47,68,21,48,8,12,16,68,116,2,1,65,94,37,65,15,29,4,10,14,52,94
2008-09-29 00:00:00.000,Tokyo Japan ATP World Tour,HARD,2,Mikhail Youzhny,Flavio Cipolla,Mikhail Youzhny,6-2; 6-2,R32,70,4,0,34,52,28,34,9,18,5,5,8,37,52,2,4,32,52,19,32,8,20,1,5,8,27,52
2008-09-29 00:00:00.000,Tokyo Japan ATP World Tour,HARD,2,Tommy Robredo,Joseph Sirianni,Tommy Robredo,6-2; 6-2,R32,65,6,1,25,42,21,25,12,17,0,0,8,33,42,0,2,41,64,23,41,10,23,6,10,8,33,64
2008-09-29 00:00:00.000,Tokyo Japan ATP World Tour,HARD,2,Tomas Berdych,Roko Karanusic,Tomas Berdych,6-3; 6-4,R32,74,7,0,37,54,29,37,13,17,1,1,10,42,54,5,1,38,71,27,38,15,33,6,8,9,42,71
2008-09-29 00:00:00.000,Tokyo Japan ATP World Tour,HARD,2,Amer Delic,Sam Querrey,Amer Delic,7-6(5); 6-3,R32,68,10,3,49,70,39,49,12,21,3,3,11,51,70,5,5,40,63,33,40,9,23,4,5,10,42,63
2008-09-29 00:00:00.000,Tokyo Japan ATP World Tour,HARD,2,Fernando Gonzalez,Yen-Hsun Lu,Fernando Gonzalez,1-6; 7-5; 6-3,R32,114,7,4,60,96,43,60,18,36,3,5,14,61,96,2,3,46,79,39,46,16,33,3,5,14,55,79
2008-09-29 00:00:00.000,Tokyo Japan ATP World Tour,HARD,2,Jo-Wilfried Tsonga,Bobby Reynolds,Jo-Wilfried Tsonga,4-6; 7-6(4); 6-4,R32,120,17,4,58,94,46,58,19,36,3,5,16,65,94,12,0,56,98,44,56,24,42,5,7,16,68,98
2008-09-29 00:00:00.000,Tokyo Japan ATP World Tour,HARD,2,Viktor Troicki,Wayne Odesnik,Viktor Troicki,6-2; 6-1,R32,64,9,0,33,54,27,33,11,21,4,4,8,38,54,2,2,29,49,19,29,6,20,3,7,7,25,49
2008-09-29 00:00:00.000,Tokyo Japan ATP World Tour,HARD,2,Jurgen Melzer,Simon Stadler,Jurgen Melzer,6-2; 6-3,R32,61,5,0,31,44,24,31,9,13,1,1,8,33,44,1,1,45,62,22,45,9,17,6,10,9,31,62
2008-09-29 00:00:00.000,Tokyo Japan ATP World Tour,HARD,2,Andy Roddick,Ivo Minar,Andy Roddick,7-6(11); 6-7(4); 7-6(2),R32,164,37,4,89,122,73,89,16,33,0,2,18,89,122,6,0,94,127,72,94,17,33,6,8,18,89,127
2008-09-29 00:00:00.000,Tokyo Japan ATP World Tour,HARD,2,David Ferrer,Takao Suzuki,David Ferrer,4-6; 6-3; 6-2,R16,116,3,0,46,68,34,46,16,22,0,2,14,50,68,9,5,49,94,37,49,17,45,7,11,13,54,94
2008-09-29 00:00:00.000,Tokyo Japan ATP World Tour,HARD,2,Juan Martin Del Potro,Jarkko Nieminen,Juan Martin Del Potro,6-1; 6-3,R16,68,8,5,37,59,31,37,7,22,3,4,8,38,59,0,1,26,48,11,26,11,22,3,8,8,22,48
2008-09-29 00:00:00.000,Tokyo Japan ATP World Tour,HARD,2,Richard Gasquet,Kei Nishikori,Richard Gasquet,6-1; 6-2,R16,55,7,0,24,42,21,24,12,18,0,0,8,33,42,0,1,23,44,14,23,8,21,4,8,7,22,44
2008-09-29 00:00:00.000,Tokyo Japan ATP World Tour,HARD,2,Rainer Schuettler,Mikhail Youzhny,Rainer Schuettler,6-3; 6-7(12); 6-4,R16,282,4,3,74,122,49,74,27,48,6,9,16,76,122,5,1,83,119,53,83,16,36,10,15,15,69,119
2008-09-29 00:00:00.000,Tokyo Japan ATP World Tour,HARD,2,Tomas Berdych,Tommy Robredo,Tomas Berdych,7-6(6); 6-2,R16,85,10,1,39,66,31,39,16,27,7,8,10,47,66,5,2,37,64,28,37,11,27,2,5,10,39,64
2008-09-29 00:00:00.000,Tokyo Japan ATP World Tour,HARD,2,Fernando Gonzalez,Amer Delic,Fernando Gonzalez,6-4; 7-6(4),R16,76,6,1,40,62,35,40,17,22,1,1,11,52,62,10,0,53,77,40,53,11,24,7,8,11,51,77
2008-09-29 00:00:00.000,Tokyo Japan ATP World Tour,HARD,2,Viktor Troicki,Jo-Wilfried Tsonga,Viktor Troicki,5-7; 2-1 RET,R16,67,3,0,34,49,22,34,4,15,4,7,7,26,49,3,0,37,51,24,37,5,14,4,7,8,29,51
2008-09-29 00:00:00.000,Tokyo Japan ATP World Tour,HARD,2,Andy Roddick,Jurgen Melzer,Andy Roddick,7-6(2); 6-2,R16,66,20,0,47,63,38,47,10,16,3,3,10,48,63,12,2,37,66,24,37,18,29,2,4,10,42,66
2008-09-29 00:00:00.000,Tokyo Japan ATP World Tour,HARD,2,Juan Martin Del Potro,David Ferrer,Juan Martin Del Potro,6-1; 7-5,Q,100,6,3,42,61,32,42,9,19,7,8,9,41,61,4,0,45,82,23,45,18,37,5,10,10,41,82
2008-09-29 00:00:00.000,Tokyo Japan ATP World Tour,HARD,2,Richard Gasquet,Rainer Schuettler,Richard Gasquet,6-3; 6-2,Q,60,8,3,29,47,22,29,14,18,0,0,9,36,47,2,3,27,45,17,27,8,18,0,3,8,25,45
2008-09-29 00:00:00.000,Tokyo Japan ATP World Tour,HARD,2,Tomas Berdych,Fernando Gonzalez,Tomas Berdych,6-0; 6-4,Q,61,5,0,31,49,22,31,12,18,2,2,8,34,49,1,1,28,45,15,28,6,17,3,7,8,21,45
2008-09-29 00:00:00.000,Tokyo Japan ATP World Tour,HARD,2,Andy Roddick,Viktor Troicki,Andy Roddick,6-3; 6-4,Q,81,7,1,42,61,31,42,9,19,1,2,10,40,61,4,4,35,63,23,35,11,28,7,10,9,34,63
2008-09-29 00:00:00.000,Tokyo Japan ATP World Tour,HARD,2,Juan Martin Del Potro,Richard Gasquet,Juan Martin Del Potro,6-3; 4-6; 7-5,S,124,14,3,62,91,50,62,12,29,7,9,15,62,91,15,3,49,85,37,49,19,36,3,7,16,56,85
2008-09-29 00:00:00.000,Tokyo Japan ATP World Tour,HARD,2,Tomas Berdych,Andy Roddick,Tomas Berdych,6-7(3); 7-5; 7-6(3),S,133,17,1,63,109,51,63,27,46,4,6,18,78,109,25,4,76,104,61,76,15,28,1,4,18,76,104
2008-09-29 00:00:00.000,Tokyo Japan ATP World Tour,HARD,2,Tomas Berdych,Juan Martin Del Potro,Tomas Berdych,6-1; 6-4,F,78,11,0,31,54,27,31,14,23,3,3,9,41,54,0,2,36,52,22,36,7,16,5,8,8,29,52
2008-10-06 00:00:00.000,Moscow Russia ATP World Tour,HARD,2,Nikolay Davydenko,Florent Serra,Nikolay Davydenko,6-1; 7-5,R32,79,6,1,31,62,20,31,25,31,4,4,10,45,62,1,0,46,60,29,46,5,14,4,7,9,34,60
2008-10-06 00:00:00.000,Moscow Russia ATP World Tour,HARD,2,Guillermo Garcia-Lopez,Nicolas Devilder,Guillermo Garcia-Lopez,6-2; 6-4,R32,84,1,4,36,59,30,36,8,23,5,6,9,38,59,4,4,40,67,23,40,11,27,7,11,9,34,67
2008-10-06 00:00:00.000,Moscow Russia ATP World Tour,HARD,2,Julien Benneteau,Harel Levy,Julien Benneteau,6-4; 6-3,R32,78,9,3,39,53,34,39,5,14,0,0,9,39,53,1,1,45,72,27,45,13,27,7,10,10,40,72
2008-10-06 00:00:00.000,Moscow Russia ATP World Tour,HARD,2,Marat Safin,Noam Okun,Marat Safin,7-6(5); 3-6; 6-4,R32,126,12,1,49,93,39,49,23,44,4,6,15,62,93,7,2,68,106,48,68,24,38,8,10,16,72,106
2008-10-06 00:00:00.000,Moscow Russia ATP World Tour,HARD,2,Teymuraz Gabashvili,Mikhail Youzhny,Teymuraz Gabashvili,7-5; 4-6; 7-6(1),R32,163,9,6,58,102,46,58,23,44,6,8,17,69,102,7,7,70,114,53,70,21,44,5,7,17,74,114
2008-10-06 00:00:00.000,Moscow Russia ATP World Tour,HARD,2,Mischa Zverev,Denis Gremelmayr,Mischa Zverev,6-3; 7-6(7),R32,88,7,5,39,73,30,39,19,34,2,4,11,49,73,2,2,52,89,32,52,19,37,12,15,10,51,89
2008-10-06 00:00:00.000,Moscow Russia ATP World Tour,HARD,2,Viktor Troicki,Evgeny Donskoy,Viktor Troicki,6-1; 6-3,R32,51,9,2,25,40,23,25,9,15,0,0,8,32,40,1,1,26,48,16,26,10,22,2,6,8,26,48
2008-10-06 00:00:00.000,Moscow Russia ATP World Tour,HARD,2,Janko Tipsarevic,Alexander Kudryavtsev,Janko Tipsarevic,4-6; 6-3; 7-6(6),R32,126,12,3,58,102,46,58,25,44,1,2,16,71,102,19,3,47,92,42,47,23,45,2,3,15,65,92
2008-10-06 00:00:00.000,Moscow Russia ATP World Tour,HARD,2,Denis Istomin,Michael Llodra,Denis Istomin,7-6(2); 6-3,R32,86,3,4,55,81,42,55,12,26,5,6,11,54,81,1,3,49,65,34,49,7,16,1,3,10,41,65
2008-10-06 00:00:00.000,Moscow Russia ATP World Tour,HARD,2,Fabrice Santoro,Yuri Schukin,Fabrice Santoro,4-6; 7-6(2); 6-4,R32,155,13,2,60,100,49,60,24,40,1,2,16,73,100,7,5,66,113,50,66,25,47,7,8,16,75,113
2008-10-06 00:00:00.000,Moscow Russia ATP World Tour,HARD,2,Dudi Sela,Victor Hanescu,Dudi Sela,6-3; 3-6; 6-2,R32,95,2,2,42,77,26,42,24,35,0,2,13,50,77,8,4,58,76,38,58,7,18,2,6,13,45,76
2008-10-06 00:00:00.000,Moscow Russia ATP World Tour,HARD,2,Paul-Henri Mathieu,Sergiy Stakhovsky,Paul-Henri Mathieu,6-3; 6-2,R32,87,0,2,30,55,23,30,17,25,3,3,9,40,55,4,0,41,61,26,41,8,20,9,12,8,34,61
2008-10-06 00:00:00.000,Moscow Russia ATP World Tour,HARD,2,Igor Kunitsyn,Mikhail Kukushkin,Igor Kunitsyn,6-1; 4-6; 6-1,R32,104,3,0,36,63,26,36,17,27,2,4,12,43,63,2,5,48,79,25,48,13,31,6,12,12,38,79
2008-10-06 00:00:00.000,Moscow Russia ATP World Tour,HARD,2,Robby Ginepri,Jiri Vanek,Robby Ginepri,6-3; 6-4,R32,62,5,1,34,48,30,34,10,14,0,0,10,40,48,11,3,42,65,33,42,8,23,3,5,9,41,65
2008-10-06 00:00:00.000,Moscow Russia ATP World Tour,HARD,2,Jeremy Chardy,Potito Starace,Jeremy Chardy,3-6; 6-1; 6-4,R32,104,4,2,50,77,35,50,19,27,0,1,13,54,77,3,3,50,89,31,50,23,39,3,6,13,54,89
2008-10-06 00:00:00.000,Moscow Russia ATP World Tour,HARD,2,Igor Andreev,Yen-Hsun Lu,Igor Andreev,6-2 RET,R32,39,1,1,16,27,12,16,6,11,0,0,4,18,27,0,2,15,26,9,15,5,11,0,2,4,14,26
2008-10-06 00:00:00.000,Moscow Russia ATP World Tour,HARD,2,Nikolay Davydenko,Guillermo Garcia-Lopez,Nikolay Davydenko,6-1; 6-1,R16,55,4,1,30,41,27,30,3,11,1,1,7,30,41,0,1,26,47,15,26,5,21,5,10,7,20,47
2008-10-06 00:00:00.000,Moscow Russia ATP World Tour,HARD,2,Marat Safin,Julien Benneteau,Marat Safin,6-4; 0-6; 6-2,R16,88,11,6,38,64,31,38,10,26,2,5,12,41,64,6,3,52,82,33,52,16,30,6,9,12,49,82
2008-10-06 00:00:00.000,Moscow Russia ATP World Tour,HARD,2,Mischa Zverev,Teymuraz Gabashvili,Mischa Zverev,6-2; 2-6; 6-1,R16,104,6,2,44,70,28,44,16,26,3,5,11,44,70,4,4,49,90,36,49,13,41,9,14,12,49,90
2008-10-06 00:00:00.000,Moscow Russia ATP World Tour,HARD,2,Viktor Troicki,Janko Tipsarevic,Viktor Troicki,6-3; 6-4,R16,82,4,3,26,53,22,26,13,27,3,5,10,35,53,1,1,42,68,26,42,10,26,4,8,9,36,68
2008-10-06 00:00:00.000,Moscow Russia ATP World Tour,HARD,2,Fabrice Santoro,Denis Istomin,Fabrice Santoro,6-2; 6-4,R16,86,1,0,25,53,21,25,15,28,3,4,9,36,53,1,0,42,69,23,42,13,27,5,9,9,36,69
2008-10-06 00:00:00.000,Moscow Russia ATP World Tour,HARD,2,Paul-Henri Mathieu,Dudi Sela,Paul-Henri Mathieu,6-7(3); 7-5; 7-6(0),R16,168,6,0,63,103,49,63,24,40,0,2,18,73,103,6,4,74,126,48,74,27,52,3,6,18,75,126
2008-10-06 00:00:00.000,Moscow Russia ATP World Tour,HARD,2,Igor Kunitsyn,Robby Ginepri,Igor Kunitsyn,6-4; 6-3,R16,81,3,0,38,65,24,38,12,27,4,7,9,36,65,3,2,36,58,18,36,8,22,1,7,10,26,58
2008-10-06 00:00:00.000,Moscow Russia ATP World Tour,HARD,2,Jeremy Chardy,Igor Andreev,Jeremy Chardy,3-6; 7-5; 6-4,R16,121,10,3,61,97,42,61,19,36,4,7,16,61,97,6,3,54,79,40,54,12,25,0,3,15,52,79
2008-10-06 00:00:00.000,Moscow Russia ATP World Tour,HARD,2,Marat Safin,Nikolay Davydenko,Marat Safin,7-6(5); 4-6; 6-4,Q,147,17,3,69,106,49,69,19,37,4,7,16,68,106,3,6,61,109,45,61,24,48,6,9,16,69,109
2008-10-06 00:00:00.000,Moscow Russia ATP World Tour,HARD,2,Mischa Zverev,Viktor Troicki,Mischa Zverev,6-4; 3-6; 7-5,Q,148,6,4,57,97,44,57,12,40,7,12,15,56,97,9,6,69,119,47,69,18,50,14,20,16,65,119
2008-10-06 00:00:00.000,Moscow Russia ATP World Tour,HARD,2,Fabrice Santoro,Paul-Henri Mathieu,Fabrice Santoro,6-3; 2-0 RET,Q,43,8,0,15,32,13,15,12,17,3,3,6,25,32,2,0,15,29,10,15,5,14,4,6,5,15,29
2008-10-06 00:00:00.000,Moscow Russia ATP World Tour,HARD,2,Igor Kunitsyn,Jeremy Chardy,Igor Kunitsyn,6-4; 6-2,Q,63,1,0,35,48,22,35,11,13,0,1,9,33,48,3,0,35,49,21,35,6,14,1,5,9,27,49
2008-10-06 00:00:00.000,Moscow Russia ATP World Tour,HARD,2,Marat Safin,Mischa Zverev,Marat Safin,W/O,S,0,0,0,0,0,0,0,0,0,0,0,0,0,0,0,0,0,0,0,0,0,0,0,0,0,0,0
2008-10-06 00:00:00.000,Moscow Russia ATP World Tour,HARD,2,Igor Kunitsyn,Fabrice Santoro,Igor Kunitsyn,6-4; 6-3,S,91,2,0,23,51,16,23,15,28,0,3,9,31,51,1,4,41,75,25,41,11,34,9,15,10,36,75
2008-10-06 00:00:00.000,Moscow Russia ATP World Tour,HARD,2,Igor Kunitsyn,Marat Safin,Igor Kunitsyn,7-6(6); 6-7(4); 6-3,F,170,7,0,51,110,38,51,38,59,5,6,17,76,110,21,6,55,113,39,55,32,58,8,10,16,71,113
2008-10-06 00:00:00.000,Stockholm Sweden ATP World Tour,HARD,2,David Nalbandian,Bobby Reynolds,David Nalbandian,6-1; 6-1,R32,56,4,1,21,38,19,21,11,17,2,2,7,30,38,3,4,24,58,14,24,12,34,2,7,7,26,58
2008-10-06 00:00:00.000,Stockholm Sweden ATP World Tour,HARD,2,Joachim Johansson,Nicolas Mahut,Joachim Johansson,7-5; 7-6(5),R32,89,20,0,48,64,44,48,9,16,0,0,12,53,64,12,6,51,81,41,51,14,30,4,5,12,55,81
2008-10-06 00:00:00.000,Stockholm Sweden ATP World Tour,HARD,2,George Bastl,Frederik Nielsen,George Bastl,7-6(6); 3-6; 7-6(4),R32,176,5,3,78,126,47,78,28,48,9,13,16,75,126,7,5,64,118,43,64,30,54,5,8,17,73,118
2008-10-06 00:00:00.000,Stockholm Sweden ATP World Tour,HARD,2,Albert Montanes,Thomas Johansson,Albert Montanes,6-3; 4-6; 6-3,R32,103,8,5,35,83,28,35,26,48,1,4,14,54,83,12,6,32,78,25,32,19,46,1,6,14,44,78
2008-10-06 00:00:00.000,Stockholm Sweden ATP World Tour,HARD,2,Jarkko Nieminen,Thomaz Bellucci,Jarkko Nieminen,6-7(5); 6-3; 7-5,R32,140,11,3,75,121,49,75,29,46,7,9,17,78,121,10,1,50,105,36,50,29,55,8,12,16,65,105
2008-10-06 00:00:00.000,Stockholm Sweden ATP World Tour,HARD,2,Arnaud Clement,Bjorn Rehnquist,Arnaud Clement,6-2; 6-1,R32,67,5,2,32,50,22,32,11,18,3,4,8,33,50,1,3,22,39,11,22,5,17,0,5,7,16,39
2008-10-06 00:00:00.000,Stockholm Sweden ATP World Tour,HARD,2,Oscar Hernandez,Ivo Minar,Oscar Hernandez,6-4; 6-3,R32,55,10,1,24,42,22,24,14,18,0,0,9,36,42,4,3,46,68,29,46,10,22,3,6,10,39,68
2008-10-06 00:00:00.000,Stockholm Sweden ATP World Tour,HARD,2,Jose Acasuso,Matthias Bachinger,Jose Acasuso,7-6(5); 3-6; 7-6(4),R32,135,9,4,66,114,51,66,19,48,6,10,17,70,114,10,3,69,112,52,69,21,43,8,10,16,73,112
2008-10-06 00:00:00.000,Stockholm Sweden ATP World Tour,HARD,2,Rainer Schuettler,Chris Guccione,Rainer Schuettler,6-0; 6-3,R32,54,5,1,31,42,28,31,4,11,0,0,8,32,42,6,3,25,49,14,25,9,24,6,10,7,23,49
2008-10-06 00:00:00.000,Stockholm Sweden ATP World Tour,HARD,2,Nicolas Lapentti,Ivan Navarro,Nicolas Lapentti,3-6; 7-6(7); 7-5,R32,176,6,6,68,111,48,68,24,43,5,9,17,72,111,10,4,52,106,41,52,24,54,9,12,16,65,106
2008-10-06 00:00:00.000,Stockholm Sweden ATP World Tour,HARD,2,Juan Monaco,Jonas Bjorkman,Juan Monaco,6-2; 6-4,R32,70,0,1,38,54,27,38,7,16,2,4,9,34,54,1,8,27,49,17,27,6,22,3,8,9,23,49
2008-10-06 00:00:00.000,Stockholm Sweden ATP World Tour,HARD,2,Robin Soderling,Benjamin Becker,Robin Soderling,7-5; 6-3,R32,76,10,2,39,61,33,39,14,22,2,2,11,47,61,12,4,28,64,24,28,17,36,4,6,10,41,64
2008-10-06 00:00:00.000,Stockholm Sweden ATP World Tour,HARD,2,Kei Nishikori,Marcel Granollers,Kei Nishikori,2-6; 6-4; 6-2,R32,109,4,3,45,76,32,45,17,31,2,5,13,49,76,6,6,30,79,23,30,24,49,2,6,13,47,79
2008-10-06 00:00:00.000,Stockholm Sweden ATP World Tour,HARD,2,Dominik Hrbaty,Pablo Andujar,Dominik Hrbaty,6-2; 6-1,R32,50,4,2,30,51,22,30,13,21,1,2,8,35,51,0,3,26,42,12,26,6,16,2,7,7,18,42
2008-10-06 00:00:00.000,Stockholm Sweden ATP World Tour,HARD,2,Steve Darcis,Christophe Rochus,Steve Darcis,2-6; 6-3; 6-3,R32,92,15,4,44,81,34,44,21,37,7,9,13,55,81,5,4,63,92,42,63,13,29,8,11,13,55,92
2008-10-06 00:00:00.000,Stockholm Sweden ATP World Tour,HARD,2,Mario Ancic,Olivier Rochus,Mario Ancic,7-6(6); 6-2,R32,87,19,3,37,58,35,37,10,21,0,1,10,45,58,3,1,36,74,26,36,16,38,4,7,10,42,74
2008-10-06 00:00:00.000,Stockholm Sweden ATP World Tour,HARD,2,David Nalbandian,Joachim Johansson,David Nalbandian,6-3; 6-2,R16,56,5,1,21,41,19,21,17,20,0,0,9,36,41,3,5,20,46,15,20,10,26,1,4,8,25,46
2008-10-06 00:00:00.000,Stockholm Sweden ATP World Tour,HARD,2,Albert Montanes,George Bastl,Albert Montanes,1-6; 6-3; 6-2,R16,99,2,2,38,67,28,38,17,29,5,7,12,45,67,3,3,36,67,25,36,17,31,2,5,12,42,67
2008-10-06 00:00:00.000,Stockholm Sweden ATP World Tour,HARD,2,Jarkko Nieminen,Arnaud Clement,Jarkko Nieminen,6-4; 6-7(5); 6-2,R16,167,7,1,69,106,49,69,22,37,8,9,15,71,106,1,3,59,115,42,59,27,56,5,9,15,69,115
2008-10-06 00:00:00.000,Stockholm Sweden ATP World Tour,HARD,2,Oscar Hernandez,Jose Acasuso,Oscar Hernandez,2-6; 6-3; 6-4,R16,131,6,3,62,111,48,62,17,49,12,15,14,65,111,4,4,39,76,29,39,20,37,4,7,13,49,76
2008-10-06 00:00:00.000,Stockholm Sweden ATP World Tour,HARD,2,Rainer Schuettler,Nicolas Lapentti,Rainer Schuettler,7-6(6); 6-3,R16,104,3,1,37,59,28,37,14,22,2,4,10,42,59,5,3,40,70,28,40,13,30,0,4,11,41,70
2008-10-06 00:00:00.000,Stockholm Sweden ATP World Tour,HARD,2,Robin Soderling,Juan Monaco,Robin Soderling,6-3; 6-3,R16,68,11,0,30,40,26,30,10,10,0,0,9,36,40,7,1,48,66,28,48,9,18,4,7,9,37,66
2008-10-06 00:00:00.000,Stockholm Sweden ATP World Tour,HARD,2,Kei Nishikori,Dominik Hrbaty,Kei Nishikori,6-1; 1-6; 7-5,R16,111,1,3,39,77,24,39,24,38,3,6,13,48,77,3,1,55,88,36,55,15,33,9,13,13,51,88
2008-10-06 00:00:00.000,Stockholm Sweden ATP World Tour,HARD,2,Mario Ancic,Steve Darcis,Mario Ancic,7-6(4); 6-4,R16,86,13,2,36,63,32,36,18,27,0,0,11,50,63,4,2,50,75,35,50,16,25,3,4,11,51,75
2008-10-06 00:00:00.000,Stockholm Sweden ATP World Tour,HARD,2,David Nalbandian,Albert Montanes,David Nalbandian,6-4; 6-1,Q,63,6,0,33,49,27,33,7,16,1,1,8,34,49,1,3,34,62,23,34,11,28,3,7,9,34,62
2008-10-06 00:00:00.000,Stockholm Sweden ATP World Tour,HARD,2,Jarkko Nieminen,Oscar Hernandez,Jarkko Nieminen,6-1; 6-4,Q,83,1,3,35,57,25,35,9,22,2,4,9,34,57,1,1,27,49,12,27,10,22,2,7,8,22,49
2008-10-06 00:00:00.000,Stockholm Sweden ATP World Tour,HARD,2,Robin Soderling,Rainer Schuettler,Robin Soderling,6-2; 7-5,Q,74,13,7,33,55,28,33,13,22,1,1,10,41,55,3,1,29,55,21,29,11,26,0,3,10,32,55
2008-10-06 00:00:00.000,Stockholm Sweden ATP World Tour,HARD,2,Kei Nishikori,Mario Ancic,Kei Nishikori,W/O,Q,0,0,0,0,0,0,0,0,0,0,0,0,0,0,0,0,0,0,0,0,0,0,0,0,0,0,0
2008-10-06 00:00:00.000,Stockholm Sweden ATP World Tour,HARD,2,David Nalbandian,Jarkko Nieminen,David Nalbandian,6-2; 6-1,S,65,4,3,30,51,22,30,10,21,6,7,7,32,51,4,3,35,53,12,35,9,18,3,9,8,21,53
2008-10-06 00:00:00.000,Stockholm Sweden ATP World Tour,HARD,2,Robin Soderling,Kei Nishikori,Robin Soderling,6-1; 6-0,S,44,13,2,25,39,22,25,7,14,0,0,7,29,39,3,4,26,39,13,26,2,13,2,7,6,15,39
2008-10-06 00:00:00.000,Stockholm Sweden ATP World Tour,HARD,2,David Nalbandian,Robin Soderling,David Nalbandian,6-2; 5-7; 6-3,F,97,13,3,45,73,33,45,19,28,2,4,14,52,73,18,7,47,85,39,47,12,38,4,9,15,51,85
2008-10-06 00:00:00.000,Vienna Austria ATP World Tour,HARD,2,Philipp Petzschner,Stanislas Wawrinka,Philipp Petzschner,6-7(5); 6-2; 7-6(5),R32,151,3,6,49,95,38,49,21,46,1,6,16,59,95,3,1,72,111,43,72,19,39,7,14,16,62,111
2008-10-06 00:00:00.000,Vienna Austria ATP World Tour,HARD,2,Jan Hernych,Roko Karanusic,Jan Hernych,4-6; 6-4; 7-6(5),R32,145,4,2,88,127,52,88,19,39,16,21,16,71,127,4,0,60,90,36,60,18,30,5,10,16,54,90
2008-10-06 00:00:00.000,Vienna Austria ATP World Tour,HARD,2,Carlos Moya,Michael Berrer,Carlos Moya,7-6(5); 7-6(6),R32,103,14,4,49,83,38,49,20,34,1,1,12,58,83,9,3,51,80,40,51,16,29,1,1,12,56,80
2008-10-06 00:00:00.000,Vienna Austria ATP World Tour,HARD,2,Eduardo Schwank,Gilles Simon,Eduardo Schwank,4-6; 7-5; 7-6(5),R32,152,1,0,80,116,54,80,20,36,10,13,17,74,116,3,2,56,98,47,56,20,42,5,8,17,67,98
2008-10-06 00:00:00.000,Vienna Austria ATP World Tour,HARD,2,Juan Carlos Ferrero,Ivo Karlovic,Juan Carlos Ferrero,6-4; 7-6(4),R32,92,0,3,49,71,42,49,13,22,2,2,11,55,71,17,0,44,67,37,44,10,23,3,4,11,47,67
2008-10-06 00:00:00.000,Vienna Austria ATP World Tour,HARD,2,Jurgen Melzer,Ivan Ljubicic,Jurgen Melzer,7-6(3); 6-3,R32,88,11,2,39,68,32,39,16,29,2,3,11,48,68,9,1,45,68,31,45,10,23,1,3,10,41,68
2008-10-06 00:00:00.000,Vienna Austria ATP World Tour,HARD,2,Feliciano Lopez,Agustin Calleri,Feliciano Lopez,7-6(2); 7-6(4),R32,96,13,1,47,73,41,47,18,26,1,1,12,59,73,12,2,53,84,39,53,23,31,8,8,12,62,84
2008-10-06 00:00:00.000,Vienna Austria ATP World Tour,HARD,2,Santiago Giraldo,Stefan Koubek,Santiago Giraldo,6-1; 6-2,R32,63,0,1,23,44,17,23,13,21,3,4,7,30,44,1,3,33,54,18,33,3,21,4,10,8,21,54
2008-10-06 00:00:00.000,Vienna Austria ATP World Tour,HARD,2,Fernando Verdasco,Victor Crivoi,Fernando Verdasco,6-4; 6-4,R32,93,4,4,42,62,35,42,9,20,3,3,10,44,62,1,3,50,75,36,50,9,25,6,8,10,45,75
2008-10-06 00:00:00.000,Vienna Austria ATP World Tour,HARD,2,Guillermo Canas,Andreas Seppi,Guillermo Canas,7-6(2); 6-3,R32,109,9,0,38,65,29,38,15,27,1,3,11,44,65,2,5,34,71,25,34,16,37,3,6,10,41,71
2008-10-06 00:00:00.000,Vienna Austria ATP World Tour,HARD,2,Philipp Kohlschreiber,Marc Gicquel,Philipp Kohlschreiber,6-2; 6-2,R32,69,8,1,36,51,27,36,9,15,0,0,8,36,51,7,2,32,55,19,32,8,23,3,7,8,27,55
2008-10-06 00:00:00.000,Vienna Austria ATP World Tour,HARD,2,Juan Martin Del Potro,Martin Fischer,Juan Martin Del Potro,7-6(7); 7-6(5),R32,131,7,0,53,80,40,53,11,27,1,4,12,51,80,5,0,60,98,34,60,22,38,6,9,12,56,98
2008-10-06 00:00:00.000,Vienna Austria ATP World Tour,HARD,2,Gael Monfils,Alexander Peya,Gael Monfils,3-6; 6-1; 6-3,R32,119,4,3,55,84,34,55,18,29,6,8,12,52,84,3,5,39,93,26,39,24,54,9,14,13,50,93
2008-10-06 00:00:00.000,Vienna Austria ATP World Tour,HARD,2,Radek Stepanek,Pavel Snobel,Radek Stepanek,6-4; 6-2,R32,80,4,0,43,61,30,43,10,18,2,3,9,40,61,8,6,36,71,25,36,12,35,10,14,9,37,71
2008-10-06 00:00:00.000,Vienna Austria ATP World Tour,HARD,2,Ernests Gulbis,Filippo Volandri,Ernests Gulbis,6-2; 6-3,R32,58,4,3,24,45,21,24,14,21,2,2,8,35,45,0,0,36,47,18,36,7,11,2,6,9,25,47
2008-10-06 00:00:00.000,Vienna Austria ATP World Tour,HARD,2,Fernando Gonzalez,Simone Bolelli,Fernando Gonzalez,4-6; 7-6(2); 6-2,R32,139,8,3,67,110,46,67,25,43,7,9,15,71,110,5,1,61,97,44,61,17,36,5,8,15,61,97
2008-10-06 00:00:00.000,Vienna Austria ATP World Tour,HARD,2,Philipp Petzschner,Jan Hernych,Philipp Petzschner,6-3; 6-4,R16,82,6,1,34,48,30,34,10,14,0,0,10,40,48,2,4,39,69,25,39,15,30,4,6,9,40,69
2008-10-06 00:00:00.000,Vienna Austria ATP World Tour,HARD,2,Carlos Moya,Eduardo Schwank,Carlos Moya,6-2; 6-3,R16,66,9,1,37,62,30,37,14,25,5,5,9,44,62,1,3,22,42,16,22,9,20,1,4,8,25,42
2008-10-06 00:00:00.000,Vienna Austria ATP World Tour,HARD,2,Jurgen Melzer,Juan Carlos Ferrero,Jurgen Melzer,7-6(4); 6-3,R16,97,7,1,46,68,36,46,17,22,2,3,11,53,68,3,3,52,77,39,52,9,25,4,6,10,48,77
2008-10-06 00:00:00.000,Vienna Austria ATP World Tour,HARD,2,Feliciano Lopez,Santiago Giraldo,Feliciano Lopez,7-6(5); 6-3,R16,102,5,5,35,71,30,35,21,36,1,1,11,51,71,3,0,47,78,30,47,18,31,2,3,10,48,78
2008-10-06 00:00:00.000,Vienna Austria ATP World Tour,HARD,2,Fernando Verdasco,Guillermo Canas,Fernando Verdasco,6-1; 6-2,R16,67,3,3,42,54,27,42,8,12,4,5,8,35,54,4,2,21,41,13,21,5,20,3,8,7,18,41
2008-10-06 00:00:00.000,Vienna Austria ATP World Tour,HARD,2,Philipp Kohlschreiber,Juan Martin Del Potro,Philipp Kohlschreiber,W/O,R16,0,0,0,0,0,0,0,0,0,0,0,0,0,0,0,0,0,0,0,0,0,0,0,0,0,0,0
2008-10-06 00:00:00.000,Vienna Austria ATP World Tour,HARD,2,Gael Monfils,Radek Stepanek,Gael Monfils,6-4; 6-3,R16,71,5,1,40,59,33,40,6,19,2,3,9,39,59,3,1,40,57,26,40,6,17,2,6,10,32,57
2008-10-06 00:00:00.000,Vienna Austria ATP World Tour,HARD,2,Fernando Gonzalez,Ernests Gulbis,Fernando Gonzalez,4-6; 7-6(11); 6-1,R16,130,7,2,70,104,53,70,16,34,4,7,15,69,104,4,7,57,95,40,57,18,38,7,11,14,58,95
2008-10-06 00:00:00.000,Vienna Austria ATP World Tour,HARD,2,Philipp Petzschner,Carlos Moya,Philipp Petzschner,6-4; 6-2,Q,61,10,0,35,48,31,35,7,13,2,2,9,38,48,4,3,35,53,23,35,8,18,1,4,9,31,53
2008-10-06 00:00:00.000,Vienna Austria ATP World Tour,HARD,2,Feliciano Lopez,Jurgen Melzer,Feliciano Lopez,4-6; 6-3; 6-4,Q,118,11,5,47,89,38,47,25,42,2,3,15,63,89,3,1,42,78,33,42,22,36,0,2,14,55,78
2008-10-06 00:00:00.000,Vienna Austria ATP World Tour,HARD,2,Philipp Kohlschreiber,Fernando Verdasco,Philipp Kohlschreiber,6-2; 6-3,Q,67,0,0,26,43,19,26,14,17,0,0,8,33,43,1,0,42,53,24,42,6,11,3,7,9,30,53
2008-10-06 00:00:00.000,Vienna Austria ATP World Tour,HARD,2,Gael Monfils,Fernando Gonzalez,Gael Monfils,6-3; 7-6(2),Q,101,6,2,49,79,38,49,16,30,7,8,11,54,79,2,0,38,62,22,38,16,24,2,4,10,38,62
2008-10-06 00:00:00.000,Vienna Austria ATP World Tour,HARD,2,Philipp Petzschner,Feliciano Lopez,Philipp Petzschner,3-6; 6-3; 6-3,S,104,6,2,39,72,31,39,20,33,2,3,13,51,72,8,1,65,95,44,65,16,30,7,10,14,60,95
2008-10-06 00:00:00.000,Vienna Austria ATP World Tour,HARD,2,Gael Monfils,Philipp Kohlschreiber,Gael Monfils,6-4; 5-7; 7-6(2),S,171,11,1,81,115,60,81,14,34,6,9,17,74,115,2,3,90,124,56,90,22,34,10,13,17,78,124
2008-10-06 00:00:00.000,Vienna Austria ATP World Tour,HARD,2,Philipp Petzschner,Gael Monfils,Philipp Petzschner,6-4; 6-4,F,89,3,0,29,51,21,29,16,22,0,1,10,37,51,6,4,44,71,29,44,11,27,6,9,10,40,71
2008-10-12 00:00:00.000,ATP Masters Series Madrid Spain ATP World Tour,HARD,2,Rafael Nadal,N/A Bye,Rafael Nadal,,R64,0,0,0,0,0,0,0,0,0,0,0,0,0,0,0,0,0,0,0,0,0,0,0,0,0,0,0
2008-10-12 00:00:00.000,ATP Masters Series Madrid Spain ATP World Tour,HARD,2,Ernests Gulbis,Nicolas Kiefer,Ernests Gulbis,5-7; 6-4; 7-5,R64,143,10,4,63,99,48,63,21,36,3,4,17,69,99,5,4,51,95,42,51,26,44,3,5,17,68,95
2008-10-12 00:00:00.000,ATP Masters Series Madrid Spain ATP World Tour,HARD,2,Mardy Fish,Steve Darcis,Mardy Fish,6-1; 6-4,R64,71,13,1,25,54,24,25,17,29,4,4,9,41,54,0,1,26,51,14,26,15,25,1,4,8,29,51
2008-10-12 00:00:00.000,ATP Masters Series Madrid Spain ATP World Tour,HARD,2,Richard Gasquet,N/A Bye,Richard Gasquet,,R64,0,0,0,0,0,0,0,0,0,0,0,0,0,0,0,0,0,0,0,0,0,0,0,0,0,0,0
2008-10-12 00:00:00.000,ATP Masters Series Madrid Spain ATP World Tour,HARD,2,Stanislas Wawrinka,N/A Bye,Stanislas Wawrinka,,R64,0,0,0,0,0,0,0,0,0,0,0,0,0,0,0,0,0,0,0,0,0,0,0,0,0,0,0
2008-10-12 00:00:00.000,ATP Masters Series Madrid Spain ATP World Tour,HARD,2,Philipp Kohlschreiber,Carlos Moya,Philipp Kohlschreiber,6-2; 6-2,R64,66,3,1,28,47,22,28,12,19,1,1,8,34,47,3,3,36,58,19,36,8,22,5,9,8,27,58
2008-10-12 00:00:00.000,ATP Masters Series Madrid Spain ATP World Tour,HARD,2,Feliciano Lopez,Albert Montanes,Feliciano Lopez,7-6(4); 6-3,R64,88,10,1,37,61,34,37,16,24,0,0,11,50,61,1,4,48,86,31,48,22,38,4,5,10,53,86
2008-10-12 00:00:00.000,ATP Masters Series Madrid Spain ATP World Tour,HARD,2,David Ferrer,N/A Bye,David Ferrer,,R64,0,0,0,0,0,0,0,0,0,0,0,0,0,0,0,0,0,0,0,0,0,0,0,0,0,0,0
2008-10-12 00:00:00.000,ATP Masters Series Madrid Spain ATP World Tour,HARD,2,Novak Djokovic,N/A Bye,Novak Djokovic,,R64,0,0,0,0,0,0,0,0,0,0,0,0,0,0,0,0,0,0,0,0,0,0,0,0,0,0,0
2008-10-12 00:00:00.000,ATP Masters Series Madrid Spain ATP World Tour,HARD,2,Victor Hanescu,Dmitry Tursunov,Victor Hanescu,4-6; 6-2; 6-3,R64,98,12,2,57,84,48,57,9,27,2,4,14,57,84,5,2,62,87,36,62,14,25,4,8,13,50,87
2008-10-12 00:00:00.000,ATP Masters Series Madrid Spain ATP World Tour,HARD,2,Robin Soderling,Florent Serra,Robin Soderling,6-3; 6-4,R64,70,11,2,27,57,20,27,15,30,3,6,10,35,57,4,2,36,56,21,36,6,20,4,9,9,27,56
2008-10-12 00:00:00.000,ATP Masters Series Madrid Spain ATP World Tour,HARD,2,Ivo Karlovic,N/A Bye,Ivo Karlovic,,R64,0,0,0,0,0,0,0,0,0,0,0,0,0,0,0,0,0,0,0,0,0,0,0,0,0,0,0
2008-10-12 00:00:00.000,ATP Masters Series Madrid Spain ATP World Tour,HARD,2,James Blake,N/A Bye,James Blake,,R64,0,0,0,0,0,0,0,0,0,0,0,0,0,0,0,0,0,0,0,0,0,0,0,0,0,0,0
2008-10-12 00:00:00.000,ATP Masters Series Madrid Spain ATP World Tour,HARD,2,Gilles Simon,Igor Andreev,Gilles Simon,4-6; 6-1; 7-6(7),R64,129,9,3,48,90,39,48,26,42,6,8,15,65,90,6,2,64,99,47,64,13,35,4,7,14,60,99
2008-10-12 00:00:00.000,ATP Masters Series Madrid Spain ATP World Tour,HARD,2,Robby Ginepri,Michael Llodra,Robby Ginepri,6-4; 6-4,R64,77,6,0,47,68,34,47,11,21,1,2,10,45,68,3,3,34,59,23,34,13,25,3,6,10,36,59
2008-10-12 00:00:00.000,ATP Masters Series Madrid Spain ATP World Tour,HARD,2,Nikolay Davydenko,N/A Bye,Nikolay Davydenko,,R64,0,0,0,0,0,0,0,0,0,0,0,0,0,0,0,0,0,0,0,0,0,0,0,0,0,0,0
2008-10-12 00:00:00.000,ATP Masters Series Madrid Spain ATP World Tour,HARD,2,Andy Roddick,N/A Bye,Andy Roddick,,R64,0,0,0,0,0,0,0,0,0,0,0,0,0,0,0,0,0,0,0,0,0,0,0,0,0,0,0
2008-10-12 00:00:00.000,ATP Masters Series Madrid Spain ATP World Tour,HARD,2,Tommy Robredo,Andreas Seppi,Tommy Robredo,7-6(5); 3-6; 6-3,R64,140,7,2,59,97,46,59,21,38,3,5,15,67,97,4,0,59,93,38,59,25,34,0,2,15,63,93
2008-10-12 00:00:00.000,ATP Masters Series Madrid Spain ATP World Tour,HARD,2,Gael Monfils,Fabio Fognini,Gael Monfils,6-2; 6-4,R64,69,5,1,33,57,21,33,16,24,1,2,9,37,57,1,7,30,58,17,30,14,28,7,11,9,31,58
2008-10-12 00:00:00.000,ATP Masters Series Madrid Spain ATP World Tour,HARD,2,Fernando Gonzalez,N/A Bye,Fernando Gonzalez,,R64,0,0,0,0,0,0,0,0,0,0,0,0,0,0,0,0,0,0,0,0,0,0,0,0,0,0,0
2008-10-12 00:00:00.000,ATP Masters Series Madrid Spain ATP World Tour,HARD,2,Fernando Verdasco,N/A Bye,Fernando Verdasco,,R64,0,0,0,0,0,0,0,0,0,0,0,0,0,0,0,0,0,0,0,0,0,0,0,0,0,0,0
2008-10-12 00:00:00.000,ATP Masters Series Madrid Spain ATP World Tour,HARD,2,Marin Cilic,Olivier Rochus,Marin Cilic,6-3; 7-5,R64,99,15,3,38,68,29,38,19,30,3,3,11,48,68,0,9,40,77,27,40,19,37,7,9,10,46,77
2008-10-12 00:00:00.000,ATP Masters Series Madrid Spain ATP World Tour,HARD,2,Simone Bolelli,Nicolas Almagro,Simone Bolelli,7-6(4); 6-1,R64,71,6,0,42,58,33,42,9,16,2,3,10,42,58,3,2,33,50,22,33,10,17,2,5,9,32,50
2008-10-12 00:00:00.000,ATP Masters Series Madrid Spain ATP World Tour,HARD,2,Andy Murray,N/A Bye,Andy Murray,,R64,0,0,0,0,0,0,0,0,0,0,0,0,0,0,0,0,0,0,0,0,0,0,0,0,0,0,0
2008-10-12 00:00:00.000,ATP Masters Series Madrid Spain ATP World Tour,HARD,2,David Nalbandian,N/A Bye,David Nalbandian,,R64,0,0,0,0,0,0,0,0,0,0,0,0,0,0,0,0,0,0,0,0,0,0,0,0,0,0,0
2008-10-12 00:00:00.000,ATP Masters Series Madrid Spain ATP World Tour,HARD,2,Tomas Berdych,Rainer Schuettler,Tomas Berdych,6-1; 6-2,R64,54,7,1,23,33,19,23,6,10,0,1,7,25,33,2,2,32,50,15,32,4,18,2,8,8,19,50
2008-10-12 00:00:00.000,ATP Masters Series Madrid Spain ATP World Tour,HARD,2,Jarkko Nieminen,Mikhail Youzhny,Jarkko Nieminen,7-5; 3-6; 6-2,R64,113,6,1,66,97,48,66,15,31,6,8,14,63,97,7,0,56,85,34,56,20,29,2,6,15,54,85
2008-10-12 00:00:00.000,ATP Masters Series Madrid Spain ATP World Tour,HARD,2,Juan Martin Del Potro,N/A Bye,Juan Martin Del Potro,,R64,0,0,0,0,0,0,0,0,0,0,0,0,0,0,0,0,0,0,0,0,0,0,0,0,0,0,0
2008-10-12 00:00:00.000,ATP Masters Series Madrid Spain ATP World Tour,HARD,2,Jo-Wilfried Tsonga,N/A Bye,Jo-Wilfried Tsonga,,R64,0,0,0,0,0,0,0,0,0,0,0,0,0,0,0,0,0,0,0,0,0,0,0,0,0,0,0
2008-10-12 00:00:00.000,ATP Masters Series Madrid Spain ATP World Tour,HARD,2,Marcel Granollers,Paul-Henri Mathieu,Marcel Granollers,6-4; 6-4,R64,83,7,0,30,54,24,30,16,24,0,0,10,40,54,2,2,28,59,20,28,16,31,3,5,10,36,59
2008-10-12 00:00:00.000,ATP Masters Series Madrid Spain ATP World Tour,HARD,2,Radek Stepanek,Juan Monaco,Radek Stepanek,6-1; 6-1,R64,52,3,2,26,39,23,26,7,13,1,1,7,30,39,1,1,26,40,10,26,7,14,2,7,7,17,40
2008-10-12 00:00:00.000,ATP Masters Series Madrid Spain ATP World Tour,HARD,2,Roger Federer,N/A Bye,Roger Federer,,R64,0,0,0,0,0,0,0,0,0,0,0,0,0,0,0,0,0,0,0,0,0,0,0,0,0,0,0
2008-10-12 00:00:00.000,ATP Masters Series Madrid Spain ATP World Tour,HARD,2,Rafael Nadal,Ernests Gulbis,Rafael Nadal,7-5; 3-6; 6-3,R32,142,2,2,66,98,47,66,18,32,4,5,15,65,98,15,8,56,90,46,56,13,34,3,5,15,59,90
2008-10-12 00:00:00.000,ATP Masters Series Madrid Spain ATP World Tour,HARD,2,Richard Gasquet,Mardy Fish,Richard Gasquet,6-7(3); 6-4; 6-3,R32,151,8,4,49,91,41,49,26,42,4,4,15,67,91,23,6,65,110,50,65,22,45,6,9,16,72,110
2008-10-12 00:00:00.000,ATP Masters Series Madrid Spain ATP World Tour,HARD,2,Stanislas Wawrinka,Philipp Kohlschreiber,Stanislas Wawrinka,3-6; 7-5; 7-6(5),R32,152,15,1,61,96,47,61,24,35,2,4,17,71,96,3,0,74,107,52,74,21,33,3,4,16,73,107
2008-10-12 00:00:00.000,ATP Masters Series Madrid Spain ATP World Tour,HARD,2,Feliciano Lopez,David Ferrer,Feliciano Lopez,6-4; 7-6(4),R32,97,8,6,34,77,28,34,23,43,3,4,11,51,77,4,2,44,63,35,44,8,19,0,2,11,43,63
2008-10-12 00:00:00.000,ATP Masters Series Madrid Spain ATP World Tour,HARD,2,Novak Djokovic,Victor Hanescu,Novak Djokovic,6-7(8); 7-6(6); 3-1 RET,R32,140,10,2,58,90,44,58,22,32,1,2,14,66,90,7,0,73,99,55,73,12,26,2,4,14,67,99
2008-10-12 00:00:00.000,ATP Masters Series Madrid Spain ATP World Tour,HARD,2,Ivo Karlovic,Robin Soderling,Ivo Karlovic,7-6(7); 7-6(8),R32,109,24,3,43,71,41,43,23,28,0,0,12,64,71,11,6,46,88,40,46,26,42,3,3,12,66,88
2008-10-12 00:00:00.000,ATP Masters Series Madrid Spain ATP World Tour,HARD,2,Gilles Simon,James Blake,Gilles Simon,3-6; 6-1; 6-4,R32,86,2,1,44,79,31,44,24,35,9,10,13,55,79,2,1,38,67,28,38,17,29,1,4,13,45,67
2008-10-12 00:00:00.000,ATP Masters Series Madrid Spain ATP World Tour,HARD,2,Robby Ginepri,Nikolay Davydenko,Robby Ginepri,4-6; 6-4; 6-4,R32,125,5,1,61,96,41,61,22,35,9,11,15,63,96,12,5,47,82,39,47,16,35,3,6,15,55,82
2008-10-12 00:00:00.000,ATP Masters Series Madrid Spain ATP World Tour,HARD,2,Andy Roddick,Tommy Robredo,Andy Roddick,6-3; 6-4,R32,69,13,1,40,56,29,40,12,16,1,1,10,41,56,1,1,26,46,19,26,11,20,1,3,9,30,46
2008-10-12 00:00:00.000,ATP Masters Series Madrid Spain ATP World Tour,HARD,2,Gael Monfils,Fernando Gonzalez,Gael Monfils,6-3; 6-4,R32,64,8,1,33,51,30,33,12,18,1,1,10,42,51,0,3,33,52,25,33,7,19,2,4,9,32,52
2008-10-12 00:00:00.000,ATP Masters Series Madrid Spain ATP World Tour,HARD,2,Marin Cilic,Fernando Verdasco,Marin Cilic,6-2; 6-3,R32,77,5,3,31,55,26,31,12,24,3,4,9,38,55,3,2,40,58,23,40,6,18,3,7,8,29,58
2008-10-12 00:00:00.000,ATP Masters Series Madrid Spain ATP World Tour,HARD,2,Andy Murray,Simone Bolelli,Andy Murray,6-0; 2-1 RET,R32,104,7,0,15,24,13,15,7,9,0,0,5,20,24,0,1,32,44,13,32,5,12,7,10,4,18,44
2008-10-12 00:00:00.000,ATP Masters Series Madrid Spain ATP World Tour,HARD,2,David Nalbandian,Tomas Berdych,David Nalbandian,6-2; 6-7(5); 6-1,R32,118,9,2,56,88,43,56,18,32,3,4,13,61,88,6,1,54,87,33,54,15,33,5,11,14,48,87
2008-10-12 00:00:00.000,ATP Masters Series Madrid Spain ATP World Tour,HARD,2,Juan Martin Del Potro,Jarkko Nieminen,Juan Martin Del Potro,6-2; 4-2 RET,R32,52,2,1,21,33,21,21,7,12,0,0,7,28,33,1,2,29,47,18,29,7,18,4,7,7,25,47
2008-10-12 00:00:00.000,ATP Masters Series Madrid Spain ATP World Tour,HARD,2,Jo-Wilfried Tsonga,Marcel Granollers,Jo-Wilfried Tsonga,3-6; 6-3; 7-6(5),R32,131,7,3,56,87,47,56,15,31,2,4,15,62,87,10,4,55,95,44,55,20,40,3,5,15,64,95
2008-10-12 00:00:00.000,ATP Masters Series Madrid Spain ATP World Tour,HARD,2,Roger Federer,Radek Stepanek,Roger Federer,6-3; 7-6(6),R32,87,10,1,40,65,37,40,15,25,0,0,11,52,65,9,4,32,63,27,32,16,31,2,3,10,43,63
2008-10-12 00:00:00.000,ATP Masters Series Madrid Spain ATP World Tour,HARD,2,Rafael Nadal,Richard Gasquet,Rafael Nadal,6-4; 6-2,R16,86,2,2,33,57,27,33,13,24,4,4,9,40,57,4,0,35,60,23,35,12,25,6,9,9,35,60
2008-10-12 00:00:00.000,ATP Masters Series Madrid Spain ATP World Tour,HARD,2,Feliciano Lopez,Stanislas Wawrinka,Feliciano Lopez,6-4; 6-4,R16,73,9,1,35,52,30,35,12,17,0,0,10,42,52,7,1,37,56,28,37,10,19,1,3,10,38,56
2008-10-12 00:00:00.000,ATP Masters Series Madrid Spain ATP World Tour,HARD,2,Ivo Karlovic,Novak Djokovic,Ivo Karlovic,7-6(4); 7-6(5),R16,102,20,0,54,83,48,54,14,29,3,3,12,62,83,8,0,47,71,39,47,17,24,1,1,12,56,71
2008-10-12 00:00:00.000,ATP Masters Series Madrid Spain ATP World Tour,HARD,2,Gilles Simon,Robby Ginepri,Gilles Simon,6-7(6); 6-4; 7-6(6),R16,155,12,4,62,112,46,62,29,50,3,6,17,75,112,6,4,91,128,59,91,19,37,10,14,17,78,128
2008-10-12 00:00:00.000,ATP Masters Series Madrid Spain ATP World Tour,HARD,2,Gael Monfils,Andy Roddick,Gael Monfils,6-4; 3-6; 6-3,R16,100,7,1,52,86,38,52,21,34,7,8,14,59,86,13,3,49,79,41,49,15,30,1,3,14,56,79
2008-10-12 00:00:00.000,ATP Masters Series Madrid Spain ATP World Tour,HARD,2,Andy Murray,Marin Cilic,Andy Murray,7-5; 7-6(2),R16,112,4,3,38,71,31,38,17,33,0,2,12,48,71,11,6,41,84,30,41,19,43,4,7,12,49,84
2008-10-12 00:00:00.000,ATP Masters Series Madrid Spain ATP World Tour,HARD,2,Juan Martin Del Potro,David Nalbandian,Juan Martin Del Potro,6-4; 6-2,R16,85,8,1,28,57,25,28,12,29,4,5,9,37,57,6,5,28,55,21,28,8,27,1,5,9,29,55
2008-10-12 00:00:00.000,ATP Masters Series Madrid Spain ATP World Tour,HARD,2,Roger Federer,Jo-Wilfried Tsonga,Roger Federer,6-4; 6-1,R16,63,9,1,31,50,25,31,13,19,4,4,9,38,50,3,5,24,50,18,24,11,26,5,8,8,29,50
2008-10-12 00:00:00.000,ATP Masters Series Madrid Spain ATP World Tour,HARD,2,Rafael Nadal,Feliciano Lopez,Rafael Nadal,6-4; 6-4,Q,91,0,0,43,61,32,43,13,18,2,2,10,45,61,4,1,29,54,21,29,14,25,2,4,10,35,54
2008-10-12 00:00:00.000,ATP Masters Series Madrid Spain ATP World Tour,HARD,2,Gilles Simon,Ivo Karlovic,Gilles Simon,7-6(1); 4-6; 7-6(2),Q,134,4,1,54,98,42,54,25,44,2,6,17,67,98,27,1,69,100,54,69,11,31,4,7,17,65,100
2008-10-12 00:00:00.000,ATP Masters Series Madrid Spain ATP World Tour,HARD,2,Andy Murray,Gael Monfils,Andy Murray,6-2; 6-2,Q,68,3,0,32,52,22,32,10,20,0,2,8,32,52,4,2,34,54,17,34,6,20,5,11,8,23,54
2008-10-12 00:00:00.000,ATP Masters Series Madrid Spain ATP World Tour,HARD,2,Roger Federer,Juan Martin Del Potro,Roger Federer,6-3; 6-3,Q,86,3,0,37,53,29,37,9,16,1,1,9,38,53,12,4,41,68,30,41,8,27,6,9,9,38,68
2008-10-12 00:00:00.000,ATP Masters Series Madrid Spain ATP World Tour,HARD,2,Gilles Simon,Rafael Nadal,Gilles Simon,3-6; 7-5; 7-6(6),S,203,3,3,90,147,57,90,28,57,17,22,17,85,147,2,1,63,102,41,63,23,39,4,8,16,64,102
2008-10-12 00:00:00.000,ATP Masters Series Madrid Spain ATP World Tour,HARD,2,Andy Murray,Roger Federer,Andy Murray,3-6; 6-3; 7-5,S,117,14,2,53,86,45,53,17,33,2,3,15,62,86,7,1,65,98,46,65,18,33,7,9,15,64,98
2008-10-12 00:00:00.000,ATP Masters Series Madrid Spain ATP World Tour,HARD,2,Andy Murray,Gilles Simon,Andy Murray,6-4; 7-6(6),F,95,11,0,44,66,37,44,11,22,0,0,11,48,66,1,1,41,75,29,41,19,34,3,4,11,48,75
2008-10-20 00:00:00.000,Basel Switzerland ATP World Tour,HARD,2,Roger Federer,Bobby Reynolds,Roger Federer,6-3; 6-7(6); 6-3,R32,110,17,2,53,89,44,53,24,36,0,0,16,68,89,15,1,58,95,46,58,18,37,10,12,14,64,95
2008-10-20 00:00:00.000,Basel Switzerland ATP World Tour,HARD,2,Jarkko Nieminen,Eduardo Schwank,Jarkko Nieminen,6-2; 6-4,R32,73,2,2,34,46,27,34,8,12,2,3,9,35,46,1,1,44,66,27,44,7,22,6,10,9,34,66
2008-10-20 00:00:00.000,Basel Switzerland ATP World Tour,HARD,2,Marcel Granollers,Marcos Baghdatis,Marcel Granollers,6-2; 4-6; 6-2,R32,139,6,2,53,95,34,53,26,42,8,10,13,60,95,3,6,34,87,25,34,24,53,5,10,13,49,87
2008-10-20 00:00:00.000,Basel Switzerland ATP World Tour,HARD,2,Simone Bolelli,Tomas Berdych,Simone Bolelli,6-4; 7-5,R32,96,2,0,39,64,35,39,12,25,2,2,11,47,64,11,4,49,75,40,49,7,26,4,6,11,47,75
2008-10-20 00:00:00.000,Basel Switzerland ATP World Tour,HARD,2,James Blake,Nicolas Kiefer,James Blake,3-6; 6-3; 6-4,R32,104,11,5,39,78,29,39,24,39,2,4,14,53,78,8,1,37,75,28,37,19,38,2,5,14,47,75
2008-10-20 00:00:00.000,Basel Switzerland ATP World Tour,HARD,2,Oscar Hernandez,Lukas Dlouhy,Oscar Hernandez,7-6(6); 6-7(5); 6-1,R32,155,5,2,68,104,41,68,23,36,4,7,15,64,104,3,16,76,128,53,76,17,52,8,14,16,70,128
2008-10-20 00:00:00.000,Basel Switzerland ATP World Tour,HARD,2,Feliciano Lopez,Marco Chiudinelli,Feliciano Lopez,7-6(5); 7-6(7),R32,124,15,2,49,84,39,49,24,35,2,2,12,63,84,4,2,54,95,46,54,19,41,5,5,12,65,95
2008-10-20 00:00:00.000,Basel Switzerland ATP World Tour,HARD,2,Mardy Fish,Agustin Calleri,Mardy Fish,7-6(5); 6-2,R32,89,9,2,24,68,21,24,27,44,2,2,10,48,68,8,2,32,61,26,32,14,29,1,3,10,40,61
2008-10-20 00:00:00.000,Basel Switzerland ATP World Tour,HARD,2,Igor Andreev,Jurgen Melzer,Igor Andreev,7-6(5); 7-5,R32,104,11,5,51,94,36,51,28,43,5,5,12,64,94,7,3,40,76,32,40,21,36,1,2,12,53,76
2008-10-20 00:00:00.000,Basel Switzerland ATP World Tour,HARD,2,Philipp Kohlschreiber,Denis Gremelmayr,Philipp Kohlschreiber,6-4; 7-6(5),R32,101,3,2,43,66,32,43,13,23,1,3,11,45,66,2,2,44,85,28,44,22,41,6,9,11,50,85
2008-10-20 00:00:00.000,Basel Switzerland ATP World Tour,HARD,2,Stephane Bohli,Jose Acasuso,Stephane Bohli,6-3; 6-2,R32,53,8,2,27,47,25,27,12,20,2,2,9,37,47,2,1,24,42,17,24,7,18,1,4,8,24,42
2008-10-20 00:00:00.000,Basel Switzerland ATP World Tour,HARD,2,Juan Martin Del Potro,George Bastl,Juan Martin Del Potro,6-2; 6-4,R32,83,6,2,30,44,28,30,6,14,1,2,9,34,44,8,5,39,60,24,39,7,21,4,8,9,31,60
2008-10-20 00:00:00.000,Basel Switzerland ATP World Tour,HARD,2,Benjamin Becker,Stanislas Wawrinka,Benjamin Becker,3-6; 7-6(5); 7-6(5),R32,150,10,5,57,105,42,57,23,48,4,9,16,65,105,9,2,65,107,42,65,26,42,0,4,17,68,107
2008-10-20 00:00:00.000,Basel Switzerland ATP World Tour,HARD,2,Andreas Beck,Nicolas Devilder,Andreas Beck,6-4; 6-4,R32,72,9,1,28,52,26,28,12,24,1,2,10,38,52,6,1,38,58,27,38,9,20,1,4,10,36,58
2008-10-20 00:00:00.000,Basel Switzerland ATP World Tour,HARD,2,Kristof Vliegen,Philipp Petzschner,Kristof Vliegen,6-2; 6-3,R32,65,7,0,24,51,20,24,18,27,4,4,9,38,51,6,1,22,52,14,22,15,30,4,7,8,29,52
2008-10-20 00:00:00.000,Basel Switzerland ATP World Tour,HARD,2,David Nalbandian,Albert Montanes,David Nalbandian,6-4; 6-2,R32,57,6,4,32,50,29,32,9,18,0,0,9,38,50,2,1,34,52,25,34,6,18,4,7,9,31,52
2008-10-20 00:00:00.000,Basel Switzerland ATP World Tour,HARD,2,Roger Federer,Jarkko Nieminen,Roger Federer,7-6(6); 7-6(1),R16,96,11,0,64,89,44,64,14,25,5,8,12,58,89,1,2,50,78,31,50,18,28,2,5,12,49,78
2008-10-20 00:00:00.000,Basel Switzerland ATP World Tour,HARD,2,Simone Bolelli,Marcel Granollers,Simone Bolelli,6-4; 6-2,R16,74,2,0,26,48,23,26,15,22,0,0,9,38,48,7,2,33,58,22,33,11,25,6,9,9,33,58
2008-10-20 00:00:00.000,Basel Switzerland ATP World Tour,HARD,2,James Blake,Oscar Hernandez,James Blake,6-7(4); 6-2; 6-4,R16,125,17,1,52,81,48,52,17,29,1,1,15,65,81,6,3,73,118,48,73,24,45,10,13,15,72,118
2008-10-20 00:00:00.000,Basel Switzerland ATP World Tour,HARD,2,Feliciano Lopez,Mardy Fish,Feliciano Lopez,7-6(9); 6-4,R16,89,16,3,52,71,43,52,11,19,2,2,11,54,71,14,6,37,77,33,37,21,40,4,5,11,54,77
2008-10-20 00:00:00.000,Basel Switzerland ATP World Tour,HARD,2,Igor Andreev,Philipp Kohlschreiber,Igor Andreev,7-6(6); 6-7(0); 7-5,R16,154,17,3,68,113,54,68,28,45,1,1,18,82,113,5,3,78,118,59,78,28,40,3,4,18,87,118
2008-10-20 00:00:00.000,Basel Switzerland ATP World Tour,HARD,2,Juan Martin Del Potro,Stephane Bohli,Juan Martin Del Potro,6-3; 6-3,R16,66,6,1,28,47,23,28,14,19,0,0,9,37,47,6,1,32,54,22,32,10,22,2,5,9,32,54
2008-10-20 00:00:00.000,Basel Switzerland ATP World Tour,HARD,2,Benjamin Becker,Andreas Beck,Benjamin Becker,3-6; 6-3; 6-4,R16,107,19,4,54,86,42,54,18,32,6,7,14,60,86,10,5,44,83,36,44,19,39,5,7,14,55,83
2008-10-20 00:00:00.000,Basel Switzerland ATP World Tour,HARD,2,David Nalbandian,Kristof Vliegen,David Nalbandian,6-4; 5-7; 7-6(4),R16,144,11,3,57,100,43,57,29,43,3,5,17,72,100,13,6,64,121,50,64,28,57,4,6,17,78,121
2008-10-20 00:00:00.000,Basel Switzerland ATP World Tour,HARD,2,Roger Federer,Simone Bolelli,Roger Federer,6-2; 6-3,Q,67,8,1,39,56,33,39,8,17,1,1,9,41,56,3,3,29,47,18,29,8,18,3,6,8,26,47
2008-10-20 00:00:00.000,Basel Switzerland ATP World Tour,HARD,2,Feliciano Lopez,James Blake,Feliciano Lopez,6-4; 7-6(7),Q,88,10,3,54,87,41,54,19,33,8,8,11,60,87,7,0,42,64,32,42,15,22,2,3,11,47,64
2008-10-20 00:00:00.000,Basel Switzerland ATP World Tour,HARD,2,Juan Martin Del Potro,Igor Andreev,Juan Martin Del Potro,6-4; 7-5,Q,114,5,1,35,69,28,35,21,34,3,3,11,49,69,10,2,51,81,35,51,14,30,7,9,11,49,81
2008-10-20 00:00:00.000,Basel Switzerland ATP World Tour,HARD,2,David Nalbandian,Benjamin Becker,David Nalbandian,7-6(4); 6-4,Q,103,8,2,43,76,37,43,16,33,3,3,11,53,76,12,2,58,88,43,58,12,30,8,9,11,55,88
2008-10-20 00:00:00.000,Basel Switzerland ATP World Tour,HARD,2,Roger Federer,Feliciano Lopez,Roger Federer,6-3; 6-2,S,61,15,2,31,54,28,31,12,23,2,2,9,40,54,5,2,25,52,18,25,11,27,1,4,8,29,52
2008-10-20 00:00:00.000,Basel Switzerland ATP World Tour,HARD,2,David Nalbandian,Juan Martin Del Potro,David Nalbandian,6-4; 6-4,S,80,7,1,43,57,32,43,8,14,2,3,10,40,57,6,0,37,56,22,37,11,19,2,5,10,33,56
2008-10-20 00:00:00.000,Basel Switzerland ATP World Tour,HARD,2,Roger Federer,David Nalbandian,Roger Federer,6-3; 6-4,F,70,8,0,30,47,26,30,14,17,0,0,10,40,47,5,3,41,61,27,41,10,20,6,8,9,37,61
2008-10-20 00:00:00.000,Lyon France ATP World Tour,HARD,2,Andy Roddick,Nicolas Mahut,Andy Roddick,7-6(5); 6-4,R32,78,18,3,44,62,39,44,10,18,0,0,11,49,62,18,5,50,71,41,50,9,21,3,4,11,50,71
2008-10-20 00:00:00.000,Lyon France ATP World Tour,HARD,2,Robby Ginepri,Sebastien Grosjean,Robby Ginepri,6-7(4); 6-4; 6-4,R32,134,5,2,61,97,44,61,17,36,4,7,16,61,97,0,4,84,113,53,84,13,29,14,19,16,66,113
2008-10-20 00:00:00.000,Lyon France ATP World Tour,HARD,2,Christophe Rochus,Gilles Muller,Christophe Rochus,6-2; 6-4,R32,75,4,0,31,44,24,31,12,13,0,0,9,36,44,20,7,42,75,30,42,11,33,9,12,9,41,75
2008-10-20 00:00:00.000,Lyon France ATP World Tour,HARD,2,Robin Soderling,Thierry Ascione,Robin Soderling,6-4; 6-1,R32,65,10,1,23,41,20,23,13,18,0,0,8,33,41,2,1,38,61,25,38,8,23,7,11,9,33,61
2008-10-20 00:00:00.000,Lyon France ATP World Tour,HARD,2,Gilles Simon,Juan Monaco,Gilles Simon,2-6; 6-4; 6-1,R32,128,8,3,61,107,38,61,24,46,8,11,13,62,107,4,1,43,78,31,43,13,35,5,9,12,44,78
2008-10-20 00:00:00.000,Lyon France ATP World Tour,HARD,2,Andreas Seppi,David Guez,Andreas Seppi,6-2; 7-5,R32,79,6,1,37,55,30,37,13,18,0,0,10,43,55,1,3,30,59,19,30,15,29,2,5,10,34,59
2008-10-20 00:00:00.000,Lyon France ATP World Tour,HARD,2,Josselin Ouanna,Ivan Ljubicic,Josselin Ouanna,6-7(2); 7-6(5); 6-4,R32,132,11,2,62,107,50,62,24,45,3,5,17,74,107,24,1,60,96,48,60,21,36,1,4,17,69,96
2008-10-20 00:00:00.000,Lyon France ATP World Tour,HARD,2,Nicolas Lapentti,Ivo Karlovic,Nicolas Lapentti,7-6(4); 6-3,R32,91,2,1,47,75,37,47,16,28,6,7,11,53,75,13,3,36,58,35,36,6,22,3,5,10,41,58
2008-10-20 00:00:00.000,Lyon France ATP World Tour,HARD,2,Paul-Henri Mathieu,Guillermo Canas,Paul-Henri Mathieu,6-3; 6-4,R32,88,2,2,36,71,26,36,21,35,3,4,10,47,71,10,1,29,51,22,29,8,22,3,6,9,30,51
2008-10-20 00:00:00.000,Lyon France ATP World Tour,HARD,2,Juan Carlos Ferrero,Sam Querrey,Juan Carlos Ferrero,6-3; 7-5,R32,81,9,0,51,68,39,51,12,17,2,2,11,51,68,7,2,45,68,32,45,9,23,4,6,10,41,68
2008-10-20 00:00:00.000,Lyon France ATP World Tour,HARD,2,Fabrice Santoro,Fabio Fognini,Fabrice Santoro,6-4; 6-1,R32,63,8,2,35,61,27,35,13,26,3,4,9,40,61,2,0,30,46,16,30,9,16,3,7,8,25,46
2008-10-20 00:00:00.000,Lyon France ATP World Tour,HARD,2,Jo-Wilfried Tsonga,Marc Gicquel,Jo-Wilfried Tsonga,7-5; 4-6; 6-3,R32,119,14,4,60,95,52,60,15,35,5,6,16,67,95,8,2,53,88,41,53,18,35,4,6,15,59,88
2008-10-20 00:00:00.000,Lyon France ATP World Tour,HARD,2,Tommy Robredo,Michael Llodra,Tommy Robredo,6-4; 6-3,R32,63,8,2,48,63,37,48,7,15,1,1,10,44,63,5,5,33,53,24,33,10,20,1,3,9,34,53
2008-10-20 00:00:00.000,Lyon France ATP World Tour,HARD,2,Julien Benneteau,Arnaud Clement,Julien Benneteau,6-3; 6-2,R32,86,10,6,30,51,26,30,10,21,2,2,8,36,51,5,3,41,67,23,41,12,26,9,13,9,35,67
2008-10-20 00:00:00.000,Lyon France ATP World Tour,HARD,2,Steve Darcis,Radek Stepanek,Steve Darcis,6-4; 3-6; 6-3,R32,92,3,3,59,88,45,59,17,29,4,5,14,62,88,13,11,48,85,38,48,18,37,4,6,14,56,85
2008-10-20 00:00:00.000,Lyon France ATP World Tour,HARD,2,Richard Gasquet,Santiago Giraldo,Richard Gasquet,5-7; 6-3; 7-6(3),R32,125,17,4,69,94,58,69,12,25,1,3,17,70,94,10,0,73,99,47,73,18,26,5,7,16,65,99
2008-10-20 00:00:00.000,Lyon France ATP World Tour,HARD,2,Andy Roddick,Robby Ginepri,Andy Roddick,7-6(5); 7-6(3),R16,98,26,0,63,79,53,63,8,16,2,2,12,61,79,11,1,65,98,50,65,15,33,6,6,12,65,98
2008-10-20 00:00:00.000,Lyon France ATP World Tour,HARD,2,Robin Soderling,Christophe Rochus,Robin Soderling,6-1; 6-2,R16,47,20,3,26,44,24,26,11,18,1,1,8,35,44,1,1,30,44,16,30,5,14,1,5,7,21,44
2008-10-20 00:00:00.000,Lyon France ATP World Tour,HARD,2,Gilles Simon,Andreas Seppi,Gilles Simon,7-6(5); 5-7; 6-4,R16,146,13,2,62,105,48,62,26,43,4,6,17,74,105,8,3,68,118,51,68,28,50,7,9,17,79,118
2008-10-20 00:00:00.000,Lyon France ATP World Tour,HARD,2,Josselin Ouanna,Nicolas Lapentti,Josselin Ouanna,6-3; 1-6; 6-3,R16,87,6,2,42,61,34,42,12,19,1,3,13,46,61,5,1,55,73,39,55,8,18,0,2,12,47,73
2008-10-20 00:00:00.000,Lyon France ATP World Tour,HARD,2,Juan Carlos Ferrero,Paul-Henri Mathieu,Juan Carlos Ferrero,6-4; 6-1,R16,58,9,1,27,40,24,27,9,13,0,0,8,33,40,2,1,36,54,22,36,6,18,3,7,9,28,54
2008-10-20 00:00:00.000,Lyon France ATP World Tour,HARD,2,Jo-Wilfried Tsonga,Fabrice Santoro,Jo-Wilfried Tsonga,6-2; 5-7; 6-3,R16,112,16,1,54,78,44,54,18,24,4,5,15,62,78,4,0,48,77,37,48,14,29,1,4,14,51,77
2008-10-20 00:00:00.000,Lyon France ATP World Tour,HARD,2,Julien Benneteau,Tommy Robredo,Julien Benneteau,6-2; 6-2,R16,70,7,4,31,49,26,31,10,18,1,1,8,36,49,5,2,40,64,25,40,6,24,9,13,8,31,64
2008-10-20 00:00:00.000,Lyon France ATP World Tour,HARD,2,Steve Darcis,Richard Gasquet,Steve Darcis,6-4; 3-6; 7-6(5),R16,115,2,0,58,86,43,58,15,28,4,7,15,58,86,17,2,66,99,55,66,11,33,3,6,16,66,99
2008-10-20 00:00:00.000,Lyon France ATP World Tour,HARD,2,Robin Soderling,Andy Roddick,Robin Soderling,7-6(5); 7-6(5),Q,84,20,6,45,74,40,45,18,29,1,1,12,58,74,22,2,58,81,46,58,13,23,4,4,12,59,81
2008-10-20 00:00:00.000,Lyon France ATP World Tour,HARD,2,Gilles Simon,Josselin Ouanna,Gilles Simon,6-3; 7-5,Q,72,7,1,34,63,27,34,20,29,0,0,11,47,63,7,1,38,58,28,38,9,20,0,2,10,37,58
2008-10-20 00:00:00.000,Lyon France ATP World Tour,HARD,2,Jo-Wilfried Tsonga,Juan Carlos Ferrero,Jo-Wilfried Tsonga,7-6(5); 6-1,Q,73,15,1,37,53,31,37,7,16,0,1,9,38,53,4,0,44,63,31,44,6,19,3,7,10,37,63
2008-10-20 00:00:00.000,Lyon France ATP World Tour,HARD,2,Julien Benneteau,Steve Darcis,Julien Benneteau,6-3; 6-2,Q,76,9,2,36,58,24,36,14,22,3,4,9,38,58,0,1,49,59,23,49,6,10,6,10,8,29,59
2008-10-20 00:00:00.000,Lyon France ATP World Tour,HARD,2,Robin Soderling,Gilles Simon,Robin Soderling,5-7; 6-3; 6-3,S,159,8,2,50,84,37,50,20,34,3,5,15,57,84,9,1,40,78,31,40,20,38,3,7,15,51,78
2008-10-20 00:00:00.000,Lyon France ATP World Tour,HARD,2,Julien Benneteau,Jo-Wilfried Tsonga,Julien Benneteau,7-6(4); 7-5,S,105,7,3,55,76,41,55,13,21,3,4,12,54,76,14,1,46,80,34,46,18,34,4,6,12,52,80
2008-10-20 00:00:00.000,Lyon France ATP World Tour,HARD,2,Robin Soderling,Julien Benneteau,Robin Soderling,6-3; 6-7(5); 6-1,F,103,10,1,64,86,53,64,13,22,3,4,15,66,86,7,3,47,75,32,47,15,28,1,5,13,47,75
2008-10-20 00:00:00.000,St. Petersburg Russia ATP World Tour,HARD,2,Andy Murray,Viktor Troicki,Andy Murray,6-3; 6-3,R32,67,4,0,26,48,24,26,13,22,1,1,9,37,48,4,2,38,57,28,38,6,19,4,7,9,34,57
2008-10-20 00:00:00.000,St. Petersburg Russia ATP World Tour,HARD,2,Ernests Gulbis,Guillermo Garcia-Lopez,Ernests Gulbis,6-0; 6-2,R32,51,11,1,29,35,25,29,4,6,0,0,7,29,35,0,2,31,47,15,31,5,16,1,6,7,20,47
2008-10-20 00:00:00.000,St. Petersburg Russia ATP World Tour,HARD,2,Janko Tipsarevic,Potito Starace,Janko Tipsarevic,6-3; 7-6(4),R32,86,12,2,37,66,34,37,16,29,1,1,11,50,66,2,2,54,73,38,54,10,19,5,6,10,48,73
2008-10-20 00:00:00.000,St. Petersburg Russia ATP World Tour,HARD,2,Jeremy Chardy,Mario Ancic,Jeremy Chardy,6-4; 3-6; 6-4,R32,115,8,4,52,77,42,52,13,25,4,6,14,55,77,12,4,49,83,39,49,16,34,4,7,15,55,83
2008-10-20 00:00:00.000,St. Petersburg Russia ATP World Tour,HARD,2,Fernando Verdasco,Teymuraz Gabashvili,Fernando Verdasco,1-6; 6-4; 6-3,R32,106,0,5,58,78,40,58,11,20,1,4,13,51,78,5,2,41,72,33,41,13,31,3,6,13,46,72
2008-10-20 00:00:00.000,St. Petersburg Russia ATP World Tour,HARD,2,Karlis Lejnieks,Alexander Kudryavtsev,Karlis Lejnieks,3-6; 7-6(1); 6-3,R32,112,14,6,75,125,55,75,21,50,10,13,16,76,125,6,3,42,72,32,42,18,30,0,2,14,50,72
2008-10-20 00:00:00.000,St. Petersburg Russia ATP World Tour,HARD,2,Rainer Schuettler,Igor Kunitsyn,Rainer Schuettler,6-2; 6-3,R32,80,2,1,35,56,22,35,14,21,2,3,9,36,56,3,2,35,49,20,35,5,14,3,7,8,25,49
2008-10-20 00:00:00.000,St. Petersburg Russia ATP World Tour,HARD,2,Dominik Hrbaty,Dmitry Tursunov,Dominik Hrbaty,6-1; 6-1,R32,56,0,1,29,46,22,29,8,17,1,2,7,30,46,2,1,46,53,20,46,2,7,5,11,7,22,53
2008-10-20 00:00:00.000,St. Petersburg Russia ATP World Tour,HARD,2,Marat Safin,Sergiy Stakhovsky,Marat Safin,6-2; 6-4,R32,68,9,1,26,59,21,26,18,33,3,4,9,39,59,1,4,38,61,25,38,7,23,3,7,9,32,61
2008-10-20 00:00:00.000,St. Petersburg Russia ATP World Tour,HARD,2,Andrey Golubev,Olivier Rochus,Andrey Golubev,6-1; 6-4,R32,69,17,0,24,52,19,24,18,28,3,4,9,37,52,1,1,28,52,17,28,11,24,7,11,8,28,52
2008-10-20 00:00:00.000,St. Petersburg Russia ATP World Tour,HARD,2,Mischa Zverev,Florent Serra,Mischa Zverev,6-4; 6-2,R32,53,1,1,33,46,28,33,8,13,0,0,9,36,46,2,2,41,54,23,41,7,13,3,6,9,30,54
2008-10-20 00:00:00.000,St. Petersburg Russia ATP World Tour,HARD,2,Mikhail Youzhny,Ivan Navarro,Mikhail Youzhny,6-2; 6-1,R32,55,3,0,24,43,22,24,12,19,3,3,8,34,43,1,1,25,44,16,25,7,19,2,6,7,23,44
2008-10-20 00:00:00.000,St. Petersburg Russia ATP World Tour,HARD,2,Mikhail Kukushkin,Marin Cilic,Mikhail Kukushkin,7-6(4); 4-6; 7-6(6),R32,177,10,5,68,114,56,68,20,46,3,6,17,76,114,19,4,72,138,54,72,37,66,8,10,17,91,138
2008-10-20 00:00:00.000,St. Petersburg Russia ATP World Tour,HARD,2,Victor Hanescu,Evgeny Korolev,Victor Hanescu,6-1; 6-2,R32,89,12,0,36,43,29,36,4,7,2,2,8,33,43,1,2,25,46,12,25,9,21,5,9,7,21,46
2008-10-20 00:00:00.000,St. Petersburg Russia ATP World Tour,HARD,2,Mikhail Elgin,Filippo Volandri,Mikhail Elgin,6-4; 6-4,R32,73,7,5,29,57,27,29,14,28,0,0,10,41,57,0,3,51,68,36,51,6,17,3,5,10,42,68
2008-10-20 00:00:00.000,St. Petersburg Russia ATP World Tour,HARD,2,Nikolay Davydenko,Chris Guccione,Nikolay Davydenko,6-4; 6-4,R32,77,4,2,26,56,22,26,20,30,0,0,10,42,56,9,3,44,65,33,44,8,21,6,8,10,41,65
2008-10-20 00:00:00.000,St. Petersburg Russia ATP World Tour,HARD,2,Andy Murray,Ernests Gulbis,Andy Murray,6-4; 6-2,R16,61,5,0,28,48,23,28,12,20,3,4,9,35,48,4,1,36,54,21,36,7,18,5,9,9,28,54
2008-10-20 00:00:00.000,St. Petersburg Russia ATP World Tour,HARD,2,Janko Tipsarevic,Jeremy Chardy,Janko Tipsarevic,6-4; 7-6(3),R16,96,11,0,40,69,33,40,16,29,3,4,11,49,69,6,2,49,67,36,49,8,18,2,4,11,44,67
2008-10-20 00:00:00.000,St. Petersburg Russia ATP World Tour,HARD,2,Fernando Verdasco,Karlis Lejnieks,Fernando Verdasco,6-1; 6-3,R16,65,2,4,27,43,24,27,10,16,1,1,8,34,43,3,1,42,59,22,42,6,17,2,6,8,28,59
2008-10-20 00:00:00.000,St. Petersburg Russia ATP World Tour,HARD,2,Rainer Schuettler,Dominik Hrbaty,Rainer Schuettler,6-3; 6-3,R16,68,1,4,30,47,27,30,10,17,1,1,9,37,47,1,1,31,52,19,31,10,21,4,7,9,29,52
2008-10-20 00:00:00.000,St. Petersburg Russia ATP World Tour,HARD,2,Andrey Golubev,Marat Safin,Andrey Golubev,6-4; 6-2,R16,74,7,4,27,51,24,27,12,24,1,2,9,36,51,5,2,33,71,19,33,18,38,6,10,9,37,71
2008-10-20 00:00:00.000,St. Petersburg Russia ATP World Tour,HARD,2,Mischa Zverev,Mikhail Youzhny,Mischa Zverev,7-5; 6-4,R16,87,5,0,50,63,34,50,8,13,4,6,11,42,63,0,3,42,65,25,42,11,23,1,5,11,36,65
2008-10-20 00:00:00.000,St. Petersburg Russia ATP World Tour,HARD,2,Victor Hanescu,Mikhail Kukushkin,Victor Hanescu,6-3; 7-6(7),R16,98,7,4,49,68,35,49,9,19,0,2,11,44,68,6,4,41,75,29,41,16,34,3,6,10,45,75
2008-10-20 00:00:00.000,St. Petersburg Russia ATP World Tour,HARD,2,Mikhail Elgin,Nikolay Davydenko,Mikhail Elgin,W/O,R16,0,0,0,0,0,0,0,0,0,0,0,0,0,0,0,0,0,0,0,0,0,0,0,0,0,0,0
2008-10-20 00:00:00.000,St. Petersburg Russia ATP World Tour,HARD,2,Andy Murray,Janko Tipsarevic,Andy Murray,7-6(5); 7-5,Q,129,9,2,47,85,35,47,19,38,5,7,12,54,85,7,4,43,87,32,43,19,44,5,8,12,51,87
2008-10-20 00:00:00.000,St. Petersburg Russia ATP World Tour,HARD,2,Fernando Verdasco,Rainer Schuettler,Fernando Verdasco,7-5; 6-2,Q,88,3,3,49,57,33,49,5,8,1,3,10,38,57,3,0,44,64,21,44,11,20,6,11,10,32,64
2008-10-20 00:00:00.000,St. Petersburg Russia ATP World Tour,HARD,2,Andrey Golubev,Mischa Zverev,Andrey Golubev,6-7(3); 6-4; 7-6(4),Q,157,6,2,71,118,54,71,24,47,8,10,17,78,118,1,1,87,112,59,87,15,25,4,7,17,74,112
2008-10-20 00:00:00.000,St. Petersburg Russia ATP World Tour,HARD,2,Victor Hanescu,Mikhail Elgin,Victor Hanescu,6-1; 6-4,Q,64,1,0,34,49,27,34,10,15,2,3,9,37,49,1,1,30,53,16,30,11,23,3,7,8,27,53
2008-10-20 00:00:00.000,St. Petersburg Russia ATP World Tour,HARD,2,Andy Murray,Fernando Verdasco,Andy Murray,6-0; 6-3,S,74,5,1,33,55,26,33,10,22,1,2,8,36,55,1,7,34,51,16,34,5,17,5,10,7,21,51
2008-10-20 00:00:00.000,St. Petersburg Russia ATP World Tour,HARD,2,Andrey Golubev,Victor Hanescu,Andrey Golubev,6-3; 6-0,S,54,2,1,27,38,20,27,8,11,0,0,7,28,38,1,1,37,46,18,37,2,9,4,9,8,20,46
2008-10-20 00:00:00.000,St. Petersburg Russia ATP World Tour,HARD,2,Andy Murray,Andrey Golubev,Andy Murray,6-1; 6-1,F,57,0,2,31,41,27,31,3,10,2,2,7,30,41,1,2,26,49,13,26,8,23,3,8,7,21,49
2008-10-26 00:00:00.000,ATP Masters Series Paris France ATP World Tour,HARD,2,Rafael Nadal,N/A Bye,Rafael Nadal,,R64,0,0,0,0,0,0,0,0,0,0,0,0,0,0,0,0,0,0,0,0,0,0,0,0,0,0,0
2008-10-26 00:00:00.000,ATP Masters Series Paris France ATP World Tour,HARD,2,Florent Serra,Guillermo Canas,Florent Serra,4-6; 7-5; 6-3,R64,124,2,3,57,92,43,57,20,35,5,7,16,63,92,14,5,42,90,36,42,23,48,9,12,15,59,90
2008-10-26 00:00:00.000,ATP Masters Series Paris France ATP World Tour,HARD,2,Juan Monaco,Marat Safin,Juan Monaco,6-0; 7-6(4),R64,79,2,0,40,59,30,40,10,19,3,4,9,40,59,7,7,36,70,25,36,12,34,7,11,9,37,70
2008-10-26 00:00:00.000,ATP Masters Series Paris France ATP World Tour,HARD,2,Gael Monfils,N/A Bye,Gael Monfils,,R64,0,0,0,0,0,0,0,0,0,0,0,0,0,0,0,0,0,0,0,0,0,0,0,0,0,0,0
2008-10-26 00:00:00.000,ATP Masters Series Paris France ATP World Tour,HARD,2,Stanislas Wawrinka,N/A Bye,Stanislas Wawrinka,,R64,0,0,0,0,0,0,0,0,0,0,0,0,0,0,0,0,0,0,0,0,0,0,0,0,0,0,0
2008-10-26 00:00:00.000,ATP Masters Series Paris France ATP World Tour,HARD,2,Tomas Berdych,Robby Ginepri,Tomas Berdych,6-4; 7-5,R64,86,6,3,45,70,32,45,14,25,6,8,11,46,70,6,3,50,81,32,50,12,31,4,8,11,44,81
2008-10-26 00:00:00.000,ATP Masters Series Paris France ATP World Tour,HARD,2,Ivan Ljubicic,Viktor Troicki,Ivan Ljubicic,6-3; 6-4,R64,72,7,3,34,54,28,34,14,20,0,0,10,42,54,3,5,41,61,30,41,6,20,4,6,9,36,61
2008-10-26 00:00:00.000,ATP Masters Series Paris France ATP World Tour,HARD,2,Nikolay Davydenko,N/A Bye,Nikolay Davydenko,,R64,0,0,0,0,0,0,0,0,0,0,0,0,0,0,0,0,0,0,0,0,0,0,0,0,0,0,0
2008-10-26 00:00:00.000,ATP Masters Series Paris France ATP World Tour,HARD,2,Andy Murray,N/A Bye,Andy Murray,,R64,0,0,0,0,0,0,0,0,0,0,0,0,0,0,0,0,0,0,0,0,0,0,0,0,0,0,0
2008-10-26 00:00:00.000,ATP Masters Series Paris France ATP World Tour,HARD,2,Sam Querrey,Marcos Baghdatis,Sam Querrey,7-5; 6-7(5); 3-2 RET,R64,107,17,1,65,87,52,65,8,22,2,3,14,60,87,9,8,45,89,38,45,22,44,2,5,15,60,89
2008-10-26 00:00:00.000,ATP Masters Series Paris France ATP World Tour,HARD,2,Tommy Robredo,Jeremy Chardy,Tommy Robredo,7-6(4); 7-6(5),R64,104,6,2,56,79,43,56,14,23,0,1,12,57,79,6,1,47,77,37,47,17,30,1,2,12,54,77
2008-10-26 00:00:00.000,ATP Masters Series Paris France ATP World Tour,HARD,2,Fernando Verdasco,N/A Bye,Fernando Verdasco,,R64,0,0,0,0,0,0,0,0,0,0,0,0,0,0,0,0,0,0,0,0,0,0,0,0,0,0,0
2008-10-26 00:00:00.000,ATP Masters Series Paris France ATP World Tour,HARD,2,Juan Martin Del Potro,N/A Bye,Juan Martin Del Potro,,R64,0,0,0,0,0,0,0,0,0,0,0,0,0,0,0,0,0,0,0,0,0,0,0,0,0,0,0
2008-10-26 00:00:00.000,ATP Masters Series Paris France ATP World Tour,HARD,2,Mario Ancic,Rainer Schuettler,Mario Ancic,6-4; 3-6; 6-1,R64,117,14,4,49,83,38,49,19,34,4,5,13,57,83,5,3,40,82,29,40,21,42,3,6,13,50,82
2008-10-26 00:00:00.000,ATP Masters Series Paris France ATP World Tour,HARD,2,Nicolas Kiefer,Ivo Karlovic,Nicolas Kiefer,6-4; 7-5,R64,80,4,1,30,48,29,30,15,18,0,0,11,44,48,12,2,47,70,32,47,12,23,2,4,11,44,70
2008-10-26 00:00:00.000,ATP Masters Series Paris France ATP World Tour,HARD,2,David Nalbandian,N/A Bye,David Nalbandian,,R64,0,0,0,0,0,0,0,0,0,0,0,0,0,0,0,0,0,0,0,0,0,0,0,0,0,0,0
2008-10-26 00:00:00.000,ATP Masters Series Paris France ATP World Tour,HARD,2,Andy Roddick,N/A Bye,Andy Roddick,,R64,0,0,0,0,0,0,0,0,0,0,0,0,0,0,0,0,0,0,0,0,0,0,0,0,0,0,0
2008-10-26 00:00:00.000,ATP Masters Series Paris France ATP World Tour,HARD,2,Feliciano Lopez,Janko Tipsarevic,Feliciano Lopez,6-3; 6-4,R64,69,11,4,33,55,30,33,11,22,2,2,10,41,55,6,1,34,52,24,34,9,18,0,2,9,33,52
2008-10-26 00:00:00.000,ATP Masters Series Paris France ATP World Tour,HARD,2,Igor Andreev,Paul-Henri Mathieu,Igor Andreev,7-6(6); 6-3,R64,87,8,1,35,66,32,35,19,31,0,0,11,51,66,3,6,41,69,30,41,14,28,2,3,10,44,69
2008-10-26 00:00:00.000,ATP Masters Series Paris France ATP World Tour,HARD,2,Gilles Simon,N/A Bye,Gilles Simon,,R64,0,0,0,0,0,0,0,0,0,0,0,0,0,0,0,0,0,0,0,0,0,0,0,0,0,0,0
2008-10-26 00:00:00.000,ATP Masters Series Paris France ATP World Tour,HARD,2,Jo-Wilfried Tsonga,N/A Bye,Jo-Wilfried Tsonga,,R64,0,0,0,0,0,0,0,0,0,0,0,0,0,0,0,0,0,0,0,0,0,0,0,0,0,0,0
2008-10-26 00:00:00.000,ATP Masters Series Paris France ATP World Tour,HARD,2,Radek Stepanek,Marc Gicquel,Radek Stepanek,6-4; 3-6; 6-4,R64,103,11,4,47,81,33,47,20,34,3,6,14,53,81,17,4,43,94,32,43,25,51,4,8,15,57,94
2008-10-26 00:00:00.000,ATP Masters Series Paris France ATP World Tour,HARD,2,Dmitry Tursunov,Adrian Mannarino,Dmitry Tursunov,6-3; 6-2,R64,78,3,4,31,49,23,31,9,18,1,2,8,32,49,3,5,36,68,26,36,8,32,5,10,9,34,68
2008-10-26 00:00:00.000,ATP Masters Series Paris France ATP World Tour,HARD,2,Novak Djokovic,N/A Bye,Novak Djokovic,,R64,0,0,0,0,0,0,0,0,0,0,0,0,0,0,0,0,0,0,0,0,0,0,0,0,0,0,0
2008-10-26 00:00:00.000,ATP Masters Series Paris France ATP World Tour,HARD,2,David Ferrer,N/A Bye,David Ferrer,,R64,0,0,0,0,0,0,0,0,0,0,0,0,0,0,0,0,0,0,0,0,0,0,0,0,0,0,0
2008-10-26 00:00:00.000,ATP Masters Series Paris France ATP World Tour,HARD,2,Philipp Kohlschreiber,Mikhail Youzhny,Philipp Kohlschreiber,6-1; 6-4,R64,77,5,1,43,64,31,43,14,21,8,8,9,45,64,0,0,29,51,18,29,10,22,2,5,8,28,51
2008-10-26 00:00:00.000,ATP Masters Series Paris France ATP World Tour,HARD,2,Simone Bolelli,Jarkko Nieminen,Simone Bolelli,7-5; 6-4,R64,90,2,0,43,62,33,43,10,19,2,3,11,43,62,7,3,46,79,31,46,17,33,5,8,11,48,79
2008-10-26 00:00:00.000,ATP Masters Series Paris France ATP World Tour,HARD,2,James Blake,N/A Bye,James Blake,,R64,0,0,0,0,0,0,0,0,0,0,0,0,0,0,0,0,0,0,0,0,0,0,0,0,0,0,0
2008-10-26 00:00:00.000,ATP Masters Series Paris France ATP World Tour,HARD,2,Marcel Granollers,N/A Bye,Marcel Granollers,,R64,0,0,0,0,0,0,0,0,0,0,0,0,0,0,0,0,0,0,0,0,0,0,0,0,0,0,0
2008-10-26 00:00:00.000,ATP Masters Series Paris France ATP World Tour,HARD,2,Marin Cilic,Andreas Seppi,Marin Cilic,7-6(5); 6-2,R64,97,8,4,37,75,29,37,18,38,4,6,10,47,75,2,7,51,85,33,51,11,34,5,9,10,44,85
2008-10-26 00:00:00.000,ATP Masters Series Paris France ATP World Tour,HARD,2,Robin Soderling,Josselin Ouanna,Robin Soderling,6-3; 6-4,R64,58,11,3,32,57,29,32,15,25,4,4,10,44,57,8,1,24,46,20,24,12,22,1,3,9,32,46
2008-10-26 00:00:00.000,ATP Masters Series Paris France ATP World Tour,HARD,2,Roger Federer,N/A Bye,Roger Federer,,R64,0,0,0,0,0,0,0,0,0,0,0,0,0,0,0,0,0,0,0,0,0,0,0,0,0,0,0
2008-10-26 00:00:00.000,ATP Masters Series Paris France ATP World Tour,HARD,2,Rafael Nadal,Florent Serra,Rafael Nadal,6-2; 6-4,R32,74,5,0,26,47,22,26,15,21,1,1,9,37,47,5,0,34,53,24,34,8,19,2,5,9,32,53
2008-10-26 00:00:00.000,ATP Masters Series Paris France ATP World Tour,HARD,2,Gael Monfils,Juan Monaco,Gael Monfils,6-4; 6-4,R32,80,12,0,26,47,24,26,9,21,1,3,10,33,47,0,1,37,65,25,37,10,28,6,10,10,35,65
2008-10-26 00:00:00.000,ATP Masters Series Paris France ATP World Tour,HARD,2,Tomas Berdych,Stanislas Wawrinka,Tomas Berdych,6-3; 7-5,R32,83,6,0,40,62,33,40,11,22,0,0,10,44,62,8,3,34,62,26,34,13,28,0,3,11,39,62
2008-10-26 00:00:00.000,ATP Masters Series Paris France ATP World Tour,HARD,2,Nikolay Davydenko,Ivan Ljubicic,Nikolay Davydenko,7-6(5); 7-5,R32,104,12,4,38,67,33,38,20,29,0,0,12,53,67,10,1,42,74,34,42,18,32,4,5,12,52,74
2008-10-26 00:00:00.000,ATP Masters Series Paris France ATP World Tour,HARD,2,Andy Murray,Sam Querrey,Andy Murray,6-2; 6-4,R32,75,8,4,42,66,27,42,12,24,5,7,9,39,66,4,5,29,57,18,29,11,28,3,8,9,29,57
2008-10-26 00:00:00.000,ATP Masters Series Paris France ATP World Tour,HARD,2,Fernando Verdasco,Tommy Robredo,Fernando Verdasco,6-2; 6-7(6); 6-2,R32,129,8,2,64,91,47,64,17,27,2,3,14,64,91,2,5,53,96,37,53,19,43,7,12,14,56,96
2008-10-26 00:00:00.000,ATP Masters Series Paris France ATP World Tour,HARD,2,Juan Martin Del Potro,Mario Ancic,Juan Martin Del Potro,6-0; 6-4,R32,78,3,0,30,50,23,30,12,20,1,1,8,35,50,5,3,27,56,21,27,8,29,3,7,8,29,56
2008-10-26 00:00:00.000,ATP Masters Series Paris France ATP World Tour,HARD,2,David Nalbandian,Nicolas Kiefer,David Nalbandian,7-6(5); 6-3,R32,127,6,2,48,90,33,48,24,42,2,3,11,57,90,8,7,46,86,34,46,16,40,4,6,10,50,86
2008-10-26 00:00:00.000,ATP Masters Series Paris France ATP World Tour,HARD,2,Andy Roddick,Feliciano Lopez,Andy Roddick,6-3; 6-4,R32,66,13,0,31,50,28,31,12,19,0,0,10,40,50,12,0,29,52,18,29,13,23,2,4,9,31,52
2008-10-26 00:00:00.000,ATP Masters Series Paris France ATP World Tour,HARD,2,Gilles Simon,Igor Andreev,Gilles Simon,6-3; 7-5,R32,90,6,0,41,71,29,41,14,30,4,7,11,43,71,1,2,34,61,21,34,9,27,7,12,10,30,61
2008-10-26 00:00:00.000,ATP Masters Series Paris France ATP World Tour,HARD,2,Jo-Wilfried Tsonga,Radek Stepanek,Jo-Wilfried Tsonga,3-6; 6-4; 6-4,R32,124,11,4,57,82,45,57,9,25,2,5,14,54,82,5,8,57,99,37,57,22,42,3,7,15,59,99
2008-10-26 00:00:00.000,ATP Masters Series Paris France ATP World Tour,HARD,2,Novak Djokovic,Dmitry Tursunov,Novak Djokovic,6-2; 4-3 RET,R32,54,8,1,26,39,21,26,7,13,0,1,8,28,39,0,1,26,44,15,26,9,18,4,7,7,24,44
2008-10-26 00:00:00.000,ATP Masters Series Paris France ATP World Tour,HARD,2,Philipp Kohlschreiber,David Ferrer,Philipp Kohlschreiber,6-3; 6-2,R32,73,2,1,48,61,39,48,4,13,6,6,9,43,61,3,1,35,56,21,35,11,21,1,4,8,32,56
2008-10-26 00:00:00.000,ATP Masters Series Paris France ATP World Tour,HARD,2,James Blake,Simone Bolelli,James Blake,6-7(10); 6-3; 6-4,R32,119,17,3,64,102,52,64,21,38,1,2,16,73,102,13,1,54,90,38,54,21,36,1,4,15,59,90
2008-10-26 00:00:00.000,ATP Masters Series Paris France ATP World Tour,HARD,2,Marin Cilic,Marcel Granollers,Marin Cilic,6-4; 7-6(2),R32,96,11,3,34,66,31,34,15,32,0,1,11,46,66,5,2,54,83,36,54,12,29,3,5,11,48,83
2008-10-26 00:00:00.000,ATP Masters Series Paris France ATP World Tour,HARD,2,Roger Federer,Robin Soderling,Roger Federer,6-4; 7-6(7),R32,75,10,0,42,60,38,42,12,18,0,0,11,50,60,5,1,44,68,34,44,13,24,1,2,11,47,68
2008-10-26 00:00:00.000,ATP Masters Series Paris France ATP World Tour,HARD,2,Rafael Nadal,Gael Monfils,Rafael Nadal,6-3; 6-2,R16,91,0,0,35,61,26,35,17,26,9,9,9,43,61,4,2,20,47,13,20,15,27,1,4,8,28,47
2008-10-26 00:00:00.000,ATP Masters Series Paris France ATP World Tour,HARD,2,Nikolay Davydenko,Tomas Berdych,Nikolay Davydenko,6-1; 6-1,R16,64,3,1,30,44,26,30,6,14,5,5,7,32,44,0,3,24,49,11,24,9,25,4,9,7,20,49
2008-10-26 00:00:00.000,ATP Masters Series Paris France ATP World Tour,HARD,2,Andy Murray,Fernando Verdasco,Andy Murray,6-3; 7-6(6),R16,82,10,3,40,62,36,40,14,22,0,0,11,50,62,8,6,37,63,31,37,14,26,0,1,10,45,63
2008-10-26 00:00:00.000,ATP Masters Series Paris France ATP World Tour,HARD,2,David Nalbandian,Juan Martin Del Potro,David Nalbandian,6-4; 6-0,R16,66,6,2,30,47,25,30,8,17,1,2,8,33,47,5,2,30,52,17,30,6,22,6,11,8,23,52
2008-10-26 00:00:00.000,ATP Masters Series Paris France ATP World Tour,HARD,2,Andy Roddick,Gilles Simon,Andy Roddick,6-3; 7-5,R16,78,15,3,36,58,32,36,12,22,4,4,10,44,58,5,1,41,74,29,41,17,33,5,8,11,46,74
2008-10-26 00:00:00.000,ATP Masters Series Paris France ATP World Tour,HARD,2,Jo-Wilfried Tsonga,Novak Djokovic,Jo-Wilfried Tsonga,6-4; 1-6; 6-3,R16,114,5,4,46,82,37,46,18,36,7,9,13,55,82,5,1,52,79,33,52,19,27,7,9,13,52,79
2008-10-26 00:00:00.000,ATP Masters Series Paris France ATP World Tour,HARD,2,James Blake,Philipp Kohlschreiber,James Blake,6-4; 6-4,R16,69,7,1,46,65,36,46,9,19,4,4,10,45,65,3,3,33,54,26,33,10,21,3,5,10,36,54
2008-10-26 00:00:00.000,ATP Masters Series Paris France ATP World Tour,HARD,2,Roger Federer,Marin Cilic,Roger Federer,6-3; 6-4,R16,71,4,0,37,61,26,37,16,24,1,2,10,42,61,7,3,34,59,24,34,9,25,3,6,9,33,59
2008-10-26 00:00:00.000,ATP Masters Series Paris France ATP World Tour,HARD,2,Nikolay Davydenko,Rafael Nadal,Nikolay Davydenko,6-1 RET,Q,48,0,0,14,27,9,14,8,13,3,3,3,17,27,0,1,19,33,10,19,4,14,5,8,4,14,33
2008-10-26 00:00:00.000,ATP Masters Series Paris France ATP World Tour,HARD,2,David Nalbandian,Andy Murray,David Nalbandian,7-6(3); 6-3,Q,104,2,2,35,60,27,35,10,25,3,6,10,37,60,11,4,39,83,28,39,16,44,8,13,11,44,83
2008-10-26 00:00:00.000,ATP Masters Series Paris France ATP World Tour,HARD,2,Jo-Wilfried Tsonga,Andy Roddick,Jo-Wilfried Tsonga,5-7; 6-4; 7-6(5),Q,166,15,6,91,144,61,91,25,53,14,17,17,86,144,14,0,66,99,51,66,17,33,2,5,17,68,99
2008-10-26 00:00:00.000,ATP Masters Series Paris France ATP World Tour,HARD,2,James Blake,Roger Federer,James Blake,W/O,Q,0,0,0,0,0,0,0,0,0,0,0,0,0,0,0,0,0,0,0,0,0,0,0,0,0,0,0
2008-10-26 00:00:00.000,ATP Masters Series Paris France ATP World Tour,HARD,2,David Nalbandian,Nikolay Davydenko,David Nalbandian,6-1; 5-7; 6-4,S,125,3,1,50,85,38,50,20,35,4,6,15,58,85,7,3,41,79,29,41,19,38,4,8,14,48,79
2008-10-26 00:00:00.000,ATP Masters Series Paris France ATP World Tour,HARD,2,Jo-Wilfried Tsonga,James Blake,Jo-Wilfried Tsonga,6-4; 6-3,S,67,12,1,28,44,25,28,11,16,0,0,9,36,44,4,1,43,66,30,43,8,23,4,7,10,38,66
2008-10-26 00:00:00.000,ATP Masters Series Paris France ATP World Tour,HARD,2,Jo-Wilfried Tsonga,David Nalbandian,Jo-Wilfried Tsonga,6-3; 4-6; 6-4,F,120,25,1,57,89,47,57,15,32,8,9,15,62,89,4,4,55,88,41,55,16,33,2,4,14,57,88
2009-01-04 00:00:00.000,Brisbane Australia ATP World Tour 250,HARD,2,Ernests Gulbis,Novak Djokovic,Ernests Gulbis,6-4; 6-4,R32,90,4,2,38,61,28,38,11,23,2,4,10,39,61,3,4,31,65,21,31,14,34,9,13,10,35,65
2009-01-04 00:00:00.000,Brisbane Australia ATP World Tour 250,HARD,2,Paul-Henri Mathieu,Teymuraz Gabashvili,Paul-Henri Mathieu,6-3; 6-3,R32,73,9,2,28,48,26,28,9,20,2,3,9,35,48,3,4,25,50,17,25,10,25,5,9,9,27,50
2009-01-04 00:00:00.000,Brisbane Australia ATP World Tour 250,HARD,2,Kei Nishikori,Bobby Reynolds,Kei Nishikori,6-3; 6-2,R32,59,5,4,23,45,19,23,14,22,0,1,9,33,45,5,1,29,53,18,29,8,24,4,8,8,26,53
2009-01-04 00:00:00.000,Brisbane Australia ATP World Tour 250,HARD,2,Tomas Berdych,Brydan Klein,Tomas Berdych,6-0; 6-4,R32,67,5,2,33,50,28,33,6,17,4,5,8,34,50,0,2,27,51,15,27,7,24,3,8,8,22,51
2009-01-04 00:00:00.000,Brisbane Australia ATP World Tour 250,HARD,2,Fernando Verdasco,Bernard Tomic,Fernando Verdasco,6-4; 6-2,R32,65,1,2,39,50,31,39,5,11,3,4,9,36,50,3,1,34,56,19,34,9,22,9,13,9,28,56
2009-01-04 00:00:00.000,Brisbane Australia ATP World Tour 250,HARD,2,Mario Ancic,Amer Delic,Mario Ancic,7-6(2); 6-7(4); 7-6(6),R32,172,23,3,72,122,56,72,32,50,2,2,18,88,122,21,3,87,129,63,87,26,42,3,3,18,89,129
2009-01-04 00:00:00.000,Brisbane Australia ATP World Tour 250,HARD,2,Florent Serra,Juan Carlos Ferrero,Florent Serra,6-3; 7-6(3),R32,84,6,2,47,77,39,47,15,30,2,3,11,54,77,7,2,41,67,31,41,11,26,8,10,10,42,67
2009-01-04 00:00:00.000,Brisbane Australia ATP World Tour 250,HARD,2,Jurgen Melzer,Mardy Fish,Jurgen Melzer,6-4; 4-6; 7-6(4),R32,143,12,4,74,114,59,74,16,40,8,10,16,75,114,20,2,53,106,41,53,30,53,8,10,16,71,106
2009-01-04 00:00:00.000,Brisbane Australia ATP World Tour 250,HARD,2,Radek Stepanek,Igor Kunitsyn,Radek Stepanek,6-2; 6-2,R32,66,6,1,23,43,19,23,13,20,0,0,8,32,43,1,2,27,47,18,27,6,20,7,11,8,24,47
2009-01-04 00:00:00.000,Brisbane Australia ATP World Tour 250,HARD,2,Michael Llodra,Joseph Sirianni,Michael Llodra,5-7; 7-6(3); 6-2,R32,145,13,3,70,101,57,70,12,31,3,5,16,69,101,9,0,41,94,31,41,28,53,4,7,16,59,94
2009-01-04 00:00:00.000,Brisbane Australia ATP World Tour 250,HARD,2,Julien Benneteau,Robby Ginepri,Julien Benneteau,3-6; 6-3; 7-5,R32,127,10,9,62,99,41,62,17,37,2,6,15,58,99,8,2,53,88,32,53,21,35,4,9,15,53,88
2009-01-04 00:00:00.000,Brisbane Australia ATP World Tour 250,HARD,2,Robin Soderling,Sam Querrey,Robin Soderling,6-3; 6-3,R32,55,7,2,30,52,26,30,13,22,0,0,9,39,52,4,3,27,49,20,27,9,22,2,5,9,29,49
2009-01-04 00:00:00.000,Brisbane Australia ATP World Tour 250,HARD,2,Richard Gasquet,Marc Gicquel,Richard Gasquet,4-6; 6-2; 6-2,R32,133,6,5,42,91,29,42,26,49,3,5,13,55,91,7,6,45,100,30,45,23,55,13,18,13,53,100
2009-01-04 00:00:00.000,Brisbane Australia ATP World Tour 250,HARD,2,Taylor Dent,Steve Darcis,Taylor Dent,7-6(0); 6-2,R32,86,8,5,37,68,31,37,13,31,6,8,10,44,68,4,2,46,70,24,46,14,24,1,5,10,38,70
2009-01-04 00:00:00.000,Brisbane Australia ATP World Tour 250,HARD,2,Jarkko Nieminen,Marcos Baghdatis,Jarkko Nieminen,5-7; 6-1; 6-4,R32,124,2,2,64,89,42,64,15,25,2,5,15,57,89,5,11,45,91,34,45,18,46,6,11,14,52,91
2009-01-04 00:00:00.000,Brisbane Australia ATP World Tour 250,HARD,2,Jo-Wilfried Tsonga,Agustin Calleri,Jo-Wilfried Tsonga,6-2; 7-5,R32,93,3,1,38,56,28,38,12,18,0,1,10,40,56,2,7,41,82,24,41,20,41,7,11,10,44,82
2009-01-04 00:00:00.000,Brisbane Australia ATP World Tour 250,HARD,2,Paul-Henri Mathieu,Ernests Gulbis,Paul-Henri Mathieu,6-3; 6-4,R16,81,6,3,28,61,22,28,23,33,4,4,10,45,61,9,1,34,49,26,34,6,15,1,3,9,32,49
2009-01-04 00:00:00.000,Brisbane Australia ATP World Tour 250,HARD,2,Kei Nishikori,Tomas Berdych,Kei Nishikori,7-6(7); 6-3,R16,100,5,1,39,72,30,39,21,33,4,5,11,51,72,6,1,44,72,29,44,16,28,2,4,10,45,72
2009-01-04 00:00:00.000,Brisbane Australia ATP World Tour 250,HARD,2,Fernando Verdasco,Mario Ancic,Fernando Verdasco,6-2; 6-3,R16,79,6,1,39,53,33,39,8,14,5,5,9,41,53,2,0,33,55,20,33,11,22,2,5,8,31,55
2009-01-04 00:00:00.000,Brisbane Australia ATP World Tour 250,HARD,2,Florent Serra,Jurgen Melzer,Florent Serra,6-4; 6-3,R16,71,4,2,32,63,21,32,20,31,4,5,10,41,63,7,3,28,53,20,28,11,25,1,4,9,31,53
2009-01-04 00:00:00.000,Brisbane Australia ATP World Tour 250,HARD,2,Radek Stepanek,Michael Llodra,Radek Stepanek,7-6(2); 6-3,R16,93,6,3,38,71,35,38,18,33,2,2,11,53,71,5,3,43,67,33,43,10,24,3,4,10,43,67
2009-01-04 00:00:00.000,Brisbane Australia ATP World Tour 250,HARD,2,Robin Soderling,Julien Benneteau,Robin Soderling,6-3; 6-3,R16,66,6,1,25,48,21,25,14,23,3,4,9,35,48,4,2,36,55,20,36,8,19,2,6,9,28,55
2009-01-04 00:00:00.000,Brisbane Australia ATP World Tour 250,HARD,2,Richard Gasquet,Taylor Dent,Richard Gasquet,7-5; 6-4,R16,80,9,2,39,60,32,39,11,21,4,5,11,43,60,4,7,41,70,31,41,10,29,2,5,11,41,70
2009-01-04 00:00:00.000,Brisbane Australia ATP World Tour 250,HARD,2,Jo-Wilfried Tsonga,Jarkko Nieminen,Jo-Wilfried Tsonga,0-6; 7-6(1); 7-6(5),R16,135,9,2,62,95,45,62,15,33,1,5,15,60,95,0,0,69,101,44,69,19,32,5,6,15,63,101
2009-01-04 00:00:00.000,Brisbane Australia ATP World Tour 250,HARD,2,Paul-Henri Mathieu,Kei Nishikori,Paul-Henri Mathieu,6-3; 6-4,Q,87,6,3,43,63,29,43,13,20,4,5,10,42,63,4,4,34,64,21,34,16,30,2,5,9,37,64
2009-01-04 00:00:00.000,Brisbane Australia ATP World Tour 250,HARD,2,Fernando Verdasco,Florent Serra,Fernando Verdasco,4-6; 6-0; 6-3,Q,114,7,2,66,79,49,66,7,13,6,7,13,56,79,3,4,56,85,34,56,13,29,5,9,12,47,85
2009-01-04 00:00:00.000,Brisbane Australia ATP World Tour 250,HARD,2,Radek Stepanek,Robin Soderling,Radek Stepanek,2-6; 6-4; 6-3,Q,106,6,4,38,72,31,38,14,34,2,7,14,45,72,9,4,43,78,30,43,13,35,8,13,13,43,78
2009-01-04 00:00:00.000,Brisbane Australia ATP World Tour 250,HARD,2,Richard Gasquet,Jo-Wilfried Tsonga,Richard Gasquet,1-6; 6-4; 6-2,Q,98,3,3,37,68,30,37,17,31,3,5,12,47,68,8,4,45,76,35,45,13,31,3,6,13,48,76
2009-01-04 00:00:00.000,Brisbane Australia ATP World Tour 250,HARD,2,Fernando Verdasco,Paul-Henri Mathieu,Fernando Verdasco,6-2; 6-1,S,76,4,2,38,50,28,38,5,12,3,4,8,33,50,0,3,32,60,19,32,7,28,3,8,7,26,60
2009-01-04 00:00:00.000,Brisbane Australia ATP World Tour 250,HARD,2,Radek Stepanek,Richard Gasquet,Radek Stepanek,2-6; 6-2; 6-4,S,132,5,1,48,78,31,48,15,30,5,9,13,46,78,6,5,61,111,37,61,22,50,14,19,13,59,111
2009-01-04 00:00:00.000,Brisbane Australia ATP World Tour 250,HARD,2,Radek Stepanek,Fernando Verdasco,Radek Stepanek,3-6; 6-3; 6-4,F,138,3,1,41,81,31,41,25,40,6,8,14,56,81,1,1,75,87,48,75,5,12,2,5,14,53,87
2009-01-05 00:00:00.000,Chennai India ATP World Tour 250,HARD,2,Nikolay Davydenko,Daniel Koellerer,Nikolay Davydenko,6-2; 6-3,R32,71,8,0,31,48,25,31,11,17,0,0,9,36,48,0,1,27,49,16,27,13,22,6,9,8,29,49
2009-01-05 00:00:00.000,Chennai India ATP World Tour 250,HARD,2,Lukas Dlouhy,Go Soeda,Lukas Dlouhy,3-6; 6-2; 6-4,R32,114,6,5,57,83,38,57,13,26,4,7,14,51,83,1,1,61,98,37,61,18,37,10,14,13,55,98
2009-01-05 00:00:00.000,Chennai India ATP World Tour 250,HARD,2,Andreas Beck,Roko Karanusic,Andreas Beck,6-1; 6-0,R32,39,3,0,25,31,19,25,5,6,0,0,6,24,31,2,4,36,45,16,36,1,9,3,9,7,17,45
2009-01-05 00:00:00.000,Chennai India ATP World Tour 250,HARD,2,Marcel Granollers,Hyung-Taik Lee,Marcel Granollers,6-4; 7-5,R32,113,7,4,37,74,26,37,20,37,4,6,11,46,74,0,3,45,81,27,45,18,36,7,11,11,45,81
2009-01-05 00:00:00.000,Chennai India ATP World Tour 250,HARD,2,Marin Cilic,Alberto Martin,Marin Cilic,6-4; 6-4,R32,92,4,3,35,69,27,35,20,34,5,5,10,47,69,0,3,36,63,23,36,17,27,1,3,10,40,63
2009-01-05 00:00:00.000,Chennai India ATP World Tour 250,HARD,2,Denis Istomin,Rohan Bopanna,Denis Istomin,6-4; 7-6(3),R32,86,3,1,50,70,39,50,12,20,2,3,11,51,70,9,2,41,77,30,41,17,36,2,4,11,47,77
2009-01-05 00:00:00.000,Chennai India ATP World Tour 250,HARD,2,Dudi Sela,Ruben Ramirez Hidalgo,Dudi Sela,4-6; 7-6(3); 6-1,R32,144,4,1,50,81,38,50,14,31,4,8,14,52,81,5,9,70,121,43,70,21,51,11,17,15,64,121
2009-01-05 00:00:00.000,Chennai India ATP World Tour 250,HARD,2,Janko Tipsarevic,Pablo Andujar,Janko Tipsarevic,6-3; 6-2,R32,80,4,0,34,57,25,34,12,23,1,2,9,37,57,3,5,41,55,23,41,6,14,2,6,8,29,55
2009-01-05 00:00:00.000,Chennai India ATP World Tour 250,HARD,2,Carlos Moya,Danai Udomchoke,Carlos Moya,6-3; 7-6(4),R32,81,5,0,41,64,31,41,16,23,0,1,11,47,64,2,5,40,65,30,40,10,25,4,6,10,40,65
2009-01-05 00:00:00.000,Chennai India ATP World Tour 250,HARD,2,Somdev Devvarman,Kevin Kim,Somdev Devvarman,6-3; 6-3,R32,75,10,3,34,57,23,34,14,23,2,3,9,37,57,0,1,33,60,22,33,10,27,4,8,9,32,60
2009-01-05 00:00:00.000,Chennai India ATP World Tour 250,HARD,2,Ivo Minar,Wayne Odesnik,Ivo Minar,6-3; 6-0,R32,60,4,3,25,44,20,25,10,19,1,2,7,30,44,1,1,36,54,16,36,5,18,2,8,8,21,54
2009-01-05 00:00:00.000,Chennai India ATP World Tour 250,HARD,2,Ivo Karlovic,Rajeev Ram,Ivo Karlovic,6-4; 6-3,R32,66,10,1,29,46,27,29,13,17,0,0,10,40,46,0,2,34,55,25,34,10,21,6,8,9,35,55
2009-01-05 00:00:00.000,Chennai India ATP World Tour 250,HARD,2,Rainer Schuettler,Prakash Amritraj,Rainer Schuettler,6-2; 4-6; 6-1,R32,85,3,2,42,68,32,42,18,26,1,2,13,50,68,2,0,45,61,27,45,9,16,1,5,12,36,61
2009-01-05 00:00:00.000,Chennai India ATP World Tour 250,HARD,2,Simon Greul,Daniel Gimeno-Traver,Simon Greul,6-3; 6-4,R32,68,5,3,33,58,28,33,15,25,1,1,10,43,58,0,1,34,48,22,34,8,14,0,2,9,30,48
2009-01-05 00:00:00.000,Chennai India ATP World Tour 250,HARD,2,Bjorn Phau,Santiago Ventura,Bjorn Phau,6-2; 7-5,R32,80,5,2,30,64,22,30,19,34,3,5,10,41,64,2,7,31,56,19,31,7,25,1,6,10,26,56
2009-01-05 00:00:00.000,Chennai India ATP World Tour 250,HARD,2,Flavio Cipolla,Stanislas Wawrinka,Flavio Cipolla,6-4; 6-1,R32,94,0,3,57,72,39,57,7,15,6,7,9,46,72,3,3,25,53,16,25,12,28,5,9,8,28,53
2009-01-05 00:00:00.000,Chennai India ATP World Tour 250,HARD,2,Lukas Dlouhy,Nikolay Davydenko,Lukas Dlouhy,W/O,R16,0,0,0,0,0,0,0,0,0,0,0,0,0,0,0,0,0,0,0,0,0,0,0,0,0,0,0
2009-01-05 00:00:00.000,Chennai India ATP World Tour 250,HARD,2,Marcel Granollers,Andreas Beck,Marcel Granollers,6-4; 6-1,R16,60,7,2,28,49,23,28,10,21,3,4,8,33,49,1,6,40,70,23,40,11,30,10,15,9,34,70
2009-01-05 00:00:00.000,Chennai India ATP World Tour 250,HARD,2,Marin Cilic,Denis Istomin,Marin Cilic,6-0; 6-4,R16,64,5,4,23,41,21,23,11,18,0,0,8,32,41,2,1,44,60,23,44,8,16,5,9,8,31,60
2009-01-05 00:00:00.000,Chennai India ATP World Tour 250,HARD,2,Janko Tipsarevic,Dudi Sela,Janko Tipsarevic,7-6(3); 6-4,R16,124,6,4,45,85,36,45,19,40,4,5,11,55,85,3,1,38,67,27,38,16,29,3,5,11,43,67
2009-01-05 00:00:00.000,Chennai India ATP World Tour 250,HARD,2,Somdev Devvarman,Carlos Moya,Somdev Devvarman,4-6; 7-5; 6-4,R16,134,10,2,54,93,43,54,22,39,6,8,16,65,93,3,4,56,96,45,56,19,40,7,10,16,64,96
2009-01-05 00:00:00.000,Chennai India ATP World Tour 250,HARD,2,Ivo Karlovic,Ivo Minar,Ivo Karlovic,6-1; 6-4,R16,53,16,0,26,46,23,26,14,20,2,2,9,37,46,3,1,29,39,21,29,3,10,2,5,8,24,39
2009-01-05 00:00:00.000,Chennai India ATP World Tour 250,HARD,2,Rainer Schuettler,Simon Greul,Rainer Schuettler,6-4; 6-2,R16,82,3,2,39,56,28,39,11,17,5,6,9,39,56,1,2,33,59,20,33,10,26,0,4,9,30,59
2009-01-05 00:00:00.000,Chennai India ATP World Tour 250,HARD,2,Bjorn Phau,Flavio Cipolla,Bjorn Phau,6-1; 6-2,R16,49,5,2,24,41,19,24,13,17,0,0,8,32,41,0,3,30,37,15,30,3,7,2,6,7,18,37
2009-01-05 00:00:00.000,Chennai India ATP World Tour 250,HARD,2,Marcel Granollers,Lukas Dlouhy,Marcel Granollers,7-5; 2-6; 6-4,Q,120,3,3,45,88,37,45,19,43,0,3,15,56,88,3,5,56,90,41,56,17,34,4,7,15,58,90
2009-01-05 00:00:00.000,Chennai India ATP World Tour 250,HARD,2,Marin Cilic,Janko Tipsarevic,Marin Cilic,6-4; 0-6; 6-4,Q,121,10,4,50,86,39,50,16,36,9,12,13,55,86,1,3,55,81,39,55,15,26,2,4,13,54,81
2009-01-05 00:00:00.000,Chennai India ATP World Tour 250,HARD,2,Somdev Devvarman,Ivo Karlovic,Somdev Devvarman,7-6(4); 6-4,Q,86,7,1,47,66,37,47,14,19,0,0,11,51,66,10,0,45,60,39,45,8,15,1,2,11,47,60
2009-01-05 00:00:00.000,Chennai India ATP World Tour 250,HARD,2,Rainer Schuettler,Bjorn Phau,Rainer Schuettler,6-2; 7-5,Q,97,3,3,51,68,28,51,9,17,3,6,10,37,68,2,0,30,65,17,30,14,35,3,9,10,31,65
2009-01-05 00:00:00.000,Chennai India ATP World Tour 250,HARD,2,Marin Cilic,Marcel Granollers,Marin Cilic,6-4; 6-3,S,72,6,1,25,44,21,25,12,19,0,1,9,33,44,2,0,37,59,23,37,11,22,1,5,10,34,59
2009-01-05 00:00:00.000,Chennai India ATP World Tour 250,HARD,2,Somdev Devvarman,Rainer Schuettler,Somdev Devvarman,W/O,S,0,0,0,0,0,0,0,0,0,0,0,0,0,0,0,0,0,0,0,0,0,0,0,0,0,0,0
2009-01-05 00:00:00.000,Chennai India ATP World Tour 250,HARD,2,Marin Cilic,Somdev Devvarman,Marin Cilic,6-4; 7-6(3),F,120,9,1,42,81,31,42,23,39,9,10,11,54,81,1,3,41,71,31,41,13,30,2,4,11,44,71
2009-01-05 00:00:00.000,Doha Qatar ATP World Tour 250,HARD,2,Rafael Nadal,Fabrice Santoro,Rafael Nadal,6-0; 6-1,R32,47,1,0,20,27,19,20,5,7,0,0,6,24,27,2,1,19,39,8,19,4,20,3,9,7,12,39
2009-01-05 00:00:00.000,Doha Qatar ATP World Tour 250,HARD,2,Karol Beck,Michal Przysiezny,Karol Beck,4-6; 6-4; 7-5,R32,128,3,4,55,90,45,55,20,35,1,3,16,65,90,9,1,57,96,41,57,22,39,4,7,16,63,96
2009-01-05 00:00:00.000,Doha Qatar ATP World Tour 250,HARD,2,Nicolas Devilder,Abdulla Hajji,Nicolas Devilder,6-0; 6-3,R32,46,6,1,18,31,17,18,11,13,0,0,7,28,31,0,0,35,54,19,35,4,19,2,7,8,23,54
2009-01-05 00:00:00.000,Doha Qatar ATP World Tour 250,HARD,2,Gael Monfils,Jan Hernych,Gael Monfils,6-2; 6-2,R32,55,9,2,35,50,27,35,6,15,2,3,8,33,50,1,2,26,41,15,26,2,15,1,6,8,17,41
2009-01-05 00:00:00.000,Doha Qatar ATP World Tour 250,HARD,2,Andy Roddick,Ivan Navarro,Andy Roddick,6-1; 6-3,R32,62,8,0,34,46,26,34,9,12,1,1,8,35,46,3,8,20,52,16,20,10,32,6,10,8,26,52
2009-01-05 00:00:00.000,Doha Qatar ATP World Tour 250,HARD,2,Arnaud Clement,Diego Junqueira,Arnaud Clement,6-1; 6-2,R32,69,4,1,34,46,28,34,6,12,1,1,8,34,46,0,0,34,56,20,34,7,22,5,9,7,27,56
2009-01-05 00:00:00.000,Doha Qatar ATP World Tour 250,HARD,2,Victor Hanescu,Viktor Troicki,Victor Hanescu,6-4; 6-2,R32,70,1,1,37,49,28,37,8,12,3,4,9,36,49,8,3,33,58,20,33,11,25,7,11,9,31,58
2009-01-05 00:00:00.000,Doha Qatar ATP World Tour 250,HARD,2,Mikhail Youzhny,Igor Andreev,Mikhail Youzhny,4-6; 6-3; 6-4,R32,121,4,0,64,86,43,64,16,22,1,3,15,59,86,2,4,46,85,36,46,18,39,5,8,14,54,85
2009-01-05 00:00:00.000,Doha Qatar ATP World Tour 250,HARD,2,Alexander Peya,Dmitry Tursunov,Alexander Peya,2-6; 6-3; 6-4,R32,115,4,5,60,101,45,60,19,41,8,10,14,64,101,8,3,53,90,33,53,23,37,8,10,13,56,90
2009-01-05 00:00:00.000,Doha Qatar ATP World Tour 250,HARD,2,Sergiy Stakhovsky,Christophe Rochus,Sergiy Stakhovsky,2-6; 6-3; 7-6(3),R32,126,14,4,63,95,47,63,15,32,1,4,15,62,95,0,7,53,97,39,53,21,44,3,5,14,60,97
2009-01-05 00:00:00.000,Doha Qatar ATP World Tour 250,HARD,2,Philipp Petzschner,Jeremy Chardy,Philipp Petzschner,7-6(2); 6-3,R32,88,4,3,35,64,31,35,18,29,5,6,11,49,64,5,2,48,70,30,48,12,22,2,4,10,42,70
2009-01-05 00:00:00.000,Doha Qatar ATP World Tour 250,HARD,2,Andy Murray,Albert Montanes,Andy Murray,6-2; 6-4,R32,75,3,3,35,59,27,35,12,24,4,5,9,39,59,3,5,40,71,26,40,13,31,11,15,9,39,71
2009-01-05 00:00:00.000,Doha Qatar ATP World Tour 250,HARD,2,Philipp Kohlschreiber,Marco Chiudinelli,Philipp Kohlschreiber,6-4; 6-3,R32,75,3,0,38,51,27,38,11,13,0,0,9,38,51,3,2,41,59,26,41,12,18,1,4,10,38,59
2009-01-05 00:00:00.000,Doha Qatar ATP World Tour 250,HARD,2,Kristof Vliegen,Oscar Hernandez,Kristof Vliegen,6-1; 6-7(4); 7-6(5),R32,158,7,1,69,107,50,69,21,38,7,9,16,71,107,2,4,78,120,48,78,23,42,10,14,15,71,120
2009-01-05 00:00:00.000,Doha Qatar ATP World Tour 250,HARD,2,Andreas Seppi,Denis Gremelmayr,Andreas Seppi,6-4; 6-2,R32,69,0,1,40,57,31,40,6,17,2,4,9,37,57,1,2,32,61,18,32,12,29,8,13,9,30,61
2009-01-05 00:00:00.000,Doha Qatar ATP World Tour 250,HARD,2,Roger Federer,Potito Starace,Roger Federer,6-2; 6-2,R32,49,5,1,25,39,22,25,10,14,0,0,8,32,39,4,1,33,49,20,33,5,16,1,5,8,25,49
2009-01-05 00:00:00.000,Doha Qatar ATP World Tour 250,HARD,2,Rafael Nadal,Karol Beck,Rafael Nadal,6-1; 6-2,R16,61,2,3,20,35,18,20,8,15,1,2,7,26,35,1,2,33,49,14,33,5,16,3,9,8,19,49
2009-01-05 00:00:00.000,Doha Qatar ATP World Tour 250,HARD,2,Gael Monfils,Nicolas Devilder,Gael Monfils,7-5; 7-6(4),R16,127,9,0,48,79,36,48,16,31,2,4,12,52,79,0,2,70,112,45,70,18,42,10,13,12,63,112
2009-01-05 00:00:00.000,Doha Qatar ATP World Tour 250,HARD,2,Andy Roddick,Arnaud Clement,Andy Roddick,6-3; 7-5,R16,103,11,0,41,59,31,41,11,18,3,5,11,42,59,3,0,42,77,20,42,20,35,5,9,10,40,77
2009-01-05 00:00:00.000,Doha Qatar ATP World Tour 250,HARD,2,Victor Hanescu,Mikhail Youzhny,Victor Hanescu,6-2; 6-4,R16,90,3,0,31,45,23,31,13,14,0,0,9,36,45,3,1,60,83,36,60,10,23,5,8,9,46,83
2009-01-05 00:00:00.000,Doha Qatar ATP World Tour 250,HARD,2,Sergiy Stakhovsky,Alexander Peya,Sergiy Stakhovsky,7-5; 6-3,R16,86,6,1,46,65,34,46,10,19,1,2,11,44,65,2,2,40,72,25,40,15,32,4,7,10,40,72
2009-01-05 00:00:00.000,Doha Qatar ATP World Tour 250,HARD,2,Andy Murray,Philipp Petzschner,Andy Murray,6-2; 6-4,R16,71,6,0,31,43,27,31,9,12,0,0,9,36,43,3,3,36,65,24,36,12,29,5,8,9,36,65
2009-01-05 00:00:00.000,Doha Qatar ATP World Tour 250,HARD,2,Philipp Kohlschreiber,Kristof Vliegen,Philipp Kohlschreiber,6-4; 6-7(4); 6-4,R16,139,8,1,70,105,52,70,21,35,4,6,16,73,105,6,2,68,105,49,68,15,37,4,8,16,64,105
2009-01-05 00:00:00.000,Doha Qatar ATP World Tour 250,HARD,2,Roger Federer,Andreas Seppi,Roger Federer,6-3; 6-3,R16,80,4,2,38,66,27,38,16,28,3,4,9,43,66,0,3,40,65,25,40,10,25,6,10,9,35,65
2009-01-05 00:00:00.000,Doha Qatar ATP World Tour 250,HARD,2,Gael Monfils,Rafael Nadal,Gael Monfils,6-4; 6-4,Q,89,7,0,40,57,33,40,6,17,0,1,10,39,57,0,2,46,63,29,46,7,17,4,7,10,36,63
2009-01-05 00:00:00.000,Doha Qatar ATP World Tour 250,HARD,2,Andy Roddick,Victor Hanescu,Andy Roddick,6-3; 6-2,Q,67,13,0,42,50,32,42,6,8,1,1,9,38,50,5,1,46,61,26,46,7,15,9,12,8,33,61
2009-01-05 00:00:00.000,Doha Qatar ATP World Tour 250,HARD,2,Andy Murray,Sergiy Stakhovsky,Andy Murray,6-4; 6-2,Q,76,4,0,32,53,23,32,11,21,2,4,9,34,53,1,2,34,59,19,34,8,25,4,9,9,27,59
2009-01-05 00:00:00.000,Doha Qatar ATP World Tour 250,HARD,2,Roger Federer,Philipp Kohlschreiber,Roger Federer,6-2; 7-6(6),Q,86,4,0,42,60,29,42,11,18,1,3,10,40,60,1,2,54,74,33,54,6,20,3,7,10,39,74
2009-01-05 00:00:00.000,Doha Qatar ATP World Tour 250,HARD,2,Andy Roddick,Gael Monfils,Andy Roddick,7-6(1); 3-6; 6-3,S,122,8,1,69,94,55,69,8,25,5,8,15,63,94,11,2,57,86,42,57,15,29,2,5,15,57,86
2009-01-05 00:00:00.000,Doha Qatar ATP World Tour 250,HARD,2,Andy Murray,Roger Federer,Andy Murray,6-7(6); 6-2; 6-2,S,125,7,1,57,87,49,57,15,30,3,3,14,64,87,7,4,61,95,42,61,18,34,2,6,14,60,95
2009-01-05 00:00:00.000,Doha Qatar ATP World Tour 250,HARD,2,Andy Murray,Andy Roddick,Andy Murray,6-4; 6-2,F,71,5,1,35,50,28,35,9,15,1,1,9,37,50,3,0,32,46,21,32,6,14,0,3,9,27,46
2009-01-12 00:00:00.000,Auckland New Zealand ATP World Tour 250,HARD,2,Juan Martin Del Potro,N/A Bye,Juan Martin Del Potro,,R32,0,0,0,0,0,0,0,0,0,0,0,0,0,0,0,0,0,0,0,0,0,0,0,0,0,0,0
2009-01-12 00:00:00.000,Auckland New Zealand ATP World Tour 250,HARD,2,Ernests Gulbis,Marcel Granollers,Ernests Gulbis,6-4; 6-7(5); 6-1,R32,117,13,6,64,103,48,64,20,39,5,7,15,68,103,4,3,53,87,36,53,16,34,4,9,14,52,87
2009-01-12 00:00:00.000,Auckland New Zealand ATP World Tour 250,HARD,2,Viktor Troicki,Igor Kunitsyn,Viktor Troicki,6-1; 6-2,R32,54,11,2,29,47,25,29,9,18,4,4,8,34,47,0,0,19,37,10,19,8,18,0,4,7,18,37
2009-01-12 00:00:00.000,Auckland New Zealand ATP World Tour 250,HARD,2,Juan Monaco,Victor Hanescu,Juan Monaco,6-3; 6-4,R32,90,3,2,32,56,25,32,10,24,0,2,9,35,56,0,3,44,71,25,44,12,27,6,11,10,37,71
2009-01-12 00:00:00.000,Auckland New Zealand ATP World Tour 250,HARD,2,Robin Soderling,N/A Bye,Robin Soderling,,R32,0,0,0,0,0,0,0,0,0,0,0,0,0,0,0,0,0,0,0,0,0,0,0,0,0,0,0
2009-01-12 00:00:00.000,Auckland New Zealand ATP World Tour 250,HARD,2,Bobby Reynolds,Oscar Hernandez,Bobby Reynolds,7-6(4); 5-7; 6-2,R32,163,9,2,54,95,46,54,24,41,3,4,16,70,95,10,8,74,130,50,74,28,56,10,12,16,78,130
2009-01-12 00:00:00.000,Auckland New Zealand ATP World Tour 250,HARD,2,Robby Ginepri,Jose (Rubin) Statham,Robby Ginepri,6-2; 6-3,R32,73,1,1,33,55,23,33,13,22,4,5,9,36,55,5,4,47,76,28,47,11,29,11,15,8,39,76
2009-01-12 00:00:00.000,Auckland New Zealand ATP World Tour 250,HARD,2,John Isner,Albert Montanes,John Isner,7-6(4); 7-5,R32,90,12,1,48,68,37,48,14,20,2,3,12,51,68,4,6,49,83,34,49,20,34,3,5,12,54,83
2009-01-12 00:00:00.000,Auckland New Zealand ATP World Tour 250,HARD,2,Sam Querrey,Daniel King-Turner,Sam Querrey,6-4; 7-5,R32,74,8,6,37,63,28,37,17,26,0,1,11,45,63,1,9,27,71,21,27,21,44,1,4,11,42,71
2009-01-12 00:00:00.000,Auckland New Zealand ATP World Tour 250,HARD,2,Gilles Muller,Florent Serra,Gilles Muller,6-3; 6-4,R32,64,12,3,28,52,24,28,15,24,0,1,10,39,52,6,3,29,53,20,29,11,24,2,5,9,31,53
2009-01-12 00:00:00.000,Auckland New Zealand ATP World Tour 250,HARD,2,Yen-Hsun Lu,Steve Darcis,Yen-Hsun Lu,7-6(5); 6-2,R32,113,4,3,49,82,32,49,17,33,7,9,10,49,82,3,3,50,88,29,50,17,38,11,15,10,46,88
2009-01-12 00:00:00.000,Auckland New Zealand ATP World Tour 250,HARD,2,Nicolas Almagro,N/A Bye,Nicolas Almagro,,R32,0,0,0,0,0,0,0,0,0,0,0,0,0,0,0,0,0,0,0,0,0,0,0,0,0,0,0
2009-01-12 00:00:00.000,Auckland New Zealand ATP World Tour 250,HARD,2,Philipp Kohlschreiber,Dominik Hrbaty,Philipp Kohlschreiber,6-1; 6-2,R32,52,3,0,28,42,25,28,8,14,0,0,8,33,42,0,4,20,38,13,20,5,18,2,6,7,18,38
2009-01-12 00:00:00.000,Auckland New Zealand ATP World Tour 250,HARD,2,Juan Carlos Ferrero,Kei Nishikori,Juan Carlos Ferrero,5-3 RET,R32,33,3,0,16,24,11,16,3,8,0,1,4,14,24,3,2,16,31,8,16,7,15,2,4,4,15,31
2009-01-12 00:00:00.000,Auckland New Zealand ATP World Tour 250,HARD,2,Marc Gicquel,Agustin Calleri,Marc Gicquel,3-6; 6-4; 6-4,R32,117,4,7,59,96,41,59,21,37,5,8,15,62,96,9,2,39,86,29,39,26,47,5,8,14,55,86
2009-01-12 00:00:00.000,Auckland New Zealand ATP World Tour 250,HARD,2,David Ferrer,N/A Bye,David Ferrer,,R32,0,0,0,0,0,0,0,0,0,0,0,0,0,0,0,0,0,0,0,0,0,0,0,0,0,0,0
2009-01-12 00:00:00.000,Auckland New Zealand ATP World Tour 250,HARD,2,Juan Martin Del Potro,Ernests Gulbis,Juan Martin Del Potro,4-6; 6-4; 6-1,R16,103,4,1,40,66,31,40,13,26,1,4,13,44,66,8,5,49,74,33,49,9,25,2,8,14,42,74
2009-01-12 00:00:00.000,Auckland New Zealand ATP World Tour 250,HARD,2,Viktor Troicki,Juan Monaco,Viktor Troicki,3-6; 6-4; 6-2,R16,148,14,3,54,93,39,54,13,39,8,13,14,52,93,3,5,52,95,31,52,16,43,8,14,13,47,95
2009-01-12 00:00:00.000,Auckland New Zealand ATP World Tour 250,HARD,2,Robin Soderling,Bobby Reynolds,Robin Soderling,6-3; 4-6; 6-2,R16,96,8,2,57,80,44,57,11,23,8,11,14,55,80,12,2,51,81,32,51,14,30,2,7,13,46,81
2009-01-12 00:00:00.000,Auckland New Zealand ATP World Tour 250,HARD,2,John Isner,Robby Ginepri,John Isner,6-4; 6-7(1); 7-6(5),R16,144,17,1,86,126,56,86,24,40,9,11,17,80,126,12,2,69,103,55,69,18,34,2,5,17,73,103
2009-01-12 00:00:00.000,Auckland New Zealand ATP World Tour 250,HARD,2,Sam Querrey,Gilles Muller,Sam Querrey,3-6; 6-3; 6-4,R16,100,9,4,49,89,41,49,19,40,6,7,14,60,89,8,3,47,81,35,47,20,34,3,5,14,55,81
2009-01-12 00:00:00.000,Auckland New Zealand ATP World Tour 250,HARD,2,Nicolas Almagro,Yen-Hsun Lu,Nicolas Almagro,6-7(4); 6-3; 6-2,R16,119,11,1,50,87,38,50,21,37,1,3,15,59,87,5,4,45,89,31,45,23,44,2,7,14,54,89
2009-01-12 00:00:00.000,Auckland New Zealand ATP World Tour 250,HARD,2,Philipp Kohlschreiber,Juan Carlos Ferrero,Philipp Kohlschreiber,6-4; 4-6; 7-6(5),R16,132,5,5,66,105,44,66,25,39,4,6,16,69,105,9,3,66,98,49,66,18,32,1,3,16,67,98
2009-01-12 00:00:00.000,Auckland New Zealand ATP World Tour 250,HARD,2,David Ferrer,Marc Gicquel,David Ferrer,6-7(3); 6-4; 6-4,R16,156,5,5,63,114,45,63,26,51,8,10,16,71,114,5,5,60,112,44,60,25,52,6,10,16,69,112
2009-01-12 00:00:00.000,Auckland New Zealand ATP World Tour 250,HARD,2,Juan Martin Del Potro,Viktor Troicki,Juan Martin Del Potro,6-3; 6-2,Q,83,1,3,39,54,28,39,7,15,3,4,9,35,54,4,4,29,62,17,29,15,33,5,9,8,32,62
2009-01-12 00:00:00.000,Auckland New Zealand ATP World Tour 250,HARD,2,Robin Soderling,John Isner,Robin Soderling,6-4; 6-4,Q,59,11,2,30,47,28,30,12,17,0,0,10,40,47,8,0,43,60,26,43,12,17,0,2,10,38,60
2009-01-12 00:00:00.000,Auckland New Zealand ATP World Tour 250,HARD,2,Sam Querrey,Nicolas Almagro,Sam Querrey,6-3; 6-2,Q,63,10,0,29,42,25,29,7,13,0,0,8,32,42,4,3,34,63,22,34,12,29,3,7,9,34,63
2009-01-12 00:00:00.000,Auckland New Zealand ATP World Tour 250,HARD,2,David Ferrer,Philipp Kohlschreiber,David Ferrer,W/O,Q,0,0,0,0,0,0,0,0,0,0,0,0,0,0,0,0,0,0,0,0,0,0,0,0,0,0,0
2009-01-12 00:00:00.000,Auckland New Zealand ATP World Tour 250,HARD,2,Juan Martin Del Potro,Robin Soderling,Juan Martin Del Potro,6-4; 6-3,S,77,7,0,27,45,22,27,14,18,0,0,9,36,45,2,8,42,71,33,42,6,29,3,6,10,39,71
2009-01-12 00:00:00.000,Auckland New Zealand ATP World Tour 250,HARD,2,Sam Querrey,David Ferrer,Sam Querrey,3-6; 6-3; 7-6(4),S,127,10,4,54,101,45,54,16,47,5,9,15,61,101,1,4,58,105,38,58,24,47,6,10,15,62,105
2009-01-12 00:00:00.000,Auckland New Zealand ATP World Tour 250,HARD,2,Juan Martin Del Potro,Sam Querrey,Juan Martin Del Potro,6-4; 6-4,F,85,9,2,46,66,32,46,11,20,3,4,10,43,66,10,3,34,62,27,34,10,28,5,8,10,37,62
2009-01-12 00:00:00.000,Sydney Australia ATP World Tour 250,HARD,2,Novak Djokovic,N/A Bye,Novak Djokovic,,R32,0,0,0,0,0,0,0,0,0,0,0,0,0,0,0,0,0,0,0,0,0,0,0,0,0,0,0
2009-01-12 00:00:00.000,Sydney Australia ATP World Tour 250,HARD,2,Paul-Henri Mathieu,Andreas Seppi,Paul-Henri Mathieu,6-2; 2-6; 6-3,R32,118,8,3,68,111,43,68,23,43,11,13,13,66,111,7,1,36,64,25,36,17,28,1,4,12,42,64
2009-01-12 00:00:00.000,Sydney Australia ATP World Tour 250,HARD,2,Mario Ancic,Xavier Malisse,Mario Ancic,4-6; 7-6(5); 6-3,R32,145,7,1,53,85,37,53,20,32,3,6,15,57,85,6,2,71,116,46,71,23,45,9,13,16,69,116
2009-01-12 00:00:00.000,Sydney Australia ATP World Tour 250,HARD,2,Tommy Robredo,Jurgen Melzer,Tommy Robredo,6-3; 6-4,R32,90,3,1,45,80,30,45,22,35,7,7,10,52,80,2,0,34,56,20,34,14,22,4,6,9,34,56
2009-01-12 00:00:00.000,Sydney Australia ATP World Tour 250,HARD,2,Jo-Wilfried Tsonga,N/A Bye,Jo-Wilfried Tsonga,,R32,0,0,0,0,0,0,0,0,0,0,0,0,0,0,0,0,0,0,0,0,0,0,0,0,0,0,0
2009-01-12 00:00:00.000,Sydney Australia ATP World Tour 250,HARD,2,Simone Bolelli,Potito Starace,Simone Bolelli,7-6(1); 6-4,R32,102,5,1,40,65,32,40,17,25,4,5,11,49,65,4,5,65,83,40,65,10,18,6,8,11,50,83
2009-01-12 00:00:00.000,Sydney Australia ATP World Tour 250,HARD,2,Jarkko Nieminen,Feliciano Lopez,Jarkko Nieminen,6-2; 7-6(9),R32,84,3,2,42,64,34,42,12,22,3,4,10,46,64,5,4,27,60,18,27,16,33,1,4,10,34,60
2009-01-12 00:00:00.000,Sydney Australia ATP World Tour 250,HARD,2,Chris Guccione,Tomas Berdych,Chris Guccione,6-3; 6-4,R32,66,10,0,36,61,30,36,14,25,2,2,10,44,61,2,0,24,43,18,24,12,19,0,2,9,30,43
2009-01-12 00:00:00.000,Sydney Australia ATP World Tour 250,HARD,2,Janko Tipsarevic,Mardy Fish,Janko Tipsarevic,6-4; 3-6; 6-4,R32,121,2,2,43,84,32,43,22,41,4,7,14,54,84,17,4,33,83,30,33,23,50,3,7,15,53,83
2009-01-12 00:00:00.000,Sydney Australia ATP World Tour 250,HARD,2,Lleyton Hewitt,Julien Benneteau,Lleyton Hewitt,5-7; 6-2; 6-4,R32,125,7,6,49,89,40,49,19,40,4,7,15,59,89,6,5,59,89,38,59,13,30,6,11,15,51,89
2009-01-12 00:00:00.000,Sydney Australia ATP World Tour 250,HARD,2,Michael Llodra,Denis Gremelmayr,Michael Llodra,6-0; 6-2,R32,46,7,2,25,35,22,25,6,10,0,0,7,28,35,0,3,17,39,9,17,7,22,1,6,7,16,39
2009-01-12 00:00:00.000,Sydney Australia ATP World Tour 250,HARD,2,David Nalbandian,N/A Bye,David Nalbandian,,R32,0,0,0,0,0,0,0,0,0,0,0,0,0,0,0,0,0,0,0,0,0,0,0,0,0,0,0
2009-01-12 00:00:00.000,Sydney Australia ATP World Tour 250,HARD,2,Igor Andreev,Frank Dancevic,Igor Andreev,7-6(2); 6-3,R32,77,11,1,38,58,34,38,10,20,0,1,10,44,58,2,1,48,75,27,48,17,27,1,4,11,44,75
2009-01-12 00:00:00.000,Sydney Australia ATP World Tour 250,HARD,2,Jeremy Chardy,Radek Stepanek,Jeremy Chardy,6-4; 3-0 RET,R32,73,2,1,25,47,21,25,11,22,2,2,6,32,47,5,8,36,66,25,36,9,30,11,14,7,34,66
2009-01-12 00:00:00.000,Sydney Australia ATP World Tour 250,HARD,2,Richard Gasquet,Dmitry Tursunov,Richard Gasquet,7-6(4); 6-4,R32,86,6,1,38,66,32,38,19,28,1,1,11,51,66,4,1,33,65,24,33,24,32,1,2,11,48,65
2009-01-12 00:00:00.000,Sydney Australia ATP World Tour 250,HARD,2,Gilles Simon,N/A Bye,Gilles Simon,,R32,0,0,0,0,0,0,0,0,0,0,0,0,0,0,0,0,0,0,0,0,0,0,0,0,0,0,0
2009-01-12 00:00:00.000,Sydney Australia ATP World Tour 250,HARD,2,Novak Djokovic,Paul-Henri Mathieu,Novak Djokovic,6-1; 6-2,R16,55,4,1,31,42,24,31,10,11,1,1,8,34,42,1,2,23,39,15,23,3,16,3,7,7,18,39
2009-01-12 00:00:00.000,Sydney Australia ATP World Tour 250,HARD,2,Mario Ancic,Tommy Robredo,Mario Ancic,6-2; 6-1,R16,63,5,1,32,48,23,32,11,16,2,2,8,34,48,1,4,26,40,12,26,8,14,1,5,7,20,40
2009-01-12 00:00:00.000,Sydney Australia ATP World Tour 250,HARD,2,Jo-Wilfried Tsonga,Simone Bolelli,Jo-Wilfried Tsonga,6-4; 6-1,R16,65,11,3,36,46,30,36,5,10,3,3,8,35,46,3,0,34,55,18,34,12,21,2,6,9,30,55
2009-01-12 00:00:00.000,Sydney Australia ATP World Tour 250,HARD,2,Jarkko Nieminen,Chris Guccione,Jarkko Nieminen,7-6(8); 6-3,R16,82,0,2,43,70,32,43,16,27,3,5,11,48,70,7,5,47,75,31,47,12,28,6,9,10,43,75
2009-01-12 00:00:00.000,Sydney Australia ATP World Tour 250,HARD,2,Lleyton Hewitt,Janko Tipsarevic,Lleyton Hewitt,7-5; 6-4,R16,97,4,5,24,59,19,24,22,35,2,4,11,41,59,8,5,37,70,30,37,12,33,3,7,11,42,70
2009-01-12 00:00:00.000,Sydney Australia ATP World Tour 250,HARD,2,David Nalbandian,Michael Llodra,David Nalbandian,6-1; 6-3,R16,58,6,1,28,44,22,28,10,16,0,0,8,32,44,3,4,23,46,15,23,8,23,4,8,8,23,46
2009-01-12 00:00:00.000,Sydney Australia ATP World Tour 250,HARD,2,Jeremy Chardy,Igor Andreev,Jeremy Chardy,6-4; 4-6; 6-4,R16,116,11,3,54,82,44,54,14,28,4,6,15,58,82,7,5,51,93,38,51,19,42,4,7,15,57,93
2009-01-12 00:00:00.000,Sydney Australia ATP World Tour 250,HARD,2,Richard Gasquet,Gilles Simon,Richard Gasquet,6-4; 6-4,R16,94,3,5,20,58,13,20,22,38,3,6,10,35,58,5,10,35,84,28,35,14,49,10,15,10,42,84
2009-01-12 00:00:00.000,Sydney Australia ATP World Tour 250,HARD,2,Novak Djokovic,Mario Ancic,Novak Djokovic,6-3; 6-4,Q,80,2,3,49,82,35,49,16,33,14,15,10,51,82,2,1,28,45,19,28,11,17,2,5,9,30,45
2009-01-12 00:00:00.000,Sydney Australia ATP World Tour 250,HARD,2,Jarkko Nieminen,Jo-Wilfried Tsonga,Jarkko Nieminen,W/O,Q,0,0,0,0,0,0,0,0,0,0,0,0,0,0,0,0,0,0,0,0,0,0,0,0,0,0,0
2009-01-12 00:00:00.000,Sydney Australia ATP World Tour 250,HARD,2,David Nalbandian,Lleyton Hewitt,David Nalbandian,7-6(3); 7-5,Q,108,7,1,49,78,32,49,16,29,3,6,12,48,78,3,4,37,79,23,37,24,42,1,5,12,47,79
2009-01-12 00:00:00.000,Sydney Australia ATP World Tour 250,HARD,2,Richard Gasquet,Jeremy Chardy,Richard Gasquet,6-2; 7-6(4),Q,83,5,2,32,60,27,32,14,28,1,2,10,41,60,6,3,42,68,25,42,15,26,0,3,10,40,68
2009-01-12 00:00:00.000,Sydney Australia ATP World Tour 250,HARD,2,Jarkko Nieminen,Novak Djokovic,Jarkko Nieminen,6-4; 7-6(3),S,100,2,3,50,77,36,50,18,27,5,5,11,54,77,2,1,54,70,39,54,7,16,4,5,11,46,70
2009-01-12 00:00:00.000,Sydney Australia ATP World Tour 250,HARD,2,David Nalbandian,Richard Gasquet,David Nalbandian,6-4; 6-3,S,74,6,2,23,52,19,23,17,29,0,1,9,36,52,4,5,36,66,26,36,10,30,3,7,10,36,66
2009-01-12 00:00:00.000,Sydney Australia ATP World Tour 250,HARD,2,David Nalbandian,Jarkko Nieminen,David Nalbandian,6-3; 6-7(9); 6-2,F,136,6,4,61,110,46,61,22,49,7,9,15,68,110,2,4,74,101,48,74,9,27,6,11,14,57,101
2009-01-19 00:00:00.000,Australian Open Australia Grand Slams,HARD,3,Rafael Nadal,Christophe Rochus,Rafael Nadal,6-0; 6-2; 6-2,R128,76,10,2,35,51,32,35,12,16,0,0,11,44,51,1,2,48,72,28,48,5,24,4,11,11,33,72
2009-01-19 00:00:00.000,Australian Open Australia Grand Slams,HARD,3,Roko Karanusic,Florent Serra,Roko Karanusic,6-3; 1-6; 6-3; 3-6; 6-3,R128,152,8,5,83,131,60,83,21,48,8,14,22,81,131,5,1,86,126,55,86,21,40,4,10,21,76,126
2009-01-19 00:00:00.000,Australian Open Australia Grand Slams,HARD,3,Tommy Haas,Eduardo Schwank,Tommy Haas,6-3; 6-3; 6-4,R128,119,11,5,42,89,37,42,23,47,5,7,14,60,89,2,4,55,92,33,55,17,37,7,13,14,50,92
2009-01-19 00:00:00.000,Australian Open Australia Grand Slams,HARD,3,Flavio Cipolla,Dmitry Tursunov,Flavio Cipolla,4-6; 6-2; 7-6(7); 7-5,R128,194,3,6,118,173,77,118,26,55,13,17,21,103,173,11,4,81,144,55,81,31,63,10,16,21,86,144
2009-01-19 00:00:00.000,Australian Open Australia Grand Slams,HARD,3,Richard Gasquet,Diego Junqueira,Richard Gasquet,6-7(5); 7-6(3); 6-3; 6-4,R128,204,14,4,80,138,63,80,34,58,7,10,21,97,138,3,4,104,158,73,104,23,54,14,19,21,96,158
2009-01-19 00:00:00.000,Australian Open Australia Grand Slams,HARD,3,Denis Istomin,Vincent Spadea,Denis Istomin,6-2; 7-5; 6-4,R128,98,10,5,47,79,37,47,16,32,1,4,15,53,79,3,7,62,95,34,62,13,33,6,13,15,47,95
2009-01-19 00:00:00.000,Australian Open Australia Grand Slams,HARD,3,Guillermo Canas,Dieter Kindlmann,Guillermo Canas,3-6; 7-5; 5-7; 6-0; 7-5,R128,215,21,4,73,143,57,73,35,70,6,12,25,92,143,3,6,106,166,64,106,27,60,13,22,26,91,166
2009-01-19 00:00:00.000,Australian Open Australia Grand Slams,HARD,3,Fernando Gonzalez,Lleyton Hewitt,Fernando Gonzalez,5-7; 6-2; 6-2; 3-6; 6-3,R128,184,12,4,75,132,60,75,29,57,7,11,23,89,132,9,11,69,134,43,69,35,65,7,14,23,78,134
2009-01-19 00:00:00.000,Australian Open Australia Grand Slams,HARD,3,Gael Monfils,Martin Vassallo Arguello,Gael Monfils,6-1; 6-3; 7-5,R128,145,9,8,47,92,39,47,19,45,6,9,14,58,92,0,6,76,116,41,76,16,40,13,21,14,57,116
2009-01-19 00:00:00.000,Australian Open Australia Grand Slams,HARD,3,Stefan Koubek,Mikhail Youzhny,Stefan Koubek,6-3; 6-2; 6-2,R128,95,4,4,43,79,34,43,18,36,4,6,13,52,79,4,5,52,82,22,52,16,30,9,16,12,38,82
2009-01-19 00:00:00.000,Australian Open Australia Grand Slams,HARD,3,Fabio Fognini,Andrey Golubev,Fabio Fognini,3-6; 7-6(7); 6-4; 6-2,R128,169,4,7,72,129,57,72,30,57,6,8,19,87,129,6,7,75,134,49,75,36,59,8,12,20,85,134
2009-01-19 00:00:00.000,Australian Open Australia Grand Slams,HARD,3,Nicolas Almagro,Nicolas Massu,Nicolas Almagro,6-4; 6-4; 3-6; 5-7; 6-3,R128,210,31,4,87,138,70,87,29,51,4,7,24,99,138,9,7,86,139,64,86,31,53,5,9,25,95,139
2009-01-19 00:00:00.000,Australian Open Australia Grand Slams,HARD,3,Ivo Karlovic,Daniel Gimeno-Traver,Ivo Karlovic,6-3; 6-4; 6-4,R128,107,13,2,45,82,39,45,24,37,2,2,15,63,82,1,1,73,87,49,73,6,14,7,10,14,55,87
2009-01-19 00:00:00.000,Australian Open Australia Grand Slams,HARD,3,Mario Ancic,Wayne Odesnik,Mario Ancic,7-5; 6-4; 4-6; 6-2,R128,174,12,2,74,108,58,74,19,34,0,2,20,77,108,1,4,87,131,56,87,24,44,6,11,20,80,131
2009-01-19 00:00:00.000,Australian Open Australia Grand Slams,HARD,3,Chris Guccione,Nicolas Devilder,Chris Guccione,6-4; 6-2; 6-4,R128,115,12,4,46,75,37,46,17,29,1,2,14,54,75,4,4,59,97,32,59,21,38,8,13,14,53,97
2009-01-19 00:00:00.000,Australian Open Australia Grand Slams,HARD,3,Gilles Simon,Pablo Andujar,Gilles Simon,6-4; 6-1; 6-1,R128,114,8,3,46,95,30,46,27,49,7,9,12,57,95,1,5,55,95,27,55,17,40,9,17,12,44,95
2009-01-19 00:00:00.000,Australian Open Australia Grand Slams,HARD,3,Andy Murray,Andrei Pavel,Andy Murray,6-2; 3-1 RET,R128,45,2,3,20,31,20,20,5,11,2,2,6,25,31,0,3,22,39,13,22,5,17,1,4,6,18,39
2009-01-19 00:00:00.000,Australian Open Australia Grand Slams,HARD,3,Marcel Granollers,Teymuraz Gabashvili,Marcel Granollers,6-4; 7-6(3); 4-6; 6-0,R128,183,12,3,70,112,51,70,21,42,6,10,19,72,112,6,10,64,131,44,64,29,67,7,14,19,73,131
2009-01-19 00:00:00.000,Australian Open Australia Grand Slams,HARD,3,Andreas Beck,Colin Ebelthite,Andreas Beck,7-5; 6-1; 6-0,R128,96,1,2,46,67,32,46,14,21,3,5,12,46,67,3,5,48,84,28,48,10,36,8,17,13,38,84
2009-01-19 00:00:00.000,Australian Open Australia Grand Slams,HARD,3,Jurgen Melzer,Kei Nishikori,Jurgen Melzer,7-5; 6-2; 6-1,R128,102,6,2,47,78,39,47,16,31,5,7,14,55,78,3,6,53,93,27,53,18,40,4,11,13,45,93
2009-01-19 00:00:00.000,Australian Open Australia Grand Slams,HARD,3,Radek Stepanek,Nicolas Lapentti,Radek Stepanek,3-6; 6-3; 6-4; 6-4,R128,174,9,3,74,110,52,74,24,36,1,3,19,76,110,9,5,75,130,48,75,32,55,9,13,19,80,130
2009-01-19 00:00:00.000,Australian Open Australia Grand Slams,HARD,3,Michael Berrer,Carsten Ball,Michael Berrer,6-2; 6-4; 6-3,R128,105,8,3,42,80,33,42,20,38,5,8,13,53,80,12,6,68,116,39,68,16,48,18,26,14,55,116
2009-01-19 00:00:00.000,Australian Open Australia Grand Slams,HARD,3,Arnaud Clement,Sergiy Stakhovsky,Arnaud Clement,6-3; 2-6; 4-6; 6-2; 6-1,R128,207,2,2,63,150,45,63,41,87,8,14,21,86,150,9,4,84,135,51,84,24,51,10,19,21,75,135
2009-01-19 00:00:00.000,Australian Open Australia Grand Slams,HARD,3,Fernando Verdasco,Adrian Mannarino,Fernando Verdasco,6-0; 6-2; 6-2,R128,87,7,4,50,69,40,50,10,19,2,2,11,50,69,2,4,27,62,15,27,11,35,5,12,11,26,62
2009-01-19 00:00:00.000,Australian Open Australia Grand Slams,HARD,3,James Blake,Frank Dancevic,James Blake,6-4; 6-3; 7-5,R128,114,7,5,59,90,47,59,14,31,9,12,16,61,90,8,3,59,107,41,59,18,48,9,15,15,59,107
2009-01-19 00:00:00.000,Australian Open Australia Grand Slams,HARD,3,Sebastien De Chaunac,Steve Darcis,Sebastien De Chaunac,2-6; 6-3; 0-6; 6-2; 6-2,R128,162,12,5,56,111,42,56,26,55,2,8,20,68,111,5,2,50,108,31,50,31,58,1,7,19,62,108
2009-01-19 00:00:00.000,Australian Open Australia Grand Slams,HARD,3,Ernests Gulbis,Albert Montanes,Ernests Gulbis,6-3; 6-2; 6-3,R128,86,11,1,47,74,39,47,16,27,1,1,13,55,74,2,2,37,68,26,37,17,31,1,6,13,43,68
2009-01-19 00:00:00.000,Australian Open Australia Grand Slams,HARD,3,Igor Andreev,Peter Polansky,Igor Andreev,5-7; 3-6; 6-4; 6-3; 6-4,R128,0,0,0,0,0,0,0,0,0,0,0,0,0,0,0,1,0,1,0,0,0,1,0,0,0,0,1
2009-01-19 00:00:00.000,Australian Open Australia Grand Slams,HARD,3,Dudi Sela,Rainer Schuettler,Dudi Sela,1-6; 6-2; 6-4; 6-4,R128,163,2,3,77,107,53,77,12,30,5,10,17,65,107,2,3,100,127,57,100,11,27,12,19,18,68,127
2009-01-19 00:00:00.000,Australian Open Australia Grand Slams,HARD,3,Victor Hanescu,Jan Hernych,Victor Hanescu,3-6; 3-6; 7-6(7); 7-6(4); 8-6,R128,252,9,4,131,182,81,131,27,51,7,16,28,108,182,6,8,142,197,93,142,24,55,14,21,28,117,197
2009-01-19 00:00:00.000,Australian Open Australia Grand Slams,HARD,3,Ivan Ljubicic,Igor Kunitsyn,Ivan Ljubicic,4-6; 7-6(3); 7-6(7); 5-7; 6-3,R128,242,26,4,112,164,79,112,24,52,2,10,28,103,164,10,6,146,189,96,146,16,43,8,15,27,112,189
2009-01-19 00:00:00.000,Australian Open Australia Grand Slams,HARD,3,Jo-Wilfried Tsonga,Juan Monaco,Jo-Wilfried Tsonga,6-4; 6-4; 6-0,R128,99,5,2,32,66,27,32,21,34,1,3,13,48,66,1,2,47,74,25,47,11,27,3,10,13,36,74
2009-01-19 00:00:00.000,Australian Open Australia Grand Slams,HARD,3,Andy Roddick,Bjorn Rehnquist,Andy Roddick,6-0; 6-2; 6-2,R128,104,9,1,33,63,25,33,21,30,0,0,11,46,63,0,2,37,65,19,37,9,28,3,10,11,28,65
2009-01-19 00:00:00.000,Australian Open Australia Grand Slams,HARD,3,Xavier Malisse,Michael Llodra,Xavier Malisse,7-6(8); 6-1; 6-1,R128,150,5,2,57,82,45,57,13,25,8,8,13,58,82,8,1,63,101,37,63,20,38,13,18,13,57,101
2009-01-19 00:00:00.000,Australian Open Australia Grand Slams,HARD,3,Fabrice Santoro,Juan Carlos Ferrero,Fabrice Santoro,6-3; 6-2; 6-7(5); 6-2,R128,151,17,3,54,115,45,54,29,61,4,7,19,74,115,3,2,61,105,41,61,18,44,0,8,18,59,105
2009-01-19 00:00:00.000,Australian Open Australia Grand Slams,HARD,3,Philipp Kohlschreiber,Sam Querrey,Philipp Kohlschreiber,7-6(6); 6-3; 6-2,R128,113,8,5,66,103,51,66,20,37,3,3,15,71,103,9,1,45,82,33,45,23,37,2,5,14,56,82
2009-01-19 00:00:00.000,Australian Open Australia Grand Slams,HARD,3,Tommy Robredo,Bobby Reynolds,Tommy Robredo,6-2; 7-5; 6-1,R128,182,10,1,42,61,34,42,18,19,0,0,13,52,61,7,5,45,76,30,45,11,31,4,10,14,41,76
2009-01-19 00:00:00.000,Australian Open Australia Grand Slams,HARD,3,Viktor Troicki,Alberto Martin,Viktor Troicki,6-3; 3-6; 6-2; 6-4,R128,280,12,1,59,97,46,59,21,38,5,8,18,67,97,3,6,60,106,40,60,23,46,5,11,18,63,106
2009-01-19 00:00:00.000,Australian Open Australia Grand Slams,HARD,3,Yen-Hsun Lu,Thomaz Bellucci,Yen-Hsun Lu,6-3; 7-5; 6-4,R128,185,8,3,61,112,49,61,27,51,12,13,16,76,112,9,5,41,71,31,41,16,30,0,4,15,47,71
2009-01-19 00:00:00.000,Australian Open Australia Grand Slams,HARD,3,David Nalbandian,Marc Gicquel,David Nalbandian,6-1; 4-6; 6-2; 6-3,R128,210,4,8,74,129,52,74,26,55,8,10,16,78,129,8,2,50,103,32,50,24,53,8,15,17,56,103
2009-01-19 00:00:00.000,Australian Open Australia Grand Slams,HARD,3,Robin Soderling,Robert Kendrick,Robin Soderling,5-7; 6-4; 6-4; 7-5,R128,150,11,2,78,114,65,78,26,36,5,6,22,91,114,20,6,78,127,63,78,23,49,4,7,22,86,127
2009-01-19 00:00:00.000,Australian Open Australia Grand Slams,HARD,3,Marcos Baghdatis,Julien Benneteau,Marcos Baghdatis,6-3; 7-6(5); 6-2,R128,250,7,2,44,104,34,44,32,60,7,8,14,66,104,4,7,68,113,45,68,18,45,7,12,15,63,113
2009-01-19 00:00:00.000,Australian Open Australia Grand Slams,HARD,3,Simone Bolelli,Kristof Vliegen,Simone Bolelli,7-6(5); 7-6(3); 7-5,R128,284,3,1,60,111,47,60,35,51,1,2,18,82,111,10,2,54,102,40,54,34,48,3,5,18,74,102
2009-01-19 00:00:00.000,Australian Open Australia Grand Slams,HARD,3,Mardy Fish,Samuel Groth,Mardy Fish,6-7(3); 6-4; 7-5; 6-0,R128,191,19,6,57,105,50,57,26,48,0,2,20,76,105,14,10,73,128,47,73,25,55,8,15,20,72,128
2009-01-19 00:00:00.000,Australian Open Australia Grand Slams,HARD,3,Paul-Henri Mathieu,Jarkko Nieminen,Paul-Henri Mathieu,6-2; 4-1 RET,R128,49,6,2,25,43,20,25,12,18,0,0,7,32,43,3,1,16,31,9,16,9,15,2,5,6,18,31
2009-01-19 00:00:00.000,Australian Open Australia Grand Slams,HARD,3,Amer Delic,Taylor Dent,Amer Delic,6-4; 3-6; 4-6; 6-3; 6-4,R128,250,21,5,106,144,81,106,18,38,3,5,24,99,144,8,10,91,133,73,91,20,42,4,7,24,93,133
2009-01-19 00:00:00.000,Australian Open Australia Grand Slams,HARD,3,Jeremy Chardy,Marcos Daniel,Jeremy Chardy,6-4; 6-4; 6-1,R128,252,18,3,44,71,35,44,17,27,0,1,13,52,71,8,8,54,98,35,54,15,44,9,15,14,50,98
2009-01-19 00:00:00.000,Australian Open Australia Grand Slams,HARD,3,Novak Djokovic,Andrea Stoppini,Novak Djokovic,6-2; 6-3; 7-5,R128,115,8,1,51,74,34,51,14,23,3,6,14,48,74,6,6,59,110,33,59,21,51,11,19,15,54,110
2009-01-19 00:00:00.000,Australian Open Australia Grand Slams,HARD,3,Juan Martin Del Potro,Mischa Zverev,Juan Martin Del Potro,6-3; 6-4; 6-2,R128,225,7,4,54,83,38,54,19,29,4,6,14,57,83,5,2,59,96,33,59,16,37,8,14,13,49,96
2009-01-19 00:00:00.000,Australian Open Australia Grand Slams,HARD,3,Florian Mayer,Lamine Ouahab,Florian Mayer,6-2; 6-1; 6-2,R128,83,4,1,40,69,31,40,19,29,0,1,12,50,69,0,4,37,72,23,37,9,35,7,14,11,32,72
2009-01-19 00:00:00.000,Australian Open Australia Grand Slams,HARD,3,Bernard Tomic,Potito Starace,Bernard Tomic,7-6(5); 1-6; 7-6(5); 7-6(6),R128,281,10,1,98,147,64,98,30,49,5,10,21,94,147,14,6,112,169,84,112,26,57,10,13,22,110,169
2009-01-19 00:00:00.000,Australian Open Australia Grand Slams,HARD,3,Gilles Muller,Feliciano Lopez,Gilles Muller,6-3; 7-6(5); 4-6; 4-6; 16-14,R128,262,0,0,194,194,148,194,0,0,4,6,36,148,194,0,0,196,196,145,196,0,0,4,6,35,145,196
2009-01-19 00:00:00.000,Australian Open Australia Grand Slams,HARD,3,Marin Cilic,Kevin Anderson,Marin Cilic,6-3; 6-2; 6-7(4); 6-3,R128,307,16,8,64,125,56,64,29,61,7,9,20,85,125,8,7,70,117,47,70,21,47,8,14,18,68,117
2009-01-19 00:00:00.000,Australian Open Australia Grand Slams,HARD,3,Janko Tipsarevic,Oscar Hernandez,Janko Tipsarevic,4-6; 6-1; 6-3; 4-6; 6-0,R128,210,15,4,88,153,68,88,29,65,15,18,21,97,153,13,11,79,142,52,79,24,63,7,15,21,76,142
2009-01-19 00:00:00.000,Australian Open Australia Grand Slams,HARD,3,Dominik Hrbaty,John Isner,Dominik Hrbaty,7-6(4); 2-6; 6-2; 7-5,R128,166,6,5,80,119,59,80,23,39,1,3,20,82,119,39,8,88,138,68,88,20,50,6,9,20,88,138
2009-01-19 00:00:00.000,Australian Open Australia Grand Slams,HARD,3,David Ferrer,Denis Gremelmayr,David Ferrer,6-1; 6-7(6); 6-1; 6-7(4); 6-4,R128,237,7,8,95,172,68,95,42,77,9,12,25,110,172,5,7,100,183,64,100,37,83,11,19,23,101,183
2009-01-19 00:00:00.000,Australian Open Australia Grand Slams,HARD,3,Stanislas Wawrinka,Ivo Minar,Stanislas Wawrinka,6-1; 2-6; 7-5; 7-6(9),R128,150,4,6,74,126,50,74,25,52,8,14,20,75,126,7,5,65,110,43,65,19,45,3,10,19,62,110
2009-01-19 00:00:00.000,Australian Open Australia Grand Slams,HARD,3,Brydan Klein,Bjorn Phau,Brydan Klein,6-4; 6-3; 4-6; 6-3,R128,307,14,6,66,106,50,66,17,40,3,7,19,67,106,3,7,53,113,39,53,27,60,7,14,19,66,113
2009-01-19 00:00:00.000,Australian Open Australia Grand Slams,HARD,3,Brian Dabul,Philipp Petzschner,Brian Dabul,6-1; 6-2; 6-4,R128,100,6,0,61,76,47,61,9,15,2,3,13,56,76,5,8,54,80,35,54,5,26,4,10,12,40,80
2009-01-19 00:00:00.000,Australian Open Australia Grand Slams,HARD,3,Tomas Berdych,Robby Ginepri,Tomas Berdych,6-4; 6-4; 6-3,R128,110,9,4,52,81,43,52,16,29,4,5,14,59,81,6,3,67,103,43,67,14,36,9,14,15,57,103
2009-01-19 00:00:00.000,Australian Open Australia Grand Slams,HARD,3,Marat Safin,Ivan Navarro,Marat Safin,6-3; 6-3; 6-4,R128,145,8,3,42,82,34,42,25,40,1,1,14,59,82,6,2,51,91,37,51,18,40,2,6,14,55,91
2009-01-19 00:00:00.000,Australian Open Australia Grand Slams,HARD,3,Guillermo Garcia-Lopez,Agustin Calleri,Guillermo Garcia-Lopez,3-6; 7-6(5); 6-2; 6-0,R128,284,4,5,69,113,44,69,24,44,6,12,18,68,113,10,12,62,108,41,62,15,46,7,16,17,56,108
2009-01-19 00:00:00.000,Australian Open Australia Grand Slams,HARD,3,Evgeny Korolev,Carlos Moya,Evgeny Korolev,6-3; 6-1; 7-6(7),R128,111,9,3,49,82,44,49,16,33,1,2,14,60,82,10,11,40,91,32,40,17,51,6,11,14,49,91
2009-01-19 00:00:00.000,Australian Open Australia Grand Slams,HARD,3,Roger Federer,Andreas Seppi,Roger Federer,6-1; 7-6(4); 7-5,R128,280,9,5,76,115,56,76,23,39,10,10,16,79,115,1,6,70,109,48,70,18,39,7,10,15,66,109
2009-01-19 00:00:00.000,Australian Open Australia Grand Slams,HARD,3,Rafael Nadal,Roko Karanusic,Rafael Nadal,6-2; 6-3; 6-2,R64,96,3,2,50,77,37,50,17,27,6,6,12,54,77,2,2,42,64,29,42,6,22,1,7,13,35,64
2009-01-19 00:00:00.000,Australian Open Australia Grand Slams,HARD,3,Tommy Haas,Flavio Cipolla,Tommy Haas,6-1; 6-2; 6-1,R64,96,7,2,34,61,26,34,17,27,1,2,11,43,61,0,4,71,89,37,71,2,18,11,19,11,39,89
2009-01-19 00:00:00.000,Australian Open Australia Grand Slams,HARD,3,Richard Gasquet,Denis Istomin,Richard Gasquet,6-3; 6-4; 6-4,R64,120,7,4,46,87,36,46,26,41,4,6,15,62,87,5,2,56,95,37,56,14,39,11,16,14,51,95
2009-01-19 00:00:00.000,Australian Open Australia Grand Slams,HARD,3,Fernando Gonzalez,Guillermo Canas,Fernando Gonzalez,7-5; 6-3; 6-4,R64,137,12,3,59,87,49,59,15,28,0,1,16,64,87,9,5,63,118,41,63,29,55,16,20,15,70,118
2009-01-19 00:00:00.000,Australian Open Australia Grand Slams,HARD,3,Gael Monfils,Stefan Koubek,Gael Monfils,6-4; 6-4; 3-6; 6-2,R64,125,17,6,65,105,48,65,25,40,4,6,18,73,105,2,3,56,104,38,56,30,48,4,9,19,68,104
2009-01-19 00:00:00.000,Australian Open Australia Grand Slams,HARD,3,Nicolas Almagro,Fabio Fognini,Nicolas Almagro,6-2; 7-5; 6-0,R64,103,8,4,44,80,35,44,18,36,1,3,13,53,80,3,5,38,73,23,38,10,35,2,10,13,33,73
2009-01-19 00:00:00.000,Australian Open Australia Grand Slams,HARD,3,Mario Ancic,Ivo Karlovic,Mario Ancic,5-7; 7-5; 4-6; 6-4; 6-3,R64,211,8,1,84,131,66,84,32,47,3,6,26,98,131,25,2,101,155,79,101,25,54,5,10,27,104,155
2009-01-19 00:00:00.000,Australian Open Australia Grand Slams,HARD,3,Gilles Simon,Chris Guccione,Gilles Simon,6-7(5); 6-4; 6-1; 6-2,R64,140,14,2,63,117,53,63,33,54,7,7,19,86,117,13,3,77,122,50,77,26,45,6,11,18,76,122
2009-01-19 00:00:00.000,Australian Open Australia Grand Slams,HARD,3,Andy Murray,Marcel Granollers,Andy Murray,6-4; 6-2; 6-2,R64,109,4,1,45,79,33,45,22,34,1,2,13,55,79,2,1,48,93,27,48,21,45,10,16,13,48,93
2009-01-19 00:00:00.000,Australian Open Australia Grand Slams,HARD,3,Jurgen Melzer,Andreas Beck,Jurgen Melzer,5-7; 7-6(7); 6-4; 6-3,R64,193,21,2,78,142,55,78,33,64,10,14,21,88,142,5,10,81,146,49,81,37,65,6,12,22,86,146
2009-01-19 00:00:00.000,Australian Open Australia Grand Slams,HARD,3,Radek Stepanek,Michael Berrer,Radek Stepanek,6-3; 6-2; 6-7(3); 7-5,R64,182,14,6,94,140,73,94,20,46,4,6,21,93,140,4,8,89,134,58,89,21,45,6,12,20,79,134
2009-01-19 00:00:00.000,Australian Open Australia Grand Slams,HARD,3,Fernando Verdasco,Arnaud Clement,Fernando Verdasco,6-1; 6-1; 6-2,R64,93,6,1,47,56,39,47,7,9,3,3,11,46,56,2,3,50,79,23,50,12,29,6,13,11,35,79
2009-01-19 00:00:00.000,Australian Open Australia Grand Slams,HARD,3,James Blake,Sebastien De Chaunac,James Blake,6-3; 6-2; 6-3,R64,128,4,5,52,81,44,52,15,29,4,4,13,59,81,9,7,52,107,33,52,24,55,13,18,13,57,107
2009-01-19 00:00:00.000,Australian Open Australia Grand Slams,HARD,3,Igor Andreev,Ernests Gulbis,Igor Andreev,6-4; 6-4; 5-7; 3-6; 6-4,R64,231,10,7,95,162,68,95,37,67,9,12,25,105,162,14,8,122,190,82,122,34,68,13,17,26,116,190
2009-01-19 00:00:00.000,Australian Open Australia Grand Slams,HARD,3,Dudi Sela,Victor Hanescu,Dudi Sela,6-3; 6-3; 6-2,R64,114,5,3,63,94,49,63,15,31,12,12,13,64,94,1,3,61,86,40,61,8,25,7,12,13,48,86
2009-01-19 00:00:00.000,Australian Open Australia Grand Slams,HARD,3,Jo-Wilfried Tsonga,Ivan Ljubicic,Jo-Wilfried Tsonga,6-7(4); 7-6(8); 7-6(7); 6-2,R64,193,18,1,91,137,76,91,27,46,0,1,22,103,137,17,1,89,146,68,89,35,57,8,11,22,103,146
2009-01-19 00:00:00.000,Australian Open Australia Grand Slams,HARD,3,Andy Roddick,Xavier Malisse,Andy Roddick,4-6; 6-2; 7-6(1); 6-2,R64,160,19,2,70,101,58,70,18,31,1,3,19,76,101,11,2,77,128,51,77,25,51,8,13,19,76,128
2009-01-19 00:00:00.000,Australian Open Australia Grand Slams,HARD,3,Fabrice Santoro,Philipp Kohlschreiber,Fabrice Santoro,5-7; 7-5; 3-6; 7-5; 6-3,R64,242,3,3,94,173,63,94,41,79,12,19,27,104,173,4,4,122,182,71,122,34,60,21,29,27,105,182
2009-01-19 00:00:00.000,Australian Open Australia Grand Slams,HARD,3,Tommy Robredo,Viktor Troicki,Tommy Robredo,6-1; 6-3; 6-0,R64,82,7,1,45,56,35,45,10,11,0,0,11,45,56,4,3,43,76,25,43,8,33,9,16,11,33,76
2009-01-19 00:00:00.000,Australian Open Australia Grand Slams,HARD,3,Yen-Hsun Lu,David Nalbandian,Yen-Hsun Lu,6-4; 5-7; 4-6; 6-4; 6-2,R64,231,9,3,102,161,72,102,31,59,11,17,25,103,161,5,8,77,155,51,77,40,78,6,14,25,91,155
2009-01-19 00:00:00.000,Australian Open Australia Grand Slams,HARD,3,Marcos Baghdatis,Robin Soderling,Marcos Baghdatis,3-6; 7-5; 6-3; 6-3,R64,175,13,7,69,120,45,69,29,51,7,12,19,74,120,7,4,76,128,49,76,20,52,7,15,20,69,128
2009-01-19 00:00:00.000,Australian Open Australia Grand Slams,HARD,3,Mardy Fish,Simone Bolelli,Mardy Fish,6-4; 6-1; 7-5,R64,118,16,2,49,95,41,49,23,46,2,3,15,64,95,5,2,50,80,33,50,11,30,5,10,14,44,80
2009-01-19 00:00:00.000,Australian Open Australia Grand Slams,HARD,3,Amer Delic,Paul-Henri Mathieu,Amer Delic,1-6; 3-6; 6-3; 7-6(3); 9-7,R64,202,33,5,95,161,66,95,42,66,5,10,27,108,161,11,4,101,150,74,101,31,49,8,11,26,105,150
2009-01-19 00:00:00.000,Australian Open Australia Grand Slams,HARD,3,Novak Djokovic,Jeremy Chardy,Novak Djokovic,7-5; 6-1; 6-3,R64,102,7,1,54,75,41,54,14,21,1,2,14,55,75,3,0,52,75,30,52,11,23,0,6,14,41,75
2009-01-19 00:00:00.000,Australian Open Australia Grand Slams,HARD,3,Juan Martin Del Potro,Florian Mayer,Juan Martin Del Potro,6-1; 7-5; 6-2,R64,112,7,0,54,82,36,54,19,28,4,5,13,55,82,3,1,47,76,25,47,14,29,4,11,14,39,76
2009-01-19 00:00:00.000,Australian Open Australia Grand Slams,HARD,3,Gilles Muller,Bernard Tomic,Gilles Muller,3-6; 6-1; 6-4; 6-2,R64,118,27,4,64,96,53,64,17,32,5,6,17,70,96,5,6,65,116,42,65,24,51,12,17,17,66,116
2009-01-19 00:00:00.000,Australian Open Australia Grand Slams,HARD,3,Marin Cilic,Janko Tipsarevic,Marin Cilic,6-2; 6-3; 4-6; 6-3,R64,195,4,0,10,11,8,10,0,1,0,0,2,8,11,0,0,8,19,4,8,7,11,3,4,2,11,19
2009-01-19 00:00:00.000,Australian Open Australia Grand Slams,HARD,3,David Ferrer,Dominik Hrbaty,David Ferrer,6-2; 6-2; 6-1,R64,90,1,0,12,18,11,12,3,6,0,0,0,14,18,0,0,7,16,4,7,4,9,0,2,4,8,16
2009-01-19 00:00:00.000,Australian Open Australia Grand Slams,HARD,3,Stanislas Wawrinka,Brydan Klein,Stanislas Wawrinka,6-3; 6-4; 6-4,R64,0,0,0,0,0,0,0,0,0,0,0,0,0,0,0,0,0,0,0,0,0,0,0,0,0,0,0
2009-01-19 00:00:00.000,Australian Open Australia Grand Slams,HARD,3,Tomas Berdych,Brian Dabul,Tomas Berdych,6-1; 6-1; 6-3,R64,101,11,1,45,72,33,45,21,27,3,3,12,54,72,2,3,65,93,38,65,7,28,12,18,11,45,93
2009-01-19 00:00:00.000,Australian Open Australia Grand Slams,HARD,3,Marat Safin,Guillermo Garcia-Lopez,Marat Safin,7-5; 6-2; 6-2,R64,101,18,3,40,76,34,40,24,36,2,2,13,58,76,1,6,56,85,35,56,14,29,7,12,14,49,85
2009-01-19 00:00:00.000,Australian Open Australia Grand Slams,HARD,3,Roger Federer,Evgeny Korolev,Roger Federer,6-2; 6-3; 6-1,R64,85,8,3,41,68,28,41,20,27,0,1,12,48,68,2,3,41,80,22,41,17,39,5,12,12,39,80
2009-01-19 00:00:00.000,Australian Open Australia Grand Slams,HARD,3,Rafael Nadal,Tommy Haas,Rafael Nadal,6-4; 6-2; 6-2,R32,122,4,0,43,62,35,43,15,19,0,1,13,50,62,6,0,61,98,35,61,15,37,12,18,13,50,98
2009-01-19 00:00:00.000,Australian Open Australia Grand Slams,HARD,3,Fernando Gonzalez,Richard Gasquet,Fernando Gonzalez,3-6; 3-6; 7-6(10); 6-2; 12-10,R32,245,14,7,145,203,104,145,27,58,8,14,30,131,203,11,8,125,179,97,125,22,54,8,14,30,119,179
2009-01-19 00:00:00.000,Australian Open Australia Grand Slams,HARD,3,Gael Monfils,Nicolas Almagro,Gael Monfils,6-4; 6-3; 7-5,R32,129,12,0,67,101,51,67,16,34,4,5,15,67,101,10,2,67,96,43,67,14,29,5,10,16,57,96
2009-01-19 00:00:00.000,Australian Open Australia Grand Slams,HARD,3,Gilles Simon,Mario Ancic,Gilles Simon,7-6(2); 6-4; 6-2,R32,154,0,1,71,118,50,71,25,47,10,12,15,75,118,6,3,51,96,34,51,21,45,5,10,15,55,96
2009-01-19 00:00:00.000,Australian Open Australia Grand Slams,HARD,3,Andy Murray,Jurgen Melzer,Andy Murray,7-5; 6-0; 6-3,R32,99,8,0,49,82,38,49,17,33,6,8,14,55,82,2,1,55,79,32,55,6,24,7,14,13,38,79
2009-01-19 00:00:00.000,Australian Open Australia Grand Slams,HARD,3,Fernando Verdasco,Radek Stepanek,Fernando Verdasco,6-4; 6-0; 6-0,R32,108,1,2,56,69,40,56,6,13,8,10,11,46,69,2,5,49,85,21,49,11,36,11,20,11,32,85
2009-01-19 00:00:00.000,Australian Open Australia Grand Slams,HARD,3,James Blake,Igor Andreev,James Blake,6-3; 6-2; 3-6; 6-1,R32,127,5,0,64,102,49,64,25,38,4,5,17,74,102,5,2,56,96,40,56,15,40,5,10,16,55,96
2009-01-19 00:00:00.000,Australian Open Australia Grand Slams,HARD,3,Jo-Wilfried Tsonga,Dudi Sela,Jo-Wilfried Tsonga,6-4; 6-2; 1-6; 6-1,R32,140,5,2,62,100,43,62,21,38,8,11,16,64,100,0,2,55,102,35,55,22,47,10,16,16,57,102
2009-01-19 00:00:00.000,Australian Open Australia Grand Slams,HARD,3,Andy Roddick,Fabrice Santoro,Andy Roddick,6-3; 6-4; 6-2,R32,97,22,1,55,73,46,55,12,18,3,3,14,58,73,4,2,45,79,31,45,16,34,7,11,13,47,79
2009-01-19 00:00:00.000,Australian Open Australia Grand Slams,HARD,3,Tommy Robredo,Yen-Hsun Lu,Tommy Robredo,6-1; 6-3; 6-2,R32,108,7,1,53,71,39,53,10,18,3,4,12,49,71,1,2,45,71,26,45,8,26,4,11,12,34,71
2009-01-19 00:00:00.000,Australian Open Australia Grand Slams,HARD,3,Marcos Baghdatis,Mardy Fish,Marcos Baghdatis,6-2; 6-4; 6-4,R32,132,5,4,45,83,36,45,18,38,1,3,14,54,83,10,4,60,111,36,60,24,51,8,14,14,60,111
2009-01-19 00:00:00.000,Australian Open Australia Grand Slams,HARD,3,Novak Djokovic,Amer Delic,Novak Djokovic,6-2; 4-6; 6-3; 7-6(4),R32,183,11,4,84,131,67,84,24,47,8,9,20,91,131,16,6,77,131,59,77,24,54,5,8,19,83,131
2009-01-19 00:00:00.000,Australian Open Australia Grand Slams,HARD,3,Juan Martin Del Potro,Gilles Muller,Juan Martin Del Potro,6-7(5); 7-5; 6-3; 7-5,R32,203,11,3,93,126,77,93,20,33,2,3,23,97,126,22,9,116,179,80,116,28,63,20,24,22,108,179
2009-01-19 00:00:00.000,Australian Open Australia Grand Slams,HARD,3,Marin Cilic,David Ferrer,Marin Cilic,7-6(5); 6-3; 6-4,R32,134,7,0,64,107,44,64,25,43,2,4,16,69,107,0,3,61,89,35,61,20,28,5,9,15,55,89
2009-01-19 00:00:00.000,Australian Open Australia Grand Slams,HARD,3,Tomas Berdych,Stanislas Wawrinka,Tomas Berdych,4-6; 6-1; 6-3; 6-4,R32,195,10,3,77,122,59,77,20,45,6,7,18,79,122,9,2,68,133,45,68,31,65,15,20,18,76,133
2009-01-19 00:00:00.000,Australian Open Australia Grand Slams,HARD,3,Roger Federer,Marat Safin,Roger Federer,6-3; 6-2; 7-6(5),R32,110,9,1,54,89,46,54,22,35,0,0,15,68,89,14,2,44,88,30,44,24,44,1,4,14,54,88
2009-01-19 00:00:00.000,Australian Open Australia Grand Slams,HARD,3,Rafael Nadal,Fernando Gonzalez,Rafael Nadal,6-3; 6-2; 6-4,R16,113,4,0,49,73,38,49,15,24,5,7,14,53,73,6,2,61,89,36,61,10,28,7,13,13,46,89
2009-01-19 00:00:00.000,Australian Open Australia Grand Slams,HARD,3,Gilles Simon,Gael Monfils,Gilles Simon,6-4; 2-6; 6-1 RET,R16,119,3,4,49,77,35,49,10,28,5,9,13,45,77,1,3,50,89,30,50,16,39,5,10,12,46,89
2009-01-19 00:00:00.000,Australian Open Australia Grand Slams,HARD,3,Fernando Verdasco,Andy Murray,Fernando Verdasco,2-6; 6-1; 1-6; 6-3; 6-4,R16,189,10,6,100,135,69,100,12,35,8,13,21,81,135,7,3,85,140,54,85,30,55,12,17,20,84,140
2009-01-19 00:00:00.000,Australian Open Australia Grand Slams,HARD,3,Jo-Wilfried Tsonga,James Blake,Jo-Wilfried Tsonga,6-4; 6-4; 7-6(3),R16,143,12,3,66,104,55,66,18,38,3,4,16,73,104,4,5,56,104,37,56,29,48,3,6,16,66,104
2009-01-19 00:00:00.000,Australian Open Australia Grand Slams,HARD,3,Andy Roddick,Tommy Robredo,Andy Roddick,7-5; 6-1; 6-3,R16,106,13,2,49,78,41,49,17,29,1,1,14,58,78,0,2,54,80,34,54,13,26,2,7,14,47,80
2009-01-19 00:00:00.000,Australian Open Australia Grand Slams,HARD,3,Novak Djokovic,Marcos Baghdatis,Novak Djokovic,6-1; 7-6(1); 6-7(5); 6-2,R16,193,3,3,81,129,60,81,27,48,4,5,20,87,129,12,2,74,136,48,74,28,62,12,17,19,76,136
2009-01-19 00:00:00.000,Australian Open Australia Grand Slams,HARD,3,Juan Martin Del Potro,Marin Cilic,Juan Martin Del Potro,5-7; 6-4; 6-4; 6-2,R16,182,8,3,92,138,64,92,25,46,7,10,20,89,138,10,1,56,113,40,56,30,57,4,10,20,70,113
2009-01-19 00:00:00.000,Australian Open Australia Grand Slams,HARD,3,Roger Federer,Tomas Berdych,Roger Federer,4-6; 6-7(4); 6-4; 6-4; 6-2,R16,205,20,5,108,159,76,108,24,51,7,12,25,100,159,7,2,93,151,65,93,27,58,4,12,25,92,151
2009-01-19 00:00:00.000,Australian Open Australia Grand Slams,HARD,3,Rafael Nadal,Gilles Simon,Rafael Nadal,6-2; 7-5; 7-5,Q,146,5,2,63,94,46,63,18,31,4,7,16,64,94,4,4,52,94,37,52,16,42,5,12,16,53,94
2009-01-19 00:00:00.000,Australian Open Australia Grand Slams,HARD,3,Fernando Verdasco,Jo-Wilfried Tsonga,Fernando Verdasco,7-6(2); 3-6; 6-3; 6-2,Q,164,7,3,103,133,71,103,18,30,11,13,19,89,133,9,3,71,110,51,71,19,39,0,4,19,70,110
2009-01-19 00:00:00.000,Australian Open Australia Grand Slams,HARD,3,Andy Roddick,Novak Djokovic,Andy Roddick,6-7(3); 6-4; 6-2; 2-1 RET,Q,150,16,5,62,87,54,62,11,25,0,1,16,65,87,8,5,72,115,46,72,20,43,7,12,17,66,115
2009-01-19 00:00:00.000,Australian Open Australia Grand Slams,HARD,3,Roger Federer,Juan Martin Del Potro,Roger Federer,6-3; 6-0; 6-0,Q,80,12,0,37,53,32,37,12,16,0,0,11,44,53,5,2,39,66,18,39,9,27,4,11,10,27,66
2009-01-19 00:00:00.000,Australian Open Australia Grand Slams,HARD,3,Rafael Nadal,Fernando Verdasco,Rafael Nadal,6-7(4); 6-4; 7-6(2); 6-7(1); 6-4,S,310,12,3,128,173,92,128,28,45,2,4,28,120,173,21,4,148,212,104,148,35,64,16,20,28,139,212
2009-01-19 00:00:00.000,Australian Open Australia Grand Slams,HARD,3,Roger Federer,Andy Roddick,Roger Federer,6-2; 7-5; 7-5,S,125,16,0,63,96,52,63,19,33,3,3,16,71,96,8,2,61,94,43,61,17,33,9,13,16,60,94
2009-01-19 00:00:00.000,Australian Open Australia Grand Slams,HARD,3,Rafael Nadal,Roger Federer,Rafael Nadal,7-5; 3-6; 7-6(3); 3-6; 6-2,F,259,4,4,112,175,74,112,30,63,13,19,24,104,175,11,6,89,172,65,89,38,83,9,16,26,103,172
2009-02-02 00:00:00.000,Johannesburg South Africa ATP World Tour 250,HARD,2,Jo-Wilfried Tsonga,Thiago Alves,Jo-Wilfried Tsonga,6-4; 6-1,R32,56,11,6,24,51,21,24,16,27,0,0,9,37,51,2,2,23,46,15,23,13,23,2,5,8,28,46
2009-02-02 00:00:00.000,Johannesburg South Africa ATP World Tour 250,HARD,2,Denis Istomin,Santiago Ventura,Denis Istomin,4-6; 6-4; 7-6(3),R32,129,8,10,57,95,43,57,19,38,3,6,16,62,95,2,6,36,89,27,36,31,53,2,5,16,58,89
2009-02-02 00:00:00.000,Johannesburg South Africa ATP World Tour 250,HARD,2,Ivo Minar,Kevin Anderson,Ivo Minar,7-6(4); 6-4,R32,84,8,2,39,68,32,39,15,29,3,4,11,47,68,10,2,47,64,33,47,11,17,1,3,11,44,64
2009-02-02 00:00:00.000,Johannesburg South Africa ATP World Tour 250,HARD,2,Kristof Vliegen,Ross Hutchins,Kristof Vliegen,7-6(3); 6-4,R32,90,8,3,27,57,24,27,26,30,1,1,11,50,57,6,3,47,79,34,47,17,32,2,3,11,51,79
2009-02-02 00:00:00.000,Johannesburg South Africa ATP World Tour 250,HARD,2,Guillermo Garcia-Lopez,Bjorn Phau,Guillermo Garcia-Lopez,6-4; 6-3,R32,69,3,5,30,56,24,30,15,26,1,3,10,39,56,3,7,29,59,19,29,12,30,6,10,9,31,59
2009-02-02 00:00:00.000,Johannesburg South Africa ATP World Tour 250,HARD,2,Leonardo Mayer,Sergio Roitman,Leonardo Mayer,6-2; 6-4,R32,77,8,4,29,51,26,29,10,22,0,1,9,36,51,2,6,35,65,22,35,13,30,5,9,9,35,65
2009-02-02 00:00:00.000,Johannesburg South Africa ATP World Tour 250,HARD,2,Frederico Gil,Daniel Koellerer,Frederico Gil,6-4; 6-0,R32,63,5,5,27,43,24,27,6,16,0,1,8,30,43,1,3,46,70,28,46,6,24,7,12,8,34,70
2009-02-02 00:00:00.000,Johannesburg South Africa ATP World Tour 250,HARD,2,Rik De Voest,Ivan Navarro,Rik De Voest,6-3; 6-4,R32,80,5,2,30,62,25,30,16,32,1,2,10,41,62,7,6,29,56,21,29,12,27,4,7,9,33,56
2009-02-02 00:00:00.000,Johannesburg South Africa ATP World Tour 250,HARD,2,Jeremy Chardy,Jiri Vanek,Jeremy Chardy,6-0; 6-4,R32,62,9,0,23,41,18,23,13,18,1,2,8,31,41,4,7,32,67,19,32,13,35,8,13,8,32,67
2009-02-02 00:00:00.000,Johannesburg South Africa ATP World Tour 250,HARD,2,Marco Chiudinelli,Flavio Cipolla,Marco Chiudinelli,7-5; 1-6; 6-4,R32,148,5,3,52,103,34,52,25,51,7,12,15,59,103,4,9,55,85,38,55,13,30,5,9,14,51,85
2009-02-02 00:00:00.000,Johannesburg South Africa ATP World Tour 250,HARD,2,Izak Van der Merwe,Benjamin Becker,Izak Van der Merwe,7-6(4); 7-6(3),R32,93,10,4,37,67,29,37,19,30,0,2,12,48,67,3,3,37,77,26,37,21,40,0,2,12,47,77
2009-02-02 00:00:00.000,Johannesburg South Africa ATP World Tour 250,HARD,2,Sebastien De Chaunac,Marcel Granollers,Sebastien De Chaunac,7-5; 7-6(3),R32,118,3,6,35,80,28,35,26,45,5,6,12,54,80,8,3,49,85,38,49,17,36,8,10,12,55,85
2009-02-02 00:00:00.000,Johannesburg South Africa ATP World Tour 250,HARD,2,Marcos Baghdatis,Andrew Anderson,Marcos Baghdatis,6-4; 6-2,R32,88,3,7,39,74,29,39,14,35,7,9,9,43,74,1,2,41,62,22,41,9,21,5,10,9,31,62
2009-02-02 00:00:00.000,Johannesburg South Africa ATP World Tour 250,HARD,2,Raven Klaasen,Ruben Ramirez Hidalgo,Raven Klaasen,6-3; 7-5,R32,92,6,0,51,82,38,51,17,31,8,8,11,55,82,4,7,29,58,24,29,11,29,0,2,10,35,58
2009-02-02 00:00:00.000,Johannesburg South Africa ATP World Tour 250,HARD,2,Simon Greul,Victor Crivoi,Simon Greul,6-2; 6-4,R32,62,8,2,21,45,19,21,15,24,1,2,9,34,45,1,5,32,56,19,32,10,24,6,10,9,29,56
2009-02-02 00:00:00.000,Johannesburg South Africa ATP World Tour 250,HARD,2,David Ferrer,Dudi Sela,David Ferrer,6-2; 6-0,R32,58,2,2,22,38,16,22,10,16,3,4,7,26,38,1,3,20,45,9,20,7,25,4,10,7,16,45
2009-02-02 00:00:00.000,Johannesburg South Africa ATP World Tour 250,HARD,2,Jo-Wilfried Tsonga,Denis Istomin,Jo-Wilfried Tsonga,6-1; 6-4,R16,63,4,3,28,50,25,28,12,22,0,0,9,37,50,2,4,22,49,15,22,11,27,0,3,8,26,49
2009-02-02 00:00:00.000,Johannesburg South Africa ATP World Tour 250,HARD,2,Kristof Vliegen,Ivo Minar,Kristof Vliegen,6-4; 6-1,R16,60,7,1,27,42,25,27,7,15,0,0,8,32,42,8,2,31,55,20,31,8,24,4,8,9,28,55
2009-02-02 00:00:00.000,Johannesburg South Africa ATP World Tour 250,HARD,2,Guillermo Garcia-Lopez,Leonardo Mayer,Guillermo Garcia-Lopez,6-4; 7-5,R16,104,1,6,42,74,33,42,18,32,6,7,11,51,74,4,3,42,70,28,42,13,28,0,3,11,41,70
2009-02-02 00:00:00.000,Johannesburg South Africa ATP World Tour 250,HARD,2,Frederico Gil,Rik De Voest,Frederico Gil,4-6; 7-5; 6-4,R16,147,2,0,56,103,39,56,22,47,10,15,16,61,103,6,4,47,97,34,47,17,50,4,10,16,51,97
2009-02-02 00:00:00.000,Johannesburg South Africa ATP World Tour 250,HARD,2,Jeremy Chardy,Marco Chiudinelli,Jeremy Chardy,6-4; 6-4,R16,74,6,2,34,59,27,34,14,25,2,3,10,41,59,3,1,31,56,23,31,13,25,6,9,10,36,56
2009-02-02 00:00:00.000,Johannesburg South Africa ATP World Tour 250,HARD,2,Sebastien De Chaunac,Izak Van der Merwe,Sebastien De Chaunac,6-7(3); 7-5; 7-6(5),R16,169,5,3,68,118,53,68,30,50,7,9,18,83,118,14,5,72,118,58,72,21,46,7,10,18,79,118
2009-02-02 00:00:00.000,Johannesburg South Africa ATP World Tour 250,HARD,2,Marcos Baghdatis,Raven Klaasen,Marcos Baghdatis,6-3; 7-5,R16,90,12,2,39,62,32,39,13,23,4,4,10,45,62,2,6,48,74,30,48,13,26,4,7,11,43,74
2009-02-02 00:00:00.000,Johannesburg South Africa ATP World Tour 250,HARD,2,David Ferrer,Simon Greul,David Ferrer,6-3; 6-4,R16,70,3,2,28,44,22,28,12,16,2,3,9,34,44,1,8,32,69,21,32,16,37,7,11,10,37,69
2009-02-02 00:00:00.000,Johannesburg South Africa ATP World Tour 250,HARD,2,Jo-Wilfried Tsonga,Kristof Vliegen,Jo-Wilfried Tsonga,6-4; 6-1,Q,73,9,3,29,53,26,29,10,24,4,5,9,36,53,5,2,24,55,16,24,12,31,5,9,8,28,55
2009-02-02 00:00:00.000,Johannesburg South Africa ATP World Tour 250,HARD,2,Frederico Gil,Guillermo Garcia-Lopez,Frederico Gil,7-6(6); 6-3,Q,114,2,3,43,82,33,43,23,39,10,11,11,56,82,3,4,46,78,34,46,15,32,4,6,10,49,78
2009-02-02 00:00:00.000,Johannesburg South Africa ATP World Tour 250,HARD,2,Jeremy Chardy,Sebastien De Chaunac,Jeremy Chardy,7-6(4); 6-3,Q,93,7,4,38,70,35,38,17,32,6,6,11,52,70,6,4,39,65,31,39,13,26,2,3,10,44,65
2009-02-02 00:00:00.000,Johannesburg South Africa ATP World Tour 250,HARD,2,David Ferrer,Marcos Baghdatis,David Ferrer,7-5; 6-2,Q,77,1,2,30,58,24,30,18,28,1,1,10,42,58,6,6,31,57,25,31,11,26,0,3,10,36,57
2009-02-02 00:00:00.000,Johannesburg South Africa ATP World Tour 250,HARD,2,Jo-Wilfried Tsonga,Frederico Gil,Jo-Wilfried Tsonga,6-3; 6-4,S,64,6,1,32,52,27,32,12,20,2,3,10,39,52,0,2,25,48,17,25,11,23,1,4,9,28,48
2009-02-02 00:00:00.000,Johannesburg South Africa ATP World Tour 250,HARD,2,Jeremy Chardy,David Ferrer,Jeremy Chardy,1-6; 7-6(9); 7-6(4),S,154,11,3,63,114,46,63,28,51,4,7,15,74,114,9,5,66,117,51,66,29,51,3,4,16,80,117
2009-02-02 00:00:00.000,Johannesburg South Africa ATP World Tour 250,HARD,2,Jo-Wilfried Tsonga,Jeremy Chardy,Jo-Wilfried Tsonga,6-4; 7-6(5),F,109,16,7,37,84,31,37,27,47,8,8,11,58,84,11,2,44,77,36,44,16,33,4,5,11,52,77
2009-02-02 00:00:00.000,ViÂ±a del Mar Chile ATP World Tour 250,CLAY,2,Fernando Gonzalez,N/A Bye,Fernando Gonzalez,,R32,0,0,0,0,0,0,0,0,0,0,0,0,0,0,0,0,0,0,0,0,0,0,0,0,0,0,0
2009-02-02 00:00:00.000,ViÂ±a del Mar Chile ATP World Tour 250,CLAY,2,Maximo Gonzalez,Boris Pashanski,Maximo Gonzalez,6-3; 6-2,R32,71,3,2,28,46,25,28,8,18,0,1,9,33,46,1,7,30,56,16,30,9,26,4,8,8,25,56
2009-02-02 00:00:00.000,ViÂ±a del Mar Chile ATP World Tour 250,CLAY,2,Potito Starace,Marcos Daniel,Potito Starace,6-4; 6-4,R32,77,6,1,35,44,32,35,5,9,0,1,10,37,44,3,6,40,71,27,40,13,31,6,9,10,40,71
2009-02-02 00:00:00.000,ViÂ±a del Mar Chile ATP World Tour 250,CLAY,2,Juan Monaco,Nicolas Devilder,Juan Monaco,6-2; 6-4,R32,83,1,3,36,57,26,36,13,21,3,3,9,39,57,2,2,36,64,21,36,13,28,5,8,9,34,64
2009-02-02 00:00:00.000,ViÂ±a del Mar Chile ATP World Tour 250,CLAY,2,Albert Montanes,N/A Bye,Albert Montanes,,R32,0,0,0,0,0,0,0,0,0,0,0,0,0,0,0,0,0,0,0,0,0,0,0,0,0,0,0
2009-02-02 00:00:00.000,ViÂ±a del Mar Chile ATP World Tour 250,CLAY,2,Pablo Cuevas,Nicolas Lapentti,Pablo Cuevas,6-3; 3-6; 7-5,R32,134,11,4,57,93,42,57,19,36,3,5,15,61,93,6,1,46,79,37,46,16,33,3,6,15,53,79
2009-02-02 00:00:00.000,ViÂ±a del Mar Chile ATP World Tour 250,CLAY,2,Daniel Gimeno-Traver,Alberto Martin,Daniel Gimeno-Traver,6-3; 6-7(2); 6-6 RET,R32,157,3,1,75,114,53,75,23,39,6,8,17,76,114,4,0,75,94,55,75,11,19,0,3,16,66,94
2009-02-02 00:00:00.000,ViÂ±a del Mar Chile ATP World Tour 250,CLAY,2,Paul Capdeville,Eduardo Schwank,Paul Capdeville,6-3; 6-4,R32,96,2,2,34,48,30,34,7,14,0,1,10,37,48,3,1,49,83,33,49,13,34,8,11,9,46,83
2009-02-02 00:00:00.000,ViÂ±a del Mar Chile ATP World Tour 250,CLAY,2,Agustin Calleri,Nicolas Massu,Agustin Calleri,7-6(4); 6-1,R32,100,3,0,44,65,34,44,7,21,1,3,10,41,65,1,2,39,63,21,39,12,24,3,7,9,33,63
2009-02-02 00:00:00.000,ViÂ±a del Mar Chile ATP World Tour 250,CLAY,2,Sebastian Decoud,Fabio Fognini,Sebastian Decoud,6-3; 7-5,R32,96,2,1,42,67,30,42,15,25,3,5,11,45,67,6,2,33,61,25,33,9,28,2,6,10,34,61
2009-02-02 00:00:00.000,ViÂ±a del Mar Chile ATP World Tour 250,CLAY,2,Thomaz Bellucci,Juan Pablo Brzezicki,Thomaz Bellucci,6-2; 6-3,R32,90,5,1,36,60,29,36,12,24,9,9,8,41,60,1,0,48,68,25,48,11,20,8,12,9,36,68
2009-02-02 00:00:00.000,ViÂ±a del Mar Chile ATP World Tour 250,CLAY,2,Jose Acasuso,N/A Bye,Jose Acasuso,,R32,0,0,0,0,0,0,0,0,0,0,0,0,0,0,0,0,0,0,0,0,0,0,0,0,0,0,0
2009-02-02 00:00:00.000,ViÂ±a del Mar Chile ATP World Tour 250,CLAY,2,Martin Vassallo Arguello,Oscar Hernandez,Martin Vassallo Arguello,6-3; 7-6(1),R32,104,0,2,42,63,31,42,12,21,1,3,11,43,63,0,1,39,61,25,39,11,22,5,8,10,36,61
2009-02-02 00:00:00.000,ViÂ±a del Mar Chile ATP World Tour 250,CLAY,2,Juan Ignacio Chela,Pablo Andujar,Juan Ignacio Chela,6-0; 3-6; 6-1,R32,130,0,1,61,92,37,61,16,31,8,11,11,53,92,1,2,53,74,24,53,9,21,5,12,11,33,74
2009-02-02 00:00:00.000,ViÂ±a del Mar Chile ATP World Tour 250,CLAY,2,Brian Dabul,Diego Junqueira,Brian Dabul,6-2; 6-7(2); 6-1,R32,137,2,2,69,102,49,69,16,33,5,6,14,65,102,0,3,59,83,35,59,11,24,2,7,13,46,83
2009-02-02 00:00:00.000,ViÂ±a del Mar Chile ATP World Tour 250,CLAY,2,Tommy Robredo,N/A Bye,Tommy Robredo,,R32,0,0,0,0,0,0,0,0,0,0,0,0,0,0,0,0,0,0,0,0,0,0,0,0,0,0,0
2009-02-02 00:00:00.000,ViÂ±a del Mar Chile ATP World Tour 250,CLAY,2,Fernando Gonzalez,Maximo Gonzalez,Fernando Gonzalez,7-5; 7-6(7),R16,127,8,2,58,78,46,58,7,20,6,8,12,53,78,2,4,80,112,46,80,18,32,13,16,12,64,112
2009-02-02 00:00:00.000,ViÂ±a del Mar Chile ATP World Tour 250,CLAY,2,Juan Monaco,Potito Starace,Juan Monaco,6-3; 6-3,R16,74,2,2,31,48,23,31,10,17,0,1,9,33,48,2,1,41,52,22,41,7,11,5,9,9,29,52
2009-02-02 00:00:00.000,ViÂ±a del Mar Chile ATP World Tour 250,CLAY,2,Pablo Cuevas,Albert Montanes,Pablo Cuevas,7-6(2); 6-4,R16,98,5,1,50,74,37,50,15,24,2,3,11,52,74,1,3,48,71,30,48,12,23,2,4,11,42,71
2009-02-02 00:00:00.000,ViÂ±a del Mar Chile ATP World Tour 250,CLAY,2,Paul Capdeville,Daniel Gimeno-Traver,Paul Capdeville,6-4; 6-3,R16,84,2,0,33,58,24,33,19,25,5,5,10,43,58,1,1,34,57,23,34,14,23,2,4,9,37,57
2009-02-02 00:00:00.000,ViÂ±a del Mar Chile ATP World Tour 250,CLAY,2,Sebastian Decoud,Agustin Calleri,Sebastian Decoud,7-6(3); 7-5,R16,102,2,4,56,76,42,56,9,20,3,5,12,51,76,6,2,45,78,30,45,16,33,3,6,12,46,78
2009-02-02 00:00:00.000,ViÂ±a del Mar Chile ATP World Tour 250,CLAY,2,Jose Acasuso,Thomaz Bellucci,Jose Acasuso,7-6(3); 6-3,R16,119,2,1,42,83,35,42,18,41,4,5,11,53,83,7,2,53,84,36,53,14,31,9,11,10,50,84
2009-02-02 00:00:00.000,ViÂ±a del Mar Chile ATP World Tour 250,CLAY,2,Juan Ignacio Chela,Martin Vassallo Arguello,Juan Ignacio Chela,6-4; 7-6(4),R16,114,4,2,44,63,35,44,12,19,4,5,11,47,63,1,2,44,70,29,44,14,26,1,3,11,43,70
2009-02-02 00:00:00.000,ViÂ±a del Mar Chile ATP World Tour 250,CLAY,2,Tommy Robredo,Brian Dabul,Tommy Robredo,6-3; 7-6(5),R16,106,4,3,46,75,33,46,15,29,4,6,11,48,75,2,3,44,65,29,44,7,21,1,4,10,36,65
2009-02-02 00:00:00.000,ViÂ±a del Mar Chile ATP World Tour 250,CLAY,2,Fernando Gonzalez,Juan Monaco,Fernando Gonzalez,6-0; 6-2,Q,56,1,0,31,36,26,31,2,5,0,0,7,28,36,0,0,38,47,18,38,2,9,4,9,7,20,47
2009-02-02 00:00:00.000,ViÂ±a del Mar Chile ATP World Tour 250,CLAY,2,Pablo Cuevas,Paul Capdeville,Pablo Cuevas,7-5; 7-5,Q,97,5,0,53,73,43,53,12,20,5,6,12,55,73,1,1,45,67,30,45,12,22,2,5,12,42,67
2009-02-02 00:00:00.000,ViÂ±a del Mar Chile ATP World Tour 250,CLAY,2,Jose Acasuso,Sebastian Decoud,Jose Acasuso,6-4; 6-2,Q,88,4,1,28,52,23,28,14,24,1,2,9,37,52,1,1,41,53,25,41,3,12,3,7,9,28,53
2009-02-02 00:00:00.000,ViÂ±a del Mar Chile ATP World Tour 250,CLAY,2,Tommy Robredo,Juan Ignacio Chela,Tommy Robredo,0-6; 6-3; 6-4,Q,129,1,2,57,96,35,57,20,39,4,8,13,55,96,2,3,54,78,37,54,11,24,4,7,12,48,78
2009-02-02 00:00:00.000,ViÂ±a del Mar Chile ATP World Tour 250,CLAY,2,Fernando Gonzalez,Pablo Cuevas,Fernando Gonzalez,6-3; 6-2,S,120,1,0,32,42,28,32,8,10,0,0,9,36,42,0,3,42,61,27,42,7,19,8,11,8,34,61
2009-02-02 00:00:00.000,ViÂ±a del Mar Chile ATP World Tour 250,CLAY,2,Jose Acasuso,Tommy Robredo,Jose Acasuso,5-7; 6-2; 6-4,S,157,1,4,48,85,36,48,21,37,3,5,15,57,85,1,0,64,86,44,64,10,22,4,8,15,54,86
2009-02-02 00:00:00.000,ViÂ±a del Mar Chile ATP World Tour 250,CLAY,2,Fernando Gonzalez,Jose Acasuso,Fernando Gonzalez,6-1; 6-3,F,56,2,0,34,41,27,34,5,7,0,0,8,32,41,2,3,28,49,16,28,7,21,4,8,8,23,49
2009-02-02 00:00:00.000,Zagreb Croatia ATP World Tour 250,HARD,2,Ivan Dodig,Igor Andreev,Ivan Dodig,6-1; 6-4,R32,75,5,5,25,52,22,25,17,27,0,0,9,39,52,2,3,32,56,20,32,11,24,1,4,8,31,56
2009-02-02 00:00:00.000,Zagreb Croatia ATP World Tour 250,HARD,2,Ernests Gulbis,Dmitry Tursunov,Ernests Gulbis,4-6; 6-4; 6-4,R32,116,8,3,55,88,49,55,13,33,2,3,15,62,88,14,5,61,101,44,61,21,40,7,9,15,65,101
2009-02-02 00:00:00.000,Zagreb Croatia ATP World Tour 250,HARD,2,Teymuraz Gabashvili,Mikhail Youzhny,Teymuraz Gabashvili,6-3; 6-4,R32,92,4,2,35,68,28,35,18,33,7,7,10,46,68,3,1,38,54,26,38,7,16,2,4,9,33,54
2009-02-02 00:00:00.000,Zagreb Croatia ATP World Tour 250,HARD,2,Mario Ancic,Lukas Lacko,Mario Ancic,6-4; 6-7(6); 7-5,R32,142,20,2,64,93,53,64,21,29,4,5,17,74,93,7,1,76,117,51,76,24,41,6,9,17,75,117
2009-02-02 00:00:00.000,Zagreb Croatia ATP World Tour 250,HARD,2,Paul-Henri Mathieu,Roko Karanusic,Paul-Henri Mathieu,6-7(6); 6-1; 7-6(3),R32,141,6,5,63,104,44,63,24,41,6,8,16,68,104,7,1,60,114,41,60,25,54,8,12,15,66,114
2009-02-02 00:00:00.000,Zagreb Croatia ATP World Tour 250,HARD,2,Jan Hernych,Nikola Mektic,Jan Hernych,6-3; 7-5,R32,81,2,1,47,68,34,47,12,21,6,7,11,46,68,4,2,39,66,25,39,12,27,3,6,10,37,66
2009-02-02 00:00:00.000,Zagreb Croatia ATP World Tour 250,HARD,2,Victor Hanescu,Lovro Zovko,Victor Hanescu,6-3; 7-5,R32,90,4,0,44,58,35,44,10,14,0,0,11,45,58,4,4,44,62,34,44,6,18,6,8,10,40,62
2009-02-02 00:00:00.000,Zagreb Croatia ATP World Tour 250,HARD,2,Mischa Zverev,Andreas Seppi,Mischa Zverev,7-6(4); 3-6; 6-2,R32,121,5,2,70,103,45,70,14,33,3,9,15,59,103,4,2,45,84,28,45,20,39,4,10,14,48,84
2009-02-02 00:00:00.000,Zagreb Croatia ATP World Tour 250,HARD,2,Viktor Troicki,Simone Bolelli,Viktor Troicki,6-3; 6-4,R32,84,4,2,31,53,27,31,9,22,0,2,10,36,53,1,2,37,66,21,37,13,29,8,12,9,34,66
2009-02-02 00:00:00.000,Zagreb Croatia ATP World Tour 250,HARD,2,Ivan Ljubicic,Christophe Rochus,Ivan Ljubicic,6-4; 6-1,R32,58,18,4,25,50,23,25,13,25,2,3,9,36,50,1,5,39,65,21,39,11,26,5,9,8,32,65
2009-02-02 00:00:00.000,Zagreb Croatia ATP World Tour 250,HARD,2,Sergiy Stakhovsky,Dominik Hrbaty,Sergiy Stakhovsky,6-2; 4-6; 6-1,R32,109,9,3,61,85,49,61,9,24,5,6,13,58,85,1,2,45,85,26,45,21,40,7,11,12,47,85
2009-02-02 00:00:00.000,Zagreb Croatia ATP World Tour 250,HARD,2,Ivo Karlovic,Philipp Petzschner,Ivo Karlovic,6-3; 6-4,R32,62,15,2,33,49,29,33,11,16,0,0,10,40,49,2,3,31,56,24,31,10,25,1,3,9,34,56
2009-02-02 00:00:00.000,Zagreb Croatia ATP World Tour 250,HARD,2,Evgeny Korolev,Jurgen Melzer,Evgeny Korolev,6-4; 6-0,R32,56,2,2,31,46,25,31,6,15,1,2,8,31,46,4,4,25,47,15,25,5,22,2,7,8,20,47
2009-02-02 00:00:00.000,Zagreb Croatia ATP World Tour 250,HARD,2,Antonio Veic,Guillermo Canas,Antonio Veic,4-6; 6-4; 6-2,R32,121,12,2,48,81,34,48,19,33,5,8,14,53,81,4,8,56,107,37,56,22,51,7,12,14,59,107
2009-02-02 00:00:00.000,Zagreb Croatia ATP World Tour 250,HARD,2,Florent Serra,Marc Gicquel,Florent Serra,6-2; 4-6; 7-6(2),R32,114,5,4,68,95,53,68,16,27,5,6,15,69,95,10,9,57,94,47,57,15,37,2,4,15,62,94
2009-02-02 00:00:00.000,Zagreb Croatia ATP World Tour 250,HARD,2,Marin Cilic,Arnaud Clement,Marin Cilic,6-4; 6-3,R32,87,12,2,28,53,25,28,14,25,3,3,9,39,53,2,2,38,67,26,38,12,29,3,6,10,38,67
2009-02-02 00:00:00.000,Zagreb Croatia ATP World Tour 250,HARD,2,Ivan Dodig,Ernests Gulbis,Ivan Dodig,7-6(3); 6-4,R16,105,8,1,43,74,30,43,19,31,3,4,11,49,74,9,6,47,80,32,47,16,33,3,5,11,48,80
2009-02-02 00:00:00.000,Zagreb Croatia ATP World Tour 250,HARD,2,Mario Ancic,Teymuraz Gabashvili,Mario Ancic,6-1; 6-1,R16,68,6,2,18,42,15,18,16,24,0,0,7,31,42,3,5,28,50,16,28,5,22,4,9,7,21,50
2009-02-02 00:00:00.000,Zagreb Croatia ATP World Tour 250,HARD,2,Jan Hernych,Paul-Henri Mathieu,Jan Hernych,6-7(7); 6-4; 6-2,R16,141,2,4,60,97,46,60,22,37,5,6,15,68,97,3,0,52,103,38,52,26,51,4,8,15,64,103
2009-02-02 00:00:00.000,Zagreb Croatia ATP World Tour 250,HARD,2,Mischa Zverev,Victor Hanescu,Mischa Zverev,6-4; 5-7; 7-6(7),R16,157,7,1,92,129,60,92,18,37,14,17,17,78,129,4,1,90,119,55,90,19,29,6,9,17,74,119
2009-02-02 00:00:00.000,Zagreb Croatia ATP World Tour 250,HARD,2,Viktor Troicki,Ivan Ljubicic,Viktor Troicki,6-4; 5-7; 6-4,R16,139,7,0,73,101,50,73,15,28,8,11,16,65,101,19,1,59,99,45,59,14,40,5,9,16,59,99
2009-02-02 00:00:00.000,Zagreb Croatia ATP World Tour 250,HARD,2,Sergiy Stakhovsky,Ivo Karlovic,Sergiy Stakhovsky,6-4; 3-6; 6-3,R16,93,6,0,42,66,38,42,15,24,1,2,14,53,66,12,4,51,79,43,51,14,28,4,6,14,57,79
2009-02-02 00:00:00.000,Zagreb Croatia ATP World Tour 250,HARD,2,Antonio Veic,Evgeny Korolev,Antonio Veic,3-6; 7-6(5); 6-4,R16,150,4,5,64,113,44,64,27,49,6,8,15,71,113,7,4,49,97,41,49,24,48,5,7,16,65,97
2009-02-02 00:00:00.000,Zagreb Croatia ATP World Tour 250,HARD,2,Marin Cilic,Florent Serra,Marin Cilic,6-2; 7-5,R16,83,13,2,35,65,29,35,14,30,2,3,10,43,65,1,3,37,70,20,37,18,33,7,11,10,38,70
2009-02-02 00:00:00.000,Zagreb Croatia ATP World Tour 250,HARD,2,Mario Ancic,Ivan Dodig,Mario Ancic,6-1; 6-3,Q,83,6,0,33,45,25,33,9,12,2,2,8,34,45,5,4,31,56,18,31,11,25,3,7,8,29,56
2009-02-02 00:00:00.000,Zagreb Croatia ATP World Tour 250,HARD,2,Jan Hernych,Mischa Zverev,Jan Hernych,5-4 RET,Q,35,0,0,14,19,12,14,4,5,0,0,4,16,19,1,0,16,33,10,16,10,17,4,5,5,20,33
2009-02-02 00:00:00.000,Zagreb Croatia ATP World Tour 250,HARD,2,Viktor Troicki,Sergiy Stakhovsky,Viktor Troicki,6-3; 6-2,Q,67,5,1,35,51,27,35,9,16,3,3,8,36,51,3,0,47,65,29,47,6,18,4,8,9,35,65
2009-02-02 00:00:00.000,Zagreb Croatia ATP World Tour 250,HARD,2,Marin Cilic,Antonio Veic,Marin Cilic,6-2; 7-6(6),Q,98,4,1,31,64,26,31,19,33,0,1,10,45,64,3,4,42,78,29,42,16,36,10,13,10,45,78
2009-02-02 00:00:00.000,Zagreb Croatia ATP World Tour 250,HARD,2,Mario Ancic,Jan Hernych,Mario Ancic,6-7(4); 6-3; 7-6(9),S,187,12,0,84,124,67,84,14,40,8,11,17,81,124,4,4,83,118,54,83,17,35,3,7,16,71,118
2009-02-02 00:00:00.000,Zagreb Croatia ATP World Tour 250,HARD,2,Marin Cilic,Viktor Troicki,Marin Cilic,6-2; 7-5,S,86,6,1,25,47,22,25,18,22,0,0,10,40,47,3,1,52,80,31,52,14,28,7,10,10,45,80
2009-02-02 00:00:00.000,Zagreb Croatia ATP World Tour 250,HARD,2,Marin Cilic,Mario Ancic,Marin Cilic,6-3; 6-4,F,91,5,2,29,69,18,29,26,40,10,12,10,44,69,4,1,34,54,19,34,10,20,2,6,9,29,54
2009-02-09 00:00:00.000,Costa Do Sauipe Brazil ATP World Tour 250,CLAY,2,Nicolas Almagro,Ricardo Hocevar,Nicolas Almagro,7-6(4); 7-5,R32,103,11,3,33,64,31,33,20,31,0,0,12,51,64,12,3,39,79,25,39,27,40,4,5,12,52,79
2009-02-09 00:00:00.000,Costa Do Sauipe Brazil ATP World Tour 250,CLAY,2,Martin Vassallo Arguello,Nicolas Massu,Martin Vassallo Arguello,7-6(4); 2-6; 6-4,R32,186,2,4,78,115,50,78,17,37,6,11,15,67,115,2,6,55,109,37,55,27,54,11,15,15,64,109
2009-02-09 00:00:00.000,Costa Do Sauipe Brazil ATP World Tour 250,CLAY,2,Frederico Gil,Pablo Andujar,Frederico Gil,3-6; 6-4; 6-3,R32,154,4,3,48,92,29,48,27,44,6,9,14,56,92,2,2,60,82,38,60,13,22,1,5,14,51,82
2009-02-09 00:00:00.000,Costa Do Sauipe Brazil ATP World Tour 250,CLAY,2,Marcel Granollers,Flavio Saretta,Marcel Granollers,6-2; 2-6; 6-1,R32,122,3,2,40,78,28,40,18,38,6,9,11,46,78,2,3,39,70,21,39,15,31,4,10,12,36,70
2009-02-09 00:00:00.000,Costa Do Sauipe Brazil ATP World Tour 250,CLAY,2,Juan Carlos Ferrero,Albert Montanes,Juan Carlos Ferrero,6-7(4); 6-2; 6-2,R32,131,5,4,71,101,50,71,15,30,8,11,14,65,101,4,5,44,95,26,44,23,51,7,14,14,49,95
2009-02-09 00:00:00.000,Costa Do Sauipe Brazil ATP World Tour 250,CLAY,2,Brian Dabul,Paul Capdeville,Brian Dabul,6-1 RET,R32,31,2,1,15,19,14,15,2,4,0,0,4,16,19,0,1,13,18,6,13,2,5,0,2,3,8,18
2009-02-09 00:00:00.000,Costa Do Sauipe Brazil ATP World Tour 250,CLAY,2,Lukasz Kubot,Daniel Gimeno-Traver,Lukasz Kubot,7-6(7); 1-6; 6-3,R32,148,2,4,61,100,39,61,21,39,7,11,14,60,100,10,3,71,106,52,71,15,35,10,13,14,67,106
2009-02-09 00:00:00.000,Costa Do Sauipe Brazil ATP World Tour 250,CLAY,2,Thomaz Bellucci,Potito Starace,Thomaz Bellucci,6-3; 6-4,R32,83,7,5,29,56,26,29,14,27,0,1,10,40,56,0,1,40,64,24,40,11,24,6,9,9,35,64
2009-02-09 00:00:00.000,Costa Do Sauipe Brazil ATP World Tour 250,CLAY,2,Eduardo Schwank,Diego Junqueira,Eduardo Schwank,6-1; 7-5,R32,91,3,2,37,58,24,37,15,21,0,1,10,39,58,0,4,52,78,29,52,11,26,9,13,9,40,78
2009-02-09 00:00:00.000,Costa Do Sauipe Brazil ATP World Tour 250,CLAY,2,Rui Machado,Ivan Navarro,Rui Machado,6-4; 6-1,R32,102,1,0,32,48,22,32,12,16,1,1,8,34,48,2,7,34,73,22,34,14,39,8,12,9,36,73
2009-02-09 00:00:00.000,Costa Do Sauipe Brazil ATP World Tour 250,CLAY,2,Pablo Cuevas,Oscar Hernandez,Pablo Cuevas,4-6; 6-4; 6-1,R32,126,8,1,53,80,38,53,17,27,2,4,14,55,80,1,2,39,71,27,39,17,32,1,5,13,44,71
2009-02-09 00:00:00.000,Costa Do Sauipe Brazil ATP World Tour 250,CLAY,2,Jose Acasuso,Juan Monaco,Jose Acasuso,7-6(3); 6-4,R32,117,2,1,38,73,31,38,22,35,4,5,11,53,73,0,2,47,86,29,47,24,39,7,9,11,53,86
2009-02-09 00:00:00.000,Costa Do Sauipe Brazil ATP World Tour 250,CLAY,2,Nicolas Devilder,Daniel Dutra da Silva,Nicolas Devilder,7-6(5); 6-2,R32,111,2,3,52,75,35,52,14,23,7,9,10,49,75,0,3,38,72,24,38,16,34,5,9,10,40,72
2009-02-09 00:00:00.000,Costa Do Sauipe Brazil ATP World Tour 250,CLAY,2,Alberto Martin,Nicolas Lapentti,Alberto Martin,6-4; 7-5,R32,94,2,0,39,61,32,39,11,22,2,3,11,43,61,2,3,36,65,24,36,16,29,2,5,11,40,65
2009-02-09 00:00:00.000,Costa Do Sauipe Brazil ATP World Tour 250,CLAY,2,Fabio Fognini,Caio Zampieri,Fabio Fognini,0-6; 7-6(5); 6-2,R32,114,3,2,39,81,24,39,22,42,2,7,13,46,81,3,2,47,82,31,47,19,35,2,6,13,50,82
2009-02-09 00:00:00.000,Costa Do Sauipe Brazil ATP World Tour 250,CLAY,2,Tommy Robredo,Thiago Alves,Tommy Robredo,6-4; 6-2,R32,73,5,1,29,42,25,29,11,13,0,0,9,36,42,2,0,38,63,22,38,14,25,1,4,9,36,63
2009-02-09 00:00:00.000,Costa Do Sauipe Brazil ATP World Tour 250,CLAY,2,Nicolas Almagro,Martin Vassallo Arguello,Nicolas Almagro,6-4; 6-4,R16,93,5,2,36,66,26,36,14,30,4,6,10,40,66,4,1,41,58,29,41,3,17,4,8,10,32,58
2009-02-09 00:00:00.000,Costa Do Sauipe Brazil ATP World Tour 250,CLAY,2,Frederico Gil,Marcel Granollers,Frederico Gil,7-5; 3-6; 6-3,R16,157,0,2,61,97,41,61,19,36,4,7,15,60,97,8,4,63,99,44,63,16,36,6,10,15,60,99
2009-02-09 00:00:00.000,Costa Do Sauipe Brazil ATP World Tour 250,CLAY,2,Juan Carlos Ferrero,Brian Dabul,Juan Carlos Ferrero,6-1; 6-2,R16,73,3,0,28,45,21,28,12,17,1,1,8,33,45,0,2,31,45,16,31,6,14,4,8,7,22,45
2009-02-09 00:00:00.000,Costa Do Sauipe Brazil ATP World Tour 250,CLAY,2,Thomaz Bellucci,Lukasz Kubot,Thomaz Bellucci,5-7; 6-4; 6-4,R16,149,18,2,49,91,35,49,27,42,3,6,16,62,91,1,8,59,95,41,59,17,36,1,5,16,58,95
2009-02-09 00:00:00.000,Costa Do Sauipe Brazil ATP World Tour 250,CLAY,2,Eduardo Schwank,Rui Machado,Eduardo Schwank,2-6; 7-6(4); 7-6(6),R16,188,5,5,68,117,42,68,20,49,3,10,16,62,117,3,5,83,120,49,83,17,37,5,10,16,66,120
2009-02-09 00:00:00.000,Costa Do Sauipe Brazil ATP World Tour 250,CLAY,2,Jose Acasuso,Pablo Cuevas,Jose Acasuso,6-3; 6-2,R16,77,2,0,32,52,24,32,14,20,2,2,9,38,52,5,2,23,48,17,23,11,25,4,7,8,28,48
2009-02-09 00:00:00.000,Costa Do Sauipe Brazil ATP World Tour 250,CLAY,2,Alberto Martin,Nicolas Devilder,Alberto Martin,6-2; 7-6(4),R16,109,1,3,53,82,35,53,18,29,9,9,10,53,82,2,2,34,68,24,34,19,34,6,8,10,43,68
2009-02-09 00:00:00.000,Costa Do Sauipe Brazil ATP World Tour 250,CLAY,2,Tommy Robredo,Fabio Fognini,Tommy Robredo,6-2; 6-2,R16,64,3,2,31,47,27,31,7,16,4,4,8,34,47,1,3,31,51,18,31,6,20,4,8,8,24,51
2009-02-09 00:00:00.000,Costa Do Sauipe Brazil ATP World Tour 250,CLAY,2,Frederico Gil,Nicolas Almagro,Frederico Gil,7-6(5); 7-6(4),Q,125,6,3,63,92,50,63,10,29,9,11,12,60,92,11,5,53,84,38,53,15,31,0,2,12,53,84
2009-02-09 00:00:00.000,Costa Do Sauipe Brazil ATP World Tour 250,CLAY,2,Thomaz Bellucci,Juan Carlos Ferrero,Thomaz Bellucci,7-6(5); 1-6; 6-3,Q,146,13,7,71,107,53,71,13,36,7,11,14,66,107,3,2,58,84,36,58,18,26,5,8,14,54,84
2009-02-09 00:00:00.000,Costa Do Sauipe Brazil ATP World Tour 250,CLAY,2,Jose Acasuso,Eduardo Schwank,Jose Acasuso,6-4; 6-3,Q,100,4,1,31,60,20,31,15,29,7,9,9,35,60,0,1,34,57,17,34,12,23,3,8,10,29,57
2009-02-09 00:00:00.000,Costa Do Sauipe Brazil ATP World Tour 250,CLAY,2,Tommy Robredo,Alberto Martin,Tommy Robredo,6-2; 6-2,Q,61,2,0,26,41,22,26,12,15,2,2,8,34,41,0,0,33,50,18,33,7,17,3,7,8,25,50
2009-02-09 00:00:00.000,Costa Do Sauipe Brazil ATP World Tour 250,CLAY,2,Thomaz Bellucci,Frederico Gil,Thomaz Bellucci,7-6(3); 7-6(4),S,136,3,1,41,71,35,41,19,30,3,4,12,54,71,2,2,50,77,37,50,13,27,1,2,12,50,77
2009-02-09 00:00:00.000,Costa Do Sauipe Brazil ATP World Tour 250,CLAY,2,Tommy Robredo,Jose Acasuso,Tommy Robredo,6-2; 6-1,S,63,6,1,33,46,26,33,8,13,2,2,8,34,46,3,5,25,47,16,25,7,22,7,11,7,23,47
2009-02-09 00:00:00.000,Costa Do Sauipe Brazil ATP World Tour 250,CLAY,2,Tommy Robredo,Thomaz Bellucci,Tommy Robredo,6-3; 3-6; 6-4,F,133,1,4,47,82,32,47,22,35,3,5,14,54,82,7,2,56,87,38,56,15,31,2,5,14,53,87
2009-02-09 00:00:00.000,Rotterdam The Netherlands ATP World Tour 500,HARD,2,Rafael Nadal,Simone Bolelli,Rafael Nadal,4-6; 6-2; 7-5,R32,146,9,2,50,81,41,50,18,31,0,1,15,59,81,7,1,67,106,49,67,17,39,12,15,15,66,106
2009-02-09 00:00:00.000,Rotterdam The Netherlands ATP World Tour 500,HARD,2,Grigor Dimitrov,Tomas Berdych,Grigor Dimitrov,4-6; 6-3; 6-4,R32,128,10,1,64,102,48,64,19,38,9,10,15,67,102,9,3,49,80,40,49,15,31,3,5,14,55,80
2009-02-09 00:00:00.000,Rotterdam The Netherlands ATP World Tour 500,HARD,2,Dmitry Tursunov,Arnaud Clement,Dmitry Tursunov,6-0; 6-3,R32,66,8,3,25,46,22,25,12,21,3,3,8,34,46,2,7,24,48,17,24,6,24,6,10,7,23,48
2009-02-09 00:00:00.000,Rotterdam The Netherlands ATP World Tour 500,HARD,2,Jo-Wilfried Tsonga,Jesse Huta Galung,Jo-Wilfried Tsonga,7-6(4); 7-6(4),R32,111,15,5,43,75,39,43,18,32,2,2,12,57,75,8,4,51,88,40,51,21,37,4,4,12,61,88
2009-02-09 00:00:00.000,Rotterdam The Netherlands ATP World Tour 500,HARD,2,Nikolay Davydenko,Igor Andreev,Nikolay Davydenko,6-3; 6-2,R32,68,3,1,30,53,22,30,16,23,1,1,9,38,53,1,0,33,43,21,33,5,10,1,4,8,26,43
2009-02-09 00:00:00.000,Rotterdam The Netherlands ATP World Tour 500,HARD,2,Julien Benneteau,Feliciano Lopez,Julien Benneteau,6-4; 5-7; 6-2,R32,109,12,2,55,75,44,55,14,20,1,2,15,58,75,8,7,47,88,40,47,18,41,6,9,15,58,88
2009-02-09 00:00:00.000,Rotterdam The Netherlands ATP World Tour 500,HARD,2,Michael Llodra,Ivo Karlovic,Michael Llodra,4-6; 6-3; 6-4,R32,102,5,10,50,83,43,50,16,33,2,4,15,59,83,25,2,53,84,43,53,11,31,2,5,14,54,84
2009-02-09 00:00:00.000,Rotterdam The Netherlands ATP World Tour 500,HARD,2,Gael Monfils,Stephane Bohli,Gael Monfils,6-4; 1-0 RET,R32,42,2,2,16,36,13,16,10,20,1,1,5,23,36,5,0,16,29,12,16,7,13,1,3,6,19,29
2009-02-09 00:00:00.000,Rotterdam The Netherlands ATP World Tour 500,HARD,2,David Ferrer,Jurgen Melzer,David Ferrer,3-6; 7-6(4); 7-5,R32,137,2,7,56,98,42,56,19,42,3,8,17,61,98,7,4,70,114,50,70,18,44,3,7,16,68,114
2009-02-09 00:00:00.000,Rotterdam The Netherlands ATP World Tour 500,HARD,2,Mikhail Youzhny,Laurent Recouderc,Mikhail Youzhny,6-4; 6-4,R32,84,2,3,31,59,28,31,14,28,2,2,10,42,59,7,2,37,67,28,37,13,30,3,5,10,41,67
2009-02-09 00:00:00.000,Rotterdam The Netherlands ATP World Tour 500,HARD,2,Mario Ancic,Rainer Schuettler,Mario Ancic,7-5; 6-2,R32,84,6,1,25,51,21,25,15,26,1,3,10,36,51,0,4,31,65,19,31,14,34,8,13,10,33,65
2009-02-09 00:00:00.000,Rotterdam The Netherlands ATP World Tour 500,HARD,2,Gilles Simon,Philipp Kohlschreiber,Gilles Simon,7-5; 7-6(1),R32,110,8,1,43,82,39,43,17,39,6,7,12,56,82,3,5,44,83,30,44,21,39,4,6,12,51,83
2009-02-09 00:00:00.000,Rotterdam The Netherlands ATP World Tour 500,HARD,2,Marc Gicquel,Evgeny Korolev,Marc Gicquel,3-6; 6-3; 6-2,R32,91,5,3,44,84,37,44,19,40,10,11,13,56,84,14,5,42,72,36,42,11,30,3,6,13,47,72
2009-02-09 00:00:00.000,Rotterdam The Netherlands ATP World Tour 500,HARD,2,Paul-Henri Mathieu,Richard Gasquet,Paul-Henri Mathieu,3-6; 7-6(4); 6-3,R32,141,15,3,61,113,42,61,23,52,5,10,16,65,113,14,5,43,95,36,43,21,52,6,10,14,57,95
2009-02-09 00:00:00.000,Rotterdam The Netherlands ATP World Tour 500,HARD,2,Andreas Seppi,Thiemo de Bakker,Andreas Seppi,6-7(5); 6-2; 7-6(1),R32,119,10,2,51,88,44,51,23,37,1,2,16,67,88,13,3,54,103,42,54,23,49,8,11,16,65,103
2009-02-09 00:00:00.000,Rotterdam The Netherlands ATP World Tour 500,HARD,2,Andy Murray,Ivan Ljubicic,Andy Murray,6-3; 6-2,R32,74,7,2,27,54,20,27,17,27,2,3,9,37,54,7,7,24,55,16,24,11,31,2,6,8,27,55
2009-02-09 00:00:00.000,Rotterdam The Netherlands ATP World Tour 500,HARD,2,Rafael Nadal,Grigor Dimitrov,Rafael Nadal,7-5; 3-6; 6-2,R16,146,3,1,51,84,37,51,22,33,7,9,14,59,84,9,6,52,92,37,52,19,40,4,8,15,56,92
2009-02-09 00:00:00.000,Rotterdam The Netherlands ATP World Tour 500,HARD,2,Jo-Wilfried Tsonga,Dmitry Tursunov,Jo-Wilfried Tsonga,7-6(6); 6-2,R16,90,13,4,57,81,41,57,13,24,4,4,10,54,81,7,2,35,63,24,35,15,28,4,6,10,39,63
2009-02-09 00:00:00.000,Rotterdam The Netherlands ATP World Tour 500,HARD,2,Julien Benneteau,Nikolay Davydenko,Julien Benneteau,6-3; 6-2,R16,72,5,0,36,58,27,36,12,22,2,3,9,39,58,2,4,26,48,17,26,5,22,2,6,8,22,48
2009-02-09 00:00:00.000,Rotterdam The Netherlands ATP World Tour 500,HARD,2,Gael Monfils,Michael Llodra,Gael Monfils,6-4; 6-4,R16,72,7,1,40,57,31,40,11,17,1,1,10,42,57,4,4,31,60,26,31,14,29,3,5,10,40,60
2009-02-09 00:00:00.000,Rotterdam The Netherlands ATP World Tour 500,HARD,2,Mikhail Youzhny,David Ferrer,Mikhail Youzhny,6-2; 3-6; 6-2,R16,105,3,3,34,67,27,34,19,33,3,5,12,46,67,4,0,44,78,26,44,17,34,2,7,13,43,78
2009-02-09 00:00:00.000,Rotterdam The Netherlands ATP World Tour 500,HARD,2,Mario Ancic,Gilles Simon,Mario Ancic,6-4; 3-6; 6-3,R16,148,9,2,63,103,49,63,20,40,6,7,14,69,103,6,2,52,103,41,52,26,51,5,7,14,67,103
2009-02-09 00:00:00.000,Rotterdam The Netherlands ATP World Tour 500,HARD,2,Marc Gicquel,Paul-Henri Mathieu,Marc Gicquel,6-4; 6-3,R16,77,3,5,27,57,23,27,17,30,3,3,9,40,57,4,2,29,61,20,29,17,32,2,5,10,37,61
2009-02-09 00:00:00.000,Rotterdam The Netherlands ATP World Tour 500,HARD,2,Andy Murray,Andreas Seppi,Andy Murray,7-6(4); 7-5,R16,107,8,4,50,75,38,50,12,25,4,7,12,50,75,5,2,48,83,32,48,17,35,6,10,12,49,83
2009-02-09 00:00:00.000,Rotterdam The Netherlands ATP World Tour 500,HARD,2,Rafael Nadal,Jo-Wilfried Tsonga,Rafael Nadal,6-4; 6-7(5); 6-4,Q,160,4,2,63,94,48,63,20,31,1,2,16,68,94,26,7,73,111,54,73,15,38,5,8,16,69,111
2009-02-09 00:00:00.000,Rotterdam The Netherlands ATP World Tour 500,HARD,2,Gael Monfils,Julien Benneteau,Gael Monfils,7-6(4); 6-1,Q,77,7,2,40,60,30,40,11,20,1,2,10,41,60,5,2,32,50,22,32,9,18,2,5,9,31,50
2009-02-09 00:00:00.000,Rotterdam The Netherlands ATP World Tour 500,HARD,2,Mario Ancic,Mikhail Youzhny,Mario Ancic,6-4; 6-2,Q,101,9,1,38,64,30,38,14,26,7,7,9,44,64,4,2,23,55,17,23,15,32,5,8,9,32,55
2009-02-09 00:00:00.000,Rotterdam The Netherlands ATP World Tour 500,HARD,2,Andy Murray,Marc Gicquel,Andy Murray,7-6(2); 4-6; 3-0 RET,Q,114,9,1,30,74,23,30,31,44,1,2,12,54,74,8,4,49,85,39,49,16,36,4,6,13,55,85
2009-02-09 00:00:00.000,Rotterdam The Netherlands ATP World Tour 500,HARD,2,Rafael Nadal,Gael Monfils,Rafael Nadal,6-4; 6-4,S,102,1,1,45,63,35,45,8,18,6,7,10,43,63,10,2,37,64,26,37,11,27,3,6,10,37,64
2009-02-09 00:00:00.000,Rotterdam The Netherlands ATP World Tour 500,HARD,2,Andy Murray,Mario Ancic,Andy Murray,6-1; 6-2,S,61,8,1,26,53,22,26,16,27,3,3,8,38,53,1,1,22,37,10,22,7,15,2,6,7,17,37
2009-02-09 00:00:00.000,Rotterdam The Netherlands ATP World Tour 500,HARD,2,Andy Murray,Rafael Nadal,Andy Murray,6-3; 4-6; 6-0,F,111,11,4,36,74,29,36,15,38,3,7,13,44,74,2,3,33,66,18,33,11,33,5,12,12,29,66
2009-02-09 00:00:00.000,San Jose CA; U.S.A. ATP World Tour 250,HARD,2,Andy Roddick,Michael Ryderstedt,Andy Roddick,6-0; 7-6(3),R32,63,7,2,33,52,29,33,14,19,3,3,9,43,52,9,3,32,52,22,32,9,20,0,3,9,31,52
2009-02-09 00:00:00.000,San Jose CA; U.S.A. ATP World Tour 250,HARD,2,Ernests Gulbis,Ricardo Mello,Ernests Gulbis,7-6(4); 6-4,R32,85,9,3,43,69,34,43,15,26,3,3,11,49,69,1,3,46,79,35,46,16,33,4,5,11,51,79
2009-02-09 00:00:00.000,San Jose CA; U.S.A. ATP World Tour 250,HARD,2,Tommy Haas,Lars Poerschke,Tommy Haas,6-1; 7-6(8),R32,75,10,2,37,63,30,37,18,26,0,0,10,48,63,12,6,42,72,32,42,14,30,2,4,9,46,72
2009-02-09 00:00:00.000,San Jose CA; U.S.A. ATP World Tour 250,HARD,2,Christophe Rochus,Igor Kunitsyn,Christophe Rochus,6-2; 7-6(7),R32,102,1,2,29,60,26,29,19,31,1,2,10,45,60,4,0,50,89,27,50,24,39,5,8,10,51,89
2009-02-09 00:00:00.000,San Jose CA; U.S.A. ATP World Tour 250,HARD,2,Radek Stepanek,Dominik Meffert,Radek Stepanek,5-7; 6-3; 6-1,R32,114,5,3,54,83,40,54,17,29,8,10,14,57,83,5,4,58,88,35,58,17,30,8,13,14,52,88
2009-02-09 00:00:00.000,San Jose CA; U.S.A. ATP World Tour 250,HARD,2,Chris Guccione,Guillermo Canas,Chris Guccione,7-6(7); 7-5,R32,94,16,3,46,74,38,46,13,28,1,2,12,51,74,8,2,42,77,34,42,16,35,4,6,12,50,77
2009-02-09 00:00:00.000,San Jose CA; U.S.A. ATP World Tour 250,HARD,2,Taylor Dent,Bobby Reynolds,Taylor Dent,6-3; 6-4,R32,69,9,1,31,51,27,31,14,20,2,2,10,41,51,3,2,29,57,25,29,12,28,4,6,9,37,57
2009-02-09 00:00:00.000,San Jose CA; U.S.A. ATP World Tour 250,HARD,2,Todd Widom,Robby Ginepri,Todd Widom,3-6; 7-6(2); 6-4,R32,126,8,1,82,113,58,82,17,31,8,9,15,75,113,8,1,57,93,45,57,21,36,1,2,16,66,93
2009-02-09 00:00:00.000,San Jose CA; U.S.A. ATP World Tour 250,HARD,2,Sam Querrey,Marcos Baghdatis,Sam Querrey,6-3; 5-7; 7-6(5),R32,118,16,2,63,98,51,63,19,35,5,7,17,70,98,8,2,44,92,35,44,28,48,0,2,16,63,92
2009-02-09 00:00:00.000,San Jose CA; U.S.A. ATP World Tour 250,HARD,2,Denis Gremelmayr,Roko Karanusic,Denis Gremelmayr,3-6; 7-6(4); 6-2,R32,121,3,2,63,106,39,63,24,43,10,14,15,63,106,4,0,68,100,37,68,23,32,8,12,14,60,100
2009-02-09 00:00:00.000,San Jose CA; U.S.A. ATP World Tour 250,HARD,2,Florent Serra,Jarkko Nieminen,Florent Serra,7-5; 6-7(1); 6-4,R32,136,8,2,70,120,47,70,25,50,8,11,17,72,120,10,2,58,109,38,58,29,51,6,11,17,67,109
2009-02-09 00:00:00.000,San Jose CA; U.S.A. ATP World Tour 250,HARD,2,James Blake,Vincent Spadea,James Blake,6-3; 6-4,R32,50,13,2,41,63,34,41,11,22,1,1,10,45,63,3,5,25,46,18,25,11,21,0,2,9,29,46
2009-02-09 00:00:00.000,San Jose CA; U.S.A. ATP World Tour 250,HARD,2,Mardy Fish,Lleyton Hewitt,Mardy Fish,7-6(5); 6-3,R32,94,19,5,44,87,35,44,22,43,10,11,11,57,87,7,3,33,61,25,33,16,28,3,5,10,41,61
2009-02-09 00:00:00.000,San Jose CA; U.S.A. ATP World Tour 250,HARD,2,John Isner,Ramon Delgado,John Isner,7-6(9); 6-4,R32,87,22,1,60,78,41,60,11,18,0,1,11,52,78,5,1,42,65,34,42,9,23,0,2,11,43,65
2009-02-09 00:00:00.000,San Jose CA; U.S.A. ATP World Tour 250,HARD,2,Kei Nishikori,Gilles Muller,Kei Nishikori,7-5; 6-2,R32,63,3,2,30,52,26,30,12,22,2,3,10,38,52,3,4,28,52,17,28,13,24,2,6,10,30,52
2009-02-09 00:00:00.000,San Jose CA; U.S.A. ATP World Tour 250,HARD,2,Juan Martin Del Potro,Andrea Stoppini,Juan Martin Del Potro,7-6(5); 7-6(5),R32,106,10,1,44,76,39,44,19,32,1,1,12,58,76,5,3,44,84,33,44,25,40,3,3,12,58,84
2009-02-09 00:00:00.000,San Jose CA; U.S.A. ATP World Tour 250,HARD,2,Andy Roddick,Ernests Gulbis,Andy Roddick,6-3; 7-6(3),R16,81,10,1,48,74,38,48,15,26,5,5,11,53,74,11,6,43,66,33,43,10,23,5,6,10,43,66
2009-02-09 00:00:00.000,San Jose CA; U.S.A. ATP World Tour 250,HARD,2,Tommy Haas,Christophe Rochus,Tommy Haas,6-2; 7-5,R16,74,18,5,30,59,27,30,16,29,0,0,10,43,59,1,3,46,72,32,46,12,26,5,8,10,44,72
2009-02-09 00:00:00.000,San Jose CA; U.S.A. ATP World Tour 250,HARD,2,Radek Stepanek,Chris Guccione,Radek Stepanek,6-2; 7-6(1),R16,75,11,3,36,60,28,36,15,24,3,4,10,43,60,8,2,45,67,33,45,7,22,5,8,10,40,67
2009-02-09 00:00:00.000,San Jose CA; U.S.A. ATP World Tour 250,HARD,2,Todd Widom,Taylor Dent,Todd Widom,6-7(5); 6-3; 6-2,R16,121,5,2,70,104,53,70,16,34,2,3,15,69,104,13,1,47,80,38,47,15,33,2,6,14,53,80
2009-02-09 00:00:00.000,San Jose CA; U.S.A. ATP World Tour 250,HARD,2,Sam Querrey,Denis Gremelmayr,Sam Querrey,6-3; 6-2,R16,53,12,1,36,50,29,36,9,14,1,1,9,38,50,0,1,33,50,17,33,11,17,3,6,8,28,50
2009-02-09 00:00:00.000,San Jose CA; U.S.A. ATP World Tour 250,HARD,2,James Blake,Florent Serra,James Blake,6-4; 6-3,R16,67,13,1,46,77,39,46,11,31,5,5,10,50,77,8,2,34,58,24,34,10,24,1,3,9,34,58
2009-02-09 00:00:00.000,San Jose CA; U.S.A. ATP World Tour 250,HARD,2,Mardy Fish,John Isner,Mardy Fish,6-2; 6-7(4); 7-5,R16,139,13,4,50,94,44,50,26,44,2,2,16,70,94,15,2,70,115,51,70,22,45,5,8,16,73,115
2009-02-09 00:00:00.000,San Jose CA; U.S.A. ATP World Tour 250,HARD,2,Juan Martin Del Potro,Kei Nishikori,Juan Martin Del Potro,6-2; 6-2,R16,75,8,1,29,52,21,29,13,23,5,6,8,34,52,1,2,22,51,14,22,7,29,4,9,8,21,51
2009-02-09 00:00:00.000,San Jose CA; U.S.A. ATP World Tour 250,HARD,2,Andy Roddick,Tommy Haas,Andy Roddick,7-5; 6-4,Q,98,8,1,39,63,31,39,15,24,0,0,11,46,63,5,4,47,80,31,47,17,33,6,8,11,48,80
2009-02-09 00:00:00.000,San Jose CA; U.S.A. ATP World Tour 250,HARD,2,Radek Stepanek,Todd Widom,Radek Stepanek,5-7; 6-0; 6-0,Q,88,9,1,46,59,36,46,10,13,0,1,12,46,59,1,1,45,69,27,45,7,24,3,9,12,34,69
2009-02-09 00:00:00.000,San Jose CA; U.S.A. ATP World Tour 250,HARD,2,James Blake,Sam Querrey,James Blake,7-6(9); 6-3,Q,67,5,3,44,72,34,44,19,28,2,3,11,53,72,16,1,38,63,31,38,13,25,4,6,10,44,63
2009-02-09 00:00:00.000,San Jose CA; U.S.A. ATP World Tour 250,HARD,2,Mardy Fish,Juan Martin Del Potro,Mardy Fish,6-3; 6-4,Q,88,19,1,39,68,30,39,18,29,4,4,10,48,68,6,3,44,67,30,44,11,23,5,7,9,41,67
2009-02-09 00:00:00.000,San Jose CA; U.S.A. ATP World Tour 250,HARD,2,Radek Stepanek,Andy Roddick,Radek Stepanek,3-6; 7-6(5); 6-4,S,133,12,4,57,104,43,57,30,47,10,11,15,73,104,19,1,78,100,63,78,9,22,3,4,16,72,100
2009-02-09 00:00:00.000,San Jose CA; U.S.A. ATP World Tour 250,HARD,2,Mardy Fish,James Blake,Mardy Fish,6-3; 6-2,S,60,16,2,29,43,27,29,9,14,0,0,9,36,43,4,2,24,52,14,24,14,28,1,4,8,28,52
2009-02-09 00:00:00.000,San Jose CA; U.S.A. ATP World Tour 250,HARD,2,Radek Stepanek,Mardy Fish,Radek Stepanek,3-6; 6-4; 6-2,F,111,5,3,58,81,46,58,9,23,2,3,13,55,81,16,0,52,84,37,52,16,32,3,6,14,53,84
2009-02-16 00:00:00.000,Buenos Aires Argentina ATP World Tour 250,CLAY,2,David Nalbandian,Nicolas Lapentti,David Nalbandian,6-3; 6-3,R32,73,3,1,21,43,17,21,16,22,0,1,9,33,43,1,2,31,54,20,31,9,23,1,5,9,29,54
2009-02-16 00:00:00.000,Buenos Aires Argentina ATP World Tour 250,CLAY,2,Daniel Gimeno-Traver,Gaston Gaudio,Daniel Gimeno-Traver,6-2; 4-6; 6-2,R32,118,3,1,73,98,44,73,12,25,9,13,13,56,98,1,11,50,69,32,50,3,19,6,13,13,35,69
2009-02-16 00:00:00.000,Buenos Aires Argentina ATP World Tour 250,CLAY,2,Juan Carlos Ferrero,Agustin Calleri,Juan Carlos Ferrero,6-3; 6-4,R32,78,1,0,41,53,31,41,11,12,0,0,10,42,53,6,3,39,67,30,39,11,28,2,4,9,41,67
2009-02-16 00:00:00.000,Buenos Aires Argentina ATP World Tour 250,CLAY,2,Marcel Granollers,Thomaz Bellucci,Marcel Granollers,7-5; 7-5,R32,117,2,4,39,78,29,39,20,39,4,7,12,49,78,1,3,37,66,25,37,13,29,4,9,12,38,66
2009-02-16 00:00:00.000,Buenos Aires Argentina ATP World Tour 250,CLAY,2,Maximo Gonzalez,Carlos Moya,Maximo Gonzalez,6-4; 6-4,R32,78,1,3,36,59,27,36,11,23,1,3,10,38,59,4,3,30,54,20,30,11,24,4,8,10,31,54
2009-02-16 00:00:00.000,Buenos Aires Argentina ATP World Tour 250,CLAY,2,Brian Dabul,Nicolas Devilder,Brian Dabul,5-7; 7-5; 6-4,R32,155,2,1,80,108,55,80,16,28,12,15,17,71,108,4,7,65,100,47,65,15,35,5,9,17,62,100
2009-02-16 00:00:00.000,Buenos Aires Argentina ATP World Tour 250,CLAY,2,Juan Monaco,Sergio Roitman,Juan Monaco,6-0; 6-0,R32,59,1,2,12,36,10,12,17,24,4,4,6,27,36,0,2,19,42,6,19,8,23,4,10,6,14,42
2009-02-16 00:00:00.000,Buenos Aires Argentina ATP World Tour 250,CLAY,2,Martin Vassallo Arguello,Albert Montanes,Martin Vassallo Arguello,6-2; 6-3,R32,74,0,3,25,54,18,25,21,29,0,0,9,39,54,1,0,36,50,23,36,6,14,2,5,8,29,50
2009-02-16 00:00:00.000,Buenos Aires Argentina ATP World Tour 250,CLAY,2,Pablo Cuevas,Eduardo Schwank,Pablo Cuevas,6-3; 6-7(4); 6-0,R32,152,8,4,49,81,39,49,20,32,2,4,14,59,81,2,4,57,94,32,57,18,37,6,12,13,50,94
2009-02-16 00:00:00.000,Buenos Aires Argentina ATP World Tour 250,CLAY,2,Franco Ferreiro,Ivan Navarro,Franco Ferreiro,1-6; 6-4; 6-2,R32,126,1,8,56,94,39,56,16,38,5,8,13,55,94,4,2,33,65,23,33,19,32,0,3,12,42,65
2009-02-16 00:00:00.000,Buenos Aires Argentina ATP World Tour 250,CLAY,2,Juan Ignacio Chela,Alberto Martin,Juan Ignacio Chela,6-3; 6-2,R32,69,0,2,38,57,27,38,12,19,3,4,9,39,57,1,1,25,41,13,25,6,16,4,8,8,19,41
2009-02-16 00:00:00.000,Buenos Aires Argentina ATP World Tour 250,CLAY,2,Tommy Robredo,Potito Starace,Tommy Robredo,5-7; 6-3; 6-3,R32,112,6,1,60,81,47,60,14,21,2,3,15,61,81,1,3,60,87,41,60,16,27,2,5,15,57,87
2009-02-16 00:00:00.000,Buenos Aires Argentina ATP World Tour 250,CLAY,2,Jose Acasuso,Daniel Munoz-De La Nava,Jose Acasuso,6-2; 7-6(4),R32,110,5,3,39,68,24,39,17,29,2,5,10,41,68,1,2,33,61,23,33,11,28,2,7,10,34,61
2009-02-16 00:00:00.000,Buenos Aires Argentina ATP World Tour 250,CLAY,2,Fabio Fognini,Pablo Andujar,Fabio Fognini,6-3; 6-2,R32,77,4,6,34,58,27,34,10,24,8,9,8,37,58,1,1,36,50,19,36,6,14,0,5,9,25,50
2009-02-16 00:00:00.000,Buenos Aires Argentina ATP World Tour 250,CLAY,2,Diego Junqueira,Nicolas Massu,Diego Junqueira,3-6; 6-4; 6-4,R32,165,3,3,56,88,34,56,20,32,2,6,15,54,88,5,6,63,105,39,63,19,42,9,13,14,58,105
2009-02-16 00:00:00.000,Buenos Aires Argentina ATP World Tour 250,CLAY,2,Oscar Hernandez,Nicolas Almagro,Oscar Hernandez,6-2; 1-6; 6-3,R32,112,2,2,57,79,38,57,13,22,3,5,12,51,79,2,3,49,74,36,49,11,25,2,5,12,47,74
2009-02-16 00:00:00.000,Buenos Aires Argentina ATP World Tour 250,CLAY,2,David Nalbandian,Daniel Gimeno-Traver,David Nalbandian,7-5; 6-2,R16,84,2,4,29,65,24,29,19,36,1,2,10,43,65,2,3,47,63,29,47,5,16,4,8,10,34,63
2009-02-16 00:00:00.000,Buenos Aires Argentina ATP World Tour 250,CLAY,2,Juan Carlos Ferrero,Marcel Granollers,Juan Carlos Ferrero,6-7(7); 6-0; 6-3,R16,147,1,1,65,91,41,65,17,26,1,3,14,58,91,3,2,43,84,28,43,16,41,5,11,13,44,84
2009-02-16 00:00:00.000,Buenos Aires Argentina ATP World Tour 250,CLAY,2,Maximo Gonzalez,Brian Dabul,Maximo Gonzalez,6-3; 6-1,R16,65,2,2,21,39,19,21,13,18,0,0,8,32,39,1,3,36,52,20,36,8,16,5,9,8,28,52
2009-02-16 00:00:00.000,Buenos Aires Argentina ATP World Tour 250,CLAY,2,Juan Monaco,Martin Vassallo Arguello,Juan Monaco,6-4; 2-6; 6-2,R16,134,1,4,39,67,29,39,16,28,0,3,13,45,67,2,3,53,93,33,53,20,40,10,14,13,53,93
2009-02-16 00:00:00.000,Buenos Aires Argentina ATP World Tour 250,CLAY,2,Franco Ferreiro,Pablo Cuevas,Franco Ferreiro,6-2; 6-4,R16,84,0,4,40,67,28,40,17,27,6,6,9,45,67,4,3,36,54,25,36,6,18,2,5,9,31,54
2009-02-16 00:00:00.000,Buenos Aires Argentina ATP World Tour 250,CLAY,2,Tommy Robredo,Juan Ignacio Chela,Tommy Robredo,6-2; 3-6; 6-4,R16,121,3,3,40,74,27,40,19,34,6,10,13,46,74,0,4,61,93,39,61,9,32,10,16,14,48,93
2009-02-16 00:00:00.000,Buenos Aires Argentina ATP World Tour 250,CLAY,2,Jose Acasuso,Fabio Fognini,Jose Acasuso,6-4; 6-3,R16,108,2,2,34,64,23,34,21,30,2,2,10,44,64,4,2,46,75,33,46,11,29,5,7,9,44,75
2009-02-16 00:00:00.000,Buenos Aires Argentina ATP World Tour 250,CLAY,2,Oscar Hernandez,Diego Junqueira,Oscar Hernandez,3-6; 7-6(5); 6-0,R16,139,1,2,70,96,45,70,8,26,5,10,14,53,96,1,4,60,84,31,60,13,24,7,13,13,44,84
2009-02-16 00:00:00.000,Buenos Aires Argentina ATP World Tour 250,CLAY,2,David Nalbandian,Juan Carlos Ferrero,David Nalbandian,6-3; 3-0 RET,Q,57,2,0,20,39,14,20,11,19,2,3,6,25,39,0,0,25,37,12,25,4,12,6,10,6,16,37
2009-02-16 00:00:00.000,Buenos Aires Argentina ATP World Tour 250,CLAY,2,Juan Monaco,Maximo Gonzalez,Juan Monaco,6-2; 6-3,Q,77,1,4,41,57,27,41,7,16,2,4,9,34,57,0,1,30,50,17,30,5,20,2,7,8,22,50
2009-02-16 00:00:00.000,Buenos Aires Argentina ATP World Tour 250,CLAY,2,Tommy Robredo,Franco Ferreiro,Tommy Robredo,6-4; 7-6(4),Q,111,0,2,53,79,33,53,14,26,5,8,11,47,79,1,3,55,82,36,55,10,27,4,8,11,46,82
2009-02-16 00:00:00.000,Buenos Aires Argentina ATP World Tour 250,CLAY,2,Jose Acasuso,Oscar Hernandez,Jose Acasuso,6-1; 6-2,Q,73,2,0,18,36,17,18,12,18,0,0,7,29,36,0,3,35,52,19,35,5,17,5,10,8,24,52
2009-02-16 00:00:00.000,Buenos Aires Argentina ATP World Tour 250,CLAY,2,Juan Monaco,David Nalbandian,Juan Monaco,2-6; 7-5; 7-6(2),S,161,3,2,81,107,51,81,13,26,3,8,16,64,107,1,4,60,104,39,60,26,44,6,10,16,65,104
2009-02-16 00:00:00.000,Buenos Aires Argentina ATP World Tour 250,CLAY,2,Tommy Robredo,Jose Acasuso,Tommy Robredo,6-4; 7-6(3),S,122,2,1,80,98,53,80,10,18,9,10,11,63,98,3,1,43,69,34,43,11,26,3,5,11,45,69
2009-02-16 00:00:00.000,Buenos Aires Argentina ATP World Tour 250,CLAY,2,Tommy Robredo,Juan Monaco,Tommy Robredo,7-5; 2-6; 7-6(5),F,165,1,3,76,101,43,76,13,25,3,8,16,56,101,0,2,91,121,56,91,12,30,8,12,16,68,121
2009-02-16 00:00:00.000,Marseille France ATP World Tour 250,HARD,2,Novak Djokovic,Jeremy Chardy,Novak Djokovic,7-6(4); 6-4,R32,87,11,3,47,68,42,47,9,21,1,1,11,51,68,13,3,43,67,34,43,14,24,3,4,11,48,67
2009-02-16 00:00:00.000,Marseille France ATP World Tour 250,HARD,2,Jan Hernych,Kristof Vliegen,Jan Hernych,6-3; 3-6; 6-4,R32,122,2,1,57,88,47,57,15,31,9,10,14,62,88,10,3,49,89,36,49,24,40,3,5,14,60,89
2009-02-16 00:00:00.000,Marseille France ATP World Tour 250,HARD,2,Mischa Zverev,Illya Marchenko,Mischa Zverev,6-7(5); 6-3; 6-4,R32,133,7,1,69,98,51,69,17,29,6,7,15,68,98,3,7,54,100,43,54,19,46,4,8,16,62,100
2009-02-16 00:00:00.000,Marseille France ATP World Tour 250,HARD,2,Arnaud Clement,Marat Safin,Arnaud Clement,4-6; 6-3; 6-2,R32,115,3,3,42,73,36,42,17,31,1,3,14,53,73,18,0,41,80,30,41,16,39,5,9,13,46,80
2009-02-16 00:00:00.000,Marseille France ATP World Tour 250,HARD,2,Jo-Wilfried Tsonga,Andrey Golubev,Jo-Wilfried Tsonga,7-6(5); 6-2,R32,80,7,3,37,62,26,37,18,25,1,2,10,44,62,7,3,35,64,28,35,11,29,5,8,10,39,64
2009-02-16 00:00:00.000,Marseille France ATP World Tour 250,HARD,2,Simone Bolelli,Richard Bloomfield,Simone Bolelli,7-6(5); 7-6(1),R32,101,7,1,56,77,47,56,13,21,1,1,12,60,77,14,1,43,73,38,43,17,30,0,0,12,55,73
2009-02-16 00:00:00.000,Marseille France ATP World Tour 250,HARD,2,Dmitry Tursunov,Teymuraz Gabashvili,Dmitry Tursunov,3-6; 6-2; 6-2,R32,101,11,1,46,70,32,46,14,24,0,3,13,46,70,4,5,35,70,20,35,17,35,0,5,12,37,70
2009-02-16 00:00:00.000,Marseille France ATP World Tour 250,HARD,2,Feliciano Lopez,Ivan Ljubicic,Feliciano Lopez,3-6; 6-4; 7-5,R32,131,13,2,51,86,35,51,22,35,3,5,15,57,86,12,1,60,108,40,60,26,48,6,9,16,66,108
2009-02-16 00:00:00.000,Marseille France ATP World Tour 250,HARD,2,Mikhail Youzhny,Tomas Berdych,Mikhail Youzhny,6-4; 6-7(2); 6-1,R32,142,10,3,43,97,34,43,34,54,1,1,15,68,97,7,5,52,90,43,52,17,38,3,6,14,60,90
2009-02-16 00:00:00.000,Marseille France ATP World Tour 250,HARD,2,Andreas Seppi,Jerzy Janowicz,Andreas Seppi,7-6(5); 3-6; 7-6(3),R32,140,2,1,61,96,46,61,23,35,5,7,16,69,96,14,2,73,115,55,73,23,42,8,9,17,78,115
2009-02-16 00:00:00.000,Marseille France ATP World Tour 250,HARD,2,Michael Llodra,Rik De Voest,Michael Llodra,7-6(2); 6-1,R32,78,11,0,44,58,37,44,8,14,0,0,10,45,58,3,3,53,72,32,53,11,19,10,12,9,43,72
2009-02-16 00:00:00.000,Marseille France ATP World Tour 250,HARD,2,Paul-Henri Mathieu,Gael Monfils,Paul-Henri Mathieu,4-6; 6-4; 7-5,R32,130,4,1,68,112,44,68,29,44,10,11,16,73,112,26,6,47,89,43,47,20,42,1,3,16,63,89
2009-02-16 00:00:00.000,Marseille France ATP World Tour 250,HARD,2,George Bastl,Marc Gicquel,George Bastl,6-4; 6-3,R32,67,8,4,36,67,26,36,15,31,1,3,10,41,67,2,3,33,69,22,33,15,36,1,5,9,37,69
2009-02-16 00:00:00.000,Marseille France ATP World Tour 250,HARD,2,Julien Benneteau,Fabrice Santoro,Julien Benneteau,4-6; 6-4; 6-2,R32,135,11,5,41,78,33,41,23,37,4,6,14,56,78,4,1,53,107,34,53,27,54,7,11,14,61,107
2009-02-16 00:00:00.000,Marseille France ATP World Tour 250,HARD,2,Rainer Schuettler,Laurent Recouderc,Rainer Schuettler,6-1; 6-4,R32,67,8,3,32,56,26,32,13,24,2,2,9,39,56,1,1,17,44,12,17,11,27,1,4,8,23,44
2009-02-16 00:00:00.000,Marseille France ATP World Tour 250,HARD,2,Gilles Simon,Grigor Dimitrov,Gilles Simon,4-6; 6-3; 7-5,R32,129,7,1,43,93,35,43,28,50,7,10,16,63,93,3,2,57,99,39,57,20,42,6,10,15,59,99
2009-02-16 00:00:00.000,Marseille France ATP World Tour 250,HARD,2,Novak Djokovic,Jan Hernych,Novak Djokovic,7-5; 6-4,R16,93,5,1,47,70,31,47,13,23,5,7,11,44,70,2,4,46,72,30,46,10,26,3,7,11,40,72
2009-02-16 00:00:00.000,Marseille France ATP World Tour 250,HARD,2,Mischa Zverev,Arnaud Clement,Mischa Zverev,6-4; 5-7; 6-2,R16,144,15,4,63,94,45,63,17,31,7,9,15,62,94,4,2,66,102,45,66,15,36,6,10,15,60,102
2009-02-16 00:00:00.000,Marseille France ATP World Tour 250,HARD,2,Jo-Wilfried Tsonga,Simone Bolelli,Jo-Wilfried Tsonga,6-3; 6-2,R16,60,10,1,31,44,27,31,9,13,0,0,9,36,44,2,1,28,49,18,28,9,21,3,6,8,27,49
2009-02-16 00:00:00.000,Marseille France ATP World Tour 250,HARD,2,Feliciano Lopez,Dmitry Tursunov,Feliciano Lopez,7-6(4); 7-6(1),R16,101,18,3,48,80,42,48,19,32,2,2,12,61,80,8,1,45,74,35,45,21,29,2,2,12,56,74
2009-02-16 00:00:00.000,Marseille France ATP World Tour 250,HARD,2,Mikhail Youzhny,Andreas Seppi,Mikhail Youzhny,7-6(2); 6-3,R16,104,4,3,47,74,33,47,14,27,4,6,10,47,74,6,1,42,78,27,42,15,36,7,11,11,42,78
2009-02-16 00:00:00.000,Marseille France ATP World Tour 250,HARD,2,Michael Llodra,Paul-Henri Mathieu,Michael Llodra,6-3; 7-6(1),R16,82,19,3,37,57,29,37,14,20,0,1,11,43,57,4,5,42,69,28,42,11,27,1,3,10,39,69
2009-02-16 00:00:00.000,Marseille France ATP World Tour 250,HARD,2,Julien Benneteau,George Bastl,Julien Benneteau,6-1; 2-6; 6-1,R16,100,12,5,42,78,31,42,17,36,9,11,11,48,78,3,5,30,59,20,30,10,29,2,7,11,30,59
2009-02-16 00:00:00.000,Marseille France ATP World Tour 250,HARD,2,Gilles Simon,Rainer Schuettler,Gilles Simon,6-4; 4-6; 6-2,R16,120,8,2,42,79,31,42,20,37,4,8,14,51,79,4,4,51,94,32,51,18,43,10,16,14,50,94
2009-02-16 00:00:00.000,Marseille France ATP World Tour 250,HARD,2,Novak Djokovic,Mischa Zverev,Novak Djokovic,6-3; 6-3,Q,69,6,1,32,52,24,32,14,20,0,0,9,38,52,3,2,35,60,21,35,12,25,1,4,9,33,60
2009-02-16 00:00:00.000,Marseille France ATP World Tour 250,HARD,2,Jo-Wilfried Tsonga,Feliciano Lopez,Jo-Wilfried Tsonga,6-2; 6-7(1); 6-4,Q,105,18,0,58,79,47,58,15,21,0,0,15,62,79,11,1,72,99,54,72,10,27,5,8,15,64,99
2009-02-16 00:00:00.000,Marseille France ATP World Tour 250,HARD,2,Michael Llodra,Mikhail Youzhny,Michael Llodra,7-6(4); 7-6(3),Q,116,12,5,47,87,40,47,20,40,8,9,12,60,87,4,1,43,77,38,43,14,34,0,1,12,52,77
2009-02-16 00:00:00.000,Marseille France ATP World Tour 250,HARD,2,Gilles Simon,Julien Benneteau,Gilles Simon,6-2; 6-4,Q,80,4,1,28,58,25,28,17,30,3,3,9,42,58,6,5,36,64,25,36,9,28,7,10,9,34,64
2009-02-16 00:00:00.000,Marseille France ATP World Tour 250,HARD,2,Jo-Wilfried Tsonga,Novak Djokovic,Jo-Wilfried Tsonga,6-4; 7-6(1),S,86,9,1,47,67,38,47,12,20,5,5,11,50,67,8,0,49,67,35,49,11,18,2,3,11,46,67
2009-02-16 00:00:00.000,Marseille France ATP World Tour 250,HARD,2,Michael Llodra,Gilles Simon,Michael Llodra,7-6(5); 6-2,S,77,12,2,46,66,41,46,10,20,2,2,10,51,66,6,3,30,58,20,30,20,28,0,2,10,40,58
2009-02-16 00:00:00.000,Marseille France ATP World Tour 250,HARD,2,Jo-Wilfried Tsonga,Michael Llodra,Jo-Wilfried Tsonga,7-5; 7-6(3),F,104,11,0,46,69,40,46,11,23,1,2,12,51,69,7,4,46,80,34,46,17,34,4,6,12,51,80
2009-02-16 00:00:00.000,Memphis TN; U.S.A. ATP World Tour 500,HARD,2,Andy Roddick,Steve Darcis,Andy Roddick,7-6(1); 6-2,R32,67,20,0,39,51,36,39,8,12,0,0,10,44,51,7,1,34,64,25,34,15,30,4,6,10,40,64
2009-02-16 00:00:00.000,Memphis TN; U.S.A. ATP World Tour 500,HARD,2,Robby Ginepri,Simon Greul,Robby Ginepri,6-4; 6-4,R32,81,6,3,43,70,33,43,12,27,8,9,10,45,70,5,5,37,67,25,37,11,30,3,6,10,36,67
2009-02-16 00:00:00.000,Memphis TN; U.S.A. ATP World Tour 500,HARD,2,Marcos Baghdatis,Kei Nishikori,Marcos Baghdatis,7-5; 6-3,R32,83,7,1,27,57,22,27,15,30,4,7,11,37,57,1,3,40,65,22,40,11,25,3,8,10,33,65
2009-02-16 00:00:00.000,Memphis TN; U.S.A. ATP World Tour 500,HARD,2,Sam Querrey,Tommy Haas,Sam Querrey,7-6(4); 6-4,R32,79,11,6,33,58,31,33,13,25,2,4,11,44,58,8,5,50,79,32,50,15,29,5,8,11,47,79
2009-02-16 00:00:00.000,Memphis TN; U.S.A. ATP World Tour 500,HARD,2,Lleyton Hewitt,James Blake,Lleyton Hewitt,3-6; 6-1; 6-4,R32,126,7,3,46,104,37,46,31,58,10,11,13,68,104,9,4,51,87,36,51,17,36,6,9,13,53,87
2009-02-16 00:00:00.000,Memphis TN; U.S.A. ATP World Tour 500,HARD,2,Chris Guccione,Vincent Spadea,Chris Guccione,7-6(1); 7-6(5),R32,78,19,4,51,80,49,51,12,29,3,3,12,61,80,10,2,38,71,31,38,24,33,1,1,12,55,71
2009-02-16 00:00:00.000,Memphis TN; U.S.A. ATP World Tour 500,HARD,2,Christophe Rochus,Donald Young,Christophe Rochus,6-4; 6-3,R32,65,4,3,33,56,25,33,14,23,1,2,10,39,56,4,3,34,59,23,34,9,25,4,7,9,32,59
2009-02-16 00:00:00.000,Memphis TN; U.S.A. ATP World Tour 500,HARD,2,Mardy Fish,Yen-Hsun Lu,Mardy Fish,6-1; 7-5,R32,74,8,1,29,54,26,29,13,25,0,1,10,39,54,2,4,34,52,19,34,9,18,4,8,9,28,52
2009-02-16 00:00:00.000,Memphis TN; U.S.A. ATP World Tour 500,HARD,2,Igor Kunitsyn,Igor Andreev,Igor Kunitsyn,1-6; 6-4; 6-3,R32,105,4,1,50,83,37,50,17,33,3,5,13,54,83,10,2,53,81,40,53,12,28,3,5,13,52,81
2009-02-16 00:00:00.000,Memphis TN; U.S.A. ATP World Tour 500,HARD,2,Philipp Petzschner,Jarkko Nieminen,Philipp Petzschner,6-3; 6-4,R32,64,9,3,37,66,28,37,17,29,5,5,10,45,66,2,0,33,51,26,33,9,18,6,8,9,35,51
2009-02-16 00:00:00.000,Memphis TN; U.S.A. ATP World Tour 500,HARD,2,Dudi Sela,Bobby Reynolds,Dudi Sela,7-6(4); 6-2,R32,97,3,5,43,82,27,43,18,39,2,5,10,45,82,6,6,35,70,23,35,13,35,6,11,10,36,70
2009-02-16 00:00:00.000,Memphis TN; U.S.A. ATP World Tour 500,HARD,2,Florent Serra,Robin Soderling,Florent Serra,6-4; 6-7(1); 6-2,R32,107,12,1,63,89,50,63,13,26,2,3,15,63,89,20,4,63,98,49,63,14,35,6,10,15,63,98
2009-02-16 00:00:00.000,Memphis TN; U.S.A. ATP World Tour 500,HARD,2,Radek Stepanek,Kevin Kim,Radek Stepanek,6-4; 6-2,R32,62,2,5,34,49,25,34,6,15,2,4,9,31,49,6,3,38,64,22,38,8,26,7,12,9,30,64
2009-02-16 00:00:00.000,Memphis TN; U.S.A. ATP World Tour 500,HARD,2,Stefan Koubek,Guillermo Garcia-Lopez,Stefan Koubek,6-2; 6-2,R32,66,0,3,25,49,17,25,11,24,0,2,8,28,49,2,8,24,51,13,24,6,27,2,8,8,19,51
2009-02-16 00:00:00.000,Memphis TN; U.S.A. ATP World Tour 500,HARD,2,Ernests Gulbis,Taylor Dent,Ernests Gulbis,6-4; 3-6; 6-2,R32,95,11,5,50,82,37,50,12,32,7,11,13,49,82,7,7,44,74,29,44,12,30,3,9,14,41,74
2009-02-16 00:00:00.000,Memphis TN; U.S.A. ATP World Tour 500,HARD,2,Juan Martin Del Potro,Guillermo Canas,Juan Martin Del Potro,6-3; 7-6(5),R32,101,11,2,52,71,36,52,16,19,1,1,11,52,71,9,2,34,72,25,34,20,38,3,4,10,45,72
2009-02-16 00:00:00.000,Memphis TN; U.S.A. ATP World Tour 500,HARD,2,Andy Roddick,Robby Ginepri,Andy Roddick,6-2; 6-3,R16,62,11,0,35,44,27,35,7,9,0,1,9,34,44,4,1,35,57,21,35,7,22,8,12,8,28,57
2009-02-16 00:00:00.000,Memphis TN; U.S.A. ATP World Tour 500,HARD,2,Sam Querrey,Marcos Baghdatis,Sam Querrey,6-1; 6-2,R16,52,8,2,28,47,24,28,11,19,2,2,8,35,47,5,2,22,45,15,22,7,23,2,6,7,22,45
2009-02-16 00:00:00.000,Memphis TN; U.S.A. ATP World Tour 500,HARD,2,Lleyton Hewitt,Chris Guccione,Lleyton Hewitt,6-2; 7-6(4),R16,64,10,0,34,54,30,34,16,20,0,0,10,46,54,12,2,38,58,30,38,8,20,2,4,10,38,58
2009-02-16 00:00:00.000,Memphis TN; U.S.A. ATP World Tour 500,HARD,2,Christophe Rochus,Mardy Fish,Christophe Rochus,6-2; 6-4,R16,64,4,3,36,51,27,36,8,15,3,4,9,35,51,14,2,26,58,19,26,14,32,9,13,9,33,58
2009-02-16 00:00:00.000,Memphis TN; U.S.A. ATP World Tour 500,HARD,2,Igor Kunitsyn,Philipp Petzschner,Igor Kunitsyn,3-6; 6-4; 6-4,R16,123,3,1,44,80,31,44,21,36,5,8,14,52,80,7,4,58,108,42,58,20,50,8,12,15,62,108
2009-02-16 00:00:00.000,Memphis TN; U.S.A. ATP World Tour 500,HARD,2,Dudi Sela,Florent Serra,Dudi Sela,7-6(4); 7-6(4),R16,103,4,3,54,92,36,54,21,38,5,8,12,57,92,3,2,51,88,34,51,19,37,2,5,12,53,88
2009-02-16 00:00:00.000,Memphis TN; U.S.A. ATP World Tour 500,HARD,2,Radek Stepanek,Stefan Koubek,Radek Stepanek,6-2; 6-4,R16,65,7,4,31,53,27,31,10,22,5,6,9,37,53,0,2,29,51,17,29,11,22,2,6,9,28,51
2009-02-16 00:00:00.000,Memphis TN; U.S.A. ATP World Tour 500,HARD,2,Juan Martin Del Potro,Ernests Gulbis,Juan Martin Del Potro,6-3; 6-4,R16,72,5,1,26,46,18,26,13,20,1,3,9,31,46,3,4,31,58,18,31,12,27,3,8,10,30,58
2009-02-16 00:00:00.000,Memphis TN; U.S.A. ATP World Tour 500,HARD,2,Andy Roddick,Sam Querrey,Andy Roddick,6-4; 3-6; 6-3,Q,103,11,1,64,82,49,64,9,18,1,2,14,58,82,15,4,48,84,36,48,20,36,4,6,14,56,84
2009-02-16 00:00:00.000,Memphis TN; U.S.A. ATP World Tour 500,HARD,2,Lleyton Hewitt,Christophe Rochus,Lleyton Hewitt,6-2; 6-3,Q,75,6,1,25,45,20,25,12,20,2,3,8,32,45,3,5,42,71,24,42,12,29,3,8,9,36,71
2009-02-16 00:00:00.000,Memphis TN; U.S.A. ATP World Tour 500,HARD,2,Dudi Sela,Igor Kunitsyn,Dudi Sela,4-6; 6-4; 6-2,Q,123,2,0,45,88,31,45,25,43,6,9,14,56,88,6,2,44,83,28,44,20,39,8,13,14,48,83
2009-02-16 00:00:00.000,Memphis TN; U.S.A. ATP World Tour 500,HARD,2,Radek Stepanek,Juan Martin Del Potro,Radek Stepanek,7-6(7); 6-4,Q,128,11,6,56,90,44,56,14,34,5,6,11,58,90,11,3,58,86,41,58,12,28,5,7,11,53,86
2009-02-16 00:00:00.000,Memphis TN; U.S.A. ATP World Tour 500,HARD,2,Andy Roddick,Lleyton Hewitt,Andy Roddick,2-6; 7-6(4); 6-4,S,131,16,3,76,103,57,76,13,27,5,7,15,70,103,14,2,53,95,44,53,23,42,8,9,15,67,95
2009-02-16 00:00:00.000,Memphis TN; U.S.A. ATP World Tour 500,HARD,2,Radek Stepanek,Dudi Sela,Radek Stepanek,6-3; 6-1,S,57,8,0,26,40,23,26,9,14,0,0,8,32,40,2,0,27,44,15,27,8,17,3,7,8,23,44
2009-02-16 00:00:00.000,Memphis TN; U.S.A. ATP World Tour 500,HARD,2,Andy Roddick,Radek Stepanek,Andy Roddick,7-5; 7-5,F,104,8,1,53,78,37,53,13,25,3,4,12,50,78,7,3,38,67,28,38,15,29,1,4,12,43,67
2009-02-23 00:00:00.000,Acapulco Mexico ATP World Tour 500,CLAY,2,Daniel Koellerer,David Nalbandian,Daniel Koellerer,1-6; 6-3; 6-4,R32,140,2,3,52,86,33,52,16,34,8,13,13,49,86,3,5,50,88,30,50,20,38,4,9,13,50,88
2009-02-23 00:00:00.000,Acapulco Mexico ATP World Tour 500,CLAY,2,Alberto Martin,Marcos Daniel,Alberto Martin,6-4; 7-5,R32,101,2,3,45,73,36,45,12,28,7,8,11,48,73,8,7,41,66,30,41,10,25,1,4,11,40,66
2009-02-23 00:00:00.000,Acapulco Mexico ATP World Tour 500,CLAY,2,Martin Vassallo Arguello,Ivan Navarro,Martin Vassallo Arguello,6-3; 5-7; 7-6(3),R32,172,5,2,71,104,56,71,17,33,4,6,17,73,104,8,7,56,111,42,56,28,55,10,12,16,70,111
2009-02-23 00:00:00.000,Acapulco Mexico ATP World Tour 500,CLAY,2,Marcel Granollers,Fabio Fognini,Marcel Granollers,7-6(3); 7-5,R32,143,3,5,51,94,35,51,22,43,4,7,12,57,94,3,3,48,89,27,48,21,41,6,10,12,48,89
2009-02-23 00:00:00.000,Acapulco Mexico ATP World Tour 500,CLAY,2,Nicolas Almagro,Santiago Gonzalez,Nicolas Almagro,6-4; 6-2,R32,63,10,0,27,46,23,27,14,19,0,0,9,37,46,3,2,35,57,24,35,7,22,5,8,9,31,57
2009-02-23 00:00:00.000,Acapulco Mexico ATP World Tour 500,CLAY,2,Potito Starace,Oscar Hernandez,Potito Starace,6-4; 6-2,R32,84,1,1,44,57,33,44,7,13,5,6,9,40,57,0,3,39,53,22,39,7,14,2,6,9,29,53
2009-02-23 00:00:00.000,Acapulco Mexico ATP World Tour 500,CLAY,2,Daniel Gimeno-Traver,Nicolas Lapentti,Daniel Gimeno-Traver,6-4; 5-7; 6-3,R32,148,0,4,68,102,43,68,17,34,6,10,16,60,102,2,2,61,97,39,61,18,36,5,10,15,57,97
2009-02-23 00:00:00.000,Acapulco Mexico ATP World Tour 500,CLAY,2,Albert Montanes,Bruno Echagaray,Albert Montanes,6-1; 6-4,R32,83,3,3,32,57,23,32,13,25,2,4,8,36,57,1,1,40,56,19,40,6,16,1,7,9,25,56
2009-02-23 00:00:00.000,Acapulco Mexico ATP World Tour 500,CLAY,2,Jose Acasuso,Brian Dabul,Jose Acasuso,6-3; 7-5,R32,90,10,1,50,72,40,50,9,22,6,7,11,49,72,3,2,30,53,20,30,11,23,2,5,10,31,53
2009-02-23 00:00:00.000,Acapulco Mexico ATP World Tour 500,CLAY,2,Juan Ignacio Chela,Pablo Cuevas,Juan Ignacio Chela,2-6; 6-3; 6-2,R32,127,0,6,57,88,40,57,14,31,6,9,13,54,88,8,2,47,75,32,47,13,28,3,7,12,45,75
2009-02-23 00:00:00.000,Acapulco Mexico ATP World Tour 500,CLAY,2,Kevin Kim,Juan Monaco,Kevin Kim,1-6; 3-0 RET,R32,33,0,0,15,30,10,15,4,15,0,3,5,14,30,0,1,14,27,9,14,5,13,0,2,5,14,27
2009-02-23 00:00:00.000,Acapulco Mexico ATP World Tour 500,CLAY,2,Tommy Robredo,Ruben Ramirez Hidalgo,Tommy Robredo,6-4; 3-6; 6-3,R32,122,8,1,50,83,37,50,15,33,5,8,14,52,83,1,6,45,89,32,45,21,44,9,13,14,53,89
2009-02-23 00:00:00.000,Acapulco Mexico ATP World Tour 500,CLAY,2,Carlos Moya,Pablo Andujar,Carlos Moya,6-4; 6-7(2); 6-2,R32,128,5,5,53,100,38,53,23,47,7,9,15,61,100,3,3,60,79,41,60,8,19,4,9,15,49,79
2009-02-23 00:00:00.000,Acapulco Mexico ATP World Tour 500,CLAY,2,Leonardo Mayer,Diego Junqueira,Leonardo Mayer,7-6(1); 6-3,R32,90,12,2,43,73,35,43,14,30,2,4,11,49,73,0,1,41,60,22,41,10,19,0,3,10,32,60
2009-02-23 00:00:00.000,Acapulco Mexico ATP World Tour 500,CLAY,2,Thomaz Bellucci,Nicolas Devilder,Thomaz Bellucci,3-6; 6-4; 6-4,R32,162,6,3,63,94,41,63,12,31,7,11,14,53,94,4,5,72,109,41,72,21,37,13,18,15,62,109
2009-02-23 00:00:00.000,Acapulco Mexico ATP World Tour 500,CLAY,2,Gael Monfils,Olivier Patience,Gael Monfils,7-6(4); 6-4,R32,103,17,2,32,62,31,32,18,30,2,3,11,49,62,3,1,46,87,34,46,21,41,6,8,11,55,87
2009-02-23 00:00:00.000,Acapulco Mexico ATP World Tour 500,CLAY,2,Daniel Koellerer,Alberto Martin,Daniel Koellerer,6-4; 5-7; 7-6(4),R16,177,3,1,71,102,50,71,16,31,3,7,17,66,102,1,6,58,107,41,58,25,49,8,12,17,66,107
2009-02-23 00:00:00.000,Acapulco Mexico ATP World Tour 500,CLAY,2,Martin Vassallo Arguello,Marcel Granollers,Martin Vassallo Arguello,6-4; 6-3,R16,100,1,1,42,57,32,42,9,15,1,2,10,41,57,2,2,43,69,27,43,10,26,5,8,9,37,69
2009-02-23 00:00:00.000,Acapulco Mexico ATP World Tour 500,CLAY,2,Nicolas Almagro,Potito Starace,Nicolas Almagro,7-6(1); 6-7(5); 6-3,R16,154,18,3,67,108,53,67,26,41,2,3,17,79,108,3,0,82,106,60,82,14,24,3,5,16,74,106
2009-02-23 00:00:00.000,Acapulco Mexico ATP World Tour 500,CLAY,2,Daniel Gimeno-Traver,Albert Montanes,Daniel Gimeno-Traver,7-6(5); 7-6(5),R16,110,2,1,57,82,42,57,13,25,4,6,12,55,82,4,3,56,78,41,56,10,22,3,5,12,51,78
2009-02-23 00:00:00.000,Acapulco Mexico ATP World Tour 500,CLAY,2,Jose Acasuso,Juan Ignacio Chela,Jose Acasuso,7-5; 6-3,R16,117,2,0,43,78,34,43,15,35,6,7,11,49,78,2,4,41,62,27,41,9,21,5,8,10,36,62
2009-02-23 00:00:00.000,Acapulco Mexico ATP World Tour 500,CLAY,2,Tommy Robredo,Kevin Kim,Tommy Robredo,6-2; 6-0,R16,80,2,0,23,32,21,23,7,9,0,0,7,28,32,4,2,30,47,17,30,2,17,2,7,7,19,47
2009-02-23 00:00:00.000,Acapulco Mexico ATP World Tour 500,CLAY,2,Leonardo Mayer,Carlos Moya,Leonardo Mayer,6-4; 7-5,R16,101,3,0,45,67,35,45,14,22,4,4,11,49,67,4,4,36,72,23,36,23,36,4,6,11,46,72
2009-02-23 00:00:00.000,Acapulco Mexico ATP World Tour 500,CLAY,2,Gael Monfils,Thomaz Bellucci,Gael Monfils,7-6(4); 6-7(5); 6-1,R16,144,6,2,62,97,50,62,21,35,2,3,16,71,97,3,2,55,99,38,55,24,44,7,10,15,62,99
2009-02-23 00:00:00.000,Acapulco Mexico ATP World Tour 500,CLAY,2,Martin Vassallo Arguello,Daniel Koellerer,Martin Vassallo Arguello,6-3; 7-6(6),Q,119,7,0,49,71,39,49,10,22,1,2,11,49,71,0,1,50,62,32,50,7,12,2,4,10,39,62
2009-02-23 00:00:00.000,Acapulco Mexico ATP World Tour 500,CLAY,2,Nicolas Almagro,Daniel Gimeno-Traver,Nicolas Almagro,6-2; 7-6(2),Q,74,14,2,38,52,35,38,8,14,0,0,10,43,52,1,2,47,61,34,47,3,14,0,2,10,37,61
2009-02-23 00:00:00.000,Acapulco Mexico ATP World Tour 500,CLAY,2,Jose Acasuso,Tommy Robredo,Jose Acasuso,7-5; 6-2,Q,87,5,1,42,61,33,42,12,19,1,1,10,45,61,2,1,34,52,25,34,9,18,4,7,10,34,52
2009-02-23 00:00:00.000,Acapulco Mexico ATP World Tour 500,CLAY,2,Gael Monfils,Leonardo Mayer,Gael Monfils,6-3; 6-7(4); 4-1 RET,Q,126,8,4,56,90,42,56,22,34,3,3,14,64,90,3,2,47,85,37,47,17,38,9,11,12,54,85
2009-02-23 00:00:00.000,Acapulco Mexico ATP World Tour 500,CLAY,2,Nicolas Almagro,Martin Vassallo Arguello,Nicolas Almagro,6-4; 6-4,S,100,6,4,36,73,25,36,21,37,4,5,10,46,73,1,1,40,59,24,40,12,19,3,6,10,36,59
2009-02-23 00:00:00.000,Acapulco Mexico ATP World Tour 500,CLAY,2,Gael Monfils,Jose Acasuso,Gael Monfils,6-3; 6-4,S,85,11,2,38,59,34,38,11,21,4,4,10,45,59,4,0,36,61,27,36,10,25,4,6,9,37,61
2009-02-23 00:00:00.000,Acapulco Mexico ATP World Tour 500,CLAY,2,Nicolas Almagro,Gael Monfils,Nicolas Almagro,6-4; 6-4,F,77,5,2,29,51,23,29,15,22,0,1,10,38,51,7,2,35,59,27,35,9,24,5,8,10,36,59
2009-02-23 00:00:00.000,Delray Beach FL; U.S.A. ATP World Tour 250,HARD,2,Mardy Fish,Frank Dancevic,Mardy Fish,7-5; 6-3,R32,81,11,1,44,72,35,44,14,28,4,5,11,49,72,2,1,34,65,25,34,15,31,6,9,10,40,65
2009-02-23 00:00:00.000,Delray Beach FL; U.S.A. ATP World Tour 250,HARD,2,Vincent Spadea,Denis Gremelmayr,Vincent Spadea,2-6; 7-5; 6-1,R32,98,8,1,35,80,28,35,21,45,10,15,14,49,80,3,2,38,79,24,38,18,41,6,12,13,42,79
2009-02-23 00:00:00.000,Delray Beach FL; U.S.A. ATP World Tour 250,HARD,2,Mischa Zverev,Taylor Dent,Mischa Zverev,6-4; 6-3,R32,66,3,0,31,55,23,31,12,24,0,2,9,35,55,3,8,47,66,26,47,9,19,4,9,10,35,66
2009-02-23 00:00:00.000,Delray Beach FL; U.S.A. ATP World Tour 250,HARD,2,Florent Serra,Jarkko Nieminen,Florent Serra,6-3; 7-6(5),R32,83,3,1,46,70,29,46,14,24,2,5,11,43,70,3,2,37,71,19,37,17,34,1,5,10,36,71
2009-02-23 00:00:00.000,Delray Beach FL; U.S.A. ATP World Tour 250,HARD,2,Marcos Baghdatis,Ernests Gulbis,Marcos Baghdatis,7-5; 6-2,R32,73,13,1,30,60,25,30,16,30,6,7,10,41,60,5,1,40,66,19,40,17,26,6,10,10,36,66
2009-02-23 00:00:00.000,Delray Beach FL; U.S.A. ATP World Tour 250,HARD,2,Dudi Sela,Philipp Petzschner,Dudi Sela,6-3; 4-1 RET,R32,37,2,1,23,35,18,23,8,12,1,2,7,26,35,2,2,26,38,14,26,3,12,0,4,7,17,38
2009-02-23 00:00:00.000,Delray Beach FL; U.S.A. ATP World Tour 250,HARD,2,Andrey Golubev,Evan King,Andrey Golubev,6-2; 6-4,R32,69,2,2,27,49,22,27,12,22,0,1,9,34,49,0,3,31,63,16,31,18,32,7,11,9,34,63
2009-02-23 00:00:00.000,Delray Beach FL; U.S.A. ATP World Tour 250,HARD,2,Jeremy Chardy,Tommy Haas,Jeremy Chardy,7-6(7); 6-3,R32,89,8,1,44,64,35,44,14,20,4,5,11,49,64,3,4,49,81,33,49,15,32,3,5,10,48,81
2009-02-23 00:00:00.000,Delray Beach FL; U.S.A. ATP World Tour 250,HARD,2,Guillermo Garcia-Lopez,Steve Darcis,Guillermo Garcia-Lopez,6-3; 6-3,R32,77,1,2,31,55,22,31,14,24,3,4,9,36,55,2,4,27,61,17,27,15,34,5,9,9,32,61
2009-02-23 00:00:00.000,Delray Beach FL; U.S.A. ATP World Tour 250,HARD,2,Gilles Muller,Ryan Sweeting,Gilles Muller,7-6(5); 6-2,R32,88,16,4,42,72,35,42,12,30,4,5,10,47,72,6,7,39,67,29,39,9,28,4,7,10,38,67
2009-02-23 00:00:00.000,Delray Beach FL; U.S.A. ATP World Tour 250,HARD,2,Robert Kendrick,Paul Capdeville,Robert Kendrick,4-6; 6-2; 6-1,R32,89,19,0,52,77,38,52,12,25,3,6,13,50,77,1,3,38,69,23,38,10,31,2,8,12,33,69
2009-02-23 00:00:00.000,Delray Beach FL; U.S.A. ATP World Tour 250,HARD,2,Evgeny Korolev,Igor Kunitsyn,Evgeny Korolev,6-4; 7-6(3),R32,93,3,4,40,65,28,40,14,25,2,5,11,42,65,6,4,65,83,40,65,6,18,5,9,11,46,83
2009-02-23 00:00:00.000,Delray Beach FL; U.S.A. ATP World Tour 250,HARD,2,Yen-Hsun Lu,Lleyton Hewitt,Yen-Hsun Lu,7-5; 2-6; 6-2,R32,118,3,4,65,98,47,65,10,33,6,10,14,57,98,8,4,41,75,28,41,18,34,4,9,14,46,75
2009-02-23 00:00:00.000,Delray Beach FL; U.S.A. ATP World Tour 250,HARD,2,Stefan Koubek,Bobby Reynolds,Stefan Koubek,6-4; 6-3,R32,60,7,5,33,59,26,33,13,26,0,1,10,39,59,2,3,29,51,21,29,9,22,0,3,9,30,51
2009-02-23 00:00:00.000,Delray Beach FL; U.S.A. ATP World Tour 250,HARD,2,Christophe Rochus,Roko Karanusic,Christophe Rochus,6-3; 6-4,R32,65,3,4,41,63,29,41,10,22,0,2,10,39,63,7,1,35,54,20,35,8,19,5,9,9,28,54
2009-02-23 00:00:00.000,Delray Beach FL; U.S.A. ATP World Tour 250,HARD,2,Sam Querrey,Guillermo Canas,Sam Querrey,7-6(3); 6-4,R32,99,13,3,37,68,29,37,15,31,1,3,11,44,68,2,5,36,84,24,36,23,48,7,10,11,47,84
2009-02-23 00:00:00.000,Delray Beach FL; U.S.A. ATP World Tour 250,HARD,2,Mardy Fish,Vincent Spadea,Mardy Fish,6-4; 6-1,R16,68,6,3,30,59,22,30,14,29,4,6,9,36,59,3,0,35,48,17,35,6,13,3,8,8,23,48
2009-02-23 00:00:00.000,Delray Beach FL; U.S.A. ATP World Tour 250,HARD,2,Florent Serra,Mischa Zverev,Florent Serra,6-3; 4-6; 6-4,R16,114,3,3,56,82,38,56,9,26,1,7,15,47,82,5,4,54,92,33,54,14,38,10,17,14,47,92
2009-02-23 00:00:00.000,Delray Beach FL; U.S.A. ATP World Tour 250,HARD,2,Marcos Baghdatis,Dudi Sela,Marcos Baghdatis,7-6(7); 6-3,R16,83,4,1,33,66,20,33,22,33,2,5,11,42,66,0,4,42,66,24,42,13,24,0,4,10,37,66
2009-02-23 00:00:00.000,Delray Beach FL; U.S.A. ATP World Tour 250,HARD,2,Jeremy Chardy,Andrey Golubev,Jeremy Chardy,7-6(4); 7-5,R16,101,6,1,44,70,34,44,15,26,0,1,12,49,70,4,2,62,106,41,62,20,44,10,12,12,61,106
2009-02-23 00:00:00.000,Delray Beach FL; U.S.A. ATP World Tour 250,HARD,2,Guillermo Garcia-Lopez,Gilles Muller,Guillermo Garcia-Lopez,5-7; 6-3; 6-3,R16,128,3,7,51,95,42,51,22,44,4,7,15,64,95,13,1,59,89,39,59,13,30,5,10,15,52,89
2009-02-23 00:00:00.000,Delray Beach FL; U.S.A. ATP World Tour 250,HARD,2,Evgeny Korolev,Robert Kendrick,Evgeny Korolev,3-6; 6-3; 7-5,R16,101,3,6,55,96,38,55,20,41,7,11,15,58,96,10,6,45,80,35,45,15,35,2,7,15,50,80
2009-02-23 00:00:00.000,Delray Beach FL; U.S.A. ATP World Tour 250,HARD,2,Stefan Koubek,Yen-Hsun Lu,Stefan Koubek,6-4; 6-3,R16,66,5,3,36,61,31,36,11,25,4,5,10,42,61,1,1,34,56,23,34,11,22,5,8,9,34,56
2009-02-23 00:00:00.000,Delray Beach FL; U.S.A. ATP World Tour 250,HARD,2,Christophe Rochus,Sam Querrey,Christophe Rochus,6-4; 6-1,R16,52,1,0,26,40,19,26,9,14,0,1,8,28,40,7,1,25,51,15,25,12,26,4,9,9,27,51
2009-02-23 00:00:00.000,Delray Beach FL; U.S.A. ATP World Tour 250,HARD,2,Mardy Fish,Florent Serra,Mardy Fish,7-6(2); 7-6(4),Q,89,9,0,41,70,35,41,19,29,0,1,12,54,70,8,2,54,77,39,54,13,23,2,3,12,52,77
2009-02-23 00:00:00.000,Delray Beach FL; U.S.A. ATP World Tour 250,HARD,2,Jeremy Chardy,Marcos Baghdatis,Jeremy Chardy,7-6(7); 7-6(3),Q,109,3,4,52,83,41,52,17,31,4,6,12,58,83,3,3,43,80,35,43,21,37,3,5,12,56,80
2009-02-23 00:00:00.000,Delray Beach FL; U.S.A. ATP World Tour 250,HARD,2,Evgeny Korolev,Guillermo Garcia-Lopez,Evgeny Korolev,6-2; 6-2,Q,55,7,0,22,40,17,22,12,18,0,1,8,29,40,1,4,32,47,16,32,4,15,4,9,8,20,47
2009-02-23 00:00:00.000,Delray Beach FL; U.S.A. ATP World Tour 250,HARD,2,Christophe Rochus,Stefan Koubek,Christophe Rochus,6-3; 7-6(6),Q,91,1,6,49,77,37,49,12,28,5,7,11,49,77,5,3,27,66,21,27,20,39,2,5,10,41,66
2009-02-23 00:00:00.000,Delray Beach FL; U.S.A. ATP World Tour 250,HARD,2,Mardy Fish,Jeremy Chardy,Mardy Fish,6-4; 6-1,S,77,9,1,30,53,24,30,13,23,2,3,9,37,53,2,2,30,59,18,30,10,29,4,8,8,28,59
2009-02-23 00:00:00.000,Delray Beach FL; U.S.A. ATP World Tour 250,HARD,2,Evgeny Korolev,Christophe Rochus,Evgeny Korolev,6-1; 7-5,S,80,7,2,29,53,22,29,11,24,1,3,9,33,53,1,3,48,77,27,48,10,29,8,14,10,37,77
2009-02-23 00:00:00.000,Delray Beach FL; U.S.A. ATP World Tour 250,HARD,2,Mardy Fish,Evgeny Korolev,Mardy Fish,7-5; 6-3,F,93,6,2,43,81,32,43,18,38,5,7,11,50,81,1,1,34,60,21,34,14,26,5,9,10,35,60
2009-02-23 00:00:00.000,Dubai U.A.E. ATP World Tour 500,HARD,2,Novak Djokovic,Flavio Cipolla,Novak Djokovic,6-3; 6-2,R32,79,5,1,44,71,31,44,12,27,4,6,9,43,71,1,3,29,54,14,29,11,25,6,11,8,25,54
2009-02-23 00:00:00.000,Dubai U.A.E. ATP World Tour 500,HARD,2,Jan Hernych,Mikhail Youzhny,Jan Hernych,4-6; 6-1; 6-4,R32,112,3,0,67,83,45,67,9,16,7,9,13,54,83,2,4,68,88,44,68,6,20,4,9,14,50,88
2009-02-23 00:00:00.000,Dubai U.A.E. ATP World Tour 500,HARD,2,Julien Benneteau,Jurgen Melzer,Julien Benneteau,1-6; 6-3; 6-3,R32,101,3,1,52,79,36,52,14,27,6,8,12,50,79,6,6,39,69,29,39,17,30,2,5,13,46,69
2009-02-23 00:00:00.000,Dubai U.A.E. ATP World Tour 500,HARD,2,Marin Cilic,Janko Tipsarevic,Marin Cilic,2-6; 7-6(3); 6-4,R32,141,13,2,63,84,51,63,11,21,3,5,15,62,84,6,2,69,105,51,69,20,36,6,7,15,71,105
2009-02-23 00:00:00.000,Dubai U.A.E. ATP World Tour 500,HARD,2,Gilles Simon,Mohammad Ghareeb,Gilles Simon,5-7; 6-4; 6-4,R32,127,6,2,49,81,40,49,19,32,4,7,16,59,81,9,6,72,117,48,72,19,45,9,13,16,67,117
2009-02-23 00:00:00.000,Dubai U.A.E. ATP World Tour 500,HARD,2,Teymuraz Gabashvili,Laurent Recouderc,Teymuraz Gabashvili,5-7; 7-6(4); 6-3,R32,142,12,3,53,101,47,53,27,48,5,6,17,74,101,11,5,56,111,44,56,30,55,7,8,16,74,111
2009-02-23 00:00:00.000,Dubai U.A.E. ATP World Tour 500,HARD,2,Fabrice Santoro,Victor Hanescu,Fabrice Santoro,6-4; 6-2,R32,66,2,0,28,43,24,28,12,15,0,0,9,36,43,5,1,39,57,27,39,6,18,0,3,9,33,57
2009-02-23 00:00:00.000,Dubai U.A.E. ATP World Tour 500,HARD,2,Marco Chiudinelli,Ivo Karlovic,Marco Chiudinelli,7-6(4); 4-6; 7-6(7),R32,156,3,0,82,116,62,82,19,34,4,5,17,81,116,19,2,65,104,60,65,19,39,4,4,17,79,104
2009-02-23 00:00:00.000,Dubai U.A.E. ATP World Tour 500,HARD,2,Igor Andreev,Rik De Voest,Igor Andreev,6-4; 6-0,R32,61,1,1,30,45,26,30,8,15,1,1,8,34,45,2,0,24,51,15,24,12,27,4,8,8,27,51
2009-02-23 00:00:00.000,Dubai U.A.E. ATP World Tour 500,HARD,2,Dmitry Tursunov,Andreas Seppi,Dmitry Tursunov,6-1; 6-4,R32,77,2,1,37,60,30,37,11,23,4,4,9,41,60,2,3,29,48,21,29,7,19,5,8,8,28,48
2009-02-23 00:00:00.000,Dubai U.A.E. ATP World Tour 500,HARD,2,Philipp Kohlschreiber,Michael Lammer,Philipp Kohlschreiber,6-1; 6-1,R32,62,4,1,29,42,23,29,8,13,2,2,7,31,42,0,2,24,45,11,24,8,21,6,11,7,19,45
2009-02-23 00:00:00.000,Dubai U.A.E. ATP World Tour 500,HARD,2,David Ferrer,Ivan Ljubicic,David Ferrer,3-6; 6-2; 6-1,R32,106,4,2,46,69,35,46,14,23,2,3,12,49,69,8,3,43,80,32,43,14,37,8,12,12,46,80
2009-02-23 00:00:00.000,Dubai U.A.E. ATP World Tour 500,HARD,2,Richard Gasquet,Marat Safin,Richard Gasquet,6-3; 5-7; 6-3,R32,115,10,3,51,85,37,51,26,34,3,4,15,63,85,10,1,46,85,34,46,21,39,5,8,15,55,85
2009-02-23 00:00:00.000,Dubai U.A.E. ATP World Tour 500,HARD,2,Simone Bolelli,Viktor Troicki,Simone Bolelli,6-3; 6-4,R32,79,3,1,32,52,26,32,14,20,0,0,10,40,52,3,4,31,66,25,31,14,35,1,3,9,39,66
2009-02-23 00:00:00.000,Dubai U.A.E. ATP World Tour 500,HARD,2,Arnaud Clement,Rainer Schuettler,Arnaud Clement,1-6; 6-3; 6-3,R32,139,3,2,47,94,33,47,18,47,6,11,13,51,94,4,2,48,79,28,48,15,31,6,11,12,43,79
2009-02-23 00:00:00.000,Dubai U.A.E. ATP World Tour 500,HARD,2,Andy Murray,Sergiy Stakhovsky,Andy Murray,6-7(3); 6-3; 5-3 RET,R32,123,5,4,53,84,42,53,15,31,0,3,15,57,84,1,2,58,84,39,58,9,26,9,14,14,48,84
2009-02-23 00:00:00.000,Dubai U.A.E. ATP World Tour 500,HARD,2,Novak Djokovic,Jan Hernych,Novak Djokovic,6-3; 3-6; 6-4,R16,127,5,3,51,92,38,51,20,41,6,8,14,58,92,2,2,69,95,46,69,15,26,7,10,14,61,95
2009-02-23 00:00:00.000,Dubai U.A.E. ATP World Tour 500,HARD,2,Marin Cilic,Julien Benneteau,Marin Cilic,6-3; 4-6; 7-5,R16,143,9,4,45,84,36,45,25,39,3,4,15,61,84,15,6,79,119,53,79,20,40,7,10,16,73,119
2009-02-23 00:00:00.000,Dubai U.A.E. ATP World Tour 500,HARD,2,Gilles Simon,Teymuraz Gabashvili,Gilles Simon,6-1; 6-2,R16,54,2,1,35,44,28,35,5,9,0,0,8,33,44,1,4,30,45,18,30,3,15,3,7,7,21,45
2009-02-23 00:00:00.000,Dubai U.A.E. ATP World Tour 500,HARD,2,Fabrice Santoro,Marco Chiudinelli,Fabrice Santoro,3-6; 6-1; 7-6(1),R16,148,14,1,54,83,41,54,16,29,4,7,14,57,83,1,4,69,110,38,69,23,41,6,10,14,61,110
2009-02-23 00:00:00.000,Dubai U.A.E. ATP World Tour 500,HARD,2,Igor Andreev,Dmitry Tursunov,Igor Andreev,5-7; 6-4; 6-3,R16,133,13,5,54,85,42,54,15,31,3,5,15,57,85,8,8,62,103,45,62,19,41,7,11,16,64,103
2009-02-23 00:00:00.000,Dubai U.A.E. ATP World Tour 500,HARD,2,David Ferrer,Philipp Kohlschreiber,David Ferrer,6-4; 6-2,R16,77,5,2,42,56,32,42,7,14,3,3,9,39,56,3,4,40,59,24,40,9,19,4,7,9,33,59
2009-02-23 00:00:00.000,Dubai U.A.E. ATP World Tour 500,HARD,2,Richard Gasquet,Simone Bolelli,Richard Gasquet,6-7(4); 6-3; 7-6(5),R16,183,18,1,72,113,56,72,24,41,5,5,16,80,113,12,1,76,121,50,76,31,45,8,10,17,81,121
2009-02-23 00:00:00.000,Dubai U.A.E. ATP World Tour 500,HARD,2,Andy Murray,Arnaud Clement,Andy Murray,6-2; 6-3,R16,84,8,0,38,54,30,38,7,16,3,3,8,37,54,3,1,41,61,24,41,8,20,9,13,9,32,61
2009-02-23 00:00:00.000,Dubai U.A.E. ATP World Tour 500,HARD,2,Novak Djokovic,Marin Cilic,Novak Djokovic,6-3; 6-4,Q,98,7,3,45,71,37,45,12,26,6,6,10,49,71,5,1,40,69,28,40,11,29,5,7,9,39,69
2009-02-23 00:00:00.000,Dubai U.A.E. ATP World Tour 500,HARD,2,Gilles Simon,Fabrice Santoro,Gilles Simon,7-6(3); 6-1,Q,94,1,2,30,67,19,30,24,37,5,7,9,43,67,3,2,39,74,21,39,15,35,5,10,10,36,74
2009-02-23 00:00:00.000,Dubai U.A.E. ATP World Tour 500,HARD,2,David Ferrer,Igor Andreev,David Ferrer,7-5; 6-1,Q,109,0,5,28,52,24,28,9,24,3,5,9,33,52,5,4,46,86,27,46,14,40,10,16,10,41,86
2009-02-23 00:00:00.000,Dubai U.A.E. ATP World Tour 500,HARD,2,Richard Gasquet,Andy Murray,Richard Gasquet,W/O,Q,0,0,0,0,0,0,0,0,0,0,0,0,0,0,0,0,0,0,0,0,0,0,0,0,0,0,0
2009-02-23 00:00:00.000,Dubai U.A.E. ATP World Tour 500,HARD,2,Novak Djokovic,Gilles Simon,Novak Djokovic,3-6; 7-5; 7-5,S,165,12,3,67,109,44,67,25,42,1,3,16,69,109,4,2,63,118,47,63,26,55,9,12,17,73,118
2009-02-23 00:00:00.000,Dubai U.A.E. ATP World Tour 500,HARD,2,David Ferrer,Richard Gasquet,David Ferrer,6-2; 6-2,S,76,2,1,35,61,23,35,16,26,6,6,8,39,61,2,1,25,48,16,25,9,23,5,9,8,25,48
2009-02-23 00:00:00.000,Dubai U.A.E. ATP World Tour 500,HARD,2,Novak Djokovic,David Ferrer,Novak Djokovic,7-5; 6-3,F,97,3,0,45,63,30,45,9,18,1,4,11,39,63,4,3,35,59,18,35,13,24,2,7,10,31,59
2009-03-12 00:00:00.000,ATP World Tour Masters 1000 Indian Wells CA; U.S.A. ATP World Tour Masters 1000,HARD,2,Rafael Nadal,N/A Bye,Rafael Nadal,,R128,0,0,0,0,0,0,0,0,0,0,0,0,0,0,0,0,0,0,0,0,0,0,0,0,0,0,0
2009-03-12 00:00:00.000,ATP World Tour Masters 1000 Indian Wells CA; U.S.A. ATP World Tour Masters 1000,HARD,2,Michael Berrer,Kevin Anderson,Michael Berrer,6-3; 6-3,R128,72,6,7,30,52,25,30,11,22,1,2,9,36,52,4,7,34,57,22,34,7,23,3,7,9,29,57
2009-03-12 00:00:00.000,ATP World Tour Masters 1000 Indian Wells CA; U.S.A. ATP World Tour Masters 1000,HARD,2,Michael Russell,Guillermo Garcia-Lopez,Michael Russell,7-5; 6-2,R128,107,3,0,45,64,24,45,12,19,3,6,10,36,64,2,5,41,64,23,41,6,23,1,7,10,29,64
2009-03-12 00:00:00.000,ATP World Tour Masters 1000 Indian Wells CA; U.S.A. ATP World Tour Masters 1000,HARD,2,Dmitry Tursunov,N/A Bye,Dmitry Tursunov,,R128,0,0,0,0,0,0,0,0,0,0,0,0,0,0,0,0,0,0,0,0,0,0,0,0,0,0,0
2009-03-12 00:00:00.000,ATP World Tour Masters 1000 Indian Wells CA; U.S.A. ATP World Tour Masters 1000,HARD,2,Tomas Berdych,N/A Bye,Tomas Berdych,,R128,0,0,0,0,0,0,0,0,0,0,0,0,0,0,0,0,0,0,0,0,0,0,0,0,0,0,0
2009-03-12 00:00:00.000,ATP World Tour Masters 1000 Indian Wells CA; U.S.A. ATP World Tour Masters 1000,HARD,2,Viktor Troicki,Mikhail Youzhny,Viktor Troicki,7-5; 2-1 RET,R128,73,7,2,39,61,26,39,10,22,10,11,7,36,61,0,2,27,45,17,27,9,18,1,4,8,26,45
2009-03-12 00:00:00.000,ATP World Tour Masters 1000 Indian Wells CA; U.S.A. ATP World Tour Masters 1000,HARD,2,Robert Kendrick,Bjorn Phau,Robert Kendrick,7-5; 6-2,R128,78,13,4,38,69,27,38,12,31,5,8,10,39,69,1,4,27,61,15,27,14,34,7,13,10,29,61
2009-03-12 00:00:00.000,ATP World Tour Masters 1000 Indian Wells CA; U.S.A. ATP World Tour Masters 1000,HARD,2,David Nalbandian,N/A Bye,David Nalbandian,,R128,0,0,0,0,0,0,0,0,0,0,0,0,0,0,0,0,0,0,0,0,0,0,0,0,0,0,0
2009-03-12 00:00:00.000,ATP World Tour Masters 1000 Indian Wells CA; U.S.A. ATP World Tour Masters 1000,HARD,2,Gael Monfils,N/A Bye,Gael Monfils,,R128,0,0,0,0,0,0,0,0,0,0,0,0,0,0,0,0,0,0,0,0,0,0,0,0,0,0,0
2009-03-12 00:00:00.000,ATP World Tour Masters 1000 Indian Wells CA; U.S.A. ATP World Tour Masters 1000,HARD,2,John Isner,Christophe Rochus,John Isner,6-1; 6-4,R128,62,14,2,33,51,23,33,11,18,2,3,8,34,51,4,2,37,60,21,37,8,23,1,6,9,29,60
2009-03-12 00:00:00.000,ATP World Tour Masters 1000 Indian Wells CA; U.S.A. ATP World Tour Masters 1000,HARD,2,Nicolas Massu,Eduardo Schwank,Nicolas Massu,7-6(1); 6-7(5); 6-4,R128,201,2,2,86,128,61,86,24,42,11,12,17,85,128,4,8,80,134,55,80,31,54,11,13,17,86,134
2009-03-12 00:00:00.000,ATP World Tour Masters 1000 Indian Wells CA; U.S.A. ATP World Tour Masters 1000,HARD,2,Marat Safin,N/A Bye,Marat Safin,,R128,0,0,0,0,0,0,0,0,0,0,0,0,0,0,0,0,0,0,0,0,0,0,0,0,0,0,0
2009-03-12 00:00:00.000,ATP World Tour Masters 1000 Indian Wells CA; U.S.A. ATP World Tour Masters 1000,HARD,2,Jurgen Melzer,N/A Bye,Jurgen Melzer,,R128,0,0,0,0,0,0,0,0,0,0,0,0,0,0,0,0,0,0,0,0,0,0,0,0,0,0,0
2009-03-12 00:00:00.000,ATP World Tour Masters 1000 Indian Wells CA; U.S.A. ATP World Tour Masters 1000,HARD,2,Taylor Dent,Diego Junqueira,Taylor Dent,6-1; 7-6(3),R128,67,11,4,35,54,32,35,9,19,1,2,10,41,54,0,2,30,49,20,30,9,19,1,4,9,29,49
2009-03-12 00:00:00.000,ATP World Tour Masters 1000 Indian Wells CA; U.S.A. ATP World Tour Masters 1000,HARD,2,Ryan Sweeting,Wayne Odesnik,Ryan Sweeting,1-6; 6-4; 7-6(5),R128,134,6,12,75,114,52,75,13,39,13,19,15,65,114,7,1,60,104,39,60,23,44,8,12,14,62,104
2009-03-12 00:00:00.000,ATP World Tour Masters 1000 Indian Wells CA; U.S.A. ATP World Tour Masters 1000,HARD,2,Juan Martin Del Potro,N/A Bye,Juan Martin Del Potro,,R128,0,0,0,0,0,0,0,0,0,0,0,0,0,0,0,0,0,0,0,0,0,0,0,0,0,0,0
2009-03-12 00:00:00.000,ATP World Tour Masters 1000 Indian Wells CA; U.S.A. ATP World Tour Masters 1000,HARD,2,Novak Djokovic,N/A Bye,Novak Djokovic,,R128,0,0,0,0,0,0,0,0,0,0,0,0,0,0,0,0,0,0,0,0,0,0,0,0,0,0,0
2009-03-12 00:00:00.000,ATP World Tour Masters 1000 Indian Wells CA; U.S.A. ATP World Tour Masters 1000,HARD,2,Martin Vassallo Arguello,Rik De Voest,Martin Vassallo Arguello,7-5; 7-6(3),R128,105,4,3,48,70,34,48,12,22,2,4,12,46,70,0,2,61,88,37,61,12,27,3,6,12,49,88
2009-03-12 00:00:00.000,ATP World Tour Masters 1000 Indian Wells CA; U.S.A. ATP World Tour Masters 1000,HARD,2,Tommy Haas,Oscar Hernandez,Tommy Haas,6-3; 6-3,R128,71,5,1,24,44,20,24,15,20,0,1,9,35,44,3,2,37,61,23,37,9,24,7,11,9,32,61
2009-03-12 00:00:00.000,ATP World Tour Masters 1000 Indian Wells CA; U.S.A. ATP World Tour Masters 1000,HARD,2,Rainer Schuettler,N/A Bye,Rainer Schuettler,,R128,0,0,0,0,0,0,0,0,0,0,0,0,0,0,0,0,0,0,0,0,0,0,0,0,0,0,0
2009-03-12 00:00:00.000,ATP World Tour Masters 1000 Indian Wells CA; U.S.A. ATP World Tour Masters 1000,HARD,2,Radek Stepanek,N/A Bye,Radek Stepanek,,R128,0,0,0,0,0,0,0,0,0,0,0,0,0,0,0,0,0,0,0,0,0,0,0,0,0,0,0
2009-03-12 00:00:00.000,ATP World Tour Masters 1000 Indian Wells CA; U.S.A. ATP World Tour Masters 1000,HARD,2,Sam Querrey,Guillermo Canas,Sam Querrey,7-6(2); 6-2,R128,81,8,2,37,58,32,37,16,21,3,3,10,48,58,2,2,34,67,25,34,18,33,5,7,10,43,67
2009-03-12 00:00:00.000,ATP World Tour Masters 1000 Indian Wells CA; U.S.A. ATP World Tour Masters 1000,HARD,2,Andreas Seppi,Juan Ignacio Chela,Andreas Seppi,6-2; 4-1 RET,R128,58,2,2,30,43,21,30,5,13,2,3,6,26,43,0,5,21,41,13,21,5,20,3,8,7,18,41
2009-03-12 00:00:00.000,ATP World Tour Masters 1000 Indian Wells CA; U.S.A. ATP World Tour Masters 1000,HARD,2,Stanislas Wawrinka,N/A Bye,Stanislas Wawrinka,,R128,0,0,0,0,0,0,0,0,0,0,0,0,0,0,0,0,0,0,0,0,0,0,0,0,0,0,0
2009-03-12 00:00:00.000,ATP World Tour Masters 1000 Indian Wells CA; U.S.A. ATP World Tour Masters 1000,HARD,2,David Ferrer,N/A Bye,David Ferrer,,R128,0,0,0,0,0,0,0,0,0,0,0,0,0,0,0,0,0,0,0,0,0,0,0,0,0,0,0
2009-03-12 00:00:00.000,ATP World Tour Masters 1000 Indian Wells CA; U.S.A. ATP World Tour Masters 1000,HARD,2,Todd Widom,Ivan Navarro,Todd Widom,6-4; 7-6(4),R128,125,3,2,47,80,34,47,15,33,4,7,11,49,80,3,4,43,75,30,43,13,32,5,9,11,43,75
2009-03-12 00:00:00.000,ATP World Tour Masters 1000 Indian Wells CA; U.S.A. ATP World Tour Masters 1000,HARD,2,Jeremy Chardy,Victor Hanescu,Jeremy Chardy,6-4; 3-6; 6-2,R128,117,8,4,59,104,42,59,24,45,7,8,13,66,104,0,2,52,77,37,52,14,25,3,6,14,51,77
2009-03-12 00:00:00.000,ATP World Tour Masters 1000 Indian Wells CA; U.S.A. ATP World Tour Masters 1000,HARD,2,Mardy Fish,N/A Bye,Mardy Fish,,R128,0,0,0,0,0,0,0,0,0,0,0,0,0,0,0,0,0,0,0,0,0,0,0,0,0,0,0
2009-03-12 00:00:00.000,ATP World Tour Masters 1000 Indian Wells CA; U.S.A. ATP World Tour Masters 1000,HARD,2,Nicolas Kiefer,N/A Bye,Nicolas Kiefer,,R128,0,0,0,0,0,0,0,0,0,0,0,0,0,0,0,0,0,0,0,0,0,0,0,0,0,0,0
2009-03-12 00:00:00.000,ATP World Tour Masters 1000 Indian Wells CA; U.S.A. ATP World Tour Masters 1000,HARD,2,Bobby Reynolds,Fabio Fognini,Bobby Reynolds,4-6; 6-0; 6-2,R128,84,9,3,34,59,29,34,18,25,0,1,12,47,59,5,11,48,82,33,48,11,34,4,9,12,44,82
2009-03-12 00:00:00.000,ATP World Tour Masters 1000 Indian Wells CA; U.S.A. ATP World Tour Masters 1000,HARD,2,Daniel Koellerer,Mischa Zverev,Daniel Koellerer,2-6; 7-5; 6-2,R128,134,2,4,64,93,43,64,14,29,6,9,14,57,93,8,5,53,90,36,53,19,37,8,12,14,55,90
2009-03-12 00:00:00.000,ATP World Tour Masters 1000 Indian Wells CA; U.S.A. ATP World Tour Masters 1000,HARD,2,Andy Roddick,N/A Bye,Andy Roddick,,R128,0,0,0,0,0,0,0,0,0,0,0,0,0,0,0,0,0,0,0,0,0,0,0,0,0,0,0
2009-03-12 00:00:00.000,ATP World Tour Masters 1000 Indian Wells CA; U.S.A. ATP World Tour Masters 1000,HARD,2,Gilles Simon,N/A Bye,Gilles Simon,,R128,0,0,0,0,0,0,0,0,0,0,0,0,0,0,0,0,0,0,0,0,0,0,0,0,0,0,0
2009-03-12 00:00:00.000,ATP World Tour Masters 1000 Indian Wells CA; U.S.A. ATP World Tour Masters 1000,HARD,2,Yen-Hsun Lu,Michael Lammer,Yen-Hsun Lu,7-5; 6-2,R128,87,1,2,43,56,30,43,7,13,3,5,10,37,56,5,4,36,68,20,36,15,32,8,13,10,35,68
2009-03-12 00:00:00.000,ATP World Tour Masters 1000 Indian Wells CA; U.S.A. ATP World Tour Masters 1000,HARD,2,Ivan Ljubicic,Kei Nishikori,Ivan Ljubicic,6-3; 6-3,R128,65,6,1,34,52,29,34,5,18,2,3,9,34,52,0,4,26,48,14,26,11,22,0,4,9,25,48
2009-03-12 00:00:00.000,ATP World Tour Masters 1000 Indian Wells CA; U.S.A. ATP World Tour Masters 1000,HARD,2,Mario Ancic,N/A Bye,Mario Ancic,,R128,0,0,0,0,0,0,0,0,0,0,0,0,0,0,0,0,0,0,0,0,0,0,0,0,0,0,0
2009-03-12 00:00:00.000,ATP World Tour Masters 1000 Indian Wells CA; U.S.A. ATP World Tour Masters 1000,HARD,2,Igor Andreev,N/A Bye,Igor Andreev,,R128,0,0,0,0,0,0,0,0,0,0,0,0,0,0,0,0,0,0,0,0,0,0,0,0,0,0,0
2009-03-12 00:00:00.000,ATP World Tour Masters 1000 Indian Wells CA; U.S.A. ATP World Tour Masters 1000,HARD,2,Ernests Gulbis,Kevin Kim,Ernests Gulbis,6-3; 6-4,R128,69,5,2,40,62,31,40,12,22,1,2,10,43,62,5,3,41,67,29,41,8,26,8,11,9,37,67
2009-03-12 00:00:00.000,ATP World Tour Masters 1000 Indian Wells CA; U.S.A. ATP World Tour Masters 1000,HARD,2,Teymuraz Gabashvili,Jose Acasuso,Teymuraz Gabashvili,6-2; 4-6; 6-3,R128,118,9,6,40,71,34,40,16,31,3,5,13,50,71,8,3,59,104,37,59,18,45,7,12,14,55,104
2009-03-12 00:00:00.000,ATP World Tour Masters 1000 Indian Wells CA; U.S.A. ATP World Tour Masters 1000,HARD,2,Jo-Wilfried Tsonga,N/A Bye,Jo-Wilfried Tsonga,,R128,0,0,0,0,0,0,0,0,0,0,0,0,0,0,0,0,0,0,0,0,0,0,0,0,0,0,0
2009-03-12 00:00:00.000,ATP World Tour Masters 1000 Indian Wells CA; U.S.A. ATP World Tour Masters 1000,HARD,2,Tommy Robredo,N/A Bye,Tommy Robredo,,R128,0,0,0,0,0,0,0,0,0,0,0,0,0,0,0,0,0,0,0,0,0,0,0,0,0,0,0
2009-03-12 00:00:00.000,ATP World Tour Masters 1000 Indian Wells CA; U.S.A. ATP World Tour Masters 1000,HARD,2,Igor Kunitsyn,Vincent Spadea,Igor Kunitsyn,6-3; 6-4,R128,73,2,0,38,59,28,38,13,21,3,4,9,41,59,2,5,24,56,17,24,16,32,1,5,10,33,56
2009-03-12 00:00:00.000,ATP World Tour Masters 1000 Indian Wells CA; U.S.A. ATP World Tour Masters 1000,HARD,2,Steve Darcis,Marcel Granollers,Steve Darcis,5-0 RET,R128,15,1,0,7,13,6,7,6,6,0,0,3,12,13,0,1,4,10,1,4,1,6,1,3,2,2,10
2009-03-12 00:00:00.000,ATP World Tour Masters 1000 Indian Wells CA; U.S.A. ATP World Tour Masters 1000,HARD,2,Marin Cilic,N/A Bye,Marin Cilic,,R128,0,0,0,0,0,0,0,0,0,0,0,0,0,0,0,0,0,0,0,0,0,0,0,0,0,0,0
2009-03-12 00:00:00.000,ATP World Tour Masters 1000 Indian Wells CA; U.S.A. ATP World Tour Masters 1000,HARD,2,Paul-Henri Mathieu,N/A Bye,Paul-Henri Mathieu,,R128,0,0,0,0,0,0,0,0,0,0,0,0,0,0,0,0,0,0,0,0,0,0,0,0,0,0,0
2009-03-12 00:00:00.000,ATP World Tour Masters 1000 Indian Wells CA; U.S.A. ATP World Tour Masters 1000,HARD,2,Potito Starace,Denis Gremelmayr,Potito Starace,7-6(6); 6-1,R128,79,2,4,51,69,38,51,8,18,5,6,9,46,69,4,9,43,78,27,43,14,35,5,9,10,41,78
2009-03-12 00:00:00.000,ATP World Tour Masters 1000 Indian Wells CA; U.S.A. ATP World Tour Masters 1000,HARD,2,Albert Montanes,Florent Serra,Albert Montanes,6-3; 6-0,R128,55,4,2,17,35,15,17,11,18,2,3,7,26,35,2,2,33,59,14,33,11,26,5,11,8,25,59
2009-03-12 00:00:00.000,ATP World Tour Masters 1000 Indian Wells CA; U.S.A. ATP World Tour Masters 1000,HARD,2,Andy Murray,N/A Bye,Andy Murray,,R128,0,0,0,0,0,0,0,0,0,0,0,0,0,0,0,0,0,0,0,0,0,0,0,0,0,0,0
2009-03-12 00:00:00.000,ATP World Tour Masters 1000 Indian Wells CA; U.S.A. ATP World Tour Masters 1000,HARD,2,Olivier Patience,N/A Bye,Olivier Patience,,R128,0,0,0,0,0,0,0,0,0,0,0,0,0,0,0,0,0,0,0,0,0,0,0,0,0,0,0
2009-03-12 00:00:00.000,ATP World Tour Masters 1000 Indian Wells CA; U.S.A. ATP World Tour Masters 1000,HARD,2,Philipp Kohlschreiber,Julien Benneteau,Philipp Kohlschreiber,6-3; 6-2,R128,75,1,2,36,53,22,36,8,17,1,4,9,30,53,1,3,28,56,13,28,10,28,2,8,8,23,56
2009-03-12 00:00:00.000,ATP World Tour Masters 1000 Indian Wells CA; U.S.A. ATP World Tour Masters 1000,HARD,2,Nicolas Lapentti,Santiago Giraldo,Nicolas Lapentti,4-6; 6-1; 7-5,R128,148,9,4,52,97,35,52,27,45,7,10,15,62,97,6,0,55,98,31,55,22,43,10,15,14,53,98
2009-03-12 00:00:00.000,ATP World Tour Masters 1000 Indian Wells CA; U.S.A. ATP World Tour Masters 1000,HARD,2,Robin Soderling,N/A Bye,Robin Soderling,,R128,0,0,0,0,0,0,0,0,0,0,0,0,0,0,0,0,0,0,0,0,0,0,0,0,0,0,0
2009-03-12 00:00:00.000,ATP World Tour Masters 1000 Indian Wells CA; U.S.A. ATP World Tour Masters 1000,HARD,2,Richard Gasquet,N/A Bye,Richard Gasquet,,R128,0,0,0,0,0,0,0,0,0,0,0,0,0,0,0,0,0,0,0,0,0,0,0,0,0,0,0
2009-03-12 00:00:00.000,ATP World Tour Masters 1000 Indian Wells CA; U.S.A. ATP World Tour Masters 1000,HARD,2,Michael Llodra,Feliciano Lopez,Michael Llodra,6-4; 6-3,R128,76,3,1,36,59,25,36,17,23,4,5,10,42,59,3,3,37,59,23,37,10,22,5,8,9,33,59
2009-03-12 00:00:00.000,ATP World Tour Masters 1000 Indian Wells CA; U.S.A. ATP World Tour Masters 1000,HARD,2,Thomaz Bellucci,Janko Tipsarevic,Thomaz Bellucci,5-7; 7-5; 6-2,R128,133,12,2,57,94,40,57,20,37,4,7,16,60,94,1,2,56,92,33,56,21,36,5,10,16,54,92
2009-03-12 00:00:00.000,ATP World Tour Masters 1000 Indian Wells CA; U.S.A. ATP World Tour Masters 1000,HARD,2,Fernando Verdasco,N/A Bye,Fernando Verdasco,,R128,0,0,0,0,0,0,0,0,0,0,0,0,0,0,0,0,0,0,0,0,0,0,0,0,0,0,0
2009-03-12 00:00:00.000,ATP World Tour Masters 1000 Indian Wells CA; U.S.A. ATP World Tour Masters 1000,HARD,2,James Blake,N/A Bye,James Blake,,R128,0,0,0,0,0,0,0,0,0,0,0,0,0,0,0,0,0,0,0,0,0,0,0,0,0,0,0
2009-03-12 00:00:00.000,ATP World Tour Masters 1000 Indian Wells CA; U.S.A. ATP World Tour Masters 1000,HARD,2,Jarkko Nieminen,Nicolas Devilder,Jarkko Nieminen,7-6(6); 6-1,R128,90,3,4,61,89,45,61,13,28,3,3,10,58,89,8,1,41,60,29,41,10,19,3,5,9,39,60
2009-03-12 00:00:00.000,ATP World Tour Masters 1000 Indian Wells CA; U.S.A. ATP World Tour Masters 1000,HARD,2,Lleyton Hewitt,Jan Hernych,Lleyton Hewitt,7-6(3); 6-3,R128,83,2,2,29,57,25,29,21,28,1,1,10,46,57,4,3,49,77,28,49,18,28,6,8,11,46,77
2009-03-12 00:00:00.000,ATP World Tour Masters 1000 Indian Wells CA; U.S.A. ATP World Tour Masters 1000,HARD,2,Fernando Gonzalez,N/A Bye,Fernando Gonzalez,,R128,0,0,0,0,0,0,0,0,0,0,0,0,0,0,0,0,0,0,0,0,0,0,0,0,0,0,0
2009-03-12 00:00:00.000,ATP World Tour Masters 1000 Indian Wells CA; U.S.A. ATP World Tour Masters 1000,HARD,2,Ivo Karlovic,N/A Bye,Ivo Karlovic,,R128,0,0,0,0,0,0,0,0,0,0,0,0,0,0,0,0,0,0,0,0,0,0,0,0,0,0,0
2009-03-12 00:00:00.000,ATP World Tour Masters 1000 Indian Wells CA; U.S.A. ATP World Tour Masters 1000,HARD,2,Sergiy Stakhovsky,Brendan Evans,Sergiy Stakhovsky,2-6; 6-3; 6-0,R128,77,8,1,45,63,28,45,12,18,2,6,12,40,63,2,0,43,67,22,43,10,24,4,10,11,32,67
2009-03-12 00:00:00.000,ATP World Tour Masters 1000 Indian Wells CA; U.S.A. ATP World Tour Masters 1000,HARD,2,Marc Gicquel,Simone Bolelli,Marc Gicquel,7-5; 6-3,R128,83,4,1,21,56,17,21,29,35,2,2,11,46,56,3,0,37,59,26,37,12,22,0,2,10,38,59
2009-03-12 00:00:00.000,ATP World Tour Masters 1000 Indian Wells CA; U.S.A. ATP World Tour Masters 1000,HARD,2,Roger Federer,N/A Bye,Roger Federer,,R128,0,0,0,0,0,0,0,0,0,0,0,0,0,0,0,0,0,0,0,0,0,0,0,0,0,0,0
2009-03-12 00:00:00.000,ATP World Tour Masters 1000 Indian Wells CA; U.S.A. ATP World Tour Masters 1000,HARD,2,Rafael Nadal,Michael Berrer,Rafael Nadal,6-2; 6-1,R64,68,0,1,16,33,13,16,15,17,0,0,7,28,33,1,0,36,59,21,36,7,23,9,14,8,28,59
2009-03-12 00:00:00.000,ATP World Tour Masters 1000 Indian Wells CA; U.S.A. ATP World Tour Masters 1000,HARD,2,Dmitry Tursunov,Michael Russell,Dmitry Tursunov,7-6(5); 4-6; 6-3,R64,149,8,8,66,108,47,66,15,42,10,16,16,62,108,2,3,76,104,46,76,11,28,6,12,15,57,104
2009-03-12 00:00:00.000,ATP World Tour Masters 1000 Indian Wells CA; U.S.A. ATP World Tour Masters 1000,HARD,2,Viktor Troicki,Tomas Berdych,Viktor Troicki,6-3; 6-1,R64,65,6,2,33,55,25,33,13,22,4,4,8,38,55,2,5,23,47,15,23,10,24,6,10,8,25,47
2009-03-12 00:00:00.000,ATP World Tour Masters 1000 Indian Wells CA; U.S.A. ATP World Tour Masters 1000,HARD,2,David Nalbandian,Robert Kendrick,David Nalbandian,6-4; 6-4,R64,64,10,1,32,49,27,32,13,17,0,0,10,40,49,7,4,29,59,22,29,17,30,0,2,10,39,59
2009-03-12 00:00:00.000,ATP World Tour Masters 1000 Indian Wells CA; U.S.A. ATP World Tour Masters 1000,HARD,2,John Isner,Gael Monfils,John Isner,6-7(5); 6-1; 6-4,R64,118,10,4,46,83,39,46,27,37,0,0,15,66,83,8,5,60,94,45,60,16,34,6,9,14,61,94
2009-03-12 00:00:00.000,ATP World Tour Masters 1000 Indian Wells CA; U.S.A. ATP World Tour Masters 1000,HARD,2,Marat Safin,Nicolas Massu,Marat Safin,6-3; 7-6(2),R64,102,5,1,34,64,29,34,16,30,0,2,11,45,64,7,4,47,74,33,47,11,27,9,12,10,44,74
2009-03-12 00:00:00.000,ATP World Tour Masters 1000 Indian Wells CA; U.S.A. ATP World Tour Masters 1000,HARD,2,Jurgen Melzer,Taylor Dent,Jurgen Melzer,7-5; 6-2,R64,73,1,1,33,53,23,33,15,20,1,2,10,38,53,6,4,35,62,25,35,10,27,6,10,10,35,62
2009-03-12 00:00:00.000,ATP World Tour Masters 1000 Indian Wells CA; U.S.A. ATP World Tour Masters 1000,HARD,2,Juan Martin Del Potro,Ryan Sweeting,Juan Martin Del Potro,6-7(6); 6-3; 6-1,R64,135,8,3,65,94,41,65,13,29,3,8,14,54,94,7,10,58,100,35,58,12,42,6,15,14,47,100
2009-03-12 00:00:00.000,ATP World Tour Masters 1000 Indian Wells CA; U.S.A. ATP World Tour Masters 1000,HARD,2,Novak Djokovic,Martin Vassallo Arguello,Novak Djokovic,7-5; 6-4,R64,104,2,2,35,58,25,35,15,23,0,2,11,40,58,1,1,45,72,28,45,14,27,4,8,11,42,72
2009-03-12 00:00:00.000,ATP World Tour Masters 1000 Indian Wells CA; U.S.A. ATP World Tour Masters 1000,HARD,2,Tommy Haas,Rainer Schuettler,Tommy Haas,6-7(4); 6-2; 6-4,R64,155,7,2,68,97,46,68,18,29,6,9,15,64,97,5,3,57,112,38,57,27,55,9,15,15,65,112
2009-03-12 00:00:00.000,ATP World Tour Masters 1000 Indian Wells CA; U.S.A. ATP World Tour Masters 1000,HARD,2,Sam Querrey,Radek Stepanek,Sam Querrey,6-4; 6-3,R64,81,11,3,43,68,32,43,14,25,1,1,10,46,68,2,3,41,61,26,41,11,20,2,4,9,37,61
2009-03-12 00:00:00.000,ATP World Tour Masters 1000 Indian Wells CA; U.S.A. ATP World Tour Masters 1000,HARD,2,Stanislas Wawrinka,Andreas Seppi,Stanislas Wawrinka,6-1; 6-3,R64,79,6,4,34,70,28,34,17,36,9,9,8,45,70,1,4,26,51,13,26,11,25,3,7,8,24,51
2009-03-12 00:00:00.000,ATP World Tour Masters 1000 Indian Wells CA; U.S.A. ATP World Tour Masters 1000,HARD,2,David Ferrer,Todd Widom,David Ferrer,6-4; 7-5,R64,123,4,1,42,67,29,42,12,25,1,3,11,41,67,0,2,48,95,29,48,23,47,14,18,11,52,95
2009-03-12 00:00:00.000,ATP World Tour Masters 1000 Indian Wells CA; U.S.A. ATP World Tour Masters 1000,HARD,2,Jeremy Chardy,Mardy Fish,Jeremy Chardy,7-6(4); 7-6(1),R64,119,7,5,56,90,44,56,13,34,2,4,12,57,90,13,1,47,81,37,47,15,34,5,7,12,52,81
2009-03-12 00:00:00.000,ATP World Tour Masters 1000 Indian Wells CA; U.S.A. ATP World Tour Masters 1000,HARD,2,Nicolas Kiefer,Bobby Reynolds,Nicolas Kiefer,6-4; 6-2,R64,74,6,0,30,52,26,30,13,22,1,1,9,39,52,9,0,35,54,22,35,11,19,1,4,9,33,54
2009-03-12 00:00:00.000,ATP World Tour Masters 1000 Indian Wells CA; U.S.A. ATP World Tour Masters 1000,HARD,2,Andy Roddick,Daniel Koellerer,Andy Roddick,6-1; 7-6(3),R64,98,16,1,41,58,33,41,12,17,0,1,10,45,58,1,0,47,62,30,47,7,15,6,9,9,37,62
2009-03-12 00:00:00.000,ATP World Tour Masters 1000 Indian Wells CA; U.S.A. ATP World Tour Masters 1000,HARD,2,Gilles Simon,Yen-Hsun Lu,Gilles Simon,5-7; 6-4; 6-4,R64,136,3,5,51,95,41,51,25,44,3,5,16,66,95,1,8,63,101,47,63,18,38,3,6,16,65,101
2009-03-12 00:00:00.000,ATP World Tour Masters 1000 Indian Wells CA; U.S.A. ATP World Tour Masters 1000,HARD,2,Ivan Ljubicic,Mario Ancic,Ivan Ljubicic,3-3 RET,R64,27,2,1,6,15,6,6,6,9,0,0,3,12,15,3,2,7,19,6,7,7,12,0,0,3,13,19
2009-03-12 00:00:00.000,ATP World Tour Masters 1000 Indian Wells CA; U.S.A. ATP World Tour Masters 1000,HARD,2,Igor Andreev,Ernests Gulbis,Igor Andreev,6-4; 6-4,R64,72,6,4,27,53,23,27,12,26,1,3,10,35,53,3,4,29,60,19,29,12,31,6,10,10,31,60
2009-03-12 00:00:00.000,ATP World Tour Masters 1000 Indian Wells CA; U.S.A. ATP World Tour Masters 1000,HARD,2,Jo-Wilfried Tsonga,Teymuraz Gabashvili,Jo-Wilfried Tsonga,7-5; 6-3,R64,80,6,0,38,53,36,38,8,15,0,0,11,44,53,5,2,30,58,22,30,15,28,2,4,10,37,58
2009-03-12 00:00:00.000,ATP World Tour Masters 1000 Indian Wells CA; U.S.A. ATP World Tour Masters 1000,HARD,2,Tommy Robredo,Igor Kunitsyn,Tommy Robredo,6-1; 6-4,R64,57,3,1,29,46,25,29,11,17,0,0,9,36,46,1,0,35,42,21,35,4,7,0,3,8,25,42
2009-03-12 00:00:00.000,ATP World Tour Masters 1000 Indian Wells CA; U.S.A. ATP World Tour Masters 1000,HARD,2,Marin Cilic,Steve Darcis,Marin Cilic,6-7(4); 6-2; 6-1,R64,123,11,5,50,86,38,50,19,36,6,8,14,57,86,5,4,57,93,36,57,12,36,7,13,13,48,93
2009-03-12 00:00:00.000,ATP World Tour Masters 1000 Indian Wells CA; U.S.A. ATP World Tour Masters 1000,HARD,2,Paul-Henri Mathieu,Potito Starace,Paul-Henri Mathieu,6-4; 6-7(11); 6-4,R64,150,14,4,53,109,40,53,31,56,2,4,16,71,109,7,2,82,115,54,82,14,33,3,7,16,68,115
2009-03-12 00:00:00.000,ATP World Tour Masters 1000 Indian Wells CA; U.S.A. ATP World Tour Masters 1000,HARD,2,Andy Murray,Albert Montanes,Andy Murray,7-5; 6-3,R64,96,8,3,42,77,29,42,21,35,5,6,11,50,77,5,5,36,63,24,36,11,27,3,6,10,35,63
2009-03-12 00:00:00.000,ATP World Tour Masters 1000 Indian Wells CA; U.S.A. ATP World Tour Masters 1000,HARD,2,Philipp Kohlschreiber,Olivier Patience,Philipp Kohlschreiber,6-7(5); 6-3; 6-3,R64,116,5,0,61,82,45,61,12,21,1,4,15,57,82,3,2,53,94,31,53,21,41,1,7,15,52,94
2009-03-12 00:00:00.000,ATP World Tour Masters 1000 Indian Wells CA; U.S.A. ATP World Tour Masters 1000,HARD,2,Nicolas Lapentti,Robin Soderling,Nicolas Lapentti,6-4; 7-6(7),R64,121,5,0,51,84,36,51,19,33,5,6,11,55,84,7,3,46,78,35,46,14,32,8,10,11,49,78
2009-03-12 00:00:00.000,ATP World Tour Masters 1000 Indian Wells CA; U.S.A. ATP World Tour Masters 1000,HARD,2,Richard Gasquet,Michael Llodra,Richard Gasquet,6-4; 6-0,R64,68,4,3,34,59,23,34,14,25,7,8,8,37,59,4,3,23,43,13,23,6,20,3,8,8,19,43
2009-03-12 00:00:00.000,ATP World Tour Masters 1000 Indian Wells CA; U.S.A. ATP World Tour Masters 1000,HARD,2,Fernando Verdasco,Thomaz Bellucci,Fernando Verdasco,7-5; 6-1,R64,86,4,1,44,55,38,44,4,11,0,0,10,42,55,6,2,43,65,25,43,10,22,2,5,9,35,65
2009-03-12 00:00:00.000,ATP World Tour Masters 1000 Indian Wells CA; U.S.A. ATP World Tour Masters 1000,HARD,2,James Blake,Jarkko Nieminen,James Blake,6-3; 6-7(6); 6-3,R64,133,14,6,74,127,59,74,22,53,11,12,16,81,127,5,2,67,104,42,67,20,37,8,11,14,62,104
2009-03-12 00:00:00.000,ATP World Tour Masters 1000 Indian Wells CA; U.S.A. ATP World Tour Masters 1000,HARD,2,Fernando Gonzalez,Lleyton Hewitt,Fernando Gonzalez,4-6; 6-2; 6-3,R64,121,8,6,67,103,45,67,18,36,14,17,14,63,103,3,7,43,86,27,43,19,43,6,11,13,46,86
2009-03-12 00:00:00.000,ATP World Tour Masters 1000 Indian Wells CA; U.S.A. ATP World Tour Masters 1000,HARD,2,Ivo Karlovic,Sergiy Stakhovsky,Ivo Karlovic,6-4; 6-2,R64,65,7,2,28,46,27,28,10,18,1,1,9,37,46,4,1,34,59,22,34,12,25,4,7,9,34,59
2009-03-12 00:00:00.000,ATP World Tour Masters 1000 Indian Wells CA; U.S.A. ATP World Tour Masters 1000,HARD,2,Roger Federer,Marc Gicquel,Roger Federer,7-6(4); 6-4,R64,84,12,2,36,59,33,36,15,23,0,0,11,48,59,8,3,52,88,36,52,20,36,2,3,11,56,88
2009-03-12 00:00:00.000,ATP World Tour Masters 1000 Indian Wells CA; U.S.A. ATP World Tour Masters 1000,HARD,2,Rafael Nadal,Dmitry Tursunov,Rafael Nadal,6-3; 6-3,R32,79,3,3,30,52,27,30,11,22,1,1,9,38,52,7,2,34,60,23,34,12,26,4,7,9,35,60
2009-03-12 00:00:00.000,ATP World Tour Masters 1000 Indian Wells CA; U.S.A. ATP World Tour Masters 1000,HARD,2,David Nalbandian,Viktor Troicki,David Nalbandian,6-4; 6-2,R32,82,0,2,26,48,20,26,15,22,1,2,9,35,48,11,5,37,70,24,37,13,33,2,6,9,37,70
2009-03-12 00:00:00.000,ATP World Tour Masters 1000 Indian Wells CA; U.S.A. ATP World Tour Masters 1000,HARD,2,John Isner,Marat Safin,John Isner,6-4; 6-4,R32,75,5,1,34,55,26,34,12,21,2,3,10,38,55,4,3,33,57,24,33,11,24,3,6,10,35,57
2009-03-12 00:00:00.000,ATP World Tour Masters 1000 Indian Wells CA; U.S.A. ATP World Tour Masters 1000,HARD,2,Juan Martin Del Potro,Jurgen Melzer,Juan Martin Del Potro,6-2; 2-6; 7-6(2),R32,120,6,3,58,87,37,58,18,29,3,7,14,55,87,4,2,43,77,34,43,15,34,5,9,14,49,77
2009-03-12 00:00:00.000,ATP World Tour Masters 1000 Indian Wells CA; U.S.A. ATP World Tour Masters 1000,HARD,2,Novak Djokovic,Tommy Haas,Novak Djokovic,6-2; 7-6(1),R32,107,8,1,44,61,34,44,9,17,3,4,10,43,61,2,6,48,79,30,48,13,31,8,11,10,43,79
2009-03-12 00:00:00.000,ATP World Tour Masters 1000 Indian Wells CA; U.S.A. ATP World Tour Masters 1000,HARD,2,Stanislas Wawrinka,Sam Querrey,Stanislas Wawrinka,2-6; 7-5; 7-6(8),R32,142,4,2,52,105,42,52,31,53,2,4,16,73,105,14,2,67,97,54,67,18,30,0,1,16,72,97
2009-03-12 00:00:00.000,ATP World Tour Masters 1000 Indian Wells CA; U.S.A. ATP World Tour Masters 1000,HARD,2,David Ferrer,Jeremy Chardy,David Ferrer,3-6; 6-4; 6-4,R32,114,5,6,56,84,42,56,18,28,7,9,15,60,84,10,3,58,98,48,58,14,40,6,8,14,62,98
2009-03-12 00:00:00.000,ATP World Tour Masters 1000 Indian Wells CA; U.S.A. ATP World Tour Masters 1000,HARD,2,Andy Roddick,Nicolas Kiefer,Andy Roddick,6-4; 7-6(4),R32,106,8,2,49,67,39,49,12,18,3,3,11,51,67,5,3,37,73,29,37,19,36,2,3,11,48,73
2009-03-12 00:00:00.000,ATP World Tour Masters 1000 Indian Wells CA; U.S.A. ATP World Tour Masters 1000,HARD,2,Ivan Ljubicic,Gilles Simon,Ivan Ljubicic,6-3; 7-6(3),R32,84,13,1,33,57,31,33,18,24,0,0,11,49,57,6,1,37,69,28,37,16,32,4,5,10,44,69
2009-03-12 00:00:00.000,ATP World Tour Masters 1000 Indian Wells CA; U.S.A. ATP World Tour Masters 1000,HARD,2,Igor Andreev,Jo-Wilfried Tsonga,Igor Andreev,7-5; 6-4,R32,98,3,3,32,74,23,32,23,42,2,3,11,46,74,6,1,35,63,28,35,14,28,5,8,11,42,63
2009-03-12 00:00:00.000,ATP World Tour Masters 1000 Indian Wells CA; U.S.A. ATP World Tour Masters 1000,HARD,2,Tommy Robredo,Marin Cilic,Tommy Robredo,7-5; 7-6(2),R32,109,4,2,51,79,32,51,14,28,5,9,12,46,79,6,1,43,78,27,43,16,35,6,11,12,43,78
2009-03-12 00:00:00.000,ATP World Tour Masters 1000 Indian Wells CA; U.S.A. ATP World Tour Masters 1000,HARD,2,Andy Murray,Paul-Henri Mathieu,Andy Murray,6-3; 6-2,R32,77,6,3,25,48,21,25,11,23,3,4,8,32,48,1,2,32,56,19,32,7,24,1,6,9,26,56
2009-03-12 00:00:00.000,ATP World Tour Masters 1000 Indian Wells CA; U.S.A. ATP World Tour Masters 1000,HARD,2,Philipp Kohlschreiber,Nicolas Lapentti,Philipp Kohlschreiber,6-2; 3-6; 6-3,R32,131,8,4,64,87,46,64,11,23,5,7,13,57,87,5,3,53,86,33,53,19,33,5,9,13,52,86
2009-03-12 00:00:00.000,ATP World Tour Masters 1000 Indian Wells CA; U.S.A. ATP World Tour Masters 1000,HARD,2,Fernando Verdasco,Richard Gasquet,Fernando Verdasco,6-3; 6-2,R32,68,2,0,29,40,21,29,9,11,1,2,8,30,40,2,6,26,52,16,26,9,26,3,8,9,25,52
2009-03-12 00:00:00.000,ATP World Tour Masters 1000 Indian Wells CA; U.S.A. ATP World Tour Masters 1000,HARD,2,Fernando Gonzalez,James Blake,Fernando Gonzalez,7-5; 6-1,R32,65,5,2,26,44,21,26,13,18,2,3,9,34,44,4,1,36,68,24,36,11,32,3,8,10,35,68
2009-03-12 00:00:00.000,ATP World Tour Masters 1000 Indian Wells CA; U.S.A. ATP World Tour Masters 1000,HARD,2,Roger Federer,Ivo Karlovic,Roger Federer,7-6(4); 6-3,R32,74,1,2,36,59,34,36,15,23,0,0,11,49,59,13,2,37,61,30,37,13,24,1,2,10,43,61
2009-03-12 00:00:00.000,ATP World Tour Masters 1000 Indian Wells CA; U.S.A. ATP World Tour Masters 1000,HARD,2,Rafael Nadal,David Nalbandian,Rafael Nadal,3-6; 7-6(5); 6-0,R16,175,1,1,62,93,39,62,19,31,11,14,13,58,93,3,8,55,110,35,55,26,55,9,14,14,61,110
2009-03-12 00:00:00.000,ATP World Tour Masters 1000 Indian Wells CA; U.S.A. ATP World Tour Masters 1000,HARD,2,Juan Martin Del Potro,John Isner,Juan Martin Del Potro,7-6(4); 7-6(3),R16,121,9,1,49,77,43,49,16,28,3,3,12,59,77,14,4,58,88,42,58,17,30,4,4,12,59,88
2009-03-12 00:00:00.000,ATP World Tour Masters 1000 Indian Wells CA; U.S.A. ATP World Tour Masters 1000,HARD,2,Novak Djokovic,Stanislas Wawrinka,Novak Djokovic,7-6(7); 7-6(6),R16,148,5,2,62,96,42,62,21,34,4,6,12,63,96,8,0,51,89,40,51,19,38,6,8,12,59,89
2009-03-12 00:00:00.000,ATP World Tour Masters 1000 Indian Wells CA; U.S.A. ATP World Tour Masters 1000,HARD,2,Andy Roddick,David Ferrer,Andy Roddick,7-6(5); 3-6; 6-3,R16,140,10,3,66,95,48,66,17,29,6,8,15,65,95,8,2,59,99,44,59,22,40,5,7,15,66,99
2009-03-12 00:00:00.000,ATP World Tour Masters 1000 Indian Wells CA; U.S.A. ATP World Tour Masters 1000,HARD,2,Ivan Ljubicic,Igor Andreev,Ivan Ljubicic,4-6; 7-6(5); 7-6(4),R16,186,14,7,75,129,63,75,23,54,14,15,17,86,129,17,5,65,114,58,65,22,49,4,4,17,80,114
2009-03-12 00:00:00.000,ATP World Tour Masters 1000 Indian Wells CA; U.S.A. ATP World Tour Masters 1000,HARD,2,Andy Murray,Tommy Robredo,Andy Murray,6-2; 3-0 RET,R16,50,0,3,23,39,18,23,7,16,3,4,6,25,39,2,3,22,34,9,22,4,12,3,7,5,13,34
2009-03-12 00:00:00.000,ATP World Tour Masters 1000 Indian Wells CA; U.S.A. ATP World Tour Masters 1000,HARD,2,Fernando Verdasco,Philipp Kohlschreiber,Fernando Verdasco,6-4; 3-6; 6-1,R16,101,2,1,44,60,35,44,7,16,1,4,13,42,60,2,2,46,77,30,46,13,31,6,11,13,43,77
2009-03-12 00:00:00.000,ATP World Tour Masters 1000 Indian Wells CA; U.S.A. ATP World Tour Masters 1000,HARD,2,Roger Federer,Fernando Gonzalez,Roger Federer,6-3; 5-7; 6-2,R16,110,3,3,44,86,36,44,25,42,1,2,15,61,86,6,2,47,86,35,47,20,39,2,5,14,55,86
2009-03-12 00:00:00.000,ATP World Tour Masters 1000 Indian Wells CA; U.S.A. ATP World Tour Masters 1000,HARD,2,Rafael Nadal,Juan Martin Del Potro,Rafael Nadal,6-2; 6-4,Q,110,2,1,44,62,32,44,9,18,4,5,9,41,62,2,2,47,71,26,47,11,24,9,13,9,37,71
2009-03-12 00:00:00.000,ATP World Tour Masters 1000 Indian Wells CA; U.S.A. ATP World Tour Masters 1000,HARD,2,Andy Roddick,Novak Djokovic,Andy Roddick,6-3; 6-2,Q,69,5,0,35,43,27,35,6,8,2,2,8,33,43,2,4,32,56,18,32,11,24,1,5,9,29,56
2009-03-12 00:00:00.000,ATP World Tour Masters 1000 Indian Wells CA; U.S.A. ATP World Tour Masters 1000,HARD,2,Andy Murray,Ivan Ljubicic,Andy Murray,7-5; 7-6(6),Q,126,6,2,52,79,41,52,12,27,4,6,12,53,79,6,0,35,74,27,35,20,39,3,6,12,47,74
2009-03-12 00:00:00.000,ATP World Tour Masters 1000 Indian Wells CA; U.S.A. ATP World Tour Masters 1000,HARD,2,Roger Federer,Fernando Verdasco,Roger Federer,6-3; 7-6(5),Q,92,4,3,42,67,32,42,10,25,5,7,10,42,67,2,4,61,77,35,61,10,16,4,8,11,45,77
2009-03-12 00:00:00.000,ATP World Tour Masters 1000 Indian Wells CA; U.S.A. ATP World Tour Masters 1000,HARD,2,Rafael Nadal,Andy Roddick,Rafael Nadal,6-4; 7-6(4),S,110,5,2,50,75,37,50,12,25,3,5,11,49,75,9,1,45,66,34,45,8,21,3,6,11,42,66
2009-03-12 00:00:00.000,ATP World Tour Masters 1000 Indian Wells CA; U.S.A. ATP World Tour Masters 1000,HARD,2,Andy Murray,Roger Federer,Andy Murray,6-3; 4-6; 6-1,S,108,6,3,49,82,35,49,19,33,8,10,13,54,82,3,0,42,74,27,42,15,32,1,6,13,42,74
2009-03-12 00:00:00.000,ATP World Tour Masters 1000 Indian Wells CA; U.S.A. ATP World Tour Masters 1000,HARD,2,Rafael Nadal,Andy Murray,Rafael Nadal,6-1; 6-2,F,81,0,1,26,43,21,26,11,17,0,0,8,32,43,0,0,34,50,19,34,6,16,1,5,7,25,50
2009-03-25 00:00:00.000,ATP World Tour Masters 1000 Miami FL; U.S.A. ATP World Tour Masters 1000,HARD,2,Rafael Nadal,N/A Bye,Rafael Nadal,,R128,0,0,0,0,0,0,0,0,0,0,0,0,0,0,0,0,0,0,0,0,0,0,0,0,0,0,0
2009-03-25 00:00:00.000,ATP World Tour Masters 1000 Miami FL; U.S.A. ATP World Tour Masters 1000,HARD,2,Teymuraz Gabashvili,Simone Bolelli,Teymuraz Gabashvili,6-4; 4-6; 6-4,R128,153,8,14,57,123,45,57,28,66,12,15,15,73,123,2,1,60,88,42,60,13,28,6,10,15,55,88
2009-03-25 00:00:00.000,ATP World Tour Masters 1000 Miami FL; U.S.A. ATP World Tour Masters 1000,HARD,2,Frederico Gil,Mischa Zverev,Frederico Gil,7-6(7); 6-2,R128,78,4,1,48,65,38,48,10,17,5,5,10,48,65,4,0,45,69,28,45,14,24,2,4,10,42,69
2009-03-25 00:00:00.000,ATP World Tour Masters 1000 Miami FL; U.S.A. ATP World Tour Masters 1000,HARD,2,Ivo Karlovic,N/A Bye,Ivo Karlovic,,R128,0,0,0,0,0,0,0,0,0,0,0,0,0,0,0,0,0,0,0,0,0,0,0,0,0,0,0
2009-03-25 00:00:00.000,ATP World Tour Masters 1000 Miami FL; U.S.A. ATP World Tour Masters 1000,HARD,2,Igor Andreev,N/A Bye,Igor Andreev,,R128,0,0,0,0,0,0,0,0,0,0,0,0,0,0,0,0,0,0,0,0,0,0,0,0,0,0,0
2009-03-25 00:00:00.000,ATP World Tour Masters 1000 Miami FL; U.S.A. ATP World Tour Masters 1000,HARD,2,Yen-Hsun Lu,Eduardo Schwank,Yen-Hsun Lu,6-2; 6-2,R128,74,0,2,31,51,26,31,9,20,1,1,8,35,51,2,4,25,52,13,25,11,27,2,6,8,24,52
2009-03-25 00:00:00.000,ATP World Tour Masters 1000 Miami FL; U.S.A. ATP World Tour Masters 1000,HARD,2,Andreas Seppi,Guillermo Garcia-Lopez,Andreas Seppi,7-6(6); 6-1,R128,90,0,1,45,73,35,45,14,28,4,5,10,49,73,0,6,36,68,25,36,12,32,3,6,9,37,68
2009-03-25 00:00:00.000,ATP World Tour Masters 1000 Miami FL; U.S.A. ATP World Tour Masters 1000,HARD,2,Stanislas Wawrinka,N/A Bye,Stanislas Wawrinka,,R128,0,0,0,0,0,0,0,0,0,0,0,0,0,0,0,0,0,0,0,0,0,0,0,0,0,0,0
2009-03-25 00:00:00.000,ATP World Tour Masters 1000 Miami FL; U.S.A. ATP World Tour Masters 1000,HARD,2,David Ferrer,N/A Bye,David Ferrer,,R128,0,0,0,0,0,0,0,0,0,0,0,0,0,0,0,0,0,0,0,0,0,0,0,0,0,0,0
2009-03-25 00:00:00.000,ATP World Tour Masters 1000 Miami FL; U.S.A. ATP World Tour Masters 1000,HARD,2,John Isner,Sergiy Stakhovsky,John Isner,6-4; 6-4,R128,74,12,3,37,57,30,37,14,20,1,1,10,44,57,3,3,37,68,24,37,17,31,7,9,10,41,68
2009-03-25 00:00:00.000,ATP World Tour Masters 1000 Miami FL; U.S.A. ATP World Tour Masters 1000,HARD,2,Amer Delic,Steve Darcis,Amer Delic,6-4; 7-6(2),R128,84,17,0,40,66,34,40,17,26,3,3,11,51,66,3,3,49,83,38,49,15,34,5,6,11,53,83
2009-03-25 00:00:00.000,ATP World Tour Masters 1000 Miami FL; U.S.A. ATP World Tour Masters 1000,HARD,2,Marin Cilic,N/A Bye,Marin Cilic,,R128,0,0,0,0,0,0,0,0,0,0,0,0,0,0,0,0,0,0,0,0,0,0,0,0,0,0,0
2009-03-25 00:00:00.000,ATP World Tour Masters 1000 Miami FL; U.S.A. ATP World Tour Masters 1000,HARD,2,Jurgen Melzer,N/A Bye,Jurgen Melzer,,R128,0,0,0,0,0,0,0,0,0,0,0,0,0,0,0,0,0,0,0,0,0,0,0,0,0,0,0
2009-03-25 00:00:00.000,ATP World Tour Masters 1000 Miami FL; U.S.A. ATP World Tour Masters 1000,HARD,2,Janko Tipsarevic,Jose Acasuso,Janko Tipsarevic,6-4; 4-6; 6-3,R128,121,9,1,40,78,33,40,21,38,0,2,14,54,78,8,4,43,85,32,43,21,42,1,5,15,53,85
2009-03-25 00:00:00.000,ATP World Tour Masters 1000 Miami FL; U.S.A. ATP World Tour Masters 1000,HARD,2,Martin Vassallo Arguello,Potito Starace,Martin Vassallo Arguello,7-6(9); 6-4,R128,98,6,2,49,71,37,49,16,22,1,2,11,53,71,2,1,47,70,37,47,10,23,1,3,11,47,70
2009-03-25 00:00:00.000,ATP World Tour Masters 1000 Miami FL; U.S.A. ATP World Tour Masters 1000,HARD,2,Juan Martin Del Potro,N/A Bye,Juan Martin Del Potro,,R128,0,0,0,0,0,0,0,0,0,0,0,0,0,0,0,0,0,0,0,0,0,0,0,0,0,0,0
2009-03-25 00:00:00.000,ATP World Tour Masters 1000 Miami FL; U.S.A. ATP World Tour Masters 1000,HARD,2,Andy Murray,N/A Bye,Andy Murray,,R128,0,0,0,0,0,0,0,0,0,0,0,0,0,0,0,0,0,0,0,0,0,0,0,0,0,0,0
2009-03-25 00:00:00.000,ATP World Tour Masters 1000 Miami FL; U.S.A. ATP World Tour Masters 1000,HARD,2,Juan Monaco,Marc Gicquel,Juan Monaco,6-0; 6-4,R128,77,3,3,32,48,25,32,10,16,1,1,8,35,48,1,1,42,74,25,42,12,32,10,14,8,37,74
2009-03-25 00:00:00.000,ATP World Tour Masters 1000 Miami FL; U.S.A. ATP World Tour Masters 1000,HARD,2,Nicolas Massu,Ryan Sweeting,Nicolas Massu,6-4; 7-6(2),R128,101,3,7,53,79,34,53,13,26,6,10,11,47,79,4,10,33,62,21,33,9,29,1,6,11,30,62
2009-03-25 00:00:00.000,ATP World Tour Masters 1000 Miami FL; U.S.A. ATP World Tour Masters 1000,HARD,2,Mardy Fish,N/A Bye,Mardy Fish,,R128,0,0,0,0,0,0,0,0,0,0,0,0,0,0,0,0,0,0,0,0,0,0,0,0,0,0,0
2009-03-25 00:00:00.000,ATP World Tour Masters 1000 Miami FL; U.S.A. ATP World Tour Masters 1000,HARD,2,Bjorn Phau,N/A Bye,Bjorn Phau,,R128,0,0,0,0,0,0,0,0,0,0,0,0,0,0,0,0,0,0,0,0,0,0,0,0,0,0,0
2009-03-25 00:00:00.000,ATP World Tour Masters 1000 Miami FL; U.S.A. ATP World Tour Masters 1000,HARD,2,Albert Montanes,Stefan Koubek,Albert Montanes,6-4; 7-6(2),R128,80,3,2,40,65,35,40,12,25,2,3,11,47,65,4,1,46,69,29,46,14,23,0,2,11,43,69
2009-03-25 00:00:00.000,ATP World Tour Masters 1000 Miami FL; U.S.A. ATP World Tour Masters 1000,HARD,2,Viktor Troicki,Nicolas Devilder,Viktor Troicki,6-2; 6-3,R128,65,7,1,22,50,17,22,15,28,4,5,8,32,50,1,4,30,53,15,30,11,23,1,6,9,26,53
2009-03-25 00:00:00.000,ATP World Tour Masters 1000 Miami FL; U.S.A. ATP World Tour Masters 1000,HARD,2,David Nalbandian,N/A Bye,David Nalbandian,,R128,0,0,0,0,0,0,0,0,0,0,0,0,0,0,0,0,0,0,0,0,0,0,0,0,0,0,0
2009-03-25 00:00:00.000,ATP World Tour Masters 1000 Miami FL; U.S.A. ATP World Tour Masters 1000,HARD,2,Fernando Gonzalez,N/A Bye,Fernando Gonzalez,,R128,0,0,0,0,0,0,0,0,0,0,0,0,0,0,0,0,0,0,0,0,0,0,0,0,0,0,0
2009-03-25 00:00:00.000,ATP World Tour Masters 1000 Miami FL; U.S.A. ATP World Tour Masters 1000,HARD,2,Igor Kunitsyn,Guillermo Canas,Igor Kunitsyn,7-6(2); 5-7; 6-3,R128,180,2,0,73,110,49,73,18,37,5,9,17,67,110,3,6,61,105,45,61,18,44,8,12,16,63,105
2009-03-25 00:00:00.000,ATP World Tour Masters 1000 Miami FL; U.S.A. ATP World Tour Masters 1000,HARD,2,Bobby Reynolds,Juan Ignacio Chela,Bobby Reynolds,0-6; 7-5; 6-4,R128,130,11,2,55,93,33,55,14,38,9,16,14,47,93,4,4,51,88,31,51,17,37,3,9,14,48,88
2009-03-25 00:00:00.000,ATP World Tour Masters 1000 Miami FL; U.S.A. ATP World Tour Masters 1000,HARD,2,Radek Stepanek,N/A Bye,Radek Stepanek,,R128,0,0,0,0,0,0,0,0,0,0,0,0,0,0,0,0,0,0,0,0,0,0,0,0,0,0,0
2009-03-25 00:00:00.000,ATP World Tour Masters 1000 Miami FL; U.S.A. ATP World Tour Masters 1000,HARD,2,Feliciano Lopez,N/A Bye,Feliciano Lopez,,R128,0,0,0,0,0,0,0,0,0,0,0,0,0,0,0,0,0,0,0,0,0,0,0,0,0,0,0
2009-03-25 00:00:00.000,ATP World Tour Masters 1000 Miami FL; U.S.A. ATP World Tour Masters 1000,HARD,2,Sam Querrey,Gilles Muller,Sam Querrey,6-4; 6-3,R128,66,9,2,22,49,19,22,19,27,2,2,9,38,49,2,3,31,61,22,31,13,30,2,5,10,35,61
2009-03-25 00:00:00.000,ATP World Tour Masters 1000 Miami FL; U.S.A. ATP World Tour Masters 1000,HARD,2,Benjamin Becker,Jesse Levine,Benjamin Becker,6-4; 6-3,R128,64,7,1,27,52,20,27,16,25,2,3,9,36,52,5,3,28,50,15,28,15,22,1,5,10,30,50
2009-03-25 00:00:00.000,ATP World Tour Masters 1000 Miami FL; U.S.A. ATP World Tour Masters 1000,HARD,2,Fernando Verdasco,N/A Bye,Fernando Verdasco,,R128,0,0,0,0,0,0,0,0,0,0,0,0,0,0,0,0,0,0,0,0,0,0,0,0,0,0,0
2009-03-25 00:00:00.000,ATP World Tour Masters 1000 Miami FL; U.S.A. ATP World Tour Masters 1000,HARD,2,Gilles Simon,N/A Bye,Gilles Simon,,R128,0,0,0,0,0,0,0,0,0,0,0,0,0,0,0,0,0,0,0,0,0,0,0,0,0,0,0
2009-03-25 00:00:00.000,ATP World Tour Masters 1000 Miami FL; U.S.A. ATP World Tour Masters 1000,HARD,2,Lleyton Hewitt,Dudi Sela,Lleyton Hewitt,3-6; 6-4; 6-3,R128,118,4,6,39,77,25,39,19,38,6,11,14,44,77,0,2,54,93,29,54,20,39,5,11,14,49,93
2009-03-25 00:00:00.000,ATP World Tour Masters 1000 Miami FL; U.S.A. ATP World Tour Masters 1000,HARD,2,Jarkko Nieminen,Ivan Navarro,Jarkko Nieminen,6-3; 6-3,R128,80,1,1,37,58,27,37,14,21,4,4,9,41,58,8,4,46,66,30,46,7,20,2,5,9,37,66
2009-03-25 00:00:00.000,ATP World Tour Masters 1000 Miami FL; U.S.A. ATP World Tour Masters 1000,HARD,2,Rainer Schuettler,N/A Bye,Rainer Schuettler,,R128,0,0,0,0,0,0,0,0,0,0,0,0,0,0,0,0,0,0,0,0,0,0,0,0,0,0,0
2009-03-25 00:00:00.000,ATP World Tour Masters 1000 Miami FL; U.S.A. ATP World Tour Masters 1000,HARD,2,Robin Soderling,N/A Bye,Robin Soderling,,R128,0,0,0,0,0,0,0,0,0,0,0,0,0,0,0,0,0,0,0,0,0,0,0,0,0,0,0
2009-03-25 00:00:00.000,ATP World Tour Masters 1000 Miami FL; U.S.A. ATP World Tour Masters 1000,HARD,2,Robert Kendrick,Arnaud Clement,Robert Kendrick,6-3; 7-6(5),R128,94,13,1,40,75,34,40,19,35,3,4,11,53,75,2,6,41,71,30,41,15,30,4,6,10,45,71
2009-03-25 00:00:00.000,ATP World Tour Masters 1000 Miami FL; U.S.A. ATP World Tour Masters 1000,HARD,2,Agustin Calleri,Christophe Rochus,Agustin Calleri,6-4; 3-6; 6-3,R128,101,11,10,41,87,34,41,21,46,9,12,14,55,87,5,2,41,83,28,41,21,42,3,7,14,49,83
2009-03-25 00:00:00.000,ATP World Tour Masters 1000 Miami FL; U.S.A. ATP World Tour Masters 1000,HARD,2,Jo-Wilfried Tsonga,N/A Bye,Jo-Wilfried Tsonga,,R128,0,0,0,0,0,0,0,0,0,0,0,0,0,0,0,0,0,0,0,0,0,0,0,0,0,0,0
2009-03-25 00:00:00.000,ATP World Tour Masters 1000 Miami FL; U.S.A. ATP World Tour Masters 1000,HARD,2,James Blake,N/A Bye,James Blake,,R128,0,0,0,0,0,0,0,0,0,0,0,0,0,0,0,0,0,0,0,0,0,0,0,0,0,0,0
2009-03-25 00:00:00.000,ATP World Tour Masters 1000 Miami FL; U.S.A. ATP World Tour Masters 1000,HARD,2,Julien Benneteau,Florent Serra,Julien Benneteau,3-6; 6-3; 6-4,R128,129,7,9,60,112,36,60,27,52,10,14,14,63,112,5,2,55,90,37,55,14,35,6,11,14,51,90
2009-03-25 00:00:00.000,ATP World Tour Masters 1000 Miami FL; U.S.A. ATP World Tour Masters 1000,HARD,2,Mikhail Youzhny,Jeremy Chardy,Mikhail Youzhny,6-4; 3-6; 6-3,R128,119,4,6,50,95,38,50,24,45,11,13,14,62,95,10,3,40,87,28,40,27,47,4,7,14,55,87
2009-03-25 00:00:00.000,ATP World Tour Masters 1000 Miami FL; U.S.A. ATP World Tour Masters 1000,HARD,2,Tomas Berdych,N/A Bye,Tomas Berdych,,R128,0,0,0,0,0,0,0,0,0,0,0,0,0,0,0,0,0,0,0,0,0,0,0,0,0,0,0
2009-03-25 00:00:00.000,ATP World Tour Masters 1000 Miami FL; U.S.A. ATP World Tour Masters 1000,HARD,2,Paul-Henri Mathieu,N/A Bye,Paul-Henri Mathieu,,R128,0,0,0,0,0,0,0,0,0,0,0,0,0,0,0,0,0,0,0,0,0,0,0,0,0,0,0
2009-03-25 00:00:00.000,ATP World Tour Masters 1000 Miami FL; U.S.A. ATP World Tour Masters 1000,HARD,2,Marcos Baghdatis,Ernests Gulbis,Marcos Baghdatis,6-2; 6-2,R128,70,7,3,33,64,23,33,20,31,3,3,8,43,64,1,4,32,52,18,32,7,20,2,6,8,25,52
2009-03-25 00:00:00.000,ATP World Tour Masters 1000 Miami FL; U.S.A. ATP World Tour Masters 1000,HARD,2,Frank Dancevic,Philipp Kohlschreiber,Frank Dancevic,6-4; 7-6(2),R128,80,6,2,34,70,28,34,21,36,1,2,11,49,70,5,1,46,65,33,46,10,19,2,4,11,43,65
2009-03-25 00:00:00.000,ATP World Tour Masters 1000 Miami FL; U.S.A. ATP World Tour Masters 1000,HARD,2,Novak Djokovic,N/A Bye,Novak Djokovic,,R128,0,0,0,0,0,0,0,0,0,0,0,0,0,0,0,0,0,0,0,0,0,0,0,0,0,0,0
2009-03-25 00:00:00.000,ATP World Tour Masters 1000 Miami FL; U.S.A. ATP World Tour Masters 1000,HARD,2,Andy Roddick,N/A Bye,Andy Roddick,,R128,0,0,0,0,0,0,0,0,0,0,0,0,0,0,0,0,0,0,0,0,0,0,0,0,0,0,0
2009-03-25 00:00:00.000,ATP World Tour Masters 1000 Miami FL; U.S.A. ATP World Tour Masters 1000,HARD,2,Diego Junqueira,Yuki Bhambri,Diego Junqueira,6-4; 6-3,R128,82,0,1,41,58,28,41,11,17,6,7,9,39,58,0,6,34,65,21,34,15,31,4,8,10,36,65
2009-03-25 00:00:00.000,ATP World Tour Masters 1000 Miami FL; U.S.A. ATP World Tour Masters 1000,HARD,2,Mikhail Kukushkin,Tommy Haas,Mikhail Kukushkin,6-4; 6-4,R128,84,2,0,32,56,21,32,17,24,0,1,10,38,56,8,8,33,69,26,33,13,36,2,5,10,39,69
2009-03-25 00:00:00.000,ATP World Tour Masters 1000 Miami FL; U.S.A. ATP World Tour Masters 1000,HARD,2,Dmitry Tursunov,N/A Bye,Dmitry Tursunov,,R128,0,0,0,0,0,0,0,0,0,0,0,0,0,0,0,0,0,0,0,0,0,0,0,0,0,0,0
2009-03-25 00:00:00.000,ATP World Tour Masters 1000 Miami FL; U.S.A. ATP World Tour Masters 1000,HARD,2,Marat Safin,N/A Bye,Marat Safin,,R128,0,0,0,0,0,0,0,0,0,0,0,0,0,0,0,0,0,0,0,0,0,0,0,0,0,0,0
2009-03-25 00:00:00.000,ATP World Tour Masters 1000 Miami FL; U.S.A. ATP World Tour Masters 1000,HARD,2,Oscar Hernandez,Ivan Ljubicic,Oscar Hernandez,6-4; 6-4,R128,105,3,3,40,68,28,40,18,28,4,4,10,46,68,7,3,40,71,31,40,13,31,3,5,10,44,71
2009-03-25 00:00:00.000,ATP World Tour Masters 1000 Miami FL; U.S.A. ATP World Tour Masters 1000,HARD,2,Michael Russell,Victor Hanescu,Michael Russell,7-6(4); 6-3,R128,102,1,5,41,66,32,41,13,25,2,2,10,45,66,6,2,48,75,31,48,15,27,4,6,11,46,75
2009-03-25 00:00:00.000,ATP World Tour Masters 1000 Miami FL; U.S.A. ATP World Tour Masters 1000,HARD,2,Gael Monfils,N/A Bye,Gael Monfils,,R128,0,0,0,0,0,0,0,0,0,0,0,0,0,0,0,0,0,0,0,0,0,0,0,0,0,0,0
2009-03-25 00:00:00.000,ATP World Tour Masters 1000 Miami FL; U.S.A. ATP World Tour Masters 1000,HARD,2,Tommy Robredo,N/A Bye,Tommy Robredo,,R128,0,0,0,0,0,0,0,0,0,0,0,0,0,0,0,0,0,0,0,0,0,0,0,0,0,0,0
2009-03-25 00:00:00.000,ATP World Tour Masters 1000 Miami FL; U.S.A. ATP World Tour Masters 1000,HARD,2,Jan Hernych,Brendan Evans,Jan Hernych,6-4; 6-3,R128,76,2,6,27,57,23,27,17,30,4,4,9,40,57,10,3,48,79,33,48,12,31,4,7,10,45,79
2009-03-25 00:00:00.000,ATP World Tour Masters 1000 Miami FL; U.S.A. ATP World Tour Masters 1000,HARD,2,Taylor Dent,Ricardo Mello,Taylor Dent,6-1; 6-3,R128,69,3,3,36,64,27,36,15,28,3,3,8,42,64,1,3,32,54,20,32,8,22,2,6,8,28,54
2009-03-25 00:00:00.000,ATP World Tour Masters 1000 Miami FL; U.S.A. ATP World Tour Masters 1000,HARD,2,Nicolas Almagro,N/A Bye,Nicolas Almagro,,R128,0,0,0,0,0,0,0,0,0,0,0,0,0,0,0,0,0,0,0,0,0,0,0,0,0,0,0
2009-03-25 00:00:00.000,ATP World Tour Masters 1000 Miami FL; U.S.A. ATP World Tour Masters 1000,HARD,2,Nicolas Kiefer,N/A Bye,Nicolas Kiefer,,R128,0,0,0,0,0,0,0,0,0,0,0,0,0,0,0,0,0,0,0,0,0,0,0,0,0,0,0
2009-03-25 00:00:00.000,ATP World Tour Masters 1000 Miami FL; U.S.A. ATP World Tour Masters 1000,HARD,2,Fabrice Santoro,Thomaz Bellucci,Fabrice Santoro,6-4; 4-6; 6-1,R128,132,4,2,50,88,32,50,21,38,2,6,14,53,88,4,4,44,77,28,44,12,33,3,9,13,40,77
2009-03-25 00:00:00.000,ATP World Tour Masters 1000 Miami FL; U.S.A. ATP World Tour Masters 1000,HARD,2,Kevin Kim,Michael Llodra,Kevin Kim,3-6 RET,R128,29,2,1,14,21,11,14,3,7,0,1,4,14,21,6,0,22,31,18,22,4,9,2,2,5,22,31
2009-03-25 00:00:00.000,ATP World Tour Masters 1000 Miami FL; U.S.A. ATP World Tour Masters 1000,HARD,2,Roger Federer,N/A Bye,Roger Federer,,R128,0,0,0,0,0,0,0,0,0,0,0,0,0,0,0,0,0,0,0,0,0,0,0,0,0,0,0
2009-03-25 00:00:00.000,ATP World Tour Masters 1000 Miami FL; U.S.A. ATP World Tour Masters 1000,HARD,2,Rafael Nadal,Teymuraz Gabashvili,Rafael Nadal,6-2; 6-2,R64,83,3,0,26,41,21,26,9,15,2,3,8,30,41,4,2,38,58,22,38,5,20,4,9,8,27,58
2009-03-25 00:00:00.000,ATP World Tour Masters 1000 Miami FL; U.S.A. ATP World Tour Masters 1000,HARD,2,Frederico Gil,Ivo Karlovic,Frederico Gil,6-4; 6-4,R64,90,1,3,39,66,28,39,15,27,4,5,10,43,66,16,4,44,74,32,44,11,30,9,12,10,43,74
2009-03-25 00:00:00.000,ATP World Tour Masters 1000 Miami FL; U.S.A. ATP World Tour Masters 1000,HARD,2,Igor Andreev,Yen-Hsun Lu,Igor Andreev,7-6(4); 6-3,R64,116,9,4,43,87,33,43,23,44,3,3,11,56,87,2,5,39,65,29,39,14,26,4,5,10,43,65
2009-03-25 00:00:00.000,ATP World Tour Masters 1000 Miami FL; U.S.A. ATP World Tour Masters 1000,HARD,2,Stanislas Wawrinka,Andreas Seppi,Stanislas Wawrinka,7-5; 7-5,R64,113,12,3,42,88,31,42,23,46,10,12,12,54,88,5,4,37,71,27,37,17,34,1,5,12,44,71
2009-03-25 00:00:00.000,ATP World Tour Masters 1000 Miami FL; U.S.A. ATP World Tour Masters 1000,HARD,2,David Ferrer,John Isner,David Ferrer,6-3; 3-6; 6-2,R64,108,2,3,43,74,31,43,21,31,8,10,13,52,74,16,2,53,80,39,53,9,27,2,6,13,48,80
2009-03-25 00:00:00.000,ATP World Tour Masters 1000 Miami FL; U.S.A. ATP World Tour Masters 1000,HARD,2,Marin Cilic,Amer Delic,Marin Cilic,6-3; 6-7(7); 6-3,R64,149,5,3,46,101,37,46,30,55,1,3,16,67,101,7,5,54,111,42,54,22,57,11,15,14,64,111
2009-03-25 00:00:00.000,ATP World Tour Masters 1000 Miami FL; U.S.A. ATP World Tour Masters 1000,HARD,2,Janko Tipsarevic,Jurgen Melzer,Janko Tipsarevic,6-4; 6-3,R64,79,4,1,27,48,20,27,15,21,2,3,9,35,48,3,4,31,57,19,31,13,26,2,6,10,32,57
2009-03-25 00:00:00.000,ATP World Tour Masters 1000 Miami FL; U.S.A. ATP World Tour Masters 1000,HARD,2,Juan Martin Del Potro,Martin Vassallo Arguello,Juan Martin Del Potro,6-2; 6-2,R64,80,5,2,23,41,20,23,12,18,0,0,8,32,41,0,4,25,48,15,25,9,23,3,7,8,24,48
2009-03-25 00:00:00.000,ATP World Tour Masters 1000 Miami FL; U.S.A. ATP World Tour Masters 1000,HARD,2,Andy Murray,Juan Monaco,Andy Murray,4-6; 6-3; 6-2,R64,135,9,4,68,99,41,68,17,31,9,12,14,58,99,3,2,56,81,36,56,8,25,5,10,13,44,81
2009-03-25 00:00:00.000,ATP World Tour Masters 1000 Miami FL; U.S.A. ATP World Tour Masters 1000,HARD,2,Nicolas Massu,Mardy Fish,Nicolas Massu,5-7; 7-6(4); 6-2,R64,142,10,4,61,101,48,61,23,40,2,3,16,71,101,14,3,57,93,43,57,22,36,4,6,16,65,93
2009-03-25 00:00:00.000,ATP World Tour Masters 1000 Miami FL; U.S.A. ATP World Tour Masters 1000,HARD,2,Bjorn Phau,Albert Montanes,Bjorn Phau,6-4; 2-0 RET,R64,58,2,2,16,42,11,16,13,26,3,5,6,24,42,2,1,21,40,14,21,3,19,2,6,6,17,40
2009-03-25 00:00:00.000,ATP World Tour Masters 1000 Miami FL; U.S.A. ATP World Tour Masters 1000,HARD,2,Viktor Troicki,David Nalbandian,Viktor Troicki,6-1; 6-3,R64,74,7,5,32,64,27,32,15,32,6,6,8,42,64,2,3,14,46,8,14,16,32,2,6,8,24,46
2009-03-25 00:00:00.000,ATP World Tour Masters 1000 Miami FL; U.S.A. ATP World Tour Masters 1000,HARD,2,Fernando Gonzalez,Igor Kunitsyn,Fernando Gonzalez,6-4; 6-4,R64,70,5,4,38,63,27,38,17,25,5,5,10,44,63,0,1,54,63,35,54,5,9,3,5,10,40,63
2009-03-25 00:00:00.000,ATP World Tour Masters 1000 Miami FL; U.S.A. ATP World Tour Masters 1000,HARD,2,Radek Stepanek,Bobby Reynolds,Radek Stepanek,7-5; 6-7(3); 6-2,R64,139,11,7,61,103,43,61,25,42,6,7,16,68,103,9,7,56,100,46,56,18,44,2,6,16,64,100
2009-03-25 00:00:00.000,ATP World Tour Masters 1000 Miami FL; U.S.A. ATP World Tour Masters 1000,HARD,2,Feliciano Lopez,Sam Querrey,Feliciano Lopez,6-7(5); 7-5; 6-2,R64,126,15,3,61,98,50,61,22,37,3,3,16,72,98,6,5,47,101,34,47,30,54,4,7,16,64,101
2009-03-25 00:00:00.000,ATP World Tour Masters 1000 Miami FL; U.S.A. ATP World Tour Masters 1000,HARD,2,Fernando Verdasco,Benjamin Becker,Fernando Verdasco,6-3; 6-4,R64,79,1,6,38,58,26,38,8,20,3,6,10,34,58,4,2,31,55,22,31,5,24,3,8,9,27,55
2009-03-25 00:00:00.000,ATP World Tour Masters 1000 Miami FL; U.S.A. ATP World Tour Masters 1000,HARD,2,Gilles Simon,Lleyton Hewitt,Gilles Simon,6-1; 6-2,R64,86,7,3,29,62,21,29,16,33,8,10,8,37,62,1,6,25,62,10,25,14,37,8,14,7,24,62
2009-03-25 00:00:00.000,ATP World Tour Masters 1000 Miami FL; U.S.A. ATP World Tour Masters 1000,HARD,2,Rainer Schuettler,Jarkko Nieminen,Rainer Schuettler,4-6; 6-2; 6-3,R64,107,1,3,50,84,31,50,17,34,4,9,14,48,84,2,1,59,83,32,59,9,24,6,13,13,41,83
2009-03-25 00:00:00.000,ATP World Tour Masters 1000 Miami FL; U.S.A. ATP World Tour Masters 1000,HARD,2,Robert Kendrick,Robin Soderling,Robert Kendrick,6-4; 6-2,R64,66,5,1,28,54,22,28,17,26,2,3,9,39,54,7,4,34,59,22,34,11,25,3,7,9,33,59
2009-03-25 00:00:00.000,ATP World Tour Masters 1000 Miami FL; U.S.A. ATP World Tour Masters 1000,HARD,2,Jo-Wilfried Tsonga,Agustin Calleri,Jo-Wilfried Tsonga,6-1; 6-1,R64,55,5,1,22,35,21,22,8,13,1,1,7,29,35,1,3,21,47,12,21,8,26,1,6,7,20,47
2009-03-25 00:00:00.000,ATP World Tour Masters 1000 Miami FL; U.S.A. ATP World Tour Masters 1000,HARD,2,James Blake,Julien Benneteau,James Blake,6-4; 6-4,R64,69,8,1,27,53,20,27,21,26,3,4,10,41,53,2,1,34,56,21,34,13,22,3,6,10,34,56
2009-03-25 00:00:00.000,ATP World Tour Masters 1000 Miami FL; U.S.A. ATP World Tour Masters 1000,HARD,2,Tomas Berdych,Mikhail Youzhny,Tomas Berdych,6-3; 3-6; 6-4,R64,132,4,2,48,81,35,48,19,33,2,5,14,54,81,6,2,59,104,38,59,22,45,6,10,14,60,104
2009-03-25 00:00:00.000,ATP World Tour Masters 1000 Miami FL; U.S.A. ATP World Tour Masters 1000,HARD,2,Paul-Henri Mathieu,Marcos Baghdatis,Paul-Henri Mathieu,6-3; 2-6; 6-2,R64,105,3,0,50,77,39,50,12,27,5,7,13,51,77,8,1,31,65,25,31,17,34,2,5,12,42,65
2009-03-25 00:00:00.000,ATP World Tour Masters 1000 Miami FL; U.S.A. ATP World Tour Masters 1000,HARD,2,Novak Djokovic,Frank Dancevic,Novak Djokovic,6-3; 6-2,R64,71,4,2,39,59,30,39,13,20,6,6,9,43,59,1,3,32,52,22,32,8,20,2,5,8,30,52
2009-03-25 00:00:00.000,ATP World Tour Masters 1000 Miami FL; U.S.A. ATP World Tour Masters 1000,HARD,2,Andy Roddick,Diego Junqueira,Andy Roddick,6-1; 6-1,R64,57,5,0,23,36,22,23,6,13,0,0,7,28,36,0,2,29,42,11,29,6,13,4,9,7,17,42
2009-03-25 00:00:00.000,ATP World Tour Masters 1000 Miami FL; U.S.A. ATP World Tour Masters 1000,HARD,2,Dmitry Tursunov,Mikhail Kukushkin,Dmitry Tursunov,3-6; 7-6(4); 6-3,R64,138,7,4,61,101,44,61,19,40,5,10,16,63,101,4,5,51,95,31,51,24,44,5,9,14,55,95
2009-03-25 00:00:00.000,ATP World Tour Masters 1000 Miami FL; U.S.A. ATP World Tour Masters 1000,HARD,2,Marat Safin,Oscar Hernandez,Marat Safin,6-4; 2-6; 6-1,R64,110,5,2,39,68,31,39,14,29,3,5,12,45,68,5,3,47,85,34,47,16,38,7,11,13,50,85
2009-03-25 00:00:00.000,ATP World Tour Masters 1000 Miami FL; U.S.A. ATP World Tour Masters 1000,HARD,2,Gael Monfils,Michael Russell,Gael Monfils,6-2; 6-7(5); 6-3,R64,107,9,6,49,86,46,49,21,37,5,5,15,67,86,1,2,58,85,43,58,14,27,2,5,14,57,85
2009-03-25 00:00:00.000,ATP World Tour Masters 1000 Miami FL; U.S.A. ATP World Tour Masters 1000,HARD,2,Tommy Robredo,Jan Hernych,Tommy Robredo,6-4; 6-4,R64,85,6,1,33,64,30,33,16,31,2,2,10,46,64,1,0,43,66,28,43,13,23,4,6,10,41,66
2009-03-25 00:00:00.000,ATP World Tour Masters 1000 Miami FL; U.S.A. ATP World Tour Masters 1000,HARD,2,Taylor Dent,Nicolas Almagro,Taylor Dent,2-6; 6-2; 7-6(7),R64,108,10,6,54,92,40,54,21,38,2,5,14,61,92,7,2,52,89,39,52,20,37,3,6,14,59,89
2009-03-25 00:00:00.000,ATP World Tour Masters 1000 Miami FL; U.S.A. ATP World Tour Masters 1000,HARD,2,Nicolas Kiefer,Fabrice Santoro,Nicolas Kiefer,5-7; 7-6(5); 6-2,R64,152,6,5,38,90,26,38,35,52,2,5,16,61,90,6,9,53,106,37,53,25,53,6,10,16,62,106
2009-03-25 00:00:00.000,ATP World Tour Masters 1000 Miami FL; U.S.A. ATP World Tour Masters 1000,HARD,2,Roger Federer,Kevin Kim,Roger Federer,6-3; 6-2,R64,65,4,1,35,58,27,35,13,23,5,5,9,40,58,5,2,29,62,24,29,11,33,2,5,8,35,62
2009-03-25 00:00:00.000,ATP World Tour Masters 1000 Miami FL; U.S.A. ATP World Tour Masters 1000,HARD,2,Rafael Nadal,Frederico Gil,Rafael Nadal,7-5; 6-3,R32,95,5,1,41,58,31,41,7,17,4,6,10,38,58,4,0,41,67,24,41,13,26,1,6,11,37,67
2009-03-25 00:00:00.000,ATP World Tour Masters 1000 Miami FL; U.S.A. ATP World Tour Masters 1000,HARD,2,Stanislas Wawrinka,Igor Andreev,Stanislas Wawrinka,4-6; 6-3; 6-3,R32,151,9,4,61,107,47,61,22,46,8,9,14,69,107,3,5,52,96,37,52,23,44,9,12,14,60,96
2009-03-25 00:00:00.000,ATP World Tour Masters 1000 Miami FL; U.S.A. ATP World Tour Masters 1000,HARD,2,David Ferrer,Marin Cilic,David Ferrer,3-6; 6-3; 6-4,R32,127,2,6,47,79,35,47,17,32,8,11,14,52,79,8,3,45,85,32,45,18,40,9,13,14,50,85
2009-03-25 00:00:00.000,ATP World Tour Masters 1000 Miami FL; U.S.A. ATP World Tour Masters 1000,HARD,2,Juan Martin Del Potro,Janko Tipsarevic,Juan Martin Del Potro,6-4; 6-1,R32,68,7,3,26,43,24,26,9,17,2,2,8,33,43,1,4,28,47,16,28,9,19,1,5,9,25,47
2009-03-25 00:00:00.000,ATP World Tour Masters 1000 Miami FL; U.S.A. ATP World Tour Masters 1000,HARD,2,Andy Murray,Nicolas Massu,Andy Murray,6-4; 6-4,R32,107,4,5,37,63,25,37,13,26,5,8,10,38,63,5,6,34,68,22,34,11,34,2,7,10,33,68
2009-03-25 00:00:00.000,ATP World Tour Masters 1000 Miami FL; U.S.A. ATP World Tour Masters 1000,HARD,2,Viktor Troicki,Bjorn Phau,Viktor Troicki,6-4; 6-3,R32,76,12,3,36,59,29,36,11,23,6,7,9,40,59,3,8,35,70,21,35,16,35,3,7,10,37,70
2009-03-25 00:00:00.000,ATP World Tour Masters 1000 Miami FL; U.S.A. ATP World Tour Masters 1000,HARD,2,Radek Stepanek,Fernando Gonzalez,Radek Stepanek,7-6(1); 6-4,R32,91,4,2,41,65,33,41,13,24,0,1,11,46,65,5,1,45,71,33,45,10,26,3,5,11,43,71
2009-03-25 00:00:00.000,ATP World Tour Masters 1000 Miami FL; U.S.A. ATP World Tour Masters 1000,HARD,2,Fernando Verdasco,Feliciano Lopez,Fernando Verdasco,3-6; 6-3; 6-4,R32,125,3,5,57,76,41,57,11,19,0,2,14,52,76,13,7,55,98,41,55,16,43,7,10,14,57,98
2009-03-25 00:00:00.000,ATP World Tour Masters 1000 Miami FL; U.S.A. ATP World Tour Masters 1000,HARD,2,Gilles Simon,Rainer Schuettler,Gilles Simon,3-6; 6-1; 6-1,R32,96,5,3,32,67,22,32,21,35,7,10,11,43,67,1,4,41,70,21,41,10,29,4,11,12,31,70
2009-03-25 00:00:00.000,ATP World Tour Masters 1000 Miami FL; U.S.A. ATP World Tour Masters 1000,HARD,2,Jo-Wilfried Tsonga,Robert Kendrick,Jo-Wilfried Tsonga,7-5; 6-4,R32,92,11,1,43,63,37,43,10,20,0,0,11,47,63,3,4,40,80,30,40,20,40,2,4,11,50,80
2009-03-25 00:00:00.000,ATP World Tour Masters 1000 Miami FL; U.S.A. ATP World Tour Masters 1000,HARD,2,Tomas Berdych,James Blake,Tomas Berdych,6-4; 6-7(3); 6-3,R32,142,6,4,53,107,42,53,31,54,4,5,16,73,107,7,4,65,108,45,65,21,43,9,12,15,66,108
2009-03-25 00:00:00.000,ATP World Tour Masters 1000 Miami FL; U.S.A. ATP World Tour Masters 1000,HARD,2,Novak Djokovic,Paul-Henri Mathieu,Novak Djokovic,6-4; 6-1,R32,76,4,2,28,42,23,28,11,14,3,3,8,34,42,1,11,29,64,17,29,17,35,3,7,9,34,64
2009-03-25 00:00:00.000,ATP World Tour Masters 1000 Miami FL; U.S.A. ATP World Tour Masters 1000,HARD,2,Andy Roddick,Dmitry Tursunov,Andy Roddick,7-6(9); 6-2,R32,110,11,1,42,60,32,42,12,18,0,1,10,44,60,4,3,43,80,32,43,15,37,7,10,10,47,80
2009-03-25 00:00:00.000,ATP World Tour Masters 1000 Miami FL; U.S.A. ATP World Tour Masters 1000,HARD,2,Gael Monfils,Marat Safin,Gael Monfils,5-7; 7-5; 7-6(3),R32,173,13,2,59,110,42,59,28,51,8,12,18,70,110,9,7,63,127,46,63,30,64,3,7,18,76,127
2009-03-25 00:00:00.000,ATP World Tour Masters 1000 Miami FL; U.S.A. ATP World Tour Masters 1000,HARD,2,Taylor Dent,Tommy Robredo,Taylor Dent,7-5; 6-3,R32,76,5,4,35,67,26,35,20,32,1,2,11,46,67,2,1,37,52,21,37,10,15,0,3,10,31,52
2009-03-25 00:00:00.000,ATP World Tour Masters 1000 Miami FL; U.S.A. ATP World Tour Masters 1000,HARD,2,Roger Federer,Nicolas Kiefer,Roger Federer,6-4; 6-1,R32,71,5,1,35,44,26,35,6,9,0,0,8,32,44,5,3,32,59,24,32,7,27,2,6,9,31,59
2009-03-25 00:00:00.000,ATP World Tour Masters 1000 Miami FL; U.S.A. ATP World Tour Masters 1000,HARD,2,Rafael Nadal,Stanislas Wawrinka,Rafael Nadal,7-6(2); 7-6(4),R16,163,0,0,54,83,40,54,19,29,4,5,12,59,83,7,2,58,103,44,58,21,45,11,12,12,65,103
2009-03-25 00:00:00.000,ATP World Tour Masters 1000 Miami FL; U.S.A. ATP World Tour Masters 1000,HARD,2,Juan Martin Del Potro,David Ferrer,Juan Martin Del Potro,6-3; 6-2,R16,80,4,2,24,46,19,24,12,22,1,2,8,31,46,3,3,32,59,21,32,7,27,7,12,9,28,59
2009-03-25 00:00:00.000,ATP World Tour Masters 1000 Miami FL; U.S.A. ATP World Tour Masters 1000,HARD,2,Andy Murray,Viktor Troicki,Andy Murray,6-1; 6-0,R16,58,2,3,29,41,24,29,6,12,0,0,7,30,41,5,5,16,48,11,16,9,32,6,11,6,20,48
2009-03-25 00:00:00.000,ATP World Tour Masters 1000 Miami FL; U.S.A. ATP World Tour Masters 1000,HARD,2,Fernando Verdasco,Radek Stepanek,Fernando Verdasco,6-2; 6-2,R16,71,2,2,35,47,27,35,9,12,2,2,8,36,47,0,3,25,51,13,25,12,26,3,7,8,25,51
2009-03-25 00:00:00.000,ATP World Tour Masters 1000 Miami FL; U.S.A. ATP World Tour Masters 1000,HARD,2,Jo-Wilfried Tsonga,Gilles Simon,Jo-Wilfried Tsonga,6-7(4); 6-3; 6-2,R16,131,9,3,59,101,50,59,22,42,5,5,15,72,101,4,4,35,78,28,35,26,43,2,5,14,54,78
2009-03-25 00:00:00.000,ATP World Tour Masters 1000 Miami FL; U.S.A. ATP World Tour Masters 1000,HARD,2,Novak Djokovic,Tomas Berdych,Novak Djokovic,6-3; 6-2,R16,73,1,2,23,43,19,23,11,20,0,1,8,30,43,3,1,33,57,18,33,9,24,6,11,9,27,57
2009-03-25 00:00:00.000,ATP World Tour Masters 1000 Miami FL; U.S.A. ATP World Tour Masters 1000,HARD,2,Andy Roddick,Gael Monfils,Andy Roddick,7-6(2); 6-4,R16,97,5,1,42,63,37,42,11,21,0,1,11,48,63,10,5,47,76,34,47,12,29,3,5,11,46,76
2009-03-25 00:00:00.000,ATP World Tour Masters 1000 Miami FL; U.S.A. ATP World Tour Masters 1000,HARD,2,Roger Federer,Taylor Dent,Roger Federer,6-3; 6-2,R16,86,5,4,41,68,34,41,13,27,8,8,9,47,68,3,5,45,81,30,45,15,36,8,11,8,45,81
2009-03-25 00:00:00.000,ATP World Tour Masters 1000 Miami FL; U.S.A. ATP World Tour Masters 1000,HARD,2,Juan Martin Del Potro,Rafael Nadal,Juan Martin Del Potro,6-4; 3-6; 7-6(3),Q,180,8,4,58,97,41,58,18,39,4,8,15,59,97,8,2,65,103,45,65,18,38,9,13,16,63,103
2009-03-25 00:00:00.000,ATP World Tour Masters 1000 Miami FL; U.S.A. ATP World Tour Masters 1000,HARD,2,Andy Murray,Fernando Verdasco,Andy Murray,6-1; 6-2,Q,76,3,3,30,55,20,30,14,25,7,8,8,34,55,2,2,32,44,16,32,4,12,2,7,7,20,44
2009-03-25 00:00:00.000,ATP World Tour Masters 1000 Miami FL; U.S.A. ATP World Tour Masters 1000,HARD,2,Novak Djokovic,Jo-Wilfried Tsonga,Novak Djokovic,6-3; 6-4,Q,116,0,1,32,67,23,32,23,35,4,4,10,46,67,4,3,34,67,27,34,13,33,5,7,9,40,67
2009-03-25 00:00:00.000,ATP World Tour Masters 1000 Miami FL; U.S.A. ATP World Tour Masters 1000,HARD,2,Roger Federer,Andy Roddick,Roger Federer,6-3; 4-6; 6-4,Q,123,7,5,51,80,36,51,20,29,2,3,14,56,80,6,4,71,101,48,71,16,30,4,7,15,64,101
2009-03-25 00:00:00.000,ATP World Tour Masters 1000 Miami FL; U.S.A. ATP World Tour Masters 1000,HARD,2,Andy Murray,Juan Martin Del Potro,Andy Murray,6-1; 5-7; 6-2,S,137,6,3,48,74,35,48,17,26,0,2,14,52,74,4,3,51,86,34,51,15,35,6,11,13,49,86
2009-03-25 00:00:00.000,ATP World Tour Masters 1000 Miami FL; U.S.A. ATP World Tour Masters 1000,HARD,2,Novak Djokovic,Roger Federer,Novak Djokovic,3-6; 6-2; 6-3,S,106,4,4,51,73,35,51,12,22,2,6,13,47,73,4,4,48,80,28,48,13,32,4,10,13,41,80
2009-03-25 00:00:00.000,ATP World Tour Masters 1000 Miami FL; U.S.A. ATP World Tour Masters 1000,HARD,2,Andy Murray,Novak Djokovic,Andy Murray,6-2; 7-5,F,103,8,0,36,61,27,36,13,25,3,5,10,40,61,2,5,45,73,24,45,12,28,6,11,10,36,73
2009-04-06 00:00:00.000,Casablanca Morocco ATP World Tour 250,CLAY,2,Igor Andreev,Rabie Chaki,Igor Andreev,3-6; 6-3; 7-5,R32,122,4,3,57,82,42,57,13,25,5,8,15,55,82,3,3,77,105,47,77,16,28,8,12,15,63,105
2009-04-06 00:00:00.000,Casablanca Morocco ATP World Tour 250,CLAY,2,Nicolas Devilder,Daniel Koellerer,Nicolas Devilder,6-3; 6-4,R32,71,6,1,36,56,25,36,14,20,0,1,10,39,56,0,3,33,55,22,33,10,22,5,8,9,32,55
2009-04-06 00:00:00.000,Casablanca Morocco ATP World Tour 250,CLAY,2,Mischa Zverev,Flavio Cipolla,Mischa Zverev,6-2; 3-6; 6-3,R32,97,5,4,53,76,37,53,12,23,6,9,13,49,76,1,3,49,71,27,49,13,22,1,6,13,40,71
2009-04-06 00:00:00.000,Casablanca Morocco ATP World Tour 250,CLAY,2,Marc Gicquel,Kristof Vliegen,Marc Gicquel,7-5; 6-3,R32,68,1,1,21,45,18,21,16,24,1,3,10,34,45,2,2,35,59,18,35,12,24,0,5,11,30,59
2009-04-06 00:00:00.000,Casablanca Morocco ATP World Tour 250,CLAY,2,Victor Hanescu,Steve Darcis,Victor Hanescu,6-4; 7-5,R32,96,1,2,47,73,28,47,18,26,6,8,11,46,73,2,2,28,58,21,28,13,30,2,6,11,34,58
2009-04-06 00:00:00.000,Casablanca Morocco ATP World Tour 250,CLAY,2,Ivan Navarro,Sergiy Stakhovsky,Ivan Navarro,7-5; 4-2 RET,R32,99,4,1,31,50,22,31,9,19,2,4,9,31,50,3,3,32,66,20,32,14,34,7,11,9,34,66
2009-04-06 00:00:00.000,Casablanca Morocco ATP World Tour 250,CLAY,2,Potito Starace,Oscar Hernandez,Potito Starace,4-6; 6-3; 6-3,R32,107,2,1,48,69,36,48,15,21,1,3,14,51,69,5,5,52,95,32,52,24,43,9,13,14,56,95
2009-04-06 00:00:00.000,Casablanca Morocco ATP World Tour 250,CLAY,2,Juan Carlos Ferrero,Christophe Rochus,Juan Carlos Ferrero,6-2; 6-3,R32,61,9,1,32,43,23,32,7,11,1,2,8,30,43,1,1,34,63,21,34,9,29,6,11,9,30,63
2009-04-06 00:00:00.000,Casablanca Morocco ATP World Tour 250,CLAY,2,Ivan Ljubicic,Arnaud Clement,Ivan Ljubicic,7-6(6); 5-7; 6-4,R32,178,16,1,64,111,50,64,25,47,3,5,17,75,111,5,1,65,110,47,65,25,45,7,9,17,72,110
2009-04-06 00:00:00.000,Casablanca Morocco ATP World Tour 250,CLAY,2,Frederico Gil,Alberto Martin,Frederico Gil,6-3; 3-6; 7-6(4),R32,142,3,4,52,101,35,52,22,49,4,9,15,57,101,5,5,49,98,35,49,25,49,6,11,15,60,98
2009-04-06 00:00:00.000,Casablanca Morocco ATP World Tour 250,CLAY,2,Santiago Ventura,Oliver Marach,Santiago Ventura,6-1; 6-1,R32,42,5,1,30,40,26,30,4,10,1,1,7,30,40,3,7,26,45,15,26,5,19,1,6,7,20,45
2009-04-06 00:00:00.000,Casablanca Morocco ATP World Tour 250,CLAY,2,Albert Montanes,Reda El Amrani,Albert Montanes,6-2; 7-5,R32,85,2,1,33,54,27,33,14,21,2,2,10,41,54,1,5,40,79,23,40,19,39,7,10,10,42,79
2009-04-06 00:00:00.000,Casablanca Morocco ATP World Tour 250,CLAY,2,Florent Serra,Thomaz Bellucci,Florent Serra,6-3; 6-3,R32,77,5,1,35,57,25,35,12,22,3,4,9,37,57,3,2,40,58,22,40,9,18,1,5,9,31,58
2009-04-06 00:00:00.000,Casablanca Morocco ATP World Tour 250,CLAY,2,Olivier Rochus,Mehdi Ziadi,Olivier Rochus,4-6; 6-2; 6-1,R32,115,1,0,53,78,39,53,13,25,8,10,13,52,78,7,4,39,68,26,39,14,29,1,6,12,40,68
2009-04-06 00:00:00.000,Casablanca Morocco ATP World Tour 250,CLAY,2,Teymuraz Gabashvili,Fabio Fognini,Teymuraz Gabashvili,6-2; 6-1,R32,45,5,2,23,44,18,23,14,21,1,1,7,32,44,0,2,21,53,11,21,13,32,4,9,8,24,53
2009-04-06 00:00:00.000,Casablanca Morocco ATP World Tour 250,CLAY,2,Ruben Ramirez Hidalgo,Rainer Schuettler,Ruben Ramirez Hidalgo,6-4; 7-6(5),R32,135,2,1,46,85,35,46,20,39,3,4,11,55,85,2,2,39,64,29,39,12,25,1,3,11,41,64
2009-04-06 00:00:00.000,Casablanca Morocco ATP World Tour 250,CLAY,2,Igor Andreev,Nicolas Devilder,Igor Andreev,6-7(11); 7-6(5); 6-4,R16,197,3,1,74,121,51,74,31,47,4,5,17,82,121,9,10,75,144,53,75,37,69,14,16,17,90,144
2009-04-06 00:00:00.000,Casablanca Morocco ATP World Tour 250,CLAY,2,Marc Gicquel,Mischa Zverev,Marc Gicquel,6-4; 7-5,R16,98,1,0,46,79,32,46,15,33,7,9,11,47,79,5,3,40,69,30,40,10,29,6,10,11,40,69
2009-04-06 00:00:00.000,Casablanca Morocco ATP World Tour 250,CLAY,2,Victor Hanescu,Ivan Navarro,Victor Hanescu,6-1; 6-0,R16,48,6,1,22,35,19,22,9,13,0,0,7,28,35,1,1,16,36,8,16,4,20,2,7,6,12,36
2009-04-06 00:00:00.000,Casablanca Morocco ATP World Tour 250,CLAY,2,Juan Carlos Ferrero,Potito Starace,Juan Carlos Ferrero,6-4; 7-6(1),R16,110,3,1,59,79,39,59,10,20,7,10,11,49,79,1,1,50,73,29,50,11,23,6,10,11,40,73
2009-04-06 00:00:00.000,Casablanca Morocco ATP World Tour 250,CLAY,2,Frederico Gil,Ivan Ljubicic,Frederico Gil,6-7(2); 7-5; 6-4,R16,175,5,4,62,116,49,62,27,54,5,6,17,76,116,9,4,58,106,45,58,25,48,4,7,17,70,106
2009-04-06 00:00:00.000,Casablanca Morocco ATP World Tour 250,CLAY,2,Albert Montanes,Santiago Ventura,Albert Montanes,5-7; 6-3; 7-5,R16,135,0,7,68,115,45,68,20,47,8,14,17,65,115,4,5,47,88,33,47,14,41,4,11,16,47,88
2009-04-06 00:00:00.000,Casablanca Morocco ATP World Tour 250,CLAY,2,Florent Serra,Olivier Rochus,Florent Serra,6-3; 6-3,R16,86,3,1,32,58,22,32,14,26,3,5,9,36,58,3,3,54,79,31,54,7,25,8,13,9,38,79
2009-04-06 00:00:00.000,Casablanca Morocco ATP World Tour 250,CLAY,2,Teymuraz Gabashvili,Ruben Ramirez Hidalgo,Teymuraz Gabashvili,6-4; 6-4,R16,107,4,6,49,87,37,49,18,38,7,7,10,55,87,6,4,42,71,30,42,13,29,3,5,10,43,71
2009-04-06 00:00:00.000,Casablanca Morocco ATP World Tour 250,CLAY,2,Igor Andreev,Marc Gicquel,Igor Andreev,6-1; 6-3,Q,53,5,1,27,37,24,27,8,10,0,0,8,32,37,1,3,24,50,18,24,9,26,4,8,8,27,50
2009-04-06 00:00:00.000,Casablanca Morocco ATP World Tour 250,CLAY,2,Juan Carlos Ferrero,Victor Hanescu,Juan Carlos Ferrero,6-3; 7-5,Q,93,3,0,42,51,31,42,7,9,0,1,10,38,51,5,1,59,84,35,59,12,25,8,12,11,47,84
2009-04-06 00:00:00.000,Casablanca Morocco ATP World Tour 250,CLAY,2,Albert Montanes,Frederico Gil,Albert Montanes,7-6(5); 6-4,Q,102,6,6,34,66,25,34,18,32,0,2,11,43,66,3,3,48,85,31,48,19,37,6,9,11,50,85
2009-04-06 00:00:00.000,Casablanca Morocco ATP World Tour 250,CLAY,2,Florent Serra,Teymuraz Gabashvili,Florent Serra,6-0; 6-4,Q,64,2,1,23,45,17,23,13,22,0,1,8,30,45,1,6,24,55,14,24,11,31,6,11,8,25,55
2009-04-06 00:00:00.000,Casablanca Morocco ATP World Tour 250,CLAY,2,Juan Carlos Ferrero,Igor Andreev,Juan Carlos Ferrero,7-6(9); 6-3,S,125,0,1,53,80,38,53,14,27,1,3,11,52,80,1,2,51,76,34,51,10,25,7,10,10,44,76
2009-04-06 00:00:00.000,Casablanca Morocco ATP World Tour 250,CLAY,2,Florent Serra,Albert Montanes,Florent Serra,6-4; 6-4,S,89,4,2,39,71,26,39,20,32,3,4,10,46,71,4,3,26,57,20,26,14,31,2,5,10,34,57
2009-04-06 00:00:00.000,Casablanca Morocco ATP World Tour 250,CLAY,2,Juan Carlos Ferrero,Florent Serra,Juan Carlos Ferrero,6-4; 7-5,F,97,5,3,42,59,29,42,5,17,3,7,11,34,59,0,2,47,78,25,47,14,31,6,12,11,39,78
2009-04-06 00:00:00.000,Houston TX; U.S.A. ATP World Tour 250,CLAY,2,Guillermo Canas,James Blake,Guillermo Canas,6-4; 6-4,R32,92,7,2,35,64,31,35,9,29,4,6,10,40,64,0,3,30,59,19,30,13,29,1,5,10,32,59
2009-04-06 00:00:00.000,Houston TX; U.S.A. ATP World Tour 250,CLAY,2,Taylor Dent,Marcos Daniel,Taylor Dent,4-6; 6-3; 6-2,R32,100,11,4,50,82,39,50,14,32,4,7,14,53,82,7,2,56,83,36,56,11,27,5,10,13,47,83
2009-04-06 00:00:00.000,Houston TX; U.S.A. ATP World Tour 250,CLAY,2,Evgeny Korolev,Leonardo Mayer,Evgeny Korolev,7-6(2); 2-6; 7-5,R32,152,3,7,63,117,49,63,22,54,10,14,16,71,117,6,3,60,100,42,60,20,40,2,5,16,62,100
2009-04-06 00:00:00.000,Houston TX; U.S.A. ATP World Tour 250,CLAY,2,Daniel Gimeno-Traver,Maximo Gonzalez,Daniel Gimeno-Traver,6-4; 3-6; 6-1,R32,130,1,1,53,92,34,53,24,39,5,7,13,58,92,0,4,70,104,43,70,15,34,9,13,13,58,104
2009-04-06 00:00:00.000,Houston TX; U.S.A. ATP World Tour 250,CLAY,2,Jeremy Chardy,Jesse Levine,Jeremy Chardy,6-3; 6-0,R32,61,6,1,25,45,20,25,14,20,1,1,8,34,45,3,2,25,51,14,25,11,26,5,9,7,25,51
2009-04-06 00:00:00.000,Houston TX; U.S.A. ATP World Tour 250,CLAY,2,Guillermo Garcia-Lopez,Giovanni Lapentti,Guillermo Garcia-Lopez,1-6; 6-0; 6-2,R32,100,2,4,34,62,22,34,16,28,3,6,10,38,62,0,1,43,68,22,43,9,25,7,13,11,31,68
2009-04-06 00:00:00.000,Houston TX; U.S.A. ATP World Tour 250,CLAY,2,Sergio Roitman,Agustin Calleri,Sergio Roitman,6-3; 6-3,R32,61,5,1,39,46,30,39,3,7,2,3,9,33,46,0,3,33,50,16,33,11,17,2,6,9,27,50
2009-04-06 00:00:00.000,Houston TX; U.S.A. ATP World Tour 250,CLAY,2,Lleyton Hewitt,Diego Junqueira,Lleyton Hewitt,6-0; 6-2,R32,65,4,0,22,41,20,22,10,19,2,2,7,30,41,1,2,40,58,18,40,8,18,12,17,7,26,58
2009-04-06 00:00:00.000,Houston TX; U.S.A. ATP World Tour 250,CLAY,2,Paul Capdeville,Amer Delic,Paul Capdeville,6-7(5); 7-6(5); 6-1,R32,139,1,4,74,107,54,74,22,33,2,3,16,76,107,6,3,70,114,43,70,29,44,10,13,15,72,114
2009-04-06 00:00:00.000,Houston TX; U.S.A. ATP World Tour 250,CLAY,2,John Isner,Michael Russell,John Isner,4-6; 6-3; 6-2,R32,128,10,4,52,83,45,52,13,31,4,5,14,58,83,0,1,71,92,42,71,13,21,4,7,13,55,92
2009-04-06 00:00:00.000,Houston TX; U.S.A. ATP World Tour 250,CLAY,2,Wayne Odesnik,Kevin Anderson,Wayne Odesnik,7-6(2); 6-4,R32,101,3,1,37,67,25,37,24,30,1,1,11,49,67,3,2,52,68,37,52,7,16,1,2,11,44,68
2009-04-06 00:00:00.000,Houston TX; U.S.A. ATP World Tour 250,CLAY,2,Jurgen Melzer,Robert Kendrick,Jurgen Melzer,6-1; 7-5,R32,67,2,3,33,53,24,33,9,20,2,4,9,33,53,3,5,37,59,20,37,8,22,3,9,10,28,59
2009-04-06 00:00:00.000,Houston TX; U.S.A. ATP World Tour 250,CLAY,2,Marcel Granollers,Brian Dabul,Marcel Granollers,2-6; 6-4; 6-1,R32,120,4,3,51,90,34,51,20,39,5,8,13,54,90,0,2,47,73,30,47,13,26,8,12,12,43,73
2009-04-06 00:00:00.000,Houston TX; U.S.A. ATP World Tour 250,CLAY,2,Tommy Haas,Denis Gremelmayr,Tommy Haas,6-3; 6-3,R32,82,3,2,35,54,26,35,10,19,4,6,9,36,54,0,5,34,61,19,34,9,27,5,10,9,28,61
2009-04-06 00:00:00.000,Houston TX; U.S.A. ATP World Tour 250,CLAY,2,Scoville Jenkins,Alexander Peya,Scoville Jenkins,0-6; 6-4; 6-3,R32,116,0,7,46,80,26,46,17,34,7,12,13,43,80,5,2,54,82,30,54,17,28,5,9,12,47,82
2009-04-06 00:00:00.000,Houston TX; U.S.A. ATP World Tour 250,CLAY,2,Bjorn Phau,Mardy Fish,Bjorn Phau,6-3; 5-7; 6-3,R32,121,7,1,39,81,32,39,27,42,4,6,15,59,81,6,1,52,84,36,52,18,32,2,6,15,54,84
2009-04-06 00:00:00.000,Houston TX; U.S.A. ATP World Tour 250,CLAY,2,Guillermo Canas,Taylor Dent,Guillermo Canas,6-2; 6-2,R16,61,4,2,26,43,22,26,10,17,3,4,8,32,43,0,3,25,50,15,25,9,25,6,11,8,24,50
2009-04-06 00:00:00.000,Houston TX; U.S.A. ATP World Tour 250,CLAY,2,Evgeny Korolev,Daniel Gimeno-Traver,Evgeny Korolev,6-3; 7-6(4),R16,80,2,2,33,60,28,33,14,27,0,2,11,42,60,8,3,36,63,25,36,14,27,3,6,10,39,63
2009-04-06 00:00:00.000,Houston TX; U.S.A. ATP World Tour 250,CLAY,2,Guillermo Garcia-Lopez,Jeremy Chardy,Guillermo Garcia-Lopez,6-1; 6-0,R16,56,2,2,22,40,16,22,9,18,2,3,6,25,40,1,5,19,39,5,19,5,20,6,13,7,10,39
2009-04-06 00:00:00.000,Houston TX; U.S.A. ATP World Tour 250,CLAY,2,Lleyton Hewitt,Sergio Roitman,Lleyton Hewitt,6-1; 6-3,R16,57,5,4,22,43,16,22,10,21,1,4,8,26,43,0,2,31,42,11,31,1,11,0,7,8,12,42
2009-04-06 00:00:00.000,Houston TX; U.S.A. ATP World Tour 250,CLAY,2,John Isner,Paul Capdeville,John Isner,4-6; 7-6(1); 7-6(5),R16,160,24,5,90,132,72,90,20,42,6,7,17,92,132,9,5,60,102,47,60,30,42,3,3,17,77,102
2009-04-06 00:00:00.000,Houston TX; U.S.A. ATP World Tour 250,CLAY,2,Wayne Odesnik,Jurgen Melzer,Wayne Odesnik,6-4; 6-0,R16,62,5,1,27,43,19,27,15,16,2,2,8,34,43,1,3,24,47,14,24,9,23,3,7,8,23,47
2009-04-06 00:00:00.000,Houston TX; U.S.A. ATP World Tour 250,CLAY,2,Tommy Haas,Marcel Granollers,Tommy Haas,4-6; 6-2; 6-3,R16,115,6,4,51,81,36,51,18,30,2,4,14,54,81,2,2,50,79,32,50,17,29,4,8,13,49,79
2009-04-06 00:00:00.000,Houston TX; U.S.A. ATP World Tour 250,CLAY,2,Bjorn Phau,Scoville Jenkins,Bjorn Phau,6-4; 7-6(2),R16,108,1,2,29,67,24,29,23,38,2,3,11,47,67,4,2,45,79,33,45,15,34,5,7,11,48,79
2009-04-06 00:00:00.000,Houston TX; U.S.A. ATP World Tour 250,CLAY,2,Evgeny Korolev,Guillermo Canas,Evgeny Korolev,2-6; 6-3; 6-4,Q,121,4,2,38,69,26,38,14,31,2,7,13,40,69,4,3,49,87,33,49,14,38,5,11,14,47,87
2009-04-06 00:00:00.000,Houston TX; U.S.A. ATP World Tour 250,CLAY,2,Lleyton Hewitt,Guillermo Garcia-Lopez,Lleyton Hewitt,6-3; 6-4,Q,104,8,6,39,73,29,39,16,34,7,9,10,45,73,2,3,34,67,23,34,12,33,8,12,9,35,67
2009-04-06 00:00:00.000,Houston TX; U.S.A. ATP World Tour 250,CLAY,2,Wayne Odesnik,John Isner,Wayne Odesnik,7-5; 3-6; 7-6(5),Q,158,9,1,48,92,38,48,32,44,4,5,16,70,92,14,3,56,96,42,56,28,40,2,3,17,70,96
2009-04-06 00:00:00.000,Houston TX; U.S.A. ATP World Tour 250,CLAY,2,Bjorn Phau,Tommy Haas,Bjorn Phau,6-3; 3-6; 6-3,Q,116,5,6,41,78,27,41,23,37,2,5,13,50,78,8,7,50,94,38,50,17,44,5,10,14,55,94
2009-04-06 00:00:00.000,Houston TX; U.S.A. ATP World Tour 250,CLAY,2,Lleyton Hewitt,Evgeny Korolev,Lleyton Hewitt,7-6(4); 6-4,S,93,3,3,38,68,31,38,19,30,0,0,11,50,68,4,1,43,71,30,43,16,28,2,3,11,46,71
2009-04-06 00:00:00.000,Houston TX; U.S.A. ATP World Tour 250,CLAY,2,Wayne Odesnik,Bjorn Phau,Wayne Odesnik,6-4; 6-3,S,103,7,1,43,66,30,43,10,23,4,6,10,40,66,3,2,28,68,17,28,19,40,4,8,9,36,68
2009-04-06 00:00:00.000,Houston TX; U.S.A. ATP World Tour 250,CLAY,2,Lleyton Hewitt,Wayne Odesnik,Lleyton Hewitt,6-2; 7-5,F,124,3,7,22,65,18,22,17,43,2,6,10,35,65,4,2,40,80,19,40,15,40,9,16,10,34,80
2009-04-12 00:00:00.000,ATP World Tour Masters 1000 Monte Carlo Monaco ATP World Tour Masters 1000,CLAY,2,Rafael Nadal,N/A Bye,Rafael Nadal,,R64,0,0,0,0,0,0,0,0,0,0,0,0,0,0,0,0,0,0,0,0,0,0,0,0,0,0,0
2009-04-12 00:00:00.000,ATP World Tour Masters 1000 Monte Carlo Monaco ATP World Tour Masters 1000,CLAY,2,Juan Ignacio Chela,Igor Kunitsyn,Juan Ignacio Chela,6-4; 2-6; 7-5,R64,143,1,4,66,106,38,66,20,40,11,17,15,58,106,0,0,81,98,47,81,9,17,13,19,15,56,98
2009-04-12 00:00:00.000,ATP World Tour Masters 1000 Monte Carlo Monaco ATP World Tour Masters 1000,CLAY,2,Marat Safin,Lleyton Hewitt,Marat Safin,6-4; 7-5,R64,96,10,3,42,66,30,42,11,24,4,6,11,41,66,2,4,27,62,20,27,17,35,4,8,11,37,62
2009-04-12 00:00:00.000,ATP World Tour Masters 1000 Monte Carlo Monaco ATP World Tour Masters 1000,CLAY,2,Nicolas Lapentti,Radek Stepanek,Nicolas Lapentti,6-3; 1-6; 6-3,R64,114,1,4,45,78,29,45,17,33,4,8,13,46,78,6,6,48,74,34,48,9,26,3,7,12,43,74
2009-04-12 00:00:00.000,ATP World Tour Masters 1000 Monte Carlo Monaco ATP World Tour Masters 1000,CLAY,2,Janko Tipsarevic,Gael Monfils,Janko Tipsarevic,6-3; 6-1,R64,67,0,3,19,48,12,19,19,29,1,2,8,31,48,2,4,26,52,14,26,9,26,3,8,8,23,52
2009-04-12 00:00:00.000,ATP World Tour Masters 1000 Monte Carlo Monaco ATP World Tour Masters 1000,CLAY,2,Simone Bolelli,Robin Soderling,Simone Bolelli,6-4; 1-6; 6-3,R64,124,6,2,43,83,31,43,20,40,1,4,13,51,83,3,6,39,87,27,39,24,48,8,11,13,51,87
2009-04-12 00:00:00.000,ATP World Tour Masters 1000 Monte Carlo Monaco ATP World Tour Masters 1000,CLAY,2,Ivan Ljubicic,Kristof Vliegen,Ivan Ljubicic,6-4; 6-7(5); 6-4,R64,150,4,3,60,98,43,60,20,38,1,4,16,63,98,8,6,64,114,46,64,23,50,7,12,16,69,114
2009-04-12 00:00:00.000,ATP World Tour Masters 1000 Monte Carlo Monaco ATP World Tour Masters 1000,CLAY,2,Juan Martin Del Potro,N/A Bye,Juan Martin Del Potro,,R64,0,0,0,0,0,0,0,0,0,0,0,0,0,0,0,0,0,0,0,0,0,0,0,0,0,0,0
2009-04-12 00:00:00.000,ATP World Tour Masters 1000 Monte Carlo Monaco ATP World Tour Masters 1000,CLAY,2,Andy Murray,N/A Bye,Andy Murray,,R64,0,0,0,0,0,0,0,0,0,0,0,0,0,0,0,0,0,0,0,0,0,0,0,0,0,0,0
2009-04-12 00:00:00.000,ATP World Tour Masters 1000 Monte Carlo Monaco ATP World Tour Masters 1000,CLAY,2,Victor Hanescu,Alberto Martin,Victor Hanescu,6-2; 6-3,R64,77,2,2,38,64,24,38,14,26,2,4,9,38,64,1,3,27,48,14,27,7,21,1,6,8,21,48
2009-04-12 00:00:00.000,ATP World Tour Masters 1000 Monte Carlo Monaco ATP World Tour Masters 1000,CLAY,2,Fabio Fognini,Tomas Berdych,Fabio Fognini,1-6; 6-3; 6-3,R64,119,4,5,38,81,22,38,23,43,5,10,13,45,81,2,0,45,70,29,45,8,25,5,10,12,37,70
2009-04-12 00:00:00.000,ATP World Tour Masters 1000 Monte Carlo Monaco ATP World Tour Masters 1000,CLAY,2,Marin Cilic,Flavio Cipolla,Marin Cilic,6-3; 6-2,R64,84,4,3,25,57,18,25,14,32,6,9,8,32,57,0,6,46,65,22,46,5,19,11,18,9,27,65
2009-04-12 00:00:00.000,ATP World Tour Masters 1000 Monte Carlo Monaco ATP World Tour Masters 1000,CLAY,2,David Nalbandian,Paul-Henri Mathieu,David Nalbandian,6-4; 3-6; 6-3,R64,120,9,10,38,80,29,38,20,42,3,7,14,49,80,1,4,70,107,37,70,21,37,6,11,14,58,107
2009-04-12 00:00:00.000,ATP World Tour Masters 1000 Monte Carlo Monaco ATP World Tour Masters 1000,CLAY,2,Marcel Granollers,Jose Acasuso,Marcel Granollers,7-6(4); 7-6(2),R64,135,2,3,56,90,40,56,14,34,4,8,12,54,90,2,9,45,94,26,45,25,49,5,9,12,51,94
2009-04-12 00:00:00.000,ATP World Tour Masters 1000 Monte Carlo Monaco ATP World Tour Masters 1000,CLAY,2,Ivo Karlovic,Florent Serra,Ivo Karlovic,6-4; 6-4,R64,78,11,1,33,52,29,33,12,19,0,0,10,41,52,2,2,57,88,41,57,10,31,10,12,10,51,88
2009-04-12 00:00:00.000,ATP World Tour Masters 1000 Monte Carlo Monaco ATP World Tour Masters 1000,CLAY,2,Nikolay Davydenko,N/A Bye,Nikolay Davydenko,,R64,0,0,0,0,0,0,0,0,0,0,0,0,0,0,0,0,0,0,0,0,0,0,0,0,0,0,0
2009-04-12 00:00:00.000,ATP World Tour Masters 1000 Monte Carlo Monaco ATP World Tour Masters 1000,CLAY,2,Fernando Verdasco,N/A Bye,Fernando Verdasco,,R64,0,0,0,0,0,0,0,0,0,0,0,0,0,0,0,0,0,0,0,0,0,0,0,0,0,0,0
2009-04-12 00:00:00.000,ATP World Tour Masters 1000 Monte Carlo Monaco ATP World Tour Masters 1000,CLAY,2,Philipp Kohlschreiber,Ernests Gulbis,Philipp Kohlschreiber,6-1; 6-3,R64,63,0,0,35,51,25,35,9,16,0,1,8,34,51,2,2,21,42,11,21,7,21,1,6,8,18,42
2009-04-12 00:00:00.000,ATP World Tour Masters 1000 Monte Carlo Monaco ATP World Tour Masters 1000,CLAY,2,Marc Gicquel,Eduardo Schwank,Marc Gicquel,3-6; 6-1; 7-6(2),R64,144,6,5,60,106,45,60,20,46,8,11,14,65,106,6,4,48,95,32,48,22,47,10,14,14,54,95
2009-04-12 00:00:00.000,ATP World Tour Masters 1000 Monte Carlo Monaco ATP World Tour Masters 1000,CLAY,2,David Ferrer,Feliciano Lopez,David Ferrer,6-2; 6-3,R64,69,1,1,35,53,25,35,13,18,1,2,9,38,53,0,1,25,43,17,25,5,18,0,4,8,22,43
2009-04-12 00:00:00.000,ATP World Tour Masters 1000 Monte Carlo Monaco ATP World Tour Masters 1000,CLAY,2,Albert Montanes,Nicolas Almagro,Albert Montanes,7-6(6); 4-6; 7-6(5),R64,150,1,10,63,121,42,63,30,58,5,10,17,72,121,12,2,54,106,41,54,28,52,5,9,17,69,106
2009-04-12 00:00:00.000,ATP World Tour Masters 1000 Monte Carlo Monaco ATP World Tour Masters 1000,CLAY,2,Jean-Rene Lisnard,Christophe Rochus,Jean-Rene Lisnard,6-2; 6-2,R64,71,5,1,23,53,18,23,17,30,2,3,8,35,53,0,2,17,52,10,17,14,35,6,11,8,24,52
2009-04-12 00:00:00.000,ATP World Tour Masters 1000 Monte Carlo Monaco ATP World Tour Masters 1000,CLAY,2,Oscar Hernandez,Julien Benneteau,Oscar Hernandez,6-4; 6-4,R64,99,2,2,33,52,23,33,11,19,1,3,10,34,52,2,9,42,64,31,42,4,22,3,7,10,35,64
2009-04-12 00:00:00.000,ATP World Tour Masters 1000 Monte Carlo Monaco ATP World Tour Masters 1000,CLAY,2,Novak Djokovic,N/A Bye,Novak Djokovic,,R64,0,0,0,0,0,0,0,0,0,0,0,0,0,0,0,0,0,0,0,0,0,0,0,0,0,0,0
2009-04-12 00:00:00.000,ATP World Tour Masters 1000 Monte Carlo Monaco ATP World Tour Masters 1000,CLAY,2,Gilles Simon,N/A Bye,Gilles Simon,,R64,0,0,0,0,0,0,0,0,0,0,0,0,0,0,0,0,0,0,0,0,0,0,0,0,0,0,0
2009-04-12 00:00:00.000,ATP World Tour Masters 1000 Monte Carlo Monaco ATP World Tour Masters 1000,CLAY,2,Andreas Beck,Nicolas Kiefer,Andreas Beck,1-6; 7-6(1); 6-4,R64,149,8,1,60,96,45,60,15,36,7,10,14,60,96,11,11,53,109,40,53,28,56,10,12,15,68,109
2009-04-12 00:00:00.000,ATP World Tour Masters 1000 Monte Carlo Monaco ATP World Tour Masters 1000,CLAY,2,Juan Monaco,Jeremy Chardy,Juan Monaco,6-2; 7-5,R64,100,1,6,34,64,25,34,18,30,3,4,10,43,64,6,3,46,85,28,46,17,39,9,13,10,45,85
2009-04-12 00:00:00.000,ATP World Tour Masters 1000 Monte Carlo Monaco ATP World Tour Masters 1000,CLAY,2,Tommy Robredo,Rainer Schuettler,Tommy Robredo,6-1; 6-4,R64,71,0,4,30,47,24,30,8,17,2,3,8,32,47,1,3,35,58,18,35,10,23,5,10,9,28,58
2009-04-12 00:00:00.000,ATP World Tour Masters 1000 Monte Carlo Monaco ATP World Tour Masters 1000,CLAY,2,Stanislas Wawrinka,Viktor Troicki,Stanislas Wawrinka,6-2; 6-3,R64,65,0,1,25,44,19,25,12,19,1,3,9,31,44,4,3,20,51,11,20,11,31,3,8,8,22,51
2009-04-12 00:00:00.000,ATP World Tour Masters 1000 Monte Carlo Monaco ATP World Tour Masters 1000,CLAY,2,Martin Vassallo Arguello,Igor Andreev,Martin Vassallo Arguello,2-6; 7-6(5); 6-2,R64,142,2,5,63,93,41,63,14,30,2,6,14,55,93,3,3,63,100,36,63,22,37,3,7,14,58,100
2009-04-12 00:00:00.000,ATP World Tour Masters 1000 Monte Carlo Monaco ATP World Tour Masters 1000,CLAY,2,Andreas Seppi,Jurgen Melzer,Andreas Seppi,6-2; 6-0,R64,63,4,2,27,40,20,27,9,13,0,0,7,29,40,4,2,24,57,11,24,14,33,7,12,7,25,57
2009-04-12 00:00:00.000,ATP World Tour Masters 1000 Monte Carlo Monaco ATP World Tour Masters 1000,CLAY,2,Roger Federer,N/A Bye,Roger Federer,,R64,0,0,0,0,0,0,0,0,0,0,0,0,0,0,0,0,0,0,0,0,0,0,0,0,0,0,0
2009-04-12 00:00:00.000,ATP World Tour Masters 1000 Monte Carlo Monaco ATP World Tour Masters 1000,CLAY,2,Rafael Nadal,Juan Ignacio Chela,Rafael Nadal,6-2; 6-3,R32,86,2,3,31,55,22,31,13,24,5,7,9,35,55,0,5,23,47,13,23,10,24,4,9,8,23,47
2009-04-12 00:00:00.000,ATP World Tour Masters 1000 Monte Carlo Monaco ATP World Tour Masters 1000,CLAY,2,Nicolas Lapentti,Marat Safin,Nicolas Lapentti,7-6(6); 2-6; 7-6(6),R32,209,3,3,77,129,51,77,23,52,13,19,16,74,129,9,4,59,114,44,59,22,55,6,10,16,66,114
2009-04-12 00:00:00.000,ATP World Tour Masters 1000 Monte Carlo Monaco ATP World Tour Masters 1000,CLAY,2,Simone Bolelli,Janko Tipsarevic,Simone Bolelli,7-5; 6-3,R32,102,4,0,40,65,31,40,15,25,4,4,11,46,65,8,3,31,66,23,31,16,35,5,7,10,39,66
2009-04-12 00:00:00.000,ATP World Tour Masters 1000 Monte Carlo Monaco ATP World Tour Masters 1000,CLAY,2,Ivan Ljubicic,Juan Martin Del Potro,Ivan Ljubicic,4-6; 6-1; 6-4,R32,147,14,1,55,93,44,55,14,38,7,10,14,58,93,6,6,47,100,28,47,26,53,8,13,13,54,100
2009-04-12 00:00:00.000,ATP World Tour Masters 1000 Monte Carlo Monaco ATP World Tour Masters 1000,CLAY,2,Andy Murray,Victor Hanescu,Andy Murray,6-3; 6-2,R32,86,2,1,38,62,28,38,10,24,4,6,9,38,62,1,2,32,52,16,32,7,20,5,10,8,23,52
2009-04-12 00:00:00.000,ATP World Tour Masters 1000 Monte Carlo Monaco ATP World Tour Masters 1000,CLAY,2,Fabio Fognini,Marin Cilic,Fabio Fognini,6-2; 6-0,R32,67,1,5,17,43,15,17,13,26,2,3,7,28,43,0,2,29,53,11,29,9,24,7,13,7,20,53
2009-04-12 00:00:00.000,ATP World Tour Masters 1000 Monte Carlo Monaco ATP World Tour Masters 1000,CLAY,2,David Nalbandian,Marcel Granollers,David Nalbandian,4-6; 6-3; 6-1,R32,128,1,3,41,78,26,41,20,37,3,7,13,46,78,1,3,50,99,28,50,18,49,13,20,13,46,99
2009-04-12 00:00:00.000,ATP World Tour Masters 1000 Monte Carlo Monaco ATP World Tour Masters 1000,CLAY,2,Nikolay Davydenko,Ivo Karlovic,Nikolay Davydenko,6-4; 6-3,R32,82,0,4,36,53,25,36,12,17,7,8,9,37,53,8,3,38,63,27,38,9,25,12,16,10,36,63
2009-04-12 00:00:00.000,ATP World Tour Masters 1000 Monte Carlo Monaco ATP World Tour Masters 1000,CLAY,2,Fernando Verdasco,Philipp Kohlschreiber,Fernando Verdasco,6-3; 6-4,R32,83,0,5,44,63,34,44,11,19,2,2,10,45,63,2,1,34,49,22,34,10,15,1,3,9,32,49
2009-04-12 00:00:00.000,ATP World Tour Masters 1000 Monte Carlo Monaco ATP World Tour Masters 1000,CLAY,2,David Ferrer,Marc Gicquel,David Ferrer,6-1; 6-0,R32,49,1,1,18,37,14,18,14,19,0,0,7,28,37,1,4,18,32,6,18,4,14,2,7,6,10,32
2009-04-12 00:00:00.000,ATP World Tour Masters 1000 Monte Carlo Monaco ATP World Tour Masters 1000,CLAY,2,Albert Montanes,Jean-Rene Lisnard,Albert Montanes,6-2; 6-4,R32,81,1,4,26,48,20,26,11,22,0,2,9,31,48,2,3,28,64,24,28,8,36,8,13,9,32,64
2009-04-12 00:00:00.000,ATP World Tour Masters 1000 Monte Carlo Monaco ATP World Tour Masters 1000,CLAY,2,Novak Djokovic,Oscar Hernandez,Novak Djokovic,6-1; 6-2,R32,79,1,1,26,43,21,26,9,17,1,2,8,30,43,0,2,37,59,20,37,7,22,9,14,7,27,59
2009-04-12 00:00:00.000,ATP World Tour Masters 1000 Monte Carlo Monaco ATP World Tour Masters 1000,CLAY,2,Andreas Beck,Gilles Simon,Andreas Beck,7-5; 6-1,R32,81,0,7,26,55,18,26,16,29,3,5,9,34,55,2,5,23,64,14,23,16,41,4,10,10,30,64
2009-04-12 00:00:00.000,ATP World Tour Masters 1000 Monte Carlo Monaco ATP World Tour Masters 1000,CLAY,2,Juan Monaco,Tommy Robredo,Juan Monaco,6-2; 6-4,R32,86,1,1,49,61,31,49,5,12,4,6,9,36,61,1,4,25,50,10,25,16,25,1,6,9,26,50
2009-04-12 00:00:00.000,ATP World Tour Masters 1000 Monte Carlo Monaco ATP World Tour Masters 1000,CLAY,2,Stanislas Wawrinka,Martin Vassallo Arguello,Stanislas Wawrinka,2-6; 7-5; 6-2,R32,158,0,1,54,92,37,54,18,38,5,9,14,55,92,1,6,48,84,29,48,18,36,5,10,14,47,84
2009-04-12 00:00:00.000,ATP World Tour Masters 1000 Monte Carlo Monaco ATP World Tour Masters 1000,CLAY,2,Roger Federer,Andreas Seppi,Roger Federer,6-4; 6-4,R32,83,4,0,30,64,26,30,20,34,3,3,10,46,64,1,4,35,65,24,35,17,30,3,5,10,41,65
2009-04-12 00:00:00.000,ATP World Tour Masters 1000 Monte Carlo Monaco ATP World Tour Masters 1000,CLAY,2,Rafael Nadal,Nicolas Lapentti,Rafael Nadal,6-3; 6-0,R16,92,1,1,30,43,18,30,6,13,2,4,7,24,43,1,2,38,63,21,38,3,25,7,14,8,24,63
2009-04-12 00:00:00.000,ATP World Tour Masters 1000 Monte Carlo Monaco ATP World Tour Masters 1000,CLAY,2,Ivan Ljubicic,Simone Bolelli,Ivan Ljubicic,7-5; 7-6(2),R16,118,14,0,47,85,37,47,20,38,5,6,12,57,85,2,3,47,73,33,47,15,26,4,6,12,48,73
2009-04-12 00:00:00.000,ATP World Tour Masters 1000 Monte Carlo Monaco ATP World Tour Masters 1000,CLAY,2,Andy Murray,Fabio Fognini,Andy Murray,7-6(11); 6-4,R16,122,3,1,58,83,36,58,14,25,6,9,11,50,83,1,4,56,85,31,56,15,29,8,12,11,46,85
2009-04-12 00:00:00.000,ATP World Tour Masters 1000 Monte Carlo Monaco ATP World Tour Masters 1000,CLAY,2,Nikolay Davydenko,David Nalbandian,Nikolay Davydenko,6-4; 5-7; 6-3,R16,152,1,5,64,95,38,64,15,31,8,14,16,53,95,5,6,55,110,35,55,21,55,12,19,15,56,110
2009-04-12 00:00:00.000,ATP World Tour Masters 1000 Monte Carlo Monaco ATP World Tour Masters 1000,CLAY,2,Fernando Verdasco,David Ferrer,Fernando Verdasco,6-2; 6-1,R16,62,0,3,31,39,23,31,2,8,0,1,7,25,39,0,0,23,49,12,23,8,26,4,10,8,20,49
2009-04-12 00:00:00.000,ATP World Tour Masters 1000 Monte Carlo Monaco ATP World Tour Masters 1000,CLAY,2,Novak Djokovic,Albert Montanes,Novak Djokovic,6-1; 6-7(4); 6-0,R16,105,5,1,53,77,40,53,8,24,0,2,13,48,77,4,5,52,86,31,52,10,34,10,17,12,41,86
2009-04-12 00:00:00.000,ATP World Tour Masters 1000 Monte Carlo Monaco ATP World Tour Masters 1000,CLAY,2,Andreas Beck,Juan Monaco,Andreas Beck,3-6; 6-2; 7-5,R16,127,2,4,57,98,38,57,19,41,4,9,15,57,98,3,4,59,82,37,59,8,23,3,9,14,45,82
2009-04-12 00:00:00.000,ATP World Tour Masters 1000 Monte Carlo Monaco ATP World Tour Masters 1000,CLAY,2,Stanislas Wawrinka,Roger Federer,Stanislas Wawrinka,6-4; 7-5,R16,110,0,1,48,77,33,48,17,29,3,4,11,50,77,2,1,44,85,29,44,21,41,11,14,11,50,85
2009-04-12 00:00:00.000,ATP World Tour Masters 1000 Monte Carlo Monaco ATP World Tour Masters 1000,CLAY,2,Rafael Nadal,Ivan Ljubicic,Rafael Nadal,6-3; 6-3,Q,73,2,1,37,52,29,37,7,15,0,1,9,36,52,4,0,22,43,17,22,8,21,2,6,9,25,43
2009-04-12 00:00:00.000,ATP World Tour Masters 1000 Monte Carlo Monaco ATP World Tour Masters 1000,CLAY,2,Andy Murray,Nikolay Davydenko,Andy Murray,7-6(1); 6-4,Q,129,4,2,43,84,29,43,20,41,6,9,11,49,84,0,1,68,86,37,68,9,18,5,9,11,46,86
2009-04-12 00:00:00.000,ATP World Tour Masters 1000 Monte Carlo Monaco ATP World Tour Masters 1000,CLAY,2,Novak Djokovic,Fernando Verdasco,Novak Djokovic,6-2; 4-6; 6-3,Q,138,4,5,54,87,42,54,17,33,4,6,14,59,87,2,5,56,82,34,56,14,26,6,10,13,48,82
2009-04-12 00:00:00.000,ATP World Tour Masters 1000 Monte Carlo Monaco ATP World Tour Masters 1000,CLAY,2,Stanislas Wawrinka,Andreas Beck,Stanislas Wawrinka,6-2; 6-4,Q,89,6,4,33,51,27,33,9,18,3,4,9,36,51,2,3,39,70,26,39,10,31,7,11,9,36,70
2009-04-12 00:00:00.000,ATP World Tour Masters 1000 Monte Carlo Monaco ATP World Tour Masters 1000,CLAY,2,Rafael Nadal,Andy Murray,Rafael Nadal,6-2; 7-6(4),S,129,0,1,40,65,27,40,14,25,2,4,10,41,65,1,0,37,74,24,37,14,37,5,9,10,38,74
2009-04-12 00:00:00.000,ATP World Tour Masters 1000 Monte Carlo Monaco ATP World Tour Masters 1000,CLAY,2,Novak Djokovic,Stanislas Wawrinka,Novak Djokovic,4-6; 6-1; 6-3,S,147,1,4,46,81,35,46,17,35,4,6,13,52,81,1,3,60,97,36,60,16,37,9,14,13,52,97
2009-04-12 00:00:00.000,ATP World Tour Masters 1000 Monte Carlo Monaco ATP World Tour Masters 1000,CLAY,2,Rafael Nadal,Novak Djokovic,Rafael Nadal,6-3; 2-6; 6-1,F,163,2,1,57,87,35,57,14,30,6,11,12,49,87,4,3,54,87,30,54,11,33,7,14,12,41,87
2009-04-20 00:00:00.000,Barcelona Spain ATP World Tour 500,CLAY,2,Rafael Nadal,N/A Bye,Rafael Nadal,,R64,0,0,0,0,0,0,0,0,0,0,0,0,0,0,0,0,0,0,0,0,0,0,0,0,0,0,0
2009-04-20 00:00:00.000,Barcelona Spain ATP World Tour 500,CLAY,2,Frederico Gil,Yen-Hsun Lu,Frederico Gil,6-2; 6-1,R64,62,0,2,25,42,20,25,12,17,0,0,8,32,42,2,1,27,42,15,27,6,15,0,4,7,21,42
2009-04-20 00:00:00.000,Barcelona Spain ATP World Tour 500,CLAY,2,Christophe Rochus,Nicolas Devilder,Christophe Rochus,6-4; 6-4,R64,94,4,0,38,72,28,38,18,34,5,6,10,46,72,6,2,38,65,23,38,15,27,9,12,10,38,65
2009-04-20 00:00:00.000,Barcelona Spain ATP World Tour 500,CLAY,2,Richard Gasquet,Jan Hernych,Richard Gasquet,4-6; 6-3; 6-2,R64,110,7,3,51,80,37,51,17,29,1,3,14,54,80,6,2,47,72,30,47,14,25,3,7,13,44,72
2009-04-20 00:00:00.000,Barcelona Spain ATP World Tour 500,CLAY,2,Nicolas Almagro,Victor Hanescu,Nicolas Almagro,3-6; 7-6(7); 2-2 RET,R64,122,8,3,46,78,37,46,16,32,4,5,12,53,78,5,1,67,95,46,67,16,28,6,6,13,62,95
2009-04-20 00:00:00.000,Barcelona Spain ATP World Tour 500,CLAY,2,Juan Ignacio Chela,Thomaz Bellucci,Juan Ignacio Chela,6-2; 3-6; 6-4,R64,126,2,2,53,78,40,53,13,25,4,6,13,53,78,3,0,49,77,30,49,17,28,1,5,14,47,77
2009-04-20 00:00:00.000,Barcelona Spain ATP World Tour 500,CLAY,2,Igor Kunitsyn,Juan Carlos Ferrero,Igor Kunitsyn,7-5; 7-6(3),R64,115,4,0,72,83,42,72,7,11,5,8,12,49,83,2,1,66,89,39,66,9,23,8,12,12,48,89
2009-04-20 00:00:00.000,Barcelona Spain ATP World Tour 500,CLAY,2,David Nalbandian,N/A Bye,David Nalbandian,,R64,0,0,0,0,0,0,0,0,0,0,0,0,0,0,0,0,0,0,0,0,0,0,0,0,0,0,0
2009-04-20 00:00:00.000,Barcelona Spain ATP World Tour 500,CLAY,2,Nikolay Davydenko,N/A Bye,Nikolay Davydenko,,R64,0,0,0,0,0,0,0,0,0,0,0,0,0,0,0,0,0,0,0,0,0,0,0,0,0,0,0
2009-04-20 00:00:00.000,Barcelona Spain ATP World Tour 500,CLAY,2,Arnaud Clement,Guillermo Canas,Arnaud Clement,7-6(0); 6-3,R64,113,5,1,44,60,36,44,6,16,2,4,10,42,60,2,2,41,76,24,41,16,35,6,10,11,40,76
2009-04-20 00:00:00.000,Barcelona Spain ATP World Tour 500,CLAY,2,Santiago Ventura,Marcel Granollers,Santiago Ventura,7-6(3); 6-3,R64,116,5,0,38,76,29,38,22,38,5,7,11,51,76,4,2,50,80,33,50,13,30,7,10,10,46,80
2009-04-20 00:00:00.000,Barcelona Spain ATP World Tour 500,CLAY,2,Feliciano Lopez,Jarkko Nieminen,Feliciano Lopez,6-2; 6-1,R64,52,8,3,23,40,19,23,11,17,2,2,7,30,40,3,2,28,44,15,28,5,16,1,6,8,20,44
2009-04-20 00:00:00.000,Barcelona Spain ATP World Tour 500,CLAY,2,Radek Stepanek,Guillermo Garcia-Lopez,Radek Stepanek,6-4; 2-6; 6-4,R64,125,3,4,66,94,48,66,15,28,11,13,14,63,94,2,5,56,91,36,56,21,35,7,9,14,57,91
2009-04-20 00:00:00.000,Barcelona Spain ATP World Tour 500,CLAY,2,Janko Tipsarevic,Albert Montanes,Janko Tipsarevic,6-4; 7-6(1),R64,123,7,1,48,84,35,48,18,36,7,9,11,53,84,3,2,44,76,29,44,14,32,6,9,11,43,76
2009-04-20 00:00:00.000,Barcelona Spain ATP World Tour 500,CLAY,2,Mikhail Youzhny,Viktor Troicki,Mikhail Youzhny,6-7(5); 7-6(6); 6-3,R64,164,1,1,90,121,61,90,13,31,3,7,17,74,121,13,2,78,121,53,78,20,43,9,14,16,73,121
2009-04-20 00:00:00.000,Barcelona Spain ATP World Tour 500,CLAY,2,Stanislas Wawrinka,N/A Bye,Stanislas Wawrinka,,R64,0,0,0,0,0,0,0,0,0,0,0,0,0,0,0,0,0,0,0,0,0,0,0,0,0,0,0
2009-04-20 00:00:00.000,Barcelona Spain ATP World Tour 500,CLAY,2,Tommy Robredo,N/A Bye,Tommy Robredo,,R64,0,0,0,0,0,0,0,0,0,0,0,0,0,0,0,0,0,0,0,0,0,0,0,0,0,0,0
2009-04-20 00:00:00.000,Barcelona Spain ATP World Tour 500,CLAY,2,Gaston Gaudio,Diego Junqueira,Gaston Gaudio,6-4; 3-6; 6-4,R64,134,5,2,62,100,36,62,20,38,6,11,14,56,100,3,3,50,83,31,50,15,33,1,7,15,46,83
2009-04-20 00:00:00.000,Barcelona Spain ATP World Tour 500,CLAY,2,Alberto Martin,Marc Gicquel,Alberto Martin,6-3; 6-4,R64,83,4,3,37,60,26,37,12,23,5,8,10,38,60,1,0,48,70,25,48,8,22,8,13,9,33,70
2009-04-20 00:00:00.000,Barcelona Spain ATP World Tour 500,CLAY,2,Igor Andreev,Andreas Seppi,Igor Andreev,6-3; 3-6; 7-5,R64,131,9,5,56,98,35,56,22,42,5,9,15,57,98,4,1,63,87,41,63,11,24,3,8,15,52,87
2009-04-20 00:00:00.000,Barcelona Spain ATP World Tour 500,CLAY,2,Robin Soderling,Teymuraz Gabashvili,Robin Soderling,6-1; 6-4,R64,61,7,2,33,50,25,33,11,17,1,2,9,36,50,3,2,27,47,15,27,9,20,4,8,8,24,47
2009-04-20 00:00:00.000,Barcelona Spain ATP World Tour 500,CLAY,2,Potito Starace,Ernests Gulbis,Potito Starace,4-6; 6-3; 6-3,R64,105,1,1,51,74,34,51,17,23,5,8,14,51,74,1,4,59,91,36,59,15,32,4,9,14,51,91
2009-04-20 00:00:00.000,Barcelona Spain ATP World Tour 500,CLAY,2,Mikhail Kukushkin,Pere Riba,Mikhail Kukushkin,6-2; 7-6(5),R64,94,5,1,47,74,33,47,14,27,5,6,10,47,74,6,1,29,59,24,29,13,30,1,4,10,37,59
2009-04-20 00:00:00.000,Barcelona Spain ATP World Tour 500,CLAY,2,David Ferrer,N/A Bye,David Ferrer,,R64,0,0,0,0,0,0,0,0,0,0,0,0,0,0,0,0,0,0,0,0,0,0,0,0,0,0,0
2009-04-20 00:00:00.000,Barcelona Spain ATP World Tour 500,CLAY,2,Fernando Gonzalez,N/A Bye,Fernando Gonzalez,,R64,0,0,0,0,0,0,0,0,0,0,0,0,0,0,0,0,0,0,0,0,0,0,0,0,0,0,0
2009-04-20 00:00:00.000,Barcelona Spain ATP World Tour 500,CLAY,2,Jose Acasuso,Dudi Sela,Jose Acasuso,6-4; 7-5,R64,98,4,2,39,70,26,39,19,31,3,5,11,45,70,0,1,42,67,27,42,11,25,2,6,11,38,67
2009-04-20 00:00:00.000,Barcelona Spain ATP World Tour 500,CLAY,2,Daniel Gimeno-Traver,Fabio Fognini,Daniel Gimeno-Traver,6-1; 6-3,R64,65,3,0,33,50,21,33,10,17,1,3,8,31,50,2,3,33,47,12,33,5,14,3,9,8,17,47
2009-04-20 00:00:00.000,Barcelona Spain ATP World Tour 500,CLAY,2,Juan Monaco,Marat Safin,Juan Monaco,6-4; 6-1,R64,66,2,1,41,52,33,41,6,11,2,2,9,39,52,1,0,20,45,12,20,15,25,2,5,8,27,45
2009-04-20 00:00:00.000,Barcelona Spain ATP World Tour 500,CLAY,2,Tomas Berdych,Martin Vassallo Arguello,Tomas Berdych,5-2 RET,R64,40,1,1,18,24,13,18,4,6,1,1,4,17,24,0,1,15,22,10,15,2,7,1,2,3,12,22
2009-04-20 00:00:00.000,Barcelona Spain ATP World Tour 500,CLAY,2,Oscar Hernandez,Eduardo Schwank,Oscar Hernandez,6-2; 6-4,R64,78,5,0,34,49,22,34,11,15,0,2,9,33,49,1,3,33,54,17,33,8,21,6,11,9,25,54
2009-04-20 00:00:00.000,Barcelona Spain ATP World Tour 500,CLAY,2,Nicolas Lapentti,Paul-Henri Mathieu,Nicolas Lapentti,6-4; 2-6; 6-2,R64,124,6,0,50,76,35,50,17,26,5,7,13,52,76,2,1,50,80,33,50,15,30,4,7,13,48,80
2009-04-20 00:00:00.000,Barcelona Spain ATP World Tour 500,CLAY,2,Fernando Verdasco,N/A Bye,Fernando Verdasco,,R64,0,0,0,0,0,0,0,0,0,0,0,0,0,0,0,0,0,0,0,0,0,0,0,0,0,0,0
2009-04-20 00:00:00.000,Barcelona Spain ATP World Tour 500,CLAY,2,Rafael Nadal,Frederico Gil,Rafael Nadal,6-2; 6-2,R32,90,1,0,34,51,23,34,12,17,3,3,8,35,51,3,3,38,57,20,38,10,19,3,7,8,30,57
2009-04-20 00:00:00.000,Barcelona Spain ATP World Tour 500,CLAY,2,Christophe Rochus,Richard Gasquet,Christophe Rochus,6-1; 6-7(2); 6-3,R32,137,6,1,73,113,53,73,18,40,7,9,15,71,113,14,3,46,85,31,46,18,39,2,7,13,49,85
2009-04-20 00:00:00.000,Barcelona Spain ATP World Tour 500,CLAY,2,Nicolas Almagro,Juan Ignacio Chela,Nicolas Almagro,3-6; 7-6(4); 6-3,R32,144,11,0,56,96,39,56,19,40,5,11,16,58,96,2,4,66,107,38,66,22,41,7,12,14,60,107
2009-04-20 00:00:00.000,Barcelona Spain ATP World Tour 500,CLAY,2,David Nalbandian,Igor Kunitsyn,David Nalbandian,7-5; 6-4,R32,87,1,4,30,62,21,30,13,32,2,6,11,34,62,1,1,53,64,26,53,5,11,6,12,11,31,64
2009-04-20 00:00:00.000,Barcelona Spain ATP World Tour 500,CLAY,2,Nikolay Davydenko,Arnaud Clement,Nikolay Davydenko,7-6(2); 6-2,R32,117,5,1,50,68,40,50,9,18,2,2,10,49,68,1,3,44,85,24,44,24,41,9,11,10,48,85
2009-04-20 00:00:00.000,Barcelona Spain ATP World Tour 500,CLAY,2,Feliciano Lopez,Santiago Ventura,Feliciano Lopez,2-6; 6-4; 6-3,R32,117,3,0,57,95,38,57,21,38,6,9,14,59,95,4,3,42,73,28,42,18,31,6,9,13,46,73
2009-04-20 00:00:00.000,Barcelona Spain ATP World Tour 500,CLAY,2,Radek Stepanek,Janko Tipsarevic,Radek Stepanek,7-6(2); 6-0,R32,94,4,1,30,53,24,30,15,23,2,3,9,39,53,5,1,26,64,17,26,15,38,4,8,9,32,64
2009-04-20 00:00:00.000,Barcelona Spain ATP World Tour 500,CLAY,2,Stanislas Wawrinka,Mikhail Youzhny,Stanislas Wawrinka,7-5; 6-1,R32,88,6,1,45,71,31,45,16,26,9,10,10,47,71,2,1,30,57,21,30,9,27,3,7,9,30,57
2009-04-20 00:00:00.000,Barcelona Spain ATP World Tour 500,CLAY,2,Tommy Robredo,Gaston Gaudio,Tommy Robredo,7-6(6); 6-1,R32,91,2,2,37,65,27,37,13,28,4,6,10,40,65,0,3,43,68,25,43,10,25,4,8,9,35,68
2009-04-20 00:00:00.000,Barcelona Spain ATP World Tour 500,CLAY,2,Igor Andreev,Alberto Martin,Igor Andreev,6-2; 6-2,R32,63,1,0,28,41,24,28,9,13,1,1,8,33,41,0,5,26,54,14,26,14,28,3,7,8,28,54
2009-04-20 00:00:00.000,Barcelona Spain ATP World Tour 500,CLAY,2,Potito Starace,Robin Soderling,Potito Starace,7-6(5); 2-6; 6-2,R32,123,5,0,73,99,52,73,11,26,8,11,14,63,99,5,4,44,90,31,44,26,46,4,7,14,57,90
2009-04-20 00:00:00.000,Barcelona Spain ATP World Tour 500,CLAY,2,David Ferrer,Mikhail Kukushkin,David Ferrer,6-3; 3-6; 6-1,R32,120,2,0,56,82,37,56,15,26,6,8,13,52,82,1,1,42,76,23,42,21,34,3,7,12,44,76
2009-04-20 00:00:00.000,Barcelona Spain ATP World Tour 500,CLAY,2,Fernando Gonzalez,Jose Acasuso,Fernando Gonzalez,6-4; 6-4,R32,72,3,2,39,56,32,39,10,17,4,4,10,42,56,1,0,39,59,25,39,11,20,3,5,10,36,59
2009-04-20 00:00:00.000,Barcelona Spain ATP World Tour 500,CLAY,2,Juan Monaco,Daniel Gimeno-Traver,Juan Monaco,7-5; 6-4,R32,85,1,0,50,65,33,50,8,15,5,7,11,41,65,1,1,40,58,23,40,10,18,1,5,11,33,58
2009-04-20 00:00:00.000,Barcelona Spain ATP World Tour 500,CLAY,2,Tomas Berdych,Oscar Hernandez,Tomas Berdych,6-2; 4-6; 6-3,R32,122,8,1,48,89,35,48,20,41,5,8,14,55,89,0,4,54,75,35,54,8,21,1,6,13,43,75
2009-04-20 00:00:00.000,Barcelona Spain ATP World Tour 500,CLAY,2,Fernando Verdasco,Nicolas Lapentti,Fernando Verdasco,7-5; 6-3,R32,99,1,3,53,69,35,53,8,16,4,6,11,43,69,3,2,35,61,21,35,12,26,1,5,10,33,61
2009-04-20 00:00:00.000,Barcelona Spain ATP World Tour 500,CLAY,2,Rafael Nadal,Christophe Rochus,Rafael Nadal,6-2; 6-0,R16,56,3,1,31,40,21,31,8,9,0,0,7,29,40,0,3,22,42,12,22,6,20,2,7,7,18,42
2009-04-20 00:00:00.000,Barcelona Spain ATP World Tour 500,CLAY,2,David Nalbandian,Nicolas Almagro,David Nalbandian,6-3; 6-4,R16,64,3,1,32,57,25,32,13,25,3,5,10,38,57,8,2,29,47,18,29,8,18,0,4,9,26,47
2009-04-20 00:00:00.000,Barcelona Spain ATP World Tour 500,CLAY,2,Nikolay Davydenko,Feliciano Lopez,Nikolay Davydenko,7-6(8); 3-6; 6-4,R16,162,4,1,76,109,56,76,20,33,7,9,16,76,109,6,5,61,112,45,61,29,51,8,9,15,74,112
2009-04-20 00:00:00.000,Barcelona Spain ATP World Tour 500,CLAY,2,Radek Stepanek,Stanislas Wawrinka,Radek Stepanek,6-4; 1-6; 7-5,R16,139,2,4,61,97,38,61,16,36,7,11,14,54,97,5,0,74,96,47,74,9,22,5,9,15,56,96
2009-04-20 00:00:00.000,Barcelona Spain ATP World Tour 500,CLAY,2,Tommy Robredo,Igor Andreev,Tommy Robredo,4-6; 6-2; 6-3,R16,122,2,4,53,92,40,53,21,39,5,6,14,61,92,0,6,49,76,36,49,12,27,3,6,13,48,76
2009-04-20 00:00:00.000,Barcelona Spain ATP World Tour 500,CLAY,2,David Ferrer,Potito Starace,David Ferrer,4-6; 7-5; 6-2,R16,132,4,2,62,98,40,62,23,36,6,9,15,63,98,3,0,66,88,42,66,9,22,7,12,15,51,88
2009-04-20 00:00:00.000,Barcelona Spain ATP World Tour 500,CLAY,2,Fernando Gonzalez,Juan Monaco,Fernando Gonzalez,7-6(6); 6-3,R16,87,8,1,44,71,33,44,16,27,1,2,11,49,71,0,2,44,59,31,44,5,15,1,3,10,36,59
2009-04-20 00:00:00.000,Barcelona Spain ATP World Tour 500,CLAY,2,Fernando Verdasco,Tomas Berdych,Fernando Verdasco,7-5; 5-7; 6-4,R16,137,3,1,76,91,51,76,13,15,6,9,17,64,91,7,2,65,102,47,65,19,37,9,13,17,66,102
2009-04-20 00:00:00.000,Barcelona Spain ATP World Tour 500,CLAY,2,Rafael Nadal,David Nalbandian,Rafael Nadal,W/O,Q,0,0,0,0,0,0,0,0,0,0,0,0,0,0,0,0,0,0,0,0,0,0,0,0,0,0,0
2009-04-20 00:00:00.000,Barcelona Spain ATP World Tour 500,CLAY,2,Nikolay Davydenko,Radek Stepanek,Nikolay Davydenko,6-7(4); 6-2; 6-2,Q,138,5,2,63,93,47,63,15,30,4,5,14,62,93,7,5,60,98,42,60,14,38,11,16,14,56,98
2009-04-20 00:00:00.000,Barcelona Spain ATP World Tour 500,CLAY,2,David Ferrer,Tommy Robredo,David Ferrer,6-3; 6-4,Q,82,3,2,40,61,31,40,12,21,2,2,10,43,61,2,2,30,56,20,30,15,26,1,3,9,35,56
2009-04-20 00:00:00.000,Barcelona Spain ATP World Tour 500,CLAY,2,Fernando Gonzalez,Fernando Verdasco,Fernando Gonzalez,6-3; 4-6; 6-4,Q,137,7,1,67,106,51,67,15,39,4,7,15,66,106,0,1,65,88,41,65,13,23,6,10,14,54,88
2009-04-20 00:00:00.000,Barcelona Spain ATP World Tour 500,CLAY,2,Rafael Nadal,Nikolay Davydenko,Rafael Nadal,6-3; 6-2,S,106,1,2,45,67,33,45,10,22,6,6,8,43,67,3,1,51,61,28,51,5,10,5,9,9,33,61
2009-04-20 00:00:00.000,Barcelona Spain ATP World Tour 500,CLAY,2,David Ferrer,Fernando Gonzalez,David Ferrer,2-6; 6-2; 7-6(5),S,133,1,2,67,94,45,67,15,27,5,8,14,60,94,3,1,66,94,44,66,15,28,2,5,14,59,94
2009-04-20 00:00:00.000,Barcelona Spain ATP World Tour 500,CLAY,2,Rafael Nadal,David Ferrer,Rafael Nadal,6-2; 7-5,F,106,1,1,38,65,24,38,15,27,4,7,10,39,65,1,4,33,60,16,33,12,27,7,13,10,28,60
2009-04-27 00:00:00.000,ATP World Tour Masters 1000 Rome Italy ATP World Tour Masters 1000,CLAY,2,Rafael Nadal,N/A Bye,Rafael Nadal,,R64,0,0,0,0,0,0,0,0,0,0,0,0,0,0,0,0,0,0,0,0,0,0,0,0,0,0,0
2009-04-27 00:00:00.000,ATP World Tour Masters 1000 Rome Italy ATP World Tour Masters 1000,CLAY,2,Andreas Seppi,Sam Querrey,Andreas Seppi,3-6; 6-4; 6-3,R64,124,4,3,42,81,28,42,18,39,0,5,14,46,81,10,4,60,108,38,60,18,48,6,12,14,56,108
2009-04-27 00:00:00.000,ATP World Tour Masters 1000 Rome Italy ATP World Tour Masters 1000,CLAY,2,Robin Soderling,Marcel Granollers,Robin Soderling,6-3; 6-0,R64,62,3,0,29,45,21,29,11,16,1,2,8,32,45,3,2,32,50,15,32,6,18,5,10,7,21,50
2009-04-27 00:00:00.000,ATP World Tour Masters 1000 Rome Italy ATP World Tour Masters 1000,CLAY,2,Victor Crivoi,James Blake,Victor Crivoi,7-5; 6-3,R64,73,4,1,40,64,28,40,12,24,1,4,11,40,64,7,2,29,60,19,29,11,31,5,10,10,30,60
2009-04-27 00:00:00.000,ATP World Tour Masters 1000 Rome Italy ATP World Tour Masters 1000,CLAY,2,Richard Gasquet,Jo-Wilfried Tsonga,Richard Gasquet,7-6(2); 6-4,R64,109,2,2,46,78,35,46,21,32,7,7,11,56,78,2,2,44,70,29,44,17,26,3,4,11,46,70
2009-04-27 00:00:00.000,ATP World Tour Masters 1000 Rome Italy ATP World Tour Masters 1000,CLAY,2,Ernests Gulbis,Nicolas Almagro,Ernests Gulbis,3-6; 7-6(5); 6-2,R64,129,11,5,62,108,42,62,26,46,9,11,14,68,108,13,1,62,110,45,62,20,48,6,9,15,65,110
2009-04-27 00:00:00.000,ATP World Tour Masters 1000 Rome Italy ATP World Tour Masters 1000,CLAY,2,Mardy Fish,Igor Andreev,Mardy Fish,6-3; 4-6; 7-6(2),R64,142,8,2,57,103,42,57,25,46,7,9,15,67,103,8,5,64,97,46,64,16,33,5,8,16,62,97
2009-04-27 00:00:00.000,ATP World Tour Masters 1000 Rome Italy ATP World Tour Masters 1000,CLAY,2,Fernando Verdasco,N/A Bye,Fernando Verdasco,,R64,0,0,0,0,0,0,0,0,0,0,0,0,0,0,0,0,0,0,0,0,0,0,0,0,0,0,0
2009-04-27 00:00:00.000,ATP World Tour Masters 1000 Rome Italy ATP World Tour Masters 1000,CLAY,2,Andy Murray,N/A Bye,Andy Murray,,R64,0,0,0,0,0,0,0,0,0,0,0,0,0,0,0,0,0,0,0,0,0,0,0,0,0,0,0
2009-04-27 00:00:00.000,ATP World Tour Masters 1000 Rome Italy ATP World Tour Masters 1000,CLAY,2,Juan Monaco,Nicolas Kiefer,Juan Monaco,6-2; 6-3,R64,74,2,2,28,46,19,28,12,18,2,3,8,31,46,7,4,31,63,18,31,11,32,4,9,9,29,63
2009-04-27 00:00:00.000,ATP World Tour Masters 1000 Rome Italy ATP World Tour Masters 1000,CLAY,2,Christophe Rochus,Juan Ignacio Chela,Christophe Rochus,6-1; 6-2,R64,60,2,2,22,44,15,22,15,22,1,2,8,30,44,1,6,22,48,13,22,7,26,6,11,7,20,48
2009-04-27 00:00:00.000,ATP World Tour Masters 1000 Rome Italy ATP World Tour Masters 1000,CLAY,2,Marin Cilic,Flavio Cipolla,Marin Cilic,6-2; 6-2,R64,81,5,1,30,52,24,30,13,22,3,3,8,37,52,0,5,35,61,18,35,11,26,6,10,8,29,61
2009-04-27 00:00:00.000,ATP World Tour Masters 1000 Rome Italy ATP World Tour Masters 1000,CLAY,2,Fernando Gonzalez,Jeremy Chardy,Fernando Gonzalez,6-4; 6-1,R64,64,2,2,32,51,23,32,12,19,3,4,9,35,51,1,3,29,53,18,29,10,24,5,9,8,28,53
2009-04-27 00:00:00.000,ATP World Tour Masters 1000 Rome Italy ATP World Tour Masters 1000,CLAY,2,Janko Tipsarevic,Jose Acasuso,Janko Tipsarevic,6-3; 6-4,R64,90,8,2,20,62,16,20,26,42,4,5,10,42,62,6,3,32,60,23,32,11,28,6,9,9,34,60
2009-04-27 00:00:00.000,ATP World Tour Masters 1000 Rome Italy ATP World Tour Masters 1000,CLAY,2,Jurgen Melzer,Julien Benneteau,Jurgen Melzer,3-6; 6-2; 6-3,R64,129,3,2,50,87,32,50,16,37,3,7,13,48,87,2,7,48,79,27,48,11,31,2,8,13,38,79
2009-04-27 00:00:00.000,ATP World Tour Masters 1000 Rome Italy ATP World Tour Masters 1000,CLAY,2,Nikolay Davydenko,N/A Bye,Nikolay Davydenko,,R64,0,0,0,0,0,0,0,0,0,0,0,0,0,0,0,0,0,0,0,0,0,0,0,0,0,0,0
2009-04-27 00:00:00.000,ATP World Tour Masters 1000 Rome Italy ATP World Tour Masters 1000,CLAY,2,Juan Martin Del Potro,N/A Bye,Juan Martin Del Potro,,R64,0,0,0,0,0,0,0,0,0,0,0,0,0,0,0,0,0,0,0,0,0,0,0,0,0,0,0
2009-04-27 00:00:00.000,ATP World Tour Masters 1000 Rome Italy ATP World Tour Masters 1000,CLAY,2,Viktor Troicki,Victor Hanescu,Viktor Troicki,6-3; 6-3,R64,78,6,2,32,61,22,32,16,29,4,6,9,38,61,0,4,22,45,15,22,7,23,2,7,9,22,45
2009-04-27 00:00:00.000,ATP World Tour Masters 1000 Rome Italy ATP World Tour Masters 1000,CLAY,2,Mikhail Youzhny,Daniel Gimeno-Traver,Mikhail Youzhny,7-5; 6-4,R64,139,2,0,55,82,35,55,17,27,1,2,11,52,82,1,2,54,86,32,54,15,32,8,11,11,47,86
2009-04-27 00:00:00.000,ATP World Tour Masters 1000 Rome Italy ATP World Tour Masters 1000,CLAY,2,Stanislas Wawrinka,Igor Kunitsyn,Stanislas Wawrinka,6-3; 6-4,R64,83,5,4,41,68,28,41,16,27,5,6,10,44,68,0,0,54,68,31,54,6,14,7,10,9,37,68
2009-04-27 00:00:00.000,ATP World Tour Masters 1000 Rome Italy ATP World Tour Masters 1000,CLAY,2,Tommy Robredo,Marat Safin,Tommy Robredo,2-6; 7-6(5); 6-2,R64,133,4,1,67,105,42,67,20,38,6,10,14,62,105,8,4,40,80,33,40,17,40,1,5,14,50,80
2009-04-27 00:00:00.000,ATP World Tour Masters 1000 Rome Italy ATP World Tour Masters 1000,CLAY,2,Philipp Kohlschreiber,Simone Bolelli,Philipp Kohlschreiber,4-6; 6-1; 6-0,R64,114,3,2,52,76,34,52,14,24,5,8,12,48,76,0,2,47,76,22,47,13,29,6,13,11,35,76
2009-04-27 00:00:00.000,ATP World Tour Masters 1000 Rome Italy ATP World Tour Masters 1000,CLAY,2,Albert Montanes,Potito Starace,Albert Montanes,7-6(8); 6-4,R64,133,2,3,59,95,44,59,20,36,5,5,11,64,95,2,4,78,96,52,78,8,18,5,6,11,60,96
2009-04-27 00:00:00.000,ATP World Tour Masters 1000 Rome Italy ATP World Tour Masters 1000,CLAY,2,Novak Djokovic,N/A Bye,Novak Djokovic,,R64,0,0,0,0,0,0,0,0,0,0,0,0,0,0,0,0,0,0,0,0,0,0,0,0,0,0,0
2009-04-27 00:00:00.000,ATP World Tour Masters 1000 Rome Italy ATP World Tour Masters 1000,CLAY,2,Gilles Simon,N/A Bye,Gilles Simon,,R64,0,0,0,0,0,0,0,0,0,0,0,0,0,0,0,0,0,0,0,0,0,0,0,0,0,0,0
2009-04-27 00:00:00.000,ATP World Tour Masters 1000 Rome Italy ATP World Tour Masters 1000,CLAY,2,Fabio Fognini,Filippo Volandri,Fabio Fognini,6-7(3); 6-1; 7-6(4),R64,165,3,6,67,117,42,67,23,50,6,11,16,65,117,0,5,91,111,49,91,9,20,12,19,15,58,111
2009-04-27 00:00:00.000,ATP World Tour Masters 1000 Rome Italy ATP World Tour Masters 1000,CLAY,2,Mischa Zverev,Tomas Berdych,Mischa Zverev,4-6; 6-2; 7-5,R64,146,4,3,65,103,50,65,13,38,6,10,15,63,103,1,3,60,98,38,60,16,38,6,12,15,54,98
2009-04-27 00:00:00.000,ATP World Tour Masters 1000 Rome Italy ATP World Tour Masters 1000,CLAY,2,Paul-Henri Mathieu,David Ferrer,Paul-Henri Mathieu,6-3; 2-6; 6-2,R64,145,3,3,48,85,32,48,21,37,5,8,13,53,85,2,5,38,72,27,38,14,34,2,6,12,41,72
2009-04-27 00:00:00.000,ATP World Tour Masters 1000 Rome Italy ATP World Tour Masters 1000,CLAY,2,Radek Stepanek,Florent Serra,Radek Stepanek,7-6(1); 4-6; 7-5,R64,147,5,6,63,103,50,63,19,40,2,5,17,69,103,4,6,74,126,54,74,21,52,11,14,17,75,126
2009-04-27 00:00:00.000,ATP World Tour Masters 1000 Rome Italy ATP World Tour Masters 1000,CLAY,2,Feliciano Lopez,Thomaz Bellucci,Feliciano Lopez,6-4; 6-2,R64,82,5,1,35,56,25,35,11,21,3,4,9,36,56,5,2,37,52,21,37,7,15,3,7,9,28,52
2009-04-27 00:00:00.000,ATP World Tour Masters 1000 Rome Italy ATP World Tour Masters 1000,CLAY,2,Ivo Karlovic,Jan Hernych,Ivo Karlovic,4-6; 6-4; 6-2,R64,119,16,6,42,77,34,42,19,35,1,3,14,53,77,2,3,44,74,30,44,18,30,3,7,14,48,74
2009-04-27 00:00:00.000,ATP World Tour Masters 1000 Rome Italy ATP World Tour Masters 1000,CLAY,2,Roger Federer,N/A Bye,Roger Federer,,R64,0,0,0,0,0,0,0,0,0,0,0,0,0,0,0,0,0,0,0,0,0,0,0,0,0,0,0
2009-04-27 00:00:00.000,ATP World Tour Masters 1000 Rome Italy ATP World Tour Masters 1000,CLAY,2,Rafael Nadal,Andreas Seppi,Rafael Nadal,6-2; 6-3,R32,80,1,0,30,44,24,30,10,14,2,3,9,34,44,2,2,33,50,21,33,5,17,3,7,8,26,50
2009-04-27 00:00:00.000,ATP World Tour Masters 1000 Rome Italy ATP World Tour Masters 1000,CLAY,2,Robin Soderling,Victor Crivoi,Robin Soderling,6-1; 6-7(2); 6-1,R32,104,8,1,44,85,32,44,26,41,11,13,14,58,85,5,0,41,79,25,41,17,38,6,12,12,42,79
2009-04-27 00:00:00.000,ATP World Tour Masters 1000 Rome Italy ATP World Tour Masters 1000,CLAY,2,Richard Gasquet,Ernests Gulbis,Richard Gasquet,6-2; 1-6; 6-4,R32,114,5,4,53,78,32,53,11,25,1,6,13,43,78,7,8,59,93,36,59,14,34,11,16,12,50,93
2009-04-27 00:00:00.000,ATP World Tour Masters 1000 Rome Italy ATP World Tour Masters 1000,CLAY,2,Fernando Verdasco,Mardy Fish,Fernando Verdasco,6-4; 5-7; 6-3,R32,142,4,2,55,79,41,55,15,24,0,2,15,56,79,10,6,50,109,36,50,31,59,10,14,16,67,109
2009-04-27 00:00:00.000,ATP World Tour Masters 1000 Rome Italy ATP World Tour Masters 1000,CLAY,2,Juan Monaco,Andy Murray,Juan Monaco,1-6; 6-3; 7-5,R32,160,0,2,76,91,43,76,5,15,7,13,14,48,91,3,2,55,92,35,55,15,37,8,14,14,50,92
2009-04-27 00:00:00.000,ATP World Tour Masters 1000 Rome Italy ATP World Tour Masters 1000,CLAY,2,Marin Cilic,Christophe Rochus,Marin Cilic,6-0; 5-7; 6-2,R32,121,11,3,43,71,34,43,16,28,1,3,13,50,71,1,4,68,105,37,68,16,37,11,17,13,53,105
2009-04-27 00:00:00.000,ATP World Tour Masters 1000 Rome Italy ATP World Tour Masters 1000,CLAY,2,Fernando Gonzalez,Janko Tipsarevic,Fernando Gonzalez,6-4; 6-4,R32,89,10,2,39,73,36,39,14,34,4,4,10,50,73,0,5,26,54,23,26,13,28,0,2,10,36,54
2009-04-27 00:00:00.000,ATP World Tour Masters 1000 Rome Italy ATP World Tour Masters 1000,CLAY,2,Jurgen Melzer,Nikolay Davydenko,Jurgen Melzer,7-5; 7-6(5),R32,95,2,3,54,72,42,54,9,18,2,3,12,51,72,1,4,51,71,37,51,8,20,1,3,12,45,71
2009-04-27 00:00:00.000,ATP World Tour Masters 1000 Rome Italy ATP World Tour Masters 1000,CLAY,2,Juan Martin Del Potro,Viktor Troicki,Juan Martin Del Potro,6-3; 1-6; 6-3,R32,137,5,1,59,97,38,59,20,38,7,9,13,58,97,1,1,45,78,36,45,14,33,7,9,12,50,78
2009-04-27 00:00:00.000,ATP World Tour Masters 1000 Rome Italy ATP World Tour Masters 1000,CLAY,2,Stanislas Wawrinka,Mikhail Youzhny,Stanislas Wawrinka,6-3; 7-6(5),R32,105,1,2,36,61,24,36,18,25,2,4,10,42,61,0,3,50,79,28,50,18,29,4,8,11,46,79
2009-04-27 00:00:00.000,ATP World Tour Masters 1000 Rome Italy ATP World Tour Masters 1000,CLAY,2,Tommy Robredo,Philipp Kohlschreiber,Tommy Robredo,6-2; 7-6(5),R32,133,2,2,60,84,37,60,13,24,8,10,10,50,84,1,2,49,74,30,49,11,25,4,8,10,41,74
2009-04-27 00:00:00.000,ATP World Tour Masters 1000 Rome Italy ATP World Tour Masters 1000,CLAY,2,Novak Djokovic,Albert Montanes,Novak Djokovic,7-6(5); 6-0,R32,98,4,5,32,64,24,32,14,32,2,4,9,38,64,0,2,34,73,20,34,14,39,5,10,9,34,73
2009-04-27 00:00:00.000,ATP World Tour Masters 1000 Rome Italy ATP World Tour Masters 1000,CLAY,2,Gilles Simon,Fabio Fognini,Gilles Simon,6-7(6); 6-2; 6-3,R32,129,3,2,45,87,34,45,23,42,2,4,14,57,87,1,6,54,95,32,54,22,41,6,12,15,54,95
2009-04-27 00:00:00.000,ATP World Tour Masters 1000 Rome Italy ATP World Tour Masters 1000,CLAY,2,Mischa Zverev,Paul-Henri Mathieu,Mischa Zverev,3-6; 7-6(5); 6-0,R32,131,4,1,63,98,42,63,19,35,7,9,13,61,98,4,0,44,80,26,44,21,36,1,5,14,47,80
2009-04-27 00:00:00.000,ATP World Tour Masters 1000 Rome Italy ATP World Tour Masters 1000,CLAY,2,Radek Stepanek,Feliciano Lopez,Radek Stepanek,6-2; 6-1,R32,71,3,3,31,54,24,31,13,23,5,5,8,37,54,3,0,23,52,16,23,10,29,4,8,7,26,52
2009-04-27 00:00:00.000,ATP World Tour Masters 1000 Rome Italy ATP World Tour Masters 1000,CLAY,2,Roger Federer,Ivo Karlovic,Roger Federer,6-4; 6-4,R32,69,1,2,33,58,25,33,18,25,3,3,10,43,58,15,4,34,53,27,34,8,19,2,4,10,35,53
2009-04-27 00:00:00.000,ATP World Tour Masters 1000 Rome Italy ATP World Tour Masters 1000,CLAY,2,Rafael Nadal,Robin Soderling,Rafael Nadal,6-1; 6-0,R16,84,1,2,29,51,18,29,15,22,5,5,6,33,51,3,2,27,52,11,27,8,25,2,8,7,19,52
2009-04-27 00:00:00.000,ATP World Tour Masters 1000 Rome Italy ATP World Tour Masters 1000,CLAY,2,Fernando Verdasco,Richard Gasquet,Fernando Verdasco,7-5; 6-4,R16,109,3,4,61,80,40,61,10,19,6,8,11,50,80,0,2,53,72,32,53,10,19,4,8,11,42,72
2009-04-27 00:00:00.000,ATP World Tour Masters 1000 Rome Italy ATP World Tour Masters 1000,CLAY,2,Juan Monaco,Marin Cilic,Juan Monaco,6-4; 6-4,R16,90,0,0,39,49,32,39,8,10,0,0,10,40,49,5,3,36,66,25,36,17,30,8,10,10,42,66
2009-04-27 00:00:00.000,ATP World Tour Masters 1000 Rome Italy ATP World Tour Masters 1000,CLAY,2,Fernando Gonzalez,Jurgen Melzer,Fernando Gonzalez,3-6; 6-3; 7-5,R16,114,3,2,55,88,42,55,20,33,4,5,15,62,88,7,4,59,100,38,59,26,41,6,8,15,64,100
2009-04-27 00:00:00.000,ATP World Tour Masters 1000 Rome Italy ATP World Tour Masters 1000,CLAY,2,Juan Martin Del Potro,Stanislas Wawrinka,Juan Martin Del Potro,6-2; 6-7(5); 6-3,R16,170,7,1,46,88,40,46,23,42,6,7,15,63,88,4,3,66,101,41,66,18,35,10,14,14,59,101
2009-04-27 00:00:00.000,ATP World Tour Masters 1000 Rome Italy ATP World Tour Masters 1000,CLAY,2,Novak Djokovic,Tommy Robredo,Novak Djokovic,6-1; 6-1,R16,64,3,4,32,51,22,32,10,19,3,4,7,32,51,0,1,29,47,11,29,5,18,3,9,7,16,47
2009-04-27 00:00:00.000,ATP World Tour Masters 1000 Rome Italy ATP World Tour Masters 1000,CLAY,2,Mischa Zverev,Gilles Simon,Mischa Zverev,6-4; 6-1,R16,63,1,1,22,40,19,22,13,18,0,0,8,32,40,1,2,29,58,17,29,14,29,4,8,9,31,58
2009-04-27 00:00:00.000,ATP World Tour Masters 1000 Rome Italy ATP World Tour Masters 1000,CLAY,2,Roger Federer,Radek Stepanek,Roger Federer,6-4; 6-1,R16,68,5,2,21,49,18,21,17,28,4,5,9,35,49,1,2,28,53,17,28,11,25,3,7,8,28,53
2009-04-27 00:00:00.000,ATP World Tour Masters 1000 Rome Italy ATP World Tour Masters 1000,CLAY,2,Rafael Nadal,Fernando Verdasco,Rafael Nadal,6-3; 6-3,Q,111,0,0,42,60,27,42,11,18,5,6,9,38,60,0,5,36,55,20,36,9,19,2,6,9,29,55
2009-04-27 00:00:00.000,ATP World Tour Masters 1000 Rome Italy ATP World Tour Masters 1000,CLAY,2,Fernando Gonzalez,Juan Monaco,Fernando Gonzalez,2-6; 6-3; 6-4,Q,128,2,6,55,92,35,55,20,37,2,5,14,55,92,1,3,61,81,41,61,11,20,1,4,13,52,81
2009-04-27 00:00:00.000,ATP World Tour Masters 1000 Rome Italy ATP World Tour Masters 1000,CLAY,2,Novak Djokovic,Juan Martin Del Potro,Novak Djokovic,6-3; 6-4,Q,97,4,3,41,64,27,41,15,23,2,3,10,42,64,2,3,29,55,20,29,11,26,3,6,9,31,55
2009-04-27 00:00:00.000,ATP World Tour Masters 1000 Rome Italy ATP World Tour Masters 1000,CLAY,2,Roger Federer,Mischa Zverev,Roger Federer,7-6(3); 6-2,Q,88,2,0,36,55,31,36,13,19,0,0,10,44,55,4,1,54,83,37,54,12,29,8,10,10,49,83
2009-04-27 00:00:00.000,ATP World Tour Masters 1000 Rome Italy ATP World Tour Masters 1000,CLAY,2,Rafael Nadal,Fernando Gonzalez,Rafael Nadal,6-3; 6-3,S,75,1,0,34,46,27,34,6,12,0,1,9,33,46,2,2,31,51,22,31,6,20,3,7,9,28,51
2009-04-27 00:00:00.000,ATP World Tour Masters 1000 Rome Italy ATP World Tour Masters 1000,CLAY,2,Novak Djokovic,Roger Federer,Novak Djokovic,4-6; 6-3; 6-3,S,131,3,6,50,100,32,50,28,50,8,11,14,60,100,6,3,40,81,29,40,17,41,3,8,14,46,81
2009-04-27 00:00:00.000,ATP World Tour Masters 1000 Rome Italy ATP World Tour Masters 1000,CLAY,2,Rafael Nadal,Novak Djokovic,Rafael Nadal,7-6(2); 6-2,F,123,0,1,50,70,34,50,11,20,2,4,10,45,70,0,2,39,66,23,39,13,27,1,5,10,36,66
2009-05-03 00:00:00.000,Estoril Portugal ATP World Tour 250,CLAY,2,Gilles Simon,Robert Kendrick,Gilles Simon,6-3; 7-6(7),R32,93,4,1,43,78,25,43,22,35,5,8,11,47,78,0,4,43,81,29,43,14,38,5,9,10,43,81
2009-05-03 00:00:00.000,Estoril Portugal ATP World Tour 250,CLAY,2,Fabio Fognini,Gaston Gaudio,Fabio Fognini,6-3; 6-4,R32,79,2,2,30,64,22,30,20,34,1,2,10,42,64,0,5,34,57,25,34,9,23,4,7,9,34,57
2009-05-03 00:00:00.000,Estoril Portugal ATP World Tour 250,CLAY,2,Simon Greul,Ricardo Hocevar,Simon Greul,6-1; 6-4,R32,77,0,3,33,54,25,33,13,21,1,1,9,38,54,1,3,20,54,15,20,16,34,7,10,8,31,54
2009-05-03 00:00:00.000,Estoril Portugal ATP World Tour 250,CLAY,2,Albert Montanes,Ryan Sweeting,Albert Montanes,6-1; 7-6(4),R32,74,1,5,31,59,22,31,14,28,5,8,9,36,59,0,2,53,66,24,53,5,13,6,12,10,29,66
2009-05-03 00:00:00.000,Estoril Portugal ATP World Tour 250,CLAY,2,David Ferrer,Daniel Gimeno-Traver,David Ferrer,6-4; 6-1,R32,72,2,2,25,49,21,25,12,24,0,2,9,33,49,1,3,24,49,13,24,8,25,2,7,8,21,49
2009-05-03 00:00:00.000,Estoril Portugal ATP World Tour 250,CLAY,2,Oscar Hernandez,Rui Machado,Oscar Hernandez,7-5; 1-6; 7-5,R32,148,1,6,65,96,41,65,11,31,6,11,16,52,96,0,5,63,93,42,63,14,30,2,6,15,56,93
2009-05-03 00:00:00.000,Estoril Portugal ATP World Tour 250,CLAY,2,Maximo Gonzalez,Guillermo Garcia-Lopez,Maximo Gonzalez,6-4; 6-3,R32,98,1,3,33,59,25,33,13,26,4,5,9,38,59,2,8,47,79,30,47,12,32,13,17,10,42,79
2009-05-03 00:00:00.000,Estoril Portugal ATP World Tour 250,CLAY,2,Paul Capdeville,David Nalbandian,Paul Capdeville,6-2; 6-2,R32,53,0,3,19,39,16,19,14,20,0,1,8,30,39,2,1,16,43,8,16,12,27,1,6,8,20,43
2009-05-03 00:00:00.000,Estoril Portugal ATP World Tour 250,CLAY,2,Florent Serra,Diego Junqueira,Florent Serra,6-4; 2-6; 6-3,R32,129,4,6,55,99,33,55,23,44,9,13,13,56,99,2,1,53,90,35,53,18,37,7,12,14,53,90
2009-05-03 00:00:00.000,Estoril Portugal ATP World Tour 250,CLAY,2,Juan Monaco,Pablo Cuevas,Juan Monaco,6-2; 6-4,R32,74,0,2,33,52,23,33,13,19,2,3,9,36,52,1,0,29,56,14,29,15,27,6,10,9,29,56
2009-05-03 00:00:00.000,Estoril Portugal ATP World Tour 250,CLAY,2,Marc Gicquel,Pablo Andujar,Marc Gicquel,7-6(6); 6-4,R32,107,6,2,38,70,30,38,22,32,0,0,11,52,70,3,2,53,78,35,53,18,25,7,8,11,53,78
2009-05-03 00:00:00.000,Estoril Portugal ATP World Tour 250,CLAY,2,James Blake,Frederico Gil,James Blake,5-7; 6-4; 6-2,R32,116,2,2,47,93,39,47,25,46,7,8,15,64,93,4,2,52,92,35,52,25,40,5,8,15,60,92
2009-05-03 00:00:00.000,Estoril Portugal ATP World Tour 250,CLAY,2,Mardy Fish,Teymuraz Gabashvili,Mardy Fish,6-3; 6-4,R32,108,8,3,39,70,26,39,14,31,2,5,10,40,70,3,7,49,87,33,49,11,38,7,12,9,44,87
2009-05-03 00:00:00.000,Estoril Portugal ATP World Tour 250,CLAY,2,Ivan Navarro,Alberto Martin,Ivan Navarro,7-5; 6-4,R32,89,4,1,56,71,40,56,5,15,4,6,11,45,71,0,3,30,61,19,30,17,31,1,5,11,36,61
2009-05-03 00:00:00.000,Estoril Portugal ATP World Tour 250,CLAY,2,Juan Carlos Ferrero,Mikhail Kukushkin,Juan Carlos Ferrero,7-6(4); 6-3,R32,95,5,1,47,70,31,47,15,23,2,3,10,46,70,6,3,33,70,22,33,17,37,1,4,11,39,70
2009-05-03 00:00:00.000,Estoril Portugal ATP World Tour 250,CLAY,2,Nikolay Davydenko,Andrey Golubev,Nikolay Davydenko,6-1; 7-6(4),R32,96,1,3,43,63,28,43,10,20,1,3,9,38,63,0,6,46,71,25,46,9,25,5,10,10,34,71
2009-05-03 00:00:00.000,Estoril Portugal ATP World Tour 250,CLAY,2,Gilles Simon,Fabio Fognini,Gilles Simon,6-0; 7-5,R16,74,1,1,29,50,17,29,13,21,2,4,9,30,50,0,4,36,65,19,36,9,29,5,11,9,28,65
2009-05-03 00:00:00.000,Estoril Portugal ATP World Tour 250,CLAY,2,Albert Montanes,Simon Greul,Albert Montanes,6-2; 6-2,R16,71,2,4,32,52,27,32,8,20,6,7,8,35,52,1,4,25,58,12,25,15,33,8,13,8,27,58
2009-05-03 00:00:00.000,Estoril Portugal ATP World Tour 250,CLAY,2,Oscar Hernandez,David Ferrer,Oscar Hernandez,6-2; 6-4,R16,100,3,2,45,69,32,45,10,24,10,12,9,42,69,1,5,29,55,15,29,10,26,5,10,9,25,55
2009-05-03 00:00:00.000,Estoril Portugal ATP World Tour 250,CLAY,2,Paul Capdeville,Maximo Gonzalez,Paul Capdeville,2-6; 6-2; 6-3,R16,140,3,4,61,100,39,61,15,39,5,10,13,54,100,0,0,65,97,37,65,11,32,12,18,12,48,97
2009-05-03 00:00:00.000,Estoril Portugal ATP World Tour 250,CLAY,2,Florent Serra,Juan Monaco,Florent Serra,6-3; 1-6; 6-3,R16,123,4,2,51,107,30,51,30,56,8,11,13,60,107,4,1,54,77,37,54,11,23,2,5,12,48,77
2009-05-03 00:00:00.000,Estoril Portugal ATP World Tour 250,CLAY,2,James Blake,Marc Gicquel,James Blake,7-6(6); 6-2,R16,77,5,1,40,64,31,40,16,24,1,1,10,47,64,9,1,45,74,33,45,14,29,6,8,10,47,74
2009-05-03 00:00:00.000,Estoril Portugal ATP World Tour 250,CLAY,2,Mardy Fish,Ivan Navarro,Mardy Fish,2-6; 6-1; 6-4,R16,117,6,1,39,85,27,39,25,46,5,8,13,52,85,5,2,48,74,34,48,9,26,3,7,12,43,74
2009-05-03 00:00:00.000,Estoril Portugal ATP World Tour 250,CLAY,2,Nikolay Davydenko,Juan Carlos Ferrero,Nikolay Davydenko,7-5; 6-2,R16,89,5,2,37,52,29,37,9,15,0,1,10,38,52,3,3,48,73,29,48,10,25,3,7,10,39,73
2009-05-03 00:00:00.000,Estoril Portugal ATP World Tour 250,CLAY,2,Albert Montanes,Gilles Simon,Albert Montanes,5-7; 6-4; 7-6(4),Q,178,3,4,58,121,40,58,29,63,4,10,17,69,121,2,2,61,119,36,61,30,58,9,15,17,66,119
2009-05-03 00:00:00.000,Estoril Portugal ATP World Tour 250,CLAY,2,Paul Capdeville,Oscar Hernandez,Paul Capdeville,4-6; 6-1; 6-4,Q,132,3,4,46,85,30,46,23,39,3,6,14,53,85,4,2,64,84,39,64,8,20,7,12,13,47,84
2009-05-03 00:00:00.000,Estoril Portugal ATP World Tour 250,CLAY,2,James Blake,Florent Serra,James Blake,6-4; 6-1,Q,48,7,2,25,46,19,25,12,21,2,4,9,31,46,0,2,32,47,15,32,7,15,3,8,8,22,47
2009-05-03 00:00:00.000,Estoril Portugal ATP World Tour 250,CLAY,2,Nikolay Davydenko,Mardy Fish,Nikolay Davydenko,6-4; 6-3,Q,85,0,2,43,57,31,43,7,14,4,5,9,38,57,5,2,31,54,20,31,7,23,2,6,10,27,54
2009-05-03 00:00:00.000,Estoril Portugal ATP World Tour 250,CLAY,2,Albert Montanes,Paul Capdeville,Albert Montanes,6-3; 6-4,S,77,5,2,30,56,21,30,13,26,2,5,10,34,56,1,0,33,57,19,33,8,24,1,6,9,27,57
2009-05-03 00:00:00.000,Estoril Portugal ATP World Tour 250,CLAY,2,James Blake,Nikolay Davydenko,James Blake,6-7(3); 7-6(2); 6-3,S,146,4,3,69,129,43,69,32,60,7,12,17,75,129,1,3,68,108,41,68,20,40,5,11,16,61,108
2009-05-03 00:00:00.000,Estoril Portugal ATP World Tour 250,CLAY,2,Albert Montanes,James Blake,Albert Montanes,5-7; 7-6(6); 6-0,F,133,8,3,46,93,36,46,29,47,6,8,15,65,93,5,7,65,119,45,65,25,54,5,9,15,70,119
2009-05-03 00:00:00.000,Munich Germany ATP World Tour 250,CLAY,2,Julien Benneteau,Alexander Peya,Julien Benneteau,2-6; 7-6(5); 7-5,R32,152,3,3,68,98,45,68,13,30,3,8,16,58,98,3,2,67,102,42,67,18,35,5,9,16,60,102
2009-05-03 00:00:00.000,Munich Germany ATP World Tour 250,CLAY,2,Daniel Brands,Stefan Koubek,Daniel Brands,6-3; 7-6(2),R32,76,6,1,45,60,37,45,11,15,6,6,10,48,60,3,2,41,68,32,41,12,27,1,3,11,44,68
2009-05-03 00:00:00.000,Munich Germany ATP World Tour 250,CLAY,2,Simone Bolelli,Stephane Bohli,Simone Bolelli,3-6; 6-2; 6-3,R32,138,3,3,64,95,46,64,15,31,8,9,13,61,95,5,4,60,103,40,60,21,43,12,15,13,61,103
2009-05-03 00:00:00.000,Munich Germany ATP World Tour 250,CLAY,2,Potito Starace,Igor Kunitsyn,Potito Starace,7-5; 5-7; 6-3,R32,131,2,1,81,98,55,81,8,17,6,10,17,63,98,1,0,75,98,46,75,11,23,4,9,16,57,98
2009-05-03 00:00:00.000,Munich Germany ATP World Tour 250,CLAY,2,Nicolas Almagro,Jan Hernych,Nicolas Almagro,6-3; 6-4,R32,74,3,0,40,55,29,40,9,15,2,3,9,38,55,0,2,44,66,27,44,10,22,5,9,10,37,66
2009-05-03 00:00:00.000,Munich Germany ATP World Tour 250,CLAY,2,Mikhail Youzhny,Ivo Minar,Mikhail Youzhny,6-3; 7-6(5),R32,95,0,1,37,60,24,37,11,23,0,3,10,35,60,5,2,52,88,36,52,11,36,6,11,11,47,88
2009-05-03 00:00:00.000,Munich Germany ATP World Tour 250,CLAY,2,Denis Gremelmayr,Martin Vassallo Arguello,Denis Gremelmayr,5-1 RET,R32,30,1,1,9,15,7,9,5,6,0,0,3,12,15,0,1,10,15,5,10,2,5,1,3,3,7,15
2009-05-03 00:00:00.000,Munich Germany ATP World Tour 250,CLAY,2,Paul-Henri Mathieu,Lamine Ouahab,Paul-Henri Mathieu,6-3; 6-2,R32,66,4,1,30,47,27,30,9,17,0,0,9,36,47,2,5,25,54,15,25,14,29,4,7,8,29,54
2009-05-03 00:00:00.000,Munich Germany ATP World Tour 250,CLAY,2,Thiemo de Bakker,Rainer Schuettler,Thiemo de Bakker,6-3; 6-3,R32,69,5,0,47,60,31,47,8,13,2,3,9,39,60,3,4,37,55,24,37,5,18,3,7,9,29,55
2009-05-03 00:00:00.000,Munich Germany ATP World Tour 250,CLAY,2,Lleyton Hewitt,Philipp Petzschner,Lleyton Hewitt,6-2; 6-7(2); 7-6(8),R32,157,2,5,60,123,40,60,34,63,7,11,16,74,123,6,5,59,113,37,59,27,54,7,13,16,64,113
2009-05-03 00:00:00.000,Munich Germany ATP World Tour 250,CLAY,2,Andreas Beck,Mischa Zverev,Andreas Beck,6-3; 6-4,R32,87,1,1,30,57,21,30,15,27,2,4,10,36,57,1,2,33,66,16,33,19,33,6,10,9,35,66
2009-05-03 00:00:00.000,Munich Germany ATP World Tour 250,CLAY,2,Tomas Berdych,Sascha Kloer,Tomas Berdych,7-6(0); 6-4,R32,91,6,1,44,66,32,44,17,22,3,4,11,49,66,2,4,61,93,38,61,16,32,8,10,11,54,93
2009-05-03 00:00:00.000,Munich Germany ATP World Tour 250,CLAY,2,Nicolas Kiefer,Ernests Gulbis,Nicolas Kiefer,2-6; 6-3; 6-2,R32,93,7,5,40,80,30,40,18,40,4,7,13,48,80,7,3,39,69,29,39,13,30,1,5,12,42,69
2009-05-03 00:00:00.000,Munich Germany ATP World Tour 250,CLAY,2,Jeremy Chardy,Evgeny Korolev,Jeremy Chardy,6-3; 6-3,R32,57,6,1,27,43,23,27,13,16,0,0,9,36,43,4,0,37,57,24,37,9,20,5,8,9,33,57
2009-05-03 00:00:00.000,Munich Germany ATP World Tour 250,CLAY,2,Philipp Kohlschreiber,Bjorn Phau,Philipp Kohlschreiber,6-2; 2-1 RET,R32,45,3,2,28,38,19,28,6,10,2,3,6,25,38,0,2,14,32,8,14,7,18,1,4,5,15,32
2009-05-03 00:00:00.000,Munich Germany ATP World Tour 250,CLAY,2,Marin Cilic,Dieter Kindlmann,Marin Cilic,6-3; 6-2,R32,75,4,1,25,44,22,25,11,19,0,0,8,33,44,0,4,42,70,24,42,13,28,4,8,9,37,70
2009-05-03 00:00:00.000,Munich Germany ATP World Tour 250,CLAY,2,Daniel Brands,Julien Benneteau,Daniel Brands,6-4; 3-6; 7-6(6),R16,135,3,3,58,90,39,58,15,32,3,8,15,54,90,3,6,75,104,47,75,14,29,6,11,16,61,104
2009-05-03 00:00:00.000,Munich Germany ATP World Tour 250,CLAY,2,Potito Starace,Simone Bolelli,Potito Starace,6-4; 7-6(5),R16,114,3,1,61,71,45,61,4,10,2,3,11,49,71,5,2,56,88,38,56,17,32,6,8,11,55,88
2009-05-03 00:00:00.000,Munich Germany ATP World Tour 250,CLAY,2,Mikhail Youzhny,Nicolas Almagro,Mikhail Youzhny,7-6(2); 6-4,R16,86,4,0,41,64,33,41,16,23,2,3,11,49,64,7,3,42,66,29,42,14,24,2,4,11,43,66
2009-05-03 00:00:00.000,Munich Germany ATP World Tour 250,CLAY,2,Paul-Henri Mathieu,Denis Gremelmayr,Paul-Henri Mathieu,6-1; 6-4,R16,75,5,0,39,61,26,39,14,22,2,3,9,40,61,0,3,34,55,19,34,7,21,5,9,8,26,55
2009-05-03 00:00:00.000,Munich Germany ATP World Tour 250,CLAY,2,Lleyton Hewitt,Thiemo de Bakker,Lleyton Hewitt,6-3; 6-4,R16,94,7,2,42,65,33,42,8,23,3,5,10,41,65,2,1,52,83,28,52,15,31,8,12,9,43,83
2009-05-03 00:00:00.000,Munich Germany ATP World Tour 250,CLAY,2,Tomas Berdych,Andreas Beck,Tomas Berdych,1-6; 6-4; 7-6(4),R16,151,7,4,52,96,42,52,21,44,5,8,14,63,96,10,5,59,108,40,59,30,49,11,13,15,70,108
2009-05-03 00:00:00.000,Munich Germany ATP World Tour 250,CLAY,2,Jeremy Chardy,Nicolas Kiefer,Jeremy Chardy,6-4; 7-6(8),R16,95,7,2,42,71,33,42,18,29,3,4,11,51,71,13,4,28,72,22,28,26,44,2,4,11,48,72
2009-05-03 00:00:00.000,Munich Germany ATP World Tour 250,CLAY,2,Marin Cilic,Philipp Kohlschreiber,Marin Cilic,6-0; 6-4,R16,77,3,2,36,59,27,36,12,23,3,3,8,39,59,1,2,31,47,14,31,10,16,1,5,8,24,47
2009-05-03 00:00:00.000,Munich Germany ATP World Tour 250,CLAY,2,Daniel Brands,Potito Starace,Daniel Brands,6-4; 1-1 RET,Q,36,5,1,20,29,18,20,6,9,0,0,6,24,29,3,1,33,38,23,33,2,5,4,5,6,25,38
2009-05-03 00:00:00.000,Munich Germany ATP World Tour 250,CLAY,2,Mikhail Youzhny,Paul-Henri Mathieu,Mikhail Youzhny,7-5; 3-6; 6-3,Q,138,10,3,52,86,41,52,20,34,4,5,15,61,86,3,1,58,97,40,58,22,39,2,4,15,62,97
2009-05-03 00:00:00.000,Munich Germany ATP World Tour 250,CLAY,2,Tomas Berdych,Lleyton Hewitt,Tomas Berdych,4-6; 6-3; 7-6(4),Q,138,8,4,73,109,51,73,19,36,4,7,16,70,109,7,4,58,95,42,58,20,37,3,6,15,62,95
2009-05-03 00:00:00.000,Munich Germany ATP World Tour 250,CLAY,2,Jeremy Chardy,Marin Cilic,Jeremy Chardy,3-6; 7-5; 6-4,Q,118,3,1,59,85,48,59,14,26,4,5,15,62,85,9,1,47,86,37,47,26,39,4,6,16,63,86
2009-05-03 00:00:00.000,Munich Germany ATP World Tour 250,CLAY,2,Mikhail Youzhny,Daniel Brands,Mikhail Youzhny,3-6; 6-3; 6-4,S,117,1,2,62,83,51,62,10,21,6,7,14,61,83,6,2,65,89,52,65,6,24,5,7,14,58,89
2009-05-03 00:00:00.000,Munich Germany ATP World Tour 250,CLAY,2,Tomas Berdych,Jeremy Chardy,Tomas Berdych,6-1; 5-7; 6-2,S,105,10,1,59,91,46,59,16,32,4,5,14,62,91,5,2,42,72,29,42,18,30,3,7,13,47,72
2009-05-03 00:00:00.000,Munich Germany ATP World Tour 250,CLAY,2,Tomas Berdych,Mikhail Youzhny,Tomas Berdych,6-4; 4-6; 7-6(5),F,154,7,7,58,93,49,58,14,35,2,5,16,63,93,7,1,68,112,53,68,17,44,9,12,16,70,112
2009-05-04 00:00:00.000,Belgrade Serbia ATP World Tour 250,CLAY,2,Novak Djokovic,N/A Bye,Novak Djokovic,,R32,0,0,0,0,0,0,0,0,0,0,0,0,0,0,0,0,0,0,0,0,0,0,0,0,0,0,0
2009-05-04 00:00:00.000,Belgrade Serbia ATP World Tour 250,CLAY,2,Janko Tipsarevic,Sergio Roitman,Janko Tipsarevic,7-5; 6-2,R32,89,5,0,34,52,26,34,11,18,1,3,10,37,52,0,3,49,72,25,49,11,23,7,12,10,36,72
2009-05-04 00:00:00.000,Belgrade Serbia ATP World Tour 250,CLAY,2,Marcel Granollers,Filip Krajinovic,Marcel Granollers,6-0; 2-6; 6-2,R32,88,0,5,29,64,15,29,21,35,3,7,11,36,64,1,1,36,61,20,36,9,25,5,12,11,29,61
2009-05-04 00:00:00.000,Belgrade Serbia ATP World Tour 250,CLAY,2,Viktor Troicki,Sam Querrey,Viktor Troicki,4-6; 6-4; 6-3,R32,117,4,5,61,98,47,61,16,37,9,12,15,63,98,3,3,46,82,31,46,19,36,2,6,14,50,82
2009-05-04 00:00:00.000,Belgrade Serbia ATP World Tour 250,CLAY,2,Andreas Seppi,N/A Bye,Andreas Seppi,,R32,0,0,0,0,0,0,0,0,0,0,0,0,0,0,0,0,0,0,0,0,0,0,0,0,0,0,0
2009-05-04 00:00:00.000,Belgrade Serbia ATP World Tour 250,CLAY,2,Leonardo Mayer,Wayne Odesnik,Leonardo Mayer,6-3; 6-2,R32,73,5,3,31,50,25,31,10,19,2,2,8,35,50,2,3,25,48,17,25,9,23,1,5,9,26,48
2009-05-04 00:00:00.000,Belgrade Serbia ATP World Tour 250,CLAY,2,Marcos Daniel,Guillermo Canas,Marcos Daniel,3-6; 6-1; 6-4,R32,140,3,1,50,72,39,50,11,22,0,1,13,50,72,6,3,55,99,44,55,17,44,7,10,13,61,99
2009-05-04 00:00:00.000,Belgrade Serbia ATP World Tour 250,CLAY,2,Ivan Ljubicic,Victor Crivoi,Ivan Ljubicic,7-6(2); 3-6; 6-4,R32,143,17,3,60,113,45,60,28,53,11,13,15,73,113,11,0,80,98,56,80,9,18,7,9,16,65,98
2009-05-04 00:00:00.000,Belgrade Serbia ATP World Tour 250,CLAY,2,Christophe Rochus,Nicolas Devilder,Christophe Rochus,6-3; 6-7(7); 7-5,R32,180,2,2,64,135,45,64,35,71,11,16,17,80,135,7,8,78,142,52,78,26,64,14,21,16,78,142
2009-05-04 00:00:00.000,Belgrade Serbia ATP World Tour 250,CLAY,2,Kristof Vliegen,Dominik Hrbaty,Kristof Vliegen,2-6; 6-2; 6-2,R32,95,6,1,37,64,29,37,15,27,1,3,12,44,64,1,4,57,86,36,57,11,29,4,8,12,47,86
2009-05-04 00:00:00.000,Belgrade Serbia ATP World Tour 250,CLAY,2,Lukasz Kubot,Arsenije Zlatanovic,Lukasz Kubot,6-3; 7-5,R32,100,3,3,36,62,22,36,18,26,1,3,10,40,62,7,2,36,67,22,36,13,31,2,7,11,35,67
2009-05-04 00:00:00.000,Belgrade Serbia ATP World Tour 250,CLAY,2,Igor Andreev,N/A Bye,Igor Andreev,,R32,0,0,0,0,0,0,0,0,0,0,0,0,0,0,0,0,0,0,0,0,0,0,0,0,0,0,0
2009-05-04 00:00:00.000,Belgrade Serbia ATP World Tour 250,CLAY,2,Arnaud Clement,Santiago Ventura,Arnaud Clement,6-1; 6-4,R32,82,1,1,45,55,30,45,4,10,4,6,9,34,55,3,2,42,54,20,42,4,12,3,8,8,24,54
2009-05-04 00:00:00.000,Belgrade Serbia ATP World Tour 250,CLAY,2,Flavio Cipolla,Marcos Baghdatis,Flavio Cipolla,1-6; 6-3; 6-1,R32,126,0,4,76,94,42,76,10,18,14,18,12,52,94,3,1,77,101,40,77,12,24,15,20,11,52,101
2009-05-04 00:00:00.000,Belgrade Serbia ATP World Tour 250,CLAY,2,Brian Dabul,Nicolas Massu,Brian Dabul,6-2; 6-1,R32,75,4,0,39,54,29,39,8,15,3,3,8,37,54,2,0,28,50,15,28,10,22,8,12,7,25,50
2009-05-04 00:00:00.000,Belgrade Serbia ATP World Tour 250,CLAY,2,Ivo Karlovic,N/A Bye,Ivo Karlovic,,R32,0,0,0,0,0,0,0,0,0,0,0,0,0,0,0,0,0,0,0,0,0,0,0,0,0,0,0
2009-05-04 00:00:00.000,Belgrade Serbia ATP World Tour 250,CLAY,2,Novak Djokovic,Janko Tipsarevic,Novak Djokovic,6-2; 4-6; 6-0,R16,121,6,3,40,63,31,40,12,23,2,4,12,43,63,5,2,50,96,31,50,17,46,13,19,12,48,96
2009-05-04 00:00:00.000,Belgrade Serbia ATP World Tour 250,CLAY,2,Viktor Troicki,Marcel Granollers,Viktor Troicki,6-3; 6-4,R16,88,2,0,36,57,26,36,14,21,1,2,10,40,57,0,2,32,62,18,32,17,30,7,10,9,35,62
2009-05-04 00:00:00.000,Belgrade Serbia ATP World Tour 250,CLAY,2,Andreas Seppi,Leonardo Mayer,Andreas Seppi,6-4; 6-1,R16,72,0,2,28,50,20,28,12,22,0,1,8,32,50,0,3,34,56,19,34,9,22,4,9,9,28,56
2009-05-04 00:00:00.000,Belgrade Serbia ATP World Tour 250,CLAY,2,Marcos Daniel,Ivan Ljubicic,Marcos Daniel,6-4; 6-3,R16,78,5,2,39,56,28,39,11,17,1,2,10,39,56,5,0,29,51,22,29,9,22,3,6,9,31,51
2009-05-04 00:00:00.000,Belgrade Serbia ATP World Tour 250,CLAY,2,Kristof Vliegen,Christophe Rochus,Kristof Vliegen,3-6; 6-4; 6-3,R16,93,8,2,47,78,29,47,19,31,3,7,14,48,78,1,2,35,78,22,35,24,43,1,6,14,46,78
2009-05-04 00:00:00.000,Belgrade Serbia ATP World Tour 250,CLAY,2,Lukasz Kubot,Igor Andreev,Lukasz Kubot,3-2 RET,R16,36,1,0,10,18,9,10,4,8,0,0,3,13,18,0,0,17,25,10,17,5,8,5,5,2,15,25
2009-05-04 00:00:00.000,Belgrade Serbia ATP World Tour 250,CLAY,2,Flavio Cipolla,Arnaud Clement,Flavio Cipolla,1-6; 6-4; 6-2,R16,118,1,5,57,76,34,57,11,19,4,7,12,45,76,2,2,43,80,31,43,17,37,4,8,13,48,80
2009-05-04 00:00:00.000,Belgrade Serbia ATP World Tour 250,CLAY,2,Ivo Karlovic,Brian Dabul,Ivo Karlovic,6-4; 7-6(5),R16,106,19,5,60,80,47,60,9,20,9,9,11,56,80,2,2,52,75,40,52,12,23,5,6,11,52,75
2009-05-04 00:00:00.000,Belgrade Serbia ATP World Tour 250,CLAY,2,Novak Djokovic,Viktor Troicki,Novak Djokovic,6-3; 6-2,Q,70,2,0,34,49,26,34,7,15,2,3,9,33,49,1,1,25,44,15,25,7,19,0,4,8,22,44
2009-05-04 00:00:00.000,Belgrade Serbia ATP World Tour 250,CLAY,2,Andreas Seppi,Marcos Daniel,Andreas Seppi,6-4; 7-5,Q,119,2,2,51,74,32,51,15,23,3,6,11,47,74,1,2,49,86,31,49,14,37,6,11,11,45,86
2009-05-04 00:00:00.000,Belgrade Serbia ATP World Tour 250,CLAY,2,Lukasz Kubot,Kristof Vliegen,Lukasz Kubot,7-6(6); 6-3,Q,108,1,2,48,77,28,48,13,29,6,10,10,41,77,5,3,40,68,22,40,12,28,3,9,11,34,68
2009-05-04 00:00:00.000,Belgrade Serbia ATP World Tour 250,CLAY,2,Ivo Karlovic,Flavio Cipolla,Ivo Karlovic,6-3; 6-3,Q,72,13,3,33,51,29,33,9,18,1,1,9,38,51,0,3,42,56,24,42,6,14,3,6,9,30,56
2009-05-04 00:00:00.000,Belgrade Serbia ATP World Tour 250,CLAY,2,Novak Djokovic,Andreas Seppi,Novak Djokovic,4-6; 6-1; 6-2,S,137,1,3,59,97,41,59,19,38,6,8,13,60,97,3,7,62,89,40,62,7,27,6,11,12,47,89
2009-05-04 00:00:00.000,Belgrade Serbia ATP World Tour 250,CLAY,2,Lukasz Kubot,Ivo Karlovic,Lukasz Kubot,7-6(0); 6-2,S,97,2,3,37,66,29,37,18,29,4,4,10,47,66,14,1,35,56,28,35,10,21,3,5,10,38,56
2009-05-04 00:00:00.000,Belgrade Serbia ATP World Tour 250,CLAY,2,Novak Djokovic,Lukasz Kubot,Novak Djokovic,6-3; 7-6(0),F,110,6,2,46,69,32,46,14,23,6,9,11,46,69,2,1,40,61,26,40,7,21,3,7,10,33,61
2009-05-10 00:00:00.000,ATP World Tour Masters 1000 Madrid Spain ATP World Tour Masters 1000,CLAY,2,Rafael Nadal,N/A Bye,Rafael Nadal,,R64,0,0,0,0,0,0,0,0,0,0,0,0,0,0,0,0,0,0,0,0,0,0,0,0,0,0,0
2009-05-10 00:00:00.000,ATP World Tour Masters 1000 Madrid Spain ATP World Tour Masters 1000,CLAY,2,Jurgen Melzer,Albert Montanes,Jurgen Melzer,4-6; 7-5; 6-3,R64,120,10,4,46,82,38,46,20,36,1,3,16,58,82,3,3,51,91,35,51,26,40,3,6,15,61,91
2009-05-10 00:00:00.000,ATP World Tour Masters 1000 Madrid Spain ATP World Tour Masters 1000,CLAY,2,Philipp Kohlschreiber,Nicolas Almagro,Philipp Kohlschreiber,6-3; 6-4,R64,92,2,1,44,63,33,44,12,19,3,3,10,45,63,7,0,36,69,29,36,13,33,7,9,9,42,69
2009-05-10 00:00:00.000,ATP World Tour Masters 1000 Madrid Spain ATP World Tour Masters 1000,CLAY,2,Marin Cilic,Marcel Granollers,Marin Cilic,6-2; 6-7(4); 6-1,R64,149,3,3,57,108,38,57,31,51,8,9,14,69,108,0,4,45,79,26,45,21,34,5,10,13,47,79
2009-05-10 00:00:00.000,ATP World Tour Masters 1000 Madrid Spain ATP World Tour Masters 1000,CLAY,2,David Ferrer,Guillermo Canas,David Ferrer,6-2; 6-2,R64,84,0,1,23,41,18,23,13,18,1,2,8,31,41,2,2,26,66,14,26,18,40,7,12,8,32,66
2009-05-10 00:00:00.000,ATP World Tour Masters 1000 Madrid Spain ATP World Tour Masters 1000,CLAY,2,Juan Monaco,Feliciano Lopez,Juan Monaco,6-4; 7-5,R64,130,0,1,52,74,35,52,15,22,6,6,11,50,74,5,1,44,93,31,44,25,49,12,14,11,56,93
2009-05-10 00:00:00.000,ATP World Tour Masters 1000 Madrid Spain ATP World Tour Masters 1000,CLAY,2,Juan Carlos Ferrero,Igor Kunitsyn,Juan Carlos Ferrero,6-3; 4-6; 6-4,R64,131,1,3,63,98,37,63,21,35,4,8,15,58,98,1,1,61,85,36,61,11,24,5,10,14,47,85
2009-05-10 00:00:00.000,ATP World Tour Masters 1000 Madrid Spain ATP World Tour Masters 1000,CLAY,2,Fernando Verdasco,N/A Bye,Fernando Verdasco,,R64,0,0,0,0,0,0,0,0,0,0,0,0,0,0,0,0,0,0,0,0,0,0,0,0,0,0,0
2009-05-10 00:00:00.000,ATP World Tour Masters 1000 Madrid Spain ATP World Tour Masters 1000,CLAY,2,Novak Djokovic,N/A Bye,Novak Djokovic,,R64,0,0,0,0,0,0,0,0,0,0,0,0,0,0,0,0,0,0,0,0,0,0,0,0,0,0,0
2009-05-10 00:00:00.000,ATP World Tour Masters 1000 Madrid Spain ATP World Tour Masters 1000,CLAY,2,Oscar Hernandez,Martin Vassallo Arguello,Oscar Hernandez,6-3; 6-3,R64,91,2,1,38,51,30,38,8,13,1,1,9,38,51,1,0,49,75,31,49,8,26,7,10,9,39,75
2009-05-10 00:00:00.000,ATP World Tour Masters 1000 Madrid Spain ATP World Tour Masters 1000,CLAY,2,Andreas Seppi,Eduardo Schwank,Andreas Seppi,7-5; 6-4,R64,107,2,0,54,80,33,54,16,26,9,11,11,49,80,1,4,34,59,21,34,15,25,0,4,11,36,59
2009-05-10 00:00:00.000,ATP World Tour Masters 1000 Madrid Spain ATP World Tour Masters 1000,CLAY,2,Sam Querrey,Radek Stepanek,Sam Querrey,7-6(2); 5-2 RET,R64,78,10,0,33,56,29,33,13,23,1,1,9,42,56,4,4,37,64,24,37,16,27,4,6,10,40,64
2009-05-10 00:00:00.000,ATP World Tour Masters 1000 Madrid Spain ATP World Tour Masters 1000,CLAY,2,Jo-Wilfried Tsonga,Marat Safin,Jo-Wilfried Tsonga,6-4; 7-5,R64,90,2,2,36,60,30,36,15,24,1,1,11,45,60,9,0,30,68,25,30,19,38,4,6,11,44,68
2009-05-10 00:00:00.000,ATP World Tour Masters 1000 Madrid Spain ATP World Tour Masters 1000,CLAY,2,Ivan Ljubicic,Teymuraz Gabashvili,Ivan Ljubicic,6-3; 6-2,R64,68,5,0,23,44,22,23,12,21,0,1,9,34,44,1,4,25,46,14,25,9,21,2,6,8,23,46
2009-05-10 00:00:00.000,ATP World Tour Masters 1000 Madrid Spain ATP World Tour Masters 1000,CLAY,2,Fabio Fognini,Paul-Henri Mathieu,Fabio Fognini,6-7(5); 6-4; 3-0 RET,R64,119,7,2,53,82,33,53,18,29,4,7,13,51,82,8,1,42,83,29,42,18,41,6,11,12,47,83
2009-05-10 00:00:00.000,ATP World Tour Masters 1000 Madrid Spain ATP World Tour Masters 1000,CLAY,2,Gilles Simon,N/A Bye,Gilles Simon,,R64,0,0,0,0,0,0,0,0,0,0,0,0,0,0,0,0,0,0,0,0,0,0,0,0,0,0,0
2009-05-10 00:00:00.000,ATP World Tour Masters 1000 Madrid Spain ATP World Tour Masters 1000,CLAY,2,Juan Martin Del Potro,N/A Bye,Juan Martin Del Potro,,R64,0,0,0,0,0,0,0,0,0,0,0,0,0,0,0,0,0,0,0,0,0,0,0,0,0,0,0
2009-05-10 00:00:00.000,ATP World Tour Masters 1000 Madrid Spain ATP World Tour Masters 1000,CLAY,2,Tomas Berdych,Guillermo Garcia-Lopez,Tomas Berdych,6-0; 7-6(5),R64,109,4,3,41,73,28,41,17,32,8,10,9,45,73,0,4,43,68,27,43,6,25,5,10,9,33,68
2009-05-10 00:00:00.000,ATP World Tour Masters 1000 Madrid Spain ATP World Tour Masters 1000,CLAY,2,Jeremy Chardy,Jose Acasuso,Jeremy Chardy,6-3; 6-2,R64,65,6,2,29,56,22,29,17,27,0,0,9,39,56,0,3,26,46,20,26,6,20,0,3,8,26,46
2009-05-10 00:00:00.000,ATP World Tour Masters 1000 Madrid Spain ATP World Tour Masters 1000,CLAY,2,Stanislas Wawrinka,Marco Crugnola,Stanislas Wawrinka,6-2; 6-0,R64,59,2,2,25,38,18,25,9,13,4,5,7,27,38,0,5,28,46,13,28,5,18,4,10,7,18,46
2009-05-10 00:00:00.000,ATP World Tour Masters 1000 Madrid Spain ATP World Tour Masters 1000,CLAY,2,Tommy Robredo,Nicolas Kiefer,Tommy Robredo,3-6; 6-2; 6-2,R64,119,5,2,49,77,33,49,17,28,5,7,12,50,77,5,6,42,79,30,42,14,37,1,6,13,44,79
2009-05-10 00:00:00.000,ATP World Tour Masters 1000 Madrid Spain ATP World Tour Masters 1000,CLAY,2,Mardy Fish,Janko Tipsarevic,Mardy Fish,7-6(3); 6-4,R64,125,10,1,39,67,29,39,19,28,1,2,11,48,67,7,2,43,72,28,43,17,29,3,5,11,45,72
2009-05-10 00:00:00.000,ATP World Tour Masters 1000 Madrid Spain ATP World Tour Masters 1000,CLAY,2,Simone Bolelli,Juan Ignacio Chela,Simone Bolelli,7-5; 7-6(3),R64,117,4,1,43,76,33,43,23,33,3,3,12,56,76,1,2,43,73,31,43,19,30,3,4,12,50,73
2009-05-10 00:00:00.000,ATP World Tour Masters 1000 Madrid Spain ATP World Tour Masters 1000,CLAY,2,Andy Murray,N/A Bye,Andy Murray,,R64,0,0,0,0,0,0,0,0,0,0,0,0,0,0,0,0,0,0,0,0,0,0,0,0,0,0,0
2009-05-10 00:00:00.000,ATP World Tour Masters 1000 Madrid Spain ATP World Tour Masters 1000,CLAY,2,Andy Roddick,N/A Bye,Andy Roddick,,R64,0,0,0,0,0,0,0,0,0,0,0,0,0,0,0,0,0,0,0,0,0,0,0,0,0,0,0
2009-05-10 00:00:00.000,ATP World Tour Masters 1000 Madrid Spain ATP World Tour Masters 1000,CLAY,2,Tommy Haas,Ernests Gulbis,Tommy Haas,6-2; 5-7; 7-5,R64,138,7,6,52,92,37,52,19,40,1,5,16,56,92,6,2,65,112,42,65,18,47,10,16,16,60,112
2009-05-10 00:00:00.000,ATP World Tour Masters 1000 Madrid Spain ATP World Tour Masters 1000,CLAY,2,Florent Serra,Rainer Schuettler,Florent Serra,6-2; 6-4,R64,64,2,2,41,57,32,41,8,16,3,3,9,40,57,1,3,31,53,18,31,12,22,0,3,9,30,53
2009-05-10 00:00:00.000,ATP World Tour Masters 1000 Madrid Spain ATP World Tour Masters 1000,CLAY,2,Nikolay Davydenko,Viktor Troicki,Nikolay Davydenko,6-2; 6-2,R64,79,2,2,48,61,32,48,6,13,4,5,8,38,61,5,1,22,50,13,22,10,28,2,7,8,23,50
2009-05-10 00:00:00.000,ATP World Tour Masters 1000 Madrid Spain ATP World Tour Masters 1000,CLAY,2,James Blake,Victor Hanescu,James Blake,6-2; 6-4,R64,68,3,1,29,53,23,29,12,24,1,2,9,35,53,7,3,41,59,25,41,6,18,6,10,9,31,59
2009-05-10 00:00:00.000,ATP World Tour Masters 1000 Madrid Spain ATP World Tour Masters 1000,CLAY,2,Ivo Karlovic,Julien Benneteau,Ivo Karlovic,3-6; 7-6(5); 6-4,R64,132,21,1,60,96,47,60,20,36,3,4,15,67,96,8,6,66,97,55,66,13,31,3,4,16,68,97
2009-05-10 00:00:00.000,ATP World Tour Masters 1000 Madrid Spain ATP World Tour Masters 1000,CLAY,2,Robin Soderling,Ivan Navarro,Robin Soderling,6-4; 6-2,R64,71,6,2,29,55,22,29,15,26,2,3,9,37,55,5,3,30,49,20,30,6,19,0,4,9,26,49
2009-05-10 00:00:00.000,ATP World Tour Masters 1000 Madrid Spain ATP World Tour Masters 1000,CLAY,2,Roger Federer,N/A Bye,Roger Federer,,R64,0,0,0,0,0,0,0,0,0,0,0,0,0,0,0,0,0,0,0,0,0,0,0,0,0,0,0
2009-05-10 00:00:00.000,ATP World Tour Masters 1000 Madrid Spain ATP World Tour Masters 1000,CLAY,2,Rafael Nadal,Jurgen Melzer,Rafael Nadal,6-3; 6-1,R32,62,1,0,24,41,21,24,11,17,0,0,8,32,41,3,4,22,41,15,22,7,19,0,4,8,22,41
2009-05-10 00:00:00.000,ATP World Tour Masters 1000 Madrid Spain ATP World Tour Masters 1000,CLAY,2,Philipp Kohlschreiber,Marin Cilic,Philipp Kohlschreiber,6-1; 6-7(5); 7-6(2),R32,175,4,2,85,122,57,85,22,37,7,8,16,79,122,7,3,71,123,48,71,24,52,15,18,15,72,123
2009-05-10 00:00:00.000,ATP World Tour Masters 1000 Madrid Spain ATP World Tour Masters 1000,CLAY,2,Juan Monaco,David Ferrer,Juan Monaco,6-4; 6-4,R32,90,1,2,44,55,30,44,7,11,3,5,10,37,55,2,4,42,70,26,42,12,28,6,10,10,38,70
2009-05-10 00:00:00.000,ATP World Tour Masters 1000 Madrid Spain ATP World Tour Masters 1000,CLAY,2,Fernando Verdasco,Juan Carlos Ferrero,Fernando Verdasco,6-3; 6-2,R32,96,4,1,52,67,32,52,7,15,5,7,9,39,67,2,0,35,54,20,35,5,19,1,6,8,25,54
2009-05-10 00:00:00.000,ATP World Tour Masters 1000 Madrid Spain ATP World Tour Masters 1000,CLAY,2,Novak Djokovic,Oscar Hernandez,Novak Djokovic,6-3; 6-3,R32,99,3,3,38,56,31,38,8,18,0,0,9,39,56,3,3,54,77,29,54,12,23,9,12,9,41,77
2009-05-10 00:00:00.000,ATP World Tour Masters 1000 Madrid Spain ATP World Tour Masters 1000,CLAY,2,Andreas Seppi,Sam Querrey,Andreas Seppi,6-3; 4-6; 6-4,R32,117,6,1,60,98,42,60,20,38,8,10,14,62,98,10,1,59,89,42,59,14,30,8,12,15,56,89
2009-05-10 00:00:00.000,ATP World Tour Masters 1000 Madrid Spain ATP World Tour Masters 1000,CLAY,2,Ivan Ljubicic,Jo-Wilfried Tsonga,Ivan Ljubicic,6-4; 7-5,R32,100,6,3,43,77,37,43,16,34,5,6,11,53,77,8,3,35,63,27,35,13,28,3,6,11,40,63
2009-05-10 00:00:00.000,ATP World Tour Masters 1000 Madrid Spain ATP World Tour Masters 1000,CLAY,2,Gilles Simon,Fabio Fognini,Gilles Simon,6-3; 6-2,R32,71,2,0,37,59,25,37,13,22,2,4,9,38,59,1,7,28,55,16,28,10,27,3,8,8,26,55
2009-05-10 00:00:00.000,ATP World Tour Masters 1000 Madrid Spain ATP World Tour Masters 1000,CLAY,2,Juan Martin Del Potro,Tomas Berdych,Juan Martin Del Potro,6-2; 4-1 RET,R32,69,3,0,21,30,16,21,8,9,0,0,6,24,30,1,0,36,59,22,36,6,23,6,10,7,28,59
2009-05-10 00:00:00.000,ATP World Tour Masters 1000 Madrid Spain ATP World Tour Masters 1000,CLAY,2,Stanislas Wawrinka,Jeremy Chardy,Stanislas Wawrinka,6-4; 7-5,R32,98,12,0,39,63,29,39,17,24,2,3,11,46,63,4,3,49,77,31,49,15,28,8,11,11,46,77
2009-05-10 00:00:00.000,ATP World Tour Masters 1000 Madrid Spain ATP World Tour Masters 1000,CLAY,2,Tommy Robredo,Mardy Fish,Tommy Robredo,3-6; 7-6(5); 6-2,R32,134,2,0,67,92,48,67,14,25,2,4,14,62,92,6,3,53,88,40,53,20,35,1,4,15,60,88
2009-05-10 00:00:00.000,ATP World Tour Masters 1000 Madrid Spain ATP World Tour Masters 1000,CLAY,2,Andy Murray,Simone Bolelli,Andy Murray,7-6(9); 6-4,R32,128,4,2,38,77,29,38,25,39,4,4,11,54,77,6,0,54,83,37,54,17,29,2,3,11,54,83
2009-05-10 00:00:00.000,ATP World Tour Masters 1000 Madrid Spain ATP World Tour Masters 1000,CLAY,2,Andy Roddick,Tommy Haas,Andy Roddick,1-6; 7-6(9); 6-4,R32,143,9,2,70,97,51,70,15,27,0,2,14,66,97,14,5,62,112,49,62,27,50,11,12,15,76,112
2009-05-10 00:00:00.000,ATP World Tour Masters 1000 Madrid Spain ATP World Tour Masters 1000,CLAY,2,Nikolay Davydenko,Florent Serra,Nikolay Davydenko,7-5; 6-3,R32,87,7,2,48,66,32,48,9,18,4,6,11,41,66,2,0,47,71,32,47,7,24,3,7,10,39,71
2009-05-10 00:00:00.000,ATP World Tour Masters 1000 Madrid Spain ATP World Tour Masters 1000,CLAY,2,James Blake,Ivo Karlovic,James Blake,6-7(4); 6-4; 7-6(4),R32,124,4,4,70,108,58,70,25,38,1,1,17,83,108,26,4,65,97,58,65,18,32,0,1,17,76,97
2009-05-10 00:00:00.000,ATP World Tour Masters 1000 Madrid Spain ATP World Tour Masters 1000,CLAY,2,Roger Federer,Robin Soderling,Roger Federer,6-1; 7-5,R32,70,11,1,27,54,23,27,17,27,0,1,10,40,54,4,5,34,57,21,34,9,23,3,7,9,30,57
2009-05-10 00:00:00.000,ATP World Tour Masters 1000 Madrid Spain ATP World Tour Masters 1000,CLAY,2,Rafael Nadal,Philipp Kohlschreiber,Rafael Nadal,W/O,R16,0,0,0,0,0,0,0,0,0,0,0,0,0,0,0,0,0,0,0,0,0,0,0,0,0,0,0
2009-05-10 00:00:00.000,ATP World Tour Masters 1000 Madrid Spain ATP World Tour Masters 1000,CLAY,2,Fernando Verdasco,Juan Monaco,Fernando Verdasco,7-5; 6-2,R16,108,2,1,51,71,31,51,11,20,2,4,10,42,71,0,1,52,68,24,52,8,16,5,10,10,32,68
2009-05-10 00:00:00.000,ATP World Tour Masters 1000 Madrid Spain ATP World Tour Masters 1000,CLAY,2,Novak Djokovic,Andreas Seppi,Novak Djokovic,6-4; 6-4,R16,98,3,2,37,57,29,37,11,20,1,2,10,40,57,3,1,56,77,33,56,11,21,8,11,10,44,77
2009-05-10 00:00:00.000,ATP World Tour Masters 1000 Madrid Spain ATP World Tour Masters 1000,CLAY,2,Ivan Ljubicic,Gilles Simon,Ivan Ljubicic,3-6; 6-4; 6-3,R16,130,5,3,58,101,39,58,23,43,10,12,14,62,101,11,1,43,74,35,43,17,31,2,5,14,52,74
2009-05-10 00:00:00.000,ATP World Tour Masters 1000 Madrid Spain ATP World Tour Masters 1000,CLAY,2,Juan Martin Del Potro,Stanislas Wawrinka,Juan Martin Del Potro,4-6; 6-4; 6-4,R16,176,5,3,55,110,40,55,26,55,9,13,15,66,110,8,1,59,92,40,59,13,33,4,9,15,53,92
2009-05-10 00:00:00.000,ATP World Tour Masters 1000 Madrid Spain ATP World Tour Masters 1000,CLAY,2,Andy Murray,Tommy Robredo,Andy Murray,7-5; 6-1,R16,104,0,2,39,60,29,39,13,21,2,2,9,42,60,1,2,47,70,28,47,10,23,8,12,10,38,70
2009-05-10 00:00:00.000,ATP World Tour Masters 1000 Madrid Spain ATP World Tour Masters 1000,CLAY,2,Andy Roddick,Nikolay Davydenko,Andy Roddick,W/O,R16,0,0,0,0,0,0,0,0,0,0,0,0,0,0,0,0,0,0,0,0,0,0,0,0,0,0,0
2009-05-10 00:00:00.000,ATP World Tour Masters 1000 Madrid Spain ATP World Tour Masters 1000,CLAY,2,Roger Federer,James Blake,Roger Federer,6-2; 6-4,R16,62,5,0,31,54,27,31,13,23,1,1,9,40,54,1,5,28,54,17,28,16,26,1,4,9,33,54
2009-05-10 00:00:00.000,ATP World Tour Masters 1000 Madrid Spain ATP World Tour Masters 1000,CLAY,2,Rafael Nadal,Fernando Verdasco,Rafael Nadal,6-4; 7-5,Q,119,1,1,59,76,37,59,10,17,3,5,11,47,76,5,7,44,62,26,44,7,18,5,9,11,33,62
2009-05-10 00:00:00.000,ATP World Tour Masters 1000 Madrid Spain ATP World Tour Masters 1000,CLAY,2,Novak Djokovic,Ivan Ljubicic,Novak Djokovic,6-4; 6-4,Q,105,5,1,39,61,30,39,14,22,2,2,10,44,61,3,0,34,72,23,34,23,38,5,7,10,46,72
2009-05-10 00:00:00.000,ATP World Tour Masters 1000 Madrid Spain ATP World Tour Masters 1000,CLAY,2,Juan Martin Del Potro,Andy Murray,Juan Martin Del Potro,7-6(4); 6-3,Q,112,5,2,42,76,30,42,23,34,4,5,11,53,76,11,1,36,62,24,36,15,26,2,4,10,39,62
2009-05-10 00:00:00.000,ATP World Tour Masters 1000 Madrid Spain ATP World Tour Masters 1000,CLAY,2,Roger Federer,Andy Roddick,Roger Federer,7-5; 6-7(5); 6-1,Q,131,15,2,56,97,49,56,20,41,2,3,16,69,97,9,1,61,91,42,61,16,30,5,9,15,58,91
2009-05-10 00:00:00.000,ATP World Tour Masters 1000 Madrid Spain ATP World Tour Masters 1000,CLAY,2,Rafael Nadal,Novak Djokovic,Rafael Nadal,3-6; 7-6(5); 7-6(9),S,243,4,4,101,133,72,101,16,32,6,8,16,88,133,7,3,69,112,56,69,24,43,1,2,17,80,112
2009-05-10 00:00:00.000,ATP World Tour Masters 1000 Madrid Spain ATP World Tour Masters 1000,CLAY,2,Roger Federer,Juan Martin Del Potro,Roger Federer,6-3; 6-4,S,81,8,1,39,60,32,39,11,21,4,4,10,43,60,3,2,35,59,25,35,11,24,4,6,9,36,59
2009-05-10 00:00:00.000,ATP World Tour Masters 1000 Madrid Spain ATP World Tour Masters 1000,CLAY,2,Roger Federer,Rafael Nadal,Roger Federer,6-4; 6-4,F,86,6,3,42,67,29,42,17,25,4,4,10,46,67,1,1,43,54,32,43,5,11,0,2,10,37,54
2009-05-17 00:00:00.000,Kitzbnhel Austria ATP World Tour 250,CLAY,2,Diego Junqueira,Paul Capdeville,Diego Junqueira,6-3; 6-2,R32,51,7,3,28,53,24,28,12,25,1,2,9,36,53,0,0,31,41,16,31,6,10,0,4,8,22,41
2009-05-17 00:00:00.000,Kitzbnhel Austria ATP World Tour 250,CLAY,2,Daniel Koellerer,Thomaz Bellucci,Daniel Koellerer,6-4; 6-4,R32,107,1,1,54,73,34,54,9,19,2,4,10,43,73,7,3,39,62,25,39,9,23,6,10,10,34,62
2009-05-17 00:00:00.000,Kitzbnhel Austria ATP World Tour 250,CLAY,2,Nicolas Massu,Robin Vik,Nicolas Massu,6-4; 6-2,R32,108,2,3,48,84,32,48,18,36,8,9,9,50,84,0,3,33,46,20,33,5,13,1,5,9,25,46
2009-05-17 00:00:00.000,Kitzbnhel Austria ATP World Tour 250,CLAY,2,Julien Benneteau,Dudi Sela,Julien Benneteau,7-5; 6-1,R32,81,5,2,36,59,28,36,13,23,3,4,10,41,59,1,2,30,60,18,30,13,30,2,6,9,31,60
2009-05-17 00:00:00.000,Kitzbnhel Austria ATP World Tour 250,CLAY,2,Oscar Hernandez,Fabrice Santoro,Oscar Hernandez,6-2; 6-3,R32,59,1,1,31,39,26,31,6,8,0,0,8,32,39,1,1,29,48,15,29,10,19,0,4,9,25,48
2009-05-17 00:00:00.000,Kitzbnhel Austria ATP World Tour 250,CLAY,2,Andreas Beck,Jan Hernych,Andreas Beck,5-7; 6-3; 7-5,R32,137,3,5,44,92,32,44,28,48,3,5,16,60,92,2,4,61,102,37,61,23,41,5,9,17,60,102
2009-05-17 00:00:00.000,Kitzbnhel Austria ATP World Tour 250,CLAY,2,Ruben Ramirez Hidalgo,Mario Ancic,Ruben Ramirez Hidalgo,6-4; 6-3,R32,89,2,3,30,51,26,30,13,21,4,4,9,39,51,4,1,38,61,25,38,12,23,3,6,10,37,61
2009-05-17 00:00:00.000,Kitzbnhel Austria ATP World Tour 250,CLAY,2,Juan Ignacio Chela,Marc Gicquel,Juan Ignacio Chela,5-7; 6-3; 6-0,R32,133,4,2,58,91,37,58,16,33,6,11,14,53,91,2,4,51,94,29,51,14,43,5,13,13,43,94
2009-05-17 00:00:00.000,Kitzbnhel Austria ATP World Tour 250,CLAY,2,Martin Vassallo Arguello,Christophe Rochus,Martin Vassallo Arguello,6-2; 6-4,R32,80,5,1,34,55,23,34,13,21,2,3,9,36,55,0,3,21,52,15,21,12,31,5,9,9,27,52
2009-05-17 00:00:00.000,Kitzbnhel Austria ATP World Tour 250,CLAY,2,Guillermo Garcia-Lopez,Bjorn Phau,Guillermo Garcia-Lopez,6-3; 6-2,R32,80,2,1,29,39,24,29,6,10,2,3,8,30,39,1,6,40,74,23,40,12,34,5,10,9,35,74
2009-05-17 00:00:00.000,Kitzbnhel Austria ATP World Tour 250,CLAY,2,Marcel Granollers,Teymuraz Gabashvili,Marcel Granollers,7-6(11); 6-3,R32,134,3,4,45,87,33,45,21,42,7,9,11,54,87,2,9,39,82,24,39,19,43,3,6,10,43,82
2009-05-17 00:00:00.000,Kitzbnhel Austria ATP World Tour 250,CLAY,2,Victor Hanescu,Nicolas Lapentti,Victor Hanescu,6-7(6); 6-3; 7-5,R32,166,5,2,63,90,49,63,19,27,2,3,16,68,90,2,4,76,123,50,76,25,47,10,14,17,75,123
2009-05-17 00:00:00.000,Kitzbnhel Austria ATP World Tour 250,CLAY,2,Mikhail Youzhny,Daniel Gimeno-Traver,Mikhail Youzhny,6-2; 7-6(7),R32,94,5,1,50,70,36,50,15,20,5,5,10,51,70,4,6,56,81,36,56,12,25,5,7,10,48,81
2009-05-17 00:00:00.000,Kitzbnhel Austria ATP World Tour 250,CLAY,2,Stefan Koubek,Philipp Petzschner,Stefan Koubek,7-6(8); 6-4,R32,92,3,5,30,68,23,30,25,38,0,1,11,48,68,6,1,35,86,29,35,24,51,4,6,11,53,86
2009-05-17 00:00:00.000,Kitzbnhel Austria ATP World Tour 250,CLAY,2,Agustin Calleri,Yen-Hsun Lu,Agustin Calleri,3-6; 7-5; 0-1 RET,R32,98,5,7,42,79,29,42,19,37,7,10,11,48,79,8,4,37,68,30,37,14,31,2,4,11,44,68
2009-05-17 00:00:00.000,Kitzbnhel Austria ATP World Tour 250,CLAY,2,Jurgen Melzer,Frederico Gil,Jurgen Melzer,6-3; 6-0,R32,54,5,2,20,37,16,20,13,17,1,2,8,29,37,1,1,37,54,13,37,10,17,5,10,7,23,54
2009-05-17 00:00:00.000,Kitzbnhel Austria ATP World Tour 250,CLAY,2,Daniel Koellerer,Diego Junqueira,Daniel Koellerer,6-1; 6-2,R16,63,2,0,25,40,23,25,10,15,1,1,8,33,40,1,4,30,50,16,30,9,20,4,8,7,25,50
2009-05-17 00:00:00.000,Kitzbnhel Austria ATP World Tour 250,CLAY,2,Julien Benneteau,Nicolas Massu,Julien Benneteau,6-1; 6-7(4); 7-6(7),R16,187,13,8,80,118,55,80,16,38,5,9,16,71,118,2,3,76,110,46,76,13,34,9,15,15,59,110
2009-05-17 00:00:00.000,Kitzbnhel Austria ATP World Tour 250,CLAY,2,Oscar Hernandez,Andreas Beck,Oscar Hernandez,7-5; 6-4,R16,128,6,5,47,77,35,47,16,30,7,8,11,51,77,4,1,47,76,32,47,14,29,9,12,11,46,76
2009-05-17 00:00:00.000,Kitzbnhel Austria ATP World Tour 250,CLAY,2,Juan Ignacio Chela,Ruben Ramirez Hidalgo,Juan Ignacio Chela,6-3; 6-2,R16,102,2,4,30,47,29,30,7,17,0,0,9,36,47,1,7,50,86,30,50,15,36,11,14,8,45,86
2009-05-17 00:00:00.000,Kitzbnhel Austria ATP World Tour 250,CLAY,2,Guillermo Garcia-Lopez,Martin Vassallo Arguello,Guillermo Garcia-Lopez,4-6; 6-4; 6-3,R16,186,0,2,50,90,39,50,25,40,5,6,15,64,90,2,2,54,83,36,54,18,29,5,7,14,54,83
2009-05-17 00:00:00.000,Kitzbnhel Austria ATP World Tour 250,CLAY,2,Victor Hanescu,Marcel Granollers,Victor Hanescu,6-1; 7-6(2),R16,84,5,0,40,62,28,40,18,22,2,2,10,46,62,3,2,29,58,22,29,13,29,0,2,9,35,58
2009-05-17 00:00:00.000,Kitzbnhel Austria ATP World Tour 250,CLAY,2,Mikhail Youzhny,Stefan Koubek,Mikhail Youzhny,6-2; 6-4,R16,89,4,2,23,49,18,23,16,26,4,5,9,34,49,2,1,25,68,21,25,15,43,6,10,9,36,68
2009-05-17 00:00:00.000,Kitzbnhel Austria ATP World Tour 250,CLAY,2,Jurgen Melzer,Agustin Calleri,Jurgen Melzer,6-4; 7-5,R16,87,5,5,39,65,31,39,13,26,3,4,11,44,65,3,3,38,71,24,38,18,33,8,11,11,42,71
2009-05-17 00:00:00.000,Kitzbnhel Austria ATP World Tour 250,CLAY,2,Julien Benneteau,Daniel Koellerer,Julien Benneteau,6-2; 6-7(5); 6-0,Q,151,9,4,62,91,49,62,12,29,4,4,13,61,91,3,3,74,96,44,74,11,22,7,12,13,55,96
2009-05-17 00:00:00.000,Kitzbnhel Austria ATP World Tour 250,CLAY,2,Oscar Hernandez,Juan Ignacio Chela,Oscar Hernandez,6-4; 6-4,Q,95,2,0,44,57,32,44,9,13,1,1,10,41,57,2,3,53,73,38,53,7,20,7,9,10,45,73
2009-05-17 00:00:00.000,Kitzbnhel Austria ATP World Tour 250,CLAY,2,Guillermo Garcia-Lopez,Victor Hanescu,Guillermo Garcia-Lopez,6-2; 6-2,Q,81,0,3,32,55,24,32,12,23,5,6,8,36,55,2,1,33,48,19,33,3,15,3,8,8,22,48
2009-05-17 00:00:00.000,Kitzbnhel Austria ATP World Tour 250,CLAY,2,Mikhail Youzhny,Jurgen Melzer,Mikhail Youzhny,6-4; 6-4,Q,88,5,2,38,63,31,38,11,25,0,1,10,42,63,3,2,32,59,21,32,13,27,1,4,10,34,59
2009-05-17 00:00:00.000,Kitzbnhel Austria ATP World Tour 250,CLAY,2,Julien Benneteau,Oscar Hernandez,Julien Benneteau,6-3; 6-4,S,89,4,6,40,66,30,40,14,26,4,5,10,44,66,4,0,35,48,24,35,6,13,2,5,9,30,48
2009-05-17 00:00:00.000,Kitzbnhel Austria ATP World Tour 250,CLAY,2,Guillermo Garcia-Lopez,Mikhail Youzhny,Guillermo Garcia-Lopez,6-3; 1-6; 7-6(5),S,143,1,7,65,95,46,65,17,30,2,4,14,63,95,5,2,56,87,44,56,17,31,1,2,14,61,87
2009-05-17 00:00:00.000,Kitzbnhel Austria ATP World Tour 250,CLAY,2,Guillermo Garcia-Lopez,Julien Benneteau,Guillermo Garcia-Lopez,3-6; 7-6(1); 6-3,F,190,0,8,73,103,46,73,13,30,4,8,14,59,103,6,9,84,119,54,84,11,35,13,18,16,65,119
2009-05-25 00:00:00.000,Roland Garros France Grand Slams,CLAY,3,Rafael Nadal,Marcos Daniel,Rafael Nadal,7-5; 6-4; 6-3,R128,143,3,0,62,82,42,62,13,20,4,7,15,55,82,4,1,52,93,32,52,17,41,4,11,16,49,93
2009-05-25 00:00:00.000,Roland Garros France Grand Slams,CLAY,3,Teymuraz Gabashvili,Igor Kunitsyn,Teymuraz Gabashvili,6-7(6); 7-6(5); 6-3; 6-1,R128,191,12,4,87,128,54,87,25,41,3,7,20,79,128,3,1,86,129,47,86,23,43,4,12,20,70,129
2009-05-25 00:00:00.000,Roland Garros France Grand Slams,CLAY,3,Andrey Golubev,Denis Gremelmayr,Andrey Golubev,6-3; 6-3; 6-2,R128,98,7,4,40,71,33,40,21,31,2,3,13,54,71,4,3,54,83,32,54,10,29,1,7,13,42,83
2009-05-25 00:00:00.000,Roland Garros France Grand Slams,CLAY,3,Lleyton Hewitt,Ivo Karlovic,Lleyton Hewitt,6-7(1); 6-7(4); 7-6(4); 6-4; 6-3,R128,236,19,6,93,173,76,93,49,80,5,6,27,125,173,55,4,124,169,102,124,20,45,4,8,28,122,169
2009-05-25 00:00:00.000,Roland Garros France Grand Slams,CLAY,3,Robin Soderling,Kevin Kim,Robin Soderling,7-6(4); 7-6(4); 6-2,R128,137,11,4,52,99,41,52,25,47,3,7,16,66,99,10,3,56,112,40,56,23,56,7,13,16,63,112
2009-05-25 00:00:00.000,Roland Garros France Grand Slams,CLAY,3,Denis Istomin,Santiago Giraldo,Denis Istomin,6-3; 6-7(2); 6-3; 7-6(4),R128,205,21,2,96,142,74,96,23,46,1,3,22,97,142,5,2,86,158,60,86,40,72,11,15,20,100,158
2009-05-25 00:00:00.000,Roland Garros France Grand Slams,CLAY,3,Nicolas Kiefer,Ilija Bozoljac,Nicolas Kiefer,7-6(4); 3-6; 7-5; 6-4,R128,193,16,3,64,124,53,64,34,60,5,7,21,87,124,22,10,76,144,59,76,32,68,8,11,22,91,144
2009-05-25 00:00:00.000,Roland Garros France Grand Slams,CLAY,3,David Ferrer,Frederico Gil,David Ferrer,6-2; 6-4; 6-4,R128,127,3,1,51,85,36,51,22,34,2,4,14,58,85,2,2,54,91,33,54,15,37,3,9,14,48,91
2009-05-25 00:00:00.000,Roland Garros France Grand Slams,CLAY,3,Nikolay Davydenko,Stefan Koubek,Nikolay Davydenko,6-2; 6-1; 6-4,R128,100,3,4,40,66,32,40,16,26,1,2,12,48,66,2,3,51,92,25,51,21,41,10,17,13,46,92
2009-05-25 00:00:00.000,Roland Garros France Grand Slams,CLAY,3,Diego Junqueira,Paul Capdeville,Diego Junqueira,3-6; 7-5; 6-1; 6-3,R128,155,2,3,84,114,57,84,13,30,5,10,18,70,114,7,7,75,117,47,75,17,42,4,13,19,64,117
2009-05-25 00:00:00.000,Roland Garros France Grand Slams,CLAY,3,Nicolas Massu,Daniel Koellerer,Nicolas Massu,6-3; 6-4; 1-6; 2-6; 6-3,R128,223,5,5,92,155,63,92,32,63,11,16,22,95,155,6,5,78,117,55,78,23,39,6,10,21,78,117
2009-05-25 00:00:00.000,Roland Garros France Grand Slams,CLAY,3,Stanislas Wawrinka,Nicolas Devilder,Stanislas Wawrinka,6-3; 5-7; 2-6; 6-4; 6-4,R128,239,6,3,94,133,69,94,15,39,6,13,24,84,133,2,5,113,180,71,113,28,67,15,23,25,99,180
2009-05-25 00:00:00.000,Roland Garros France Grand Slams,CLAY,3,Nicolas Almagro,Agustin Calleri,Nicolas Almagro,6-4; 6-1; 6-3,R128,89,11,1,35,62,31,35,21,27,0,0,13,52,62,5,4,33,69,26,33,15,36,4,9,13,41,69
2009-05-25 00:00:00.000,Roland Garros France Grand Slams,CLAY,3,Ernests Gulbis,Sam Querrey,Ernests Gulbis,7-6(1); 6-1; 3-6; 6-1,R128,106,26,0,59,90,52,59,21,31,0,1,18,73,90,15,3,65,97,47,65,15,32,2,6,17,62,97
2009-05-25 00:00:00.000,Roland Garros France Grand Slams,CLAY,3,Philipp Petzschner,Peter Polansky,Philipp Petzschner,5-7; 6-2; 7-6(4); 4-6; 6-3,R128,222,10,7,96,168,68,96,44,72,7,11,26,112,168,10,10,99,167,74,99,32,68,6,11,25,106,167
2009-05-25 00:00:00.000,Roland Garros France Grand Slams,CLAY,3,Fernando Verdasco,Florent Serra,Fernando Verdasco,6-2; 6-1; 6-4,R128,131,15,2,60,84,45,60,12,24,6,7,13,57,84,2,1,70,112,42,70,14,42,22,28,12,56,112
2009-05-25 00:00:00.000,Roland Garros France Grand Slams,CLAY,3,Andy Murray,Juan Ignacio Chela,Andy Murray,6-2; 6-2; 6-1,R128,103,10,3,48,84,34,48,20,36,8,10,12,54,84,1,4,42,73,19,42,11,31,8,16,11,30,73
2009-05-25 00:00:00.000,Roland Garros France Grand Slams,CLAY,3,Potito Starace,Mischa Zverev,Potito Starace,6-7(5); 7-5; 1-0 RET,R128,129,3,2,64,81,41,64,11,17,2,4,13,52,81,5,2,57,87,37,57,13,30,9,12,12,50,87
2009-05-25 00:00:00.000,Roland Garros France Grand Slams,CLAY,3,Janko Tipsarevic,Albert Montanes,Janko Tipsarevic,3-6; 7-6(3); 7-6(5); 6-4,R128,220,18,2,86,135,65,86,29,49,0,3,22,94,135,16,4,85,146,69,85,29,61,9,11,21,98,146
2009-05-25 00:00:00.000,Roland Garros France Grand Slams,CLAY,3,Feliciano Lopez,Franco Ferreiro,Feliciano Lopez,6-7(3); 4-6; 7-6(4); 7-5; 6-2,R128,258,30,1,110,174,83,110,41,64,7,9,27,124,174,11,5,137,186,96,137,28,49,6,10,27,124,186
2009-05-25 00:00:00.000,Roland Garros France Grand Slams,CLAY,3,Radek Stepanek,Gaston Gaudio,Radek Stepanek,6-3; 6-4; 6-1,R128,112,5,3,43,76,34,43,18,33,0,1,13,52,76,4,2,57,83,33,57,12,26,5,11,13,45,83
2009-05-25 00:00:00.000,Roland Garros France Grand Slams,CLAY,3,Mathieu Montcourt,Yen-Hsun Lu,Mathieu Montcourt,6-2 RET,R128,40,1,3,14,28,8,14,9,14,1,2,4,17,28,0,2,17,31,7,17,6,14,4,7,4,13,31
2009-05-25 00:00:00.000,Roland Garros France Grand Slams,CLAY,3,Dudi Sela,Jean-Rene Lisnard,Dudi Sela,6-4; 6-3; 4-6; 6-3,R128,172,9,1,77,109,52,77,21,32,5,8,19,73,109,6,8,70,128,49,70,28,58,8,14,19,77,128
2009-05-25 00:00:00.000,Roland Garros France Grand Slams,CLAY,3,Marin Cilic,Jan Hernych,Marin Cilic,6-0; 6-4; 6-3,R128,154,6,3,43,80,34,43,23,37,5,6,13,57,80,4,3,82,133,48,82,19,51,21,27,12,67,133
2009-05-25 00:00:00.000,Roland Garros France Grand Slams,CLAY,3,Fernando Gonzalez,Jiri Vanek,Fernando Gonzalez,6-3; 6-2; 6-3,R128,85,18,0,34,62,30,34,24,28,1,1,13,54,62,4,6,51,88,34,51,13,37,6,11,13,47,88
2009-05-25 00:00:00.000,Roland Garros France Grand Slams,CLAY,3,Rui Machado,Kristof Vliegen,Rui Machado,6-2; 6-4; 4-6; 2-6; 6-3,R128,201,3,3,104,151,71,104,26,47,12,16,23,97,151,10,5,80,139,57,80,29,59,10,15,22,86,139
2009-05-25 00:00:00.000,Roland Garros France Grand Slams,CLAY,3,Josselin Ouanna,Marcel Granollers,Josselin Ouanna,7-5; 2-6; 3-6; 7-6(2); 6-1,R128,222,13,3,98,152,70,98,28,54,7,11,23,98,152,3,5,106,149,74,106,21,43,6,11,25,95,149
2009-05-25 00:00:00.000,Roland Garros France Grand Slams,CLAY,3,Marat Safin,Alexandre Sidorenko,Marat Safin,6-4; 6-4; 6-4,R128,137,6,2,52,92,38,52,24,40,5,7,15,62,92,4,5,54,108,39,54,20,54,7,12,15,59,108
2009-05-25 00:00:00.000,Roland Garros France Grand Slams,CLAY,3,Victor Hanescu,Steve Darcis,Victor Hanescu,7-6(8); 7-6(5); 7-6(3),R128,177,11,3,96,140,73,96,23,44,12,14,18,96,140,9,7,77,138,60,77,26,61,12,14,18,86,138
2009-05-25 00:00:00.000,Roland Garros France Grand Slams,CLAY,3,Mikhail Youzhny,Gilles Muller,Mikhail Youzhny,7-6(2); 6-1; 6-4,R128,112,6,2,53,77,47,53,18,24,0,0,15,65,77,9,1,57,90,38,57,17,33,5,8,14,55,90
2009-05-25 00:00:00.000,Roland Garros France Grand Slams,CLAY,3,Robert Kendrick,Daniel Brands,Robert Kendrick,6-7(7); 7-5; 7-6(11); 4-6; 6-3,R128,227,35,6,117,198,98,117,44,81,8,9,28,142,198,22,6,115,175,94,115,33,60,5,7,27,127,175
2009-05-25 00:00:00.000,Roland Garros France Grand Slams,CLAY,3,Gilles Simon,Wayne Odesnik,Gilles Simon,3-6; 7-5; 6-2; 4-6; 6-3,R128,223,14,2,77,145,55,77,42,68,10,13,24,97,145,7,0,110,150,70,110,24,40,9,14,24,94,150
2009-05-25 00:00:00.000,Roland Garros France Grand Slams,CLAY,3,Juan Martin Del Potro,Michael Llodra,Juan Martin Del Potro,6-3; 6-3; 6-1,R128,91,7,1,44,64,38,44,12,20,0,0,12,50,64,3,2,59,84,31,59,12,25,4,10,13,43,84
2009-05-25 00:00:00.000,Roland Garros France Grand Slams,CLAY,3,Viktor Troicki,Lukasz Kubot,Viktor Troicki,3-6; 6-3; 6-4; 6-7(4); 6-3,R128,238,13,4,107,166,80,107,27,59,11,14,25,107,166,5,3,105,170,73,105,34,65,15,20,24,107,170
2009-05-25 00:00:00.000,Roland Garros France Grand Slams,CLAY,3,Martin Vassallo Arguello,Thomaz Bellucci,Martin Vassallo Arguello,6-4; 6-7(4); 5-5 RET,R128,160,2,1,81,104,55,81,14,23,7,9,16,69,104,6,2,58,94,40,58,22,36,3,6,16,62,94
2009-05-25 00:00:00.000,Roland Garros France Grand Slams,CLAY,3,Igor Andreev,Fabio Fognini,Igor Andreev,1-6; 6-3; 6-1; 3-6; 7-5,R128,192,4,4,90,133,63,90,23,43,7,13,22,86,133,6,11,87,145,57,87,26,58,6,13,22,83,145
2009-05-25 00:00:00.000,Roland Garros France Grand Slams,CLAY,3,Arnaud Clement,Dmitry Tursunov,Arnaud Clement,6-3; 3-6; 6-4; 6-1,R128,175,10,3,68,123,48,68,26,55,13,17,17,74,123,9,9,73,127,47,73,18,54,9,17,18,65,127
2009-05-25 00:00:00.000,Roland Garros France Grand Slams,CLAY,3,Christophe Rochus,Fabrice Santoro,Christophe Rochus,6-3; 6-1; 3-6; 6-4,R128,162,1,0,95,128,63,95,12,33,9,14,18,75,128,11,4,59,113,36,59,22,54,7,15,17,58,113
2009-05-25 00:00:00.000,Roland Garros France Grand Slams,CLAY,3,Juan Monaco,Marcos Baghdatis,Juan Monaco,6-3; 6-2; 6-4,R128,116,2,1,63,83,41,63,14,20,1,3,14,55,83,4,2,37,82,24,37,20,45,5,11,13,44,82
2009-05-25 00:00:00.000,Roland Garros France Grand Slams,CLAY,3,Jo-Wilfried Tsonga,Julien Benneteau,Jo-Wilfried Tsonga,6-4; 3-6; 6-3; 6-4,R128,163,6,2,81,109,57,81,16,28,3,6,19,73,109,2,2,92,123,59,92,14,31,6,11,19,73,123
2009-05-25 00:00:00.000,Roland Garros France Grand Slams,CLAY,3,Tommy Robredo,Adrian Mannarino,Tommy Robredo,6-2; 6-1; 6-2,R128,98,5,3,44,71,28,44,15,27,5,8,11,43,71,1,7,44,85,23,44,9,41,13,23,12,32,85
2009-05-25 00:00:00.000,Roland Garros France Grand Slams,CLAY,3,Daniel Gimeno-Traver,Evgeny Korolev,Daniel Gimeno-Traver,6-4 RET,R128,36,5,0,22,30,19,22,3,8,4,4,5,22,30,0,1,17,31,13,17,6,14,1,2,5,19,31
2009-05-25 00:00:00.000,Roland Garros France Grand Slams,CLAY,3,Andreas Seppi,Guillermo Garcia-Lopez,Andreas Seppi,6-3; 6-3; 6-1,R128,108,6,0,48,71,38,48,8,23,4,6,12,46,71,2,1,59,86,27,59,13,27,7,15,13,40,86
2009-05-25 00:00:00.000,Roland Garros France Grand Slams,CLAY,3,Maximo Gonzalez,Mardy Fish,Maximo Gonzalez,6-3; 1-6; 6-4; 7-6(4),R128,167,1,1,73,112,49,73,22,39,6,11,19,71,112,10,2,71,123,49,71,26,52,8,13,19,75,123
2009-05-25 00:00:00.000,Roland Garros France Grand Slams,CLAY,3,Philipp Kohlschreiber,Bernard Tomic,Philipp Kohlschreiber,6-1; 6-2; 6-2,R128,72,5,1,40,60,32,40,12,20,2,3,11,44,60,1,5,38,66,15,38,11,28,5,13,12,26,66
2009-05-25 00:00:00.000,Roland Garros France Grand Slams,CLAY,3,Juan Carlos Ferrero,Ivan Ljubicic,Juan Carlos Ferrero,2-6; 6-4; 6-4; 3-6; 6-3,R128,197,5,3,112,138,75,112,15,26,8,12,23,90,138,19,2,77,136,59,77,30,59,6,10,23,89,136
2009-05-25 00:00:00.000,Roland Garros France Grand Slams,CLAY,3,Sergiy Stakhovsky,Brian Dabul,Sergiy Stakhovsky,4-6; 7-5; 7-6(2); 6-3,R128,187,13,4,78,133,55,78,36,55,2,5,21,91,133,2,2,109,137,74,109,12,28,5,10,22,86,137
2009-05-25 00:00:00.000,Roland Garros France Grand Slams,CLAY,3,Novak Djokovic,Nicolas Lapentti,Novak Djokovic,6-3; 3-1 RET,R128,78,1,0,28,42,23,28,9,14,0,0,7,32,42,0,1,38,58,23,38,8,20,5,7,6,31,58
2009-05-25 00:00:00.000,Roland Garros France Grand Slams,CLAY,3,Andy Roddick,Romain Jouan,Andy Roddick,6-2; 6-4; 6-2,R128,94,11,1,48,62,41,48,11,14,0,0,13,52,62,7,0,41,74,25,41,18,33,4,9,13,43,74
2009-05-25 00:00:00.000,Roland Garros France Grand Slams,CLAY,3,Ivo Minar,Oscar Hernandez,Ivo Minar,6-3; 7-6(4); 6-3,R128,125,9,4,58,104,47,58,26,46,6,7,16,73,104,10,0,68,98,44,68,17,30,6,9,14,61,98
2009-05-25 00:00:00.000,Roland Garros France Grand Slams,CLAY,3,Andreas Beck,Ivan Navarro,Andreas Beck,7-6(9); 6-4; 6-1,R128,138,2,0,51,80,44,51,23,29,1,1,14,67,80,10,1,71,107,50,71,16,36,3,7,15,66,107
2009-05-25 00:00:00.000,Roland Garros France Grand Slams,CLAY,3,Marc Gicquel,Rainer Schuettler,Marc Gicquel,6-0; 6-0; 6-4,R128,98,5,1,38,65,28,38,17,27,6,7,11,45,65,0,3,50,84,27,50,11,34,3,11,11,38,84
2009-05-25 00:00:00.000,Roland Garros France Grand Slams,CLAY,3,Jurgen Melzer,Sergio Roitman,Jurgen Melzer,6-4; 7-6(4); 6-0,R128,137,10,3,58,95,42,58,25,37,4,5,14,67,95,3,0,74,112,46,74,17,38,10,15,14,63,112
2009-05-25 00:00:00.000,Roland Garros France Grand Slams,CLAY,3,Guillaume Rufin,Eduardo Schwank,Guillaume Rufin,6-1; 6-3; 6-3,R128,113,7,2,47,78,36,47,19,31,2,2,13,55,78,1,4,44,76,27,44,13,32,3,8,12,40,76
2009-05-25 00:00:00.000,Roland Garros France Grand Slams,CLAY,3,Victor Crivoi,Simon Greul,Victor Crivoi,6-1; 7-6(1); 6-2,R128,107,6,1,49,81,44,49,15,32,0,1,14,59,81,8,1,64,90,38,64,10,26,8,13,13,48,90
2009-05-25 00:00:00.000,Roland Garros France Grand Slams,CLAY,3,Gael Monfils,Bobby Reynolds,Gael Monfils,6-2; 6-3; 6-1,R128,89,5,0,42,67,35,42,17,25,2,2,12,52,67,2,3,55,80,29,55,11,25,0,6,12,40,80
2009-05-25 00:00:00.000,Roland Garros France Grand Slams,CLAY,3,Leonardo Mayer,James Blake,Leonardo Mayer,7-6(6); 7-5; 6-2,R128,128,5,2,58,87,51,58,22,29,4,4,16,73,87,3,2,66,127,49,66,30,61,13,16,16,79,127
2009-05-25 00:00:00.000,Roland Garros France Grand Slams,CLAY,3,Tommy Haas,Andrei Pavel,Tommy Haas,6-1; 6-4; 6-4,R128,97,9,3,54,76,48,54,10,22,2,2,14,58,76,3,1,64,94,35,64,19,30,11,15,13,54,94
2009-05-25 00:00:00.000,Roland Garros France Grand Slams,CLAY,3,Jeremy Chardy,Thiago Alves,Jeremy Chardy,6-2; 7-6(10); 6-3,R128,115,21,5,58,90,47,58,16,32,3,6,15,63,90,1,4,59,86,36,59,15,27,4,10,14,51,86
2009-05-25 00:00:00.000,Roland Garros France Grand Slams,CLAY,3,Simone Bolelli,Tomas Berdych,Simone Bolelli,6-4; 6-4; 5-7; 4-6; 6-3,R128,210,10,3,95,141,68,95,28,46,2,6,25,96,141,18,4,86,143,62,86,31,57,1,7,26,93,143
2009-05-25 00:00:00.000,Roland Garros France Grand Slams,CLAY,3,Paul-Henri Mathieu,Laurent Recouderc,Paul-Henri Mathieu,6-4; 6-4; 6-1,R128,116,9,1,40,74,35,40,18,34,0,1,13,53,74,4,4,33,86,22,33,25,53,6,12,14,47,86
2009-05-25 00:00:00.000,Roland Garros France Grand Slams,CLAY,3,Pablo Andujar,Robby Ginepri,Pablo Andujar,6-4; 7-6(7); 7-6(3),R128,189,4,7,70,131,50,70,33,61,8,11,17,83,131,3,3,76,125,47,76,24,49,4,8,17,71,125
2009-05-25 00:00:00.000,Roland Garros France Grand Slams,CLAY,3,Jose Acasuso,Santiago Ventura,Jose Acasuso,3-6; 7-6(5); 6-0; 6-3,R128,161,14,4,64,98,47,64,18,34,4,7,17,65,98,6,4,78,140,51,78,25,62,8,15,19,76,140
2009-05-25 00:00:00.000,Roland Garros France Grand Slams,CLAY,3,Roger Federer,Alberto Martin,Roger Federer,6-4; 6-3; 6-2,R128,103,10,0,51,75,40,51,16,24,0,1,14,56,75,0,3,56,87,34,56,13,31,5,10,13,47,87
2009-05-25 00:00:00.000,Roland Garros France Grand Slams,CLAY,3,Rafael Nadal,Teymuraz Gabashvili,Rafael Nadal,6-1; 6-4; 6-2,R64,137,2,1,50,77,37,50,19,27,4,4,13,56,77,2,3,52,85,34,52,12,33,8,13,12,46,85
2009-05-25 00:00:00.000,Roland Garros France Grand Slams,CLAY,3,Lleyton Hewitt,Andrey Golubev,Lleyton Hewitt,6-4; 6-3; 6-1,R64,114,2,1,45,80,35,45,23,35,8,8,13,58,80,4,5,51,93,32,51,17,42,5,10,13,49,93
2009-05-25 00:00:00.000,Roland Garros France Grand Slams,CLAY,3,Robin Soderling,Denis Istomin,Robin Soderling,6-4; 7-6(4); 6-4,R64,121,6,1,56,95,46,56,23,39,3,4,16,69,95,16,2,70,106,48,70,17,36,4,7,16,65,106
2009-05-25 00:00:00.000,Roland Garros France Grand Slams,CLAY,3,David Ferrer,Nicolas Kiefer,David Ferrer,6-3; 5-7; 6-4; 3-6; 6-2,R64,245,6,3,117,163,81,117,24,46,8,11,24,105,163,15,10,90,174,65,90,40,84,14,19,24,105,174
2009-05-25 00:00:00.000,Roland Garros France Grand Slams,CLAY,3,Nikolay Davydenko,Diego Junqueira,Nikolay Davydenko,4-6; 6-3; 6-0; 6-2,R64,164,2,1,63,86,43,63,14,23,5,9,16,57,86,0,1,85,123,43,85,17,38,13,23,17,60,123
2009-05-25 00:00:00.000,Roland Garros France Grand Slams,CLAY,3,Stanislas Wawrinka,Nicolas Massu,Stanislas Wawrinka,6-1; 6-1; 6-2,R64,74,11,2,33,53,31,33,14,20,0,0,11,45,53,0,1,37,61,19,37,9,24,4,11,11,28,61
2009-05-25 00:00:00.000,Roland Garros France Grand Slams,CLAY,3,Nicolas Almagro,Ernests Gulbis,Nicolas Almagro,6-7(4); 7-6(5); 6-3; 6-2,R64,162,15,1,73,120,61,73,29,47,1,1,20,90,120,10,1,82,127,65,82,21,45,6,10,21,86,127
2009-05-25 00:00:00.000,Roland Garros France Grand Slams,CLAY,3,Fernando Verdasco,Philipp Petzschner,Fernando Verdasco,6-1; 6-2; 6-3,R64,75,1,0,46,56,37,46,9,10,0,1,12,46,56,3,6,35,67,18,35,12,32,2,9,12,30,67
2009-05-25 00:00:00.000,Roland Garros France Grand Slams,CLAY,3,Andy Murray,Potito Starace,Andy Murray,6-3; 2-6; 7-5; 6-4,R64,160,8,0,75,118,57,75,19,43,9,13,19,76,118,1,0,92,123,57,92,17,31,5,11,20,74,123
2009-05-25 00:00:00.000,Roland Garros France Grand Slams,CLAY,3,Janko Tipsarevic,Feliciano Lopez,Janko Tipsarevic,6-7(9); 6-4; 7-6(4); 6-3,R64,235,9,4,92,161,66,92,42,69,11,13,22,108,161,17,2,93,151,69,93,29,58,7,11,21,98,151
2009-05-25 00:00:00.000,Roland Garros France Grand Slams,CLAY,3,Radek Stepanek,Mathieu Montcourt,Radek Stepanek,6-4; 4-6; 6-4; 6-4,R64,187,5,3,77,125,52,77,27,48,4,8,20,79,125,1,6,67,121,46,67,25,54,4,10,20,71,121
2009-05-25 00:00:00.000,Roland Garros France Grand Slams,CLAY,3,Marin Cilic,Dudi Sela,Marin Cilic,6-0; 6-3; 6-1,R64,83,7,1,40,68,34,40,15,28,2,2,11,49,68,0,1,42,65,20,42,11,23,6,13,11,31,65
2009-05-25 00:00:00.000,Roland Garros France Grand Slams,CLAY,3,Fernando Gonzalez,Rui Machado,Fernando Gonzalez,6-3; 6-2; 6-3,R64,88,4,2,46,63,40,46,12,17,0,0,13,52,63,2,0,62,86,36,62,11,24,9,14,13,47,86
2009-05-25 00:00:00.000,Roland Garros France Grand Slams,CLAY,3,Josselin Ouanna,Marat Safin,Josselin Ouanna,7-6(2); 7-6(4); 4-6; 3-6; 10-8,R64,274,4,8,118,187,85,118,39,69,7,12,30,124,187,19,4,122,215,92,122,44,93,19,23,31,136,215
2009-05-25 00:00:00.000,Roland Garros France Grand Slams,CLAY,3,Victor Hanescu,Mikhail Youzhny,Victor Hanescu,7-5; 7-5; 7-5,R64,181,3,1,77,109,57,77,19,32,8,10,18,76,109,2,5,76,134,51,76,26,58,10,15,18,77,134
2009-05-25 00:00:00.000,Roland Garros France Grand Slams,CLAY,3,Gilles Simon,Robert Kendrick,Gilles Simon,7-5; 6-0; 6-1,R64,94,6,2,33,72,27,33,28,39,3,3,13,55,72,5,4,51,90,32,51,14,39,9,15,12,46,90
2009-05-25 00:00:00.000,Roland Garros France Grand Slams,CLAY,3,Juan Martin Del Potro,Viktor Troicki,Juan Martin Del Potro,6-3; 7-5; 6-0,R64,123,7,3,41,77,32,41,16,36,1,4,14,48,77,3,0,57,86,26,57,13,29,6,14,13,39,86
2009-05-25 00:00:00.000,Roland Garros France Grand Slams,CLAY,3,Igor Andreev,Martin Vassallo Arguello,Igor Andreev,1-6; 7-5; 5-7; 6-3; 6-4,R64,240,5,3,132,180,83,132,25,48,14,20,25,108,180,2,2,150,198,91,150,23,48,13,19,25,114,198
2009-05-25 00:00:00.000,Roland Garros France Grand Slams,CLAY,3,Christophe Rochus,Arnaud Clement,Christophe Rochus,6-1; 7-5; 4-6; 6-3,R64,225,8,2,71,116,55,71,24,45,10,12,19,79,116,14,4,103,160,66,103,24,57,16,22,19,90,160
2009-05-25 00:00:00.000,Roland Garros France Grand Slams,CLAY,3,Jo-Wilfried Tsonga,Juan Monaco,Jo-Wilfried Tsonga,7-5; 2-6; 6-1; 7-6(8),R64,189,11,2,85,134,68,85,21,49,12,16,20,89,134,1,0,100,128,62,100,19,28,8,13,19,81,128
2009-05-25 00:00:00.000,Roland Garros France Grand Slams,CLAY,3,Tommy Robredo,Daniel Gimeno-Traver,Tommy Robredo,6-4; 6-4; 6-3,R64,122,2,5,60,88,47,60,15,28,5,5,14,62,88,1,4,60,93,40,60,15,33,3,7,15,55,93
2009-05-25 00:00:00.000,Roland Garros France Grand Slams,CLAY,3,Maximo Gonzalez,Andreas Seppi,Maximo Gonzalez,7-6(8); 6-3; 6-3,R64,178,7,2,94,129,61,94,20,35,17,19,15,81,129,0,4,59,106,38,59,22,47,8,13,15,60,106
2009-05-25 00:00:00.000,Roland Garros France Grand Slams,CLAY,3,Philipp Kohlschreiber,Juan Carlos Ferrero,Philipp Kohlschreiber,6-4; 2-6; 6-4; 6-7(3); 6-3,R64,213,7,1,113,159,66,113,22,46,8,17,25,88,159,3,0,109,143,60,109,16,34,5,15,24,76,143
2009-05-25 00:00:00.000,Roland Garros France Grand Slams,CLAY,3,Novak Djokovic,Sergiy Stakhovsky,Novak Djokovic,6-3; 6-4; 6-1,R64,124,5,2,53,77,36,53,15,24,3,5,13,51,77,6,3,62,107,38,62,16,45,11,18,13,54,107
2009-05-25 00:00:00.000,Roland Garros France Grand Slams,CLAY,3,Andy Roddick,Ivo Minar,Andy Roddick,6-2; 6-2; 7-6(2),R64,111,15,1,62,81,53,62,10,19,4,4,14,63,81,4,2,49,101,32,49,26,52,12,16,14,58,101
2009-05-25 00:00:00.000,Roland Garros France Grand Slams,CLAY,3,Marc Gicquel,Andreas Beck,Marc Gicquel,6-4; 6-7(6); 7-6(3); 7-5,R64,224,17,1,93,156,71,93,39,63,7,8,23,110,156,7,6,94,157,66,94,37,63,10,13,23,103,157
2009-05-25 00:00:00.000,Roland Garros France Grand Slams,CLAY,3,Jurgen Melzer,Guillaume Rufin,Jurgen Melzer,6-2; 7-5; 6-4,R64,135,12,3,65,100,49,65,17,35,3,5,15,66,100,2,7,49,100,35,49,19,51,3,9,15,54,100
2009-05-25 00:00:00.000,Roland Garros France Grand Slams,CLAY,3,Gael Monfils,Victor Crivoi,Gael Monfils,6-4; 6-3; 6-3,R64,105,4,0,59,86,45,59,17,27,2,2,14,62,86,2,1,62,89,39,62,14,27,3,7,14,53,89
2009-05-25 00:00:00.000,Roland Garros France Grand Slams,CLAY,3,Tommy Haas,Leonardo Mayer,Tommy Haas,6-3; 7-6(2); 3-6; 4-6; 6-3,R64,208,13,5,103,155,78,103,27,52,8,11,24,105,155,18,4,85,142,67,85,30,57,3,7,25,97,142
2009-05-25 00:00:00.000,Roland Garros France Grand Slams,CLAY,3,Jeremy Chardy,Simone Bolelli,Jeremy Chardy,6-2; 6-3; 4-6; 4-6; 6-1,R64,176,14,3,84,139,60,84,30,55,6,10,22,90,139,1,2,90,130,57,90,21,40,10,18,22,78,130
2009-05-25 00:00:00.000,Roland Garros France Grand Slams,CLAY,3,Paul-Henri Mathieu,Pablo Andujar,Paul-Henri Mathieu,6-2; 6-3; 6-4,R64,141,5,0,59,99,43,59,22,40,8,9,14,65,99,1,4,48,81,29,48,15,33,3,8,13,44,81
2009-05-25 00:00:00.000,Roland Garros France Grand Slams,CLAY,3,Roger Federer,Jose Acasuso,Roger Federer,7-6(8); 5-7; 7-6(2); 6-2,R64,205,11,0,101,142,75,101,22,41,5,10,22,97,142,5,2,96,154,59,96,31,58,6,12,22,90,154
2009-05-25 00:00:00.000,Roland Garros France Grand Slams,CLAY,3,Rafael Nadal,Lleyton Hewitt,Rafael Nadal,6-1; 6-3; 6-1,R32,111,7,0,50,66,38,50,10,16,2,3,12,48,66,2,2,46,75,26,46,9,29,6,13,11,35,75
2009-05-25 00:00:00.000,Roland Garros France Grand Slams,CLAY,3,Robin Soderling,David Ferrer,Robin Soderling,6-7(5); 7-5; 6-2; 7-6(5),R32,216,6,3,87,151,69,87,28,64,9,12,22,97,151,4,4,98,153,64,98,25,55,11,17,22,89,153
2009-05-25 00:00:00.000,Roland Garros France Grand Slams,CLAY,3,Nikolay Davydenko,Stanislas Wawrinka,Nikolay Davydenko,6-3; 4-6; 6-3; 6-2,R32,177,2,3,70,109,53,70,25,39,1,2,18,78,109,7,3,58,113,38,58,30,55,4,9,18,68,113
2009-05-25 00:00:00.000,Roland Garros France Grand Slams,CLAY,3,Fernando Verdasco,Nicolas Almagro,Fernando Verdasco,6-2; 7-6(4); 7-6(8),R32,167,3,4,97,110,73,97,3,13,0,2,16,76,110,5,2,60,126,41,60,34,66,5,9,16,75,126
2009-05-25 00:00:00.000,Roland Garros France Grand Slams,CLAY,3,Andy Murray,Janko Tipsarevic,Andy Murray,7-6(3); 6-3 RET,R32,111,6,0,35,69,25,35,17,34,2,6,10,42,69,6,2,42,78,26,42,13,36,2,8,11,39,78
2009-05-25 00:00:00.000,Roland Garros France Grand Slams,CLAY,3,Marin Cilic,Radek Stepanek,Marin Cilic,6-1; 7-6(4); 6-3,R32,126,8,5,49,90,36,49,24,41,0,2,15,60,90,0,4,59,91,31,59,16,32,9,14,13,47,91
2009-05-25 00:00:00.000,Roland Garros France Grand Slams,CLAY,3,Fernando Gonzalez,Josselin Ouanna,Fernando Gonzalez,7-5; 6-3; 7-5,R32,114,11,4,60,79,50,60,9,19,0,2,16,59,79,1,4,68,115,48,68,17,47,6,12,17,65,115
2009-05-25 00:00:00.000,Roland Garros France Grand Slams,CLAY,3,Victor Hanescu,Gilles Simon,Victor Hanescu,6-4; 6-4; 6-2,R32,142,6,3,67,100,53,67,16,33,6,6,14,69,100,7,4,64,116,46,64,20,52,11,15,14,66,116
2009-05-25 00:00:00.000,Roland Garros France Grand Slams,CLAY,3,Juan Martin Del Potro,Igor Andreev,Juan Martin Del Potro,6-4; 7-5; 6-4,R32,142,6,5,55,98,45,55,21,43,2,4,16,66,98,1,0,63,91,39,63,17,28,3,8,16,56,91
2009-05-25 00:00:00.000,Roland Garros France Grand Slams,CLAY,3,Jo-Wilfried Tsonga,Christophe Rochus,Jo-Wilfried Tsonga,6-2; 6-2; 6-2,R32,84,8,2,44,64,37,44,13,20,1,1,12,50,64,0,1,42,60,22,42,8,18,0,6,12,30,60
2009-05-25 00:00:00.000,Roland Garros France Grand Slams,CLAY,3,Tommy Robredo,Maximo Gonzalez,Tommy Robredo,4-6; 7-5; 6-1; 6-0,R32,146,4,5,53,99,38,53,31,46,2,4,18,69,99,0,2,74,105,40,74,17,31,4,11,17,57,105
2009-05-25 00:00:00.000,Roland Garros France Grand Slams,CLAY,3,Philipp Kohlschreiber,Novak Djokovic,Philipp Kohlschreiber,6-4; 6-4; 6-4,R32,141,1,1,65,98,42,65,21,33,4,6,15,63,98,3,3,58,90,38,58,13,32,5,10,15,51,90
2009-05-25 00:00:00.000,Roland Garros France Grand Slams,CLAY,3,Andy Roddick,Marc Gicquel,Andy Roddick,6-1; 6-4; 6-4,R32,104,7,0,55,81,46,55,15,26,3,3,14,61,81,7,4,38,77,24,38,21,39,3,7,13,45,77
2009-05-25 00:00:00.000,Roland Garros France Grand Slams,CLAY,3,Gael Monfils,Jurgen Melzer,Gael Monfils,6-2; 4-6; 6-3; 6-1,R32,137,12,1,72,112,53,72,19,40,6,8,17,72,112,2,0,62,97,42,62,12,35,4,11,17,54,97
2009-05-25 00:00:00.000,Roland Garros France Grand Slams,CLAY,3,Tommy Haas,Jeremy Chardy,Tommy Haas,7-5; 6-3; 4-6; 6-4,R32,157,16,1,76,116,59,76,20,40,6,10,21,79,116,5,3,79,128,47,79,26,49,6,12,20,73,128
2009-05-25 00:00:00.000,Roland Garros France Grand Slams,CLAY,3,Roger Federer,Paul-Henri Mathieu,Roger Federer,4-6; 6-1; 6-4; 6-4,R32,166,14,3,65,110,53,65,22,45,5,7,19,75,110,8,3,75,126,49,75,24,51,11,16,18,73,126
2009-05-25 00:00:00.000,Roland Garros France Grand Slams,CLAY,3,Robin Soderling,Rafael Nadal,Robin Soderling,6-2; 6-7(2); 6-4; 7-6(2),R16,210,9,0,91,143,62,91,32,52,2,4,21,94,143,3,2,99,128,66,99,13,29,1,6,21,79,128
2009-05-25 00:00:00.000,Roland Garros France Grand Slams,CLAY,3,Nikolay Davydenko,Fernando Verdasco,Nikolay Davydenko,6-2; 6-2; 6-4,R16,122,4,2,58,75,48,58,9,17,3,3,13,57,75,4,1,49,83,27,49,17,34,4,9,13,44,83
2009-05-25 00:00:00.000,Roland Garros France Grand Slams,CLAY,3,Andy Murray,Marin Cilic,Andy Murray,7-5; 7-6(4); 6-1,R16,151,10,1,56,106,42,56,26,50,1,4,16,68,106,4,5,60,104,39,60,18,44,6,12,15,57,104
2009-05-25 00:00:00.000,Roland Garros France Grand Slams,CLAY,3,Fernando Gonzalez,Victor Hanescu,Fernando Gonzalez,6-2; 6-4; 6-2,R16,87,6,0,35,67,30,35,23,32,0,0,13,53,67,2,2,52,75,33,52,10,23,3,8,13,43,75
2009-05-25 00:00:00.000,Roland Garros France Grand Slams,CLAY,3,Juan Martin Del Potro,Jo-Wilfried Tsonga,Juan Martin Del Potro,6-1; 6-7(5); 6-1; 6-4,R16,161,9,4,69,100,56,69,22,31,0,1,19,78,100,7,2,61,113,37,61,29,52,7,13,17,66,113
2009-05-25 00:00:00.000,Roland Garros France Grand Slams,CLAY,3,Tommy Robredo,Philipp Kohlschreiber,Tommy Robredo,6-4; 5-7; 7-6(4); 6-2,R16,196,7,2,75,122,63,75,28,47,5,6,21,91,122,2,2,73,133,47,73,42,60,7,10,21,89,133
2009-05-25 00:00:00.000,Roland Garros France Grand Slams,CLAY,3,Gael Monfils,Andy Roddick,Gael Monfils,6-4; 6-2; 6-3,R16,111,17,3,49,83,37,49,20,34,9,10,13,57,83,4,1,60,84,35,60,11,24,5,11,14,46,84
2009-05-25 00:00:00.000,Roland Garros France Grand Slams,CLAY,3,Roger Federer,Tommy Haas,Roger Federer,6-7(4); 5-7; 6-4; 6-0; 6-2,R16,187,16,1,82,130,70,82,29,48,3,5,24,99,130,11,3,93,145,63,93,28,52,8,15,24,91,145
2009-05-25 00:00:00.000,Roland Garros France Grand Slams,CLAY,3,Robin Soderling,Nikolay Davydenko,Robin Soderling,6-1; 6-3; 6-1,Q,101,4,3,45,70,35,45,18,25,2,2,12,53,70,1,5,62,80,31,62,8,18,8,14,11,39,80
2009-05-25 00:00:00.000,Roland Garros France Grand Slams,CLAY,3,Fernando Gonzalez,Andy Murray,Fernando Gonzalez,6-3; 3-6; 6-0; 6-4,Q,135,4,1,69,99,51,69,17,30,4,6,17,68,99,3,2,74,103,44,74,14,29,6,12,17,58,103
2009-05-25 00:00:00.000,Roland Garros France Grand Slams,CLAY,3,Juan Martin Del Potro,Tommy Robredo,Juan Martin Del Potro,6-3; 6-4; 6-2,Q,127,14,1,51,94,46,51,20,43,7,7,14,66,94,3,4,50,81,35,50,12,31,6,10,13,47,81
2009-05-25 00:00:00.000,Roland Garros France Grand Slams,CLAY,3,Roger Federer,Gael Monfils,Roger Federer,7-6(6); 6-2; 6-4,Q,130,8,1,54,94,43,54,26,40,4,4,15,69,94,7,1,61,105,41,61,22,44,2,5,15,63,105
2009-05-25 00:00:00.000,Roland Garros France Grand Slams,CLAY,3,Robin Soderling,Fernando Gonzalez,Robin Soderling,6-3; 7-5; 5-7; 4-6; 6-4,S,208,16,2,98,148,70,98,33,50,3,7,27,103,148,22,3,119,176,80,119,29,57,13,18,26,109,176
2009-05-25 00:00:00.000,Roland Garros France Grand Slams,CLAY,3,Roger Federer,Juan Martin Del Potro,Roger Federer,3-6; 7-6(2); 2-6; 6-1; 6-4,S,209,5,1,92,142,67,92,26,50,8,13,24,93,142,16,6,98,168,72,98,30,70,8,12,22,102,168
2009-05-25 00:00:00.000,Roland Garros France Grand Slams,CLAY,3,Roger Federer,Robin Soderling,Roger Federer,6-1; 7-6(1); 6-4,F,115,16,2,52,79,44,52,18,27,2,2,14,62,79,2,3,55,91,35,55,20,36,2,6,15,55,91
2009-06-08 00:00:00.000,Halle Germany ATP World Tour 250,GRASS,2,Lukas Lacko,Harel Levy,Lukas Lacko,7-6(6); 6-2,R32,74,2,3,44,68,32,44,10,24,3,5,10,42,68,6,1,46,72,29,46,10,26,5,9,10,39,72
2009-06-08 00:00:00.000,Halle Germany ATP World Tour 250,GRASS,2,Andreas Beck,Christophe Rochus,Andreas Beck,6-3; 6-1,R32,61,5,5,33,56,26,33,12,23,5,5,8,38,56,1,1,28,47,15,28,9,19,1,5,8,24,47
2009-06-08 00:00:00.000,Halle Germany ATP World Tour 250,GRASS,2,Philipp Kohlschreiber,Bjorn Phau,Philipp Kohlschreiber,6-4; 6-2,R32,64,6,4,39,60,34,39,9,21,3,3,9,43,60,4,2,24,45,17,24,11,21,1,4,9,28,45
2009-06-08 00:00:00.000,Halle Germany ATP World Tour 250,GRASS,2,Dmitry Tursunov,Igor Kunitsyn,Dmitry Tursunov,7-5; 6-4,R32,83,4,2,47,77,38,47,14,30,8,9,11,52,77,5,2,24,55,19,24,19,31,2,5,11,38,55
2009-06-08 00:00:00.000,Halle Germany ATP World Tour 250,GRASS,2,Jo-Wilfried Tsonga,Fabrice Santoro,Jo-Wilfried Tsonga,7-5; 6-2,R32,69,8,2,33,48,31,33,9,15,0,0,10,40,48,2,1,38,67,26,38,14,29,6,9,10,40,67
2009-06-08 00:00:00.000,Halle Germany ATP World Tour 250,GRASS,2,Tommy Haas,Stefan Koubek,Tommy Haas,6-2; 6-2,R32,59,1,1,35,53,24,35,14,18,2,2,8,38,53,2,2,30,56,17,30,11,26,3,7,8,28,56
2009-06-08 00:00:00.000,Halle Germany ATP World Tour 250,GRASS,2,Mischa Zverev,Joseph Sirianni,Mischa Zverev,6-2; 6-4,R32,81,8,1,42,62,30,42,10,20,4,5,9,40,62,2,2,46,76,30,46,10,30,6,10,9,40,76
2009-06-08 00:00:00.000,Halle Germany ATP World Tour 250,GRASS,2,Tomas Berdych,Jan Hernych,Tomas Berdych,6-4; 7-5,R32,89,10,2,39,68,31,39,16,29,4,6,11,47,68,2,4,47,82,26,47,18,35,3,7,11,44,82
2009-06-08 00:00:00.000,Halle Germany ATP World Tour 250,GRASS,2,Rainer Schuettler,Marc Gicquel,Rainer Schuettler,6-3; 6-4,R32,80,5,1,58,84,41,58,10,26,10,11,10,51,84,4,2,32,59,25,32,9,27,5,8,9,34,59
2009-06-08 00:00:00.000,Halle Germany ATP World Tour 250,GRASS,2,Benjamin Becker,Victor Hanescu,Benjamin Becker,6-4; 6-4,R32,59,7,0,31,43,29,31,8,12,1,2,10,37,43,6,3,47,60,33,47,4,13,3,6,10,37,60
2009-06-08 00:00:00.000,Halle Germany ATP World Tour 250,GRASS,2,Olivier Rochus,Fernando Vicente,Olivier Rochus,6-0; 6-0,R32,56,0,0,26,36,18,26,8,10,1,1,6,26,36,1,2,23,37,7,23,4,14,1,7,6,11,37
2009-06-08 00:00:00.000,Halle Germany ATP World Tour 250,GRASS,2,Philipp Petzschner,Fernando Verdasco,Philipp Petzschner,3-6; 7-6(5); 6-4,R32,106,5,5,52,94,38,52,21,42,3,7,15,59,94,9,5,58,89,43,58,17,31,3,7,16,60,89
2009-06-08 00:00:00.000,Halle Germany ATP World Tour 250,GRASS,2,Jurgen Melzer,Arnaud Clement,Jurgen Melzer,1-6; 6-3; 6-2,R32,111,8,2,42,81,34,42,18,39,1,3,12,52,81,3,2,38,77,23,38,24,39,4,7,12,47,77
2009-06-08 00:00:00.000,Halle Germany ATP World Tour 250,GRASS,2,Nicolas Kiefer,Viktor Troicki,Nicolas Kiefer,6-2; 6-1,R32,75,5,3,30,59,25,30,12,29,5,6,8,37,59,2,6,28,52,17,28,5,24,3,8,7,22,52
2009-06-08 00:00:00.000,Halle Germany ATP World Tour 250,GRASS,2,Florent Serra,Dudi Sela,Florent Serra,1-6; 6-4; 6-2,R32,83,2,3,52,83,37,52,11,31,6,10,12,48,83,6,1,45,73,28,45,15,28,5,10,13,43,73
2009-06-08 00:00:00.000,Halle Germany ATP World Tour 250,GRASS,2,Novak Djokovic,Simone Bolelli,Novak Djokovic,7-5; 6-2,R32,84,8,2,44,61,33,44,10,17,2,2,10,43,61,2,1,55,78,35,55,9,23,7,10,10,44,78
2009-06-08 00:00:00.000,Halle Germany ATP World Tour 250,GRASS,2,Andreas Beck,Lukas Lacko,Andreas Beck,7-5; 7-6(5),R16,90,9,1,40,61,34,40,18,21,0,0,12,52,61,5,2,50,88,38,50,19,38,5,6,12,57,88
2009-06-08 00:00:00.000,Halle Germany ATP World Tour 250,GRASS,2,Philipp Kohlschreiber,Dmitry Tursunov,Philipp Kohlschreiber,6-4; 7-6(6),R16,93,10,0,36,61,29,36,19,25,0,1,11,48,61,5,1,48,78,33,48,17,30,7,9,11,50,78
2009-06-08 00:00:00.000,Halle Germany ATP World Tour 250,GRASS,2,Tommy Haas,Jo-Wilfried Tsonga,Tommy Haas,6-3; 7-6(3),R16,79,7,5,40,64,35,40,16,24,3,3,11,51,64,12,2,45,70,34,45,13,25,5,6,10,47,70
2009-06-08 00:00:00.000,Halle Germany ATP World Tour 250,GRASS,2,Mischa Zverev,Tomas Berdych,Mischa Zverev,3-6; 6-2; 7-6(8),R16,153,0,4,74,110,51,74,14,36,10,14,14,65,110,6,3,63,108,40,63,21,45,3,8,15,61,108
2009-06-08 00:00:00.000,Halle Germany ATP World Tour 250,GRASS,2,Benjamin Becker,Rainer Schuettler,Benjamin Becker,6-4; 2-6; 6-4,R16,122,12,5,42,96,31,42,20,54,8,14,14,51,96,6,3,52,84,33,52,16,32,8,14,14,49,84
2009-06-08 00:00:00.000,Halle Germany ATP World Tour 250,GRASS,2,Olivier Rochus,Philipp Petzschner,Olivier Rochus,5-7; 7-5; 6-2,R16,127,0,1,58,90,44,58,18,32,5,7,16,62,90,10,2,43,93,35,43,25,50,4,8,16,60,93
2009-06-08 00:00:00.000,Halle Germany ATP World Tour 250,GRASS,2,Jurgen Melzer,Nicolas Kiefer,Jurgen Melzer,6-1 RET,R16,31,3,0,10,15,8,10,4,5,0,0,3,12,15,2,1,14,24,6,14,2,10,0,3,4,8,24
2009-06-08 00:00:00.000,Halle Germany ATP World Tour 250,GRASS,2,Novak Djokovic,Florent Serra,Novak Djokovic,5-7; 7-5; 6-1,R16,125,14,1,46,87,36,46,24,41,11,13,15,60,87,7,3,67,107,43,67,20,40,6,11,16,63,107
2009-06-08 00:00:00.000,Halle Germany ATP World Tour 250,GRASS,2,Philipp Kohlschreiber,Andreas Beck,Philipp Kohlschreiber,3-6; 6-3; 6-3,Q,117,17,4,69,93,52,69,10,24,8,9,13,62,93,9,7,49,88,36,49,19,39,2,5,14,55,88
2009-06-08 00:00:00.000,Halle Germany ATP World Tour 250,GRASS,2,Tommy Haas,Mischa Zverev,Tommy Haas,7-6(5); 6-2,Q,76,9,1,44,63,33,44,13,19,4,5,10,46,63,1,3,39,59,29,39,9,20,3,6,10,38,59
2009-06-08 00:00:00.000,Halle Germany ATP World Tour 250,GRASS,2,Olivier Rochus,Benjamin Becker,Olivier Rochus,6-7(4); 6-3; 6-3,Q,124,2,3,52,82,44,52,20,30,0,0,15,64,82,17,2,54,98,40,54,23,44,5,8,15,63,98
2009-06-08 00:00:00.000,Halle Germany ATP World Tour 250,GRASS,2,Novak Djokovic,Jurgen Melzer,Novak Djokovic,6-1; 6-4,Q,67,6,1,37,49,30,37,5,12,1,2,9,35,49,5,3,29,62,18,29,12,33,3,7,8,30,62
2009-06-08 00:00:00.000,Halle Germany ATP World Tour 250,GRASS,2,Tommy Haas,Philipp Kohlschreiber,Tommy Haas,2-6; 7-6(5); 7-6(3),S,132,15,9,70,110,60,70,14,40,6,9,16,74,110,6,0,67,95,51,67,17,28,2,3,16,68,95
2009-06-08 00:00:00.000,Halle Germany ATP World Tour 250,GRASS,2,Novak Djokovic,Olivier Rochus,Novak Djokovic,7-6(7); 6-4,S,115,10,2,48,73,39,48,11,25,2,3,11,50,73,2,1,40,72,29,40,17,32,4,6,11,46,72
2009-06-08 00:00:00.000,Halle Germany ATP World Tour 250,GRASS,2,Tommy Haas,Novak Djokovic,Tommy Haas,6-3; 6-7(4); 6-1,F,132,10,6,57,103,47,57,26,46,4,4,15,73,103,4,3,46,86,29,46,24,40,7,10,13,53,86
2009-06-08 00:00:00.000,London / Queen's Club Great Britain ATP World Tour 250,GRASS,2,Andy Murray,N/A Bye,Andy Murray,,R64,0,0,0,0,0,0,0,0,0,0,0,0,0,0,0,0,0,0,0,0,0,0,0,0,0,0,0
2009-06-08 00:00:00.000,London / Queen's Club Great Britain ATP World Tour 250,GRASS,2,Andreas Seppi,Robby Ginepri,Andreas Seppi,5-7; 7-6(4); 6-3,R64,111,7,1,65,99,52,65,20,34,2,4,17,72,99,4,3,67,99,55,67,11,32,1,3,16,66,99
2009-06-08 00:00:00.000,London / Queen's Club Great Britain ATP World Tour 250,GRASS,2,Gilles Muller,Josh Goodall,Gilles Muller,6-3; 7-6(7),R64,83,22,5,50,69,43,50,10,19,4,4,11,53,69,7,3,36,67,28,36,20,31,1,2,10,48,67
2009-06-08 00:00:00.000,London / Queen's Club Great Britain ATP World Tour 250,GRASS,2,Guillermo Garcia-Lopez,Yen-Hsun Lu,Guillermo Garcia-Lopez,6-1; 6-1,R64,46,4,3,24,34,22,24,6,10,0,0,7,28,34,2,3,32,42,17,32,1,10,0,5,7,18,42
2009-06-08 00:00:00.000,London / Queen's Club Great Britain ATP World Tour 250,GRASS,2,Feliciano Lopez,Robert Kendrick,Feliciano Lopez,7-6(3); 7-6(3),R64,88,14,2,49,82,39,49,19,33,3,4,12,58,82,10,2,43,74,33,43,16,31,0,1,12,49,74
2009-06-08 00:00:00.000,London / Queen's Club Great Britain ATP World Tour 250,GRASS,2,Denis Istomin,Ivo Minar,Denis Istomin,3-6; 6-1; 6-2,R64,68,11,4,45,65,35,45,12,20,1,2,12,47,65,5,2,46,74,30,46,14,28,6,10,12,44,74
2009-06-08 00:00:00.000,London / Queen's Club Great Britain ATP World Tour 250,GRASS,2,Michael Llodra,Evgeny Korolev,Michael Llodra,6-3; 6-4,R64,63,16,4,38,56,30,38,10,18,2,3,10,40,56,5,2,37,57,23,37,9,20,1,4,9,32,57
2009-06-08 00:00:00.000,London / Queen's Club Great Britain ATP World Tour 250,GRASS,2,Mardy Fish,N/A Bye,Mardy Fish,,R64,0,0,0,0,0,0,0,0,0,0,0,0,0,0,0,0,0,0,0,0,0,0,0,0,0,0,0
2009-06-08 00:00:00.000,London / Queen's Club Great Britain ATP World Tour 250,GRASS,2,Gael Monfils,N/A Bye,Gael Monfils,,R64,0,0,0,0,0,0,0,0,0,0,0,0,0,0,0,0,0,0,0,0,0,0,0,0,0,0,0
2009-06-08 00:00:00.000,London / Queen's Club Great Britain ATP World Tour 250,GRASS,2,Andrey Golubev,Bobby Reynolds,Andrey Golubev,6-2; 4-6; 7-6(3),R64,100,6,5,51,87,40,51,20,36,3,5,15,60,87,3,6,66,99,43,66,19,33,9,12,15,62,99
2009-06-08 00:00:00.000,London / Queen's Club Great Britain ATP World Tour 250,GRASS,2,Steve Darcis,Paul Capdeville,Steve Darcis,3-6; 6-3; 6-4,R64,101,3,1,51,79,38,51,18,28,2,3,14,56,79,3,3,52,90,38,52,18,38,6,8,14,56,90
2009-06-08 00:00:00.000,London / Queen's Club Great Britain ATP World Tour 250,GRASS,2,Alberto Martin,Ernests Gulbis,Alberto Martin,7-6(9); 6-4,R64,96,5,3,48,79,33,48,19,31,4,5,11,52,79,18,6,60,91,47,60,10,31,9,11,11,57,91
2009-06-08 00:00:00.000,London / Queen's Club Great Britain ATP World Tour 250,GRASS,2,Paul-Henri Mathieu,Andrei Pavel,Paul-Henri Mathieu,6-4; 7-6(6),R64,85,8,1,38,67,31,38,17,29,0,1,11,48,67,7,2,41,66,31,41,11,25,0,2,11,42,66
2009-06-08 00:00:00.000,London / Queen's Club Great Britain ATP World Tour 250,GRASS,2,Juan Carlos Ferrero,Sebastien Grosjean,Juan Carlos Ferrero,6-2; 2-1 RET,R64,41,2,1,16,28,11,16,9,12,0,0,5,20,28,3,1,25,39,16,25,6,14,3,6,6,22,39
2009-06-08 00:00:00.000,London / Queen's Club Great Britain ATP World Tour 250,GRASS,2,Xavier Malisse,Pablo Andujar,Xavier Malisse,5-0 RET,R64,23,2,0,8,11,7,8,1,3,0,0,2,8,11,1,2,15,30,8,15,4,15,3,6,3,12,30
2009-06-08 00:00:00.000,London / Queen's Club Great Britain ATP World Tour 250,GRASS,2,Rik De Voest,N/A Bye,Rik De Voest,,R64,0,0,0,0,0,0,0,0,0,0,0,0,0,0,0,0,0,0,0,0,0,0,0,0,0,0,0
2009-06-08 00:00:00.000,London / Queen's Club Great Britain ATP World Tour 250,GRASS,2,James Blake,N/A Bye,James Blake,,R64,0,0,0,0,0,0,0,0,0,0,0,0,0,0,0,0,0,0,0,0,0,0,0,0,0,0,0
2009-06-08 00:00:00.000,London / Queen's Club Great Britain ATP World Tour 250,GRASS,2,Ivan Ljubicic,Sergiy Stakhovsky,Ivan Ljubicic,4-6; 6-4; 6-4,R64,105,17,2,55,74,49,55,9,19,3,4,15,58,74,7,3,55,91,43,55,18,36,3,5,15,61,91
2009-06-08 00:00:00.000,London / Queen's Club Great Britain ATP World Tour 250,GRASS,2,Kevin Anderson,Fabio Fognini,Kevin Anderson,6-3; 7-6(3),R64,93,6,1,52,71,41,52,12,19,3,3,11,53,71,5,2,51,78,38,51,13,27,4,5,10,51,78
2009-06-08 00:00:00.000,London / Queen's Club Great Britain ATP World Tour 250,GRASS,2,Sam Querrey,Jeremy Chardy,Sam Querrey,7-6(10); 6-4,R64,83,13,1,40,67,37,40,17,27,3,3,11,54,67,12,7,51,85,39,51,18,34,5,6,11,57,85
2009-06-08 00:00:00.000,London / Queen's Club Great Britain ATP World Tour 250,GRASS,2,Mikhail Youzhny,Oscar Hernandez,Mikhail Youzhny,6-4; 6-2,R64,63,1,1,28,43,25,28,11,15,0,0,9,36,43,2,3,41,63,29,41,8,22,2,5,9,37,63
2009-06-08 00:00:00.000,London / Queen's Club Great Britain ATP World Tour 250,GRASS,2,Marcos Baghdatis,James Ward,Marcos Baghdatis,6-2; 6-3,R64,54,6,4,21,41,20,21,16,20,0,0,9,36,41,4,4,21,44,16,21,9,23,4,7,8,25,44
2009-06-08 00:00:00.000,London / Queen's Club Great Britain ATP World Tour 250,GRASS,2,Grigor Dimitrov,Ivan Navarro,Grigor Dimitrov,6-4; 4-6; 6-3,R64,97,8,3,51,79,46,51,11,28,1,2,15,57,79,11,2,53,83,40,53,15,30,5,7,14,55,83
2009-06-08 00:00:00.000,London / Queen's Club Great Britain ATP World Tour 250,GRASS,2,Gilles Simon,N/A Bye,Gilles Simon,,R64,0,0,0,0,0,0,0,0,0,0,0,0,0,0,0,0,0,0,0,0,0,0,0,0,0,0,0
2009-06-08 00:00:00.000,London / Queen's Club Great Britain ATP World Tour 250,GRASS,2,Marin Cilic,N/A Bye,Marin Cilic,,R64,0,0,0,0,0,0,0,0,0,0,0,0,0,0,0,0,0,0,0,0,0,0,0,0,0,0,0
2009-06-08 00:00:00.000,London / Queen's Club Great Britain ATP World Tour 250,GRASS,2,Nicolas Mahut,Janko Tipsarevic,Nicolas Mahut,6-0; 6-4,R64,62,8,2,31,47,29,31,5,16,1,1,8,34,47,3,2,25,45,17,25,7,20,1,5,8,24,45
2009-06-08 00:00:00.000,London / Queen's Club Great Britain ATP World Tour 250,GRASS,2,Julien Benneteau,Daniel Koellerer,Julien Benneteau,6-3; 6-4,R64,60,8,2,46,58,36,46,7,12,4,4,10,43,58,3,3,39,55,26,39,8,16,4,6,9,34,55
2009-06-08 00:00:00.000,London / Queen's Club Great Britain ATP World Tour 250,GRASS,2,Ivo Karlovic,Teymuraz Gabashvili,Ivo Karlovic,6-3; 7-6(11),R64,88,28,3,61,77,54,61,5,16,8,8,11,59,77,8,1,45,66,37,45,10,21,0,1,10,47,66
2009-06-08 00:00:00.000,London / Queen's Club Great Britain ATP World Tour 250,GRASS,2,Lleyton Hewitt,Eduardo Schwank,Lleyton Hewitt,6-1; 6-0,R64,44,2,1,23,36,19,23,7,13,1,1,6,26,36,0,1,26,37,7,26,3,11,2,8,7,10,37
2009-06-08 00:00:00.000,London / Queen's Club Great Britain ATP World Tour 250,GRASS,2,Frederico Gil,Daniel Gimeno-Traver,Frederico Gil,6-1; 6-3,R64,55,1,0,36,49,29,36,7,13,2,2,8,36,49,8,9,32,60,22,32,8,28,6,10,8,30,60
2009-06-08 00:00:00.000,London / Queen's Club Great Britain ATP World Tour 250,GRASS,2,Kristof Vliegen,Leonardo Mayer,Kristof Vliegen,7-6(3); 6-4,R64,94,3,4,45,71,37,45,16,26,6,6,11,53,71,4,0,47,78,34,47,16,31,7,8,11,50,78
2009-06-08 00:00:00.000,London / Queen's Club Great Britain ATP World Tour 250,GRASS,2,Andy Roddick,N/A Bye,Andy Roddick,,R64,0,0,0,0,0,0,0,0,0,0,0,0,0,0,0,0,0,0,0,0,0,0,0,0,0,0,0
2009-06-08 00:00:00.000,London / Queen's Club Great Britain ATP World Tour 250,GRASS,2,Andy Murray,Andreas Seppi,Andy Murray,6-1; 6-4,R32,59,2,1,26,43,19,26,12,17,0,1,8,31,43,0,3,35,53,19,35,6,18,2,7,9,25,53
2009-06-08 00:00:00.000,London / Queen's Club Great Britain ATP World Tour 250,GRASS,2,Guillermo Garcia-Lopez,Gilles Muller,Guillermo Garcia-Lopez,7-6(3); 6-3,R32,88,4,5,37,63,30,37,14,26,2,4,11,44,63,4,3,44,75,32,44,12,31,7,10,10,44,75
2009-06-08 00:00:00.000,London / Queen's Club Great Britain ATP World Tour 250,GRASS,2,Feliciano Lopez,Denis Istomin,Feliciano Lopez,7-6(3); 4-6; 7-6(5),R32,122,17,5,66,108,55,66,23,42,4,5,17,78,108,15,2,70,96,53,70,21,26,0,0,17,74,96
2009-06-08 00:00:00.000,London / Queen's Club Great Britain ATP World Tour 250,GRASS,2,Mardy Fish,Michael Llodra,Mardy Fish,5-7; 7-6(5); 6-3,R32,112,8,1,73,98,53,73,18,25,2,3,17,71,98,9,1,63,94,50,63,17,31,7,8,16,67,94
2009-06-08 00:00:00.000,London / Queen's Club Great Britain ATP World Tour 250,GRASS,2,Gael Monfils,Andrey Golubev,Gael Monfils,6-3; 3-6; 7-6(5),R32,112,4,3,63,89,49,63,16,26,3,5,15,65,89,3,8,59,109,44,59,26,50,7,9,15,70,109
2009-06-08 00:00:00.000,London / Queen's Club Great Britain ATP World Tour 250,GRASS,2,Steve Darcis,Alberto Martin,Steve Darcis,6-2; 6-4,R32,63,3,0,32,47,28,32,10,15,0,0,9,38,47,2,2,34,57,23,34,10,23,7,10,9,33,57
2009-06-08 00:00:00.000,London / Queen's Club Great Britain ATP World Tour 250,GRASS,2,Juan Carlos Ferrero,Paul-Henri Mathieu,Juan Carlos Ferrero,6-4; 6-4,R32,84,15,4,42,67,31,42,13,25,5,6,10,44,67,7,1,41,74,27,41,17,33,5,8,10,44,74
2009-06-08 00:00:00.000,London / Queen's Club Great Britain ATP World Tour 250,GRASS,2,Xavier Malisse,Rik De Voest,Xavier Malisse,7-6(6); 7-6(8),R32,119,4,1,43,79,32,43,26,36,2,4,12,58,79,1,2,56,91,39,56,19,35,5,7,12,58,91
2009-06-08 00:00:00.000,London / Queen's Club Great Britain ATP World Tour 250,GRASS,2,James Blake,Ivan Ljubicic,James Blake,6-2; 7-6(4),R32,75,3,1,48,72,35,48,15,24,3,3,10,50,72,10,3,32,60,24,32,16,28,1,3,10,40,60
2009-06-08 00:00:00.000,London / Queen's Club Great Britain ATP World Tour 250,GRASS,2,Sam Querrey,Kevin Anderson,Sam Querrey,7-5; 6-3,R32,88,13,0,43,63,37,43,10,20,0,0,11,47,63,8,2,42,60,31,42,7,18,3,5,10,38,60
2009-06-08 00:00:00.000,London / Queen's Club Great Britain ATP World Tour 250,GRASS,2,Mikhail Youzhny,Marcos Baghdatis,Mikhail Youzhny,6-4; 7-6(3),R32,116,1,0,43,73,27,43,21,30,8,10,11,48,73,7,1,45,83,33,45,16,38,7,10,11,49,83
2009-06-08 00:00:00.000,London / Queen's Club Great Britain ATP World Tour 250,GRASS,2,Gilles Simon,Grigor Dimitrov,Gilles Simon,7-6(7); 7-6(5),R32,110,4,2,64,106,51,64,19,42,3,4,12,70,106,1,1,59,87,42,59,16,28,0,1,12,58,87
2009-06-08 00:00:00.000,London / Queen's Club Great Britain ATP World Tour 250,GRASS,2,Nicolas Mahut,Marin Cilic,Nicolas Mahut,7-6(1); 7-6(4),R32,108,9,0,51,87,41,51,23,36,4,4,12,64,87,11,1,48,75,40,48,16,27,0,0,12,56,75
2009-06-08 00:00:00.000,London / Queen's Club Great Britain ATP World Tour 250,GRASS,2,Ivo Karlovic,Julien Benneteau,Ivo Karlovic,7-6(7); 6-7(4); 6-2,R32,122,33,1,65,92,59,65,16,27,0,0,16,75,92,1,2,59,102,45,59,30,43,1,3,16,75,102
2009-06-08 00:00:00.000,London / Queen's Club Great Britain ATP World Tour 250,GRASS,2,Lleyton Hewitt,Frederico Gil,Lleyton Hewitt,3-6; 6-2; 6-2,R32,81,8,4,40,70,29,40,18,30,1,4,13,47,70,6,0,36,62,23,36,11,26,1,6,12,34,62
2009-06-08 00:00:00.000,London / Queen's Club Great Britain ATP World Tour 250,GRASS,2,Andy Roddick,Kristof Vliegen,Andy Roddick,6-1; 6-4,R32,56,11,0,29,45,26,29,10,16,0,0,9,36,45,2,3,21,43,15,21,10,22,0,3,8,25,43
2009-06-08 00:00:00.000,London / Queen's Club Great Britain ATP World Tour 250,GRASS,2,Andy Murray,Guillermo Garcia-Lopez,Andy Murray,6-4; 6-4,R16,70,9,0,27,51,24,27,16,24,0,0,10,40,51,3,2,36,53,26,36,9,17,0,2,10,35,53
2009-06-08 00:00:00.000,London / Queen's Club Great Britain ATP World Tour 250,GRASS,2,Mardy Fish,Feliciano Lopez,Mardy Fish,6-1; 6-4,R16,52,12,0,29,36,27,29,5,7,0,0,8,32,36,5,5,38,54,25,38,4,16,5,9,9,29,54
2009-06-08 00:00:00.000,London / Queen's Club Great Britain ATP World Tour 250,GRASS,2,Steve Darcis,Gael Monfils,Steve Darcis,W/O,R16,0,0,0,0,0,0,0,0,0,0,0,0,0,0,0,0,0,0,0,0,0,0,0,0,0,0,0
2009-06-08 00:00:00.000,London / Queen's Club Great Britain ATP World Tour 250,GRASS,2,Juan Carlos Ferrero,Xavier Malisse,Juan Carlos Ferrero,6-4; 7-6(4),R16,105,9,3,41,75,34,41,20,34,4,4,11,54,75,6,2,41,82,34,41,19,41,5,6,11,53,82
2009-06-08 00:00:00.000,London / Queen's Club Great Britain ATP World Tour 250,GRASS,2,James Blake,Sam Querrey,James Blake,6-4; 4-6; 6-3,R16,94,9,1,51,81,43,51,15,30,1,3,15,58,81,14,2,42,87,30,42,24,45,4,7,14,54,87
2009-06-08 00:00:00.000,London / Queen's Club Great Britain ATP World Tour 250,GRASS,2,Mikhail Youzhny,Gilles Simon,Mikhail Youzhny,6-1; 2-6; 6-2,R16,92,1,1,37,69,26,37,18,32,2,4,12,44,69,2,1,30,61,21,30,14,31,3,7,11,35,61
2009-06-08 00:00:00.000,London / Queen's Club Great Britain ATP World Tour 250,GRASS,2,Ivo Karlovic,Nicolas Mahut,Ivo Karlovic,6-3; 6-4,R16,72,19,0,37,60,28,37,15,23,2,2,10,43,60,1,1,43,58,29,43,7,15,4,6,9,36,58
2009-06-08 00:00:00.000,London / Queen's Club Great Britain ATP World Tour 250,GRASS,2,Andy Roddick,Lleyton Hewitt,Andy Roddick,7-6(2); 7-6(4),R16,100,18,3,47,80,42,47,18,33,1,1,12,60,80,7,4,46,72,40,46,13,26,0,0,12,53,72
2009-06-08 00:00:00.000,London / Queen's Club Great Britain ATP World Tour 250,GRASS,2,Andy Murray,Mardy Fish,Andy Murray,7-5; 6-3,Q,70,11,0,31,45,30,31,10,14,0,0,10,40,45,9,3,43,68,33,43,8,25,3,6,11,41,68
2009-06-08 00:00:00.000,London / Queen's Club Great Britain ATP World Tour 250,GRASS,2,Juan Carlos Ferrero,Steve Darcis,Juan Carlos Ferrero,4-6; 6-3; 6-4,Q,108,9,0,62,86,49,62,12,24,1,2,15,61,86,8,3,51,89,39,51,18,38,4,6,14,57,89
2009-06-08 00:00:00.000,London / Queen's Club Great Britain ATP World Tour 250,GRASS,2,James Blake,Mikhail Youzhny,James Blake,7-6(5); 6-3,Q,76,5,2,34,59,26,34,17,25,1,2,10,43,59,0,2,44,66,26,44,13,22,0,3,11,39,66
2009-06-08 00:00:00.000,London / Queen's Club Great Britain ATP World Tour 250,GRASS,2,Andy Roddick,Ivo Karlovic,Andy Roddick,7-6(4); 7-6(5),Q,82,24,2,56,72,50,56,11,16,0,0,12,61,72,26,0,53,74,48,53,12,21,2,2,12,60,74
2009-06-08 00:00:00.000,London / Queen's Club Great Britain ATP World Tour 250,GRASS,2,Andy Murray,Juan Carlos Ferrero,Andy Murray,6-2; 6-4,S,72,9,2,29,51,25,29,13,22,0,0,9,38,51,2,0,34,66,22,34,14,32,6,9,9,36,66
2009-06-08 00:00:00.000,London / Queen's Club Great Britain ATP World Tour 250,GRASS,2,James Blake,Andy Roddick,James Blake,4-4 RET,S,32,3,0,11,20,10,11,7,9,0,0,4,17,20,4,0,14,26,12,14,6,12,3,3,4,18,26
2009-06-08 00:00:00.000,London / Queen's Club Great Britain ATP World Tour 250,GRASS,2,Andy Murray,James Blake,Andy Murray,7-5; 6-4,F,68,7,3,34,59,28,34,15,25,1,2,11,43,59,1,1,31,55,21,31,16,24,0,3,11,37,55
2009-06-14 00:00:00.000,Eastbourne Great Britain ATP World Tour 250,GRASS,2,Frank Dancevic,Igor Andreev,Frank Dancevic,7-6(6); 6-2,R32,88,11,1,41,58,34,41,12,17,1,1,10,46,58,6,1,47,72,32,47,13,25,5,7,10,45,72
2009-06-14 00:00:00.000,Eastbourne Great Britain ATP World Tour 250,GRASS,2,James Ward,Victor Crivoi,James Ward,6-1; 6-3,R32,52,9,2,19,43,16,19,15,24,1,2,8,31,43,1,0,32,51,12,32,11,19,4,9,8,23,51
2009-06-14 00:00:00.000,Eastbourne Great Britain ATP World Tour 250,GRASS,2,Leonardo Mayer,Eduardo Schwank,Leonardo Mayer,6-4; 6-2,R32,74,7,1,26,45,22,26,14,19,0,0,9,36,45,1,5,29,72,25,29,17,43,9,12,9,42,72
2009-06-14 00:00:00.000,Eastbourne Great Britain ATP World Tour 250,GRASS,2,Julien Benneteau,Mikhail Youzhny,Julien Benneteau,4-6; 6-4; 6-4,R32,136,5,1,65,95,41,65,13,30,1,6,15,54,95,5,4,79,116,42,79,20,37,9,15,15,62,116
2009-06-14 00:00:00.000,Eastbourne Great Britain ATP World Tour 250,GRASS,2,Fabrice Santoro,Robert Kendrick,Fabrice Santoro,6-3; 6-2,R32,62,1,2,32,59,26,32,17,27,4,4,9,43,59,1,5,33,56,22,33,8,23,4,7,8,30,56
2009-06-14 00:00:00.000,Eastbourne Great Britain ATP World Tour 250,GRASS,2,Robby Ginepri,Andrey Golubev,Robby Ginepri,6-3; 6-4,R32,61,1,1,35,55,28,35,11,20,2,3,10,39,55,6,4,27,50,21,27,8,23,1,4,9,29,50
2009-06-14 00:00:00.000,Eastbourne Great Britain ATP World Tour 250,GRASS,2,Josh Goodall,Tatsuma Ito,Josh Goodall,6-4; 6-1,R32,61,5,2,20,49,17,20,16,29,0,1,8,33,49,2,4,27,50,16,27,7,23,1,6,9,23,50
2009-06-14 00:00:00.000,Eastbourne Great Britain ATP World Tour 250,GRASS,2,Ivan Ljubicic,Andreas Seppi,Ivan Ljubicic,7-6(4); 7-5,R32,94,9,2,49,73,35,49,16,24,3,4,12,51,73,2,3,44,73,32,44,14,29,6,8,12,46,73
2009-06-14 00:00:00.000,Eastbourne Great Britain ATP World Tour 250,GRASS,2,Guillermo Garcia-Lopez,Evgeny Korolev,Guillermo Garcia-Lopez,6-2; 6-7(3); 6-2,R32,121,13,3,54,79,43,54,13,25,1,3,14,56,79,2,2,58,101,41,58,16,43,7,13,14,57,101
2009-06-14 00:00:00.000,Eastbourne Great Britain ATP World Tour 250,GRASS,2,Yen-Hsun Lu,Colin Fleming,Yen-Hsun Lu,7-6(2); 1-6; 6-3,R32,125,6,7,65,102,46,65,17,37,8,11,14,63,102,8,5,51,86,42,51,13,35,2,4,14,55,86
2009-06-14 00:00:00.000,Eastbourne Great Britain ATP World Tour 250,GRASS,2,Brydan Klein,Teymuraz Gabashvili,Brydan Klein,6-3; 5-7; 6-1,R32,111,5,7,41,75,28,41,21,34,2,5,14,49,75,5,2,54,91,35,54,15,37,6,12,14,50,91
2009-06-14 00:00:00.000,Eastbourne Great Britain ATP World Tour 250,GRASS,2,Janko Tipsarevic,Paul-Henri Mathieu,Janko Tipsarevic,6-4; 6-2,R32,87,8,5,31,58,28,31,13,27,2,2,9,41,58,8,3,36,77,26,36,16,41,14,17,9,42,77
2009-06-14 00:00:00.000,Eastbourne Great Britain ATP World Tour 250,GRASS,2,Sam Querrey,Paul Capdeville,Sam Querrey,6-2; 7-5,R32,51,19,2,40,54,32,40,9,14,0,0,10,41,54,2,1,43,56,29,43,5,13,0,3,10,34,56
2009-06-14 00:00:00.000,Eastbourne Great Britain ATP World Tour 250,GRASS,2,Denis Istomin,Kevin Kim,Denis Istomin,7-6(5); 7-5,R32,81,10,3,51,77,40,51,15,26,2,3,12,55,77,0,6,49,76,33,49,17,27,7,9,12,50,76
2009-06-14 00:00:00.000,Eastbourne Great Britain ATP World Tour 250,GRASS,2,Alex Bogdanovic,Ivo Minar,Alex Bogdanovic,6-4; 7-6(3),R32,75,8,1,36,57,35,36,10,21,0,1,11,45,57,9,2,46,78,33,46,15,32,5,7,11,48,78
2009-06-14 00:00:00.000,Eastbourne Great Britain ATP World Tour 250,GRASS,2,Dmitry Tursunov,Fabio Fognini,Dmitry Tursunov,6-3; 4-6; 6-4,R32,119,3,5,55,99,40,55,21,44,0,3,15,61,99,6,5,49,85,35,49,16,36,4,8,14,51,85
2009-06-14 00:00:00.000,Eastbourne Great Britain ATP World Tour 250,GRASS,2,Frank Dancevic,James Ward,Frank Dancevic,7-6(6); 6-4,R16,89,7,0,45,74,36,45,14,29,5,7,11,50,74,10,4,38,70,31,38,15,32,5,8,11,46,70
2009-06-14 00:00:00.000,Eastbourne Great Britain ATP World Tour 250,GRASS,2,Leonardo Mayer,Julien Benneteau,Leonardo Mayer,6-4; 6-4,R16,84,7,0,37,64,27,37,17,27,5,6,10,44,64,4,3,45,67,29,45,9,22,5,8,10,38,67
2009-06-14 00:00:00.000,Eastbourne Great Britain ATP World Tour 250,GRASS,2,Fabrice Santoro,Robby Ginepri,Fabrice Santoro,4-6; 6-4; 6-1,R16,115,0,2,40,83,29,40,24,43,6,8,13,53,83,6,6,58,98,41,58,13,40,7,12,14,54,98
2009-06-14 00:00:00.000,Eastbourne Great Britain ATP World Tour 250,GRASS,2,Ivan Ljubicic,Josh Goodall,Ivan Ljubicic,6-3; 7-5,R16,75,12,1,34,56,27,34,18,22,0,0,11,45,56,3,1,33,62,26,33,14,29,3,5,10,40,62
2009-06-14 00:00:00.000,Eastbourne Great Britain ATP World Tour 250,GRASS,2,Guillermo Garcia-Lopez,Yen-Hsun Lu,Guillermo Garcia-Lopez,6-4; 6-7(0); 7-6(3),R16,165,13,6,72,113,55,72,18,41,5,7,17,73,113,2,6,77,119,55,77,20,42,10,13,17,75,119
2009-06-14 00:00:00.000,Eastbourne Great Britain ATP World Tour 250,GRASS,2,Janko Tipsarevic,Brydan Klein,Janko Tipsarevic,7-6(5); 6-1,R16,79,11,2,37,62,31,37,13,25,1,2,10,44,62,4,1,33,54,26,33,8,21,3,6,9,34,54
2009-06-14 00:00:00.000,Eastbourne Great Britain ATP World Tour 250,GRASS,2,Denis Istomin,Sam Querrey,Denis Istomin,3-6; 7-6(3); 6-4,R16,111,6,3,56,99,45,56,24,43,7,8,15,69,99,17,3,60,102,46,60,26,42,5,6,16,72,102
2009-06-14 00:00:00.000,Eastbourne Great Britain ATP World Tour 250,GRASS,2,Dmitry Tursunov,Alex Bogdanovic,Dmitry Tursunov,6-7(2); 6-4; 7-6(5),R16,153,7,5,87,131,65,87,22,44,7,8,17,87,131,14,9,54,101,43,54,30,47,1,3,17,73,101
2009-06-14 00:00:00.000,Eastbourne Great Britain ATP World Tour 250,GRASS,2,Frank Dancevic,Leonardo Mayer,Frank Dancevic,6-7(4); 6-4; 7-5,Q,134,16,1,72,101,61,72,14,29,2,2,17,75,101,15,4,75,111,56,75,17,36,3,5,17,73,111
2009-06-14 00:00:00.000,Eastbourne Great Britain ATP World Tour 250,GRASS,2,Fabrice Santoro,Ivan Ljubicic,Fabrice Santoro,3-6; 4-2 RET,Q,63,2,0,19,42,14,19,15,23,0,1,7,29,42,8,1,33,47,25,33,8,14,2,3,8,33,47
2009-06-14 00:00:00.000,Eastbourne Great Britain ATP World Tour 250,GRASS,2,Guillermo Garcia-Lopez,Janko Tipsarevic,Guillermo Garcia-Lopez,6-4; 3-6; 6-3,Q,123,9,2,43,83,32,43,20,40,1,5,14,52,83,4,3,37,75,30,37,16,38,5,10,14,46,75
2009-06-14 00:00:00.000,Eastbourne Great Britain ATP World Tour 250,GRASS,2,Dmitry Tursunov,Denis Istomin,Dmitry Tursunov,7-6(6); 6-4,Q,94,3,4,47,70,40,47,13,23,3,3,11,53,70,8,1,54,81,36,54,17,27,9,10,11,53,81
2009-06-14 00:00:00.000,Eastbourne Great Britain ATP World Tour 250,GRASS,2,Frank Dancevic,Fabrice Santoro,Frank Dancevic,6-4; 6-4,S,84,7,2,47,77,35,47,16,30,6,6,10,51,77,2,2,34,54,28,34,9,20,3,5,10,37,54
2009-06-14 00:00:00.000,Eastbourne Great Britain ATP World Tour 250,GRASS,2,Dmitry Tursunov,Guillermo Garcia-Lopez,Dmitry Tursunov,6-2; 6-2,S,70,2,0,30,49,24,30,12,19,4,4,8,36,49,0,4,30,50,17,30,9,20,3,7,8,26,50
2009-06-14 00:00:00.000,Eastbourne Great Britain ATP World Tour 250,GRASS,2,Dmitry Tursunov,Frank Dancevic,Dmitry Tursunov,6-3; 7-6(5),F,83,12,2,37,61,32,37,17,24,0,0,11,49,61,10,2,45,63,35,45,9,18,2,3,10,44,63
2009-06-14 00:00:00.000,s-Hertogenbosch The Netherlands ATP World Tour 250,GRASS,2,Fernando Verdasco,Pablo Andujar,Fernando Verdasco,6-3; 7-5,R32,82,9,2,37,59,31,37,15,22,1,1,11,46,59,0,5,31,63,23,31,17,32,2,4,10,40,63
2009-06-14 00:00:00.000,s-Hertogenbosch The Netherlands ATP World Tour 250,GRASS,2,Benjamin Becker,Florent Serra,Benjamin Becker,6-3; 6-4,R32,54,15,5,38,62,30,38,13,24,2,2,10,43,62,3,1,33,53,22,33,9,20,4,6,9,31,53
2009-06-14 00:00:00.000,s-Hertogenbosch The Netherlands ATP World Tour 250,GRASS,2,Kristof Vliegen,Jan Hernych,Kristof Vliegen,2-6; 7-5; 6-2,R32,103,12,3,59,88,38,59,16,29,2,5,14,54,88,0,2,51,90,31,51,23,39,5,9,14,54,90
2009-06-14 00:00:00.000,s-Hertogenbosch The Netherlands ATP World Tour 250,GRASS,2,Michael Llodra,Mischa Zverev,Michael Llodra,4-1 RET,R32,20,3,0,8,13,8,8,4,5,0,0,3,12,13,1,0,7,16,2,7,6,9,3,4,2,8,16
2009-06-14 00:00:00.000,s-Hertogenbosch The Netherlands ATP World Tour 250,GRASS,2,Rainer Schuettler,Nicolas Devilder,Rainer Schuettler,6-4; 7-6(6),R32,100,3,1,47,71,28,47,16,24,3,6,11,44,71,2,6,51,89,33,51,13,38,9,13,11,46,89
2009-06-14 00:00:00.000,s-Hertogenbosch The Netherlands ATP World Tour 250,GRASS,2,Thiemo de Bakker,Bjorn Phau,Thiemo de Bakker,7-6(3); 2-6; 6-3,R32,115,6,2,50,83,39,50,14,33,4,8,14,53,83,5,10,64,108,45,64,16,44,8,12,15,61,108
2009-06-14 00:00:00.000,s-Hertogenbosch The Netherlands ATP World Tour 250,GRASS,2,Dick Norman,Daniel Berta,Dick Norman,6-3; 6-3,R32,60,11,5,21,44,18,21,18,23,0,0,9,36,44,1,2,20,51,13,20,18,31,1,4,9,31,51
2009-06-14 00:00:00.000,s-Hertogenbosch The Netherlands ATP World Tour 250,GRASS,2,Jeremy Chardy,Philipp Petzschner,Jeremy Chardy,6-1; 6-3,R32,52,7,1,27,44,24,27,10,17,0,0,8,34,44,6,5,20,49,14,20,12,29,4,8,8,26,49
2009-06-14 00:00:00.000,s-Hertogenbosch The Netherlands ATP World Tour 250,GRASS,2,Marc Gicquel,Steve Darcis,Marc Gicquel,6-2; 6-3,R32,60,7,1,34,52,29,34,10,18,1,1,9,39,52,3,1,31,51,20,31,8,20,4,7,8,28,51
2009-06-14 00:00:00.000,s-Hertogenbosch The Netherlands ATP World Tour 250,GRASS,2,Ivan Navarro,Gilles Muller,Ivan Navarro,7-5; 7-5,R32,84,15,3,42,67,36,42,14,25,4,4,12,50,67,5,2,36,62,27,36,19,26,2,4,12,46,62
2009-06-14 00:00:00.000,s-Hertogenbosch The Netherlands ATP World Tour 250,GRASS,2,Oscar Hernandez,Daniel Koellerer,Oscar Hernandez,6-3; 6-2,R32,72,8,3,36,59,29,36,13,23,3,3,9,42,59,2,1,34,48,20,34,5,14,3,6,8,25,48
2009-06-14 00:00:00.000,s-Hertogenbosch The Netherlands ATP World Tour 250,GRASS,2,David Ferrer,Jesse Huta Galung,David Ferrer,6-2; 7-5,R32,93,3,3,48,70,33,48,11,22,8,10,10,44,70,3,1,35,69,22,35,14,34,7,12,10,36,69
2009-06-14 00:00:00.000,s-Hertogenbosch The Netherlands ATP World Tour 250,GRASS,2,Igor Kunitsyn,Arnaud Clement,Igor Kunitsyn,6-2; 6-3,R32,78,8,2,26,47,22,26,13,21,2,2,8,35,47,2,4,39,64,24,39,8,25,4,8,9,32,64
2009-06-14 00:00:00.000,s-Hertogenbosch The Netherlands ATP World Tour 250,GRASS,2,Dudi Sela,Christophe Rochus,Dudi Sela,6-2; 6-4,R32,58,3,1,28,42,25,28,11,14,0,0,9,36,42,2,2,46,61,27,46,8,15,6,9,9,35,61
2009-06-14 00:00:00.000,s-Hertogenbosch The Netherlands ATP World Tour 250,GRASS,2,Raemon Sluiter,Daniel Gimeno-Traver,Raemon Sluiter,6-2; 7-5,R32,78,8,4,41,64,35,41,9,23,2,2,10,44,64,9,3,29,57,25,29,11,28,1,4,10,36,57
2009-06-14 00:00:00.000,s-Hertogenbosch The Netherlands ATP World Tour 250,GRASS,2,Marcos Baghdatis,Tommy Robredo,Marcos Baghdatis,7-5; 6-2,R32,78,5,0,28,52,23,28,16,24,2,3,10,39,52,2,4,39,69,24,39,13,30,4,8,10,37,69
2009-06-14 00:00:00.000,s-Hertogenbosch The Netherlands ATP World Tour 250,GRASS,2,Benjamin Becker,Fernando Verdasco,Benjamin Becker,7-5; 7-6(4),R16,104,10,2,42,82,34,42,25,40,3,3,12,59,82,9,7,48,86,36,48,20,38,2,3,12,56,86
2009-06-14 00:00:00.000,s-Hertogenbosch The Netherlands ATP World Tour 250,GRASS,2,Michael Llodra,Kristof Vliegen,Michael Llodra,6-2; 6-3,R16,67,8,1,29,49,24,29,13,20,2,2,9,37,49,3,2,42,63,23,42,13,21,7,10,8,36,63
2009-06-14 00:00:00.000,s-Hertogenbosch The Netherlands ATP World Tour 250,GRASS,2,Rainer Schuettler,Thiemo de Bakker,Rainer Schuettler,6-3; 7-6(3),R16,89,2,2,51,74,39,51,14,23,1,1,11,53,74,3,1,36,63,27,36,15,27,1,2,10,42,63
2009-06-14 00:00:00.000,s-Hertogenbosch The Netherlands ATP World Tour 250,GRASS,2,Jeremy Chardy,Dick Norman,Jeremy Chardy,3-6; 6-3; 6-3,R16,102,9,6,40,76,33,40,20,36,2,3,13,53,76,18,13,39,80,32,39,22,41,6,9,14,54,80
2009-06-14 00:00:00.000,s-Hertogenbosch The Netherlands ATP World Tour 250,GRASS,2,Ivan Navarro,Marc Gicquel,Ivan Navarro,6-4; 3-6; 7-5,R16,152,11,7,68,113,51,68,20,45,11,13,15,71,113,3,4,65,107,46,65,21,42,5,8,16,67,107
2009-06-14 00:00:00.000,s-Hertogenbosch The Netherlands ATP World Tour 250,GRASS,2,David Ferrer,Oscar Hernandez,David Ferrer,6-4; 6-3,R16,83,5,0,34,57,28,34,13,23,1,2,10,41,57,2,2,30,56,21,30,10,26,2,5,9,31,56
2009-06-14 00:00:00.000,s-Hertogenbosch The Netherlands ATP World Tour 250,GRASS,2,Dudi Sela,Igor Kunitsyn,Dudi Sela,6-4; 6-3,R16,86,0,2,44,74,32,44,16,30,14,14,9,48,74,5,5,40,61,32,40,6,21,1,4,10,38,61
2009-06-14 00:00:00.000,s-Hertogenbosch The Netherlands ATP World Tour 250,GRASS,2,Raemon Sluiter,Marcos Baghdatis,Raemon Sluiter,4-3 RET,R16,33,2,2,16,28,11,16,6,12,4,5,4,17,28,5,1,15,22,9,15,3,7,1,2,3,12,22
2009-06-14 00:00:00.000,s-Hertogenbosch The Netherlands ATP World Tour 250,GRASS,2,Benjamin Becker,Michael Llodra,Benjamin Becker,7-6(6); 7-5,Q,93,14,2,46,82,37,46,20,36,1,2,12,57,82,10,1,49,75,38,49,13,26,4,6,12,51,75
2009-06-14 00:00:00.000,s-Hertogenbosch The Netherlands ATP World Tour 250,GRASS,2,Rainer Schuettler,Jeremy Chardy,Rainer Schuettler,7-6(7); 3-6; 7-6(11),Q,149,5,6,73,108,53,73,22,35,2,5,16,75,108,16,7,68,110,55,68,22,42,6,8,17,77,110
2009-06-14 00:00:00.000,s-Hertogenbosch The Netherlands ATP World Tour 250,GRASS,2,Ivan Navarro,David Ferrer,Ivan Navarro,6-4; 6-2,Q,81,3,5,44,72,31,44,15,28,5,5,9,46,72,4,0,32,48,22,32,8,16,3,6,9,30,48
2009-06-14 00:00:00.000,s-Hertogenbosch The Netherlands ATP World Tour 250,GRASS,2,Raemon Sluiter,Dudi Sela,Raemon Sluiter,4-6; 6-4; 6-4,Q,126,8,1,63,88,47,63,14,25,5,7,15,61,88,5,4,60,96,44,60,18,36,8,11,15,62,96
2009-06-14 00:00:00.000,s-Hertogenbosch The Netherlands ATP World Tour 250,GRASS,2,Benjamin Becker,Rainer Schuettler,Benjamin Becker,3-6; 7-5; 6-1,S,103,7,1,51,81,36,51,16,30,0,3,14,52,81,2,0,62,82,36,62,10,20,3,8,14,46,82
2009-06-14 00:00:00.000,s-Hertogenbosch The Netherlands ATP World Tour 250,GRASS,2,Raemon Sluiter,Ivan Navarro,Raemon Sluiter,6-7(5); 6-2; 6-3,S,129,3,1,70,93,52,70,12,23,6,7,15,64,93,10,5,54,90,41,54,16,36,2,6,14,57,90
2009-06-14 00:00:00.000,s-Hertogenbosch The Netherlands ATP World Tour 250,GRASS,2,Benjamin Becker,Raemon Sluiter,Benjamin Becker,7-5; 6-3,F,76,11,0,38,57,33,38,12,19,0,0,11,45,57,6,1,44,61,31,44,9,17,3,5,10,40,61
2009-06-22 00:00:00.000,Wimbledon Great Britain Grand Slams,GRASS,3,Juan Martin Del Potro,Arnaud Clement,Juan Martin Del Potro,6-3; 6-1; 6-2,R128,97,10,0,41,59,35,41,13,18,0,0,12,48,59,3,6,27,73,19,27,19,46,3,9,12,38,73
2009-06-22 00:00:00.000,Wimbledon Great Britain Grand Slams,GRASS,3,Lleyton Hewitt,Robby Ginepri,Lleyton Hewitt,6-4; 6-1; 6-1,R128,92,13,3,40,68,37,40,13,28,3,4,12,50,68,3,6,49,88,24,49,16,39,11,18,12,40,88
2009-06-22 00:00:00.000,Wimbledon Great Britain Grand Slams,GRASS,3,Philipp Petzschner,Rajeev Ram,Philipp Petzschner,2-6; 6-1; 7-6(3); 6-1,R128,116,18,6,53,105,43,53,34,52,5,7,18,77,105,12,3,62,97,45,62,15,35,5,9,16,60,97
2009-06-22 00:00:00.000,Wimbledon Great Britain Grand Slams,GRASS,3,Mischa Zverev,Dmitry Tursunov,Mischa Zverev,6-4; 6-2; 3-0 RET,R128,83,6,0,46,62,37,46,9,16,1,1,10,46,62,6,5,41,74,30,41,9,33,5,10,11,39,74
2009-06-22 00:00:00.000,Wimbledon Great Britain Grand Slams,GRASS,3,Radek Stepanek,Alejandro Falla,Radek Stepanek,6-4; 6-4; 6-1,R128,110,5,3,51,81,38,51,17,30,4,5,13,55,81,2,8,55,91,34,55,12,36,3,9,14,46,91
2009-06-22 00:00:00.000,Wimbledon Great Britain Grand Slams,GRASS,3,Potito Starace,Jose Acasuso,Potito Starace,7-6; 6-3 RET,R128,77,3,0,40,51,36,40,7,11,0,0,10,43,51,4,2,44,69,32,44,11,25,3,5,11,43,69
2009-06-22 00:00:00.000,Wimbledon Great Britain Grand Slams,GRASS,3,Fabio Fognini,Denis Istomin,Fabio Fognini,1-6; 6-7(3); 6-4; 3-1 RET,R128,144,7,4,77,117,51,77,20,40,6,9,16,71,117,6,5,83,133,61,83,22,50,14,17,17,83,133
2009-06-22 00:00:00.000,Wimbledon Great Britain Grand Slams,GRASS,3,David Ferrer,Kevin Kim,David Ferrer,7-5; 6-3; 4-6; 6-2,R128,145,7,3,74,117,50,74,20,43,8,14,20,70,117,4,6,61,113,39,61,19,52,5,14,19,58,113
2009-06-22 00:00:00.000,Wimbledon Great Britain Grand Slams,GRASS,3,Nikolay Davydenko,Daniel Evans,Nikolay Davydenko,6-2; 6-3; 6-3,R128,109,3,3,47,64,36,47,9,17,0,3,13,45,64,3,5,65,98,35,65,10,33,7,15,13,45,98
2009-06-22 00:00:00.000,Wimbledon Great Britain Grand Slams,GRASS,3,Victor Crivoi,Bjorn Phau,Victor Crivoi,4-6; 6-1; 7-6(3); 2-6; 6-3,R128,178,5,1,96,143,62,96,29,47,5,10,24,91,143,13,6,75,145,48,75,38,70,7,12,22,86,145
2009-06-22 00:00:00.000,Wimbledon Great Britain Grand Slams,GRASS,3,Paul-Henri Mathieu,Frederico Gil,Paul-Henri Mathieu,6-1; 2-6; 6-4; 6-2,R128,125,13,6,64,100,53,64,15,36,3,5,17,68,100,12,1,60,97,43,60,14,37,6,11,16,57,97
2009-06-22 00:00:00.000,Wimbledon Great Britain Grand Slams,GRASS,3,Tomas Berdych,Alex Bogdanovic,Tomas Berdych,6-3; 6-4; 6-4,R128,88,9,1,44,72,41,44,21,28,0,0,15,62,72,5,3,47,74,37,47,12,27,2,5,14,49,74
2009-06-22 00:00:00.000,Wimbledon Great Britain Grand Slams,GRASS,3,Jurgen Melzer,Wayne Odesnik,Jurgen Melzer,6-1; 6-4; 6-2,R128,85,16,3,51,80,39,51,17,29,3,4,13,56,80,5,7,52,83,30,52,12,31,9,15,12,42,83
2009-06-22 00:00:00.000,Wimbledon Great Britain Grand Slams,GRASS,3,Benjamin Becker,Roko Karanusic,Benjamin Becker,6-4; 6-4; 6-1,R128,73,13,1,45,71,41,45,16,26,5,6,14,57,71,3,2,43,70,25,43,15,27,1,6,13,40,70
2009-06-22 00:00:00.000,Wimbledon Great Britain Grand Slams,GRASS,3,Igor Kunitsyn,Grigor Dimitrov,Igor Kunitsyn,3-6; 6-0; 3-0 RET,R128,75,4,4,31,58,22,31,15,27,3,5,9,37,58,3,6,40,70,22,40,10,30,8,13,9,32,70
2009-06-22 00:00:00.000,Wimbledon Great Britain Grand Slams,GRASS,3,Andy Roddick,Jeremy Chardy,Andy Roddick,6-3; 7-6(3); 4-6; 6-3,R128,132,21,1,76,106,68,76,18,30,1,3,21,86,106,14,6,63,120,51,63,29,57,7,10,19,80,120
2009-06-22 00:00:00.000,Wimbledon Great Britain Grand Slams,GRASS,3,Andy Murray,Robert Kendrick,Andy Murray,7-5; 6-7(3); 6-3; 6-4,R128,158,20,4,74,126,63,74,30,52,1,2,22,93,126,18,5,91,136,66,91,23,45,4,8,21,89,136
2009-06-22 00:00:00.000,Wimbledon Great Britain Grand Slams,GRASS,3,Ernests Gulbis,Riccardo Ghedin,Ernests Gulbis,6-2; 6-4; 6-4,R128,88,11,6,45,80,36,45,21,35,1,2,14,57,80,6,4,42,76,27,42,17,34,1,6,14,44,76
2009-06-22 00:00:00.000,Wimbledon Great Britain Grand Slams,GRASS,3,Daniel Gimeno-Traver,Taylor Dent,Daniel Gimeno-Traver,7-5; 7-6(6); 4-6; 6-7(3); 6-4,R128,205,5,6,113,162,87,113,28,49,3,6,28,115,162,12,20,94,182,77,94,44,88,11,15,28,121,182
2009-06-22 00:00:00.000,Wimbledon Great Britain Grand Slams,GRASS,3,Viktor Troicki,Brian Dabul,Viktor Troicki,6-4; 6-4; 6-3,R128,105,11,5,50,87,40,50,22,37,6,7,14,62,87,3,3,59,92,40,59,14,33,2,7,15,54,92
2009-06-22 00:00:00.000,Wimbledon Great Britain Grand Slams,GRASS,3,Stanislas Wawrinka,Eduardo Schwank,Stanislas Wawrinka,7-5; 6-4; 6-1,R128,112,11,0,54,89,43,54,20,35,6,6,14,63,89,8,5,60,96,42,60,13,36,2,7,15,55,96
2009-06-22 00:00:00.000,Wimbledon Great Britain Grand Slams,GRASS,3,Martin Vassallo Arguello,Pablo Andujar,Martin Vassallo Arguello,4-6; 6-3; 6-2; 6-2,R128,139,4,1,71,101,51,71,16,30,3,6,18,67,101,2,5,57,96,34,57,20,39,4,11,17,54,96
2009-06-22 00:00:00.000,Wimbledon Great Britain Grand Slams,GRASS,3,Pablo Cuevas,Christophe Rochus,Pablo Cuevas,3-6; 4-6; 6-4; 6-1; 11-9,R128,184,33,6,100,150,80,100,23,50,4,9,28,103,150,0,2,116,164,73,116,29,48,7,14,28,102,164
2009-06-22 00:00:00.000,Wimbledon Great Britain Grand Slams,GRASS,3,Jesse Levine,Marat Safin,Jesse Levine,6-2; 3-6; 7-6(4); 6-4,R128,136,11,10,68,119,59,68,25,51,11,13,19,84,119,13,2,78,123,55,78,24,45,4,8,20,79,123
2009-06-22 00:00:00.000,Wimbledon Great Britain Grand Slams,GRASS,3,Fernando Gonzalez,Teymuraz Gabashvili,Fernando Gonzalez,7-5; 7-5; 6-3,R128,134,18,3,63,109,50,63,24,46,4,5,17,74,109,8,9,48,105,36,48,28,57,8,12,16,64,105
2009-06-22 00:00:00.000,Wimbledon Great Britain Grand Slams,GRASS,3,Leonardo Mayer,Oscar Hernandez,Leonardo Mayer,6-0; 6-0; 6-3,R128,71,10,1,38,59,35,38,11,21,3,3,11,46,59,1,5,44,62,21,44,5,18,4,11,10,26,62
2009-06-22 00:00:00.000,Wimbledon Great Britain Grand Slams,GRASS,3,Juan Carlos Ferrero,Mikhail Youzhny,Juan Carlos Ferrero,6-3; 7-6(3); 6-3,R128,114,6,1,64,96,50,64,23,32,5,6,16,73,96,5,0,56,78,44,56,9,22,2,5,14,53,78
2009-06-22 00:00:00.000,Wimbledon Great Britain Grand Slams,GRASS,3,Fabrice Santoro,Nicolas Kiefer,Fabrice Santoro,6-4; 6-2; 6-2,R128,107,11,3,50,82,38,50,20,32,2,2,13,58,82,3,8,42,88,29,42,22,46,7,12,13,51,88
2009-06-22 00:00:00.000,Wimbledon Great Britain Grand Slams,GRASS,3,Victor Hanescu,Ivan Navarro,Victor Hanescu,6-3; 6-7(5); 6-4; 6-7(5); 12-10,R128,251,12,0,135,197,102,135,39,62,5,6,33,141,197,18,10,107,187,83,107,47,80,3,7,32,130,187
2009-06-22 00:00:00.000,Wimbledon Great Britain Grand Slams,GRASS,3,Nicolas Devilder,Nicolas Lapentti,Nicolas Devilder,3-6; 6-4; 6-3; 4-6; 7-5,R128,223,13,4,113,173,74,113,33,60,11,16,25,107,173,5,3,88,152,63,88,34,64,8,14,25,97,152
2009-06-22 00:00:00.000,Wimbledon Great Britain Grand Slams,GRASS,3,Thiago Alves,Andrei Pavel,Thiago Alves,6-3; 2-6; 6-1; 2-6; 6-1,R128,140,3,4,80,121,56,80,17,41,4,8,19,73,121,6,9,68,120,47,68,22,52,9,16,20,69,120
2009-06-22 00:00:00.000,Wimbledon Great Britain Grand Slams,GRASS,3,Gilles Simon,Bobby Reynolds,Gilles Simon,6-4; 6-3; 6-3,R128,96,14,3,50,78,39,50,18,28,2,3,14,57,78,4,4,60,94,40,60,12,34,5,10,14,52,94
2009-06-22 00:00:00.000,Wimbledon Great Britain Grand Slams,GRASS,3,Andreas Seppi,James Blake,Andreas Seppi,7-5; 6-4; 7-6(5),R128,129,9,2,69,108,48,69,24,39,4,6,17,72,108,11,2,81,127,55,81,21,46,11,15,17,76,127
2009-06-22 00:00:00.000,Wimbledon Great Britain Grand Slams,GRASS,3,Marc Gicquel,Adrian Mannarino,Marc Gicquel,6-2; 6-2; 6-4,R128,92,5,3,39,74,31,39,22,35,3,4,13,53,74,8,4,51,80,30,51,12,29,3,9,13,42,80
2009-06-22 00:00:00.000,Wimbledon Great Britain Grand Slams,GRASS,3,Vincent Spadea,Paul Capdeville,Vincent Spadea,6-0; 6-4; 7-5,R128,86,10,0,47,72,41,47,16,25,1,1,14,57,72,11,2,47,76,36,47,11,29,2,7,14,47,76
2009-06-22 00:00:00.000,Wimbledon Great Britain Grand Slams,GRASS,3,Igor Andreev,Evgeny Korolev,Igor Andreev,4-6; 7-6(2); 6-4; 7-6(4),R128,170,20,4,76,131,61,76,33,55,1,4,22,94,131,15,6,104,153,72,104,28,49,8,11,22,100,153
2009-06-22 00:00:00.000,Wimbledon Great Britain Grand Slams,GRASS,3,Tommy Haas,Alexander Peya,Tommy Haas,6-7(5); 7-6; 6-3; 6-4,R128,174,12,13,96,160,76,96,30,64,12,14,22,106,160,11,4,74,127,51,74,32,53,8,12,21,83,127
2009-06-22 00:00:00.000,Wimbledon Great Britain Grand Slams,GRASS,3,Michael Llodra,Josh Goodall,Michael Llodra,4-6; 7-6(5); 6-4; 3-6; 6-4,R128,194,25,4,101,150,78,101,29,49,6,9,25,107,150,17,7,109,173,84,109,32,64,15,18,26,116,173
2009-06-22 00:00:00.000,Wimbledon Great Britain Grand Slams,GRASS,3,Sam Querrey,Danai Udomchoke,Sam Querrey,6-3; 6-4; 6-4,R128,101,14,5,73,103,63,73,9,30,7,7,15,72,103,5,1,69,104,46,69,18,35,7,10,14,64,104
2009-06-22 00:00:00.000,Wimbledon Great Britain Grand Slams,GRASS,3,Marin Cilic,Alberto Martin,Marin Cilic,6-3; 6-4; 6-4,R128,110,12,1,57,90,42,57,23,33,4,4,15,65,90,2,1,56,89,36,56,19,33,5,8,14,55,89
2009-06-22 00:00:00.000,Wimbledon Great Britain Grand Slams,GRASS,3,Tommy Robredo,Luka Gregorc,Tommy Robredo,7-6(4); 6-4; 5-7; 7-6(3),R128,180,13,4,89,139,77,89,25,50,5,7,23,102,139,15,8,97,151,75,97,24,54,10,12,23,99,151
2009-06-22 00:00:00.000,Wimbledon Great Britain Grand Slams,GRASS,3,Stefan Koubek,Edouard Roger-Vasselin,Stefan Koubek,7-5; 6-3; 4-6; 3-6; 6-3,R128,194,9,5,85,149,60,85,32,64,8,12,24,92,149,4,3,100,154,67,100,28,54,6,12,25,95,154
2009-06-22 00:00:00.000,Wimbledon Great Britain Grand Slams,GRASS,3,Dudi Sela,Santiago Gonzalez,Dudi Sela,6-4; 4-6; 7-6(2); 6-3,R128,146,0,4,82,128,59,82,27,46,8,12,21,86,128,4,3,76,114,54,76,18,38,6,11,20,72,114
2009-06-22 00:00:00.000,Wimbledon Great Britain Grand Slams,GRASS,3,Rainer Schuettler,Xavier Malisse,Rainer Schuettler,6-7(9); 6-4; 7-6(3); 6-1,R128,178,8,5,94,138,68,94,24,44,4,7,21,92,138,15,2,80,135,52,80,28,55,4,10,20,80,135
2009-06-22 00:00:00.000,Wimbledon Great Britain Grand Slams,GRASS,3,Mardy Fish,Sergio Roitman,Mardy Fish,6-3; 6-2; 4-1 RET,R128,83,14,0,42,66,35,42,15,24,4,4,11,50,66,0,1,60,77,35,60,5,17,7,12,11,40,77
2009-06-22 00:00:00.000,Wimbledon Great Britain Grand Slams,GRASS,3,Janko Tipsarevic,Jan Hernych,Janko Tipsarevic,6-4; 6-4; 7-6(4),R128,133,10,3,57,97,46,57,17,40,2,5,16,63,97,9,0,65,97,42,65,14,32,1,6,16,56,97
2009-06-22 00:00:00.000,Wimbledon Great Britain Grand Slams,GRASS,3,Simon Greul,Michael Yani,Simon Greul,6-4; 6-2; 7-5,R128,111,4,3,64,103,48,64,22,39,4,4,15,70,103,4,5,46,80,36,46,16,34,2,6,15,52,80
2009-06-22 00:00:00.000,Wimbledon Great Britain Grand Slams,GRASS,3,Novak Djokovic,Julien Benneteau,Novak Djokovic,6-7(8); 7-6(1); 6-2; 6-4,R128,209,14,4,87,128,72,87,20,41,3,4,21,92,128,3,4,104,152,71,104,24,48,8,12,21,95,152
2009-06-22 00:00:00.000,Wimbledon Great Britain Grand Slams,GRASS,3,Fernando Verdasco,James Ward,Fernando Verdasco,6-1; 6-3; 6-4,R128,91,15,4,59,72,47,59,7,13,3,3,13,54,72,4,4,43,74,31,43,13,31,5,10,13,44,74
2009-06-22 00:00:00.000,Wimbledon Great Britain Grand Slams,GRASS,3,Kristof Vliegen,Nicolas Mahut,Kristof Vliegen,6-3; 7-6(6); 5-7; 5-7; 6-4,R128,213,23,5,99,157,77,99,29,58,8,12,27,106,157,22,6,96,165,73,96,36,69,4,9,28,109,165
2009-06-22 00:00:00.000,Wimbledon Great Britain Grand Slams,GRASS,3,Guillermo Canas,Diego Junqueira,Guillermo Canas,6-1; 6-2; 6-2,R128,84,9,2,32,61,28,32,21,29,2,2,12,49,61,0,5,34,65,18,34,12,31,5,11,11,30,65
2009-06-22 00:00:00.000,Wimbledon Great Britain Grand Slams,GRASS,3,Albert Montanes,Grega Zemlja,Albert Montanes,6-4; 6-4; 6-4,R128,98,11,2,61,89,51,61,15,28,3,3,15,66,89,5,4,58,91,39,58,18,33,3,6,15,57,91
2009-06-22 00:00:00.000,Wimbledon Great Britain Grand Slams,GRASS,3,Ivo Karlovic,Lukas Lacko,Ivo Karlovic,6-3; 7-6(4); 6-3,R128,108,28,3,60,87,56,60,16,27,4,4,16,72,87,8,2,69,97,49,69,12,28,3,5,14,61,97
2009-06-22 00:00:00.000,Wimbledon Great Britain Grand Slams,GRASS,3,Steve Darcis,Frank Dancevic,Steve Darcis,6-4; 7-6(4); 6-3,R128,100,8,0,51,93,43,51,31,42,3,3,16,74,93,13,2,61,82,46,61,12,21,1,3,15,58,82
2009-06-22 00:00:00.000,Wimbledon Great Britain Grand Slams,GRASS,3,Simone Bolelli,Daniel Koellerer,Simone Bolelli,6-7(3); 2-6; 7-5; 6-4; 6-4,R128,236,18,5,114,174,85,114,31,60,9,11,26,116,174,5,0,113,149,85,113,20,36,3,6,26,105,149
2009-06-22 00:00:00.000,Wimbledon Great Britain Grand Slams,GRASS,3,Jo-Wilfried Tsonga,Andrey Golubev,Jo-Wilfried Tsonga,6-3; 5-7; 7-6(4); 7-6(5),R128,202,15,3,91,138,69,91,32,47,2,4,23,101,138,6,5,122,182,85,122,31,60,11,13,22,116,182
2009-06-22 00:00:00.000,Wimbledon Great Britain Grand Slams,GRASS,3,Robin Soderling,Gilles Muller,Robin Soderling,6-7(4); 7-5; 6-1; 6-2,R128,126,31,2,82,117,67,82,21,35,8,8,20,88,117,17,4,68,110,51,68,21,42,3,8,19,72,110
2009-06-22 00:00:00.000,Wimbledon Great Britain Grand Slams,GRASS,3,Marcel Granollers,Andreas Beck,Marcel Granollers,6-2; 6-4; 6-7(4); 6-2,R128,160,20,4,73,115,62,73,18,42,4,5,19,80,115,2,13,84,133,58,84,18,49,10,16,19,76,133
2009-06-22 00:00:00.000,Wimbledon Great Britain Grand Slams,GRASS,3,Nicolas Almagro,Juan Monaco,Nicolas Almagro,6-7(3); 6-7(7); 7-6(5); 6-4; 8-6,R128,239,33,13,114,198,91,114,47,84,9,11,30,138,198,13,8,141,208,107,141,33,67,18,22,30,140,208
2009-06-22 00:00:00.000,Wimbledon Great Britain Grand Slams,GRASS,3,Karol Beck,Feliciano Lopez,Karol Beck,1-6; 7-5; 6-3; 4-6; 10-8,R128,226,13,5,108,174,72,108,34,66,9,16,28,106,174,18,7,95,151,66,95,32,56,4,11,28,98,151
2009-06-22 00:00:00.000,Wimbledon Great Britain Grand Slams,GRASS,3,Philipp Kohlschreiber,Florent Serra,Philipp Kohlschreiber,7-6(3); 6-1; 6-4,R128,105,8,2,43,77,34,43,25,34,2,5,15,59,77,5,2,64,99,35,64,18,35,7,13,14,53,99
2009-06-22 00:00:00.000,Wimbledon Great Britain Grand Slams,GRASS,3,Ivo Minar,Maximo Gonzalez,Ivo Minar,6-4; 3-6; 7-5; 6-0,R128,117,9,0,69,99,53,69,18,30,2,4,18,71,99,3,3,71,113,46,71,19,42,8,14,19,65,113
2009-06-22 00:00:00.000,Wimbledon Great Britain Grand Slams,GRASS,3,Guillermo Garcia-Lopez,Agustin Calleri,Guillermo Garcia-Lopez,6-2; 6-3; 6-2,R128,99,6,4,47,70,38,47,16,23,1,2,13,54,70,1,5,63,86,37,63,8,23,2,8,12,45,86
2009-06-22 00:00:00.000,Wimbledon Great Britain Grand Slams,GRASS,3,Roger Federer,Yen-Hsun Lu,Roger Federer,7-5; 6-3; 6-2,R128,105,10,1,53,75,45,53,15,22,2,3,15,60,75,3,1,64,93,40,64,13,29,6,11,14,53,93
2009-06-22 00:00:00.000,Wimbledon Great Britain Grand Slams,GRASS,3,Lleyton Hewitt,Juan Martin Del Potro,Lleyton Hewitt,6-3; 7-5; 7-5,R64,153,14,3,59,115,49,59,29,56,7,8,17,78,115,10,4,55,93,40,55,18,38,5,9,16,58,93
2009-06-22 00:00:00.000,Wimbledon Great Britain Grand Slams,GRASS,3,Philipp Petzschner,Mischa Zverev,Philipp Petzschner,4-6; 7-6(13); 3-6; 7-6(5); 6-0,R64,216,19,8,97,185,72,97,46,88,7,12,24,118,185,9,1,101,156,76,101,26,55,0,6,25,102,156
2009-06-22 00:00:00.000,Wimbledon Great Britain Grand Slams,GRASS,3,Radek Stepanek,Potito Starace,Radek Stepanek,6-4; 4-6; 6-2; 4-6; 6-3,R64,166,15,4,90,131,70,90,22,41,1,5,24,92,131,6,2,88,143,63,88,24,55,5,11,23,87,143
2009-06-22 00:00:00.000,Wimbledon Great Britain Grand Slams,GRASS,3,David Ferrer,Fabio Fognini,David Ferrer,6-2; 6-2; 6-3,R64,97,3,3,43,73,31,43,16,30,3,6,13,47,73,2,7,55,91,31,55,11,36,9,17,12,42,91
2009-06-22 00:00:00.000,Wimbledon Great Britain Grand Slams,GRASS,3,Nikolay Davydenko,Victor Crivoi,Nikolay Davydenko,6-4; 6-4; 6-2,R64,99,7,3,50,81,42,50,15,31,3,4,14,57,81,3,2,57,80,35,57,10,23,2,7,14,45,80
2009-06-22 00:00:00.000,Wimbledon Great Britain Grand Slams,GRASS,3,Tomas Berdych,Paul-Henri Mathieu,Tomas Berdych,6-2; 6-4; 6-4,R64,117,15,3,47,75,43,47,17,28,1,1,14,60,75,14,3,62,111,44,62,18,49,12,16,14,62,111
2009-06-22 00:00:00.000,Wimbledon Great Britain Grand Slams,GRASS,3,Jurgen Melzer,Benjamin Becker,Jurgen Melzer,7-6(6); 6-3; 7-6(1),R64,138,12,4,53,105,43,53,32,52,5,7,17,75,105,8,1,66,111,47,66,21,45,10,13,16,68,111
2009-06-22 00:00:00.000,Wimbledon Great Britain Grand Slams,GRASS,3,Andy Roddick,Igor Kunitsyn,Andy Roddick,6-4; 6-2; 3-6; 6-2,R64,127,18,5,60,86,50,60,16,26,1,2,17,66,86,7,2,77,116,50,77,19,39,7,12,18,69,116
2009-06-22 00:00:00.000,Wimbledon Great Britain Grand Slams,GRASS,3,Andy Murray,Ernests Gulbis,Andy Murray,6-2; 7-5; 6-3,R64,89,11,1,52,71,46,52,13,19,2,2,14,59,71,15,2,64,92,44,64,10,28,2,7,15,54,92
2009-06-22 00:00:00.000,Wimbledon Great Britain Grand Slams,GRASS,3,Viktor Troicki,Daniel Gimeno-Traver,Viktor Troicki,6-7(5); 6-0; 1-6; 6-3; 7-5,R64,183,24,10,95,150,71,95,30,55,9,12,23,101,150,4,11,87,141,65,87,23,54,3,9,23,88,141
2009-06-22 00:00:00.000,Wimbledon Great Britain Grand Slams,GRASS,3,Stanislas Wawrinka,Martin Vassallo Arguello,Stanislas Wawrinka,6-3; 6-2; 6-2,R64,85,10,3,38,67,33,38,21,29,3,3,13,54,67,2,1,44,65,28,44,9,21,2,7,12,37,65
2009-06-22 00:00:00.000,Wimbledon Great Britain Grand Slams,GRASS,3,Jesse Levine,Pablo Cuevas,Jesse Levine,6-2; 6-1; 4-6; 4-6; 6-3,R64,158,6,5,84,140,61,84,28,56,3,7,22,89,140,14,4,91,142,55,91,23,51,7,15,22,78,142
2009-06-22 00:00:00.000,Wimbledon Great Britain Grand Slams,GRASS,3,Fernando Gonzalez,Leonardo Mayer,Fernando Gonzalez,6-7(4); 6-4; 6-4; 6-4,R64,141,14,7,79,118,70,79,22,39,3,3,21,92,118,11,1,70,109,58,70,25,39,1,4,21,83,109
2009-06-22 00:00:00.000,Wimbledon Great Britain Grand Slams,GRASS,3,Juan Carlos Ferrero,Fabrice Santoro,Juan Carlos Ferrero,6-7(1); 6-3; 6-4; 6-3,R64,162,8,2,65,109,51,65,29,44,4,6,20,80,109,7,3,86,140,58,86,24,54,13,19,20,82,140
2009-06-22 00:00:00.000,Wimbledon Great Britain Grand Slams,GRASS,3,Victor Hanescu,Nicolas Devilder,Victor Hanescu,6-2; 6-3; 6-1,R64,89,11,1,48,72,37,48,14,24,5,5,12,51,72,4,7,41,75,22,41,16,34,5,11,12,38,75
2009-06-22 00:00:00.000,Wimbledon Great Britain Grand Slams,GRASS,3,Gilles Simon,Thiago Alves,Gilles Simon,5-7; 6-3; 6-4; 6-4,R64,158,23,5,62,127,52,62,36,65,11,13,21,88,127,5,7,70,140,55,70,31,70,10,14,20,86,140
2009-06-22 00:00:00.000,Wimbledon Great Britain Grand Slams,GRASS,3,Andreas Seppi,Marc Gicquel,Andreas Seppi,7-5; 6-4; 6-7(3); 5-7; 6-4,R64,230,8,6,111,176,75,111,36,65,11,16,28,111,176,21,6,123,190,90,123,27,67,10,17,28,117,190
2009-06-22 00:00:00.000,Wimbledon Great Britain Grand Slams,GRASS,3,Igor Andreev,Vincent Spadea,Igor Andreev,6-3; 7-5; 6-2,R64,102,6,1,53,78,40,53,16,25,3,4,14,56,78,4,9,59,98,38,59,17,39,5,11,15,55,98
2009-06-22 00:00:00.000,Wimbledon Great Britain Grand Slams,GRASS,3,Tommy Haas,Michael Llodra,Tommy Haas,4-3 RET,R64,30,3,1,16,21,15,16,1,5,0,0,4,16,21,2,0,12,19,9,12,4,7,0,0,3,13,19
2009-06-22 00:00:00.000,Wimbledon Great Britain Grand Slams,GRASS,3,Marin Cilic,Sam Querrey,Marin Cilic,4-6; 7-6(3); 6-3; 6-7(4); 6-4,R64,204,13,9,108,185,83,108,42,77,12,15,27,125,185,24,3,107,154,83,107,24,47,3,7,26,107,154
2009-06-22 00:00:00.000,Wimbledon Great Britain Grand Slams,GRASS,3,Tommy Robredo,Stefan Koubek,Tommy Robredo,3-6; 4-6; 6-4; 7-6(5); 6-1,R64,210,11,4,88,143,68,88,31,55,5,8,23,99,143,3,5,120,188,84,120,32,68,18,23,25,116,188
2009-06-22 00:00:00.000,Wimbledon Great Britain Grand Slams,GRASS,3,Dudi Sela,Rainer Schuettler,Dudi Sela,7-6(3); 6-3; 6-2,R64,124,2,1,60,90,50,60,13,30,0,1,15,63,90,3,7,68,108,39,68,20,40,6,10,14,59,108
2009-06-22 00:00:00.000,Wimbledon Great Britain Grand Slams,GRASS,3,Mardy Fish,Janko Tipsarevic,Mardy Fish,6-4; 3-6; 6-1; 6-4,R64,150,11,2,57,94,44,57,22,37,2,5,18,66,94,8,3,62,117,37,62,28,55,7,13,18,65,117
2009-06-22 00:00:00.000,Wimbledon Great Britain Grand Slams,GRASS,3,Novak Djokovic,Simon Greul,Novak Djokovic,7-5; 6-1; 6-4,R64,120,13,6,63,97,40,63,18,34,6,10,15,58,97,0,2,53,87,26,53,16,34,7,15,14,42,87
2009-06-22 00:00:00.000,Wimbledon Great Britain Grand Slams,GRASS,3,Fernando Verdasco,Kristof Vliegen,Fernando Verdasco,7-6(3); 6-7(3); 7-6(4); 6-4,R64,175,20,7,92,140,72,92,33,48,0,0,23,105,140,12,1,103,145,77,103,27,42,4,5,23,104,145
2009-06-22 00:00:00.000,Wimbledon Great Britain Grand Slams,GRASS,3,Albert Montanes,Guillermo Canas,Albert Montanes,6-4; 6-3; 4-6; 6-3,R64,167,4,4,74,133,52,74,32,59,14,17,19,84,133,4,3,53,105,41,53,23,52,4,10,19,64,105
2009-06-22 00:00:00.000,Wimbledon Great Britain Grand Slams,GRASS,3,Ivo Karlovic,Steve Darcis,Ivo Karlovic,7-5; 6-3; 6-4,R64,104,24,1,54,77,46,54,18,23,0,0,16,64,77,3,8,59,95,46,59,15,36,7,10,15,61,95
2009-06-22 00:00:00.000,Wimbledon Great Britain Grand Slams,GRASS,3,Jo-Wilfried Tsonga,Simone Bolelli,Jo-Wilfried Tsonga,W/O,R64,0,0,0,0,0,0,0,0,0,0,0,0,0,0,0,0,0,0,0,0,0,0,0,0,0,0,0
2009-06-22 00:00:00.000,Wimbledon Great Britain Grand Slams,GRASS,3,Robin Soderling,Marcel Granollers,Robin Soderling,4-6; 7-6(7); 6-4; 7-5,R64,167,12,4,82,133,67,82,29,51,2,3,22,96,133,23,7,79,130,65,79,28,51,3,5,22,93,130
2009-06-22 00:00:00.000,Wimbledon Great Britain Grand Slams,GRASS,3,Nicolas Almagro,Karol Beck,Nicolas Almagro,6-4; 7-6(2); 3-6; 3-6; 7-5,R64,184,28,5,77,148,59,77,44,71,7,10,26,103,148,16,4,98,154,73,98,35,56,5,7,26,108,154
2009-06-22 00:00:00.000,Wimbledon Great Britain Grand Slams,GRASS,3,Philipp Kohlschreiber,Ivo Minar,Philipp Kohlschreiber,6-4; 3-6; 4-6; 6-2; 8-6,R64,176,10,1,95,140,77,95,25,45,3,5,25,102,140,14,3,117,179,80,117,33,62,9,13,26,113,179
2009-06-22 00:00:00.000,Wimbledon Great Britain Grand Slams,GRASS,3,Roger Federer,Guillermo Garcia-Lopez,Roger Federer,6-2; 6-2; 6-4,R64,90,11,2,48,75,44,48,13,27,2,2,13,57,75,3,6,55,74,35,55,9,19,2,7,13,44,74
2009-06-22 00:00:00.000,Wimbledon Great Britain Grand Slams,GRASS,3,Lleyton Hewitt,Philipp Petzschner,Lleyton Hewitt,7-5; 7-6(3); 6-3,R32,148,9,5,49,101,40,49,34,52,3,3,16,74,101,16,4,56,114,43,56,30,58,9,12,17,73,114
2009-06-22 00:00:00.000,Wimbledon Great Britain Grand Slams,GRASS,3,Radek Stepanek,David Ferrer,Radek Stepanek,7-5; 7-5; 3-6; 4-6; 6-4,R32,224,9,5,100,163,75,100,32,63,5,9,26,107,163,12,11,110,170,79,110,30,60,4,9,27,109,170
2009-06-22 00:00:00.000,Wimbledon Great Britain Grand Slams,GRASS,3,Tomas Berdych,Nikolay Davydenko,Tomas Berdych,6-2; 6-3; 6-2,R32,108,13,1,44,73,40,44,15,29,4,5,13,55,73,5,4,50,81,33,50,9,31,5,11,12,42,81
2009-06-22 00:00:00.000,Wimbledon Great Britain Grand Slams,GRASS,3,Andy Roddick,Jurgen Melzer,Andy Roddick,7-6(2); 7-6(2); 4-6; 6-3,R32,174,33,1,88,123,70,88,24,35,3,5,22,94,123,26,4,82,138,63,82,28,56,7,9,21,91,138
2009-06-22 00:00:00.000,Wimbledon Great Britain Grand Slams,GRASS,3,Andy Murray,Viktor Troicki,Andy Murray,6-2; 6-3; 6-4,R32,97,17,1,49,75,43,49,14,26,1,1,14,57,75,4,6,49,85,36,49,13,36,4,8,13,49,85
2009-06-22 00:00:00.000,Wimbledon Great Britain Grand Slams,GRASS,3,Stanislas Wawrinka,Jesse Levine,Stanislas Wawrinka,5-7; 7-5; 6-3; 6-3,R32,188,17,4,75,123,62,75,20,48,2,5,21,82,123,10,9,98,161,67,98,26,63,17,23,21,93,161
2009-06-22 00:00:00.000,Wimbledon Great Britain Grand Slams,GRASS,3,Juan Carlos Ferrero,Fernando Gonzalez,Juan Carlos Ferrero,4-6; 7-5; 6-4; 4-6; 6-4,R32,181,14,1,115,166,86,115,28,51,8,10,26,114,166,24,5,87,135,73,87,28,48,4,7,26,101,135
2009-06-22 00:00:00.000,Wimbledon Great Britain Grand Slams,GRASS,3,Gilles Simon,Victor Hanescu,Gilles Simon,6-2; 7-5; 6-2,R32,87,10,1,51,77,40,51,18,26,5,5,14,58,77,5,2,60,82,37,60,10,22,3,8,14,47,82
2009-06-22 00:00:00.000,Wimbledon Great Britain Grand Slams,GRASS,3,Igor Andreev,Andreas Seppi,Igor Andreev,6-1; 7-6(5); 4-6; 7-6(5),R32,183,14,3,82,140,62,82,32,58,6,10,21,94,140,3,3,86,136,54,86,28,50,2,7,20,82,136
2009-06-22 00:00:00.000,Wimbledon Great Britain Grand Slams,GRASS,3,Tommy Haas,Marin Cilic,Tommy Haas,7-5; 7-5; 1-6; 6-7(3); 10-8,R32,268,2,13,116,196,83,116,43,80,8,13,30,126,196,28,11,114,191,90,114,36,77,5,11,31,126,191
2009-06-22 00:00:00.000,Wimbledon Great Britain Grand Slams,GRASS,3,Dudi Sela,Tommy Robredo,Dudi Sela,7-6(8); 7-5; 2-6; 7-5,R32,179,0,3,84,132,53,84,26,48,4,10,22,79,132,10,5,78,131,56,78,25,53,3,9,22,81,131
2009-06-22 00:00:00.000,Wimbledon Great Britain Grand Slams,GRASS,3,Novak Djokovic,Mardy Fish,Novak Djokovic,6-4; 6-4; 6-4,R32,119,8,1,51,81,38,51,23,30,0,1,15,61,81,6,1,56,96,42,56,16,40,8,12,15,58,96
2009-06-22 00:00:00.000,Wimbledon Great Britain Grand Slams,GRASS,3,Fernando Verdasco,Albert Montanes,Fernando Verdasco,4-6; 6-1; 6-4; 7-6(2),R32,138,16,5,87,114,71,87,15,27,4,5,20,86,114,5,0,64,111,50,64,24,47,6,9,19,74,111
2009-06-22 00:00:00.000,Wimbledon Great Britain Grand Slams,GRASS,3,Ivo Karlovic,Jo-Wilfried Tsonga,Ivo Karlovic,7-6(5); 6-7(5); 7-5; 7-6(5),R32,165,47,2,102,130,92,102,19,28,0,0,24,111,130,26,3,94,138,82,94,27,44,1,2,24,109,138
2009-06-22 00:00:00.000,Wimbledon Great Britain Grand Slams,GRASS,3,Robin Soderling,Nicolas Almagro,Robin Soderling,7-6(7); 6-4; 6-4,R32,117,19,3,53,89,50,53,20,36,0,0,16,70,89,20,3,53,110,44,53,27,57,4,6,16,71,110
2009-06-22 00:00:00.000,Wimbledon Great Britain Grand Slams,GRASS,3,Roger Federer,Philipp Kohlschreiber,Roger Federer,6-3; 6-2; 6-7(5); 6-1,R32,151,15,2,87,126,66,87,20,39,5,7,19,86,126,5,4,81,126,50,81,20,45,15,22,17,70,126
2009-06-22 00:00:00.000,Wimbledon Great Britain Grand Slams,GRASS,3,Lleyton Hewitt,Radek Stepanek,Lleyton Hewitt,4-6; 2-6; 6-1; 6-2; 6-2,R16,175,14,7,60,117,51,60,29,57,6,10,21,80,117,11,6,80,134,54,80,22,54,8,15,20,76,134
2009-06-22 00:00:00.000,Wimbledon Great Britain Grand Slams,GRASS,3,Andy Roddick,Tomas Berdych,Andy Roddick,7-6(4); 6-4; 6-3,R16,109,24,0,57,82,51,57,20,25,0,0,16,71,82,9,3,63,96,49,63,16,33,6,8,15,65,96
2009-06-22 00:00:00.000,Wimbledon Great Britain Grand Slams,GRASS,3,Andy Murray,Stanislas Wawrinka,Andy Murray,2-6; 6-3; 6-3; 5-7; 6-3,R16,237,8,4,82,150,61,82,38,68,10,14,24,99,150,17,3,104,162,67,104,29,58,6,11,23,96,162
2009-06-22 00:00:00.000,Wimbledon Great Britain Grand Slams,GRASS,3,Juan Carlos Ferrero,Gilles Simon,Juan Carlos Ferrero,7-6(4); 6-3; 6-2,R16,119,7,1,55,91,45,55,21,36,5,7,15,66,91,6,4,41,93,32,41,23,52,4,9,14,55,93
2009-06-22 00:00:00.000,Wimbledon Great Britain Grand Slams,GRASS,3,Tommy Haas,Igor Andreev,Tommy Haas,7-6(8); 6-4; 6-4,R16,135,12,7,57,92,54,57,20,35,0,0,16,74,92,15,2,74,116,54,74,21,42,5,7,16,75,116
2009-06-22 00:00:00.000,Wimbledon Great Britain Grand Slams,GRASS,3,Novak Djokovic,Dudi Sela,Novak Djokovic,6-2; 6-4; 6-1,R16,90,11,4,46,72,37,46,12,26,4,6,13,49,72,1,2,46,71,26,46,10,25,7,14,12,36,71
2009-06-22 00:00:00.000,Wimbledon Great Britain Grand Slams,GRASS,3,Ivo Karlovic,Fernando Verdasco,Ivo Karlovic,7-6(5); 6-7(4); 6-3; 7-6(9),R16,181,36,5,94,131,88,94,21,37,0,0,23,109,131,7,8,99,146,81,99,27,47,5,6,22,108,146
2009-06-22 00:00:00.000,Wimbledon Great Britain Grand Slams,GRASS,3,Roger Federer,Robin Soderling,Roger Federer,6-4; 7-6(5); 7-6(5),R16,119,23,0,68,102,60,68,21,34,2,2,17,81,102,16,3,55,98,50,55,26,43,3,4,17,76,98
2009-06-22 00:00:00.000,Wimbledon Great Britain Grand Slams,GRASS,3,Andy Roddick,Lleyton Hewitt,Andy Roddick,6-3; 6-7(10); 7-6(1); 4-6; 6-4,Q,231,43,4,121,165,89,121,27,44,5,8,27,116,165,21,9,114,192,87,114,38,78,11,15,26,125,192
2009-06-22 00:00:00.000,Wimbledon Great Britain Grand Slams,GRASS,3,Andy Murray,Juan Carlos Ferrero,Andy Murray,7-5; 6-3; 6-2,Q,102,18,1,48,76,42,48,17,28,1,2,15,59,76,3,3,62,88,37,62,10,26,5,10,14,47,88
2009-06-22 00:00:00.000,Wimbledon Great Britain Grand Slams,GRASS,3,Tommy Haas,Novak Djokovic,Tommy Haas,7-5; 7-6(6); 4-6; 6-3,Q,165,18,7,77,124,62,77,28,47,0,2,22,90,124,13,4,73,124,58,73,28,51,2,5,21,86,124
2009-06-22 00:00:00.000,Wimbledon Great Britain Grand Slams,GRASS,3,Roger Federer,Ivo Karlovic,Roger Federer,6-3; 7-5; 7-6(3),Q,103,7,2,53,85,50,53,24,32,0,0,17,74,85,23,2,57,82,46,57,15,25,0,2,16,61,82
2009-06-22 00:00:00.000,Wimbledon Great Britain Grand Slams,GRASS,3,Andy Roddick,Andy Murray,Andy Roddick,6-4; 4-6; 7-6(7); 7-6(5),S,187,21,1,102,137,79,102,18,35,5,7,22,97,137,25,5,75,146,62,75,38,71,3,5,22,100,146
2009-06-22 00:00:00.000,Wimbledon Great Britain Grand Slams,GRASS,3,Roger Federer,Tommy Haas,Roger Federer,7-6(3); 7-5; 6-3,S,123,11,1,62,83,55,62,17,21,0,0,17,72,83,11,5,72,110,53,72,17,38,6,8,16,70,110
2009-06-22 00:00:00.000,Wimbledon Great Britain Grand Slams,GRASS,3,Roger Federer,Andy Roddick,Roger Federer,5-7; 7-6(6); 7-6(5); 3-6; 16-14,F,256,50,4,127,197,113,127,42,70,3,5,37,155,197,27,4,169,239,140,169,31,70,6,7,38,171,239
2009-07-06 00:00:00.000,Newport RI; U.S.A. ATP World Tour 250,GRASS,2,Rajeev Ram,Alejandro Falla,Rajeev Ram,6-4; 7-5,R32,72,6,0,40,60,35,40,11,20,0,0,11,46,60,3,7,45,75,35,45,13,30,3,5,11,48,75
2009-07-06 00:00:00.000,Newport RI; U.S.A. ATP World Tour 250,GRASS,2,Samuel Groth,Ricardo Mello,Samuel Groth,7-5; 3-6; 6-3,R32,106,9,10,47,100,33,47,27,53,5,8,15,60,100,1,4,49,84,32,49,21,35,0,4,15,53,84
2009-07-06 00:00:00.000,Newport RI; U.S.A. ATP World Tour 250,GRASS,2,Jesse Levine,Chris Guccione,Jesse Levine,7-6(2); 7-6(2),R32,98,13,7,72,108,48,72,18,36,7,9,12,66,108,14,2,54,77,42,54,8,23,3,5,12,50,77
2009-07-06 00:00:00.000,Newport RI; U.S.A. ATP World Tour 250,GRASS,2,Philipp Petzschner,Horacio Zeballos,Philipp Petzschner,6-4; 6-7(4); 6-2,R32,97,13,8,56,93,48,56,16,37,5,6,15,64,93,5,6,51,89,38,51,21,38,7,11,15,59,89
2009-07-06 00:00:00.000,Newport RI; U.S.A. ATP World Tour 250,GRASS,2,Brendan Evans,Benjamin Becker,Brendan Evans,7-6(5); 3-6; 7-5,R32,114,10,1,74,105,54,74,18,31,6,8,16,72,105,12,10,58,106,44,58,28,48,4,6,17,72,106
2009-07-06 00:00:00.000,Newport RI; U.S.A. ATP World Tour 250,GRASS,2,Robby Ginepri,Santiago Ventura,Robby Ginepri,6-2; 1-6; 6-4,R32,95,7,4,49,81,34,49,15,32,7,11,13,49,81,1,5,47,83,29,47,16,36,6,10,12,45,83
2009-07-06 00:00:00.000,Newport RI; U.S.A. ATP World Tour 250,GRASS,2,Olivier Rochus,Alexander Peya,Olivier Rochus,6-2; 4-6; 6-4,R32,103,0,3,55,94,38,55,22,39,5,7,14,60,94,3,1,50,85,35,50,16,35,1,5,14,51,85
2009-07-06 00:00:00.000,Newport RI; U.S.A. ATP World Tour 250,GRASS,2,Sergiy Stakhovsky,Frank Dancevic,Sergiy Stakhovsky,7-6(9); 2-6; 7-5,R32,118,10,6,73,111,58,73,17,38,8,10,16,75,111,7,0,74,116,55,74,22,42,4,5,16,77,116
2009-07-06 00:00:00.000,Newport RI; U.S.A. ATP World Tour 250,GRASS,2,Kevin Kim,Sebastien Grosjean,Kevin Kim,4-6; 6-3 RET,R32,92,1,6,22,54,17,22,16,32,0,2,9,33,54,5,6,59,96,35,59,17,37,13,16,10,52,96
2009-07-06 00:00:00.000,Newport RI; U.S.A. ATP World Tour 250,GRASS,2,Daniel Brands,Vincent Spadea,Daniel Brands,6-0; 6-4,R32,60,6,4,29,50,23,29,12,21,5,5,8,35,50,5,9,29,63,21,29,11,34,11,15,8,32,63
2009-07-06 00:00:00.000,Newport RI; U.S.A. ATP World Tour 250,GRASS,2,Prakash Amritraj,Danai Udomchoke,Prakash Amritraj,6-1; 6-4,R32,63,4,3,29,53,21,29,17,24,3,3,9,38,53,5,5,30,54,19,30,11,24,2,5,8,30,54
2009-07-06 00:00:00.000,Newport RI; U.S.A. ATP World Tour 250,GRASS,2,Sam Querrey,Ruben Ramirez Hidalgo,Sam Querrey,6-3; 6-2,R32,60,6,4,22,48,18,22,15,26,1,2,9,33,48,2,6,24,57,15,24,13,33,3,7,8,28,57
2009-07-06 00:00:00.000,Newport RI; U.S.A. ATP World Tour 250,GRASS,2,Alex Bogomolov Jr.,Arnaud Clement,Alex Bogomolov Jr.,1-6; 6-3; 6-4,R32,115,0,3,42,72,26,42,18,30,4,8,13,44,72,2,8,43,90,26,43,26,47,6,10,13,52,90
2009-07-06 00:00:00.000,Newport RI; U.S.A. ATP World Tour 250,GRASS,2,Nicolas Mahut,Amer Delic,Nicolas Mahut,6-4; 6-4,R32,65,8,5,29,49,27,29,13,20,0,0,10,40,49,6,4,40,61,27,40,11,21,2,4,10,38,61
2009-07-06 00:00:00.000,Newport RI; U.S.A. ATP World Tour 250,GRASS,2,Taylor Dent,Marcos Daniel,Taylor Dent,6-2; 6-1,R32,49,8,5,22,43,21,22,12,21,0,0,8,33,43,3,4,25,50,14,25,12,25,5,9,7,26,50
2009-07-06 00:00:00.000,Newport RI; U.S.A. ATP World Tour 250,GRASS,2,Fabrice Santoro,Flavio Cipolla,Fabrice Santoro,6-3; 7-5,R32,82,2,1,49,76,34,49,17,27,11,12,11,51,76,3,5,41,69,33,41,6,28,8,11,10,39,69
2009-07-06 00:00:00.000,Newport RI; U.S.A. ATP World Tour 250,GRASS,2,Rajeev Ram,Samuel Groth,Rajeev Ram,6-4; 6-2,R16,63,5,1,30,50,24,30,15,20,0,0,9,39,50,8,5,23,52,18,23,14,29,6,9,9,32,52
2009-07-06 00:00:00.000,Newport RI; U.S.A. ATP World Tour 250,GRASS,2,Jesse Levine,Philipp Petzschner,Jesse Levine,7-6(3); 6-2,R16,82,4,8,40,76,33,40,20,36,10,10,10,53,76,5,7,41,76,29,41,16,35,5,7,10,45,76
2009-07-06 00:00:00.000,Newport RI; U.S.A. ATP World Tour 250,GRASS,2,Brendan Evans,Robby Ginepri,Brendan Evans,6-3; 6-4,R16,59,5,1,44,66,34,44,12,22,2,3,10,46,66,2,1,41,58,25,41,9,17,2,5,9,34,58
2009-07-06 00:00:00.000,Newport RI; U.S.A. ATP World Tour 250,GRASS,2,Olivier Rochus,Sergiy Stakhovsky,Olivier Rochus,5-7; 7-6(2); 6-3,R16,121,1,4,68,111,49,68,26,43,2,4,17,75,111,6,3,60,100,47,60,21,40,3,5,16,68,100
2009-07-06 00:00:00.000,Newport RI; U.S.A. ATP World Tour 250,GRASS,2,Kevin Kim,Daniel Brands,Kevin Kim,4-6; 7-6(5); 6-4,R16,122,10,13,56,114,44,56,28,58,7,10,16,72,114,12,7,70,116,51,70,25,46,5,8,16,76,116
2009-07-06 00:00:00.000,Newport RI; U.S.A. ATP World Tour 250,GRASS,2,Sam Querrey,Prakash Amritraj,Sam Querrey,6-7(7); 6-3; 6-2,R16,113,31,10,68,103,56,68,15,35,4,4,15,71,103,7,5,53,99,39,53,23,46,3,6,14,62,99
2009-07-06 00:00:00.000,Newport RI; U.S.A. ATP World Tour 250,GRASS,2,Nicolas Mahut,Alex Bogomolov Jr.,Nicolas Mahut,6-2; 6-2,R16,52,12,2,26,42,22,26,9,16,0,1,8,31,42,0,3,35,54,17,35,7,19,2,7,8,24,54
2009-07-06 00:00:00.000,Newport RI; U.S.A. ATP World Tour 250,GRASS,2,Fabrice Santoro,Taylor Dent,Fabrice Santoro,7-6(5); 6-4,R16,88,1,2,36,65,26,36,17,29,1,3,11,43,65,13,5,46,82,34,46,12,36,3,6,11,46,82
2009-07-06 00:00:00.000,Newport RI; U.S.A. ATP World Tour 250,GRASS,2,Rajeev Ram,Jesse Levine,Rajeev Ram,5-7; 6-2; 7-6(3),Q,104,9,4,61,90,50,61,15,29,3,5,16,65,90,10,12,64,97,47,64,15,33,3,6,16,62,97
2009-07-06 00:00:00.000,Newport RI; U.S.A. ATP World Tour 250,GRASS,2,Olivier Rochus,Brendan Evans,Olivier Rochus,6-4; 6-4,Q,61,2,2,31,53,23,31,15,22,1,2,10,38,53,9,3,34,59,24,34,12,25,0,3,10,36,59
2009-07-06 00:00:00.000,Newport RI; U.S.A. ATP World Tour 250,GRASS,2,Sam Querrey,Kevin Kim,Sam Querrey,6-3; 6-4,Q,55,12,2,28,47,25,28,15,19,0,0,10,40,47,3,14,36,75,27,36,16,39,5,7,9,43,75
2009-07-06 00:00:00.000,Newport RI; U.S.A. ATP World Tour 250,GRASS,2,Fabrice Santoro,Nicolas Mahut,Fabrice Santoro,6-4; 6-4,Q,80,2,1,30,55,25,30,17,25,1,1,10,42,55,6,1,40,65,29,40,10,25,3,5,10,39,65
2009-07-06 00:00:00.000,Newport RI; U.S.A. ATP World Tour 250,GRASS,2,Rajeev Ram,Olivier Rochus,Rajeev Ram,6-3; 6-4,S,80,9,2,35,61,25,35,18,26,6,7,10,43,61,2,2,36,57,23,36,11,21,4,7,9,34,57
2009-07-06 00:00:00.000,Newport RI; U.S.A. ATP World Tour 250,GRASS,2,Sam Querrey,Fabrice Santoro,Sam Querrey,6-3; 7-6(2),S,70,18,2,40,57,38,40,10,17,0,0,11,48,57,0,0,41,65,28,41,15,24,1,2,10,43,65
2009-07-06 00:00:00.000,Newport RI; U.S.A. ATP World Tour 250,GRASS,2,Rajeev Ram,Sam Querrey,Rajeev Ram,6-7(3); 7-5; 6-3,F,122,12,4,67,110,54,67,18,43,5,7,17,72,110,13,7,54,96,41,54,21,42,3,7,16,62,96
2009-07-13 00:00:00.000,Bsstad Sweden ATP World Tour 250,CLAY,2,Fernando Verdasco,N/A Bye,Fernando Verdasco,,R32,0,0,0,0,0,0,0,0,0,0,0,0,0,0,0,0,0,0,0,0,0,0,0,0,0,0,0
2009-07-13 00:00:00.000,Bsstad Sweden ATP World Tour 250,CLAY,2,Daniel Koellerer,Steve Darcis,Daniel Koellerer,1-6; 6-3; 6-4,R32,97,3,2,48,77,34,48,15,29,0,2,13,49,77,4,0,43,72,31,43,18,29,2,4,13,49,72
2009-07-13 00:00:00.000,Bsstad Sweden ATP World Tour 250,CLAY,2,Victor Crivoi,Denis Istomin,Victor Crivoi,6-0; 6-4,R32,0,0,0,0,0,0,0,0,0,0,0,0,0,0,0,0,0,0,0,0,0,0,0,0,0,0,0
2009-07-13 00:00:00.000,Bsstad Sweden ATP World Tour 250,CLAY,2,Juan Monaco,Maximo Gonzalez,Juan Monaco,7-6(4); 3-6; 6-1,R32,139,2,2,78,106,49,78,12,28,7,12,14,61,106,1,3,54,81,36,54,11,27,2,8,14,47,81
2009-07-13 00:00:00.000,Bsstad Sweden ATP World Tour 250,CLAY,2,Tommy Robredo,N/A Bye,Tommy Robredo,,R32,0,0,0,0,0,0,0,0,0,0,0,0,0,0,0,0,0,0,0,0,0,0,0,0,0,0,0
2009-07-13 00:00:00.000,Bsstad Sweden ATP World Tour 250,CLAY,2,Peter Luczak,Alberto Martin,Peter Luczak,6-2; 6-2,R32,65,2,1,30,43,22,30,9,13,3,4,8,31,43,0,4,26,47,13,26,9,21,3,8,8,22,47
2009-07-13 00:00:00.000,Bsstad Sweden ATP World Tour 250,CLAY,2,Bjorn Phau,Daniel Berta,Bjorn Phau,6-3; 6-2,R32,63,3,2,27,47,23,27,13,20,0,0,9,36,47,0,1,33,55,20,33,9,22,3,6,8,29,55
2009-07-13 00:00:00.000,Bsstad Sweden ATP World Tour 250,CLAY,2,Teymuraz Gabashvili,Christophe Rochus,Teymuraz Gabashvili,4-6; 6-1; 6-0,R32,0,0,0,0,0,0,0,0,0,0,0,0,0,0,0,0,0,0,0,0,0,0,0,0,0,0,0
2009-07-13 00:00:00.000,Bsstad Sweden ATP World Tour 250,CLAY,2,Andreas Vinciguerra,Florent Serra,Andreas Vinciguerra,6-7(5); 6-3; 6-4,R32,145,9,5,84,127,62,84,21,43,15,16,16,83,127,2,2,75,109,49,75,19,34,6,9,15,68,109
2009-07-13 00:00:00.000,Bsstad Sweden ATP World Tour 250,CLAY,2,Guillermo Canas,Grigor Dimitrov,Guillermo Canas,6-3; 7-6(2),R32,103,4,0,22,55,16,22,23,33,1,3,10,39,55,3,3,47,75,29,47,11,28,6,10,11,40,75
2009-07-13 00:00:00.000,Bsstad Sweden ATP World Tour 250,CLAY,2,Daniel Gimeno-Traver,Frederico Gil,Daniel Gimeno-Traver,6-1; 6-4,R32,77,3,0,42,67,30,42,14,25,3,3,9,44,67,1,4,35,52,22,35,7,17,4,7,8,29,52
2009-07-13 00:00:00.000,Bsstad Sweden ATP World Tour 250,CLAY,2,Jurgen Melzer,N/A Bye,Jurgen Melzer,,R32,0,0,0,0,0,0,0,0,0,0,0,0,0,0,0,0,0,0,0,0,0,0,0,0,0,0,0
2009-07-13 00:00:00.000,Bsstad Sweden ATP World Tour 250,CLAY,2,Nicolas Almagro,Marat Safin,Nicolas Almagro,6-3; 7-6(6),R32,81,5,2,42,70,36,42,16,28,0,0,11,52,70,9,5,45,75,36,45,15,30,5,6,10,51,75
2009-07-13 00:00:00.000,Bsstad Sweden ATP World Tour 250,CLAY,2,Potito Starace,Julien Benneteau,Potito Starace,7-6(5); 6-3,R32,117,1,0,50,73,35,50,9,23,3,6,11,44,73,2,1,54,70,32,54,6,16,0,4,10,38,70
2009-07-13 00:00:00.000,Bsstad Sweden ATP World Tour 250,CLAY,2,Kristof Vliegen,Marcel Granollers,Kristof Vliegen,7-6(3); 6-4,R32,89,1,1,39,68,30,39,15,29,1,4,11,45,68,2,2,46,69,29,46,11,23,4,8,11,40,69
2009-07-13 00:00:00.000,Bsstad Sweden ATP World Tour 250,CLAY,2,Robin Soderling,N/A Bye,Robin Soderling,,R32,0,0,0,0,0,0,0,0,0,0,0,0,0,0,0,0,0,0,0,0,0,0,0,0,0,0,0
2009-07-13 00:00:00.000,Bsstad Sweden ATP World Tour 250,CLAY,2,Fernando Verdasco,Daniel Koellerer,Fernando Verdasco,6-7(1); 6-2; 7-5,R16,189,6,7,93,128,59,93,16,35,13,16,16,75,128,0,2,83,107,46,83,14,24,6,12,16,60,107
2009-07-13 00:00:00.000,Bsstad Sweden ATP World Tour 250,CLAY,2,Juan Monaco,Victor Crivoi,Juan Monaco,6-0; 7-6(1),R16,89,1,2,38,58,29,38,14,20,2,2,9,43,58,6,4,45,80,32,45,11,35,11,14,9,43,80
2009-07-13 00:00:00.000,Bsstad Sweden ATP World Tour 250,CLAY,2,Tommy Robredo,Peter Luczak,Tommy Robredo,6-2; 6-3,R16,73,10,1,28,49,27,28,12,21,3,3,9,39,49,1,1,34,54,23,34,5,20,3,6,8,28,54
2009-07-13 00:00:00.000,Bsstad Sweden ATP World Tour 250,CLAY,2,Teymuraz Gabashvili,Bjorn Phau,Teymuraz Gabashvili,6-3; 6-2,R16,76,0,9,40,62,30,40,11,22,5,5,9,41,62,4,1,29,43,19,29,6,14,1,4,8,25,43
2009-07-13 00:00:00.000,Bsstad Sweden ATP World Tour 250,CLAY,2,Andreas Vinciguerra,Guillermo Canas,Andreas Vinciguerra,6-7(5); 6-3; 6-4,R16,163,1,1,62,89,47,62,16,27,2,3,15,63,89,4,5,47,97,33,47,29,50,3,7,16,62,97
2009-07-13 00:00:00.000,Bsstad Sweden ATP World Tour 250,CLAY,2,Jurgen Melzer,Daniel Gimeno-Traver,Jurgen Melzer,6-2; 6-2,R16,58,3,1,26,47,22,26,12,21,1,1,8,34,47,3,2,29,47,17,29,8,18,3,7,8,25,47
2009-07-13 00:00:00.000,Bsstad Sweden ATP World Tour 250,CLAY,2,Nicolas Almagro,Potito Starace,Nicolas Almagro,2-6; 6-1; 6-1,R16,82,3,2,40,72,28,40,16,32,4,7,11,44,72,1,1,43,62,23,43,8,19,3,9,11,31,62
2009-07-13 00:00:00.000,Bsstad Sweden ATP World Tour 250,CLAY,2,Robin Soderling,Kristof Vliegen,Robin Soderling,6-2; 6-3,R16,54,5,0,28,48,24,28,14,20,2,2,9,38,48,2,0,23,37,17,23,6,14,0,3,8,23,37
2009-07-13 00:00:00.000,Bsstad Sweden ATP World Tour 250,CLAY,2,Juan Monaco,Fernando Verdasco,Juan Monaco,6-1; 3-1 RET,Q,56,4,2,18,30,14,18,7,12,0,0,5,21,30,0,1,33,51,18,33,6,18,3,7,6,24,51
2009-07-13 00:00:00.000,Bsstad Sweden ATP World Tour 250,CLAY,2,Tommy Robredo,Teymuraz Gabashvili,Tommy Robredo,6-4; 6-0,Q,78,4,1,21,40,17,21,14,19,2,3,8,31,40,1,4,39,60,22,39,4,21,7,12,8,26,60
2009-07-13 00:00:00.000,Bsstad Sweden ATP World Tour 250,CLAY,2,Andreas Vinciguerra,Jurgen Melzer,Andreas Vinciguerra,2-6; 6-4; 6-3,Q,105,5,1,46,66,35,46,13,20,5,7,13,48,66,5,2,56,85,36,56,17,29,3,6,14,53,85
2009-07-13 00:00:00.000,Bsstad Sweden ATP World Tour 250,CLAY,2,Robin Soderling,Nicolas Almagro,Robin Soderling,7-5; 6-3,Q,75,7,1,31,59,27,31,16,28,1,2,11,43,59,7,3,41,58,25,41,7,17,1,4,10,32,58
2009-07-13 00:00:00.000,Bsstad Sweden ATP World Tour 250,CLAY,2,Juan Monaco,Tommy Robredo,Juan Monaco,6-0; 6-2,S,64,1,3,31,42,24,31,5,11,0,1,7,29,42,1,2,30,51,15,30,5,21,5,11,7,20,51
2009-07-13 00:00:00.000,Bsstad Sweden ATP World Tour 250,CLAY,2,Robin Soderling,Andreas Vinciguerra,Robin Soderling,6-1; 7-6(6),S,83,7,1,36,63,33,36,12,27,1,2,10,45,63,6,2,52,71,34,52,6,19,6,9,9,40,71
2009-07-13 00:00:00.000,Bsstad Sweden ATP World Tour 250,CLAY,2,Robin Soderling,Juan Monaco,Robin Soderling,6-3; 7-6(4),F,113,6,5,62,97,47,62,13,35,5,6,11,60,97,4,3,50,71,34,50,10,21,4,6,10,44,71
2009-07-13 00:00:00.000,Stuttgart Germany ATP World Tour 250,CLAY,2,Gilles Simon,Philipp Petzschner,Gilles Simon,6-3; 6-4,R32,74,6,1,26,60,19,26,17,34,6,8,10,36,60,5,2,32,61,24,32,7,29,3,7,9,31,61
2009-07-13 00:00:00.000,Stuttgart Germany ATP World Tour 250,CLAY,2,Mischa Zverev,Guillermo Garcia-Lopez,Mischa Zverev,6-2; 6-4,R32,92,2,1,33,60,26,33,13,27,6,7,9,39,60,2,4,27,55,19,27,11,28,3,7,9,30,55
2009-07-13 00:00:00.000,Stuttgart Germany ATP World Tour 250,CLAY,2,Martin Vassallo Arguello,Andrey Golubev,Martin Vassallo Arguello,3-6; 6-3; 6-0,R32,122,2,0,57,76,42,57,9,19,7,8,12,51,76,3,6,38,78,23,38,22,40,6,10,12,45,78
2009-07-13 00:00:00.000,Stuttgart Germany ATP World Tour 250,CLAY,2,Jeremy Chardy,Jose Acasuso,Jeremy Chardy,6-2; 7-6(4),R32,76,7,2,33,64,29,33,17,31,0,1,10,46,64,3,1,39,60,26,39,11,21,1,4,10,37,60
2009-07-13 00:00:00.000,Stuttgart Germany ATP World Tour 250,CLAY,2,Nicolas Kiefer,Tomas Berdych,Nicolas Kiefer,6-3; 6-3,R32,78,8,1,29,68,22,29,21,39,6,7,9,43,68,5,4,26,47,15,26,9,21,1,5,9,24,47
2009-07-13 00:00:00.000,Stuttgart Germany ATP World Tour 250,CLAY,2,Simon Greul,Andreas Beck,Simon Greul,7-6(4); 7-6(5),R32,115,9,7,48,91,34,48,26,43,2,3,12,60,91,3,2,49,78,36,49,17,29,2,3,12,53,78
2009-07-13 00:00:00.000,Stuttgart Germany ATP World Tour 250,CLAY,2,Lukasz Kubot,Pablo Andujar,Lukasz Kubot,6-2; 6-4,R32,99,2,0,28,53,21,28,15,25,3,4,9,36,53,2,2,36,68,23,36,12,32,8,12,9,35,68
2009-07-13 00:00:00.000,Stuttgart Germany ATP World Tour 250,CLAY,2,Philipp Kohlschreiber,Diego Junqueira,Philipp Kohlschreiber,6-3; 6-2,R32,62,9,6,36,54,28,36,8,18,0,1,9,36,54,0,1,28,43,11,28,9,15,0,4,8,20,43
2009-07-13 00:00:00.000,Stuttgart Germany ATP World Tour 250,CLAY,2,Alexandre Sidorenko,Daniel Munoz-De La Nava,Alexandre Sidorenko,7-6(3); 1-6; 6-2,R32,107,6,1,44,79,34,44,19,35,5,8,13,53,79,8,4,50,79,45,50,9,29,0,3,14,54,79
2009-07-13 00:00:00.000,Stuttgart Germany ATP World Tour 250,CLAY,2,Oscar Hernandez,Janko Tipsarevic,Oscar Hernandez,6-4; 6-4,R32,70,6,0,29,47,24,29,13,18,0,1,10,37,47,4,4,39,69,26,39,14,30,8,11,10,40,69
2009-07-13 00:00:00.000,Stuttgart Germany ATP World Tour 250,CLAY,2,Rainer Schuettler,Ivo Minar,Rainer Schuettler,2-6; 7-6(2); 6-4,R32,136,2,2,60,95,39,60,13,35,5,12,15,52,95,4,2,57,103,30,57,26,46,9,15,15,56,103
2009-07-13 00:00:00.000,Stuttgart Germany ATP World Tour 250,CLAY,2,Victor Hanescu,Dominik Meffert,Victor Hanescu,6-4; 7-6(6),R32,91,4,4,51,77,41,51,12,26,5,6,11,53,77,3,2,45,64,35,45,9,19,1,3,11,44,64
2009-07-13 00:00:00.000,Stuttgart Germany ATP World Tour 250,CLAY,2,Fabio Fognini,Fabrice Santoro,Fabio Fognini,5-7; 7-6(3); 6-1,R32,110,3,7,54,86,36,54,15,32,1,5,15,51,86,1,2,62,108,39,62,20,46,5,11,16,59,108
2009-07-13 00:00:00.000,Stuttgart Germany ATP World Tour 250,CLAY,2,Paul-Henri Mathieu,Mikhail Youzhny,Paul-Henri Mathieu,7-6(4); 7-6(4),R32,131,7,5,52,101,37,52,21,49,9,13,12,58,101,5,3,62,87,35,62,11,25,3,7,12,46,87
2009-07-13 00:00:00.000,Stuttgart Germany ATP World Tour 250,CLAY,2,Michael Berrer,Stefan Koubek,Michael Berrer,0-6; 7-6(3); 7-6(4),R32,132,3,5,79,102,45,79,12,23,5,11,15,57,102,9,3,61,106,41,61,25,45,5,8,15,66,106
2009-07-13 00:00:00.000,Stuttgart Germany ATP World Tour 250,CLAY,2,Nikolay Davydenko,Ivan Navarro,Nikolay Davydenko,4-6; 7-5; 6-3,R32,156,4,2,65,106,46,65,21,41,7,10,16,67,106,6,4,63,103,45,63,15,40,7,11,15,60,103
2009-07-13 00:00:00.000,Stuttgart Germany ATP World Tour 250,CLAY,2,Mischa Zverev,Gilles Simon,Mischa Zverev,6-4; 6-2,R16,67,1,1,34,55,29,34,11,21,5,5,9,40,55,3,1,38,51,25,38,5,13,5,8,9,30,51
2009-07-13 00:00:00.000,Stuttgart Germany ATP World Tour 250,CLAY,2,Jeremy Chardy,Martin Vassallo Arguello,Jeremy Chardy,2-6; 6-3; 6-1,R16,97,6,6,37,62,30,37,13,25,1,3,12,43,62,1,1,48,68,26,48,13,20,2,6,12,39,68
2009-07-13 00:00:00.000,Stuttgart Germany ATP World Tour 250,CLAY,2,Nicolas Kiefer,Simon Greul,Nicolas Kiefer,6-3; 6-4,R16,75,5,1,31,58,29,31,16,27,2,2,10,45,58,4,5,30,55,21,30,13,25,4,6,9,34,55
2009-07-13 00:00:00.000,Stuttgart Germany ATP World Tour 250,CLAY,2,Lukasz Kubot,Philipp Kohlschreiber,Lukasz Kubot,6-2; 6-4,R16,71,6,2,30,45,27,30,9,15,0,0,9,36,45,2,0,42,59,29,42,7,17,2,5,9,36,59
2009-07-13 00:00:00.000,Stuttgart Germany ATP World Tour 250,CLAY,2,Alexandre Sidorenko,Oscar Hernandez,Alexandre Sidorenko,2-6; 6-4; 6-3,R16,126,4,4,45,88,32,45,21,43,2,5,14,53,88,2,2,64,84,44,64,10,20,6,9,13,54,84
2009-07-13 00:00:00.000,Stuttgart Germany ATP World Tour 250,CLAY,2,Victor Hanescu,Rainer Schuettler,Victor Hanescu,6-2; 6-1,R16,56,4,0,32,42,26,32,6,10,0,0,8,32,42,1,3,25,43,15,25,7,18,4,8,7,22,43
2009-07-13 00:00:00.000,Stuttgart Germany ATP World Tour 250,CLAY,2,Fabio Fognini,Paul-Henri Mathieu,Fabio Fognini,6-4; 4-1 RET,R16,59,4,3,27,40,20,27,7,13,0,1,7,27,40,3,0,20,40,12,20,8,20,2,6,8,20,40
2009-07-13 00:00:00.000,Stuttgart Germany ATP World Tour 250,CLAY,2,Nikolay Davydenko,Michael Berrer,Nikolay Davydenko,6-3; 6-3,R16,66,2,0,37,48,27,37,7,11,0,1,9,34,48,1,3,37,54,22,37,8,17,5,9,9,30,54
2009-07-13 00:00:00.000,Stuttgart Germany ATP World Tour 250,CLAY,2,Jeremy Chardy,Mischa Zverev,Jeremy Chardy,7-6(4); 6-1,Q,83,4,1,45,70,31,45,16,25,6,7,10,47,70,0,0,37,60,23,37,12,23,6,9,9,35,60
2009-07-13 00:00:00.000,Stuttgart Germany ATP World Tour 250,CLAY,2,Nicolas Kiefer,Lukasz Kubot,Nicolas Kiefer,6-2; 6-1,Q,64,7,0,20,38,19,20,13,18,0,0,8,32,38,1,4,30,52,18,30,7,22,3,7,7,25,52
2009-07-13 00:00:00.000,Stuttgart Germany ATP World Tour 250,CLAY,2,Victor Hanescu,Alexandre Sidorenko,Victor Hanescu,7-6(2); 6-4,Q,84,6,1,44,66,38,44,13,22,1,1,11,51,66,2,5,41,67,33,41,14,26,3,4,11,47,67
2009-07-13 00:00:00.000,Stuttgart Germany ATP World Tour 250,CLAY,2,Fabio Fognini,Nikolay Davydenko,Fabio Fognini,6-1; 3-6; 7-5,Q,140,3,2,53,94,40,53,16,41,4,7,14,56,94,1,1,54,81,31,54,16,27,7,12,14,47,81
2009-07-13 00:00:00.000,Stuttgart Germany ATP World Tour 250,CLAY,2,Jeremy Chardy,Nicolas Kiefer,Jeremy Chardy,6-3; 7-5,S,79,2,3,31,52,26,31,11,21,1,2,10,37,52,10,1,41,71,27,41,14,30,8,12,11,41,71
2009-07-13 00:00:00.000,Stuttgart Germany ATP World Tour 250,CLAY,2,Victor Hanescu,Fabio Fognini,Victor Hanescu,6-3; 6-7(4); 6-2,S,135,3,4,65,97,42,65,18,32,6,10,15,60,97,5,3,56,94,29,56,20,38,8,15,14,49,94
2009-07-13 00:00:00.000,Stuttgart Germany ATP World Tour 250,CLAY,2,Jeremy Chardy,Victor Hanescu,Jeremy Chardy,1-6; 6-3; 6-4,F,108,10,5,50,83,39,50,14,33,5,8,13,53,83,4,2,52,80,34,52,15,28,3,6,13,49,80
2009-07-19 00:00:00.000,Hamburg Germany ATP World Tour 500,CLAY,2,Gilles Simon,N/A Bye,Gilles Simon,,R64,0,0,0,0,0,0,0,0,0,0,0,0,0,0,0,0,0,0,0,0,0,0,0,0,0,0,0
2009-07-19 00:00:00.000,Hamburg Germany ATP World Tour 500,CLAY,2,Daniel Brands,Victor Crivoi,Daniel Brands,4-6; 6-4; 6-1,R64,99,10,2,52,80,40,52,13,28,6,9,14,53,80,2,4,52,76,32,52,11,24,4,9,13,43,76
2009-07-19 00:00:00.000,Hamburg Germany ATP World Tour 500,CLAY,2,Pere Riba,Evgeny Korolev,Pere Riba,7-6(3); 6-2,R64,105,5,3,39,77,28,39,16,38,8,11,10,44,77,3,1,37,72,22,37,14,35,6,11,10,36,72
2009-07-19 00:00:00.000,Hamburg Germany ATP World Tour 500,CLAY,2,Paul-Henri Mathieu,N/A Bye,Paul-Henri Mathieu,,R64,0,0,0,0,0,0,0,0,0,0,0,0,0,0,0,0,0,0,0,0,0,0,0,0,0,0,0
2009-07-19 00:00:00.000,Hamburg Germany ATP World Tour 500,CLAY,2,Viktor Troicki,N/A Bye,Viktor Troicki,,R64,0,0,0,0,0,0,0,0,0,0,0,0,0,0,0,0,0,0,0,0,0,0,0,0,0,0,0
2009-07-19 00:00:00.000,Hamburg Germany ATP World Tour 500,CLAY,2,Teymuraz Gabashvili,Andreas Seppi,Teymuraz Gabashvili,6-3; 6-1,R64,103,3,3,40,74,24,40,22,34,12,12,8,46,74,3,1,22,49,15,22,12,27,6,10,8,27,49
2009-07-19 00:00:00.000,Hamburg Germany ATP World Tour 500,CLAY,2,Guillermo Garcia-Lopez,Christophe Rochus,Guillermo Garcia-Lopez,6-4; 6-2,R64,70,5,1,38,52,27,38,6,14,1,3,9,33,52,1,1,28,47,15,28,5,19,1,6,9,20,47
2009-07-19 00:00:00.000,Hamburg Germany ATP World Tour 500,CLAY,2,Stanislas Wawrinka,N/A Bye,Stanislas Wawrinka,,R64,0,0,0,0,0,0,0,0,0,0,0,0,0,0,0,0,0,0,0,0,0,0,0,0,0,0,0
2009-07-19 00:00:00.000,Hamburg Germany ATP World Tour 500,CLAY,2,Robin Soderling,N/A Bye,Robin Soderling,,R64,0,0,0,0,0,0,0,0,0,0,0,0,0,0,0,0,0,0,0,0,0,0,0,0,0,0,0
2009-07-19 00:00:00.000,Hamburg Germany ATP World Tour 500,CLAY,2,Fabio Fognini,Ivo Minar,Fabio Fognini,6-4; 6-2,R64,68,1,1,34,50,28,34,9,16,0,0,9,37,50,3,4,35,63,25,35,11,28,5,8,9,36,63
2009-07-19 00:00:00.000,Hamburg Germany ATP World Tour 500,CLAY,2,Marcel Granollers,Martin Vassallo Arguello,Marcel Granollers,6-4; 6-4,R64,90,1,3,43,65,27,43,13,22,6,9,10,40,65,0,2,49,67,27,49,8,18,3,8,10,35,67
2009-07-19 00:00:00.000,Hamburg Germany ATP World Tour 500,CLAY,2,Nicolas Almagro,N/A Bye,Nicolas Almagro,,R64,0,0,0,0,0,0,0,0,0,0,0,0,0,0,0,0,0,0,0,0,0,0,0,0,0,0,0
2009-07-19 00:00:00.000,Hamburg Germany ATP World Tour 500,CLAY,2,Jurgen Melzer,N/A Bye,Jurgen Melzer,,R64,0,0,0,0,0,0,0,0,0,0,0,0,0,0,0,0,0,0,0,0,0,0,0,0,0,0,0
2009-07-19 00:00:00.000,Hamburg Germany ATP World Tour 500,CLAY,2,Pablo Cuevas,Bjorn Phau,Pablo Cuevas,7-6(0); 6-4,R64,93,4,1,53,66,42,53,7,13,0,0,11,49,66,3,2,47,78,34,47,16,31,4,5,11,50,78
2009-07-19 00:00:00.000,Hamburg Germany ATP World Tour 500,CLAY,2,Potito Starace,Maximo Gonzalez,Potito Starace,5-7; 6-4; 6-3,R64,149,2,3,79,105,49,79,11,26,3,8,16,60,105,1,0,78,104,41,78,13,26,7,13,15,54,104
2009-07-19 00:00:00.000,Hamburg Germany ATP World Tour 500,CLAY,2,Philipp Kohlschreiber,N/A Bye,Philipp Kohlschreiber,,R64,0,0,0,0,0,0,0,0,0,0,0,0,0,0,0,0,0,0,0,0,0,0,0,0,0,0,0
2009-07-19 00:00:00.000,Hamburg Germany ATP World Tour 500,CLAY,2,David Ferrer,N/A Bye,David Ferrer,,R64,0,0,0,0,0,0,0,0,0,0,0,0,0,0,0,0,0,0,0,0,0,0,0,0,0,0,0
2009-07-19 00:00:00.000,Hamburg Germany ATP World Tour 500,CLAY,2,Florian Mayer,Rainer Schuettler,Florian Mayer,6-7(3); 6-3; 6-3,R64,140,3,6,65,98,51,65,15,33,6,8,15,66,98,3,5,70,111,43,70,19,41,8,13,15,62,111
2009-07-19 00:00:00.000,Hamburg Germany ATP World Tour 500,CLAY,2,Juan Monaco,Mikhail Youzhny,Juan Monaco,7-6(4); 6-3,R64,112,0,2,52,75,32,52,13,23,4,7,10,45,75,1,3,65,91,40,65,7,26,6,11,11,47,91
2009-07-19 00:00:00.000,Hamburg Germany ATP World Tour 500,CLAY,2,Jose Acasuso,N/A Bye,Jose Acasuso,,R64,0,0,0,0,0,0,0,0,0,0,0,0,0,0,0,0,0,0,0,0,0,0,0,0,0,0,0
2009-07-19 00:00:00.000,Hamburg Germany ATP World Tour 500,CLAY,2,Mischa Zverev,N/A Bye,Mischa Zverev,,R64,0,0,0,0,0,0,0,0,0,0,0,0,0,0,0,0,0,0,0,0,0,0,0,0,0,0,0
2009-07-19 00:00:00.000,Hamburg Germany ATP World Tour 500,CLAY,2,Simon Greul,Janko Tipsarevic,Simon Greul,2-6; 6-3; 6-3,R64,125,7,3,33,70,24,33,23,37,3,6,13,47,70,7,4,43,90,32,43,20,47,5,9,13,52,90
2009-07-19 00:00:00.000,Hamburg Germany ATP World Tour 500,CLAY,2,Ivan Navarro,Steve Darcis,Ivan Navarro,6-4; 6-4,R64,77,5,0,37,57,28,37,12,20,1,2,10,40,57,2,2,39,58,28,39,7,19,1,4,10,35,58
2009-07-19 00:00:00.000,Hamburg Germany ATP World Tour 500,CLAY,2,Tommy Robredo,N/A Bye,Tommy Robredo,,R64,0,0,0,0,0,0,0,0,0,0,0,0,0,0,0,0,0,0,0,0,0,0,0,0,0,0,0
2009-07-19 00:00:00.000,Hamburg Germany ATP World Tour 500,CLAY,2,Igor Andreev,N/A Bye,Igor Andreev,,R64,0,0,0,0,0,0,0,0,0,0,0,0,0,0,0,0,0,0,0,0,0,0,0,0,0,0,0
2009-07-19 00:00:00.000,Hamburg Germany ATP World Tour 500,CLAY,2,Julien Benneteau,Juan Ignacio Chela,Julien Benneteau,6-4; 1-6; 6-1,R64,106,4,4,49,78,32,49,11,29,4,9,12,43,78,3,0,35,60,17,35,11,25,1,7,12,28,60
2009-07-19 00:00:00.000,Hamburg Germany ATP World Tour 500,CLAY,2,Jan Hernych,Kevin Krawietz,Jan Hernych,6-0; 4-6; 6-3,R64,78,7,1,51,72,36,51,11,21,1,4,13,47,72,5,5,42,76,25,42,12,34,4,10,12,37,76
2009-07-19 00:00:00.000,Hamburg Germany ATP World Tour 500,CLAY,2,Victor Hanescu,N/A Bye,Victor Hanescu,,R64,0,0,0,0,0,0,0,0,0,0,0,0,0,0,0,0,0,0,0,0,0,0,0,0,0,0,0
2009-07-19 00:00:00.000,Hamburg Germany ATP World Tour 500,CLAY,2,Jeremy Chardy,N/A Bye,Jeremy Chardy,,R64,0,0,0,0,0,0,0,0,0,0,0,0,0,0,0,0,0,0,0,0,0,0,0,0,0,0,0
2009-07-19 00:00:00.000,Hamburg Germany ATP World Tour 500,CLAY,2,Andreas Beck,Oscar Hernandez,Andreas Beck,6-7(3); 6-4; 6-4,R64,171,4,3,59,100,45,59,22,41,5,7,16,67,100,5,1,90,134,56,90,23,44,13,17,16,79,134
2009-07-19 00:00:00.000,Hamburg Germany ATP World Tour 500,CLAY,2,Philipp Petzschner,Florent Serra,Philipp Petzschner,7-6(3); 6-2,R64,83,6,2,48,82,35,48,16,34,10,12,10,51,82,1,1,37,61,22,37,11,24,1,5,10,33,61
2009-07-19 00:00:00.000,Hamburg Germany ATP World Tour 500,CLAY,2,Nikolay Davydenko,N/A Bye,Nikolay Davydenko,,R64,0,0,0,0,0,0,0,0,0,0,0,0,0,0,0,0,0,0,0,0,0,0,0,0,0,0,0
2009-07-19 00:00:00.000,Hamburg Germany ATP World Tour 500,CLAY,2,Daniel Brands,Gilles Simon,Daniel Brands,3-6; 6-4; 6-3,R32,131,7,4,81,120,53,81,15,39,8,12,14,68,120,4,1,47,88,29,47,20,41,5,10,14,49,88
2009-07-19 00:00:00.000,Hamburg Germany ATP World Tour 500,CLAY,2,Paul-Henri Mathieu,Pere Riba,Paul-Henri Mathieu,6-1; 2-6; 7-6(3),R32,131,5,3,44,94,33,44,26,50,2,5,14,59,94,15,3,46,79,34,46,16,33,2,5,13,50,79
2009-07-19 00:00:00.000,Hamburg Germany ATP World Tour 500,CLAY,2,Viktor Troicki,Teymuraz Gabashvili,Viktor Troicki,3-6; 6-2; 6-4,R32,161,11,4,52,110,37,52,27,58,13,17,14,64,110,3,7,47,89,30,47,19,42,9,14,13,49,89
2009-07-19 00:00:00.000,Hamburg Germany ATP World Tour 500,CLAY,2,Guillermo Garcia-Lopez,Stanislas Wawrinka,Guillermo Garcia-Lopez,6-2; 6-4,R32,86,0,4,41,62,26,41,14,21,6,7,9,40,62,1,2,38,54,20,38,8,16,2,6,9,28,54
2009-07-19 00:00:00.000,Hamburg Germany ATP World Tour 500,CLAY,2,Robin Soderling,Fabio Fognini,Robin Soderling,6-3; 6-7(3); 6-3,R32,128,5,4,56,97,40,56,22,41,6,9,16,62,97,2,3,55,94,34,55,20,39,4,9,14,54,94
2009-07-19 00:00:00.000,Hamburg Germany ATP World Tour 500,CLAY,2,Nicolas Almagro,Marcel Granollers,Nicolas Almagro,4-6; 6-3; 6-4,R32,106,10,2,53,89,37,53,21,36,6,8,15,58,89,5,0,52,73,38,52,12,21,3,6,14,50,73
2009-07-19 00:00:00.000,Hamburg Germany ATP World Tour 500,CLAY,2,Pablo Cuevas,Jurgen Melzer,Pablo Cuevas,7-6(5); 6-3,R32,95,11,1,43,62,32,43,14,19,2,3,11,46,62,1,3,45,73,32,45,13,28,2,4,10,45,73
2009-07-19 00:00:00.000,Hamburg Germany ATP World Tour 500,CLAY,2,Philipp Kohlschreiber,Potito Starace,Philipp Kohlschreiber,6-2; 4-6; 6-4,R32,118,6,0,66,87,48,66,10,21,0,1,14,58,87,2,1,66,86,43,66,10,20,4,7,14,53,86
2009-07-19 00:00:00.000,Hamburg Germany ATP World Tour 500,CLAY,2,David Ferrer,Florian Mayer,David Ferrer,6-3; 6-2,R32,70,0,1,29,49,22,29,15,20,2,2,8,37,49,1,0,37,56,20,37,9,19,4,8,9,29,56
2009-07-19 00:00:00.000,Hamburg Germany ATP World Tour 500,CLAY,2,Juan Monaco,Jose Acasuso,Juan Monaco,6-1; 1-1 RET,R32,42,1,0,15,21,11,15,4,6,0,1,4,15,21,0,3,13,32,7,13,6,19,2,6,5,13,32
2009-07-19 00:00:00.000,Hamburg Germany ATP World Tour 500,CLAY,2,Simon Greul,Mischa Zverev,Simon Greul,0-6; 7-5; 6-1,R32,107,3,3,50,88,35,50,20,38,7,10,13,55,88,1,0,50,70,35,50,11,20,6,9,12,46,70
2009-07-19 00:00:00.000,Hamburg Germany ATP World Tour 500,CLAY,2,Ivan Navarro,Tommy Robredo,Ivan Navarro,7-5; 7-6(2),R32,117,2,1,43,73,33,43,20,30,1,2,12,53,73,1,2,49,81,34,49,18,32,4,6,12,52,81
2009-07-19 00:00:00.000,Hamburg Germany ATP World Tour 500,CLAY,2,Julien Benneteau,Igor Andreev,Julien Benneteau,6-4; 6-3,R32,96,3,1,39,65,24,39,16,26,5,7,10,40,65,2,2,38,58,22,38,9,20,4,8,9,31,58
2009-07-19 00:00:00.000,Hamburg Germany ATP World Tour 500,CLAY,2,Victor Hanescu,Jan Hernych,Victor Hanescu,6-2; 6-3,R32,63,3,0,41,46,32,41,3,5,3,4,9,35,46,2,3,31,50,19,31,6,19,2,6,8,25,50
2009-07-19 00:00:00.000,Hamburg Germany ATP World Tour 500,CLAY,2,Jeremy Chardy,Andreas Beck,Jeremy Chardy,7-6(2); 7-6(6),R32,109,22,3,47,76,40,47,19,29,2,3,12,59,76,8,5,51,86,37,51,22,35,5,6,12,59,86
2009-07-19 00:00:00.000,Hamburg Germany ATP World Tour 500,CLAY,2,Nikolay Davydenko,Philipp Petzschner,Nikolay Davydenko,6-3; 6-2,R32,70,1,1,42,58,31,42,12,16,3,3,9,43,58,3,2,25,50,15,25,13,25,3,6,8,28,50
2009-07-19 00:00:00.000,Hamburg Germany ATP World Tour 500,CLAY,2,Paul-Henri Mathieu,Daniel Brands,Paul-Henri Mathieu,7-5; 7-5,R16,103,7,0,39,78,29,39,25,39,3,3,12,54,78,5,2,56,72,42,56,5,16,2,4,12,47,72
2009-07-19 00:00:00.000,Hamburg Germany ATP World Tour 500,CLAY,2,Viktor Troicki,Guillermo Garcia-Lopez,Viktor Troicki,6-7(2); 6-4; 7-6(6),R16,172,11,2,73,111,48,73,22,38,4,7,17,70,111,4,6,71,109,50,71,16,38,2,6,17,66,109
2009-07-19 00:00:00.000,Hamburg Germany ATP World Tour 500,CLAY,2,Nicolas Almagro,Robin Soderling,Nicolas Almagro,7-5; 6-3,R16,75,0,0,0,0,0,0,0,0,0,0,0,0,0,0,0,0,0,0,0,0,0,0,0,0,0,0
2009-07-19 00:00:00.000,Hamburg Germany ATP World Tour 500,CLAY,2,Pablo Cuevas,Philipp Kohlschreiber,Pablo Cuevas,6-4; 7-6(8),R16,114,8,0,56,82,45,56,14,26,4,4,11,59,82,3,2,59,82,43,59,11,23,7,8,11,54,82
2009-07-19 00:00:00.000,Hamburg Germany ATP World Tour 500,CLAY,2,David Ferrer,Juan Monaco,David Ferrer,4-6; 7-5; 6-2,R16,136,4,3,53,80,36,53,14,27,0,4,15,50,80,2,3,72,95,42,72,10,23,4,10,15,52,95
2009-07-19 00:00:00.000,Hamburg Germany ATP World Tour 500,CLAY,2,Simon Greul,Ivan Navarro,Simon Greul,7-5; 7-6(7),R16,123,3,1,51,82,37,51,18,31,0,1,12,55,82,9,3,56,84,37,56,14,28,5,7,12,51,84
2009-07-19 00:00:00.000,Hamburg Germany ATP World Tour 500,CLAY,2,Victor Hanescu,Julien Benneteau,Victor Hanescu,3-6; 6-3; 6-3,R16,113,7,2,55,83,38,55,16,28,11,13,14,54,83,2,0,56,83,36,56,15,27,8,11,13,51,83
2009-07-19 00:00:00.000,Hamburg Germany ATP World Tour 500,CLAY,2,Nikolay Davydenko,Jeremy Chardy,Nikolay Davydenko,6-3; 6-3,R16,72,4,1,33,42,30,33,6,9,0,0,9,36,42,2,4,48,74,30,48,12,26,8,11,9,42,74
2009-07-19 00:00:00.000,Hamburg Germany ATP World Tour 500,CLAY,2,Paul-Henri Mathieu,Viktor Troicki,Paul-Henri Mathieu,3-0 RET,Q,21,1,0,6,16,5,6,6,10,2,2,2,11,16,0,0,3,8,1,3,1,5,0,1,1,2,8
2009-07-19 00:00:00.000,Hamburg Germany ATP World Tour 500,CLAY,2,Pablo Cuevas,Nicolas Almagro,Pablo Cuevas,6-2; 6-4,Q,74,4,1,36,55,29,36,11,19,5,5,9,40,55,3,1,30,45,24,30,5,15,1,4,9,29,45
2009-07-19 00:00:00.000,Hamburg Germany ATP World Tour 500,CLAY,2,David Ferrer,Simon Greul,David Ferrer,6-2; 6-3,Q,65,0,0,32,46,28,32,8,14,0,0,9,36,46,2,0,36,52,23,36,6,16,4,7,8,29,52
2009-07-19 00:00:00.000,Hamburg Germany ATP World Tour 500,CLAY,2,Nikolay Davydenko,Victor Hanescu,Nikolay Davydenko,6-3; 4-6; 6-3,Q,140,3,1,67,94,51,67,12,27,2,3,14,63,94,2,1,82,104,52,82,10,22,9,12,14,62,104
2009-07-19 00:00:00.000,Hamburg Germany ATP World Tour 500,CLAY,2,Paul-Henri Mathieu,Pablo Cuevas,Paul-Henri Mathieu,4-6; 6-3; 7-5,S,172,2,2,59,101,38,59,25,42,6,10,16,63,101,12,1,56,91,38,56,16,35,2,7,15,54,91
2009-07-19 00:00:00.000,Hamburg Germany ATP World Tour 500,CLAY,2,Nikolay Davydenko,David Ferrer,Nikolay Davydenko,7-5; 7-6(2),S,133,4,2,58,85,39,58,11,27,3,6,12,50,85,3,1,56,98,37,56,16,42,13,17,12,53,98
2009-07-19 00:00:00.000,Hamburg Germany ATP World Tour 500,CLAY,2,Nikolay Davydenko,Paul-Henri Mathieu,Nikolay Davydenko,6-4; 6-2,F,89,3,1,39,50,24,39,8,11,4,6,9,32,50,1,2,31,62,17,31,13,31,8,13,9,30,62
2009-07-19 00:00:00.000,Indianapolis IN; U.S.A. ATP World Tour 250,HARD,2,Dmitry Tursunov,Michael Berrer,Dmitry Tursunov,6-3; 2-6; 6-0,R32,97,6,5,36,74,29,36,14,38,6,10,12,43,74,1,16,42,77,26,42,12,35,4,10,11,38,77
2009-07-19 00:00:00.000,Indianapolis IN; U.S.A. ATP World Tour 250,HARD,2,Marcos Daniel,Taylor Dent,Marcos Daniel,6-2; 6-4,R32,64,5,2,25,45,19,25,17,20,0,0,9,36,45,9,7,24,52,22,24,9,28,0,3,9,31,52
2009-07-19 00:00:00.000,Indianapolis IN; U.S.A. ATP World Tour 250,HARD,2,Frank Dancevic,Bobby Reynolds,Frank Dancevic,6-2; 7-6(5),R32,76,6,1,32,59,26,32,22,27,0,0,10,48,59,10,2,42,72,29,42,18,30,7,9,10,47,72
2009-07-19 00:00:00.000,Indianapolis IN; U.S.A. ATP World Tour 250,HARD,2,Benjamin Becker,Go Soeda,Benjamin Becker,6-2; 6-3,R32,57,6,2,28,45,18,28,13,17,0,1,8,31,45,0,4,28,48,16,28,6,20,1,6,9,22,48
2009-07-19 00:00:00.000,Indianapolis IN; U.S.A. ATP World Tour 250,HARD,2,Sam Querrey,Arnaud Clement,Sam Querrey,6-3; 6-4,R32,73,11,3,37,50,31,37,10,13,0,0,10,41,50,7,0,34,60,26,34,12,26,4,6,9,38,60
2009-07-19 00:00:00.000,Indianapolis IN; U.S.A. ATP World Tour 250,HARD,2,Rajeev Ram,Devin Britton,Rajeev Ram,6-3; 7-5,R32,79,10,2,29,58,24,29,18,29,3,3,10,42,58,3,4,50,86,33,50,15,36,9,12,11,48,86
2009-07-19 00:00:00.000,Indianapolis IN; U.S.A. ATP World Tour 250,HARD,2,Jesse Levine,Danai Udomchoke,Jesse Levine,6-1; 7-6(10),R32,83,2,5,39,64,26,39,12,25,0,3,9,38,64,3,2,45,77,27,45,10,32,7,13,10,37,77
2009-07-19 00:00:00.000,Indianapolis IN; U.S.A. ATP World Tour 250,HARD,2,Marc Gicquel,Ernests Gulbis,Marc Gicquel,6-2; 6-3,R32,61,6,1,26,45,22,26,12,19,3,3,8,34,45,6,3,40,65,24,40,11,25,6,10,9,35,65
2009-07-19 00:00:00.000,Indianapolis IN; U.S.A. ATP World Tour 250,HARD,2,Denis Istomin,Kevin Kim,Denis Istomin,2-6; 6-4; 6-4,R32,107,7,5,58,97,35,58,18,39,6,11,14,53,97,8,9,39,94,29,39,25,55,4,9,14,54,94
2009-07-19 00:00:00.000,Indianapolis IN; U.S.A. ATP World Tour 250,HARD,2,John Isner,Josselin Ouanna,John Isner,6-1; 7-6(6),R32,71,15,1,37,55,32,37,13,18,0,0,10,45,55,1,5,36,66,26,36,15,30,4,6,9,41,66
2009-07-19 00:00:00.000,Indianapolis IN; U.S.A. ATP World Tour 250,HARD,2,Wayne Odesnik,Marcos Baghdatis,Wayne Odesnik,7-6(5); 1-6; 6-4,R32,135,2,5,62,97,44,62,14,35,8,12,14,58,97,7,6,46,87,41,46,16,41,2,5,15,57,87
2009-07-19 00:00:00.000,Indianapolis IN; U.S.A. ATP World Tour 250,HARD,2,Igor Kunitsyn,Brian Dabul,Igor Kunitsyn,6-4; 6-1,R32,72,2,1,30,44,25,30,7,14,0,0,8,32,44,1,4,39,69,22,39,13,30,2,6,9,35,69
2009-07-19 00:00:00.000,Indianapolis IN; U.S.A. ATP World Tour 250,HARD,2,Eduardo Schwank,Yen-Hsun Lu,Eduardo Schwank,4-6; 6-3; 6-2,R32,126,6,7,51,101,36,51,26,50,8,10,14,62,101,5,8,39,80,30,39,16,41,3,7,13,46,80
2009-07-19 00:00:00.000,Indianapolis IN; U.S.A. ATP World Tour 250,HARD,2,Robby Ginepri,Sebastien De Chaunac,Robby Ginepri,7-5; 5-7; 6-2,R32,115,8,2,54,94,43,54,23,40,5,7,16,66,94,7,4,45,89,36,45,22,44,4,8,16,58,89
2009-07-19 00:00:00.000,Indianapolis IN; U.S.A. ATP World Tour 250,HARD,2,Alex Bogomolov Jr.,Flavio Cipolla,Alex Bogomolov Jr.,6-2; 6-3,R32,61,0,0,32,45,22,32,9,13,1,2,8,31,45,1,6,29,49,13,29,8,20,2,7,9,21,49
2009-07-19 00:00:00.000,Indianapolis IN; U.S.A. ATP World Tour 250,HARD,2,Dudi Sela,Vincent Spadea,Dudi Sela,7-5; 6-1,R32,76,0,3,34,63,21,34,17,29,5,7,9,38,63,2,8,31,63,20,31,11,32,3,9,10,31,63
2009-07-19 00:00:00.000,Indianapolis IN; U.S.A. ATP World Tour 250,HARD,2,Dmitry Tursunov,Marcos Daniel,Dmitry Tursunov,6-3; 6-3,R16,69,9,1,30,48,23,30,11,18,1,2,9,34,48,7,4,33,64,19,33,15,31,2,6,9,34,64
2009-07-19 00:00:00.000,Indianapolis IN; U.S.A. ATP World Tour 250,HARD,2,Frank Dancevic,Benjamin Becker,Frank Dancevic,6-2; 7-5,R16,58,9,0,28,50,25,28,16,22,0,0,10,41,50,7,1,25,50,18,25,16,25,0,3,10,34,50
2009-07-19 00:00:00.000,Indianapolis IN; U.S.A. ATP World Tour 250,HARD,2,Sam Querrey,Rajeev Ram,Sam Querrey,7-5; 6-3,R16,69,13,4,36,59,31,36,13,23,0,0,11,44,59,7,5,36,72,27,36,18,36,6,8,10,45,72
2009-07-19 00:00:00.000,Indianapolis IN; U.S.A. ATP World Tour 250,HARD,2,Marc Gicquel,Jesse Levine,Marc Gicquel,6-2; 6-2,R16,65,8,3,34,61,25,34,12,27,4,5,8,37,61,2,8,27,48,15,27,6,21,2,7,8,21,48
2009-07-19 00:00:00.000,Indianapolis IN; U.S.A. ATP World Tour 250,HARD,2,John Isner,Denis Istomin,John Isner,6-4; 6-4,R16,83,5,0,40,58,30,40,13,18,1,1,10,43,58,4,5,44,73,30,44,15,29,4,6,10,45,73
2009-07-19 00:00:00.000,Indianapolis IN; U.S.A. ATP World Tour 250,HARD,2,Wayne Odesnik,Igor Kunitsyn,Wayne Odesnik,2-6; 6-1; 6-1,R16,92,6,2,40,66,25,40,16,26,7,10,11,41,66,4,4,35,59,19,35,9,24,3,9,11,28,59
2009-07-19 00:00:00.000,Indianapolis IN; U.S.A. ATP World Tour 250,HARD,2,Robby Ginepri,Eduardo Schwank,Robby Ginepri,6-7(1); 6-3; 6-0,R16,101,5,2,41,77,31,41,24,36,1,2,14,55,77,7,4,54,88,35,54,16,34,3,8,13,51,88
2009-07-19 00:00:00.000,Indianapolis IN; U.S.A. ATP World Tour 250,HARD,2,Alex Bogomolov Jr.,Dudi Sela,Alex Bogomolov Jr.,6-4; 7-6(5),R16,93,4,1,61,77,42,61,10,16,6,7,11,52,77,3,1,38,66,27,38,16,28,1,3,11,43,66
2009-07-19 00:00:00.000,Indianapolis IN; U.S.A. ATP World Tour 250,HARD,2,Frank Dancevic,Dmitry Tursunov,Frank Dancevic,3-6; 7-6(5); 6-2,Q,123,18,4,49,88,38,49,23,39,0,2,14,61,88,6,2,41,93,33,41,30,52,5,8,15,63,93
2009-07-19 00:00:00.000,Indianapolis IN; U.S.A. ATP World Tour 250,HARD,2,Sam Querrey,Marc Gicquel,Sam Querrey,6-4; 7-5,Q,92,19,4,43,76,38,43,15,33,2,2,11,53,76,6,4,38,77,29,38,18,39,6,8,11,47,77
2009-07-19 00:00:00.000,Indianapolis IN; U.S.A. ATP World Tour 250,HARD,2,John Isner,Wayne Odesnik,John Isner,7-5; 6-7(2); 7-5,Q,158,27,7,63,102,54,63,21,39,5,5,18,75,102,9,6,63,106,51,63,25,43,3,5,18,76,106
2009-07-19 00:00:00.000,Indianapolis IN; U.S.A. ATP World Tour 250,HARD,2,Robby Ginepri,Alex Bogomolov Jr.,Robby Ginepri,7-5; 6-1,Q,76,5,1,38,59,28,38,12,21,1,2,10,40,59,1,2,35,57,20,35,10,22,1,5,9,30,57
2009-07-19 00:00:00.000,Indianapolis IN; U.S.A. ATP World Tour 250,HARD,2,Sam Querrey,Frank Dancevic,Sam Querrey,6-4; 6-4,S,73,11,4,30,54,24,30,12,24,2,4,10,36,54,1,2,33,64,20,33,17,31,5,9,10,37,64
2009-07-19 00:00:00.000,Indianapolis IN; U.S.A. ATP World Tour 250,HARD,2,Robby Ginepri,John Isner,Robby Ginepri,6-4; 6-3,S,86,2,2,42,69,30,42,18,27,5,5,10,48,69,11,3,46,68,32,46,9,22,7,9,9,41,68
2009-07-19 00:00:00.000,Indianapolis IN; U.S.A. ATP World Tour 250,HARD,2,Robby Ginepri,Sam Querrey,Robby Ginepri,6-2; 6-4,F,63,4,2,33,51,27,33,11,18,1,1,9,38,51,2,9,20,53,17,20,15,33,1,4,9,32,53
2009-07-26 00:00:00.000,Gstaad Switzerland ATP World Tour 250,CLAY,2,Stanislas Wawrinka,Federico Delbonis,Stanislas Wawrinka,6-4; 7-5,R32,95,4,7,45,77,31,45,16,32,6,9,11,47,77,2,1,40,67,25,40,13,27,2,7,11,38,67
2009-07-26 00:00:00.000,Gstaad Switzerland ATP World Tour 250,CLAY,2,Thomaz Bellucci,Michael Lammer,Thomaz Bellucci,6-7(5); 7-6(5); 6-4,R32,190,2,6,72,125,49,72,25,53,10,15,17,74,125,3,2,78,127,47,78,27,49,9,15,17,74,127
2009-07-26 00:00:00.000,Gstaad Switzerland ATP World Tour 250,CLAY,2,Ivan Navarro,Farrukh Dustov,Ivan Navarro,7-6(2); 4-6; 6-2,R32,128,4,3,55,81,45,55,17,26,0,1,15,62,81,4,0,86,104,58,86,8,18,5,7,15,66,104
2009-07-26 00:00:00.000,Gstaad Switzerland ATP World Tour 250,CLAY,2,Nicolas Kiefer,Jose Acasuso,Nicolas Kiefer,7-6(5); 6-2,R32,86,9,6,32,60,30,32,15,28,4,5,10,45,60,5,2,35,72,22,35,21,37,7,10,10,43,72
2009-07-26 00:00:00.000,Gstaad Switzerland ATP World Tour 250,CLAY,2,Igor Andreev,Diego Junqueira,Igor Andreev,7-5; 6-4,R32,95,4,1,42,68,25,42,19,26,3,5,11,44,68,1,1,37,65,22,37,14,28,0,4,11,36,65
2009-07-26 00:00:00.000,Gstaad Switzerland ATP World Tour 250,CLAY,2,Jan Hernych,Flavio Cipolla,Jan Hernych,6-1; 6-0,R32,52,4,0,33,53,23,33,13,20,1,1,7,36,53,0,1,24,45,8,24,9,21,3,8,6,17,45
2009-07-26 00:00:00.000,Gstaad Switzerland ATP World Tour 250,CLAY,2,Mikhail Youzhny,Gaston Gaudio,Mikhail Youzhny,6-3; 5-7; 6-4,R32,167,5,3,72,117,42,72,25,45,10,14,15,67,117,0,7,76,120,47,76,21,44,14,20,16,68,120
2009-07-26 00:00:00.000,Gstaad Switzerland ATP World Tour 250,CLAY,2,Jeremy Chardy,Thierry Ascione,Jeremy Chardy,6-3; 6-3,R32,60,12,4,24,49,20,24,14,25,1,2,9,34,49,2,3,36,58,18,36,13,22,3,7,9,31,58
2009-07-26 00:00:00.000,Gstaad Switzerland ATP World Tour 250,CLAY,2,Marcos Daniel,Paul-Henri Mathieu,Marcos Daniel,7-6(3); 7-6(6),R32,118,13,0,51,81,36,51,20,30,4,6,12,56,81,10,5,56,100,43,56,19,44,8,10,12,62,100
2009-07-26 00:00:00.000,Gstaad Switzerland ATP World Tour 250,CLAY,2,Julien Benneteau,Stephane Bohli,Julien Benneteau,7-6(4); 7-5,R32,116,10,4,54,77,42,54,15,23,3,3,12,57,77,10,5,53,93,41,53,18,40,5,6,12,59,93
2009-07-26 00:00:00.000,Gstaad Switzerland ATP World Tour 250,CLAY,2,Florent Serra,Martin Vassallo Arguello,Florent Serra,6-3; 6-2,R32,61,1,1,24,45,20,24,16,21,0,0,9,36,45,5,1,31,47,21,31,6,16,2,5,8,27,47
2009-07-26 00:00:00.000,Gstaad Switzerland ATP World Tour 250,CLAY,2,Victor Hanescu,Ivo Minar,Victor Hanescu,6-2; 6-2,R32,51,4,0,32,42,26,32,7,10,0,0,8,33,42,5,5,29,48,16,29,9,19,1,5,8,25,48
2009-07-26 00:00:00.000,Gstaad Switzerland ATP World Tour 250,CLAY,2,Guillermo Garcia-Lopez,Feliciano Lopez,Guillermo Garcia-Lopez,6-4; 6-7(4); 6-3,R32,138,2,7,64,98,42,64,20,34,3,6,16,62,98,9,4,46,100,33,46,27,54,6,11,15,60,100
2009-07-26 00:00:00.000,Gstaad Switzerland ATP World Tour 250,CLAY,2,Andreas Beck,Marco Chiudinelli,Andreas Beck,4-6; 7-6(7); 6-4,R32,155,6,9,69,118,51,69,25,49,4,5,16,76,118,8,4,58,106,46,58,25,48,6,7,16,71,106
2009-07-26 00:00:00.000,Gstaad Switzerland ATP World Tour 250,CLAY,2,Teymuraz Gabashvili,Paul Capdeville,Teymuraz Gabashvili,1-6; 7-6(3); 6-3,R32,129,7,7,64,106,42,64,22,42,7,12,15,64,106,9,6,56,88,40,56,12,32,8,11,13,52,88
2009-07-26 00:00:00.000,Gstaad Switzerland ATP World Tour 250,CLAY,2,Victor Crivoi,Philipp Kohlschreiber,Victor Crivoi,6-4; 6-0,R32,65,4,0,20,49,13,20,22,29,2,2,8,35,49,2,5,30,55,15,30,12,25,9,13,8,27,55
2009-07-26 00:00:00.000,Gstaad Switzerland ATP World Tour 250,CLAY,2,Thomaz Bellucci,Stanislas Wawrinka,Thomaz Bellucci,6-4; 6-4,R16,75,3,2,35,53,27,35,14,18,0,0,10,41,53,5,3,26,51,22,26,14,25,1,3,10,36,51
2009-07-26 00:00:00.000,Gstaad Switzerland ATP World Tour 250,CLAY,2,Nicolas Kiefer,Ivan Navarro,Nicolas Kiefer,6-3; 6-7(3); 6-2,R16,143,8,3,57,98,42,57,26,41,4,4,15,68,98,7,4,64,92,40,64,16,28,1,4,14,56,92
2009-07-26 00:00:00.000,Gstaad Switzerland ATP World Tour 250,CLAY,2,Igor Andreev,Jan Hernych,Igor Andreev,6-4; 6-1,R16,62,3,3,31,51,27,31,11,20,3,3,9,38,51,1,3,33,50,22,33,7,17,4,7,8,29,50
2009-07-26 00:00:00.000,Gstaad Switzerland ATP World Tour 250,CLAY,2,Jeremy Chardy,Mikhail Youzhny,Jeremy Chardy,6-3; 5-7; 6-3,R16,121,8,6,57,95,43,57,13,38,2,7,15,56,95,3,5,51,97,26,51,24,46,7,14,15,50,97
2009-07-26 00:00:00.000,Gstaad Switzerland ATP World Tour 250,CLAY,2,Marcos Daniel,Julien Benneteau,Marcos Daniel,6-3; 7-6(8),R16,118,3,1,57,92,40,57,23,35,7,7,11,63,92,5,1,41,64,34,41,11,23,1,2,10,45,64
2009-07-26 00:00:00.000,Gstaad Switzerland ATP World Tour 250,CLAY,2,Florent Serra,Victor Hanescu,Florent Serra,6-4 RET,R16,31,1,1,20,28,16,20,5,8,2,2,5,21,28,3,0,19,27,14,19,4,8,1,2,5,18,27
2009-07-26 00:00:00.000,Gstaad Switzerland ATP World Tour 250,CLAY,2,Andreas Beck,Guillermo Garcia-Lopez,Andreas Beck,7-6(3); 1-6; 7-6(3),R16,168,3,10,54,98,41,54,20,44,5,10,15,61,98,12,12,87,138,59,87,22,51,14,17,16,81,138
2009-07-26 00:00:00.000,Gstaad Switzerland ATP World Tour 250,CLAY,2,Victor Crivoi,Teymuraz Gabashvili,Victor Crivoi,6-4; 6-4,R16,71,8,3,32,51,28,32,13,19,2,2,10,41,51,3,5,36,61,22,36,16,25,1,3,10,38,61
2009-07-26 00:00:00.000,Gstaad Switzerland ATP World Tour 250,CLAY,2,Thomaz Bellucci,Nicolas Kiefer,Thomaz Bellucci,3-6; 1-0 RET,Q,53,2,3,13,28,11,13,6,15,0,1,5,17,28,2,2,18,35,14,18,9,17,2,2,5,23,35
2009-07-26 00:00:00.000,Gstaad Switzerland ATP World Tour 250,CLAY,2,Igor Andreev,Jeremy Chardy,Igor Andreev,6-3; 6-3,Q,67,2,2,34,53,24,34,13,19,1,1,9,37,53,4,7,30,57,21,30,11,27,3,6,9,32,57
2009-07-26 00:00:00.000,Gstaad Switzerland ATP World Tour 250,CLAY,2,Marcos Daniel,Florent Serra,Marcos Daniel,6-4; 7-6(1),Q,109,6,2,44,73,32,44,14,29,8,11,11,46,73,2,2,50,93,32,50,17,43,7,11,11,49,93
2009-07-26 00:00:00.000,Gstaad Switzerland ATP World Tour 250,CLAY,2,Andreas Beck,Victor Crivoi,Andreas Beck,6-4; 7-6(5),Q,105,8,6,41,80,29,41,18,39,7,10,11,47,80,4,4,42,80,28,42,18,38,7,11,11,46,80
2009-07-26 00:00:00.000,Gstaad Switzerland ATP World Tour 250,CLAY,2,Thomaz Bellucci,Igor Andreev,Thomaz Bellucci,6-4; 7-5,S,98,2,2,51,74,38,51,12,23,1,1,11,50,74,1,2,37,59,29,37,11,22,0,2,11,40,59
2009-07-26 00:00:00.000,Gstaad Switzerland ATP World Tour 250,CLAY,2,Andreas Beck,Marcos Daniel,Andreas Beck,7-6(3); 6-3,S,85,7,2,36,60,32,36,16,24,0,0,11,48,60,10,2,49,67,38,49,8,18,7,8,10,46,67
2009-07-26 00:00:00.000,Gstaad Switzerland ATP World Tour 250,CLAY,2,Thomaz Bellucci,Andreas Beck,Thomaz Bellucci,6-4; 7-6(2),F,100,7,1,48,67,40,48,10,19,1,1,11,50,67,3,3,34,61,30,34,15,27,2,3,11,45,61
2009-07-27 00:00:00.000,Los Angeles CA; U.S.A. ATP World Tour 250,HARD,2,Tommy Haas,N/A Bye,Tommy Haas,,R32,0,0,0,0,0,0,0,0,0,0,0,0,0,0,0,0,0,0,0,0,0,0,0,0,0,0,0
2009-07-27 00:00:00.000,Los Angeles CA; U.S.A. ATP World Tour 250,HARD,2,Jesse Levine,Bobby Reynolds,Jesse Levine,6-2; 6-3,R32,60,4,2,33,44,26,33,7,11,1,1,8,33,44,6,3,32,62,25,32,9,30,2,6,9,34,62
2009-07-27 00:00:00.000,Los Angeles CA; U.S.A. ATP World Tour 250,HARD,2,Ernests Gulbis,Yen-Hsun Lu,Ernests Gulbis,7-5; 6-2,R32,83,7,6,43,71,33,43,15,28,5,5,10,48,71,0,4,36,59,22,36,11,23,3,6,10,33,59
2009-07-27 00:00:00.000,Los Angeles CA; U.S.A. ATP World Tour 250,HARD,2,Marat Safin,Robby Ginepri,Marat Safin,3-6; 6-3; 6-4,R32,92,8,7,36,71,29,36,16,35,0,4,14,45,71,5,1,43,72,32,43,12,29,4,9,14,44,72
2009-07-27 00:00:00.000,Los Angeles CA; U.S.A. ATP World Tour 250,HARD,2,Dudi Sela,N/A Bye,Dudi Sela,,R32,0,0,0,0,0,0,0,0,0,0,0,0,0,0,0,0,0,0,0,0,0,0,0,0,0,0,0
2009-07-27 00:00:00.000,Los Angeles CA; U.S.A. ATP World Tour 250,HARD,2,Robert Kendrick,Vincent Spadea,Robert Kendrick,6-0; 6-0,R32,36,5,0,18,29,16,18,8,11,0,0,6,24,29,1,3,20,39,6,20,6,19,3,9,6,12,39
2009-07-27 00:00:00.000,Los Angeles CA; U.S.A. ATP World Tour 250,HARD,2,Ryan Sweeting,Taylor Dent,Ryan Sweeting,6-4; 2-6; 6-3,R32,103,5,4,55,91,37,55,19,36,10,13,13,56,91,7,9,40,74,33,40,14,34,5,9,14,47,74
2009-07-27 00:00:00.000,Los Angeles CA; U.S.A. ATP World Tour 250,HARD,2,Sam Querrey,Denis Istomin,Sam Querrey,6-2; 6-0,R32,46,6,2,20,33,18,20,6,13,0,1,7,24,33,2,5,31,47,16,31,2,16,5,11,7,18,47
2009-07-27 00:00:00.000,Los Angeles CA; U.S.A. ATP World Tour 250,HARD,2,John Isner,Benjamin Becker,John Isner,7-6(8); 7-6(3),R32,125,15,5,48,86,44,48,18,38,1,2,12,62,86,6,3,56,98,41,56,20,42,7,8,12,61,98
2009-07-27 00:00:00.000,Los Angeles CA; U.S.A. ATP World Tour 250,HARD,2,Marcos Baghdatis,Frank Dancevic,Marcos Baghdatis,7-6(3); 6-3,R32,101,11,8,39,87,28,39,29,48,8,9,11,57,87,2,3,38,65,26,38,13,27,1,3,10,39,65
2009-07-27 00:00:00.000,Los Angeles CA; U.S.A. ATP World Tour 250,HARD,2,Carsten Ball,Marc Gicquel,Carsten Ball,6-2; 7-6(6),R32,81,9,7,37,66,31,37,14,29,3,4,10,45,66,3,3,40,73,27,40,16,33,5,8,10,43,73
2009-07-27 00:00:00.000,Los Angeles CA; U.S.A. ATP World Tour 250,HARD,2,Dmitry Tursunov,N/A Bye,Dmitry Tursunov,,R32,0,0,0,0,0,0,0,0,0,0,0,0,0,0,0,0,0,0,0,0,0,0,0,0,0,0,0
2009-07-27 00:00:00.000,Los Angeles CA; U.S.A. ATP World Tour 250,HARD,2,Igor Kunitsyn,Somdev Devvarman,Igor Kunitsyn,7-5; 6-2,R32,76,0,0,36,56,25,36,13,20,0,2,10,38,56,1,2,32,55,21,32,8,23,3,8,10,29,55
2009-07-27 00:00:00.000,Los Angeles CA; U.S.A. ATP World Tour 250,HARD,2,Leonardo Mayer,Josselin Ouanna,Leonardo Mayer,6-2; 6-3,R32,75,4,4,21,51,16,21,20,30,0,1,9,36,51,4,4,26,59,16,26,14,33,1,5,8,30,59
2009-07-27 00:00:00.000,Los Angeles CA; U.S.A. ATP World Tour 250,HARD,2,Chris Guccione,Kevin Kim,Chris Guccione,6-1; 6-4,R32,50,11,0,22,47,20,22,17,25,2,2,9,37,47,4,6,26,44,22,26,4,18,0,3,8,26,44
2009-07-27 00:00:00.000,Los Angeles CA; U.S.A. ATP World Tour 250,HARD,2,Mardy Fish,N/A Bye,Mardy Fish,,R32,0,0,0,0,0,0,0,0,0,0,0,0,0,0,0,0,0,0,0,0,0,0,0,0,0,0,0
2009-07-27 00:00:00.000,Los Angeles CA; U.S.A. ATP World Tour 250,HARD,2,Tommy Haas,Jesse Levine,Tommy Haas,6-1; 6-3,R16,63,2,4,23,44,21,23,12,21,0,0,8,33,44,4,9,23,48,16,23,9,25,5,9,8,25,48
2009-07-27 00:00:00.000,Los Angeles CA; U.S.A. ATP World Tour 250,HARD,2,Marat Safin,Ernests Gulbis,Marat Safin,2-6; 6-3; 6-4,R16,105,5,4,49,87,29,49,22,38,9,13,14,51,87,4,8,44,90,30,44,22,46,10,14,13,52,90
2009-07-27 00:00:00.000,Los Angeles CA; U.S.A. ATP World Tour 250,HARD,2,Dudi Sela,Robert Kendrick,Dudi Sela,6-4; 3-6; 6-1,R16,109,2,3,60,82,45,60,11,22,2,3,13,56,82,8,2,45,86,30,45,22,41,3,6,13,52,86
2009-07-27 00:00:00.000,Los Angeles CA; U.S.A. ATP World Tour 250,HARD,2,Sam Querrey,Ryan Sweeting,Sam Querrey,6-3; 6-7(5); 6-3,R16,117,15,5,59,104,46,59,22,45,4,6,16,68,104,8,7,67,98,46,67,13,31,3,7,14,59,98
2009-07-27 00:00:00.000,Los Angeles CA; U.S.A. ATP World Tour 250,HARD,2,John Isner,Marcos Baghdatis,John Isner,6-3; 7-6(11),R16,110,11,1,50,76,34,50,20,26,0,0,11,54,76,3,2,35,71,27,35,20,36,2,3,10,47,71
2009-07-27 00:00:00.000,Los Angeles CA; U.S.A. ATP World Tour 250,HARD,2,Carsten Ball,Dmitry Tursunov,Carsten Ball,6-4; 0-1 RET,R16,49,7,2,16,32,12,16,10,16,0,1,5,22,32,0,1,21,41,12,21,11,20,4,6,6,23,41
2009-07-27 00:00:00.000,Los Angeles CA; U.S.A. ATP World Tour 250,HARD,2,Leonardo Mayer,Igor Kunitsyn,Leonardo Mayer,7-6(5); 6-7(7); 6-3,R16,163,9,9,63,110,49,63,24,47,2,6,17,73,110,1,3,81,125,52,81,24,44,7,12,16,76,125
2009-07-27 00:00:00.000,Los Angeles CA; U.S.A. ATP World Tour 250,HARD,2,Mardy Fish,Chris Guccione,Mardy Fish,6-7(3); 7-6(12); 6-4,R16,143,11,4,70,116,55,70,29,46,2,2,17,84,116,24,6,70,119,55,70,28,49,3,4,17,83,119
2009-07-27 00:00:00.000,Los Angeles CA; U.S.A. ATP World Tour 250,HARD,2,Tommy Haas,Marat Safin,Tommy Haas,7-6(3); 6-2,Q,109,4,4,34,58,23,34,16,24,2,4,10,39,58,4,4,54,102,31,54,20,48,12,16,10,51,102
2009-07-27 00:00:00.000,Los Angeles CA; U.S.A. ATP World Tour 250,HARD,2,Sam Querrey,Dudi Sela,Sam Querrey,6-3; 7-5,Q,77,9,3,27,58,25,27,20,31,0,0,11,45,58,1,2,35,61,26,35,13,26,3,5,10,39,61
2009-07-27 00:00:00.000,Los Angeles CA; U.S.A. ATP World Tour 250,HARD,2,Carsten Ball,John Isner,Carsten Ball,6-4; 6-4,Q,63,9,1,34,60,26,34,17,26,2,2,10,43,60,2,1,37,52,25,37,9,15,0,2,10,34,52
2009-07-27 00:00:00.000,Los Angeles CA; U.S.A. ATP World Tour 250,HARD,2,Leonardo Mayer,Mardy Fish,Leonardo Mayer,W/O,Q,0,0,0,0,0,0,0,0,0,0,0,0,0,0,0,0,0,0,0,0,0,0,0,0,0,0,0
2009-07-27 00:00:00.000,Los Angeles CA; U.S.A. ATP World Tour 250,HARD,2,Sam Querrey,Tommy Haas,Sam Querrey,6-3; 7-5,S,90,8,2,44,71,34,44,16,27,5,5,11,50,71,2,3,35,64,26,35,13,29,4,6,10,39,64
2009-07-27 00:00:00.000,Los Angeles CA; U.S.A. ATP World Tour 250,HARD,2,Carsten Ball,Leonardo Mayer,Carsten Ball,7-5; 7-6(3),S,92,10,4,38,75,32,38,21,37,3,4,12,53,75,6,3,46,75,34,46,15,29,2,4,12,49,75
2009-07-27 00:00:00.000,Los Angeles CA; U.S.A. ATP World Tour 250,HARD,2,Sam Querrey,Carsten Ball,Sam Querrey,6-4; 3-6; 6-1,F,88,11,3,46,81,36,46,17,35,2,4,13,53,81,11,3,43,78,33,43,15,35,3,7,13,48,78
2009-07-27 00:00:00.000,Umag Croatia ATP World Tour 250,CLAY,2,Nikolay Davydenko,Daniel Gimeno-Traver,Nikolay Davydenko,6-2; 6-2,R32,76,1,0,34,46,24,34,9,12,0,0,8,33,46,1,3,29,60,20,29,10,31,4,8,8,30,60
2009-07-27 00:00:00.000,Umag Croatia ATP World Tour 250,CLAY,2,Alberto Martin,Martin Klizan,Alberto Martin,6-4; 6-4,R32,109,0,1,43,74,26,43,16,31,7,10,10,42,74,2,3,28,63,18,28,13,35,4,9,10,31,63
2009-07-27 00:00:00.000,Umag Croatia ATP World Tour 250,CLAY,2,Simone Bolelli,Ruben Ramirez Hidalgo,Simone Bolelli,7-6(7); 3-6; 6-0,R32,155,5,4,65,100,48,65,15,35,7,10,14,63,100,3,6,66,109,42,66,21,43,12,16,13,63,109
2009-07-27 00:00:00.000,Umag Croatia ATP World Tour 250,CLAY,2,Fabio Fognini,Mischa Zverev,Fabio Fognini,2-6; 6-3; 6-4,R32,114,4,5,54,83,43,54,13,29,5,8,14,56,83,2,1,57,94,39,57,16,37,8,11,13,55,94
2009-07-27 00:00:00.000,Umag Croatia ATP World Tour 250,CLAY,2,Jurgen Melzer,Brian Dabul,Jurgen Melzer,6-3; 7-5,R32,89,3,2,34,61,28,34,13,27,2,3,10,41,61,0,1,43,65,27,43,10,22,5,9,11,37,65
2009-07-27 00:00:00.000,Umag Croatia ATP World Tour 250,CLAY,2,Pablo Cuevas,Ivan Dodig,Pablo Cuevas,6-3; 6-1,R32,78,4,2,27,46,21,27,9,19,0,1,8,30,46,4,0,26,55,16,26,9,29,5,10,8,25,55
2009-07-27 00:00:00.000,Umag Croatia ATP World Tour 250,CLAY,2,Ivan Ljubicic,Filippo Volandri,Ivan Ljubicic,6-1; 6-4,R32,64,7,0,26,56,23,26,15,30,6,7,9,38,56,0,2,35,45,20,35,3,10,3,7,8,23,45
2009-07-27 00:00:00.000,Umag Croatia ATP World Tour 250,CLAY,2,Nicolas Almagro,Marcel Granollers,Nicolas Almagro,6-1; 6-3,R32,66,3,3,31,51,23,31,8,20,4,6,8,31,51,1,3,24,48,10,24,8,24,0,6,8,18,48
2009-07-27 00:00:00.000,Umag Croatia ATP World Tour 250,CLAY,2,Juan Carlos Ferrero,Christophe Rochus,Juan Carlos Ferrero,6-2; 6-3,R32,71,6,0,42,62,28,42,10,20,5,6,8,38,62,0,2,21,48,11,21,11,27,2,7,9,22,48
2009-07-27 00:00:00.000,Umag Croatia ATP World Tour 250,CLAY,2,Potito Starace,Grega Zemlja,Potito Starace,6-1; 6-3,R32,67,0,0,40,51,28,40,7,11,2,3,8,35,51,2,5,25,47,15,25,8,22,3,7,7,23,47
2009-07-27 00:00:00.000,Umag Croatia ATP World Tour 250,CLAY,2,Oscar Hernandez,Sergiy Stakhovsky,Oscar Hernandez,7-6(3); 6-1,R32,91,1,0,46,61,35,46,10,15,2,3,10,45,61,4,3,41,64,26,41,9,23,3,6,9,35,64
2009-07-27 00:00:00.000,Umag Croatia ATP World Tour 250,CLAY,2,Maximo Gonzalez,Viktor Troicki,Maximo Gonzalez,6-4; 3-6; 7-6(6),R32,179,1,7,61,108,43,61,19,47,7,11,15,62,108,7,4,75,130,49,75,27,55,13,17,16,76,130
2009-07-27 00:00:00.000,Umag Croatia ATP World Tour 250,CLAY,2,Andreas Seppi,Juan Ignacio Chela,Andreas Seppi,6-4; 2-6; 6-3,R32,128,2,2,68,109,45,68,18,41,10,14,14,63,109,2,1,53,85,34,53,14,32,8,12,13,48,85
2009-07-27 00:00:00.000,Umag Croatia ATP World Tour 250,CLAY,2,Frederico Gil,Sergio Roitman,Frederico Gil,7-5; 6-2,R32,81,2,0,31,50,23,31,11,19,1,3,10,34,50,0,3,39,63,24,39,6,24,3,8,10,30,63
2009-07-27 00:00:00.000,Umag Croatia ATP World Tour 250,CLAY,2,Nicolas Massu,Blaz Kavcic,Nicolas Massu,5-7; 6-3; 6-2,R32,164,4,4,58,86,38,58,15,28,3,7,15,53,86,3,1,70,92,41,70,8,22,6,12,14,49,92
2009-07-27 00:00:00.000,Umag Croatia ATP World Tour 250,CLAY,2,David Ferrer,Daniel Koellerer,David Ferrer,6-1; 6-7(2); 6-3,R32,147,4,4,60,100,38,60,23,40,4,8,15,61,100,2,3,45,79,24,45,17,34,2,9,13,41,79
2009-07-27 00:00:00.000,Umag Croatia ATP World Tour 250,CLAY,2,Nikolay Davydenko,Alberto Martin,Nikolay Davydenko,6-2; 6-3,R16,69,0,1,38,48,29,38,6,10,1,2,9,35,48,0,2,29,47,15,29,8,18,3,7,8,23,47
2009-07-27 00:00:00.000,Umag Croatia ATP World Tour 250,CLAY,2,Simone Bolelli,Fabio Fognini,Simone Bolelli,6-3; 6-4,R16,96,1,1,46,78,30,46,19,32,9,10,10,49,78,5,3,26,53,16,26,16,27,4,7,9,32,53
2009-07-27 00:00:00.000,Umag Croatia ATP World Tour 250,CLAY,2,Jurgen Melzer,Pablo Cuevas,Jurgen Melzer,6-4; 6-3,R16,81,7,3,36,63,29,36,13,27,0,1,10,42,63,6,2,28,55,18,28,14,27,2,5,9,32,55
2009-07-27 00:00:00.000,Umag Croatia ATP World Tour 250,CLAY,2,Ivan Ljubicic,Nicolas Almagro,Ivan Ljubicic,7-5; 7-6(2),R16,121,14,1,53,101,43,53,23,48,8,8,12,66,101,4,0,44,76,31,44,18,32,0,1,12,49,76
2009-07-27 00:00:00.000,Umag Croatia ATP World Tour 250,CLAY,2,Juan Carlos Ferrero,Potito Starace,Juan Carlos Ferrero,1-6; 6-3; 6-2,R16,113,1,1,60,79,40,60,9,19,7,10,12,49,79,2,1,61,80,38,61,9,19,6,10,12,47,80
2009-07-27 00:00:00.000,Umag Croatia ATP World Tour 250,CLAY,2,Maximo Gonzalez,Oscar Hernandez,Maximo Gonzalez,6-4; 6-4,R16,108,1,3,37,59,21,37,9,22,2,6,10,30,59,1,2,48,72,25,48,10,24,9,15,10,35,72
2009-07-27 00:00:00.000,Umag Croatia ATP World Tour 250,CLAY,2,Andreas Seppi,Frederico Gil,Andreas Seppi,7-5; 7-6(5),R16,118,7,2,45,80,32,45,18,35,7,10,12,50,80,2,4,36,75,21,36,19,39,1,5,12,40,75
2009-07-27 00:00:00.000,Umag Croatia ATP World Tour 250,CLAY,2,Nicolas Massu,David Ferrer,Nicolas Massu,4-6; 6-2; 6-4,R16,137,5,5,52,78,35,52,10,26,1,5,14,45,78,4,3,54,83,33,54,12,29,5,11,14,45,83
2009-07-27 00:00:00.000,Umag Croatia ATP World Tour 250,CLAY,2,Nikolay Davydenko,Simone Bolelli,Nikolay Davydenko,7-6(10); 6-1,Q,112,7,3,42,79,28,42,22,37,3,5,10,50,79,5,1,46,80,26,46,16,34,7,11,9,42,80
2009-07-27 00:00:00.000,Umag Croatia ATP World Tour 250,CLAY,2,Jurgen Melzer,Ivan Ljubicic,Jurgen Melzer,4-6; 7-6(3); 6-3,Q,148,3,2,68,109,53,68,20,41,6,8,16,73,109,10,1,53,96,40,53,24,43,6,8,15,64,96
2009-07-27 00:00:00.000,Umag Croatia ATP World Tour 250,CLAY,2,Juan Carlos Ferrero,Maximo Gonzalez,Juan Carlos Ferrero,7-5; 6-2,Q,101,5,2,41,58,30,41,10,17,1,2,10,40,58,1,3,34,59,21,34,11,25,3,7,10,32,59
2009-07-27 00:00:00.000,Umag Croatia ATP World Tour 250,CLAY,2,Andreas Seppi,Nicolas Massu,Andreas Seppi,6-4; 6-4,Q,95,6,2,35,58,27,35,13,23,0,2,10,40,58,3,2,36,68,22,36,16,32,6,10,10,38,68
2009-07-27 00:00:00.000,Umag Croatia ATP World Tour 250,CLAY,2,Nikolay Davydenko,Jurgen Melzer,Nikolay Davydenko,6-1; 6-1,S,51,2,0,28,32,25,28,3,4,0,0,7,28,32,0,0,25,45,12,25,6,20,4,9,7,18,45
2009-07-27 00:00:00.000,Umag Croatia ATP World Tour 250,CLAY,2,Juan Carlos Ferrero,Andreas Seppi,Juan Carlos Ferrero,6-1; 6-7(1); 7-5,S,158,2,2,54,98,40,54,26,44,5,6,16,66,98,3,2,54,100,38,54,21,46,4,8,15,59,100
2009-07-27 00:00:00.000,Umag Croatia ATP World Tour 250,CLAY,2,Nikolay Davydenko,Juan Carlos Ferrero,Nikolay Davydenko,6-3; 6-0,F,71,4,4,28,43,23,28,6,15,1,2,7,29,43,0,0,39,54,14,39,8,15,4,10,8,22,54
2009-08-02 00:00:00.000,Washington DC; USA ATP World Tour 500,HARD,2,Andy Roddick,N/A Bye,Andy Roddick,,R64,0,0,0,0,0,0,0,0,0,0,0,0,0,0,0,0,0,0,0,0,0,0,0,0,0,0,0
2009-08-02 00:00:00.000,Washington DC; USA ATP World Tour 500,HARD,2,Benjamin Becker,Robby Ginepri,Benjamin Becker,7-6(3); 6-7(1); 7-6(4),R64,130,27,7,66,118,60,66,24,52,3,5,18,84,118,13,4,63,102,54,63,23,39,1,3,18,77,102
2009-08-02 00:00:00.000,Washington DC; USA ATP World Tour 500,HARD,2,Igor Kunitsyn,Frederico Gil,Igor Kunitsyn,7-6(1); 6-4,R64,77,4,0,35,71,31,35,21,36,2,2,11,52,71,1,2,38,60,29,38,14,22,1,2,11,43,60
2009-08-02 00:00:00.000,Washington DC; USA ATP World Tour 500,HARD,2,Sam Querrey,N/A Bye,Sam Querrey,,R64,0,0,0,0,0,0,0,0,0,0,0,0,0,0,0,0,0,0,0,0,0,0,0,0,0,0,0
2009-08-02 00:00:00.000,Washington DC; USA ATP World Tour 500,HARD,2,Ivo Karlovic,N/A Bye,Ivo Karlovic,,R64,0,0,0,0,0,0,0,0,0,0,0,0,0,0,0,0,0,0,0,0,0,0,0,0,0,0,0
2009-08-02 00:00:00.000,Washington DC; USA ATP World Tour 500,HARD,2,Rainer Schuettler,Leonardo Mayer,Rainer Schuettler,6-1; 3-6; 7-6(5),R64,128,5,1,57,93,40,57,22,36,5,7,14,62,93,4,2,48,88,36,48,21,40,4,7,14,57,88
2009-08-02 00:00:00.000,Washington DC; USA ATP World Tour 500,HARD,2,Somdev Devvarman,Yuichi Sugita,Somdev Devvarman,6-0; 7-6(6),R64,86,1,0,39,59,30,39,9,20,0,2,9,39,59,1,4,28,57,18,28,10,29,3,8,9,28,57
2009-08-02 00:00:00.000,Washington DC; USA ATP World Tour 500,HARD,2,Marin Cilic,N/A Bye,Marin Cilic,,R64,0,0,0,0,0,0,0,0,0,0,0,0,0,0,0,0,0,0,0,0,0,0,0,0,0,0,0
2009-08-02 00:00:00.000,Washington DC; USA ATP World Tour 500,HARD,2,Jo-Wilfried Tsonga,N/A Bye,Jo-Wilfried Tsonga,,R64,0,0,0,0,0,0,0,0,0,0,0,0,0,0,0,0,0,0,0,0,0,0,0,0,0,0,0
2009-08-02 00:00:00.000,Washington DC; USA ATP World Tour 500,HARD,2,John Isner,Andrey Golubev,John Isner,7-6(8); 6-3,R64,79,4,1,47,61,41,47,10,14,0,0,11,51,61,3,1,39,69,30,39,17,30,1,2,10,47,69
2009-08-02 00:00:00.000,Washington DC; USA ATP World Tour 500,HARD,2,Sebastien De Chaunac,Denis Istomin,Sebastien De Chaunac,6-3; 7-6(7),R64,120,15,4,49,94,38,49,16,45,8,12,11,54,94,5,2,41,69,27,41,9,28,3,8,10,36,69
2009-08-02 00:00:00.000,Washington DC; USA ATP World Tour 500,HARD,2,Dmitry Tursunov,N/A Bye,Dmitry Tursunov,,R64,0,0,0,0,0,0,0,0,0,0,0,0,0,0,0,0,0,0,0,0,0,0,0,0,0,0,0
2009-08-02 00:00:00.000,Washington DC; USA ATP World Tour 500,HARD,2,Mardy Fish,N/A Bye,Mardy Fish,,R64,0,0,0,0,0,0,0,0,0,0,0,0,0,0,0,0,0,0,0,0,0,0,0,0,0,0,0
2009-08-02 00:00:00.000,Washington DC; USA ATP World Tour 500,HARD,2,Philipp Petzschner,Teymuraz Gabashvili,Philipp Petzschner,4-6; 6-3; 6-4,R64,119,7,5,47,90,41,47,19,43,5,7,15,60,90,6,15,41,97,30,41,27,56,4,7,14,57,97
2009-08-02 00:00:00.000,Washington DC; USA ATP World Tour 500,HARD,2,Ernests Gulbis,Kevin Kim,Ernests Gulbis,7-5; 3-6; 6-3,R64,110,9,6,52,86,37,52,17,34,0,3,15,54,86,5,3,48,94,35,48,24,46,3,7,15,59,94
2009-08-02 00:00:00.000,Washington DC; USA ATP World Tour 500,HARD,2,Tomas Berdych,N/A Bye,Tomas Berdych,,R64,0,0,0,0,0,0,0,0,0,0,0,0,0,0,0,0,0,0,0,0,0,0,0,0,0,0,0
2009-08-02 00:00:00.000,Washington DC; USA ATP World Tour 500,HARD,2,Tommy Robredo,N/A Bye,Tommy Robredo,,R64,0,0,0,0,0,0,0,0,0,0,0,0,0,0,0,0,0,0,0,0,0,0,0,0,0,0,0
2009-08-02 00:00:00.000,Washington DC; USA ATP World Tour 500,HARD,2,Juan Carlos Ferrero,Nicolas Lapentti,Juan Carlos Ferrero,6-4; 6-7(5); 6-0,R64,150,2,4,61,106,50,61,21,45,8,8,14,71,106,10,1,54,89,38,54,19,35,2,6,14,57,89
2009-08-02 00:00:00.000,Washington DC; USA ATP World Tour 500,HARD,2,Frank Dancevic,Santiago Giraldo,Frank Dancevic,6-4; 6-3,R64,68,11,1,31,51,25,31,15,20,0,0,10,40,51,3,1,40,63,25,40,13,23,5,7,9,38,63
2009-08-02 00:00:00.000,Washington DC; USA ATP World Tour 500,HARD,2,Tommy Haas,N/A Bye,Tommy Haas,,R64,0,0,0,0,0,0,0,0,0,0,0,0,0,0,0,0,0,0,0,0,0,0,0,0,0,0,0
2009-08-02 00:00:00.000,Washington DC; USA ATP World Tour 500,HARD,2,Igor Andreev,N/A Bye,Igor Andreev,,R64,0,0,0,0,0,0,0,0,0,0,0,0,0,0,0,0,0,0,0,0,0,0,0,0,0,0,0
2009-08-02 00:00:00.000,Washington DC; USA ATP World Tour 500,HARD,2,Wayne Odesnik,Paul Capdeville,Wayne Odesnik,4-6; 6-2; 6-4,R64,127,9,1,43,79,30,43,20,36,7,11,14,50,79,4,7,51,88,30,51,17,37,10,16,14,47,88
2009-08-02 00:00:00.000,Washington DC; USA ATP World Tour 500,HARD,2,Alejandro Falla,Jesse Witten,Alejandro Falla,6-1; 6-4,R64,60,1,1,31,53,22,31,11,22,4,6,9,33,53,2,3,23,42,11,23,8,19,2,7,8,19,42
2009-08-02 00:00:00.000,Washington DC; USA ATP World Tour 500,HARD,2,Fernando Gonzalez,N/A Bye,Fernando Gonzalez,,R64,0,0,0,0,0,0,0,0,0,0,0,0,0,0,0,0,0,0,0,0,0,0,0,0,0,0,0
2009-08-02 00:00:00.000,Washington DC; USA ATP World Tour 500,HARD,2,Robin Soderling,N/A Bye,Robin Soderling,,R64,0,0,0,0,0,0,0,0,0,0,0,0,0,0,0,0,0,0,0,0,0,0,0,0,0,0,0
2009-08-02 00:00:00.000,Washington DC; USA ATP World Tour 500,HARD,2,Mikhail Youzhny,Robert Kendrick,Mikhail Youzhny,7-5; 3-6; 6-1,R64,101,11,6,45,82,36,45,18,37,1,3,14,54,82,7,4,34,70,27,34,19,36,2,6,14,46,70
2009-08-02 00:00:00.000,Washington DC; USA ATP World Tour 500,HARD,2,Marc Gicquel,Jerzy Janowicz,Marc Gicquel,7-5; 2-6; 6-4,R64,118,6,4,49,93,34,49,23,44,2,5,15,57,93,9,1,40,81,30,40,22,41,1,4,15,52,81
2009-08-02 00:00:00.000,Washington DC; USA ATP World Tour 500,HARD,2,Viktor Troicki,N/A Bye,Viktor Troicki,,R64,0,0,0,0,0,0,0,0,0,0,0,0,0,0,0,0,0,0,0,0,0,0,0,0,0,0,0
2009-08-02 00:00:00.000,Washington DC; USA ATP World Tour 500,HARD,2,Dudi Sela,N/A Bye,Dudi Sela,,R64,0,0,0,0,0,0,0,0,0,0,0,0,0,0,0,0,0,0,0,0,0,0,0,0,0,0,0
2009-08-02 00:00:00.000,Washington DC; USA ATP World Tour 500,HARD,2,Lleyton Hewitt,Donald Young,Lleyton Hewitt,7-5; 6-2,R64,94,4,2,27,70,22,27,17,43,8,11,10,39,70,4,5,23,64,17,23,14,41,4,10,10,31,64
2009-08-02 00:00:00.000,Washington DC; USA ATP World Tour 500,HARD,2,Yen-Hsun Lu,Michael Russell,Yen-Hsun Lu,4-6; 6-1; 7-5,R64,167,3,5,61,119,45,61,22,58,14,18,14,67,119,4,5,67,99,39,67,12,32,6,13,15,51,99
2009-08-02 00:00:00.000,Washington DC; USA ATP World Tour 500,HARD,2,Juan Martin Del Potro,N/A Bye,Juan Martin Del Potro,,R64,0,0,0,0,0,0,0,0,0,0,0,0,0,0,0,0,0,0,0,0,0,0,0,0,0,0,0
2009-08-02 00:00:00.000,Washington DC; USA ATP World Tour 500,HARD,2,Andy Roddick,Benjamin Becker,Andy Roddick,6-3; 6-2,R32,55,8,0,27,46,22,27,15,19,0,0,9,37,46,5,2,21,39,14,21,10,18,1,4,8,24,39
2009-08-02 00:00:00.000,Washington DC; USA ATP World Tour 500,HARD,2,Sam Querrey,Igor Kunitsyn,Sam Querrey,6-3; 6-4,R32,67,6,2,34,48,29,34,9,14,0,1,10,38,48,2,2,37,68,23,37,16,31,9,12,9,39,68
2009-08-02 00:00:00.000,Washington DC; USA ATP World Tour 500,HARD,2,Ivo Karlovic,Rainer Schuettler,Ivo Karlovic,6-4; 7-5,R32,76,18,2,34,55,29,34,13,21,0,1,11,42,55,3,1,43,62,30,43,12,19,2,5,11,42,62
2009-08-02 00:00:00.000,Washington DC; USA ATP World Tour 500,HARD,2,Somdev Devvarman,Marin Cilic,Somdev Devvarman,7-5; 6-4,R32,102,1,1,38,61,28,38,13,23,5,7,11,41,61,8,4,41,76,25,41,19,35,3,7,11,44,76
2009-08-02 00:00:00.000,Washington DC; USA ATP World Tour 500,HARD,2,John Isner,Jo-Wilfried Tsonga,John Isner,4-6; 7-6(2); 7-6(4),R32,169,20,4,73,110,57,73,23,37,6,7,17,80,110,8,5,60,111,52,60,29,51,6,6,17,81,111
2009-08-02 00:00:00.000,Washington DC; USA ATP World Tour 500,HARD,2,Sebastien De Chaunac,Dmitry Tursunov,Sebastien De Chaunac,3-6; 7-6(3); 7-5,R32,160,6,5,61,122,39,61,28,61,6,13,17,67,122,6,4,54,100,39,54,16,46,8,14,16,55,100
2009-08-02 00:00:00.000,Washington DC; USA ATP World Tour 500,HARD,2,Philipp Petzschner,Mardy Fish,Philipp Petzschner,1-6; 6-4; 6-1,R32,92,9,5,33,74,26,33,22,41,1,3,12,48,74,7,9,36,72,29,36,16,36,2,5,12,45,72
2009-08-02 00:00:00.000,Washington DC; USA ATP World Tour 500,HARD,2,Tomas Berdych,Ernests Gulbis,Tomas Berdych,6-2; 7-6(6),R32,95,8,5,44,86,34,44,21,42,12,13,10,55,86,5,1,34,62,23,34,16,28,0,3,10,39,62
2009-08-02 00:00:00.000,Washington DC; USA ATP World Tour 500,HARD,2,Juan Carlos Ferrero,Tommy Robredo,Juan Carlos Ferrero,6-3; 6-2,R32,79,3,0,36,55,26,36,14,19,3,3,9,40,55,1,0,32,50,21,32,8,18,4,7,8,29,50
2009-08-02 00:00:00.000,Washington DC; USA ATP World Tour 500,HARD,2,Tommy Haas,Frank Dancevic,Tommy Haas,6-1; 4-6; 6-4,R32,116,12,9,43,97,34,43,28,54,7,9,14,62,97,8,2,48,76,31,48,15,28,6,10,13,46,76
2009-08-02 00:00:00.000,Washington DC; USA ATP World Tour 500,HARD,2,Wayne Odesnik,Igor Andreev,Wayne Odesnik,2-6; 7-5; 6-4,R32,151,8,7,68,103,41,68,12,35,5,12,15,53,103,10,9,52,95,32,52,17,43,7,14,15,49,95
2009-08-02 00:00:00.000,Washington DC; USA ATP World Tour 500,HARD,2,Fernando Gonzalez,Alejandro Falla,Fernando Gonzalez,7-5; 7-5,R32,85,7,6,39,75,29,39,16,36,8,11,12,45,75,2,3,37,63,25,37,9,26,0,5,12,34,63
2009-08-02 00:00:00.000,Washington DC; USA ATP World Tour 500,HARD,2,Robin Soderling,Mikhail Youzhny,Robin Soderling,6-3; 6-1,R32,63,4,0,31,50,25,31,11,19,4,4,8,36,50,1,0,30,50,19,30,6,20,2,6,8,25,50
2009-08-02 00:00:00.000,Washington DC; USA ATP World Tour 500,HARD,2,Marc Gicquel,Viktor Troicki,Marc Gicquel,3-0 RET,R32,16,1,0,3,8,3,3,5,5,0,0,2,8,8,2,2,2,16,2,2,5,14,1,2,1,7,16
2009-08-02 00:00:00.000,Washington DC; USA ATP World Tour 500,HARD,2,Lleyton Hewitt,Dudi Sela,Lleyton Hewitt,6-3; 2-6; 6-2,R32,116,8,5,44,82,30,44,21,38,5,8,13,51,82,3,3,45,85,25,45,24,40,4,8,12,49,85
2009-08-02 00:00:00.000,Washington DC; USA ATP World Tour 500,HARD,2,Juan Martin Del Potro,Yen-Hsun Lu,Juan Martin Del Potro,4-6; 6-3; 6-2,R32,111,11,6,48,84,37,48,22,36,1,2,14,59,84,5,2,45,75,32,45,14,30,5,8,13,46,75
2009-08-02 00:00:00.000,Washington DC; USA ATP World Tour 500,HARD,2,Andy Roddick,Sam Querrey,Andy Roddick,7-6(4); 6-4,R16,95,3,6,51,77,36,51,14,26,7,9,11,50,77,11,1,39,68,30,39,12,29,2,5,11,42,68
2009-08-02 00:00:00.000,Washington DC; USA ATP World Tour 500,HARD,2,Ivo Karlovic,Somdev Devvarman,Ivo Karlovic,7-5; 6-1,R16,64,14,1,29,46,26,29,14,17,0,0,10,40,46,2,0,36,51,23,36,7,15,2,5,9,30,51
2009-08-02 00:00:00.000,Washington DC; USA ATP World Tour 500,HARD,2,John Isner,Sebastien De Chaunac,John Isner,6-2; 6-4,R16,80,3,2,31,47,23,31,13,16,0,0,9,36,47,2,5,31,70,25,31,14,39,1,4,9,39,70
2009-08-02 00:00:00.000,Washington DC; USA ATP World Tour 500,HARD,2,Tomas Berdych,Philipp Petzschner,Tomas Berdych,4-6; 6-3; 6-3,R16,109,6,2,40,77,24,40,22,37,5,9,14,46,77,11,5,49,86,32,49,14,37,3,9,14,46,86
2009-08-02 00:00:00.000,Washington DC; USA ATP World Tour 500,HARD,2,Tommy Haas,Juan Carlos Ferrero,Tommy Haas,7-5; 2-6; 6-1,R16,104,19,5,43,78,36,43,17,35,1,4,14,53,78,3,2,46,72,29,46,16,26,1,5,13,45,72
2009-08-02 00:00:00.000,Washington DC; USA ATP World Tour 500,HARD,2,Fernando Gonzalez,Wayne Odesnik,Fernando Gonzalez,6-2; 6-4,R16,74,7,3,37,68,30,37,13,31,8,9,9,43,68,3,2,33,52,20,33,9,19,4,8,9,29,52
2009-08-02 00:00:00.000,Washington DC; USA ATP World Tour 500,HARD,2,Robin Soderling,Marc Gicquel,Robin Soderling,7-5; 5-7; 6-3,R16,125,15,7,55,96,45,55,21,41,1,3,17,66,96,13,3,59,103,39,59,24,44,7,10,16,63,103
2009-08-02 00:00:00.000,Washington DC; USA ATP World Tour 500,HARD,2,Juan Martin Del Potro,Lleyton Hewitt,Juan Martin Del Potro,4-6; 6-3; 7-6(2),R16,146,18,4,51,96,38,51,27,45,7,10,16,65,96,13,6,49,99,40,49,23,50,6,9,15,63,99
2009-08-02 00:00:00.000,Washington DC; USA ATP World Tour 500,HARD,2,Andy Roddick,Ivo Karlovic,Andy Roddick,7-6(4); 7-6(5),Q,96,7,2,53,72,44,53,10,19,0,2,12,54,72,13,3,44,75,38,44,14,31,1,3,12,52,75
2009-08-02 00:00:00.000,Washington DC; USA ATP World Tour 500,HARD,2,John Isner,Tomas Berdych,John Isner,6-3; 6-7(10); 6-2,Q,149,17,4,69,112,52,69,20,43,7,9,15,72,112,7,8,43,97,33,43,25,54,3,8,14,58,97
2009-08-02 00:00:00.000,Washington DC; USA ATP World Tour 500,HARD,2,Fernando Gonzalez,Tommy Haas,Fernando Gonzalez,7-5; 6-4,Q,83,2,4,36,62,30,36,12,26,2,3,11,42,62,7,6,31,60,23,31,15,29,2,5,11,38,60
2009-08-02 00:00:00.000,Washington DC; USA ATP World Tour 500,HARD,2,Juan Martin Del Potro,Robin Soderling,Juan Martin Del Potro,W/O,Q,0,0,0,0,0,0,0,0,0,0,0,0,0,0,0,0,0,0,0,0,0,0,0,0,0,0,0
2009-08-02 00:00:00.000,Washington DC; USA ATP World Tour 500,HARD,2,Andy Roddick,John Isner,Andy Roddick,6-7(3); 6-2; 7-5,S,151,9,1,57,83,51,57,18,26,2,2,16,69,83,20,0,67,116,48,67,25,49,7,10,16,73,116
2009-08-02 00:00:00.000,Washington DC; USA ATP World Tour 500,HARD,2,Juan Martin Del Potro,Fernando Gonzalez,Juan Martin Del Potro,7-6(2); 6-3,S,127,10,7,42,89,32,42,24,47,6,8,11,56,89,5,6,47,83,31,47,16,36,3,6,10,47,83
2009-08-02 00:00:00.000,Washington DC; USA ATP World Tour 500,HARD,2,Juan Martin Del Potro,Andy Roddick,Juan Martin Del Potro,3-6; 7-5; 7-6(6),F,150,19,6,52,95,40,52,24,43,0,3,16,64,95,21,4,70,103,51,70,16,33,2,5,17,67,103
2009-08-10 00:00:00.000,ATP World Tour Masters 1000 Canada MontrTal; Canada ATP World Tour Masters 1000,HARD,2,Roger Federer,N/A Bye,Roger Federer,,R64,0,0,0,0,0,0,0,0,0,0,0,0,0,0,0,0,0,0,0,0,0,0,0,0,0,0,0
2009-08-10 00:00:00.000,ATP World Tour Masters 1000 Canada MontrTal; Canada ATP World Tour Masters 1000,HARD,2,Frederic Niemeyer,Igor Kunitsyn,Frederic Niemeyer,7-5; 6-1,R64,82,7,3,43,67,32,43,12,24,4,5,10,44,67,2,2,37,56,22,37,7,19,1,5,9,29,56
2009-08-10 00:00:00.000,ATP World Tour Masters 1000 Canada MontrTal; Canada ATP World Tour Masters 1000,HARD,2,Stanislas Wawrinka,Nicolas Kiefer,Stanislas Wawrinka,6-4; 6-1,R64,86,4,2,17,41,17,17,15,24,0,0,8,32,41,6,6,37,73,24,37,14,36,5,9,9,38,73
2009-08-10 00:00:00.000,ATP World Tour Masters 1000 Canada MontrTal; Canada ATP World Tour Masters 1000,HARD,2,Andrey Golubev,Radek Stepanek,Andrey Golubev,6-3; 6-4,R64,75,2,1,39,56,31,39,9,17,0,1,10,40,56,2,0,34,50,21,34,8,16,1,4,9,29,50
2009-08-10 00:00:00.000,ATP World Tour Masters 1000 Canada MontrTal; Canada ATP World Tour Masters 1000,HARD,2,Gilles Simon,Frank Dancevic,Gilles Simon,6-1; 6-2,R64,61,3,0,19,40,14,19,15,21,0,1,8,29,40,4,0,31,50,19,31,3,19,1,6,7,22,50
2009-08-10 00:00:00.000,ATP World Tour Masters 1000 Canada MontrTal; Canada ATP World Tour Masters 1000,HARD,2,Alejandro Falla,Dudi Sela,Alejandro Falla,6-4; 3-6; 6-3,R64,124,4,5,55,104,38,55,27,49,9,12,14,65,104,2,4,51,88,29,51,22,37,6,10,14,51,88
2009-08-10 00:00:00.000,ATP World Tour Masters 1000 Canada MontrTal; Canada ATP World Tour Masters 1000,HARD,2,Rainer Schuettler,Florent Serra,Rainer Schuettler,6-4; 6-0,R64,65,8,1,30,48,21,30,13,18,3,4,8,34,48,0,0,31,59,18,31,9,28,3,8,8,27,59
2009-08-10 00:00:00.000,ATP World Tour Masters 1000 Canada MontrTal; Canada ATP World Tour Masters 1000,HARD,2,Jo-Wilfried Tsonga,N/A Bye,Jo-Wilfried Tsonga,,R64,0,0,0,0,0,0,0,0,0,0,0,0,0,0,0,0,0,0,0,0,0,0,0,0,0,0,0
2009-08-10 00:00:00.000,ATP World Tour Masters 1000 Canada MontrTal; Canada ATP World Tour Masters 1000,HARD,2,Andy Murray,N/A Bye,Andy Murray,,R64,0,0,0,0,0,0,0,0,0,0,0,0,0,0,0,0,0,0,0,0,0,0,0,0,0,0,0
2009-08-10 00:00:00.000,ATP World Tour Masters 1000 Canada MontrTal; Canada ATP World Tour Masters 1000,HARD,2,Jeremy Chardy,Yen-Hsun Lu,Jeremy Chardy,6-7(5); 6-3; 6-4,R64,172,17,6,57,99,48,57,20,42,5,7,15,68,99,4,4,68,109,44,68,21,41,6,11,16,65,109
2009-08-10 00:00:00.000,ATP World Tour Masters 1000 Canada MontrTal; Canada ATP World Tour Masters 1000,HARD,2,Juan Carlos Ferrero,Lleyton Hewitt,Juan Carlos Ferrero,6-1; 6-4,R64,77,6,2,32,50,23,32,12,18,0,1,9,35,50,2,0,29,53,19,29,8,24,4,8,8,27,53
2009-08-10 00:00:00.000,ATP World Tour Masters 1000 Canada MontrTal; Canada ATP World Tour Masters 1000,HARD,2,Gael Monfils,Marat Safin,Gael Monfils,6-2; 3-6; 6-2,R64,109,10,1,48,73,36,48,14,25,0,2,12,50,73,7,5,49,96,33,49,20,47,8,13,13,53,96
2009-08-10 00:00:00.000,ATP World Tour Masters 1000 Canada MontrTal; Canada ATP World Tour Masters 1000,HARD,2,Fernando Gonzalez,Milos Raonic,Fernando Gonzalez,4-6; 7-6(6); 6-4,R64,136,10,4,71,109,51,71,22,38,4,5,16,73,109,20,3,64,110,55,64,21,46,6,7,16,76,110
2009-08-10 00:00:00.000,ATP World Tour Masters 1000 Canada MontrTal; Canada ATP World Tour Masters 1000,HARD,2,Tommy Haas,Ivo Karlovic,Tommy Haas,4-6; 7-6(3); 6-4,R64,121,7,6,63,92,50,63,20,29,3,4,16,70,92,19,4,45,91,41,45,25,46,2,3,16,66,91
2009-08-10 00:00:00.000,ATP World Tour Masters 1000 Canada MontrTal; Canada ATP World Tour Masters 1000,HARD,2,Paul-Henri Mathieu,Guillermo Garcia-Lopez,Paul-Henri Mathieu,7-5; 0-6; 6-1,R64,115,9,5,36,81,28,36,23,45,4,7,13,51,81,5,2,42,65,28,42,14,23,0,3,12,42,65
2009-08-10 00:00:00.000,ATP World Tour Masters 1000 Canada MontrTal; Canada ATP World Tour Masters 1000,HARD,2,Nikolay Davydenko,N/A Bye,Nikolay Davydenko,,R64,0,0,0,0,0,0,0,0,0,0,0,0,0,0,0,0,0,0,0,0,0,0,0,0,0,0,0
2009-08-10 00:00:00.000,ATP World Tour Masters 1000 Canada MontrTal; Canada ATP World Tour Masters 1000,HARD,2,Andy Roddick,N/A Bye,Andy Roddick,,R64,0,0,0,0,0,0,0,0,0,0,0,0,0,0,0,0,0,0,0,0,0,0,0,0,0,0,0
2009-08-10 00:00:00.000,ATP World Tour Masters 1000 Canada MontrTal; Canada ATP World Tour Masters 1000,HARD,2,Igor Andreev,Dmitry Tursunov,Igor Andreev,5-5 RET,R64,37,4,1,15,24,12,15,6,9,1,2,5,18,24,4,2,12,30,10,12,8,18,0,1,5,18,30
2009-08-10 00:00:00.000,ATP World Tour Masters 1000 Canada MontrTal; Canada ATP World Tour Masters 1000,HARD,2,Leonardo Mayer,Mischa Zverev,Leonardo Mayer,7-6(6); 6-3,R64,105,6,1,49,79,38,49,13,30,3,4,10,51,79,6,0,64,84,40,64,7,20,6,9,11,47,84
2009-08-10 00:00:00.000,ATP World Tour Masters 1000 Canada MontrTal; Canada ATP World Tour Masters 1000,HARD,2,Fernando Verdasco,Feliciano Lopez,Fernando Verdasco,6-1; 6-7(5); 6-1,R64,109,14,8,61,83,48,61,11,22,2,3,14,59,83,12,2,60,88,42,60,8,28,5,10,12,50,88
2009-08-10 00:00:00.000,ATP World Tour Masters 1000 Canada MontrTal; Canada ATP World Tour Masters 1000,HARD,2,Mikhail Youzhny,Marin Cilic,Mikhail Youzhny,4-6; 7-6(4); 6-1,R64,147,4,10,60,107,43,60,24,47,5,9,15,67,107,6,5,46,92,28,46,22,46,2,7,14,50,92
2009-08-10 00:00:00.000,ATP World Tour Masters 1000 Canada MontrTal; Canada ATP World Tour Masters 1000,HARD,2,John Isner,Jesse Levine,John Isner,6-3; 6-4,R64,71,10,1,36,58,26,36,17,22,3,3,10,43,58,5,6,36,54,29,36,6,18,5,7,9,35,54
2009-08-10 00:00:00.000,ATP World Tour Masters 1000 Canada MontrTal; Canada ATP World Tour Masters 1000,HARD,2,Peter Polansky,Bruno Agostinelli,Peter Polansky,6-3; 7-6(6),R64,105,5,2,44,75,33,44,19,31,4,5,11,52,75,4,3,42,69,30,42,13,27,8,10,10,43,69
2009-08-10 00:00:00.000,ATP World Tour Masters 1000 Canada MontrTal; Canada ATP World Tour Masters 1000,HARD,2,Novak Djokovic,N/A Bye,Novak Djokovic,,R64,0,0,0,0,0,0,0,0,0,0,0,0,0,0,0,0,0,0,0,0,0,0,0,0,0,0,0
2009-08-10 00:00:00.000,ATP World Tour Masters 1000 Canada MontrTal; Canada ATP World Tour Masters 1000,HARD,2,Juan Martin Del Potro,N/A Bye,Juan Martin Del Potro,,R64,0,0,0,0,0,0,0,0,0,0,0,0,0,0,0,0,0,0,0,0,0,0,0,0,0,0,0
2009-08-10 00:00:00.000,ATP World Tour Masters 1000 Canada MontrTal; Canada ATP World Tour Masters 1000,HARD,2,Jan Hernych,Julien Benneteau,Jan Hernych,6-2; 6-3,R64,60,3,0,39,44,31,39,3,5,1,1,8,34,44,1,2,36,52,25,36,4,16,5,9,9,29,52
2009-08-10 00:00:00.000,ATP World Tour Masters 1000 Canada MontrTal; Canada ATP World Tour Masters 1000,HARD,2,Victor Hanescu,Jurgen Melzer,Victor Hanescu,6-4; 6-3,R64,85,5,1,55,69,38,55,7,14,5,6,10,45,69,7,1,39,65,28,39,10,26,10,13,9,38,65
2009-08-10 00:00:00.000,ATP World Tour Masters 1000 Canada MontrTal; Canada ATP World Tour Masters 1000,HARD,2,Philipp Kohlschreiber,Tomas Berdych,Philipp Kohlschreiber,7-6(5); 6-7(9); 6-4,R64,176,9,3,57,111,44,57,32,54,2,4,17,76,111,9,5,71,140,47,71,41,69,8,11,17,88,140
2009-08-10 00:00:00.000,ATP World Tour Masters 1000 Canada MontrTal; Canada ATP World Tour Masters 1000,HARD,2,Tommy Robredo,Alex Bogomolov Jr.,Tommy Robredo,6-4; 6-2,R64,75,6,0,29,45,26,29,11,16,0,0,9,37,45,1,1,40,62,24,40,12,22,1,4,9,36,62
2009-08-10 00:00:00.000,ATP World Tour Masters 1000 Canada MontrTal; Canada ATP World Tour Masters 1000,HARD,2,Philipp Petzschner,Sam Querrey,Philipp Petzschner,7-5; 6-3,R64,66,11,0,33,51,29,33,13,18,0,0,10,42,51,9,2,43,70,28,43,12,27,0,3,11,40,70
2009-08-10 00:00:00.000,ATP World Tour Masters 1000 Canada MontrTal; Canada ATP World Tour Masters 1000,HARD,2,David Ferrer,Viktor Troicki,David Ferrer,6-3; 6-0,R64,70,4,1,35,53,25,35,10,18,6,7,8,35,53,4,2,29,59,16,29,10,30,6,11,7,26,59
2009-08-10 00:00:00.000,ATP World Tour Masters 1000 Canada MontrTal; Canada ATP World Tour Masters 1000,HARD,2,Rafael Nadal,N/A Bye,Rafael Nadal,,R64,0,0,0,0,0,0,0,0,0,0,0,0,0,0,0,0,0,0,0,0,0,0,0,0,0,0,0
2009-08-10 00:00:00.000,ATP World Tour Masters 1000 Canada MontrTal; Canada ATP World Tour Masters 1000,HARD,2,Roger Federer,Frederic Niemeyer,Roger Federer,7-6(3); 6-4,R32,86,12,1,46,65,40,46,11,19,1,1,11,51,65,6,5,34,72,28,34,21,38,5,6,11,49,72
2009-08-10 00:00:00.000,ATP World Tour Masters 1000 Canada MontrTal; Canada ATP World Tour Masters 1000,HARD,2,Stanislas Wawrinka,Andrey Golubev,Stanislas Wawrinka,7-5; 6-4,R32,88,2,2,30,58,25,30,21,28,1,1,11,46,58,4,4,42,77,33,42,15,35,7,9,11,48,77
2009-08-10 00:00:00.000,ATP World Tour Masters 1000 Canada MontrTal; Canada ATP World Tour Masters 1000,HARD,2,Gilles Simon,Alejandro Falla,Gilles Simon,4-6; 6-2; 6-2,R32,126,1,3,37,75,32,37,21,38,1,2,13,53,75,0,4,63,96,42,63,14,33,7,11,13,56,96
2009-08-10 00:00:00.000,ATP World Tour Masters 1000 Canada MontrTal; Canada ATP World Tour Masters 1000,HARD,2,Jo-Wilfried Tsonga,Rainer Schuettler,Jo-Wilfried Tsonga,4-6; 6-3; 6-4,R32,128,10,1,59,86,50,59,12,27,3,4,15,62,86,4,6,55,95,41,55,20,40,10,12,14,61,95
2009-08-10 00:00:00.000,ATP World Tour Masters 1000 Canada MontrTal; Canada ATP World Tour Masters 1000,HARD,2,Andy Murray,Jeremy Chardy,Andy Murray,6-4; 6-2,R32,95,9,2,47,72,36,47,11,25,10,10,9,47,72,9,1,50,68,32,50,6,18,5,8,9,38,68
2009-08-10 00:00:00.000,ATP World Tour Masters 1000 Canada MontrTal; Canada ATP World Tour Masters 1000,HARD,2,Juan Carlos Ferrero,Gael Monfils,Juan Carlos Ferrero,6-3; 7-6(7),R32,105,2,2,54,76,38,54,16,22,6,7,11,54,76,11,1,41,66,30,41,10,25,0,2,10,40,66
2009-08-10 00:00:00.000,ATP World Tour Masters 1000 Canada MontrTal; Canada ATP World Tour Masters 1000,HARD,2,Fernando Gonzalez,Tommy Haas,Fernando Gonzalez,7-6(2) RET,R32,66,1,1,30,36,21,30,4,6,0,1,6,25,36,0,4,33,55,22,33,9,22,3,4,6,31,55
2009-08-10 00:00:00.000,ATP World Tour Masters 1000 Canada MontrTal; Canada ATP World Tour Masters 1000,HARD,2,Nikolay Davydenko,Paul-Henri Mathieu,Nikolay Davydenko,7-6(4); 7-6(2),R32,125,5,3,50,79,40,50,18,29,0,1,12,58,79,4,2,46,84,36,46,20,38,3,4,12,56,84
2009-08-10 00:00:00.000,ATP World Tour Masters 1000 Canada MontrTal; Canada ATP World Tour Masters 1000,HARD,2,Andy Roddick,Igor Andreev,Andy Roddick,6-1; 7-6(3),R32,82,8,0,37,57,31,37,14,20,0,0,10,45,57,2,2,30,57,23,30,13,27,3,5,9,36,57
2009-08-10 00:00:00.000,ATP World Tour Masters 1000 Canada MontrTal; Canada ATP World Tour Masters 1000,HARD,2,Fernando Verdasco,Leonardo Mayer,Fernando Verdasco,6-1; 6-1,R32,58,1,1,24,34,19,24,8,10,3,4,7,27,34,1,3,25,47,12,25,5,22,4,10,7,17,47
2009-08-10 00:00:00.000,ATP World Tour Masters 1000 Canada MontrTal; Canada ATP World Tour Masters 1000,HARD,2,Mikhail Youzhny,John Isner,Mikhail Youzhny,6-7(8); 6-1; 6-3,R32,155,4,5,73,111,49,73,24,38,5,6,14,73,111,9,6,75,110,46,75,17,35,6,11,14,63,110
2009-08-10 00:00:00.000,ATP World Tour Masters 1000 Canada MontrTal; Canada ATP World Tour Masters 1000,HARD,2,Novak Djokovic,Peter Polansky,Novak Djokovic,6-4; 7-6(6),R32,119,8,7,47,76,39,47,12,29,4,5,11,51,76,7,3,42,83,30,42,19,41,8,10,11,49,83
2009-08-10 00:00:00.000,ATP World Tour Masters 1000 Canada MontrTal; Canada ATP World Tour Masters 1000,HARD,2,Juan Martin Del Potro,Jan Hernych,Juan Martin Del Potro,6-2; 7-5,R32,88,10,2,35,58,28,35,13,23,2,3,10,41,58,4,1,43,73,28,43,10,30,5,9,10,38,73
2009-08-10 00:00:00.000,ATP World Tour Masters 1000 Canada MontrTal; Canada ATP World Tour Masters 1000,HARD,2,Victor Hanescu,Philipp Kohlschreiber,Victor Hanescu,6-3; 4-6; 7-5,R32,126,6,3,66,104,49,66,15,38,5,8,16,64,104,7,2,68,98,46,68,11,30,13,17,15,57,98
2009-08-10 00:00:00.000,ATP World Tour Masters 1000 Canada MontrTal; Canada ATP World Tour Masters 1000,HARD,2,Philipp Petzschner,Tommy Robredo,Philipp Petzschner,7-6(3); 7-6(4),R32,120,11,2,45,90,35,45,22,45,4,6,12,57,90,1,1,36,71,25,36,20,35,0,2,12,45,71
2009-08-10 00:00:00.000,ATP World Tour Masters 1000 Canada MontrTal; Canada ATP World Tour Masters 1000,HARD,2,Rafael Nadal,David Ferrer,Rafael Nadal,4-3 RET,R32,37,0,1,16,34,10,16,9,18,7,8,3,19,34,2,2,14,21,10,14,1,7,1,3,4,11,21
2009-08-10 00:00:00.000,ATP World Tour Masters 1000 Canada MontrTal; Canada ATP World Tour Masters 1000,HARD,2,Roger Federer,Stanislas Wawrinka,Roger Federer,6-3; 7-6(5),R16,106,4,0,49,75,35,49,16,26,6,7,11,51,75,11,2,46,77,32,46,15,31,6,8,10,47,77
2009-08-10 00:00:00.000,ATP World Tour Masters 1000 Canada MontrTal; Canada ATP World Tour Masters 1000,HARD,2,Jo-Wilfried Tsonga,Gilles Simon,Jo-Wilfried Tsonga,6-3; 6-3,R16,82,9,2,54,70,42,54,5,16,7,7,9,47,70,2,2,26,61,13,26,22,35,2,5,9,35,61
2009-08-10 00:00:00.000,ATP World Tour Masters 1000 Canada MontrTal; Canada ATP World Tour Masters 1000,HARD,2,Andy Murray,Juan Carlos Ferrero,Andy Murray,6-1; 6-3,R16,78,9,2,21,42,19,21,13,21,0,0,8,32,42,3,2,50,71,28,50,8,21,10,14,8,36,71
2009-08-10 00:00:00.000,ATP World Tour Masters 1000 Canada MontrTal; Canada ATP World Tour Masters 1000,HARD,2,Nikolay Davydenko,Fernando Gonzalez,Nikolay Davydenko,7-6(2); 7-5,R16,90,6,1,51,70,40,51,15,19,2,2,12,55,70,6,1,42,73,34,42,16,31,2,3,12,50,73
2009-08-10 00:00:00.000,ATP World Tour Masters 1000 Canada MontrTal; Canada ATP World Tour Masters 1000,HARD,2,Andy Roddick,Fernando Verdasco,Andy Roddick,7-6(2); 4-6; 7-6(5),R16,157,12,0,71,105,56,71,21,34,4,6,17,77,105,13,2,75,110,58,75,21,35,5,6,17,79,110
2009-08-10 00:00:00.000,ATP World Tour Masters 1000 Canada MontrTal; Canada ATP World Tour Masters 1000,HARD,2,Novak Djokovic,Mikhail Youzhny,Novak Djokovic,6-3; 6-4,R16,83,3,4,42,62,31,42,12,20,4,5,10,43,62,1,3,26,46,18,26,11,20,3,6,9,29,46
2009-08-10 00:00:00.000,ATP World Tour Masters 1000 Canada MontrTal; Canada ATP World Tour Masters 1000,HARD,2,Juan Martin Del Potro,Victor Hanescu,Juan Martin Del Potro,3-6; 6-3; 6-4,R16,122,9,5,39,74,33,39,18,35,3,6,14,51,74,5,1,49,81,32,49,19,32,1,5,14,51,81
2009-08-10 00:00:00.000,ATP World Tour Masters 1000 Canada MontrTal; Canada ATP World Tour Masters 1000,HARD,2,Rafael Nadal,Philipp Petzschner,Rafael Nadal,6-3; 6-2,R16,70,2,4,33,54,27,33,13,21,2,2,9,40,54,5,1,27,45,16,27,7,18,2,5,8,23,45
2009-08-10 00:00:00.000,ATP World Tour Masters 1000 Canada MontrTal; Canada ATP World Tour Masters 1000,HARD,2,Jo-Wilfried Tsonga,Roger Federer,Jo-Wilfried Tsonga,7-6(5); 1-6; 7-6(3),Q,139,11,6,50,96,39,50,25,46,6,10,15,64,96,9,2,58,101,45,58,26,43,3,5,16,71,101
2009-08-10 00:00:00.000,ATP World Tour Masters 1000 Canada MontrTal; Canada ATP World Tour Masters 1000,HARD,2,Andy Murray,Nikolay Davydenko,Andy Murray,6-2; 6-4,Q,82,9,2,28,56,21,28,16,28,2,3,9,37,56,0,2,34,55,19,34,9,21,0,4,9,28,55
2009-08-10 00:00:00.000,ATP World Tour Masters 1000 Canada MontrTal; Canada ATP World Tour Masters 1000,HARD,2,Andy Roddick,Novak Djokovic,Andy Roddick,6-4; 7-6(4),Q,103,4,1,45,68,36,45,13,23,1,2,11,49,68,10,6,43,78,33,43,16,35,1,3,11,49,78
2009-08-10 00:00:00.000,ATP World Tour Masters 1000 Canada MontrTal; Canada ATP World Tour Masters 1000,HARD,2,Juan Martin Del Potro,Rafael Nadal,Juan Martin Del Potro,7-6(5); 6-1,Q,112,8,0,46,61,35,46,7,15,1,1,9,42,61,1,1,43,67,27,43,11,24,5,8,10,38,67
2009-08-10 00:00:00.000,ATP World Tour Masters 1000 Canada MontrTal; Canada ATP World Tour Masters 1000,HARD,2,Andy Murray,Jo-Wilfried Tsonga,Andy Murray,6-4; 7-6(8),S,110,4,2,30,71,22,30,28,41,5,6,11,50,71,4,2,47,77,34,47,16,30,3,5,11,50,77
2009-08-10 00:00:00.000,ATP World Tour Masters 1000 Canada MontrTal; Canada ATP World Tour Masters 1000,HARD,2,Juan Martin Del Potro,Andy Roddick,Juan Martin Del Potro,4-6; 6-2; 7-5,S,127,19,2,60,87,47,60,15,27,5,6,15,62,87,11,2,60,85,46,60,9,25,4,7,15,55,85
2009-08-10 00:00:00.000,ATP World Tour Masters 1000 Canada MontrTal; Canada ATP World Tour Masters 1000,HARD,2,Andy Murray,Juan Martin Del Potro,Andy Murray,6-7(4); 7-6(3); 6-1,F,165,16,1,46,89,39,46,29,43,1,3,16,68,89,11,5,69,121,46,69,25,52,6,10,15,71,121
2009-08-16 00:00:00.000,ATP World Tour Masters 1000 Cincinnati OH; U.S.A. ATP World Tour Masters 1000,HARD,2,Roger Federer,N/A Bye,Roger Federer,,R64,0,0,0,0,0,0,0,0,0,0,0,0,0,0,0,0,0,0,0,0,0,0,0,0,0,0,0
2009-08-16 00:00:00.000,ATP World Tour Masters 1000 Cincinnati OH; U.S.A. ATP World Tour Masters 1000,HARD,2,Jose Acasuso,Lukasz Kubot,Jose Acasuso,6-4; 6-3,R64,93,7,2,35,57,26,35,12,22,0,2,10,38,57,3,4,36,63,21,36,12,27,4,8,9,33,63
2009-08-16 00:00:00.000,ATP World Tour Masters 1000 Cincinnati OH; U.S.A. ATP World Tour Masters 1000,HARD,2,David Ferrer,Stanislas Wawrinka,David Ferrer,7-5; 6-2,R64,100,1,1,33,60,27,33,16,27,3,4,10,43,60,2,3,34,72,22,34,16,38,7,11,10,38,72
2009-08-16 00:00:00.000,ATP World Tour Masters 1000 Cincinnati OH; U.S.A. ATP World Tour Masters 1000,HARD,2,Marin Cilic,Juan Carlos Ferrero,Marin Cilic,6-3; 6-4,R64,72,5,4,29,59,25,29,16,30,2,3,10,41,59,1,3,38,56,22,38,11,18,5,8,9,33,56
2009-08-16 00:00:00.000,ATP World Tour Masters 1000 Cincinnati OH; U.S.A. ATP World Tour Masters 1000,HARD,2,Lleyton Hewitt,Robin Soderling,Lleyton Hewitt,3-6; 7-6(8); 6-4,R64,130,8,2,52,97,41,52,27,45,3,4,15,68,97,19,7,59,102,51,59,20,43,1,2,16,71,102
2009-08-16 00:00:00.000,ATP World Tour Masters 1000 Cincinnati OH; U.S.A. ATP World Tour Masters 1000,HARD,2,Benjamin Becker,Martin Vassallo Arguello,Benjamin Becker,6-3; 6-3,R64,66,4,2,29,42,27,29,9,13,0,0,9,36,42,3,5,39,61,25,39,10,22,6,9,9,35,61
2009-08-16 00:00:00.000,ATP World Tour Masters 1000 Cincinnati OH; U.S.A. ATP World Tour Masters 1000,HARD,2,Sam Querrey,Yen-Hsun Lu,Sam Querrey,6-3; 6-4,R64,66,9,2,37,53,29,37,9,16,1,2,10,38,53,2,1,36,55,21,36,11,19,5,8,9,32,55
2009-08-16 00:00:00.000,ATP World Tour Masters 1000 Cincinnati OH; U.S.A. ATP World Tour Masters 1000,HARD,2,Andy Roddick,N/A Bye,Andy Roddick,,R64,0,0,0,0,0,0,0,0,0,0,0,0,0,0,0,0,0,0,0,0,0,0,0,0,0,0,0
2009-08-16 00:00:00.000,ATP World Tour Masters 1000 Cincinnati OH; U.S.A. ATP World Tour Masters 1000,HARD,2,Andy Murray,N/A Bye,Andy Murray,,R64,0,0,0,0,0,0,0,0,0,0,0,0,0,0,0,0,0,0,0,0,0,0,0,0,0,0,0
2009-08-16 00:00:00.000,ATP World Tour Masters 1000 Cincinnati OH; U.S.A. ATP World Tour Masters 1000,HARD,2,Nicolas Almagro,Dudi Sela,Nicolas Almagro,6-4; 1-0 RET,R64,40,7,0,13,23,12,13,8,10,0,0,5,20,23,2,2,14,36,9,14,10,22,0,2,6,19,36
2009-08-16 00:00:00.000,ATP World Tour Masters 1000 Cincinnati OH; U.S.A. ATP World Tour Masters 1000,HARD,2,Marat Safin,Robby Ginepri,Marat Safin,7-5; 7-6(2),R64,86,13,4,36,65,28,36,22,29,2,3,12,50,65,2,2,50,78,34,50,15,28,4,6,12,49,78
2009-08-16 00:00:00.000,ATP World Tour Masters 1000 Cincinnati OH; U.S.A. ATP World Tour Masters 1000,HARD,2,Radek Stepanek,Viktor Troicki,Radek Stepanek,7-6(2); 1-0 RET,R64,55,5,1,21,32,18,21,7,11,0,1,6,25,32,1,2,26,44,13,26,11,18,1,3,7,24,44
2009-08-16 00:00:00.000,ATP World Tour Masters 1000 Cincinnati OH; U.S.A. ATP World Tour Masters 1000,HARD,2,Guillermo Garcia-Lopez,Fernando Verdasco,Guillermo Garcia-Lopez,7-6(4); 7-6(4),R64,105,5,3,45,73,37,45,17,28,3,4,12,54,73,11,2,45,70,37,45,13,25,2,3,12,50,70
2009-08-16 00:00:00.000,ATP World Tour Masters 1000 Cincinnati OH; U.S.A. ATP World Tour Masters 1000,HARD,2,Mikhail Youzhny,Victor Hanescu,Mikhail Youzhny,7-5; 6-2,R64,96,4,3,41,65,32,41,15,24,4,4,10,47,65,3,3,45,68,27,45,11,23,5,8,10,38,68
2009-08-16 00:00:00.000,ATP World Tour Masters 1000 Cincinnati OH; U.S.A. ATP World Tour Masters 1000,HARD,2,Jurgen Melzer,Feliciano Lopez,Jurgen Melzer,5-7; 7-6(4); 7-6(7),R64,168,10,2,91,128,70,91,21,37,5,6,18,91,128,16,2,67,121,56,67,31,54,6,6,18,87,121
2009-08-16 00:00:00.000,ATP World Tour Masters 1000 Cincinnati OH; U.S.A. ATP World Tour Masters 1000,HARD,2,Julien Benneteau,N/A Bye,Julien Benneteau,,R64,0,0,0,0,0,0,0,0,0,0,0,0,0,0,0,0,0,0,0,0,0,0,0,0,0,0,0
2009-08-16 00:00:00.000,ATP World Tour Masters 1000 Cincinnati OH; U.S.A. ATP World Tour Masters 1000,HARD,2,Nikolay Davydenko,N/A Bye,Nikolay Davydenko,,R64,0,0,0,0,0,0,0,0,0,0,0,0,0,0,0,0,0,0,0,0,0,0,0,0,0,0,0
2009-08-16 00:00:00.000,ATP World Tour Masters 1000 Cincinnati OH; U.S.A. ATP World Tour Masters 1000,HARD,2,Igor Kunitsyn,James Blake,Igor Kunitsyn,7-6(5); 6-7(5); 6-4,R64,157,9,3,88,126,61,88,21,38,7,10,17,82,126,13,6,62,127,48,62,29,65,8,12,17,77,127
2009-08-16 00:00:00.000,ATP World Tour Masters 1000 Cincinnati OH; U.S.A. ATP World Tour Masters 1000,HARD,2,Igor Andreev,Nicolas Kiefer,Igor Andreev,6-1; 7-5,R64,70,6,1,29,51,25,29,13,22,2,2,9,38,51,4,3,28,50,23,28,8,22,1,5,10,31,50
2009-08-16 00:00:00.000,ATP World Tour Masters 1000 Cincinnati OH; U.S.A. ATP World Tour Masters 1000,HARD,2,Gilles Simon,Wayne Odesnik,Gilles Simon,6-3; 6-2,R64,80,8,1,37,59,31,37,10,22,6,6,9,41,59,3,5,25,52,17,25,13,27,1,4,8,30,52
2009-08-16 00:00:00.000,ATP World Tour Masters 1000 Cincinnati OH; U.S.A. ATP World Tour Masters 1000,HARD,2,Jeremy Chardy,Tommy Robredo,Jeremy Chardy,6-3; 7-5,R64,72,18,0,36,61,28,36,17,25,1,1,11,45,61,7,1,30,49,23,30,13,19,2,4,10,36,49
2009-08-16 00:00:00.000,ATP World Tour Masters 1000 Cincinnati OH; U.S.A. ATP World Tour Masters 1000,HARD,2,John Isner,Tommy Haas,John Isner,7-6(5); 5-7; 7-6(3),R64,154,23,4,67,111,56,67,27,44,5,6,18,83,111,16,4,64,105,56,64,26,41,2,2,18,82,105
2009-08-16 00:00:00.000,ATP World Tour Masters 1000 Cincinnati OH; U.S.A. ATP World Tour Masters 1000,HARD,2,Ivan Ljubicic,Florent Serra,Ivan Ljubicic,4-6; 6-3; 6-4,R64,107,19,2,58,82,44,58,17,24,3,4,15,61,82,4,1,49,73,34,49,17,24,0,2,14,51,73
2009-08-16 00:00:00.000,ATP World Tour Masters 1000 Cincinnati OH; U.S.A. ATP World Tour Masters 1000,HARD,2,Novak Djokovic,N/A Bye,Novak Djokovic,,R64,0,0,0,0,0,0,0,0,0,0,0,0,0,0,0,0,0,0,0,0,0,0,0,0,0,0,0
2009-08-16 00:00:00.000,ATP World Tour Masters 1000 Cincinnati OH; U.S.A. ATP World Tour Masters 1000,HARD,2,Jo-Wilfried Tsonga,N/A Bye,Jo-Wilfried Tsonga,,R64,0,0,0,0,0,0,0,0,0,0,0,0,0,0,0,0,0,0,0,0,0,0,0,0,0,0,0
2009-08-16 00:00:00.000,ATP World Tour Masters 1000 Cincinnati OH; U.S.A. ATP World Tour Masters 1000,HARD,2,Chris Guccione,Philipp Kohlschreiber,Chris Guccione,7-5; 2-6; 6-3,R64,91,19,5,50,85,43,50,16,35,3,5,15,59,85,7,2,43,77,32,43,22,34,2,4,14,54,77
2009-08-16 00:00:00.000,ATP World Tour Masters 1000 Cincinnati OH; U.S.A. ATP World Tour Masters 1000,HARD,2,Philipp Petzschner,Simone Bolelli,Philipp Petzschner,7-6(6); 6-3,R64,90,7,1,39,68,35,39,16,29,1,1,11,51,68,3,0,39,64,31,39,14,25,2,3,10,45,64
2009-08-16 00:00:00.000,ATP World Tour Masters 1000 Cincinnati OH; U.S.A. ATP World Tour Masters 1000,HARD,2,Tomas Berdych,Fernando Gonzalez,Tomas Berdych,6-4 RET,R64,41,5,0,22,36,19,22,6,14,4,4,5,25,36,4,3,21,34,15,21,6,13,4,5,5,21,34
2009-08-16 00:00:00.000,ATP World Tour Masters 1000 Cincinnati OH; U.S.A. ATP World Tour Masters 1000,HARD,2,Ivo Karlovic,Gael Monfils,Ivo Karlovic,6-4; 6-7(5); 7-6(2),R64,131,21,4,74,106,64,74,18,32,5,5,17,82,106,8,1,74,111,57,74,23,37,5,6,17,80,111
2009-08-16 00:00:00.000,ATP World Tour Masters 1000 Cincinnati OH; U.S.A. ATP World Tour Masters 1000,HARD,2,Paul-Henri Mathieu,Mischa Zverev,Paul-Henri Mathieu,6-7(4); 7-5; 6-3,R64,146,7,7,51,88,40,51,19,37,2,5,16,59,88,9,9,67,111,43,67,20,44,12,18,17,63,111
2009-08-16 00:00:00.000,ATP World Tour Masters 1000 Cincinnati OH; U.S.A. ATP World Tour Masters 1000,HARD,2,Andreas Seppi,Jan Hernych,Andreas Seppi,3-6; 6-4; 6-1,R64,117,7,2,52,77,34,52,14,25,5,9,13,48,77,5,2,61,101,39,61,14,40,8,14,13,53,101
2009-08-16 00:00:00.000,ATP World Tour Masters 1000 Cincinnati OH; U.S.A. ATP World Tour Masters 1000,HARD,2,Rafael Nadal,N/A Bye,Rafael Nadal,,R64,0,0,0,0,0,0,0,0,0,0,0,0,0,0,0,0,0,0,0,0,0,0,0,0,0,0,0
2009-08-16 00:00:00.000,ATP World Tour Masters 1000 Cincinnati OH; U.S.A. ATP World Tour Masters 1000,HARD,2,Roger Federer,Jose Acasuso,Roger Federer,6-3; 7-5,R32,70,14,2,40,58,35,40,11,18,1,1,11,46,58,11,3,30,60,23,30,15,30,4,6,10,38,60
2009-08-16 00:00:00.000,ATP World Tour Masters 1000 Cincinnati OH; U.S.A. ATP World Tour Masters 1000,HARD,2,David Ferrer,Marin Cilic,David Ferrer,7-6(4); 6-2,R32,92,1,0,42,60,31,42,15,18,2,2,10,46,60,3,2,47,72,31,47,12,25,3,5,10,43,72
2009-08-16 00:00:00.000,ATP World Tour Masters 1000 Cincinnati OH; U.S.A. ATP World Tour Masters 1000,HARD,2,Lleyton Hewitt,Benjamin Becker,Lleyton Hewitt,6-3; 6-3,R32,68,11,1,28,44,26,28,10,16,0,0,9,36,44,8,2,30,60,21,30,11,30,5,8,9,32,60
2009-08-16 00:00:00.000,ATP World Tour Masters 1000 Cincinnati OH; U.S.A. ATP World Tour Masters 1000,HARD,2,Sam Querrey,Andy Roddick,Sam Querrey,7-6(11); 7-6(3),R32,118,16,4,46,90,37,46,26,44,2,3,12,63,90,10,0,57,87,43,57,16,30,2,3,12,59,87
2009-08-16 00:00:00.000,ATP World Tour Masters 1000 Cincinnati OH; U.S.A. ATP World Tour Masters 1000,HARD,2,Andy Murray,Nicolas Almagro,Andy Murray,7-6(3); 6-2,R32,85,9,1,26,53,26,26,20,27,1,1,10,46,53,5,2,42,74,32,42,15,32,5,7,10,47,74
2009-08-16 00:00:00.000,ATP World Tour Masters 1000 Cincinnati OH; U.S.A. ATP World Tour Masters 1000,HARD,2,Radek Stepanek,Marat Safin,Radek Stepanek,4-6; 6-3; 6-1,R32,114,5,3,37,71,31,37,20,34,0,1,13,51,71,10,8,52,91,35,52,18,39,11,15,13,53,91
2009-08-16 00:00:00.000,ATP World Tour Masters 1000 Cincinnati OH; U.S.A. ATP World Tour Masters 1000,HARD,2,Guillermo Garcia-Lopez,Mikhail Youzhny,Guillermo Garcia-Lopez,7-5; 6-3,R32,103,3,4,31,60,25,31,17,29,2,4,11,42,60,5,3,45,76,29,45,12,31,14,18,10,41,76
2009-08-16 00:00:00.000,ATP World Tour Masters 1000 Cincinnati OH; U.S.A. ATP World Tour Masters 1000,HARD,2,Julien Benneteau,Jurgen Melzer,Julien Benneteau,6-2; 3-6; 6-2,R32,99,6,1,43,73,32,43,17,30,1,3,13,49,73,7,3,49,78,34,49,13,29,7,11,12,47,78
2009-08-16 00:00:00.000,ATP World Tour Masters 1000 Cincinnati OH; U.S.A. ATP World Tour Masters 1000,HARD,2,Nikolay Davydenko,Igor Kunitsyn,Nikolay Davydenko,6-2; 1-6; 6-3,R32,109,5,4,39,67,27,39,15,28,4,7,12,42,67,0,2,64,87,37,64,12,23,11,15,12,49,87
2009-08-16 00:00:00.000,ATP World Tour Masters 1000 Cincinnati OH; U.S.A. ATP World Tour Masters 1000,HARD,2,Gilles Simon,Igor Andreev,Gilles Simon,7-6(5); 6-7(6); 6-1,R32,141,8,4,61,110,48,61,32,49,8,8,16,80,110,10,1,58,100,45,58,25,42,1,3,15,70,100
2009-08-16 00:00:00.000,ATP World Tour Masters 1000 Cincinnati OH; U.S.A. ATP World Tour Masters 1000,HARD,2,Jeremy Chardy,John Isner,Jeremy Chardy,6-7(1); 6-3; 4-1 RET,R32,92,17,2,42,64,38,42,17,22,3,3,13,55,64,19,2,65,88,49,65,7,23,4,7,13,56,88
2009-08-16 00:00:00.000,ATP World Tour Masters 1000 Cincinnati OH; U.S.A. ATP World Tour Masters 1000,HARD,2,Novak Djokovic,Ivan Ljubicic,Novak Djokovic,7-6(5); 6-4,R32,100,9,1,36,63,35,36,17,27,1,1,11,52,63,15,0,48,85,35,48,21,37,3,4,11,56,85
2009-08-16 00:00:00.000,ATP World Tour Masters 1000 Cincinnati OH; U.S.A. ATP World Tour Masters 1000,HARD,2,Chris Guccione,Jo-Wilfried Tsonga,Chris Guccione,7-6(12); 6-2,R32,77,20,6,42,71,38,42,18,29,3,3,10,56,71,3,0,47,69,36,47,13,22,0,2,10,49,69
2009-08-16 00:00:00.000,ATP World Tour Masters 1000 Cincinnati OH; U.S.A. ATP World Tour Masters 1000,HARD,2,Tomas Berdych,Philipp Petzschner,Tomas Berdych,7-6(8); 6-7(7); 6-4,R32,160,14,3,63,108,52,63,27,45,2,4,17,79,108,9,3,66,117,49,66,27,51,5,8,17,76,117
2009-08-16 00:00:00.000,ATP World Tour Masters 1000 Cincinnati OH; U.S.A. ATP World Tour Masters 1000,HARD,2,Paul-Henri Mathieu,Ivo Karlovic,Paul-Henri Mathieu,7-6(9); 6-4,R32,98,8,0,54,76,48,54,10,22,1,1,11,58,76,23,1,47,66,41,47,11,19,0,1,11,52,66
2009-08-16 00:00:00.000,ATP World Tour Masters 1000 Cincinnati OH; U.S.A. ATP World Tour Masters 1000,HARD,2,Rafael Nadal,Andreas Seppi,Rafael Nadal,7-6(4); 7-6(3),R32,131,8,2,60,88,45,60,14,28,9,10,12,59,88,4,4,53,84,36,53,19,31,4,5,12,55,84
2009-08-16 00:00:00.000,ATP World Tour Masters 1000 Cincinnati OH; U.S.A. ATP World Tour Masters 1000,HARD,2,Roger Federer,David Ferrer,Roger Federer,3-6; 6-3; 6-4,R16,102,6,2,53,85,40,53,15,32,4,7,14,55,85,3,2,52,76,36,52,14,24,5,9,14,50,76
2009-08-16 00:00:00.000,ATP World Tour Masters 1000 Cincinnati OH; U.S.A. ATP World Tour Masters 1000,HARD,2,Lleyton Hewitt,Sam Querrey,Lleyton Hewitt,6-1; 2-6; 6-3,R16,87,3,4,35,61,28,35,14,26,1,4,12,42,61,13,2,36,71,24,36,14,35,6,11,12,38,71
2009-08-16 00:00:00.000,ATP World Tour Masters 1000 Cincinnati OH; U.S.A. ATP World Tour Masters 1000,HARD,2,Andy Murray,Radek Stepanek,Andy Murray,6-4; 6-1,R16,77,8,1,38,65,29,38,14,27,3,4,9,43,65,3,3,43,60,22,43,7,17,5,9,8,29,60
2009-08-16 00:00:00.000,ATP World Tour Masters 1000 Cincinnati OH; U.S.A. ATP World Tour Masters 1000,HARD,2,Julien Benneteau,Guillermo Garcia-Lopez,Julien Benneteau,4-6; 6-4; 7-6(4),R16,184,6,2,76,110,53,76,15,34,3,7,16,68,110,4,5,68,107,44,68,20,39,5,9,16,64,107
2009-08-16 00:00:00.000,ATP World Tour Masters 1000 Cincinnati OH; U.S.A. ATP World Tour Masters 1000,HARD,2,Gilles Simon,Nikolay Davydenko,Gilles Simon,6-7(6); 6-4; 6-4,R16,142,5,3,62,115,46,62,31,53,8,9,16,77,115,5,6,65,99,49,65,19,34,3,6,16,68,99
2009-08-16 00:00:00.000,ATP World Tour Masters 1000 Cincinnati OH; U.S.A. ATP World Tour Masters 1000,HARD,2,Novak Djokovic,Jeremy Chardy,Novak Djokovic,7-5; 6-3,R16,93,7,4,36,62,27,36,14,26,3,5,11,41,62,5,7,31,66,21,31,15,35,6,10,10,36,66
2009-08-16 00:00:00.000,ATP World Tour Masters 1000 Cincinnati OH; U.S.A. ATP World Tour Masters 1000,HARD,2,Tomas Berdych,Chris Guccione,Tomas Berdych,6-4; 6-3,R16,65,4,1,22,46,19,22,19,24,2,2,9,38,46,9,6,31,62,22,31,15,31,3,6,10,37,62
2009-08-16 00:00:00.000,ATP World Tour Masters 1000 Cincinnati OH; U.S.A. ATP World Tour Masters 1000,HARD,2,Rafael Nadal,Paul-Henri Mathieu,Rafael Nadal,7-5; 6-2,R16,116,5,0,41,59,32,41,8,18,1,2,10,40,59,3,3,49,84,33,49,13,35,8,12,10,46,84
2009-08-16 00:00:00.000,ATP World Tour Masters 1000 Cincinnati OH; U.S.A. ATP World Tour Masters 1000,HARD,2,Roger Federer,Lleyton Hewitt,Roger Federer,6-3; 6-4,Q,70,11,1,27,51,24,27,16,24,0,0,10,40,51,2,3,32,65,22,32,16,33,3,5,9,38,65
2009-08-16 00:00:00.000,ATP World Tour Masters 1000 Cincinnati OH; U.S.A. ATP World Tour Masters 1000,HARD,2,Andy Murray,Julien Benneteau,Andy Murray,4-6; 6-3; 6-1,Q,132,7,7,53,88,37,53,16,35,5,8,13,53,88,4,3,58,91,34,58,13,33,7,13,13,47,91
2009-08-16 00:00:00.000,ATP World Tour Masters 1000 Cincinnati OH; U.S.A. ATP World Tour Masters 1000,HARD,2,Novak Djokovic,Gilles Simon,Novak Djokovic,6-4; 7-5,Q,88,8,3,40,64,33,40,12,24,2,3,11,45,64,6,3,37,65,26,37,14,28,6,9,11,40,65
2009-08-16 00:00:00.000,ATP World Tour Masters 1000 Cincinnati OH; U.S.A. ATP World Tour Masters 1000,HARD,2,Rafael Nadal,Tomas Berdych,Rafael Nadal,6-4; 7-5,Q,101,2,1,41,58,35,41,11,17,0,0,11,46,58,3,0,38,68,25,38,19,30,4,6,11,44,68
2009-08-16 00:00:00.000,ATP World Tour Masters 1000 Cincinnati OH; U.S.A. ATP World Tour Masters 1000,HARD,2,Roger Federer,Andy Murray,Roger Federer,6-2; 7-6(8),S,90,4,1,35,62,31,35,16,27,0,0,10,47,62,10,3,36,70,26,36,20,34,4,6,10,46,70
2009-08-16 00:00:00.000,ATP World Tour Masters 1000 Cincinnati OH; U.S.A. ATP World Tour Masters 1000,HARD,2,Novak Djokovic,Rafael Nadal,Novak Djokovic,6-1; 6-4,S,92,5,1,36,55,27,36,11,19,1,1,9,38,55,1,3,35,56,21,35,10,21,3,6,8,31,56
2009-08-16 00:00:00.000,ATP World Tour Masters 1000 Cincinnati OH; U.S.A. ATP World Tour Masters 1000,HARD,2,Roger Federer,Novak Djokovic,Roger Federer,6-1; 7-5,F,127,7,0,33,60,28,33,15,27,3,4,10,43,60,3,1,55,81,33,55,9,26,11,15,9,42,81
2009-08-23 00:00:00.000,New Haven CT; U.S.A. ATP World Tour 250,HARD,2,Nikolay Davydenko,N/A Bye,Nikolay Davydenko,,R64,0,0,0,0,0,0,0,0,0,0,0,0,0,0,0,0,0,0,0,0,0,0,0,0,0,0,0
2009-08-23 00:00:00.000,New Haven CT; U.S.A. ATP World Tour 250,HARD,2,Robert Kendrick,Frederik Nielsen,Robert Kendrick,6-3; 7-5,R64,69,8,4,34,66,25,34,18,32,3,5,11,43,66,4,1,27,60,20,27,14,33,4,8,10,34,60
2009-08-23 00:00:00.000,New Haven CT; U.S.A. ATP World Tour 250,HARD,2,Potito Starace,Mischa Zverev,Potito Starace,6-3; 2-6; 6-3,R64,97,4,1,65,81,42,65,10,16,2,4,13,52,81,7,8,49,84,37,49,15,35,6,9,13,52,84
2009-08-23 00:00:00.000,New Haven CT; U.S.A. ATP World Tour 250,HARD,2,Fabrice Santoro,N/A Bye,Fabrice Santoro,,R64,0,0,0,0,0,0,0,0,0,0,0,0,0,0,0,0,0,0,0,0,0,0,0,0,0,0,0
2009-08-23 00:00:00.000,New Haven CT; U.S.A. ATP World Tour 250,HARD,2,Nicolas Almagro,N/A Bye,Nicolas Almagro,,R64,0,0,0,0,0,0,0,0,0,0,0,0,0,0,0,0,0,0,0,0,0,0,0,0,0,0,0
2009-08-23 00:00:00.000,New Haven CT; U.S.A. ATP World Tour 250,HARD,2,Bjorn Phau,Benjamin Becker,Bjorn Phau,2-6; 6-2; 6-3,R64,96,4,7,49,89,33,49,24,40,3,5,13,57,89,8,1,41,62,31,41,11,21,0,3,12,42,62
2009-08-23 00:00:00.000,New Haven CT; U.S.A. ATP World Tour 250,HARD,2,Marc Gicquel,Martin Vassallo Arguello,Marc Gicquel,6-3; 6-4,R64,93,2,5,33,57,26,33,17,24,3,3,10,43,57,3,0,58,85,36,58,12,27,12,14,9,48,85
2009-08-23 00:00:00.000,New Haven CT; U.S.A. ATP World Tour 250,HARD,2,Sam Querrey,N/A Bye,Sam Querrey,,R64,0,0,0,0,0,0,0,0,0,0,0,0,0,0,0,0,0,0,0,0,0,0,0,0,0,0,0
2009-08-23 00:00:00.000,New Haven CT; U.S.A. ATP World Tour 250,HARD,2,Tommy Robredo,N/A Bye,Tommy Robredo,,R64,0,0,0,0,0,0,0,0,0,0,0,0,0,0,0,0,0,0,0,0,0,0,0,0,0,0,0
2009-08-23 00:00:00.000,New Haven CT; U.S.A. ATP World Tour 250,HARD,2,Jose Acasuso,Maximo Gonzalez,Jose Acasuso,6-1; 6-7(7); 6-2,R64,135,19,1,57,100,45,57,24,43,6,6,13,69,100,2,3,54,95,36,54,21,41,9,14,14,57,95
2009-08-23 00:00:00.000,New Haven CT; U.S.A. ATP World Tour 250,HARD,2,Taylor Dent,Ivan Ljubicic,Taylor Dent,6-3; 6-4,R64,66,8,6,33,56,30,33,13,23,1,1,10,43,56,7,1,30,49,22,30,10,19,3,5,9,32,49
2009-08-23 00:00:00.000,New Haven CT; U.S.A. ATP World Tour 250,HARD,2,Igor Kunitsyn,N/A Bye,Igor Kunitsyn,,R64,0,0,0,0,0,0,0,0,0,0,0,0,0,0,0,0,0,0,0,0,0,0,0,0,0,0,0
2009-08-23 00:00:00.000,New Haven CT; U.S.A. ATP World Tour 250,HARD,2,Jeremy Chardy,N/A Bye,Jeremy Chardy,,R64,0,0,0,0,0,0,0,0,0,0,0,0,0,0,0,0,0,0,0,0,0,0,0,0,0,0,0
2009-08-23 00:00:00.000,New Haven CT; U.S.A. ATP World Tour 250,HARD,2,Florent Serra,Steve Darcis,Florent Serra,6-3; 6-3,R64,82,2,0,30,51,22,30,12,21,0,1,9,34,51,4,5,35,77,25,35,16,42,8,12,9,41,77
2009-08-23 00:00:00.000,New Haven CT; U.S.A. ATP World Tour 250,HARD,2,Rajeev Ram,Nicolas Lapentti,Rajeev Ram,7-5; 1-6; 7-6(3),R64,145,11,3,54,107,42,54,24,53,5,8,15,66,107,4,3,61,94,45,61,17,33,3,5,16,62,94
2009-08-23 00:00:00.000,New Haven CT; U.S.A. ATP World Tour 250,HARD,2,Mardy Fish,N/A Bye,Mardy Fish,,R64,0,0,0,0,0,0,0,0,0,0,0,0,0,0,0,0,0,0,0,0,0,0,0,0,0,0,0
2009-08-23 00:00:00.000,New Haven CT; U.S.A. ATP World Tour 250,HARD,2,Igor Andreev,N/A Bye,Igor Andreev,,R64,0,0,0,0,0,0,0,0,0,0,0,0,0,0,0,0,0,0,0,0,0,0,0,0,0,0,0
2009-08-23 00:00:00.000,New Haven CT; U.S.A. ATP World Tour 250,HARD,2,Kevin Kim,Teymuraz Gabashvili,Kevin Kim,6-4; 5-7; 6-3,R64,147,14,8,62,118,49,62,24,56,9,11,15,73,118,11,8,50,105,38,50,27,55,6,10,16,65,105
2009-08-23 00:00:00.000,New Haven CT; U.S.A. ATP World Tour 250,HARD,2,Frederico Gil,Marcos Baghdatis,Frederico Gil,6-4; 6-3,R64,82,4,2,33,57,26,33,16,24,1,1,10,42,57,2,5,21,55,14,21,20,34,4,6,9,34,55
2009-08-23 00:00:00.000,New Haven CT; U.S.A. ATP World Tour 250,HARD,2,Philipp Petzschner,N/A Bye,Philipp Petzschner,,R64,0,0,0,0,0,0,0,0,0,0,0,0,0,0,0,0,0,0,0,0,0,0,0,0,0,0,0
2009-08-23 00:00:00.000,New Haven CT; U.S.A. ATP World Tour 250,HARD,2,Andreas Beck,N/A Bye,Andreas Beck,,R64,0,0,0,0,0,0,0,0,0,0,0,0,0,0,0,0,0,0,0,0,0,0,0,0,0,0,0
2009-08-23 00:00:00.000,New Haven CT; U.S.A. ATP World Tour 250,HARD,2,Simone Bolelli,Christophe Rochus,Simone Bolelli,6-3; 6-4,R64,77,6,3,38,60,26,38,11,22,3,5,9,37,60,2,7,31,58,20,31,10,27,5,10,10,30,58
2009-08-23 00:00:00.000,New Haven CT; U.S.A. ATP World Tour 250,HARD,2,Leonardo Mayer,Denis Istomin,Leonardo Mayer,6-2; 6-4,R64,73,3,3,29,52,23,29,16,23,1,1,9,39,52,2,2,32,58,22,32,12,26,0,3,9,34,58
2009-08-23 00:00:00.000,New Haven CT; U.S.A. ATP World Tour 250,HARD,2,Olivier Rochus,N/A Bye,Olivier Rochus,,R64,0,0,0,0,0,0,0,0,0,0,0,0,0,0,0,0,0,0,0,0,0,0,0,0,0,0,0
2009-08-23 00:00:00.000,New Haven CT; U.S.A. ATP World Tour 250,HARD,2,Victor Hanescu,N/A Bye,Victor Hanescu,,R64,0,0,0,0,0,0,0,0,0,0,0,0,0,0,0,0,0,0,0,0,0,0,0,0,0,0,0
2009-08-23 00:00:00.000,New Haven CT; U.S.A. ATP World Tour 250,HARD,2,Janko Tipsarevic,Fabio Fognini,Janko Tipsarevic,7-5; 2-0 RET,R64,69,2,3,23,53,17,23,14,30,3,5,7,31,53,2,6,23,43,11,23,8,20,1,5,7,19,43
2009-08-23 00:00:00.000,New Haven CT; U.S.A. ATP World Tour 250,HARD,2,Pablo Cuevas,Andrey Golubev,Pablo Cuevas,6-3; 6-4,R64,74,4,5,35,63,28,35,17,28,2,2,10,45,63,4,3,27,51,19,27,15,24,3,5,9,34,51
2009-08-23 00:00:00.000,New Haven CT; U.S.A. ATP World Tour 250,HARD,2,Jurgen Melzer,N/A Bye,Jurgen Melzer,,R64,0,0,0,0,0,0,0,0,0,0,0,0,0,0,0,0,0,0,0,0,0,0,0,0,0,0,0
2009-08-23 00:00:00.000,New Haven CT; U.S.A. ATP World Tour 250,HARD,2,Andreas Seppi,N/A Bye,Andreas Seppi,,R64,0,0,0,0,0,0,0,0,0,0,0,0,0,0,0,0,0,0,0,0,0,0,0,0,0,0,0
2009-08-23 00:00:00.000,New Haven CT; U.S.A. ATP World Tour 250,HARD,2,Yen-Hsun Lu,Guillermo Garcia-Lopez,Yen-Hsun Lu,6-2; 6-2,R64,72,6,1,31,50,23,31,13,19,0,0,8,36,50,1,11,34,54,21,34,5,20,6,10,8,26,54
2009-08-23 00:00:00.000,New Haven CT; U.S.A. ATP World Tour 250,HARD,2,Paul Capdeville,Jarkko Nieminen,Paul Capdeville,7-5; 6-3,R64,77,4,2,38,60,30,38,12,22,2,3,11,42,60,3,3,37,69,23,37,16,32,10,13,10,39,69
2009-08-23 00:00:00.000,New Haven CT; U.S.A. ATP World Tour 250,HARD,2,Fernando Verdasco,N/A Bye,Fernando Verdasco,,R64,0,0,0,0,0,0,0,0,0,0,0,0,0,0,0,0,0,0,0,0,0,0,0,0,0,0,0
2009-08-23 00:00:00.000,New Haven CT; U.S.A. ATP World Tour 250,HARD,2,Nikolay Davydenko,Robert Kendrick,Nikolay Davydenko,7-6(10); 6-3,R32,82,6,1,47,67,34,47,16,20,2,3,11,50,67,12,2,38,66,31,38,11,28,1,3,10,42,66
2009-08-23 00:00:00.000,New Haven CT; U.S.A. ATP World Tour 250,HARD,2,Fabrice Santoro,Potito Starace,Fabrice Santoro,7-5; 6-0,R32,76,3,1,38,65,24,38,13,27,2,4,9,37,65,4,5,33,49,18,33,4,16,4,10,9,22,49
2009-08-23 00:00:00.000,New Haven CT; U.S.A. ATP World Tour 250,HARD,2,Bjorn Phau,Nicolas Almagro,Bjorn Phau,2-6; 6-3; 7-5,R32,122,7,1,46,91,27,46,27,45,8,12,14,54,91,8,3,51,98,36,51,22,47,7,12,15,58,98
2009-08-23 00:00:00.000,New Haven CT; U.S.A. ATP World Tour 250,HARD,2,Sam Querrey,Marc Gicquel,Sam Querrey,6-4; 6-7(3); 6-2,R32,117,11,2,56,94,42,56,21,38,3,5,15,63,94,5,4,49,97,37,49,20,48,9,14,15,57,97
2009-08-23 00:00:00.000,New Haven CT; U.S.A. ATP World Tour 250,HARD,2,Jose Acasuso,Tommy Robredo,Jose Acasuso,3-6; 7-5; 7-6(5),R32,147,7,4,43,97,34,43,33,54,4,7,16,67,97,8,5,63,111,47,63,26,48,6,9,17,73,111
2009-08-23 00:00:00.000,New Haven CT; U.S.A. ATP World Tour 250,HARD,2,Igor Kunitsyn,Taylor Dent,Igor Kunitsyn,6-3; 6-4,R32,82,0,3,39,70,29,39,18,31,6,6,10,47,70,8,3,32,52,26,32,9,20,2,4,9,35,52
2009-08-23 00:00:00.000,New Haven CT; U.S.A. ATP World Tour 250,HARD,2,Florent Serra,Jeremy Chardy,Florent Serra,6-7(8); 7-6(4); 6-1,R32,128,13,2,63,100,46,63,25,37,1,2,16,71,100,11,11,45,106,33,45,31,61,3,6,15,64,106
2009-08-23 00:00:00.000,New Haven CT; U.S.A. ATP World Tour 250,HARD,2,Rajeev Ram,Mardy Fish,Rajeev Ram,6-3; 6-3,R32,73,10,1,31,61,24,31,17,30,5,5,9,41,61,5,1,32,56,20,32,12,24,2,5,9,32,56
2009-08-23 00:00:00.000,New Haven CT; U.S.A. ATP World Tour 250,HARD,2,Igor Andreev,Kevin Kim,Igor Andreev,6-3; 6-1,R32,53,5,2,25,38,23,25,9,13,0,0,8,32,38,1,6,23,57,16,23,13,34,8,12,8,29,57
2009-08-23 00:00:00.000,New Haven CT; U.S.A. ATP World Tour 250,HARD,2,Frederico Gil,Philipp Petzschner,Frederico Gil,6-7(2); 7-6(8); 6-3,R32,176,2,3,94,126,58,94,13,32,9,14,17,71,126,8,4,56,115,37,56,27,59,8,14,16,64,115
2009-08-23 00:00:00.000,New Haven CT; U.S.A. ATP World Tour 250,HARD,2,Simone Bolelli,Andreas Beck,Simone Bolelli,6-4; 6-4,R32,98,10,0,40,69,30,40,13,29,4,6,10,43,69,4,6,41,73,24,41,16,32,8,12,10,40,73
2009-08-23 00:00:00.000,New Haven CT; U.S.A. ATP World Tour 250,HARD,2,Leonardo Mayer,Olivier Rochus,Leonardo Mayer,6-0; 6-4,R32,74,8,2,35,58,26,35,11,23,7,8,8,37,58,0,2,24,49,13,24,9,25,5,10,8,22,49
2009-08-23 00:00:00.000,New Haven CT; U.S.A. ATP World Tour 250,HARD,2,Victor Hanescu,Janko Tipsarevic,Victor Hanescu,6-4; 6-7(8); 6-3,R32,145,5,3,60,90,46,60,14,30,4,7,15,60,90,4,6,55,109,37,55,26,54,6,12,16,63,109
2009-08-23 00:00:00.000,New Haven CT; U.S.A. ATP World Tour 250,HARD,2,Jurgen Melzer,Pablo Cuevas,Jurgen Melzer,6-2; 3-0 RET,R32,50,4,0,14,24,12,14,8,10,0,0,5,20,24,2,2,33,50,19,33,5,17,3,7,6,24,50
2009-08-23 00:00:00.000,New Haven CT; U.S.A. ATP World Tour 250,HARD,2,Andreas Seppi,Yen-Hsun Lu,Andreas Seppi,6-7(5); 6-3; 7-5,R32,153,13,3,66,122,46,66,29,56,8,12,17,75,122,5,7,70,109,46,70,19,39,6,12,16,65,109
2009-08-23 00:00:00.000,New Haven CT; U.S.A. ATP World Tour 250,HARD,2,Fernando Verdasco,Paul Capdeville,Fernando Verdasco,6-0; 6-3,R32,50,8,6,21,43,19,21,12,22,3,4,8,31,43,3,3,31,51,17,31,4,20,6,11,7,21,51
2009-08-23 00:00:00.000,New Haven CT; U.S.A. ATP World Tour 250,HARD,2,Nikolay Davydenko,Fabrice Santoro,Nikolay Davydenko,7-5; 6-3,R16,93,2,3,51,65,40,51,7,14,2,3,11,47,65,0,2,36,74,24,36,18,38,3,6,10,42,74
2009-08-23 00:00:00.000,New Haven CT; U.S.A. ATP World Tour 250,HARD,2,Sam Querrey,Bjorn Phau,Sam Querrey,7-5; 6-3,R16,64,14,2,38,60,32,38,12,22,1,2,11,44,60,2,7,28,55,21,28,10,27,0,3,10,31,55
2009-08-23 00:00:00.000,New Haven CT; U.S.A. ATP World Tour 250,HARD,2,Jose Acasuso,Igor Kunitsyn,Jose Acasuso,3-6; 7-6(3); 6-3,R16,137,6,2,43,87,35,43,22,44,6,9,14,57,87,3,7,58,101,37,58,22,43,9,13,16,59,101
2009-08-23 00:00:00.000,New Haven CT; U.S.A. ATP World Tour 250,HARD,2,Florent Serra,Rajeev Ram,Florent Serra,4-6; 7-6(6); 7-5,R16,140,7,4,54,105,41,54,32,51,4,6,17,73,105,20,3,64,112,49,64,25,48,7,9,17,74,112
2009-08-23 00:00:00.000,New Haven CT; U.S.A. ATP World Tour 250,HARD,2,Igor Andreev,Frederico Gil,Igor Andreev,6-4; 6-4,R16,92,5,3,39,66,30,39,13,27,1,2,10,43,66,5,4,39,70,28,39,13,31,5,8,10,41,70
2009-08-23 00:00:00.000,New Haven CT; U.S.A. ATP World Tour 250,HARD,2,Leonardo Mayer,Simone Bolelli,Leonardo Mayer,6-2; 6-4,R16,80,6,1,25,47,20,25,14,22,0,1,9,34,47,0,2,34,64,24,34,9,30,5,9,9,33,64
2009-08-23 00:00:00.000,New Haven CT; U.S.A. ATP World Tour 250,HARD,2,Jurgen Melzer,Victor Hanescu,Jurgen Melzer,7-6(5); 4-6; 6-1,R16,118,6,4,62,91,51,62,14,29,1,2,15,65,91,9,1,58,91,41,58,18,33,2,4,14,59,91
2009-08-23 00:00:00.000,New Haven CT; U.S.A. ATP World Tour 250,HARD,2,Fernando Verdasco,Andreas Seppi,Fernando Verdasco,7-6(3); 6-2,R16,86,3,7,32,60,28,32,15,28,3,4,10,43,60,3,2,31,68,23,31,17,37,3,6,10,40,68
2009-08-23 00:00:00.000,New Haven CT; U.S.A. ATP World Tour 250,HARD,2,Sam Querrey,Nikolay Davydenko,Sam Querrey,6-3; 3-6; 6-4,Q,102,15,1,47,78,38,47,17,31,5,7,14,55,78,3,4,58,72,43,58,4,14,0,3,14,47,72
2009-08-23 00:00:00.000,New Haven CT; U.S.A. ATP World Tour 250,HARD,2,Jose Acasuso,Florent Serra,Jose Acasuso,7-5; 6-4,Q,84,7,3,39,72,30,39,16,33,3,4,11,46,72,2,1,38,65,28,38,11,27,5,8,11,39,65
2009-08-23 00:00:00.000,New Haven CT; U.S.A. ATP World Tour 250,HARD,2,Igor Andreev,Leonardo Mayer,Igor Andreev,6-4; 6-7(4); 6-3,Q,142,5,6,63,100,43,63,24,37,2,3,16,67,100,3,5,63,109,41,63,25,46,9,12,15,66,109
2009-08-23 00:00:00.000,New Haven CT; U.S.A. ATP World Tour 250,HARD,2,Fernando Verdasco,Jurgen Melzer,Fernando Verdasco,6-3; 6-1,Q,58,5,1,31,47,20,31,12,16,2,3,8,32,47,1,1,27,46,11,27,9,19,1,6,8,20,46
2009-08-23 00:00:00.000,New Haven CT; U.S.A. ATP World Tour 250,HARD,2,Sam Querrey,Jose Acasuso,Sam Querrey,6-3; 6-4,S,64,11,3,33,52,31,33,11,19,1,1,10,42,52,4,1,21,50,16,21,17,29,3,5,9,33,50
2009-08-23 00:00:00.000,New Haven CT; U.S.A. ATP World Tour 250,HARD,2,Fernando Verdasco,Igor Andreev,Fernando Verdasco,7-6(4); 7-6(5),S,112,7,11,57,90,46,57,14,33,5,7,12,60,90,7,4,57,91,39,57,18,34,9,11,12,57,91
2009-08-23 00:00:00.000,New Haven CT; U.S.A. ATP World Tour 250,HARD,2,Fernando Verdasco,Sam Querrey,Fernando Verdasco,6-4; 7-6(6),F,96,4,4,48,67,35,48,13,19,4,6,11,48,67,7,3,51,88,36,51,16,37,4,7,11,52,88
2009-08-31 00:00:00.000,US Open NY; U.S.A. Grand Slams,HARD,3,Roger Federer,Devin Britton,Roger Federer,6-1; 6-3; 7-5,R128,88,6,3,45,69,37,45,13,24,1,3,14,50,69,6,9,58,100,34,58,15,42,2,9,14,49,100
2009-08-31 00:00:00.000,US Open NY; U.S.A. Grand Slams,HARD,3,Simon Greul,Giovanni Lapentti,Simon Greul,6-3; 4-6; 3-6; 6-0; 7-6(9),R128,217,15,9,73,142,59,73,33,69,9,13,23,92,142,5,5,80,153,56,80,38,73,11,17,23,94,153
2009-08-31 00:00:00.000,US Open NY; U.S.A. Grand Slams,HARD,3,Juan Ignacio Chela,Oscar Hernandez,Juan Ignacio Chela,6-4; 6-4; 6-2,R128,121,4,1,56,89,48,56,17,33,3,3,14,65,89,1,3,69,94,47,69,8,25,4,8,14,55,94
2009-08-31 00:00:00.000,US Open NY; U.S.A. Grand Slams,HARD,3,Lleyton Hewitt,Thiago Alves,Lleyton Hewitt,6-0; 6-3; 6-4,R128,110,6,4,36,79,29,36,25,43,1,3,13,54,79,5,5,53,85,26,53,14,32,10,17,12,40,85
2009-08-31 00:00:00.000,US Open NY; U.S.A. Grand Slams,HARD,3,James Blake,Ruben Ramirez Hidalgo,James Blake,6-1; 6-4; 7-5,R128,116,11,2,60,95,42,60,22,35,3,5,15,64,95,1,7,52,95,29,52,22,43,8,14,14,51,95
2009-08-31 00:00:00.000,US Open NY; U.S.A. Grand Slams,HARD,3,Olivier Rochus,Igor Kunitsyn,Olivier Rochus,6-3; 6-0; 6-2,R128,107,2,2,51,82,39,51,18,31,10,10,12,57,82,3,3,47,78,26,47,11,31,5,11,11,37,78
2009-08-31 00:00:00.000,US Open NY; U.S.A. Grand Slams,HARD,3,Guillermo Garcia-Lopez,Peter Polansky,Guillermo Garcia-Lopez,6-4; 6-4; 5-7; 3-6; 6-1,R128,204,5,18,76,153,57,76,36,77,16,22,24,93,153,7,8,80,144,56,80,25,64,11,19,24,81,144
2009-08-31 00:00:00.000,US Open NY; U.S.A. Grand Slams,HARD,3,Tommy Robredo,Donald Young,Tommy Robredo,6-4; 3-6; 6-2; 6-3,R128,137,7,2,55,97,47,55,26,42,1,2,18,73,97,2,5,66,108,49,66,19,42,4,8,18,68,108
2009-08-31 00:00:00.000,US Open NY; U.S.A. Grand Slams,HARD,3,Robin Soderling,Albert Montanes,Robin Soderling,6-1; 3-6; 6-1; 6-4,R128,114,18,5,56,92,48,56,17,36,0,2,17,65,92,7,4,53,105,42,53,16,52,4,10,16,58,105
2009-08-31 00:00:00.000,US Open NY; U.S.A. Grand Slams,HARD,3,Marcel Granollers,Mischa Zverev,Marcel Granollers,2-6; 7-5; 3-6; 6-4; 6-0,R128,175,7,5,80,138,59,80,29,58,8,13,23,88,138,7,1,78,125,50,78,27,47,4,10,22,77,125
2009-08-31 00:00:00.000,US Open NY; U.S.A. Grand Slams,HARD,3,Kevin Kim,Dudi Sela,Kevin Kim,6-3; 0-6; 6-2; 6-2,R128,110,4,7,45,90,32,45,21,45,3,8,16,53,90,1,5,52,91,32,52,16,39,6,13,15,48,91
2009-08-31 00:00:00.000,US Open NY; U.S.A. Grand Slams,HARD,3,Sam Querrey,Michael Yani,Sam Querrey,6-3; 7-5; 6-4,R128,120,10,5,53,99,44,53,28,46,4,4,16,72,99,6,6,61,109,35,61,31,48,9,12,15,66,109
2009-08-31 00:00:00.000,US Open NY; U.S.A. Grand Slams,HARD,3,Mikhail Youzhny,Paul-Henri Mathieu,Mikhail Youzhny,2-6; 7-5; 6-0; 6-2,R128,176,11,8,62,111,52,62,17,49,4,7,17,69,111,6,5,62,119,42,62,21,57,4,11,17,63,119
2009-08-31 00:00:00.000,US Open NY; U.S.A. Grand Slams,HARD,3,Marco Chiudinelli,Potito Starace,Marco Chiudinelli,7-6(3); 7-6(2); 6-0,R128,128,6,1,58,92,49,58,18,34,5,7,15,67,92,6,3,78,105,47,78,12,27,3,8,15,59,105
2009-08-31 00:00:00.000,US Open NY; U.S.A. Grand Slams,HARD,3,Jan Hernych,Rainer Schuettler,Jan Hernych,1-6; 7-6(5); 6-4; 2-6; 6-3,R128,200,4,6,79,134,56,79,23,55,3,10,22,79,134,5,9,99,172,65,99,33,73,14,20,24,98,172
2009-08-31 00:00:00.000,US Open NY; U.S.A. Grand Slams,HARD,3,Nikolay Davydenko,Dieter Kindlmann,Nikolay Davydenko,6-3; 6-4; 7-5,R128,133,6,1,60,97,40,60,24,37,5,7,16,64,97,1,5,41,87,30,41,19,46,6,11,15,49,87
2009-08-31 00:00:00.000,US Open NY; U.S.A. Grand Slams,HARD,3,Novak Djokovic,Ivan Ljubicic,Novak Djokovic,6-3; 6-1; 6-3,R128,97,9,0,52,66,43,52,9,14,0,0,13,52,66,10,4,39,78,23,39,17,39,5,10,12,40,78
2009-08-31 00:00:00.000,US Open NY; U.S.A. Grand Slams,HARD,3,Carsten Ball,Juan Pablo Brzezicki,Carsten Ball,7-6(5); 6-3; 6-4,R128,109,19,2,60,93,49,60,22,33,1,1,16,71,93,2,3,54,94,37,54,27,40,4,6,15,64,94
2009-08-31 00:00:00.000,US Open NY; U.S.A. Grand Slams,HARD,3,Maximo Gonzalez,Karol Beck,Maximo Gonzalez,2-6; 1-6; 6-1; 6-4; 6-3,R128,190,1,10,83,139,56,83,21,56,16,23,20,77,139,8,15,68,143,51,68,29,75,10,18,21,80,143
2009-08-31 00:00:00.000,US Open NY; U.S.A. Grand Slams,HARD,3,Jesse Witten,Igor Andreev,Jesse Witten,6-4; 6-0; 6-2,R128,97,7,4,37,79,28,37,25,42,4,5,12,53,79,1,7,36,82,22,36,15,46,7,13,12,37,82
2009-08-31 00:00:00.000,US Open NY; U.S.A. Grand Slams,HARD,3,Philipp Kohlschreiber,Andreas Seppi,Philipp Kohlschreiber,6-0; 6-4; 6-4,R128,118,5,2,52,90,36,52,24,38,8,9,13,60,90,5,3,40,81,26,40,18,41,7,12,13,44,81
2009-08-31 00:00:00.000,US Open NY; U.S.A. Grand Slams,HARD,3,Somdev Devvarman,Frederico Gil,Somdev Devvarman,6-3; 6-4; 6-3,R128,146,4,2,60,83,42,60,13,23,3,5,14,55,83,0,5,67,106,37,67,20,39,7,14,14,57,106
2009-08-31 00:00:00.000,US Open NY; U.S.A. Grand Slams,HARD,3,Leonardo Mayer,Andrey Golubev,Leonardo Mayer,6-4; 4-6; 7-5; 6-3,R128,174,8,6,88,137,61,88,26,49,10,14,21,87,137,4,3,72,125,52,72,23,53,10,16,20,75,125
2009-08-31 00:00:00.000,US Open NY; U.S.A. Grand Slams,HARD,3,Radek Stepanek,Simone Bolelli,Radek Stepanek,6-4; 6-4; 6-4,R128,126,11,2,44,87,34,44,22,43,6,9,15,56,87,4,1,60,95,32,60,18,35,4,10,15,50,95
2009-08-31 00:00:00.000,US Open NY; U.S.A. Grand Slams,HARD,3,Fernando Verdasco,Benjamin Becker,Fernando Verdasco,7-5; 6-4; 7-5,R128,132,12,5,47,83,40,47,21,36,1,3,17,61,83,1,1,57,106,42,57,21,49,2,7,17,63,106
2009-08-31 00:00:00.000,US Open NY; U.S.A. Grand Slams,HARD,3,Florent Serra,Janko Tipsarevic,Florent Serra,7-6(8); 7-6(5); 7-6(5),R128,172,4,4,71,127,52,71,33,56,5,8,18,85,127,16,7,72,142,61,72,31,70,9,12,18,92,142
2009-08-31 00:00:00.000,US Open NY; U.S.A. Grand Slams,HARD,3,Robert Kendrick,Martin Vassallo Arguello,Robert Kendrick,6-3; 6-2; 6-2,R128,83,16,1,52,76,44,52,11,24,2,3,13,55,76,2,2,44,62,27,44,4,18,2,8,12,31,62
2009-08-31 00:00:00.000,US Open NY; U.S.A. Grand Slams,HARD,3,Tommy Haas,Alejandro Falla,Tommy Haas,7-5; 4-6; 7-6(7); 6-2,R128,190,9,9,75,129,53,75,28,54,3,9,21,81,129,5,10,76,148,52,76,30,72,7,15,21,82,148
2009-08-31 00:00:00.000,US Open NY; U.S.A. Grand Slams,HARD,3,John Isner,Victor Hanescu,John Isner,6-1; 7-6(14); 7-6(5),R128,147,13,2,68,106,56,68,22,38,0,1,16,78,106,9,3,70,100,54,70,15,30,3,6,15,69,100
2009-08-31 00:00:00.000,US Open NY; U.S.A. Grand Slams,HARD,3,Marsel Ilhan,Christophe Rochus,Marsel Ilhan,3-6; 6-3; 3-6; 7-5; 7-5,R128,202,15,4,100,149,71,100,21,49,8,14,25,92,149,6,2,105,175,68,105,35,70,9,17,26,103,175
2009-08-31 00:00:00.000,US Open NY; U.S.A. Grand Slams,HARD,3,Marc Gicquel,Dmitry Tursunov,Marc Gicquel,6-2; 5-7; 6-3; 6-3,R128,179,8,7,77,137,58,77,25,60,7,11,19,83,137,2,6,72,137,43,72,30,65,14,22,19,73,137
2009-08-31 00:00:00.000,US Open NY; U.S.A. Grand Slams,HARD,3,Andy Roddick,Bjorn Phau,Andy Roddick,6-1; 6-4; 6-2,R128,95,13,1,56,69,45,56,8,13,1,2,13,53,69,3,0,41,76,27,41,12,35,3,9,12,39,76
2009-08-31 00:00:00.000,US Open NY; U.S.A. Grand Slams,HARD,3,Jo-Wilfried Tsonga,Chase Buchanan,Jo-Wilfried Tsonga,6-0; 6-2; 6-1,R128,78,8,3,34,54,30,34,13,20,0,1,11,43,54,2,1,50,75,26,50,6,25,8,16,10,32,75
2009-08-31 00:00:00.000,US Open NY; U.S.A. Grand Slams,HARD,3,Jarkko Nieminen,Fabio Fognini,Jarkko Nieminen,7-5; 7-6(6); 6-4,R128,141,4,4,70,114,47,70,23,44,5,9,17,70,114,4,5,54,112,34,54,29,58,8,14,17,63,112
2009-08-31 00:00:00.000,US Open NY; U.S.A. Grand Slams,HARD,3,Julien Benneteau,Flavio Cipolla,Julien Benneteau,4-6; 6-1; 6-3; 6-3,R128,158,9,0,74,108,53,74,21,34,6,8,18,74,108,1,4,78,112,44,78,18,34,5,11,17,62,112
2009-08-31 00:00:00.000,US Open NY; U.S.A. Grand Slams,HARD,3,Viktor Troicki,Peter Luczak,Viktor Troicki,6-3; 6-3; 1-6; 2-6; 6-1,R128,170,14,8,58,124,39,58,32,66,6,12,20,71,124,5,2,73,125,39,73,34,52,10,17,20,73,125
2009-08-31 00:00:00.000,US Open NY; U.S.A. Grand Slams,HARD,3,Tomas Berdych,Wayne Odesnik,Tomas Berdych,7-5; 6-4; 6-4,R128,154,6,4,58,110,46,58,26,52,7,8,16,72,110,3,2,72,111,49,72,15,39,10,14,16,64,111
2009-08-31 00:00:00.000,US Open NY; U.S.A. Grand Slams,HARD,3,Horacio Zeballos,Michael Berrer,Horacio Zeballos,6-3; 7-6(7); 3-6; 6-0,R128,178,7,6,84,146,56,84,34,62,15,18,19,90,146,5,8,81,117,55,81,16,36,8,13,17,71,117
2009-08-31 00:00:00.000,US Open NY; U.S.A. Grand Slams,HARD,3,Josselin Ouanna,Rajeev Ram,Josselin Ouanna,7-6(4); 6-4; 3-6; 6-3,R128,163,11,5,79,125,57,79,28,46,7,9,20,85,125,10,6,72,136,58,72,28,64,6,8,20,86,136
2009-08-31 00:00:00.000,US Open NY; U.S.A. Grand Slams,HARD,3,Fernando Gonzalez,Nicolas Massu,Fernando Gonzalez,6-3; 6-3; 6-3,R128,125,12,2,42,80,31,42,23,38,2,4,14,54,80,6,6,60,103,32,60,18,43,11,17,13,50,103
2009-08-31 00:00:00.000,US Open NY; U.S.A. Grand Slams,HARD,3,Gael Monfils,Jeremy Chardy,Gael Monfils,6-1; 6-4; 6-3,R128,95,12,0,44,76,36,44,16,32,3,4,13,52,76,5,8,47,80,32,47,11,33,4,10,13,43,80
2009-08-31 00:00:00.000,US Open NY; U.S.A. Grand Slams,HARD,3,Andreas Beck,Evgeny Korolev,Andreas Beck,6-3; 6-4; 2-6; 2-6; 6-4,R128,188,10,9,82,134,56,82,30,52,4,8,23,86,134,15,6,94,151,71,94,27,57,7,10,22,98,151
2009-08-31 00:00:00.000,US Open NY; U.S.A. Grand Slams,HARD,3,Jose Acasuso,Marcos Daniel,Jose Acasuso,6-2; 6-4; 6-3,R128,108,13,3,39,68,34,39,19,29,0,0,13,53,68,4,4,37,87,27,37,24,50,4,9,14,51,87
2009-08-31 00:00:00.000,US Open NY; U.S.A. Grand Slams,HARD,3,David Ferrer,Alberto Martin,David Ferrer,7-5; 5-7; 6-3; 6-3,R128,163,2,7,63,113,39,63,23,50,4,12,21,62,113,3,6,72,139,44,72,26,67,18,29,21,70,139
2009-08-31 00:00:00.000,US Open NY; U.S.A. Grand Slams,HARD,3,Nicolas Almagro,Steve Darcis,Nicolas Almagro,6-2; 6-4; 2-6; 7-6(8),R128,164,15,5,82,131,63,82,24,49,7,10,19,87,131,10,2,75,132,57,75,26,57,4,8,19,83,132
2009-08-31 00:00:00.000,US Open NY; U.S.A. Grand Slams,HARD,3,Robby Ginepri,Andrei Pavel,Robby Ginepri,5-7; 6-2; 6-4; 6-0,R128,131,7,1,65,101,48,65,14,36,2,6,18,62,101,3,6,68,120,41,68,20,52,6,15,18,61,120
2009-08-31 00:00:00.000,US Open NY; U.S.A. Grand Slams,HARD,3,Nicolas Kiefer,Michael Llodra,Nicolas Kiefer,6-3; 6-4; 6-4,R128,114,12,5,49,87,39,49,21,38,4,6,15,60,87,6,6,50,83,34,50,13,33,1,5,14,47,83
2009-08-31 00:00:00.000,US Open NY; U.S.A. Grand Slams,HARD,3,Rafael Nadal,Richard Gasquet,Rafael Nadal,6-2; 6-2; 6-3,R128,101,7,0,35,62,33,35,19,27,0,0,13,52,62,4,4,49,75,29,49,12,26,5,10,12,41,75
2009-08-31 00:00:00.000,US Open NY; U.S.A. Grand Slams,HARD,3,Juan Martin Del Potro,Juan Monaco,Juan Martin Del Potro,6-3; 6-3; 6-1,R128,125,7,2,37,65,29,37,20,28,2,4,13,49,65,0,0,74,101,37,74,12,27,7,14,12,49,101
2009-08-31 00:00:00.000,US Open NY; U.S.A. Grand Slams,HARD,3,Jurgen Melzer,Marat Safin,Jurgen Melzer,1-6; 6-4; 6-3; 6-4,R128,133,7,6,58,105,49,58,22,47,4,6,18,71,105,15,4,53,106,41,53,29,53,8,11,18,70,106
2009-08-31 00:00:00.000,US Open NY; U.S.A. Grand Slams,HARD,3,Pablo Cuevas,Chris Guccione,Pablo Cuevas,6-4; 7-6(4); 6-0,R128,103,11,1,58,80,49,58,15,22,1,1,14,64,80,12,3,38,82,25,38,25,44,2,6,14,50,82
2009-08-31 00:00:00.000,US Open NY; U.S.A. Grand Slams,HARD,3,Daniel Koellerer,Rui Machado,Daniel Koellerer,6-2; 6-4; 2-6; 6-2,R128,157,1,0,87,115,56,87,18,28,5,7,17,74,115,6,2,61,104,42,61,22,43,5,10,17,64,104
2009-08-31 00:00:00.000,US Open NY; U.S.A. Grand Slams,HARD,3,Juan Carlos Ferrero,Fabrice Santoro,Juan Carlos Ferrero,6-4; 6-3; 6-3,R128,127,5,1,48,84,36,48,18,36,5,8,14,54,84,2,0,51,98,28,51,20,47,9,16,14,48,98
2009-08-31 00:00:00.000,US Open NY; U.S.A. Grand Slams,HARD,3,Philipp Petzschner,Sergiy Stakhovsky,Philipp Petzschner,7-6(3); 6-7(6); 6-4; 4-6; 6-3,R128,210,14,8,83,174,66,83,51,91,6,9,26,117,174,10,5,85,162,68,85,40,77,6,11,27,108,162
2009-08-31 00:00:00.000,US Open NY; U.S.A. Grand Slams,HARD,3,Thomaz Bellucci,Yen-Hsun Lu,Thomaz Bellucci,6-4; 6-2; 6-3,R128,111,8,2,54,86,41,54,19,32,3,4,14,60,86,1,3,47,79,28,47,17,32,3,8,13,45,79
2009-08-31 00:00:00.000,US Open NY; U.S.A. Grand Slams,HARD,3,Gilles Simon,Daniel Gimeno-Traver,Gilles Simon,6-4; 7-6(3); 6-3,R128,125,3,4,45,93,32,45,26,48,3,6,15,58,93,6,5,57,101,39,57,17,44,0,6,16,56,101
2009-08-31 00:00:00.000,US Open NY; U.S.A. Grand Slams,HARD,3,Marin Cilic,Ryan Sweeting,Marin Cilic,7-6(2); 6-4; 7-6(4),R128,145,10,5,53,101,42,53,24,48,6,11,17,66,101,6,5,90,126,55,90,15,36,9,15,17,70,126
2009-08-31 00:00:00.000,US Open NY; U.S.A. Grand Slams,HARD,3,Jesse Levine,Teymuraz Gabashvili,Jesse Levine,7-5; 6-1; 6-2,R128,109,10,5,50,80,39,50,17,30,3,4,13,56,80,4,7,56,95,33,56,15,39,6,13,14,48,95
2009-08-31 00:00:00.000,US Open NY; U.S.A. Grand Slams,HARD,3,Denis Istomin,Brendan Evans,Denis Istomin,6-4; 6-4; 7-6(3),R128,146,18,2,79,118,58,79,23,39,9,10,16,81,118,8,1,65,100,41,65,23,35,3,6,16,64,100
2009-08-31 00:00:00.000,US Open NY; U.S.A. Grand Slams,HARD,3,Nicolas Lapentti,Stanislas Wawrinka,Nicolas Lapentti,4-6; 3-6; 7-6(6); 7-6(3); 6-3,R128,283,5,4,108,166,74,108,28,58,8,16,26,102,166,19,12,98,188,69,98,38,90,13,20,26,107,188
2009-08-31 00:00:00.000,US Open NY; U.S.A. Grand Slams,HARD,3,Ivan Navarro,Ivo Karlovic,Ivan Navarro,6-4; 7-6(8); 7-6(5),R128,133,8,2,70,102,57,70,23,32,0,1,17,80,102,22,3,75,106,62,75,14,31,3,5,17,76,106
2009-08-31 00:00:00.000,US Open NY; U.S.A. Grand Slams,HARD,3,Taylor Dent,Feliciano Lopez,Taylor Dent,4-6; 7-6(6); 6-3; 7-5,R128,170,17,10,88,140,71,88,26,52,5,7,22,97,140,7,5,88,140,64,88,28,52,6,9,21,92,140
2009-08-31 00:00:00.000,US Open NY; U.S.A. Grand Slams,HARD,3,Paul Capdeville,Victor Crivoi,Paul Capdeville,6-3; 6-0; 7-6(2),R128,107,9,1,47,83,37,47,24,36,2,3,14,61,83,5,8,57,109,35,57,21,52,9,14,13,56,109
2009-08-31 00:00:00.000,US Open NY; U.S.A. Grand Slams,HARD,3,Andy Murray,Ernests Gulbis,Andy Murray,7-5; 6-3; 7-5,R128,137,11,1,50,94,42,50,23,44,4,6,17,65,94,11,3,66,110,46,66,16,44,8,13,16,62,110
2009-08-31 00:00:00.000,US Open NY; U.S.A. Grand Slams,HARD,3,Roger Federer,Simon Greul,Roger Federer,6-3; 7-5; 7-5,R64,118,8,2,66,99,48,66,23,33,5,6,17,71,99,0,4,46,93,32,46,25,47,4,8,16,57,93
2009-08-31 00:00:00.000,US Open NY; U.S.A. Grand Slams,HARD,3,Lleyton Hewitt,Juan Ignacio Chela,Lleyton Hewitt,6-3; 6-3; 6-4,R64,130,3,2,47,88,37,47,25,41,8,9,14,62,88,5,2,62,108,40,62,18,46,12,17,14,58,108
2009-08-31 00:00:00.000,US Open NY; U.S.A. Grand Slams,HARD,3,James Blake,Olivier Rochus,James Blake,6-4; 3-6; 7-6(6); 6-3,R64,164,21,4,59,126,47,59,37,67,5,9,21,84,126,5,4,90,128,58,90,20,38,10,14,19,78,128
2009-08-31 00:00:00.000,US Open NY; U.S.A. Grand Slams,HARD,3,Tommy Robredo,Guillermo Garcia-Lopez,Tommy Robredo,6-2; 4-6; 6-2; 6-4,R64,191,11,7,83,145,60,83,27,62,12,15,18,87,145,1,8,65,124,39,65,29,59,12,18,18,68,124
2009-08-31 00:00:00.000,US Open NY; U.S.A. Grand Slams,HARD,3,Robin Soderling,Marcel Granollers,Robin Soderling,2-0 RET,R64,16,1,0,4,6,4,4,2,2,0,0,2,6,6,1,1,3,10,1,3,3,7,1,2,1,4,10
2009-08-31 00:00:00.000,US Open NY; U.S.A. Grand Slams,HARD,3,Sam Querrey,Kevin Kim,Sam Querrey,7-5; 6-7(6); 6-4; 6-4,R64,176,15,3,82,139,66,82,31,57,5,6,22,97,139,9,3,72,147,57,72,37,75,6,10,22,94,147
2009-08-31 00:00:00.000,US Open NY; U.S.A. Grand Slams,HARD,3,Marco Chiudinelli,Mikhail Youzhny,Marco Chiudinelli,2-6; 7-6(4); 6-4; 6-3,R64,187,4,3,60,119,37,60,31,59,10,17,19,68,119,4,8,86,137,51,86,22,51,4,12,20,73,137
2009-08-31 00:00:00.000,US Open NY; U.S.A. Grand Slams,HARD,3,Nikolay Davydenko,Jan Hernych,Nikolay Davydenko,6-4; 6-1; 6-2,R64,88,2,3,51,68,41,51,10,17,1,2,13,51,68,1,1,44,68,25,44,9,24,3,9,12,34,68
2009-08-31 00:00:00.000,US Open NY; U.S.A. Grand Slams,HARD,3,Novak Djokovic,Carsten Ball,Novak Djokovic,6-3; 6-4; 6-4,R64,109,3,0,46,75,35,46,23,29,1,2,15,58,75,8,7,53,93,37,53,18,40,14,18,14,55,93
2009-08-31 00:00:00.000,US Open NY; U.S.A. Grand Slams,HARD,3,Jesse Witten,Maximo Gonzalez,Jesse Witten,6-7(3); 6-4; 7-5; 6-2,R64,215,10,6,63,130,47,63,29,67,9,15,21,76,130,0,7,107,164,59,107,26,57,15,24,21,85,164
2009-08-31 00:00:00.000,US Open NY; U.S.A. Grand Slams,HARD,3,Philipp Kohlschreiber,Somdev Devvarman,Philipp Kohlschreiber,6-3; 6-4; 0-6; 6-2,R64,168,5,4,74,127,51,74,24,53,16,20,17,75,127,3,2,63,100,42,63,17,37,8,13,16,59,100
2009-08-31 00:00:00.000,US Open NY; U.S.A. Grand Slams,HARD,3,Radek Stepanek,Leonardo Mayer,Radek Stepanek,7-6(5); 6-3; 6-4,R64,134,4,9,66,108,54,66,17,42,3,5,16,71,108,6,2,53,90,35,53,22,37,3,7,15,57,90
2009-08-31 00:00:00.000,US Open NY; U.S.A. Grand Slams,HARD,3,Fernando Verdasco,Florent Serra,Fernando Verdasco,6-3; 6-0; 6-3,R64,89,9,7,33,64,27,33,19,31,1,2,12,46,64,4,2,52,91,34,52,10,39,7,14,12,44,91
2009-08-31 00:00:00.000,US Open NY; U.S.A. Grand Slams,HARD,3,Tommy Haas,Robert Kendrick,Tommy Haas,6-4; 6-4; 7-6(3),R64,144,11,2,60,96,51,60,24,36,4,4,16,75,96,8,2,66,132,48,66,33,66,16,18,16,81,132
2009-08-31 00:00:00.000,US Open NY; U.S.A. Grand Slams,HARD,3,John Isner,Marsel Ilhan,John Isner,6-3; 6-4; 7-6(1),R64,119,16,4,55,90,45,55,22,35,2,3,16,67,90,2,1,64,92,40,64,18,28,3,6,15,58,92
2009-08-31 00:00:00.000,US Open NY; U.S.A. Grand Slams,HARD,3,Andy Roddick,Marc Gicquel,Andy Roddick,6-1; 6-4; 6-4,R64,113,13,0,55,81,42,55,19,26,1,1,14,61,81,5,3,49,86,30,49,20,37,1,5,13,50,86
2009-08-31 00:00:00.000,US Open NY; U.S.A. Grand Slams,HARD,3,Jo-Wilfried Tsonga,Jarkko Nieminen,Jo-Wilfried Tsonga,7-5; 6-3; 6-4,R64,109,11,4,48,83,44,48,24,35,1,1,16,68,83,5,2,45,84,33,45,23,39,0,3,15,56,84
2009-08-31 00:00:00.000,US Open NY; U.S.A. Grand Slams,HARD,3,Julien Benneteau,Viktor Troicki,Julien Benneteau,6-1; 3-6; 6-1; 6-0,R64,140,4,2,56,84,42,56,18,28,2,4,15,60,84,6,5,51,105,33,51,18,54,10,17,14,51,105
2009-08-31 00:00:00.000,US Open NY; U.S.A. Grand Slams,HARD,3,Tomas Berdych,Horacio Zeballos,Tomas Berdych,6-3; 6-7(3); 7-6(2); 6-2,R64,180,17,7,74,125,62,74,30,51,0,1,21,92,125,11,4,95,140,61,95,27,45,7,11,20,88,140
2009-08-31 00:00:00.000,US Open NY; U.S.A. Grand Slams,HARD,3,Fernando Gonzalez,Josselin Ouanna,Fernando Gonzalez,6-4; 6-7(5); 6-3; 6-4,R64,137,26,5,77,124,65,77,28,47,3,3,21,93,124,11,3,74,114,56,74,24,40,3,8,20,80,114
2009-08-31 00:00:00.000,US Open NY; U.S.A. Grand Slams,HARD,3,Gael Monfils,Andreas Beck,Gael Monfils,6-3; 7-5; 6-3,R64,118,17,3,61,99,47,61,19,38,2,3,15,66,99,1,7,60,103,40,60,19,43,8,13,15,59,103
2009-08-31 00:00:00.000,US Open NY; U.S.A. Grand Slams,HARD,3,Jose Acasuso,David Ferrer,Jose Acasuso,6-3; 3-6; 1-6; 6-3; 6-2,R64,192,12,9,63,133,48,63,32,70,12,17,21,80,133,10,10,84,140,62,84,21,56,13,19,21,83,140
2009-08-31 00:00:00.000,US Open NY; U.S.A. Grand Slams,HARD,3,Nicolas Almagro,Robby Ginepri,Nicolas Almagro,6-7(7); 6-2; 6-3; 4-6; 6-4,R64,215,18,9,113,189,75,113,36,76,21,29,25,111,189,11,1,100,151,55,100,27,51,9,19,24,82,151
2009-08-31 00:00:00.000,US Open NY; U.S.A. Grand Slams,HARD,3,Rafael Nadal,Nicolas Kiefer,Rafael Nadal,6-0; 3-6; 6-3; 6-4,R64,179,3,1,51,82,37,51,26,31,1,3,17,63,82,7,5,54,133,38,54,33,79,9,15,17,71,133
2009-08-31 00:00:00.000,US Open NY; U.S.A. Grand Slams,HARD,3,Juan Martin Del Potro,Jurgen Melzer,Juan Martin Del Potro,7-6(6); 6-3; 6-3,R64,141,13,4,49,85,43,49,22,36,4,5,15,65,85,8,2,57,104,44,57,22,47,8,12,15,66,104
2009-08-31 00:00:00.000,US Open NY; U.S.A. Grand Slams,HARD,3,Daniel Koellerer,Pablo Cuevas,Daniel Koellerer,3-6; 6-2; 6-1; 6-4,R64,167,3,2,78,125,58,78,23,47,10,11,17,81,125,16,6,68,108,48,68,17,40,4,9,17,65,108
2009-08-31 00:00:00.000,US Open NY; U.S.A. Grand Slams,HARD,3,Juan Carlos Ferrero,Philipp Petzschner,Juan Carlos Ferrero,1-6; 3-6; 6-4; 6-2; 6-4,R64,180,1,2,98,143,65,98,25,45,10,16,22,90,143,17,6,72,142,56,72,29,70,8,14,22,85,142
2009-08-31 00:00:00.000,US Open NY; U.S.A. Grand Slams,HARD,3,Gilles Simon,Thomaz Bellucci,Gilles Simon,6-3; 6-2; 6-4,R64,122,8,0,38,75,30,38,26,37,1,2,14,56,75,8,3,64,101,36,64,19,37,8,12,13,55,101
2009-08-31 00:00:00.000,US Open NY; U.S.A. Grand Slams,HARD,3,Marin Cilic,Jesse Levine,Marin Cilic,4-6; 2-6; 6-0; 6-3; 6-0,R64,166,14,9,65,126,49,65,28,61,7,12,20,77,126,3,10,58,107,35,58,20,49,6,15,19,55,107
2009-08-31 00:00:00.000,US Open NY; U.S.A. Grand Slams,HARD,3,Denis Istomin,Nicolas Lapentti,Denis Istomin,2-6; 6-4; 4-6; 7-5; 7-6(4),R64,288,12,5,108,174,76,108,32,66,10,17,26,108,174,9,6,120,198,85,120,35,78,12,18,26,120,198
2009-08-31 00:00:00.000,US Open NY; U.S.A. Grand Slams,HARD,3,Taylor Dent,Ivan Navarro,Taylor Dent,6-4; 5-7; 6-7(1); 7-5; 7-6(9),R64,252,19,7,130,186,101,130,29,56,2,5,29,130,186,12,4,156,190,111,156,18,34,7,11,29,129,190
2009-08-31 00:00:00.000,US Open NY; U.S.A. Grand Slams,HARD,3,Andy Murray,Paul Capdeville,Andy Murray,6-2; 3-6; 6-0; 6-2,R64,127,15,2,52,99,39,52,26,47,2,3,15,65,99,6,2,60,97,35,60,18,37,9,16,16,53,97
2009-08-31 00:00:00.000,US Open NY; U.S.A. Grand Slams,HARD,3,Roger Federer,Lleyton Hewitt,Roger Federer,4-6; 6-3; 7-5; 6-4,R32,153,15,4,75,134,56,75,31,59,11,14,21,87,134,5,4,57,110,40,57,29,53,6,11,20,69,110
2009-08-31 00:00:00.000,US Open NY; U.S.A. Grand Slams,HARD,3,Tommy Robredo,James Blake,Tommy Robredo,7-6(2); 6-4; 6-4,R32,139,9,3,68,104,53,68,17,36,3,5,16,70,104,2,8,53,102,39,53,24,49,1,5,16,63,102
2009-08-31 00:00:00.000,US Open NY; U.S.A. Grand Slams,HARD,3,Robin Soderling,Sam Querrey,Robin Soderling,6-2; 7-5; 6-7(6); 6-1,R32,141,24,4,65,123,56,65,37,58,8,9,20,93,123,18,7,87,131,62,87,16,44,5,11,19,78,131
2009-08-31 00:00:00.000,US Open NY; U.S.A. Grand Slams,HARD,3,Nikolay Davydenko,Marco Chiudinelli,Nikolay Davydenko,6-4; 7-5; 7-5,R32,154,10,7,68,104,46,68,21,36,7,10,17,67,104,4,2,62,109,34,62,25,47,4,10,17,59,109
2009-08-31 00:00:00.000,US Open NY; U.S.A. Grand Slams,HARD,3,Novak Djokovic,Jesse Witten,Novak Djokovic,6-7(2); 6-3; 7-6(2); 6-4,R32,208,8,8,83,136,58,83,24,53,5,11,21,82,136,5,11,66,142,39,66,40,76,9,18,22,79,142
2009-08-31 00:00:00.000,US Open NY; U.S.A. Grand Slams,HARD,3,Radek Stepanek,Philipp Kohlschreiber,Radek Stepanek,4-6; 6-2; 6-3; 6-3,R32,155,13,4,60,109,48,60,27,49,7,9,18,75,109,10,3,69,112,45,69,18,43,8,14,18,63,112
2009-08-31 00:00:00.000,US Open NY; U.S.A. Grand Slams,HARD,3,Fernando Verdasco,Tommy Haas,Fernando Verdasco,3-6; 7-5; 7-6(8); 1-6; 6-4,R32,225,18,13,102,163,73,102,27,61,8,14,24,100,163,22,6,99,160,73,99,31,61,6,11,26,104,160
2009-08-31 00:00:00.000,US Open NY; U.S.A. Grand Slams,HARD,3,John Isner,Andy Roddick,John Isner,7-6(3); 6-3; 3-6; 5-7; 7-6(5),R32,231,38,7,106,163,85,106,34,57,7,9,27,119,163,20,2,102,154,85,102,33,52,6,7,27,118,154
2009-08-31 00:00:00.000,US Open NY; U.S.A. Grand Slams,HARD,3,Jo-Wilfried Tsonga,Julien Benneteau,Jo-Wilfried Tsonga,7-6(4); 6-2; 6-4,R32,132,10,1,58,89,49,58,19,31,3,3,15,68,89,6,4,59,98,41,59,21,39,7,10,15,62,98
2009-08-31 00:00:00.000,US Open NY; U.S.A. Grand Slams,HARD,3,Fernando Gonzalez,Tomas Berdych,Fernando Gonzalez,7-5; 6-4; 6-4,R32,132,15,4,56,99,46,56,25,43,4,4,16,71,99,4,1,50,98,36,50,29,48,6,9,16,65,98
2009-08-31 00:00:00.000,US Open NY; U.S.A. Grand Slams,HARD,3,Gael Monfils,Jose Acasuso,Gael Monfils,6-3; 6-4; 1-0 RET,R32,85,10,1,41,59,33,41,11,18,1,1,10,44,59,2,2,29,57,22,29,13,28,3,6,10,35,57
2009-08-31 00:00:00.000,US Open NY; U.S.A. Grand Slams,HARD,3,Rafael Nadal,Nicolas Almagro,Rafael Nadal,7-5; 6-4; 6-4,R32,159,2,3,63,101,39,63,21,38,8,13,16,60,101,5,9,52,102,31,52,18,50,5,12,16,49,102
2009-08-31 00:00:00.000,US Open NY; U.S.A. Grand Slams,HARD,3,Juan Martin Del Potro,Daniel Koellerer,Juan Martin Del Potro,6-1; 3-6; 6-3; 6-3,R32,157,20,4,58,93,47,58,13,35,5,10,17,60,93,0,2,79,113,40,79,15,34,7,16,17,55,113
2009-08-31 00:00:00.000,US Open NY; U.S.A. Grand Slams,HARD,3,Juan Carlos Ferrero,Gilles Simon,Juan Carlos Ferrero,1-6; 6-4; 7-6(5); 1-0 RET,R32,149,9,2,54,91,37,54,22,37,5,8,14,59,91,8,4,65,112,46,65,24,47,9,12,16,70,112
2009-08-31 00:00:00.000,US Open NY; U.S.A. Grand Slams,HARD,3,Marin Cilic,Denis Istomin,Marin Cilic,6-1; 6-4; 6-3,R32,113,2,2,38,79,31,38,27,41,3,3,13,58,79,1,3,59,85,34,59,12,26,3,8,13,46,85
2009-08-31 00:00:00.000,US Open NY; U.S.A. Grand Slams,HARD,3,Andy Murray,Taylor Dent,Andy Murray,6-3; 6-2; 6-2,R32,90,7,1,32,68,29,32,22,36,1,2,13,51,68,2,2,43,70,25,43,11,27,5,11,12,36,70
2009-08-31 00:00:00.000,US Open NY; U.S.A. Grand Slams,HARD,3,Roger Federer,Tommy Robredo,Roger Federer,7-5; 6-2; 6-2,R16,108,9,0,47,75,41,47,19,28,4,4,14,60,75,2,2,64,93,40,64,11,29,5,10,14,51,93
2009-08-31 00:00:00.000,US Open NY; U.S.A. Grand Slams,HARD,3,Robin Soderling,Nikolay Davydenko,Robin Soderling,7-5; 3-6; 6-2 RET,R16,129,8,5,50,90,43,50,15,40,2,5,15,58,90,4,3,65,95,43,65,15,30,9,13,14,58,95
2009-08-31 00:00:00.000,US Open NY; U.S.A. Grand Slams,HARD,3,Novak Djokovic,Radek Stepanek,Novak Djokovic,6-1; 6-3; 6-3,R16,106,5,3,46,74,35,46,16,28,2,3,13,51,74,4,1,49,80,26,49,14,31,7,13,12,40,80
2009-08-31 00:00:00.000,US Open NY; U.S.A. Grand Slams,HARD,3,Fernando Verdasco,John Isner,Fernando Verdasco,4-6; 6-4; 6-4; 6-4,R16,146,7,4,76,102,57,76,16,26,1,4,20,73,102,13,3,72,102,52,72,16,30,3,8,20,68,102
2009-08-31 00:00:00.000,US Open NY; U.S.A. Grand Slams,HARD,3,Fernando Gonzalez,Jo-Wilfried Tsonga,Fernando Gonzalez,3-6; 6-3; 7-6(3); 6-4,R16,161,8,3,85,135,67,85,29,50,13,14,20,96,135,15,4,80,127,64,80,21,47,5,7,20,85,127
2009-08-31 00:00:00.000,US Open NY; U.S.A. Grand Slams,HARD,3,Rafael Nadal,Gael Monfils,Rafael Nadal,6-7(3); 6-3; 6-1; 6-3,R16,165,0,0,81,110,59,81,18,29,3,6,19,77,110,11,4,66,108,46,66,15,42,6,14,18,61,108
2009-08-31 00:00:00.000,US Open NY; U.S.A. Grand Slams,HARD,3,Juan Martin Del Potro,Juan Carlos Ferrero,Juan Martin Del Potro,6-3; 6-3; 6-3,R16,128,22,1,61,90,49,61,15,29,4,4,14,64,90,4,2,56,84,36,56,13,28,5,9,13,49,84
2009-08-31 00:00:00.000,US Open NY; U.S.A. Grand Slams,HARD,3,Marin Cilic,Andy Murray,Marin Cilic,7-5; 6-2; 6-2,R16,128,10,3,48,93,38,48,26,45,7,7,14,64,93,5,3,50,78,33,50,14,28,4,9,14,47,78
2009-08-31 00:00:00.000,US Open NY; U.S.A. Grand Slams,HARD,3,Roger Federer,Robin Soderling,Roger Federer,6-0; 6-3; 6-7(6); 7-6(6),Q,153,28,3,85,128,73,85,24,43,5,5,20,97,128,11,5,85,127,62,85,19,42,7,11,19,81,127
2009-08-31 00:00:00.000,US Open NY; U.S.A. Grand Slams,HARD,3,Novak Djokovic,Fernando Verdasco,Novak Djokovic,7-6(2); 1-6; 7-5; 6-2,Q,185,9,4,93,138,66,93,23,45,10,14,20,89,138,5,8,68,122,47,68,26,54,8,12,19,73,122
2009-08-31 00:00:00.000,US Open NY; U.S.A. Grand Slams,HARD,3,Rafael Nadal,Fernando Gonzalez,Rafael Nadal,7-6(4); 7-6(2); 6-0,Q,157,1,0,65,87,55,65,16,22,2,2,15,71,87,9,6,65,107,43,65,22,42,7,10,15,65,107
2009-08-31 00:00:00.000,US Open NY; U.S.A. Grand Slams,HARD,3,Juan Martin Del Potro,Marin Cilic,Juan Martin Del Potro,4-6; 6-3; 6-2; 6-1,Q,153,6,4,62,94,50,62,14,32,4,7,17,64,94,7,2,62,105,40,62,17,43,0,8,17,57,105
2009-08-31 00:00:00.000,US Open NY; U.S.A. Grand Slams,HARD,3,Roger Federer,Novak Djokovic,Roger Federer,7-6(3); 7-5; 7-5,S,154,8,3,63,109,49,63,28,46,2,3,18,77,109,6,4,78,115,53,78,20,37,7,10,18,73,115
2009-08-31 00:00:00.000,US Open NY; U.S.A. Grand Slams,HARD,3,Juan Martin Del Potro,Rafael Nadal,Juan Martin Del Potro,6-2; 6-2; 6-2,S,140,6,3,56,85,44,56,12,29,5,5,12,56,85,4,4,70,90,40,70,6,20,10,16,12,46,90
2009-08-31 00:00:00.000,US Open NY; U.S.A. Grand Slams,HARD,3,Juan Martin Del Potro,Roger Federer,Juan Martin Del Potro,3-6; 7-6(5); 4-6; 7-6(4); 6-2,F,246,8,6,112,171,81,112,33,59,17,22,25,114,171,14,11,93,181,67,93,48,88,10,15,26,115,181
2009-09-21 00:00:00.000,Bucharest Romania ATP World Tour 250,CLAY,2,Oscar Hernandez,Victor Hanescu,Oscar Hernandez,7-6(5); 6-4,R32,113,4,1,56,81,41,56,10,25,4,6,11,51,81,2,1,54,72,31,54,10,18,2,5,11,41,72
2009-09-21 00:00:00.000,Bucharest Romania ATP World Tour 250,CLAY,2,Maximo Gonzalez,Olivier Rochus,Maximo Gonzalez,6-7(4); 6-1; 6-4,R32,164,7,2,70,111,47,70,21,41,10,12,14,68,111,4,4,79,115,45,79,17,36,6,12,15,62,115
2009-09-21 00:00:00.000,Bucharest Romania ATP World Tour 250,CLAY,2,Simon Greul,Steve Darcis,Simon Greul,7-5; 6-3,R32,104,1,4,46,83,33,46,18,37,4,5,11,51,83,2,1,39,67,26,39,12,28,4,7,10,38,67
2009-09-21 00:00:00.000,Bucharest Romania ATP World Tour 250,CLAY,2,Daniel Koellerer,Filippo Volandri,Daniel Koellerer,2-6; 7-5; 6-3,R32,169,2,1,67,103,36,67,18,36,11,17,15,54,103,1,1,84,105,44,84,12,21,9,15,14,56,105
2009-09-21 00:00:00.000,Bucharest Romania ATP World Tour 250,CLAY,2,Juan Monaco,Julio Silva,Juan Monaco,6-2; 6-4,R32,77,4,0,35,56,23,35,15,21,2,3,9,38,56,1,0,37,53,20,37,9,16,3,7,9,29,53
2009-09-21 00:00:00.000,Bucharest Romania ATP World Tour 250,CLAY,2,Pere Riba,Frederico Gil,Pere Riba,7-5; 5-7; 6-2,R32,158,3,2,59,112,40,59,29,53,7,10,16,69,112,6,6,55,94,36,55,19,39,3,8,16,55,94
2009-09-21 00:00:00.000,Bucharest Romania ATP World Tour 250,CLAY,2,Peter Luczak,Karol Beck,Peter Luczak,7-5; 7-6(6),R32,148,7,3,61,104,42,61,20,43,6,8,12,62,104,9,2,45,79,33,45,13,34,1,4,12,46,79
2009-09-21 00:00:00.000,Bucharest Romania ATP World Tour 250,CLAY,2,Pablo Cuevas,Andrei Pavel,Pablo Cuevas,6-3; 7-6(2),R32,80,8,1,45,63,36,45,11,18,2,3,11,47,63,1,0,45,60,28,45,9,15,2,4,10,37,60
2009-09-21 00:00:00.000,Bucharest Romania ATP World Tour 250,CLAY,2,Ruben Ramirez Hidalgo,Andreas Seppi,Ruben Ramirez Hidalgo,6-4; 6-4,R32,124,1,3,43,69,30,43,12,26,7,9,10,42,69,5,9,33,78,24,33,17,45,8,12,10,41,78
2009-09-21 00:00:00.000,Bucharest Romania ATP World Tour 250,CLAY,2,Marius Copil,Victor Crivoi,Marius Copil,6-3; 6-2,R32,75,3,2,28,57,21,28,18,29,2,2,9,39,57,0,0,25,47,16,25,10,22,2,5,8,26,47
2009-09-21 00:00:00.000,Bucharest Romania ATP World Tour 250,CLAY,2,Alberto Martin,Florent Serra,Alberto Martin,4-6; 6-0; 6-4,R32,137,5,1,53,100,38,53,23,47,6,8,13,61,100,2,5,55,100,37,55,16,45,10,15,13,53,100
2009-09-21 00:00:00.000,Bucharest Romania ATP World Tour 250,CLAY,2,Santiago Ventura,Igor Andreev,Santiago Ventura,6-4; 6-1,R32,64,4,0,29,46,22,29,12,17,2,3,9,34,46,0,2,23,42,12,23,9,19,1,5,8,21,42
2009-09-21 00:00:00.000,Bucharest Romania ATP World Tour 250,CLAY,2,Albert Montanes,Potito Starace,Albert Montanes,6-4; 6-2,R32,76,4,0,40,58,29,40,11,18,6,7,9,40,58,3,2,39,56,22,39,7,17,4,8,9,29,56
2009-09-21 00:00:00.000,Bucharest Romania ATP World Tour 250,CLAY,2,Marcel Granollers,Petru-Alexandru Luncanu,Marcel Granollers,6-2; 6-7(3); 6-1,R32,130,2,1,56,86,45,56,14,30,5,6,14,59,86,0,4,64,98,38,64,16,34,10,15,13,54,98
2009-09-21 00:00:00.000,Bucharest Romania ATP World Tour 250,CLAY,2,Fabio Fognini,Daniel Gimeno-Traver,Fabio Fognini,1-6; 6-4; 6-3,R32,121,2,4,47,77,32,47,12,30,3,7,13,44,77,4,4,51,86,35,51,15,35,4,8,13,50,86
2009-09-21 00:00:00.000,Bucharest Romania ATP World Tour 250,CLAY,2,Nicolas Almagro,Simone Bolelli,Nicolas Almagro,6-4; 6-3,R32,81,5,1,38,66,28,38,17,28,5,6,10,45,66,2,1,43,56,30,43,3,13,2,5,9,33,56
2009-09-21 00:00:00.000,Bucharest Romania ATP World Tour 250,CLAY,2,Maximo Gonzalez,Oscar Hernandez,Maximo Gonzalez,7-5; 3-6; 6-1,R16,139,1,2,60,86,43,60,15,26,4,6,14,58,86,1,6,67,93,42,67,11,26,10,14,14,53,93
2009-09-21 00:00:00.000,Bucharest Romania ATP World Tour 250,CLAY,2,Simon Greul,Daniel Koellerer,Simon Greul,6-1; 6-4,R16,80,11,4,27,59,21,27,17,32,11,12,8,38,59,2,2,34,59,17,34,12,25,3,8,9,29,59
2009-09-21 00:00:00.000,Bucharest Romania ATP World Tour 250,CLAY,2,Juan Monaco,Pere Riba,Juan Monaco,6-4; 6-2,R16,78,0,1,21,44,16,21,20,23,0,0,9,36,44,2,0,39,57,23,39,10,18,5,8,9,33,57
2009-09-21 00:00:00.000,Bucharest Romania ATP World Tour 250,CLAY,2,Pablo Cuevas,Peter Luczak,Pablo Cuevas,7-5; 6-4,R16,119,7,2,41,75,29,41,19,34,7,9,11,48,75,0,3,37,64,23,37,14,27,3,7,11,37,64
2009-09-21 00:00:00.000,Bucharest Romania ATP World Tour 250,CLAY,2,Ruben Ramirez Hidalgo,Marius Copil,Ruben Ramirez Hidalgo,6-3; 6-7(3); 6-4,R16,198,0,6,78,117,51,78,19,39,7,9,15,70,117,11,7,48,99,38,48,20,51,2,7,16,58,99
2009-09-21 00:00:00.000,Bucharest Romania ATP World Tour 250,CLAY,2,Santiago Ventura,Alberto Martin,Santiago Ventura,4-5 RET,R16,49,2,1,25,43,18,25,7,18,2,3,5,25,43,2,1,11,19,10,11,6,8,0,0,4,16,19
2009-09-21 00:00:00.000,Bucharest Romania ATP World Tour 250,CLAY,2,Albert Montanes,Marcel Granollers,Albert Montanes,6-1; 6-3,R16,68,1,3,25,44,21,25,12,19,0,0,8,33,44,2,2,35,52,18,35,7,17,6,10,8,25,52
2009-09-21 00:00:00.000,Bucharest Romania ATP World Tour 250,CLAY,2,Fabio Fognini,Nicolas Almagro,Fabio Fognini,6-4; 7-6(3),R16,103,2,2,55,80,37,55,15,25,6,8,11,52,80,5,2,47,72,32,47,11,25,1,4,11,43,72
2009-09-21 00:00:00.000,Bucharest Romania ATP World Tour 250,CLAY,2,Simon Greul,Maximo Gonzalez,Simon Greul,6-2; 6-2,Q,64,0,0,28,48,17,28,15,20,1,2,8,32,48,0,2,28,45,12,28,8,17,4,9,8,20,45
2009-09-21 00:00:00.000,Bucharest Romania ATP World Tour 250,CLAY,2,Juan Monaco,Pablo Cuevas,Juan Monaco,6-3; 2-6; 6-1,Q,115,1,0,50,76,34,50,17,26,6,8,12,51,76,4,1,54,84,36,54,13,30,7,11,12,49,84
2009-09-21 00:00:00.000,Bucharest Romania ATP World Tour 250,CLAY,2,Santiago Ventura,Ruben Ramirez Hidalgo,Santiago Ventura,6-2; 6-3,Q,91,5,1,35,54,25,35,8,19,3,5,9,33,54,0,2,32,66,18,32,12,34,7,12,8,30,66
2009-09-21 00:00:00.000,Bucharest Romania ATP World Tour 250,CLAY,2,Albert Montanes,Fabio Fognini,Albert Montanes,6-1; 6-1,Q,57,2,0,28,40,22,28,10,12,2,2,7,32,40,2,1,29,53,17,29,6,24,7,12,7,23,53
2009-09-21 00:00:00.000,Bucharest Romania ATP World Tour 250,CLAY,2,Juan Monaco,Simon Greul,Juan Monaco,6-4; 6-3,S,91,3,2,49,68,34,49,9,19,4,5,10,43,68,1,0,32,53,21,32,9,21,2,5,9,30,53
2009-09-21 00:00:00.000,Bucharest Romania ATP World Tour 250,CLAY,2,Albert Montanes,Santiago Ventura,Albert Montanes,4-6; 6-4; 6-1,S,111,1,3,55,84,42,55,14,29,3,6,14,56,84,1,0,50,77,35,50,10,27,4,9,13,45,77
2009-09-21 00:00:00.000,Bucharest Romania ATP World Tour 250,CLAY,2,Albert Montanes,Juan Monaco,Albert Montanes,7-6(2); 7-6(6),F,131,2,2,63,90,43,63,16,27,5,6,12,59,90,1,1,68,83,44,68,9,15,2,3,12,53,83
2009-09-21 00:00:00.000,Metz France ATP World Tour 250,HARD,2,Gael Monfils,N/A Bye,Gael Monfils,,R32,0,0,0,0,0,0,0,0,0,0,0,0,0,0,0,0,0,0,0,0,0,0,0,0,0,0,0
2009-09-21 00:00:00.000,Metz France ATP World Tour 250,HARD,2,Sebastien Grosjean,Nicolas Mahut,Sebastien Grosjean,7-6(1); 7-5,R32,112,4,1,42,81,30,42,25,39,1,2,12,55,81,6,4,48,81,35,48,15,33,5,7,12,50,81
2009-09-21 00:00:00.000,Metz France ATP World Tour 250,HARD,2,Janko Tipsarevic,Arnaud Clement,Janko Tipsarevic,6-4; 6-4,R32,80,10,1,31,50,27,31,13,19,0,0,10,40,50,3,2,33,60,27,33,12,27,3,5,10,39,60
2009-09-21 00:00:00.000,Metz France ATP World Tour 250,HARD,2,Ivan Ljubicic,Sebastien De Chaunac,Ivan Ljubicic,4-6; 6-1; 7-6(1),R32,142,21,3,61,93,50,61,17,32,4,5,15,67,93,5,2,54,102,37,54,26,48,8,10,14,63,102
2009-09-21 00:00:00.000,Metz France ATP World Tour 250,HARD,2,Philipp Petzschner,N/A Bye,Philipp Petzschner,,R32,0,0,0,0,0,0,0,0,0,0,0,0,0,0,0,0,0,0,0,0,0,0,0,0,0,0,0
2009-09-21 00:00:00.000,Metz France ATP World Tour 250,HARD,2,Michael Llodra,Mischa Zverev,Michael Llodra,4-6; 6-3; 6-3,R32,109,15,1,62,90,45,62,15,28,7,8,14,60,90,8,2,59,99,39,59,20,40,7,10,14,59,99
2009-09-21 00:00:00.000,Metz France ATP World Tour 250,HARD,2,Richard Gasquet,Michael Berrer,Richard Gasquet,6-3; 2-6; 7-6(5),R32,152,12,5,63,115,48,63,24,52,10,12,14,72,115,12,3,77,107,58,77,10,30,11,13,15,68,107
2009-09-21 00:00:00.000,Metz France ATP World Tour 250,HARD,2,Christophe Rochus,Fabrice Santoro,Christophe Rochus,0-6; 6-4; 7-6(3),R32,116,0,2,62,89,37,62,9,27,2,9,14,46,89,20,2,46,79,35,46,11,33,1,6,14,46,79
2009-09-21 00:00:00.000,Metz France ATP World Tour 250,HARD,2,Andreas Beck,Yen-Hsun Lu,Andreas Beck,6-4; 6-2,R32,72,6,2,35,61,28,35,15,26,5,5,9,43,61,5,2,30,50,19,30,10,20,2,5,9,29,50
2009-09-21 00:00:00.000,Metz France ATP World Tour 250,HARD,2,Thierry Ascione,Adrian Mannarino,Thierry Ascione,7-6(5); 6-4,R32,96,9,0,48,67,38,48,14,19,1,1,11,52,67,11,1,40,78,32,40,22,38,6,7,11,54,78
2009-09-21 00:00:00.000,Metz France ATP World Tour 250,HARD,2,Marc Gicquel,Roman Valent,Marc Gicquel,6-3; 6-1,R32,54,5,0,24,43,20,24,14,19,0,0,8,34,43,1,2,27,46,16,27,7,19,0,4,8,23,46
2009-09-21 00:00:00.000,Metz France ATP World Tour 250,HARD,2,Paul-Henri Mathieu,N/A Bye,Paul-Henri Mathieu,,R32,0,0,0,0,0,0,0,0,0,0,0,0,0,0,0,0,0,0,0,0,0,0,0,0,0,0,0
2009-09-21 00:00:00.000,Metz France ATP World Tour 250,HARD,2,Evgeny Korolev,Benjamin Becker,Evgeny Korolev,6-2; 6-3,R32,52,7,0,26,39,23,26,9,13,0,0,8,32,39,8,1,30,46,21,30,5,16,0,4,9,26,46
2009-09-21 00:00:00.000,Metz France ATP World Tour 250,HARD,2,Denis Istomin,Andrey Golubev,Denis Istomin,6-2; 6-4,R32,58,0,0,35,49,27,35,7,14,0,1,9,34,49,3,2,33,48,22,33,7,15,0,4,9,29,48
2009-09-21 00:00:00.000,Metz France ATP World Tour 250,HARD,2,Bjorn Phau,Rainer Schuettler,Bjorn Phau,7-6(1); 7-6(5),R32,110,4,3,49,84,36,49,18,35,6,8,12,54,84,3,2,46,80,34,46,14,34,1,3,12,48,80
2009-09-21 00:00:00.000,Metz France ATP World Tour 250,HARD,2,Philipp Kohlschreiber,N/A Bye,Philipp Kohlschreiber,,R32,0,0,0,0,0,0,0,0,0,0,0,0,0,0,0,0,0,0,0,0,0,0,0,0,0,0,0
2009-09-21 00:00:00.000,Metz France ATP World Tour 250,HARD,2,Gael Monfils,Sebastien Grosjean,Gael Monfils,6-1; 6-1,R16,66,10,1,28,50,22,28,10,22,6,7,7,32,50,1,3,41,60,18,41,8,19,7,13,7,26,60
2009-09-21 00:00:00.000,Metz France ATP World Tour 250,HARD,2,Janko Tipsarevic,Ivan Ljubicic,Janko Tipsarevic,6-4; 7-6(3),R16,115,7,3,41,69,33,41,16,28,4,5,11,49,69,11,3,49,83,36,49,16,34,6,8,11,52,83
2009-09-21 00:00:00.000,Metz France ATP World Tour 250,HARD,2,Philipp Petzschner,Michael Llodra,Philipp Petzschner,7-6(3); 6-3,R16,93,6,1,38,70,33,38,18,32,5,5,11,51,70,5,6,38,74,28,38,18,36,4,5,10,46,74
2009-09-21 00:00:00.000,Metz France ATP World Tour 250,HARD,2,Richard Gasquet,Christophe Rochus,Richard Gasquet,7-5; 4-6; 6-2,R16,129,21,3,47,83,38,47,18,36,3,6,15,56,83,6,1,81,110,49,81,13,29,7,12,15,62,110
2009-09-21 00:00:00.000,Metz France ATP World Tour 250,HARD,2,Andreas Beck,Thierry Ascione,Andreas Beck,6-2; 6-4,R16,67,3,1,27,44,24,27,12,17,0,0,9,36,44,2,2,43,57,27,43,6,14,3,6,9,33,57
2009-09-21 00:00:00.000,Metz France ATP World Tour 250,HARD,2,Paul-Henri Mathieu,Marc Gicquel,Paul-Henri Mathieu,7-6(5); 6-4,R16,86,4,0,43,64,36,43,12,21,1,2,11,48,64,8,0,41,68,25,41,21,27,4,6,11,46,68
2009-09-21 00:00:00.000,Metz France ATP World Tour 250,HARD,2,Evgeny Korolev,Denis Istomin,Evgeny Korolev,3-6; 7-5; 7-6(2),R16,138,12,5,65,112,54,65,20,47,5,8,17,74,112,8,2,79,115,56,79,17,36,6,8,16,73,115
2009-09-21 00:00:00.000,Metz France ATP World Tour 250,HARD,2,Philipp Kohlschreiber,Bjorn Phau,Philipp Kohlschreiber,4-6; 6-3; 6-2,R16,109,3,1,46,75,36,46,19,29,1,2,14,55,75,2,3,46,86,32,46,20,40,2,5,13,52,86
2009-09-21 00:00:00.000,Metz France ATP World Tour 250,HARD,2,Gael Monfils,Janko Tipsarevic,Gael Monfils,6-1; 4-2 RET,Q,46,8,0,25,40,22,25,8,15,0,0,7,30,40,2,1,25,34,14,25,3,9,1,4,6,17,34
2009-09-21 00:00:00.000,Metz France ATP World Tour 250,HARD,2,Richard Gasquet,Philipp Petzschner,Richard Gasquet,6-7(2); 6-1; 6-3,Q,106,3,2,48,87,33,48,27,39,2,3,14,60,87,16,5,45,82,33,45,15,37,2,7,14,48,82
2009-09-21 00:00:00.000,Metz France ATP World Tour 250,HARD,2,Paul-Henri Mathieu,Andreas Beck,Paul-Henri Mathieu,6-2; 3-6; 6-3,Q,114,18,3,50,84,41,50,15,34,0,1,13,56,84,14,0,52,86,36,52,18,34,6,9,13,54,86
2009-09-21 00:00:00.000,Metz France ATP World Tour 250,HARD,2,Philipp Kohlschreiber,Evgeny Korolev,Philipp Kohlschreiber,6-1; 6-3,Q,54,5,0,27,40,24,27,9,13,0,0,8,33,40,5,0,27,47,17,27,8,20,2,6,8,25,47
2009-09-21 00:00:00.000,Metz France ATP World Tour 250,HARD,2,Gael Monfils,Richard Gasquet,Gael Monfils,6-4; 6-3,S,81,13,1,30,50,27,30,11,20,4,4,9,38,50,2,4,48,81,33,48,13,33,2,5,10,46,81
2009-09-21 00:00:00.000,Metz France ATP World Tour 250,HARD,2,Philipp Kohlschreiber,Paul-Henri Mathieu,Philipp Kohlschreiber,7-6(5); 6-4,S,99,13,0,48,71,39,48,15,23,5,5,11,54,71,15,2,47,74,38,47,10,27,1,2,11,48,74
2009-09-21 00:00:00.000,Metz France ATP World Tour 250,HARD,2,Gael Monfils,Philipp Kohlschreiber,Gael Monfils,7-6(1); 3-6; 6-2,F,133,14,2,50,84,44,50,19,34,3,4,14,63,84,7,2,79,112,52,79,16,33,8,10,15,68,112
2009-09-28 00:00:00.000,Bangkok Thailand ATP World Tour 250,HARD,2,Jo-Wilfried Tsonga,N/A Bye,Jo-Wilfried Tsonga,,R32,0,0,0,0,0,0,0,0,0,0,0,0,0,0,0,0,0,0,0,0,0,0,0,0,0,0,0
2009-09-28 00:00:00.000,Bangkok Thailand ATP World Tour 250,HARD,2,Ernests Gulbis,Somdev Devvarman,Ernests Gulbis,7-6(7); 6-2,R32,96,14,2,49,68,40,49,7,19,4,5,10,47,68,2,2,53,79,36,53,12,26,5,8,10,48,79
2009-09-28 00:00:00.000,Bangkok Thailand ATP World Tour 250,HARD,2,Marco Chiudinelli,Florian Mayer,Marco Chiudinelli,6-3; 6-3,R32,74,4,0,33,52,25,33,12,19,2,3,9,37,52,5,0,39,53,24,39,7,14,0,4,9,31,53
2009-09-28 00:00:00.000,Bangkok Thailand ATP World Tour 250,HARD,2,Marat Safin,Philipp Petzschner,Marat Safin,6-2; 3-6; 6-1,R32,97,7,6,46,84,36,46,20,38,2,3,12,56,84,0,5,49,85,32,49,16,36,6,10,12,48,85
2009-09-28 00:00:00.000,Bangkok Thailand ATP World Tour 250,HARD,2,Viktor Troicki,N/A Bye,Viktor Troicki,,R32,0,0,0,0,0,0,0,0,0,0,0,0,0,0,0,0,0,0,0,0,0,0,0,0,0,0,0
2009-09-28 00:00:00.000,Bangkok Thailand ATP World Tour 250,HARD,2,Thomaz Bellucci,Guillermo Garcia-Lopez,Thomaz Bellucci,6-4; 7-6(7),R32,117,4,4,54,84,38,54,18,30,11,12,11,56,84,3,3,50,72,36,50,11,22,4,6,11,47,72
2009-09-28 00:00:00.000,Bangkok Thailand ATP World Tour 250,HARD,2,Mischa Zverev,Leonardo Mayer,Mischa Zverev,5-7; 6-3; 6-3,R32,123,5,2,70,101,54,70,14,31,6,7,15,68,101,9,5,55,95,42,55,19,40,3,6,15,61,95
2009-09-28 00:00:00.000,Bangkok Thailand ATP World Tour 250,HARD,2,John Isner,Kittipong Wachiramanowong,John Isner,6-3; 3-6; 7-6(5),R32,132,21,0,72,104,52,72,19,32,4,6,15,71,104,7,1,51,90,36,51,28,39,2,4,15,64,90
2009-09-28 00:00:00.000,Bangkok Thailand ATP World Tour 250,HARD,2,Jurgen Melzer,Marcos Daniel,Jurgen Melzer,6-3; 6-2,R32,56,13,0,38,47,33,38,5,9,1,1,9,38,47,2,2,31,44,20,31,6,13,3,6,8,26,44
2009-09-28 00:00:00.000,Bangkok Thailand ATP World Tour 250,HARD,2,Marsel Ilhan,Benjamin Becker,Marsel Ilhan,4-6; 7-6(4); 6-3,R32,119,8,1,63,90,49,63,15,27,4,5,15,64,90,15,1,53,90,40,53,23,37,0,2,16,63,90
2009-09-28 00:00:00.000,Bangkok Thailand ATP World Tour 250,HARD,2,Andreas Beck,Edouard Roger-Vasselin,Andreas Beck,7-5; 7-6(1),R32,107,8,3,46,71,36,46,13,25,2,4,12,49,71,7,1,56,84,33,56,16,28,6,9,12,49,84
2009-09-28 00:00:00.000,Bangkok Thailand ATP World Tour 250,HARD,2,Donald Young,N/A Bye,Donald Young,,R32,0,0,0,0,0,0,0,0,0,0,0,0,0,0,0,0,0,0,0,0,0,0,0,0,0,0,0
2009-09-28 00:00:00.000,Bangkok Thailand ATP World Tour 250,HARD,2,Evgeny Korolev,Fabrice Santoro,Evgeny Korolev,4-6; 7-6(4); 7-6(7),R32,168,5,4,74,123,51,74,28,49,12,15,17,79,123,13,1,64,121,48,64,29,57,8,10,17,77,121
2009-09-28 00:00:00.000,Bangkok Thailand ATP World Tour 250,HARD,2,Robby Ginepri,Danai Udomchoke,Robby Ginepri,6-4; 6-3,R32,70,5,1,44,55,33,44,8,11,1,1,10,41,55,2,2,41,64,29,41,10,23,8,10,9,39,64
2009-09-28 00:00:00.000,Bangkok Thailand ATP World Tour 250,HARD,2,Kevin Kim,Rainer Schuettler,Kevin Kim,6-4; 6-4,R32,72,7,1,40,60,31,40,11,20,3,4,10,42,60,6,0,42,57,27,42,7,15,1,4,10,34,57
2009-09-28 00:00:00.000,Bangkok Thailand ATP World Tour 250,HARD,2,Gilles Simon,N/A Bye,Gilles Simon,,R32,0,0,0,0,0,0,0,0,0,0,0,0,0,0,0,0,0,0,0,0,0,0,0,0,0,0,0
2009-09-28 00:00:00.000,Bangkok Thailand ATP World Tour 250,HARD,2,Jo-Wilfried Tsonga,Ernests Gulbis,Jo-Wilfried Tsonga,6-7(3); 7-6(4); 7-6(2),R16,132,20,2,76,112,60,76,24,36,0,0,18,84,112,23,2,75,109,63,75,19,34,1,1,18,82,109
2009-09-28 00:00:00.000,Bangkok Thailand ATP World Tour 250,HARD,2,Marco Chiudinelli,Marat Safin,Marco Chiudinelli,6-3; 7-6(4),R16,89,5,1,41,68,33,41,19,27,3,3,11,52,68,6,1,40,65,33,40,12,25,1,2,10,45,65
2009-09-28 00:00:00.000,Bangkok Thailand ATP World Tour 250,HARD,2,Viktor Troicki,Thomaz Bellucci,Viktor Troicki,6-3; 7-6(4),R16,88,3,0,42,65,36,42,15,23,1,1,11,51,65,6,3,46,68,37,46,9,22,4,5,10,46,68
2009-09-28 00:00:00.000,Bangkok Thailand ATP World Tour 250,HARD,2,John Isner,Mischa Zverev,John Isner,7-6(5); 6-4,R16,84,7,2,53,71,40,53,9,18,2,3,11,49,71,8,0,55,79,38,55,12,24,3,5,11,50,79
2009-09-28 00:00:00.000,Bangkok Thailand ATP World Tour 250,HARD,2,Jurgen Melzer,Marsel Ilhan,Jurgen Melzer,6-4; 6-2,R16,67,9,1,28,48,25,28,14,20,4,4,9,39,48,0,0,43,57,25,43,6,14,2,5,9,31,57
2009-09-28 00:00:00.000,Bangkok Thailand ATP World Tour 250,HARD,2,Andreas Beck,Donald Young,Andreas Beck,6-1; 6-7(3); 6-4,R16,120,8,3,55,88,46,55,17,33,3,4,15,63,88,4,0,67,104,34,67,27,37,10,14,14,61,104
2009-09-28 00:00:00.000,Bangkok Thailand ATP World Tour 250,HARD,2,Evgeny Korolev,Robby Ginepri,Evgeny Korolev,6-1; 6-1,R16,43,7,1,25,34,21,25,7,9,0,0,7,28,34,0,0,26,43,16,26,1,17,3,8,7,17,43
2009-09-28 00:00:00.000,Bangkok Thailand ATP World Tour 250,HARD,2,Gilles Simon,Kevin Kim,Gilles Simon,6-2; 6-2,R16,62,11,1,30,55,23,30,15,25,2,2,8,38,55,0,0,25,45,11,25,10,20,3,7,8,21,45
2009-09-28 00:00:00.000,Bangkok Thailand ATP World Tour 250,HARD,2,Jo-Wilfried Tsonga,Marco Chiudinelli,Jo-Wilfried Tsonga,6-7(7); 6-3; 6-4,Q,142,20,2,57,91,49,57,19,34,5,6,16,68,91,7,2,74,114,55,74,16,40,5,8,15,71,114
2009-09-28 00:00:00.000,Bangkok Thailand ATP World Tour 250,HARD,2,Viktor Troicki,John Isner,Viktor Troicki,7-6(3); 6-2,Q,80,13,0,43,58,35,43,11,15,1,1,10,46,58,7,1,51,71,33,51,11,20,7,9,10,44,71
2009-09-28 00:00:00.000,Bangkok Thailand ATP World Tour 250,HARD,2,Jurgen Melzer,Andreas Beck,Jurgen Melzer,6-4; 6-2,Q,67,10,0,26,44,22,26,14,18,0,0,9,36,44,2,2,38,55,23,38,9,17,4,7,9,32,55
2009-09-28 00:00:00.000,Bangkok Thailand ATP World Tour 250,HARD,2,Gilles Simon,Evgeny Korolev,Gilles Simon,4-6; 6-3; 6-4,Q,103,7,1,48,78,37,48,16,30,0,2,15,53,78,4,0,50,77,39,50,13,27,2,5,14,52,77
2009-09-28 00:00:00.000,Bangkok Thailand ATP World Tour 250,HARD,2,Viktor Troicki,Jo-Wilfried Tsonga,Viktor Troicki,1-6; 6-2; 6-3,S,98,5,1,58,78,41,58,7,20,5,8,12,48,78,11,2,53,79,39,53,8,26,5,9,12,47,79
2009-09-28 00:00:00.000,Bangkok Thailand ATP World Tour 250,HARD,2,Gilles Simon,Jurgen Melzer,Gilles Simon,6-4; 7-6(3),S,108,8,1,38,68,29,38,20,30,3,4,11,49,68,3,3,48,78,32,48,14,30,2,4,11,46,78
2009-09-28 00:00:00.000,Bangkok Thailand ATP World Tour 250,HARD,2,Gilles Simon,Viktor Troicki,Gilles Simon,7-5; 6-3,F,76,7,0,38,59,29,38,14,21,1,2,11,43,59,3,1,46,64,31,46,6,18,4,7,10,37,64
2009-09-28 00:00:00.000,Kuala Lumpur Malaysia ATP World Tour 250,HARD,2,Nikolay Davydenko,N/A Bye,Nikolay Davydenko,,R32,0,0,0,0,0,0,0,0,0,0,0,0,0,0,0,0,0,0,0,0,0,0,0,0,0,0,0
2009-09-28 00:00:00.000,Kuala Lumpur Malaysia ATP World Tour 250,HARD,2,Taylor Dent,Andrey Golubev,Taylor Dent,4-6; 6-3; 7-6(4),R32,121,4,8,61,100,51,61,18,39,4,6,16,69,100,8,2,53,86,43,53,18,33,5,7,15,61,86
2009-09-28 00:00:00.000,Kuala Lumpur Malaysia ATP World Tour 250,HARD,2,Martin Vassallo Arguello,Feliciano Lopez,Martin Vassallo Arguello,6-3; 6-3,R32,71,3,1,41,49,33,41,5,8,0,0,9,38,49,2,3,35,61,18,35,16,26,5,8,9,34,61
2009-09-28 00:00:00.000,Kuala Lumpur Malaysia ATP World Tour 250,HARD,2,Gael Monfils,Denis Istomin,Gael Monfils,7-6(3); 7-6(2),R32,96,9,2,48,74,37,48,15,26,0,3,12,52,74,1,2,58,80,40,58,8,22,3,6,12,48,80
2009-09-28 00:00:00.000,Kuala Lumpur Malaysia ATP World Tour 250,HARD,2,Robin Soderling,N/A Bye,Robin Soderling,,R32,0,0,0,0,0,0,0,0,0,0,0,0,0,0,0,0,0,0,0,0,0,0,0,0,0,0,0
2009-09-28 00:00:00.000,Kuala Lumpur Malaysia ATP World Tour 250,HARD,2,Brendan Evans,Michael Yani,Brendan Evans,6-3; 6-4,R32,84,6,0,42,55,37,42,7,13,0,0,10,44,55,4,0,43,71,27,43,14,28,6,8,9,41,71
2009-09-28 00:00:00.000,Kuala Lumpur Malaysia ATP World Tour 250,HARD,2,Simon Greul,Christophe Rochus,Simon Greul,6-4; 3-6; 6-2,R32,119,14,2,40,79,34,40,17,39,1,3,13,51,79,1,5,53,92,37,53,18,39,9,13,14,55,92
2009-09-28 00:00:00.000,Kuala Lumpur Malaysia ATP World Tour 250,HARD,2,Tomas Berdych,Igor Kunitsyn,Tomas Berdych,6-1; 3-6; 6-2,R32,113,5,3,40,71,31,40,15,31,4,6,12,46,71,2,1,53,91,31,53,19,38,4,9,12,50,91
2009-09-28 00:00:00.000,Kuala Lumpur Malaysia ATP World Tour 250,HARD,2,Mikhail Youzhny,David Ferrer,Mikhail Youzhny,7-6(3); 6-2,R32,105,1,2,37,58,26,37,15,21,1,3,10,41,58,2,3,49,81,26,49,15,32,6,10,10,41,81
2009-09-28 00:00:00.000,Kuala Lumpur Malaysia ATP World Tour 250,HARD,2,Marcos Baghdatis,Yen-Hsun Lu,Marcos Baghdatis,4-6; 6-3; 7-6(5),R32,169,17,4,54,119,44,54,25,65,6,11,16,69,119,3,4,67,111,39,67,23,44,9,14,15,62,111
2009-09-28 00:00:00.000,Kuala Lumpur Malaysia ATP World Tour 250,HARD,2,Rohan Bopanna,Jose Acasuso,Rohan Bopanna,4-6; 6-3; 6-4,R32,115,14,4,52,86,39,52,20,34,4,6,15,59,86,5,5,54,95,39,54,22,41,8,11,14,61,95
2009-09-28 00:00:00.000,Kuala Lumpur Malaysia ATP World Tour 250,HARD,2,Fernando Gonzalez,N/A Bye,Fernando Gonzalez,,R32,0,0,0,0,0,0,0,0,0,0,0,0,0,0,0,0,0,0,0,0,0,0,0,0,0,0,0
2009-09-28 00:00:00.000,Kuala Lumpur Malaysia ATP World Tour 250,HARD,2,Joachim Johansson,Lleyton Hewitt,Joachim Johansson,7-6(7); 6-3,R32,100,13,4,47,85,38,47,20,38,9,9,11,58,85,11,4,34,68,24,34,21,34,2,3,10,45,68
2009-09-28 00:00:00.000,Kuala Lumpur Malaysia ATP World Tour 250,HARD,2,Richard Gasquet,Victor Crivoi,Richard Gasquet,6-1; 6-2,R32,67,12,1,31,48,26,31,8,17,3,3,8,34,48,3,1,29,50,12,29,13,21,2,6,7,25,50
2009-09-28 00:00:00.000,Kuala Lumpur Malaysia ATP World Tour 250,HARD,2,Karol Beck,Mikhail Kukushkin,Karol Beck,1-6; 7-6(4); 6-3,R32,147,6,3,55,93,34,55,19,38,6,12,15,53,93,2,4,51,93,38,51,15,42,6,10,13,53,93
2009-09-28 00:00:00.000,Kuala Lumpur Malaysia ATP World Tour 250,HARD,2,Fernando Verdasco,N/A Bye,Fernando Verdasco,,R32,0,0,0,0,0,0,0,0,0,0,0,0,0,0,0,0,0,0,0,0,0,0,0,0,0,0,0
2009-09-28 00:00:00.000,Kuala Lumpur Malaysia ATP World Tour 250,HARD,2,Nikolay Davydenko,Taylor Dent,Nikolay Davydenko,6-3; 7-6(4),R16,115,5,1,74,93,47,74,11,19,12,13,10,58,93,6,4,41,78,28,41,16,37,4,7,11,44,78
2009-09-28 00:00:00.000,Kuala Lumpur Malaysia ATP World Tour 250,HARD,2,Gael Monfils,Martin Vassallo Arguello,Gael Monfils,6-4; 6-2,R16,93,4,1,34,57,25,34,14,23,1,2,9,39,57,0,3,59,84,33,59,10,25,10,14,9,43,84
2009-09-28 00:00:00.000,Kuala Lumpur Malaysia ATP World Tour 250,HARD,2,Robin Soderling,Brendan Evans,Robin Soderling,6-1; 6-1,R16,57,6,3,19,40,19,19,12,21,2,2,7,31,40,5,1,35,60,18,35,8,25,11,16,7,26,60
2009-09-28 00:00:00.000,Kuala Lumpur Malaysia ATP World Tour 250,HARD,2,Tomas Berdych,Simon Greul,Tomas Berdych,6-3; 4-6; 6-3,R16,127,9,3,40,75,32,40,21,35,0,2,14,53,75,4,6,66,106,44,66,16,40,5,9,14,60,106
2009-09-28 00:00:00.000,Kuala Lumpur Malaysia ATP World Tour 250,HARD,2,Mikhail Youzhny,Marcos Baghdatis,Mikhail Youzhny,6-2; 6-3,R16,67,2,0,21,39,20,21,13,18,0,0,8,33,39,1,0,32,54,18,32,10,22,2,6,9,28,54
2009-09-28 00:00:00.000,Kuala Lumpur Malaysia ATP World Tour 250,HARD,2,Fernando Gonzalez,Rohan Bopanna,Fernando Gonzalez,6-4; 3-6; 6-4,R16,83,12,4,43,81,33,43,23,38,1,2,14,56,81,12,3,45,75,40,45,14,30,1,3,15,54,75
2009-09-28 00:00:00.000,Kuala Lumpur Malaysia ATP World Tour 250,HARD,2,Richard Gasquet,Joachim Johansson,Richard Gasquet,4-6; 7-6(1); 6-2,R16,119,26,6,75,102,57,75,13,27,7,8,15,70,102,24,4,62,102,45,62,20,40,11,13,15,65,102
2009-09-28 00:00:00.000,Kuala Lumpur Malaysia ATP World Tour 250,HARD,2,Fernando Verdasco,Karol Beck,Fernando Verdasco,6-4; 6-0,R16,70,5,6,31,56,24,31,11,25,7,9,8,35,56,1,5,25,48,13,25,6,23,3,9,8,19,48
2009-09-28 00:00:00.000,Kuala Lumpur Malaysia ATP World Tour 250,HARD,2,Nikolay Davydenko,Gael Monfils,Nikolay Davydenko,6-3; 6-3,Q,74,0,2,37,52,27,37,10,15,2,3,9,37,52,7,4,34,59,21,34,9,25,5,9,9,30,59
2009-09-28 00:00:00.000,Kuala Lumpur Malaysia ATP World Tour 250,HARD,2,Robin Soderling,Tomas Berdych,Robin Soderling,6-2; 6-2,Q,64,5,1,25,47,20,25,16,22,1,1,8,36,47,2,3,20,44,10,20,11,24,2,6,8,21,44
2009-09-28 00:00:00.000,Kuala Lumpur Malaysia ATP World Tour 250,HARD,2,Fernando Gonzalez,Mikhail Youzhny,Fernando Gonzalez,6-3; 6-4,Q,81,5,0,32,52,26,32,14,20,0,0,10,40,52,2,2,39,59,26,39,11,20,7,9,9,37,59
2009-09-28 00:00:00.000,Kuala Lumpur Malaysia ATP World Tour 250,HARD,2,Fernando Verdasco,Richard Gasquet,Fernando Verdasco,7-5; 6-4,Q,91,4,3,43,73,34,43,15,30,5,6,11,49,73,3,3,37,64,24,37,13,27,3,6,11,37,64
2009-09-28 00:00:00.000,Kuala Lumpur Malaysia ATP World Tour 250,HARD,2,Nikolay Davydenko,Robin Soderling,Nikolay Davydenko,1-6; 7-6(1); 6-2,S,123,9,6,54,90,36,54,20,36,6,9,13,56,90,9,3,52,89,35,52,20,37,6,9,14,55,89
2009-09-28 00:00:00.000,Kuala Lumpur Malaysia ATP World Tour 250,HARD,2,Fernando Verdasco,Fernando Gonzalez,Fernando Verdasco,6-4; 7-5,S,92,7,4,35,65,28,35,20,30,3,3,11,48,65,5,3,39,72,32,39,15,33,4,6,11,47,72
2009-09-28 00:00:00.000,Kuala Lumpur Malaysia ATP World Tour 250,HARD,2,Nikolay Davydenko,Fernando Verdasco,Nikolay Davydenko,6-4; 7-5,F,95,2,2,44,67,30,44,15,23,6,7,11,45,67,8,6,46,81,33,46,14,35,6,9,11,47,81
2009-10-05 00:00:00.000,Beijing China ATP World Tour 500,HARD,2,Rafael Nadal,Marcos Baghdatis,Rafael Nadal,6-4; 3-6; 6-4,R32,130,2,0,61,85,43,61,14,24,1,3,15,57,85,8,3,51,85,38,51,19,34,2,4,14,57,85
2009-10-05 00:00:00.000,Beijing China ATP World Tour 500,HARD,2,James Blake,Florian Mayer,James Blake,6-3; 3-6; 6-3,R32,91,3,1,54,87,41,54,15,33,7,10,14,56,87,3,2,41,76,27,41,18,35,5,9,13,45,76
2009-10-05 00:00:00.000,Beijing China ATP World Tour 500,HARD,2,Marat Safin,Jose Acasuso,Marat Safin,6-4; 6-2,R32,61,6,2,29,46,26,29,12,17,2,2,9,38,46,2,2,34,58,22,34,10,24,3,6,9,32,58
2009-10-05 00:00:00.000,Beijing China ATP World Tour 500,HARD,2,Fernando Gonzalez,David Ferrer,Fernando Gonzalez,7-5; 6-4,R32,125,13,7,78,125,53,78,18,47,18,20,11,71,125,3,5,45,68,30,45,9,23,5,9,11,39,68
2009-10-05 00:00:00.000,Beijing China ATP World Tour 500,HARD,2,Nikolay Davydenko,Igor Kunitsyn,Nikolay Davydenko,6-1; 6-7(6); 6-2,R32,133,5,1,68,94,48,68,11,26,10,13,14,59,94,4,0,62,94,33,62,12,32,3,10,13,45,94
2009-10-05 00:00:00.000,Beijing China ATP World Tour 500,HARD,2,Philipp Kohlschreiber,Ivo Karlovic,Philipp Kohlschreiber,7-6(6); 4-6; 6-1,R32,114,3,2,53,80,42,53,21,27,0,1,15,63,80,27,2,61,89,45,61,14,28,2,4,14,59,89
2009-10-05 00:00:00.000,Beijing China ATP World Tour 500,HARD,2,Julien Benneteau,Marcos Daniel,Julien Benneteau,6-3; 6-4,R32,71,13,0,42,58,32,42,12,16,4,4,10,44,58,6,2,27,52,19,27,14,25,2,4,9,33,52
2009-10-05 00:00:00.000,Beijing China ATP World Tour 500,HARD,2,Marin Cilic,Igor Andreev,Marin Cilic,6-4; 6-4,R32,83,2,0,29,51,21,29,16,22,0,1,10,37,51,0,2,31,56,20,31,14,25,4,7,10,34,56
2009-10-05 00:00:00.000,Beijing China ATP World Tour 500,HARD,2,Robin Soderling,Jeremy Chardy,Robin Soderling,6-3; 4-6; 6-2,R32,101,9,2,43,70,33,43,20,27,0,1,14,53,70,9,4,59,96,40,59,16,37,7,10,13,56,96
2009-10-05 00:00:00.000,Beijing China ATP World Tour 500,HARD,2,Tommy Robredo,Benjamin Becker,Tommy Robredo,6-2; 6-1,R32,52,4,0,29,39,27,29,5,10,0,0,8,32,39,4,0,26,45,14,26,8,19,3,7,7,22,45
2009-10-05 00:00:00.000,Beijing China ATP World Tour 500,HARD,2,Ivan Ljubicic,Paul-Henri Mathieu,Ivan Ljubicic,7-6(8); 4-6; 6-1,R32,137,22,2,63,100,52,63,17,37,0,2,15,69,100,5,4,64,103,44,64,19,39,2,5,14,63,103
2009-10-05 00:00:00.000,Beijing China ATP World Tour 500,HARD,2,Lukasz Kubot,Andy Roddick,Lukasz Kubot,6-2; 6-4,R32,81,5,7,37,57,29,37,7,20,2,4,9,36,57,5,4,41,59,24,41,5,18,4,9,9,29,59
2009-10-05 00:00:00.000,Beijing China ATP World Tour 500,HARD,2,Fernando Verdasco,Robby Ginepri,Fernando Verdasco,6-7(7); 6-1; 6-2,R32,110,6,7,50,82,40,50,18,32,1,3,14,58,82,4,3,67,98,38,67,14,31,5,11,13,52,98
2009-10-05 00:00:00.000,Beijing China ATP World Tour 500,HARD,2,Juan Carlos Ferrero,Nicolas Almagro,Juan Carlos Ferrero,7-5; 7-6(3),R32,97,9,3,66,90,48,66,14,24,8,9,12,62,90,10,3,40,64,34,40,11,24,2,4,12,45,64
2009-10-05 00:00:00.000,Beijing China ATP World Tour 500,HARD,2,Viktor Troicki,Fabio Fognini,Viktor Troicki,7-6(5); 7-5,R32,108,10,0,53,70,37,53,11,17,3,6,12,48,70,1,3,61,88,37,61,15,27,8,12,12,52,88
2009-10-05 00:00:00.000,Beijing China ATP World Tour 500,HARD,2,Novak Djokovic,Victor Hanescu,Novak Djokovic,6-3; 7-5,R32,89,10,3,42,62,29,42,10,20,4,7,11,39,62,0,6,33,58,20,33,8,25,4,9,10,28,58
2009-10-05 00:00:00.000,Beijing China ATP World Tour 500,HARD,2,Rafael Nadal,James Blake,Rafael Nadal,7-5; 6-7(4); 6-3,R16,144,6,2,72,108,48,72,22,36,8,11,17,70,108,6,2,56,101,39,56,19,45,1,6,16,58,101
2009-10-05 00:00:00.000,Beijing China ATP World Tour 500,HARD,2,Marat Safin,Fernando Gonzalez,Marat Safin,6-3; 6-4,R16,69,12,0,34,55,30,34,13,21,1,1,10,43,55,1,2,35,58,26,35,11,23,3,5,9,37,58
2009-10-05 00:00:00.000,Beijing China ATP World Tour 500,HARD,2,Nikolay Davydenko,Philipp Kohlschreiber,Nikolay Davydenko,6-1; 6-0,R16,56,5,0,22,33,19,22,6,11,0,0,6,25,33,2,0,38,53,18,38,4,15,5,11,7,22,53
2009-10-05 00:00:00.000,Beijing China ATP World Tour 500,HARD,2,Marin Cilic,Julien Benneteau,Marin Cilic,6-2; 2-6; 6-0,R16,108,9,4,34,68,24,34,22,34,3,5,11,46,68,2,6,52,85,32,52,12,33,9,14,11,44,85
2009-10-05 00:00:00.000,Beijing China ATP World Tour 500,HARD,2,Robin Soderling,Tommy Robredo,Robin Soderling,6-3; 6-3,R16,80,5,0,23,41,19,23,17,18,0,0,9,36,41,2,0,33,72,21,33,18,39,5,8,9,39,72
2009-10-05 00:00:00.000,Beijing China ATP World Tour 500,HARD,2,Ivan Ljubicic,Lukasz Kubot,Ivan Ljubicic,7-6(6); 4-6; 6-4,R16,155,14,2,64,103,50,64,20,39,5,8,16,70,103,8,4,90,108,61,90,7,18,6,9,16,68,108
2009-10-05 00:00:00.000,Beijing China ATP World Tour 500,HARD,2,Fernando Verdasco,Juan Carlos Ferrero,Fernando Verdasco,7-5; 6-4,R16,90,7,3,42,67,32,42,14,25,2,3,11,46,67,5,2,47,65,31,47,9,18,4,7,11,40,65
2009-10-05 00:00:00.000,Beijing China ATP World Tour 500,HARD,2,Novak Djokovic,Viktor Troicki,Novak Djokovic,6-3; 6-0,R16,61,1,1,23,47,16,23,18,24,0,0,8,34,47,3,1,22,41,14,22,5,19,3,7,7,19,41
2009-10-05 00:00:00.000,Beijing China ATP World Tour 500,HARD,2,Rafael Nadal,Marat Safin,Rafael Nadal,6-3; 6-1,Q,78,1,1,43,55,29,43,8,12,3,3,8,37,55,1,3,32,51,18,32,6,19,1,5,8,24,51
2009-10-05 00:00:00.000,Beijing China ATP World Tour 500,HARD,2,Marin Cilic,Nikolay Davydenko,Marin Cilic,6-4; 6-4,Q,96,5,2,40,65,26,40,14,25,3,5,10,40,65,4,2,39,54,23,39,8,15,2,6,10,31,54
2009-10-05 00:00:00.000,Beijing China ATP World Tour 500,HARD,2,Robin Soderling,Ivan Ljubicic,Robin Soderling,7-6(3); 6-4,Q,97,9,1,43,63,36,43,14,20,1,1,11,50,63,12,6,51,89,38,51,18,38,6,7,11,56,89
2009-10-05 00:00:00.000,Beijing China ATP World Tour 500,HARD,2,Novak Djokovic,Fernando Verdasco,Novak Djokovic,6-3; 1-6; 6-1,Q,105,3,5,51,80,33,51,14,29,4,7,12,47,80,6,3,56,85,35,56,12,29,7,11,11,47,85
2009-10-05 00:00:00.000,Beijing China ATP World Tour 500,HARD,2,Marin Cilic,Rafael Nadal,Marin Cilic,6-1; 6-3,S,82,8,0,31,48,24,31,9,17,1,2,8,33,48,0,0,36,53,18,36,6,17,8,13,8,24,53
2009-10-05 00:00:00.000,Beijing China ATP World Tour 500,HARD,2,Novak Djokovic,Robin Soderling,Novak Djokovic,6-3; 6-3,S,81,6,2,30,50,24,30,12,20,1,2,9,36,50,4,4,36,66,23,36,12,30,8,12,9,35,66
2009-10-05 00:00:00.000,Beijing China ATP World Tour 500,HARD,2,Novak Djokovic,Marin Cilic,Novak Djokovic,6-2; 7-6(4),F,114,2,1,50,74,33,50,11,24,8,11,10,44,74,1,1,41,66,25,41,9,25,4,9,10,34,66
2009-10-05 00:00:00.000,Tokyo Japan ATP World Tour 500,HARD,2,Edouard Roger-Vasselin,Juan Martin Del Potro,Edouard Roger-Vasselin,6-4; 6-4,R32,89,9,2,43,74,34,43,18,31,6,6,10,52,74,6,1,29,58,24,29,14,29,2,4,10,38,58
2009-10-05 00:00:00.000,Tokyo Japan ATP World Tour 500,HARD,2,Jurgen Melzer,Leonardo Mayer,Jurgen Melzer,7-6(4); 6-3,R32,112,5,2,47,72,39,47,13,25,3,3,11,52,72,10,1,55,88,40,55,15,33,6,7,10,55,88
2009-10-05 00:00:00.000,Tokyo Japan ATP World Tour 500,HARD,2,Fabrice Santoro,Andrey Golubev,Fabrice Santoro,6-7(5); 7-6(2); 6-2,R32,157,2,3,83,111,64,83,10,28,6,8,16,74,111,8,4,84,131,52,84,24,47,13,17,16,76,131
2009-10-05 00:00:00.000,Tokyo Japan ATP World Tour 500,HARD,2,Lleyton Hewitt,Tatsuma Ito,Lleyton Hewitt,6-1; 7-5,R32,82,4,1,38,62,25,38,16,24,1,2,10,41,62,5,2,31,54,21,31,7,23,3,7,9,28,54
2009-10-05 00:00:00.000,Tokyo Japan ATP World Tour 500,HARD,2,Gilles Simon,Takao Suzuki,Gilles Simon,6-3; 6-4,R32,64,9,1,34,60,27,34,17,26,2,2,10,44,60,4,2,28,46,16,28,13,18,0,2,9,29,46
2009-10-05 00:00:00.000,Tokyo Japan ATP World Tour 500,HARD,2,Mikhail Youzhny,Thomaz Bellucci,Mikhail Youzhny,6-2; 6-3,R32,93,1,1,31,58,25,31,14,27,4,5,9,39,58,3,3,37,62,17,37,14,25,4,8,8,31,62
2009-10-05 00:00:00.000,Tokyo Japan ATP World Tour 500,HARD,2,Andreas Beck,Rainer Schuettler,Andreas Beck,6-3; 4-6; 7-6(3),R32,164,12,5,63,111,49,63,20,48,9,12,16,69,111,8,5,72,120,44,72,27,48,11,14,15,71,120
2009-10-05 00:00:00.000,Tokyo Japan ATP World Tour 500,HARD,2,Tomas Berdych,Go Soeda,Tomas Berdych,6-2; 6-4,R32,69,6,0,25,44,21,25,15,19,0,0,9,36,44,3,8,35,63,24,35,11,28,4,7,9,35,63
2009-10-05 00:00:00.000,Tokyo Japan ATP World Tour 500,HARD,2,Stanislas Wawrinka,John Isner,Stanislas Wawrinka,6-4; 6-4,R32,93,8,2,30,55,29,30,14,25,1,1,10,43,55,9,2,51,75,33,51,12,24,5,7,10,45,75
2009-10-05 00:00:00.000,Tokyo Japan ATP World Tour 500,HARD,2,Simon Greul,Martin Vassallo Arguello,Simon Greul,4-6; 6-4; 6-2,R32,116,7,1,39,68,33,39,21,29,0,1,14,54,68,8,1,79,99,49,79,11,20,9,12,14,60,99
2009-10-05 00:00:00.000,Tokyo Japan ATP World Tour 500,HARD,2,Marco Chiudinelli,Dudi Sela,Marco Chiudinelli,4-6; 6-1; 6-4,R32,129,8,3,53,99,40,53,25,46,3,4,14,65,99,6,4,43,79,32,43,17,36,5,8,13,49,79
2009-10-05 00:00:00.000,Tokyo Japan ATP World Tour 500,HARD,2,Gael Monfils,Marsel Ilhan,Gael Monfils,6-2; 6-4,R32,66,15,0,47,62,33,47,8,15,5,5,9,41,62,3,1,34,56,24,34,9,22,3,6,9,33,56
2009-10-05 00:00:00.000,Tokyo Japan ATP World Tour 500,HARD,2,Ernests Gulbis,Radek Stepanek,Ernests Gulbis,6-4; 6-4,R32,96,13,6,43,63,33,43,13,20,5,5,10,46,63,10,2,30,48,20,30,12,18,0,2,10,32,48
2009-10-05 00:00:00.000,Tokyo Japan ATP World Tour 500,HARD,2,Juan Monaco,Guillermo Garcia-Lopez,Juan Monaco,5-0 RET,R32,19,2,0,12,16,9,12,3,4,0,0,3,12,16,0,0,3,10,0,3,2,7,0,2,2,2,10
2009-10-05 00:00:00.000,Tokyo Japan ATP World Tour 500,HARD,2,Richard Gasquet,Philipp Petzschner,Richard Gasquet,6-3; 6-2,R32,68,4,0,31,57,25,31,15,26,0,0,9,40,57,2,4,22,52,16,22,14,30,4,7,8,30,52
2009-10-05 00:00:00.000,Tokyo Japan ATP World Tour 500,HARD,2,Jo-Wilfried Tsonga,Mischa Zverev,Jo-Wilfried Tsonga,6-4; 6-3,R32,82,10,2,41,63,29,41,13,22,4,5,10,42,63,3,2,39,62,26,39,9,23,7,10,9,35,62
2009-10-05 00:00:00.000,Tokyo Japan ATP World Tour 500,HARD,2,Edouard Roger-Vasselin,Jurgen Melzer,Edouard Roger-Vasselin,4-6; 6-2; 6-3,R16,109,15,0,64,93,49,64,10,29,7,9,14,59,93,13,1,41,75,27,41,20,34,4,8,13,47,75
2009-10-05 00:00:00.000,Tokyo Japan ATP World Tour 500,HARD,2,Lleyton Hewitt,Fabrice Santoro,Lleyton Hewitt,3-6; 6-3; 6-1,R16,111,10,3,44,80,32,44,18,36,3,6,13,50,80,7,4,45,79,33,45,11,34,7,12,12,44,79
2009-10-05 00:00:00.000,Tokyo Japan ATP World Tour 500,HARD,2,Mikhail Youzhny,Gilles Simon,Mikhail Youzhny,7-6(5); 6-7(5); 6-4,R16,159,8,1,76,108,61,76,15,32,0,1,17,76,108,8,3,75,124,58,75,24,49,8,10,17,82,124
2009-10-05 00:00:00.000,Tokyo Japan ATP World Tour 500,HARD,2,Tomas Berdych,Andreas Beck,Tomas Berdych,6-4; 6-1,R16,83,15,0,41,59,34,41,7,18,4,4,8,41,59,2,6,38,66,21,38,14,28,6,10,9,35,66
2009-10-05 00:00:00.000,Tokyo Japan ATP World Tour 500,HARD,2,Stanislas Wawrinka,Simon Greul,Stanislas Wawrinka,6-3; 6-2,R16,76,9,1,31,47,27,31,10,16,1,1,9,37,47,1,2,35,61,19,35,15,26,5,8,8,34,61
2009-10-05 00:00:00.000,Tokyo Japan ATP World Tour 500,HARD,2,Gael Monfils,Marco Chiudinelli,Gael Monfils,7-6(5); 6-3,R16,86,10,1,37,66,29,37,16,29,4,5,10,45,66,1,2,41,67,28,41,12,26,1,4,11,40,67
2009-10-05 00:00:00.000,Tokyo Japan ATP World Tour 500,HARD,2,Ernests Gulbis,Juan Monaco,Ernests Gulbis,6-3; 4-1 RET,R16,60,2,2,30,41,23,30,4,11,1,2,7,27,41,1,2,27,39,15,27,4,12,0,4,7,19,39
2009-10-05 00:00:00.000,Tokyo Japan ATP World Tour 500,HARD,2,Jo-Wilfried Tsonga,Richard Gasquet,Jo-Wilfried Tsonga,4-6; 6-2; 6-2,R16,99,12,4,48,89,35,48,24,41,5,6,13,59,89,2,4,35,66,24,35,16,31,3,7,13,40,66
2009-10-05 00:00:00.000,Tokyo Japan ATP World Tour 500,HARD,2,Lleyton Hewitt,Edouard Roger-Vasselin,Lleyton Hewitt,6-4; 6-0,Q,67,5,1,24,39,22,24,7,15,1,2,8,29,39,2,1,35,56,21,35,7,21,7,12,8,28,56
2009-10-05 00:00:00.000,Tokyo Japan ATP World Tour 500,HARD,2,Mikhail Youzhny,Tomas Berdych,Mikhail Youzhny,6-2; 7-6(6),Q,97,9,1,46,70,32,46,13,24,3,5,10,45,70,3,1,42,64,24,42,13,22,1,5,10,37,64
2009-10-05 00:00:00.000,Tokyo Japan ATP World Tour 500,HARD,2,Gael Monfils,Stanislas Wawrinka,Gael Monfils,2-6; 6-3; 6-4,Q,113,9,3,63,94,45,63,15,31,4,6,14,60,94,10,0,37,78,31,37,21,41,2,4,13,52,78
2009-10-05 00:00:00.000,Tokyo Japan ATP World Tour 500,HARD,2,Jo-Wilfried Tsonga,Ernests Gulbis,Jo-Wilfried Tsonga,4-6; 6-4; 6-3,Q,92,19,0,56,78,48,56,11,22,2,3,15,59,78,11,2,53,75,39,53,14,22,2,4,14,53,75
2009-10-05 00:00:00.000,Tokyo Japan ATP World Tour 500,HARD,2,Mikhail Youzhny,Lleyton Hewitt,Mikhail Youzhny,6-2; 5-7; 7-5,S,159,10,3,62,105,46,62,25,43,6,7,16,71,105,3,1,43,92,31,43,28,49,2,5,16,59,92
2009-10-05 00:00:00.000,Tokyo Japan ATP World Tour 500,HARD,2,Jo-Wilfried Tsonga,Gael Monfils,Jo-Wilfried Tsonga,6-3; 6-3,S,56,9,0,29,42,28,29,8,13,0,0,9,36,42,4,3,41,61,29,41,6,20,4,7,9,35,61
2009-10-05 00:00:00.000,Tokyo Japan ATP World Tour 500,HARD,2,Jo-Wilfried Tsonga,Mikhail Youzhny,Jo-Wilfried Tsonga,6-3; 6-3,F,69,11,0,43,57,34,43,8,14,1,1,9,42,57,3,0,35,50,22,35,7,15,1,4,9,29,50
2009-10-11 00:00:00.000,ATP World Tour Masters 1000 Shanghai China ATP World Tour Masters 1000,HARD,2,Rafael Nadal,N/A Bye,Rafael Nadal,,R64,0,0,0,0,0,0,0,0,0,0,0,0,0,0,0,0,0,0,0,0,0,0,0,0,0,0,0
2009-10-11 00:00:00.000,ATP World Tour Masters 1000 Shanghai China ATP World Tour Masters 1000,HARD,2,James Blake,Ivo Karlovic,James Blake,3-6; 7-6(4); 6-3,R64,114,5,4,50,81,44,50,17,31,0,1,14,61,81,27,3,76,100,60,76,9,24,4,6,16,69,100
2009-10-11 00:00:00.000,ATP World Tour Masters 1000 Shanghai China ATP World Tour Masters 1000,HARD,2,Florian Mayer,Philipp Petzschner,Florian Mayer,6-3; 6-2,R64,61,1,0,42,65,27,42,16,23,7,8,9,43,65,1,1,34,51,19,34,6,17,3,7,8,25,51
2009-10-11 00:00:00.000,ATP World Tour Masters 1000 Shanghai China ATP World Tour Masters 1000,HARD,2,Tommy Robredo,Michael Llodra,Tommy Robredo,6-1; 6-4,R64,105,5,1,31,41,29,31,7,10,0,0,9,36,41,2,2,35,55,21,35,9,20,4,7,8,30,55
2009-10-11 00:00:00.000,ATP World Tour Masters 1000 Shanghai China ATP World Tour Masters 1000,HARD,2,Gael Monfils,Paul-Henri Mathieu,Gael Monfils,6-2; 6-2,R64,55,7,3,29,44,24,29,9,15,1,1,8,33,44,1,4,24,46,17,24,7,22,4,8,8,24,46
2009-10-11 00:00:00.000,ATP World Tour Masters 1000 Shanghai China ATP World Tour Masters 1000,HARD,2,Lleyton Hewitt,John Isner,Lleyton Hewitt,6-2; 6-4,R64,77,2,2,31,50,28,31,11,19,2,2,9,39,50,5,0,46,65,32,46,5,19,7,10,9,37,65
2009-10-11 00:00:00.000,ATP World Tour Masters 1000 Shanghai China ATP World Tour Masters 1000,HARD,2,Ivan Ljubicic,Julien Benneteau,Ivan Ljubicic,6-3; 3-6; 6-1,R64,107,16,1,42,78,36,42,19,36,3,4,13,55,78,6,1,44,68,32,44,8,24,4,7,12,40,68
2009-10-11 00:00:00.000,ATP World Tour Masters 1000 Shanghai China ATP World Tour Masters 1000,HARD,2,Fernando Verdasco,N/A Bye,Fernando Verdasco,,R64,0,0,0,0,0,0,0,0,0,0,0,0,0,0,0,0,0,0,0,0,0,0,0,0,0,0,0
2009-10-11 00:00:00.000,ATP World Tour Masters 1000 Shanghai China ATP World Tour Masters 1000,HARD,2,Juan Martin Del Potro,N/A Bye,Juan Martin Del Potro,,R64,0,0,0,0,0,0,0,0,0,0,0,0,0,0,0,0,0,0,0,0,0,0,0,0,0,0,0
2009-10-11 00:00:00.000,ATP World Tour Masters 1000 Shanghai China ATP World Tour Masters 1000,HARD,2,Jurgen Melzer,Jeremy Chardy,Jurgen Melzer,6-4; 6-4,R64,65,9,0,33,48,30,33,10,15,0,0,10,40,48,9,2,37,61,24,37,12,24,2,4,10,36,61
2009-10-11 00:00:00.000,ATP World Tour Masters 1000 Shanghai China ATP World Tour Masters 1000,HARD,2,Feliciano Lopez,Guillermo Garcia-Lopez,Feliciano Lopez,6-3; 6-4,R64,83,7,1,41,62,33,41,11,21,2,2,10,44,62,1,1,42,59,32,42,6,17,3,5,9,38,59
2009-10-11 00:00:00.000,ATP World Tour Masters 1000 Shanghai China ATP World Tour Masters 1000,HARD,2,David Ferrer,Richard Gasquet,David Ferrer,6-4; 6-3,R64,86,1,2,36,55,25,36,10,19,1,3,9,35,55,0,1,44,73,27,44,9,29,9,14,10,36,73
2009-10-11 00:00:00.000,ATP World Tour Masters 1000 Shanghai China ATP World Tour Masters 1000,HARD,2,Robin Soderling,Victor Hanescu,Robin Soderling,6-3; 6-4,R64,74,9,2,35,52,29,35,10,17,2,3,10,39,52,4,1,51,67,28,51,8,16,3,6,9,36,67
2009-10-11 00:00:00.000,ATP World Tour Masters 1000 Shanghai China ATP World Tour Masters 1000,HARD,2,Nicolas Almagro,Philipp Kohlschreiber,Nicolas Almagro,6-7(2); 6-1; 7-6(6),R64,132,23,3,68,114,49,68,26,46,8,9,16,75,114,8,0,72,108,48,72,20,36,4,7,15,68,108
2009-10-11 00:00:00.000,ATP World Tour Masters 1000 Shanghai China ATP World Tour Masters 1000,HARD,2,Shao-Xuan Zeng,Dudi Sela,Shao-Xuan Zeng,2-6; 6-1; 6-4,R64,111,5,4,50,86,32,50,17,36,4,9,13,49,86,1,3,55,85,31,55,13,30,10,16,12,44,85
2009-10-11 00:00:00.000,ATP World Tour Masters 1000 Shanghai China ATP World Tour Masters 1000,HARD,2,Jo-Wilfried Tsonga,N/A Bye,Jo-Wilfried Tsonga,,R64,0,0,0,0,0,0,0,0,0,0,0,0,0,0,0,0,0,0,0,0,0,0,0,0,0,0,0
2009-10-11 00:00:00.000,ATP World Tour Masters 1000 Shanghai China ATP World Tour Masters 1000,HARD,2,Nikolay Davydenko,N/A Bye,Nikolay Davydenko,,R64,0,0,0,0,0,0,0,0,0,0,0,0,0,0,0,0,0,0,0,0,0,0,0,0,0,0,0
2009-10-11 00:00:00.000,ATP World Tour Masters 1000 Shanghai China ATP World Tour Masters 1000,HARD,2,Igor Kunitsyn,Igor Andreev,Igor Kunitsyn,6-7(6); 6-4; 6-2,R64,132,4,1,48,88,34,48,26,40,6,8,15,60,88,8,3,69,104,42,69,17,35,4,9,15,59,104
2009-10-11 00:00:00.000,ATP World Tour Masters 1000 Shanghai China ATP World Tour Masters 1000,HARD,2,Thomaz Bellucci,Marco Chiudinelli,Thomaz Bellucci,7-6(3); 6-4,R64,112,11,2,39,62,35,39,13,23,1,2,11,48,62,4,2,47,68,38,47,9,21,4,6,11,47,68
2009-10-11 00:00:00.000,ATP World Tour Masters 1000 Shanghai China ATP World Tour Masters 1000,HARD,2,Fernando Gonzalez,Mischa Zverev,Fernando Gonzalez,7-5; 6-7(0); 2-2 RET,R64,114,9,3,59,83,40,59,14,24,3,4,14,54,83,0,1,80,94,55,80,10,14,4,6,14,65,94
2009-10-11 00:00:00.000,ATP World Tour Masters 1000 Shanghai China ATP World Tour Masters 1000,HARD,2,Radek Stepanek,Juan Carlos Ferrero,Radek Stepanek,6-3; 6-0,R64,57,4,0,25,44,24,25,10,19,4,4,8,34,44,3,1,28,43,14,28,6,15,2,6,7,20,43
2009-10-11 00:00:00.000,ATP World Tour Masters 1000 Shanghai China ATP World Tour Masters 1000,HARD,2,Andreas Beck,Jose Acasuso,Andreas Beck,7-6(2); 1-0 RET,R64,62,5,1,21,35,16,21,9,14,0,1,6,25,35,5,6,27,50,20,27,9,23,3,5,7,29,50
2009-10-11 00:00:00.000,ATP World Tour Masters 1000 Shanghai China ATP World Tour Masters 1000,HARD,2,Stanislas Wawrinka,Lukasz Kubot,Stanislas Wawrinka,2-6; 7-6(5); 7-6(3),R64,190,12,1,66,115,49,66,31,49,5,7,16,80,115,5,3,74,113,54,74,24,39,5,5,16,78,113
2009-10-11 00:00:00.000,ATP World Tour Masters 1000 Shanghai China ATP World Tour Masters 1000,HARD,2,Andy Roddick,N/A Bye,Andy Roddick,,R64,0,0,0,0,0,0,0,0,0,0,0,0,0,0,0,0,0,0,0,0,0,0,0,0,0,0,0
2009-10-11 00:00:00.000,ATP World Tour Masters 1000 Shanghai China ATP World Tour Masters 1000,HARD,2,Gilles Simon,N/A Bye,Gilles Simon,,R64,0,0,0,0,0,0,0,0,0,0,0,0,0,0,0,0,0,0,0,0,0,0,0,0,0,0,0
2009-10-11 00:00:00.000,ATP World Tour Masters 1000 Shanghai China ATP World Tour Masters 1000,HARD,2,Viktor Troicki,Juan Monaco,Viktor Troicki,6-1; 6-2,R64,61,8,2,26,40,22,26,5,14,2,4,7,27,40,0,3,29,53,16,29,4,24,6,13,8,20,53
2009-10-11 00:00:00.000,ATP World Tour Masters 1000 Shanghai China ATP World Tour Masters 1000,HARD,2,Marat Safin,Mao-Xin Gong,Marat Safin,6-4; 6-4,R64,86,12,2,33,63,27,33,16,30,1,2,10,43,63,0,7,34,61,24,34,9,27,1,4,10,33,61
2009-10-11 00:00:00.000,ATP World Tour Masters 1000 Shanghai China ATP World Tour Masters 1000,HARD,2,Tomas Berdych,Marin Cilic,Tomas Berdych,7-6(8); 3-6; 6-4,R64,159,5,2,71,109,47,71,18,38,8,12,15,65,109,8,3,63,100,48,63,14,37,1,5,16,62,100
2009-10-11 00:00:00.000,ATP World Tour Masters 1000 Shanghai China ATP World Tour Masters 1000,HARD,2,Tommy Haas,Benjamin Becker,Tommy Haas,7-6(5); 6-4,R64,90,11,5,38,64,32,38,18,26,1,1,11,50,64,13,1,45,79,34,45,19,34,3,4,11,53,79
2009-10-11 00:00:00.000,ATP World Tour Masters 1000 Shanghai China ATP World Tour Masters 1000,HARD,2,Rainer Schuettler,Martin Vassallo Arguello,Rainer Schuettler,6-4; 3-6; 7-6(2),R64,150,1,2,58,85,41,58,14,27,0,4,15,55,85,2,2,64,96,45,64,16,32,4,8,16,61,96
2009-10-11 00:00:00.000,ATP World Tour Masters 1000 Shanghai China ATP World Tour Masters 1000,HARD,2,Fabio Fognini,Ernests Gulbis,Fabio Fognini,7-6(3); 6-3,R64,80,2,2,36,62,27,36,18,26,0,2,11,45,62,7,6,43,64,31,43,7,21,2,5,10,38,64
2009-10-11 00:00:00.000,ATP World Tour Masters 1000 Shanghai China ATP World Tour Masters 1000,HARD,2,Novak Djokovic,N/A Bye,Novak Djokovic,,R64,0,0,0,0,0,0,0,0,0,0,0,0,0,0,0,0,0,0,0,0,0,0,0,0,0,0,0
2009-10-11 00:00:00.000,ATP World Tour Masters 1000 Shanghai China ATP World Tour Masters 1000,HARD,2,Rafael Nadal,James Blake,Rafael Nadal,6-2; 6-7(4); 6-4,R32,132,6,1,62,85,48,62,11,23,1,3,15,59,85,5,4,60,99,40,60,16,39,3,8,15,56,99
2009-10-11 00:00:00.000,ATP World Tour Masters 1000 Shanghai China ATP World Tour Masters 1000,HARD,2,Tommy Robredo,Florian Mayer,Tommy Robredo,4-6; 7-6(10); 6-4,R32,128,9,4,72,105,52,72,19,33,3,5,16,71,105,10,3,67,109,52,67,20,42,5,7,16,72,109
2009-10-11 00:00:00.000,ATP World Tour Masters 1000 Shanghai China ATP World Tour Masters 1000,HARD,2,Gael Monfils,Lleyton Hewitt,Gael Monfils,4-6; 6-4; 6-2,R32,124,7,7,46,76,31,46,13,30,3,7,14,44,76,0,5,58,102,34,58,19,44,5,11,14,53,102
2009-10-11 00:00:00.000,ATP World Tour Masters 1000 Shanghai China ATP World Tour Masters 1000,HARD,2,Ivan Ljubicic,Fernando Verdasco,Ivan Ljubicic,6-4; 7-6(6),R32,94,8,0,42,64,36,42,10,22,0,1,11,46,64,8,2,51,66,32,51,10,15,1,3,11,42,66
2009-10-11 00:00:00.000,ATP World Tour Masters 1000 Shanghai China ATP World Tour Masters 1000,HARD,2,Jurgen Melzer,Juan Martin Del Potro,Jurgen Melzer,7-5; 2-1 RET,R32,75,6,1,27,45,22,27,10,18,3,4,8,32,45,4,2,35,54,23,35,8,19,4,6,7,31,54
2009-10-11 00:00:00.000,ATP World Tour Masters 1000 Shanghai China ATP World Tour Masters 1000,HARD,2,Feliciano Lopez,David Ferrer,Feliciano Lopez,4-6; 7-5; 6-1,R32,113,11,1,50,80,41,50,15,30,0,1,14,56,80,6,2,67,87,45,67,8,20,3,7,15,53,87
2009-10-11 00:00:00.000,ATP World Tour Masters 1000 Shanghai China ATP World Tour Masters 1000,HARD,2,Robin Soderling,Nicolas Almagro,Robin Soderling,6-4; 7-5,R32,82,9,6,39,67,31,39,15,28,2,3,11,46,67,12,1,49,73,35,49,8,24,6,9,11,43,73
2009-10-11 00:00:00.000,ATP World Tour Masters 1000 Shanghai China ATP World Tour Masters 1000,HARD,2,Jo-Wilfried Tsonga,Shao-Xuan Zeng,Jo-Wilfried Tsonga,6-3; 6-3,R32,61,3,0,29,42,26,29,10,13,0,0,9,36,42,0,0,37,57,26,37,7,20,4,7,9,33,57
2009-10-11 00:00:00.000,ATP World Tour Masters 1000 Shanghai China ATP World Tour Masters 1000,HARD,2,Nikolay Davydenko,Igor Kunitsyn,Nikolay Davydenko,6-4; 6-2,R32,72,8,1,32,51,27,32,11,19,1,1,9,38,51,3,1,27,50,18,27,12,23,2,5,9,30,50
2009-10-11 00:00:00.000,ATP World Tour Masters 1000 Shanghai China ATP World Tour Masters 1000,HARD,2,Fernando Gonzalez,Thomaz Bellucci,Fernando Gonzalez,6-3; 6-4,R32,82,5,2,40,60,32,40,13,20,3,3,10,45,60,2,2,31,59,21,31,16,28,9,11,9,37,59
2009-10-11 00:00:00.000,ATP World Tour Masters 1000 Shanghai China ATP World Tour Masters 1000,HARD,2,Radek Stepanek,Andreas Beck,Radek Stepanek,7-5; 6-4,R32,106,15,5,52,72,41,52,9,20,5,5,11,50,72,9,5,58,89,40,58,13,31,7,9,11,53,89
2009-10-11 00:00:00.000,ATP World Tour Masters 1000 Shanghai China ATP World Tour Masters 1000,HARD,2,Stanislas Wawrinka,Andy Roddick,Stanislas Wawrinka,3-4 RET,R32,36,2,2,13,25,9,13,7,12,2,2,3,16,25,4,0,16,22,13,16,4,6,0,0,4,17,22
2009-10-11 00:00:00.000,ATP World Tour Masters 1000 Shanghai China ATP World Tour Masters 1000,HARD,2,Gilles Simon,Viktor Troicki,Gilles Simon,6-3; 6-4,R32,66,3,2,37,60,28,37,14,23,2,3,10,42,60,2,0,35,46,24,35,5,11,2,5,9,29,46
2009-10-11 00:00:00.000,ATP World Tour Masters 1000 Shanghai China ATP World Tour Masters 1000,HARD,2,Tomas Berdych,Marat Safin,Tomas Berdych,3-6; 6-4; 6-4,R32,137,2,4,67,104,41,67,20,37,9,13,15,61,104,18,1,60,90,41,60,14,30,1,5,14,55,90
2009-10-11 00:00:00.000,ATP World Tour Masters 1000 Shanghai China ATP World Tour Masters 1000,HARD,2,Rainer Schuettler,Tommy Haas,Rainer Schuettler,6-4 RET,R32,40,3,1,16,26,16,16,4,10,0,0,5,20,26,4,3,21,35,19,21,3,14,3,4,5,22,35
2009-10-11 00:00:00.000,ATP World Tour Masters 1000 Shanghai China ATP World Tour Masters 1000,HARD,2,Novak Djokovic,Fabio Fognini,Novak Djokovic,6-3; 6-1,R32,70,3,1,29,50,24,29,10,21,3,4,8,34,50,2,2,39,50,21,39,2,11,2,7,8,23,50
2009-10-11 00:00:00.000,ATP World Tour Masters 1000 Shanghai China ATP World Tour Masters 1000,HARD,2,Rafael Nadal,Tommy Robredo,Rafael Nadal,6-1; 6-4,R16,93,0,2,42,57,29,42,9,15,1,2,9,38,57,2,2,33,57,20,33,9,24,6,10,8,29,57
2009-10-11 00:00:00.000,ATP World Tour Masters 1000 Shanghai China ATP World Tour Masters 1000,HARD,2,Ivan Ljubicic,Gael Monfils,Ivan Ljubicic,6-2; 3-0 RET,R16,37,5,0,19,25,17,19,3,6,0,0,5,20,25,0,2,33,39,16,33,2,6,1,5,6,18,39
2009-10-11 00:00:00.000,ATP World Tour Masters 1000 Shanghai China ATP World Tour Masters 1000,HARD,2,Feliciano Lopez,Jurgen Melzer,Feliciano Lopez,5-7; 7-6(3); 6-1,R16,128,15,3,57,100,44,57,24,43,4,6,16,68,100,17,4,52,94,40,52,20,42,1,4,15,60,94
2009-10-11 00:00:00.000,ATP World Tour Masters 1000 Shanghai China ATP World Tour Masters 1000,HARD,2,Robin Soderling,Jo-Wilfried Tsonga,Robin Soderling,6-3; 6-3,R16,70,8,2,34,50,26,34,11,16,1,2,9,37,50,5,1,29,52,18,29,10,23,4,8,9,28,52
2009-10-11 00:00:00.000,ATP World Tour Masters 1000 Shanghai China ATP World Tour Masters 1000,HARD,2,Nikolay Davydenko,Fernando Gonzalez,Nikolay Davydenko,6-3; 7-5,R16,81,2,1,32,47,29,32,9,15,0,1,10,38,47,8,1,42,69,33,42,8,27,4,8,11,41,69
2009-10-11 00:00:00.000,ATP World Tour Masters 1000 Shanghai China ATP World Tour Masters 1000,HARD,2,Radek Stepanek,Stanislas Wawrinka,Radek Stepanek,3-6; 7-6(5); 4-2 RET,R16,142,5,3,61,90,40,61,15,29,6,9,13,55,90,8,7,52,97,40,52,18,45,6,9,14,58,97
2009-10-11 00:00:00.000,ATP World Tour Masters 1000 Shanghai China ATP World Tour Masters 1000,HARD,2,Gilles Simon,Tomas Berdych,Gilles Simon,6-3; 6-4,R16,91,6,1,41,68,31,41,14,27,6,7,10,45,68,3,4,33,61,22,33,12,28,3,6,9,34,61
2009-10-11 00:00:00.000,ATP World Tour Masters 1000 Shanghai China ATP World Tour Masters 1000,HARD,2,Novak Djokovic,Rainer Schuettler,Novak Djokovic,6-4; 6-2,R16,84,5,3,29,48,22,29,12,19,0,1,9,34,48,0,3,32,63,20,32,13,31,5,9,9,33,63
2009-10-11 00:00:00.000,ATP World Tour Masters 1000 Shanghai China ATP World Tour Masters 1000,HARD,2,Rafael Nadal,Ivan Ljubicic,Rafael Nadal,3-6; 6-3 RET,Q,96,2,2,41,55,28,41,10,14,5,6,9,38,55,12,3,40,62,28,40,11,22,5,6,9,39,62
2009-10-11 00:00:00.000,ATP World Tour Masters 1000 Shanghai China ATP World Tour Masters 1000,HARD,2,Feliciano Lopez,Robin Soderling,Feliciano Lopez,7-6(4); 6-3,Q,103,10,1,41,75,28,41,24,34,3,4,11,52,75,11,3,37,58,29,37,11,21,3,5,10,40,58
2009-10-11 00:00:00.000,ATP World Tour Masters 1000 Shanghai China ATP World Tour Masters 1000,HARD,2,Nikolay Davydenko,Radek Stepanek,Nikolay Davydenko,6-1; 4-6; 6-1,Q,122,5,2,60,87,40,60,13,27,7,9,12,53,87,7,2,51,92,33,51,14,41,8,14,12,47,92
2009-10-11 00:00:00.000,ATP World Tour Masters 1000 Shanghai China ATP World Tour Masters 1000,HARD,2,Novak Djokovic,Gilles Simon,Novak Djokovic,6-3; 2-6; 6-2,Q,144,1,5,52,84,32,52,14,32,4,9,13,46,84,4,1,51,97,31,51,19,46,8,14,12,50,97
2009-10-11 00:00:00.000,ATP World Tour Masters 1000 Shanghai China ATP World Tour Masters 1000,HARD,2,Rafael Nadal,Feliciano Lopez,Rafael Nadal,6-1; 3-0 RET,S,51,1,0,14,24,12,14,8,10,0,0,5,20,24,1,0,12,31,5,12,5,19,1,5,5,10,31
2009-10-11 00:00:00.000,ATP World Tour Masters 1000 Shanghai China ATP World Tour Masters 1000,HARD,2,Nikolay Davydenko,Novak Djokovic,Nikolay Davydenko,4-6; 6-4; 7-6(1),S,183,5,1,66,99,49,66,18,33,6,7,16,67,99,5,2,77,120,50,77,26,43,8,9,16,76,120
2009-10-11 00:00:00.000,ATP World Tour Masters 1000 Shanghai China ATP World Tour Masters 1000,HARD,2,Nikolay Davydenko,Rafael Nadal,Nikolay Davydenko,7-6(3); 6-3,F,123,4,1,53,76,39,53,12,23,3,4,11,51,76,1,0,42,61,29,42,9,19,5,7,10,38,61
2009-10-19 00:00:00.000,Moscow Russia ATP World Tour 250,HARD,2,Marat Safin,Nikolay Davydenko,Marat Safin,4-6; 6-4; 6-2,R32,116,10,2,42,77,30,42,25,35,1,2,14,55,77,7,4,55,93,37,55,20,38,5,8,14,57,93
2009-10-19 00:00:00.000,Moscow Russia ATP World Tour 250,HARD,2,Evgeny Korolev,Igor Kunitsyn,Evgeny Korolev,7-6(6); 6-3,R32,79,8,1,43,67,34,43,15,24,1,2,11,49,67,6,1,36,62,24,36,17,26,3,5,10,41,62
2009-10-19 00:00:00.000,Moscow Russia ATP World Tour 250,HARD,2,Illya Marchenko,Denis Istomin,Illya Marchenko,1-6; 6-4; 4-1 RET,R32,110,2,5,41,77,26,41,21,36,9,12,11,47,77,3,0,53,70,34,53,8,17,2,5,11,42,70
2009-10-19 00:00:00.000,Moscow Russia ATP World Tour 250,HARD,2,Andrey Golubev,Martin Vassallo Arguello,Andrey Golubev,7-5; 6-3,R32,87,3,1,29,54,26,29,18,25,1,1,10,44,54,0,1,50,70,33,50,10,20,2,5,11,43,70
2009-10-19 00:00:00.000,Moscow Russia ATP World Tour 250,HARD,2,Robby Ginepri,Igor Andreev,Robby Ginepri,6-3; 6-7(9); 7-6(1),R32,152,8,1,85,128,65,85,17,43,6,9,17,82,128,8,3,70,101,50,70,16,31,5,9,16,66,101
2009-10-19 00:00:00.000,Moscow Russia ATP World Tour 250,HARD,2,Marcel Granollers,Nicolas Kiefer,Marcel Granollers,6-4; 1-0 RET,R32,68,1,0,26,46,14,26,10,20,6,8,5,24,46,2,1,18,33,10,18,3,15,2,6,6,13,33
2009-10-19 00:00:00.000,Moscow Russia ATP World Tour 250,HARD,2,Christophe Rochus,Marc Gicquel,Christophe Rochus,7-5 RET,R32,51,2,2,24,40,16,24,9,16,3,4,6,25,40,5,1,21,37,14,21,6,16,1,3,6,20,37
2009-10-19 00:00:00.000,Moscow Russia ATP World Tour 250,HARD,2,Janko Tipsarevic,Daniel Koellerer,Janko Tipsarevic,6-4; 6-3,R32,83,10,2,31,51,28,31,9,20,1,2,10,37,51,0,1,35,49,26,35,6,14,1,4,9,32,49
2009-10-19 00:00:00.000,Moscow Russia ATP World Tour 250,HARD,2,Fabrice Santoro,Andrey Kuznetsov,Fabrice Santoro,4-6; 6-2; 6-2,R32,117,6,1,49,92,37,49,19,43,8,11,13,56,92,3,1,42,76,23,42,18,34,3,9,13,41,76
2009-10-19 00:00:00.000,Moscow Russia ATP World Tour 250,HARD,2,Sergiy Stakhovsky,Mikhail Biryukov,Sergiy Stakhovsky,6-0; 6-2,R32,48,5,0,35,46,29,35,4,11,3,3,7,33,46,0,1,23,41,12,23,5,18,3,8,7,17,41
2009-10-19 00:00:00.000,Moscow Russia ATP World Tour 250,HARD,2,Potito Starace,Evgeny Donskoy,Potito Starace,6-3; 6-3,R32,68,1,0,44,56,33,44,7,12,1,1,9,40,56,6,1,21,50,17,21,15,29,4,7,9,32,50
2009-10-19 00:00:00.000,Moscow Russia ATP World Tour 250,HARD,2,Mikhail Youzhny,Horacio Zeballos,Mikhail Youzhny,6-1; 7-6(5),R32,87,8,1,37,50,32,37,6,13,0,1,9,38,50,4,1,49,74,31,49,9,25,5,9,10,40,74
2009-10-19 00:00:00.000,Moscow Russia ATP World Tour 250,HARD,2,Pablo Cuevas,Yen-Hsun Lu,Pablo Cuevas,6-4; 6-2,R32,60,9,1,40,50,33,40,5,10,1,1,9,38,50,1,4,27,50,22,27,8,23,0,3,9,30,50
2009-10-19 00:00:00.000,Moscow Russia ATP World Tour 250,HARD,2,Teymuraz Gabashvili,Karol Beck,Teymuraz Gabashvili,3-6; 6-4; 6-4,R32,164,9,7,38,96,25,38,28,58,10,15,14,53,96,4,2,51,97,34,51,19,46,8,14,15,53,97
2009-10-19 00:00:00.000,Moscow Russia ATP World Tour 250,HARD,2,Mikhail Kukushkin,Fabio Fognini,Mikhail Kukushkin,6-4; 5-7; 6-4,R32,147,2,4,40,85,28,40,24,45,0,5,16,52,85,9,1,78,119,48,78,16,41,12,18,16,64,119
2009-10-19 00:00:00.000,Moscow Russia ATP World Tour 250,HARD,2,Wayne Odesnik,Victor Hanescu,Wayne Odesnik,5-7; 7-5; 6-4,R32,135,7,1,64,98,45,64,13,34,2,7,17,58,98,4,2,61,97,42,61,14,36,5,11,17,56,97
2009-10-19 00:00:00.000,Moscow Russia ATP World Tour 250,HARD,2,Evgeny Korolev,Marat Safin,Evgeny Korolev,6-4; 7-6(4),R16,90,7,0,43,72,32,43,14,29,3,5,11,46,72,6,2,40,69,30,40,11,29,4,7,11,41,69
2009-10-19 00:00:00.000,Moscow Russia ATP World Tour 250,HARD,2,Illya Marchenko,Andrey Golubev,Illya Marchenko,6-1; 1-6; 6-4,R16,105,0,2,39,66,23,39,15,27,1,5,12,38,66,5,1,47,71,28,47,10,24,3,8,12,38,71
2009-10-19 00:00:00.000,Moscow Russia ATP World Tour 250,HARD,2,Robby Ginepri,Marcel Granollers,Robby Ginepri,7-6(5); 6-0,R16,91,7,0,39,69,28,39,18,30,9,10,9,46,69,0,2,42,63,24,42,10,21,5,9,9,34,63
2009-10-19 00:00:00.000,Moscow Russia ATP World Tour 250,HARD,2,Janko Tipsarevic,Christophe Rochus,Janko Tipsarevic,6-4; 2-1 RET,R16,63,13,2,26,41,19,26,7,15,2,3,6,26,41,2,3,32,49,21,32,5,17,2,5,7,26,49
2009-10-19 00:00:00.000,Moscow Russia ATP World Tour 250,HARD,2,Sergiy Stakhovsky,Fabrice Santoro,Sergiy Stakhovsky,7-5; 6-1,R16,73,11,0,43,62,32,43,13,19,3,3,10,45,62,1,1,28,56,16,28,18,28,3,6,9,34,56
2009-10-19 00:00:00.000,Moscow Russia ATP World Tour 250,HARD,2,Mikhail Youzhny,Potito Starace,Mikhail Youzhny,6-1; 6-1,R16,54,5,0,22,33,20,22,8,11,0,0,7,28,33,1,2,28,41,14,28,4,13,6,11,7,18,41
2009-10-19 00:00:00.000,Moscow Russia ATP World Tour 250,HARD,2,Pablo Cuevas,Teymuraz Gabashvili,Pablo Cuevas,3-6; 6-1; 6-4,R16,117,9,3,46,70,37,46,14,24,0,1,13,51,70,4,3,41,82,28,41,25,41,1,4,13,53,82
2009-10-19 00:00:00.000,Moscow Russia ATP World Tour 250,HARD,2,Mikhail Kukushkin,Wayne Odesnik,Mikhail Kukushkin,6-3; 6-4,R16,101,6,2,47,75,34,47,16,28,9,9,10,50,75,3,1,38,52,26,38,8,14,4,6,9,34,52
2009-10-19 00:00:00.000,Moscow Russia ATP World Tour 250,HARD,2,Illya Marchenko,Evgeny Korolev,Illya Marchenko,0-6; 6-2; 6-3,Q,95,3,5,35,67,24,35,11,32,2,7,12,35,67,9,1,38,57,24,38,6,19,1,6,11,30,57
2009-10-19 00:00:00.000,Moscow Russia ATP World Tour 250,HARD,2,Janko Tipsarevic,Robby Ginepri,Janko Tipsarevic,6-3; 6-3,Q,71,10,2,28,50,26,28,12,22,1,1,9,38,50,5,0,34,53,19,34,11,19,5,8,9,30,53
2009-10-19 00:00:00.000,Moscow Russia ATP World Tour 250,HARD,2,Mikhail Youzhny,Sergiy Stakhovsky,Mikhail Youzhny,6-3; 6-3,Q,72,5,1,28,46,23,28,11,18,3,5,9,34,46,3,4,33,58,21,33,7,25,4,9,9,28,58
2009-10-19 00:00:00.000,Moscow Russia ATP World Tour 250,HARD,2,Mikhail Kukushkin,Pablo Cuevas,Mikhail Kukushkin,4-6; 6-1; 6-4,Q,127,5,1,51,89,39,51,18,38,7,9,14,57,89,6,1,51,86,33,51,19,35,10,14,13,52,86
2009-10-19 00:00:00.000,Moscow Russia ATP World Tour 250,HARD,2,Janko Tipsarevic,Illya Marchenko,Janko Tipsarevic,6-1; 6-4,S,90,5,0,32,45,27,32,9,13,0,0,9,36,45,2,0,32,59,19,32,13,27,6,9,8,32,59
2009-10-19 00:00:00.000,Moscow Russia ATP World Tour 250,HARD,2,Mikhail Youzhny,Mikhail Kukushkin,Mikhail Youzhny,6-2; 6-1,S,69,6,0,21,39,17,21,10,18,1,2,7,27,39,1,1,33,52,18,33,4,19,3,9,8,22,52
2009-10-19 00:00:00.000,Moscow Russia ATP World Tour 250,HARD,2,Mikhail Youzhny,Janko Tipsarevic,Mikhail Youzhny,6-7(5); 6-0; 6-4,F,165,14,1,49,79,42,49,17,30,2,3,14,59,79,8,3,71,116,43,71,22,45,13,18,14,65,116
2009-10-19 00:00:00.000,Stockholm Sweden ATP World Tour 250,HARD,2,Robin Soderling,Giovanni Lapentti,Robin Soderling,6-3; 6-0,R32,64,9,1,27,40,23,27,10,13,1,1,8,33,40,2,5,33,56,18,33,8,23,6,10,7,26,56
2009-10-19 00:00:00.000,Stockholm Sweden ATP World Tour 250,HARD,2,Andreas Seppi,Victor Crivoi,Andreas Seppi,6-4; 6-1,R32,66,6,3,29,53,23,29,13,24,1,3,9,36,53,1,4,40,57,19,40,9,17,4,9,8,28,57
2009-10-19 00:00:00.000,Stockholm Sweden ATP World Tour 250,HARD,2,Guillermo Garcia-Lopez,Alberto Martin,Guillermo Garcia-Lopez,6-3; 6-2,R32,76,2,3,38,59,26,38,9,21,6,7,8,35,59,1,2,26,52,12,26,13,26,3,8,9,25,52
2009-10-19 00:00:00.000,Stockholm Sweden ATP World Tour 250,HARD,2,Simon Greul,Benjamin Becker,Simon Greul,2-6; 6-3; 7-5,R32,103,7,4,46,84,38,46,20,38,1,4,15,58,84,12,3,43,82,36,43,19,39,1,4,14,55,82
2009-10-19 00:00:00.000,Stockholm Sweden ATP World Tour 250,HARD,2,Marcos Baghdatis,Juan Carlos Ferrero,Marcos Baghdatis,6-4; 6-2,R32,85,13,1,33,59,28,33,10,26,1,2,9,38,59,3,4,35,60,21,35,10,25,3,7,9,31,60
2009-10-19 00:00:00.000,Stockholm Sweden ATP World Tour 250,HARD,2,Robert Kendrick,Oscar Hernandez,Robert Kendrick,6-3; 6-4,R32,79,8,0,34,57,24,34,14,23,5,7,10,38,57,3,4,33,61,22,33,10,28,5,9,9,32,61
2009-10-19 00:00:00.000,Stockholm Sweden ATP World Tour 250,HARD,2,Michael Berrer,Henri Kontinen,Michael Berrer,7-5; 7-6(7),R32,129,4,5,61,86,46,61,12,25,3,4,12,58,86,8,2,60,96,40,60,16,36,10,12,12,56,96
2009-10-19 00:00:00.000,Stockholm Sweden ATP World Tour 250,HARD,2,Arnaud Clement,Andreas Beck,Arnaud Clement,6-4; 6-2,R32,76,3,3,25,48,23,25,15,23,2,2,9,38,48,6,3,23,55,21,23,11,32,3,6,9,32,55
2009-10-19 00:00:00.000,Stockholm Sweden ATP World Tour 250,HARD,2,Leonardo Mayer,Albert Montanes,Leonardo Mayer,6-4; 6-3,R32,73,3,4,30,51,25,30,9,21,1,3,9,34,51,0,4,44,66,25,44,8,22,4,9,10,33,66
2009-10-19 00:00:00.000,Stockholm Sweden ATP World Tour 250,HARD,2,Thomaz Bellucci,Frederik Nielsen,Thomaz Bellucci,7-6(6); 6-3,R32,91,10,1,39,73,30,39,18,34,5,6,10,48,73,2,0,61,77,37,61,8,16,7,10,11,45,77
2009-10-19 00:00:00.000,Stockholm Sweden ATP World Tour 250,HARD,2,Joachim Johansson,Peter Luczak,Joachim Johansson,7-5; 6-2,R32,83,21,4,36,51,33,36,8,15,1,1,10,41,51,8,7,43,74,32,43,11,31,5,8,10,43,74
2009-10-19 00:00:00.000,Stockholm Sweden ATP World Tour 250,HARD,2,Juan Monaco,Jan Hernych,Juan Monaco,6-2; 5-7; 7-5,R32,129,3,10,58,103,36,58,24,45,7,11,16,60,103,4,4,72,107,43,72,16,35,6,12,16,59,107
2009-10-19 00:00:00.000,Stockholm Sweden ATP World Tour 250,HARD,2,Feliciano Lopez,Ernests Gulbis,Feliciano Lopez,6-2; 6-4,R32,54,8,3,34,46,27,34,7,12,2,3,9,34,46,4,2,37,54,18,37,10,17,0,4,9,28,54
2009-10-19 00:00:00.000,Stockholm Sweden ATP World Tour 250,HARD,2,Olivier Rochus,Andreas Vinciguerra,Olivier Rochus,6-3; 6-2,R32,68,2,0,35,49,29,35,7,14,0,0,9,36,49,5,1,29,45,19,29,9,16,3,6,8,28,45
2009-10-19 00:00:00.000,Stockholm Sweden ATP World Tour 250,HARD,2,Jarkko Nieminen,Grigor Dimitrov,Jarkko Nieminen,6-0; 6-2,R32,50,1,1,27,35,23,27,6,8,0,0,7,29,35,1,3,16,39,10,16,7,23,0,5,7,17,39
2009-10-19 00:00:00.000,Stockholm Sweden ATP World Tour 250,HARD,2,Tommy Haas,Florent Serra,Tommy Haas,6-3; 6-4,R32,56,17,4,35,53,31,35,11,18,0,0,10,42,53,3,1,33,48,24,33,10,15,2,4,9,34,48
2009-10-19 00:00:00.000,Stockholm Sweden ATP World Tour 250,HARD,2,Robin Soderling,Andreas Seppi,Robin Soderling,6-1; 6-3,R16,63,3,3,25,43,18,25,13,18,1,2,8,31,43,0,3,30,54,15,30,10,24,4,9,8,25,54
2009-10-19 00:00:00.000,Stockholm Sweden ATP World Tour 250,HARD,2,Guillermo Garcia-Lopez,Simon Greul,Guillermo Garcia-Lopez,6-3; 7-5,R16,92,5,5,37,62,29,37,12,25,1,2,10,41,62,2,3,36,66,26,36,10,30,3,7,11,36,66
2009-10-19 00:00:00.000,Stockholm Sweden ATP World Tour 250,HARD,2,Marcos Baghdatis,Robert Kendrick,Marcos Baghdatis,6-2; 6-2,R16,53,7,0,20,40,17,20,13,20,0,1,8,30,40,3,0,29,42,16,29,2,13,0,5,8,18,42
2009-10-19 00:00:00.000,Stockholm Sweden ATP World Tour 250,HARD,2,Arnaud Clement,Michael Berrer,Arnaud Clement,3-6; 7-6(7); 6-1,R16,148,6,1,65,115,44,65,27,50,7,10,15,71,115,12,2,54,77,37,54,10,23,1,4,13,47,77
2009-10-19 00:00:00.000,Stockholm Sweden ATP World Tour 250,HARD,2,Thomaz Bellucci,Leonardo Mayer,Thomaz Bellucci,7-5; 3-6; 6-3,R16,137,6,3,56,95,40,56,20,39,6,10,15,60,95,3,2,56,92,39,56,16,36,4,9,15,55,92
2009-10-19 00:00:00.000,Stockholm Sweden ATP World Tour 250,HARD,2,Joachim Johansson,Juan Monaco,Joachim Johansson,6-4; 6-4,R16,63,11,1,35,48,32,35,9,13,0,0,10,41,48,6,3,38,58,25,38,13,20,1,3,10,38,58
2009-10-19 00:00:00.000,Stockholm Sweden ATP World Tour 250,HARD,2,Olivier Rochus,Feliciano Lopez,Olivier Rochus,4-6; 6-4; 6-1,R16,115,4,1,65,88,41,65,17,23,4,5,14,58,88,15,3,39,69,32,39,14,30,0,3,13,46,69
2009-10-19 00:00:00.000,Stockholm Sweden ATP World Tour 250,HARD,2,Jarkko Nieminen,Tommy Haas,Jarkko Nieminen,W/O,R16,0,0,0,0,0,0,0,0,0,0,0,0,0,0,0,0,0,0,0,0,0,0,0,0,0,0,0
2009-10-19 00:00:00.000,Stockholm Sweden ATP World Tour 250,HARD,2,Robin Soderling,Guillermo Garcia-Lopez,Robin Soderling,7-6(4); 6-4,Q,104,8,3,38,69,29,38,18,31,3,5,11,47,69,6,5,46,71,28,46,13,25,4,7,11,41,71
2009-10-19 00:00:00.000,Stockholm Sweden ATP World Tour 250,HARD,2,Marcos Baghdatis,Arnaud Clement,Marcos Baghdatis,6-4; 6-4,Q,88,6,3,30,55,24,30,15,25,3,4,10,39,55,1,4,34,62,22,34,13,28,2,5,10,35,62
2009-10-19 00:00:00.000,Stockholm Sweden ATP World Tour 250,HARD,2,Thomaz Bellucci,Joachim Johansson,Thomaz Bellucci,7-6(4); 6-3,Q,82,18,1,42,68,37,42,15,26,1,1,11,52,68,13,0,43,62,34,43,12,19,4,5,10,46,62
2009-10-19 00:00:00.000,Stockholm Sweden ATP World Tour 250,HARD,2,Olivier Rochus,Jarkko Nieminen,Olivier Rochus,6-3; 2-6; 6-1,Q,107,4,2,51,69,31,51,8,18,1,5,12,39,69,8,3,45,77,28,45,10,32,3,9,12,38,77
2009-10-19 00:00:00.000,Stockholm Sweden ATP World Tour 250,HARD,2,Marcos Baghdatis,Robin Soderling,Marcos Baghdatis,W/O,S,0,0,0,0,0,0,0,0,0,0,0,0,0,0,0,0,0,0,0,0,0,0,0,0,0,0,0
2009-10-19 00:00:00.000,Stockholm Sweden ATP World Tour 250,HARD,2,Olivier Rochus,Thomaz Bellucci,Olivier Rochus,7-6(4); 4-6; 6-3,S,143,4,1,65,91,50,65,16,26,2,6,16,66,91,17,2,52,92,39,52,17,40,5,9,15,56,92
2009-10-19 00:00:00.000,Stockholm Sweden ATP World Tour 250,HARD,2,Marcos Baghdatis,Olivier Rochus,Marcos Baghdatis,6-1; 7-5,F,99,15,2,37,65,30,37,10,28,4,6,10,40,65,0,4,35,63,21,35,11,28,5,10,9,32,63
2009-10-25 00:00:00.000,St. Petersburg Russia ATP World Tour 250,HARD,2,Mikhail Youzhny,Andrey Golubev,Mikhail Youzhny,6-3; 6-2,R32,71,0,0,28,47,21,28,15,19,0,0,9,36,47,1,3,32,52,16,32,13,20,3,6,8,29,52
2009-10-25 00:00:00.000,St. Petersburg Russia ATP World Tour 250,HARD,2,Denis Istomin,Rainer Schuettler,Denis Istomin,6-4; 6-4,R32,81,2,1,46,61,36,46,8,15,4,5,10,44,61,7,2,41,65,27,41,11,24,5,8,10,38,65
2009-10-25 00:00:00.000,St. Petersburg Russia ATP World Tour 250,HARD,2,Marat Safin,Richard Gasquet,Marat Safin,7-6(5); 6-4,R32,101,14,2,50,84,36,50,18,34,4,5,11,54,84,6,4,36,70,27,36,18,34,5,7,11,45,70
2009-10-25 00:00:00.000,St. Petersburg Russia ATP World Tour 250,HARD,2,Igor Andreev,Potito Starace,Igor Andreev,6-4; 6-2,R32,85,4,2,43,69,32,43,13,26,6,7,9,45,69,0,2,35,61,16,35,15,26,1,5,9,31,61
2009-10-25 00:00:00.000,St. Petersburg Russia ATP World Tour 250,HARD,2,Karol Beck,Viktor Troicki,Karol Beck,7-6(4); 4-6; 6-4,R32,154,8,2,68,104,54,68,18,36,3,5,16,72,104,10,4,64,107,53,64,15,43,5,7,16,68,107
2009-10-25 00:00:00.000,St. Petersburg Russia ATP World Tour 250,HARD,2,Bjorn Phau,Stanislav Vovk,Bjorn Phau,6-3; 6-2,R32,78,1,2,21,42,18,21,15,21,1,1,8,33,42,1,2,40,70,24,40,13,30,3,7,9,37,70
2009-10-25 00:00:00.000,St. Petersburg Russia ATP World Tour 250,HARD,2,Andrey Kuznetsov,Marcel Granollers,Andrey Kuznetsov,6-7(4); 7-6(6); 6-4,R32,172,8,4,69,116,52,69,24,47,6,8,17,76,116,7,3,86,132,57,86,25,46,3,6,17,82,132
2009-10-25 00:00:00.000,St. Petersburg Russia ATP World Tour 250,HARD,2,Sergiy Stakhovsky,Evgeny Korolev,Sergiy Stakhovsky,6-4; 6-3,R32,59,6,0,32,47,28,32,12,15,0,0,10,40,47,0,2,39,52,24,39,8,13,3,5,9,32,52
2009-10-25 00:00:00.000,St. Petersburg Russia ATP World Tour 250,HARD,2,Horacio Zeballos,Yuri Schukin,Horacio Zeballos,7-6(9); 6-3,R32,99,17,4,46,71,36,46,13,25,2,3,11,49,71,7,3,53,81,39,53,11,28,3,5,10,50,81
2009-10-25 00:00:00.000,St. Petersburg Russia ATP World Tour 250,HARD,2,Alexandr Dolgopolov,Robby Ginepri,Alexandr Dolgopolov,6-2; 1-0 RET,R32,29,1,0,16,23,13,16,4,7,0,0,4,17,23,3,1,18,33,13,18,3,15,0,3,5,16,33
2009-10-25 00:00:00.000,St. Petersburg Russia ATP World Tour 250,HARD,2,Ernests Gulbis,Florian Mayer,Ernests Gulbis,6-3; 7-6(3),R32,64,3,5,55,79,45,55,11,24,7,7,11,56,79,1,0,45,59,35,45,7,14,3,4,10,42,59
2009-10-25 00:00:00.000,St. Petersburg Russia ATP World Tour 250,HARD,2,Jeremy Chardy,Petru-Alexandru Luncanu,Jeremy Chardy,6-2; 6-2,R32,63,6,0,30,39,24,30,8,9,0,0,8,32,39,0,4,34,65,20,34,12,31,7,11,8,32,65
2009-10-25 00:00:00.000,St. Petersburg Russia ATP World Tour 250,HARD,2,Igor Kunitsyn,Pablo Cuevas,Igor Kunitsyn,6-4; 6-3,R32,70,1,0,44,61,30,44,10,17,3,5,10,40,61,2,6,31,57,19,31,9,26,5,9,9,28,57
2009-10-25 00:00:00.000,St. Petersburg Russia ATP World Tour 250,HARD,2,Mikhail Elgin,Mikhail Kukushkin,Mikhail Elgin,6-3; 6-3,R32,92,11,1,44,70,35,44,11,26,5,5,9,46,70,2,1,39,70,22,39,16,31,7,10,9,38,70
2009-10-25 00:00:00.000,St. Petersburg Russia ATP World Tour 250,HARD,2,Illya Marchenko,Fabio Fognini,Illya Marchenko,6-4; 6-1,R32,62,1,3,34,51,29,34,10,17,2,2,9,39,51,2,4,29,55,17,29,13,26,4,7,8,30,55
2009-10-25 00:00:00.000,St. Petersburg Russia ATP World Tour 250,HARD,2,Victor Hanescu,Teymuraz Gabashvili,Victor Hanescu,6-1; 6-2,R32,59,4,0,30,43,27,30,7,13,2,2,8,34,43,1,4,29,44,17,29,5,15,4,8,7,22,44
2009-10-25 00:00:00.000,St. Petersburg Russia ATP World Tour 250,HARD,2,Denis Istomin,Mikhail Youzhny,Denis Istomin,6-2; 2-1 RET,R16,51,0,0,33,38,24,33,3,5,2,2,6,27,38,3,1,18,32,10,18,6,14,1,3,5,16,32
2009-10-25 00:00:00.000,St. Petersburg Russia ATP World Tour 250,HARD,2,Marat Safin,Igor Andreev,Marat Safin,6-3; 0-1 RET,R16,41,4,0,17,31,15,17,6,14,0,0,5,21,31,0,0,29,37,20,29,2,8,2,3,5,22,37
2009-10-25 00:00:00.000,St. Petersburg Russia ATP World Tour 250,HARD,2,Bjorn Phau,Karol Beck,Bjorn Phau,6-4; 2-1 RET,R16,50,1,1,18,32,13,18,9,14,1,2,6,22,32,3,1,16,37,10,16,9,21,0,3,7,19,37
2009-10-25 00:00:00.000,St. Petersburg Russia ATP World Tour 250,HARD,2,Sergiy Stakhovsky,Andrey Kuznetsov,Sergiy Stakhovsky,6-1; 6-4,R16,62,7,0,32,53,26,32,14,21,3,3,9,40,53,2,2,25,42,17,25,7,17,1,4,8,24,42
2009-10-25 00:00:00.000,St. Petersburg Russia ATP World Tour 250,HARD,2,Horacio Zeballos,Alexandr Dolgopolov,Horacio Zeballos,6-3; 6-1,R16,49,4,1,30,42,23,30,9,12,0,0,8,32,42,8,2,32,49,20,32,6,17,2,6,8,26,49
2009-10-25 00:00:00.000,St. Petersburg Russia ATP World Tour 250,HARD,2,Ernests Gulbis,Jeremy Chardy,Ernests Gulbis,7-6(7); 6-3,R16,95,22,4,52,73,46,52,8,21,3,4,11,54,73,9,2,49,83,37,49,14,34,8,10,10,51,83
2009-10-25 00:00:00.000,St. Petersburg Russia ATP World Tour 250,HARD,2,Igor Kunitsyn,Mikhail Elgin,Igor Kunitsyn,6-2; 6-3,R16,69,3,0,43,63,29,43,13,20,2,2,9,42,63,6,1,30,47,20,30,5,17,3,6,8,25,47
2009-10-25 00:00:00.000,St. Petersburg Russia ATP World Tour 250,HARD,2,Victor Hanescu,Illya Marchenko,Victor Hanescu,6-3; 6-4,R16,79,7,1,36,54,32,36,9,18,0,0,10,41,54,1,1,34,55,26,34,9,21,0,2,9,35,55
2009-10-25 00:00:00.000,St. Petersburg Russia ATP World Tour 250,HARD,2,Marat Safin,Denis Istomin,Marat Safin,6-0; 7-6(4),Q,82,12,1,31,51,26,31,10,20,0,2,9,36,51,4,0,55,76,32,55,7,21,10,15,9,39,76
2009-10-25 00:00:00.000,St. Petersburg Russia ATP World Tour 250,HARD,2,Sergiy Stakhovsky,Bjorn Phau,Sergiy Stakhovsky,6-2; 7-5,Q,90,4,1,49,72,35,49,13,23,1,2,10,48,72,1,4,39,67,27,39,9,28,5,9,10,36,67
2009-10-25 00:00:00.000,St. Petersburg Russia ATP World Tour 250,HARD,2,Horacio Zeballos,Ernests Gulbis,Horacio Zeballos,7-6(8); 6-4,Q,92,3,0,52,80,38,52,18,28,6,6,11,56,80,18,4,47,65,37,47,11,18,1,2,11,48,65
2009-10-25 00:00:00.000,St. Petersburg Russia ATP World Tour 250,HARD,2,Igor Kunitsyn,Victor Hanescu,Igor Kunitsyn,6-3; 3-6; 7-6(6),Q,132,4,1,75,99,52,75,14,24,7,9,15,66,99,5,1,78,95,55,78,8,17,5,7,15,63,95
2009-10-25 00:00:00.000,St. Petersburg Russia ATP World Tour 250,HARD,2,Sergiy Stakhovsky,Marat Safin,Sergiy Stakhovsky,6-4; 4-6; 6-4,S,108,7,3,68,98,49,68,14,30,4,6,15,63,98,10,3,40,72,32,40,18,32,1,4,15,50,72
2009-10-25 00:00:00.000,St. Petersburg Russia ATP World Tour 250,HARD,2,Horacio Zeballos,Igor Kunitsyn,Horacio Zeballos,7-6(7); 6-3,S,85,10,2,52,74,39,52,10,22,1,2,11,49,74,3,0,41,59,30,41,10,18,0,2,10,40,59
2009-10-25 00:00:00.000,St. Petersburg Russia ATP World Tour 250,HARD,2,Sergiy Stakhovsky,Horacio Zeballos,Sergiy Stakhovsky,2-6; 7-6(8); 7-6(7),F,139,9,3,69,103,53,69,13,34,7,11,16,66,103,1,2,68,99,49,68,19,31,1,3,16,68,99
2009-10-26 00:00:00.000,Lyon France ATP World Tour 250,HARD,2,Jo-Wilfried Tsonga,Kevin Kim,Jo-Wilfried Tsonga,7-6(5); 7-6(5),R32,96,14,2,52,75,47,52,11,23,0,0,12,58,75,5,3,59,83,47,59,12,24,2,2,12,59,83
2009-10-26 00:00:00.000,Lyon France ATP World Tour 250,HARD,2,Olivier Rochus,Vincent Millot,Olivier Rochus,6-3; 6-2,R32,82,1,1,35,53,23,35,14,18,1,2,9,37,53,2,0,36,58,23,36,5,22,5,9,8,28,58
2009-10-26 00:00:00.000,Lyon France ATP World Tour 250,HARD,2,Arnaud Clement,Oscar Hernandez,Arnaud Clement,6-1; 6-3,R32,68,6,0,26,44,17,26,10,18,0,2,8,27,44,3,5,33,54,17,33,5,21,6,12,8,22,54
2009-10-26 00:00:00.000,Lyon France ATP World Tour 250,HARD,2,Benjamin Becker,Paolo Lorenzi,Benjamin Becker,6-2; 6-2,R32,53,10,0,26,39,26,26,6,13,0,0,8,32,39,2,2,25,46,16,25,6,21,2,6,8,22,46
2009-10-26 00:00:00.000,Lyon France ATP World Tour 250,HARD,2,Ivan Ljubicic,Martin Vassallo Arguello,Ivan Ljubicic,6-3; 6-4,R32,89,7,2,33,57,29,33,12,24,1,1,10,41,57,1,2,64,80,40,64,7,16,10,12,9,47,80
2009-10-26 00:00:00.000,Lyon France ATP World Tour 250,HARD,2,Nicolas Kiefer,Sebastien Grosjean,Nicolas Kiefer,4-6; 7-6(7); 7-6(2),R32,148,20,7,67,119,53,67,26,52,7,10,17,79,119,17,3,80,120,61,80,17,40,9,11,17,78,120
2009-10-26 00:00:00.000,Lyon France ATP World Tour 250,HARD,2,Florent Serra,Christophe Rochus,Florent Serra,6-3; 6-3,R32,62,6,2,37,54,29,37,11,17,4,4,9,40,54,4,1,36,54,21,36,10,18,3,6,9,31,54
2009-10-26 00:00:00.000,Lyon France ATP World Tour 250,HARD,2,Albert Montanes,Fabrice Santoro,Albert Montanes,6-4; 6-4,R32,85,0,0,49,80,29,49,22,31,5,5,10,51,80,13,2,42,61,34,42,6,19,3,5,10,40,61
2009-10-26 00:00:00.000,Lyon France ATP World Tour 250,HARD,2,Paul-Henri Mathieu,Leonardo Mayer,Paul-Henri Mathieu,7-6(5); 6-2,R32,91,7,0,32,57,24,32,19,25,1,2,10,43,57,18,4,41,72,31,41,14,31,6,9,10,45,72
2009-10-26 00:00:00.000,Lyon France ATP World Tour 250,HARD,2,Marc Gicquel,Jerome Haehnel,Marc Gicquel,6-1; 6-4,R32,59,8,0,37,50,29,37,9,13,1,1,9,38,50,2,2,30,50,18,30,10,20,3,6,8,28,50
2009-10-26 00:00:00.000,Lyon France ATP World Tour 250,HARD,2,Michael Llodra,Lamine Ouahab,Michael Llodra,6-1; 6-2,R32,48,11,1,22,37,21,22,11,15,0,0,8,32,37,2,5,17,42,10,17,8,25,2,6,7,18,42
2009-10-26 00:00:00.000,Lyon France ATP World Tour 250,HARD,2,Juan Monaco,Josselin Ouanna,Juan Monaco,6-3; 6-2,R32,61,3,1,30,45,18,30,10,15,1,3,8,28,45,6,2,36,58,20,36,5,22,4,10,9,25,58
2009-10-26 00:00:00.000,Lyon France ATP World Tour 250,HARD,2,Julien Benneteau,Alberto Martin,Julien Benneteau,7-6(1); 6-1,R32,90,6,1,39,57,32,39,9,18,0,0,9,41,57,2,3,48,78,31,48,12,30,6,9,10,43,78
2009-10-26 00:00:00.000,Lyon France ATP World Tour 250,HARD,2,Kevin Anderson,Simon Greul,Kevin Anderson,6-4; 4-6; 7-6(3),R32,134,24,2,75,104,60,75,12,29,3,5,16,72,104,6,6,56,103,45,56,25,47,4,6,16,70,103
2009-10-26 00:00:00.000,Lyon France ATP World Tour 250,HARD,2,David Guez,Rajeev Ram,David Guez,6-2; 6-4,R32,72,2,1,32,55,24,32,16,23,3,3,9,40,55,7,1,34,51,22,34,9,17,2,5,9,31,51
2009-10-26 00:00:00.000,Lyon France ATP World Tour 250,HARD,2,Gilles Simon,Simone Bolelli,Gilles Simon,7-6(5); 7-6(5),R32,128,14,2,47,89,38,47,21,42,3,4,12,59,89,1,0,65,101,43,65,20,36,3,4,12,63,101
2009-10-26 00:00:00.000,Lyon France ATP World Tour 250,HARD,2,Jo-Wilfried Tsonga,Olivier Rochus,Jo-Wilfried Tsonga,6-3; 6-2,R16,64,13,1,30,49,25,30,12,19,2,2,9,37,49,0,0,37,50,21,37,8,13,1,4,8,29,50
2009-10-26 00:00:00.000,Lyon France ATP World Tour 250,HARD,2,Arnaud Clement,Benjamin Becker,Arnaud Clement,6-4; 6-3,R16,82,2,1,39,56,30,39,12,17,1,1,10,42,56,6,4,28,59,21,28,15,31,3,5,9,36,59
2009-10-26 00:00:00.000,Lyon France ATP World Tour 250,HARD,2,Ivan Ljubicic,Nicolas Kiefer,Ivan Ljubicic,6-3; 3-6; 6-3,R16,103,27,0,52,73,44,52,11,21,0,1,14,55,73,9,3,61,89,46,61,10,28,9,11,13,56,89
2009-10-26 00:00:00.000,Lyon France ATP World Tour 250,HARD,2,Florent Serra,Albert Montanes,Florent Serra,7-5; 6-3,R16,70,11,2,39,57,32,39,11,18,2,3,11,43,57,4,0,36,67,26,36,13,31,3,6,10,39,67
2009-10-26 00:00:00.000,Lyon France ATP World Tour 250,HARD,2,Marc Gicquel,Paul-Henri Mathieu,Marc Gicquel,6-4; 6-0,R16,72,10,0,30,48,26,30,7,18,3,4,8,33,48,5,0,34,63,21,34,8,29,8,13,8,29,63
2009-10-26 00:00:00.000,Lyon France ATP World Tour 250,HARD,2,Michael Llodra,Juan Monaco,Michael Llodra,6-3; 6-4,R16,75,11,0,37,56,31,37,11,19,0,0,10,42,56,4,2,41,61,27,41,10,20,3,5,9,37,61
2009-10-26 00:00:00.000,Lyon France ATP World Tour 250,HARD,2,Julien Benneteau,Kevin Anderson,Julien Benneteau,7-5; 6-2,R16,70,5,1,34,43,33,34,7,9,0,0,10,40,43,12,2,45,61,33,45,7,16,4,7,10,40,61
2009-10-26 00:00:00.000,Lyon France ATP World Tour 250,HARD,2,Gilles Simon,David Guez,Gilles Simon,6-1; 6-2,R16,53,5,0,29,44,20,29,9,15,4,5,7,29,44,1,4,19,41,7,19,7,22,0,6,8,14,41
2009-10-26 00:00:00.000,Lyon France ATP World Tour 250,HARD,2,Arnaud Clement,Jo-Wilfried Tsonga,Arnaud Clement,5-7; 6-4; 7-6(8),Q,167,5,1,83,124,63,83,20,41,5,6,17,83,124,27,3,80,114,67,80,10,34,5,6,17,77,114
2009-10-26 00:00:00.000,Lyon France ATP World Tour 250,HARD,2,Ivan Ljubicic,Florent Serra,Ivan Ljubicic,7-6(6); 6-2,Q,82,16,1,40,55,36,40,10,15,0,0,10,46,55,4,4,60,92,40,60,15,32,10,12,10,55,92
2009-10-26 00:00:00.000,Lyon France ATP World Tour 250,HARD,2,Michael Llodra,Marc Gicquel,Michael Llodra,7-6(5); 6-4,Q,86,13,0,42,65,35,42,14,23,4,5,11,49,65,4,1,44,64,34,44,10,20,1,3,11,44,64
2009-10-26 00:00:00.000,Lyon France ATP World Tour 250,HARD,2,Gilles Simon,Julien Benneteau,Gilles Simon,7-6(5); 6-3,Q,83,6,0,35,53,33,35,12,18,0,0,10,45,53,4,1,45,74,35,45,14,29,1,3,11,49,74
2009-10-26 00:00:00.000,Lyon France ATP World Tour 250,HARD,2,Ivan Ljubicic,Arnaud Clement,Ivan Ljubicic,6-2; 6-4,S,81,6,0,25,46,22,25,15,21,0,0,9,37,46,2,1,36,56,27,36,8,20,4,7,9,35,56
2009-10-26 00:00:00.000,Lyon France ATP World Tour 250,HARD,2,Michael Llodra,Gilles Simon,Michael Llodra,6-7(4); 6-3; 7-6(1),S,108,24,2,67,90,59,67,17,23,0,0,17,76,90,7,0,53,93,42,53,27,40,3,4,16,69,93
2009-10-26 00:00:00.000,Lyon France ATP World Tour 250,HARD,2,Ivan Ljubicic,Michael Llodra,Ivan Ljubicic,7-5; 6-3,F,97,7,0,56,77,41,56,9,21,3,4,11,50,77,9,6,43,71,31,43,10,28,6,9,10,41,71
2009-10-26 00:00:00.000,Vienna Austria ATP World Tour 250,HARD,2,Marin Cilic,Alejandro Falla,Marin Cilic,6-2; 6-3,R32,78,7,2,27,45,21,27,10,18,0,1,8,31,45,5,2,46,77,25,46,12,31,6,11,9,37,77
2009-10-26 00:00:00.000,Vienna Austria ATP World Tour 250,HARD,2,Daniel Brands,Robert Kendrick,Daniel Brands,7-6(5); 7-5,R32,76,13,1,51,69,37,51,14,18,2,3,12,51,69,16,1,38,63,31,38,15,25,0,2,12,46,63
2009-10-26 00:00:00.000,Vienna Austria ATP World Tour 250,HARD,2,Daniel Koellerer,Jarkko Nieminen,Daniel Koellerer,6-1; 6-2,R32,71,2,2,46,64,33,46,10,18,8,8,8,43,64,1,2,25,40,14,25,4,15,2,6,7,18,40
2009-10-26 00:00:00.000,Vienna Austria ATP World Tour 250,HARD,2,Feliciano Lopez,Andreas Haider-Maurer,Feliciano Lopez,6-4; 6-4,R32,72,5,1,26,50,24,26,15,24,1,2,10,39,50,6,7,26,57,18,26,16,31,4,7,10,34,57
2009-10-26 00:00:00.000,Vienna Austria ATP World Tour 250,HARD,2,Philipp Kohlschreiber,Dieter Kindlmann,Philipp Kohlschreiber,6-1; 6-3,R32,69,9,0,30,54,23,30,16,24,4,4,8,39,54,1,5,23,57,17,23,11,34,7,11,8,28,57
2009-10-26 00:00:00.000,Vienna Austria ATP World Tour 250,HARD,2,Victor Crivoi,Jan Hernych,Victor Crivoi,6-3; 6-3,R32,69,3,4,31,53,26,31,11,22,2,3,9,37,53,4,3,45,61,27,45,4,16,7,11,9,31,61
2009-10-26 00:00:00.000,Vienna Austria ATP World Tour 250,HARD,2,Wayne Odesnik,Lukas Rosol,Wayne Odesnik,6-2; 5-7; 7-6(6),R32,141,10,1,73,103,51,73,18,30,2,5,16,69,103,10,3,70,110,52,70,16,40,8,12,16,68,110
2009-10-26 00:00:00.000,Vienna Austria ATP World Tour 250,HARD,2,Nicolas Almagro,Peter Luczak,Nicolas Almagro,5-7; 7-6(3); 6-1,R32,134,20,1,61,108,47,61,27,47,7,9,16,74,108,15,4,69,106,51,69,15,37,4,7,15,66,106
2009-10-26 00:00:00.000,Vienna Austria ATP World Tour 250,HARD,2,Janko Tipsarevic,John Isner,Janko Tipsarevic,7-6(4); 6-4,R32,93,9,2,45,69,37,45,16,24,4,4,11,53,69,11,2,54,71,40,54,11,17,4,5,11,51,71
2009-10-26 00:00:00.000,Vienna Austria ATP World Tour 250,HARD,2,Michael Berrer,Steve Darcis,Michael Berrer,6-3; 6-2,R32,61,9,1,43,57,30,43,9,14,4,4,9,39,57,7,0,28,41,19,28,5,13,3,6,8,24,41
2009-10-26 00:00:00.000,Vienna Austria ATP World Tour 250,HARD,2,Jan Hajek,Andreas Seppi,Jan Hajek,7-6(4); 5-7; 6-3,R32,140,7,2,81,112,54,81,17,31,4,7,17,71,112,9,6,63,104,47,63,18,41,4,7,16,65,104
2009-10-26 00:00:00.000,Vienna Austria ATP World Tour 250,HARD,2,Gael Monfils,Guillermo Garcia-Lopez,Gael Monfils,7-5; 6-4,R32,82,7,1,35,58,30,35,16,23,2,2,11,46,58,2,3,35,65,26,35,16,30,6,8,11,42,65
2009-10-26 00:00:00.000,Vienna Austria ATP World Tour 250,HARD,2,Jurgen Melzer,Marco Chiudinelli,Jurgen Melzer,7-6(4); 7-6(10),R32,127,12,1,54,97,42,54,23,43,3,4,12,65,97,5,1,49,86,36,49,23,37,3,4,12,59,86
2009-10-26 00:00:00.000,Vienna Austria ATP World Tour 250,HARD,2,Dominik Hrbaty,Ruben Ramirez Hidalgo,Dominik Hrbaty,6-3; 6-4,R32,80,4,2,32,54,25,32,9,22,4,6,9,34,54,5,5,33,65,18,33,13,32,3,8,10,31,65
2009-10-26 00:00:00.000,Vienna Austria ATP World Tour 250,HARD,2,Frederico Gil,Stefan Koubek,Frederico Gil,4-6; 6-4; 6-4,R32,120,5,0,62,90,45,62,13,28,6,9,15,58,90,5,3,48,86,31,48,20,38,5,9,15,51,86
2009-10-26 00:00:00.000,Vienna Austria ATP World Tour 250,HARD,2,Radek Stepanek,Lukasz Kubot,Radek Stepanek,6-4; 6-1,R32,83,10,1,33,46,27,33,6,13,2,2,8,33,46,5,0,44,73,24,44,13,29,7,11,9,37,73
2009-10-26 00:00:00.000,Vienna Austria ATP World Tour 250,HARD,2,Marin Cilic,Daniel Brands,Marin Cilic,7-6(7); 6-4,R16,95,7,3,33,63,30,33,20,30,2,3,11,50,63,5,6,50,77,38,50,12,27,6,8,11,50,77
2009-10-26 00:00:00.000,Vienna Austria ATP World Tour 250,HARD,2,Feliciano Lopez,Daniel Koellerer,Feliciano Lopez,6-3; 6-3,R16,81,6,1,28,49,22,28,13,21,1,2,9,35,49,1,2,49,58,28,49,3,9,4,8,9,31,58
2009-10-26 00:00:00.000,Vienna Austria ATP World Tour 250,HARD,2,Philipp Kohlschreiber,Victor Crivoi,Philipp Kohlschreiber,6-2; 3-0 RET,R16,35,4,0,14,25,11,14,9,11,0,0,5,20,25,3,1,15,34,9,15,7,19,3,7,6,16,34
2009-10-26 00:00:00.000,Vienna Austria ATP World Tour 250,HARD,2,Nicolas Almagro,Wayne Odesnik,Nicolas Almagro,6-4; 6-4,R16,73,8,0,32,50,27,32,13,18,0,0,10,40,50,9,1,28,55,22,28,14,27,2,4,10,36,55
2009-10-26 00:00:00.000,Vienna Austria ATP World Tour 250,HARD,2,Janko Tipsarevic,Michael Berrer,Janko Tipsarevic,7-6(3); 6-1,R16,95,6,2,37,67,29,37,13,30,5,7,9,42,67,3,2,38,60,20,38,7,22,1,6,10,27,60
2009-10-26 00:00:00.000,Vienna Austria ATP World Tour 250,HARD,2,Gael Monfils,Jan Hajek,Gael Monfils,6-1; 2-6; 6-4,R16,91,8,3,52,75,37,52,12,23,1,3,12,49,75,3,2,55,86,34,55,15,31,7,11,13,49,86
2009-10-26 00:00:00.000,Vienna Austria ATP World Tour 250,HARD,2,Jurgen Melzer,Dominik Hrbaty,Jurgen Melzer,6-4; 7-5,R16,79,5,4,49,71,38,49,11,22,5,6,11,49,71,5,2,40,63,28,40,11,23,3,6,11,39,63
2009-10-26 00:00:00.000,Vienna Austria ATP World Tour 250,HARD,2,Radek Stepanek,Frederico Gil,Radek Stepanek,6-2; 6-3,R16,70,2,1,29,49,26,29,11,20,0,0,9,37,49,4,0,40,56,23,40,8,16,3,6,8,31,56
2009-10-26 00:00:00.000,Vienna Austria ATP World Tour 250,HARD,2,Marin Cilic,Feliciano Lopez,Marin Cilic,6-1; 6-4,Q,85,8,1,33,61,25,33,17,28,2,2,9,42,61,4,5,33,59,20,33,13,26,5,8,8,33,59
2009-10-26 00:00:00.000,Vienna Austria ATP World Tour 250,HARD,2,Philipp Kohlschreiber,Nicolas Almagro,Philipp Kohlschreiber,7-5; 6-4,Q,77,8,0,47,65,35,47,13,18,3,3,11,48,65,9,4,39,66,32,39,12,27,3,5,11,44,66
2009-10-26 00:00:00.000,Vienna Austria ATP World Tour 250,HARD,2,Janko Tipsarevic,Gael Monfils,Janko Tipsarevic,6-4; 6-7(8); 6-3,Q,132,8,0,68,101,47,68,24,33,4,5,16,71,101,8,3,65,101,49,65,17,36,7,10,15,66,101
2009-10-26 00:00:00.000,Vienna Austria ATP World Tour 250,HARD,2,Jurgen Melzer,Radek Stepanek,Jurgen Melzer,6-2; 6-2,Q,61,6,0,28,42,22,28,12,14,1,1,8,34,42,1,2,35,52,21,35,5,17,3,7,8,26,52
2009-10-26 00:00:00.000,Vienna Austria ATP World Tour 250,HARD,2,Marin Cilic,Philipp Kohlschreiber,Marin Cilic,6-4; 7-6(4),S,99,12,1,39,66,31,39,17,27,2,3,11,48,66,2,1,56,82,37,56,13,26,6,8,11,50,82
2009-10-26 00:00:00.000,Vienna Austria ATP World Tour 250,HARD,2,Jurgen Melzer,Janko Tipsarevic,Jurgen Melzer,4-6; 7-6(5); 6-4,S,149,17,2,55,105,44,55,31,50,3,4,16,75,105,5,3,49,96,41,49,25,47,2,3,16,66,96
2009-10-26 00:00:00.000,Vienna Austria ATP World Tour 250,HARD,2,Jurgen Melzer,Marin Cilic,Jurgen Melzer,6-4; 6-3,F,93,1,1,33,61,24,33,17,28,5,5,9,41,61,10,3,40,65,31,40,10,25,5,8,10,41,65
2009-11-02 00:00:00.000,Basel Switzerland ATP World Tour 500,HARD,2,Roger Federer,Olivier Rochus,Roger Federer,6-3; 6-4,R32,67,12,1,37,55,32,37,10,18,0,0,10,42,55,1,0,36,59,22,36,14,23,0,2,9,36,59
2009-11-02 00:00:00.000,Basel Switzerland ATP World Tour 500,HARD,2,Andreas Seppi,Stephane Bohli,Andreas Seppi,4-6; 6-1; 7-5,R32,151,6,6,53,94,36,53,20,41,4,7,14,56,94,4,3,54,105,31,54,26,51,3,9,15,57,105
2009-11-02 00:00:00.000,Basel Switzerland ATP World Tour 500,HARD,2,Evgeny Korolev,Simone Bolelli,Evgeny Korolev,3-6; 7-6(4); 6-2,R32,130,11,6,70,110,51,70,20,40,9,10,14,71,110,14,0,74,108,51,74,18,34,10,12,15,69,108
2009-11-02 00:00:00.000,Basel Switzerland ATP World Tour 500,HARD,2,Jeremy Chardy,James Blake,Jeremy Chardy,7-6(4); 6-7(6); 6-4,R32,137,24,1,56,103,48,56,30,47,2,2,17,78,103,14,8,73,128,56,73,26,55,6,7,17,82,128
2009-11-02 00:00:00.000,Basel Switzerland ATP World Tour 500,HARD,2,John Isner,Fernando Gonzalez,John Isner,7-6(3); 4-6; 6-4,R32,112,18,1,76,101,55,76,17,25,1,2,16,72,101,17,4,61,92,51,61,17,31,1,2,16,68,92
2009-11-02 00:00:00.000,Basel Switzerland ATP World Tour 500,HARD,2,Richard Gasquet,Horacio Zeballos,Richard Gasquet,7-6(3); 6-4,R32,87,9,1,40,74,32,40,21,34,2,2,11,53,74,6,1,45,71,30,45,17,26,3,4,11,47,71
2009-11-02 00:00:00.000,Basel Switzerland ATP World Tour 500,HARD,2,Michael Lammer,Daniel Koellerer,Michael Lammer,3-6; 6-2; 7-5,R32,128,4,3,45,72,33,45,17,27,0,3,14,50,72,2,2,85,104,51,85,9,19,12,17,15,60,104
2009-11-02 00:00:00.000,Basel Switzerland ATP World Tour 500,HARD,2,Marco Chiudinelli,Philipp Kohlschreiber,Marco Chiudinelli,7-6(5); 3-6; 7-5,R32,135,11,3,67,105,48,67,20,38,10,12,16,68,105,15,5,65,98,52,65,19,33,4,6,17,71,98
2009-11-02 00:00:00.000,Basel Switzerland ATP World Tour 500,HARD,2,Radek Stepanek,Rainer Schuettler,Radek Stepanek,6-2; 6-0,R32,68,6,2,43,63,30,43,10,20,5,5,7,40,63,1,3,28,46,14,28,7,18,6,11,7,21,46
2009-11-02 00:00:00.000,Basel Switzerland ATP World Tour 500,HARD,2,Florent Serra,Ivo Karlovic,Florent Serra,7-6(5); 6-4,R32,78,6,2,41,63,34,41,17,22,2,2,11,51,63,28,2,49,70,41,49,8,21,3,4,11,49,70
2009-11-02 00:00:00.000,Basel Switzerland ATP World Tour 500,HARD,2,Viktor Troicki,Benjamin Becker,Viktor Troicki,6-2; 7-6(5),R32,88,8,1,36,64,30,36,14,28,1,2,10,44,64,4,2,36,69,25,36,15,33,5,8,10,40,69
2009-11-02 00:00:00.000,Basel Switzerland ATP World Tour 500,HARD,2,Marin Cilic,Philipp Petzschner,Marin Cilic,6-4; 6-4,R32,83,14,5,38,68,31,38,15,30,2,2,10,46,68,10,2,43,66,35,43,7,23,3,5,10,42,66
2009-11-02 00:00:00.000,Basel Switzerland ATP World Tour 500,HARD,2,Stanislas Wawrinka,Ivan Ljubicic,Stanislas Wawrinka,6-7(5); 6-3; 6-4,R32,132,15,4,57,95,46,57,23,38,4,6,16,69,95,13,3,56,97,42,56,20,41,3,7,15,62,97
2009-11-02 00:00:00.000,Basel Switzerland ATP World Tour 500,HARD,2,Jarkko Nieminen,Julien Benneteau,Jarkko Nieminen,7-5; 6-2,R32,94,1,2,46,68,33,46,11,22,1,2,10,44,68,4,1,48,68,28,48,7,20,4,8,10,35,68
2009-11-02 00:00:00.000,Basel Switzerland ATP World Tour 500,HARD,2,Jan Hernych,Peter Luczak,Jan Hernych,6-3; 6-4,R32,76,4,1,38,66,30,38,16,28,6,6,10,46,66,4,2,23,47,16,23,14,24,0,2,9,30,47
2009-11-02 00:00:00.000,Basel Switzerland ATP World Tour 500,HARD,2,Novak Djokovic,Andreas Beck,Novak Djokovic,6-3; 7-5,R32,87,10,2,41,63,33,41,11,22,3,4,11,44,63,6,3,38,64,29,38,7,26,5,8,10,36,64
2009-11-02 00:00:00.000,Basel Switzerland ATP World Tour 500,HARD,2,Roger Federer,Andreas Seppi,Roger Federer,6-3; 6-3,R16,61,6,0,38,55,30,38,10,17,2,2,9,40,55,2,1,37,56,23,37,10,19,4,7,9,33,56
2009-11-02 00:00:00.000,Basel Switzerland ATP World Tour 500,HARD,2,Evgeny Korolev,Jeremy Chardy,Evgeny Korolev,6-4; 7-6(1),R16,71,8,3,42,64,32,42,13,22,0,1,11,45,64,12,2,28,55,26,28,15,27,2,4,11,41,55
2009-11-02 00:00:00.000,Basel Switzerland ATP World Tour 500,HARD,2,Richard Gasquet,John Isner,Richard Gasquet,4-6; 7-6(9); 6-2,R16,121,6,4,58,93,48,58,22,35,3,4,15,70,93,22,4,77,102,58,77,12,25,4,6,15,70,102
2009-11-02 00:00:00.000,Basel Switzerland ATP World Tour 500,HARD,2,Marco Chiudinelli,Michael Lammer,Marco Chiudinelli,2-6; 6-3; 6-3,R16,127,8,4,53,80,37,53,17,27,6,8,13,54,80,3,4,56,89,37,56,16,33,6,9,13,53,89
2009-11-02 00:00:00.000,Basel Switzerland ATP World Tour 500,HARD,2,Radek Stepanek,Florent Serra,Radek Stepanek,3-6; 7-6(1); 7-6(1),R16,140,22,4,67,103,54,67,20,36,2,3,16,74,103,11,4,87,137,65,87,24,50,16,16,17,89,137
2009-11-02 00:00:00.000,Basel Switzerland ATP World Tour 500,HARD,2,Marin Cilic,Viktor Troicki,Marin Cilic,7-6(7); 6-7(8); 7-6(6),R16,181,10,3,74,126,57,74,28,52,4,7,18,85,126,9,5,83,138,60,83,26,55,5,8,18,86,138
2009-11-02 00:00:00.000,Basel Switzerland ATP World Tour 500,HARD,2,Stanislas Wawrinka,Jarkko Nieminen,Stanislas Wawrinka,7-5; 2-6; 6-1,R16,120,10,2,47,78,37,47,13,31,0,3,14,50,78,2,1,64,98,38,64,18,34,10,14,13,56,98
2009-11-02 00:00:00.000,Basel Switzerland ATP World Tour 500,HARD,2,Novak Djokovic,Jan Hernych,Novak Djokovic,6-0; 6-0,R16,53,4,1,30,47,21,30,11,17,3,3,6,32,47,2,2,21,37,8,21,3,16,3,9,6,11,37
2009-11-02 00:00:00.000,Basel Switzerland ATP World Tour 500,HARD,2,Roger Federer,Evgeny Korolev,Roger Federer,6-3; 6-2,Q,56,7,0,41,55,32,41,8,14,2,2,9,40,55,3,2,25,43,18,25,8,18,1,4,8,26,43
2009-11-02 00:00:00.000,Basel Switzerland ATP World Tour 500,HARD,2,Marco Chiudinelli,Richard Gasquet,Marco Chiudinelli,6-1; 6-3,Q,62,13,2,31,44,28,31,6,13,3,3,8,34,44,3,2,39,50,20,39,3,11,3,7,8,23,50
2009-11-02 00:00:00.000,Basel Switzerland ATP World Tour 500,HARD,2,Radek Stepanek,Marin Cilic,Radek Stepanek,4-6; 6-3; 6-3,Q,122,7,4,53,86,37,53,20,33,6,8,14,57,86,10,1,46,84,33,46,17,38,0,4,14,50,84
2009-11-02 00:00:00.000,Basel Switzerland ATP World Tour 500,HARD,2,Novak Djokovic,Stanislas Wawrinka,Novak Djokovic,3-6; 7-6(5); 6-2,Q,139,5,1,51,84,44,51,17,33,4,6,14,61,84,13,1,61,96,44,61,19,35,6,9,15,63,96
2009-11-02 00:00:00.000,Basel Switzerland ATP World Tour 500,HARD,2,Roger Federer,Marco Chiudinelli,Roger Federer,7-6(7); 6-3,S,85,4,0,44,63,36,44,15,19,3,3,11,51,63,1,2,52,67,39,52,7,15,2,3,10,46,67
2009-11-02 00:00:00.000,Basel Switzerland ATP World Tour 500,HARD,2,Novak Djokovic,Radek Stepanek,Novak Djokovic,6-7(4); 7-5; 6-2,S,151,7,7,58,105,44,58,28,47,7,7,16,72,105,8,2,62,106,48,62,21,44,5,8,16,69,106
2009-11-02 00:00:00.000,Basel Switzerland ATP World Tour 500,HARD,2,Novak Djokovic,Roger Federer,Novak Djokovic,6-4; 4-6; 6-2,F,131,6,7,63,98,45,63,19,35,9,11,14,64,98,10,1,61,86,42,61,11,25,4,8,14,53,86
2009-11-02 00:00:00.000,Valencia Spain ATP World Tour 500,HARD,2,Andy Murray,Daniel Gimeno-Traver,Andy Murray,6-3; 6-1,R32,60,3,2,26,45,22,26,9,19,1,2,8,31,45,2,2,25,47,18,25,5,22,5,10,8,23,47
2009-11-02 00:00:00.000,Valencia Spain ATP World Tour 500,HARD,2,Leonardo Mayer,Igor Andreev,Leonardo Mayer,6-3; 6-3,R32,63,3,0,32,46,27,32,9,14,0,1,9,36,46,2,2,36,54,24,36,5,18,5,9,9,29,54
2009-11-02 00:00:00.000,Valencia Spain ATP World Tour 500,HARD,2,Albert Montanes,Roberto Bautista Agut,Albert Montanes,6-1; 3-6; 6-4,R32,115,4,3,43,80,28,43,22,37,3,6,13,50,80,0,1,49,84,32,49,16,35,4,9,13,48,84
2009-11-02 00:00:00.000,Valencia Spain ATP World Tour 500,HARD,2,David Ferrer,Nicolas Almagro,David Ferrer,7-5; 6-7(3); 6-2,R32,137,1,3,50,92,38,50,20,42,0,3,16,58,92,8,1,65,103,44,65,17,38,5,11,16,61,103
2009-11-02 00:00:00.000,Valencia Spain ATP World Tour 500,HARD,2,Fernando Verdasco,Oscar Hernandez,Fernando Verdasco,6-1; 0-1 RET,R32,30,2,0,10,19,10,10,6,9,0,0,4,16,19,0,1,13,20,9,13,2,7,0,2,4,11,20
2009-11-02 00:00:00.000,Valencia Spain ATP World Tour 500,HARD,2,Janko Tipsarevic,Victor Hanescu,Janko Tipsarevic,6-4; 6-3,R32,85,5,2,33,60,24,33,15,27,1,2,9,39,60,4,0,49,61,29,49,3,12,4,8,10,32,61
2009-11-02 00:00:00.000,Valencia Spain ATP World Tour 500,HARD,2,Feliciano Lopez,Alberto Martin,Feliciano Lopez,7-5; 6-3,R32,80,12,3,38,57,34,38,9,19,2,2,10,43,57,1,4,47,70,28,47,13,23,3,6,11,41,70
2009-11-02 00:00:00.000,Valencia Spain ATP World Tour 500,HARD,2,Tommy Robredo,Christophe Rochus,Tommy Robredo,6-0; 5-7; 6-3,R32,130,16,1,63,100,45,63,16,37,10,13,13,61,100,0,1,53,84,28,53,12,31,3,10,14,40,84
2009-11-02 00:00:00.000,Valencia Spain ATP World Tour 500,HARD,2,Gilles Simon,Igor Kunitsyn,Gilles Simon,6-3; 6-2,R32,54,4,0,35,50,30,35,9,15,3,3,9,39,50,0,1,23,44,15,23,10,21,0,3,8,25,44
2009-11-02 00:00:00.000,Valencia Spain ATP World Tour 500,HARD,2,Tomas Berdych,Paul-Henri Mathieu,Tomas Berdych,6-3; 6-4,R32,80,8,2,41,61,36,41,9,20,4,4,10,45,61,2,2,26,56,16,26,18,30,2,4,9,34,56
2009-11-02 00:00:00.000,Valencia Spain ATP World Tour 500,HARD,2,Pablo Cuevas,Juan Carlos Ferrero,Pablo Cuevas,2-6; 7-6(4); 6-3,R32,127,10,3,57,103,42,57,24,46,7,11,15,66,103,6,0,46,78,35,46,16,32,1,4,14,51,78
2009-11-02 00:00:00.000,Valencia Spain ATP World Tour 500,HARD,2,Mikhail Youzhny,Jo-Wilfried Tsonga,Mikhail Youzhny,6-7(3); 6-0; 3-0 RET,R32,89,5,2,31,60,25,31,19,29,2,3,10,44,60,10,3,46,82,30,46,13,36,3,9,11,43,82
2009-11-02 00:00:00.000,Valencia Spain ATP World Tour 500,HARD,2,Gael Monfils,Marcel Granollers,Gael Monfils,6-4; 6-2,R32,71,2,1,38,71,26,38,15,33,8,10,9,41,71,0,3,29,57,13,29,16,28,5,10,9,29,57
2009-11-02 00:00:00.000,Valencia Spain ATP World Tour 500,HARD,2,Guillermo Garcia-Lopez,Simon Greul,Guillermo Garcia-Lopez,7-5; 6-2,R32,86,4,4,41,60,28,41,10,19,7,9,10,38,60,1,0,40,59,22,40,8,19,1,6,10,30,59
2009-11-02 00:00:00.000,Valencia Spain ATP World Tour 500,HARD,2,Juan Monaco,Martin Vassallo Arguello,Juan Monaco,6-3; 6-2,R32,75,3,0,30,49,20,30,13,19,2,3,8,33,49,0,3,37,55,21,37,5,18,1,6,9,26,55
2009-11-02 00:00:00.000,Valencia Spain ATP World Tour 500,HARD,2,Nikolay Davydenko,Alejandro Falla,Nikolay Davydenko,6-2; 6-1,R32,62,5,0,26,37,21,26,7,11,0,1,8,28,37,0,3,25,50,13,25,9,25,7,12,7,22,50
2009-11-02 00:00:00.000,Valencia Spain ATP World Tour 500,HARD,2,Andy Murray,Leonardo Mayer,Andy Murray,6-4; 3-6; 6-3,R16,142,8,3,52,93,41,52,18,41,3,5,14,59,93,3,1,49,90,32,49,24,41,10,13,14,56,90
2009-11-02 00:00:00.000,Valencia Spain ATP World Tour 500,HARD,2,Albert Montanes,David Ferrer,Albert Montanes,W/O,R16,0,0,0,0,0,0,0,0,0,0,0,0,0,0,0,0,0,0,0,0,0,0,0,0,0,0,0
2009-11-02 00:00:00.000,Valencia Spain ATP World Tour 500,HARD,2,Fernando Verdasco,Janko Tipsarevic,Fernando Verdasco,6-3; 6-3,R16,83,7,2,40,61,31,40,9,21,5,6,9,40,61,2,1,29,54,18,29,13,25,2,6,9,31,54
2009-11-02 00:00:00.000,Valencia Spain ATP World Tour 500,HARD,2,Tommy Robredo,Feliciano Lopez,Tommy Robredo,4-6; 6-3; 6-4,R16,102,7,1,48,80,37,48,21,32,4,6,15,58,80,16,4,51,72,39,51,11,21,3,6,14,50,72
2009-11-02 00:00:00.000,Valencia Spain ATP World Tour 500,HARD,2,Gilles Simon,Tomas Berdych,Gilles Simon,6-4; 4-6; 6-3,R16,139,11,1,67,114,49,67,23,47,11,13,15,72,114,5,2,50,84,39,50,15,34,6,9,14,54,84
2009-11-02 00:00:00.000,Valencia Spain ATP World Tour 500,HARD,2,Mikhail Youzhny,Pablo Cuevas,Mikhail Youzhny,6-2; 2-6; 6-1,R16,95,1,2,39,64,33,39,12,25,2,4,12,45,64,3,1,43,67,25,43,12,24,4,8,11,37,67
2009-11-02 00:00:00.000,Valencia Spain ATP World Tour 500,HARD,2,Guillermo Garcia-Lopez,Gael Monfils,Guillermo Garcia-Lopez,6-2; 7-5,R16,97,1,4,39,62,31,39,12,23,1,1,10,43,62,1,4,50,75,28,50,14,25,5,8,10,42,75
2009-11-02 00:00:00.000,Valencia Spain ATP World Tour 500,HARD,2,Nikolay Davydenko,Juan Monaco,Nikolay Davydenko,6-3; 7-5,R16,102,0,4,39,68,27,39,15,29,3,5,11,42,68,2,0,49,65,30,49,6,16,5,9,10,36,65
2009-11-02 00:00:00.000,Valencia Spain ATP World Tour 500,HARD,2,Andy Murray,Albert Montanes,Andy Murray,6-4; 6-2,Q,74,3,1,31,52,24,31,11,21,1,2,9,35,52,1,2,35,59,20,35,12,24,6,10,9,32,59
2009-11-02 00:00:00.000,Valencia Spain ATP World Tour 500,HARD,2,Fernando Verdasco,Tommy Robredo,Fernando Verdasco,6-3; 6-2,Q,76,5,1,35,55,25,35,14,20,2,2,9,39,55,0,3,34,56,24,34,8,22,4,7,8,32,56
2009-11-02 00:00:00.000,Valencia Spain ATP World Tour 500,HARD,2,Mikhail Youzhny,Gilles Simon,Mikhail Youzhny,6-4; 6-4,Q,97,4,0,55,77,36,55,15,22,11,11,10,51,77,5,2,32,54,25,32,11,22,2,4,10,36,54
2009-11-02 00:00:00.000,Valencia Spain ATP World Tour 500,HARD,2,Nikolay Davydenko,Guillermo Garcia-Lopez,Nikolay Davydenko,6-4; 7-6(3),Q,117,9,2,30,62,25,30,20,32,2,4,11,45,62,1,5,46,76,30,46,14,30,3,6,11,44,76
2009-11-02 00:00:00.000,Valencia Spain ATP World Tour 500,HARD,2,Andy Murray,Fernando Verdasco,Andy Murray,6-3; 2-6; 6-3,S,122,5,4,42,87,29,42,26,45,6,8,13,55,87,5,3,40,74,30,40,16,34,5,8,13,46,74
2009-11-02 00:00:00.000,Valencia Spain ATP World Tour 500,HARD,2,Mikhail Youzhny,Nikolay Davydenko,Mikhail Youzhny,3-6; 6-4; 6-3,S,144,2,0,56,87,37,56,13,31,6,10,14,50,87,2,2,57,97,35,57,20,40,8,13,14,55,97
2009-11-02 00:00:00.000,Valencia Spain ATP World Tour 500,HARD,2,Andy Murray,Mikhail Youzhny,Andy Murray,6-3; 6-2,F,68,8,1,29,49,26,29,9,20,2,3,9,35,49,0,0,30,43,19,30,3,13,1,5,8,22,43
2009-11-08 00:00:00.000,ATP World Tour Masters 1000 Paris France ATP World Tour Masters 1000,HARD,2,Roger Federer,N/A Bye,Roger Federer,,R64,0,0,0,0,0,0,0,0,0,0,0,0,0,0,0,0,0,0,0,0,0,0,0,0,0,0,0
2009-11-08 00:00:00.000,ATP World Tour Masters 1000 Paris France ATP World Tour Masters 1000,HARD,2,Julien Benneteau,Philipp Petzschner,Julien Benneteau,4-6; 7-5; 6-3,R64,122,10,1,65,90,48,65,16,25,0,2,16,64,90,12,5,58,98,43,58,16,40,4,7,15,59,98
2009-11-08 00:00:00.000,ATP World Tour Masters 1000 Paris France ATP World Tour Masters 1000,HARD,2,David Guez,Stanislas Wawrinka,David Guez,6-3; 6-4,R64,102,0,0,34,64,19,34,20,30,3,5,10,39,64,4,1,36,69,20,36,16,33,3,7,9,36,69
2009-11-08 00:00:00.000,ATP World Tour Masters 1000 Paris France ATP World Tour Masters 1000,HARD,2,Gael Monfils,N/A Bye,Gael Monfils,,R64,0,0,0,0,0,0,0,0,0,0,0,0,0,0,0,0,0,0,0,0,0,0,0,0,0,0,0
2009-11-08 00:00:00.000,ATP World Tour Masters 1000 Paris France ATP World Tour Masters 1000,HARD,2,Marin Cilic,N/A Bye,Marin Cilic,,R64,0,0,0,0,0,0,0,0,0,0,0,0,0,0,0,0,0,0,0,0,0,0,0,0,0,0,0
2009-11-08 00:00:00.000,ATP World Tour Masters 1000 Paris France ATP World Tour Masters 1000,HARD,2,Lukasz Kubot,Andreas Beck,Lukasz Kubot,6-4; 3-6; 6-4,R64,124,14,1,46,72,38,46,16,26,0,1,14,54,72,8,2,60,97,45,60,19,37,7,9,15,64,97
2009-11-08 00:00:00.000,ATP World Tour Masters 1000 Paris France ATP World Tour Masters 1000,HARD,2,Andreas Seppi,Philipp Kohlschreiber,Andreas Seppi,6-3; 6-3,R64,57,7,1,33,50,26,33,11,17,2,3,9,37,50,6,3,33,51,21,33,7,18,3,7,9,28,51
2009-11-08 00:00:00.000,ATP World Tour Masters 1000 Paris France ATP World Tour Masters 1000,HARD,2,Fernando Verdasco,N/A Bye,Fernando Verdasco,,R64,0,0,0,0,0,0,0,0,0,0,0,0,0,0,0,0,0,0,0,0,0,0,0,0,0,0,0
2009-11-08 00:00:00.000,ATP World Tour Masters 1000 Paris France ATP World Tour Masters 1000,HARD,2,Andy Murray,N/A Bye,Andy Murray,,R64,0,0,0,0,0,0,0,0,0,0,0,0,0,0,0,0,0,0,0,0,0,0,0,0,0,0,0
2009-11-08 00:00:00.000,ATP World Tour Masters 1000 Paris France ATP World Tour Masters 1000,HARD,2,James Blake,Fabrice Santoro,James Blake,6-4; 6-3,R64,75,3,1,38,63,25,38,14,25,4,6,10,39,63,0,1,34,55,20,34,7,21,2,6,9,27,55
2009-11-08 00:00:00.000,ATP World Tour Masters 1000 Paris France ATP World Tour Masters 1000,HARD,2,Viktor Troicki,Paul-Henri Mathieu,Viktor Troicki,7-6(4); 3-0 RET,R64,69,16,1,48,65,36,48,8,17,3,3,8,44,65,5,1,29,48,19,29,13,19,1,2,7,32,48
2009-11-08 00:00:00.000,ATP World Tour Masters 1000 Paris France ATP World Tour Masters 1000,HARD,2,Radek Stepanek,N/A Bye,Radek Stepanek,,R64,0,0,0,0,0,0,0,0,0,0,0,0,0,0,0,0,0,0,0,0,0,0,0,0,0,0,0
2009-11-08 00:00:00.000,ATP World Tour Masters 1000 Paris France ATP World Tour Masters 1000,HARD,2,Fernando Gonzalez,N/A Bye,Fernando Gonzalez,,R64,0,0,0,0,0,0,0,0,0,0,0,0,0,0,0,0,0,0,0,0,0,0,0,0,0,0,0
2009-11-08 00:00:00.000,ATP World Tour Masters 1000 Paris France ATP World Tour Masters 1000,HARD,2,John Isner,Alejandro Falla,John Isner,4-6; 7-6(10); 7-5,R64,138,17,2,81,109,62,81,18,28,5,6,17,80,109,12,3,74,107,61,74,18,33,4,5,17,79,107
2009-11-08 00:00:00.000,ATP World Tour Masters 1000 Paris France ATP World Tour Masters 1000,HARD,2,Marat Safin,Thierry Ascione,Marat Safin,6-4; 4-6; 7-6(3),R64,112,24,0,65,104,49,65,22,39,10,12,16,71,104,13,2,54,87,42,54,20,33,2,4,16,62,87
2009-11-08 00:00:00.000,ATP World Tour Masters 1000 Paris France ATP World Tour Masters 1000,HARD,2,Juan Martin Del Potro,N/A Bye,Juan Martin Del Potro,,R64,0,0,0,0,0,0,0,0,0,0,0,0,0,0,0,0,0,0,0,0,0,0,0,0,0,0,0
2009-11-08 00:00:00.000,ATP World Tour Masters 1000 Paris France ATP World Tour Masters 1000,HARD,2,Nikolay Davydenko,N/A Bye,Nikolay Davydenko,,R64,0,0,0,0,0,0,0,0,0,0,0,0,0,0,0,0,0,0,0,0,0,0,0,0,0,0,0
2009-11-08 00:00:00.000,ATP World Tour Masters 1000 Paris France ATP World Tour Masters 1000,HARD,2,Benjamin Becker,Michael Llodra,Benjamin Becker,3-6; 6-2; 6-3,R64,101,9,3,49,82,39,49,17,33,3,4,13,56,82,9,5,49,79,35,49,15,30,0,3,13,50,79
2009-11-08 00:00:00.000,ATP World Tour Masters 1000 Paris France ATP World Tour Masters 1000,HARD,2,Ivo Karlovic,Pablo Cuevas,Ivo Karlovic,7-6(3); 6-4,R64,76,21,1,43,55,40,43,9,12,0,0,11,49,55,6,1,46,76,35,46,17,30,4,5,11,52,76
2009-11-08 00:00:00.000,ATP World Tour Masters 1000 Paris France ATP World Tour Masters 1000,HARD,2,Robin Soderling,N/A Bye,Robin Soderling,,R64,0,0,0,0,0,0,0,0,0,0,0,0,0,0,0,0,0,0,0,0,0,0,0,0,0,0,0
2009-11-08 00:00:00.000,ATP World Tour Masters 1000 Paris France ATP World Tour Masters 1000,HARD,2,Tommy Haas,N/A Bye,Tommy Haas,,R64,0,0,0,0,0,0,0,0,0,0,0,0,0,0,0,0,0,0,0,0,0,0,0,0,0,0,0
2009-11-08 00:00:00.000,ATP World Tour Masters 1000 Paris France ATP World Tour Masters 1000,HARD,2,Arnaud Clement,Feliciano Lopez,Arnaud Clement,6-3; 6-1,R64,51,6,0,28,38,25,28,7,10,0,0,8,32,38,5,2,27,40,15,27,4,13,1,5,8,19,40
2009-11-08 00:00:00.000,ATP World Tour Masters 1000 Paris France ATP World Tour Masters 1000,HARD,2,Juan Monaco,Jeremy Chardy,Juan Monaco,7-6(6); 7-5,R64,117,5,1,48,70,36,48,12,22,0,2,12,48,70,9,5,61,109,45,61,17,48,7,10,12,62,109
2009-11-08 00:00:00.000,ATP World Tour Masters 1000 Paris France ATP World Tour Masters 1000,HARD,2,Novak Djokovic,N/A Bye,Novak Djokovic,,R64,0,0,0,0,0,0,0,0,0,0,0,0,0,0,0,0,0,0,0,0,0,0,0,0,0,0,0
2009-11-08 00:00:00.000,ATP World Tour Masters 1000 Paris France ATP World Tour Masters 1000,HARD,2,Jo-Wilfried Tsonga,N/A Bye,Jo-Wilfried Tsonga,,R64,0,0,0,0,0,0,0,0,0,0,0,0,0,0,0,0,0,0,0,0,0,0,0,0,0,0,0
2009-11-08 00:00:00.000,ATP World Tour Masters 1000 Paris France ATP World Tour Masters 1000,HARD,2,Albert Montanes,Victor Hanescu,Albert Montanes,3-6; 6-3; 7-6(3),R64,128,4,0,68,109,51,68,21,41,3,4,15,72,109,13,3,59,95,49,59,15,36,1,2,15,64,95
2009-11-08 00:00:00.000,ATP World Tour Masters 1000 Paris France ATP World Tour Masters 1000,HARD,2,Ivan Ljubicic,Sebastien Grosjean,Ivan Ljubicic,7-6(2); 6-4,R64,94,7,2,44,69,36,44,11,25,1,2,11,47,69,4,3,33,69,23,33,20,36,3,5,11,43,69
2009-11-08 00:00:00.000,ATP World Tour Masters 1000 Paris France ATP World Tour Masters 1000,HARD,2,Gilles Simon,N/A Bye,Gilles Simon,,R64,0,0,0,0,0,0,0,0,0,0,0,0,0,0,0,0,0,0,0,0,0,0,0,0,0,0,0
2009-11-08 00:00:00.000,ATP World Tour Masters 1000 Paris France ATP World Tour Masters 1000,HARD,2,Tommy Robredo,N/A Bye,Tommy Robredo,,R64,0,0,0,0,0,0,0,0,0,0,0,0,0,0,0,0,0,0,0,0,0,0,0,0,0,0,0
2009-11-08 00:00:00.000,ATP World Tour Masters 1000 Paris France ATP World Tour Masters 1000,HARD,2,Tomas Berdych,Vincent Millot,Tomas Berdych,6-3; 7-6(4),R64,86,10,3,35,67,27,35,21,32,1,3,11,48,67,5,3,33,63,24,33,15,30,1,4,10,39,63
2009-11-08 00:00:00.000,ATP World Tour Masters 1000 Paris France ATP World Tour Masters 1000,HARD,2,Nicolas Almagro,Marco Chiudinelli,Nicolas Almagro,6-2; 6-4,R64,88,12,2,36,67,30,36,13,31,5,6,9,43,67,3,1,37,60,23,37,7,23,5,9,9,30,60
2009-11-08 00:00:00.000,ATP World Tour Masters 1000 Paris France ATP World Tour Masters 1000,HARD,2,Rafael Nadal,N/A Bye,Rafael Nadal,,R64,0,0,0,0,0,0,0,0,0,0,0,0,0,0,0,0,0,0,0,0,0,0,0,0,0,0,0
2009-11-08 00:00:00.000,ATP World Tour Masters 1000 Paris France ATP World Tour Masters 1000,HARD,2,Julien Benneteau,Roger Federer,Julien Benneteau,3-6; 7-6(4); 6-4,R32,115,7,2,72,91,57,72,11,19,6,7,15,68,91,14,0,70,96,57,70,13,26,6,7,16,70,96
2009-11-08 00:00:00.000,ATP World Tour Masters 1000 Paris France ATP World Tour Masters 1000,HARD,2,Gael Monfils,David Guez,Gael Monfils,6-4; 7-5,R32,93,11,3,45,68,38,45,9,23,3,4,11,47,68,1,5,39,72,26,39,17,33,8,11,11,43,72
2009-11-08 00:00:00.000,ATP World Tour Masters 1000 Paris France ATP World Tour Masters 1000,HARD,2,Marin Cilic,Lukasz Kubot,Marin Cilic,6-7(3); 6-4; 6-2,R32,150,16,2,61,98,46,61,23,37,9,9,15,69,98,9,5,76,109,57,76,14,33,10,13,15,71,109
2009-11-08 00:00:00.000,ATP World Tour Masters 1000 Paris France ATP World Tour Masters 1000,HARD,2,Fernando Verdasco,Andreas Seppi,Fernando Verdasco,6-7(3); 6-4; 6-4,R32,128,9,2,50,88,40,50,21,38,0,3,16,61,88,5,3,62,102,44,62,19,40,5,10,16,63,102
2009-11-08 00:00:00.000,ATP World Tour Masters 1000 Paris France ATP World Tour Masters 1000,HARD,2,Andy Murray,James Blake,Andy Murray,6-3; 6-7(5); 7-6(4),R32,134,21,3,67,106,56,67,19,39,2,3,17,75,106,4,5,69,116,45,69,28,47,4,6,16,73,116
2009-11-08 00:00:00.000,ATP World Tour Masters 1000 Paris France ATP World Tour Masters 1000,HARD,2,Radek Stepanek,Viktor Troicki,Radek Stepanek,6-4; 6-0,R32,75,5,0,26,46,21,26,11,20,0,1,8,32,46,3,1,35,60,19,35,8,25,5,10,8,27,60
2009-11-08 00:00:00.000,ATP World Tour Masters 1000 Paris France ATP World Tour Masters 1000,HARD,2,Fernando Gonzalez,John Isner,Fernando Gonzalez,7-5; 7-6(3),R32,90,13,3,48,72,42,48,13,24,3,3,12,55,72,13,1,60,84,43,60,12,24,7,8,12,55,84
2009-11-08 00:00:00.000,ATP World Tour Masters 1000 Paris France ATP World Tour Masters 1000,HARD,2,Juan Martin Del Potro,Marat Safin,Juan Martin Del Potro,6-4; 5-7; 6-4,R32,116,11,1,50,81,40,50,22,31,2,3,16,62,81,15,1,57,102,42,57,25,45,7,9,16,67,102
2009-11-08 00:00:00.000,ATP World Tour Masters 1000 Paris France ATP World Tour Masters 1000,HARD,2,Nikolay Davydenko,Benjamin Becker,Nikolay Davydenko,6-2; 6-1,R32,78,5,2,33,48,26,33,8,15,4,4,7,34,48,4,0,40,68,24,40,6,28,8,13,8,30,68
2009-11-08 00:00:00.000,ATP World Tour Masters 1000 Paris France ATP World Tour Masters 1000,HARD,2,Robin Soderling,Ivo Karlovic,Robin Soderling,6-4; 7-6(6),R32,85,12,1,53,82,45,53,14,29,8,8,11,59,82,14,2,47,63,37,47,10,16,0,1,11,47,63
2009-11-08 00:00:00.000,ATP World Tour Masters 1000 Paris France ATP World Tour Masters 1000,HARD,2,Arnaud Clement,Tommy Haas,Arnaud Clement,5-7; 6-3; 7-6(8),R32,168,6,3,61,112,46,61,29,51,8,12,17,75,112,16,11,74,121,52,74,21,47,12,16,16,73,121
2009-11-08 00:00:00.000,ATP World Tour Masters 1000 Paris France ATP World Tour Masters 1000,HARD,2,Novak Djokovic,Juan Monaco,Novak Djokovic,6-3; 7-5,R32,92,4,5,40,63,25,40,13,23,5,8,11,38,63,2,1,39,60,22,39,9,21,7,12,10,31,60
2009-11-08 00:00:00.000,ATP World Tour Masters 1000 Paris France ATP World Tour Masters 1000,HARD,2,Jo-Wilfried Tsonga,Albert Montanes,Jo-Wilfried Tsonga,6-1; 7-5,R32,63,12,2,30,48,28,30,12,18,0,0,10,40,48,1,2,33,53,23,33,8,20,0,3,9,31,53
2009-11-08 00:00:00.000,ATP World Tour Masters 1000 Paris France ATP World Tour Masters 1000,HARD,2,Gilles Simon,Ivan Ljubicic,Gilles Simon,6-3; 3-6; 7-6(4),R32,127,12,5,49,91,43,49,23,42,2,3,15,66,91,18,0,71,101,56,71,14,30,6,7,15,70,101
2009-11-08 00:00:00.000,ATP World Tour Masters 1000 Paris France ATP World Tour Masters 1000,HARD,2,Tommy Robredo,Tomas Berdych,Tommy Robredo,6-4; 6-4,R32,78,4,3,45,69,34,45,13,24,5,5,10,47,69,4,1,31,51,24,31,11,20,1,3,10,35,51
2009-11-08 00:00:00.000,ATP World Tour Masters 1000 Paris France ATP World Tour Masters 1000,HARD,2,Rafael Nadal,Nicolas Almagro,Rafael Nadal,3-6; 7-6(2); 7-5,R32,194,9,4,65,110,40,65,24,45,6,12,16,64,110,12,1,79,124,50,79,19,45,8,14,17,69,124
2009-11-08 00:00:00.000,ATP World Tour Masters 1000 Paris France ATP World Tour Masters 1000,HARD,2,Gael Monfils,Julien Benneteau,Gael Monfils,6-4; 6-3,R16,83,16,0,49,72,38,49,11,23,6,6,10,49,72,2,0,43,52,30,43,4,9,2,4,9,34,52
2009-11-08 00:00:00.000,ATP World Tour Masters 1000 Paris France ATP World Tour Masters 1000,HARD,2,Marin Cilic,Fernando Verdasco,Marin Cilic,3-6; 6-3; 6-4,R16,116,3,0,52,80,38,52,17,28,1,2,14,55,80,9,5,56,89,45,56,13,33,5,7,14,58,89
2009-11-08 00:00:00.000,ATP World Tour Masters 1000 Paris France ATP World Tour Masters 1000,HARD,2,Radek Stepanek,Andy Murray,Radek Stepanek,1-6; 6-3; 6-4,R16,97,5,2,41,68,33,41,11,27,2,5,13,44,68,11,3,41,80,35,41,16,39,3,6,13,51,80
2009-11-08 00:00:00.000,ATP World Tour Masters 1000 Paris France ATP World Tour Masters 1000,HARD,2,Juan Martin Del Potro,Fernando Gonzalez,Juan Martin Del Potro,6-7(6); 7-6(6) RET,R16,144,8,1,79,118,54,79,18,39,15,16,12,72,118,13,3,55,97,44,55,18,42,5,6,12,62,97
2009-11-08 00:00:00.000,ATP World Tour Masters 1000 Paris France ATP World Tour Masters 1000,HARD,2,Robin Soderling,Nikolay Davydenko,Robin Soderling,6-3; 3-6; 6-4,R16,122,9,1,56,87,43,56,15,31,2,3,14,58,87,11,1,54,87,41,54,16,33,8,10,14,57,87
2009-11-08 00:00:00.000,ATP World Tour Masters 1000 Paris France ATP World Tour Masters 1000,HARD,2,Novak Djokovic,Arnaud Clement,Novak Djokovic,6-2; 6-2,R16,76,8,3,30,45,24,30,7,15,2,3,8,31,45,2,2,30,57,18,30,7,27,4,9,8,25,57
2009-11-08 00:00:00.000,ATP World Tour Masters 1000 Paris France ATP World Tour Masters 1000,HARD,2,Jo-Wilfried Tsonga,Gilles Simon,Jo-Wilfried Tsonga,6-2; 6-3,R16,53,13,0,27,40,24,27,12,13,0,0,9,36,40,3,1,37,57,22,37,9,20,8,11,8,31,57
2009-11-08 00:00:00.000,ATP World Tour Masters 1000 Paris France ATP World Tour Masters 1000,HARD,2,Rafael Nadal,Tommy Robredo,Rafael Nadal,6-3; 3-6; 7-5,R16,141,5,2,64,89,45,64,16,25,4,6,15,61,89,7,0,49,83,36,49,20,34,4,7,15,56,83
2009-11-08 00:00:00.000,ATP World Tour Masters 1000 Paris France ATP World Tour Masters 1000,HARD,2,Gael Monfils,Marin Cilic,Gael Monfils,3-6; 6-4; 6-4,Q,142,13,0,61,92,48,61,14,31,4,6,15,62,92,7,4,50,89,40,50,21,39,3,5,14,61,89
2009-11-08 00:00:00.000,ATP World Tour Masters 1000 Paris France ATP World Tour Masters 1000,HARD,2,Radek Stepanek,Juan Martin Del Potro,Radek Stepanek,4-0 RET,Q,28,1,0,14,24,10,14,4,10,3,3,2,14,24,0,0,13,15,5,13,0,2,0,2,2,5,15
2009-11-08 00:00:00.000,ATP World Tour Masters 1000 Paris France ATP World Tour Masters 1000,HARD,2,Novak Djokovic,Robin Soderling,Novak Djokovic,6-4; 1-6; 6-3,Q,117,3,4,57,87,39,57,15,30,11,14,13,54,87,7,3,35,69,28,35,17,34,3,6,13,45,69
2009-11-08 00:00:00.000,ATP World Tour Masters 1000 Paris France ATP World Tour Masters 1000,HARD,2,Rafael Nadal,Jo-Wilfried Tsonga,Rafael Nadal,7-5; 7-5,Q,112,7,0,54,74,39,54,15,20,6,6,12,54,74,10,5,50,78,39,50,10,28,4,6,12,49,78
2009-11-08 00:00:00.000,ATP World Tour Masters 1000 Paris France ATP World Tour Masters 1000,HARD,2,Gael Monfils,Radek Stepanek,Gael Monfils,6-4; 5-7; 6-4,S,162,11,0,60,96,40,60,15,36,0,5,16,55,96,4,4,62,104,43,62,16,42,5,11,16,59,104
2009-11-08 00:00:00.000,ATP World Tour Masters 1000 Paris France ATP World Tour Masters 1000,HARD,2,Novak Djokovic,Rafael Nadal,Novak Djokovic,6-2; 6-3,S,77,4,4,29,50,24,29,13,21,0,0,9,37,50,4,2,25,38,14,25,6,13,0,3,8,20,38
2009-11-08 00:00:00.000,ATP World Tour Masters 1000 Paris France ATP World Tour Masters 1000,HARD,2,Novak Djokovic,Gael Monfils,Novak Djokovic,6-2; 5-7; 7-6(3),F,164,2,5,66,98,47,66,19,32,3,7,16,66,98,12,6,65,106,48,65,15,41,5,10,16,63,106
2010-01-03 00:00:00.000,Brisbane Australia ATP World Tour 250,HARD,2,Andy Roddick,Peter Luczak,Andy Roddick,7-6(5); 6-2,R32,84,15,0,42,63,36,42,14,21,3,3,10,50,63,4,2,34,56,29,34,11,22,3,5,10,40,56
2010-01-03 00:00:00.000,Brisbane Australia ATP World Tour 250,HARD,2,Carsten Ball,Mischa Zverev,Carsten Ball,7-5; 6-1,R32,70,10,3,30,57,23,30,19,27,0,0,10,42,57,2,2,34,66,22,34,14,32,7,10,9,36,66
2010-01-03 00:00:00.000,Brisbane Australia ATP World Tour 250,HARD,2,Richard Gasquet,Jarkko Nieminen,Richard Gasquet,6-3; 4-6; 6-4,R32,121,5,4,51,97,33,51,27,46,5,8,15,60,97,4,0,58,85,38,58,14,27,7,11,14,52,85
2010-01-03 00:00:00.000,Brisbane Australia ATP World Tour 250,HARD,2,Matthew Ebden,Jurgen Melzer,Matthew Ebden,7-5; 6-1,R32,64,12,1,35,50,30,35,12,15,3,3,10,42,50,2,1,29,53,16,29,15,24,2,5,9,31,53
2010-01-03 00:00:00.000,Brisbane Australia ATP World Tour 250,HARD,2,Tomas Berdych,Nick Lindahl,Tomas Berdych,6-2; 6-4,R32,69,3,1,27,46,24,27,14,19,1,1,9,38,46,6,1,41,69,26,41,14,28,6,9,9,40,69
2010-01-03 00:00:00.000,Brisbane Australia ATP World Tour 250,HARD,2,Marcos Baghdatis,Mardy Fish,Marcos Baghdatis,7-5; 7-5,R32,101,7,5,32,62,27,32,17,30,0,1,12,44,62,7,3,36,77,28,36,20,41,3,6,12,48,77
2010-01-03 00:00:00.000,Brisbane Australia ATP World Tour 250,HARD,2,Harel Levy,Michael Llodra,Harel Levy,6-2; 6-0,R32,41,8,0,23,35,18,23,10,12,0,0,7,28,35,0,0,36,46,17,36,3,10,5,10,7,20,46
2010-01-03 00:00:00.000,Brisbane Australia ATP World Tour 250,HARD,2,Thomaz Bellucci,Juan Ignacio Chela,Thomaz Bellucci,6-3; 3-6; 6-1,R32,105,12,4,58,87,37,58,14,29,6,10,13,51,87,1,1,38,71,20,38,17,33,2,8,12,37,71
2010-01-03 00:00:00.000,Brisbane Australia ATP World Tour 250,HARD,2,James Blake,Sam Querrey,James Blake,4-6; 6-3; 6-4,R32,88,10,3,47,86,40,47,24,39,2,3,15,64,86,9,3,52,85,41,52,16,33,3,5,14,57,85
2010-01-03 00:00:00.000,Brisbane Australia ATP World Tour 250,HARD,2,Marc Gicquel,Philipp Petzschner,Marc Gicquel,6-3; 6-1,R32,50,4,1,27,38,25,27,8,11,0,0,8,33,38,4,2,21,46,15,21,10,25,1,5,8,25,46
2010-01-03 00:00:00.000,Brisbane Australia ATP World Tour 250,HARD,2,Florent Serra,Julian Reister,Florent Serra,6-7(3); 7-6(5); 7-5,R32,160,9,1,67,107,46,67,28,40,2,5,18,74,107,7,1,105,143,69,105,19,38,5,9,18,88,143
2010-01-03 00:00:00.000,Brisbane Australia ATP World Tour 250,HARD,2,Gael Monfils,Taylor Dent,Gael Monfils,7-6(1); 6-7(5); 6-2,R32,133,9,4,60,104,48,60,28,44,5,5,16,76,104,6,4,67,105,52,67,17,38,8,10,16,69,105
2010-01-03 00:00:00.000,Brisbane Australia ATP World Tour 250,HARD,2,Alejandro Falla,Jeremy Chardy,Alejandro Falla,6-4; 6-4,R32,73,2,2,25,59,19,25,24,34,3,3,10,43,59,6,2,32,56,25,32,11,24,3,5,10,36,56
2010-01-03 00:00:00.000,Brisbane Australia ATP World Tour 250,HARD,2,Wayne Odesnik,Arnaud Clement,Wayne Odesnik,6-4; 7-6(2),R32,113,10,1,58,86,36,58,17,28,7,9,11,53,86,7,2,42,67,32,42,11,25,4,7,11,43,67
2010-01-03 00:00:00.000,Brisbane Australia ATP World Tour 250,HARD,2,Alexandr Dolgopolov,Bernard Tomic,Alexandr Dolgopolov,6-4; 6-4,R32,69,13,1,37,62,29,37,13,25,3,4,10,42,62,2,1,45,75,33,45,10,30,8,11,10,43,75
2010-01-03 00:00:00.000,Brisbane Australia ATP World Tour 250,HARD,2,Radek Stepanek,John Millman,Radek Stepanek,6-4; 6-0,R32,70,3,2,34,46,29,34,3,12,2,3,8,32,46,1,4,27,52,14,27,10,25,1,6,8,24,52
2010-01-03 00:00:00.000,Brisbane Australia ATP World Tour 250,HARD,2,Andy Roddick,Carsten Ball,Andy Roddick,7-6(0); 6-3,R16,81,9,0,49,59,41,49,8,10,1,1,11,49,59,8,3,36,68,26,36,18,32,7,8,10,44,68
2010-01-03 00:00:00.000,Brisbane Australia ATP World Tour 250,HARD,2,Richard Gasquet,Matthew Ebden,Richard Gasquet,6-3; 6-4,R16,80,6,2,37,59,30,37,12,22,3,4,10,42,59,5,0,36,55,22,36,9,19,3,6,9,31,55
2010-01-03 00:00:00.000,Brisbane Australia ATP World Tour 250,HARD,2,Tomas Berdych,Marcos Baghdatis,Tomas Berdych,6-0; 6-1,R16,66,0,0,23,46,16,23,16,23,3,3,7,32,46,1,3,13,36,7,13,6,23,2,7,6,13,36
2010-01-03 00:00:00.000,Brisbane Australia ATP World Tour 250,HARD,2,Thomaz Bellucci,Harel Levy,Thomaz Bellucci,6-4; 4-6; 6-4,R16,120,7,1,53,86,42,53,20,33,3,4,15,62,86,6,1,42,79,39,42,18,37,3,5,15,57,79
2010-01-03 00:00:00.000,Brisbane Australia ATP World Tour 250,HARD,2,James Blake,Marc Gicquel,James Blake,6-3; 3-6; 7-6(8),R16,120,13,2,51,95,42,51,23,44,2,4,15,65,95,8,5,65,120,45,65,30,55,8,10,15,75,120
2010-01-03 00:00:00.000,Brisbane Australia ATP World Tour 250,HARD,2,Gael Monfils,Florent Serra,Gael Monfils,6-7(5); 7-6(5); 6-1,R16,139,16,6,53,101,41,53,23,48,4,7,15,64,101,9,3,72,114,49,72,17,42,7,13,16,66,114
2010-01-03 00:00:00.000,Brisbane Australia ATP World Tour 250,HARD,2,Wayne Odesnik,Alejandro Falla,Wayne Odesnik,6-7(8); 6-2; 6-1,R16,136,4,1,57,96,41,57,24,39,6,7,14,65,96,8,6,44,82,33,44,14,38,4,9,13,47,82
2010-01-03 00:00:00.000,Brisbane Australia ATP World Tour 250,HARD,2,Radek Stepanek,Alexandr Dolgopolov,Radek Stepanek,5-7; 7-6(4); 6-2,R16,140,11,7,70,108,53,70,18,38,4,7,16,71,108,9,6,49,98,40,49,22,49,4,8,16,62,98
2010-01-03 00:00:00.000,Brisbane Australia ATP World Tour 250,HARD,2,Andy Roddick,Richard Gasquet,Andy Roddick,6-3; 7-6(5),Q,85,16,1,45,60,39,45,10,15,0,0,11,49,60,6,2,38,67,31,38,14,29,7,8,10,45,67
2010-01-03 00:00:00.000,Brisbane Australia ATP World Tour 250,HARD,2,Tomas Berdych,Thomaz Bellucci,Tomas Berdych,7-6(4); 2-6; 7-6(3),Q,162,12,2,59,99,45,59,23,40,3,6,16,68,99,8,5,62,113,46,62,27,51,2,3,16,73,113
2010-01-03 00:00:00.000,Brisbane Australia ATP World Tour 250,HARD,2,Gael Monfils,James Blake,Gael Monfils,3-6; 6-3; 6-4,Q,104,13,4,55,90,41,55,18,35,7,9,14,59,90,4,5,50,88,38,50,17,38,3,6,14,55,88
2010-01-03 00:00:00.000,Brisbane Australia ATP World Tour 250,HARD,2,Radek Stepanek,Wayne Odesnik,Radek Stepanek,7-6(2); 6-1,Q,100,7,4,33,61,24,33,17,28,1,2,9,41,61,3,3,40,69,25,40,11,29,6,10,10,36,69
2010-01-03 00:00:00.000,Brisbane Australia ATP World Tour 250,HARD,2,Andy Roddick,Tomas Berdych,Andy Roddick,1-6; 6-3; 6-4,S,128,7,1,60,81,43,60,11,21,4,6,13,54,81,12,2,43,88,34,43,21,45,10,12,13,55,88
2010-01-03 00:00:00.000,Brisbane Australia ATP World Tour 250,HARD,2,Radek Stepanek,Gael Monfils,Radek Stepanek,6-2; 6-1,S,61,3,0,31,50,20,31,15,19,1,1,8,35,50,1,3,27,45,14,27,7,18,3,7,7,21,45
2010-01-03 00:00:00.000,Brisbane Australia ATP World Tour 250,HARD,2,Andy Roddick,Radek Stepanek,Andy Roddick,7-6(2); 7-6(7),F,125,7,1,64,83,45,64,13,19,3,5,12,58,83,5,8,56,95,38,56,21,39,6,8,12,59,95
2010-01-04 00:00:00.000,Chennai India ATP World Tour 250,HARD,2,Robby Ginepri,Robin Soderling,Robby Ginepri,6-4; 7-5,R32,91,11,4,56,82,40,56,11,26,7,8,11,51,82,9,5,39,65,28,39,10,26,5,8,11,38,65
2010-01-04 00:00:00.000,Chennai India ATP World Tour 250,HARD,2,Lukas Lacko,Yen-Hsun Lu,Lukas Lacko,6-4; 6-3,R32,91,5,3,35,63,21,35,18,28,8,10,9,39,63,0,6,32,67,17,32,16,35,5,10,10,33,67
2010-01-04 00:00:00.000,Chennai India ATP World Tour 250,HARD,2,Kevin Kim,Daniel Brands,Kevin Kim,6-2; 6-2,R32,68,5,3,33,54,26,33,11,21,2,2,8,37,54,5,3,32,52,15,32,10,20,7,11,8,25,52
2010-01-04 00:00:00.000,Chennai India ATP World Tour 250,HARD,2,Dudi Sela,Denis Istomin,Dudi Sela,6-1; 6-2,R32,59,2,5,19,41,14,19,13,22,2,3,7,27,41,1,2,31,48,15,31,5,17,4,10,8,20,48
2010-01-04 00:00:00.000,Chennai India ATP World Tour 250,HARD,2,Stanislas Wawrinka,Rohan Bopanna,Stanislas Wawrinka,6-1; 6-4,R32,51,5,3,26,45,22,26,14,19,0,0,9,36,45,1,4,24,42,18,24,8,18,3,6,8,26,42
2010-01-04 00:00:00.000,Chennai India ATP World Tour 250,HARD,2,Michael Russell,Prakash Amritraj,Michael Russell,6-3; 6-1,R32,67,3,1,30,47,26,30,10,17,3,3,8,36,47,6,2,35,51,25,35,2,16,1,5,8,27,51
2010-01-04 00:00:00.000,Chennai India ATP World Tour 250,HARD,2,Stephane Robert,Louk Sorensen,Stephane Robert,6-2; 6-1,R32,71,0,0,21,43,13,21,17,22,1,1,7,30,43,3,0,34,58,16,34,12,24,2,7,8,28,58
2010-01-04 00:00:00.000,Chennai India ATP World Tour 250,HARD,2,Michael Berrer,Santiago Ventura,Michael Berrer,6-3; 6-2,R32,71,4,4,27,51,25,27,13,24,2,2,9,38,51,2,2,29,56,17,29,13,27,2,5,8,30,56
2010-01-04 00:00:00.000,Chennai India ATP World Tour 250,HARD,2,Thiemo de Bakker,Rajeev Ram,Thiemo de Bakker,6-1; 6-1,R32,60,3,0,29,42,24,29,8,13,3,3,7,32,42,7,2,36,58,21,36,6,22,10,15,7,27,58
2010-01-04 00:00:00.000,Chennai India ATP World Tour 250,HARD,2,Robin Haase,Tsung-Hua Yang,Robin Haase,6-4; 6-3,R32,61,10,2,30,45,26,30,11,15,0,0,9,37,45,1,2,44,65,25,44,12,21,8,11,10,37,65
2010-01-04 00:00:00.000,Chennai India ATP World Tour 250,HARD,2,Somdev Devvarman,Rainer Schuettler,Somdev Devvarman,7-5; 6-2,R32,97,1,2,32,60,23,32,16,28,1,3,10,39,60,1,1,40,74,21,40,16,34,5,10,10,37,74
2010-01-04 00:00:00.000,Chennai India ATP World Tour 250,HARD,2,Janko Tipsarevic,Carlos Moya,Janko Tipsarevic,6-3; 7-6(2),R32,92,3,1,35,61,29,35,17,26,0,1,11,46,61,3,3,38,61,27,38,10,23,2,4,10,37,61
2010-01-04 00:00:00.000,Chennai India ATP World Tour 250,HARD,2,Jan Hajek,Simon Greul,Jan Hajek,3-6; 6-2; 6-4,R32,107,2,0,50,77,37,50,14,27,1,3,13,51,77,7,2,55,91,40,55,13,36,6,10,14,53,91
2010-01-04 00:00:00.000,Chennai India ATP World Tour 250,HARD,2,Santiago Giraldo,Bjorn Phau,Santiago Giraldo,6-4; 6-7(6); 6-3,R32,123,6,2,52,98,42,52,25,46,2,4,16,67,98,4,3,45,88,32,45,24,43,1,5,15,56,88
2010-01-04 00:00:00.000,Chennai India ATP World Tour 250,HARD,2,Marcel Granollers,James Ward,Marcel Granollers,5-7; 6-2; 6-2,R32,113,7,5,45,84,32,45,22,39,0,3,14,54,84,6,4,43,75,26,43,13,32,2,8,14,39,75
2010-01-04 00:00:00.000,Chennai India ATP World Tour 250,HARD,2,Marin Cilic,Igor Kunitsyn,Marin Cilic,6-2; 6-4,R32,73,8,1,33,48,28,33,9,15,0,0,9,37,48,1,2,33,65,27,33,8,32,5,8,9,35,65
2010-01-04 00:00:00.000,Chennai India ATP World Tour 250,HARD,2,Lukas Lacko,Robby Ginepri,Lukas Lacko,7-6(3); 6-4,R16,93,11,1,50,75,38,50,14,25,3,4,11,52,75,4,1,38,71,23,38,24,33,2,4,11,47,71
2010-01-04 00:00:00.000,Chennai India ATP World Tour 250,HARD,2,Dudi Sela,Kevin Kim,Dudi Sela,7-6(3); 6-2,R16,98,3,2,49,68,36,49,12,19,3,3,10,48,68,3,5,41,77,31,41,14,36,5,7,10,45,77
2010-01-04 00:00:00.000,Chennai India ATP World Tour 250,HARD,2,Stanislas Wawrinka,Michael Russell,Stanislas Wawrinka,6-3; 6-4,R16,91,5,4,33,63,24,33,17,30,2,3,10,41,63,0,3,29,55,16,29,16,26,3,6,9,32,55
2010-01-04 00:00:00.000,Chennai India ATP World Tour 250,HARD,2,Michael Berrer,Stephane Robert,Michael Berrer,7-6(7); 6-3,R16,100,2,3,45,69,34,45,15,24,3,4,10,49,69,2,1,32,73,21,32,24,41,2,5,11,45,73
2010-01-04 00:00:00.000,Chennai India ATP World Tour 250,HARD,2,Thiemo de Bakker,Robin Haase,Thiemo de Bakker,6-3; 6-4,R16,79,6,1,35,54,26,35,10,19,0,2,10,36,54,2,3,36,58,23,36,9,22,4,8,9,32,58
2010-01-04 00:00:00.000,Chennai India ATP World Tour 250,HARD,2,Janko Tipsarevic,Somdev Devvarman,Janko Tipsarevic,6-2; 6-1,R16,78,0,1,24,42,15,24,9,18,1,3,7,24,42,0,0,28,46,8,28,8,18,3,10,8,16,46
2010-01-04 00:00:00.000,Chennai India ATP World Tour 250,HARD,2,Santiago Giraldo,Jan Hajek,Santiago Giraldo,6-4; 6-2,R16,67,8,1,34,58,27,34,13,24,4,5,9,40,58,1,0,36,49,18,36,9,13,1,5,9,27,49
2010-01-04 00:00:00.000,Chennai India ATP World Tour 250,HARD,2,Marin Cilic,Marcel Granollers,Marin Cilic,6-7(3); 6-3; 6-4,R16,166,5,1,56,110,40,56,28,54,4,7,16,68,110,3,4,56,102,36,56,22,46,9,14,15,58,102
2010-01-04 00:00:00.000,Chennai India ATP World Tour 250,HARD,2,Dudi Sela,Lukas Lacko,Dudi Sela,7-6(3); 7-5,Q,115,1,4,44,80,33,44,17,36,3,6,12,50,80,1,2,44,81,30,44,15,37,6,10,12,45,81
2010-01-04 00:00:00.000,Chennai India ATP World Tour 250,HARD,2,Stanislas Wawrinka,Michael Berrer,Stanislas Wawrinka,7-6(5); 6-4,Q,110,6,2,41,69,33,41,15,28,4,5,11,48,69,2,2,47,70,34,47,9,23,2,4,11,43,70
2010-01-04 00:00:00.000,Chennai India ATP World Tour 250,HARD,2,Janko Tipsarevic,Thiemo de Bakker,Janko Tipsarevic,7-5; 7-5,Q,126,3,3,43,71,28,43,16,28,4,7,12,44,71,7,1,51,80,31,51,12,29,9,14,12,43,80
2010-01-04 00:00:00.000,Chennai India ATP World Tour 250,HARD,2,Marin Cilic,Santiago Giraldo,Marin Cilic,7-6(3); 6-1,Q,99,3,2,37,75,19,37,24,38,6,8,10,43,75,3,0,30,55,19,30,8,25,0,4,9,27,55
2010-01-04 00:00:00.000,Chennai India ATP World Tour 250,HARD,2,Stanislas Wawrinka,Dudi Sela,Stanislas Wawrinka,6-4; 2-6; 7-5,S,153,2,3,44,88,27,44,27,44,3,6,15,54,88,0,4,69,105,48,69,18,36,5,8,15,66,105
2010-01-04 00:00:00.000,Chennai India ATP World Tour 250,HARD,2,Marin Cilic,Janko Tipsarevic,Marin Cilic,6-1; 6-3,S,84,6,2,26,51,22,26,12,25,1,2,8,34,51,2,2,35,59,16,35,11,24,4,9,8,27,59
2010-01-04 00:00:00.000,Chennai India ATP World Tour 250,HARD,2,Marin Cilic,Stanislas Wawrinka,Marin Cilic,7-6(2); 7-6(3),F,161,2,1,47,83,34,47,22,36,3,5,12,56,83,5,0,52,88,32,52,22,36,6,8,12,54,88
2010-01-04 00:00:00.000,Doha Qatar ATP World Tour 250,HARD,2,Roger Federer,Christophe Rochus,Roger Federer,6-1; 6-2,R32,57,12,1,36,53,28,36,9,17,3,3,8,37,53,0,1,37,54,20,37,6,17,9,13,7,26,54
2010-01-04 00:00:00.000,Doha Qatar ATP World Tour 250,HARD,2,Evgeny Korolev,Martin Vassallo Arguello,Evgeny Korolev,6-2; 6-3,R32,69,1,0,32,38,26,32,3,6,0,1,8,29,38,1,1,47,66,23,47,9,19,3,8,9,32,66
2010-01-04 00:00:00.000,Doha Qatar ATP World Tour 250,HARD,2,Andreas Seppi,Oscar Hernandez,Andreas Seppi,6-4; 7-5,R32,89,6,2,33,53,32,33,13,20,1,1,11,45,53,5,1,55,82,34,55,13,27,5,7,11,47,82
2010-01-04 00:00:00.000,Doha Qatar ATP World Tour 250,HARD,2,Ernests Gulbis,Albert Montanes,Ernests Gulbis,6-2; 7-5,R32,73,13,2,37,50,32,37,9,13,0,0,10,41,50,4,2,43,68,31,43,10,25,7,10,10,41,68
2010-01-04 00:00:00.000,Doha Qatar ATP World Tour 250,HARD,2,Nikolay Davydenko,Mikhail Kukushkin,Nikolay Davydenko,6-2; 6-0,R32,74,4,4,26,47,21,26,10,21,2,3,7,31,47,0,1,22,47,10,22,8,25,1,7,7,18,47
2010-01-04 00:00:00.000,Doha Qatar ATP World Tour 250,HARD,2,Marco Chiudinelli,Paolo Lorenzi,Marco Chiudinelli,7-5; 6-3,R32,98,7,0,37,57,33,37,11,20,2,3,11,44,57,2,3,41,72,24,41,18,31,6,9,10,42,72
2010-01-04 00:00:00.000,Doha Qatar ATP World Tour 250,HARD,2,Benjamin Becker,Daniel Koellerer,Benjamin Becker,5-1 RET,R32,30,2,0,6,14,5,6,7,8,0,0,3,12,14,4,3,14,29,10,14,3,15,1,3,3,13,29
2010-01-04 00:00:00.000,Doha Qatar ATP World Tour 250,HARD,2,Ivo Karlovic,Fabio Fognini,Ivo Karlovic,6-4; 6-4,R32,94,7,0,43,69,32,43,14,26,2,2,10,46,69,3,1,37,55,25,37,11,18,4,6,10,36,55
2010-01-04 00:00:00.000,Doha Qatar ATP World Tour 250,HARD,2,Viktor Troicki,Daniel Gimeno-Traver,Viktor Troicki,6-1; 7-5,R32,55,10,3,31,48,27,31,11,17,0,1,10,38,48,2,3,35,53,20,35,7,18,3,7,9,27,53
2010-01-04 00:00:00.000,Doha Qatar ATP World Tour 250,HARD,2,Olivier Rochus,Abdulla Hajji,Olivier Rochus,6-1; 6-0,R32,38,3,2,16,31,14,16,11,15,0,0,6,25,31,0,2,22,35,7,22,2,13,1,7,7,9,35
2010-01-04 00:00:00.000,Doha Qatar ATP World Tour 250,HARD,2,Lukasz Kubot,Karim Maamoun,Lukasz Kubot,6-0; 6-2,R32,48,2,3,19,36,15,19,11,17,2,3,7,26,36,0,2,29,43,9,29,6,14,7,13,7,15,43
2010-01-04 00:00:00.000,Doha Qatar ATP World Tour 250,HARD,2,Sergiy Stakhovsky,Mikhail Youzhny,Sergiy Stakhovsky,7-6(11); 6-2,R32,105,9,2,49,75,37,49,15,26,2,2,10,52,75,1,5,45,73,34,45,11,28,3,5,10,45,73
2010-01-04 00:00:00.000,Doha Qatar ATP World Tour 250,HARD,2,Steve Darcis,Guillermo Garcia-Lopez,Steve Darcis,6-4; 6-1,R32,70,1,1,37,53,27,37,7,16,3,4,8,34,53,5,5,32,52,20,32,5,20,0,5,9,25,52
2010-01-04 00:00:00.000,Doha Qatar ATP World Tour 250,HARD,2,Younes El Aynaoui,Ryler DeHeart,Younes El Aynaoui,7-6(3); 7-6(4),R32,99,16,4,46,76,39,46,16,30,2,3,12,55,76,2,1,51,80,35,51,17,29,3,4,12,52,80
2010-01-04 00:00:00.000,Doha Qatar ATP World Tour 250,HARD,2,Potito Starace,Frederico Gil,Potito Starace,6-2; 6-0,R32,58,1,1,33,44,24,33,6,11,1,1,7,30,44,1,3,32,52,14,32,9,20,7,12,7,23,52
2010-01-04 00:00:00.000,Doha Qatar ATP World Tour 250,HARD,2,Rafael Nadal,Simone Bolelli,Rafael Nadal,6-3; 6-3,R32,88,5,0,36,54,26,36,13,18,3,3,9,39,54,4,1,40,68,27,40,10,28,4,7,9,37,68
2010-01-04 00:00:00.000,Doha Qatar ATP World Tour 250,HARD,2,Roger Federer,Evgeny Korolev,Roger Federer,6-2; 6-4,R16,64,3,1,25,43,21,25,12,18,1,2,9,33,43,0,3,40,64,26,40,9,24,5,9,9,35,64
2010-01-04 00:00:00.000,Doha Qatar ATP World Tour 250,HARD,2,Ernests Gulbis,Andreas Seppi,Ernests Gulbis,6-4; 7-5,R16,82,6,6,38,57,32,38,10,19,1,2,11,42,57,1,3,40,71,25,40,15,31,6,9,11,40,71
2010-01-04 00:00:00.000,Doha Qatar ATP World Tour 250,HARD,2,Nikolay Davydenko,Marco Chiudinelli,Nikolay Davydenko,6-3; 6-4,R16,83,6,3,37,56,28,37,10,19,5,6,9,38,56,2,3,49,72,30,49,9,23,5,9,10,39,72
2010-01-04 00:00:00.000,Doha Qatar ATP World Tour 250,HARD,2,Ivo Karlovic,Benjamin Becker,Ivo Karlovic,4-6; 6-3; 6-2,R16,101,20,2,49,78,38,49,16,29,1,3,14,54,78,6,2,34,67,25,34,16,33,1,5,13,41,67
2010-01-04 00:00:00.000,Doha Qatar ATP World Tour 250,HARD,2,Viktor Troicki,Olivier Rochus,Viktor Troicki,6-2; 6-2,R16,63,12,1,32,51,26,32,8,19,4,5,8,34,51,0,4,30,54,18,30,6,24,4,9,8,24,54
2010-01-04 00:00:00.000,Doha Qatar ATP World Tour 250,HARD,2,Lukasz Kubot,Sergiy Stakhovsky,Lukasz Kubot,6-2; 7-6(5),R16,110,4,4,48,77,36,48,16,29,4,4,10,52,77,7,2,60,91,40,60,12,31,7,9,10,52,91
2010-01-04 00:00:00.000,Doha Qatar ATP World Tour 250,HARD,2,Steve Darcis,Younes El Aynaoui,Steve Darcis,6-3; 6-1,R16,53,4,0,36,49,27,36,9,13,2,2,8,36,49,0,2,25,43,18,25,5,18,4,8,8,23,43
2010-01-04 00:00:00.000,Doha Qatar ATP World Tour 250,HARD,2,Rafael Nadal,Potito Starace,Rafael Nadal,6-2; 6-2,R16,72,3,1,32,50,26,32,9,18,0,0,8,35,50,1,0,30,43,14,30,7,13,1,5,8,21,43
2010-01-04 00:00:00.000,Doha Qatar ATP World Tour 250,HARD,2,Roger Federer,Ernests Gulbis,Roger Federer,6-2; 4-6; 6-4,Q,107,10,0,54,88,40,54,20,34,4,6,14,60,88,13,7,62,95,46,62,11,33,9,13,14,57,95
2010-01-04 00:00:00.000,Doha Qatar ATP World Tour 250,HARD,2,Nikolay Davydenko,Ivo Karlovic,Nikolay Davydenko,7-6(4); 7-6(7),Q,107,3,0,61,71,54,61,4,10,0,0,12,58,71,17,0,52,81,42,52,16,29,2,2,12,58,81
2010-01-04 00:00:00.000,Doha Qatar ATP World Tour 250,HARD,2,Viktor Troicki,Lukasz Kubot,Viktor Troicki,4-6; 6-4; 7-6(1),Q,146,4,2,58,97,46,58,17,39,6,11,16,63,97,4,8,75,108,48,75,16,33,9,14,16,64,108
2010-01-04 00:00:00.000,Doha Qatar ATP World Tour 250,HARD,2,Rafael Nadal,Steve Darcis,Rafael Nadal,6-1; 2-0 RET,Q,35,2,0,12,19,11,12,5,7,0,0,4,16,19,3,2,22,33,8,22,5,11,2,6,5,13,33
2010-01-04 00:00:00.000,Doha Qatar ATP World Tour 250,HARD,2,Nikolay Davydenko,Roger Federer,Nikolay Davydenko,6-4; 6-4,S,81,2,2,48,61,35,48,7,13,2,3,10,42,61,2,3,34,62,23,34,14,28,7,10,10,37,62
2010-01-04 00:00:00.000,Doha Qatar ATP World Tour 250,HARD,2,Rafael Nadal,Viktor Troicki,Rafael Nadal,6-1; 6-3,S,68,1,0,28,45,23,28,9,17,0,1,8,32,45,2,0,33,46,13,33,7,13,3,8,8,20,46
2010-01-04 00:00:00.000,Doha Qatar ATP World Tour 250,HARD,2,Nikolay Davydenko,Rafael Nadal,Nikolay Davydenko,0-6; 7-6(8); 6-4,F,163,2,4,73,99,45,73,12,26,3,8,14,57,99,1,2,57,91,38,57,18,34,5,8,14,56,91
2010-01-11 00:00:00.000,Auckland New Zealand ATP World Tour 250,HARD,2,Tommy Robredo,N/A Bye,Tommy Robredo,,R32,0,0,0,0,0,0,0,0,0,0,0,0,0,0,0,0,0,0,0,0,0,0,0,0,0,0,0
2010-01-11 00:00:00.000,Auckland New Zealand ATP World Tour 250,HARD,2,Simon Greul,Paolo Lorenzi,Simon Greul,6-3; 6-3,R32,87,2,4,31,57,25,31,14,26,8,9,9,39,57,0,6,42,64,22,42,11,22,8,12,9,33,64
2010-01-11 00:00:00.000,Auckland New Zealand ATP World Tour 250,HARD,2,John Isner,Guillermo Garcia-Lopez,John Isner,4-6; 7-6(3); 6-2,R32,120,11,2,56,85,45,56,17,29,3,5,15,62,85,5,5,56,89,37,56,22,33,4,7,15,59,89
2010-01-11 00:00:00.000,Auckland New Zealand ATP World Tour 250,HARD,2,Juan Monaco,Horacio Zeballos,Juan Monaco,6-3; 6-0,R32,63,6,3,28,44,25,28,8,16,2,2,8,33,44,4,2,29,53,18,29,8,24,5,9,7,26,53
2010-01-11 00:00:00.000,Auckland New Zealand ATP World Tour 250,HARD,2,Juan Carlos Ferrero,N/A Bye,Juan Carlos Ferrero,,R32,0,0,0,0,0,0,0,0,0,0,0,0,0,0,0,0,0,0,0,0,0,0,0,0,0,0,0
2010-01-11 00:00:00.000,Auckland New Zealand ATP World Tour 250,HARD,2,Michael Lammer,Daniel Evans,Michael Lammer,1-6; 6-2; 6-4,R32,121,1,4,56,98,34,56,20,42,7,11,13,54,98,5,3,35,67,21,35,18,32,1,5,12,39,67
2010-01-11 00:00:00.000,Auckland New Zealand ATP World Tour 250,HARD,2,Jose (Rubin) Statham,Daniel King-Turner,Jose (Rubin) Statham,6-2; 7-5,R32,96,1,4,48,73,33,48,10,25,7,9,10,43,73,10,3,47,75,29,47,10,28,12,17,10,39,75
2010-01-11 00:00:00.000,Auckland New Zealand ATP World Tour 250,HARD,2,Albert Montanes,James Lemke,Albert Montanes,6-1; 7-5,R32,72,5,1,36,58,27,36,9,22,2,4,9,36,58,0,5,38,60,19,38,7,22,0,6,10,26,60
2010-01-11 00:00:00.000,Auckland New Zealand ATP World Tour 250,HARD,2,Philipp Kohlschreiber,Inigo Cervantes,Philipp Kohlschreiber,6-2; 6-3,R32,63,1,0,33,49,21,33,15,16,2,3,9,36,49,1,5,24,50,18,24,8,26,3,7,8,26,50
2010-01-11 00:00:00.000,Auckland New Zealand ATP World Tour 250,HARD,2,Thomaz Bellucci,Marco Chiudinelli,Thomaz Bellucci,6-3; 6-3,R32,64,8,3,37,54,29,37,9,17,1,1,9,38,54,3,0,34,53,20,34,11,19,1,4,9,31,53
2010-01-11 00:00:00.000,Auckland New Zealand ATP World Tour 250,HARD,2,Marc Gicquel,Olivier Rochus,Marc Gicquel,6-3; 6-2,R32,64,5,2,32,59,23,32,16,27,0,1,9,39,59,1,3,23,47,13,23,12,24,6,10,8,25,47
2010-01-11 00:00:00.000,Auckland New Zealand ATP World Tour 250,HARD,2,Nicolas Almagro,N/A Bye,Nicolas Almagro,,R32,0,0,0,0,0,0,0,0,0,0,0,0,0,0,0,0,0,0,0,0,0,0,0,0,0,0,0
2010-01-11 00:00:00.000,Auckland New Zealand ATP World Tour 250,HARD,2,Jurgen Melzer,Fabio Fognini,Jurgen Melzer,5-7; 6-3; 6-2,R32,105,8,6,50,82,38,50,21,32,0,1,15,59,82,3,7,45,93,34,45,23,48,6,9,14,57,93
2010-01-11 00:00:00.000,Auckland New Zealand ATP World Tour 250,HARD,2,Sebastien Grosjean,Florian Mayer,Sebastien Grosjean,6-3; 3-6; 6-3,R32,122,5,3,48,110,33,48,34,62,11,13,14,67,110,1,3,50,81,34,50,15,31,6,9,13,49,81
2010-01-11 00:00:00.000,Auckland New Zealand ATP World Tour 250,HARD,2,Arnaud Clement,Jeremy Chardy,Arnaud Clement,7-5; 6-4,R32,111,5,3,50,81,31,50,16,31,5,8,11,47,81,4,6,35,79,21,35,19,44,7,12,11,40,79
2010-01-11 00:00:00.000,Auckland New Zealand ATP World Tour 250,HARD,2,David Ferrer,N/A Bye,David Ferrer,,R32,0,0,0,0,0,0,0,0,0,0,0,0,0,0,0,0,0,0,0,0,0,0,0,0,0,0,0
2010-01-11 00:00:00.000,Auckland New Zealand ATP World Tour 250,HARD,2,Tommy Robredo,Simon Greul,Tommy Robredo,7-6(1); 7-6(2),R16,98,7,5,45,69,34,45,12,24,1,4,12,46,69,3,7,39,85,26,39,21,46,3,6,12,47,85
2010-01-11 00:00:00.000,Auckland New Zealand ATP World Tour 250,HARD,2,John Isner,Juan Monaco,John Isner,5-7; 6-4; 6-3,R16,135,11,3,53,93,37,53,25,40,1,2,15,62,93,2,3,71,102,52,71,15,31,5,8,16,67,102
2010-01-11 00:00:00.000,Auckland New Zealand ATP World Tour 250,HARD,2,Michael Lammer,Juan Carlos Ferrero,Michael Lammer,3-1 RET,R16,26,1,1,9,15,8,9,3,6,0,0,2,11,15,0,0,10,12,5,10,1,2,1,2,2,6,12
2010-01-11 00:00:00.000,Auckland New Zealand ATP World Tour 250,HARD,2,Albert Montanes,Jose (Rubin) Statham,Albert Montanes,7-6(6); 6-2,R16,86,1,0,36,68,29,36,21,32,1,1,10,50,68,5,3,43,70,31,43,14,27,4,6,10,45,70
2010-01-11 00:00:00.000,Auckland New Zealand ATP World Tour 250,HARD,2,Philipp Kohlschreiber,Thomaz Bellucci,Philipp Kohlschreiber,6-4; 6-1,R16,82,1,3,40,67,28,40,14,27,7,9,9,42,67,3,1,28,46,14,28,4,18,1,6,8,18,46
2010-01-11 00:00:00.000,Auckland New Zealand ATP World Tour 250,HARD,2,Marc Gicquel,Nicolas Almagro,Marc Gicquel,6-0; 6-3,R16,59,3,3,26,42,19,26,9,16,2,3,7,28,42,8,1,42,63,21,42,6,21,4,10,8,27,63
2010-01-11 00:00:00.000,Auckland New Zealand ATP World Tour 250,HARD,2,Jurgen Melzer,Sebastien Grosjean,Jurgen Melzer,6-2; 6-7(5); 7-6(1),R16,134,10,4,47,96,42,47,30,49,6,7,16,72,96,1,3,69,112,48,69,22,43,3,6,16,70,112
2010-01-11 00:00:00.000,Auckland New Zealand ATP World Tour 250,HARD,2,Arnaud Clement,David Ferrer,Arnaud Clement,7-5; 6-4,R16,110,3,3,52,93,37,52,21,41,5,5,11,58,93,2,1,43,60,30,43,9,17,2,4,11,39,60
2010-01-11 00:00:00.000,Auckland New Zealand ATP World Tour 250,HARD,2,John Isner,Tommy Robredo,John Isner,7-6(5); 3-6; 6-4,Q,132,20,4,74,102,56,74,11,28,9,12,15,67,102,2,7,55,99,38,55,25,44,6,9,16,63,99
2010-01-11 00:00:00.000,Auckland New Zealand ATP World Tour 250,HARD,2,Albert Montanes,Michael Lammer,Albert Montanes,6-3; 6-3,Q,75,5,4,32,56,24,32,13,24,4,5,9,37,56,4,2,33,56,23,33,7,23,3,7,9,30,56
2010-01-11 00:00:00.000,Auckland New Zealand ATP World Tour 250,HARD,2,Philipp Kohlschreiber,Marc Gicquel,Philipp Kohlschreiber,6-3; 6-1,Q,54,6,1,23,40,19,23,12,17,0,1,8,31,40,2,4,18,43,9,18,8,25,1,6,8,17,43
2010-01-11 00:00:00.000,Auckland New Zealand ATP World Tour 250,HARD,2,Arnaud Clement,Jurgen Melzer,Arnaud Clement,6-2; 7-5,Q,77,3,4,29,52,26,29,13,23,0,1,10,39,52,6,5,31,60,21,31,12,29,3,7,10,33,60
2010-01-11 00:00:00.000,Auckland New Zealand ATP World Tour 250,HARD,2,John Isner,Albert Montanes,John Isner,6-2; 7-6(5),S,79,14,2,43,58,35,43,10,15,0,0,10,45,58,1,1,43,75,31,43,13,32,4,6,10,44,75
2010-01-11 00:00:00.000,Auckland New Zealand ATP World Tour 250,HARD,2,Arnaud Clement,Philipp Kohlschreiber,Arnaud Clement,6-3; 7-6(2),S,99,3,1,39,64,30,39,19,25,0,0,11,49,64,7,3,35,70,29,35,15,35,4,5,10,44,70
2010-01-11 00:00:00.000,Auckland New Zealand ATP World Tour 250,HARD,2,John Isner,Arnaud Clement,John Isner,6-3; 5-7; 7-6(2),F,139,22,2,73,100,59,73,13,27,4,6,17,72,100,8,0,56,93,40,56,24,37,4,6,16,64,93
2010-01-11 00:00:00.000,Sydney Australia ATP World Tour 250,HARD,2,Daniel Gimeno-Traver,N/A Bye,Daniel Gimeno-Traver,,R32,0,0,0,0,0,0,0,0,0,0,0,0,0,0,0,0,0,0,0,0,0,0,0,0,0,0,0
2010-01-11 00:00:00.000,Sydney Australia ATP World Tour 250,HARD,2,Potito Starace,Frederico Gil,Potito Starace,6-1; 6-4,R32,63,2,1,28,46,21,28,11,18,3,4,8,32,46,1,4,30,48,15,30,9,18,4,9,9,24,48
2010-01-11 00:00:00.000,Sydney Australia ATP World Tour 250,HARD,2,Richard Gasquet,Feliciano Lopez,Richard Gasquet,6-1; 6-4,R32,76,3,2,25,49,21,25,18,24,3,3,9,39,49,8,1,45,65,27,45,8,20,13,16,8,35,65
2010-01-11 00:00:00.000,Sydney Australia ATP World Tour 250,HARD,2,Benjamin Becker,Juan Ignacio Chela,Benjamin Becker,6-3; 6-3,R32,73,8,1,24,43,18,24,14,19,0,1,9,32,43,4,4,40,64,21,40,14,24,7,11,9,35,64
2010-01-11 00:00:00.000,Sydney Australia ATP World Tour 250,HARD,2,Taylor Dent,N/A Bye,Taylor Dent,,R32,0,0,0,0,0,0,0,0,0,0,0,0,0,0,0,0,0,0,0,0,0,0,0,0,0,0,0
2010-01-11 00:00:00.000,Sydney Australia ATP World Tour 250,HARD,2,Julien Benneteau,Dudi Sela,Julien Benneteau,6-3; 6-1,R32,76,9,3,32,53,23,32,11,21,5,6,8,34,53,0,1,30,54,16,30,10,24,8,13,8,26,54
2010-01-11 00:00:00.000,Sydney Australia ATP World Tour 250,HARD,2,Pablo Cuevas,Michael Llodra,Pablo Cuevas,6-2; 7-6(1),R32,72,13,4,41,62,34,41,12,21,3,3,10,46,62,3,6,40,66,27,40,14,26,5,7,10,41,66
2010-01-11 00:00:00.000,Sydney Australia ATP World Tour 250,HARD,2,Leonardo Mayer,Igor Andreev,Leonardo Mayer,6-7(7); 6-3; 7-6(4),R32,191,6,4,72,122,51,72,32,50,13,15,17,83,122,8,4,59,116,46,59,31,57,7,10,16,77,116
2010-01-11 00:00:00.000,Sydney Australia ATP World Tour 250,HARD,2,Viktor Troicki,Florent Serra,Viktor Troicki,7-6(5); 6-4,R32,94,20,4,46,76,37,46,16,30,3,4,11,53,76,3,4,42,72,31,42,15,30,3,5,11,46,72
2010-01-11 00:00:00.000,Sydney Australia ATP World Tour 250,HARD,2,Marcos Baghdatis,Nick Lindahl,Marcos Baghdatis,6-2; 7-5,R32,80,7,5,21,59,19,21,22,38,2,3,10,41,59,1,2,42,58,25,42,7,16,6,10,10,32,58
2010-01-11 00:00:00.000,Sydney Australia ATP World Tour 250,HARD,2,Andreas Seppi,Marinko Matosevic,Andreas Seppi,6-4; 6-4,R32,88,2,1,37,59,27,37,12,22,3,5,10,39,59,3,5,46,79,26,46,17,33,8,12,10,43,79
2010-01-11 00:00:00.000,Sydney Australia ATP World Tour 250,HARD,2,Lleyton Hewitt,N/A Bye,Lleyton Hewitt,,R32,0,0,0,0,0,0,0,0,0,0,0,0,0,0,0,0,0,0,0,0,0,0,0,0,0,0,0
2010-01-11 00:00:00.000,Sydney Australia ATP World Tour 250,HARD,2,Evgeny Korolev,Sam Querrey,Evgeny Korolev,6-2; 5-7; 6-4,R32,105,4,7,59,91,43,59,16,32,4,7,15,59,91,9,3,54,86,38,54,10,32,3,8,15,48,86
2010-01-11 00:00:00.000,Sydney Australia ATP World Tour 250,HARD,2,Mardy Fish,Carsten Ball,Mardy Fish,6-4; 7-6(4),R32,95,9,4,26,64,22,26,27,38,1,1,11,49,64,10,4,27,58,24,27,19,31,1,2,11,43,58
2010-01-11 00:00:00.000,Sydney Australia ATP World Tour 250,HARD,2,Peter Luczak,Jose Acasuso,Peter Luczak,7-6(1); 6-4,R32,95,11,3,42,68,34,42,14,26,4,5,11,48,68,5,4,39,69,30,39,14,30,5,7,11,44,69
2010-01-11 00:00:00.000,Sydney Australia ATP World Tour 250,HARD,2,Tomas Berdych,N/A Bye,Tomas Berdych,,R32,0,0,0,0,0,0,0,0,0,0,0,0,0,0,0,0,0,0,0,0,0,0,0,0,0,0,0
2010-01-11 00:00:00.000,Sydney Australia ATP World Tour 250,HARD,2,Potito Starace,Daniel Gimeno-Traver,Potito Starace,6-3; 3-2 RET,R16,67,1,1,27,44,23,27,9,17,2,2,7,32,44,4,3,24,52,14,24,15,28,8,10,7,29,52
2010-01-11 00:00:00.000,Sydney Australia ATP World Tour 250,HARD,2,Richard Gasquet,Benjamin Becker,Richard Gasquet,6-2; 7-6(4),R16,105,6,2,39,68,28,39,18,29,2,3,10,46,68,10,2,44,66,32,44,9,22,2,5,10,41,66
2010-01-11 00:00:00.000,Sydney Australia ATP World Tour 250,HARD,2,Julien Benneteau,Taylor Dent,Julien Benneteau,6-3; 5-7; 7-6(2),R16,140,4,4,66,95,49,66,19,29,3,4,16,68,95,10,7,56,105,48,56,22,49,5,7,17,70,105
2010-01-11 00:00:00.000,Sydney Australia ATP World Tour 250,HARD,2,Leonardo Mayer,Pablo Cuevas,Leonardo Mayer,6-4; 6-2,R16,80,3,3,29,53,24,29,13,24,2,2,9,37,53,3,3,38,64,26,38,11,26,3,6,9,37,64
2010-01-11 00:00:00.000,Sydney Australia ATP World Tour 250,HARD,2,Marcos Baghdatis,Viktor Troicki,Marcos Baghdatis,7-5; 6-3,R16,96,7,1,34,63,31,34,14,29,1,2,11,45,63,6,3,36,70,27,36,13,34,7,10,10,40,70
2010-01-11 00:00:00.000,Sydney Australia ATP World Tour 250,HARD,2,Lleyton Hewitt,Andreas Seppi,Lleyton Hewitt,6-0; 6-2,R16,56,3,2,22,38,18,22,8,16,1,2,7,26,38,3,3,28,45,12,28,5,17,0,6,7,17,45
2010-01-11 00:00:00.000,Sydney Australia ATP World Tour 250,HARD,2,Mardy Fish,Evgeny Korolev,Mardy Fish,6-1; 6-2,R16,59,8,0,27,47,21,27,15,20,1,1,8,36,47,1,3,18,40,12,18,8,22,2,6,7,20,40
2010-01-11 00:00:00.000,Sydney Australia ATP World Tour 250,HARD,2,Peter Luczak,Tomas Berdych,Peter Luczak,1-6; 6-4; 6-2,R16,117,7,3,55,88,38,55,15,33,7,10,13,53,88,12,0,40,66,28,40,14,26,2,5,12,42,66
2010-01-11 00:00:00.000,Sydney Australia ATP World Tour 250,HARD,2,Richard Gasquet,Potito Starace,Richard Gasquet,6-3; 7-6(7),Q,86,9,4,45,67,34,45,12,22,4,5,10,46,67,1,3,47,71,30,47,12,24,2,5,11,42,71
2010-01-11 00:00:00.000,Sydney Australia ATP World Tour 250,HARD,2,Julien Benneteau,Leonardo Mayer,Julien Benneteau,6-4; 6-7(5); 6-0,Q,134,6,5,58,93,47,58,16,35,9,11,14,63,93,4,8,40,85,28,40,21,45,5,11,14,49,85
2010-01-11 00:00:00.000,Sydney Australia ATP World Tour 250,HARD,2,Marcos Baghdatis,Lleyton Hewitt,Marcos Baghdatis,4-6; 6-2; 6-3,Q,120,8,3,41,78,32,41,21,37,0,2,14,53,78,7,3,54,89,33,54,18,35,6,10,13,51,89
2010-01-11 00:00:00.000,Sydney Australia ATP World Tour 250,HARD,2,Mardy Fish,Peter Luczak,Mardy Fish,7-6(5); 6-2,Q,103,16,2,43,74,40,43,12,31,0,0,10,52,74,5,3,40,72,27,40,17,32,2,4,10,44,72
2010-01-11 00:00:00.000,Sydney Australia ATP World Tour 250,HARD,2,Richard Gasquet,Julien Benneteau,Richard Gasquet,6-4; 7-5,S,99,5,3,33,69,23,33,20,36,4,6,11,43,69,1,2,32,66,22,32,16,34,1,5,11,38,66
2010-01-11 00:00:00.000,Sydney Australia ATP World Tour 250,HARD,2,Marcos Baghdatis,Mardy Fish,Marcos Baghdatis,6-4; 6-7(7); 7-6(5),S,178,8,7,53,119,40,53,37,66,6,9,17,77,119,16,7,61,124,48,61,28,63,4,8,17,76,124
2010-01-11 00:00:00.000,Sydney Australia ATP World Tour 250,HARD,2,Marcos Baghdatis,Richard Gasquet,Marcos Baghdatis,6-4; 7-6(2),F,104,9,4,41,81,30,41,22,40,3,4,11,52,81,6,4,36,71,28,36,15,35,2,4,11,43,71
2010-01-18 00:00:00.000,Australian Open Australia Grand Slams,HARD,3,Roger Federer,Igor Andreev,Roger Federer,4-6; 6-2; 7-6(2); 6-0,R128,164,9,2,57,102,44,57,22,45,6,11,18,66,102,2,7,84,136,48,84,19,52,10,19,18,67,136
2010-01-18 00:00:00.000,Australian Open Australia Grand Slams,HARD,3,Victor Hanescu,Juan Ignacio Chela,Victor Hanescu,6-4; 6-3; 7-6(2),R128,137,6,1,78,110,54,78,18,32,4,7,16,72,110,6,4,60,112,38,60,20,52,8,13,15,58,112
2010-01-18 00:00:00.000,Australian Open Australia Grand Slams,HARD,3,Stephane Robert,Potito Starace,Stephane Robert,6-3; 7-6(2); 7-6(4),R128,143,3,2,83,134,61,83,29,51,9,11,17,90,134,5,2,68,110,45,68,21,42,3,6,16,66,110
2010-01-18 00:00:00.000,Australian Open Australia Grand Slams,HARD,3,Albert Montanes,Oscar Hernandez,Albert Montanes,7-6(5); 2-2 RET,R128,81,4,2,28,47,22,28,12,19,0,1,8,34,47,0,2,38,70,23,38,17,32,7,8,8,40,70
2010-01-18 00:00:00.000,Australian Open Australia Grand Slams,HARD,3,Lleyton Hewitt,Ricardo Hocevar,Lleyton Hewitt,6-1; 6-2; 6-3,R128,100,10,3,37,62,33,37,16,25,1,1,12,49,62,5,4,59,84,36,59,9,25,6,12,12,45,84
2010-01-18 00:00:00.000,Australian Open Australia Grand Slams,HARD,3,Donald Young,Christophe Rochus,Donald Young,1-6; 7-5; 6-2; 6-4,R128,175,6,6,70,130,50,70,29,60,10,15,19,79,130,4,6,68,108,45,68,16,40,2,6,18,61,108
2010-01-18 00:00:00.000,Australian Open Australia Grand Slams,HARD,3,Marcos Baghdatis,Paolo Lorenzi,Marcos Baghdatis,6-2; 6-4; 6-4,R128,120,7,1,37,71,31,37,23,34,3,4,14,54,71,3,6,67,102,39,67,15,35,5,10,14,54,102
2010-01-18 00:00:00.000,Australian Open Australia Grand Slams,HARD,3,David Ferrer,Frederico Gil,David Ferrer,6-0; 6-0; 2-0 RET,R128,61,2,1,21,36,17,21,11,15,0,0,7,28,36,0,1,32,46,10,32,3,14,2,9,7,13,46
2010-01-18 00:00:00.000,Australian Open Australia Grand Slams,HARD,3,Fernando Verdasco,Carsten Ball,Fernando Verdasco,6-7(4); 7-6(1); 7-5; 6-2,R128,185,7,6,107,147,84,107,18,40,10,13,22,102,147,13,5,74,152,49,74,44,78,16,22,22,93,152
2010-01-18 00:00:00.000,Australian Open Australia Grand Slams,HARD,3,Ivan Sergeyev,Dudi Sela,Ivan Sergeyev,6-3; 7-6(3); 4-6; 7-6(8),R128,202,10,7,92,159,66,92,34,67,9,14,22,100,159,7,3,91,145,60,91,28,54,10,15,21,88,145
2010-01-18 00:00:00.000,Australian Open Australia Grand Slams,HARD,3,Stefan Koubek,Rajeev Ram,Stefan Koubek,4-6; 6-3; 5-7; 6-1; 6-3,R128,193,13,3,91,149,63,91,37,58,5,7,24,100,149,15,7,89,155,63,89,32,66,9,14,23,95,155
2010-01-18 00:00:00.000,Australian Open Australia Grand Slams,HARD,3,Ivan Dodig,Juan Carlos Ferrero,Ivan Dodig,2-6; 1-6; 6-4; 6-1; 6-1,R128,180,19,5,82,136,55,82,25,54,8,13,20,80,136,5,3,84,129,57,84,19,45,6,12,19,76,129
2010-01-18 00:00:00.000,Australian Open Australia Grand Slams,HARD,3,Juan Monaco,Ernests Gulbis,Juan Monaco,6-3; 7-6(5); 6-1,R128,135,3,1,64,97,44,64,17,33,7,10,13,61,97,8,7,56,103,33,56,18,47,11,19,15,51,103
2010-01-18 00:00:00.000,Australian Open Australia Grand Slams,HARD,3,Michael Llodra,Martin Vassallo Arguello,Michael Llodra,6-3; 7-5; 6-4,R128,134,9,4,59,94,45,59,21,35,3,4,16,66,94,3,2,81,114,50,81,15,33,8,12,15,65,114
2010-01-18 00:00:00.000,Australian Open Australia Grand Slams,HARD,3,Illya Marchenko,Carlos Moya,Illya Marchenko,7-6(2); 7-5; 6-3,R128,156,7,6,66,115,49,66,26,49,4,7,17,75,115,9,2,57,102,37,57,22,45,6,11,16,59,102
2010-01-18 00:00:00.000,Australian Open Australia Grand Slams,HARD,3,Nikolay Davydenko,Dieter Kindlmann,Nikolay Davydenko,6-1; 6-0; 6-3,R128,91,6,2,36,60,24,36,15,24,4,6,11,39,60,0,5,49,79,25,49,5,30,10,19,11,30,79
2010-01-18 00:00:00.000,Australian Open Australia Grand Slams,HARD,3,Novak Djokovic,Daniel Gimeno-Traver,Novak Djokovic,7-5; 6-3; 6-2,R128,121,4,5,61,90,47,61,16,29,5,6,15,63,90,5,5,54,91,39,54,12,37,9,14,14,51,91
2010-01-18 00:00:00.000,Australian Open Australia Grand Slams,HARD,3,Marco Chiudinelli,Marinko Matosevic,Marco Chiudinelli,7-6(7); 7-6(3); 4-6; 6-3,R128,190,4,3,79,135,57,79,28,56,7,12,21,85,135,11,5,79,141,46,79,38,62,6,12,22,84,141
2010-01-18 00:00:00.000,Australian Open Australia Grand Slams,HARD,3,Michael Berrer,Kristof Vliegen,Michael Berrer,6-1; 6-2; 6-1,R128,80,10,4,38,54,35,38,9,16,0,0,11,44,54,5,4,54,79,29,54,6,25,7,14,11,35,79
2010-01-18 00:00:00.000,Australian Open Australia Grand Slams,HARD,3,Denis Istomin,Jeremy Chardy,Denis Istomin,6-2; 6-2; 6-0,R128,81,6,2,40,66,33,40,17,26,1,1,11,50,66,5,7,30,61,18,30,11,31,5,12,11,29,61
2010-01-18 00:00:00.000,Australian Open Australia Grand Slams,HARD,3,Mikhail Youzhny,Richard Gasquet,Mikhail Youzhny,6-7(9); 4-6; 7-6(2); 7-6(4); 6-4,R128,293,12,8,111,188,79,111,40,77,10,16,28,119,188,8,9,105,179,81,105,30,74,4,10,28,111,179
2010-01-18 00:00:00.000,Australian Open Australia Grand Slams,HARD,3,Jan Hajek,Robby Ginepri,Jan Hajek,7-6(2); 7-5; 6-1,R128,124,3,3,73,109,51,73,19,36,6,8,16,70,109,6,3,73,116,46,73,17,43,8,13,15,63,116
2010-01-18 00:00:00.000,Australian Open Australia Grand Slams,HARD,3,Lukasz Kubot,Mischa Zverev,Lukasz Kubot,6-3; 6-3; 6-3,R128,101,5,3,45,71,31,45,18,26,1,3,13,49,71,12,3,48,94,30,48,18,46,4,11,14,48,94
2010-01-18 00:00:00.000,Australian Open Australia Grand Slams,HARD,3,Santiago Giraldo,Tommy Robredo,Santiago Giraldo,6-4; 6-2; 6-2,R128,116,2,0,40,74,32,40,23,34,2,2,13,55,74,2,6,53,93,32,53,18,40,8,12,13,50,93
2010-01-18 00:00:00.000,Australian Open Australia Grand Slams,HARD,3,Jo-Wilfried Tsonga,Sergiy Stakhovsky,Jo-Wilfried Tsonga,6-3; 6-4; 6-4,R128,111,15,1,57,87,47,57,15,30,4,6,15,62,87,4,6,57,94,36,57,17,37,5,10,14,53,94
2010-01-18 00:00:00.000,Australian Open Australia Grand Slams,HARD,3,Taylor Dent,Fabio Fognini,Taylor Dent,6-1; 6-3; 6-3,R128,80,6,3,39,73,31,39,15,34,5,8,13,46,73,2,7,26,60,13,26,11,34,4,12,12,24,60
2010-01-18 00:00:00.000,Australian Open Australia Grand Slams,HARD,3,Janko Tipsarevic,Ryan Harrison,Janko Tipsarevic,6-2; 6-4; 7-6(3),R128,166,10,5,75,122,49,75,28,47,9,11,15,77,122,5,9,65,121,41,65,25,56,14,18,15,66,121
2010-01-18 00:00:00.000,Australian Open Australia Grand Slams,HARD,3,Tommy Haas,Simon Greul,Tommy Haas,6-7(5); 6-4; 6-2; 6-1,R128,170,14,4,71,109,49,71,25,38,2,4,18,74,109,3,11,69,143,44,69,30,74,17,25,19,74,143
2010-01-18 00:00:00.000,Australian Open Australia Grand Slams,HARD,3,Nicolas Almagro,Xavier Malisse,Nicolas Almagro,7-6(12); 6-4; 2-6; 4-6; 8-6,R128,216,15,5,103,169,76,103,39,66,5,9,27,115,169,14,3,106,187,79,106,45,81,10,13,27,124,187
2010-01-18 00:00:00.000,Australian Open Australia Grand Slams,HARD,3,Benjamin Becker,Grega Zemlja,Benjamin Becker,7-6(5); 7-5; 7-5,R128,153,8,8,55,108,44,55,25,53,4,8,18,69,108,10,3,61,107,38,61,28,46,5,11,18,66,107
2010-01-18 00:00:00.000,Australian Open Australia Grand Slams,HARD,3,Alejandro Falla,Marcos Daniel,Alejandro Falla,7-5; 6-3; 6-1,R128,119,2,4,45,87,36,45,24,42,2,2,14,60,87,2,8,31,87,25,31,24,56,5,10,14,49,87
2010-01-18 00:00:00.000,Australian Open Australia Grand Slams,HARD,3,Marcel Granollers,Robin Soderling,Marcel Granollers,5-7; 2-6; 6-4; 6-4; 6-2,R128,201,11,1,91,142,57,91,29,51,6,12,24,86,142,8,3,97,158,65,97,28,61,8,15,24,93,158
2010-01-18 00:00:00.000,Australian Open Australia Grand Slams,HARD,3,Andy Roddick,Thiemo de Bakker,Andy Roddick,6-1; 6-4; 6-4,R128,124,8,1,55,88,41,55,23,33,7,7,14,64,88,17,2,66,91,43,66,12,25,11,15,13,55,91
2010-01-18 00:00:00.000,Australian Open Australia Grand Slams,HARD,3,Thomaz Bellucci,Teymuraz Gabashvili,Thomaz Bellucci,6-3; 7-5; 4-6; 6-4,R128,235,9,6,95,148,70,95,26,53,13,16,21,96,148,3,13,88,154,58,88,31,66,23,27,20,89,154
2010-01-18 00:00:00.000,Australian Open Australia Grand Slams,HARD,3,Feliciano Lopez,Pablo Cuevas,Feliciano Lopez,6-1; 6-4; 7-5,R128,109,13,2,59,88,44,59,14,29,3,5,15,58,88,7,8,51,84,36,51,12,33,4,11,14,48,84
2010-01-18 00:00:00.000,Australian Open Australia Grand Slams,HARD,3,Rainer Schuettler,Sam Querrey,Rainer Schuettler,6-3; 2-6; 6-4; 6-3,R128,135,1,5,64,113,47,64,24,49,2,5,18,71,113,15,6,62,106,47,62,18,44,5,10,18,65,106
2010-01-18 00:00:00.000,Australian Open Australia Grand Slams,HARD,3,Tomas Berdych,Robin Haase,Tomas Berdych,6-0; 6-3; 6-3,R128,99,2,1,33,66,26,33,21,33,2,3,12,47,66,5,5,49,81,26,49,11,32,3,10,12,37,81
2010-01-18 00:00:00.000,Australian Open Australia Grand Slams,HARD,3,Evgeny Korolev,Daniel Brands,Evgeny Korolev,6-2; 7-5; 7-5,R128,124,2,7,58,101,42,58,21,43,4,7,16,63,101,10,5,49,95,29,49,22,46,2,9,16,51,95
2010-01-18 00:00:00.000,Australian Open Australia Grand Slams,HARD,3,Marsel Ilhan,Sebastien Grosjean,Marsel Ilhan,6-4; 6-3; 7-5,R128,159,1,1,74,110,49,74,22,36,10,11,15,71,110,4,1,64,101,42,64,18,37,10,16,16,60,101
2010-01-18 00:00:00.000,Australian Open Australia Grand Slams,HARD,3,Fernando Gonzalez,Olivier Rochus,Fernando Gonzalez,6-3; 6-4; 3-6; 6-1,R128,138,19,4,56,95,48,56,19,39,4,7,18,67,95,5,4,83,127,51,83,20,44,9,15,17,71,127
2010-01-18 00:00:00.000,Australian Open Australia Grand Slams,HARD,3,Marin Cilic,Fabrice Santoro,Marin Cilic,7-5; 7-5; 6-3,R128,152,6,2,53,92,42,53,22,39,2,4,17,64,92,0,1,65,108,43,65,21,43,12,17,16,64,108
2010-01-18 00:00:00.000,Australian Open Australia Grand Slams,HARD,3,Bernard Tomic,Guillaume Rufin,Bernard Tomic,6-3; 6-4; 6-4,R128,104,5,0,56,85,39,56,18,29,5,8,15,57,85,2,2,44,79,24,44,18,35,7,13,14,42,79
2010-01-18 00:00:00.000,Australian Open Australia Grand Slams,HARD,3,Igor Kunitsyn,Jose Acasuso,Igor Kunitsyn,6-1; 2-6; 6-4; 6-2,R128,188,5,2,99,120,67,99,10,21,11,14,17,77,120,9,6,61,105,39,61,17,44,5,11,16,56,105
2010-01-18 00:00:00.000,Australian Open Australia Grand Slams,HARD,3,Stanislas Wawrinka,Guillermo Garcia-Lopez,Stanislas Wawrinka,6-3; 6-3; 6-2,R128,110,6,4,43,74,36,43,20,31,3,3,13,56,74,1,9,52,84,34,52,12,32,3,8,13,46,84
2010-01-18 00:00:00.000,Australian Open Australia Grand Slams,HARD,3,Viktor Troicki,Nicolas Lapentti,Viktor Troicki,4-6; 6-3; 6-1; 6-3,R128,182,15,3,60,110,46,60,27,50,8,10,17,73,110,2,3,53,117,31,53,31,64,5,12,18,62,117
2010-01-18 00:00:00.000,Australian Open Australia Grand Slams,HARD,3,Florian Mayer,Philipp Petzschner,Florian Mayer,0-6; 2-6; 6-4; 6-2; 6-2,R128,154,4,2,84,121,54,84,18,37,3,9,20,72,121,7,6,73,125,51,73,23,52,3,9,20,74,125
2010-01-18 00:00:00.000,Australian Open Australia Grand Slams,HARD,3,James Blake,Arnaud Clement,James Blake,7-5; 7-5; 6-2,R128,132,9,0,60,94,49,60,20,34,1,2,16,69,94,2,1,65,103,41,65,20,38,9,14,16,61,103
2010-01-18 00:00:00.000,Australian Open Australia Grand Slams,HARD,3,Juan Martin Del Potro,Michael Russell,Juan Martin Del Potro,6-4; 6-4; 3-6; 6-2,R128,180,21,6,66,109,48,66,21,43,3,6,18,69,109,3,9,86,131,55,86,20,45,8,14,19,75,131
2010-01-18 00:00:00.000,Australian Open Australia Grand Slams,HARD,3,Andy Murray,Kevin Anderson,Andy Murray,6-1; 6-1; 6-2,R128,97,9,1,24,65,21,24,24,41,3,4,11,45,65,2,2,50,74,26,50,6,24,4,12,11,32,74
2010-01-18 00:00:00.000,Australian Open Australia Grand Slams,HARD,3,Marc Gicquel,Simone Bolelli,Marc Gicquel,7-6(2); 7-6(3); 6-3,R128,161,14,4,70,130,52,70,35,60,6,8,17,87,130,5,2,76,115,53,76,18,39,6,9,16,71,115
2010-01-18 00:00:00.000,Australian Open Australia Grand Slams,HARD,3,Jarkko Nieminen,Nick Lindahl,Jarkko Nieminen,6-2; 7-5; 6-4,R128,121,1,0,74,95,54,74,13,21,7,8,15,67,95,7,2,64,102,43,64,16,38,8,13,15,59,102
2010-01-18 00:00:00.000,Australian Open Australia Grand Slams,HARD,3,Florent Serra,Jurgen Melzer,Florent Serra,6-1; 6-7(3); 6-4; 4-6; 6-3,R128,184,12,2,103,154,72,103,34,51,9,11,25,106,154,10,7,85,138,59,85,27,53,6,11,23,86,138
2010-01-18 00:00:00.000,Australian Open Australia Grand Slams,HARD,3,John Isner,Andreas Seppi,John Isner,6-3; 6-3; 3-6; 5-7; 6-4,R128,197,34,5,95,155,74,95,29,60,6,9,25,103,155,10,10,79,141,60,79,35,62,3,6,24,95,141
2010-01-18 00:00:00.000,Australian Open Australia Grand Slams,HARD,3,Louk Sorensen,Yen-Hsun Lu,Louk Sorensen,6-4; 3-6; 6-2; 6-1,R128,156,6,2,65,91,50,65,15,26,1,3,17,65,91,0,3,68,112,45,68,17,44,8,14,17,62,112
2010-01-18 00:00:00.000,Australian Open Australia Grand Slams,HARD,3,Antonio Veic,Daniel Koellerer,Antonio Veic,6-4; 3-6; 6-7(3); 6-1; 6-4,R128,237,7,1,107,157,69,107,26,50,7,14,25,95,157,1,1,109,136,67,109,11,27,6,14,23,78,136
2010-01-18 00:00:00.000,Australian Open Australia Grand Slams,HARD,3,Gael Monfils,Matthew Ebden,Gael Monfils,6-4; 6-4; 6-4,R128,116,4,4,52,77,43,52,16,25,0,1,15,59,77,2,2,62,96,44,62,16,34,3,7,15,60,96
2010-01-18 00:00:00.000,Australian Open Australia Grand Slams,HARD,3,Ivo Karlovic,Radek Stepanek,Ivo Karlovic,2-6; 7-6(5); 6-4; 3-6; 6-4,R128,236,35,9,87,147,77,87,21,60,10,14,24,98,147,2,6,95,166,66,95,40,71,9,12,25,106,166
2010-01-18 00:00:00.000,Australian Open Australia Grand Slams,HARD,3,Julien Benneteau,David Guez,Julien Benneteau,0-6; 6-4; 7-6(4); 7-6(2),R128,231,4,7,93,135,63,93,19,42,6,12,20,82,135,1,5,81,129,44,81,33,48,3,7,20,77,129
2010-01-18 00:00:00.000,Australian Open Australia Grand Slams,HARD,3,Andrey Golubev,Mardy Fish,Andrey Golubev,6-2; 1-6; 6-3; 6-3,R128,171,4,2,65,100,41,65,19,35,5,9,16,60,100,3,4,61,117,41,61,22,56,3,10,17,63,117
2010-01-18 00:00:00.000,Australian Open Australia Grand Slams,HARD,3,Ivan Ljubicic,Jason Kubler,Ivan Ljubicic,6-1; 6-2; 6-2,R128,89,6,2,44,62,38,44,11,18,0,0,12,49,62,2,2,41,73,22,41,13,32,8,14,11,35,73
2010-01-18 00:00:00.000,Australian Open Australia Grand Slams,HARD,3,Philipp Kohlschreiber,Horacio Zeballos,Philipp Kohlschreiber,6-1; 7-5; 6-1,R128,121,10,4,53,76,44,53,12,23,2,3,13,56,76,7,3,54,85,33,54,8,31,6,13,13,41,85
2010-01-18 00:00:00.000,Australian Open Australia Grand Slams,HARD,3,Wayne Odesnik,Blaz Kavcic,Wayne Odesnik,4-6; 6-1; 6-4; 6-2,R128,155,6,3,67,104,48,67,19,37,2,6,18,67,104,1,4,70,111,40,70,16,41,9,16,17,56,111
2010-01-18 00:00:00.000,Australian Open Australia Grand Slams,HARD,3,Lukas Lacko,Leonardo Mayer,Lukas Lacko,6-4; 6-4; 6-0,R128,110,7,2,46,75,41,46,15,29,0,0,13,56,75,7,3,51,77,31,51,13,26,3,8,13,44,77
2010-01-18 00:00:00.000,Australian Open Australia Grand Slams,HARD,3,Rafael Nadal,Peter Luczak,Rafael Nadal,7-6(0); 6-1; 6-4,R128,154,11,1,72,104,55,72,18,32,6,7,15,73,104,7,6,57,91,39,57,12,34,5,9,14,51,91
2010-01-18 00:00:00.000,Australian Open Australia Grand Slams,HARD,3,Roger Federer,Victor Hanescu,Roger Federer,6-2; 6-3; 6-2,R64,99,8,1,50,73,41,50,14,23,5,5,13,55,73,3,1,61,87,34,61,12,26,6,11,12,46,87
2010-01-18 00:00:00.000,Australian Open Australia Grand Slams,HARD,3,Albert Montanes,Stephane Robert,Albert Montanes,4-6; 6-7(3); 6-2; 6-3; 6-2,R64,201,13,5,107,158,75,107,23,51,6,10,23,98,158,3,7,98,166,58,98,32,68,10,19,24,90,166
2010-01-18 00:00:00.000,Australian Open Australia Grand Slams,HARD,3,Lleyton Hewitt,Donald Young,Lleyton Hewitt,7-6(3); 6-4; 6-1,R64,120,7,1,56,96,38,56,25,40,6,9,15,63,96,7,2,50,82,33,50,10,32,6,12,14,43,82
2010-01-18 00:00:00.000,Australian Open Australia Grand Slams,HARD,3,Marcos Baghdatis,David Ferrer,Marcos Baghdatis,4-6; 3-6; 7-6(4); 6-3; 6-1,R64,249,12,1,80,142,60,80,33,62,5,9,23,93,142,1,1,116,178,73,116,32,62,11,17,24,105,178
2010-01-18 00:00:00.000,Australian Open Australia Grand Slams,HARD,3,Fernando Verdasco,Ivan Sergeyev,Fernando Verdasco,6-1; 6-2; 6-2,R64,109,6,6,56,81,41,56,11,25,4,5,11,52,81,0,7,34,84,18,34,17,50,10,18,12,35,84
2010-01-18 00:00:00.000,Australian Open Australia Grand Slams,HARD,3,Stefan Koubek,Ivan Dodig,Stefan Koubek,7-6(4); 6-1; 6-2,R64,136,9,4,54,83,44,54,16,29,3,4,14,60,83,9,5,51,95,31,51,22,44,5,10,13,53,95
2010-01-18 00:00:00.000,Australian Open Australia Grand Slams,HARD,3,Juan Monaco,Michael Llodra,Juan Monaco,3-6; 3-6; 7-6(5); 6-1; 6-3,R64,206,5,2,98,145,61,98,27,47,8,15,23,88,145,6,7,82,144,52,82,28,62,10,18,23,80,144
2010-01-18 00:00:00.000,Australian Open Australia Grand Slams,HARD,3,Nikolay Davydenko,Illya Marchenko,Nikolay Davydenko,6-3; 6-3; 6-0,R64,109,9,0,56,75,44,56,9,19,6,7,12,53,75,1,1,38,70,23,38,10,32,4,11,12,33,70
2010-01-18 00:00:00.000,Australian Open Australia Grand Slams,HARD,3,Novak Djokovic,Marco Chiudinelli,Novak Djokovic,3-6; 6-1; 6-1; 6-3,R64,178,12,9,79,125,59,79,15,46,14,17,16,74,125,3,3,57,102,33,57,19,45,10,18,16,52,102
2010-01-18 00:00:00.000,Australian Open Australia Grand Slams,HARD,3,Denis Istomin,Michael Berrer,Denis Istomin,7-5; 6-3; 6-4,R64,141,9,2,59,88,44,59,16,29,0,2,15,60,88,5,2,70,107,39,70,21,37,4,10,16,60,107
2010-01-18 00:00:00.000,Australian Open Australia Grand Slams,HARD,3,Mikhail Youzhny,Jan Hajek,Mikhail Youzhny,6-2; 6-1; 6-1,R64,91,5,1,36,60,33,36,12,24,0,0,11,45,60,0,5,48,70,22,48,8,22,4,10,11,30,70
2010-01-18 00:00:00.000,Australian Open Australia Grand Slams,HARD,3,Lukasz Kubot,Santiago Giraldo,Lukasz Kubot,6-4; 3-6; 6-3; 6-1,R64,163,17,6,75,114,56,75,19,39,8,11,17,75,114,2,2,93,132,56,93,15,39,10,17,18,71,132
2010-01-18 00:00:00.000,Australian Open Australia Grand Slams,HARD,3,Jo-Wilfried Tsonga,Taylor Dent,Jo-Wilfried Tsonga,6-4; 6-3; 6-3,R64,101,12,0,42,73,36,42,19,31,0,1,14,55,73,6,7,40,85,28,40,21,45,6,11,14,49,85
2010-01-18 00:00:00.000,Australian Open Australia Grand Slams,HARD,3,Tommy Haas,Janko Tipsarevic,Tommy Haas,4-6; 6-4; 6-3; 1-6; 6-3,R64,200,16,7,89,159,64,89,31,70,11,16,23,95,159,14,5,66,125,46,66,30,59,2,8,22,76,125
2010-01-18 00:00:00.000,Australian Open Australia Grand Slams,HARD,3,Nicolas Almagro,Benjamin Becker,Nicolas Almagro,6-4; 6-2; 3-6; 4-6; 6-3,R64,177,17,1,72,124,54,72,37,52,0,2,23,91,124,14,5,69,132,52,69,36,63,3,7,23,88,132
2010-01-18 00:00:00.000,Australian Open Australia Grand Slams,HARD,3,Alejandro Falla,Marcel Granollers,Alejandro Falla,6-4; 6-1; 6-3,R64,113,2,4,46,76,34,46,13,30,2,5,13,47,76,3,4,66,96,36,66,8,30,10,18,13,44,96
2010-01-18 00:00:00.000,Australian Open Australia Grand Slams,HARD,3,Andy Roddick,Thomaz Bellucci,Andy Roddick,6-3; 6-4; 6-4,R64,132,11,0,62,79,49,62,12,17,4,5,15,61,79,8,4,61,100,39,61,19,39,6,10,14,58,100
2010-01-18 00:00:00.000,Australian Open Australia Grand Slams,HARD,3,Feliciano Lopez,Rainer Schuettler,Feliciano Lopez,6-3; 2-6; 6-3; 6-2,R64,160,10,4,59,120,42,59,35,61,7,9,17,77,120,3,4,63,99,43,63,16,36,5,10,17,59,99
2010-01-18 00:00:00.000,Australian Open Australia Grand Slams,HARD,3,Evgeny Korolev,Tomas Berdych,Evgeny Korolev,6-4; 6-4; 7-5,R64,141,4,5,56,95,42,56,16,39,4,8,16,58,95,4,4,48,95,29,48,20,47,5,12,16,49,95
2010-01-18 00:00:00.000,Australian Open Australia Grand Slams,HARD,3,Fernando Gonzalez,Marsel Ilhan,Fernando Gonzalez,6-3; 6-4; 7-5,R64,112,12,6,64,96,55,64,14,32,2,3,16,69,96,4,1,76,95,45,76,11,19,5,9,15,56,95
2010-01-18 00:00:00.000,Australian Open Australia Grand Slams,HARD,3,Marin Cilic,Bernard Tomic,Marin Cilic,6-7(6); 6-3; 4-6; 6-2; 6-4,R64,228,25,2,79,156,59,79,45,77,8,13,25,104,156,4,8,128,190,82,128,27,62,8,16,24,109,190
2010-01-18 00:00:00.000,Australian Open Australia Grand Slams,HARD,3,Stanislas Wawrinka,Igor Kunitsyn,Stanislas Wawrinka,6-3; 6-2; 6-2,R64,111,12,5,49,93,43,49,18,44,3,3,13,61,93,2,1,50,69,29,50,9,19,2,7,12,38,69
2010-01-18 00:00:00.000,Australian Open Australia Grand Slams,HARD,3,Florian Mayer,Viktor Troicki,Florian Mayer,4-6; 6-4; 7-6(2); 6-1,R64,164,6,0,83,125,60,83,26,42,4,6,19,86,125,26,9,72,118,55,72,20,46,6,11,20,75,118
2010-01-18 00:00:00.000,Australian Open Australia Grand Slams,HARD,3,Juan Martin Del Potro,James Blake,Juan Martin Del Potro,6-4; 6-7(3); 5-7; 6-3; 10-8,R64,257,19,9,109,188,86,109,34,79,5,10,31,120,188,16,3,135,217,93,135,39,82,15,22,30,132,217
2010-01-18 00:00:00.000,Australian Open Australia Grand Slams,HARD,3,Andy Murray,Marc Gicquel,Andy Murray,6-1; 6-4; 6-3,R64,110,10,2,47,84,34,47,21,37,6,7,13,55,84,1,3,53,92,32,53,15,39,6,12,13,47,92
2010-01-18 00:00:00.000,Australian Open Australia Grand Slams,HARD,3,Florent Serra,Jarkko Nieminen,Florent Serra,3-6; 6-4; 5-7; 7-6(4); 7-5,R64,231,11,7,115,199,73,115,47,84,17,24,28,120,199,9,4,148,195,94,148,26,47,11,16,27,120,195
2010-01-18 00:00:00.000,Australian Open Australia Grand Slams,HARD,3,John Isner,Louk Sorensen,John Isner,6-3; 7-6(4); 7-5,R64,136,21,2,78,105,59,78,18,27,3,3,17,77,105,11,6,53,87,48,53,17,34,3,5,16,65,87
2010-01-18 00:00:00.000,Australian Open Australia Grand Slams,HARD,3,Gael Monfils,Antonio Veic,Gael Monfils,6-4; 6-4; 6-4,R64,110,7,7,66,104,48,66,17,38,2,5,15,65,104,2,0,53,84,32,53,14,31,1,7,15,46,84
2010-01-18 00:00:00.000,Australian Open Australia Grand Slams,HARD,3,Ivo Karlovic,Julien Benneteau,Ivo Karlovic,2-6; 6-1; 6-3; 6-3,R64,137,26,2,60,103,50,60,21,43,8,10,17,71,103,7,4,59,98,37,59,20,39,3,8,16,57,98
2010-01-18 00:00:00.000,Australian Open Australia Grand Slams,HARD,3,Ivan Ljubicic,Andrey Golubev,Ivan Ljubicic,6-3; 3-6; 6-2; 6-3,R64,153,12,3,67,110,53,67,25,43,5,6,18,78,110,6,9,65,120,43,65,29,55,7,11,17,72,120
2010-01-18 00:00:00.000,Australian Open Australia Grand Slams,HARD,3,Philipp Kohlschreiber,Wayne Odesnik,Philipp Kohlschreiber,6-4; 3-6; 6-3; 6-2,R64,185,16,3,77,123,60,77,20,46,12,14,18,80,123,8,11,61,127,39,61,35,66,10,15,18,74,127
2010-01-18 00:00:00.000,Australian Open Australia Grand Slams,HARD,3,Rafael Nadal,Lukas Lacko,Rafael Nadal,6-2; 6-2; 6-2,R64,113,1,1,35,64,25,35,20,29,0,1,12,45,64,2,5,32,80,19,32,17,48,3,10,12,36,80
2010-01-18 00:00:00.000,Australian Open Australia Grand Slams,HARD,3,Roger Federer,Albert Montanes,Roger Federer,6-3; 6-4; 6-4,R32,108,10,3,52,79,46,52,15,27,0,0,15,61,79,7,1,55,91,33,55,23,36,3,6,14,56,91
2010-01-18 00:00:00.000,Australian Open Australia Grand Slams,HARD,3,Lleyton Hewitt,Marcos Baghdatis,Lleyton Hewitt,6-0; 4-2 RET,R32,54,1,0,17,31,13,17,11,14,0,0,6,24,31,5,2,17,36,11,17,3,19,4,8,6,14,36
2010-01-18 00:00:00.000,Australian Open Australia Grand Slams,HARD,3,Fernando Verdasco,Stefan Koubek,Fernando Verdasco,6-1 RET,R32,23,0,2,9,16,9,9,3,7,0,0,3,12,16,0,2,7,17,2,7,3,10,0,3,4,5,17
2010-01-18 00:00:00.000,Australian Open Australia Grand Slams,HARD,3,Nikolay Davydenko,Juan Monaco,Nikolay Davydenko,6-0; 6-3; 6-4,R32,109,6,2,53,75,38,53,13,22,1,2,13,51,75,0,0,47,70,22,47,12,23,4,10,12,34,70
2010-01-18 00:00:00.000,Australian Open Australia Grand Slams,HARD,3,Novak Djokovic,Denis Istomin,Novak Djokovic,6-1; 6-1; 6-2,R32,97,3,7,47,78,34,47,14,31,7,9,11,48,78,3,0,33,60,13,33,7,27,5,14,11,20,60
2010-01-18 00:00:00.000,Australian Open Australia Grand Slams,HARD,3,Lukasz Kubot,Mikhail Youzhny,Lukasz Kubot,W/O,R32,0,0,0,0,0,0,0,0,0,0,0,0,0,0,0,0,0,0,0,0,0,0,0,0,0,0,0
2010-01-18 00:00:00.000,Australian Open Australia Grand Slams,HARD,3,Jo-Wilfried Tsonga,Tommy Haas,Jo-Wilfried Tsonga,6-4; 3-6; 6-1; 7-5,R32,148,20,3,72,108,56,72,20,36,2,4,19,76,108,9,2,74,108,49,74,19,34,6,11,19,68,108
2010-01-18 00:00:00.000,Australian Open Australia Grand Slams,HARD,3,Nicolas Almagro,Alejandro Falla,Nicolas Almagro,6-4; 6-3; 6-4,R32,123,10,3,49,89,43,49,21,40,3,4,15,64,89,3,2,49,98,31,49,25,49,6,10,14,56,98
2010-01-18 00:00:00.000,Australian Open Australia Grand Slams,HARD,3,Andy Roddick,Feliciano Lopez,Andy Roddick,6-7(4); 6-4; 6-4; 7-6(3),R32,212,29,3,95,129,76,95,23,34,4,5,22,99,129,29,5,97,166,71,97,36,69,14,17,22,107,166
2010-01-18 00:00:00.000,Australian Open Australia Grand Slams,HARD,3,Fernando Gonzalez,Evgeny Korolev,Fernando Gonzalez,6-7(5); 6-3; 1-6; 6-3; 6-4,R32,202,18,5,90,159,73,90,34,69,6,9,24,107,159,16,7,87,145,68,87,30,58,7,11,23,98,145
2010-01-18 00:00:00.000,Australian Open Australia Grand Slams,HARD,3,Marin Cilic,Stanislas Wawrinka,Marin Cilic,4-6; 6-4; 6-3; 6-3,R32,200,10,2,68,115,55,68,24,47,5,7,19,79,115,10,6,69,128,52,69,26,59,5,10,19,78,128
2010-01-18 00:00:00.000,Australian Open Australia Grand Slams,HARD,3,Juan Martin Del Potro,Florian Mayer,Juan Martin Del Potro,6-3; 0-6; 6-4; 7-5,R32,154,11,5,72,123,51,72,23,51,5,10,19,74,123,5,3,75,112,48,75,20,37,9,14,18,68,112
2010-01-18 00:00:00.000,Australian Open Australia Grand Slams,HARD,3,Andy Murray,Florent Serra,Andy Murray,7-5; 6-1; 6-4,R32,112,14,3,43,76,34,43,19,33,0,3,15,53,76,5,2,70,98,36,70,13,28,9,16,14,49,98
2010-01-18 00:00:00.000,Australian Open Australia Grand Slams,HARD,3,John Isner,Gael Monfils,John Isner,6-1; 4-6; 7-6(4); 7-6(5),R32,168,26,3,87,131,69,87,24,44,4,7,21,93,131,12,7,76,126,54,76,26,50,1,5,20,80,126
2010-01-18 00:00:00.000,Australian Open Australia Grand Slams,HARD,3,Ivo Karlovic,Ivan Ljubicic,Ivo Karlovic,6-3; 3-6; 6-3; 7-6(7),R32,181,33,2,79,114,68,79,18,35,6,7,20,86,114,15,0,85,135,64,85,25,50,8,10,19,89,135
2010-01-18 00:00:00.000,Australian Open Australia Grand Slams,HARD,3,Rafael Nadal,Philipp Kohlschreiber,Rafael Nadal,6-4; 6-2; 2-6; 7-5,R32,210,6,3,84,138,58,84,28,54,12,15,19,86,138,11,4,78,128,53,78,24,50,7,12,19,77,128
2010-01-18 00:00:00.000,Australian Open Australia Grand Slams,HARD,3,Roger Federer,Lleyton Hewitt,Roger Federer,6-2; 6-3; 6-4,R16,115,7,0,50,79,38,50,19,29,4,5,14,57,79,5,2,61,100,37,61,18,39,10,15,13,55,100
2010-01-18 00:00:00.000,Australian Open Australia Grand Slams,HARD,3,Nikolay Davydenko,Fernando Verdasco,Nikolay Davydenko,6-2; 7-5; 4-6; 6-7(5); 6-3,R16,237,6,5,108,173,73,108,37,65,8,12,26,110,173,14,20,88,155,64,88,30,67,5,12,25,94,155
2010-01-18 00:00:00.000,Australian Open Australia Grand Slams,HARD,3,Novak Djokovic,Lukasz Kubot,Novak Djokovic,6-1; 6-2; 7-5,R16,115,10,1,51,74,41,51,16,23,1,2,14,57,74,4,4,46,76,31,46,10,30,3,9,13,41,76
2010-01-18 00:00:00.000,Australian Open Australia Grand Slams,HARD,3,Jo-Wilfried Tsonga,Nicolas Almagro,Jo-Wilfried Tsonga,6-3; 6-4; 4-6; 6-7(6); 9-7,R16,213,25,4,93,161,79,93,43,68,3,4,29,122,161,13,1,133,173,100,133,21,40,8,11,28,121,173
2010-01-18 00:00:00.000,Australian Open Australia Grand Slams,HARD,3,Andy Roddick,Fernando Gonzalez,Andy Roddick,6-3; 3-6; 4-6; 7-5; 6-2,R16,205,33,0,85,125,74,85,20,40,2,4,24,94,125,17,9,107,175,81,107,29,68,14,18,24,110,175
2010-01-18 00:00:00.000,Australian Open Australia Grand Slams,HARD,3,Marin Cilic,Juan Martin Del Potro,Marin Cilic,5-7; 6-4; 7-5; 5-7; 6-3,R16,278,20,7,101,173,84,101,34,72,7,10,28,118,173,19,3,108,181,78,108,40,73,12,16,27,118,181
2010-01-18 00:00:00.000,Australian Open Australia Grand Slams,HARD,3,Andy Murray,John Isner,Andy Murray,7-6(4); 6-3; 6-2,R16,132,5,1,65,90,53,65,17,25,4,4,15,70,90,14,2,61,89,43,61,8,28,3,5,14,51,89
2010-01-18 00:00:00.000,Australian Open Australia Grand Slams,HARD,3,Rafael Nadal,Ivo Karlovic,Rafael Nadal,6-4; 4-6; 6-4; 6-4,R16,156,2,2,72,102,56,72,22,30,1,2,20,78,102,28,2,73,106,56,73,21,33,3,6,20,77,106
2010-01-18 00:00:00.000,Australian Open Australia Grand Slams,HARD,3,Roger Federer,Nikolay Davydenko,Roger Federer,2-6; 6-3; 6-0; 7-5,Q,156,8,4,73,122,49,73,24,49,14,19,18,73,122,1,4,66,107,39,66,16,41,6,14,17,55,107
2010-01-18 00:00:00.000,Australian Open Australia Grand Slams,HARD,3,Jo-Wilfried Tsonga,Novak Djokovic,Jo-Wilfried Tsonga,7-6(8); 6-7(5); 1-6; 6-3; 6-1,Q,232,19,2,109,168,74,109,28,59,10,16,23,102,168,2,9,100,145,67,100,22,45,4,11,24,89,145
2010-01-18 00:00:00.000,Australian Open Australia Grand Slams,HARD,3,Marin Cilic,Andy Roddick,Marin Cilic,7-6(4); 6-3; 3-6; 2-6; 6-3,Q,230,20,6,77,155,58,77,36,78,10,16,24,94,155,15,1,90,141,62,90,26,51,8,13,23,88,141
2010-01-18 00:00:00.000,Australian Open Australia Grand Slams,HARD,3,Andy Murray,Rafael Nadal,Andy Murray,6-3; 7-6(2); 3-0 RET,Q,150,12,1,57,97,44,57,18,40,10,12,13,62,97,1,1,48,72,30,48,10,24,6,10,11,40,72
2010-01-18 00:00:00.000,Australian Open Australia Grand Slams,HARD,3,Roger Federer,Jo-Wilfried Tsonga,Roger Federer,6-2; 6-3; 6-2,S,88,4,0,44,69,37,44,17,25,0,0,13,54,69,6,5,42,70,28,42,11,28,5,10,12,39,70
2010-01-18 00:00:00.000,Australian Open Australia Grand Slams,HARD,3,Andy Murray,Marin Cilic,Andy Murray,3-6; 6-4; 6-4; 6-2,S,182,4,1,68,107,51,68,23,39,6,9,19,74,107,6,6,70,124,49,70,24,54,11,16,18,73,124
2010-01-18 00:00:00.000,Australian Open Australia Grand Slams,HARD,3,Roger Federer,Andy Murray,Roger Federer,6-3; 6-4; 7-6(11),F,161,11,2,75,112,54,75,22,37,6,8,16,76,112,10,4,58,104,40,58,24,46,8,12,15,64,104
2010-02-01 00:00:00.000,Johannesburg South Africa ATP World Tour 250,HARD,2,Gael Monfils,Dominik Hrbaty,Gael Monfils,6-2; 6-1,R32,54,7,4,25,49,23,25,10,24,3,4,8,33,49,0,3,22,46,9,22,11,24,6,11,7,20,46
2010-02-01 00:00:00.000,Johannesburg South Africa ATP World Tour 250,HARD,2,Josselin Ouanna,Harel Levy,Josselin Ouanna,7-6(4); 6-2,R32,61,8,1,29,53,29,29,16,24,0,0,10,45,53,2,2,37,53,31,37,6,16,0,2,10,37,53
2010-02-01 00:00:00.000,Johannesburg South Africa ATP World Tour 250,HARD,2,Raven Klaasen,David Guez,Raven Klaasen,6-4; 6-3,R32,80,5,3,41,63,31,41,15,22,4,4,10,46,63,0,3,28,60,21,28,15,32,5,7,9,36,60
2010-02-01 00:00:00.000,Johannesburg South Africa ATP World Tour 250,HARD,2,Yen-Hsun Lu,Jarkko Nieminen,Yen-Hsun Lu,6-3; 6-2,R32,78,4,2,36,65,27,36,12,29,7,9,9,39,65,2,3,26,49,15,26,7,23,5,10,8,22,49
2010-02-01 00:00:00.000,Johannesburg South Africa ATP World Tour 250,HARD,2,Feliciano Lopez,Benjamin Balleret,Feliciano Lopez,6-1; 6-7(5); 6-3,R32,124,4,6,52,90,44,52,18,38,1,3,15,62,90,7,2,54,97,32,54,22,43,5,10,13,54,97
2010-02-01 00:00:00.000,Johannesburg South Africa ATP World Tour 250,HARD,2,Blaz Kavcic,Thierry Ascione,Blaz Kavcic,1-6; 7-5; 6-3,R32,120,6,5,62,89,41,62,10,27,5,10,14,51,89,0,4,49,89,31,49,17,40,6,11,14,48,89
2010-02-01 00:00:00.000,Johannesburg South Africa ATP World Tour 250,HARD,2,Bjorn Phau,Fritz Wolmarans,Bjorn Phau,6-4; 7-5,R32,89,1,3,42,77,32,42,21,35,7,7,11,53,77,15,2,47,66,34,47,9,19,2,4,11,43,66
2010-02-01 00:00:00.000,Johannesburg South Africa ATP World Tour 250,HARD,2,Rajeev Ram,Rik De Voest,Rajeev Ram,6-7(3); 6-3; 6-3,R32,119,16,2,52,95,40,52,22,43,4,6,15,62,95,5,3,71,101,43,71,14,30,3,8,15,57,101
2010-02-01 00:00:00.000,Johannesburg South Africa ATP World Tour 250,HARD,2,Stephane Robert,Brendan Evans,Stephane Robert,3-6; 6-2; 6-2,R32,94,5,3,46,78,34,46,14,32,2,5,12,48,78,3,8,44,89,30,44,14,45,7,13,13,44,89
2010-02-01 00:00:00.000,Johannesburg South Africa ATP World Tour 250,HARD,2,Izak Van der Merwe,Noam Okun,Izak Van der Merwe,7-6(5); 7-6(2),R32,108,12,4,47,73,36,47,17,26,2,3,12,53,73,4,4,52,85,36,52,17,33,2,3,12,53,85
2010-02-01 00:00:00.000,Johannesburg South Africa ATP World Tour 250,HARD,2,Laurent Recouderc,Steve Darcis,Laurent Recouderc,3-6; 6-3; 6-4,R32,120,4,2,56,106,39,56,24,50,9,13,14,63,106,6,3,58,93,35,58,16,35,3,8,14,51,93
2010-02-01 00:00:00.000,Johannesburg South Africa ATP World Tour 250,HARD,2,Dustin Brown,Marco Chiudinelli,Dustin Brown,6-4; 3-6; 6-4,R32,95,13,6,51,96,46,51,18,45,11,12,14,64,96,5,6,50,73,41,50,13,23,0,2,15,54,73
2010-02-01 00:00:00.000,Johannesburg South Africa ATP World Tour 250,HARD,2,Somdev Devvarman,Xavier Malisse,Somdev Devvarman,6-4; 6-2,R32,89,2,1,42,70,27,42,16,28,4,5,9,43,70,1,2,33,55,20,33,10,22,2,6,9,30,55
2010-02-01 00:00:00.000,Johannesburg South Africa ATP World Tour 250,HARD,2,Thiago Alves,Alexandr Dolgopolov,Thiago Alves,5-7; 6-2; 6-3,R32,101,8,3,59,93,40,59,21,34,8,10,14,61,93,17,6,59,101,43,59,16,42,8,13,15,59,101
2010-02-01 00:00:00.000,Johannesburg South Africa ATP World Tour 250,HARD,2,Filip Prpic,Ivan Navarro,Filip Prpic,6-3; 7-5,R32,86,5,2,45,66,34,45,14,21,5,5,11,48,66,7,1,45,61,31,45,8,16,1,3,10,39,61
2010-02-01 00:00:00.000,Johannesburg South Africa ATP World Tour 250,HARD,2,David Ferrer,Karol Beck,David Ferrer,6-1; 7-5,R32,83,1,0,32,56,23,32,17,24,1,2,10,40,56,1,3,35,67,23,35,12,32,7,11,9,35,67
2010-02-01 00:00:00.000,Johannesburg South Africa ATP World Tour 250,HARD,2,Gael Monfils,Josselin Ouanna,Gael Monfils,6-4; 7-5,R16,82,12,6,34,57,31,34,12,23,0,1,11,43,57,6,4,43,84,32,43,17,41,13,16,11,49,84
2010-02-01 00:00:00.000,Johannesburg South Africa ATP World Tour 250,HARD,2,Yen-Hsun Lu,Raven Klaasen,Yen-Hsun Lu,6-4; 7-5,R16,116,1,4,46,84,35,46,18,38,6,8,11,53,84,8,3,55,88,30,55,17,33,7,11,11,47,88
2010-02-01 00:00:00.000,Johannesburg South Africa ATP World Tour 250,HARD,2,Feliciano Lopez,Blaz Kavcic,Feliciano Lopez,6-2; 7-6(4),R16,83,10,4,37,72,33,37,19,35,3,3,10,52,72,3,4,40,60,31,40,8,20,0,2,10,39,60
2010-02-01 00:00:00.000,Johannesburg South Africa ATP World Tour 250,HARD,2,Rajeev Ram,Bjorn Phau,Rajeev Ram,7-6(10); 7-6(2),R16,108,14,6,45,80,33,45,21,35,0,2,12,54,80,4,7,41,83,30,41,23,42,3,5,12,53,83
2010-02-01 00:00:00.000,Johannesburg South Africa ATP World Tour 250,HARD,2,Stephane Robert,Izak Van der Merwe,Stephane Robert,7-6(7); 6-1,R16,80,1,4,46,76,35,46,17,30,6,6,10,52,76,4,1,23,52,18,23,15,29,0,2,9,33,52
2010-02-01 00:00:00.000,Johannesburg South Africa ATP World Tour 250,HARD,2,Dustin Brown,Laurent Recouderc,Dustin Brown,6-4; 6-4,R16,60,14,1,29,49,27,29,13,20,0,0,10,40,49,2,3,33,66,25,33,17,33,4,6,10,42,66
2010-02-01 00:00:00.000,Johannesburg South Africa ATP World Tour 250,HARD,2,Somdev Devvarman,Thiago Alves,Somdev Devvarman,6-4; 6-1,R16,66,6,0,35,47,29,35,9,12,3,3,9,38,47,2,1,39,56,22,39,7,17,3,6,8,29,56
2010-02-01 00:00:00.000,Johannesburg South Africa ATP World Tour 250,HARD,2,David Ferrer,Filip Prpic,David Ferrer,6-3; 6-4,R16,108,2,3,42,76,31,42,14,34,5,6,10,45,76,3,5,49,81,35,49,10,32,6,9,9,45,81
2010-02-01 00:00:00.000,Johannesburg South Africa ATP World Tour 250,HARD,2,Gael Monfils,Yen-Hsun Lu,Gael Monfils,6-1; 6-4,Q,57,4,2,34,58,24,34,16,24,4,4,9,40,58,0,4,17,38,12,17,9,21,0,3,8,21,38
2010-02-01 00:00:00.000,Johannesburg South Africa ATP World Tour 250,HARD,2,Feliciano Lopez,Rajeev Ram,Feliciano Lopez,7-6(2); 6-3,Q,95,12,4,43,83,34,43,22,40,7,7,11,56,83,12,2,37,68,28,37,16,31,3,4,10,44,68
2010-02-01 00:00:00.000,Johannesburg South Africa ATP World Tour 250,HARD,2,Stephane Robert,Dustin Brown,Stephane Robert,7-6(5); 6-3,Q,89,3,5,45,94,32,45,23,49,11,13,11,55,94,7,6,26,67,19,26,17,41,2,5,10,36,67
2010-02-01 00:00:00.000,Johannesburg South Africa ATP World Tour 250,HARD,2,David Ferrer,Somdev Devvarman,David Ferrer,6-1; 6-3,Q,66,4,2,25,52,20,25,14,27,5,6,8,34,52,1,0,24,45,12,24,9,21,3,8,8,21,45
2010-02-01 00:00:00.000,Johannesburg South Africa ATP World Tour 250,HARD,2,Feliciano Lopez,Gael Monfils,Feliciano Lopez,3-6; 6-1; 7-6(1),S,93,11,2,45,76,37,45,23,31,1,2,14,60,76,19,4,50,80,41,50,14,30,1,3,14,55,80
2010-02-01 00:00:00.000,Johannesburg South Africa ATP World Tour 250,HARD,2,Stephane Robert,David Ferrer,Stephane Robert,7-5; 6-4,S,96,3,6,46,78,34,46,13,32,6,8,11,47,78,4,4,43,80,29,43,15,37,1,5,11,44,80
2010-02-01 00:00:00.000,Johannesburg South Africa ATP World Tour 250,HARD,2,Feliciano Lopez,Stephane Robert,Feliciano Lopez,7-5; 6-1,F,74,11,1,36,52,28,36,12,16,0,0,10,40,52,3,1,34,67,20,34,17,33,9,12,9,37,67
2010-02-01 00:00:00.000,Santiago Chile ATP World Tour 250,CLAY,2,Fernando Gonzalez,Oscar Hernandez,Fernando Gonzalez,6-2; 6-1,R32,59,6,1,21,44,20,21,13,23,1,1,8,33,44,2,1,39,49,21,39,2,10,6,10,7,23,49
2010-02-01 00:00:00.000,Santiago Chile ATP World Tour 250,CLAY,2,Ruben Ramirez Hidalgo,Victor Crivoi,Ruben Ramirez Hidalgo,6-4; 6-2,R32,89,3,5,38,60,28,38,8,22,3,5,9,36,60,1,1,42,60,23,42,5,18,5,10,9,28,60
2010-02-01 00:00:00.000,Santiago Chile ATP World Tour 250,CLAY,2,Marcel Granollers,Martin Vassallo Arguello,Marcel Granollers,4-6; 6-3 RET,R32,107,3,3,39,66,31,39,13,27,3,4,10,44,66,0,3,38,59,25,38,13,21,5,6,9,38,59
2010-02-01 00:00:00.000,Santiago Chile ATP World Tour 250,CLAY,2,Lukasz Kubot,Horacio Zeballos,Lukasz Kubot,3-6; 7-5; 6-3,R32,146,5,3,46,84,34,46,21,38,2,4,15,55,84,7,4,71,104,48,71,15,33,9,12,15,63,104
2010-02-01 00:00:00.000,Santiago Chile ATP World Tour 250,CLAY,2,Thomaz Bellucci,Nicolas Lapentti,Thomaz Bellucci,3-6; 6-1; 6-1,R32,106,3,4,37,61,28,37,11,24,1,4,11,39,61,1,1,37,73,22,37,12,36,4,11,12,34,73
2010-02-01 00:00:00.000,Santiago Chile ATP World Tour 250,CLAY,2,Paul Capdeville,Cristobal Saavedra-Corvalan,Paul Capdeville,4-6; 6-2; 6-1,R32,117,1,2,42,71,32,42,17,29,4,6,13,49,71,1,1,53,83,30,53,16,30,10,15,12,46,83
2010-02-01 00:00:00.000,Santiago Chile ATP World Tour 250,CLAY,2,Eduardo Schwank,Paolo Lorenzi,Eduardo Schwank,4-6; 7-6(3); 6-3,R32,191,3,4,86,119,60,86,14,33,8,11,15,74,119,0,10,100,139,62,100,16,39,11,15,16,78,139
2010-02-01 00:00:00.000,Santiago Chile ATP World Tour 250,CLAY,2,Jose Acasuso,Hans Podlipnik-Castillo,Jose Acasuso,6-1; 6-1,R32,55,6,1,22,33,19,22,9,11,0,0,7,28,33,0,3,35,48,16,35,3,13,5,10,7,19,48
2010-02-01 00:00:00.000,Santiago Chile ATP World Tour 250,CLAY,2,Joao Souza,Simon Greul,Joao Souza,3-6; 6-4; 7-6(5),R32,144,4,2,64,99,42,64,20,35,4,7,15,62,99,4,7,49,95,39,49,26,46,7,10,16,65,95
2010-02-01 00:00:00.000,Santiago Chile ATP World Tour 250,CLAY,2,Pere Riba,Santiago Ventura,Pere Riba,6-3; 7-5,R32,92,3,3,39,67,28,39,13,28,1,3,11,41,67,1,2,40,64,25,40,10,24,4,8,10,35,64
2010-02-01 00:00:00.000,Santiago Chile ATP World Tour 250,CLAY,2,Alberto Martin,Marcos Daniel,Alberto Martin,6-7(5); 7-5; 6-4,R32,156,1,7,79,124,54,79,20,45,8,12,17,74,124,6,3,68,105,46,68,19,37,5,11,17,65,105
2010-02-01 00:00:00.000,Santiago Chile ATP World Tour 250,CLAY,2,Ricardo Mello,Pablo Cuevas,Ricardo Mello,7-6(5); 6-3,R32,91,2,3,39,65,26,39,14,26,3,6,10,40,65,5,3,45,83,30,45,15,38,5,10,11,45,83
2010-02-01 00:00:00.000,Santiago Chile ATP World Tour 250,CLAY,2,Peter Luczak,Potito Starace,Peter Luczak,7-6(3); 6-4,R32,106,5,1,38,74,27,38,24,36,3,3,11,51,74,5,1,50,74,32,50,16,24,3,4,11,48,74
2010-02-01 00:00:00.000,Santiago Chile ATP World Tour 250,CLAY,2,David Marrero,Juan-Martin Aranguren,David Marrero,7-6(4); 2-6; 7-6(2),R32,165,7,3,80,118,58,80,12,38,4,9,16,70,118,4,6,72,107,53,72,17,35,4,7,16,70,107
2010-02-01 00:00:00.000,Santiago Chile ATP World Tour 250,CLAY,2,Juan Ignacio Chela,Jorge Aguilar,Juan Ignacio Chela,7-5; 6-2,R32,93,0,3,27,65,17,27,21,38,5,8,10,38,65,1,3,28,55,15,28,10,27,2,8,10,25,55
2010-02-01 00:00:00.000,Santiago Chile ATP World Tour 250,CLAY,2,Juan Monaco,Nicolas Massu,Juan Monaco,6-3; 6-4,R32,105,6,2,37,66,30,37,14,29,6,7,10,44,66,4,2,32,62,22,32,12,30,6,9,9,34,62
2010-02-01 00:00:00.000,Santiago Chile ATP World Tour 250,CLAY,2,Fernando Gonzalez,Ruben Ramirez Hidalgo,Fernando Gonzalez,6-4; 6-3,R16,70,8,3,29,47,25,29,10,18,2,3,9,35,47,1,1,32,58,20,32,12,26,3,7,10,32,58
2010-02-01 00:00:00.000,Santiago Chile ATP World Tour 250,CLAY,2,Marcel Granollers,Lukasz Kubot,Marcel Granollers,6-4; 6-2,R16,87,4,2,40,53,28,40,8,13,3,4,9,36,53,2,4,33,55,20,33,9,22,5,9,9,29,55
2010-02-01 00:00:00.000,Santiago Chile ATP World Tour 250,CLAY,2,Thomaz Bellucci,Paul Capdeville,Thomaz Bellucci,5-7; 6-4; 7-5,R16,174,8,4,57,107,42,57,21,50,4,9,17,63,107,4,7,95,136,62,95,12,41,6,12,17,74,136
2010-02-01 00:00:00.000,Santiago Chile ATP World Tour 250,CLAY,2,Eduardo Schwank,Jose Acasuso,Eduardo Schwank,6-7(3); 6-2 RET,R16,100,4,3,36,55,31,36,9,19,0,1,10,40,55,6,0,42,68,28,42,14,26,2,5,10,42,68
2010-02-01 00:00:00.000,Santiago Chile ATP World Tour 250,CLAY,2,Joao Souza,Pere Riba,Joao Souza,6-4; 6-4,R16,88,3,3,38,61,28,38,11,23,3,5,10,39,61,4,2,33,68,18,33,19,35,3,7,10,37,68
2010-02-01 00:00:00.000,Santiago Chile ATP World Tour 250,CLAY,2,Alberto Martin,Ricardo Mello,Alberto Martin,6-3; 6-4,R16,77,4,2,38,59,31,38,10,21,4,5,10,41,59,3,5,35,57,23,35,8,22,3,6,9,31,57
2010-02-01 00:00:00.000,Santiago Chile ATP World Tour 250,CLAY,2,Peter Luczak,David Marrero,Peter Luczak,6-3; 7-6(4),R16,98,12,0,39,63,34,39,18,24,0,0,11,52,63,7,3,47,76,33,47,17,29,5,6,10,50,76
2010-02-01 00:00:00.000,Santiago Chile ATP World Tour 250,CLAY,2,Juan Monaco,Juan Ignacio Chela,Juan Monaco,6-3; 7-5,R16,89,5,4,42,71,30,42,14,29,6,9,11,44,71,1,4,21,57,13,21,15,36,2,7,10,28,57
2010-02-01 00:00:00.000,Santiago Chile ATP World Tour 250,CLAY,2,Fernando Gonzalez,Marcel Granollers,Fernando Gonzalez,7-6(8); 7-6(9),Q,136,4,6,66,101,51,66,13,35,6,9,12,64,101,2,5,68,102,43,68,17,34,7,10,12,60,102
2010-02-01 00:00:00.000,Santiago Chile ATP World Tour 250,CLAY,2,Thomaz Bellucci,Eduardo Schwank,Thomaz Bellucci,6-4; 6-4,Q,77,6,1,39,50,33,39,7,11,0,0,10,40,50,4,3,34,58,28,34,10,24,4,6,10,38,58
2010-02-01 00:00:00.000,Santiago Chile ATP World Tour 250,CLAY,2,Joao Souza,Alberto Martin,Joao Souza,6-2; 6-4,Q,72,5,1,40,55,29,40,7,15,1,2,9,36,55,0,2,31,53,15,31,11,22,2,6,9,26,53
2010-02-01 00:00:00.000,Santiago Chile ATP World Tour 250,CLAY,2,Juan Monaco,Peter Luczak,Juan Monaco,6-4; 3-6; 6-3,Q,117,11,5,54,85,43,54,14,31,8,10,14,57,85,5,1,52,80,37,52,15,28,4,7,14,52,80
2010-02-01 00:00:00.000,Santiago Chile ATP World Tour 250,CLAY,2,Thomaz Bellucci,Fernando Gonzalez,Thomaz Bellucci,3-6; 6-4; 6-3,S,114,2,2,55,77,41,55,12,22,4,6,14,53,77,4,8,55,90,42,55,13,35,4,7,14,55,90
2010-02-01 00:00:00.000,Santiago Chile ATP World Tour 250,CLAY,2,Juan Monaco,Joao Souza,Juan Monaco,6-1; 6-4,S,74,5,3,26,57,20,26,19,31,1,2,9,39,57,2,1,28,47,14,28,12,19,1,5,8,26,47
2010-02-01 00:00:00.000,Santiago Chile ATP World Tour 250,CLAY,2,Thomaz Bellucci,Juan Monaco,Thomaz Bellucci,6-2; 0-6; 6-4,F,125,5,4,61,93,36,61,15,32,9,13,12,51,93,6,3,51,80,35,51,10,29,6,10,12,45,80
2010-02-01 00:00:00.000,Zagreb Croatia ATP World Tour 250,HARD,2,Marin Cilic,Jan Hajek,Marin Cilic,6-2; 6-2,R32,56,6,2,26,46,20,26,13,20,1,1,8,33,46,0,1,30,41,15,30,6,11,0,4,8,21,41
2010-02-01 00:00:00.000,Zagreb Croatia ATP World Tour 250,HARD,2,Daniel Koellerer,Andrey Golubev,Daniel Koellerer,6-3; 3-6; 6-3,R32,114,2,3,54,73,41,54,11,19,4,6,14,52,73,17,4,58,84,42,58,10,26,4,7,13,52,84
2010-02-01 00:00:00.000,Zagreb Croatia ATP World Tour 250,HARD,2,Alexandre Sidorenko,Ruben Bemelmans,Alexandre Sidorenko,7-6(5); 3-6; 6-3,R32,122,7,2,61,90,43,61,18,29,4,7,15,61,90,6,2,73,102,48,73,14,29,5,8,15,62,102
2010-02-01 00:00:00.000,Zagreb Croatia ATP World Tour 250,HARD,2,Ivo Karlovic,Antonio Veic,Ivo Karlovic,4-5 RET,R32,38,6,1,16,26,13,16,5,10,0,1,5,18,26,0,0,16,23,11,16,6,7,1,1,4,17,23
2010-02-01 00:00:00.000,Zagreb Croatia ATP World Tour 250,HARD,2,Jurgen Melzer,Daniel Brands,Jurgen Melzer,6-4; 6-3,R32,94,7,2,42,67,32,42,14,25,7,8,10,46,67,7,2,43,75,29,43,12,32,5,8,9,41,75
2010-02-01 00:00:00.000,Zagreb Croatia ATP World Tour 250,HARD,2,Olivier Rochus,Igor Kunitsyn,Olivier Rochus,4-6; 6-2; 7-5,R32,164,1,0,56,89,34,56,22,33,2,6,15,56,89,1,0,69,96,41,69,10,27,7,13,15,51,96
2010-02-01 00:00:00.000,Zagreb Croatia ATP World Tour 250,HARD,2,Illya Marchenko,Simone Bolelli,Illya Marchenko,6-2; 6-4,R32,81,4,1,34,51,26,34,11,17,1,2,9,37,51,1,1,39,51,25,39,5,12,3,7,9,30,51
2010-02-01 00:00:00.000,Zagreb Croatia ATP World Tour 250,HARD,2,Ivan Dodig,Evgeny Korolev,Ivan Dodig,7-6(9); 6-4,R32,117,10,3,40,73,31,40,18,33,4,7,11,49,73,7,6,55,92,35,55,14,37,6,10,11,49,92
2010-02-01 00:00:00.000,Zagreb Croatia ATP World Tour 250,HARD,2,Michael Berrer,Janko Tipsarevic,Michael Berrer,7-6(5); 6-3,R32,116,11,0,53,75,39,53,10,22,1,3,11,49,75,6,6,47,89,31,47,18,42,8,11,10,49,89
2010-02-01 00:00:00.000,Zagreb Croatia ATP World Tour 250,HARD,2,Petar Jelenic,Ilija Bozoljac,Petar Jelenic,7-6(6); 7-5,R32,119,6,3,53,87,41,53,14,34,4,5,12,55,87,16,3,51,82,42,51,11,31,11,13,12,53,82
2010-02-01 00:00:00.000,Zagreb Croatia ATP World Tour 250,HARD,2,Mikhail Kukushkin,Mischa Zverev,Mikhail Kukushkin,6-4; 6-3,R32,66,5,0,37,50,28,37,10,13,2,2,9,38,50,7,3,39,61,27,39,10,22,6,9,10,37,61
2010-02-01 00:00:00.000,Zagreb Croatia ATP World Tour 250,HARD,2,Viktor Troicki,Rainer Schuettler,Viktor Troicki,6-3; 6-2,R32,62,5,2,27,43,24,27,9,16,2,2,8,33,43,3,3,35,58,22,35,10,23,2,6,9,32,58
2010-02-01 00:00:00.000,Zagreb Croatia ATP World Tour 250,HARD,2,Benjamin Becker,Andreas Vinciguerra,Benjamin Becker,1-6; 6-1; 7-6(4),R32,105,13,3,40,79,30,40,27,39,5,7,13,57,79,10,3,56,91,44,56,16,35,5,7,13,60,91
2010-02-01 00:00:00.000,Zagreb Croatia ATP World Tour 250,HARD,2,Philipp Petzschner,Christophe Rochus,Philipp Petzschner,6-7(4); 6-3; 6-1,R32,121,21,2,51,88,42,51,18,37,4,5,14,60,88,2,2,69,102,45,69,15,33,8,13,14,60,102
2010-02-01 00:00:00.000,Zagreb Croatia ATP World Tour 250,HARD,2,Lukas Lacko,Denis Istomin,Lukas Lacko,6-2; 2-2 RET,R32,76,1,0,23,35,17,23,8,12,0,0,6,25,35,3,2,51,80,28,51,13,29,11,13,6,41,80
2010-02-01 00:00:00.000,Zagreb Croatia ATP World Tour 250,HARD,2,Ivan Ljubicic,Arnaud Clement,Ivan Ljubicic,7-6(4); 6-3,R32,96,11,2,47,73,36,47,15,26,2,3,11,51,73,5,1,38,69,27,38,16,31,0,2,10,43,69
2010-02-01 00:00:00.000,Zagreb Croatia ATP World Tour 250,HARD,2,Marin Cilic,Daniel Koellerer,Marin Cilic,6-2; 6-1,R16,61,12,0,27,40,25,27,8,13,0,0,8,33,40,0,2,21,38,12,21,5,17,1,5,7,17,38
2010-02-01 00:00:00.000,Zagreb Croatia ATP World Tour 250,HARD,2,Ivo Karlovic,Alexandre Sidorenko,Ivo Karlovic,7-6(4); 7-6(8),R16,111,21,2,50,77,45,50,15,27,0,0,12,60,77,11,3,58,99,48,58,19,41,9,9,12,67,99
2010-02-01 00:00:00.000,Zagreb Croatia ATP World Tour 250,HARD,2,Jurgen Melzer,Olivier Rochus,Jurgen Melzer,6-2; 6-3,R16,62,4,0,30,48,24,30,13,18,1,1,9,37,48,2,2,24,40,13,24,10,16,2,5,8,23,40
2010-02-01 00:00:00.000,Zagreb Croatia ATP World Tour 250,HARD,2,Illya Marchenko,Ivan Dodig,Illya Marchenko,6-4; 6-2,R16,112,0,3,39,57,26,39,11,18,2,3,9,37,57,8,3,43,79,26,43,17,36,10,14,9,43,79
2010-02-01 00:00:00.000,Zagreb Croatia ATP World Tour 250,HARD,2,Michael Berrer,Petar Jelenic,Michael Berrer,6-4; 6-3,R16,84,2,1,32,44,26,32,10,12,0,0,9,36,44,4,1,37,67,27,37,11,30,1,4,10,38,67
2010-02-01 00:00:00.000,Zagreb Croatia ATP World Tour 250,HARD,2,Viktor Troicki,Mikhail Kukushkin,Viktor Troicki,7-5; 7-5,R16,106,12,1,43,70,33,43,13,27,3,4,12,46,70,2,0,49,70,29,49,16,21,3,6,12,45,70
2010-02-01 00:00:00.000,Zagreb Croatia ATP World Tour 250,HARD,2,Philipp Petzschner,Benjamin Becker,Philipp Petzschner,1-6; 7-6(4); 7-6(6),R16,136,5,4,60,97,45,60,23,37,1,4,16,68,97,9,0,58,103,46,58,28,45,4,4,15,74,103
2010-02-01 00:00:00.000,Zagreb Croatia ATP World Tour 250,HARD,2,Lukas Lacko,Ivan Ljubicic,Lukas Lacko,7-6(3); 5-7; 7-6(5),R16,157,12,1,60,114,51,60,31,54,4,6,18,82,114,18,6,66,119,56,66,24,53,8,9,18,80,119
2010-02-01 00:00:00.000,Zagreb Croatia ATP World Tour 250,HARD,2,Marin Cilic,Ivo Karlovic,Marin Cilic,7-6(6); 6-4,Q,103,6,1,42,65,36,42,15,23,0,0,11,51,65,24,2,54,81,48,54,9,27,7,8,11,57,81
2010-02-01 00:00:00.000,Zagreb Croatia ATP World Tour 250,HARD,2,Jurgen Melzer,Illya Marchenko,Jurgen Melzer,3-6; 6-0; 7-5,Q,127,3,1,48,69,27,48,11,21,2,7,13,38,69,2,1,67,100,35,67,15,33,7,15,14,50,100
2010-02-01 00:00:00.000,Zagreb Croatia ATP World Tour 250,HARD,2,Michael Berrer,Viktor Troicki,Michael Berrer,6-4; 6-3,Q,84,4,1,37,57,31,37,11,20,1,1,10,42,57,5,3,41,69,26,41,15,28,8,10,9,41,69
2010-02-01 00:00:00.000,Zagreb Croatia ATP World Tour 250,HARD,2,Philipp Petzschner,Lukas Lacko,Philipp Petzschner,6-7(1); 6-2; 6-2,Q,106,11,2,45,77,34,45,19,32,0,2,14,53,77,9,3,51,90,33,51,16,39,6,12,14,49,90
2010-02-01 00:00:00.000,Zagreb Croatia ATP World Tour 250,HARD,2,Marin Cilic,Jurgen Melzer,Marin Cilic,7-6(5); 6-4,S,110,7,1,43,69,37,43,15,26,5,6,11,52,69,7,1,46,72,31,46,14,26,2,4,11,45,72
2010-02-01 00:00:00.000,Zagreb Croatia ATP World Tour 250,HARD,2,Michael Berrer,Philipp Petzschner,Michael Berrer,7-6(6); 7-5,S,106,5,1,45,75,34,45,20,30,4,5,12,54,75,7,1,41,72,33,41,15,31,1,3,12,48,72
2010-02-01 00:00:00.000,Zagreb Croatia ATP World Tour 250,HARD,2,Marin Cilic,Michael Berrer,Marin Cilic,6-4; 6-7(5); 6-3,F,159,13,3,58,105,44,58,28,47,6,6,16,72,105,2,2,68,108,50,68,19,40,6,8,15,69,108
2010-02-08 00:00:00.000,Costa Do Sauipe Brazil ATP World Tour 250,CLAY,2,Juan Carlos Ferrero,Eduardo Schwank,Juan Carlos Ferrero,7-6(4); 6-3,R32,126,0,2,56,79,36,56,12,23,9,11,10,48,79,6,3,36,75,21,36,20,39,2,6,11,41,75
2010-02-08 00:00:00.000,Costa Do Sauipe Brazil ATP World Tour 250,CLAY,2,Nicolas Massu,Rogerio Dutra Silva,Nicolas Massu,6-4; 3-6; 6-4,R32,178,2,3,71,89,47,71,12,18,4,6,14,59,89,2,0,81,98,52,81,10,17,2,5,15,62,98
2010-02-08 00:00:00.000,Costa Do Sauipe Brazil ATP World Tour 250,CLAY,2,Juan Ignacio Chela,Peter Luczak,Juan Ignacio Chela,6-7(4); 6-3; 6-4,R32,144,5,1,59,95,45,59,19,36,5,7,16,64,95,4,4,68,106,42,68,21,38,7,11,15,63,106
2010-02-08 00:00:00.000,Costa Do Sauipe Brazil ATP World Tour 250,CLAY,2,Carlos Berlocq,Ricardo Hocevar,Carlos Berlocq,7-5; 6-3,R32,126,3,1,46,73,34,46,16,27,3,3,10,50,73,4,2,41,71,30,41,12,30,0,3,11,42,71
2010-02-08 00:00:00.000,Costa Do Sauipe Brazil ATP World Tour 250,CLAY,2,Thomaz Bellucci,Thiago Alves,Thomaz Bellucci,6-2; 7-5,R32,92,10,1,36,56,26,36,12,20,2,4,10,38,56,1,3,43,69,25,43,8,26,4,9,10,33,69
2010-02-08 00:00:00.000,Costa Do Sauipe Brazil ATP World Tour 250,CLAY,2,Daniel Gimeno-Traver,Santiago Ventura,Daniel Gimeno-Traver,7-6(7); 6-1,R32,94,2,2,38,56,30,38,11,18,0,1,10,41,56,4,2,36,64,24,36,13,28,7,10,9,37,64
2010-02-08 00:00:00.000,Costa Do Sauipe Brazil ATP World Tour 250,CLAY,2,Ricardo Mello,Paolo Lorenzi,Ricardo Mello,6-2; 7-5,R32,100,2,1,42,57,28,42,10,15,5,7,10,38,57,2,4,47,74,29,47,8,27,8,13,10,37,74
2010-02-08 00:00:00.000,Costa Do Sauipe Brazil ATP World Tour 250,CLAY,2,Victor Hanescu,Joao Souza,Victor Hanescu,7-6(5); 6-4,R32,113,7,0,58,76,42,58,12,18,3,3,11,54,76,4,2,57,86,39,57,13,29,5,6,11,52,86
2010-02-08 00:00:00.000,Costa Do Sauipe Brazil ATP World Tour 250,CLAY,2,Pablo Cuevas,Filippo Volandri,Pablo Cuevas,6-4; 6-3,R32,114,3,2,39,75,23,39,20,36,9,12,10,43,75,0,5,47,75,24,47,12,28,5,10,9,36,75
2010-02-08 00:00:00.000,Costa Do Sauipe Brazil ATP World Tour 250,CLAY,2,Frederico Gil,Pablo Andujar,Frederico Gil,7-6(9); 6-2,R32,110,4,1,47,68,35,47,12,21,0,0,10,47,68,0,1,44,63,27,44,11,19,0,2,10,38,63
2010-02-08 00:00:00.000,Costa Do Sauipe Brazil ATP World Tour 250,CLAY,2,Rui Machado,Marcos Daniel,Rui Machado,6-3; 7-6(3),R32,128,1,3,48,70,32,48,13,22,5,7,10,45,70,11,2,60,97,38,60,15,37,16,20,11,53,97
2010-02-08 00:00:00.000,Costa Do Sauipe Brazil ATP World Tour 250,CLAY,2,Igor Andreev,Potito Starace,Igor Andreev,6-2; 6-2,R32,63,6,3,24,42,21,24,12,18,3,3,8,33,42,0,1,29,40,18,29,2,11,1,5,8,20,40
2010-02-08 00:00:00.000,Costa Do Sauipe Brazil ATP World Tour 250,CLAY,2,Marcel Granollers,Horacio Zeballos,Marcel Granollers,7-5; 3-0 RET,R32,79,8,2,33,52,23,33,10,19,4,5,7,33,52,5,0,37,58,18,37,10,21,3,7,8,28,58
2010-02-08 00:00:00.000,Costa Do Sauipe Brazil ATP World Tour 250,CLAY,2,Fabio Fognini,Martin Vassallo Arguello,Fabio Fognini,6-4; 6-0,R32,83,2,0,25,47,19,25,14,22,2,3,8,33,47,1,1,42,63,21,42,9,21,4,9,8,30,63
2010-02-08 00:00:00.000,Costa Do Sauipe Brazil ATP World Tour 250,CLAY,2,Lukasz Kubot,Oscar Hernandez,Lukasz Kubot,7-5; 7-6(2),R32,140,3,5,42,70,33,42,16,28,3,5,12,49,70,1,1,60,94,37,60,17,34,4,7,12,54,94
2010-02-08 00:00:00.000,Costa Do Sauipe Brazil ATP World Tour 250,CLAY,2,Albert Montanes,Simon Greul,Albert Montanes,6-2; 7-6(2),R32,88,9,1,34,53,31,34,13,19,0,0,10,44,53,0,10,32,72,27,32,16,40,1,3,10,43,72
2010-02-08 00:00:00.000,Costa Do Sauipe Brazil ATP World Tour 250,CLAY,2,Juan Carlos Ferrero,Nicolas Massu,Juan Carlos Ferrero,6-2; 5-7; 6-2,R16,144,4,1,64,81,43,64,9,17,3,6,14,52,81,2,4,60,104,38,60,18,44,8,14,14,56,104
2010-02-08 00:00:00.000,Costa Do Sauipe Brazil ATP World Tour 250,CLAY,2,Carlos Berlocq,Juan Ignacio Chela,Carlos Berlocq,7-6(5); 6-2,R16,130,2,0,48,78,37,48,13,30,6,7,10,50,78,2,1,51,78,36,51,10,27,7,10,10,46,78
2010-02-08 00:00:00.000,Costa Do Sauipe Brazil ATP World Tour 250,CLAY,2,Thomaz Bellucci,Daniel Gimeno-Traver,Thomaz Bellucci,6-4; 6-2,R16,80,4,1,24,54,18,24,22,30,5,5,9,40,54,1,1,33,54,21,33,11,21,4,7,9,32,54
2010-02-08 00:00:00.000,Costa Do Sauipe Brazil ATP World Tour 250,CLAY,2,Ricardo Mello,Victor Hanescu,Ricardo Mello,7-5; 6-3,R16,92,4,1,56,80,39,56,15,24,9,9,11,54,80,5,3,42,60,32,42,7,18,4,6,10,39,60
2010-02-08 00:00:00.000,Costa Do Sauipe Brazil ATP World Tour 250,CLAY,2,Pablo Cuevas,Frederico Gil,Pablo Cuevas,7-5; 4-6; 7-6(3),R16,194,9,4,83,145,54,83,31,62,15,19,17,85,145,3,5,106,142,64,106,16,36,15,19,17,80,142
2010-02-08 00:00:00.000,Costa Do Sauipe Brazil ATP World Tour 250,CLAY,2,Igor Andreev,Rui Machado,Igor Andreev,6-3; 5-7; 6-4,R16,154,7,4,52,94,39,52,20,42,3,6,15,59,94,0,1,58,99,36,58,20,41,4,9,16,56,99
2010-02-08 00:00:00.000,Costa Do Sauipe Brazil ATP World Tour 250,CLAY,2,Fabio Fognini,Marcel Granollers,Fabio Fognini,0-6; 6-1; 7-6(1),R16,113,3,4,41,71,31,41,17,30,3,6,12,48,71,6,4,36,76,30,36,18,40,5,8,13,48,76
2010-02-08 00:00:00.000,Costa Do Sauipe Brazil ATP World Tour 250,CLAY,2,Lukasz Kubot,Albert Montanes,Lukasz Kubot,6-2; 6-2,R16,84,2,3,30,62,26,30,14,32,3,3,8,40,62,3,2,30,51,18,30,7,21,9,13,8,25,51
2010-02-08 00:00:00.000,Costa Do Sauipe Brazil ATP World Tour 250,CLAY,2,Juan Carlos Ferrero,Carlos Berlocq,Juan Carlos Ferrero,6-3; 6-2,Q,91,0,1,41,52,27,41,8,11,3,4,8,35,52,0,3,33,59,20,33,10,26,9,14,9,30,59
2010-02-08 00:00:00.000,Costa Do Sauipe Brazil ATP World Tour 250,CLAY,2,Ricardo Mello,Thomaz Bellucci,Ricardo Mello,6-3; 7-6(3),Q,104,4,0,52,77,36,52,15,25,5,7,11,51,77,6,3,35,63,26,35,12,28,3,6,10,38,63
2010-02-08 00:00:00.000,Costa Do Sauipe Brazil ATP World Tour 250,CLAY,2,Igor Andreev,Pablo Cuevas,Igor Andreev,6-1; 6-1,Q,56,8,2,24,44,23,24,9,20,1,1,7,32,44,1,2,25,40,10,25,6,15,1,6,7,16,40
2010-02-08 00:00:00.000,Costa Do Sauipe Brazil ATP World Tour 250,CLAY,2,Lukasz Kubot,Fabio Fognini,Lukasz Kubot,6-3; 6-1,Q,78,2,6,35,60,21,35,16,25,3,4,8,37,60,1,3,38,54,18,38,6,16,4,9,8,24,54
2010-02-08 00:00:00.000,Costa Do Sauipe Brazil ATP World Tour 250,CLAY,2,Juan Carlos Ferrero,Ricardo Mello,Juan Carlos Ferrero,6-4; 6-2,S,73,5,0,34,44,26,34,6,10,0,2,9,32,44,1,1,40,55,21,40,6,15,3,8,9,27,55
2010-02-08 00:00:00.000,Costa Do Sauipe Brazil ATP World Tour 250,CLAY,2,Lukasz Kubot,Igor Andreev,Lukasz Kubot,2-6; 6-2; 6-4,S,114,9,2,44,70,31,44,15,26,1,4,13,46,70,6,2,45,74,31,45,13,29,2,6,13,44,74
2010-02-08 00:00:00.000,Costa Do Sauipe Brazil ATP World Tour 250,CLAY,2,Juan Carlos Ferrero,Lukasz Kubot,Juan Carlos Ferrero,6-1; 6-0,F,61,1,1,30,37,20,30,4,7,1,2,6,24,37,1,4,19,43,6,19,5,24,3,10,7,11,43
2010-02-08 00:00:00.000,Rotterdam The Netherlands ATP World Tour 500,HARD,2,Novak Djokovic,Sergiy Stakhovsky,Novak Djokovic,6-2; 4-1 RET,R32,54,2,1,17,31,15,17,10,14,1,1,6,25,31,3,0,35,52,20,35,6,17,7,11,7,26,52
2010-02-08 00:00:00.000,Rotterdam The Netherlands ATP World Tour 500,HARD,2,Marco Chiudinelli,Michael Llodra,Marco Chiudinelli,6-1; 6-7(5); 7-6(6),R32,156,5,6,61,108,42,61,29,47,4,6,15,71,108,16,5,70,111,50,70,20,41,6,11,16,70,111
2010-02-08 00:00:00.000,Rotterdam The Netherlands ATP World Tour 500,HARD,2,Florian Mayer,Janko Tipsarevic,Florian Mayer,6-3; 6-7(6); 7-6(6),R32,178,12,6,83,140,66,83,28,57,9,10,17,94,140,9,5,65,108,54,65,20,43,2,4,16,74,108
2010-02-08 00:00:00.000,Rotterdam The Netherlands ATP World Tour 500,HARD,2,Tommy Robredo,Robin Haase,Tommy Robredo,7-6(4); 6-4,R32,91,1,1,40,65,30,40,15,25,1,2,11,45,65,6,2,51,74,37,51,9,23,5,7,11,46,74
2010-02-08 00:00:00.000,Rotterdam The Netherlands ATP World Tour 500,HARD,2,Gael Monfils,Olivier Rochus,Gael Monfils,4-6; 6-1; 6-2,R32,103,19,10,47,78,35,47,14,31,5,8,13,49,78,0,3,60,89,34,60,12,29,12,18,12,46,89
2010-02-08 00:00:00.000,Rotterdam The Netherlands ATP World Tour 500,HARD,2,Thiemo de Bakker,Jan Hajek,Thiemo de Bakker,7-6(5); 6-3,R32,94,9,3,32,64,25,32,19,32,3,5,10,44,64,1,2,49,75,27,49,15,26,5,9,11,42,75
2010-02-08 00:00:00.000,Rotterdam The Netherlands ATP World Tour 500,HARD,2,Marsel Ilhan,Guillermo Garcia-Lopez,Marsel Ilhan,6-1; 6-4,R32,59,3,0,29,44,21,29,13,15,0,1,9,34,44,4,1,25,44,15,25,9,19,3,7,8,24,44
2010-02-08 00:00:00.000,Rotterdam The Netherlands ATP World Tour 500,HARD,2,Mikhail Youzhny,Andrey Golubev,Mikhail Youzhny,1-6; 7-6(0); 7-6(5),R32,139,3,2,61,96,44,61,24,35,3,5,15,68,96,7,6,46,101,40,46,31,55,3,3,16,71,101
2010-02-08 00:00:00.000,Rotterdam The Netherlands ATP World Tour 500,HARD,2,Julien Benneteau,Ivan Ljubicic,Julien Benneteau,6-3; 6-3,R32,100,6,1,44,72,33,44,15,28,4,4,9,48,72,11,3,47,74,33,47,9,27,8,11,9,42,74
2010-02-08 00:00:00.000,Rotterdam The Netherlands ATP World Tour 500,HARD,2,Michael Berrer,Arnaud Clement,Michael Berrer,7-6(16); 4-6; 6-4,R32,159,16,4,64,108,55,64,18,44,3,6,16,73,108,7,3,69,106,52,69,21,37,3,6,16,73,106
2010-02-08 00:00:00.000,Rotterdam The Netherlands ATP World Tour 500,HARD,2,Igor Sijsling,Mischa Zverev,Igor Sijsling,6-7(2); 6-3; 7-5,R32,113,7,1,76,105,57,76,13,29,2,4,17,70,105,7,2,56,96,45,56,18,40,2,6,16,63,96
2010-02-08 00:00:00.000,Rotterdam The Netherlands ATP World Tour 500,HARD,2,Robin Soderling,Florent Serra,Robin Soderling,4-6; 6-4; 6-1,R32,107,26,3,57,87,45,57,14,30,1,2,14,59,87,6,1,56,100,37,56,20,44,4,7,13,57,100
2010-02-08 00:00:00.000,Rotterdam The Netherlands ATP World Tour 500,HARD,2,Jurgen Melzer,Viktor Troicki,Jurgen Melzer,6-3; 3-0 RET,R32,66,2,0,30,50,22,30,9,20,5,6,6,31,50,4,6,19,36,13,19,3,17,0,4,6,16,36
2010-02-08 00:00:00.000,Rotterdam The Netherlands ATP World Tour 500,HARD,2,Andreas Seppi,Stephane Bohli,Andreas Seppi,6-1; 7-5,R32,88,4,4,28,49,20,28,12,21,2,4,9,32,49,5,3,42,76,26,42,9,34,11,17,10,35,76
2010-02-08 00:00:00.000,Rotterdam The Netherlands ATP World Tour 500,HARD,2,Marcos Baghdatis,James Blake,Marcos Baghdatis,6-4; 6-2,R32,67,3,2,24,50,20,24,17,26,0,0,9,37,50,2,4,31,58,18,31,13,27,3,6,9,31,58
2010-02-08 00:00:00.000,Rotterdam The Netherlands ATP World Tour 500,HARD,2,Nikolay Davydenko,Feliciano Lopez,Nikolay Davydenko,6-4; 6-2,R32,75,1,0,33,56,25,33,15,23,2,2,9,40,56,8,5,41,61,28,41,9,20,4,7,9,37,61
2010-02-08 00:00:00.000,Rotterdam The Netherlands ATP World Tour 500,HARD,2,Novak Djokovic,Marco Chiudinelli,Novak Djokovic,6-4; 6-2,R16,91,2,3,28,46,24,28,12,18,0,0,9,36,46,4,0,46,82,28,46,16,36,11,14,9,44,82
2010-02-08 00:00:00.000,Rotterdam The Netherlands ATP World Tour 500,HARD,2,Florian Mayer,Tommy Robredo,Florian Mayer,6-4; 3-6; 6-3,R16,119,5,2,61,97,47,61,17,36,4,5,14,64,97,6,0,51,82,39,51,16,31,5,7,14,55,82
2010-02-08 00:00:00.000,Rotterdam The Netherlands ATP World Tour 500,HARD,2,Gael Monfils,Thiemo de Bakker,Gael Monfils,6-3; 6-2,R16,76,6,3,35,55,29,35,12,20,3,3,9,41,55,2,1,39,58,24,39,8,19,10,13,8,32,58
2010-02-08 00:00:00.000,Rotterdam The Netherlands ATP World Tour 500,HARD,2,Mikhail Youzhny,Marsel Ilhan,Mikhail Youzhny,6-4; 6-4,R16,92,6,3,36,62,27,36,17,26,3,3,10,44,62,4,1,31,63,21,31,20,32,5,7,10,41,63
2010-02-08 00:00:00.000,Rotterdam The Netherlands ATP World Tour 500,HARD,2,Julien Benneteau,Michael Berrer,Julien Benneteau,6-4; 6-4,R16,101,3,1,42,58,34,42,8,16,5,6,10,42,58,5,5,50,83,36,50,10,33,10,13,10,46,83
2010-02-08 00:00:00.000,Rotterdam The Netherlands ATP World Tour 500,HARD,2,Robin Soderling,Igor Sijsling,Robin Soderling,7-6(6); 6-2,R16,79,11,2,46,65,37,46,12,19,1,1,10,49,65,3,2,36,66,27,36,16,30,4,6,10,43,66
2010-02-08 00:00:00.000,Rotterdam The Netherlands ATP World Tour 500,HARD,2,Jurgen Melzer,Andreas Seppi,Jurgen Melzer,6-2; 6-2,R16,82,5,0,35,55,25,35,10,20,3,4,8,35,55,2,1,34,60,18,34,9,26,4,9,8,27,60
2010-02-08 00:00:00.000,Rotterdam The Netherlands ATP World Tour 500,HARD,2,Nikolay Davydenko,Marcos Baghdatis,Nikolay Davydenko,6-3; 6-2,R16,77,1,1,24,47,20,24,11,23,0,1,8,31,47,1,1,24,51,12,24,12,27,2,7,9,24,51
2010-02-08 00:00:00.000,Rotterdam The Netherlands ATP World Tour 500,HARD,2,Novak Djokovic,Florian Mayer,Novak Djokovic,W/O,Q,0,0,0,0,0,0,0,0,0,0,0,0,0,0,0,0,0,0,0,0,0,0,0,0,0,0,0
2010-02-08 00:00:00.000,Rotterdam The Netherlands ATP World Tour 500,HARD,2,Mikhail Youzhny,Gael Monfils,Mikhail Youzhny,5-7; 6-2; 6-3,Q,175,3,4,65,114,38,65,27,49,11,15,15,65,114,11,8,63,115,42,63,20,52,16,22,14,62,115
2010-02-08 00:00:00.000,Rotterdam The Netherlands ATP World Tour 500,HARD,2,Robin Soderling,Julien Benneteau,Robin Soderling,6-0; 6-1,Q,64,6,1,25,40,22,25,7,15,1,1,7,29,40,1,1,21,32,9,21,1,11,0,5,6,10,32
2010-02-08 00:00:00.000,Rotterdam The Netherlands ATP World Tour 500,HARD,2,Nikolay Davydenko,Jurgen Melzer,Nikolay Davydenko,6-3; 6-2,Q,75,6,1,33,45,27,33,7,12,1,2,9,34,45,1,1,39,63,23,39,9,24,3,7,8,32,63
2010-02-08 00:00:00.000,Rotterdam The Netherlands ATP World Tour 500,HARD,2,Mikhail Youzhny,Novak Djokovic,Mikhail Youzhny,7-6(5); 7-6(6),S,137,4,3,54,89,40,54,19,35,3,5,12,59,89,4,2,44,77,35,44,17,33,1,3,12,52,77
2010-02-08 00:00:00.000,Rotterdam The Netherlands ATP World Tour 500,HARD,2,Robin Soderling,Nikolay Davydenko,Robin Soderling,7-6(3); 6-4,S,103,5,3,38,68,33,38,16,30,3,4,11,49,68,4,4,35,75,24,35,21,40,7,9,11,45,75
2010-02-08 00:00:00.000,Rotterdam The Netherlands ATP World Tour 500,HARD,2,Robin Soderling,Mikhail Youzhny,Robin Soderling,6-4; 2-0 RET,F,54,4,2,18,34,13,18,7,16,1,3,6,20,34,1,1,22,32,11,22,3,10,1,5,6,14,32
2010-02-08 00:00:00.000,San Jose CA; U.S.A. ATP World Tour 250,HARD,2,Andy Roddick,Ryler DeHeart,Andy Roddick,6-1; 7-6(1),R32,67,11,1,41,55,32,41,10,14,0,1,10,42,55,5,1,35,54,25,35,6,19,1,4,9,31,54
2010-02-08 00:00:00.000,San Jose CA; U.S.A. ATP World Tour 250,HARD,2,Leonardo Mayer,Ernests Gulbis,Leonardo Mayer,7-5; 6-4,R32,91,10,1,53,76,39,53,15,23,6,6,11,54,76,8,3,52,73,36,52,11,21,3,5,11,47,73
2010-02-08 00:00:00.000,San Jose CA; U.S.A. ATP World Tour 250,HARD,2,Jarkko Nieminen,Lars Poerschke,Jarkko Nieminen,3-6; 6-3; 6-2,R32,100,5,3,58,75,43,58,11,17,5,6,13,54,75,5,3,51,86,39,51,14,35,10,13,13,53,86
2010-02-08 00:00:00.000,San Jose CA; U.S.A. ATP World Tour 250,HARD,2,Tomas Berdych,Wayne Odesnik,Tomas Berdych,6-1; 6-7(5); 7-5,R32,147,13,4,55,97,45,55,27,42,4,4,16,72,97,8,7,72,113,52,72,17,41,9,12,15,69,113
2010-02-08 00:00:00.000,San Jose CA; U.S.A. ATP World Tour 250,HARD,2,Xavier Malisse,Radek Stepanek,Xavier Malisse,6-3; 6-4,R32,71,5,2,40,67,31,40,16,27,4,4,10,47,67,7,3,37,53,29,37,5,16,2,4,9,34,53
2010-02-08 00:00:00.000,San Jose CA; U.S.A. ATP World Tour 250,HARD,2,Michael Russell,Kyu Tae Im,Michael Russell,7-6(6); 6-1,R32,89,1,0,39,54,28,39,10,15,1,2,9,38,54,2,2,41,73,26,41,15,32,2,6,10,41,73
2010-02-08 00:00:00.000,San Jose CA; U.S.A. ATP World Tour 250,HARD,2,Taylor Dent,Alex Bogomolov Jr.,Taylor Dent,6-4; 7-6(2),R32,92,12,1,44,76,31,44,20,32,4,5,11,51,76,0,2,47,69,32,47,13,22,1,3,11,45,69
2010-02-08 00:00:00.000,San Jose CA; U.S.A. ATP World Tour 250,HARD,2,Sam Querrey,Teymuraz Gabashvili,Sam Querrey,6-3; 6-2,R32,55,7,0,27,53,22,27,18,26,1,1,9,40,53,3,5,27,44,18,27,8,17,2,5,8,26,44
2010-02-08 00:00:00.000,San Jose CA; U.S.A. ATP World Tour 250,HARD,2,Philipp Kohlschreiber,Rajeev Ram,Philipp Kohlschreiber,6-7(7); 6-1; 6-3,R32,122,14,3,52,75,44,52,15,23,0,0,14,59,75,14,1,59,104,33,59,26,45,4,8,14,59,104
2010-02-08 00:00:00.000,San Jose CA; U.S.A. ATP World Tour 250,HARD,2,Dudi Sela,Santiago Giraldo,Dudi Sela,7-6(2); 7-6(4),R32,117,5,3,54,82,43,54,17,28,1,2,12,60,82,4,0,51,83,35,51,20,32,1,2,12,55,83
2010-02-08 00:00:00.000,San Jose CA; U.S.A. ATP World Tour 250,HARD,2,Denis Istomin,Ryan Harrison,Denis Istomin,6-2; 7-5,R32,74,6,1,29,51,23,29,15,22,0,1,10,38,51,6,2,47,74,31,47,10,27,9,13,10,41,74
2010-02-08 00:00:00.000,San Jose CA; U.S.A. ATP World Tour 250,HARD,2,Tommy Haas,Devin Britton,Tommy Haas,6-4; 7-6(3),R32,73,10,3,42,70,37,42,16,28,3,3,11,53,70,15,0,47,70,36,47,11,23,3,4,11,47,70
2010-02-08 00:00:00.000,San Jose CA; U.S.A. ATP World Tour 250,HARD,2,Bjorn Phau,Jeremy Chardy,Bjorn Phau,6-3; 6-1,R32,67,7,2,33,60,24,33,16,27,6,6,8,40,60,1,2,35,53,19,35,8,18,1,5,8,27,53
2010-02-08 00:00:00.000,San Jose CA; U.S.A. ATP World Tour 250,HARD,2,Ricardas Berankis,Robby Ginepri,Ricardas Berankis,6-7(5); 6-2; 6-3,R32,114,9,0,56,94,43,56,21,38,0,2,15,64,94,4,3,47,90,38,47,18,43,5,10,14,56,90
2010-02-08 00:00:00.000,San Jose CA; U.S.A. ATP World Tour 250,HARD,2,Benjamin Becker,Tim Smyczek,Benjamin Becker,6-4; 6-2,R32,69,6,1,26,48,21,26,13,22,0,1,9,34,48,2,3,36,57,21,36,9,21,1,5,9,30,57
2010-02-08 00:00:00.000,San Jose CA; U.S.A. ATP World Tour 250,HARD,2,Fernando Verdasco,Yen-Hsun Lu,Fernando Verdasco,6-3; 6-7(6); 6-3,R32,120,14,4,67,102,52,67,18,35,5,7,16,70,102,6,1,59,89,39,59,14,30,4,8,14,53,89
2010-02-08 00:00:00.000,San Jose CA; U.S.A. ATP World Tour 250,HARD,2,Andy Roddick,Leonardo Mayer,Andy Roddick,6-3; 6-2,R16,74,7,0,31,42,27,31,9,11,0,0,9,36,42,7,2,40,60,27,40,7,20,9,12,8,34,60
2010-02-08 00:00:00.000,San Jose CA; U.S.A. ATP World Tour 250,HARD,2,Tomas Berdych,Jarkko Nieminen,Tomas Berdych,6-3; 6-2,R16,63,8,1,25,45,22,25,14,20,0,0,9,36,45,2,1,36,52,18,36,10,16,3,6,8,28,52
2010-02-08 00:00:00.000,San Jose CA; U.S.A. ATP World Tour 250,HARD,2,Michael Russell,Xavier Malisse,Michael Russell,6-4; 7-5,R16,101,1,0,43,62,31,43,10,19,1,3,11,41,62,7,0,48,71,35,48,6,23,1,5,11,41,71
2010-02-08 00:00:00.000,San Jose CA; U.S.A. ATP World Tour 250,HARD,2,Sam Querrey,Taylor Dent,Sam Querrey,6-4; 6-4,R16,67,10,0,52,63,38,52,6,11,4,4,10,44,63,8,0,28,55,23,28,12,27,2,4,10,35,55
2010-02-08 00:00:00.000,San Jose CA; U.S.A. ATP World Tour 250,HARD,2,Philipp Kohlschreiber,Dudi Sela,Philipp Kohlschreiber,6-2; 6-0,R16,55,4,3,28,42,25,28,5,14,0,0,7,30,42,0,4,22,42,11,22,5,20,3,8,7,16,42
2010-02-08 00:00:00.000,San Jose CA; U.S.A. ATP World Tour 250,HARD,2,Denis Istomin,Tommy Haas,Denis Istomin,7-6(3); 6-2,R16,88,10,0,54,72,43,54,10,18,5,5,10,53,72,3,7,45,79,32,45,16,34,8,10,10,48,79
2010-02-08 00:00:00.000,San Jose CA; U.S.A. ATP World Tour 250,HARD,2,Ricardas Berankis,Bjorn Phau,Ricardas Berankis,7-6(5); 6-3,R16,115,8,3,56,105,39,56,24,49,4,6,11,63,105,6,5,40,80,26,40,21,40,10,13,10,47,80
2010-02-08 00:00:00.000,San Jose CA; U.S.A. ATP World Tour 250,HARD,2,Fernando Verdasco,Benjamin Becker,Fernando Verdasco,7-5; 6-2,R16,81,13,2,38,58,31,38,10,20,2,3,10,41,58,8,1,40,68,29,40,9,28,4,8,10,38,68
2010-02-08 00:00:00.000,San Jose CA; U.S.A. ATP World Tour 250,HARD,2,Andy Roddick,Tomas Berdych,Andy Roddick,7-6(5); 7-6(5),Q,103,16,2,61,83,51,61,11,22,3,3,12,62,83,18,3,50,76,41,50,17,26,3,3,12,58,76
2010-02-08 00:00:00.000,San Jose CA; U.S.A. ATP World Tour 250,HARD,2,Sam Querrey,Michael Russell,Sam Querrey,6-4; 6-3,Q,66,9,1,35,56,28,35,12,21,1,2,10,40,56,3,0,36,49,24,36,6,13,1,4,9,30,49
2010-02-08 00:00:00.000,San Jose CA; U.S.A. ATP World Tour 250,HARD,2,Denis Istomin,Philipp Kohlschreiber,Denis Istomin,6-1; 1-6; 6-3,Q,97,4,1,49,75,38,49,10,26,7,10,12,48,75,4,0,37,62,25,37,12,25,5,9,11,37,62
2010-02-08 00:00:00.000,San Jose CA; U.S.A. ATP World Tour 250,HARD,2,Fernando Verdasco,Ricardas Berankis,Fernando Verdasco,6-3; 7-6(5),Q,87,9,4,42,70,35,42,16,28,2,2,11,51,70,6,4,35,67,29,35,18,32,3,4,10,47,67
2010-02-08 00:00:00.000,San Jose CA; U.S.A. ATP World Tour 250,HARD,2,Andy Roddick,Sam Querrey,Andy Roddick,2-6; 7-6(5); 7-6(4),S,120,21,1,69,95,57,69,12,26,3,5,16,69,95,32,3,63,100,58,63,15,37,0,0,16,73,100
2010-02-08 00:00:00.000,San Jose CA; U.S.A. ATP World Tour 250,HARD,2,Fernando Verdasco,Denis Istomin,Fernando Verdasco,6-3; 2-6; 6-4,S,103,6,6,56,78,43,56,9,22,3,6,14,52,78,4,0,42,69,32,42,14,27,2,5,13,46,69
2010-02-08 00:00:00.000,San Jose CA; U.S.A. ATP World Tour 250,HARD,2,Fernando Verdasco,Andy Roddick,Fernando Verdasco,3-6; 6-4; 6-4,F,131,15,7,60,98,46,60,18,38,8,10,15,64,98,10,2,64,92,53,64,8,28,9,11,14,61,92
2010-02-15 00:00:00.000,Buenos Aires Argentina ATP World Tour 250,CLAY,2,David Ferrer,Simon Greul,David Ferrer,6-2; 7-6(3),R32,102,3,1,44,65,31,44,11,21,2,5,10,42,65,0,7,46,89,27,46,18,43,12,17,10,45,89
2010-02-15 00:00:00.000,Buenos Aires Argentina ATP World Tour 250,CLAY,2,Frederico Gil,Peter Luczak,Frederico Gil,6-2; 6-4,R32,87,3,2,31,58,23,31,15,27,4,5,9,38,58,2,3,25,55,16,25,12,30,1,5,9,28,55
2010-02-15 00:00:00.000,Buenos Aires Argentina ATP World Tour 250,CLAY,2,Marcel Granollers,Diego Junqueira,Marcel Granollers,6-1; 6-2,R32,61,0,1,23,36,20,23,8,13,0,0,7,28,36,0,1,37,45,17,37,3,8,4,9,8,20,45
2010-02-15 00:00:00.000,Buenos Aires Argentina ATP World Tour 250,CLAY,2,Igor Andreev,Fabio Fognini,Igor Andreev,7-5; 7-6(4),R32,128,3,3,53,95,34,53,19,42,7,11,12,53,95,0,6,41,81,30,41,14,40,3,8,12,44,81
2010-02-15 00:00:00.000,Buenos Aires Argentina ATP World Tour 250,CLAY,2,Daniel Gimeno-Traver,Nicolas Almagro,Daniel Gimeno-Traver,6-7(4); 7-6(6); 6-3,R32,150,6,2,75,109,55,75,21,34,2,3,17,76,109,5,3,64,96,46,64,20,32,1,3,16,66,96
2010-02-15 00:00:00.000,Buenos Aires Argentina ATP World Tour 250,CLAY,2,David Nalbandian,Potito Starace,David Nalbandian,6-2; 7-6(2),R32,101,1,0,46,68,33,46,10,22,1,3,10,43,68,4,2,61,85,35,61,8,24,7,11,10,43,85
2010-02-15 00:00:00.000,Buenos Aires Argentina ATP World Tour 250,CLAY,2,Pablo Andujar,Oscar Hernandez,Pablo Andujar,6-4; 6-1,R32,97,0,3,29,44,20,29,7,15,0,2,8,27,44,1,4,44,80,24,44,14,36,10,16,9,38,80
2010-02-15 00:00:00.000,Buenos Aires Argentina ATP World Tour 250,CLAY,2,Albert Montanes,Pablo Cuevas,Albert Montanes,6-2; 6-2,R32,74,0,1,22,53,17,22,19,31,0,0,8,36,53,0,1,25,46,17,25,7,21,3,7,8,24,46
2010-02-15 00:00:00.000,Buenos Aires Argentina ATP World Tour 250,CLAY,2,Horacio Zeballos,Gaston Gaudio,Horacio Zeballos,6-3; 3-6; 6-3,R32,117,8,2,61,92,42,61,18,31,5,6,14,60,92,3,1,68,90,43,68,15,22,9,11,13,58,90
2010-02-15 00:00:00.000,Buenos Aires Argentina ATP World Tour 250,CLAY,2,Carlos Moya,Filippo Volandri,Carlos Moya,6-2; 7-5,R32,99,2,2,50,75,34,50,13,25,5,6,10,47,75,0,1,53,64,29,53,6,11,3,7,10,35,64
2010-02-15 00:00:00.000,Buenos Aires Argentina ATP World Tour 250,CLAY,2,Juan Ignacio Chela,Richard Gasquet,Juan Ignacio Chela,7-6(3); 7-5,R32,105,3,2,38,76,29,38,23,38,3,5,12,52,76,5,1,49,77,35,49,13,28,4,7,12,48,77
2010-02-15 00:00:00.000,Buenos Aires Argentina ATP World Tour 250,CLAY,2,Juan Monaco,Lukasz Kubot,Juan Monaco,6-4; 7-6(1),R32,95,8,2,36,61,31,36,18,25,0,0,11,49,61,2,5,50,79,35,50,15,29,3,4,11,50,79
2010-02-15 00:00:00.000,Buenos Aires Argentina ATP World Tour 250,CLAY,2,Victor Hanescu,Eduardo Schwank,Victor Hanescu,6-3; 7-5,R32,86,4,0,44,64,36,44,10,20,0,1,11,46,64,1,3,36,61,24,36,12,25,4,7,10,36,61
2010-02-15 00:00:00.000,Buenos Aires Argentina ATP World Tour 250,CLAY,2,Santiago Ventura,Daniel Koellerer,Santiago Ventura,6-4; 6-2,R32,94,4,4,33,69,27,33,17,36,7,8,9,44,69,0,0,42,54,22,42,7,12,5,9,9,29,54
2010-02-15 00:00:00.000,Buenos Aires Argentina ATP World Tour 250,CLAY,2,Marcos Daniel,Paolo Lorenzi,Marcos Daniel,6-1; 6-3,R32,96,1,2,41,57,25,41,9,16,3,5,8,34,57,0,4,29,53,13,29,9,24,3,9,8,22,53
2010-02-15 00:00:00.000,Buenos Aires Argentina ATP World Tour 250,CLAY,2,Juan Carlos Ferrero,Ricardo Mello,Juan Carlos Ferrero,6-1; 6-2,R32,49,1,0,28,33,23,28,5,5,0,0,7,28,33,0,1,26,39,13,26,4,13,2,7,8,17,39
2010-02-15 00:00:00.000,Buenos Aires Argentina ATP World Tour 250,CLAY,2,David Ferrer,Frederico Gil,David Ferrer,6-3; 6-0,R16,57,1,0,29,36,22,29,3,7,2,3,7,25,36,1,1,26,40,10,26,4,14,1,7,8,14,40
2010-02-15 00:00:00.000,Buenos Aires Argentina ATP World Tour 250,CLAY,2,Igor Andreev,Marcel Granollers,Igor Andreev,3-6; 6-3; 6-4,R16,134,2,2,55,87,40,55,18,32,4,5,14,58,87,3,2,50,83,34,50,19,33,4,6,14,53,83
2010-02-15 00:00:00.000,Buenos Aires Argentina ATP World Tour 250,CLAY,2,David Nalbandian,Daniel Gimeno-Traver,David Nalbandian,6-7(5); 6-4; 7-6(7),R16,167,1,1,89,127,55,89,22,38,8,12,17,77,127,8,7,75,115,53,75,16,40,6,11,17,69,115
2010-02-15 00:00:00.000,Buenos Aires Argentina ATP World Tour 250,CLAY,2,Albert Montanes,Pablo Andujar,Albert Montanes,6-3; 6-2,R16,67,7,1,30,46,27,30,8,16,1,2,9,35,46,2,0,34,51,20,34,6,17,5,9,8,26,51
2010-02-15 00:00:00.000,Buenos Aires Argentina ATP World Tour 250,CLAY,2,Horacio Zeballos,Carlos Moya,Horacio Zeballos,6-4; 6-4,R16,70,4,0,39,51,33,39,6,12,1,2,10,39,51,3,1,29,53,21,29,12,24,0,3,10,33,53
2010-02-15 00:00:00.000,Buenos Aires Argentina ATP World Tour 250,CLAY,2,Juan Monaco,Juan Ignacio Chela,Juan Monaco,7-6(3); 4-6; 6-2,R16,167,6,1,77,119,51,77,23,42,12,15,15,74,119,2,3,53,103,34,53,27,50,8,12,15,61,103
2010-02-15 00:00:00.000,Buenos Aires Argentina ATP World Tour 250,CLAY,2,Santiago Ventura,Victor Hanescu,Santiago Ventura,6-4; 7-6(10),R16,126,1,2,51,86,31,51,18,35,8,12,11,49,86,2,1,57,81,31,57,14,24,5,10,11,45,81
2010-02-15 00:00:00.000,Buenos Aires Argentina ATP World Tour 250,CLAY,2,Juan Carlos Ferrero,Marcos Daniel,Juan Carlos Ferrero,6-2; 6-4,R16,76,0,0,33,43,27,33,9,10,0,0,9,36,43,5,0,46,70,29,46,9,24,9,12,9,38,70
2010-02-15 00:00:00.000,Buenos Aires Argentina ATP World Tour 250,CLAY,2,David Ferrer,Igor Andreev,David Ferrer,7-5; 6-2,Q,102,2,1,48,75,28,48,18,27,10,12,10,46,75,3,4,31,60,21,31,10,29,3,8,10,31,60
2010-02-15 00:00:00.000,Buenos Aires Argentina ATP World Tour 250,CLAY,2,Albert Montanes,David Nalbandian,Albert Montanes,W/O,Q,0,0,0,0,0,0,0,0,0,0,0,0,0,0,0,0,0,0,0,0,0,0,0,0,0,0,0
2010-02-15 00:00:00.000,Buenos Aires Argentina ATP World Tour 250,CLAY,2,Juan Monaco,Horacio Zeballos,Juan Monaco,7-5; 6-1,Q,78,4,1,29,52,25,29,16,23,0,0,10,41,52,5,1,43,61,26,43,5,18,1,4,9,31,61
2010-02-15 00:00:00.000,Buenos Aires Argentina ATP World Tour 250,CLAY,2,Juan Carlos Ferrero,Santiago Ventura,Juan Carlos Ferrero,6-3; 3-6; 6-2,Q,108,2,0,54,66,40,54,10,12,1,2,13,50,66,6,4,40,80,28,40,21,40,3,6,13,49,80
2010-02-15 00:00:00.000,Buenos Aires Argentina ATP World Tour 250,CLAY,2,David Ferrer,Albert Montanes,David Ferrer,6-1; 6-1,S,71,1,0,28,47,24,28,9,19,1,1,7,33,47,1,8,29,54,15,29,8,25,1,6,7,23,54
2010-02-15 00:00:00.000,Buenos Aires Argentina ATP World Tour 250,CLAY,2,Juan Carlos Ferrero,Juan Monaco,Juan Carlos Ferrero,6-2; 7-6(7),S,97,1,0,46,58,30,46,10,12,1,3,10,40,58,1,3,42,63,23,42,11,21,3,7,10,34,63
2010-02-15 00:00:00.000,Buenos Aires Argentina ATP World Tour 250,CLAY,2,Juan Carlos Ferrero,David Ferrer,Juan Carlos Ferrero,5-7; 6-4; 6-3,F,152,2,4,78,100,53,78,10,22,7,11,16,63,100,1,1,54,88,35,54,16,34,4,9,15,51,88
2010-02-15 00:00:00.000,Marseille France ATP World Tour 250,HARD,2,Robin Soderling,N/A Bye,Robin Soderling,,R32,0,0,0,0,0,0,0,0,0,0,0,0,0,0,0,0,0,0,0,0,0,0,0,0,0,0,0
2010-02-15 00:00:00.000,Marseille France ATP World Tour 250,HARD,2,Sergiy Stakhovsky,Simone Bolelli,Sergiy Stakhovsky,6-3; 3-6; 6-4,R32,106,15,3,59,86,48,59,10,27,5,7,14,58,86,4,3,54,78,42,54,12,24,4,7,14,54,78
2010-02-15 00:00:00.000,Marseille France ATP World Tour 250,HARD,2,Michael Llodra,Edouard Roger-Vasselin,Michael Llodra,6-7(5); 6-3; 6-4,R32,115,17,3,53,83,47,53,18,30,1,2,16,65,83,6,1,55,85,41,55,18,30,2,5,15,59,85
2010-02-15 00:00:00.000,Marseille France ATP World Tour 250,HARD,2,Marcos Baghdatis,Daniel Brands,Marcos Baghdatis,6-3; 6-2,R32,69,4,1,39,57,33,39,9,18,1,1,9,42,57,7,1,29,52,17,29,12,23,4,7,8,29,52
2010-02-15 00:00:00.000,Marseille France ATP World Tour 250,HARD,2,Tommy Robredo,N/A Bye,Tommy Robredo,,R32,0,0,0,0,0,0,0,0,0,0,0,0,0,0,0,0,0,0,0,0,0,0,0,0,0,0,0
2010-02-15 00:00:00.000,Marseille France ATP World Tour 250,HARD,2,Mischa Zverev,David Guez,Mischa Zverev,7-6(3); 6-4,R32,102,4,1,35,63,28,35,15,28,2,5,11,43,63,0,0,37,75,18,37,23,38,6,10,11,41,75
2010-02-15 00:00:00.000,Marseille France ATP World Tour 250,HARD,2,Yannick Mertens,Jan Hajek,Yannick Mertens,7-6(8); 6-1,R32,73,4,2,35,57,26,35,11,22,5,7,9,37,57,2,0,32,69,18,32,17,37,1,6,10,35,69
2010-02-15 00:00:00.000,Marseille France ATP World Tour 250,HARD,2,Guillaume Rufin,Laurent Recouderc,Guillaume Rufin,7-5; 4-6; 7-6(2),R32,144,15,10,42,112,31,42,39,70,5,10,17,70,112,7,1,45,102,31,45,29,57,1,6,17,60,102
2010-02-15 00:00:00.000,Marseille France ATP World Tour 250,HARD,2,Julien Benneteau,Stephane Bohli,Julien Benneteau,7-6(5); 7-6(3),R32,120,9,2,53,90,41,53,24,37,2,2,12,65,90,14,2,37,73,33,37,21,36,1,1,12,54,73
2010-02-15 00:00:00.000,Marseille France ATP World Tour 250,HARD,2,Florent Serra,Igor Kunitsyn,Florent Serra,6-3; 6-3,R32,55,4,0,29,48,25,29,11,19,0,0,9,36,48,1,0,33,45,21,33,6,12,0,3,9,27,45
2010-02-15 00:00:00.000,Marseille France ATP World Tour 250,HARD,2,Andreas Seppi,Arnaud Clement,Andreas Seppi,7-6(2); 7-5,R32,121,7,9,49,88,39,49,15,39,4,7,12,54,88,6,3,45,86,32,45,18,41,9,13,12,50,86
2010-02-15 00:00:00.000,Marseille France ATP World Tour 250,HARD,2,Gael Monfils,N/A Bye,Gael Monfils,,R32,0,0,0,0,0,0,0,0,0,0,0,0,0,0,0,0,0,0,0,0,0,0,0,0,0,0,0
2010-02-15 00:00:00.000,Marseille France ATP World Tour 250,HARD,2,Olivier Rochus,Gilles Simon,Olivier Rochus,7-5; 6-2,R32,96,0,1,42,55,30,42,7,13,1,3,10,37,55,13,3,37,78,26,37,14,41,9,14,10,40,78
2010-02-15 00:00:00.000,Marseille France ATP World Tour 250,HARD,2,Illya Marchenko,Ruben Bemelmans,Illya Marchenko,4-6; 6-3; 6-2,R32,118,4,0,54,87,36,54,23,33,2,3,14,59,87,2,1,52,86,34,52,19,34,11,14,13,53,86
2010-02-15 00:00:00.000,Marseille France ATP World Tour 250,HARD,2,Josselin Ouanna,Denis Istomin,Josselin Ouanna,6-4; 1-6; 6-3,R32,87,12,4,37,70,31,37,19,33,2,4,13,50,70,14,0,51,67,40,51,8,16,2,4,13,48,67
2010-02-15 00:00:00.000,Marseille France ATP World Tour 250,HARD,2,Jo-Wilfried Tsonga,N/A Bye,Jo-Wilfried Tsonga,,R32,0,0,0,0,0,0,0,0,0,0,0,0,0,0,0,0,0,0,0,0,0,0,0,0,0,0,0
2010-02-15 00:00:00.000,Marseille France ATP World Tour 250,HARD,2,Robin Soderling,Sergiy Stakhovsky,Robin Soderling,6-7(5); 6-3; 6-4,R16,115,16,7,65,103,56,65,18,38,4,4,16,74,103,20,3,62,88,49,62,11,26,0,2,15,60,88
2010-02-15 00:00:00.000,Marseille France ATP World Tour 250,HARD,2,Michael Llodra,Marcos Baghdatis,Michael Llodra,7-6(6); 6-4,R16,99,11,4,42,72,31,42,20,30,6,7,11,51,72,5,2,39,72,29,39,16,33,1,3,11,45,72
2010-02-15 00:00:00.000,Marseille France ATP World Tour 250,HARD,2,Mischa Zverev,Tommy Robredo,Mischa Zverev,6-2; 3-6; 6-1,R16,114,3,6,55,85,41,55,14,30,5,6,12,55,85,3,1,54,85,35,54,14,31,5,9,12,49,85
2010-02-15 00:00:00.000,Marseille France ATP World Tour 250,HARD,2,Guillaume Rufin,Yannick Mertens,Guillaume Rufin,6-3; 2-6; 6-2,R16,91,6,4,33,77,27,33,23,44,3,5,13,50,77,4,3,37,64,27,37,15,27,2,5,12,42,64
2010-02-15 00:00:00.000,Marseille France ATP World Tour 250,HARD,2,Julien Benneteau,Florent Serra,Julien Benneteau,6-4; 6-4,R16,79,11,0,47,62,33,47,12,15,2,2,10,45,62,2,2,34,59,24,34,14,25,3,5,10,38,59
2010-02-15 00:00:00.000,Marseille France ATP World Tour 250,HARD,2,Gael Monfils,Andreas Seppi,Gael Monfils,7-6(4); 3-6; 7-6(3),R16,125,18,5,64,103,54,64,18,39,1,2,16,72,103,2,5,60,104,46,60,31,44,3,3,17,77,104
2010-02-15 00:00:00.000,Marseille France ATP World Tour 250,HARD,2,Illya Marchenko,Olivier Rochus,Illya Marchenko,6-1; 3-6; 6-2,R16,134,5,5,48,87,35,48,15,39,5,8,12,50,87,1,1,48,78,21,48,19,30,5,11,12,40,78
2010-02-15 00:00:00.000,Marseille France ATP World Tour 250,HARD,2,Jo-Wilfried Tsonga,Josselin Ouanna,Jo-Wilfried Tsonga,7-6(9); 6-4,R16,92,19,1,45,65,40,45,13,20,0,0,11,53,65,8,6,47,80,38,47,17,33,4,5,11,55,80
2010-02-15 00:00:00.000,Marseille France ATP World Tour 250,HARD,2,Michael Llodra,Robin Soderling,Michael Llodra,7-6(2); 6-4,Q,87,15,6,40,64,37,40,12,24,2,2,11,49,64,8,1,45,75,35,45,14,30,3,4,11,49,75
2010-02-15 00:00:00.000,Marseille France ATP World Tour 250,HARD,2,Mischa Zverev,Guillaume Rufin,Mischa Zverev,7-5; 6-7(4); 6-3,Q,133,7,3,77,106,54,77,16,29,2,5,17,70,106,6,9,62,114,42,62,25,52,12,17,16,67,114
2010-02-15 00:00:00.000,Marseille France ATP World Tour 250,HARD,2,Julien Benneteau,Gael Monfils,Julien Benneteau,6-3; 7-5,Q,79,1,3,36,61,27,36,15,25,2,4,11,42,61,14,4,35,61,26,35,7,26,3,7,10,33,61
2010-02-15 00:00:00.000,Marseille France ATP World Tour 250,HARD,2,Jo-Wilfried Tsonga,Illya Marchenko,Jo-Wilfried Tsonga,6-3; 6-4,Q,95,7,3,40,63,32,40,9,23,2,3,10,41,63,1,1,41,68,25,41,15,27,8,11,9,40,68
2010-02-15 00:00:00.000,Marseille France ATP World Tour 250,HARD,2,Michael Llodra,Mischa Zverev,Michael Llodra,6-1; 7-6(3),S,72,13,2,34,57,29,34,15,23,0,1,10,44,57,3,1,32,62,21,32,14,30,3,6,9,35,62
2010-02-15 00:00:00.000,Marseille France ATP World Tour 250,HARD,2,Julien Benneteau,Jo-Wilfried Tsonga,Julien Benneteau,7-6(11); 5-7; 7-6(3),S,177,13,6,92,134,63,92,21,42,5,9,18,84,134,23,1,79,119,58,79,22,40,4,7,18,80,119
2010-02-15 00:00:00.000,Marseille France ATP World Tour 250,HARD,2,Michael Llodra,Julien Benneteau,Michael Llodra,6-3; 6-4,F,71,14,4,39,59,33,39,11,20,0,0,10,44,59,6,3,31,48,24,31,8,17,0,2,9,32,48
2010-02-15 00:00:00.000,Memphis TN; U.S.A. ATP World Tour 500,HARD,2,Andy Roddick,James Blake,Andy Roddick,6-3; 4-6; 7-6(3),R32,117,22,2,71,94,54,71,11,23,0,3,16,65,94,8,1,57,91,42,57,17,34,2,5,15,59,91
2010-02-15 00:00:00.000,Memphis TN; U.S.A. ATP World Tour 500,HARD,2,Yen-Hsun Lu,Robby Ginepri,Yen-Hsun Lu,4-6; 6-4; 6-4,R32,115,6,4,60,97,42,60,20,37,6,9,15,62,97,9,3,52,86,36,52,17,34,3,7,15,53,86
2010-02-15 00:00:00.000,Memphis TN; U.S.A. ATP World Tour 500,HARD,2,Leonardo Mayer,Mardy Fish,Leonardo Mayer,6-4; 6-0,R32,49,8,1,28,41,25,28,6,13,0,1,8,31,41,2,3,21,41,11,21,8,20,2,7,8,19,41
2010-02-15 00:00:00.000,Memphis TN; U.S.A. ATP World Tour 500,HARD,2,Sam Querrey,Rajeev Ram,Sam Querrey,6-2; 6-3,R32,50,11,2,40,51,33,40,5,11,3,3,9,38,51,4,3,27,44,18,27,6,17,1,4,8,24,44
2010-02-15 00:00:00.000,Memphis TN; U.S.A. ATP World Tour 500,HARD,2,Radek Stepanek,Kevin Anderson,Radek Stepanek,7-5; 4-6; 6-4,R32,123,6,2,50,87,40,50,24,37,5,7,16,64,87,15,0,71,96,49,71,14,25,2,5,16,63,96
2010-02-15 00:00:00.000,Memphis TN; U.S.A. ATP World Tour 500,HARD,2,Ernests Gulbis,Robert Kendrick,Ernests Gulbis,6-4; 6-4,R32,68,8,3,34,59,27,34,17,25,2,2,10,44,59,12,4,38,64,29,38,12,26,5,7,10,41,64
2010-02-15 00:00:00.000,Memphis TN; U.S.A. ATP World Tour 500,HARD,2,Michael Russell,Wayne Odesnik,Michael Russell,0-6; 7-5; 6-4,R32,133,3,8,52,80,36,52,12,28,4,9,14,48,80,6,4,55,100,38,55,18,45,10,14,14,56,100
2010-02-15 00:00:00.000,Memphis TN; U.S.A. ATP World Tour 500,HARD,2,Tomas Berdych,Ryan Sweeting,Tomas Berdych,6-2; 6-1,R32,57,4,2,25,39,23,25,10,14,0,0,8,33,39,2,3,34,53,19,34,7,19,4,8,7,26,53
2010-02-15 00:00:00.000,Memphis TN; U.S.A. ATP World Tour 500,HARD,2,John Isner,Ryan Harrison,John Isner,6-1; 7-5,R32,63,8,1,33,46,27,33,11,13,0,0,9,38,46,4,6,44,68,30,44,8,24,3,7,10,38,68
2010-02-15 00:00:00.000,Memphis TN; U.S.A. ATP World Tour 500,HARD,2,Jarkko Nieminen,Dudi Sela,Jarkko Nieminen,6-2; 7-5,R32,74,2,4,52,67,34,52,7,15,2,4,10,41,67,0,3,29,58,16,29,12,29,2,7,10,28,58
2010-02-15 00:00:00.000,Memphis TN; U.S.A. ATP World Tour 500,HARD,2,Ivo Karlovic,Benjamin Becker,Ivo Karlovic,7-6(6); 7-6(4),R32,99,32,4,58,82,49,58,14,24,3,3,12,63,82,8,4,40,78,31,40,27,38,1,1,12,58,78
2010-02-15 00:00:00.000,Memphis TN; U.S.A. ATP World Tour 500,HARD,2,Xavier Malisse,Tommy Haas,Xavier Malisse,6-4; 3-6; 6-4,R32,115,12,1,55,82,41,55,14,27,1,3,14,55,82,11,8,68,116,48,68,20,48,15,18,15,68,116
2010-02-15 00:00:00.000,Memphis TN; U.S.A. ATP World Tour 500,HARD,2,Evgeny Korolev,Philipp Kohlschreiber,Evgeny Korolev,7-5; 7-5,R32,103,10,3,44,78,35,44,15,34,5,8,12,50,78,2,4,52,85,32,52,12,33,10,15,12,44,85
2010-02-15 00:00:00.000,Memphis TN; U.S.A. ATP World Tour 500,HARD,2,Philipp Petzschner,Taylor Dent,Philipp Petzschner,1-6; 6-3; 6-4,R32,85,10,3,45,83,35,45,20,38,3,5,13,55,83,8,4,38,67,32,38,15,29,0,2,13,47,67
2010-02-15 00:00:00.000,Memphis TN; U.S.A. ATP World Tour 500,HARD,2,Lukas Lacko,Bobby Reynolds,Lukas Lacko,2-6; 7-6(6); 6-4,R32,121,10,3,49,87,40,49,19,38,3,6,15,59,87,12,5,51,102,40,51,29,51,4,6,15,69,102
2010-02-15 00:00:00.000,Memphis TN; U.S.A. ATP World Tour 500,HARD,2,Jeremy Chardy,Fernando Verdasco,Jeremy Chardy,7-6(4); 6-3,R32,75,7,6,40,66,35,40,15,26,0,0,11,50,66,8,4,38,61,30,38,13,23,3,4,10,43,61
2010-02-15 00:00:00.000,Memphis TN; U.S.A. ATP World Tour 500,HARD,2,Andy Roddick,Yen-Hsun Lu,Andy Roddick,7-6(2); 6-4,R16,101,10,3,45,65,38,45,12,20,0,0,11,50,65,1,1,59,82,40,59,11,23,7,8,11,51,82
2010-02-15 00:00:00.000,Memphis TN; U.S.A. ATP World Tour 500,HARD,2,Sam Querrey,Leonardo Mayer,Sam Querrey,6-4; 6-0,R16,61,8,3,32,51,29,32,6,19,0,0,8,35,51,2,1,29,46,20,29,4,17,5,9,8,24,46
2010-02-15 00:00:00.000,Memphis TN; U.S.A. ATP World Tour 500,HARD,2,Ernests Gulbis,Radek Stepanek,Ernests Gulbis,7-6(5); 7-5,R16,98,20,1,51,74,41,51,14,23,5,5,12,55,74,7,3,52,86,36,52,18,34,2,3,12,54,86
2010-02-15 00:00:00.000,Memphis TN; U.S.A. ATP World Tour 500,HARD,2,Tomas Berdych,Michael Russell,Tomas Berdych,3-6; 6-3; 6-2,R16,126,13,5,46,76,41,46,14,30,4,5,13,55,76,4,6,58,99,38,58,20,41,7,10,13,58,99
2010-02-15 00:00:00.000,Memphis TN; U.S.A. ATP World Tour 500,HARD,2,John Isner,Jarkko Nieminen,John Isner,6-7(3); 6-4; 6-4,R16,120,18,4,77,101,61,77,12,24,1,1,16,73,101,4,2,81,98,58,81,10,17,1,3,16,68,98
2010-02-15 00:00:00.000,Memphis TN; U.S.A. ATP World Tour 500,HARD,2,Ivo Karlovic,Xavier Malisse,Ivo Karlovic,6-4; 6-4,R16,70,18,3,36,53,32,36,10,17,1,1,10,42,53,4,1,33,63,21,33,20,30,5,7,10,41,63
2010-02-15 00:00:00.000,Memphis TN; U.S.A. ATP World Tour 500,HARD,2,Philipp Petzschner,Evgeny Korolev,Philipp Petzschner,7-6(5); 7-6(5),R16,103,14,2,41,84,33,41,24,43,1,3,12,57,84,5,7,50,88,40,50,16,38,6,8,12,56,88
2010-02-15 00:00:00.000,Memphis TN; U.S.A. ATP World Tour 500,HARD,2,Lukas Lacko,Jeremy Chardy,Lukas Lacko,7-6(4); 2-1 RET,R16,58,9,2,26,47,24,26,11,21,1,2,8,35,47,8,1,29,46,24,29,7,17,3,4,7,31,46
2010-02-15 00:00:00.000,Memphis TN; U.S.A. ATP World Tour 500,HARD,2,Sam Querrey,Andy Roddick,Sam Querrey,7-5; 3-6; 6-1,Q,95,16,3,52,82,41,52,16,30,3,4,14,57,82,11,2,50,70,40,50,10,20,1,4,14,50,70
2010-02-15 00:00:00.000,Memphis TN; U.S.A. ATP World Tour 500,HARD,2,Ernests Gulbis,Tomas Berdych,Ernests Gulbis,3-6; 6-3; 7-6(3),Q,157,23,5,69,116,52,69,22,47,1,3,15,74,116,12,3,60,95,46,60,16,35,1,3,15,62,95
2010-02-15 00:00:00.000,Memphis TN; U.S.A. ATP World Tour 500,HARD,2,John Isner,Ivo Karlovic,John Isner,6-1; 7-6(7),Q,76,10,1,45,67,35,45,15,22,1,1,10,50,67,13,2,31,50,28,31,7,19,1,3,9,35,50
2010-02-15 00:00:00.000,Memphis TN; U.S.A. ATP World Tour 500,HARD,2,Philipp Petzschner,Lukas Lacko,Philipp Petzschner,6-1; 1-6; 6-1,Q,91,10,0,38,69,25,38,20,31,4,6,11,45,69,5,2,37,62,25,37,10,25,5,9,10,35,62
2010-02-15 00:00:00.000,Memphis TN; U.S.A. ATP World Tour 500,HARD,2,Sam Querrey,Ernests Gulbis,Sam Querrey,6-3; 6-4,S,89,11,2,50,79,37,50,15,29,9,9,10,52,79,8,4,40,73,29,40,15,33,10,12,9,44,73
2010-02-15 00:00:00.000,Memphis TN; U.S.A. ATP World Tour 500,HARD,2,John Isner,Philipp Petzschner,John Isner,7-5; 4-6; 6-3,S,122,13,2,56,90,41,56,23,34,5,7,16,64,90,12,5,56,95,38,56,23,39,8,11,15,61,95
2010-02-15 00:00:00.000,Memphis TN; U.S.A. ATP World Tour 500,HARD,2,Sam Querrey,John Isner,Sam Querrey,6-7(3); 7-6(5); 6-3,F,119,17,2,50,93,41,50,34,43,3,3,16,75,93,19,1,65,99,53,65,21,34,2,4,17,74,99
2010-02-22 00:00:00.000,Acapulco Mexico ATP World Tour 500,CLAY,2,Fernando Verdasco,Fabio Fognini,Fernando Verdasco,2-6; 6-4; 6-0,R32,114,4,9,50,75,39,50,8,25,7,9,12,47,75,1,3,50,79,35,50,11,29,4,8,12,46,79
2010-02-22 00:00:00.000,Acapulco Mexico ATP World Tour 500,CLAY,2,Lukasz Kubot,Horacio Zeballos,Lukasz Kubot,6-1; 6-2,R32,65,8,1,35,53,28,35,10,18,4,4,8,38,53,2,1,34,44,14,34,6,10,5,9,7,20,44
2010-02-22 00:00:00.000,Acapulco Mexico ATP World Tour 500,CLAY,2,Juan Ignacio Chela,Peter Luczak,Juan Ignacio Chela,6-0; 1-6; 6-0,R32,96,6,3,32,60,22,32,14,28,2,5,10,36,60,1,4,40,57,20,40,6,17,7,13,9,26,57
2010-02-22 00:00:00.000,Acapulco Mexico ATP World Tour 500,CLAY,2,Juan Monaco,Alberto Martin,Juan Monaco,6-7(6); 7-5; 6-2,R32,151,0,7,60,119,40,60,36,59,7,8,16,76,119,1,5,72,101,48,72,15,29,4,8,16,63,101
2010-02-22 00:00:00.000,Acapulco Mexico ATP World Tour 500,CLAY,2,Juan Carlos Ferrero,Diego Junqueira,Juan Carlos Ferrero,6-2; 6-3,R32,68,0,2,29,47,20,29,10,18,3,5,8,30,47,1,3,30,47,11,30,8,17,4,10,9,19,47
2010-02-22 00:00:00.000,Acapulco Mexico ATP World Tour 500,CLAY,2,Igor Andreev,Victor Crivoi,Igor Andreev,6-3; 6-4,R32,89,2,7,39,70,30,39,15,31,9,10,10,45,70,2,2,33,53,21,33,9,20,3,6,9,30,53
2010-02-22 00:00:00.000,Acapulco Mexico ATP World Tour 500,CLAY,2,Richard Gasquet,Carlos Moya,Richard Gasquet,4-6; 6-3; 6-2,R32,110,10,3,49,70,41,49,11,21,1,3,14,52,70,2,2,48,82,29,48,18,34,1,5,13,47,82
2010-02-22 00:00:00.000,Acapulco Mexico ATP World Tour 500,CLAY,2,Nicolas Almagro,Dudi Sela,Nicolas Almagro,6-1; 7-6(0),R32,86,5,1,34,63,28,34,14,29,2,4,10,42,63,2,4,42,58,20,42,9,16,4,8,9,29,58
2010-02-22 00:00:00.000,Acapulco Mexico ATP World Tour 500,CLAY,2,Albert Montanes,Daniel Gimeno-Traver,Albert Montanes,7-5; 4-6; 6-2,R32,149,3,4,67,100,45,67,16,33,10,14,15,61,100,2,3,53,98,31,53,23,45,5,11,15,54,98
2010-02-22 00:00:00.000,Acapulco Mexico ATP World Tour 500,CLAY,2,Pablo Cuevas,Marcos Daniel,Pablo Cuevas,1-6; 7-5; 7-6(8),R32,152,4,6,61,100,46,61,14,39,2,7,15,60,100,6,1,71,105,49,71,18,34,3,7,16,67,105
2010-02-22 00:00:00.000,Acapulco Mexico ATP World Tour 500,CLAY,2,Thomaz Bellucci,Oscar Hernandez,Thomaz Bellucci,6-3; 6-2,R32,72,10,4,21,47,20,21,15,26,2,2,8,35,47,1,3,39,59,25,39,8,20,7,11,9,33,59
2010-02-22 00:00:00.000,Acapulco Mexico ATP World Tour 500,CLAY,2,David Ferrer,Potito Starace,David Ferrer,6-2; 6-4,R32,78,1,1,32,53,23,32,13,21,2,3,9,36,53,1,3,38,59,24,38,7,21,2,6,9,31,59
2010-02-22 00:00:00.000,Acapulco Mexico ATP World Tour 500,CLAY,2,Simon Greul,John Isner,Simon Greul,7-6(4); 7-5,R32,93,6,4,39,69,35,39,20,30,2,2,12,55,69,8,3,38,70,30,38,21,32,2,3,12,51,70
2010-02-22 00:00:00.000,Acapulco Mexico ATP World Tour 500,CLAY,2,Eduardo Schwank,Santiago Gonzalez,Eduardo Schwank,7-6(4); 7-6(4),R32,118,0,3,42,79,32,42,20,37,0,2,12,52,79,6,3,36,80,33,36,18,44,2,4,12,51,80
2010-02-22 00:00:00.000,Acapulco Mexico ATP World Tour 500,CLAY,2,Victor Hanescu,Frederico Gil,Victor Hanescu,7-6(5); 6-3,R32,112,1,2,49,83,31,49,21,34,4,5,11,52,83,1,3,50,81,34,50,13,31,11,13,10,47,81
2010-02-22 00:00:00.000,Acapulco Mexico ATP World Tour 500,CLAY,2,Fernando Gonzalez,Sam Querrey,Fernando Gonzalez,6-4; 3-6; 7-6(2),R32,107,8,4,56,86,42,56,18,30,2,5,15,60,86,10,4,63,103,47,63,18,40,5,8,16,65,103
2010-02-22 00:00:00.000,Acapulco Mexico ATP World Tour 500,CLAY,2,Fernando Verdasco,Lukasz Kubot,Fernando Verdasco,6-4; 6-3,R16,87,5,3,48,66,34,48,8,18,5,7,10,42,66,2,6,27,52,16,27,11,25,4,8,9,27,52
2010-02-22 00:00:00.000,Acapulco Mexico ATP World Tour 500,CLAY,2,Juan Monaco,Juan Ignacio Chela,Juan Monaco,6-4; 7-6(4),R16,107,1,2,51,84,35,51,15,33,6,9,11,50,84,1,2,29,67,16,29,22,38,1,5,11,38,67
2010-02-22 00:00:00.000,Acapulco Mexico ATP World Tour 500,CLAY,2,Juan Carlos Ferrero,Igor Andreev,Juan Carlos Ferrero,6-4; 6-3,R16,93,0,2,49,70,32,49,11,21,8,10,10,43,70,2,2,35,60,20,35,10,25,3,7,9,30,60
2010-02-22 00:00:00.000,Acapulco Mexico ATP World Tour 500,CLAY,2,Nicolas Almagro,Richard Gasquet,Nicolas Almagro,3-6; 7-5; 7-6(7),R16,154,8,1,53,105,36,53,30,52,2,5,16,66,105,10,4,58,114,44,58,28,56,4,7,17,72,114
2010-02-22 00:00:00.000,Acapulco Mexico ATP World Tour 500,CLAY,2,Pablo Cuevas,Albert Montanes,Pablo Cuevas,7-5; 6-3,R16,97,5,4,35,68,28,35,18,33,2,3,11,46,68,1,0,35,66,19,35,19,31,3,6,10,38,66
2010-02-22 00:00:00.000,Acapulco Mexico ATP World Tour 500,CLAY,2,David Ferrer,Thomaz Bellucci,David Ferrer,6-4; 6-1,R16,95,2,4,38,63,25,38,12,25,5,7,9,37,63,2,1,31,55,15,31,11,24,3,8,8,26,55
2010-02-22 00:00:00.000,Acapulco Mexico ATP World Tour 500,CLAY,2,Eduardo Schwank,Simon Greul,Eduardo Schwank,7-6(4); 6-3,R16,112,7,3,29,60,23,29,18,31,0,2,10,41,60,4,9,48,103,32,48,22,55,17,21,11,54,103
2010-02-22 00:00:00.000,Acapulco Mexico ATP World Tour 500,CLAY,2,Fernando Gonzalez,Victor Hanescu,Fernando Gonzalez,7-6(2); 3-6; 6-1,R16,111,8,2,56,83,44,56,17,27,3,4,14,61,83,5,1,59,74,45,59,6,15,1,3,14,51,74
2010-02-22 00:00:00.000,Acapulco Mexico ATP World Tour 500,CLAY,2,Juan Monaco,Fernando Verdasco,Juan Monaco,7-5; 6-3,Q,106,1,4,46,66,36,46,10,20,1,2,11,46,66,1,5,36,61,24,36,12,25,3,6,10,36,61
2010-02-22 00:00:00.000,Acapulco Mexico ATP World Tour 500,CLAY,2,Juan Carlos Ferrero,Nicolas Almagro,Juan Carlos Ferrero,6-1; 5-7; 6-2,Q,120,3,0,59,75,41,59,12,16,2,3,13,53,75,8,3,48,94,33,48,20,46,8,13,14,53,94
2010-02-22 00:00:00.000,Acapulco Mexico ATP World Tour 500,CLAY,2,David Ferrer,Pablo Cuevas,David Ferrer,7-5; 6-4,Q,114,1,1,49,76,32,49,17,27,3,5,11,49,76,3,6,37,81,20,37,25,44,8,12,11,45,81
2010-02-22 00:00:00.000,Acapulco Mexico ATP World Tour 500,CLAY,2,Fernando Gonzalez,Eduardo Schwank,Fernando Gonzalez,3-6; 6-3; 7-5,Q,133,10,5,56,98,43,56,23,42,8,9,15,66,98,1,2,50,85,34,50,22,35,0,2,15,56,85
2010-02-22 00:00:00.000,Acapulco Mexico ATP World Tour 500,CLAY,2,Juan Carlos Ferrero,Juan Monaco,Juan Carlos Ferrero,7-5 RET,S,64,0,2,19,30,15,19,7,11,1,2,6,22,30,1,2,40,51,23,40,6,11,6,8,6,29,51
2010-02-22 00:00:00.000,Acapulco Mexico ATP World Tour 500,CLAY,2,David Ferrer,Fernando Gonzalez,David Ferrer,6-7(4); 6-0; 6-4,S,136,2,1,68,94,51,68,15,26,3,4,14,66,94,4,5,65,96,44,65,11,31,5,10,14,55,96
2010-02-22 00:00:00.000,Acapulco Mexico ATP World Tour 500,CLAY,2,David Ferrer,Juan Carlos Ferrero,David Ferrer,6-3; 3-6; 6-1,F,107,2,1,47,65,39,47,11,18,1,2,13,50,65,0,1,46,68,27,46,14,22,0,3,12,41,68
2010-02-22 00:00:00.000,Delray Beach FL; U.S.A. ATP World Tour 250,HARD,2,Teymuraz Gabashvili,Tommy Haas,Teymuraz Gabashvili,7-6(3); 7-5,R32,110,4,4,51,87,41,51,14,36,12,15,12,55,87,6,1,45,74,31,45,12,29,1,5,12,43,74
2010-02-22 00:00:00.000,Delray Beach FL; U.S.A. ATP World Tour 250,HARD,2,Ernests Gulbis,Ryan Harrison,Ernests Gulbis,6-4; 7-6(5),R32,79,17,2,52,69,43,52,9,17,1,2,11,52,69,4,1,35,65,30,35,14,30,3,5,11,44,65
2010-02-22 00:00:00.000,Delray Beach FL; U.S.A. ATP World Tour 250,HARD,2,Leonardo Mayer,Kevin Anderson,Leonardo Mayer,7-6(7); 7-6(2),R32,105,12,2,46,73,41,46,17,27,1,1,12,58,73,12,4,52,75,42,52,13,23,0,0,12,55,75
2010-02-22 00:00:00.000,Delray Beach FL; U.S.A. ATP World Tour 250,HARD,2,Florian Mayer,Nick Lindahl,Florian Mayer,6-4; 6-1,R32,52,7,0,27,40,20,27,10,13,1,2,8,30,40,4,5,36,60,23,36,5,24,5,10,9,28,60
2010-02-22 00:00:00.000,Delray Beach FL; U.S.A. ATP World Tour 250,HARD,2,Benjamin Becker,Kei Nishikori,Benjamin Becker,6-3; 1-6; 6-0,R32,77,9,3,40,68,31,40,13,28,3,5,11,44,68,1,5,32,63,20,32,17,31,4,8,11,37,63
2010-02-22 00:00:00.000,Delray Beach FL; U.S.A. ATP World Tour 250,HARD,2,Wayne Odesnik,Rajeev Ram,Wayne Odesnik,6-3; 6-2,R32,79,11,2,31,61,24,31,20,30,4,4,9,44,61,10,1,35,54,24,35,7,19,1,4,8,31,54
2010-02-22 00:00:00.000,Delray Beach FL; U.S.A. ATP World Tour 250,HARD,2,Jarkko Nieminen,Paolo Lorenzi,Jarkko Nieminen,6-3; 6-4,R32,77,5,1,47,57,36,47,6,10,4,4,10,42,57,5,4,27,57,21,27,16,30,4,6,9,37,57
2010-02-22 00:00:00.000,Delray Beach FL; U.S.A. ATP World Tour 250,HARD,2,Evgeny Korolev,Nicolas Lapentti,Evgeny Korolev,6-2; 1-6; 6-1,R32,88,11,3,39,66,30,39,12,27,4,6,11,42,66,2,0,33,64,19,33,17,31,4,8,11,36,64
2010-02-22 00:00:00.000,Delray Beach FL; U.S.A. ATP World Tour 250,HARD,2,Mischa Zverev,Michael Russell,Mischa Zverev,6-4; 3-6; 7-5,R32,134,5,5,59,90,36,59,18,31,3,7,15,54,90,4,3,75,106,48,75,13,31,5,10,16,61,106
2010-02-22 00:00:00.000,Delray Beach FL; U.S.A. ATP World Tour 250,HARD,2,Mardy Fish,Christophe Rochus,Mardy Fish,5-7; 6-3; 3-3 RET,R32,119,25,1,63,97,48,63,13,34,5,8,14,61,97,0,3,52,89,36,52,19,37,3,6,13,55,89
2010-02-22 00:00:00.000,Delray Beach FL; U.S.A. ATP World Tour 250,HARD,2,Santiago Giraldo,Vincent Spadea,Santiago Giraldo,6-2; 6-3,R32,55,2,1,17,41,16,17,17,24,0,0,8,33,41,5,6,30,52,19,30,8,22,1,5,9,27,52
2010-02-22 00:00:00.000,Delray Beach FL; U.S.A. ATP World Tour 250,HARD,2,Jeremy Chardy,Xavier Malisse,Jeremy Chardy,6-3; 7-6(5),R32,102,20,2,50,88,37,50,19,38,5,6,11,56,88,12,2,38,89,28,38,25,51,7,9,10,53,89
2010-02-22 00:00:00.000,Delray Beach FL; U.S.A. ATP World Tour 250,HARD,2,James Blake,Taylor Dent,James Blake,6-1; 3-6; 6-3,R32,101,8,3,55,81,43,55,11,26,0,1,13,54,81,10,5,41,82,33,41,15,41,4,7,12,48,82
2010-02-22 00:00:00.000,Delray Beach FL; U.S.A. ATP World Tour 250,HARD,2,Robin Haase,Robert Kendrick,Robin Haase,7-6(4); 7-6(0),R32,103,6,8,47,81,36,47,18,34,3,5,12,54,81,6,2,58,89,36,58,14,31,6,8,12,50,89
2010-02-22 00:00:00.000,Delray Beach FL; U.S.A. ATP World Tour 250,HARD,2,Daniel Brands,Sebastien Grosjean,Daniel Brands,3-6; 6-3; 6-2,R32,96,4,1,50,71,40,50,14,21,3,4,13,54,71,7,1,40,79,22,40,27,39,5,8,13,49,79
2010-02-22 00:00:00.000,Delray Beach FL; U.S.A. ATP World Tour 250,HARD,2,Ivo Karlovic,Philipp Petzschner,Ivo Karlovic,6-3; 7-6(3),R32,83,19,0,42,66,38,42,12,24,2,2,11,50,66,3,3,27,68,22,27,22,41,4,5,10,44,68
2010-02-22 00:00:00.000,Delray Beach FL; U.S.A. ATP World Tour 250,HARD,2,Ernests Gulbis,Teymuraz Gabashvili,Ernests Gulbis,6-1; 6-4,R16,71,5,1,28,47,23,28,11,19,1,1,8,34,47,1,4,29,59,18,29,13,30,1,5,9,31,59
2010-02-22 00:00:00.000,Delray Beach FL; U.S.A. ATP World Tour 250,HARD,2,Leonardo Mayer,Florian Mayer,Leonardo Mayer,6-4; 7-6(4),R16,86,7,4,36,64,29,36,20,28,3,4,11,49,64,4,3,40,69,29,40,17,29,2,4,11,46,69
2010-02-22 00:00:00.000,Delray Beach FL; U.S.A. ATP World Tour 250,HARD,2,Benjamin Becker,Wayne Odesnik,Benjamin Becker,W/O,R16,0,0,0,0,0,0,0,0,0,0,0,0,0,0,0,0,0,0,0,0,0,0,0,0,0,0,0
2010-02-22 00:00:00.000,Delray Beach FL; U.S.A. ATP World Tour 250,HARD,2,Jarkko Nieminen,Evgeny Korolev,Jarkko Nieminen,5-7; 6-1; 6-0,R16,96,7,5,55,80,36,55,17,25,4,5,12,53,80,10,5,49,84,31,49,13,35,6,12,13,44,84
2010-02-22 00:00:00.000,Delray Beach FL; U.S.A. ATP World Tour 250,HARD,2,Mardy Fish,Mischa Zverev,Mardy Fish,6-2; 6-4,R16,82,4,1,29,54,20,29,15,25,3,5,9,35,54,1,2,43,69,26,43,9,26,6,11,9,35,69
2010-02-22 00:00:00.000,Delray Beach FL; U.S.A. ATP World Tour 250,HARD,2,Jeremy Chardy,Santiago Giraldo,Jeremy Chardy,7-5; 4-6; 7-5,R16,145,8,11,61,113,45,61,22,52,7,11,17,67,113,5,2,69,125,48,69,25,56,8,13,17,73,125
2010-02-22 00:00:00.000,Delray Beach FL; U.S.A. ATP World Tour 250,HARD,2,James Blake,Robin Haase,James Blake,6-3; 6-1,R16,55,1,0,30,48,21,30,12,18,4,5,8,33,48,0,1,26,59,16,26,13,33,6,11,8,29,59
2010-02-22 00:00:00.000,Delray Beach FL; U.S.A. ATP World Tour 250,HARD,2,Ivo Karlovic,Daniel Brands,Ivo Karlovic,7-6(8); 7-6(6),R16,105,26,0,51,72,46,51,14,21,0,0,12,60,72,12,2,52,85,41,52,20,33,1,1,12,61,85
2010-02-22 00:00:00.000,Delray Beach FL; U.S.A. ATP World Tour 250,HARD,2,Ernests Gulbis,Leonardo Mayer,Ernests Gulbis,7-6(2); 6-4,Q,97,11,3,41,66,34,41,14,25,1,2,11,48,66,3,0,50,77,38,50,10,27,6,8,11,48,77
2010-02-22 00:00:00.000,Delray Beach FL; U.S.A. ATP World Tour 250,HARD,2,Jarkko Nieminen,Benjamin Becker,Jarkko Nieminen,7-5; 3-6; 7-6(5),Q,135,6,3,79,108,56,79,12,29,7,11,16,68,108,9,3,61,107,41,61,25,46,5,9,17,66,107
2010-02-22 00:00:00.000,Delray Beach FL; U.S.A. ATP World Tour 250,HARD,2,Mardy Fish,Jeremy Chardy,Mardy Fish,6-4; 6-3,Q,67,5,2,31,47,23,31,10,16,0,1,9,33,47,3,2,39,64,25,39,10,25,6,10,10,35,64
2010-02-22 00:00:00.000,Delray Beach FL; U.S.A. ATP World Tour 250,HARD,2,Ivo Karlovic,James Blake,Ivo Karlovic,6-3; 6-7(5); 6-1,Q,101,23,3,59,87,53,59,11,28,0,1,15,64,87,2,3,61,90,41,61,16,29,3,7,13,57,90
2010-02-22 00:00:00.000,Delray Beach FL; U.S.A. ATP World Tour 250,HARD,2,Ernests Gulbis,Jarkko Nieminen,Ernests Gulbis,6-4; 6-4,S,75,9,2,34,55,29,34,10,21,1,2,10,39,55,3,0,51,66,36,51,5,15,3,6,10,41,66
2010-02-22 00:00:00.000,Delray Beach FL; U.S.A. ATP World Tour 250,HARD,2,Ivo Karlovic,Mardy Fish,Ivo Karlovic,6-2; 6-3,S,59,7,1,25,42,23,25,13,17,0,0,9,36,42,0,1,27,47,24,27,5,20,1,4,8,29,47
2010-02-22 00:00:00.000,Delray Beach FL; U.S.A. ATP World Tour 250,HARD,2,Ernests Gulbis,Ivo Karlovic,Ernests Gulbis,6-2; 6-3,F,81,6,2,29,48,23,29,11,19,2,2,8,34,48,14,5,43,69,29,43,7,26,5,9,9,36,69
2010-02-22 00:00:00.000,Dubai U.A.E. ATP World Tour 500,HARD,2,Tommy Robredo,Julien Benneteau,Tommy Robredo,6-2; 6-1,R32,45,8,2,21,34,20,21,8,13,0,0,7,28,34,1,1,26,42,12,26,6,16,2,7,8,18,42
2010-02-22 00:00:00.000,Dubai U.A.E. ATP World Tour 500,HARD,2,Jurgen Melzer,Simone Bolelli,Jurgen Melzer,6-1; 7-5,R32,79,11,2,25,51,22,25,15,26,0,1,9,37,51,2,4,34,58,19,34,12,24,4,9,10,31,58
2010-02-22 00:00:00.000,Dubai U.A.E. ATP World Tour 500,HARD,2,Stefan Koubek,Feliciano Lopez,Stefan Koubek,7-6(4); 6-4,R32,84,6,3,44,65,34,44,13,21,0,1,11,47,65,14,8,49,76,37,49,12,27,4,6,11,49,76
2010-02-22 00:00:00.000,Dubai U.A.E. ATP World Tour 500,HARD,2,Marin Cilic,Arnaud Clement,Marin Cilic,6-2; 6-4,R32,90,13,2,31,61,25,31,17,30,5,5,9,42,61,2,2,30,59,19,30,13,29,4,7,9,32,59
2010-02-22 00:00:00.000,Dubai U.A.E. ATP World Tour 500,HARD,2,Andy Murray,Igor Kunitsyn,Andy Murray,6-2; 6-3,R32,101,13,3,33,63,27,33,13,30,4,5,9,40,63,0,0,52,74,27,52,11,22,10,14,8,38,74
2010-02-22 00:00:00.000,Dubai U.A.E. ATP World Tour 500,HARD,2,Janko Tipsarevic,Andreas Seppi,Janko Tipsarevic,7-6(4); 7-5,R32,102,13,2,41,74,33,41,19,33,1,2,12,52,74,4,1,46,81,34,46,17,35,2,4,12,51,81
2010-02-22 00:00:00.000,Dubai U.A.E. ATP World Tour 500,HARD,2,Bjorn Phau,Mohammad Ghareeb,Bjorn Phau,3-0 RET,R32,12,5,1,6,9,6,6,2,3,0,0,2,8,9,0,0,5,5,1,5,0,0,0,1,1,1,5
2010-02-22 00:00:00.000,Dubai U.A.E. ATP World Tour 500,HARD,2,Mikhail Youzhny,Lukas Lacko,Mikhail Youzhny,6-7(3); 7-6(5); 6-1,R32,159,1,3,65,104,46,65,19,39,4,7,15,65,104,6,3,68,110,43,68,21,42,9,15,16,64,110
2010-02-22 00:00:00.000,Dubai U.A.E. ATP World Tour 500,HARD,2,Marcos Baghdatis,Gilles Simon,Marcos Baghdatis,7-6(3); 6-4,R32,103,14,4,44,71,36,44,11,27,2,4,11,47,71,4,4,38,69,31,38,13,31,2,5,11,44,69
2010-02-22 00:00:00.000,Dubai U.A.E. ATP World Tour 500,HARD,2,Somdev Devvarman,Marco Chiudinelli,Somdev Devvarman,6-4; 7-5,R32,80,4,1,44,63,34,44,14,19,2,2,11,48,63,1,2,35,59,28,35,12,24,0,2,11,40,59
2010-02-22 00:00:00.000,Dubai U.A.E. ATP World Tour 500,HARD,2,Michael Berrer,Sergiy Stakhovsky,Michael Berrer,6-4; 7-6(3),R32,99,4,4,57,82,38,57,16,25,3,4,11,54,82,7,1,46,73,33,46,13,27,4,6,11,46,73
2010-02-22 00:00:00.000,Dubai U.A.E. ATP World Tour 500,HARD,2,Nikolay Davydenko,Florent Serra,Nikolay Davydenko,6-7(5); 6-4; 6-1,R32,131,11,1,59,102,49,59,25,43,8,8,15,74,102,4,3,68,102,47,68,17,34,11,14,14,64,102
2010-02-22 00:00:00.000,Dubai U.A.E. ATP World Tour 500,HARD,2,Jo-Wilfried Tsonga,Michael Llodra,Jo-Wilfried Tsonga,7-6(9) RET,R32,55,2,1,26,43,21,26,12,17,1,1,6,33,43,11,1,35,48,28,35,5,13,2,2,6,33,48
2010-02-22 00:00:00.000,Dubai U.A.E. ATP World Tour 500,HARD,2,Ivan Ljubicic,Jan Hernych,Ivan Ljubicic,6-2; 6-7(3); 6-4,R32,135,14,1,57,98,41,57,24,41,2,3,15,65,98,2,2,63,103,37,63,26,40,2,6,15,63,103
2010-02-22 00:00:00.000,Dubai U.A.E. ATP World Tour 500,HARD,2,Viktor Troicki,Rainer Schuettler,Viktor Troicki,6-3; 6-4,R32,87,5,3,36,59,29,36,11,23,0,0,9,40,59,0,6,49,73,32,49,12,24,3,6,10,44,73
2010-02-22 00:00:00.000,Dubai U.A.E. ATP World Tour 500,HARD,2,Novak Djokovic,Guillermo Garcia-Lopez,Novak Djokovic,6-4; 6-4,R32,98,2,3,45,67,28,45,12,22,3,6,10,40,67,2,4,29,58,18,29,12,29,5,10,10,30,58
2010-02-22 00:00:00.000,Dubai U.A.E. ATP World Tour 500,HARD,2,Jurgen Melzer,Tommy Robredo,Jurgen Melzer,6-3; 7-5,R16,80,6,4,42,62,34,42,13,20,4,4,11,47,62,2,3,31,56,21,31,16,25,2,4,10,37,56
2010-02-22 00:00:00.000,Dubai U.A.E. ATP World Tour 500,HARD,2,Marin Cilic,Stefan Koubek,Marin Cilic,6-2; 7-6(6),R16,88,5,7,30,63,24,30,15,33,3,6,10,39,63,1,4,43,71,22,43,13,28,4,9,10,35,71
2010-02-22 00:00:00.000,Dubai U.A.E. ATP World Tour 500,HARD,2,Janko Tipsarevic,Andy Murray,Janko Tipsarevic,7-6(3); 4-6; 6-4,R16,150,13,2,68,106,52,68,19,38,9,12,16,71,106,13,4,56,104,42,56,24,48,1,4,16,66,104
2010-02-22 00:00:00.000,Dubai U.A.E. ATP World Tour 500,HARD,2,Mikhail Youzhny,Bjorn Phau,Mikhail Youzhny,7-6(2); 6-4,R16,119,6,2,55,77,38,55,14,22,4,5,11,52,77,5,3,51,85,30,51,20,34,5,7,11,50,85
2010-02-22 00:00:00.000,Dubai U.A.E. ATP World Tour 500,HARD,2,Marcos Baghdatis,Somdev Devvarman,Marcos Baghdatis,6-3; 3-6; 6-1,R16,104,6,6,50,94,38,50,20,44,11,13,13,58,94,2,0,45,67,30,45,9,22,2,6,12,39,67
2010-02-22 00:00:00.000,Dubai U.A.E. ATP World Tour 500,HARD,2,Michael Berrer,Nikolay Davydenko,Michael Berrer,6-3 RET,R16,45,5,1,24,36,19,24,5,12,0,0,5,24,36,3,1,16,25,10,16,4,9,0,1,4,14,25
2010-02-22 00:00:00.000,Dubai U.A.E. ATP World Tour 500,HARD,2,Ivan Ljubicic,Jo-Wilfried Tsonga,Ivan Ljubicic,7-5; 6-3,R16,73,15,1,39,57,35,39,10,18,0,0,11,45,57,8,3,47,64,32,47,8,17,4,6,10,40,64
2010-02-22 00:00:00.000,Dubai U.A.E. ATP World Tour 500,HARD,2,Novak Djokovic,Viktor Troicki,Novak Djokovic,3-6; 6-4; 6-2,R16,125,2,5,43,79,30,43,22,36,3,5,14,52,79,10,2,46,93,28,46,29,47,7,10,13,57,93
2010-02-22 00:00:00.000,Dubai U.A.E. ATP World Tour 500,HARD,2,Jurgen Melzer,Marin Cilic,Jurgen Melzer,7-6(8); 7-5,Q,125,11,3,57,92,40,57,20,35,4,6,12,60,92,11,3,48,84,36,48,17,36,3,6,12,53,84
2010-02-22 00:00:00.000,Dubai U.A.E. ATP World Tour 500,HARD,2,Mikhail Youzhny,Janko Tipsarevic,Mikhail Youzhny,6-3; 6-4,Q,92,3,1,44,67,34,44,13,23,3,3,10,47,67,5,1,24,50,21,24,12,26,1,3,9,33,50
2010-02-22 00:00:00.000,Dubai U.A.E. ATP World Tour 500,HARD,2,Marcos Baghdatis,Michael Berrer,Marcos Baghdatis,7-6(5); 6-1,Q,99,11,1,30,54,27,30,16,24,0,0,10,43,54,4,3,58,81,35,58,11,23,13,15,9,46,81
2010-02-22 00:00:00.000,Dubai U.A.E. ATP World Tour 500,HARD,2,Novak Djokovic,Ivan Ljubicic,Novak Djokovic,2-6; 6-4; 6-0,Q,109,3,4,44,77,32,44,17,33,3,5,12,49,77,14,2,41,67,28,41,13,26,4,8,12,41,67
2010-02-22 00:00:00.000,Dubai U.A.E. ATP World Tour 500,HARD,2,Mikhail Youzhny,Jurgen Melzer,Mikhail Youzhny,7-5; 7-6(4),S,133,7,0,49,83,41,49,19,34,2,2,12,60,83,10,3,50,84,41,50,17,34,4,5,12,58,84
2010-02-22 00:00:00.000,Dubai U.A.E. ATP World Tour 500,HARD,2,Novak Djokovic,Marcos Baghdatis,Novak Djokovic,6-7(2); 6-3; 6-4,S,176,5,10,66,110,46,66,19,44,13,16,16,65,110,7,1,48,92,33,48,24,44,5,10,15,57,92
2010-02-22 00:00:00.000,Dubai U.A.E. ATP World Tour 500,HARD,2,Novak Djokovic,Mikhail Youzhny,Novak Djokovic,7-5; 5-7; 6-3,F,202,5,12,56,107,40,56,21,51,6,12,17,61,107,1,2,72,108,39,72,17,36,4,11,16,56,108
2010-03-11 00:00:00.000,ATP World Tour Masters 1000 Indian Wells CA; U.S.A. ATP World Tour Masters 1000,HARD,2,Roger Federer,N/A Bye,Roger Federer,,R128,0,0,0,0,0,0,0,0,0,0,0,0,0,0,0,0,0,0,0,0,0,0,0,0,0,0,0
2010-03-11 00:00:00.000,ATP World Tour Masters 1000 Indian Wells CA; U.S.A. ATP World Tour Masters 1000,HARD,2,Victor Hanescu,Juan Ignacio Chela,Victor Hanescu,6-3; 7-6(4),R128,91,7,2,56,83,40,56,15,27,6,8,11,55,83,2,1,39,63,24,39,14,24,3,6,10,38,63
2010-03-11 00:00:00.000,ATP World Tour Masters 1000 Indian Wells CA; U.S.A. ATP World Tour Masters 1000,HARD,2,Arnaud Clement,Peter Luczak,Arnaud Clement,4-6; 6-3; 6-2,R128,138,11,2,57,91,45,57,17,34,6,7,14,62,91,3,2,57,93,35,57,21,36,8,11,13,56,93
2010-03-11 00:00:00.000,ATP World Tour Masters 1000 Indian Wells CA; U.S.A. ATP World Tour Masters 1000,HARD,2,Marcos Baghdatis,N/A Bye,Marcos Baghdatis,,R128,0,0,0,0,0,0,0,0,0,0,0,0,0,0,0,0,0,0,0,0,0,0,0,0,0,0,0
2010-03-11 00:00:00.000,ATP World Tour Masters 1000 Indian Wells CA; U.S.A. ATP World Tour Masters 1000,HARD,2,Tommy Robredo,N/A Bye,Tommy Robredo,,R128,0,0,0,0,0,0,0,0,0,0,0,0,0,0,0,0,0,0,0,0,0,0,0,0,0,0,0
2010-03-11 00:00:00.000,ATP World Tour Masters 1000 Indian Wells CA; U.S.A. ATP World Tour Masters 1000,HARD,2,Sergiy Stakhovsky,Wayne Odesnik,Sergiy Stakhovsky,6-1; 6-4,R128,63,7,5,30,48,23,30,9,18,1,3,9,32,48,1,4,30,57,18,30,7,27,4,9,8,25,57
2010-03-11 00:00:00.000,ATP World Tour Masters 1000 Indian Wells CA; U.S.A. ATP World Tour Masters 1000,HARD,2,Dudi Sela,Jesse Levine,Dudi Sela,6-2; 6-2,R128,64,2,0,29,44,24,29,6,15,0,1,8,30,44,3,3,34,51,16,34,7,17,2,7,8,23,51
2010-03-11 00:00:00.000,ATP World Tour Masters 1000 Indian Wells CA; U.S.A. ATP World Tour Masters 1000,HARD,2,Radek Stepanek,N/A Bye,Radek Stepanek,,R128,0,0,0,0,0,0,0,0,0,0,0,0,0,0,0,0,0,0,0,0,0,0,0,0,0,0,0
2010-03-11 00:00:00.000,ATP World Tour Masters 1000 Indian Wells CA; U.S.A. ATP World Tour Masters 1000,HARD,2,Gael Monfils,N/A Bye,Gael Monfils,,R128,0,0,0,0,0,0,0,0,0,0,0,0,0,0,0,0,0,0,0,0,0,0,0,0,0,0,0
2010-03-11 00:00:00.000,ATP World Tour Masters 1000 Indian Wells CA; U.S.A. ATP World Tour Masters 1000,HARD,2,Simon Greul,Richard Gasquet,Simon Greul,7-6(6); 7-6(7),R128,114,6,5,52,90,41,52,23,38,3,3,12,64,90,7,4,45,78,39,45,19,33,3,3,12,58,78
2010-03-11 00:00:00.000,ATP World Tour Masters 1000 Indian Wells CA; U.S.A. ATP World Tour Masters 1000,HARD,2,David Nalbandian,Stefan Koubek,David Nalbandian,6-2; 7-6(2),R128,75,5,3,35,55,24,35,10,20,2,5,10,34,55,0,4,46,67,24,46,7,21,5,10,10,31,67
2010-03-11 00:00:00.000,ATP World Tour Masters 1000 Indian Wells CA; U.S.A. ATP World Tour Masters 1000,HARD,2,Jurgen Melzer,N/A Bye,Jurgen Melzer,,R128,0,0,0,0,0,0,0,0,0,0,0,0,0,0,0,0,0,0,0,0,0,0,0,0,0,0,0
2010-03-11 00:00:00.000,ATP World Tour Masters 1000 Indian Wells CA; U.S.A. ATP World Tour Masters 1000,HARD,2,Janko Tipsarevic,N/A Bye,Janko Tipsarevic,,R128,0,0,0,0,0,0,0,0,0,0,0,0,0,0,0,0,0,0,0,0,0,0,0,0,0,0,0
2010-03-11 00:00:00.000,ATP World Tour Masters 1000 Indian Wells CA; U.S.A. ATP World Tour Masters 1000,HARD,2,Thiemo de Bakker,Marcos Daniel,Thiemo de Bakker,6-3; 6-3,R128,78,11,1,28,47,25,28,9,19,0,1,9,34,47,2,1,25,46,16,25,7,21,0,4,9,23,46
2010-03-11 00:00:00.000,ATP World Tour Masters 1000 Indian Wells CA; U.S.A. ATP World Tour Masters 1000,HARD,2,Yen-Hsun Lu,Oscar Hernandez,Yen-Hsun Lu,6-1; 6-2,R128,55,3,1,26,38,22,26,8,12,5,5,7,30,38,2,2,38,54,16,38,7,16,6,11,8,23,54
2010-03-11 00:00:00.000,ATP World Tour Masters 1000 Indian Wells CA; U.S.A. ATP World Tour Masters 1000,HARD,2,Andy Roddick,N/A Bye,Andy Roddick,,R128,0,0,0,0,0,0,0,0,0,0,0,0,0,0,0,0,0,0,0,0,0,0,0,0,0,0,0
2010-03-11 00:00:00.000,ATP World Tour Masters 1000 Indian Wells CA; U.S.A. ATP World Tour Masters 1000,HARD,2,Andy Murray,N/A Bye,Andy Murray,,R128,0,0,0,0,0,0,0,0,0,0,0,0,0,0,0,0,0,0,0,0,0,0,0,0,0,0,0
2010-03-11 00:00:00.000,ATP World Tour Masters 1000 Indian Wells CA; U.S.A. ATP World Tour Masters 1000,HARD,2,Andreas Seppi,Robby Ginepri,Andreas Seppi,2-6; 7-6(5); 6-3,R128,118,5,2,42,85,26,42,23,43,2,7,14,49,85,3,3,46,97,27,46,29,51,5,10,15,56,97
2010-03-11 00:00:00.000,ATP World Tour Masters 1000 Indian Wells CA; U.S.A. ATP World Tour Masters 1000,HARD,2,Michael Russell,Paolo Lorenzi,Michael Russell,6-2; 7-5,R128,84,3,1,38,51,29,38,5,13,0,2,10,34,51,3,5,45,63,28,45,4,18,6,11,10,32,63
2010-03-11 00:00:00.000,ATP World Tour Masters 1000 Indian Wells CA; U.S.A. ATP World Tour Masters 1000,HARD,2,Igor Andreev,N/A Bye,Igor Andreev,,R128,0,0,0,0,0,0,0,0,0,0,0,0,0,0,0,0,0,0,0,0,0,0,0,0,0,0,0
2010-03-11 00:00:00.000,ATP World Tour Masters 1000 Indian Wells CA; U.S.A. ATP World Tour Masters 1000,HARD,2,Ivo Karlovic,N/A Bye,Ivo Karlovic,,R128,0,0,0,0,0,0,0,0,0,0,0,0,0,0,0,0,0,0,0,0,0,0,0,0,0,0,0
2010-03-11 00:00:00.000,ATP World Tour Masters 1000 Indian Wells CA; U.S.A. ATP World Tour Masters 1000,HARD,2,Nicolas Almagro,Mischa Zverev,Nicolas Almagro,6-3; 6-2,R128,64,2,1,34,57,27,34,11,23,3,4,9,38,57,2,2,30,48,18,30,7,18,0,4,8,25,48
2010-03-11 00:00:00.000,ATP World Tour Masters 1000 Indian Wells CA; U.S.A. ATP World Tour Masters 1000,HARD,2,James Blake,Daniel Gimeno-Traver,James Blake,6-3; 6-2,R128,55,2,2,33,52,23,33,13,19,0,0,9,36,52,4,4,22,46,15,22,10,24,3,6,8,25,46
2010-03-11 00:00:00.000,ATP World Tour Masters 1000 Indian Wells CA; U.S.A. ATP World Tour Masters 1000,HARD,2,David Ferrer,N/A Bye,David Ferrer,,R128,0,0,0,0,0,0,0,0,0,0,0,0,0,0,0,0,0,0,0,0,0,0,0,0,0,0,0
2010-03-11 00:00:00.000,ATP World Tour Masters 1000 Indian Wells CA; U.S.A. ATP World Tour Masters 1000,HARD,2,Jo-Wilfried Tsonga,N/A Bye,Jo-Wilfried Tsonga,,R128,0,0,0,0,0,0,0,0,0,0,0,0,0,0,0,0,0,0,0,0,0,0,0,0,0,0,0
2010-03-11 00:00:00.000,ATP World Tour Masters 1000 Indian Wells CA; U.S.A. ATP World Tour Masters 1000,HARD,2,Marinko Matosevic,Michael Llodra,Marinko Matosevic,6-3; 6-0,R128,51,5,2,24,41,18,24,10,17,0,2,8,28,41,2,1,42,57,18,42,4,15,8,14,7,22,57
2010-03-11 00:00:00.000,ATP World Tour Masters 1000 Indian Wells CA; U.S.A. ATP World Tour Masters 1000,HARD,2,Ricardo Mello,Horacio Zeballos,Ricardo Mello,2-6; 6-3; 6-4,R128,116,4,2,57,88,34,57,25,31,5,7,14,59,88,8,2,50,88,36,50,20,38,6,8,13,56,88
2010-03-11 00:00:00.000,ATP World Tour Masters 1000 Indian Wells CA; U.S.A. ATP World Tour Masters 1000,HARD,2,Albert Montanes,N/A Bye,Albert Montanes,,R128,0,0,0,0,0,0,0,0,0,0,0,0,0,0,0,0,0,0,0,0,0,0,0,0,0,0,0
2010-03-11 00:00:00.000,ATP World Tour Masters 1000 Indian Wells CA; U.S.A. ATP World Tour Masters 1000,HARD,2,Feliciano Lopez,N/A Bye,Feliciano Lopez,,R128,0,0,0,0,0,0,0,0,0,0,0,0,0,0,0,0,0,0,0,0,0,0,0,0,0,0,0
2010-03-11 00:00:00.000,ATP World Tour Masters 1000 Indian Wells CA; U.S.A. ATP World Tour Masters 1000,HARD,2,Paul-Henri Mathieu,Benjamin Becker,Paul-Henri Mathieu,6-3; 6-1,R128,67,3,3,34,60,25,34,14,26,4,4,8,39,60,3,1,19,39,12,19,7,20,0,4,8,19,39
2010-03-11 00:00:00.000,ATP World Tour Masters 1000 Indian Wells CA; U.S.A. ATP World Tour Masters 1000,HARD,2,Evgeny Korolev,Florian Mayer,Evgeny Korolev,6-3; 6-2,R128,58,3,2,23,47,17,23,13,24,0,1,8,30,47,5,4,34,50,20,34,5,16,1,6,9,25,50
2010-03-11 00:00:00.000,ATP World Tour Masters 1000 Indian Wells CA; U.S.A. ATP World Tour Masters 1000,HARD,2,Robin Soderling,N/A Bye,Robin Soderling,,R128,0,0,0,0,0,0,0,0,0,0,0,0,0,0,0,0,0,0,0,0,0,0,0,0,0,0,0
2010-03-11 00:00:00.000,ATP World Tour Masters 1000 Indian Wells CA; U.S.A. ATP World Tour Masters 1000,HARD,2,Nikolay Davydenko,N/A Bye,Nikolay Davydenko,,R128,0,0,0,0,0,0,0,0,0,0,0,0,0,0,0,0,0,0,0,0,0,0,0,0,0,0,0
2010-03-11 00:00:00.000,ATP World Tour Masters 1000 Indian Wells CA; U.S.A. ATP World Tour Masters 1000,HARD,2,Ernests Gulbis,Marco Chiudinelli,Ernests Gulbis,3-6; 6-3; 6-3,R128,98,13,6,46,69,40,46,8,23,1,3,13,48,69,4,2,53,83,34,53,17,30,8,12,14,51,83
2010-03-11 00:00:00.000,ATP World Tour Masters 1000 Indian Wells CA; U.S.A. ATP World Tour Masters 1000,HARD,2,Pablo Cuevas,Frederico Gil,Pablo Cuevas,6-4; 7-5,R128,85,4,3,35,61,28,35,16,26,1,2,11,44,61,4,2,44,72,29,44,15,28,4,7,11,44,72
2010-03-11 00:00:00.000,ATP World Tour Masters 1000 Indian Wells CA; U.S.A. ATP World Tour Masters 1000,HARD,2,Viktor Troicki,N/A Bye,Viktor Troicki,,R128,0,0,0,0,0,0,0,0,0,0,0,0,0,0,0,0,0,0,0,0,0,0,0,0,0,0,0
2010-03-11 00:00:00.000,ATP World Tour Masters 1000 Indian Wells CA; U.S.A. ATP World Tour Masters 1000,HARD,2,Tomas Berdych,N/A Bye,Tomas Berdych,,R128,0,0,0,0,0,0,0,0,0,0,0,0,0,0,0,0,0,0,0,0,0,0,0,0,0,0,0
2010-03-11 00:00:00.000,ATP World Tour Masters 1000 Indian Wells CA; U.S.A. ATP World Tour Masters 1000,HARD,2,Florent Serra,Alejandro Falla,Florent Serra,6-1; 6-2,R128,53,3,1,28,50,21,28,14,22,6,7,8,35,50,3,2,20,43,8,20,10,23,4,9,7,18,43
2010-03-11 00:00:00.000,ATP World Tour Masters 1000 Indian Wells CA; U.S.A. ATP World Tour Masters 1000,HARD,2,Ramon Delgado,Andreas Beck,Ramon Delgado,6-7(2); 6-2; 6-4,R128,125,10,0,66,91,50,66,16,25,2,2,15,66,91,2,5,42,89,32,42,25,47,3,6,15,57,89
2010-03-11 00:00:00.000,ATP World Tour Masters 1000 Indian Wells CA; U.S.A. ATP World Tour Masters 1000,HARD,2,Fernando Verdasco,N/A Bye,Fernando Verdasco,,R128,0,0,0,0,0,0,0,0,0,0,0,0,0,0,0,0,0,0,0,0,0,0,0,0,0,0,0
2010-03-11 00:00:00.000,ATP World Tour Masters 1000 Indian Wells CA; U.S.A. ATP World Tour Masters 1000,HARD,2,John Isner,N/A Bye,John Isner,,R128,0,0,0,0,0,0,0,0,0,0,0,0,0,0,0,0,0,0,0,0,0,0,0,0,0,0,0
2010-03-11 00:00:00.000,ATP World Tour Masters 1000 Indian Wells CA; U.S.A. ATP World Tour Masters 1000,HARD,2,Kevin Anderson,Bjorn Phau,Kevin Anderson,6-3; 6-3,R128,73,7,1,39,50,34,39,5,11,2,2,9,39,50,0,4,32,64,20,32,17,32,6,9,9,37,64
2010-03-11 00:00:00.000,ATP World Tour Masters 1000 Indian Wells CA; U.S.A. ATP World Tour Masters 1000,HARD,2,Jeremy Chardy,Potito Starace,Jeremy Chardy,6-1; 4-1 RET,R128,64,3,3,29,48,24,29,8,19,3,3,6,32,48,1,3,23,43,12,23,6,20,4,8,6,18,43
2010-03-11 00:00:00.000,ATP World Tour Masters 1000 Indian Wells CA; U.S.A. ATP World Tour Masters 1000,HARD,2,Sam Querrey,N/A Bye,Sam Querrey,,R128,0,0,0,0,0,0,0,0,0,0,0,0,0,0,0,0,0,0,0,0,0,0,0,0,0,0,0
2010-03-11 00:00:00.000,ATP World Tour Masters 1000 Indian Wells CA; U.S.A. ATP World Tour Masters 1000,HARD,2,Julien Benneteau,N/A Bye,Julien Benneteau,,R128,0,0,0,0,0,0,0,0,0,0,0,0,0,0,0,0,0,0,0,0,0,0,0,0,0,0,0
2010-03-11 00:00:00.000,ATP World Tour Masters 1000 Indian Wells CA; U.S.A. ATP World Tour Masters 1000,HARD,2,Mario Ancic,Bobby Reynolds,Mario Ancic,4-6; 6-3; 6-4,R128,115,12,2,51,80,41,51,17,29,1,3,15,58,80,8,1,46,84,33,46,21,38,8,11,14,54,84
2010-03-11 00:00:00.000,ATP World Tour Masters 1000 Indian Wells CA; U.S.A. ATP World Tour Masters 1000,HARD,2,Rainer Schuettler,Thiago Alves,Rainer Schuettler,7-5; 6-0,R128,76,5,1,29,50,24,29,14,21,2,2,9,38,50,4,3,30,51,18,30,8,21,2,6,9,26,51
2010-03-11 00:00:00.000,ATP World Tour Masters 1000 Indian Wells CA; U.S.A. ATP World Tour Masters 1000,HARD,2,Rafael Nadal,N/A Bye,Rafael Nadal,,R128,0,0,0,0,0,0,0,0,0,0,0,0,0,0,0,0,0,0,0,0,0,0,0,0,0,0,0
2010-03-11 00:00:00.000,ATP World Tour Masters 1000 Indian Wells CA; U.S.A. ATP World Tour Masters 1000,HARD,2,Marin Cilic,N/A Bye,Marin Cilic,,R128,0,0,0,0,0,0,0,0,0,0,0,0,0,0,0,0,0,0,0,0,0,0,0,0,0,0,0
2010-03-11 00:00:00.000,ATP World Tour Masters 1000 Indian Wells CA; U.S.A. ATP World Tour Masters 1000,HARD,2,Guillermo Garcia-Lopez,Lukas Lacko,Guillermo Garcia-Lopez,4-6; 6-4; 7-5,R128,144,4,2,52,94,36,52,24,42,6,9,16,60,94,5,2,71,107,50,71,16,36,9,13,16,66,107
2010-03-11 00:00:00.000,ATP World Tour Masters 1000 Indian Wells CA; U.S.A. ATP World Tour Masters 1000,HARD,2,Carlos Moya,Tim Smyczek,Carlos Moya,7-6(7); 7-6(5),R128,140,4,3,55,93,41,55,19,38,7,10,12,60,93,1,1,66,108,36,66,25,42,13,16,12,61,108
2010-03-11 00:00:00.000,ATP World Tour Masters 1000 Indian Wells CA; U.S.A. ATP World Tour Masters 1000,HARD,2,Thomaz Bellucci,N/A Bye,Thomaz Bellucci,,R128,0,0,0,0,0,0,0,0,0,0,0,0,0,0,0,0,0,0,0,0,0,0,0,0,0,0,0
2010-03-11 00:00:00.000,ATP World Tour Masters 1000 Indian Wells CA; U.S.A. ATP World Tour Masters 1000,HARD,2,Juan Monaco,N/A Bye,Juan Monaco,,R128,0,0,0,0,0,0,0,0,0,0,0,0,0,0,0,0,0,0,0,0,0,0,0,0,0,0,0
2010-03-11 00:00:00.000,ATP World Tour Masters 1000 Indian Wells CA; U.S.A. ATP World Tour Masters 1000,HARD,2,Fabio Fognini,Olivier Rochus,Fabio Fognini,6-4; 1-6; 7-5,R128,131,6,7,50,95,38,50,14,45,12,17,14,52,95,1,1,62,93,40,62,12,31,8,13,15,52,93
2010-03-11 00:00:00.000,ATP World Tour Masters 1000 Indian Wells CA; U.S.A. ATP World Tour Masters 1000,HARD,2,Daniel Koellerer,Rajeev Ram,Daniel Koellerer,6-1; 6-3,R128,49,1,1,29,39,24,29,8,10,0,0,8,32,39,2,2,28,41,15,28,7,13,0,4,8,22,41
2010-03-11 00:00:00.000,ATP World Tour Masters 1000 Indian Wells CA; U.S.A. ATP World Tour Masters 1000,HARD,2,Juan Carlos Ferrero,N/A Bye,Juan Carlos Ferrero,,R128,0,0,0,0,0,0,0,0,0,0,0,0,0,0,0,0,0,0,0,0,0,0,0,0,0,0,0
2010-03-11 00:00:00.000,ATP World Tour Masters 1000 Indian Wells CA; U.S.A. ATP World Tour Masters 1000,HARD,2,Gilles Simon,N/A Bye,Gilles Simon,,R128,0,0,0,0,0,0,0,0,0,0,0,0,0,0,0,0,0,0,0,0,0,0,0,0,0,0,0
2010-03-11 00:00:00.000,ATP World Tour Masters 1000 Indian Wells CA; U.S.A. ATP World Tour Masters 1000,HARD,2,Brian Dabul,Leonardo Mayer,Brian Dabul,7-6(4); 6-2,R128,95,1,0,43,63,34,43,15,20,1,1,10,49,63,6,3,40,70,26,40,20,30,6,8,10,46,70
2010-03-11 00:00:00.000,ATP World Tour Masters 1000 Indian Wells CA; U.S.A. ATP World Tour Masters 1000,HARD,2,Ryan Harrison,Taylor Dent,Ryan Harrison,6-3; 6-4,R128,71,7,0,35,59,25,35,17,24,1,1,10,42,59,2,4,29,59,21,29,14,30,3,5,9,35,59
2010-03-11 00:00:00.000,ATP World Tour Masters 1000 Indian Wells CA; U.S.A. ATP World Tour Masters 1000,HARD,2,Ivan Ljubicic,N/A Bye,Ivan Ljubicic,,R128,0,0,0,0,0,0,0,0,0,0,0,0,0,0,0,0,0,0,0,0,0,0,0,0,0,0,0
2010-03-11 00:00:00.000,ATP World Tour Masters 1000 Indian Wells CA; U.S.A. ATP World Tour Masters 1000,HARD,2,Philipp Kohlschreiber,N/A Bye,Philipp Kohlschreiber,,R128,0,0,0,0,0,0,0,0,0,0,0,0,0,0,0,0,0,0,0,0,0,0,0,0,0,0,0
2010-03-11 00:00:00.000,ATP World Tour Masters 1000 Indian Wells CA; U.S.A. ATP World Tour Masters 1000,HARD,2,Philipp Petzschner,Christophe Rochus,Philipp Petzschner,6-2; 7-5,R128,83,13,1,34,61,31,34,14,27,1,1,10,45,61,1,4,42,69,26,42,13,27,3,6,10,39,69
2010-03-11 00:00:00.000,ATP World Tour Masters 1000 Indian Wells CA; U.S.A. ATP World Tour Masters 1000,HARD,2,Mardy Fish,Michael Berrer,Mardy Fish,1-6; 6-1; 6-3,R128,95,6,1,44,67,29,44,12,23,0,3,12,41,67,1,3,46,70,29,46,8,24,3,7,11,37,70
2010-03-11 00:00:00.000,ATP World Tour Masters 1000 Indian Wells CA; U.S.A. ATP World Tour Masters 1000,HARD,2,Novak Djokovic,N/A Bye,Novak Djokovic,,R128,0,0,0,0,0,0,0,0,0,0,0,0,0,0,0,0,0,0,0,0,0,0,0,0,0,0,0
2010-03-11 00:00:00.000,ATP World Tour Masters 1000 Indian Wells CA; U.S.A. ATP World Tour Masters 1000,HARD,2,Roger Federer,Victor Hanescu,Roger Federer,6-3; 6-7(5); 6-1,R64,117,10,2,52,95,41,52,27,43,6,7,15,68,95,1,1,77,101,48,77,10,24,8,12,13,58,101
2010-03-11 00:00:00.000,ATP World Tour Masters 1000 Indian Wells CA; U.S.A. ATP World Tour Masters 1000,HARD,2,Marcos Baghdatis,Arnaud Clement,Marcos Baghdatis,7-6(7); 6-1,R64,119,6,3,30,77,21,30,28,47,5,6,10,49,77,2,1,38,74,21,38,19,36,7,10,9,40,74
2010-03-11 00:00:00.000,ATP World Tour Masters 1000 Indian Wells CA; U.S.A. ATP World Tour Masters 1000,HARD,2,Tommy Robredo,Sergiy Stakhovsky,Tommy Robredo,3-6; 6-3; 7-5,R64,115,6,3,63,95,43,63,17,32,10,13,15,60,95,2,1,40,77,29,40,22,37,4,8,15,51,77
2010-03-11 00:00:00.000,ATP World Tour Masters 1000 Indian Wells CA; U.S.A. ATP World Tour Masters 1000,HARD,2,Dudi Sela,Radek Stepanek,Dudi Sela,6-4; 1-6; 6-2,R64,104,1,1,49,78,33,49,15,29,1,4,12,48,78,3,5,39,69,24,39,19,30,1,5,13,43,69
2010-03-11 00:00:00.000,ATP World Tour Masters 1000 Indian Wells CA; U.S.A. ATP World Tour Masters 1000,HARD,2,Simon Greul,Gael Monfils,Simon Greul,1-6; 6-2; 6-3,R64,100,2,5,49,79,30,49,16,30,2,5,12,46,79,8,5,48,71,30,48,10,23,0,4,12,40,71
2010-03-11 00:00:00.000,ATP World Tour Masters 1000 Indian Wells CA; U.S.A. ATP World Tour Masters 1000,HARD,2,Jurgen Melzer,David Nalbandian,Jurgen Melzer,6-4; 6-1,R64,69,2,2,34,46,26,34,8,12,1,1,8,34,46,2,1,25,52,15,25,14,27,5,9,9,29,52
2010-03-11 00:00:00.000,ATP World Tour Masters 1000 Indian Wells CA; U.S.A. ATP World Tour Masters 1000,HARD,2,Thiemo de Bakker,Janko Tipsarevic,Thiemo de Bakker,3-2 RET,R64,40,0,1,11,19,7,11,4,8,2,3,3,11,19,0,0,12,21,6,12,4,9,1,2,2,10,21
2010-03-11 00:00:00.000,ATP World Tour Masters 1000 Indian Wells CA; U.S.A. ATP World Tour Masters 1000,HARD,2,Andy Roddick,Yen-Hsun Lu,Andy Roddick,6-4; 6-4,R64,79,10,0,45,57,35,45,6,12,1,2,10,41,57,5,2,37,63,24,37,14,26,3,6,10,38,63
2010-03-11 00:00:00.000,ATP World Tour Masters 1000 Indian Wells CA; U.S.A. ATP World Tour Masters 1000,HARD,2,Andy Murray,Andreas Seppi,Andy Murray,6-4; 6-4,R64,86,5,1,27,54,21,27,13,27,0,2,10,34,54,2,0,26,64,17,26,19,38,3,7,10,36,64
2010-03-11 00:00:00.000,ATP World Tour Masters 1000 Indian Wells CA; U.S.A. ATP World Tour Masters 1000,HARD,2,Michael Russell,Igor Andreev,Michael Russell,4-6; 6-3; 6-2,R64,110,2,1,59,84,44,59,16,25,3,4,14,60,84,7,1,41,72,30,41,17,31,4,7,13,47,72
2010-03-11 00:00:00.000,ATP World Tour Masters 1000 Indian Wells CA; U.S.A. ATP World Tour Masters 1000,HARD,2,Nicolas Almagro,Ivo Karlovic,Nicolas Almagro,7-5; 7-6(5),R64,102,3,1,42,82,37,42,21,40,5,5,12,58,82,16,1,49,72,42,49,9,23,2,3,12,51,72
2010-03-11 00:00:00.000,ATP World Tour Masters 1000 Indian Wells CA; U.S.A. ATP World Tour Masters 1000,HARD,2,James Blake,David Ferrer,James Blake,6-1; 6-4,R64,62,1,0,35,53,27,35,11,18,0,0,9,38,53,1,1,35,52,21,35,9,17,6,9,8,30,52
2010-03-11 00:00:00.000,ATP World Tour Masters 1000 Indian Wells CA; U.S.A. ATP World Tour Masters 1000,HARD,2,Jo-Wilfried Tsonga,Marinko Matosevic,Jo-Wilfried Tsonga,6-1; 6-3,R64,63,3,3,21,45,17,21,13,24,1,2,8,30,45,2,4,20,48,10,20,11,28,2,7,8,21,48
2010-03-11 00:00:00.000,ATP World Tour Masters 1000 Indian Wells CA; U.S.A. ATP World Tour Masters 1000,HARD,2,Albert Montanes,Ricardo Mello,Albert Montanes,3-6; 6-4; 6-4,R64,129,5,2,64,112,44,64,22,48,5,8,15,66,112,4,2,44,80,30,44,21,36,4,7,14,51,80
2010-03-11 00:00:00.000,ATP World Tour Masters 1000 Indian Wells CA; U.S.A. ATP World Tour Masters 1000,HARD,2,Feliciano Lopez,Paul-Henri Mathieu,Feliciano Lopez,3-6; 6-3; 6-4,R64,130,19,4,55,91,44,55,18,36,6,7,14,62,91,3,2,54,94,37,54,24,40,5,7,14,61,94
2010-03-11 00:00:00.000,ATP World Tour Masters 1000 Indian Wells CA; U.S.A. ATP World Tour Masters 1000,HARD,2,Robin Soderling,Evgeny Korolev,Robin Soderling,6-2; 6-4,R64,72,10,2,30,48,26,30,6,18,0,2,9,32,48,4,6,32,64,21,32,11,32,11,16,9,32,64
2010-03-11 00:00:00.000,ATP World Tour Masters 1000 Indian Wells CA; U.S.A. ATP World Tour Masters 1000,HARD,2,Nikolay Davydenko,Ernests Gulbis,Nikolay Davydenko,6-4; 6-4,R64,94,5,1,44,68,31,44,13,24,2,3,10,44,68,7,1,30,55,21,30,12,25,3,6,10,33,55
2010-03-11 00:00:00.000,ATP World Tour Masters 1000 Indian Wells CA; U.S.A. ATP World Tour Masters 1000,HARD,2,Viktor Troicki,Pablo Cuevas,Viktor Troicki,1-0 RET,R64,5,1,0,4,5,3,4,1,1,0,0,1,4,5,0,0,1,1,0,1,0,0,0,0,0,0,1
2010-03-11 00:00:00.000,ATP World Tour Masters 1000 Indian Wells CA; U.S.A. ATP World Tour Masters 1000,HARD,2,Tomas Berdych,Florent Serra,Tomas Berdych,7-5; 4-6; 6-4,R64,137,13,5,62,108,49,62,17,46,3,6,16,66,108,4,4,59,100,44,59,20,41,7,11,16,64,100
2010-03-11 00:00:00.000,ATP World Tour Masters 1000 Indian Wells CA; U.S.A. ATP World Tour Masters 1000,HARD,2,Fernando Verdasco,Ramon Delgado,Fernando Verdasco,6-4; 6-1,R64,89,5,6,45,73,28,45,15,28,8,10,9,43,73,1,0,39,55,20,39,6,16,4,9,8,26,55
2010-03-11 00:00:00.000,ATP World Tour Masters 1000 Indian Wells CA; U.S.A. ATP World Tour Masters 1000,HARD,2,John Isner,Kevin Anderson,John Isner,6-3; 7-5,R64,70,5,2,39,56,33,39,11,17,0,0,11,44,56,4,2,34,50,23,34,11,16,0,2,10,34,50
2010-03-11 00:00:00.000,ATP World Tour Masters 1000 Indian Wells CA; U.S.A. ATP World Tour Masters 1000,HARD,2,Sam Querrey,Jeremy Chardy,Sam Querrey,6-3; 6-4,R64,55,8,1,33,52,28,33,13,19,0,0,10,41,52,1,1,27,46,20,27,10,19,0,2,9,30,46
2010-03-11 00:00:00.000,ATP World Tour Masters 1000 Indian Wells CA; U.S.A. ATP World Tour Masters 1000,HARD,2,Mario Ancic,Julien Benneteau,Mario Ancic,4-6; 7-6(5); 6-3,R64,161,11,4,57,95,42,57,12,38,2,8,15,54,95,9,4,87,124,55,87,13,37,14,21,16,68,124
2010-03-11 00:00:00.000,ATP World Tour Masters 1000 Indian Wells CA; U.S.A. ATP World Tour Masters 1000,HARD,2,Rafael Nadal,Rainer Schuettler,Rafael Nadal,6-4; 6-4,R64,94,3,4,45,61,34,45,7,16,0,1,10,41,61,1,4,47,69,29,47,10,22,2,5,10,39,69
2010-03-11 00:00:00.000,ATP World Tour Masters 1000 Indian Wells CA; U.S.A. ATP World Tour Masters 1000,HARD,2,Guillermo Garcia-Lopez,Marin Cilic,Guillermo Garcia-Lopez,7-6(1); 6-0,R64,92,3,2,36,57,27,36,12,21,2,3,9,39,57,4,2,37,60,23,37,8,23,2,6,9,31,60
2010-03-11 00:00:00.000,ATP World Tour Masters 1000 Indian Wells CA; U.S.A. ATP World Tour Masters 1000,HARD,2,Thomaz Bellucci,Carlos Moya,Thomaz Bellucci,W/O,R64,0,0,0,0,0,0,0,0,0,0,0,0,0,0,0,0,0,0,0,0,0,0,0,0,0,0,0
2010-03-11 00:00:00.000,ATP World Tour Masters 1000 Indian Wells CA; U.S.A. ATP World Tour Masters 1000,HARD,2,Juan Monaco,Fabio Fognini,Juan Monaco,6-4; 7-5,R64,99,0,4,49,77,33,49,14,28,6,8,11,47,77,2,3,42,67,28,42,10,25,2,6,11,38,67
2010-03-11 00:00:00.000,ATP World Tour Masters 1000 Indian Wells CA; U.S.A. ATP World Tour Masters 1000,HARD,2,Juan Carlos Ferrero,Daniel Koellerer,Juan Carlos Ferrero,6-3; 6-0,R64,50,4,0,25,34,21,25,5,9,0,1,7,26,34,1,2,32,47,15,32,3,15,3,9,8,18,47
2010-03-11 00:00:00.000,ATP World Tour Masters 1000 Indian Wells CA; U.S.A. ATP World Tour Masters 1000,HARD,2,Brian Dabul,Gilles Simon,Brian Dabul,7-5; 6-4,R64,91,1,0,46,66,36,46,12,20,5,5,11,48,66,4,0,28,63,18,28,24,35,1,3,11,42,63
2010-03-11 00:00:00.000,ATP World Tour Masters 1000 Indian Wells CA; U.S.A. ATP World Tour Masters 1000,HARD,2,Ivan Ljubicic,Ryan Harrison,Ivan Ljubicic,6-2; 7-6(2),R64,95,8,0,38,68,28,38,18,30,4,5,10,46,68,2,4,40,75,25,40,17,35,5,8,10,42,75
2010-03-11 00:00:00.000,ATP World Tour Masters 1000 Indian Wells CA; U.S.A. ATP World Tour Masters 1000,HARD,2,Philipp Kohlschreiber,Philipp Petzschner,Philipp Kohlschreiber,6-3; 6-2,R64,65,3,1,27,45,24,27,12,18,0,0,9,36,45,1,1,27,54,17,27,12,27,3,6,8,29,54
2010-03-11 00:00:00.000,ATP World Tour Masters 1000 Indian Wells CA; U.S.A. ATP World Tour Masters 1000,HARD,2,Novak Djokovic,Mardy Fish,Novak Djokovic,6-1; 0-6; 6-2,R64,102,2,9,45,80,30,45,17,35,6,9,11,47,80,7,3,33,64,22,33,14,31,8,12,10,36,64
2010-03-11 00:00:00.000,ATP World Tour Masters 1000 Indian Wells CA; U.S.A. ATP World Tour Masters 1000,HARD,2,Marcos Baghdatis,Roger Federer,Marcos Baghdatis,5-7; 7-5; 7-6(4),R32,142,3,2,65,111,48,65,30,46,6,8,18,78,111,8,1,63,105,54,63,21,42,2,4,18,75,105
2010-03-11 00:00:00.000,ATP World Tour Masters 1000 Indian Wells CA; U.S.A. ATP World Tour Masters 1000,HARD,2,Tommy Robredo,Dudi Sela,Tommy Robredo,6-3; 6-0,R32,68,4,1,32,52,24,32,9,20,1,2,8,33,52,0,4,28,48,16,28,5,20,2,7,7,21,48
2010-03-11 00:00:00.000,ATP World Tour Masters 1000 Indian Wells CA; U.S.A. ATP World Tour Masters 1000,HARD,2,Jurgen Melzer,Simon Greul,Jurgen Melzer,W/O,R32,0,0,0,0,0,0,0,0,0,0,0,0,0,0,0,0,0,0,0,0,0,0,0,0,0,0,0
2010-03-11 00:00:00.000,ATP World Tour Masters 1000 Indian Wells CA; U.S.A. ATP World Tour Masters 1000,HARD,2,Andy Roddick,Thiemo de Bakker,Andy Roddick,6-3; 6-4,R32,75,10,1,29,50,23,29,18,21,1,1,10,41,50,15,0,34,56,23,34,12,22,4,6,9,35,56
2010-03-11 00:00:00.000,ATP World Tour Masters 1000 Indian Wells CA; U.S.A. ATP World Tour Masters 1000,HARD,2,Andy Murray,Michael Russell,Andy Murray,6-3; 7-5,R32,113,7,6,37,79,32,37,18,42,4,5,10,50,79,3,5,40,68,19,40,18,28,4,8,11,37,68
2010-03-11 00:00:00.000,ATP World Tour Masters 1000 Indian Wells CA; U.S.A. ATP World Tour Masters 1000,HARD,2,Nicolas Almagro,James Blake,Nicolas Almagro,6-4; 3-6; 6-3,R32,113,19,0,52,89,40,52,22,37,5,6,14,62,89,2,0,46,89,33,46,26,43,3,5,14,59,89
2010-03-11 00:00:00.000,ATP World Tour Masters 1000 Indian Wells CA; U.S.A. ATP World Tour Masters 1000,HARD,2,Jo-Wilfried Tsonga,Albert Montanes,Jo-Wilfried Tsonga,4-6; 6-3; 6-3,R32,107,17,2,49,73,42,49,15,24,1,2,14,57,73,5,1,52,91,34,52,22,39,7,10,14,56,91
2010-03-11 00:00:00.000,ATP World Tour Masters 1000 Indian Wells CA; U.S.A. ATP World Tour Masters 1000,HARD,2,Robin Soderling,Feliciano Lopez,Robin Soderling,7-6(3); 6-4,R32,85,14,1,36,57,33,36,15,21,0,0,11,48,57,12,3,45,67,33,45,10,22,1,2,11,43,67
2010-03-11 00:00:00.000,ATP World Tour Masters 1000 Indian Wells CA; U.S.A. ATP World Tour Masters 1000,HARD,2,Viktor Troicki,Nikolay Davydenko,Viktor Troicki,W/O,R32,0,0,0,0,0,0,0,0,0,0,0,0,0,0,0,0,0,0,0,0,0,0,0,0,0,0,0
2010-03-11 00:00:00.000,ATP World Tour Masters 1000 Indian Wells CA; U.S.A. ATP World Tour Masters 1000,HARD,2,Tomas Berdych,Fernando Verdasco,Tomas Berdych,6-0; 6-3,R32,59,5,0,25,40,20,25,12,15,0,0,8,32,40,1,0,28,39,14,28,4,11,3,7,7,18,39
2010-03-11 00:00:00.000,ATP World Tour Masters 1000 Indian Wells CA; U.S.A. ATP World Tour Masters 1000,HARD,2,John Isner,Sam Querrey,John Isner,7-6(3); 6-4,R32,73,11,1,46,58,41,46,7,12,0,0,11,48,58,9,2,45,71,33,45,15,26,3,4,11,48,71
2010-03-11 00:00:00.000,ATP World Tour Masters 1000 Indian Wells CA; U.S.A. ATP World Tour Masters 1000,HARD,2,Rafael Nadal,Mario Ancic,Rafael Nadal,6-2; 6-2,R32,66,5,3,24,37,23,24,9,13,0,0,8,32,37,2,2,31,52,15,31,9,21,5,9,8,24,52
2010-03-11 00:00:00.000,ATP World Tour Masters 1000 Indian Wells CA; U.S.A. ATP World Tour Masters 1000,HARD,2,Guillermo Garcia-Lopez,Thomaz Bellucci,Guillermo Garcia-Lopez,4-6; 6-2; 6-1,R32,125,6,2,49,77,38,49,12,28,5,7,13,50,77,8,6,36,77,24,36,19,41,2,7,12,43,77
2010-03-11 00:00:00.000,ATP World Tour Masters 1000 Indian Wells CA; U.S.A. ATP World Tour Masters 1000,HARD,2,Juan Monaco,Juan Carlos Ferrero,Juan Monaco,7-6(2); 3-6; 6-3,R32,181,2,3,63,101,40,63,22,38,5,8,15,62,101,0,2,95,122,61,95,11,27,7,10,15,72,122
2010-03-11 00:00:00.000,ATP World Tour Masters 1000 Indian Wells CA; U.S.A. ATP World Tour Masters 1000,HARD,2,Ivan Ljubicic,Brian Dabul,Ivan Ljubicic,6-2; 6-3,R32,81,17,1,43,69,36,43,9,26,4,5,9,45,69,3,1,36,49,19,36,7,13,4,8,8,26,49
2010-03-11 00:00:00.000,ATP World Tour Masters 1000 Indian Wells CA; U.S.A. ATP World Tour Masters 1000,HARD,2,Novak Djokovic,Philipp Kohlschreiber,Novak Djokovic,6-3; 2-6; 7-6(3),R32,156,2,5,60,108,40,60,24,48,9,14,15,64,108,4,3,45,85,31,45,19,40,0,4,14,50,85
2010-03-11 00:00:00.000,ATP World Tour Masters 1000 Indian Wells CA; U.S.A. ATP World Tour Masters 1000,HARD,2,Tommy Robredo,Marcos Baghdatis,Tommy Robredo,7-5; 0-6; 6-4,R16,139,6,2,63,103,42,63,18,40,13,16,14,60,103,8,1,50,84,36,50,20,34,3,5,14,56,84
2010-03-11 00:00:00.000,ATP World Tour Masters 1000 Indian Wells CA; U.S.A. ATP World Tour Masters 1000,HARD,2,Andy Roddick,Jurgen Melzer,Andy Roddick,7-6(5); 6-4,R16,91,13,0,46,67,37,46,15,21,0,0,11,52,67,9,2,48,68,38,48,10,20,2,3,11,48,68
2010-03-11 00:00:00.000,ATP World Tour Masters 1000 Indian Wells CA; U.S.A. ATP World Tour Masters 1000,HARD,2,Andy Murray,Nicolas Almagro,Andy Murray,6-2; 1-0 RET,R16,38,3,2,17,27,15,17,3,10,1,2,5,18,27,1,1,10,18,5,10,1,8,1,4,4,6,18
2010-03-11 00:00:00.000,ATP World Tour Masters 1000 Indian Wells CA; U.S.A. ATP World Tour Masters 1000,HARD,2,Robin Soderling,Jo-Wilfried Tsonga,Robin Soderling,6-3; 6-4,R16,80,8,1,40,70,31,40,16,30,2,2,10,47,70,11,1,32,55,26,32,10,23,5,7,9,36,55
2010-03-11 00:00:00.000,ATP World Tour Masters 1000 Indian Wells CA; U.S.A. ATP World Tour Masters 1000,HARD,2,Tomas Berdych,Viktor Troicki,Tomas Berdych,6-1; 6-3,R16,71,0,0,23,45,17,23,16,22,0,0,8,33,45,5,0,29,47,15,29,7,18,7,11,8,22,47
2010-03-11 00:00:00.000,ATP World Tour Masters 1000 Indian Wells CA; U.S.A. ATP World Tour Masters 1000,HARD,2,Rafael Nadal,John Isner,Rafael Nadal,7-5; 3-6; 6-3,R16,131,2,3,44,73,37,44,21,29,0,1,15,58,73,22,1,69,105,51,69,16,36,7,9,15,67,105
2010-03-11 00:00:00.000,ATP World Tour Masters 1000 Indian Wells CA; U.S.A. ATP World Tour Masters 1000,HARD,2,Juan Monaco,Guillermo Garcia-Lopez,Juan Monaco,3-6; 6-2; 6-1,R16,125,2,0,38,74,24,38,20,36,7,10,12,44,74,1,6,40,70,24,40,12,30,0,6,12,36,70
2010-03-11 00:00:00.000,ATP World Tour Masters 1000 Indian Wells CA; U.S.A. ATP World Tour Masters 1000,HARD,2,Ivan Ljubicic,Novak Djokovic,Ivan Ljubicic,7-5; 6-3,R16,105,13,0,45,73,33,45,16,28,6,7,11,49,73,5,4,43,70,25,43,16,27,2,5,10,41,70
2010-03-11 00:00:00.000,ATP World Tour Masters 1000 Indian Wells CA; U.S.A. ATP World Tour Masters 1000,HARD,2,Andy Roddick,Tommy Robredo,Andy Roddick,6-3; 7-5,Q,78,6,2,36,52,35,36,9,16,0,0,11,44,52,5,2,29,54,22,29,13,25,0,2,10,35,54
2010-03-11 00:00:00.000,ATP World Tour Masters 1000 Indian Wells CA; U.S.A. ATP World Tour Masters 1000,HARD,2,Robin Soderling,Andy Murray,Robin Soderling,6-1; 7-6(4),Q,95,10,4,45,70,37,45,11,25,7,8,10,48,70,10,2,39,76,27,39,16,37,8,11,9,43,76
2010-03-11 00:00:00.000,ATP World Tour Masters 1000 Indian Wells CA; U.S.A. ATP World Tour Masters 1000,HARD,2,Rafael Nadal,Tomas Berdych,Rafael Nadal,6-4; 7-6(4),Q,132,3,1,51,70,36,51,11,19,5,7,11,47,70,6,3,47,83,32,47,16,36,3,6,11,48,83
2010-03-11 00:00:00.000,ATP World Tour Masters 1000 Indian Wells CA; U.S.A. ATP World Tour Masters 1000,HARD,2,Ivan Ljubicic,Juan Monaco,Ivan Ljubicic,4-6; 6-2; 6-1,Q,108,11,2,38,65,32,38,17,27,0,1,13,49,65,2,3,56,81,34,56,11,25,4,8,12,45,81
2010-03-11 00:00:00.000,ATP World Tour Masters 1000 Indian Wells CA; U.S.A. ATP World Tour Masters 1000,HARD,2,Andy Roddick,Robin Soderling,Andy Roddick,6-4; 3-6; 6-3,S,107,12,1,53,82,40,53,12,29,3,6,14,52,82,11,6,48,76,35,48,14,28,3,7,14,49,76
2010-03-11 00:00:00.000,ATP World Tour Masters 1000 Indian Wells CA; U.S.A. ATP World Tour Masters 1000,HARD,2,Ivan Ljubicic,Rafael Nadal,Ivan Ljubicic,3-6; 6-4; 7-6(1),S,155,17,6,59,102,48,59,17,43,7,10,16,65,102,5,2,55,88,40,55,21,33,4,6,15,61,88
2010-03-11 00:00:00.000,ATP World Tour Masters 1000 Indian Wells CA; U.S.A. ATP World Tour Masters 1000,HARD,2,Ivan Ljubicic,Andy Roddick,Ivan Ljubicic,7-6(3); 7-6(5),F,127,21,2,54,96,47,54,21,42,6,6,12,68,96,12,0,52,72,43,52,13,20,3,3,12,56,72
2010-03-24 00:00:00.000,ATP World Tour Masters 1000 Miami FL; U.S.A. ATP World Tour Masters 1000,HARD,2,Roger Federer,N/A Bye,Roger Federer,,R128,0,0,0,0,0,0,0,0,0,0,0,0,0,0,0,0,0,0,0,0,0,0,0,0,0,0,0
2010-03-24 00:00:00.000,ATP World Tour Masters 1000 Miami FL; U.S.A. ATP World Tour Masters 1000,HARD,2,Nicolas Lapentti,Potito Starace,Nicolas Lapentti,7-5; 6-3,R128,97,2,6,35,68,29,35,13,33,3,5,11,42,68,1,1,36,59,21,36,12,23,1,5,10,33,59
2010-03-24 00:00:00.000,ATP World Tour Masters 1000 Miami FL; U.S.A. ATP World Tour Masters 1000,HARD,2,Florent Serra,Nicolas Massu,Florent Serra,6-4; 6-4,R128,72,2,1,40,58,33,40,10,18,0,0,10,43,58,5,4,37,65,29,37,13,28,4,6,10,42,65
2010-03-24 00:00:00.000,ATP World Tour Masters 1000 Miami FL; U.S.A. ATP World Tour Masters 1000,HARD,2,Albert Montanes,N/A Bye,Albert Montanes,,R128,0,0,0,0,0,0,0,0,0,0,0,0,0,0,0,0,0,0,0,0,0,0,0,0,0,0,0
2010-03-24 00:00:00.000,ATP World Tour Masters 1000 Miami FL; U.S.A. ATP World Tour Masters 1000,HARD,2,Gilles Simon,N/A Bye,Gilles Simon,,R128,0,0,0,0,0,0,0,0,0,0,0,0,0,0,0,0,0,0,0,0,0,0,0,0,0,0,0
2010-03-24 00:00:00.000,ATP World Tour Masters 1000 Miami FL; U.S.A. ATP World Tour Masters 1000,HARD,2,Horacio Zeballos,Andreas Seppi,Horacio Zeballos,7-6(4); 6-2,R128,91,6,4,32,62,24,32,20,30,1,2,10,44,62,5,3,43,78,31,43,13,35,2,5,10,44,78
2010-03-24 00:00:00.000,ATP World Tour Masters 1000 Miami FL; U.S.A. ATP World Tour Masters 1000,HARD,2,Thiemo de Bakker,Rajeev Ram,Thiemo de Bakker,6-4; 7-5,R128,71,9,0,36,55,29,36,15,19,0,0,11,44,55,8,4,33,62,29,33,12,29,0,2,11,41,62
2010-03-24 00:00:00.000,ATP World Tour Masters 1000 Miami FL; U.S.A. ATP World Tour Masters 1000,HARD,2,Tomas Berdych,N/A Bye,Tomas Berdych,,R128,0,0,0,0,0,0,0,0,0,0,0,0,0,0,0,0,0,0,0,0,0,0,0,0,0,0,0
2010-03-24 00:00:00.000,ATP World Tour Masters 1000 Miami FL; U.S.A. ATP World Tour Masters 1000,HARD,2,Fernando Verdasco,N/A Bye,Fernando Verdasco,,R128,0,0,0,0,0,0,0,0,0,0,0,0,0,0,0,0,0,0,0,0,0,0,0,0,0,0,0
2010-03-24 00:00:00.000,ATP World Tour Masters 1000 Miami FL; U.S.A. ATP World Tour Masters 1000,HARD,2,Dudi Sela,Evgeny Korolev,Dudi Sela,6-3; 6-3,R128,74,2,4,32,62,21,32,21,30,1,1,9,42,62,6,3,27,50,21,27,10,23,1,4,9,31,50
2010-03-24 00:00:00.000,ATP World Tour Masters 1000 Miami FL; U.S.A. ATP World Tour Masters 1000,HARD,2,Alejandro Falla,Victor Hanescu,Alejandro Falla,7-6(4); 3-6; 6-4,R128,128,7,1,44,92,34,44,27,48,1,5,16,61,92,9,1,68,95,48,68,13,27,2,5,15,61,95
2010-03-24 00:00:00.000,ATP World Tour Masters 1000 Miami FL; U.S.A. ATP World Tour Masters 1000,HARD,2,Jurgen Melzer,N/A Bye,Jurgen Melzer,,R128,0,0,0,0,0,0,0,0,0,0,0,0,0,0,0,0,0,0,0,0,0,0,0,0,0,0,0
2010-03-24 00:00:00.000,ATP World Tour Masters 1000 Miami FL; U.S.A. ATP World Tour Masters 1000,HARD,2,Marcos Baghdatis,N/A Bye,Marcos Baghdatis,,R128,0,0,0,0,0,0,0,0,0,0,0,0,0,0,0,0,0,0,0,0,0,0,0,0,0,0,0
2010-03-24 00:00:00.000,ATP World Tour Masters 1000 Miami FL; U.S.A. ATP World Tour Masters 1000,HARD,2,Juan Ignacio Chela,Paolo Lorenzi,Juan Ignacio Chela,6-4; 3-6; 7-6(3),R128,172,2,5,57,117,39,57,30,60,14,18,15,69,117,8,5,53,98,41,53,20,45,0,4,16,61,98
2010-03-24 00:00:00.000,ATP World Tour Masters 1000 Miami FL; U.S.A. ATP World Tour Masters 1000,HARD,2,Stephane Robert,Andreas Beck,Stephane Robert,7-5; 6-4,R128,81,4,2,24,57,21,24,18,33,2,4,11,39,57,3,7,41,71,27,41,11,30,8,12,11,38,71
2010-03-24 00:00:00.000,ATP World Tour Masters 1000 Miami FL; U.S.A. ATP World Tour Masters 1000,HARD,2,Marin Cilic,N/A Bye,Marin Cilic,,R128,0,0,0,0,0,0,0,0,0,0,0,0,0,0,0,0,0,0,0,0,0,0,0,0,0,0,0
2010-03-24 00:00:00.000,ATP World Tour Masters 1000 Miami FL; U.S.A. ATP World Tour Masters 1000,HARD,2,Andy Murray,N/A Bye,Andy Murray,,R128,0,0,0,0,0,0,0,0,0,0,0,0,0,0,0,0,0,0,0,0,0,0,0,0,0,0,0
2010-03-24 00:00:00.000,ATP World Tour Masters 1000 Miami FL; U.S.A. ATP World Tour Masters 1000,HARD,2,Mardy Fish,Leonardo Mayer,Mardy Fish,7-6(4); 6-4,R128,100,6,1,29,63,21,29,23,34,2,3,11,44,63,3,8,40,75,33,40,11,35,5,7,11,44,75
2010-03-24 00:00:00.000,ATP World Tour Masters 1000 Miami FL; U.S.A. ATP World Tour Masters 1000,HARD,2,Michael Berrer,Lukas Lacko,Michael Berrer,7-5; 4-6; 6-3,R128,135,5,4,72,108,49,72,21,36,11,13,16,70,108,8,1,58,92,47,58,12,34,1,4,15,59,92
2010-03-24 00:00:00.000,ATP World Tour Masters 1000 Miami FL; U.S.A. ATP World Tour Masters 1000,HARD,2,Feliciano Lopez,N/A Bye,Feliciano Lopez,,R128,0,0,0,0,0,0,0,0,0,0,0,0,0,0,0,0,0,0,0,0,0,0,0,0,0,0,0
2010-03-24 00:00:00.000,ATP World Tour Masters 1000 Miami FL; U.S.A. ATP World Tour Masters 1000,HARD,2,Stanislas Wawrinka,N/A Bye,Stanislas Wawrinka,,R128,0,0,0,0,0,0,0,0,0,0,0,0,0,0,0,0,0,0,0,0,0,0,0,0,0,0,0
2010-03-24 00:00:00.000,ATP World Tour Masters 1000 Miami FL; U.S.A. ATP World Tour Masters 1000,HARD,2,Kevin Anderson,Ricardo Mello,Kevin Anderson,6-3; 6-1,R128,56,10,0,26,36,23,26,9,10,0,0,8,32,36,0,2,29,53,20,29,7,24,2,6,8,27,53
2010-03-24 00:00:00.000,ATP World Tour Masters 1000 Miami FL; U.S.A. ATP World Tour Masters 1000,HARD,2,Santiago Giraldo,Marcos Daniel,Santiago Giraldo,6-3; 6-2,R128,76,6,0,24,40,21,24,11,16,0,0,8,32,40,3,3,34,65,24,34,10,31,5,9,9,34,65
2010-03-24 00:00:00.000,ATP World Tour Masters 1000 Miami FL; U.S.A. ATP World Tour Masters 1000,HARD,2,Mikhail Youzhny,N/A Bye,Mikhail Youzhny,,R128,0,0,0,0,0,0,0,0,0,0,0,0,0,0,0,0,0,0,0,0,0,0,0,0,0,0,0
2010-03-24 00:00:00.000,ATP World Tour Masters 1000 Miami FL; U.S.A. ATP World Tour Masters 1000,HARD,2,Fernando Gonzalez,N/A Bye,Fernando Gonzalez,,R128,0,0,0,0,0,0,0,0,0,0,0,0,0,0,0,0,0,0,0,0,0,0,0,0,0,0,0
2010-03-24 00:00:00.000,ATP World Tour Masters 1000 Miami FL; U.S.A. ATP World Tour Masters 1000,HARD,2,Yen-Hsun Lu,Fabio Fognini,Yen-Hsun Lu,6-7(5); 6-2; 6-4,R128,148,2,2,52,101,36,52,25,49,4,7,15,61,101,5,2,71,132,38,71,30,61,8,14,15,68,132
2010-03-24 00:00:00.000,ATP World Tour Masters 1000 Miami FL; U.S.A. ATP World Tour Masters 1000,HARD,2,Marsel Ilhan,Pablo Cuevas,Marsel Ilhan,6-2; 6-2,R128,60,5,2,26,44,21,26,10,18,3,4,8,31,44,0,2,34,58,19,34,7,24,6,11,8,26,58
2010-03-24 00:00:00.000,ATP World Tour Masters 1000 Miami FL; U.S.A. ATP World Tour Masters 1000,HARD,2,Juan Monaco,N/A Bye,Juan Monaco,,R128,0,0,0,0,0,0,0,0,0,0,0,0,0,0,0,0,0,0,0,0,0,0,0,0,0,0,0
2010-03-24 00:00:00.000,ATP World Tour Masters 1000 Miami FL; U.S.A. ATP World Tour Masters 1000,HARD,2,Janko Tipsarevic,N/A Bye,Janko Tipsarevic,,R128,0,0,0,0,0,0,0,0,0,0,0,0,0,0,0,0,0,0,0,0,0,0,0,0,0,0,0
2010-03-24 00:00:00.000,ATP World Tour Masters 1000 Miami FL; U.S.A. ATP World Tour Masters 1000,HARD,2,Philipp Petzschner,Ryan Sweeting,Philipp Petzschner,6-3; 6-1,R128,50,3,1,26,45,20,26,14,19,1,1,8,34,45,4,7,28,42,17,28,3,14,2,6,8,20,42
2010-03-24 00:00:00.000,ATP World Tour Masters 1000 Miami FL; U.S.A. ATP World Tour Masters 1000,HARD,2,Peter Luczak,Oscar Hernandez,Peter Luczak,6-3; 7-6(4),R128,86,9,2,41,67,35,41,17,26,1,1,11,52,67,5,1,41,57,32,41,9,16,2,3,10,41,57
2010-03-24 00:00:00.000,ATP World Tour Masters 1000 Miami FL; U.S.A. ATP World Tour Masters 1000,HARD,2,Robin Soderling,N/A Bye,Robin Soderling,,R128,0,0,0,0,0,0,0,0,0,0,0,0,0,0,0,0,0,0,0,0,0,0,0,0,0,0,0
2010-03-24 00:00:00.000,ATP World Tour Masters 1000 Miami FL; U.S.A. ATP World Tour Masters 1000,HARD,2,Jo-Wilfried Tsonga,N/A Bye,Jo-Wilfried Tsonga,,R128,0,0,0,0,0,0,0,0,0,0,0,0,0,0,0,0,0,0,0,0,0,0,0,0,0,0,0
2010-03-24 00:00:00.000,ATP World Tour Masters 1000 Miami FL; U.S.A. ATP World Tour Masters 1000,HARD,2,Guillermo Garcia-Lopez,Arnaud Clement,Guillermo Garcia-Lopez,7-6(4); 6-2,R128,103,9,2,33,66,26,33,20,33,2,4,10,46,66,1,1,33,68,25,33,15,35,4,8,10,40,68
2010-03-24 00:00:00.000,ATP World Tour Masters 1000 Miami FL; U.S.A. ATP World Tour Masters 1000,HARD,2,Florian Mayer,Marco Chiudinelli,Florian Mayer,7-6(2); 1-6; 6-2,R128,137,2,1,41,77,25,41,20,36,2,8,14,45,77,5,10,63,120,41,63,24,57,8,13,13,65,120
2010-03-24 00:00:00.000,ATP World Tour Masters 1000 Miami FL; U.S.A. ATP World Tour Masters 1000,HARD,2,Philipp Kohlschreiber,N/A Bye,Philipp Kohlschreiber,,R128,0,0,0,0,0,0,0,0,0,0,0,0,0,0,0,0,0,0,0,0,0,0,0,0,0,0,0
2010-03-24 00:00:00.000,ATP World Tour Masters 1000 Miami FL; U.S.A. ATP World Tour Masters 1000,HARD,2,John Isner,N/A Bye,John Isner,,R128,0,0,0,0,0,0,0,0,0,0,0,0,0,0,0,0,0,0,0,0,0,0,0,0,0,0,0
2010-03-24 00:00:00.000,ATP World Tour Masters 1000 Miami FL; U.S.A. ATP World Tour Masters 1000,HARD,2,Michael Russell,Denis Istomin,Michael Russell,7-6(5); 6-4,R128,113,0,1,45,71,27,45,14,26,4,7,11,41,71,6,0,55,76,32,55,10,21,6,10,11,42,76
2010-03-24 00:00:00.000,ATP World Tour Masters 1000 Miami FL; U.S.A. ATP World Tour Masters 1000,HARD,2,Daniel Koellerer,Christophe Rochus,Daniel Koellerer,4-6; 6-3; 6-2,R128,124,6,1,74,102,51,74,14,28,4,5,14,65,102,9,4,45,82,30,45,19,37,2,5,13,49,82
2010-03-24 00:00:00.000,ATP World Tour Masters 1000 Miami FL; U.S.A. ATP World Tour Masters 1000,HARD,2,Juan Carlos Ferrero,N/A Bye,Juan Carlos Ferrero,,R128,0,0,0,0,0,0,0,0,0,0,0,0,0,0,0,0,0,0,0,0,0,0,0,0,0,0,0
2010-03-24 00:00:00.000,ATP World Tour Masters 1000 Miami FL; U.S.A. ATP World Tour Masters 1000,HARD,2,David Ferrer,N/A Bye,David Ferrer,,R128,0,0,0,0,0,0,0,0,0,0,0,0,0,0,0,0,0,0,0,0,0,0,0,0,0,0,0
2010-03-24 00:00:00.000,ATP World Tour Masters 1000 Miami FL; U.S.A. ATP World Tour Masters 1000,HARD,2,Michael Llodra,Ryan Harrison,Michael Llodra,6-2; 6-2,R128,56,5,1,28,41,25,28,8,13,0,0,8,33,41,3,2,33,51,21,33,6,18,5,9,8,27,51
2010-03-24 00:00:00.000,ATP World Tour Masters 1000 Miami FL; U.S.A. ATP World Tour Masters 1000,HARD,2,Daniel Gimeno-Traver,Andrey Golubev,Daniel Gimeno-Traver,6-3; 6-4,R128,71,0,0,26,49,24,26,13,23,2,2,9,37,49,1,4,32,61,21,32,17,29,4,7,10,38,61
2010-03-24 00:00:00.000,ATP World Tour Masters 1000 Miami FL; U.S.A. ATP World Tour Masters 1000,HARD,2,Ivo Karlovic,N/A Bye,Ivo Karlovic,,R128,0,0,0,0,0,0,0,0,0,0,0,0,0,0,0,0,0,0,0,0,0,0,0,0,0,0,0
2010-03-24 00:00:00.000,ATP World Tour Masters 1000 Miami FL; U.S.A. ATP World Tour Masters 1000,HARD,2,Viktor Troicki,N/A Bye,Viktor Troicki,,R128,0,0,0,0,0,0,0,0,0,0,0,0,0,0,0,0,0,0,0,0,0,0,0,0,0,0,0
2010-03-24 00:00:00.000,ATP World Tour Masters 1000 Miami FL; U.S.A. ATP World Tour Masters 1000,HARD,2,David Nalbandian,Lukasz Kubot,David Nalbandian,6-3; 6-2,R128,62,2,2,28,51,23,28,11,23,0,1,9,34,51,4,3,28,44,18,28,3,16,1,5,8,21,44
2010-03-24 00:00:00.000,ATP World Tour Masters 1000 Miami FL; U.S.A. ATP World Tour Masters 1000,HARD,2,Taylor Dent,Rainer Schuettler,Taylor Dent,6-1; 6-4,R128,62,7,6,29,55,24,29,15,26,4,4,9,39,55,1,3,29,46,17,29,11,17,0,3,8,28,46
2010-03-24 00:00:00.000,ATP World Tour Masters 1000 Miami FL; U.S.A. ATP World Tour Masters 1000,HARD,2,Rafael Nadal,N/A Bye,Rafael Nadal,,R128,0,0,0,0,0,0,0,0,0,0,0,0,0,0,0,0,0,0,0,0,0,0,0,0,0,0,0
2010-03-24 00:00:00.000,ATP World Tour Masters 1000 Miami FL; U.S.A. ATP World Tour Masters 1000,HARD,2,Andy Roddick,N/A Bye,Andy Roddick,,R128,0,0,0,0,0,0,0,0,0,0,0,0,0,0,0,0,0,0,0,0,0,0,0,0,0,0,0
2010-03-24 00:00:00.000,ATP World Tour Masters 1000 Miami FL; U.S.A. ATP World Tour Masters 1000,HARD,2,Igor Andreev,Xavier Malisse,Igor Andreev,6-4; 6-4,R128,64,7,1,25,48,23,25,17,23,0,0,10,40,48,3,1,35,61,26,35,13,26,5,7,10,39,61
2010-03-24 00:00:00.000,ATP World Tour Masters 1000 Miami FL; U.S.A. ATP World Tour Masters 1000,HARD,2,Sergiy Stakhovsky,Jan Hajek,Sergiy Stakhovsky,6-3; 5-7; 7-5,R128,139,7,1,50,100,38,50,29,50,3,5,17,67,100,2,6,79,124,51,79,24,45,7,10,16,75,124
2010-03-24 00:00:00.000,ATP World Tour Masters 1000 Miami FL; U.S.A. ATP World Tour Masters 1000,HARD,2,Julien Benneteau,N/A Bye,Julien Benneteau,,R128,0,0,0,0,0,0,0,0,0,0,0,0,0,0,0,0,0,0,0,0,0,0,0,0,0,0,0
2010-03-24 00:00:00.000,ATP World Tour Masters 1000 Miami FL; U.S.A. ATP World Tour Masters 1000,HARD,2,Tommy Robredo,N/A Bye,Tommy Robredo,,R128,0,0,0,0,0,0,0,0,0,0,0,0,0,0,0,0,0,0,0,0,0,0,0,0,0,0,0
2010-03-24 00:00:00.000,ATP World Tour Masters 1000 Miami FL; U.S.A. ATP World Tour Masters 1000,HARD,2,Illya Marchenko,Paul-Henri Mathieu,Illya Marchenko,6-3; 7-6(3),R128,111,13,2,46,72,35,46,13,26,4,6,10,48,72,3,5,49,84,35,49,11,35,5,9,11,46,84
2010-03-24 00:00:00.000,ATP World Tour Masters 1000 Miami FL; U.S.A. ATP World Tour Masters 1000,HARD,2,Benjamin Becker,Simon Greul,Benjamin Becker,6-3; 6-2,R128,59,9,2,28,47,27,28,11,19,1,1,9,38,47,2,4,22,50,14,22,13,28,2,5,8,27,50
2010-03-24 00:00:00.000,ATP World Tour Masters 1000 Miami FL; U.S.A. ATP World Tour Masters 1000,HARD,2,Ivan Ljubicic,N/A Bye,Ivan Ljubicic,,R128,0,0,0,0,0,0,0,0,0,0,0,0,0,0,0,0,0,0,0,0,0,0,0,0,0,0,0
2010-03-24 00:00:00.000,ATP World Tour Masters 1000 Miami FL; U.S.A. ATP World Tour Masters 1000,HARD,2,Nicolas Almagro,N/A Bye,Nicolas Almagro,,R128,0,0,0,0,0,0,0,0,0,0,0,0,0,0,0,0,0,0,0,0,0,0,0,0,0,0,0
2010-03-24 00:00:00.000,ATP World Tour Masters 1000 Miami FL; U.S.A. ATP World Tour Masters 1000,HARD,2,Eduardo Schwank,Marc Gicquel,Eduardo Schwank,4-3 RET,R128,26,2,1,9,14,8,9,4,5,0,0,3,12,14,2,3,8,29,8,8,8,21,3,4,4,16,29
2010-03-24 00:00:00.000,ATP World Tour Masters 1000 Miami FL; U.S.A. ATP World Tour Masters 1000,HARD,2,Jeremy Chardy,Mario Ancic,Jeremy Chardy,6-4; 6-4,R128,76,9,3,27,53,23,27,18,26,0,0,10,41,53,12,3,38,69,30,38,12,31,6,8,10,42,69
2010-03-24 00:00:00.000,ATP World Tour Masters 1000 Miami FL; U.S.A. ATP World Tour Masters 1000,HARD,2,Sam Querrey,N/A Bye,Sam Querrey,,R128,0,0,0,0,0,0,0,0,0,0,0,0,0,0,0,0,0,0,0,0,0,0,0,0,0,0,0
2010-03-24 00:00:00.000,ATP World Tour Masters 1000 Miami FL; U.S.A. ATP World Tour Masters 1000,HARD,2,Thomaz Bellucci,N/A Bye,Thomaz Bellucci,,R128,0,0,0,0,0,0,0,0,0,0,0,0,0,0,0,0,0,0,0,0,0,0,0,0,0,0,0
2010-03-24 00:00:00.000,ATP World Tour Masters 1000 Miami FL; U.S.A. ATP World Tour Masters 1000,HARD,2,James Blake,Filip Krajinovic,James Blake,6-7(6); 6-4; 6-4,R128,133,5,8,48,109,38,48,36,61,4,5,16,74,109,7,4,58,106,42,58,27,48,8,11,16,69,106
2010-03-24 00:00:00.000,ATP World Tour Masters 1000 Miami FL; U.S.A. ATP World Tour Masters 1000,HARD,2,Olivier Rochus,Richard Gasquet,Olivier Rochus,7-6(2); 1-6; 6-4,R128,129,2,5,53,106,38,53,27,53,8,12,15,65,106,13,5,43,74,33,43,19,31,0,2,14,52,74
2010-03-24 00:00:00.000,ATP World Tour Masters 1000 Miami FL; U.S.A. ATP World Tour Masters 1000,HARD,2,Novak Djokovic,N/A Bye,Novak Djokovic,,R128,0,0,0,0,0,0,0,0,0,0,0,0,0,0,0,0,0,0,0,0,0,0,0,0,0,0,0
2010-03-24 00:00:00.000,ATP World Tour Masters 1000 Miami FL; U.S.A. ATP World Tour Masters 1000,HARD,2,Roger Federer,Nicolas Lapentti,Roger Federer,6-3; 6-3,R64,67,10,0,31,48,27,31,10,17,1,1,9,37,48,1,2,28,50,19,28,12,22,0,3,9,31,50
2010-03-24 00:00:00.000,ATP World Tour Masters 1000 Miami FL; U.S.A. ATP World Tour Masters 1000,HARD,2,Florent Serra,Albert Montanes,Florent Serra,6-3; 3-6; 6-2,R64,109,8,2,55,105,40,55,23,50,10,12,13,63,105,5,7,35,68,27,35,15,33,0,4,13,42,68
2010-03-24 00:00:00.000,ATP World Tour Masters 1000 Miami FL; U.S.A. ATP World Tour Masters 1000,HARD,2,Horacio Zeballos,Gilles Simon,Horacio Zeballos,6-2; 6-3,R64,64,7,0,30,48,25,30,11,18,3,3,8,36,48,3,5,26,48,19,26,7,22,2,6,9,26,48
2010-03-24 00:00:00.000,ATP World Tour Masters 1000 Miami FL; U.S.A. ATP World Tour Masters 1000,HARD,2,Tomas Berdych,Thiemo de Bakker,Tomas Berdych,6-3; 6-4,R64,83,3,0,31,54,26,31,14,23,4,5,10,40,54,10,3,39,63,26,39,7,24,5,8,9,33,63
2010-03-24 00:00:00.000,ATP World Tour Masters 1000 Miami FL; U.S.A. ATP World Tour Masters 1000,HARD,2,Fernando Verdasco,Dudi Sela,Fernando Verdasco,6-1; 6-2,R64,65,3,4,26,43,24,26,8,17,0,0,8,32,43,0,1,26,45,11,26,10,19,2,6,7,21,45
2010-03-24 00:00:00.000,ATP World Tour Masters 1000 Miami FL; U.S.A. ATP World Tour Masters 1000,HARD,2,Jurgen Melzer,Alejandro Falla,Jurgen Melzer,6-3; 6-4,R64,78,3,2,35,62,30,35,13,27,1,1,10,43,62,3,4,41,66,28,41,13,25,4,6,9,41,66
2010-03-24 00:00:00.000,ATP World Tour Masters 1000 Miami FL; U.S.A. ATP World Tour Masters 1000,HARD,2,Marcos Baghdatis,Juan Ignacio Chela,Marcos Baghdatis,6-2; 6-4,R64,82,4,1,22,51,18,22,19,29,0,1,9,37,51,1,3,43,70,26,43,11,27,4,8,9,37,70
2010-03-24 00:00:00.000,ATP World Tour Masters 1000 Miami FL; U.S.A. ATP World Tour Masters 1000,HARD,2,Marin Cilic,Stephane Robert,Marin Cilic,6-3; 6-1,R64,60,1,1,32,47,24,32,10,15,0,0,8,34,47,1,1,28,50,16,28,8,22,2,6,8,24,50
2010-03-24 00:00:00.000,ATP World Tour Masters 1000 Miami FL; U.S.A. ATP World Tour Masters 1000,HARD,2,Mardy Fish,Andy Murray,Mardy Fish,6-4; 6-4,R64,92,10,2,33,65,27,33,16,32,4,5,10,43,65,2,5,38,72,25,38,17,34,4,7,10,42,72
2010-03-24 00:00:00.000,ATP World Tour Masters 1000 Miami FL; U.S.A. ATP World Tour Masters 1000,HARD,2,Feliciano Lopez,Michael Berrer,Feliciano Lopez,7-6(2); 7-5,R64,99,6,3,37,71,31,37,16,34,0,2,12,47,71,6,8,58,79,42,58,6,21,6,9,12,48,79
2010-03-24 00:00:00.000,ATP World Tour Masters 1000 Miami FL; U.S.A. ATP World Tour Masters 1000,HARD,2,Stanislas Wawrinka,Kevin Anderson,Stanislas Wawrinka,6-4; 7-5,R64,103,2,0,34,64,27,34,18,30,4,5,11,45,64,8,4,55,83,40,55,10,28,10,13,11,50,83
2010-03-24 00:00:00.000,ATP World Tour Masters 1000 Miami FL; U.S.A. ATP World Tour Masters 1000,HARD,2,Mikhail Youzhny,Santiago Giraldo,Mikhail Youzhny,6-0; 6-1,R64,50,4,1,21,36,18,21,11,15,0,0,7,29,36,0,2,18,35,7,18,5,17,3,8,6,12,35
2010-03-24 00:00:00.000,ATP World Tour Masters 1000 Miami FL; U.S.A. ATP World Tour Masters 1000,HARD,2,Fernando Gonzalez,Yen-Hsun Lu,Fernando Gonzalez,6-4; 6-4,R64,77,10,3,31,56,27,31,14,25,4,5,10,41,56,6,6,31,61,22,31,15,30,3,6,10,37,61
2010-03-24 00:00:00.000,ATP World Tour Masters 1000 Miami FL; U.S.A. ATP World Tour Masters 1000,HARD,2,Juan Monaco,Marsel Ilhan,Juan Monaco,6-2; 7-5,R64,142,3,3,31,57,22,31,14,26,1,3,10,36,57,3,2,45,76,26,45,11,31,4,9,10,37,76
2010-03-24 00:00:00.000,ATP World Tour Masters 1000 Miami FL; U.S.A. ATP World Tour Masters 1000,HARD,2,Philipp Petzschner,Janko Tipsarevic,Philipp Petzschner,6-4; 6-0,R64,58,3,2,21,46,18,21,15,25,3,4,8,33,46,1,2,22,43,11,22,7,21,2,7,8,18,43
2010-03-24 00:00:00.000,ATP World Tour Masters 1000 Miami FL; U.S.A. ATP World Tour Masters 1000,HARD,2,Robin Soderling,Peter Luczak,Robin Soderling,7-6(5); 6-0,R64,81,6,5,28,55,23,28,14,27,4,6,9,37,55,2,2,28,57,20,28,7,29,6,11,9,27,57
2010-03-24 00:00:00.000,ATP World Tour Masters 1000 Miami FL; U.S.A. ATP World Tour Masters 1000,HARD,2,Jo-Wilfried Tsonga,Guillermo Garcia-Lopez,Jo-Wilfried Tsonga,6-4; 6-3,R64,102,15,4,37,70,30,37,17,33,6,7,10,47,70,0,2,42,78,29,42,13,36,6,9,9,42,78
2010-03-24 00:00:00.000,ATP World Tour Masters 1000 Miami FL; U.S.A. ATP World Tour Masters 1000,HARD,2,Philipp Kohlschreiber,Florian Mayer,Philipp Kohlschreiber,6-6 RET,R64,53,3,6,23,44,20,23,10,21,3,3,6,30,44,2,0,27,39,19,27,9,12,1,1,6,28,39
2010-03-24 00:00:00.000,ATP World Tour Masters 1000 Miami FL; U.S.A. ATP World Tour Masters 1000,HARD,2,John Isner,Michael Russell,John Isner,7-6(5); 2-6; 7-6(5),R64,150,25,7,96,128,67,96,17,32,5,7,16,84,128,2,3,70,96,58,70,17,26,0,0,16,75,96
2010-03-24 00:00:00.000,ATP World Tour Masters 1000 Miami FL; U.S.A. ATP World Tour Masters 1000,HARD,2,Juan Carlos Ferrero,Daniel Koellerer,Juan Carlos Ferrero,4-0 RET,R64,24,2,0,6,14,5,6,4,8,0,0,2,9,14,4,3,11,20,6,11,1,9,3,5,2,7,20
2010-03-24 00:00:00.000,ATP World Tour Masters 1000 Miami FL; U.S.A. ATP World Tour Masters 1000,HARD,2,David Ferrer,Michael Llodra,David Ferrer,6-2; 6-4,R64,70,4,0,30,43,25,30,11,13,0,0,9,36,43,3,1,28,56,19,28,15,28,6,9,9,34,56
2010-03-24 00:00:00.000,ATP World Tour Masters 1000 Miami FL; U.S.A. ATP World Tour Masters 1000,HARD,2,Ivo Karlovic,Daniel Gimeno-Traver,Ivo Karlovic,6-3; 6-7(5); 6-3,R64,131,28,2,63,96,54,63,18,33,5,5,16,72,96,4,2,64,92,42,64,19,28,4,6,14,61,92
2010-03-24 00:00:00.000,ATP World Tour Masters 1000 Miami FL; U.S.A. ATP World Tour Masters 1000,HARD,2,David Nalbandian,Viktor Troicki,David Nalbandian,6-3; 4-6; 6-4,R64,140,0,5,56,106,40,56,21,50,5,9,15,61,106,9,6,51,98,30,51,23,47,11,16,14,53,98
2010-03-24 00:00:00.000,ATP World Tour Masters 1000 Miami FL; U.S.A. ATP World Tour Masters 1000,HARD,2,Rafael Nadal,Taylor Dent,Rafael Nadal,6-4; 6-3,R64,71,2,0,33,49,25,33,10,16,1,2,9,35,49,6,6,23,51,17,23,12,28,0,4,10,29,51
2010-03-24 00:00:00.000,ATP World Tour Masters 1000 Miami FL; U.S.A. ATP World Tour Masters 1000,HARD,2,Andy Roddick,Igor Andreev,Andy Roddick,6-4; 6-4,R64,80,12,1,39,55,30,39,12,16,1,1,10,42,55,3,1,41,68,31,41,12,27,4,6,10,43,68
2010-03-24 00:00:00.000,ATP World Tour Masters 1000 Miami FL; U.S.A. ATP World Tour Masters 1000,HARD,2,Sergiy Stakhovsky,Julien Benneteau,Sergiy Stakhovsky,6-3; 7-6(5),R64,79,7,2,54,71,42,54,7,17,3,4,11,49,71,5,3,48,63,37,48,7,15,4,6,10,44,63
2010-03-24 00:00:00.000,ATP World Tour Masters 1000 Miami FL; U.S.A. ATP World Tour Masters 1000,HARD,2,Tommy Robredo,Illya Marchenko,Tommy Robredo,6-3; 4-6; 6-4,R64,140,1,3,44,85,28,44,22,41,3,9,15,50,85,3,5,44,96,29,44,21,52,7,14,14,50,96
2010-03-24 00:00:00.000,ATP World Tour Masters 1000 Miami FL; U.S.A. ATP World Tour Masters 1000,HARD,2,Benjamin Becker,Ivan Ljubicic,Benjamin Becker,4-6; 0-1 RET,R64,64,4,0,15,36,12,15,10,21,2,4,6,22,36,8,2,30,44,21,30,6,14,8,8,5,27,44
2010-03-24 00:00:00.000,ATP World Tour Masters 1000 Miami FL; U.S.A. ATP World Tour Masters 1000,HARD,2,Nicolas Almagro,Eduardo Schwank,Nicolas Almagro,6-4; 7-5,R64,89,6,1,34,58,28,34,16,24,0,1,11,44,58,5,5,52,72,33,52,10,20,6,9,11,43,72
2010-03-24 00:00:00.000,ATP World Tour Masters 1000 Miami FL; U.S.A. ATP World Tour Masters 1000,HARD,2,Jeremy Chardy,Sam Querrey,Jeremy Chardy,4-6; 6-4; 6-2,R64,91,8,4,45,84,35,45,22,39,3,5,14,57,84,13,1,45,73,33,45,13,28,2,6,14,46,73
2010-03-24 00:00:00.000,ATP World Tour Masters 1000 Miami FL; U.S.A. ATP World Tour Masters 1000,HARD,2,Thomaz Bellucci,James Blake,Thomaz Bellucci,3-6; 6-1; 6-2,R64,104,11,2,35,74,27,35,22,39,3,4,12,49,74,4,1,54,90,38,54,12,36,8,12,12,50,90
2010-03-24 00:00:00.000,ATP World Tour Masters 1000 Miami FL; U.S.A. ATP World Tour Masters 1000,HARD,2,Olivier Rochus,Novak Djokovic,Olivier Rochus,6-2; 6-7(7); 6-4,R64,175,1,4,63,107,41,63,26,44,10,13,15,67,107,6,11,70,114,48,70,13,44,9,15,15,61,114
2010-03-24 00:00:00.000,ATP World Tour Masters 1000 Miami FL; U.S.A. ATP World Tour Masters 1000,HARD,2,Roger Federer,Florent Serra,Roger Federer,7-6(2); 7-6(3),R32,92,6,2,46,79,36,46,17,33,2,5,12,53,79,4,2,38,78,26,38,23,40,5,8,12,49,78
2010-03-24 00:00:00.000,ATP World Tour Masters 1000 Miami FL; U.S.A. ATP World Tour Masters 1000,HARD,2,Tomas Berdych,Horacio Zeballos,Tomas Berdych,6-4; 7-5,R32,95,7,1,39,62,33,39,11,23,4,5,11,44,62,2,1,47,68,31,47,9,21,4,7,11,40,68
2010-03-24 00:00:00.000,ATP World Tour Masters 1000 Miami FL; U.S.A. ATP World Tour Masters 1000,HARD,2,Fernando Verdasco,Jurgen Melzer,Fernando Verdasco,3-6; 7-6(4); 6-1,R32,123,5,12,74,110,56,74,13,36,8,10,15,69,110,2,3,43,80,35,43,17,37,3,5,13,52,80
2010-03-24 00:00:00.000,ATP World Tour Masters 1000 Miami FL; U.S.A. ATP World Tour Masters 1000,HARD,2,Marin Cilic,Marcos Baghdatis,Marin Cilic,6-3; 6-4,R32,76,5,1,29,58,25,29,17,29,0,0,10,42,58,6,1,26,48,22,26,11,22,0,2,9,33,48
2010-03-24 00:00:00.000,ATP World Tour Masters 1000 Miami FL; U.S.A. ATP World Tour Masters 1000,HARD,2,Mardy Fish,Feliciano Lopez,Mardy Fish,7-5; 6-3,R32,90,7,1,37,60,31,37,15,23,2,2,11,46,60,9,5,35,76,25,35,19,41,11,13,10,44,76
2010-03-24 00:00:00.000,ATP World Tour Masters 1000 Miami FL; U.S.A. ATP World Tour Masters 1000,HARD,2,Mikhail Youzhny,Stanislas Wawrinka,Mikhail Youzhny,1-6; 7-6(5); 7-5,R32,150,2,4,68,100,48,68,15,32,5,9,15,63,100,6,3,57,97,43,57,20,40,1,4,16,63,97
2010-03-24 00:00:00.000,ATP World Tour Masters 1000 Miami FL; U.S.A. ATP World Tour Masters 1000,HARD,2,Fernando Gonzalez,Juan Monaco,Fernando Gonzalez,6-7(4); 6-4; 6-2,R32,142,3,3,52,100,41,52,25,48,5,6,15,66,100,2,2,67,90,46,67,13,23,5,9,15,59,90
2010-03-24 00:00:00.000,ATP World Tour Masters 1000 Miami FL; U.S.A. ATP World Tour Masters 1000,HARD,2,Robin Soderling,Philipp Petzschner,Robin Soderling,6-1; 6-2,R32,65,1,3,34,62,24,34,16,28,3,3,8,40,62,7,4,27,48,19,27,4,21,1,5,7,23,48
2010-03-24 00:00:00.000,ATP World Tour Masters 1000 Miami FL; U.S.A. ATP World Tour Masters 1000,HARD,2,Jo-Wilfried Tsonga,Philipp Kohlschreiber,Jo-Wilfried Tsonga,6-2; 7-5,R32,82,11,2,33,51,28,33,11,18,0,1,10,39,51,4,3,41,72,27,41,14,31,8,12,10,41,72
2010-03-24 00:00:00.000,ATP World Tour Masters 1000 Miami FL; U.S.A. ATP World Tour Masters 1000,HARD,2,Juan Carlos Ferrero,John Isner,Juan Carlos Ferrero,6-2; 3-6; 6-3,R32,101,4,3,43,71,36,43,15,28,3,4,13,51,71,15,2,50,78,38,50,12,28,4,7,13,50,78
2010-03-24 00:00:00.000,ATP World Tour Masters 1000 Miami FL; U.S.A. ATP World Tour Masters 1000,HARD,2,David Ferrer,Ivo Karlovic,David Ferrer,7-6(5); 6-3,R32,87,3,3,50,68,39,50,13,18,0,0,11,52,68,10,3,37,68,29,37,18,31,1,2,10,47,68
2010-03-24 00:00:00.000,ATP World Tour Masters 1000 Miami FL; U.S.A. ATP World Tour Masters 1000,HARD,2,Rafael Nadal,David Nalbandian,Rafael Nadal,6-7(8); 6-2; 6-2,R32,146,5,3,59,97,47,59,18,38,2,3,14,65,97,8,1,50,81,37,50,13,31,1,6,14,50,81
2010-03-24 00:00:00.000,ATP World Tour Masters 1000 Miami FL; U.S.A. ATP World Tour Masters 1000,HARD,2,Andy Roddick,Sergiy Stakhovsky,Andy Roddick,6-2; 6-1,R32,56,3,1,33,46,27,33,8,13,3,3,8,35,46,1,3,14,34,8,14,7,20,0,4,7,15,34
2010-03-24 00:00:00.000,ATP World Tour Masters 1000 Miami FL; U.S.A. ATP World Tour Masters 1000,HARD,2,Benjamin Becker,Tommy Robredo,Benjamin Becker,1-6; 6-4; 7-6(1),R32,125,5,7,45,93,32,45,19,48,2,9,15,51,93,5,4,59,96,34,59,20,37,8,13,14,54,96
2010-03-24 00:00:00.000,ATP World Tour Masters 1000 Miami FL; U.S.A. ATP World Tour Masters 1000,HARD,2,Nicolas Almagro,Jeremy Chardy,Nicolas Almagro,6-2; 6-7(9); 6-3,R32,126,11,3,53,90,40,53,24,37,2,3,14,64,90,9,10,51,105,35,51,24,54,10,15,15,59,105
2010-03-24 00:00:00.000,ATP World Tour Masters 1000 Miami FL; U.S.A. ATP World Tour Masters 1000,HARD,2,Thomaz Bellucci,Olivier Rochus,Thomaz Bellucci,6-3; 6-4,R32,73,9,1,29,50,25,29,12,21,1,2,10,37,50,0,2,25,52,17,25,15,27,2,5,9,32,52
2010-03-24 00:00:00.000,ATP World Tour Masters 1000 Miami FL; U.S.A. ATP World Tour Masters 1000,HARD,2,Tomas Berdych,Roger Federer,Tomas Berdych,6-4; 6-7(3); 7-6(6),R16,172,6,3,76,135,51,76,32,59,8,10,17,83,135,5,2,57,103,42,57,25,46,1,4,17,67,103
2010-03-24 00:00:00.000,ATP World Tour Masters 1000 Miami FL; U.S.A. ATP World Tour Masters 1000,HARD,2,Fernando Verdasco,Marin Cilic,Fernando Verdasco,6-4; 7-6(3),R16,114,3,3,46,74,32,46,17,28,4,5,11,49,74,1,3,48,76,37,48,10,28,7,9,11,47,76
2010-03-24 00:00:00.000,ATP World Tour Masters 1000 Miami FL; U.S.A. ATP World Tour Masters 1000,HARD,2,Mikhail Youzhny,Mardy Fish,Mikhail Youzhny,6-1; 1-0 RET,R16,56,2,0,18,25,14,18,4,7,1,1,4,18,25,2,2,8,29,5,8,7,21,6,9,4,12,29
2010-03-24 00:00:00.000,ATP World Tour Masters 1000 Miami FL; U.S.A. ATP World Tour Masters 1000,HARD,2,Robin Soderling,Fernando Gonzalez,Robin Soderling,6-0; 6-7(3); 6-2,R16,99,15,2,41,75,35,41,21,34,0,0,13,56,75,4,7,40,82,27,40,21,42,7,12,13,48,82
2010-03-24 00:00:00.000,ATP World Tour Masters 1000 Miami FL; U.S.A. ATP World Tour Masters 1000,HARD,2,Jo-Wilfried Tsonga,Juan Carlos Ferrero,Jo-Wilfried Tsonga,6-2; 6-2,R16,60,8,2,23,46,19,23,13,23,3,4,8,32,46,0,1,24,38,9,24,8,14,1,6,8,17,38
2010-03-24 00:00:00.000,ATP World Tour Masters 1000 Miami FL; U.S.A. ATP World Tour Masters 1000,HARD,2,Rafael Nadal,David Ferrer,Rafael Nadal,7-6(5); 6-4,R16,117,2,1,41,69,30,41,17,28,5,7,11,47,69,2,1,46,78,31,46,19,32,6,9,11,50,78
2010-03-24 00:00:00.000,ATP World Tour Masters 1000 Miami FL; U.S.A. ATP World Tour Masters 1000,HARD,2,Andy Roddick,Benjamin Becker,Andy Roddick,7-6(4); 6-3,R16,81,8,2,47,66,36,47,13,19,3,4,11,49,66,11,2,35,55,28,35,12,20,2,4,10,40,55
2010-03-24 00:00:00.000,ATP World Tour Masters 1000 Miami FL; U.S.A. ATP World Tour Masters 1000,HARD,2,Nicolas Almagro,Thomaz Bellucci,Nicolas Almagro,6-4; 3-6; 7-6(3),R16,157,14,2,48,85,38,48,18,37,0,3,15,56,85,8,6,57,123,40,57,34,66,12,15,16,74,123
2010-03-24 00:00:00.000,ATP World Tour Masters 1000 Miami FL; U.S.A. ATP World Tour Masters 1000,HARD,2,Tomas Berdych,Fernando Verdasco,Tomas Berdych,4-6; 7-6(5); 6-4,Q,172,4,2,65,108,48,65,22,43,7,9,16,70,108,7,6,77,109,53,77,17,32,7,9,16,70,109
2010-03-24 00:00:00.000,ATP World Tour Masters 1000 Miami FL; U.S.A. ATP World Tour Masters 1000,HARD,2,Robin Soderling,Mikhail Youzhny,Robin Soderling,6-1; 6-4,Q,72,1,3,22,48,17,22,10,26,0,3,9,27,48,4,2,34,54,18,34,6,20,3,9,8,24,54
2010-03-24 00:00:00.000,ATP World Tour Masters 1000 Miami FL; U.S.A. ATP World Tour Masters 1000,HARD,2,Rafael Nadal,Jo-Wilfried Tsonga,Rafael Nadal,6-3; 6-2,Q,91,1,2,51,70,33,51,12,19,8,8,8,45,70,5,0,29,46,18,29,6,17,1,5,9,24,46
2010-03-24 00:00:00.000,ATP World Tour Masters 1000 Miami FL; U.S.A. ATP World Tour Masters 1000,HARD,2,Andy Roddick,Nicolas Almagro,Andy Roddick,6-3; 6-3,Q,79,4,1,34,49,28,34,10,15,2,2,9,38,49,5,2,34,61,26,34,9,27,4,7,9,35,61
2010-03-24 00:00:00.000,ATP World Tour Masters 1000 Miami FL; U.S.A. ATP World Tour Masters 1000,HARD,2,Tomas Berdych,Robin Soderling,Tomas Berdych,6-2; 6-2,S,69,7,1,27,44,23,27,11,17,1,1,8,34,44,7,2,29,55,19,29,7,26,4,8,8,26,55
2010-03-24 00:00:00.000,ATP World Tour Masters 1000 Miami FL; U.S.A. ATP World Tour Masters 1000,HARD,2,Andy Roddick,Rafael Nadal,Andy Roddick,4-6; 6-3; 6-3,S,126,15,3,55,83,47,55,13,28,3,4,14,60,83,6,0,48,77,34,48,17,29,3,6,14,51,77
2010-03-24 00:00:00.000,ATP World Tour Masters 1000 Miami FL; U.S.A. ATP World Tour Masters 1000,HARD,2,Andy Roddick,Tomas Berdych,Andy Roddick,7-5; 6-4,F,103,13,2,37,60,29,37,16,23,0,0,11,45,60,7,3,34,69,25,34,20,35,3,5,11,45,69
2010-04-05 00:00:00.000,Casablanca Morocco ATP World Tour 250,CLAY,2,Stanislas Wawrinka,N/A Bye,Stanislas Wawrinka,,R32,0,0,0,0,0,0,0,0,0,0,0,0,0,0,0,0,0,0,0,0,0,0,0,0,0,0,0
2010-04-05 00:00:00.000,Casablanca Morocco ATP World Tour 250,CLAY,2,Martin Klizan,Alexandr Dolgopolov,Martin Klizan,4-6; 6-1; 7-5,R32,137,4,5,50,110,33,50,31,60,9,12,14,64,110,4,5,51,91,35,51,19,40,9,15,15,54,91
2010-04-05 00:00:00.000,Casablanca Morocco ATP World Tour 250,CLAY,2,Reda El Amrani,Teymuraz Gabashvili,Reda El Amrani,7-6(5); 4-6; 7-6(4),R32,160,9,4,72,123,49,72,25,51,11,16,17,74,123,6,4,55,112,40,55,29,57,8,12,17,69,112
2010-04-05 00:00:00.000,Casablanca Morocco ATP World Tour 250,CLAY,2,Jan Hajek,Simon Greul,Jan Hajek,7-6(3); 6-4,R32,99,0,3,47,80,32,47,15,33,9,13,11,47,80,1,3,32,66,20,32,15,34,1,6,11,35,66
2010-04-05 00:00:00.000,Casablanca Morocco ATP World Tour 250,CLAY,2,Lukasz Kubot,N/A Bye,Lukasz Kubot,,R32,0,0,0,0,0,0,0,0,0,0,0,0,0,0,0,0,0,0,0,0,0,0,0,0,0,0,0
2010-04-05 00:00:00.000,Casablanca Morocco ATP World Tour 250,CLAY,2,Arnaud Clement,Ivan Navarro,Arnaud Clement,6-3; 6-3,R32,75,1,1,36,57,25,36,15,21,2,2,9,40,57,7,2,29,47,21,29,7,18,3,6,9,28,47
2010-04-05 00:00:00.000,Casablanca Morocco ATP World Tour 250,CLAY,2,Potito Starace,Peter Luczak,Potito Starace,6-3; 7-5,R32,101,3,0,49,56,33,49,6,7,1,2,10,39,56,6,2,45,72,28,45,13,27,3,7,11,41,72
2010-04-05 00:00:00.000,Casablanca Morocco ATP World Tour 250,CLAY,2,Oscar Hernandez,Paul-Henri Mathieu,Oscar Hernandez,7-6(7); 6-3,R32,118,6,4,46,86,32,46,24,40,4,5,11,56,86,2,1,30,61,20,30,22,31,0,2,10,42,61
2010-04-05 00:00:00.000,Casablanca Morocco ATP World Tour 250,CLAY,2,Richard Gasquet,Olivier Rochus,Richard Gasquet,6-1; 6-1,R32,47,3,0,18,29,17,18,11,11,0,0,7,28,29,0,0,25,45,11,25,8,20,4,9,7,19,45
2010-04-05 00:00:00.000,Casablanca Morocco ATP World Tour 250,CLAY,2,Andrey Golubev,Daniel Koellerer,Andrey Golubev,6-2; 7-6(5),R32,112,9,1,40,76,31,40,17,36,7,10,10,48,76,1,2,45,75,26,45,14,30,7,12,10,40,75
2010-04-05 00:00:00.000,Casablanca Morocco ATP World Tour 250,CLAY,2,Jarkko Nieminen,Mehdi Ziadi,Jarkko Nieminen,6-1; 6-1,R32,65,0,0,28,35,21,28,5,7,1,2,7,26,35,5,3,27,54,13,27,9,27,3,9,7,22,54
2010-04-05 00:00:00.000,Casablanca Morocco ATP World Tour 250,CLAY,2,Victor Hanescu,N/A Bye,Victor Hanescu,,R32,0,0,0,0,0,0,0,0,0,0,0,0,0,0,0,0,0,0,0,0,0,0,0,0,0,0,0
2010-04-05 00:00:00.000,Casablanca Morocco ATP World Tour 250,CLAY,2,Florent Serra,Santiago Ventura,Florent Serra,6-4; 6-3,R32,90,1,1,38,65,24,38,16,27,2,4,9,40,65,2,7,40,79,28,40,13,39,5,10,10,41,79
2010-04-05 00:00:00.000,Casablanca Morocco ATP World Tour 250,CLAY,2,Stephane Robert,Stefan Koubek,Stephane Robert,6-3; 5-7; 7-5,R32,127,0,4,63,113,42,63,23,50,9,14,16,65,113,5,4,61,105,39,61,18,44,6,13,17,57,105
2010-04-05 00:00:00.000,Casablanca Morocco ATP World Tour 250,CLAY,2,Marcel Granollers,Robin Haase,Marcel Granollers,7-6(7); 7-6(5),R32,122,1,2,45,80,33,45,17,35,3,6,12,50,80,4,5,54,96,35,54,20,42,3,6,12,55,96
2010-04-05 00:00:00.000,Casablanca Morocco ATP World Tour 250,CLAY,2,Guillermo Garcia-Lopez,N/A Bye,Guillermo Garcia-Lopez,,R32,0,0,0,0,0,0,0,0,0,0,0,0,0,0,0,0,0,0,0,0,0,0,0,0,0,0,0
2010-04-05 00:00:00.000,Casablanca Morocco ATP World Tour 250,CLAY,2,Stanislas Wawrinka,Martin Klizan,Stanislas Wawrinka,6-4; 0-6; 6-4,R16,122,4,1,60,80,38,60,11,20,4,8,13,49,80,6,5,45,92,32,45,24,47,8,11,13,56,92
2010-04-05 00:00:00.000,Casablanca Morocco ATP World Tour 250,CLAY,2,Reda El Amrani,Jan Hajek,Reda El Amrani,6-3; 2-6; 6-2,R16,108,13,6,62,107,44,62,19,45,10,13,13,63,107,1,2,55,76,32,55,11,21,6,10,12,43,76
2010-04-05 00:00:00.000,Casablanca Morocco ATP World Tour 250,CLAY,2,Lukasz Kubot,Arnaud Clement,Lukasz Kubot,6-4; 6-1,R16,97,1,8,42,66,24,42,11,24,3,6,8,35,66,1,3,25,54,13,25,9,29,3,10,9,22,54
2010-04-05 00:00:00.000,Casablanca Morocco ATP World Tour 250,CLAY,2,Potito Starace,Oscar Hernandez,Potito Starace,6-2; 6-1,R16,67,1,0,34,44,26,34,7,10,0,0,8,33,44,1,0,36,48,17,36,5,12,6,10,7,22,48
2010-04-05 00:00:00.000,Casablanca Morocco ATP World Tour 250,CLAY,2,Richard Gasquet,Andrey Golubev,Richard Gasquet,6-1; 6-1,R16,45,4,1,26,35,23,26,5,9,0,0,7,28,35,5,4,27,44,14,27,6,17,3,8,7,20,44
2010-04-05 00:00:00.000,Casablanca Morocco ATP World Tour 250,CLAY,2,Victor Hanescu,Jarkko Nieminen,Victor Hanescu,2-6; 6-3; 6-2,R16,103,7,3,63,88,49,63,8,25,7,10,13,57,88,0,0,49,63,30,49,8,14,3,7,12,38,63
2010-04-05 00:00:00.000,Casablanca Morocco ATP World Tour 250,CLAY,2,Florent Serra,Stephane Robert,Florent Serra,2-6; 6-1; 6-3,R16,85,5,2,46,74,33,46,16,28,3,5,12,49,74,5,1,44,74,30,44,12,30,6,10,12,42,74
2010-04-05 00:00:00.000,Casablanca Morocco ATP World Tour 250,CLAY,2,Guillermo Garcia-Lopez,Marcel Granollers,Guillermo Garcia-Lopez,6-3; 6-2,R16,87,2,3,27,47,23,27,11,20,0,1,9,34,47,0,0,41,62,21,41,9,21,7,11,8,30,62
2010-04-05 00:00:00.000,Casablanca Morocco ATP World Tour 250,CLAY,2,Stanislas Wawrinka,Reda El Amrani,Stanislas Wawrinka,6-3; 6-1,Q,62,6,0,22,39,19,22,13,17,0,0,8,32,39,3,8,26,54,16,26,11,28,3,7,8,27,54
2010-04-05 00:00:00.000,Casablanca Morocco ATP World Tour 250,CLAY,2,Potito Starace,Lukasz Kubot,Potito Starace,6-1; 6-0,Q,62,2,0,42,48,29,42,3,6,3,3,7,32,48,1,2,17,30,8,17,2,13,1,6,6,10,30
2010-04-05 00:00:00.000,Casablanca Morocco ATP World Tour 250,CLAY,2,Victor Hanescu,Richard Gasquet,Victor Hanescu,7-6(3); 4-6; 6-3,Q,154,7,2,78,108,60,78,15,30,8,9,16,75,108,4,7,66,115,47,66,27,49,5,6,15,74,115
2010-04-05 00:00:00.000,Casablanca Morocco ATP World Tour 250,CLAY,2,Florent Serra,Guillermo Garcia-Lopez,Florent Serra,6-2; 6-2,Q,75,4,0,37,53,26,37,10,16,5,5,8,36,53,0,3,28,48,17,28,8,20,6,10,8,25,48
2010-04-05 00:00:00.000,Casablanca Morocco ATP World Tour 250,CLAY,2,Stanislas Wawrinka,Potito Starace,Stanislas Wawrinka,6-4; 3-6; 6-4,S,154,7,3,60,93,42,60,17,33,6,9,15,59,93,1,0,78,104,46,78,14,26,6,9,14,60,104
2010-04-05 00:00:00.000,Casablanca Morocco ATP World Tour 250,CLAY,2,Victor Hanescu,Florent Serra,Victor Hanescu,6-4; 6-1,S,63,2,2,42,55,36,42,3,13,1,1,9,39,55,3,2,28,49,17,28,10,21,3,6,8,27,49
2010-04-05 00:00:00.000,Casablanca Morocco ATP World Tour 250,CLAY,2,Stanislas Wawrinka,Victor Hanescu,Stanislas Wawrinka,6-2; 6-3,F,78,3,2,30,57,24,30,13,27,4,5,9,37,57,0,2,37,49,22,37,4,12,5,9,8,26,49
2010-04-05 00:00:00.000,Houston TX; U.S.A. ATP World Tour 250,CLAY,2,Fernando Gonzalez,N/A Bye,Fernando Gonzalez,,R32,0,0,0,0,0,0,0,0,0,0,0,0,0,0,0,0,0,0,0,0,0,0,0,0,0,0,0
2010-04-05 00:00:00.000,Houston TX; U.S.A. ATP World Tour 250,CLAY,2,Kevin Anderson,Donald Young,Kevin Anderson,7-5; 6-3,R32,81,2,3,33,49,30,33,8,16,1,2,10,38,49,2,3,51,83,33,51,12,32,2,6,11,45,83
2010-04-05 00:00:00.000,Houston TX; U.S.A. ATP World Tour 250,CLAY,2,Dudi Sela,Jesse Levine,Dudi Sela,6-4; 7-6(6),R32,106,0,4,38,72,27,38,14,34,3,7,11,41,72,2,4,43,83,28,43,14,40,7,12,11,42,83
2010-04-05 00:00:00.000,Houston TX; U.S.A. ATP World Tour 250,CLAY,2,Horacio Zeballos,Taylor Dent,Horacio Zeballos,6-3 RET,R32,37,2,0,12,24,6,12,8,12,2,3,4,14,24,4,6,30,45,16,30,6,15,5,8,5,22,45
2010-04-05 00:00:00.000,Houston TX; U.S.A. ATP World Tour 250,CLAY,2,Lleyton Hewitt,N/A Bye,Lleyton Hewitt,,R32,0,0,0,0,0,0,0,0,0,0,0,0,0,0,0,0,0,0,0,0,0,0,0,0,0,0,0
2010-04-05 00:00:00.000,Houston TX; U.S.A. ATP World Tour 250,CLAY,2,Somdev Devvarman,Conor Niland,Somdev Devvarman,6-4; 6-2,R32,85,5,0,30,49,24,30,10,19,0,1,9,34,49,3,6,35,56,24,35,6,21,1,5,9,30,56
2010-04-05 00:00:00.000,Houston TX; U.S.A. ATP World Tour 250,CLAY,2,Juan Ignacio Chela,Rajeev Ram,Juan Ignacio Chela,6-2; 3-0 RET,R32,44,0,0,20,26,15,20,6,6,1,1,5,21,26,0,1,18,35,8,18,6,17,1,5,6,14,35
2010-04-05 00:00:00.000,Houston TX; U.S.A. ATP World Tour 250,CLAY,2,Eduardo Schwank,Marcos Daniel,Eduardo Schwank,6-3; 6-2,R32,71,5,1,37,50,32,37,6,13,2,2,9,38,50,3,4,29,50,20,29,7,21,7,10,8,27,50
2010-04-05 00:00:00.000,Houston TX; U.S.A. ATP World Tour 250,CLAY,2,Ryan Sweeting,Evgeny Korolev,Ryan Sweeting,6-3; 4-6; 6-2,R32,115,7,5,49,81,36,49,16,32,4,7,14,52,81,3,4,45,92,29,45,21,47,4,9,13,50,92
2010-04-05 00:00:00.000,Houston TX; U.S.A. ATP World Tour 250,CLAY,2,Nicolas Massu,Mischa Zverev,Nicolas Massu,6-4; 6-2,R32,90,3,4,38,55,26,38,10,17,5,7,9,36,55,0,2,44,56,21,44,5,12,4,9,9,26,56
2010-04-05 00:00:00.000,Houston TX; U.S.A. ATP World Tour 250,CLAY,2,Blaz Kavcic,Denis Istomin,Blaz Kavcic,6-3; 4-6; 6-3,R32,128,0,5,43,77,30,43,22,34,0,2,14,52,77,4,1,48,82,31,48,17,34,3,7,14,48,82
2010-04-05 00:00:00.000,Houston TX; U.S.A. ATP World Tour 250,CLAY,2,Sam Querrey,N/A Bye,Sam Querrey,,R32,0,0,0,0,0,0,0,0,0,0,0,0,0,0,0,0,0,0,0,0,0,0,0,0,0,0,0
2010-04-05 00:00:00.000,Houston TX; U.S.A. ATP World Tour 250,CLAY,2,Mikhail Kukushkin,Michael Yani,Mikhail Kukushkin,6-1; 7-5,R32,93,5,2,39,71,30,39,15,32,3,4,10,45,71,1,5,30,58,21,30,8,28,3,7,9,29,58
2010-04-05 00:00:00.000,Houston TX; U.S.A. ATP World Tour 250,CLAY,2,Wayne Odesnik,Jerzy Janowicz,Wayne Odesnik,6-3; 6-4,R32,105,1,2,38,64,26,38,16,26,3,4,10,42,64,1,6,49,80,30,49,14,31,7,10,9,44,80
2010-04-05 00:00:00.000,Houston TX; U.S.A. ATP World Tour 250,CLAY,2,Xavier Malisse,Nick Lindahl,Xavier Malisse,6-3; 7-5,R32,94,4,4,36,89,31,36,23,53,7,8,11,54,89,1,3,29,52,22,29,11,23,1,4,10,33,52
2010-04-05 00:00:00.000,Houston TX; U.S.A. ATP World Tour 250,CLAY,2,John Isner,N/A Bye,John Isner,,R32,0,0,0,0,0,0,0,0,0,0,0,0,0,0,0,0,0,0,0,0,0,0,0,0,0,0,0
2010-04-05 00:00:00.000,Houston TX; U.S.A. ATP World Tour 250,CLAY,2,Fernando Gonzalez,Kevin Anderson,Fernando Gonzalez,6-4; 4-6; 6-4,R16,115,2,3,58,89,43,58,20,31,4,5,15,63,89,2,3,53,77,42,53,14,24,0,2,15,56,77
2010-04-05 00:00:00.000,Houston TX; U.S.A. ATP World Tour 250,CLAY,2,Horacio Zeballos,Dudi Sela,Horacio Zeballos,6-3; 6-2,R16,54,3,2,32,43,31,32,5,11,0,0,9,36,43,3,4,27,44,19,27,5,17,1,4,8,24,44
2010-04-05 00:00:00.000,Houston TX; U.S.A. ATP World Tour 250,CLAY,2,Lleyton Hewitt,Somdev Devvarman,Lleyton Hewitt,1-6; 6-0; 7-6(2),R16,114,2,3,45,75,32,45,12,30,2,7,12,44,75,1,3,42,73,22,42,14,31,1,7,13,36,73
2010-04-05 00:00:00.000,Houston TX; U.S.A. ATP World Tour 250,CLAY,2,Juan Ignacio Chela,Eduardo Schwank,Juan Ignacio Chela,6-1; 6-7(5); 6-1,R16,122,4,5,46,83,31,46,23,37,6,7,12,54,83,0,6,59,90,28,59,16,31,4,11,14,44,90
2010-04-05 00:00:00.000,Houston TX; U.S.A. ATP World Tour 250,CLAY,2,Nicolas Massu,Ryan Sweeting,Nicolas Massu,6-7(5); 7-6(3); 6-4,R16,205,2,4,90,123,59,90,13,33,8,14,17,72,123,1,3,92,127,51,92,17,35,7,14,17,68,127
2010-04-05 00:00:00.000,Houston TX; U.S.A. ATP World Tour 250,CLAY,2,Sam Querrey,Blaz Kavcic,Sam Querrey,6-2; 6-1,R16,60,6,4,29,47,25,29,9,18,1,1,8,34,47,1,4,24,48,11,24,13,24,2,6,7,24,48
2010-04-05 00:00:00.000,Houston TX; U.S.A. ATP World Tour 250,CLAY,2,Wayne Odesnik,Mikhail Kukushkin,Wayne Odesnik,6-1; 7-5,R16,111,2,6,37,64,26,37,17,27,7,8,10,43,64,0,0,45,75,27,45,12,30,12,16,9,39,75
2010-04-05 00:00:00.000,Houston TX; U.S.A. ATP World Tour 250,CLAY,2,Xavier Malisse,John Isner,Xavier Malisse,7-6(3); 6-7(7); 7-6(3),R16,156,9,3,67,114,55,67,26,47,1,3,18,81,114,14,5,86,126,59,86,24,40,5,7,18,83,126
2010-04-05 00:00:00.000,Houston TX; U.S.A. ATP World Tour 250,CLAY,2,Horacio Zeballos,Fernando Gonzalez,Horacio Zeballos,6-4; 6-4,Q,89,4,3,43,69,31,43,17,26,6,6,10,48,69,6,2,35,61,24,35,15,26,5,7,10,39,61
2010-04-05 00:00:00.000,Houston TX; U.S.A. ATP World Tour 250,CLAY,2,Juan Ignacio Chela,Lleyton Hewitt,Juan Ignacio Chela,6-4; 6-3,Q,72,3,3,32,46,23,32,8,14,0,2,9,31,46,1,4,35,57,19,35,8,22,3,8,10,27,57
2010-04-05 00:00:00.000,Houston TX; U.S.A. ATP World Tour 250,CLAY,2,Sam Querrey,Nicolas Massu,Sam Querrey,6-3; 3-6; 6-4,Q,110,10,6,40,74,35,40,16,34,0,2,14,51,74,0,2,53,83,40,53,11,30,4,7,14,51,83
2010-04-05 00:00:00.000,Houston TX; U.S.A. ATP World Tour 250,CLAY,2,Wayne Odesnik,Xavier Malisse,Wayne Odesnik,6-4; 6-1,Q,82,5,2,42,69,28,42,16,27,11,12,9,44,69,4,2,31,52,19,31,9,21,4,8,8,28,52
2010-04-05 00:00:00.000,Houston TX; U.S.A. ATP World Tour 250,CLAY,2,Juan Ignacio Chela,Horacio Zeballos,Juan Ignacio Chela,7-5; 6-2,S,91,0,1,53,73,30,53,13,20,6,9,10,43,73,2,3,42,59,24,42,6,17,2,8,10,30,59
2010-04-05 00:00:00.000,Houston TX; U.S.A. ATP World Tour 250,CLAY,2,Sam Querrey,Wayne Odesnik,Sam Querrey,7-6(3); 1-6; 7-5,S,168,12,7,55,88,42,55,15,33,2,6,15,57,88,7,3,62,103,44,62,22,41,4,7,16,66,103
2010-04-05 00:00:00.000,Houston TX; U.S.A. ATP World Tour 250,CLAY,2,Juan Ignacio Chela,Sam Querrey,Juan Ignacio Chela,5-7; 6-4; 6-3,F,145,2,1,91,115,60,91,10,24,4,7,16,70,115,11,3,58,101,39,58,20,43,9,13,15,59,101
2010-04-11 00:00:00.000,ATP World Tour Masters 1000 Monte Carlo Monaco ATP World Tour Masters 1000,CLAY,2,Novak Djokovic,N/A Bye,Novak Djokovic,,R64,0,0,0,0,0,0,0,0,0,0,0,0,0,0,0,0,0,0,0,0,0,0,0,0,0,0,0
2010-04-11 00:00:00.000,ATP World Tour Masters 1000 Monte Carlo Monaco ATP World Tour Masters 1000,CLAY,2,Florent Serra,Stephane Robert,Florent Serra,7-6(6); 3-6; 6-4,R64,122,6,5,71,123,43,71,29,52,7,12,16,72,123,5,3,60,95,43,60,15,35,2,6,15,58,95
2010-04-11 00:00:00.000,ATP World Tour Masters 1000 Monte Carlo Monaco ATP World Tour Masters 1000,CLAY,2,Ernests Gulbis,Marco Chiudinelli,Ernests Gulbis,6-3; 6-2,R64,71,5,0,30,51,21,30,14,21,0,0,8,35,51,2,2,29,57,17,29,13,28,4,8,9,30,57
2010-04-11 00:00:00.000,ATP World Tour Masters 1000 Monte Carlo Monaco ATP World Tour Masters 1000,CLAY,2,Stanislas Wawrinka,Victor Hanescu,Stanislas Wawrinka,6-2; 6-4,R64,69,11,1,33,50,30,33,9,17,3,3,9,39,50,0,1,48,63,28,48,8,15,5,8,9,36,63
2010-04-11 00:00:00.000,ATP World Tour Masters 1000 Monte Carlo Monaco ATP World Tour Masters 1000,CLAY,2,Tommy Robredo,Horacio Zeballos,Tommy Robredo,6-3; 6-3,R64,69,3,3,34,47,26,34,7,13,0,1,9,33,47,0,2,37,55,22,37,7,18,5,9,9,29,55
2010-04-11 00:00:00.000,ATP World Tour Masters 1000 Monte Carlo Monaco ATP World Tour Masters 1000,CLAY,2,Viktor Troicki,Lukasz Kubot,Viktor Troicki,4-6; 6-2; 6-2,R64,111,6,0,54,81,37,54,13,27,2,5,13,50,81,4,6,45,80,26,45,14,35,3,9,13,40,80
2010-04-11 00:00:00.000,ATP World Tour Masters 1000 Monte Carlo Monaco ATP World Tour Masters 1000,CLAY,2,David Nalbandian,Andreas Beck,David Nalbandian,6-3; 6-1,R64,68,8,1,22,43,17,22,17,21,1,1,8,34,43,1,7,30,54,17,30,10,24,3,7,8,27,54
2010-04-11 00:00:00.000,ATP World Tour Masters 1000 Monte Carlo Monaco ATP World Tour Masters 1000,CLAY,2,Mikhail Youzhny,N/A Bye,Mikhail Youzhny,,R64,0,0,0,0,0,0,0,0,0,0,0,0,0,0,0,0,0,0,0,0,0,0,0,0,0,0,0
2010-04-11 00:00:00.000,ATP World Tour Masters 1000 Monte Carlo Monaco ATP World Tour Masters 1000,CLAY,2,Marin Cilic,N/A Bye,Marin Cilic,,R64,0,0,0,0,0,0,0,0,0,0,0,0,0,0,0,0,0,0,0,0,0,0,0,0,0,0,0
2010-04-11 00:00:00.000,ATP World Tour Masters 1000 Monte Carlo Monaco ATP World Tour Masters 1000,CLAY,2,Igor Andreev,Simone Bolelli,Igor Andreev,6-3; 6-4,R64,92,3,4,43,74,31,43,16,31,5,6,10,47,74,1,1,35,53,21,35,8,18,3,6,9,29,53
2010-04-11 00:00:00.000,ATP World Tour Masters 1000 Monte Carlo Monaco ATP World Tour Masters 1000,CLAY,2,Andreas Seppi,Olivier Rochus,Andreas Seppi,7-6(3) RET,R64,68,1,0,34,43,22,34,4,9,1,2,6,26,43,1,0,31,52,17,31,11,21,2,3,6,28,52
2010-04-11 00:00:00.000,ATP World Tour Masters 1000 Monte Carlo Monaco ATP World Tour Masters 1000,CLAY,2,Albert Montanes,Marcos Baghdatis,Albert Montanes,6-4; 6-2,R64,75,2,1,55,68,37,55,6,13,8,8,9,43,68,2,0,39,54,25,39,6,15,1,4,9,31,54
2010-04-11 00:00:00.000,ATP World Tour Masters 1000 Monte Carlo Monaco ATP World Tour Masters 1000,CLAY,2,Tomas Berdych,Feliciano Lopez,Tomas Berdych,6-3; 6-1,R64,65,7,3,26,42,21,26,10,16,0,1,8,31,42,1,4,20,45,11,20,9,25,2,7,8,20,45
2010-04-11 00:00:00.000,ATP World Tour Masters 1000 Monte Carlo Monaco ATP World Tour Masters 1000,CLAY,2,Richard Gasquet,Daniel Gimeno-Traver,Richard Gasquet,6-2; 4-6; 6-2,R64,126,2,5,48,84,39,48,17,36,7,9,13,56,84,0,3,51,93,33,51,18,42,5,10,13,51,93
2010-04-11 00:00:00.000,ATP World Tour Masters 1000 Monte Carlo Monaco ATP World Tour Masters 1000,CLAY,2,Julien Benneteau,Alexandr Dolgopolov,Julien Benneteau,6-4; 5-7; 6-2,R64,148,5,4,77,108,46,77,16,31,11,15,15,62,108,1,3,59,102,38,59,19,43,8,14,15,57,102
2010-04-11 00:00:00.000,ATP World Tour Masters 1000 Monte Carlo Monaco ATP World Tour Masters 1000,CLAY,2,Fernando Verdasco,N/A Bye,Fernando Verdasco,,R64,0,0,0,0,0,0,0,0,0,0,0,0,0,0,0,0,0,0,0,0,0,0,0,0,0,0,0
2010-04-11 00:00:00.000,ATP World Tour Masters 1000 Monte Carlo Monaco ATP World Tour Masters 1000,CLAY,2,Ivan Ljubicic,N/A Bye,Ivan Ljubicic,,R64,0,0,0,0,0,0,0,0,0,0,0,0,0,0,0,0,0,0,0,0,0,0,0,0,0,0,0
2010-04-11 00:00:00.000,ATP World Tour Masters 1000 Monte Carlo Monaco ATP World Tour Masters 1000,CLAY,2,Michael Llodra,Fabio Fognini,Michael Llodra,6-3; 6-3,R64,74,7,2,39,60,31,39,10,21,1,1,9,41,60,0,3,38,60,24,38,10,22,5,8,9,34,60
2010-04-11 00:00:00.000,ATP World Tour Masters 1000 Monte Carlo Monaco ATP World Tour Masters 1000,CLAY,2,Andrey Golubev,Jeremy Chardy,Andrey Golubev,6-2; 7-6(2),R64,89,2,4,34,65,26,34,12,31,1,4,10,38,65,1,1,35,65,17,35,12,30,4,9,10,29,65
2010-04-11 00:00:00.000,ATP World Tour Masters 1000 Monte Carlo Monaco ATP World Tour Masters 1000,CLAY,2,David Ferrer,Peter Luczak,David Ferrer,6-2; 6-4,R64,97,1,1,47,69,29,47,15,22,3,4,9,44,69,0,2,24,56,13,24,17,32,3,7,9,30,56
2010-04-11 00:00:00.000,ATP World Tour Masters 1000 Monte Carlo Monaco ATP World Tour Masters 1000,CLAY,2,Jurgen Melzer,Paul-Henri Mathieu,Jurgen Melzer,6-3; 6-2,R64,89,3,2,23,49,19,23,14,26,2,4,8,33,49,2,1,37,72,23,37,10,35,6,12,9,33,72
2010-04-11 00:00:00.000,ATP World Tour Masters 1000 Monte Carlo Monaco ATP World Tour Masters 1000,CLAY,2,Philipp Petzschner,Guillermo Garcia-Lopez,Philipp Petzschner,6-3; 2-6; 6-2,R64,138,6,1,40,81,30,40,21,41,3,5,13,51,81,2,6,69,102,43,69,15,33,7,10,12,58,102
2010-04-11 00:00:00.000,ATP World Tour Masters 1000 Monte Carlo Monaco ATP World Tour Masters 1000,CLAY,2,Philipp Kohlschreiber,Thomaz Bellucci,Philipp Kohlschreiber,2-6; 6-3; 7-6(3),R64,144,3,2,55,92,35,55,16,37,4,10,14,51,92,5,2,65,109,43,65,16,44,5,11,15,59,109
2010-04-11 00:00:00.000,ATP World Tour Masters 1000 Monte Carlo Monaco ATP World Tour Masters 1000,CLAY,2,Andy Murray,N/A Bye,Andy Murray,,R64,0,0,0,0,0,0,0,0,0,0,0,0,0,0,0,0,0,0,0,0,0,0,0,0,0,0,0
2010-04-11 00:00:00.000,ATP World Tour Masters 1000 Monte Carlo Monaco ATP World Tour Masters 1000,CLAY,2,Jo-Wilfried Tsonga,N/A Bye,Jo-Wilfried Tsonga,,R64,0,0,0,0,0,0,0,0,0,0,0,0,0,0,0,0,0,0,0,0,0,0,0,0,0,0,0
2010-04-11 00:00:00.000,ATP World Tour Masters 1000 Monte Carlo Monaco ATP World Tour Masters 1000,CLAY,2,Nicolas Almagro,Simon Greul,Nicolas Almagro,3-6; 7-5; 6-2,R64,118,2,2,45,98,31,45,27,53,7,11,14,58,98,2,6,45,84,31,45,14,39,5,11,15,45,84
2010-04-11 00:00:00.000,ATP World Tour Masters 1000 Monte Carlo Monaco ATP World Tour Masters 1000,CLAY,2,Benjamin Becker,Bernard Tomic,Benjamin Becker,6-4; 6-2,R64,76,11,0,36,57,26,36,13,21,2,3,9,39,57,5,3,52,76,29,52,11,24,7,11,9,40,76
2010-04-11 00:00:00.000,ATP World Tour Masters 1000 Monte Carlo Monaco ATP World Tour Masters 1000,CLAY,2,Juan Carlos Ferrero,Marcel Granollers,Juan Carlos Ferrero,6-0; 6-3,R64,69,0,1,31,42,23,31,7,11,0,1,8,30,42,1,5,25,52,13,25,9,27,4,9,7,22,52
2010-04-11 00:00:00.000,ATP World Tour Masters 1000 Monte Carlo Monaco ATP World Tour Masters 1000,CLAY,2,Juan Monaco,Jarkko Nieminen,Juan Monaco,7-5; 7-5,R64,116,5,1,48,71,28,48,14,23,4,8,12,42,71,1,2,65,89,30,65,13,24,9,15,12,43,89
2010-04-11 00:00:00.000,ATP World Tour Masters 1000 Monte Carlo Monaco ATP World Tour Masters 1000,CLAY,2,Michael Berrer,Evgeny Korolev,Michael Berrer,6-1; 6-4,R64,64,3,3,38,53,26,38,8,15,5,7,9,34,53,2,5,23,51,10,23,13,28,2,7,8,23,51
2010-04-11 00:00:00.000,ATP World Tour Masters 1000 Monte Carlo Monaco ATP World Tour Masters 1000,CLAY,2,Thiemo de Bakker,Eduardo Schwank,Thiemo de Bakker,6-3; 7-5,R64,94,10,1,40,65,29,40,15,25,3,4,11,44,65,2,3,41,68,29,41,10,27,3,6,10,39,68
2010-04-11 00:00:00.000,ATP World Tour Masters 1000 Monte Carlo Monaco ATP World Tour Masters 1000,CLAY,2,Rafael Nadal,N/A Bye,Rafael Nadal,,R64,0,0,0,0,0,0,0,0,0,0,0,0,0,0,0,0,0,0,0,0,0,0,0,0,0,0,0
2010-04-11 00:00:00.000,ATP World Tour Masters 1000 Monte Carlo Monaco ATP World Tour Masters 1000,CLAY,2,Novak Djokovic,Florent Serra,Novak Djokovic,6-2; 6-3,R32,83,2,4,42,68,25,42,15,26,7,9,9,40,68,2,5,31,61,17,31,10,30,6,11,8,27,61
2010-04-11 00:00:00.000,ATP World Tour Masters 1000 Monte Carlo Monaco ATP World Tour Masters 1000,CLAY,2,Stanislas Wawrinka,Ernests Gulbis,Stanislas Wawrinka,6-1; 6-4,R32,71,5,1,43,64,32,43,12,21,3,3,9,44,64,6,6,26,40,18,26,4,14,0,3,8,22,40
2010-04-11 00:00:00.000,ATP World Tour Masters 1000 Monte Carlo Monaco ATP World Tour Masters 1000,CLAY,2,Tommy Robredo,Viktor Troicki,Tommy Robredo,6-4; 6-3,R32,75,0,0,40,54,29,40,8,14,2,3,9,37,54,5,0,28,53,18,28,12,25,2,6,10,30,53
2010-04-11 00:00:00.000,ATP World Tour Masters 1000 Monte Carlo Monaco ATP World Tour Masters 1000,CLAY,2,David Nalbandian,Mikhail Youzhny,David Nalbandian,4-6; 6-3; 7-6(5),R32,175,2,5,65,101,45,65,16,36,7,11,15,61,101,5,3,90,136,53,90,22,46,14,19,16,75,136
2010-04-11 00:00:00.000,ATP World Tour Masters 1000 Monte Carlo Monaco ATP World Tour Masters 1000,CLAY,2,Marin Cilic,Igor Andreev,Marin Cilic,6-7(4); 6-1; 6-4,R32,171,5,1,55,111,35,55,30,56,14,18,14,65,111,3,4,76,117,42,76,17,41,11,19,15,59,117
2010-04-11 00:00:00.000,ATP World Tour Masters 1000 Monte Carlo Monaco ATP World Tour Masters 1000,CLAY,2,Albert Montanes,Andreas Seppi,Albert Montanes,7-6(1); 3-6; 6-0,R32,125,4,3,51,77,33,51,11,26,3,8,13,44,77,2,1,77,102,38,77,12,25,15,22,14,50,102
2010-04-11 00:00:00.000,ATP World Tour Masters 1000 Monte Carlo Monaco ATP World Tour Masters 1000,CLAY,2,Tomas Berdych,Richard Gasquet,Tomas Berdych,6-2; 6-0,R32,57,4,1,27,43,23,27,8,16,3,3,7,31,43,0,0,21,39,11,21,5,18,2,7,7,16,39
2010-04-11 00:00:00.000,ATP World Tour Masters 1000 Monte Carlo Monaco ATP World Tour Masters 1000,CLAY,2,Fernando Verdasco,Julien Benneteau,Fernando Verdasco,6-2; 6-1,R32,75,1,1,25,44,20,25,11,19,1,1,7,31,44,1,5,26,53,14,26,9,27,4,9,8,23,53
2010-04-11 00:00:00.000,ATP World Tour Masters 1000 Monte Carlo Monaco ATP World Tour Masters 1000,CLAY,2,Ivan Ljubicic,Michael Llodra,Ivan Ljubicic,6-3; 7-6(3),R32,99,8,0,42,71,33,42,14,29,3,5,11,47,71,8,2,48,87,29,48,21,39,9,12,10,50,87
2010-04-11 00:00:00.000,ATP World Tour Masters 1000 Monte Carlo Monaco ATP World Tour Masters 1000,CLAY,2,David Ferrer,Andrey Golubev,David Ferrer,6-3; 6-2,R32,70,1,2,26,45,21,26,12,19,1,2,9,33,45,0,1,31,53,18,31,9,22,7,11,8,27,53
2010-04-11 00:00:00.000,ATP World Tour Masters 1000 Monte Carlo Monaco ATP World Tour Masters 1000,CLAY,2,Philipp Petzschner,Jurgen Melzer,Philipp Petzschner,7-6(4); 6-2,R32,93,5,1,39,85,26,39,25,46,3,5,10,51,85,1,2,49,73,30,49,10,24,7,11,10,40,73
2010-04-11 00:00:00.000,ATP World Tour Masters 1000 Monte Carlo Monaco ATP World Tour Masters 1000,CLAY,2,Philipp Kohlschreiber,Andy Murray,Philipp Kohlschreiber,6-2; 6-1,R32,64,2,1,27,37,23,27,6,10,0,0,7,29,37,1,2,17,46,10,17,12,29,2,7,8,22,46
2010-04-11 00:00:00.000,ATP World Tour Masters 1000 Monte Carlo Monaco ATP World Tour Masters 1000,CLAY,2,Jo-Wilfried Tsonga,Nicolas Almagro,Jo-Wilfried Tsonga,7-6(5); 7-5,R32,125,2,3,49,94,33,49,27,45,10,11,12,60,94,0,0,51,78,36,51,14,27,2,4,12,50,78
2010-04-11 00:00:00.000,ATP World Tour Masters 1000 Monte Carlo Monaco ATP World Tour Masters 1000,CLAY,2,Juan Carlos Ferrero,Benjamin Becker,Juan Carlos Ferrero,6-3; 6-4,R32,80,2,0,36,51,27,36,14,15,0,0,10,41,51,3,2,40,68,28,40,13,28,7,9,9,41,68
2010-04-11 00:00:00.000,ATP World Tour Masters 1000 Monte Carlo Monaco ATP World Tour Masters 1000,CLAY,2,Michael Berrer,Juan Monaco,Michael Berrer,6-4; 6-4,R32,101,2,1,44,61,31,44,9,17,2,3,10,40,61,6,2,48,71,33,48,9,23,6,9,10,42,71
2010-04-11 00:00:00.000,ATP World Tour Masters 1000 Monte Carlo Monaco ATP World Tour Masters 1000,CLAY,2,Rafael Nadal,Thiemo de Bakker,Rafael Nadal,6-1; 6-0,R32,60,2,1,24,42,18,24,12,18,3,3,7,30,42,0,4,14,34,6,14,4,20,1,6,6,10,34
2010-04-11 00:00:00.000,ATP World Tour Masters 1000 Monte Carlo Monaco ATP World Tour Masters 1000,CLAY,2,Novak Djokovic,Stanislas Wawrinka,Novak Djokovic,6-4; 6-4,R16,101,2,1,43,61,28,43,10,18,3,5,10,38,61,4,1,39,66,23,39,14,27,6,10,10,37,66
2010-04-11 00:00:00.000,ATP World Tour Masters 1000 Monte Carlo Monaco ATP World Tour Masters 1000,CLAY,2,David Nalbandian,Tommy Robredo,David Nalbandian,6-3; 6-4,R16,89,0,2,45,69,35,45,11,24,6,7,10,46,69,0,1,45,57,26,45,6,12,0,3,9,32,57
2010-04-11 00:00:00.000,ATP World Tour Masters 1000 Monte Carlo Monaco ATP World Tour Masters 1000,CLAY,2,Albert Montanes,Marin Cilic,Albert Montanes,6-4; 6-4,R16,96,1,2,35,59,27,35,12,24,7,9,10,39,59,3,2,38,61,25,38,8,23,4,8,10,33,61
2010-04-11 00:00:00.000,ATP World Tour Masters 1000 Monte Carlo Monaco ATP World Tour Masters 1000,CLAY,2,Fernando Verdasco,Tomas Berdych,Fernando Verdasco,5-7; 6-3; 6-2,R16,153,7,4,60,97,38,60,22,37,2,5,14,60,97,2,5,51,93,37,51,15,42,4,10,15,52,93
2010-04-11 00:00:00.000,ATP World Tour Masters 1000 Monte Carlo Monaco ATP World Tour Masters 1000,CLAY,2,David Ferrer,Ivan Ljubicic,David Ferrer,6-0; 7-6(4),R16,91,3,0,42,56,30,42,10,14,1,2,9,40,56,8,0,38,72,26,38,14,34,8,12,9,40,72
2010-04-11 00:00:00.000,ATP World Tour Masters 1000 Monte Carlo Monaco ATP World Tour Masters 1000,CLAY,2,Philipp Kohlschreiber,Philipp Petzschner,Philipp Kohlschreiber,6-3; 6-4,R16,93,2,1,43,61,32,43,10,18,2,2,10,42,61,0,0,44,73,30,44,12,29,9,11,9,42,73
2010-04-11 00:00:00.000,ATP World Tour Masters 1000 Monte Carlo Monaco ATP World Tour Masters 1000,CLAY,2,Juan Carlos Ferrero,Jo-Wilfried Tsonga,Juan Carlos Ferrero,6-1; 3-6; 7-5,R16,135,0,1,57,79,37,57,16,22,0,2,14,53,79,8,5,55,91,39,55,15,36,7,11,14,54,91
2010-04-11 00:00:00.000,ATP World Tour Masters 1000 Monte Carlo Monaco ATP World Tour Masters 1000,CLAY,2,Rafael Nadal,Michael Berrer,Rafael Nadal,6-0; 6-1,R16,54,2,1,27,38,21,27,8,11,0,0,7,29,38,0,1,16,31,6,16,3,15,1,6,6,9,31
2010-04-11 00:00:00.000,ATP World Tour Masters 1000 Monte Carlo Monaco ATP World Tour Masters 1000,CLAY,2,Novak Djokovic,David Nalbandian,Novak Djokovic,6-2; 6-3,Q,80,2,0,29,50,20,29,13,21,2,3,8,33,50,2,3,28,52,13,28,9,24,3,8,9,22,52
2010-04-11 00:00:00.000,ATP World Tour Masters 1000 Monte Carlo Monaco ATP World Tour Masters 1000,CLAY,2,Fernando Verdasco,Albert Montanes,Fernando Verdasco,6-3; 6-7(4); 6-0,Q,126,5,3,59,84,43,59,9,25,1,4,13,52,84,2,6,61,101,38,61,14,40,9,17,14,52,101
2010-04-11 00:00:00.000,ATP World Tour Masters 1000 Monte Carlo Monaco ATP World Tour Masters 1000,CLAY,2,David Ferrer,Philipp Kohlschreiber,David Ferrer,7-5; 7-6(1),Q,121,1,2,31,65,21,31,20,34,3,7,12,41,65,2,2,48,77,30,48,10,29,3,8,12,40,77
2010-04-11 00:00:00.000,ATP World Tour Masters 1000 Monte Carlo Monaco ATP World Tour Masters 1000,CLAY,2,Rafael Nadal,Juan Carlos Ferrero,Rafael Nadal,6-4; 6-2,Q,95,2,0,32,48,25,32,9,16,0,1,8,34,48,1,1,43,60,26,43,7,17,4,8,9,33,60
2010-04-11 00:00:00.000,ATP World Tour Masters 1000 Monte Carlo Monaco ATP World Tour Masters 1000,CLAY,2,Fernando Verdasco,Novak Djokovic,Fernando Verdasco,6-2; 6-2,S,92,4,1,35,45,25,35,5,10,2,3,8,30,45,0,5,40,66,21,40,8,26,7,12,8,29,66
2010-04-11 00:00:00.000,ATP World Tour Masters 1000 Monte Carlo Monaco ATP World Tour Masters 1000,CLAY,2,Rafael Nadal,David Ferrer,Rafael Nadal,6-2; 6-3,S,75,2,2,35,50,23,35,8,15,2,4,8,31,50,1,2,29,48,15,29,7,19,3,9,9,22,48
2010-04-11 00:00:00.000,ATP World Tour Masters 1000 Monte Carlo Monaco ATP World Tour Masters 1000,CLAY,2,Rafael Nadal,Fernando Verdasco,Rafael Nadal,6-0; 6-1,F,86,2,1,31,45,20,31,9,14,5,5,6,29,45,2,3,31,53,12,31,7,22,8,14,7,19,53
2010-04-19 00:00:00.000,Barcelona Spain ATP World Tour 500,CLAY,2,Teymuraz Gabashvili,N/A Bye,Teymuraz Gabashvili,,R64,0,0,0,0,0,0,0,0,0,0,0,0,0,0,0,0,0,0,0,0,0,0,0,0,0,0,0
2010-04-19 00:00:00.000,Barcelona Spain ATP World Tour 500,CLAY,2,Guillermo Garcia-Lopez,Christophe Rochus,Guillermo Garcia-Lopez,5-7; 6-1; 6-3,R64,120,3,3,41,70,30,41,16,29,1,5,14,46,70,1,2,57,98,33,57,18,41,6,13,14,51,98
2010-04-19 00:00:00.000,Barcelona Spain ATP World Tour 500,CLAY,2,Victor Hanescu,Andreas Beck,Victor Hanescu,6-1; 6-2,R64,67,4,0,30,40,25,30,7,10,0,0,8,32,40,2,3,34,60,21,34,10,26,7,11,7,31,60
2010-04-19 00:00:00.000,Barcelona Spain ATP World Tour 500,CLAY,2,Thomaz Bellucci,Jarkko Nieminen,Thomaz Bellucci,6-4; 6-4,R64,88,2,0,40,60,26,40,9,20,2,4,10,35,60,1,2,46,62,28,46,6,16,3,7,10,34,62
2010-04-19 00:00:00.000,Barcelona Spain ATP World Tour 500,CLAY,2,Simone Bolelli,Tommy Robredo,Simone Bolelli,6-7(7); 6-4; 3-1 RET,R64,131,5,1,65,97,44,65,16,32,6,8,13,60,97,2,4,50,83,35,50,18,33,3,7,13,53,83
2010-04-19 00:00:00.000,Barcelona Spain ATP World Tour 500,CLAY,2,Alberto Martin,Mikhail Kukushkin,Alberto Martin,7-5; 6-4,R64,103,0,3,44,67,31,44,11,23,4,6,11,42,67,1,0,42,68,26,42,14,26,2,6,11,40,68
2010-04-19 00:00:00.000,Barcelona Spain ATP World Tour 500,CLAY,2,Marcel Granollers,Lukasz Kubot,Marcel Granollers,6-4; 6-3,R64,89,2,2,28,52,25,28,14,24,1,1,9,39,52,1,6,46,68,30,46,9,22,4,7,10,39,68
2010-04-19 00:00:00.000,Barcelona Spain ATP World Tour 500,CLAY,2,David Ferrer,N/A Bye,David Ferrer,,R64,0,0,0,0,0,0,0,0,0,0,0,0,0,0,0,0,0,0,0,0,0,0,0,0,0,0,0
2010-04-19 00:00:00.000,Barcelona Spain ATP World Tour 500,CLAY,2,Fernando Gonzalez,N/A Bye,Fernando Gonzalez,,R64,0,0,0,0,0,0,0,0,0,0,0,0,0,0,0,0,0,0,0,0,0,0,0,0,0,0,0
2010-04-19 00:00:00.000,Barcelona Spain ATP World Tour 500,CLAY,2,Albert Ramos,Michael Russell,Albert Ramos,6-4; 6-3,R64,81,1,0,45,56,30,45,6,11,4,6,9,36,56,1,0,38,54,21,38,8,16,0,5,10,29,54
2010-04-19 00:00:00.000,Barcelona Spain ATP World Tour 500,CLAY,2,Ernests Gulbis,Peter Luczak,Ernests Gulbis,7-6(4); 6-3,R64,108,11,1,37,62,35,37,17,25,1,1,11,52,62,4,1,39,81,26,39,25,42,12,13,10,51,81
2010-04-19 00:00:00.000,Barcelona Spain ATP World Tour 500,CLAY,2,Jeremy Chardy,Albert Montanes,Jeremy Chardy,6-3; 7-6(1),R64,82,7,0,40,64,28,40,17,24,0,1,11,45,64,2,0,38,55,25,38,10,17,1,3,10,35,55
2010-04-19 00:00:00.000,Barcelona Spain ATP World Tour 500,CLAY,2,Jurgen Melzer,Nicolas Lapentti,Jurgen Melzer,6-3; 6-3,R64,76,7,5,41,67,32,41,13,26,10,10,9,45,67,5,0,28,47,18,28,10,19,1,4,9,28,47
2010-04-19 00:00:00.000,Barcelona Spain ATP World Tour 500,CLAY,2,Oscar Hernandez,Illya Marchenko,Oscar Hernandez,6-7(2); 6-2; 6-4,R64,157,3,0,64,93,43,64,16,29,4,7,15,59,93,1,8,64,108,41,64,16,44,10,16,15,57,108
2010-04-19 00:00:00.000,Barcelona Spain ATP World Tour 500,CLAY,2,Richard Gasquet,Igor Andreev,Richard Gasquet,7-6(5); 6-4,R64,102,6,2,46,70,32,46,9,24,2,5,11,41,70,4,2,38,76,23,38,18,38,1,5,11,41,76
2010-04-19 00:00:00.000,Barcelona Spain ATP World Tour 500,CLAY,2,Fernando Verdasco,N/A Bye,Fernando Verdasco,,R64,0,0,0,0,0,0,0,0,0,0,0,0,0,0,0,0,0,0,0,0,0,0,0,0,0,0,0
2010-04-19 00:00:00.000,Barcelona Spain ATP World Tour 500,CLAY,2,Juan Carlos Ferrero,N/A Bye,Juan Carlos Ferrero,,R64,0,0,0,0,0,0,0,0,0,0,0,0,0,0,0,0,0,0,0,0,0,0,0,0,0,0,0
2010-04-19 00:00:00.000,Barcelona Spain ATP World Tour 500,CLAY,2,Sergiy Stakhovsky,Mischa Zverev,Sergiy Stakhovsky,4-6; 6-4; 6-2,R64,116,4,0,59,93,39,59,18,34,5,8,14,57,93,1,0,51,81,32,51,15,30,1,6,14,47,81
2010-04-19 00:00:00.000,Barcelona Spain ATP World Tour 500,CLAY,2,Thiemo de Bakker,Alejandro Falla,Thiemo de Bakker,6-1; 6-0,R64,44,3,0,24,41,16,24,14,17,0,0,7,30,41,0,2,20,34,9,20,2,14,0,5,6,11,34
2010-04-19 00:00:00.000,Barcelona Spain ATP World Tour 500,CLAY,2,Daniel Gimeno-Traver,Juan Monaco,Daniel Gimeno-Traver,6-2; 3-6; 6-2,R64,123,7,2,53,90,40,53,17,37,12,13,12,57,90,2,7,56,92,38,56,15,36,6,10,13,53,92
2010-04-19 00:00:00.000,Barcelona Spain ATP World Tour 500,CLAY,2,Nicolas Almagro,Santiago Ventura,Nicolas Almagro,6-1; 6-2,R64,60,10,1,24,39,21,24,11,15,0,0,8,32,39,0,1,21,45,11,21,11,24,3,7,7,22,45
2010-04-19 00:00:00.000,Barcelona Spain ATP World Tour 500,CLAY,2,Simon Greul,Pere Riba,Simon Greul,6-4; 6-4,R64,86,1,1,40,64,28,40,15,24,2,3,10,43,64,3,1,35,60,23,35,11,25,3,6,10,34,60
2010-04-19 00:00:00.000,Barcelona Spain ATP World Tour 500,CLAY,2,Jan Hajek,Potito Starace,Jan Hajek,6-1; 6-4,R64,87,1,0,41,65,28,41,14,24,6,7,9,42,65,1,0,53,76,27,53,12,23,9,13,8,39,76
2010-04-19 00:00:00.000,Barcelona Spain ATP World Tour 500,CLAY,2,Jo-Wilfried Tsonga,N/A Bye,Jo-Wilfried Tsonga,,R64,0,0,0,0,0,0,0,0,0,0,0,0,0,0,0,0,0,0,0,0,0,0,0,0,0,0,0
2010-04-19 00:00:00.000,Barcelona Spain ATP World Tour 500,CLAY,2,Ivan Navarro,N/A Bye,Ivan Navarro,,R64,0,0,0,0,0,0,0,0,0,0,0,0,0,0,0,0,0,0,0,0,0,0,0,0,0,0,0
2010-04-19 00:00:00.000,Barcelona Spain ATP World Tour 500,CLAY,2,Pablo Cuevas,Horacio Zeballos,Pablo Cuevas,7-6(2); 6-2,R64,105,6,2,54,84,36,54,16,30,7,9,10,52,84,1,1,48,71,29,48,10,23,4,8,10,39,71
2010-04-19 00:00:00.000,Barcelona Spain ATP World Tour 500,CLAY,2,Eduardo Schwank,Fabio Fognini,Eduardo Schwank,6-1; 6-3,R64,64,2,2,27,41,22,27,11,14,2,2,8,33,41,4,6,29,61,20,29,10,32,6,10,8,30,61
2010-04-19 00:00:00.000,Barcelona Spain ATP World Tour 500,CLAY,2,Lleyton Hewitt,Marsel Ilhan,Lleyton Hewitt,6-4; 4-6; 6-2,R64,118,10,3,45,78,33,45,16,33,1,5,14,49,78,8,2,49,100,28,49,25,51,3,9,14,53,100
2010-04-19 00:00:00.000,Barcelona Spain ATP World Tour 500,CLAY,2,Feliciano Lopez,Alexandr Dolgopolov,Feliciano Lopez,6-3; 3-0 RET,R64,51,5,0,17,32,15,17,9,15,0,0,6,24,32,3,2,24,49,16,24,10,25,5,8,6,26,49
2010-04-19 00:00:00.000,Barcelona Spain ATP World Tour 500,CLAY,2,Denis Istomin,Stephane Robert,Denis Istomin,7-6(5); 1-6; 6-1,R64,128,2,4,81,107,50,81,12,26,8,11,13,62,107,0,2,49,95,27,49,29,46,6,9,13,56,95
2010-04-19 00:00:00.000,Barcelona Spain ATP World Tour 500,CLAY,2,Juan Ignacio Chela,Filip Krajinovic,Juan Ignacio Chela,6-1; 6-4,R64,78,0,0,37,49,21,37,7,12,5,8,8,28,49,2,0,33,55,14,33,7,22,5,12,9,21,55
2010-04-19 00:00:00.000,Barcelona Spain ATP World Tour 500,CLAY,2,Robin Soderling,N/A Bye,Robin Soderling,,R64,0,0,0,0,0,0,0,0,0,0,0,0,0,0,0,0,0,0,0,0,0,0,0,0,0,0,0
2010-04-19 00:00:00.000,Barcelona Spain ATP World Tour 500,CLAY,2,Guillermo Garcia-Lopez,Teymuraz Gabashvili,Guillermo Garcia-Lopez,1-6; 7-6(5); 6-4,R32,148,6,0,53,82,36,53,18,29,0,3,14,54,82,7,3,56,97,40,56,24,41,2,4,15,64,97
2010-04-19 00:00:00.000,Barcelona Spain ATP World Tour 500,CLAY,2,Thomaz Bellucci,Victor Hanescu,Thomaz Bellucci,6-2; 1-6; 7-5,R32,122,7,0,54,88,38,54,17,34,8,11,13,55,88,8,0,67,95,42,67,15,28,11,15,14,57,95
2010-04-19 00:00:00.000,Barcelona Spain ATP World Tour 500,CLAY,2,Simone Bolelli,Alberto Martin,Simone Bolelli,7-6(2); 7-6(1),R32,107,3,1,49,72,38,49,11,23,0,2,12,49,72,3,1,49,79,33,49,15,30,5,7,12,48,79
2010-04-19 00:00:00.000,Barcelona Spain ATP World Tour 500,CLAY,2,David Ferrer,Marcel Granollers,David Ferrer,7-5; 6-4,R32,107,0,1,32,68,20,32,24,36,1,3,11,44,68,3,3,42,74,31,42,10,32,5,9,11,41,74
2010-04-19 00:00:00.000,Barcelona Spain ATP World Tour 500,CLAY,2,Albert Ramos,Fernando Gonzalez,Albert Ramos,6-4; 6-7(8); 6-3,R32,135,3,1,76,99,51,76,15,23,4,6,16,66,99,6,3,70,106,49,70,13,36,5,9,15,62,106
2010-04-19 00:00:00.000,Barcelona Spain ATP World Tour 500,CLAY,2,Ernests Gulbis,Jeremy Chardy,Ernests Gulbis,6-3; 6-2,R32,78,5,2,36,58,28,36,11,22,3,4,9,39,58,4,2,30,58,20,30,9,28,4,8,8,29,58
2010-04-19 00:00:00.000,Barcelona Spain ATP World Tour 500,CLAY,2,Jurgen Melzer,Oscar Hernandez,Jurgen Melzer,6-7(4); 7-5; 7-5,R32,168,4,1,78,113,52,78,21,35,8,11,18,73,113,11,3,78,114,51,78,19,36,4,9,18,70,114
2010-04-19 00:00:00.000,Barcelona Spain ATP World Tour 500,CLAY,2,Fernando Verdasco,Richard Gasquet,Fernando Verdasco,7-5; 6-3,R32,80,1,2,48,62,34,48,8,14,3,4,10,42,62,2,1,38,60,29,38,6,22,2,6,11,35,60
2010-04-19 00:00:00.000,Barcelona Spain ATP World Tour 500,CLAY,2,Juan Carlos Ferrero,Sergiy Stakhovsky,Juan Carlos Ferrero,6-3; 4-2 RET,R32,66,1,0,33,43,21,33,8,10,3,4,7,29,43,3,1,40,57,23,40,7,17,3,7,8,30,57
2010-04-19 00:00:00.000,Barcelona Spain ATP World Tour 500,CLAY,2,Thiemo de Bakker,Daniel Gimeno-Traver,Thiemo de Bakker,7-6(5); 6-3,R32,86,5,0,43,68,36,43,13,25,0,1,11,49,68,2,2,36,55,26,36,14,19,0,2,10,40,55
2010-04-19 00:00:00.000,Barcelona Spain ATP World Tour 500,CLAY,2,Nicolas Almagro,Simon Greul,Nicolas Almagro,6-1; 6-3,R32,65,9,1,22,38,20,22,12,16,0,0,8,32,38,0,1,29,57,16,29,14,28,4,8,8,30,57
2010-04-19 00:00:00.000,Barcelona Spain ATP World Tour 500,CLAY,2,Jo-Wilfried Tsonga,Jan Hajek,Jo-Wilfried Tsonga,6-3; 6-2,R32,65,5,0,40,51,33,40,6,11,2,2,9,39,51,1,0,36,55,20,36,11,19,3,6,8,31,55
2010-04-19 00:00:00.000,Barcelona Spain ATP World Tour 500,CLAY,2,Ivan Navarro,Pablo Cuevas,Ivan Navarro,6-2; 6-4,R32,73,4,1,44,57,34,44,7,13,3,3,9,41,57,3,1,39,49,25,39,5,10,2,5,9,30,49
2010-04-19 00:00:00.000,Barcelona Spain ATP World Tour 500,CLAY,2,Eduardo Schwank,Lleyton Hewitt,Eduardo Schwank,7-6(3); 6-4,R32,104,4,0,42,68,32,42,14,26,0,1,11,46,68,5,1,42,72,30,42,16,30,5,7,11,46,72
2010-04-19 00:00:00.000,Barcelona Spain ATP World Tour 500,CLAY,2,Feliciano Lopez,Denis Istomin,Feliciano Lopez,7-6(7); 7-5,R32,104,10,4,47,78,40,47,18,31,3,3,12,58,78,5,0,47,71,38,47,14,24,3,4,12,52,71
2010-04-19 00:00:00.000,Barcelona Spain ATP World Tour 500,CLAY,2,Robin Soderling,Juan Ignacio Chela,Robin Soderling,7-5; 7-5,R32,90,5,1,38,65,28,38,16,27,1,3,12,44,65,1,1,53,69,31,53,9,16,1,5,12,40,69
2010-04-19 00:00:00.000,Barcelona Spain ATP World Tour 500,CLAY,2,Thomaz Bellucci,Guillermo Garcia-Lopez,Thomaz Bellucci,6-4; 6-4,R16,107,2,2,46,66,33,46,10,20,4,5,10,43,66,4,3,39,62,24,39,11,23,1,4,10,35,62
2010-04-19 00:00:00.000,Barcelona Spain ATP World Tour 500,CLAY,2,David Ferrer,Simone Bolelli,David Ferrer,6-0; 3-0 RET,R16,45,0,0,16,25,10,16,7,9,0,0,4,17,25,0,0,19,32,6,19,3,13,4,9,5,9,32
2010-04-19 00:00:00.000,Barcelona Spain ATP World Tour 500,CLAY,2,Ernests Gulbis,Albert Ramos,Ernests Gulbis,6-1; 6-3,R16,62,9,1,33,48,27,33,8,15,1,1,8,35,48,3,1,33,42,17,33,4,9,1,5,8,21,42
2010-04-19 00:00:00.000,Barcelona Spain ATP World Tour 500,CLAY,2,Fernando Verdasco,Jurgen Melzer,Fernando Verdasco,3-6; 7-6(1); 6-3,R16,133,5,3,63,101,42,63,22,38,2,6,16,64,101,2,1,51,83,32,51,17,32,7,10,14,49,83
2010-04-19 00:00:00.000,Barcelona Spain ATP World Tour 500,CLAY,2,Thiemo de Bakker,Juan Carlos Ferrero,Thiemo de Bakker,7-6(2); 3-6; 7-6(4),R16,154,16,1,68,104,49,68,21,36,7,10,16,70,104,2,0,83,104,61,83,11,21,1,3,17,72,104
2010-04-19 00:00:00.000,Barcelona Spain ATP World Tour 500,CLAY,2,Jo-Wilfried Tsonga,Nicolas Almagro,Jo-Wilfried Tsonga,5-7; 6-1; 6-4,R16,123,8,1,57,89,43,57,17,32,4,6,15,60,89,2,3,42,76,33,42,17,34,3,7,14,50,76
2010-04-19 00:00:00.000,Barcelona Spain ATP World Tour 500,CLAY,2,Eduardo Schwank,Ivan Navarro,Eduardo Schwank,6-3; 7-6(7),R16,132,1,1,44,69,33,44,19,25,1,1,11,52,69,13,2,72,105,48,72,14,33,11,12,10,62,105
2010-04-19 00:00:00.000,Barcelona Spain ATP World Tour 500,CLAY,2,Robin Soderling,Feliciano Lopez,Robin Soderling,6-3; 6-2,R16,58,11,2,25,49,22,25,16,24,0,0,9,38,49,3,1,28,48,19,28,8,20,0,3,8,27,48
2010-04-19 00:00:00.000,Barcelona Spain ATP World Tour 500,CLAY,2,David Ferrer,Thomaz Bellucci,David Ferrer,6-4; 6-0,Q,93,0,1,40,64,27,40,14,24,4,4,8,41,64,2,1,31,56,19,31,10,25,7,11,8,29,56
2010-04-19 00:00:00.000,Barcelona Spain ATP World Tour 500,CLAY,2,Fernando Verdasco,Ernests Gulbis,Fernando Verdasco,6-2; 7-6(4),Q,117,3,5,65,83,45,65,7,18,8,9,10,52,83,0,2,42,66,25,42,13,24,0,3,10,38,66
2010-04-19 00:00:00.000,Barcelona Spain ATP World Tour 500,CLAY,2,Thiemo de Bakker,Jo-Wilfried Tsonga,Thiemo de Bakker,6-4; 3-6; 6-3,Q,126,5,0,43,75,29,43,19,32,2,5,14,48,75,1,5,56,96,34,56,20,40,5,9,14,54,96
2010-04-19 00:00:00.000,Barcelona Spain ATP World Tour 500,CLAY,2,Robin Soderling,Eduardo Schwank,Robin Soderling,6-2; 6-3,Q,68,7,2,34,55,29,34,11,21,1,1,9,40,55,4,4,21,43,14,21,11,22,1,4,8,25,43
2010-04-19 00:00:00.000,Barcelona Spain ATP World Tour 500,CLAY,2,Fernando Verdasco,David Ferrer,Fernando Verdasco,6-7(3); 7-5; 6-1,S,156,4,2,68,92,49,68,12,24,1,3,16,61,92,1,0,87,117,54,87,13,30,12,17,15,67,117
2010-04-19 00:00:00.000,Barcelona Spain ATP World Tour 500,CLAY,2,Robin Soderling,Thiemo de Bakker,Robin Soderling,6-1; 6-4,S,76,3,2,25,58,17,25,20,33,4,5,9,37,58,4,2,31,60,16,31,16,29,7,11,8,32,60
2010-04-19 00:00:00.000,Barcelona Spain ATP World Tour 500,CLAY,2,Fernando Verdasco,Robin Soderling,Fernando Verdasco,6-3; 4-6; 6-3,F,124,3,2,61,81,40,61,15,20,3,5,14,55,81,4,2,56,86,37,56,14,30,7,11,14,51,86
2010-04-25 00:00:00.000,ATP World Tour Masters 1000 Rome Italy ATP World Tour Masters 1000,CLAY,2,Roger Federer,N/A Bye,Roger Federer,,R64,0,0,0,0,0,0,0,0,0,0,0,0,0,0,0,0,0,0,0,0,0,0,0,0,0,0,0
2010-04-25 00:00:00.000,ATP World Tour Masters 1000 Rome Italy ATP World Tour Masters 1000,CLAY,2,Ernests Gulbis,Marcos Baghdatis,Ernests Gulbis,6-2; 6-2,R64,70,6,2,39,49,28,39,7,10,1,1,8,35,49,1,1,30,52,14,30,11,22,2,6,8,25,52
2010-04-25 00:00:00.000,ATP World Tour Masters 1000 Rome Italy ATP World Tour Masters 1000,CLAY,2,Filippo Volandri,Peter Luczak,Filippo Volandri,6-4; 6-3,R64,145,0,2,62,78,45,62,5,16,12,12,9,50,78,7,1,63,108,41,63,17,45,17,20,10,58,108
2010-04-25 00:00:00.000,ATP World Tour Masters 1000 Rome Italy ATP World Tour Masters 1000,CLAY,2,Julien Benneteau,Sam Querrey,Julien Benneteau,7-6(6); 3-6; 7-6(2),R64,165,4,5,76,110,52,76,17,34,7,11,16,69,110,11,2,81,134,57,81,22,53,8,11,17,79,134
2010-04-25 00:00:00.000,ATP World Tour Masters 1000 Rome Italy ATP World Tour Masters 1000,CLAY,2,Ivan Ljubicic,Paul-Henri Mathieu,Ivan Ljubicic,7-5; 6-7(1); 6-0,R64,159,14,0,53,93,39,53,20,40,3,5,15,59,93,6,3,63,108,43,63,19,45,7,13,15,62,108
2010-04-25 00:00:00.000,ATP World Tour Masters 1000 Rome Italy ATP World Tour Masters 1000,CLAY,2,Nicolas Almagro,Lukasz Kubot,Nicolas Almagro,6-7(3); 6-2; 6-3,R64,146,7,2,52,88,42,52,20,36,1,2,15,62,88,6,3,58,103,39,58,22,45,4,8,14,61,103
2010-04-25 00:00:00.000,ATP World Tour Masters 1000 Rome Italy ATP World Tour Masters 1000,CLAY,2,Feliciano Lopez,Benjamin Becker,Feliciano Lopez,6-4; 6-3,R64,73,11,1,35,60,31,35,15,25,2,2,10,46,60,6,2,34,51,24,34,9,17,1,3,9,33,51
2010-04-25 00:00:00.000,ATP World Tour Masters 1000 Rome Italy ATP World Tour Masters 1000,CLAY,2,Marin Cilic,N/A Bye,Marin Cilic,,R64,0,0,0,0,0,0,0,0,0,0,0,0,0,0,0,0,0,0,0,0,0,0,0,0,0,0,0
2010-04-25 00:00:00.000,ATP World Tour Masters 1000 Rome Italy ATP World Tour Masters 1000,CLAY,2,Rafael Nadal,N/A Bye,Rafael Nadal,,R64,0,0,0,0,0,0,0,0,0,0,0,0,0,0,0,0,0,0,0,0,0,0,0,0,0,0,0
2010-04-25 00:00:00.000,ATP World Tour Masters 1000 Rome Italy ATP World Tour Masters 1000,CLAY,2,Philipp Kohlschreiber,Pablo Cuevas,Philipp Kohlschreiber,6-7(1); 6-1; 6-4,R64,148,3,4,66,103,48,66,19,37,9,10,15,67,103,7,3,68,105,44,68,19,37,8,12,14,63,105
2010-04-25 00:00:00.000,ATP World Tour Masters 1000 Rome Italy ATP World Tour Masters 1000,CLAY,2,Victor Hanescu,Michael Berrer,Victor Hanescu,6-2; 6-7(5); 6-3,R64,126,11,2,61,87,44,61,15,26,2,3,14,59,87,3,2,64,96,41,64,15,32,3,8,15,56,96
2010-04-25 00:00:00.000,ATP World Tour Masters 1000 Rome Italy ATP World Tour Masters 1000,CLAY,2,Juan Monaco,Igor Andreev,Juan Monaco,7-6(4); 7-5,R64,138,2,1,52,76,34,52,12,24,3,7,12,46,76,3,7,58,97,32,58,21,39,7,12,12,53,97
2010-04-25 00:00:00.000,ATP World Tour Masters 1000 Rome Italy ATP World Tour Masters 1000,CLAY,2,Tomas Berdych,Marcel Granollers,Tomas Berdych,6-3; 6-3,R64,78,5,1,35,49,24,35,7,14,2,4,9,31,49,1,0,36,52,18,36,7,16,3,8,9,25,52
2010-04-25 00:00:00.000,ATP World Tour Masters 1000 Rome Italy ATP World Tour Masters 1000,CLAY,2,Stanislas Wawrinka,Jurgen Melzer,Stanislas Wawrinka,6-1; 6-2,R64,57,6,0,22,38,19,22,13,16,0,0,8,32,38,3,2,25,46,14,25,8,21,3,7,7,22,46
2010-04-25 00:00:00.000,ATP World Tour Masters 1000 Rome Italy ATP World Tour Masters 1000,CLAY,2,Paolo Lorenzi,Albert Montanes,Paolo Lorenzi,2-6; 6-4; 6-3,R64,132,5,2,46,88,31,46,18,42,11,15,13,49,88,4,2,53,83,32,53,15,30,3,8,14,47,83
2010-04-25 00:00:00.000,ATP World Tour Masters 1000 Rome Italy ATP World Tour Masters 1000,CLAY,2,Robin Soderling,N/A Bye,Robin Soderling,,R64,0,0,0,0,0,0,0,0,0,0,0,0,0,0,0,0,0,0,0,0,0,0,0,0,0,0,0
2010-04-25 00:00:00.000,ATP World Tour Masters 1000 Rome Italy ATP World Tour Masters 1000,CLAY,2,Jo-Wilfried Tsonga,N/A Bye,Jo-Wilfried Tsonga,,R64,0,0,0,0,0,0,0,0,0,0,0,0,0,0,0,0,0,0,0,0,0,0,0,0,0,0,0
2010-04-25 00:00:00.000,ATP World Tour Masters 1000 Rome Italy ATP World Tour Masters 1000,CLAY,2,Viktor Troicki,Thiemo de Bakker,Viktor Troicki,3-6; 6-1; 1-0 RET,R64,69,2,3,23,41,16,23,7,18,1,4,8,23,41,2,0,31,55,18,31,8,24,3,8,9,26,55
2010-04-25 00:00:00.000,ATP World Tour Masters 1000 Rome Italy ATP World Tour Masters 1000,CLAY,2,Michael Llodra,Andreas Beck,Michael Llodra,6-2; 3-6; 6-4,R64,118,14,1,51,81,36,51,17,30,3,5,14,53,81,2,5,50,80,32,50,17,30,3,6,13,49,80
2010-04-25 00:00:00.000,ATP World Tour Masters 1000 Rome Italy ATP World Tour Masters 1000,CLAY,2,Santiago Giraldo,Juan Carlos Ferrero,Santiago Giraldo,6-0; 6-3,R64,58,3,1,36,52,26,36,7,16,4,5,8,33,52,1,0,33,46,12,33,7,13,8,13,7,19,46
2010-04-25 00:00:00.000,ATP World Tour Masters 1000 Rome Italy ATP World Tour Masters 1000,CLAY,2,David Ferrer,Evgeny Korolev,David Ferrer,6-4; 6-1,R64,70,1,0,43,54,29,43,6,11,3,5,9,35,54,1,2,21,41,10,21,7,20,0,5,8,17,41
2010-04-25 00:00:00.000,ATP World Tour Masters 1000 Rome Italy ATP World Tour Masters 1000,CLAY,2,Potito Starace,Jan Hajek,Potito Starace,6-2; 6-2,R64,69,1,0,37,48,28,37,6,11,2,2,8,34,48,0,0,24,47,13,24,11,23,1,5,8,24,47
2010-04-25 00:00:00.000,ATP World Tour Masters 1000 Rome Italy ATP World Tour Masters 1000,CLAY,2,Andreas Seppi,Fabio Fognini,Andreas Seppi,6-0; 6-3,R64,70,0,1,46,59,31,46,7,13,4,5,8,38,59,0,5,23,46,11,23,7,23,2,7,7,18,46
2010-04-25 00:00:00.000,ATP World Tour Masters 1000 Rome Italy ATP World Tour Masters 1000,CLAY,2,Andy Murray,N/A Bye,Andy Murray,,R64,0,0,0,0,0,0,0,0,0,0,0,0,0,0,0,0,0,0,0,0,0,0,0,0,0,0,0
2010-04-25 00:00:00.000,ATP World Tour Masters 1000 Rome Italy ATP World Tour Masters 1000,CLAY,2,Fernando Verdasco,N/A Bye,Fernando Verdasco,,R64,0,0,0,0,0,0,0,0,0,0,0,0,0,0,0,0,0,0,0,0,0,0,0,0,0,0,0
2010-04-25 00:00:00.000,ATP World Tour Masters 1000 Rome Italy ATP World Tour Masters 1000,CLAY,2,Simone Bolelli,Simon Greul,Simone Bolelli,6-4; 6-1,R64,91,6,1,38,57,29,38,9,19,1,2,9,38,57,1,1,36,62,17,36,14,26,5,9,8,31,62
2010-04-25 00:00:00.000,ATP World Tour Masters 1000 Rome Italy ATP World Tour Masters 1000,CLAY,2,Guillermo Garcia-Lopez,Juan Ignacio Chela,Guillermo Garcia-Lopez,6-2; 6-2,R64,63,5,1,36,50,27,36,7,14,0,0,8,34,50,0,0,27,41,13,27,7,14,0,4,8,20,41
2010-04-25 00:00:00.000,ATP World Tour Masters 1000 Rome Italy ATP World Tour Masters 1000,CLAY,2,Lleyton Hewitt,Mikhail Youzhny,Lleyton Hewitt,6-4; 4-6; 6-3,R64,149,6,3,43,88,31,43,22,45,2,5,14,53,88,5,4,61,95,36,61,17,34,2,7,15,53,95
2010-04-25 00:00:00.000,ATP World Tour Masters 1000 Rome Italy ATP World Tour Masters 1000,CLAY,2,John Isner,Horacio Zeballos,John Isner,4-6; 7-6(5); 7-5,R64,156,20,2,67,98,55,67,20,31,0,1,17,75,98,6,2,84,120,62,84,20,36,9,10,17,82,120
2010-04-25 00:00:00.000,ATP World Tour Masters 1000 Rome Italy ATP World Tour Masters 1000,CLAY,2,Thomaz Bellucci,Leonardo Mayer,Thomaz Bellucci,6-4; 3-6; 6-1,R64,127,3,1,36,65,25,36,21,29,0,2,13,46,65,7,1,66,90,42,66,9,24,7,11,13,51,90
2010-04-25 00:00:00.000,ATP World Tour Masters 1000 Rome Italy ATP World Tour Masters 1000,CLAY,2,Jeremy Chardy,Janko Tipsarevic,Jeremy Chardy,6-4; 6-4,R64,96,10,1,35,62,25,35,20,27,3,3,10,45,62,2,0,50,78,29,50,17,28,9,11,10,46,78
2010-04-25 00:00:00.000,ATP World Tour Masters 1000 Rome Italy ATP World Tour Masters 1000,CLAY,2,Novak Djokovic,N/A Bye,Novak Djokovic,,R64,0,0,0,0,0,0,0,0,0,0,0,0,0,0,0,0,0,0,0,0,0,0,0,0,0,0,0
2010-04-25 00:00:00.000,ATP World Tour Masters 1000 Rome Italy ATP World Tour Masters 1000,CLAY,2,Ernests Gulbis,Roger Federer,Ernests Gulbis,2-6; 6-1; 7-5,R32,123,8,2,65,89,46,65,11,24,3,6,14,57,89,2,3,53,94,35,53,18,41,6,10,13,53,94
2010-04-25 00:00:00.000,ATP World Tour Masters 1000 Rome Italy ATP World Tour Masters 1000,CLAY,2,Filippo Volandri,Julien Benneteau,Filippo Volandri,6-2; 6-0,R32,65,0,0,35,42,22,35,7,7,1,2,7,29,42,1,0,33,41,12,33,2,8,6,12,7,14,41
2010-04-25 00:00:00.000,ATP World Tour Masters 1000 Rome Italy ATP World Tour Masters 1000,CLAY,2,Ivan Ljubicic,Nicolas Almagro,Ivan Ljubicic,7-5; 7-6(3),R32,126,17,2,46,72,39,46,12,26,1,2,12,51,72,8,4,55,91,37,55,16,36,11,13,12,53,91
2010-04-25 00:00:00.000,ATP World Tour Masters 1000 Rome Italy ATP World Tour Masters 1000,CLAY,2,Feliciano Lopez,Marin Cilic,Feliciano Lopez,2-6; 7-6(2); 6-4,R32,145,12,4,61,108,46,61,24,47,8,10,15,70,108,6,2,57,94,44,57,21,37,3,4,15,65,94
2010-04-25 00:00:00.000,ATP World Tour Masters 1000 Rome Italy ATP World Tour Masters 1000,CLAY,2,Rafael Nadal,Philipp Kohlschreiber,Rafael Nadal,6-1; 6-3,R32,70,2,0,29,42,23,29,10,13,1,1,8,33,42,2,0,28,48,16,28,9,20,2,6,8,25,48
2010-04-25 00:00:00.000,ATP World Tour Masters 1000 Rome Italy ATP World Tour Masters 1000,CLAY,2,Victor Hanescu,Juan Monaco,Victor Hanescu,7-6(4); 6-4,R32,96,4,0,58,68,39,58,6,10,5,7,11,45,68,3,3,50,67,29,50,8,17,1,4,11,37,67
2010-04-25 00:00:00.000,ATP World Tour Masters 1000 Rome Italy ATP World Tour Masters 1000,CLAY,2,Stanislas Wawrinka,Tomas Berdych,Stanislas Wawrinka,2-6; 6-3; 7-6(6),R32,184,4,3,66,106,43,66,21,40,7,11,15,64,106,4,3,56,97,36,56,24,41,7,10,14,60,97
2010-04-25 00:00:00.000,ATP World Tour Masters 1000 Rome Italy ATP World Tour Masters 1000,CLAY,2,Robin Soderling,Paolo Lorenzi,Robin Soderling,6-1; 7-5,R32,74,7,3,40,56,30,40,12,16,3,3,10,42,56,1,3,29,57,19,29,13,28,4,7,9,32,57
2010-04-25 00:00:00.000,ATP World Tour Masters 1000 Rome Italy ATP World Tour Masters 1000,CLAY,2,Jo-Wilfried Tsonga,Viktor Troicki,Jo-Wilfried Tsonga,6-2; 6-3,R32,81,0,2,40,53,24,40,8,13,4,6,8,32,53,1,0,32,58,17,32,8,26,4,10,9,25,58
2010-04-25 00:00:00.000,ATP World Tour Masters 1000 Rome Italy ATP World Tour Masters 1000,CLAY,2,Santiago Giraldo,Michael Llodra,Santiago Giraldo,6-3; 6-2,R32,65,3,0,42,49,30,42,5,7,0,0,8,35,49,5,1,41,64,23,41,10,23,8,12,9,33,64
2010-04-25 00:00:00.000,ATP World Tour Masters 1000 Rome Italy ATP World Tour Masters 1000,CLAY,2,David Ferrer,Potito Starace,David Ferrer,7-5; 6-2,R32,87,1,0,51,61,34,51,9,10,5,6,10,43,61,1,0,42,60,22,42,11,18,2,6,10,33,60
2010-04-25 00:00:00.000,ATP World Tour Masters 1000 Rome Italy ATP World Tour Masters 1000,CLAY,2,Andy Murray,Andreas Seppi,Andy Murray,6-2; 6-4,R32,81,11,3,29,55,26,29,12,26,2,2,9,38,55,4,1,36,59,20,36,13,23,1,4,9,33,59
2010-04-25 00:00:00.000,ATP World Tour Masters 1000 Rome Italy ATP World Tour Masters 1000,CLAY,2,Fernando Verdasco,Simone Bolelli,Fernando Verdasco,7-6(11); 6-3,R32,108,3,2,63,76,47,63,7,13,3,4,11,54,76,4,2,41,63,31,41,11,22,1,3,10,42,63
2010-04-25 00:00:00.000,ATP World Tour Masters 1000 Rome Italy ATP World Tour Masters 1000,CLAY,2,Guillermo Garcia-Lopez,Lleyton Hewitt,Guillermo Garcia-Lopez,6-2; 6-3,R32,76,2,1,38,54,23,38,8,16,5,8,9,31,54,4,3,23,46,11,23,7,23,2,8,8,18,46
2010-04-25 00:00:00.000,ATP World Tour Masters 1000 Rome Italy ATP World Tour Masters 1000,CLAY,2,Thomaz Bellucci,John Isner,Thomaz Bellucci,7-6(7); 7-5,R32,120,8,2,46,75,37,46,18,29,3,4,12,55,75,16,3,66,97,41,66,19,31,2,4,12,60,97
2010-04-25 00:00:00.000,ATP World Tour Masters 1000 Rome Italy ATP World Tour Masters 1000,CLAY,2,Novak Djokovic,Jeremy Chardy,Novak Djokovic,6-1; 6-1,R32,60,1,2,27,39,22,27,7,12,0,0,7,29,39,5,2,29,52,19,29,4,23,2,7,7,23,52
2010-04-25 00:00:00.000,ATP World Tour Masters 1000 Rome Italy ATP World Tour Masters 1000,CLAY,2,Ernests Gulbis,Filippo Volandri,Ernests Gulbis,6-2; 3-6; 7-6(4),R16,163,7,3,52,83,42,52,16,31,2,4,14,58,83,0,4,70,113,45,70,25,43,14,17,15,70,113
2010-04-25 00:00:00.000,ATP World Tour Masters 1000 Rome Italy ATP World Tour Masters 1000,CLAY,2,Feliciano Lopez,Ivan Ljubicic,Feliciano Lopez,W/O,R16,0,0,0,0,0,0,0,0,0,0,0,0,0,0,0,0,0,0,0,0,0,0,0,0,0,0,0
2010-04-25 00:00:00.000,ATP World Tour Masters 1000 Rome Italy ATP World Tour Masters 1000,CLAY,2,Rafael Nadal,Victor Hanescu,Rafael Nadal,6-3; 6-2,R16,83,0,1,47,60,35,47,7,13,5,5,9,42,60,3,0,35,47,22,35,3,12,4,7,8,25,47
2010-04-25 00:00:00.000,ATP World Tour Masters 1000 Rome Italy ATP World Tour Masters 1000,CLAY,2,Stanislas Wawrinka,Robin Soderling,Stanislas Wawrinka,6-3; 6-2,R16,78,8,2,25,48,23,25,16,23,2,2,9,39,48,2,3,34,67,22,34,14,33,8,11,8,36,67
2010-04-25 00:00:00.000,ATP World Tour Masters 1000 Rome Italy ATP World Tour Masters 1000,CLAY,2,Jo-Wilfried Tsonga,Santiago Giraldo,Jo-Wilfried Tsonga,6-3; 6-4,R16,88,4,0,36,62,26,36,18,26,2,2,10,44,62,2,1,29,54,21,29,14,25,0,2,9,35,54
2010-04-25 00:00:00.000,ATP World Tour Masters 1000 Rome Italy ATP World Tour Masters 1000,CLAY,2,David Ferrer,Andy Murray,David Ferrer,6-3; 6-4,R16,96,1,2,50,64,35,50,9,14,3,3,10,44,64,7,0,25,61,19,25,18,36,4,6,9,37,61
2010-04-25 00:00:00.000,ATP World Tour Masters 1000 Rome Italy ATP World Tour Masters 1000,CLAY,2,Fernando Verdasco,Guillermo Garcia-Lopez,Fernando Verdasco,6-4; 7-6(2),R16,122,2,2,53,73,39,53,10,20,3,5,11,49,73,3,4,57,81,40,57,7,24,7,10,11,47,81
2010-04-25 00:00:00.000,ATP World Tour Masters 1000 Rome Italy ATP World Tour Masters 1000,CLAY,2,Novak Djokovic,Thomaz Bellucci,Novak Djokovic,6-4; 6-4,R16,87,1,3,28,49,22,28,12,21,1,3,10,34,49,5,6,41,61,24,41,7,20,5,9,10,31,61
2010-04-25 00:00:00.000,ATP World Tour Masters 1000 Rome Italy ATP World Tour Masters 1000,CLAY,2,Ernests Gulbis,Feliciano Lopez,Ernests Gulbis,7-6(6); 6-1,Q,97,6,1,45,70,29,45,18,25,3,4,10,47,70,5,1,42,61,27,42,8,19,3,6,9,35,61
2010-04-25 00:00:00.000,ATP World Tour Masters 1000 Rome Italy ATP World Tour Masters 1000,CLAY,2,Rafael Nadal,Stanislas Wawrinka,Rafael Nadal,6-4; 6-1,Q,91,2,2,48,64,35,48,8,16,2,2,9,43,64,2,1,25,43,18,25,9,18,3,6,8,27,43
2010-04-25 00:00:00.000,ATP World Tour Masters 1000 Rome Italy ATP World Tour Masters 1000,CLAY,2,David Ferrer,Jo-Wilfried Tsonga,David Ferrer,6-4; 6-1,Q,72,0,0,39,50,27,39,7,11,1,2,9,34,50,0,2,39,53,22,39,5,14,3,7,8,27,53
2010-04-25 00:00:00.000,ATP World Tour Masters 1000 Rome Italy ATP World Tour Masters 1000,CLAY,2,Fernando Verdasco,Novak Djokovic,Fernando Verdasco,7-6(4); 3-6; 6-4,Q,198,3,3,78,99,49,78,11,21,6,11,16,60,99,6,7,79,121,56,79,14,42,10,14,15,70,121
2010-04-25 00:00:00.000,ATP World Tour Masters 1000 Rome Italy ATP World Tour Masters 1000,CLAY,2,Rafael Nadal,Ernests Gulbis,Rafael Nadal,6-4; 3-6; 6-4,S,167,0,1,72,94,50,72,12,22,6,7,14,62,94,14,2,85,110,62,85,7,25,10,12,15,69,110
2010-04-25 00:00:00.000,ATP World Tour Masters 1000 Rome Italy ATP World Tour Masters 1000,CLAY,2,David Ferrer,Fernando Verdasco,David Ferrer,7-5; 6-3,S,91,2,0,45,65,32,45,7,20,1,4,11,39,65,3,3,39,53,22,39,5,14,2,7,10,27,53
2010-04-25 00:00:00.000,ATP World Tour Masters 1000 Rome Italy ATP World Tour Masters 1000,CLAY,2,Rafael Nadal,David Ferrer,Rafael Nadal,7-5; 6-2,F,104,3,0,44,55,34,44,7,11,1,1,10,41,55,1,5,58,81,36,58,9,23,10,13,10,45,81
2010-05-02 00:00:00.000,Munich Germany ATP World Tour 250,CLAY,2,Marin Cilic,Michael Berrer,Marin Cilic,6-4; 6-2,R32,68,6,1,35,46,26,35,7,11,0,1,9,33,46,5,2,35,50,21,35,4,15,0,4,9,25,50
2010-05-02 00:00:00.000,Munich Germany ATP World Tour 250,CLAY,2,Simon Greul,Nicolas Kiefer,Simon Greul,7-5; 6-2,R32,71,9,1,39,56,35,39,6,17,0,0,10,41,56,3,4,31,56,21,31,13,25,4,7,10,34,56
2010-05-02 00:00:00.000,Munich Germany ATP World Tour 250,CLAY,2,Kevin Anderson,Mischa Zverev,Kevin Anderson,6-5 RET,R32,59,2,2,23,41,18,23,8,18,2,3,6,26,41,1,1,20,32,14,20,5,12,1,2,5,19,32
2010-05-02 00:00:00.000,Munich Germany ATP World Tour 250,CLAY,2,Nicolas Almagro,Kristof Vliegen,Nicolas Almagro,6-3; 6-1,R32,55,4,1,16,36,16,16,16,20,0,0,8,32,36,1,0,30,50,17,30,9,20,1,5,8,26,50
2010-05-02 00:00:00.000,Munich Germany ATP World Tour 250,CLAY,2,Philipp Kohlschreiber,Daniel Brands,Philipp Kohlschreiber,6-4; 6-4,R32,78,4,0,40,57,29,40,13,17,1,1,10,42,57,4,0,41,56,25,41,11,15,3,5,10,36,56
2010-05-02 00:00:00.000,Munich Germany ATP World Tour 250,CLAY,2,Santiago Ventura,Alexandr Dolgopolov,Santiago Ventura,6-7(5); 6-3; 6-3,R32,126,8,4,56,91,41,56,19,35,2,4,15,60,91,2,1,85,109,50,85,13,24,11,16,15,63,109
2010-05-02 00:00:00.000,Munich Germany ATP World Tour 250,CLAY,2,Marco Chiudinelli,Thierry Ascione,Marco Chiudinelli,6-0; 6-4,R32,52,5,2,25,46,22,25,12,21,2,2,8,34,46,1,2,44,50,22,44,3,6,3,7,8,25,50
2010-05-02 00:00:00.000,Munich Germany ATP World Tour 250,CLAY,2,Marcos Baghdatis,Peter Gojowczyk,Marcos Baghdatis,3-6; 6-1; 6-2,R32,100,3,8,33,62,27,33,11,29,4,8,12,38,62,1,5,63,98,30,63,18,35,3,10,12,48,98
2010-05-02 00:00:00.000,Munich Germany ATP World Tour 250,CLAY,2,Philipp Petzschner,Julien Benneteau,Philipp Petzschner,3-6; 6-3; 6-3,R32,110,3,4,45,80,36,45,12,35,5,8,13,48,80,4,4,57,85,36,57,14,28,4,9,14,50,85
2010-05-02 00:00:00.000,Munich Germany ATP World Tour 250,CLAY,2,Daniel Koellerer,Mario Ancic,Daniel Koellerer,7-6(7); 7-5,R32,132,0,1,36,68,24,36,17,32,2,6,12,41,68,3,2,52,86,33,52,13,34,9,14,12,46,86
2010-05-02 00:00:00.000,Munich Germany ATP World Tour 250,CLAY,2,Pere Riba,Lukas Lacko,Pere Riba,5-7; 6-1; 6-2,R32,119,7,2,53,85,36,53,17,32,2,5,14,53,85,1,1,51,88,25,51,19,37,9,15,13,44,88
2010-05-02 00:00:00.000,Munich Germany ATP World Tour 250,CLAY,2,Tomas Berdych,Kevin Krawietz,Tomas Berdych,6-1; 6-1,R32,44,0,1,14,32,12,14,16,18,0,0,7,28,32,0,2,26,43,15,26,4,17,1,6,7,19,43
2010-05-02 00:00:00.000,Munich Germany ATP World Tour 250,CLAY,2,Benjamin Becker,Stephane Robert,Benjamin Becker,6-4; 4-6; 6-0,R32,117,9,2,48,92,31,48,22,44,6,9,13,53,92,1,4,40,90,28,40,20,50,9,15,13,48,90
2010-05-02 00:00:00.000,Munich Germany ATP World Tour 250,CLAY,2,Jan Hajek,Alexandre Sidorenko,Jan Hajek,6-1; 6-2,R32,68,3,3,34,74,25,34,22,40,8,8,8,47,74,2,3,30,48,18,30,6,18,6,10,7,24,48
2010-05-02 00:00:00.000,Munich Germany ATP World Tour 250,CLAY,2,Andreas Beck,Denis Istomin,Andreas Beck,2-6; 7-6(3); 6-1,R32,114,0,4,52,84,37,52,19,32,3,6,14,56,84,5,1,56,77,39,56,10,21,1,4,13,49,77
2010-05-02 00:00:00.000,Munich Germany ATP World Tour 250,CLAY,2,Mikhail Youzhny,Jeremy Chardy,Mikhail Youzhny,6-1; 6-4,R32,59,2,1,33,47,25,33,9,14,3,4,9,34,47,5,2,21,41,14,21,5,20,1,5,8,19,41
2010-05-02 00:00:00.000,Munich Germany ATP World Tour 250,CLAY,2,Marin Cilic,Simon Greul,Marin Cilic,6-7(6); 6-2; 7-5,R16,152,5,2,61,92,48,61,17,31,3,4,16,65,92,1,1,72,113,42,72,23,41,5,9,16,65,113
2010-05-02 00:00:00.000,Munich Germany ATP World Tour 250,CLAY,2,Nicolas Almagro,Kevin Anderson,Nicolas Almagro,6-2; 5-7; 7-6(5),R16,125,17,3,69,100,54,69,19,31,9,10,16,73,100,8,3,71,102,52,71,17,31,6,8,16,69,102
2010-05-02 00:00:00.000,Munich Germany ATP World Tour 250,CLAY,2,Philipp Kohlschreiber,Santiago Ventura,Philipp Kohlschreiber,6-2; 6-1,R16,68,1,0,31,38,29,31,3,7,0,0,8,32,38,2,0,24,36,14,24,6,12,3,7,7,20,36
2010-05-02 00:00:00.000,Munich Germany ATP World Tour 250,CLAY,2,Marcos Baghdatis,Marco Chiudinelli,Marcos Baghdatis,6-3; 6-4,R16,77,7,3,29,61,25,29,18,32,3,4,10,43,61,2,1,40,59,25,40,10,19,4,7,9,35,59
2010-05-02 00:00:00.000,Munich Germany ATP World Tour 250,CLAY,2,Philipp Petzschner,Daniel Koellerer,Philipp Petzschner,6-1; 6-4,R16,87,8,1,37,61,30,37,11,24,4,5,9,41,61,0,2,45,62,26,45,5,17,5,9,8,31,62
2010-05-02 00:00:00.000,Munich Germany ATP World Tour 250,CLAY,2,Tomas Berdych,Pere Riba,Tomas Berdych,7-5; 6-1,R16,102,1,0,27,58,20,27,20,31,6,7,9,40,58,3,1,35,59,19,35,10,24,5,10,10,29,59
2010-05-02 00:00:00.000,Munich Germany ATP World Tour 250,CLAY,2,Jan Hajek,Benjamin Becker,Jan Hajek,6-4; 6-0,R16,73,0,1,36,50,27,36,9,14,1,1,8,36,50,6,2,33,58,21,33,7,25,5,9,8,28,58
2010-05-02 00:00:00.000,Munich Germany ATP World Tour 250,CLAY,2,Mikhail Youzhny,Andreas Beck,Mikhail Youzhny,6-3; 6-3,R16,60,1,0,39,45,33,39,2,6,0,1,9,35,45,1,3,41,59,23,41,8,18,6,10,9,31,59
2010-05-02 00:00:00.000,Munich Germany ATP World Tour 250,CLAY,2,Marin Cilic,Nicolas Almagro,Marin Cilic,6-4; 6-7(2); 6-2,Q,141,5,1,74,112,56,74,19,38,10,10,15,75,112,11,1,69,95,54,69,11,26,2,5,15,65,95
2010-05-02 00:00:00.000,Munich Germany ATP World Tour 250,CLAY,2,Marcos Baghdatis,Philipp Kohlschreiber,Marcos Baghdatis,6-3; 6-4,Q,84,6,0,36,62,24,36,17,26,5,6,10,41,62,3,0,41,56,26,41,6,15,2,5,9,32,56
2010-05-02 00:00:00.000,Munich Germany ATP World Tour 250,CLAY,2,Philipp Petzschner,Tomas Berdych,Philipp Petzschner,1-6; 6-3; 6-4,Q,109,7,1,44,80,31,44,22,36,6,8,13,53,80,7,3,47,76,36,47,17,29,7,9,13,53,76
2010-05-02 00:00:00.000,Munich Germany ATP World Tour 250,CLAY,2,Mikhail Youzhny,Jan Hajek,Mikhail Youzhny,6-1; 6-3,Q,76,4,3,44,66,33,44,8,22,8,9,8,41,66,0,0,39,52,18,39,5,13,5,10,8,23,52
2010-05-02 00:00:00.000,Munich Germany ATP World Tour 250,CLAY,2,Marin Cilic,Marcos Baghdatis,Marin Cilic,3-6; 6-2; 6-3,S,136,8,2,64,101,45,64,21,37,8,9,13,66,101,10,0,46,85,32,46,20,39,1,4,13,52,85
2010-05-02 00:00:00.000,Munich Germany ATP World Tour 250,CLAY,2,Mikhail Youzhny,Philipp Petzschner,Mikhail Youzhny,7-5; 7-6(5),S,104,3,0,54,77,38,54,13,23,2,4,12,51,77,4,3,44,72,33,44,14,28,3,6,12,47,72
2010-05-02 00:00:00.000,Munich Germany ATP World Tour 250,CLAY,2,Mikhail Youzhny,Marin Cilic,Mikhail Youzhny,6-3; 4-6; 6-4,F,171,6,1,68,109,51,68,19,41,7,9,15,70,109,5,5,49,103,34,49,28,54,8,11,14,62,103
2010-05-03 00:00:00.000,Belgrade Serbia ATP World Tour 250,CLAY,2,Novak Djokovic,N/A Bye,Novak Djokovic,,R32,0,0,0,0,0,0,0,0,0,0,0,0,0,0,0,0,0,0,0,0,0,0,0,0,0,0,0
2010-05-03 00:00:00.000,Belgrade Serbia ATP World Tour 250,CLAY,2,Fabio Fognini,Franko Skugor,Fabio Fognini,6-3; 6-1,R32,66,3,1,26,40,18,26,10,14,0,1,8,28,40,2,3,21,50,16,21,7,29,1,6,8,23,50
2010-05-03 00:00:00.000,Belgrade Serbia ATP World Tour 250,CLAY,2,Filip Krajinovic,Evgeny Donskoy,Filip Krajinovic,5-7; 7-6(7); 6-1,R32,139,7,3,71,103,54,71,14,32,1,5,16,68,103,4,2,50,96,31,50,25,46,5,10,15,56,96
2010-05-03 00:00:00.000,Belgrade Serbia ATP World Tour 250,CLAY,2,Horacio Zeballos,Peter Polansky,Horacio Zeballos,2-6; 6-4; 7-6(2),R32,129,5,1,53,95,39,53,21,42,0,4,15,60,95,2,4,57,97,41,57,18,40,6,9,15,59,97
2010-05-03 00:00:00.000,Belgrade Serbia ATP World Tour 250,CLAY,2,Sam Querrey,N/A Bye,Sam Querrey,,R32,0,0,0,0,0,0,0,0,0,0,0,0,0,0,0,0,0,0,0,0,0,0,0,0,0,0,0
2010-05-03 00:00:00.000,Belgrade Serbia ATP World Tour 250,CLAY,2,Evgeny Korolev,Michael Russell,Evgeny Korolev,6-1; 6-0,R32,55,3,4,21,43,15,21,13,22,4,4,6,28,43,1,1,25,42,8,25,6,17,3,9,7,14,42
2010-05-03 00:00:00.000,Belgrade Serbia ATP World Tour 250,CLAY,2,Igor Andreev,Blaz Kavcic,Igor Andreev,6-3; 6-2,R32,85,1,3,25,47,20,25,13,22,2,3,9,33,47,1,6,41,62,24,41,7,21,6,10,8,31,62
2010-05-03 00:00:00.000,Belgrade Serbia ATP World Tour 250,CLAY,2,Ivo Karlovic,Dusan Lajovic,Ivo Karlovic,7-6(4); 6-4,R32,87,10,2,41,64,33,41,15,23,2,3,11,48,64,4,2,37,65,28,37,16,28,2,4,11,44,65
2010-05-03 00:00:00.000,Belgrade Serbia ATP World Tour 250,CLAY,2,Viktor Troicki,Ivan Navarro,Viktor Troicki,6-4; 6-0,R32,67,4,1,27,46,21,27,13,19,1,1,8,34,46,0,3,29,50,16,29,9,21,1,5,8,25,50
2010-05-03 00:00:00.000,Belgrade Serbia ATP World Tour 250,CLAY,2,Florent Serra,Karol Beck,Florent Serra,6-3; 6-3,R32,66,3,0,33,54,26,33,11,21,2,3,9,37,54,1,6,27,60,16,27,15,33,3,7,9,31,60
2010-05-03 00:00:00.000,Belgrade Serbia ATP World Tour 250,CLAY,2,Alessio Di Mauro,Marko Djokovic,Alessio Di Mauro,6-7(5); 7-5; 6-0,R32,146,6,4,48,96,37,48,23,48,4,7,15,60,96,2,4,63,107,34,63,21,44,5,12,15,55,107
2010-05-03 00:00:00.000,Belgrade Serbia ATP World Tour 250,CLAY,2,Stanislas Wawrinka,N/A Bye,Stanislas Wawrinka,,R32,0,0,0,0,0,0,0,0,0,0,0,0,0,0,0,0,0,0,0,0,0,0,0,0,0,0,0
2010-05-03 00:00:00.000,Belgrade Serbia ATP World Tour 250,CLAY,2,Andreas Seppi,Leonardo Mayer,Andreas Seppi,2-6; 6-1; 6-4,R32,127,1,1,57,79,35,57,9,22,4,9,12,44,79,1,7,62,103,29,62,20,41,6,13,13,49,103
2010-05-03 00:00:00.000,Belgrade Serbia ATP World Tour 250,CLAY,2,Richard Gasquet,Olivier Rochus,Richard Gasquet,6-0; 6-1,R32,55,6,0,25,39,18,25,12,14,0,0,7,30,39,1,1,21,37,10,21,4,16,4,9,6,14,37
2010-05-03 00:00:00.000,Belgrade Serbia ATP World Tour 250,CLAY,2,Josselin Ouanna,Flavio Cipolla,Josselin Ouanna,6-3; 6-1,R32,70,6,4,24,45,19,24,14,21,0,0,8,33,45,2,3,44,62,23,44,8,18,3,7,8,31,62
2010-05-03 00:00:00.000,Belgrade Serbia ATP World Tour 250,CLAY,2,John Isner,N/A Bye,John Isner,,R32,0,0,0,0,0,0,0,0,0,0,0,0,0,0,0,0,0,0,0,0,0,0,0,0,0,0,0
2010-05-03 00:00:00.000,Belgrade Serbia ATP World Tour 250,CLAY,2,Novak Djokovic,Fabio Fognini,Novak Djokovic,6-4; 6-4,R16,91,0,4,38,63,21,38,12,25,2,6,10,33,63,3,6,36,64,20,36,10,28,3,9,10,30,64
2010-05-03 00:00:00.000,Belgrade Serbia ATP World Tour 250,CLAY,2,Filip Krajinovic,Horacio Zeballos,Filip Krajinovic,6-3; 1-6; 7-6(5),R16,147,1,3,61,95,41,61,18,34,5,9,14,59,95,7,3,67,117,44,67,25,50,10,13,14,69,117
2010-05-03 00:00:00.000,Belgrade Serbia ATP World Tour 250,CLAY,2,Sam Querrey,Evgeny Korolev,Sam Querrey,6-3; 6-4,R16,71,7,5,41,56,32,41,7,15,2,3,10,39,56,4,2,26,58,16,26,16,32,3,6,9,32,58
2010-05-03 00:00:00.000,Belgrade Serbia ATP World Tour 250,CLAY,2,Igor Andreev,Ivo Karlovic,Igor Andreev,6-4; 7-5,R16,87,3,4,34,60,28,34,17,26,0,0,11,45,60,9,3,39,70,32,39,13,31,2,4,11,45,70
2010-05-03 00:00:00.000,Belgrade Serbia ATP World Tour 250,CLAY,2,Viktor Troicki,Florent Serra,Viktor Troicki,6-0; 6-1,R16,41,6,2,17,29,16,17,8,12,0,0,6,24,29,0,4,21,40,8,21,4,19,4,10,7,12,40
2010-05-03 00:00:00.000,Belgrade Serbia ATP World Tour 250,CLAY,2,Stanislas Wawrinka,Alessio Di Mauro,Stanislas Wawrinka,6-1; 6-4,R16,77,6,2,20,49,17,20,20,29,2,2,9,37,49,1,1,45,71,24,45,14,26,10,13,8,38,71
2010-05-03 00:00:00.000,Belgrade Serbia ATP World Tour 250,CLAY,2,Richard Gasquet,Andreas Seppi,Richard Gasquet,4-6; 6-2; 7-5,R16,143,6,3,49,90,34,49,27,41,2,4,15,61,90,0,2,63,98,44,63,15,35,6,10,15,59,98
2010-05-03 00:00:00.000,Belgrade Serbia ATP World Tour 250,CLAY,2,John Isner,Josselin Ouanna,John Isner,6-2; 6-4,R16,52,16,2,33,49,28,33,10,16,1,1,9,38,49,2,1,29,48,19,29,9,19,3,6,9,28,48
2010-05-03 00:00:00.000,Belgrade Serbia ATP World Tour 250,CLAY,2,Filip Krajinovic,Novak Djokovic,Filip Krajinovic,6-4 RET,Q,40,1,2,14,26,9,14,8,12,0,1,5,17,26,0,1,27,43,15,27,8,16,7,9,5,23,43
2010-05-03 00:00:00.000,Belgrade Serbia ATP World Tour 250,CLAY,2,Sam Querrey,Igor Andreev,Sam Querrey,6-3; 2-6; 6-4,Q,101,7,3,43,76,33,43,18,33,2,5,14,51,76,4,4,47,87,33,47,20,40,7,10,13,53,87
2010-05-03 00:00:00.000,Belgrade Serbia ATP World Tour 250,CLAY,2,Stanislas Wawrinka,Viktor Troicki,Stanislas Wawrinka,7-5; 6-7(3); 7-6(6),Q,205,4,4,75,127,55,75,32,52,5,5,18,87,127,4,2,75,131,57,75,31,56,6,7,18,88,131
2010-05-03 00:00:00.000,Belgrade Serbia ATP World Tour 250,CLAY,2,John Isner,Richard Gasquet,John Isner,2-6; 7-6(6); 6-3,Q,160,20,2,76,119,54,76,20,43,9,12,15,74,119,5,4,53,90,38,53,22,37,3,5,14,60,90
2010-05-03 00:00:00.000,Belgrade Serbia ATP World Tour 250,CLAY,2,Sam Querrey,Filip Krajinovic,Sam Querrey,6-1; 6-2,S,51,8,1,27,46,25,27,10,19,2,2,8,35,46,2,2,27,41,12,27,6,14,0,4,7,18,41
2010-05-03 00:00:00.000,Belgrade Serbia ATP World Tour 250,CLAY,2,John Isner,Stanislas Wawrinka,John Isner,7-5; 7-5,S,88,9,2,49,66,41,49,9,17,2,2,12,50,66,4,3,47,68,37,47,9,21,1,3,12,46,68
2010-05-03 00:00:00.000,Belgrade Serbia ATP World Tour 250,CLAY,2,Sam Querrey,John Isner,Sam Querrey,3-6; 7-6(4); 6-4,F,116,11,6,47,89,40,47,24,42,4,6,15,64,89,13,2,63,105,48,63,23,42,5,7,16,71,105
2010-05-03 00:00:00.000,Estoril Portugal ATP World Tour 250,CLAY,2,Roger Federer,N/A Bye,Roger Federer,,R32,0,0,0,0,0,0,0,0,0,0,0,0,0,0,0,0,0,0,0,0,0,0,0,0,0,0,0
2010-05-03 00:00:00.000,Estoril Portugal ATP World Tour 250,CLAY,2,Bjorn Phau,Marc Lopez,Bjorn Phau,6-4; 4-6; 6-1,R32,146,5,6,50,101,36,50,24,51,5,8,14,60,101,0,1,66,100,39,66,15,34,7,12,13,54,100
2010-05-03 00:00:00.000,Estoril Portugal ATP World Tour 250,CLAY,2,Arnaud Clement,Igor Kunitsyn,Arnaud Clement,7-5; 4-6; 6-4,R32,173,2,3,59,106,38,59,23,47,9,14,16,61,106,5,2,56,98,35,56,19,42,8,14,16,54,98
2010-05-03 00:00:00.000,Estoril Portugal ATP World Tour 250,CLAY,2,Alejandro Falla,Juan Ignacio Chela,Alejandro Falla,6-4; 7-6(4),R32,113,0,0,51,71,35,51,11,20,5,8,11,46,71,1,2,50,81,30,50,15,31,4,8,11,45,81
2010-05-03 00:00:00.000,Estoril Portugal ATP World Tour 250,CLAY,2,Albert Montanes,N/A Bye,Albert Montanes,,R32,0,0,0,0,0,0,0,0,0,0,0,0,0,0,0,0,0,0,0,0,0,0,0,0,0,0,0
2010-05-03 00:00:00.000,Estoril Portugal ATP World Tour 250,CLAY,2,Daniel Gimeno-Traver,Nicolas Lapentti,Daniel Gimeno-Traver,6-3; 3-1 RET,R32,66,3,1,25,48,17,25,11,23,6,8,7,28,48,0,3,21,42,10,21,9,21,3,7,6,19,42
2010-05-03 00:00:00.000,Estoril Portugal ATP World Tour 250,CLAY,2,Marcel Granollers,Oscar Hernandez,Marcel Granollers,6-2; 6-1,R32,70,0,1,27,37,23,27,7,10,2,2,7,30,37,0,2,37,50,15,37,5,13,5,10,8,20,50
2010-05-03 00:00:00.000,Estoril Portugal ATP World Tour 250,CLAY,2,Pablo Cuevas,Pablo Andujar,Pablo Cuevas,1-6; 7-5; 6-0,R32,114,5,2,47,69,33,47,11,22,4,9,13,44,69,1,6,55,85,29,55,12,30,9,15,12,41,85
2010-05-03 00:00:00.000,Estoril Portugal ATP World Tour 250,CLAY,2,Guillermo Garcia-Lopez,Xavier Malisse,Guillermo Garcia-Lopez,6-2; 7-6(7),R32,106,1,1,52,77,36,52,14,25,2,3,10,50,77,2,3,37,73,26,37,17,36,0,3,10,43,73
2010-05-03 00:00:00.000,Estoril Portugal ATP World Tour 250,CLAY,2,Leonardo Tavares,Ricardo Mello,Leonardo Tavares,6-3; 6-3,R32,85,2,4,38,60,30,38,11,22,5,5,9,41,60,1,3,45,64,23,45,12,19,8,11,9,35,64
2010-05-03 00:00:00.000,Estoril Portugal ATP World Tour 250,CLAY,2,Alberto Martin,Federico Delbonis,Alberto Martin,7-6(6); 6-1,R32,81,0,0,46,71,28,46,19,25,0,1,10,47,71,4,3,32,59,18,32,15,27,1,4,9,33,59
2010-05-03 00:00:00.000,Estoril Portugal ATP World Tour 250,CLAY,2,David Marrero,N/A Bye,David Marrero,,R32,0,0,0,0,0,0,0,0,0,0,0,0,0,0,0,0,0,0,0,0,0,0,0,0,0,0,0
2010-05-03 00:00:00.000,Estoril Portugal ATP World Tour 250,CLAY,2,Frederico Gil,Florian Mayer,Frederico Gil,6-2; 6-7(5); 6-3,R32,138,2,1,65,98,43,65,16,33,2,5,14,59,98,2,6,56,101,30,56,21,45,6,13,15,51,101
2010-05-03 00:00:00.000,Estoril Portugal ATP World Tour 250,CLAY,2,Santiago Giraldo,Steve Darcis,Santiago Giraldo,6-4 RET,R32,38,1,0,19,28,15,19,7,9,3,3,5,22,28,1,1,16,35,11,16,10,19,2,3,5,21,35
2010-05-03 00:00:00.000,Estoril Portugal ATP World Tour 250,CLAY,2,Rui Machado,Nicolas Massu,Rui Machado,6-2; 6-4,R32,91,2,2,46,63,31,46,10,17,5,6,9,41,63,1,6,34,63,18,34,13,29,7,11,9,31,63
2010-05-03 00:00:00.000,Estoril Portugal ATP World Tour 250,CLAY,2,Michal Przysiezny,N/A Bye,Michal Przysiezny,,R32,0,0,0,0,0,0,0,0,0,0,0,0,0,0,0,0,0,0,0,0,0,0,0,0,0,0,0
2010-05-03 00:00:00.000,Estoril Portugal ATP World Tour 250,CLAY,2,Roger Federer,Bjorn Phau,Roger Federer,6-3; 6-4,R16,83,3,0,27,56,20,27,22,29,3,3,10,42,56,4,5,43,78,29,43,15,35,7,9,9,44,78
2010-05-03 00:00:00.000,Estoril Portugal ATP World Tour 250,CLAY,2,Arnaud Clement,Alejandro Falla,Arnaud Clement,6-4; 6-3,R16,91,0,0,33,58,26,33,16,25,0,0,10,42,58,2,1,40,57,31,40,4,17,5,7,9,35,57
2010-05-03 00:00:00.000,Estoril Portugal ATP World Tour 250,CLAY,2,Albert Montanes,Daniel Gimeno-Traver,Albert Montanes,6-1; 6-2,R16,56,1,0,36,49,28,36,7,13,2,2,8,35,49,2,0,23,41,16,23,3,18,1,5,7,19,41
2010-05-03 00:00:00.000,Estoril Portugal ATP World Tour 250,CLAY,2,Pablo Cuevas,Marcel Granollers,Pablo Cuevas,7-6(8); 7-6(2),R16,133,1,2,54,82,39,54,14,28,4,7,12,53,82,1,5,51,84,32,51,17,33,1,4,12,49,84
2010-05-03 00:00:00.000,Estoril Portugal ATP World Tour 250,CLAY,2,Guillermo Garcia-Lopez,Leonardo Tavares,Guillermo Garcia-Lopez,6-2; 6-2,R16,82,1,0,31,43,22,31,11,12,0,0,8,33,43,2,1,50,70,27,50,7,20,11,15,8,34,70
2010-05-03 00:00:00.000,Estoril Portugal ATP World Tour 250,CLAY,2,Alberto Martin,David Marrero,Alberto Martin,6-1; 6-2,R16,67,3,0,26,44,19,26,14,18,0,0,8,33,44,1,2,39,51,21,39,4,12,4,8,7,25,51
2010-05-03 00:00:00.000,Estoril Portugal ATP World Tour 250,CLAY,2,Frederico Gil,Santiago Giraldo,Frederico Gil,6-4; 6-4,R16,92,5,3,43,63,34,43,8,20,1,2,10,42,63,5,3,40,71,28,40,11,31,3,6,10,39,71
2010-05-03 00:00:00.000,Estoril Portugal ATP World Tour 250,CLAY,2,Rui Machado,Michal Przysiezny,Rui Machado,6-4; 6-4,R16,92,3,5,48,66,39,48,4,18,6,7,10,43,66,1,3,39,70,31,39,10,31,5,8,10,41,70
2010-05-03 00:00:00.000,Estoril Portugal ATP World Tour 250,CLAY,2,Roger Federer,Arnaud Clement,Roger Federer,7-6(7); 6-2,Q,97,4,0,37,62,30,37,15,25,2,3,10,45,62,3,0,46,76,30,46,12,30,5,8,10,42,76
2010-05-03 00:00:00.000,Estoril Portugal ATP World Tour 250,CLAY,2,Albert Montanes,Pablo Cuevas,Albert Montanes,6-4; 6-3,Q,90,2,3,33,58,23,33,12,25,2,5,10,35,58,3,1,47,64,26,47,6,17,7,12,9,32,64
2010-05-03 00:00:00.000,Estoril Portugal ATP World Tour 250,CLAY,2,Guillermo Garcia-Lopez,Alberto Martin,Guillermo Garcia-Lopez,6-0; 2-0 RET,Q,27,1,0,13,17,12,13,4,4,0,0,4,16,17,0,0,16,20,4,16,0,4,1,5,4,4,20
2010-05-03 00:00:00.000,Estoril Portugal ATP World Tour 250,CLAY,2,Frederico Gil,Rui Machado,Frederico Gil,4-6; 7-6(1); 6-3,Q,140,3,1,60,101,43,60,23,41,4,8,15,66,101,3,1,71,90,44,71,10,19,2,7,16,54,90
2010-05-03 00:00:00.000,Estoril Portugal ATP World Tour 250,CLAY,2,Albert Montanes,Roger Federer,Albert Montanes,6-2; 7-6(5),S,82,0,0,42,61,29,42,13,19,2,3,10,42,61,2,1,43,65,28,43,10,22,3,6,10,38,65
2010-05-03 00:00:00.000,Estoril Portugal ATP World Tour 250,CLAY,2,Frederico Gil,Guillermo Garcia-Lopez,Frederico Gil,6-2; 5-7; 6-3,S,149,2,1,60,93,41,60,17,33,3,6,14,58,93,3,4,77,105,44,77,13,28,8,14,15,57,105
2010-05-03 00:00:00.000,Estoril Portugal ATP World Tour 250,CLAY,2,Albert Montanes,Frederico Gil,Albert Montanes,6-2; 6-7(4); 7-5,F,153,2,4,55,97,42,55,18,42,2,6,16,60,97,1,2,70,108,39,70,18,38,8,15,16,57,108
2010-05-09 00:00:00.000,ATP World Tour Masters 1000 Madrid Spain ATP World Tour Masters 1000,CLAY,2,Roger Federer,N/A Bye,Roger Federer,,R64,0,0,0,0,0,0,0,0,0,0,0,0,0,0,0,0,0,0,0,0,0,0,0,0,0,0,0
2010-05-09 00:00:00.000,ATP World Tour Masters 1000 Madrid Spain ATP World Tour Masters 1000,CLAY,2,Benjamin Becker,Carlos Moya,Benjamin Becker,6-0; 6-2,R64,63,3,0,26,46,21,26,12,20,5,5,7,33,46,2,2,25,46,11,25,8,21,4,9,7,19,46
2010-05-09 00:00:00.000,ATP World Tour Masters 1000 Madrid Spain ATP World Tour Masters 1000,CLAY,2,Leonardo Mayer,Julien Benneteau,Leonardo Mayer,6-7(9); 7-5; 6-4,R64,162,8,3,72,110,54,72,22,38,5,6,17,76,110,4,7,71,110,52,71,19,39,1,4,17,71,110
2010-05-09 00:00:00.000,ATP World Tour Masters 1000 Madrid Spain ATP World Tour Masters 1000,CLAY,2,Stanislas Wawrinka,Marcel Granollers,Stanislas Wawrinka,6-4; 6-4,R64,92,3,2,36,70,20,36,15,34,6,10,10,35,70,0,1,33,62,17,33,11,29,3,9,10,28,62
2010-05-09 00:00:00.000,ATP World Tour Masters 1000 Madrid Spain ATP World Tour Masters 1000,CLAY,2,Mikhail Youzhny,Lukas Lacko,Mikhail Youzhny,2-6; 6-3; 6-1,R64,97,2,2,45,69,31,45,13,24,1,4,12,44,69,7,1,45,73,29,45,12,28,5,10,12,41,73
2010-05-09 00:00:00.000,ATP World Tour Masters 1000 Madrid Spain ATP World Tour Masters 1000,CLAY,2,Ernests Gulbis,Albert Montanes,Ernests Gulbis,7-5; 6-1,R64,97,6,1,38,58,27,38,13,20,4,5,10,40,58,1,0,42,59,24,42,6,17,3,7,9,30,59
2010-05-09 00:00:00.000,ATP World Tour Masters 1000 Madrid Spain ATP World Tour Masters 1000,CLAY,2,Feliciano Lopez,Lukasz Kubot,Feliciano Lopez,6-3; 6-3,R64,72,6,3,28,53,23,28,10,25,2,4,9,33,53,0,3,34,50,19,34,7,16,3,8,9,26,50
2010-05-09 00:00:00.000,ATP World Tour Masters 1000 Madrid Spain ATP World Tour Masters 1000,CLAY,2,Oscar Hernandez,N/A Bye,Oscar Hernandez,,R64,0,0,0,0,0,0,0,0,0,0,0,0,0,0,0,0,0,0,0,0,0,0,0,0,0,0,0
2010-05-09 00:00:00.000,ATP World Tour Masters 1000 Madrid Spain ATP World Tour Masters 1000,CLAY,2,Andy Murray,N/A Bye,Andy Murray,,R64,0,0,0,0,0,0,0,0,0,0,0,0,0,0,0,0,0,0,0,0,0,0,0,0,0,0,0
2010-05-09 00:00:00.000,ATP World Tour Masters 1000 Madrid Spain ATP World Tour Masters 1000,CLAY,2,Juan Ignacio Chela,Pablo Cuevas,Juan Ignacio Chela,2-0 RET,R64,5,1,0,5,5,5,5,0,0,0,0,1,5,5,0,0,3,5,1,3,0,2,0,1,1,1,5
2010-05-09 00:00:00.000,ATP World Tour Masters 1000 Madrid Spain ATP World Tour Masters 1000,CLAY,2,Victor Hanescu,Igor Andreev,Victor Hanescu,3-6; 6-5 RET,R64,96,4,2,48,67,32,48,8,19,1,4,10,40,67,7,0,29,61,23,29,16,32,2,4,10,39,61
2010-05-09 00:00:00.000,ATP World Tour Masters 1000 Madrid Spain ATP World Tour Masters 1000,CLAY,2,Daniel Munoz-De La Nava,Sam Querrey,Daniel Munoz-De La Nava,6-7(3); 6-3; 7-5,R64,132,5,0,52,100,39,52,30,48,5,6,16,69,100,17,1,65,100,52,65,14,35,1,5,17,66,100
2010-05-09 00:00:00.000,ATP World Tour Masters 1000 Madrid Spain ATP World Tour Masters 1000,CLAY,2,David Ferrer,Jeremy Chardy,David Ferrer,6-3; 7-6(2),R64,111,0,2,47,65,30,47,10,18,4,7,10,40,65,3,0,50,92,30,50,18,42,13,18,11,48,92
2010-05-09 00:00:00.000,ATP World Tour Masters 1000 Madrid Spain ATP World Tour Masters 1000,CLAY,2,Marcos Baghdatis,Marco Chiudinelli,Marcos Baghdatis,6-3; 6-4,R64,85,12,4,40,62,32,40,13,22,2,2,10,45,62,5,2,35,59,24,35,12,24,3,5,9,36,59
2010-05-09 00:00:00.000,ATP World Tour Masters 1000 Madrid Spain ATP World Tour Masters 1000,CLAY,2,Eduardo Schwank,Paul-Henri Mathieu,Eduardo Schwank,6-3; 6-3,R64,78,6,1,35,54,25,35,12,19,0,1,9,37,54,2,5,27,51,17,27,10,24,3,7,9,27,51
2010-05-09 00:00:00.000,ATP World Tour Masters 1000 Madrid Spain ATP World Tour Masters 1000,CLAY,2,Marin Cilic,N/A Bye,Marin Cilic,,R64,0,0,0,0,0,0,0,0,0,0,0,0,0,0,0,0,0,0,0,0,0,0,0,0,0,0,0
2010-05-09 00:00:00.000,ATP World Tour Masters 1000 Madrid Spain ATP World Tour Masters 1000,CLAY,2,Fernando Verdasco,N/A Bye,Fernando Verdasco,,R64,0,0,0,0,0,0,0,0,0,0,0,0,0,0,0,0,0,0,0,0,0,0,0,0,0,0,0
2010-05-09 00:00:00.000,ATP World Tour Masters 1000 Madrid Spain ATP World Tour Masters 1000,CLAY,2,Ivo Karlovic,Evgeny Korolev,Ivo Karlovic,6-4; 7-6(5),R64,95,19,0,47,70,39,47,15,23,2,2,11,54,70,1,3,47,74,35,47,16,27,2,3,11,51,74
2010-05-09 00:00:00.000,ATP World Tour Masters 1000 Madrid Spain ATP World Tour Masters 1000,CLAY,2,Jurgen Melzer,Kevin Anderson,Jurgen Melzer,6-2; 2-6; 6-4,R64,116,6,0,64,83,42,64,7,19,6,9,13,49,83,7,1,51,81,35,51,13,30,4,8,13,48,81
2010-05-09 00:00:00.000,ATP World Tour Masters 1000 Madrid Spain ATP World Tour Masters 1000,CLAY,2,Mardy Fish,Michael Russell,Mardy Fish,6-2; 7-6(1),R64,105,14,2,49,80,36,49,15,31,5,7,10,51,80,1,1,46,67,27,46,9,21,2,6,10,36,67
2010-05-09 00:00:00.000,ATP World Tour Masters 1000 Madrid Spain ATP World Tour Masters 1000,CLAY,2,Thomaz Bellucci,Pere Riba,Thomaz Bellucci,7-6(5); 6-1,R64,88,4,2,38,67,27,38,17,29,2,4,10,44,67,3,0,29,56,21,29,11,27,1,5,9,32,56
2010-05-09 00:00:00.000,ATP World Tour Masters 1000 Madrid Spain ATP World Tour Masters 1000,CLAY,2,Juan Monaco,Simon Greul,Juan Monaco,6-1; 6-1,R64,59,4,3,29,43,19,29,9,14,1,2,7,28,43,1,1,37,46,16,37,2,9,3,9,7,18,46
2010-05-09 00:00:00.000,ATP World Tour Masters 1000 Madrid Spain ATP World Tour Masters 1000,CLAY,2,Nicolas Almagro,Viktor Troicki,Nicolas Almagro,6-1; 7-6(3),R64,99,2,1,51,80,34,51,14,29,7,9,10,48,80,7,3,42,71,26,42,9,29,5,9,9,35,71
2010-05-09 00:00:00.000,ATP World Tour Masters 1000 Madrid Spain ATP World Tour Masters 1000,CLAY,2,Robin Soderling,N/A Bye,Robin Soderling,,R64,0,0,0,0,0,0,0,0,0,0,0,0,0,0,0,0,0,0,0,0,0,0,0,0,0,0,0
2010-05-09 00:00:00.000,ATP World Tour Masters 1000 Madrid Spain ATP World Tour Masters 1000,CLAY,2,Jo-Wilfried Tsonga,N/A Bye,Jo-Wilfried Tsonga,,R64,0,0,0,0,0,0,0,0,0,0,0,0,0,0,0,0,0,0,0,0,0,0,0,0,0,0,0
2010-05-09 00:00:00.000,ATP World Tour Masters 1000 Madrid Spain ATP World Tour Masters 1000,CLAY,2,Guillermo Garcia-Lopez,Daniel Gimeno-Traver,Guillermo Garcia-Lopez,6-3; 6-4,R64,71,2,1,33,52,28,33,11,19,1,2,10,39,52,2,1,32,48,23,32,7,16,4,7,9,30,48
2010-05-09 00:00:00.000,ATP World Tour Masters 1000 Madrid Spain ATP World Tour Masters 1000,CLAY,2,Philipp Petzschner,Fabio Fognini,Philipp Petzschner,6-1; 4-6; 7-5,R64,121,5,3,52,97,35,52,21,45,8,12,14,56,97,0,4,55,84,36,55,8,29,3,10,15,44,84
2010-05-09 00:00:00.000,ATP World Tour Masters 1000 Madrid Spain ATP World Tour Masters 1000,CLAY,2,Gael Monfils,Stephane Robert,Gael Monfils,6-2; 7-5,R64,84,7,3,38,62,24,38,13,24,2,4,10,37,62,0,1,36,59,17,36,12,23,1,6,10,29,59
2010-05-09 00:00:00.000,ATP World Tour Masters 1000 Madrid Spain ATP World Tour Masters 1000,CLAY,2,John Isner,Christophe Rochus,John Isner,5-7; 6-2; 6-2,R64,102,21,2,52,79,44,52,15,27,3,4,14,59,79,4,3,49,88,33,49,20,39,5,9,14,53,88
2010-05-09 00:00:00.000,ATP World Tour Masters 1000 Madrid Spain ATP World Tour Masters 1000,CLAY,2,Santiago Giraldo,Philipp Kohlschreiber,Santiago Giraldo,1-6; 6-2; 6-3,R64,99,1,0,50,72,38,50,10,22,2,4,12,48,72,4,2,52,74,37,52,11,22,4,7,12,48,74
2010-05-09 00:00:00.000,ATP World Tour Masters 1000 Madrid Spain ATP World Tour Masters 1000,CLAY,2,Alexandr Dolgopolov,Andreas Seppi,Alexandr Dolgopolov,6-3; 6-4,R64,66,4,0,32,58,26,32,16,26,3,3,10,42,58,3,1,25,45,17,25,15,20,2,4,9,32,45
2010-05-09 00:00:00.000,ATP World Tour Masters 1000 Madrid Spain ATP World Tour Masters 1000,CLAY,2,Rafael Nadal,N/A Bye,Rafael Nadal,,R64,0,0,0,0,0,0,0,0,0,0,0,0,0,0,0,0,0,0,0,0,0,0,0,0,0,0,0
2010-05-09 00:00:00.000,ATP World Tour Masters 1000 Madrid Spain ATP World Tour Masters 1000,CLAY,2,Roger Federer,Benjamin Becker,Roger Federer,6-2; 7-6(4),R32,82,8,1,39,57,32,39,12,18,0,0,10,44,57,9,0,47,73,35,47,8,26,6,8,10,43,73
2010-05-09 00:00:00.000,ATP World Tour Masters 1000 Madrid Spain ATP World Tour Masters 1000,CLAY,2,Stanislas Wawrinka,Leonardo Mayer,Stanislas Wawrinka,6-4; 4-2 RET,R32,66,3,1,28,42,23,28,7,14,1,2,8,30,42,1,2,31,45,19,31,7,14,5,8,8,26,45
2010-05-09 00:00:00.000,ATP World Tour Masters 1000 Madrid Spain ATP World Tour Masters 1000,CLAY,2,Ernests Gulbis,Mikhail Youzhny,Ernests Gulbis,7-6(2); 6-4,R32,104,5,0,35,58,32,35,17,23,1,1,11,49,58,3,2,55,73,40,55,7,18,5,6,11,47,73
2010-05-09 00:00:00.000,ATP World Tour Masters 1000 Madrid Spain ATP World Tour Masters 1000,CLAY,2,Feliciano Lopez,Oscar Hernandez,Feliciano Lopez,6-1; 6-2,R32,64,4,3,22,42,21,22,10,20,1,1,7,31,42,4,3,40,58,20,40,7,18,5,10,8,27,58
2010-05-09 00:00:00.000,ATP World Tour Masters 1000 Madrid Spain ATP World Tour Masters 1000,CLAY,2,Andy Murray,Juan Ignacio Chela,Andy Murray,6-3; 6-3,R32,73,5,1,19,43,17,19,14,24,0,2,9,31,43,0,2,47,67,22,47,8,20,6,11,9,30,67
2010-05-09 00:00:00.000,ATP World Tour Masters 1000 Madrid Spain ATP World Tour Masters 1000,CLAY,2,Victor Hanescu,Daniel Munoz-De La Nava,Victor Hanescu,6-0; 4-6; 6-3,R32,102,7,1,59,76,44,59,9,17,4,6,13,53,76,2,3,39,66,25,39,11,27,4,9,12,36,66
2010-05-09 00:00:00.000,ATP World Tour Masters 1000 Madrid Spain ATP World Tour Masters 1000,CLAY,2,David Ferrer,Marcos Baghdatis,David Ferrer,1-6; 6-3; 7-5,R32,158,2,1,67,99,41,67,17,32,13,17,14,58,99,8,1,48,106,32,48,27,58,12,16,14,59,106
2010-05-09 00:00:00.000,ATP World Tour Masters 1000 Madrid Spain ATP World Tour Masters 1000,CLAY,2,Marin Cilic,Eduardo Schwank,Marin Cilic,6-3; 6-0,R32,66,5,0,26,53,21,26,14,27,3,4,8,35,53,1,6,21,44,10,21,7,23,3,8,7,17,44
2010-05-09 00:00:00.000,ATP World Tour Masters 1000 Madrid Spain ATP World Tour Masters 1000,CLAY,2,Fernando Verdasco,Ivo Karlovic,Fernando Verdasco,7-6(5); 6-3,R32,99,7,2,56,67,46,56,6,11,2,2,11,52,67,11,1,49,74,35,49,14,25,2,3,10,49,74
2010-05-09 00:00:00.000,ATP World Tour Masters 1000 Madrid Spain ATP World Tour Masters 1000,CLAY,2,Jurgen Melzer,Mardy Fish,Jurgen Melzer,3-6; 6-1; 6-4,R32,99,4,2,40,72,30,40,19,32,0,1,13,49,72,8,2,41,74,30,41,19,33,1,4,13,49,74
2010-05-09 00:00:00.000,ATP World Tour Masters 1000 Madrid Spain ATP World Tour Masters 1000,CLAY,2,Juan Monaco,Thomaz Bellucci,Juan Monaco,6-2; 6-2,R32,71,0,0,37,50,24,37,10,13,3,4,8,34,50,1,4,26,52,14,26,11,26,8,13,8,25,52
2010-05-09 00:00:00.000,ATP World Tour Masters 1000 Madrid Spain ATP World Tour Masters 1000,CLAY,2,Nicolas Almagro,Robin Soderling,Nicolas Almagro,6-4; 7-5,R32,102,8,0,40,71,27,40,18,31,4,6,11,45,71,4,2,39,73,27,39,13,34,9,13,11,40,73
2010-05-09 00:00:00.000,ATP World Tour Masters 1000 Madrid Spain ATP World Tour Masters 1000,CLAY,2,Guillermo Garcia-Lopez,Jo-Wilfried Tsonga,Guillermo Garcia-Lopez,6-2 RET,R32,40,1,0,16,24,9,16,6,8,5,6,4,15,24,0,4,14,24,6,14,3,10,3,6,4,9,24
2010-05-09 00:00:00.000,ATP World Tour Masters 1000 Madrid Spain ATP World Tour Masters 1000,CLAY,2,Gael Monfils,Philipp Petzschner,Gael Monfils,1-1 RET,R32,11,0,2,4,8,2,4,1,4,0,1,1,3,8,0,0,8,9,3,8,0,1,0,1,1,3,9
2010-05-09 00:00:00.000,ATP World Tour Masters 1000 Madrid Spain ATP World Tour Masters 1000,CLAY,2,John Isner,Santiago Giraldo,John Isner,1-6; 7-6(6); 6-2,R32,115,22,3,77,110,48,77,16,33,11,14,14,64,110,1,0,59,75,42,59,9,16,2,4,13,51,75
2010-05-09 00:00:00.000,ATP World Tour Masters 1000 Madrid Spain ATP World Tour Masters 1000,CLAY,2,Rafael Nadal,Alexandr Dolgopolov,Rafael Nadal,6-4; 6-3,R32,87,0,2,52,68,37,52,9,16,1,1,9,46,68,3,0,33,59,22,33,13,26,1,4,10,35,59
2010-05-09 00:00:00.000,ATP World Tour Masters 1000 Madrid Spain ATP World Tour Masters 1000,CLAY,2,Roger Federer,Stanislas Wawrinka,Roger Federer,6-3; 6-1,R16,69,6,1,26,41,22,26,8,15,0,1,8,30,41,3,1,44,64,21,44,8,20,6,11,8,29,64
2010-05-09 00:00:00.000,ATP World Tour Masters 1000 Madrid Spain ATP World Tour Masters 1000,CLAY,2,Ernests Gulbis,Feliciano Lopez,Ernests Gulbis,6-2; 7-6(0),R16,94,9,2,43,59,35,43,10,16,3,3,10,45,59,6,3,48,73,32,48,9,25,10,12,10,41,73
2010-05-09 00:00:00.000,ATP World Tour Masters 1000 Madrid Spain ATP World Tour Masters 1000,CLAY,2,Andy Murray,Victor Hanescu,Andy Murray,6-2; 6-1,R16,70,4,0,26,45,22,26,12,19,2,2,8,34,45,1,1,37,52,19,37,5,15,4,8,7,24,52
2010-05-09 00:00:00.000,ATP World Tour Masters 1000 Madrid Spain ATP World Tour Masters 1000,CLAY,2,David Ferrer,Marin Cilic,David Ferrer,6-3; 6-2,R16,71,3,0,34,47,30,34,7,13,3,3,9,37,47,1,1,31,48,14,31,11,17,0,3,8,25,48
2010-05-09 00:00:00.000,ATP World Tour Masters 1000 Madrid Spain ATP World Tour Masters 1000,CLAY,2,Jurgen Melzer,Fernando Verdasco,Jurgen Melzer,7-5; 6-3,R16,116,4,4,47,79,33,47,13,32,9,12,10,46,79,1,5,44,69,24,44,8,25,7,13,11,32,69
2010-05-09 00:00:00.000,ATP World Tour Masters 1000 Madrid Spain ATP World Tour Masters 1000,CLAY,2,Nicolas Almagro,Juan Monaco,Nicolas Almagro,6-4; 6-1,R16,68,7,0,29,48,24,29,11,19,1,1,8,35,48,2,3,36,51,23,36,2,15,1,5,9,25,51
2010-05-09 00:00:00.000,ATP World Tour Masters 1000 Madrid Spain ATP World Tour Masters 1000,CLAY,2,Gael Monfils,Guillermo Garcia-Lopez,Gael Monfils,7-6(5); 6-4,R16,130,3,1,60,86,44,60,15,26,6,6,11,59,86,1,2,67,98,41,67,20,31,15,16,11,61,98
2010-05-09 00:00:00.000,ATP World Tour Masters 1000 Madrid Spain ATP World Tour Masters 1000,CLAY,2,Rafael Nadal,John Isner,Rafael Nadal,7-5; 6-4,R16,87,1,0,34,52,29,34,15,18,0,0,11,44,52,11,0,43,66,33,43,11,23,0,2,11,44,66
2010-05-09 00:00:00.000,ATP World Tour Masters 1000 Madrid Spain ATP World Tour Masters 1000,CLAY,2,Roger Federer,Ernests Gulbis,Roger Federer,3-6; 6-1; 6-4,Q,113,6,2,56,80,39,56,13,24,4,6,13,52,80,6,1,51,79,31,51,15,28,1,5,13,46,79
2010-05-09 00:00:00.000,ATP World Tour Masters 1000 Madrid Spain ATP World Tour Masters 1000,CLAY,2,David Ferrer,Andy Murray,David Ferrer,7-5; 6-3,Q,131,0,1,69,80,45,69,5,11,6,8,11,50,80,10,2,50,100,34,50,19,50,11,15,10,53,100
2010-05-09 00:00:00.000,ATP World Tour Masters 1000 Madrid Spain ATP World Tour Masters 1000,CLAY,2,Nicolas Almagro,Jurgen Melzer,Nicolas Almagro,6-3; 6-1,Q,58,6,2,27,42,23,27,10,15,0,0,8,33,42,0,2,33,50,20,33,7,17,3,7,8,27,50
2010-05-09 00:00:00.000,ATP World Tour Masters 1000 Madrid Spain ATP World Tour Masters 1000,CLAY,2,Rafael Nadal,Gael Monfils,Rafael Nadal,6-1; 6-3,Q,78,1,1,30,41,27,30,6,11,2,2,8,33,41,3,7,36,67,24,36,10,31,4,8,8,34,67
2010-05-09 00:00:00.000,ATP World Tour Masters 1000 Madrid Spain ATP World Tour Masters 1000,CLAY,2,Roger Federer,David Ferrer,Roger Federer,7-5; 3-6; 6-3,S,126,8,2,49,81,42,49,19,32,3,4,15,61,81,3,3,58,101,37,58,27,43,7,9,15,64,101
2010-05-09 00:00:00.000,ATP World Tour Masters 1000 Madrid Spain ATP World Tour Masters 1000,CLAY,2,Rafael Nadal,Nicolas Almagro,Rafael Nadal,4-6; 6-2; 6-2,S,136,1,1,45,70,35,45,9,25,3,6,13,44,70,5,3,48,90,33,48,15,42,6,12,13,48,90
2010-05-09 00:00:00.000,ATP World Tour Masters 1000 Madrid Spain ATP World Tour Masters 1000,CLAY,2,Rafael Nadal,Roger Federer,Rafael Nadal,6-4; 7-6(5),F,131,2,2,59,81,32,59,14,22,8,11,11,46,81,9,0,59,88,35,59,14,29,7,11,11,49,88
2010-05-16 00:00:00.000,Nice France ATP World Tour 250,CLAY,2,Robin Soderling,N/A Bye,Robin Soderling,,R32,0,0,0,0,0,0,0,0,0,0,0,0,0,0,0,0,0,0,0,0,0,0,0,0,0,0,0
2010-05-16 00:00:00.000,Nice France ATP World Tour 250,CLAY,2,Olivier Rochus,Adrian Mannarino,Olivier Rochus,6-3; 6-1,R32,67,1,0,35,50,25,35,8,15,1,2,8,33,50,2,2,32,46,14,32,6,14,4,9,8,20,46
2010-05-16 00:00:00.000,Nice France ATP World Tour 250,CLAY,2,Richard Gasquet,Lukas Lacko,Richard Gasquet,6-3; 6-0,R32,67,5,1,35,52,28,35,9,17,1,1,8,37,52,1,1,24,47,13,24,11,23,1,5,7,24,47
2010-05-16 00:00:00.000,Nice France ATP World Tour 250,CLAY,2,Alexandr Dolgopolov,Albert Montanes,Alexandr Dolgopolov,6-3; 7-5,R32,75,11,1,39,63,34,39,12,24,2,3,11,46,63,4,4,44,64,29,44,9,20,1,4,10,38,64
2010-05-16 00:00:00.000,Nice France ATP World Tour 250,CLAY,2,Gael Monfils,N/A Bye,Gael Monfils,,R32,0,0,0,0,0,0,0,0,0,0,0,0,0,0,0,0,0,0,0,0,0,0,0,0,0,0,0
2010-05-16 00:00:00.000,Nice France ATP World Tour 250,CLAY,2,Marco Chiudinelli,Fabio Fognini,Marco Chiudinelli,7-5; 6-2,R32,86,4,4,37,60,31,37,9,23,4,5,10,40,60,2,0,40,65,23,40,13,25,3,7,10,36,65
2010-05-16 00:00:00.000,Nice France ATP World Tour 250,CLAY,2,Potito Starace,Steve Darcis,Potito Starace,6-3; 6-1,R32,70,4,0,50,62,33,50,7,12,4,4,8,40,62,1,2,24,40,14,24,6,16,3,7,8,20,40
2010-05-16 00:00:00.000,Nice France ATP World Tour 250,CLAY,2,Lukasz Kubot,Gianni Mina,Lukasz Kubot,7-5; 6-4,R32,95,0,1,38,58,28,38,13,20,0,1,11,41,58,2,1,38,70,24,38,19,32,4,7,11,43,70
2010-05-16 00:00:00.000,Nice France ATP World Tour 250,CLAY,2,Marcos Baghdatis,Laurent Recouderc,Marcos Baghdatis,6-4; 7-5,R32,91,7,0,26,53,23,26,18,27,0,1,11,41,53,3,2,34,73,23,34,21,39,8,11,11,44,73
2010-05-16 00:00:00.000,Nice France ATP World Tour 250,CLAY,2,Simon Greul,Arnaud Clement,Simon Greul,6-3; 6-4,R32,98,5,1,42,63,29,42,6,21,3,6,9,35,63,1,0,31,62,17,31,13,31,5,11,10,30,62
2010-05-16 00:00:00.000,Nice France ATP World Tour 250,CLAY,2,Leonardo Mayer,David Guez,Leonardo Mayer,1-6; 6-1; 6-3,R32,92,6,2,36,57,28,36,11,21,0,2,11,39,57,0,1,50,71,32,50,10,21,0,4,12,42,71
2010-05-16 00:00:00.000,Nice France ATP World Tour 250,CLAY,2,Thomaz Bellucci,N/A Bye,Thomaz Bellucci,,R32,0,0,0,0,0,0,0,0,0,0,0,0,0,0,0,0,0,0,0,0,0,0,0,0,0,0,0
2010-05-16 00:00:00.000,Nice France ATP World Tour 250,CLAY,2,Andreas Seppi,Michael Berrer,Andreas Seppi,6-3; 7-5,R32,94,2,1,40,63,27,40,16,23,2,3,10,43,63,5,2,44,69,28,44,10,25,2,6,11,38,69
2010-05-16 00:00:00.000,Nice France ATP World Tour 250,CLAY,2,Sergiy Stakhovsky,Jarkko Nieminen,Sergiy Stakhovsky,2-6; 6-3; 6-4,R32,99,6,1,59,85,38,59,14,26,2,6,14,52,85,2,1,53,74,37,53,9,21,5,9,13,46,74
2010-05-16 00:00:00.000,Nice France ATP World Tour 250,CLAY,2,Florent Serra,Illya Marchenko,Florent Serra,7-5; 7-6(4),R32,123,2,3,51,74,38,51,11,23,5,7,12,49,74,6,2,63,102,44,63,13,39,7,10,12,57,102
2010-05-16 00:00:00.000,Nice France ATP World Tour 250,CLAY,2,Fernando Verdasco,N/A Bye,Fernando Verdasco,,R32,0,0,0,0,0,0,0,0,0,0,0,0,0,0,0,0,0,0,0,0,0,0,0,0,0,0,0
2010-05-16 00:00:00.000,Nice France ATP World Tour 250,CLAY,2,Olivier Rochus,Robin Soderling,Olivier Rochus,2-6; 6-4; 6-4,R16,122,4,0,68,98,46,68,14,30,3,6,14,60,98,15,1,48,77,38,48,14,29,3,6,14,52,77
2010-05-16 00:00:00.000,Nice France ATP World Tour 250,CLAY,2,Richard Gasquet,Alexandr Dolgopolov,Richard Gasquet,6-0; 2-6; 6-3,R16,82,3,4,46,72,34,46,11,26,3,6,12,45,72,4,3,28,60,18,28,13,32,5,10,11,31,60
2010-05-16 00:00:00.000,Nice France ATP World Tour 250,CLAY,2,Gael Monfils,Marco Chiudinelli,Gael Monfils,1-6; 6-1; 6-4,R16,99,3,3,49,71,35,49,12,22,4,6,12,47,71,0,4,40,74,29,40,15,34,4,7,12,44,74
2010-05-16 00:00:00.000,Nice France ATP World Tour 250,CLAY,2,Potito Starace,Lukasz Kubot,Potito Starace,6-3; 6-4,R16,78,1,0,39,49,28,39,7,10,0,2,10,35,49,1,1,43,53,26,43,3,10,1,5,9,29,53
2010-05-16 00:00:00.000,Nice France ATP World Tour 250,CLAY,2,Marcos Baghdatis,Simon Greul,Marcos Baghdatis,6-3; 6-2,R16,66,3,1,19,46,17,19,20,27,2,2,9,37,46,1,4,35,48,24,35,2,13,2,5,8,26,48
2010-05-16 00:00:00.000,Nice France ATP World Tour 250,CLAY,2,Leonardo Mayer,Thomaz Bellucci,Leonardo Mayer,6-4; 6-1,R16,92,6,1,32,52,24,32,14,20,1,1,9,38,52,2,1,43,69,24,43,13,26,6,9,8,37,69
2010-05-16 00:00:00.000,Nice France ATP World Tour 250,CLAY,2,Sergiy Stakhovsky,Andreas Seppi,Sergiy Stakhovsky,7-5; 6-3,R16,80,2,0,42,56,29,42,7,14,0,3,11,36,56,3,1,49,63,25,49,7,14,2,7,10,32,63
2010-05-16 00:00:00.000,Nice France ATP World Tour 250,CLAY,2,Fernando Verdasco,Florent Serra,Fernando Verdasco,6-2; 6-2,R16,67,4,1,33,52,23,33,14,19,3,3,8,37,52,0,0,33,52,16,33,11,19,4,8,8,27,52
2010-05-16 00:00:00.000,Nice France ATP World Tour 250,CLAY,2,Richard Gasquet,Olivier Rochus,Richard Gasquet,6-4; 6-2,Q,83,5,0,42,60,28,42,12,18,6,7,9,40,60,2,1,33,48,19,33,6,15,3,7,9,25,48
2010-05-16 00:00:00.000,Nice France ATP World Tour 250,CLAY,2,Potito Starace,Gael Monfils,Potito Starace,7-6(2); 6-2,Q,93,4,1,58,66,44,58,3,8,5,6,10,47,66,2,1,58,73,32,58,8,15,3,6,10,40,73
2010-05-16 00:00:00.000,Nice France ATP World Tour 250,CLAY,2,Leonardo Mayer,Marcos Baghdatis,Leonardo Mayer,5-7; 6-3; 6-4,Q,175,6,1,50,84,41,50,22,34,5,6,15,63,84,8,2,62,135,43,62,36,73,21,24,16,79,135
2010-05-16 00:00:00.000,Nice France ATP World Tour 250,CLAY,2,Fernando Verdasco,Sergiy Stakhovsky,Fernando Verdasco,6-2; 6-7(5); 6-4,Q,140,7,2,65,93,47,65,16,28,3,5,15,63,93,2,5,84,113,55,84,9,29,6,11,15,64,113
2010-05-16 00:00:00.000,Nice France ATP World Tour 250,CLAY,2,Richard Gasquet,Potito Starace,Richard Gasquet,7-6(1); 7-6(6),S,122,8,2,61,95,41,61,21,34,6,7,12,62,95,2,0,65,80,43,65,11,15,3,4,12,54,80
2010-05-16 00:00:00.000,Nice France ATP World Tour 250,CLAY,2,Fernando Verdasco,Leonardo Mayer,Fernando Verdasco,7-6(3); 7-5,S,100,6,2,51,68,40,51,11,17,0,1,12,51,68,4,1,49,77,37,49,14,28,4,6,12,51,77
2010-05-16 00:00:00.000,Nice France ATP World Tour 250,CLAY,2,Richard Gasquet,Fernando Verdasco,Richard Gasquet,6-3; 5-7; 7-6(5),F,157,5,5,88,120,52,88,19,32,4,9,17,71,120,3,3,75,98,48,75,12,23,6,11,16,60,98
2010-05-24 00:00:00.000,Roland Garros France Grand Slams,CLAY,3,Roger Federer,Peter Luczak,Roger Federer,6-4; 6-1; 6-2,R128,108,7,0,49,69,39,49,15,20,1,1,13,54,69,6,1,46,81,27,46,17,35,7,12,12,44,81
2010-05-24 00:00:00.000,Roland Garros France Grand Slams,CLAY,3,Alejandro Falla,Janko Tipsarevic,Alejandro Falla,6-1; 6-2; 6-3,R128,76,6,3,37,62,28,37,16,25,2,4,12,44,62,3,4,43,77,21,43,12,34,6,14,12,33,77
2010-05-24 00:00:00.000,Roland Garros France Grand Slams,CLAY,3,Olivier Rochus,Benoit Paire,Olivier Rochus,3-6; 7-6(4); 6-4; 7-5,R128,198,3,6,78,132,55,78,33,54,6,9,21,88,132,24,7,84,153,63,84,30,69,7,11,22,93,153
2010-05-24 00:00:00.000,Roland Garros France Grand Slams,CLAY,3,Julian Reister,Feliciano Lopez,Julian Reister,6-1; 7-6(5); 6-2,R128,134,3,5,63,97,50,63,18,34,5,5,14,68,97,10,1,55,98,39,55,16,43,6,10,13,55,98
2010-05-24 00:00:00.000,Roland Garros France Grand Slams,CLAY,3,Stanislas Wawrinka,Jan Hajek,Stanislas Wawrinka,6-1; 6-3; 6-3,R128,94,10,3,39,66,36,39,18,27,3,3,13,54,66,0,3,66,87,38,66,6,21,8,13,12,44,87
2010-05-24 00:00:00.000,Roland Garros France Grand Slams,CLAY,3,Andreas Beck,Paolo Lorenzi,Andreas Beck,4-6; 6-3; 6-2; 6-2,R128,159,5,3,72,104,55,72,19,32,5,6,18,74,104,14,10,59,105,42,59,19,46,5,10,17,61,105
2010-05-24 00:00:00.000,Roland Garros France Grand Slams,CLAY,3,Fabio Fognini,Nicolas Massu,Fabio Fognini,6-1; 3-6; 2-6; 6-3; 6-3,R128,214,5,7,82,129,59,82,19,47,4,9,21,78,129,8,5,91,143,57,91,21,52,13,20,21,78,143
2010-05-24 00:00:00.000,Roland Garros France Grand Slams,CLAY,3,Gael Monfils,Dieter Kindlmann,Gael Monfils,6-3; 7-5; 6-7(5); 6-2,R128,165,11,9,82,129,57,82,24,47,6,10,20,81,129,3,4,90,142,54,90,25,52,9,18,21,79,142
2010-05-24 00:00:00.000,Roland Garros France Grand Slams,CLAY,3,Marin Cilic,Ricardo Mello,Marin Cilic,6-1; 3-6; 6-3; 6-1,R128,136,5,2,51,95,38,51,23,44,8,11,16,61,95,1,4,59,100,33,59,17,41,4,12,16,50,100
2010-05-24 00:00:00.000,Roland Garros France Grand Slams,CLAY,3,Daniel Gimeno-Traver,Dmitry Tursunov,Daniel Gimeno-Traver,6-1; 6-1; 6-1,R128,78,5,1,37,64,29,37,20,27,3,3,11,49,64,0,1,40,65,16,40,12,25,11,18,10,28,65
2010-05-24 00:00:00.000,Roland Garros France Grand Slams,CLAY,3,Leonardo Mayer,Sergiy Stakhovsky,Leonardo Mayer,7-6(4); 6-3; 6-2,R128,127,11,4,50,87,41,50,26,37,0,0,15,67,87,5,4,60,95,43,60,15,35,2,5,14,58,95
2010-05-24 00:00:00.000,Roland Garros France Grand Slams,CLAY,3,Julien Benneteau,Ernests Gulbis,Julien Benneteau,6-4; 6-2; 1-0 RET,R128,102,3,1,36,58,25,36,13,22,3,4,9,38,58,4,2,30,65,20,30,14,35,5,10,10,34,65
2010-05-24 00:00:00.000,Roland Garros France Grand Slams,CLAY,3,Albert Montanes,Stefano Galvani,Albert Montanes,6-3; 6-3; 6-3,R128,122,8,4,55,101,41,55,25,46,6,7,14,66,101,2,6,52,93,34,52,16,41,6,11,13,50,93
2010-05-24 00:00:00.000,Roland Garros France Grand Slams,CLAY,3,Tobias Kamke,Stephane Robert,Tobias Kamke,6-0; 6-4; 6-3,R128,104,4,3,30,72,19,30,24,42,3,7,12,43,72,1,6,52,89,24,52,11,37,7,17,13,35,89
2010-05-24 00:00:00.000,Roland Garros France Grand Slams,CLAY,3,Taylor Dent,Nicolas Lapentti,Taylor Dent,6-3; 6-4; 7-6(3),R128,134,9,8,48,91,42,48,24,43,2,4,15,66,91,0,3,81,123,51,81,16,42,9,14,16,67,123
2010-05-24 00:00:00.000,Roland Garros France Grand Slams,CLAY,3,Robin Soderling,Laurent Recouderc,Robin Soderling,6-0; 6-2; 6-3,R128,94,9,1,34,57,30,34,19,23,1,1,12,49,57,3,1,41,75,20,41,15,34,5,11,11,35,75
2010-05-24 00:00:00.000,Roland Garros France Grand Slams,CLAY,3,Andy Murray,Richard Gasquet,Andy Murray,4-6; 6-7(5); 6-4; 6-2; 6-1,R128,244,17,8,77,165,56,77,49,88,9,12,24,105,165,13,5,86,158,57,86,34,72,9,16,23,91,158
2010-05-24 00:00:00.000,Roland Garros France Grand Slams,CLAY,3,Juan Ignacio Chela,Ryan Sweeting,Juan Ignacio Chela,6-0; 6-4; 7-6(4),R128,142,2,3,46,87,37,46,23,41,6,8,14,60,87,2,3,86,109,47,86,9,23,10,16,14,56,109
2010-05-24 00:00:00.000,Roland Garros France Grand Slams,CLAY,3,Marcel Granollers,Paul-Henri Mathieu,Marcel Granollers,3-6; 6-3; 3-0 RET,R128,114,5,2,34,59,21,34,11,25,3,7,10,32,59,1,4,46,81,27,46,13,35,11,17,11,40,81
2010-05-24 00:00:00.000,Roland Garros France Grand Slams,CLAY,3,Marcos Baghdatis,Jesse Witten,Marcos Baghdatis,6-3; 6-4; 6-3,R128,106,8,2,42,84,32,42,25,42,3,5,14,57,84,1,3,41,83,21,41,22,42,3,9,14,43,83
2010-05-24 00:00:00.000,Roland Garros France Grand Slams,CLAY,3,John Isner,Andrey Golubev,John Isner,6-4; 6-3; 6-2,R128,90,8,1,52,66,44,52,12,14,0,0,14,56,66,6,4,45,83,33,45,17,38,5,9,13,50,83
2010-05-24 00:00:00.000,Roland Garros France Grand Slams,CLAY,3,Marco Chiudinelli,Somdev Devvarman,Marco Chiudinelli,6-3; 3-6; 6-3; 3-6; 6-3,R128,218,7,6,82,153,62,82,38,71,10,13,23,100,153,13,3,85,137,62,85,25,52,3,7,22,87,137
2010-05-24 00:00:00.000,Roland Garros France Grand Slams,CLAY,3,Edouard Roger-Vasselin,Kevin Anderson,Edouard Roger-Vasselin,1-6; 4-6; 6-3; 7-6(4); 6-1,R128,196,7,8,94,150,69,94,29,56,10,15,23,98,150,15,5,92,134,65,92,19,42,5,10,22,84,134
2010-05-24 00:00:00.000,Roland Garros France Grand Slams,CLAY,3,Tomas Berdych,Jorge Aguilar,Tomas Berdych,7-6(7); 6-3; 6-1,R128,151,17,2,58,82,50,58,17,24,0,0,14,67,82,2,2,66,116,41,66,24,50,13,17,14,65,116
2010-05-24 00:00:00.000,Roland Garros France Grand Slams,CLAY,3,Mikhail Youzhny,Michal Przysiezny,Mikhail Youzhny,6-1; 6-0; 6-4,R128,96,3,2,46,71,37,46,14,25,4,5,12,51,71,3,4,43,71,23,43,9,28,4,11,11,32,71
2010-05-24 00:00:00.000,Roland Garros France Grand Slams,CLAY,3,Lukas Lacko,Michael Yani,Lukas Lacko,4-6; 7-6(5); 7-6(4); 6-7(5); 12-10,R128,296,23,6,131,231,104,131,58,100,14,15,34,162,231,17,10,157,252,116,157,54,95,12,13,34,170,252
2010-05-24 00:00:00.000,Roland Garros France Grand Slams,CLAY,3,Carsten Ball,Philipp Petzschner,Carsten Ball,3-6; 6-7(4); 6-2; 7-5; 9-7,R128,226,14,6,117,185,86,117,35,68,6,10,29,121,185,12,3,100,186,72,100,46,86,12,18,28,118,186
2010-05-24 00:00:00.000,Roland Garros France Grand Slams,CLAY,3,Viktor Troicki,Tommy Robredo,Viktor Troicki,6-4; 6-4; 6-3,R128,130,7,1,52,86,40,52,18,34,3,5,15,58,86,4,2,43,75,30,43,16,32,4,9,14,46,75
2010-05-24 00:00:00.000,Roland Garros France Grand Slams,CLAY,3,Guillermo Garcia-Lopez,Rainer Schuettler,Guillermo Garcia-Lopez,7-5; 6-4; 6-2,R128,142,5,5,60,104,45,60,26,44,5,5,15,71,104,0,4,54,98,41,54,17,44,6,10,15,58,98
2010-05-24 00:00:00.000,Roland Garros France Grand Slams,CLAY,3,Thiemo de Bakker,Olivier Patience,Thiemo de Bakker,6-4; 5-7; 6-4; 6-3,R128,172,16,2,62,112,50,62,33,50,3,4,20,83,112,10,5,89,148,63,89,27,59,6,10,21,90,148
2010-05-24 00:00:00.000,Roland Garros France Grand Slams,CLAY,3,Josselin Ouanna,Lukasz Kubot,Josselin Ouanna,7-6(5); 6-7(4); 6-2; 6-4,R128,215,13,6,90,153,74,90,30,63,10,12,21,104,153,7,8,108,145,74,108,15,37,5,10,21,89,145
2010-05-24 00:00:00.000,Roland Garros France Grand Slams,CLAY,3,Jo-Wilfried Tsonga,Daniel Brands,Jo-Wilfried Tsonga,4-6; 6-3; 6-2; 6-7(2); 7-5,R128,223,16,5,100,174,78,100,39,74,8,11,26,117,174,11,7,93,156,65,93,34,63,8,14,25,99,156
2010-05-24 00:00:00.000,Roland Garros France Grand Slams,CLAY,3,Andy Roddick,Jarkko Nieminen,Andy Roddick,6-2; 4-6; 4-6; 7-6(4); 6-3,R128,199,19,2,90,139,72,90,27,49,4,6,24,99,139,10,7,97,148,68,97,28,51,7,11,25,96,148
2010-05-24 00:00:00.000,Roland Garros France Grand Slams,CLAY,3,Blaz Kavcic,Eduardo Schwank,Blaz Kavcic,3-6; 6-3; 7-5; 4-0 RET,R128,174,5,6,78,114,53,78,18,36,8,11,17,71,114,6,3,77,111,52,77,12,34,5,11,17,64,111
2010-05-24 00:00:00.000,Roland Garros France Grand Slams,CLAY,3,Teymuraz Gabashvili,Daniel Koellerer,Teymuraz Gabashvili,6-2; 6-2; 6-1,R128,93,5,3,41,73,32,41,18,32,2,2,11,50,73,0,3,42,68,23,42,11,26,4,11,12,34,68
2010-05-24 00:00:00.000,Roland Garros France Grand Slams,CLAY,3,Grega Zemlja,Juan Monaco,Grega Zemlja,7-6(6); 3-6; 7-5; 6-3,R128,180,14,6,96,153,73,96,27,57,15,17,21,100,153,8,4,87,125,63,87,21,38,4,7,21,84,125
2010-05-24 00:00:00.000,Roland Garros France Grand Slams,CLAY,3,Jurgen Melzer,Dudi Sela,Jurgen Melzer,7-5; 6-2; 6-4,R128,126,9,0,47,80,37,47,24,33,3,4,15,61,80,4,5,73,116,50,73,14,43,6,11,15,64,116
2010-05-24 00:00:00.000,Roland Garros France Grand Slams,CLAY,3,Nicolas Mahut,Mischa Zverev,Nicolas Mahut,6-1; 6-2; 6-4,R128,117,10,0,61,84,46,61,13,23,4,5,13,59,84,2,5,71,103,39,71,14,32,7,13,12,53,103
2010-05-24 00:00:00.000,Roland Garros France Grand Slams,CLAY,3,Xavier Malisse,Simon Greul,Xavier Malisse,6-4; 7-6(7); 6-4,R128,157,4,2,59,112,41,59,32,53,9,11,16,73,112,1,3,78,123,47,78,25,45,8,12,16,72,123
2010-05-24 00:00:00.000,Roland Garros France Grand Slams,CLAY,3,David Ferrer,David Guez,David Ferrer,6-1; 6-3; 6-1,R128,93,6,2,38,56,33,38,9,18,0,1,11,42,56,0,3,44,66,22,44,5,22,2,10,12,27,66
2010-05-24 00:00:00.000,Roland Garros France Grand Slams,CLAY,3,Juan Carlos Ferrero,Pablo Cuevas,Juan Carlos Ferrero,6-4; 6-3; 6-1,R128,112,0,0,62,78,46,62,8,16,0,1,13,54,78,11,5,55,93,36,55,11,38,11,17,13,47,93
2010-05-24 00:00:00.000,Roland Garros France Grand Slams,CLAY,3,Pere Riba,Marc Gicquel,Pere Riba,6-3; 6-2; 7-6(5),R128,116,8,5,44,87,38,44,24,43,3,5,15,62,87,12,3,59,105,41,59,17,46,3,8,14,58,105
2010-05-24 00:00:00.000,Roland Garros France Grand Slams,CLAY,3,Potito Starace,Illya Marchenko,Potito Starace,6-7(5); 6-1; 6-3; 6-3,R128,185,5,0,93,115,65,93,16,22,1,3,19,81,115,7,8,76,135,49,76,25,59,6,13,18,74,135
2010-05-24 00:00:00.000,Roland Garros France Grand Slams,CLAY,3,Robby Ginepri,Sam Querrey,Robby Ginepri,4-6; 7-6(3); 6-4; 6-2,R128,131,13,1,79,115,60,79,25,36,3,4,20,85,115,14,5,73,123,59,73,25,50,6,9,20,84,123
2010-05-24 00:00:00.000,Roland Garros France Grand Slams,CLAY,3,Victor Hanescu,Oscar Hernandez,Victor Hanescu,6-1; 1-6; 6-4; 6-3,R128,140,9,3,73,107,56,73,16,34,7,9,17,72,107,7,3,60,97,42,60,18,37,3,7,16,60,97
2010-05-24 00:00:00.000,Roland Garros France Grand Slams,CLAY,3,Yuri Schukin,Rajeev Ram,Yuri Schukin,3-6; 6-4; 6-2; 6-4,R128,150,4,2,66,101,50,66,20,35,5,8,19,70,101,12,7,70,124,47,70,22,54,7,12,18,69,124
2010-05-24 00:00:00.000,Roland Garros France Grand Slams,CLAY,3,Kei Nishikori,Santiago Giraldo,Kei Nishikori,2-6; 4-6; 7-6(3); 6-2; 6-4,R128,216,4,1,81,141,59,81,38,60,7,10,24,97,141,8,2,94,168,62,94,45,74,13,16,24,107,168
2010-05-24 00:00:00.000,Roland Garros France Grand Slams,CLAY,3,Novak Djokovic,Evgeny Korolev,Novak Djokovic,6-1; 3-6; 6-1; 6-3,R128,128,7,4,61,97,48,61,17,36,4,6,16,65,97,4,4,46,93,29,46,21,47,5,12,16,50,93
2010-05-24 00:00:00.000,Roland Garros France Grand Slams,CLAY,3,Fernando Verdasco,Igor Kunitsyn,Fernando Verdasco,6-4; 6-2; 6-2,R128,115,6,2,57,78,42,57,14,21,4,5,13,56,78,3,1,46,75,29,46,8,29,4,10,13,37,75
2010-05-24 00:00:00.000,Roland Garros France Grand Slams,CLAY,3,Florent Serra,Michael Russell,Florent Serra,6-4; 6-0; 6-1,R128,99,6,1,43,65,33,43,13,22,6,7,11,46,65,1,10,33,73,16,33,15,40,8,16,12,31,73
2010-05-24 00:00:00.000,Roland Garros France Grand Slams,CLAY,3,Andreas Seppi,Santiago Ventura,Andreas Seppi,7-5; 6-4; 7-5,R128,158,9,1,72,101,49,72,15,29,6,10,17,64,101,11,9,52,127,35,52,32,75,14,21,17,67,127
2010-05-24 00:00:00.000,Roland Garros France Grand Slams,CLAY,3,Philipp Kohlschreiber,Karol Beck,Philipp Kohlschreiber,7-6(7); 6-1; 6-1,R128,131,14,4,49,86,42,49,19,37,3,4,13,61,86,10,2,46,91,31,46,17,45,4,10,13,48,91
2010-05-24 00:00:00.000,Roland Garros France Grand Slams,CLAY,3,Nicolas Almagro,Robin Haase,Nicolas Almagro,6-4; 3-6; 4-6; 7-6(3); 6-4,R128,214,20,0,83,150,57,83,43,67,2,6,25,100,150,10,6,83,164,70,83,38,81,7,11,26,108,164
2010-05-24 00:00:00.000,Roland Garros France Grand Slams,CLAY,3,Steve Darcis,Kristof Vliegen,Steve Darcis,6-1; 6-4; 6-4,R128,111,2,4,38,81,30,38,25,43,2,4,14,55,81,6,4,39,82,27,39,15,43,8,14,13,42,82
2010-05-24 00:00:00.000,Roland Garros France Grand Slams,CLAY,3,Alexandr Dolgopolov,Arnaud Clement,Alexandr Dolgopolov,3-6; 7-6(5); 3-6; 6-3; 6-3,R128,225,14,4,76,148,59,76,40,72,4,7,23,99,148,2,2,81,160,56,81,48,79,11,15,25,104,160
2010-05-24 00:00:00.000,Roland Garros France Grand Slams,CLAY,3,Fernando Gonzalez,Thiago Alves,Fernando Gonzalez,6-2; 4-6; 6-4; 6-4,R128,137,21,6,57,99,47,57,24,42,4,7,19,71,99,5,1,77,101,54,77,8,24,4,10,19,62,101
2010-05-24 00:00:00.000,Roland Garros France Grand Slams,CLAY,3,Ivan Ljubicic,Yen-Hsun Lu,Ivan Ljubicic,7-6(5); 7-5; 6-3,R128,154,10,2,52,105,43,52,28,53,2,3,16,71,105,6,4,69,113,43,69,24,44,8,12,17,67,113
2010-05-24 00:00:00.000,Roland Garros France Grand Slams,CLAY,3,Mardy Fish,Michael Berrer,Mardy Fish,5-7; 6-4; 3-6; 6-1; 6-3,R128,196,17,3,67,127,55,67,30,60,3,7,23,85,127,6,6,89,137,61,89,22,48,9,16,24,83,137
2010-05-24 00:00:00.000,Roland Garros France Grand Slams,CLAY,3,Pablo Andujar,Simone Bolelli,Pablo Andujar,7-6(2); 6-4; 6-2,R128,142,6,3,57,83,44,57,14,26,1,4,15,58,83,5,3,61,93,38,61,12,32,6,12,15,50,93
2010-05-24 00:00:00.000,Roland Garros France Grand Slams,CLAY,3,Thomaz Bellucci,Michael Llodra,Thomaz Bellucci,6-4; 6-2; 6-2,R128,97,7,1,40,64,37,40,16,24,0,0,13,53,64,5,6,49,91,34,49,14,42,6,11,13,48,91
2010-05-24 00:00:00.000,Roland Garros France Grand Slams,CLAY,3,Lleyton Hewitt,Jeremy Chardy,Lleyton Hewitt,7-5; 6-0; 6-4,R128,127,4,5,54,91,40,54,22,37,3,4,14,62,91,5,4,44,81,31,44,13,37,7,13,14,44,81
2010-05-24 00:00:00.000,Roland Garros France Grand Slams,CLAY,3,Denis Istomin,Benjamin Becker,Denis Istomin,7-5; 7-5; 6-3,R128,127,12,2,58,90,45,58,20,32,4,6,17,65,90,9,4,62,97,40,62,17,35,4,9,16,57,97
2010-05-24 00:00:00.000,Roland Garros France Grand Slams,CLAY,3,Horacio Zeballos,Martin Fischer,Horacio Zeballos,7-6(6); 6-7(8); 1-6; 6-4; 8-6,R128,245,18,6,105,164,77,105,32,59,3,8,27,109,164,14,6,95,186,74,95,47,91,9,14,28,121,186
2010-05-24 00:00:00.000,Roland Garros France Grand Slams,CLAY,3,Rafael Nadal,Gianni Mina,Rafael Nadal,6-2; 6-2; 6-2,R128,143,0,0,62,91,44,62,15,29,9,9,12,59,91,3,4,42,83,26,42,14,41,6,12,12,40,83
2010-05-24 00:00:00.000,Roland Garros France Grand Slams,CLAY,3,Roger Federer,Alejandro Falla,Roger Federer,7-6(4); 6-2; 6-4,R64,120,6,0,65,104,49,65,21,39,7,8,15,70,104,3,2,64,94,41,64,16,30,5,9,15,57,94
2010-05-24 00:00:00.000,Roland Garros France Grand Slams,CLAY,3,Julian Reister,Olivier Rochus,Julian Reister,6-2; 6-2; 7-6(5),R64,133,3,1,68,95,46,68,16,27,3,5,14,62,95,0,3,58,92,31,58,15,34,4,10,14,46,92
2010-05-24 00:00:00.000,Roland Garros France Grand Slams,CLAY,3,Stanislas Wawrinka,Andreas Beck,Stanislas Wawrinka,6-1; 6-4; 6-4,R64,106,14,4,43,78,36,43,23,35,1,1,14,59,78,3,3,60,95,34,60,20,35,7,11,13,54,95
2010-05-24 00:00:00.000,Roland Garros France Grand Slams,CLAY,3,Fabio Fognini,Gael Monfils,Fabio Fognini,2-6; 4-6; 7-5; 6-4; 9-7,R64,256,3,7,110,167,74,110,25,57,8,16,28,99,167,15,5,129,200,80,129,32,71,11,19,28,112,200
2010-05-24 00:00:00.000,Roland Garros France Grand Slams,CLAY,3,Marin Cilic,Daniel Gimeno-Traver,Marin Cilic,6-3; 7-6(4); 6-2,R64,137,5,2,56,108,41,56,35,52,6,6,15,76,108,7,2,56,95,37,56,21,39,6,9,14,58,95
2010-05-24 00:00:00.000,Roland Garros France Grand Slams,CLAY,3,Leonardo Mayer,Julien Benneteau,Leonardo Mayer,6-7(4); 6-3; 6-4; 6-4,R64,192,8,3,81,128,63,81,20,47,5,9,21,83,128,2,4,93,131,56,93,19,38,7,14,20,75,131
2010-05-24 00:00:00.000,Roland Garros France Grand Slams,CLAY,3,Albert Montanes,Tobias Kamke,Albert Montanes,6-3; 6-2; 6-1,R64,105,2,4,50,84,41,50,16,34,8,8,12,57,84,1,4,46,72,25,46,9,26,6,12,12,34,72
2010-05-24 00:00:00.000,Roland Garros France Grand Slams,CLAY,3,Robin Soderling,Taylor Dent,Robin Soderling,6-0; 6-1; 6-1,R64,71,8,6,38,64,32,38,14,26,4,4,10,46,64,2,8,29,54,11,29,9,25,4,12,10,20,54
2010-05-24 00:00:00.000,Roland Garros France Grand Slams,CLAY,3,Andy Murray,Juan Ignacio Chela,Andy Murray,6-2; 6-7(5); 6-3; 6-2,R64,210,9,3,83,146,65,83,28,63,8,10,19,93,146,0,3,93,157,55,93,30,64,9,16,18,85,157
2010-05-24 00:00:00.000,Roland Garros France Grand Slams,CLAY,3,Marcos Baghdatis,Marcel Granollers,Marcos Baghdatis,4-6; 6-1; 7-5; 6-2,R64,160,9,0,53,104,39,53,35,51,6,8,19,74,104,6,2,70,108,45,70,19,38,3,9,18,64,108
2010-05-24 00:00:00.000,Roland Garros France Grand Slams,CLAY,3,John Isner,Marco Chiudinelli,John Isner,6-7(3); 7-6(3); 7-6(7); 6-4,R64,191,38,6,102,146,80,102,26,44,2,4,23,106,146,5,2,95,152,72,95,35,57,8,11,23,107,152
2010-05-24 00:00:00.000,Roland Garros France Grand Slams,CLAY,3,Tomas Berdych,Edouard Roger-Vasselin,Tomas Berdych,7-5; 6-1; 6-4,R64,125,5,5,51,85,43,51,18,34,5,7,15,61,85,3,3,65,97,40,65,13,32,6,12,14,53,97
2010-05-24 00:00:00.000,Roland Garros France Grand Slams,CLAY,3,Mikhail Youzhny,Lukas Lacko,Mikhail Youzhny,6-7(8); 6-3; 6-3; 6-2,R64,184,11,3,87,132,60,87,29,45,10,12,19,89,132,3,2,69,124,45,69,26,55,11,18,19,71,124
2010-05-24 00:00:00.000,Roland Garros France Grand Slams,CLAY,3,Viktor Troicki,Carsten Ball,Viktor Troicki,6-4; 6-3; 6-3,R64,105,10,1,50,80,39,50,19,30,5,6,14,58,80,8,4,66,101,44,66,11,35,11,16,14,55,101
2010-05-24 00:00:00.000,Roland Garros France Grand Slams,CLAY,3,Thiemo de Bakker,Guillermo Garcia-Lopez,Thiemo de Bakker,6-3; 3-6; 7-6(5); 7-5,R64,172,15,2,81,126,66,81,20,45,6,9,21,86,126,4,8,90,134,66,90,21,44,3,7,21,87,134
2010-05-24 00:00:00.000,Roland Garros France Grand Slams,CLAY,3,Jo-Wilfried Tsonga,Josselin Ouanna,Jo-Wilfried Tsonga,6-0; 6-1; 6-4,R64,79,9,4,38,64,35,38,15,26,4,4,12,50,64,2,3,35,66,22,35,11,31,4,10,11,33,66
2010-05-24 00:00:00.000,Roland Garros France Grand Slams,CLAY,3,Andy Roddick,Blaz Kavcic,Andy Roddick,6-3; 5-7; 6-4; 6-2,R64,177,13,3,78,121,52,78,18,43,6,13,20,70,121,0,6,95,124,50,95,12,29,9,19,19,62,124
2010-05-24 00:00:00.000,Roland Garros France Grand Slams,CLAY,3,Teymuraz Gabashvili,Grega Zemlja,Teymuraz Gabashvili,6-3; 6-1; 6-1,R64,87,3,1,30,56,23,30,22,26,0,0,11,45,56,7,3,61,98,36,61,12,37,10,17,12,48,98
2010-05-24 00:00:00.000,Roland Garros France Grand Slams,CLAY,3,Jurgen Melzer,Nicolas Mahut,Jurgen Melzer,6-1; 3-6; 7-6(7); 6-4,R64,160,5,1,58,103,46,58,30,45,0,2,19,76,103,8,3,80,121,50,80,24,41,2,6,19,74,121
2010-05-24 00:00:00.000,Roland Garros France Grand Slams,CLAY,3,David Ferrer,Xavier Malisse,David Ferrer,6-2; 6-2; 2-0 RET,R64,76,4,3,27,46,23,27,11,19,2,3,9,34,46,1,2,31,63,17,31,10,32,5,11,9,27,63
2010-05-24 00:00:00.000,Roland Garros France Grand Slams,CLAY,3,Juan Carlos Ferrero,Pere Riba,Juan Carlos Ferrero,7-6(5); 6-7(13); 6-2; 6-2,R64,211,2,3,103,140,73,103,16,37,7,11,20,89,140,11,2,75,151,48,75,33,76,7,15,20,81,151
2010-05-24 00:00:00.000,Roland Garros France Grand Slams,CLAY,3,Robby Ginepri,Potito Starace,Robby Ginepri,3-6; 6-4; 6-3; 6-3,R64,153,6,1,79,118,57,79,23,39,4,6,19,80,118,5,2,86,123,54,86,19,37,9,13,18,73,123
2010-05-24 00:00:00.000,Roland Garros France Grand Slams,CLAY,3,Victor Hanescu,Yuri Schukin,Victor Hanescu,6-3; 6-4; 6-2,R64,100,11,1,57,74,46,57,12,17,0,0,14,58,74,2,3,44,87,28,44,20,43,4,8,13,48,87
2010-05-24 00:00:00.000,Roland Garros France Grand Slams,CLAY,3,Novak Djokovic,Kei Nishikori,Novak Djokovic,6-1; 6-4; 6-4,R64,160,3,9,74,117,53,74,15,43,7,9,14,68,117,1,1,57,95,32,57,17,38,8,14,13,49,95
2010-05-24 00:00:00.000,Roland Garros France Grand Slams,CLAY,3,Fernando Verdasco,Florent Serra,Fernando Verdasco,6-2; 6-2; 0-6; 6-4,R64,135,3,2,57,86,41,57,13,29,1,6,16,54,86,2,1,63,108,33,63,21,45,11,18,16,54,108
2010-05-24 00:00:00.000,Roland Garros France Grand Slams,CLAY,3,Philipp Kohlschreiber,Andreas Seppi,Philipp Kohlschreiber,7-6(5); 6-3; 7-5,R64,157,7,1,54,112,39,54,36,58,4,6,17,75,112,5,2,50,99,33,50,31,49,5,9,16,64,99
2010-05-24 00:00:00.000,Roland Garros France Grand Slams,CLAY,3,Nicolas Almagro,Steve Darcis,Nicolas Almagro,6-3; 6-0; 7-5,R64,100,14,4,36,64,33,36,15,28,0,1,13,48,64,4,2,42,94,24,42,24,52,6,13,14,48,94
2010-05-24 00:00:00.000,Roland Garros France Grand Slams,CLAY,3,Alexandr Dolgopolov,Fernando Gonzalez,Alexandr Dolgopolov,6-3; 6-4; 6-3,R64,109,9,2,48,99,35,48,26,51,5,7,14,61,99,5,3,57,98,34,57,19,41,6,12,14,53,98
2010-05-24 00:00:00.000,Roland Garros France Grand Slams,CLAY,3,Ivan Ljubicic,Mardy Fish,Ivan Ljubicic,6-2; 6-7(8); 4-6; 6-2; 10-8,R64,278,18,1,106,180,84,106,37,74,7,10,28,121,180,10,5,105,191,82,105,36,86,13,20,28,118,191
2010-05-24 00:00:00.000,Roland Garros France Grand Slams,CLAY,3,Thomaz Bellucci,Pablo Andujar,Thomaz Bellucci,1-6; 6-3; 2-6; 6-4; 6-2,R64,207,17,7,79,149,57,79,28,70,7,14,21,85,149,2,3,78,134,49,78,26,56,7,14,21,75,134
2010-05-24 00:00:00.000,Roland Garros France Grand Slams,CLAY,3,Lleyton Hewitt,Denis Istomin,Lleyton Hewitt,1-6; 6-3; 6-4; 2-6; 6-2,R64,188,6,4,65,135,49,65,34,70,7,12,21,83,135,5,1,97,138,63,97,22,41,12,17,21,85,138
2010-05-24 00:00:00.000,Roland Garros France Grand Slams,CLAY,3,Rafael Nadal,Horacio Zeballos,Rafael Nadal,6-2; 6-2; 6-3,R64,105,1,2,59,74,47,59,7,15,5,6,13,54,74,2,0,48,76,24,48,13,28,4,10,12,37,76
2010-05-24 00:00:00.000,Roland Garros France Grand Slams,CLAY,3,Roger Federer,Julian Reister,Roger Federer,6-4; 6-0; 6-4,R32,93,6,3,41,72,36,41,19,31,0,0,13,55,72,1,2,61,80,32,61,9,19,8,13,13,41,80
2010-05-24 00:00:00.000,Roland Garros France Grand Slams,CLAY,3,Stanislas Wawrinka,Fabio Fognini,Stanislas Wawrinka,6-3; 6-4; 6-1,R32,112,7,3,46,79,32,46,20,33,3,4,13,52,79,1,6,52,90,32,52,15,38,5,11,13,47,90
2010-05-24 00:00:00.000,Roland Garros France Grand Slams,CLAY,3,Marin Cilic,Leonardo Mayer,Marin Cilic,6-4; 3-6; 7-5; 6-7(5); 6-4,R32,253,12,6,90,171,65,90,49,81,11,14,26,114,171,23,6,95,163,75,95,34,68,6,11,27,109,163
2010-05-24 00:00:00.000,Roland Garros France Grand Slams,CLAY,3,Robin Soderling,Albert Montanes,Robin Soderling,6-4; 7-5; 2-6; 6-3,R32,149,20,2,72,113,57,72,24,41,5,7,20,81,113,8,3,81,122,55,81,22,41,8,11,19,77,122
2010-05-24 00:00:00.000,Roland Garros France Grand Slams,CLAY,3,Andy Murray,Marcos Baghdatis,Andy Murray,6-2; 6-3; 0-6; 6-2,R32,153,4,6,62,100,43,62,13,38,4,9,15,56,100,5,6,49,116,29,49,30,67,10,18,16,59,116
2010-05-24 00:00:00.000,Roland Garros France Grand Slams,CLAY,3,Tomas Berdych,John Isner,Tomas Berdych,6-2; 6-2; 6-1,R32,93,9,2,30,55,28,30,17,25,0,0,11,45,55,9,1,67,91,37,67,7,24,5,12,12,44,91
2010-05-24 00:00:00.000,Roland Garros France Grand Slams,CLAY,3,Mikhail Youzhny,Viktor Troicki,Mikhail Youzhny,2-6; 7-6(4); 6-2; 6-3,R32,170,3,2,64,101,45,64,18,37,1,6,18,63,101,8,1,79,118,48,79,19,39,7,14,19,67,118
2010-05-24 00:00:00.000,Roland Garros France Grand Slams,CLAY,3,Jo-Wilfried Tsonga,Thiemo de Bakker,Jo-Wilfried Tsonga,6-7(6); 7-6(4); 6-3; 6-4,R32,186,16,5,94,143,76,94,28,49,2,3,22,104,143,8,1,87,144,63,87,34,57,7,10,21,97,144
2010-05-24 00:00:00.000,Roland Garros France Grand Slams,CLAY,3,Teymuraz Gabashvili,Andy Roddick,Teymuraz Gabashvili,6-4; 6-4; 6-2,R32,114,9,1,46,86,36,46,29,40,3,3,14,65,86,4,1,64,89,40,64,12,25,7,11,14,52,89
2010-05-24 00:00:00.000,Roland Garros France Grand Slams,CLAY,3,Jurgen Melzer,David Ferrer,Jurgen Melzer,6-4; 6-0; 7-6(1),R32,116,7,2,56,82,45,56,17,26,4,4,14,62,82,4,2,64,100,35,64,22,36,9,13,14,57,100
2010-05-24 00:00:00.000,Roland Garros France Grand Slams,CLAY,3,Robby Ginepri,Juan Carlos Ferrero,Robby Ginepri,7-5; 6-3; 3-6; 2-6; 6-4,R32,196,5,2,106,152,62,106,28,46,8,15,24,90,152,5,1,107,140,66,107,19,33,5,12,24,85,140
2010-05-24 00:00:00.000,Roland Garros France Grand Slams,CLAY,3,Novak Djokovic,Victor Hanescu,Novak Djokovic,6-3; 3-6; 6-3; 6-2,R32,158,2,8,67,100,50,67,16,33,1,5,18,66,100,5,1,85,118,51,85,16,33,9,16,17,67,118
2010-05-24 00:00:00.000,Roland Garros France Grand Slams,CLAY,3,Fernando Verdasco,Philipp Kohlschreiber,Fernando Verdasco,2-6; 6-3; 6-3; 6-7(1); 6-4,R32,242,5,15,128,170,85,128,15,42,9,16,24,100,170,3,6,91,155,62,91,25,64,8,17,24,87,155
2010-05-24 00:00:00.000,Roland Garros France Grand Slams,CLAY,3,Nicolas Almagro,Alexandr Dolgopolov,Nicolas Almagro,6-3; 6-3; 6-4,R32,113,6,3,42,90,31,42,30,48,5,6,14,61,90,6,1,53,92,28,53,24,39,5,10,14,52,92
2010-05-24 00:00:00.000,Roland Garros France Grand Slams,CLAY,3,Thomaz Bellucci,Ivan Ljubicic,Thomaz Bellucci,7-6(4); 6-2; 6-4,R32,140,7,2,55,95,38,55,19,40,4,8,15,57,95,7,2,64,102,41,64,12,38,6,13,15,53,102
2010-05-24 00:00:00.000,Roland Garros France Grand Slams,CLAY,3,Rafael Nadal,Lleyton Hewitt,Rafael Nadal,6-3; 6-4; 6-3,R32,148,1,1,60,79,42,60,10,19,3,6,14,52,79,5,2,59,110,38,59,19,51,9,16,14,57,110
2010-05-24 00:00:00.000,Roland Garros France Grand Slams,CLAY,3,Roger Federer,Stanislas Wawrinka,Roger Federer,6-3; 7-6(5); 6-2,R16,116,7,0,59,89,43,59,19,30,3,4,14,62,89,5,4,48,87,38,48,16,39,3,8,15,54,87
2010-05-24 00:00:00.000,Roland Garros France Grand Slams,CLAY,3,Robin Soderling,Marin Cilic,Robin Soderling,6-4; 6-4; 6-2,R16,101,6,2,52,72,35,52,12,20,2,5,14,47,72,4,2,45,78,28,45,13,33,7,14,14,41,78
2010-05-24 00:00:00.000,Roland Garros France Grand Slams,CLAY,3,Tomas Berdych,Andy Murray,Tomas Berdych,6-4; 7-5; 6-3,R16,136,10,2,38,83,35,38,24,45,0,1,15,59,83,14,4,54,105,36,54,24,51,9,14,16,60,105
2010-05-24 00:00:00.000,Roland Garros France Grand Slams,CLAY,3,Mikhail Youzhny,Jo-Wilfried Tsonga,Mikhail Youzhny,6-2 RET,R16,30,0,0,12,17,10,12,3,5,0,1,4,13,17,0,1,11,20,5,11,1,9,2,5,4,6,20
2010-05-24 00:00:00.000,Roland Garros France Grand Slams,CLAY,3,Jurgen Melzer,Teymuraz Gabashvili,Jurgen Melzer,7-6(6); 4-6; 6-1; 6-4,R16,174,11,1,69,128,54,69,34,59,6,8,20,88,128,9,1,70,123,47,70,30,53,9,13,19,77,123
2010-05-24 00:00:00.000,Roland Garros France Grand Slams,CLAY,3,Novak Djokovic,Robby Ginepri,Novak Djokovic,6-4; 2-6; 6-1; 6-2,R16,137,2,2,76,109,52,76,18,33,6,8,17,70,109,3,0,64,87,44,64,10,23,4,9,16,54,87
2010-05-24 00:00:00.000,Roland Garros France Grand Slams,CLAY,3,Nicolas Almagro,Fernando Verdasco,Nicolas Almagro,6-1; 4-6; 6-1; 6-4,R16,132,6,1,45,88,36,45,30,43,0,1,17,66,88,2,3,73,96,42,73,12,23,6,12,17,54,96
2010-05-24 00:00:00.000,Roland Garros France Grand Slams,CLAY,3,Rafael Nadal,Thomaz Bellucci,Rafael Nadal,6-2; 7-5; 6-4,R16,153,2,0,65,88,41,65,15,23,5,9,15,56,88,2,1,56,102,29,56,20,46,3,11,15,49,102
2010-05-24 00:00:00.000,Roland Garros France Grand Slams,CLAY,3,Robin Soderling,Roger Federer,Robin Soderling,3-6; 6-3; 7-5; 6-4,Q,150,14,6,81,126,59,81,25,45,5,7,20,84,126,12,2,76,119,56,76,23,43,5,9,20,79,119
2010-05-24 00:00:00.000,Roland Garros France Grand Slams,CLAY,3,Tomas Berdych,Mikhail Youzhny,Tomas Berdych,6-3; 6-1; 6-2,Q,114,8,2,36,69,31,36,21,33,3,3,12,52,69,1,3,53,82,31,53,11,29,6,12,12,42,82
2010-05-24 00:00:00.000,Roland Garros France Grand Slams,CLAY,3,Jurgen Melzer,Novak Djokovic,Jurgen Melzer,3-6; 2-6; 6-2; 7-6(3); 6-4,Q,255,9,5,73,145,52,73,41,72,4,8,23,93,145,4,10,127,197,85,127,32,70,20,24,24,117,197
2010-05-24 00:00:00.000,Roland Garros France Grand Slams,CLAY,3,Rafael Nadal,Nicolas Almagro,Rafael Nadal,7-6(2); 7-6(3); 6-4,Q,155,4,0,81,111,59,81,17,30,1,2,17,76,111,5,1,71,112,51,71,20,41,4,6,17,71,112
2010-05-24 00:00:00.000,Roland Garros France Grand Slams,CLAY,3,Robin Soderling,Tomas Berdych,Robin Soderling,6-3; 3-6; 5-7; 6-3; 6-3,S,207,18,8,91,145,69,91,27,54,8,12,24,96,145,21,5,75,150,56,75,35,75,7,13,24,91,150
2010-05-24 00:00:00.000,Roland Garros France Grand Slams,CLAY,3,Rafael Nadal,Jurgen Melzer,Rafael Nadal,6-2; 6-3; 7-6(6),S,129,4,4,65,85,49,65,11,20,1,3,15,60,85,3,2,72,99,41,72,10,27,3,8,14,51,99
2010-05-24 00:00:00.000,Roland Garros France Grand Slams,CLAY,3,Rafael Nadal,Robin Soderling,Rafael Nadal,6-4; 6-2; 6-4,F,138,7,1,69,90,51,69,13,21,8,8,14,64,90,7,4,51,91,33,51,22,40,8,12,14,55,91
2010-06-07 00:00:00.000,Halle Germany ATP World Tour 250,GRASS,2,Roger Federer,Jarkko Nieminen,Roger Federer,6-4; 6-4,R32,64,11,2,43,57,39,43,5,14,3,3,10,44,57,3,1,40,62,30,40,8,22,2,4,10,38,62
2010-06-07 00:00:00.000,Halle Germany ATP World Tour 250,GRASS,2,Alejandro Falla,Noam Okun,Alejandro Falla,6-4; 6-3,R32,97,5,1,26,44,23,26,10,18,0,1,9,33,44,5,4,47,78,30,47,12,31,12,16,10,42,78
2010-06-07 00:00:00.000,Halle Germany ATP World Tour 250,GRASS,2,Marco Chiudinelli,Olivier Rochus,Marco Chiudinelli,6-3; 2-6; 6-3,R32,133,12,7,42,82,32,42,16,40,5,9,13,48,82,1,6,52,98,35,52,19,46,7,12,13,54,98
2010-06-07 00:00:00.000,Halle Germany ATP World Tour 250,GRASS,2,Philipp Kohlschreiber,Ruben Bemelmans,Philipp Kohlschreiber,7-6(2); 6-7(10); 6-4,R32,149,9,3,78,111,63,78,20,33,3,4,17,83,111,18,2,84,120,63,84,19,36,4,6,17,82,120
2010-06-07 00:00:00.000,Halle Germany ATP World Tour 250,GRASS,2,Dominik Meffert,Juan Carlos Ferrero,Dominik Meffert,6-3; 7-5,R32,71,16,4,44,63,34,44,14,19,1,1,11,48,63,6,2,46,70,33,46,11,24,2,4,10,44,70
2010-06-07 00:00:00.000,Halle Germany ATP World Tour 250,GRASS,2,Lukas Lacko,Jeremy Chardy,Lukas Lacko,7-5; 7-6(0),R32,83,4,1,52,73,39,52,12,21,1,2,12,51,73,6,3,42,73,31,42,16,31,4,6,12,47,73
2010-06-07 00:00:00.000,Halle Germany ATP World Tour 250,GRASS,2,Viktor Troicki,Guillermo Garcia-Lopez,Viktor Troicki,6-1; 7-6(4),R32,84,5,5,37,70,30,37,15,33,4,5,10,45,70,1,6,33,57,25,33,7,24,2,5,9,32,57
2010-06-07 00:00:00.000,Halle Germany ATP World Tour 250,GRASS,2,Philipp Petzschner,Marcos Baghdatis,Philipp Petzschner,6-4; 6-3,R32,69,5,5,42,73,33,42,14,31,4,5,10,47,73,1,0,18,42,12,18,14,24,1,4,9,26,42
2010-06-07 00:00:00.000,Halle Germany ATP World Tour 250,GRASS,2,Lleyton Hewitt,Peter Luczak,Lleyton Hewitt,6-2; 6-2,R32,61,5,0,19,42,16,19,17,23,0,0,8,33,42,4,3,28,47,18,28,5,19,2,6,8,23,47
2010-06-07 00:00:00.000,Halle Germany ATP World Tour 250,GRASS,2,Thiemo de Bakker,Rohan Bopanna,Thiemo de Bakker,6-4; 7-6(11),R32,82,10,1,52,74,40,52,16,22,0,0,11,56,74,12,6,66,92,48,66,11,26,5,6,11,59,92
2010-06-07 00:00:00.000,Halle Germany ATP World Tour 250,GRASS,2,Andreas Beck,Sergiy Stakhovsky,Andreas Beck,6-1; 7-5,R32,85,4,9,41,69,27,41,14,28,4,6,10,41,69,5,7,39,66,23,39,8,27,1,6,9,31,66
2010-06-07 00:00:00.000,Halle Germany ATP World Tour 250,GRASS,2,Nicolas Kiefer,Mikhail Youzhny,Nicolas Kiefer,4-6; 6-1; 7-5,R32,128,19,3,54,90,48,54,17,36,4,5,15,65,90,3,1,58,85,42,58,13,27,4,7,14,55,85
2010-06-07 00:00:00.000,Halle Germany ATP World Tour 250,GRASS,2,Jurgen Melzer,Alexander Kudryavtsev,Jurgen Melzer,3-6; 7-6(2); 6-2,R32,107,9,1,51,88,39,51,19,37,4,6,14,58,88,5,1,57,100,39,57,23,43,1,4,15,62,100
2010-06-07 00:00:00.000,Halle Germany ATP World Tour 250,GRASS,2,Mischa Zverev,Florent Serra,Mischa Zverev,6-4; 6-4,R32,81,8,3,48,63,33,48,11,15,4,5,10,44,63,4,0,40,75,27,40,15,35,2,5,10,42,75
2010-06-07 00:00:00.000,Halle Germany ATP World Tour 250,GRASS,2,Benjamin Becker,Mikhail Ledovskikh,Benjamin Becker,6-4; 6-2,R32,55,17,1,28,45,27,28,10,17,1,1,9,37,45,2,5,37,64,28,37,6,27,7,10,9,34,64
2010-06-07 00:00:00.000,Halle Germany ATP World Tour 250,GRASS,2,Nikolay Davydenko,Simon Greul,Nikolay Davydenko,7-6(1); 6-0,R32,94,3,4,41,67,33,41,10,26,3,4,9,43,67,3,1,51,70,23,51,11,19,9,13,9,34,70
2010-06-07 00:00:00.000,Halle Germany ATP World Tour 250,GRASS,2,Roger Federer,Alejandro Falla,Roger Federer,6-1; 6-2,R16,52,6,1,30,44,27,30,8,14,2,2,8,35,44,4,0,31,49,19,31,6,18,6,10,7,25,49
2010-06-07 00:00:00.000,Halle Germany ATP World Tour 250,GRASS,2,Philipp Kohlschreiber,Marco Chiudinelli,Philipp Kohlschreiber,6-4; 7-5,R16,87,13,2,38,61,30,38,14,23,4,5,11,44,61,6,2,40,64,28,40,10,24,1,4,11,38,64
2010-06-07 00:00:00.000,Halle Germany ATP World Tour 250,GRASS,2,Lukas Lacko,Dominik Meffert,Lukas Lacko,2-6; 6-4; 6-3,R16,110,11,1,50,79,36,50,17,29,6,9,14,53,79,9,1,48,84,33,48,18,36,6,9,13,51,84
2010-06-07 00:00:00.000,Halle Germany ATP World Tour 250,GRASS,2,Philipp Petzschner,Viktor Troicki,Philipp Petzschner,7-6(5); 6-3,R16,101,6,4,52,75,37,52,13,23,6,7,11,50,75,9,5,49,77,37,49,10,28,4,6,10,47,77
2010-06-07 00:00:00.000,Halle Germany ATP World Tour 250,GRASS,2,Lleyton Hewitt,Thiemo de Bakker,Lleyton Hewitt,6-3; 6-3,R16,66,3,3,29,44,25,29,11,15,0,0,9,36,44,9,2,36,54,26,36,7,18,2,5,9,33,54
2010-06-07 00:00:00.000,Halle Germany ATP World Tour 250,GRASS,2,Andreas Beck,Nicolas Kiefer,Andreas Beck,6-2; 3-6; 7-6(4),R16,130,7,4,51,87,39,51,20,36,3,6,14,59,87,16,12,40,96,33,40,26,56,3,7,15,59,96
2010-06-07 00:00:00.000,Halle Germany ATP World Tour 250,GRASS,2,Mischa Zverev,Jurgen Melzer,Mischa Zverev,3-6; 7-6(2); 7-6(3),R16,138,11,4,73,102,58,73,15,29,4,6,16,73,102,7,1,63,103,50,63,24,40,2,3,17,74,103
2010-06-07 00:00:00.000,Halle Germany ATP World Tour 250,GRASS,2,Benjamin Becker,Nikolay Davydenko,Benjamin Becker,6-3; 6-4,R16,73,6,0,35,58,26,35,17,23,2,2,10,43,58,5,1,32,51,24,32,10,19,3,5,9,34,51
2010-06-07 00:00:00.000,Halle Germany ATP World Tour 250,GRASS,2,Roger Federer,Philipp Kohlschreiber,Roger Federer,7-5; 6-3,Q,68,12,1,39,55,35,39,10,16,1,1,11,45,55,3,0,32,56,26,32,12,24,0,2,10,38,56
2010-06-07 00:00:00.000,Halle Germany ATP World Tour 250,GRASS,2,Philipp Petzschner,Lukas Lacko,Philipp Petzschner,6-4; 6-3,Q,75,8,3,34,63,26,34,13,29,4,5,9,39,63,3,1,38,60,26,38,10,22,3,7,10,36,60
2010-06-07 00:00:00.000,Halle Germany ATP World Tour 250,GRASS,2,Lleyton Hewitt,Andreas Beck,Lleyton Hewitt,7-6(0); 6-1,Q,85,13,3,40,64,33,40,11,24,4,5,10,44,64,4,6,30,60,20,30,14,30,3,6,9,34,60
2010-06-07 00:00:00.000,Halle Germany ATP World Tour 250,GRASS,2,Benjamin Becker,Mischa Zverev,Benjamin Becker,7-6(4); 6-0,Q,73,10,2,30,47,27,30,12,17,1,2,9,39,47,0,5,44,68,26,44,10,24,5,9,9,36,68
2010-06-07 00:00:00.000,Halle Germany ATP World Tour 250,GRASS,2,Roger Federer,Philipp Petzschner,Roger Federer,7-6(3); 6-4,S,92,6,1,45,75,30,45,18,30,5,7,11,48,75,7,2,31,71,25,31,17,40,4,7,11,42,71
2010-06-07 00:00:00.000,Halle Germany ATP World Tour 250,GRASS,2,Lleyton Hewitt,Benjamin Becker,Lleyton Hewitt,6-7(4); 7-6(3); 6-2,S,144,13,0,61,100,48,61,25,39,4,5,16,73,100,20,2,73,118,53,73,24,45,7,10,16,77,118
2010-06-07 00:00:00.000,Halle Germany ATP World Tour 250,GRASS,2,Lleyton Hewitt,Roger Federer,Lleyton Hewitt,3-6; 7-6(4); 6-4,F,142,6,3,61,99,46,61,20,38,8,10,15,66,99,13,1,75,125,52,75,23,50,7,9,16,75,125
2010-06-07 00:00:00.000,London / Queen's Club Great Britain ATP World Tour 250,GRASS,2,Rafael Nadal,N/A Bye,Rafael Nadal,,R64,0,0,0,0,0,0,0,0,0,0,0,0,0,0,0,0,0,0,0,0,0,0,0,0,0,0,0
2010-06-07 00:00:00.000,London / Queen's Club Great Britain ATP World Tour 250,GRASS,2,Marcos Daniel,Blaz Kavcic,Marcos Daniel,6-1; 6-4,R64,67,3,1,34,64,27,34,16,30,7,7,9,43,64,2,1,33,47,21,33,6,14,0,3,8,27,47
2010-06-07 00:00:00.000,London / Queen's Club Great Britain ATP World Tour 250,GRASS,2,Dustin Brown,Frank Dancevic,Dustin Brown,7-5; 6-7(4); 6-4,R64,121,14,5,74,120,56,74,22,46,7,10,17,78,120,7,2,76,115,51,76,20,39,11,16,17,71,115
2010-06-07 00:00:00.000,London / Queen's Club Great Britain ATP World Tour 250,GRASS,2,Denis Istomin,Jamie Baker,Denis Istomin,6-1; 6-4,R64,68,4,1,31,49,23,31,14,18,0,0,9,37,49,1,2,32,55,22,32,8,23,4,7,8,30,55
2010-06-07 00:00:00.000,London / Queen's Club Great Britain ATP World Tour 250,GRASS,2,Julien Benneteau,Arnaud Clement,Julien Benneteau,6-2; 6-4,R64,65,11,3,35,49,30,35,8,14,0,0,9,38,49,0,2,32,53,20,32,11,21,4,7,9,31,53
2010-06-07 00:00:00.000,London / Queen's Club Great Britain ATP World Tour 250,GRASS,2,Kevin Anderson,Taylor Dent,Kevin Anderson,6-7(7); 6-3; 7-5,R64,128,17,3,65,108,48,65,25,43,7,9,17,73,108,16,10,56,103,46,56,21,47,4,8,16,67,103
2010-06-07 00:00:00.000,London / Queen's Club Great Britain ATP World Tour 250,GRASS,2,Grigor Dimitrov,Alex Bogdanovic,Grigor Dimitrov,4-6; 6-3; 6-4,R64,129,9,3,61,94,44,61,13,33,4,7,15,57,94,4,3,49,74,35,49,12,25,3,7,14,47,74
2010-06-07 00:00:00.000,London / Queen's Club Great Britain ATP World Tour 250,GRASS,2,Feliciano Lopez,N/A Bye,Feliciano Lopez,,R64,0,0,0,0,0,0,0,0,0,0,0,0,0,0,0,0,0,0,0,0,0,0,0,0,0,0,0
2010-06-07 00:00:00.000,London / Queen's Club Great Britain ATP World Tour 250,GRASS,2,Andy Murray,N/A Bye,Andy Murray,,R64,0,0,0,0,0,0,0,0,0,0,0,0,0,0,0,0,0,0,0,0,0,0,0,0,0,0,0
2010-06-07 00:00:00.000,London / Queen's Club Great Britain ATP World Tour 250,GRASS,2,Ivan Navarro,Daniel Koellerer,Ivan Navarro,6-3; 6-4,R64,83,10,3,37,54,29,37,11,17,0,1,10,40,54,1,2,39,59,24,39,10,20,4,7,9,34,59
2010-06-07 00:00:00.000,London / Queen's Club Great Britain ATP World Tour 250,GRASS,2,Mardy Fish,Somdev Devvarman,Mardy Fish,6-1; 6-4,R64,56,11,0,33,48,29,33,8,15,2,2,9,37,48,3,2,27,43,20,27,6,16,0,3,8,26,43
2010-06-07 00:00:00.000,London / Queen's Club Great Britain ATP World Tour 250,GRASS,2,Santiago Giraldo,Evgeny Korolev,Santiago Giraldo,7-6(6); 4-6; 6-3,R64,134,14,1,68,104,45,68,23,36,4,7,16,68,104,6,2,57,103,39,57,26,46,10,13,15,65,103
2010-06-07 00:00:00.000,London / Queen's Club Great Britain ATP World Tour 250,GRASS,2,Michael Llodra,Andrey Golubev,Michael Llodra,6-3; 6-2,R64,55,10,1,29,46,26,29,11,17,2,2,9,37,46,8,1,30,44,18,30,5,14,0,3,8,23,44
2010-06-07 00:00:00.000,London / Queen's Club Great Britain ATP World Tour 250,GRASS,2,Jesse Levine,Ryan Harrison,Jesse Levine,6-3; 6-3,R64,77,5,7,52,74,38,52,9,22,3,3,9,47,74,0,1,31,52,19,31,10,21,3,6,9,29,52
2010-06-07 00:00:00.000,London / Queen's Club Great Britain ATP World Tour 250,GRASS,2,Nicolas Mahut,Yen-Hsun Lu,Nicolas Mahut,7-6(2); 6-4,R64,86,15,4,50,79,36,50,14,29,5,8,11,50,79,4,1,43,61,26,43,10,18,1,5,11,36,61
2010-06-07 00:00:00.000,London / Queen's Club Great Britain ATP World Tour 250,GRASS,2,Marin Cilic,N/A Bye,Marin Cilic,,R64,0,0,0,0,0,0,0,0,0,0,0,0,0,0,0,0,0,0,0,0,0,0,0,0,0,0,0
2010-06-07 00:00:00.000,London / Queen's Club Great Britain ATP World Tour 250,GRASS,2,Gael Monfils,N/A Bye,Gael Monfils,,R64,0,0,0,0,0,0,0,0,0,0,0,0,0,0,0,0,0,0,0,0,0,0,0,0,0,0,0
2010-06-07 00:00:00.000,London / Queen's Club Great Britain ATP World Tour 250,GRASS,2,Rainer Schuettler,Daniel Gimeno-Traver,Rainer Schuettler,6-1; 6-2,R64,46,1,0,25,41,21,25,12,16,1,1,8,33,41,3,3,25,40,13,25,5,15,3,7,7,18,40
2010-06-07 00:00:00.000,London / Queen's Club Great Britain ATP World Tour 250,GRASS,2,Rajeev Ram,Karol Beck,Rajeev Ram,1-6; 6-3; 6-4,R64,102,9,3,58,93,40,58,17,35,9,11,13,57,93,6,2,48,69,35,48,14,21,2,4,13,49,69
2010-06-07 00:00:00.000,London / Queen's Club Great Britain ATP World Tour 250,GRASS,2,Richard Gasquet,Kei Nishikori,Richard Gasquet,6-3; 6-3,R64,80,7,1,42,63,31,42,12,21,8,8,9,43,63,1,4,38,57,23,38,9,19,4,7,9,32,57
2010-06-07 00:00:00.000,London / Queen's Club Great Britain ATP World Tour 250,GRASS,2,Dudi Sela,Chris Guccione,Dudi Sela,6-7(4); 7-6(5); 6-4,R64,116,5,4,63,99,49,63,29,36,3,3,17,78,99,20,0,75,104,58,75,16,29,4,5,17,74,104
2010-06-07 00:00:00.000,London / Queen's Club Great Britain ATP World Tour 250,GRASS,2,Gilles Muller,Michal Przysiezny,Gilles Muller,7-6(3); 6-3,R64,84,13,1,43,66,35,43,17,23,3,3,11,52,66,14,4,52,66,41,52,5,14,3,4,10,46,66
2010-06-07 00:00:00.000,London / Queen's Club Great Britain ATP World Tour 250,GRASS,2,Igor Kunitsyn,Illya Marchenko,Igor Kunitsyn,1-6; 6-4; 6-3,R64,119,1,0,65,93,40,65,15,28,7,10,13,55,93,9,0,52,78,41,52,8,26,2,5,13,49,78
2010-06-07 00:00:00.000,London / Queen's Club Great Britain ATP World Tour 250,GRASS,2,Andy Roddick,N/A Bye,Andy Roddick,,R64,0,0,0,0,0,0,0,0,0,0,0,0,0,0,0,0,0,0,0,0,0,0,0,0,0,0,0
2010-06-07 00:00:00.000,London / Queen's Club Great Britain ATP World Tour 250,GRASS,2,Sam Querrey,N/A Bye,Sam Querrey,,R64,0,0,0,0,0,0,0,0,0,0,0,0,0,0,0,0,0,0,0,0,0,0,0,0,0,0,0
2010-06-07 00:00:00.000,London / Queen's Club Great Britain ATP World Tour 250,GRASS,2,Robby Ginepri,James Ward,Robby Ginepri,6-3; 7-5,R64,83,5,1,49,68,35,49,11,19,6,7,11,46,68,5,3,38,63,30,38,8,25,3,6,10,38,63
2010-06-07 00:00:00.000,London / Queen's Club Great Britain ATP World Tour 250,GRASS,2,Marc Gicquel,Michael Russell,Marc Gicquel,7-6(6); 6-3,R64,89,7,4,45,81,34,45,20,36,9,10,11,54,81,5,4,39,62,25,39,13,23,1,3,10,38,62
2010-06-07 00:00:00.000,London / Queen's Club Great Britain ATP World Tour 250,GRASS,2,Marcel Granollers,Janko Tipsarevic,Marcel Granollers,6-4; 3-6; 6-3,R64,135,9,1,58,93,44,58,17,35,8,10,14,61,93,5,1,42,90,35,42,21,48,4,7,14,56,90
2010-06-07 00:00:00.000,London / Queen's Club Great Britain ATP World Tour 250,GRASS,2,Bernard Tomic,Andreas Seppi,Bernard Tomic,6-3; 5-7; 6-3,R64,101,5,5,62,101,41,62,19,39,5,8,15,60,101,14,1,59,93,41,59,12,34,5,10,15,53,93
2010-06-07 00:00:00.000,London / Queen's Club Great Britain ATP World Tour 250,GRASS,2,Xavier Malisse,Dmitry Tursunov,Xavier Malisse,6-2; 7-6(3),R64,88,9,1,37,52,33,37,6,15,0,1,10,39,52,2,1,47,76,29,47,10,29,1,4,10,39,76
2010-06-07 00:00:00.000,London / Queen's Club Great Britain ATP World Tour 250,GRASS,2,Paolo Lorenzi,Pere Riba,Paolo Lorenzi,6-4; 6-4,R64,82,6,1,43,60,34,43,9,17,2,2,10,43,60,6,3,42,68,30,42,10,26,3,5,10,40,68
2010-06-07 00:00:00.000,London / Queen's Club Great Britain ATP World Tour 250,GRASS,2,Novak Djokovic,N/A Bye,Novak Djokovic,,R64,0,0,0,0,0,0,0,0,0,0,0,0,0,0,0,0,0,0,0,0,0,0,0,0,0,0,0
2010-06-07 00:00:00.000,London / Queen's Club Great Britain ATP World Tour 250,GRASS,2,Rafael Nadal,Marcos Daniel,Rafael Nadal,6-2; 6-2,R32,53,6,1,26,39,24,26,8,13,0,0,8,32,39,3,1,34,55,23,34,4,21,2,6,8,27,55
2010-06-07 00:00:00.000,London / Queen's Club Great Britain ATP World Tour 250,GRASS,2,Denis Istomin,Dustin Brown,Denis Istomin,7-6(7); 6-4,R32,66,7,2,55,70,44,55,9,15,1,1,11,53,70,13,0,42,67,31,42,18,25,0,1,11,49,67
2010-06-07 00:00:00.000,London / Queen's Club Great Britain ATP World Tour 250,GRASS,2,Julien Benneteau,Kevin Anderson,Julien Benneteau,7-5; 6-3,R32,85,3,5,41,63,31,41,11,22,4,6,11,42,63,5,1,30,49,21,30,8,19,0,4,10,29,49
2010-06-07 00:00:00.000,London / Queen's Club Great Britain ATP World Tour 250,GRASS,2,Feliciano Lopez,Grigor Dimitrov,Feliciano Lopez,6-2; 6-4,R32,138,6,0,30,45,27,30,10,15,3,3,9,37,45,8,3,23,50,18,23,11,27,3,6,9,29,50
2010-06-07 00:00:00.000,London / Queen's Club Great Britain ATP World Tour 250,GRASS,2,Andy Murray,Ivan Navarro,Andy Murray,7-6(8); 6-3,R32,86,6,1,37,63,32,37,17,26,0,0,10,49,63,8,3,48,81,32,48,19,33,2,4,11,51,81
2010-06-07 00:00:00.000,London / Queen's Club Great Britain ATP World Tour 250,GRASS,2,Mardy Fish,Santiago Giraldo,Mardy Fish,7-6(5); 6-2,R32,75,16,2,40,62,35,40,11,22,1,1,10,46,62,5,2,49,73,35,49,11,24,2,4,10,46,73
2010-06-07 00:00:00.000,London / Queen's Club Great Britain ATP World Tour 250,GRASS,2,Michael Llodra,Jesse Levine,Michael Llodra,6-4; 6-2,R32,84,11,4,33,55,22,33,17,22,3,3,9,39,55,5,1,35,50,24,35,5,15,0,3,9,29,50
2010-06-07 00:00:00.000,London / Queen's Club Great Britain ATP World Tour 250,GRASS,2,Marin Cilic,Nicolas Mahut,Marin Cilic,6-7(5); 6-3; 6-2,R32,114,7,4,47,79,43,47,20,32,0,1,15,63,79,4,1,56,86,44,56,15,30,4,8,14,59,86
2010-06-07 00:00:00.000,London / Queen's Club Great Britain ATP World Tour 250,GRASS,2,Rainer Schuettler,Gael Monfils,Rainer Schuettler,6-3; 6-7(4); 6-2,R32,122,2,1,71,99,51,71,14,28,3,4,15,65,99,5,4,62,92,41,62,13,30,3,7,14,54,92
2010-06-07 00:00:00.000,London / Queen's Club Great Britain ATP World Tour 250,GRASS,2,Richard Gasquet,Rajeev Ram,Richard Gasquet,6-3; 7-5,R32,60,3,1,40,57,32,40,13,17,2,2,11,45,57,11,1,35,50,27,35,8,15,2,4,10,35,50
2010-06-07 00:00:00.000,London / Queen's Club Great Britain ATP World Tour 250,GRASS,2,Dudi Sela,Gilles Muller,Dudi Sela,7-5; 6-2,R32,64,3,0,29,46,26,29,14,17,0,0,10,40,46,6,3,38,53,26,38,6,15,0,3,10,32,53
2010-06-07 00:00:00.000,London / Queen's Club Great Britain ATP World Tour 250,GRASS,2,Andy Roddick,Igor Kunitsyn,Andy Roddick,6-2; 6-1,R32,51,12,1,28,38,21,28,9,10,1,1,7,30,38,3,1,34,50,19,34,5,16,7,12,8,24,50
2010-06-07 00:00:00.000,London / Queen's Club Great Britain ATP World Tour 250,GRASS,2,Sam Querrey,Robby Ginepri,Sam Querrey,7-6(4); 6-2,R32,62,10,0,48,57,39,48,7,9,0,0,10,46,57,3,0,49,63,34,49,6,14,2,4,10,40,63
2010-06-07 00:00:00.000,London / Queen's Club Great Britain ATP World Tour 250,GRASS,2,Marcel Granollers,Marc Gicquel,Marcel Granollers,6-1; 6-4,R32,60,4,5,29,52,25,29,10,23,3,4,9,35,52,1,1,21,42,14,21,8,21,1,5,8,22,42
2010-06-07 00:00:00.000,London / Queen's Club Great Britain ATP World Tour 250,GRASS,2,Xavier Malisse,Bernard Tomic,Xavier Malisse,6-2; 3-6; 6-2,R32,94,11,2,37,73,29,37,24,36,7,8,12,53,73,3,2,44,76,26,44,18,32,4,8,13,44,76
2010-06-07 00:00:00.000,London / Queen's Club Great Britain ATP World Tour 250,GRASS,2,Novak Djokovic,Paolo Lorenzi,Novak Djokovic,6-3; 6-3,R32,72,3,2,40,64,31,40,12,24,6,6,9,43,64,4,0,31,52,21,31,11,21,3,6,9,32,52
2010-06-07 00:00:00.000,London / Queen's Club Great Britain ATP World Tour 250,GRASS,2,Rafael Nadal,Denis Istomin,Rafael Nadal,7-6(4); 4-6; 6-4,R16,130,2,2,76,107,50,76,20,31,3,6,16,70,107,9,4,78,116,55,78,19,38,5,8,16,74,116
2010-06-07 00:00:00.000,London / Queen's Club Great Britain ATP World Tour 250,GRASS,2,Feliciano Lopez,Julien Benneteau,Feliciano Lopez,6-2; 6-4,R16,63,8,1,30,47,25,30,12,17,0,0,9,37,47,7,2,30,50,25,30,5,20,0,3,9,30,50
2010-06-07 00:00:00.000,London / Queen's Club Great Britain ATP World Tour 250,GRASS,2,Mardy Fish,Andy Murray,Mardy Fish,6-4; 1-6; 7-6(2),R16,96,7,1,54,81,43,54,14,27,2,5,14,57,81,12,1,37,76,33,37,20,39,1,3,15,53,76
2010-06-07 00:00:00.000,London / Queen's Club Great Britain ATP World Tour 250,GRASS,2,Michael Llodra,Marin Cilic,Michael Llodra,7-6(2); 6-2,R16,82,8,2,36,57,31,36,11,21,0,1,10,42,57,3,2,34,62,27,34,11,28,4,7,10,38,62
2010-06-07 00:00:00.000,London / Queen's Club Great Britain ATP World Tour 250,GRASS,2,Rainer Schuettler,Richard Gasquet,Rainer Schuettler,W/O,R16,0,0,0,0,0,0,0,0,0,0,0,0,0,0,0,0,0,0,0,0,0,0,0,0,0,0,0
2010-06-07 00:00:00.000,London / Queen's Club Great Britain ATP World Tour 250,GRASS,2,Dudi Sela,Andy Roddick,Dudi Sela,6-4; 7-6(8),R16,107,6,0,45,72,34,45,21,27,1,1,11,55,72,10,1,56,82,40,56,14,26,5,6,11,54,82
2010-06-07 00:00:00.000,London / Queen's Club Great Britain ATP World Tour 250,GRASS,2,Sam Querrey,Marcel Granollers,Sam Querrey,6-4; 7-6(5),R16,70,12,2,41,61,34,41,11,20,0,1,11,45,61,5,1,43,68,32,43,14,25,1,3,11,46,68
2010-06-07 00:00:00.000,London / Queen's Club Great Britain ATP World Tour 250,GRASS,2,Xavier Malisse,Novak Djokovic,Xavier Malisse,6-3; 4-6; 6-2,R16,102,5,3,47,72,40,47,11,25,4,5,13,51,72,4,5,68,92,44,68,10,24,5,9,14,54,92
2010-06-07 00:00:00.000,London / Queen's Club Great Britain ATP World Tour 250,GRASS,2,Feliciano Lopez,Rafael Nadal,Feliciano Lopez,7-6(5); 6-4,Q,111,12,1,49,85,40,49,16,36,5,7,11,56,85,3,2,41,58,31,41,10,17,0,3,11,41,58
2010-06-07 00:00:00.000,London / Queen's Club Great Britain ATP World Tour 250,GRASS,2,Mardy Fish,Michael Llodra,Mardy Fish,6-4; 6-4,Q,63,11,0,26,47,23,26,14,21,0,1,10,37,47,5,4,37,59,27,37,10,22,3,6,10,37,59
2010-06-07 00:00:00.000,London / Queen's Club Great Britain ATP World Tour 250,GRASS,2,Rainer Schuettler,Dudi Sela,Rainer Schuettler,7-5; 6-4,Q,100,3,2,47,76,32,47,16,29,7,9,11,48,76,0,3,36,65,28,36,9,29,2,6,11,37,65
2010-06-07 00:00:00.000,London / Queen's Club Great Britain ATP World Tour 250,GRASS,2,Sam Querrey,Xavier Malisse,Sam Querrey,6-3; 7-5,Q,79,9,3,40,68,29,40,16,28,1,2,11,45,68,5,1,49,77,34,49,11,28,12,15,10,45,77
2010-06-07 00:00:00.000,London / Queen's Club Great Britain ATP World Tour 250,GRASS,2,Mardy Fish,Feliciano Lopez,Mardy Fish,6-3; 6-4,S,62,11,0,27,45,25,27,15,18,0,0,10,40,45,5,2,30,52,21,30,13,22,0,2,9,34,52
2010-06-07 00:00:00.000,London / Queen's Club Great Britain ATP World Tour 250,GRASS,2,Sam Querrey,Rainer Schuettler,Sam Querrey,6-7(9); 7-5; 6-3,S,114,12,4,75,108,63,75,19,33,6,6,17,82,108,1,2,63,93,53,63,15,30,0,2,16,68,93
2010-06-07 00:00:00.000,London / Queen's Club Great Britain ATP World Tour 250,GRASS,2,Sam Querrey,Mardy Fish,Sam Querrey,7-6(3); 7-5,F,84,15,4,46,74,39,46,14,28,4,5,12,53,74,9,1,40,68,29,40,16,28,1,3,12,45,68
2010-06-13 00:00:00.000,Eastbourne Great Britain ATP World Tour 250,GRASS,2,Nicolas Almagro,Lukasz Kubot,Nicolas Almagro,7-5; 7-6(3),R32,100,8,2,49,75,35,49,16,26,6,8,12,51,75,3,4,58,82,36,58,13,24,3,6,12,49,82
2010-06-13 00:00:00.000,Eastbourne Great Britain ATP World Tour 250,GRASS,2,Denis Istomin,Eduardo Schwank,Denis Istomin,6-0; 6-3,R32,57,5,0,28,32,24,28,4,4,0,0,7,28,32,3,5,52,74,27,52,9,22,9,14,8,36,74
2010-06-13 00:00:00.000,Eastbourne Great Britain ATP World Tour 250,GRASS,2,Illya Marchenko,Andreas Seppi,Illya Marchenko,6-4; 6-4,R32,94,5,5,43,76,30,43,18,33,11,12,10,48,76,3,0,40,57,30,40,6,17,3,6,10,36,57
2010-06-13 00:00:00.000,Eastbourne Great Britain ATP World Tour 250,GRASS,2,Horacio Zeballos,Lukas Lacko,Horacio Zeballos,6-4; 4-6; 7-5,R32,110,9,3,57,87,46,57,15,30,6,8,16,61,87,5,4,60,96,45,60,17,36,5,8,16,62,96
2010-06-13 00:00:00.000,Eastbourne Great Britain ATP World Tour 250,GRASS,2,Julien Benneteau,James Blake,Julien Benneteau,7-6(3); 7-5,R32,96,4,2,50,76,40,50,14,26,9,11,12,54,76,3,3,49,83,35,49,16,34,7,10,12,51,83
2010-06-13 00:00:00.000,Eastbourne Great Britain ATP World Tour 250,GRASS,2,Dudi Sela,Kevin Anderson,Dudi Sela,5-7; 6-3 RET,R32,87,0,2,43,69,29,43,15,26,0,2,11,44,69,8,3,30,52,24,30,11,22,0,2,10,35,52
2010-06-13 00:00:00.000,Eastbourne Great Britain ATP World Tour 250,GRASS,2,Fabio Fognini,Giovanni Lapentti,Fabio Fognini,7-6(11); 6-7(3); 6-3,R32,167,8,9,66,118,49,66,24,52,6,10,17,73,118,10,6,93,140,62,93,18,47,9,14,16,80,140
2010-06-13 00:00:00.000,Eastbourne Great Britain ATP World Tour 250,GRASS,2,Guillermo Garcia-Lopez,Marc Gicquel,Guillermo Garcia-Lopez,6-4; 6-7(4); 7-6(3),R32,127,13,6,50,95,41,50,26,45,0,2,17,67,95,7,0,67,101,48,67,18,34,2,5,17,66,101
2010-06-13 00:00:00.000,Eastbourne Great Britain ATP World Tour 250,GRASS,2,Michael Llodra,Martin Emmrich,Michael Llodra,6-0; 6-3,R32,65,15,1,32,49,25,32,11,17,8,8,8,36,49,6,5,30,48,19,30,4,18,2,6,7,23,48
2010-06-13 00:00:00.000,Eastbourne Great Britain ATP World Tour 250,GRASS,2,Stephane Robert,Leonardo Mayer,Stephane Robert,7-6(4); 6-4,R32,89,7,3,51,74,42,51,13,23,3,3,11,55,74,12,4,54,78,42,54,10,24,4,5,11,52,78
2010-06-13 00:00:00.000,Eastbourne Great Britain ATP World Tour 250,GRASS,2,Andrey Kuznetsov,Kei Nishikori,Andrey Kuznetsov,6-4; 3-1 RET,R32,49,7,1,27,43,21,27,9,16,2,2,7,30,43,3,2,31,46,23,31,5,15,0,2,7,28,46
2010-06-13 00:00:00.000,Eastbourne Great Britain ATP World Tour 250,GRASS,2,Gilles Simon,Evgeny Korolev,Gilles Simon,6-3; 6-7(6); 6-4,R32,130,5,9,55,115,40,55,30,60,6,9,16,70,115,7,4,49,92,36,49,20,43,4,9,15,56,92
2010-06-13 00:00:00.000,Eastbourne Great Britain ATP World Tour 250,GRASS,2,Alexandr Dolgopolov,Jamie Baker,Alexandr Dolgopolov,6-4; 3-6; 6-1,R32,106,15,2,51,75,35,51,18,24,6,7,13,53,75,3,4,58,90,39,58,15,32,7,10,13,54,90
2010-06-13 00:00:00.000,Eastbourne Great Britain ATP World Tour 250,GRASS,2,Yen-Hsun Lu,Karol Beck,Yen-Hsun Lu,6-4; 6-4,R32,76,3,4,30,49,24,30,12,19,0,1,10,36,49,9,1,41,67,27,41,12,26,7,10,10,39,67
2010-06-13 00:00:00.000,Eastbourne Great Britain ATP World Tour 250,GRASS,2,Rainer Schuettler,Andrey Golubev,Rainer Schuettler,6-2; 6-3,R32,70,2,2,27,50,20,27,16,23,2,3,9,36,50,1,8,28,63,21,28,11,35,5,9,8,32,63
2010-06-13 00:00:00.000,Eastbourne Great Britain ATP World Tour 250,GRASS,2,James Ward,Feliciano Lopez,James Ward,6-3; 5-4 RET,R32,73,6,3,32,53,27,32,11,21,4,4,9,38,53,12,1,48,69,32,48,8,21,3,5,9,40,69
2010-06-13 00:00:00.000,Eastbourne Great Britain ATP World Tour 250,GRASS,2,Denis Istomin,Nicolas Almagro,Denis Istomin,6-4; 1-0 RET,R16,52,2,2,17,32,11,17,9,15,1,3,5,20,32,1,1,21,35,10,21,4,14,0,4,6,14,35
2010-06-13 00:00:00.000,Eastbourne Great Britain ATP World Tour 250,GRASS,2,Illya Marchenko,Horacio Zeballos,Illya Marchenko,7-6(2); 6-3,R16,94,0,4,49,76,35,49,16,27,8,9,10,51,76,2,1,42,64,31,42,9,22,3,6,11,40,64
2010-06-13 00:00:00.000,Eastbourne Great Britain ATP World Tour 250,GRASS,2,Julien Benneteau,Dudi Sela,Julien Benneteau,7-6(8); 7-5,R16,114,4,2,65,98,45,65,16,33,3,4,12,61,98,5,3,48,73,35,48,14,25,2,4,12,49,73
2010-06-13 00:00:00.000,Eastbourne Great Britain ATP World Tour 250,GRASS,2,Guillermo Garcia-Lopez,Fabio Fognini,Guillermo Garcia-Lopez,6-2; 6-2,R16,53,4,2,19,37,18,19,12,18,2,3,8,30,37,2,3,35,54,18,35,6,19,4,9,8,24,54
2010-06-13 00:00:00.000,Eastbourne Great Britain ATP World Tour 250,GRASS,2,Michael Llodra,Stephane Robert,Michael Llodra,6-1; 6-7(2); 6-4,R16,125,14,3,69,105,54,69,16,36,4,5,15,70,105,1,8,53,98,37,53,21,45,4,8,14,58,98
2010-06-13 00:00:00.000,Eastbourne Great Britain ATP World Tour 250,GRASS,2,Gilles Simon,Andrey Kuznetsov,Gilles Simon,6-1; 6-7(3); 7-6(2),R16,117,7,7,66,113,53,66,25,47,6,7,16,78,113,7,2,63,102,46,63,20,39,5,8,15,66,102
2010-06-13 00:00:00.000,Eastbourne Great Britain ATP World Tour 250,GRASS,2,Alexandr Dolgopolov,Yen-Hsun Lu,Alexandr Dolgopolov,6-7(1); 6-1; 6-2,R16,102,14,3,55,86,43,55,15,31,3,4,13,58,86,3,5,50,81,31,50,16,31,5,11,14,47,81
2010-06-13 00:00:00.000,Eastbourne Great Britain ATP World Tour 250,GRASS,2,James Ward,Rainer Schuettler,James Ward,6-3; 7-6(5),R16,87,3,3,42,60,34,42,9,18,0,0,10,43,60,3,3,43,76,32,43,16,33,4,6,11,48,76
2010-06-13 00:00:00.000,Eastbourne Great Britain ATP World Tour 250,GRASS,2,Denis Istomin,Illya Marchenko,Denis Istomin,6-1; 6-4,Q,81,2,0,44,61,30,44,12,17,2,2,9,42,61,2,2,27,50,20,27,7,23,3,6,8,27,50
2010-06-13 00:00:00.000,Eastbourne Great Britain ATP World Tour 250,GRASS,2,Guillermo Garcia-Lopez,Julien Benneteau,Guillermo Garcia-Lopez,4-6; 6-3; 7-6(2),Q,146,5,9,65,109,48,65,20,44,13,17,15,68,109,5,2,52,96,40,52,16,44,1,6,16,56,96
2010-06-13 00:00:00.000,Eastbourne Great Britain ATP World Tour 250,GRASS,2,Michael Llodra,Gilles Simon,Michael Llodra,6-1; 6-3,Q,59,9,3,32,48,28,32,8,16,3,3,8,36,48,2,4,29,52,17,29,11,23,2,6,8,28,52
2010-06-13 00:00:00.000,Eastbourne Great Britain ATP World Tour 250,GRASS,2,Alexandr Dolgopolov,James Ward,Alexandr Dolgopolov,6-3; 6-4,Q,80,14,1,30,52,27,30,15,22,1,1,10,42,52,5,6,48,90,32,48,19,42,14,16,9,51,90
2010-06-13 00:00:00.000,Eastbourne Great Britain ATP World Tour 250,GRASS,2,Guillermo Garcia-Lopez,Denis Istomin,Guillermo Garcia-Lopez,3-6; 6-3; 6-4,S,117,1,0,45,77,37,45,17,32,1,3,14,54,77,0,2,71,107,43,71,23,36,17,20,14,66,107
2010-06-13 00:00:00.000,Eastbourne Great Britain ATP World Tour 250,GRASS,2,Michael Llodra,Alexandr Dolgopolov,Michael Llodra,6-3; 7-5,S,61,12,1,32,52,27,32,15,20,0,1,11,42,52,4,0,32,49,22,32,9,17,1,4,10,31,49
2010-06-13 00:00:00.000,Eastbourne Great Britain ATP World Tour 250,GRASS,2,Michael Llodra,Guillermo Garcia-Lopez,Michael Llodra,7-5; 6-2,F,67,11,0,32,48,28,32,13,16,2,2,10,41,48,7,3,41,60,27,41,10,19,3,6,10,37,60
2010-06-13 00:00:00.000,s-Hertogenbosch The Netherlands ATP World Tour 250,GRASS,2,Ivan Ljubicic,N/A Bye,Ivan Ljubicic,,R32,0,0,0,0,0,0,0,0,0,0,0,0,0,0,0,0,0,0,0,0,0,0,0,0,0,0,0
2010-06-13 00:00:00.000,s-Hertogenbosch The Netherlands ATP World Tour 250,GRASS,2,Alejandro Falla,Florent Serra,Alejandro Falla,6-4; 6-4,R32,76,4,2,34,63,27,34,18,29,5,5,10,45,63,4,0,42,68,26,42,16,26,3,5,10,42,68
2010-06-13 00:00:00.000,s-Hertogenbosch The Netherlands ATP World Tour 250,GRASS,2,Daniel Brands,Rameez Junaid,Daniel Brands,6-1; 6-3,R32,56,9,1,32,43,27,32,6,11,2,2,8,33,43,2,3,25,45,15,25,9,20,2,6,8,24,45
2010-06-13 00:00:00.000,s-Hertogenbosch The Netherlands ATP World Tour 250,GRASS,2,Xavier Malisse,Rajeev Ram,Xavier Malisse,6-3; 6-2,R32,51,6,1,31,47,25,31,12,16,0,0,9,37,47,4,2,20,41,13,20,11,21,1,4,8,24,41
2010-06-13 00:00:00.000,s-Hertogenbosch The Netherlands ATP World Tour 250,GRASS,2,Viktor Troicki,N/A Bye,Viktor Troicki,,R32,0,0,0,0,0,0,0,0,0,0,0,0,0,0,0,0,0,0,0,0,0,0,0,0,0,0,0
2010-06-13 00:00:00.000,s-Hertogenbosch The Netherlands ATP World Tour 250,GRASS,2,Santiago Giraldo,Marco Chiudinelli,Santiago Giraldo,6-2; 7-5,R32,69,7,1,49,65,36,49,7,16,3,4,10,43,65,2,4,41,68,27,41,9,27,5,9,10,36,68
2010-06-13 00:00:00.000,s-Hertogenbosch The Netherlands ATP World Tour 250,GRASS,2,Sergiy Stakhovsky,Kristof Vliegen,Sergiy Stakhovsky,6-2; 6-1,R32,71,4,0,33,53,27,33,10,20,2,2,8,37,53,2,2,33,59,20,33,8,26,7,11,7,28,59
2010-06-13 00:00:00.000,s-Hertogenbosch The Netherlands ATP World Tour 250,GRASS,2,Igor Sijsling,Thiemo de Bakker,Igor Sijsling,4-6; 6-2; 7-6(4),R32,105,4,3,51,88,36,51,25,37,2,4,15,61,88,10,2,55,97,34,55,24,42,4,7,15,58,97
2010-06-13 00:00:00.000,s-Hertogenbosch The Netherlands ATP World Tour 250,GRASS,2,Benjamin Becker,Jarkko Nieminen,Benjamin Becker,6-4; 3-6; 6-4,R32,101,8,1,51,72,42,51,13,21,0,1,14,55,72,6,3,65,97,48,65,13,32,5,7,15,61,97
2010-06-13 00:00:00.000,s-Hertogenbosch The Netherlands ATP World Tour 250,GRASS,2,Henri Kontinen,Dustin Brown,Henri Kontinen,7-5; 2-6; 7-6(5),R32,109,9,5,56,97,41,56,22,41,6,10,16,63,97,14,1,59,94,48,59,16,35,3,6,16,64,94
2010-06-13 00:00:00.000,s-Hertogenbosch The Netherlands ATP World Tour 250,GRASS,2,Simon Greul,Robin Haase,Simon Greul,7-5; 7-6(5),R32,107,3,2,46,72,32,46,13,26,5,9,12,45,72,2,2,53,89,32,53,19,36,7,12,12,51,89
2010-06-13 00:00:00.000,s-Hertogenbosch The Netherlands ATP World Tour 250,GRASS,2,Tommy Robredo,N/A Bye,Tommy Robredo,,R32,0,0,0,0,0,0,0,0,0,0,0,0,0,0,0,0,0,0,0,0,0,0,0,0,0,0,0
2010-06-13 00:00:00.000,s-Hertogenbosch The Netherlands ATP World Tour 250,GRASS,2,Janko Tipsarevic,Jeremy Chardy,Janko Tipsarevic,6-3; 6-4,R32,62,7,0,32,55,25,32,16,23,1,1,10,41,55,9,3,34,51,26,34,8,17,2,4,9,34,51
2010-06-13 00:00:00.000,s-Hertogenbosch The Netherlands ATP World Tour 250,GRASS,2,Arnaud Clement,Simon Stadler,Arnaud Clement,6-1; 3-6; 6-1,R32,96,4,3,48,78,36,48,15,30,3,4,12,51,78,4,1,46,67,29,46,9,21,6,10,11,38,67
2010-06-13 00:00:00.000,s-Hertogenbosch The Netherlands ATP World Tour 250,GRASS,2,Peter Luczak,Michael Russell,Peter Luczak,7-6(6); 7-6(3),R32,127,15,6,63,102,48,63,16,39,5,7,12,64,102,6,5,51,76,37,51,13,25,2,4,12,50,76
2010-06-13 00:00:00.000,s-Hertogenbosch The Netherlands ATP World Tour 250,GRASS,2,Marcos Baghdatis,N/A Bye,Marcos Baghdatis,,R32,0,0,0,0,0,0,0,0,0,0,0,0,0,0,0,0,0,0,0,0,0,0,0,0,0,0,0
2010-06-13 00:00:00.000,s-Hertogenbosch The Netherlands ATP World Tour 250,GRASS,2,Alejandro Falla,Ivan Ljubicic,Alejandro Falla,6-2; 7-6(6),R16,99,0,6,57,81,41,57,12,24,7,8,10,53,81,12,3,52,84,37,52,12,32,5,8,10,49,84
2010-06-13 00:00:00.000,s-Hertogenbosch The Netherlands ATP World Tour 250,GRASS,2,Xavier Malisse,Daniel Brands,Xavier Malisse,4-6; 6-1; 7-5,R16,106,8,2,58,94,42,58,20,36,4,6,15,62,94,8,3,60,86,39,60,14,26,8,12,14,53,86
2010-06-13 00:00:00.000,s-Hertogenbosch The Netherlands ATP World Tour 250,GRASS,2,Santiago Giraldo,Viktor Troicki,Santiago Giraldo,6-4; 6-4,R16,76,1,0,39,62,32,39,13,23,7,7,10,45,62,8,8,42,69,32,42,12,27,5,7,10,44,69
2010-06-13 00:00:00.000,s-Hertogenbosch The Netherlands ATP World Tour 250,GRASS,2,Sergiy Stakhovsky,Igor Sijsling,Sergiy Stakhovsky,6-2; 7-6(4),R16,69,6,1,35,56,29,35,14,21,0,0,10,43,56,3,0,43,67,27,43,13,24,3,5,10,40,67
2010-06-13 00:00:00.000,s-Hertogenbosch The Netherlands ATP World Tour 250,GRASS,2,Benjamin Becker,Henri Kontinen,Benjamin Becker,6-2; 6-1,R16,45,5,1,26,42,22,26,9,16,2,2,7,31,42,2,5,19,40,12,19,5,21,1,6,8,17,40
2010-06-13 00:00:00.000,s-Hertogenbosch The Netherlands ATP World Tour 250,GRASS,2,Simon Greul,Tommy Robredo,Simon Greul,6-1; 6-4,R16,63,1,2,34,50,30,34,9,16,3,3,9,39,50,6,1,25,43,16,25,8,18,0,3,8,24,43
2010-06-13 00:00:00.000,s-Hertogenbosch The Netherlands ATP World Tour 250,GRASS,2,Janko Tipsarevic,Arnaud Clement,Janko Tipsarevic,3-6; 6-1; 6-3,R16,107,6,3,48,85,37,48,18,37,9,10,12,55,85,9,2,42,71,32,42,12,29,0,4,13,44,71
2010-06-13 00:00:00.000,s-Hertogenbosch The Netherlands ATP World Tour 250,GRASS,2,Peter Luczak,Marcos Baghdatis,Peter Luczak,7-5; 6-1,R16,70,7,2,37,50,29,37,8,13,0,1,10,37,50,7,5,22,57,14,22,17,35,2,6,9,31,57
2010-06-13 00:00:00.000,s-Hertogenbosch The Netherlands ATP World Tour 250,GRASS,2,Xavier Malisse,Alejandro Falla,Xavier Malisse,6-3; 3-6; 6-3,Q,109,8,2,61,99,41,61,21,38,9,12,14,62,99,3,2,54,78,34,54,12,24,2,6,13,46,78
2010-06-13 00:00:00.000,s-Hertogenbosch The Netherlands ATP World Tour 250,GRASS,2,Sergiy Stakhovsky,Santiago Giraldo,Sergiy Stakhovsky,6-3; 6-4,Q,70,7,0,43,62,33,43,9,19,3,4,10,42,62,3,3,35,54,23,35,7,19,3,6,9,30,54
2010-06-13 00:00:00.000,s-Hertogenbosch The Netherlands ATP World Tour 250,GRASS,2,Benjamin Becker,Simon Greul,Benjamin Becker,6-3; 6-1,Q,53,7,0,32,44,26,32,5,12,0,1,8,31,44,0,1,19,39,10,19,7,20,2,7,8,17,39
2010-06-13 00:00:00.000,s-Hertogenbosch The Netherlands ATP World Tour 250,GRASS,2,Janko Tipsarevic,Peter Luczak,Janko Tipsarevic,6-3; 6-3,Q,62,12,1,25,45,23,25,13,20,0,0,9,36,45,13,2,33,48,24,33,6,15,0,3,9,30,48
2010-06-13 00:00:00.000,s-Hertogenbosch The Netherlands ATP World Tour 250,GRASS,2,Sergiy Stakhovsky,Xavier Malisse,Sergiy Stakhovsky,6-3; 6-4,S,67,5,1,37,58,26,37,11,21,2,4,10,37,58,3,3,38,55,23,38,5,17,0,4,9,28,55
2010-06-13 00:00:00.000,s-Hertogenbosch The Netherlands ATP World Tour 250,GRASS,2,Janko Tipsarevic,Benjamin Becker,Janko Tipsarevic,6-7(5); 6-3; 6-4,S,137,15,1,62,101,51,62,21,39,4,5,16,72,101,15,3,57,100,47,57,19,43,4,7,15,66,100
2010-06-13 00:00:00.000,s-Hertogenbosch The Netherlands ATP World Tour 250,GRASS,2,Sergiy Stakhovsky,Janko Tipsarevic,Sergiy Stakhovsky,6-3; 6-0,F,56,8,0,25,41,23,25,11,16,2,2,8,34,41,6,1,35,51,20,35,5,16,8,12,7,25,51
2010-06-21 00:00:00.000,Wimbledon Great Britain Grand Slams,GRASS,3,Roger Federer,Alejandro Falla,Roger Federer,5-7; 4-6; 6-4; 7-6(1); 6-0,R128,198,21,7,89,151,70,89,34,62,7,10,25,104,151,8,2,107,177,72,107,35,70,9,14,25,107,177
2010-06-21 00:00:00.000,Wimbledon Great Britain Grand Slams,GRASS,3,Ilija Bozoljac,Nicolas Massu,Ilija Bozoljac,7-6(3); 3-6; 6-3; 7-6(7),R128,180,27,2,81,122,68,81,21,41,2,4,21,89,122,8,6,114,178,77,114,33,64,11,13,21,110,178
2010-06-21 00:00:00.000,Wimbledon Great Britain Grand Slams,GRASS,3,Arnaud Clement,Janko Tipsarevic,Arnaud Clement,6-3; 3-6; 6-4; 7-5,R128,164,9,4,67,113,56,67,26,46,3,4,20,82,113,18,5,75,125,53,75,26,50,5,8,20,79,125
2010-06-21 00:00:00.000,Wimbledon Great Britain Grand Slams,GRASS,3,Peter Luczak,Tommy Robredo,Peter Luczak,2-6; 7-6(3); 6-2; 7-5,R128,142,13,0,77,108,62,77,19,31,1,3,20,81,108,14,2,73,113,54,73,18,40,0,3,20,72,113
2010-06-21 00:00:00.000,Wimbledon Great Britain Grand Slams,GRASS,3,Feliciano Lopez,Jesse Levine,Feliciano Lopez,7-6(2); 3-6; 6-2; 6-3,R128,174,19,4,67,126,52,67,32,59,9,12,19,84,126,6,4,77,134,46,77,33,57,12,17,19,79,134
2010-06-21 00:00:00.000,Wimbledon Great Britain Grand Slams,GRASS,3,Ricardas Berankis,Carsten Ball,Ricardas Berankis,6-2; 6-0; 3-6; 7-6(5),R128,121,8,5,48,100,41,48,33,52,0,1,17,74,100,12,7,78,115,56,78,12,37,3,8,18,68,115
2010-06-21 00:00:00.000,Wimbledon Great Britain Grand Slams,GRASS,3,Viktor Troicki,Igor Kunitsyn,Viktor Troicki,6-3; 6-4; 6-1,R128,112,21,6,56,98,47,56,18,42,7,7,13,65,98,3,3,51,95,32,51,21,44,10,15,13,53,95
2010-06-21 00:00:00.000,Wimbledon Great Britain Grand Slams,GRASS,3,Jurgen Melzer,Dustin Brown,Jurgen Melzer,6-3; 4-6; 6-2; 6-3,R128,108,7,5,66,99,55,66,16,33,4,6,18,71,99,17,3,62,101,43,62,19,39,4,10,18,62,101
2010-06-21 00:00:00.000,Wimbledon Great Britain Grand Slams,GRASS,3,Tomas Berdych,Andrey Golubev,Tomas Berdych,7-6(5); 6-2; 6-2,R128,115,12,3,52,87,45,52,19,35,4,5,14,64,87,7,5,65,106,39,65,19,41,3,8,14,58,106
2010-06-21 00:00:00.000,Wimbledon Great Britain Grand Slams,GRASS,3,Benjamin Becker,Ryan Sweeting,Benjamin Becker,5-7; 6-2; 6-2; 6-4,R128,106,27,3,65,93,60,65,13,28,3,5,19,73,93,15,4,82,115,57,82,12,33,8,14,19,69,115
2010-06-21 00:00:00.000,Wimbledon Great Britain Grand Slams,GRASS,3,Rainer Schuettler,Dmitry Tursunov,Rainer Schuettler,6-2; 6-2; 6-3,R128,92,2,0,37,59,34,37,14,22,0,0,12,48,59,4,1,60,87,33,60,15,27,7,13,13,48,87
2010-06-21 00:00:00.000,Wimbledon Great Britain Grand Slams,GRASS,3,Denis Istomin,Stanislas Wawrinka,Denis Istomin,6-7(5); 6-1; 2-6; 7-6(4); 6-3,R128,185,6,1,106,153,77,106,31,47,0,3,25,108,153,9,10,84,135,56,84,33,51,1,5,23,89,135
2010-06-21 00:00:00.000,Wimbledon Great Britain Grand Slams,GRASS,3,Victor Hanescu,Andrey Kuznetsov,Victor Hanescu,6-7(4); 7-6(3); 6-3; 1-6; 7-5,R128,227,20,3,141,197,97,141,25,56,17,22,26,122,197,17,7,114,170,84,114,25,56,11,16,26,109,170
2010-06-21 00:00:00.000,Wimbledon Great Britain Grand Slams,GRASS,3,Marsel Ilhan,Marcos Daniel,Marsel Ilhan,6-7(4); 4-6; 6-2; 6-3; 6-1,R128,188,31,1,94,141,76,94,22,47,5,8,23,98,141,19,2,94,149,66,94,18,55,5,13,23,84,149
2010-06-21 00:00:00.000,Wimbledon Great Britain Grand Slams,GRASS,3,Daniel Brands,Igor Andreev,Daniel Brands,7-6(5); 7-6(4); 7-5,R128,132,21,1,66,102,55,66,24,36,0,1,18,79,102,8,2,67,118,51,67,28,51,2,4,18,79,118
2010-06-21 00:00:00.000,Wimbledon Great Britain Grand Slams,GRASS,3,Nikolay Davydenko,Kevin Anderson,Nikolay Davydenko,3-6; 6-7(3); 7-6(3); 7-5; 9-7,R128,253,9,5,139,182,105,139,24,43,7,10,30,129,182,36,9,130,192,106,130,26,62,3,7,31,132,192
2010-06-21 00:00:00.000,Wimbledon Great Britain Grand Slams,GRASS,3,Novak Djokovic,Olivier Rochus,Novak Djokovic,4-6; 6-2; 3-6; 6-4; 6-2,R128,231,17,12,79,137,54,79,29,58,10,17,23,83,137,1,4,110,174,63,110,27,64,11,20,22,90,174
2010-06-21 00:00:00.000,Wimbledon Great Britain Grand Slams,GRASS,3,Taylor Dent,Juan Ignacio Chela,Taylor Dent,6-3; 6-7(2); 7-6(3); 7-5,R128,169,17,11,95,160,74,95,32,65,2,4,23,106,160,5,4,78,130,59,78,29,52,1,5,22,88,130
2010-06-21 00:00:00.000,Wimbledon Great Britain Grand Slams,GRASS,3,Brendan Evans,Jesse Huta Galung,Brendan Evans,6-3; 7-6(12); 6-3,R128,103,14,3,62,100,47,62,24,38,0,1,16,71,100,16,10,54,93,40,54,20,39,4,7,14,60,93
2010-06-21 00:00:00.000,Wimbledon Great Britain Grand Slams,GRASS,3,Albert Montanes,Paolo Lorenzi,Albert Montanes,6-3; 7-6(5); 6-2,R128,111,3,1,64,102,53,64,20,38,5,5,15,73,102,9,2,59,88,41,59,13,29,4,7,14,54,88
2010-06-21 00:00:00.000,Wimbledon Great Britain Grand Slams,GRASS,3,Gael Monfils,Leonardo Mayer,Gael Monfils,6-1; 7-6(9); 6-2,R128,95,21,2,49,75,45,49,16,26,0,1,14,61,75,3,1,55,85,33,55,15,30,5,10,13,48,85
2010-06-21 00:00:00.000,Wimbledon Great Britain Grand Slams,GRASS,3,Karol Beck,Santiago Ventura,Karol Beck,6-3; 6-1; 4-6; 6-2,R128,155,13,3,66,104,49,66,21,38,6,8,17,70,104,7,6,65,116,42,65,22,51,9,16,17,64,116
2010-06-21 00:00:00.000,Wimbledon Great Britain Grand Slams,GRASS,3,Evgeny Korolev,Eduardo Schwank,Evgeny Korolev,6-1; 7-6(8); 4-6; 6-2,R128,145,9,1,73,126,55,73,30,53,6,8,19,85,126,6,13,61,112,43,61,23,51,5,10,18,66,112
2010-06-21 00:00:00.000,Wimbledon Great Britain Grand Slams,GRASS,3,Lleyton Hewitt,Maximo Gonzalez,Lleyton Hewitt,5-7; 6-0; 6-2; 6-2,R128,128,12,6,49,93,43,49,23,44,1,3,17,66,93,1,2,81,98,45,81,6,17,0,8,17,51,98
2010-06-21 00:00:00.000,Wimbledon Great Britain Grand Slams,GRASS,3,Florian Mayer,Marin Cilic,Florian Mayer,6-2; 6-4; 7-6(1),R128,121,8,1,60,86,49,60,18,26,2,2,15,67,86,8,0,75,111,49,75,17,36,13,16,15,66,111
2010-06-21 00:00:00.000,Wimbledon Great Britain Grand Slams,GRASS,3,Mardy Fish,Bernard Tomic,Mardy Fish,6-3; 7-6(8); 6-2,R128,92,25,1,56,82,51,56,17,26,0,0,15,68,82,3,3,57,85,40,57,15,28,2,5,14,55,85
2010-06-21 00:00:00.000,Wimbledon Great Britain Grand Slams,GRASS,3,Yen-Hsun Lu,Horacio Zeballos,Yen-Hsun Lu,7-5; 6-4; 6-3,R128,120,18,1,46,73,43,46,17,27,0,0,15,60,73,11,5,77,119,54,77,17,42,7,11,16,71,119
2010-06-21 00:00:00.000,Wimbledon Great Britain Grand Slams,GRASS,3,Michal Przysiezny,Ivan Ljubicic,Michal Przysiezny,7-5; 7-6(5); 6-3,R128,133,14,3,66,97,53,66,13,31,2,4,16,66,97,9,1,61,92,46,61,12,31,1,6,17,58,92
2010-06-21 00:00:00.000,Wimbledon Great Britain Grand Slams,GRASS,3,Philipp Kohlschreiber,Potito Starace,Philipp Kohlschreiber,6-3; 3-6; 6-3; 6-0,R128,104,11,2,58,84,50,58,15,26,1,3,17,65,84,7,2,64,94,37,64,17,30,3,9,16,54,94
2010-06-21 00:00:00.000,Wimbledon Great Britain Grand Slams,GRASS,3,Teymuraz Gabashvili,Ramon Delgado,Teymuraz Gabashvili,2-6; 6-4; 6-4; 6-2,R128,132,14,5,64,101,51,64,21,37,3,5,18,72,101,9,2,78,122,51,78,25,44,8,12,18,76,122
2010-06-21 00:00:00.000,Wimbledon Great Britain Grand Slams,GRASS,3,Michael Llodra,Jesse Witten,Michael Llodra,6-4; 6-4; 6-7(5); 6-3,R128,148,11,0,77,118,63,77,24,41,3,4,21,87,118,11,7,86,135,63,86,23,49,8,12,20,86,135
2010-06-21 00:00:00.000,Wimbledon Great Britain Grand Slams,GRASS,3,Andy Roddick,Rajeev Ram,Andy Roddick,6-3; 6-2; 6-2,R128,83,13,2,49,67,41,49,12,18,0,0,13,53,67,12,3,41,72,30,41,10,31,6,11,12,40,72
2010-06-21 00:00:00.000,Wimbledon Great Britain Grand Slams,GRASS,3,Fabio Fognini,Fernando Verdasco,Fabio Fognini,7-6(9); 6-2; 6-7(6); 6-4,R128,174,5,8,86,141,67,86,35,55,1,1,21,102,141,9,8,80,140,62,80,31,60,2,5,21,93,140
2010-06-21 00:00:00.000,Wimbledon Great Britain Grand Slams,GRASS,3,Michael Russell,Pere Riba,Michael Russell,6-3; 7-6(1); 2-6; 7-6(1),R128,160,10,4,67,110,59,67,27,43,0,2,20,86,110,15,6,96,157,69,96,29,61,10,12,21,98,157
2010-06-21 00:00:00.000,Wimbledon Great Britain Grand Slams,GRASS,3,Andreas Beck,Jamie Baker,Andreas Beck,7-6(4); 6-3; 6-4,R128,132,7,1,51,89,40,51,27,38,1,2,16,67,89,13,1,64,92,49,64,12,28,6,9,15,61,92
2010-06-21 00:00:00.000,Wimbledon Great Britain Grand Slams,GRASS,3,Julien Benneteau,Kristof Vliegen,Julien Benneteau,2-6; 6-7(6); 6-1; 6-2; 7-5,R128,214,18,7,126,181,88,126,25,55,11,15,24,113,181,12,6,88,155,57,88,33,67,2,9,23,90,155
2010-06-21 00:00:00.000,Wimbledon Great Britain Grand Slams,GRASS,3,Andreas Seppi,Nicolas Almagro,Andreas Seppi,7-6(4); 7-6(7); 6-2,R128,123,11,2,63,94,53,63,16,31,1,3,16,69,94,15,7,73,122,52,73,22,49,8,12,16,74,122
2010-06-21 00:00:00.000,Wimbledon Great Britain Grand Slams,GRASS,3,Tobias Kamke,Guillermo Garcia-Lopez,Tobias Kamke,5-7; 2-6; 7-5; 6-4; 6-4,R128,216,3,8,100,169,62,100,34,69,12,20,26,96,169,6,7,83,161,60,83,33,78,9,17,26,93,161
2010-06-21 00:00:00.000,Wimbledon Great Britain Grand Slams,GRASS,3,Alexandr Dolgopolov,Marco Chiudinelli,Alexandr Dolgopolov,6-4; 6-3; 6-3,R128,104,13,3,43,78,35,43,18,35,4,6,14,53,78,3,4,58,97,37,58,16,39,9,15,14,53,97
2010-06-21 00:00:00.000,Wimbledon Great Britain Grand Slams,GRASS,3,Jo-Wilfried Tsonga,Robert Kendrick,Jo-Wilfried Tsonga,7-6(2); 7-6(6); 3-6; 6-4,R128,154,19,6,82,123,71,82,24,41,3,4,21,95,123,28,4,97,142,74,97,24,45,7,8,22,98,142
2010-06-21 00:00:00.000,Wimbledon Great Britain Grand Slams,GRASS,3,Xavier Malisse,Juan Carlos Ferrero,Xavier Malisse,6-2; 6-7(6); 7-6(5); 4-6; 6-1,R128,201,27,4,94,149,82,94,23,55,2,5,25,105,149,8,4,102,160,67,102,34,58,8,14,24,101,160
2010-06-21 00:00:00.000,Wimbledon Great Britain Grand Slams,GRASS,3,Julian Reister,Rik De Voest,Julian Reister,6-4; 7-5; 3-6; 6-2,R128,152,5,2,88,118,57,88,19,30,4,7,19,76,118,9,1,77,124,53,77,22,47,8,14,20,75,124
2010-06-21 00:00:00.000,Wimbledon Great Britain Grand Slams,GRASS,3,Ivan Dodig,Oscar Hernandez,Ivan Dodig,6-1; 6-3; 6-3,R128,91,12,4,43,71,35,43,20,28,5,5,13,55,71,2,4,42,68,26,42,10,26,4,9,12,36,68
2010-06-21 00:00:00.000,Wimbledon Great Britain Grand Slams,GRASS,3,Sam Querrey,Sergiy Stakhovsky,Sam Querrey,7-6(4); 6-3; 2-1 RET,R128,89,11,1,46,76,38,46,17,30,3,4,12,55,76,7,3,49,74,37,49,10,25,4,7,12,47,74
2010-06-21 00:00:00.000,Wimbledon Great Britain Grand Slams,GRASS,3,Gilles Simon,Guillermo Alcaide,Gilles Simon,6-3; 6-4; 7-6(0),R128,113,6,3,61,106,50,61,23,45,3,4,16,73,106,11,6,60,98,45,60,16,38,4,7,15,61,98
2010-06-21 00:00:00.000,Wimbledon Great Britain Grand Slams,GRASS,3,Illya Marchenko,Michael Berrer,Illya Marchenko,6-3; 7-5 RET,R128,85,10,1,42,60,32,42,10,18,0,1,11,42,60,3,4,32,57,24,32,11,25,4,7,10,35,57
2010-06-21 00:00:00.000,Wimbledon Great Britain Grand Slams,GRASS,3,Jarkko Nieminen,Stefan Koubek,Jarkko Nieminen,6-4; 7-6(3); 5-7; 6-2,R128,157,7,4,104,140,70,104,16,36,8,11,21,86,140,4,2,79,127,54,79,25,48,5,10,21,79,127
2010-06-21 00:00:00.000,Wimbledon Great Britain Grand Slams,GRASS,3,Andy Murray,Jan Hajek,Andy Murray,7-5; 6-1; 6-2,R128,101,17,1,40,72,35,40,20,32,2,3,14,55,72,3,3,54,87,36,54,10,33,5,11,13,46,87
2010-06-21 00:00:00.000,Wimbledon Great Britain Grand Slams,GRASS,3,Robin Soderling,Robby Ginepri,Robin Soderling,6-2; 6-2; 6-3,R128,78,13,1,46,68,42,46,12,22,2,2,13,54,68,5,0,47,69,31,47,10,22,3,8,12,41,69
2010-06-21 00:00:00.000,Wimbledon Great Britain Grand Slams,GRASS,3,Marcel Granollers,Frederico Gil,Marcel Granollers,6-3; 6-0; 6-4,R128,93,15,1,38,64,35,38,15,26,1,2,13,50,64,1,2,69,93,36,69,10,24,10,16,12,46,93
2010-06-21 00:00:00.000,Wimbledon Great Britain Grand Slams,GRASS,3,Martin Fischer,Go Soeda,Martin Fischer,6-4; 6-3; 6-1,R128,116,3,2,48,79,36,48,17,31,2,3,13,53,79,2,3,48,95,26,48,24,47,7,13,13,50,95
2010-06-21 00:00:00.000,Wimbledon Great Britain Grand Slams,GRASS,3,Thomaz Bellucci,Ricardo Mello,Thomaz Bellucci,6-4; 6-4; 6-4,R128,121,12,1,50,91,41,50,21,41,4,6,15,62,91,1,2,72,110,43,72,18,38,7,12,15,61,110
2010-06-21 00:00:00.000,Wimbledon Great Britain Grand Slams,GRASS,3,Lukas Lacko,Marcos Baghdatis,Lukas Lacko,6-3; 2-6; 6-3; 6-1,R128,120,8,4,64,98,48,64,18,34,7,9,16,66,98,13,4,66,107,45,66,16,41,7,13,17,61,107
2010-06-21 00:00:00.000,Wimbledon Great Britain Grand Slams,GRASS,3,Jeremy Chardy,Daniel Gimeno-Traver,Jeremy Chardy,6-3; 6-3; 6-1,R128,85,12,5,42,76,36,42,19,34,3,3,13,55,76,10,7,51,83,28,51,16,32,5,10,12,44,83
2010-06-21 00:00:00.000,Wimbledon Great Britain Grand Slams,GRASS,3,Florent Serra,Simon Greul,Florent Serra,7-6(2); 6-3; 6-2,R128,116,5,3,52,93,39,52,25,41,1,2,14,64,93,5,3,61,97,34,61,22,36,7,12,15,56,97
2010-06-21 00:00:00.000,Wimbledon Great Britain Grand Slams,GRASS,3,David Ferrer,Nicolas Kiefer,David Ferrer,6-4; 6-2; 6-3,R128,100,13,3,48,74,44,48,15,26,2,2,14,59,74,7,7,39,78,28,39,17,39,3,7,13,45,78
2010-06-21 00:00:00.000,Wimbledon Great Britain Grand Slams,GRASS,3,Mikhail Youzhny,Dudi Sela,Mikhail Youzhny,6-3; 6-4; 4-6; 7-6(2),R128,193,7,4,95,146,60,95,21,51,4,11,21,81,146,3,5,75,138,49,75,25,63,15,23,20,74,138
2010-06-21 00:00:00.000,Wimbledon Great Britain Grand Slams,GRASS,3,Paul-Henri Mathieu,Marc Gicquel,Paul-Henri Mathieu,6-1; 7-5; 3-6; 6-1,R128,132,16,6,56,107,45,56,29,51,4,6,18,74,107,7,4,62,112,43,62,21,50,6,12,17,64,112
2010-06-21 00:00:00.000,Wimbledon Great Britain Grand Slams,GRASS,3,Thiemo de Bakker,Santiago Giraldo,Thiemo de Bakker,6-7(4); 6-4; 6-3; 5-7; 16-14,R128,246,37,3,133,210,116,133,35,77,5,6,36,151,210,11,3,150,214,115,150,38,64,5,9,37,153,214
2010-06-21 00:00:00.000,Wimbledon Great Britain Grand Slams,GRASS,3,John Isner,Nicolas Mahut,John Isner,6-4; 3-6; 6-7(7); 7-6(3); 70-68,R128,665,113,10,361,491,292,361,82,130,2,3,90,374,491,103,21,328,489,284,328,101,161,12,14,91,385,489
2010-06-21 00:00:00.000,Wimbledon Great Britain Grand Slams,GRASS,3,Philipp Petzschner,Stephane Robert,Philipp Petzschner,6-4; 7-6(6); 4-6; 2-6; 6-4,R128,166,16,3,82,141,61,82,29,59,6,13,25,90,141,5,9,91,154,66,91,30,63,8,14,25,96,154
2010-06-21 00:00:00.000,Wimbledon Great Britain Grand Slams,GRASS,3,Lukasz Kubot,Blaz Kavcic,Lukasz Kubot,4-6; 6-2; 6-2; 6-3,R128,144,17,4,78,104,58,78,12,26,2,5,18,70,104,9,9,57,102,36,57,18,45,7,14,17,54,102
2010-06-21 00:00:00.000,Wimbledon Great Britain Grand Slams,GRASS,3,Robin Haase,James Blake,Robin Haase,6-2; 6-4; 6-4,R128,97,9,2,51,93,41,51,23,42,9,9,14,64,93,5,3,63,101,41,63,17,38,9,13,14,58,101
2010-06-21 00:00:00.000,Wimbledon Great Britain Grand Slams,GRASS,3,Rafael Nadal,Kei Nishikori,Rafael Nadal,6-2; 6-4; 6-4,R128,125,8,3,54,78,44,54,13,24,2,3,14,57,78,4,8,66,105,47,66,13,39,8,13,14,60,105
2010-06-21 00:00:00.000,Wimbledon Great Britain Grand Slams,GRASS,3,Roger Federer,Ilija Bozoljac,Roger Federer,6-3; 6-7(4); 6-4; 7-6(5),R64,166,16,1,94,135,72,94,29,41,4,4,21,101,135,31,6,90,140,70,90,28,50,10,13,22,98,140
2010-06-21 00:00:00.000,Wimbledon Great Britain Grand Slams,GRASS,3,Arnaud Clement,Peter Luczak,Arnaud Clement,6-7(4); 6-3; 6-3; 6-4,R64,175,17,1,86,123,66,86,23,37,3,3,20,89,123,14,5,77,130,56,77,27,53,4,8,20,83,130
2010-06-21 00:00:00.000,Wimbledon Great Britain Grand Slams,GRASS,3,Feliciano Lopez,Ricardas Berankis,Feliciano Lopez,7-5; 4-6; 6-3; 6-4,R64,147,25,3,60,112,54,60,32,52,1,2,21,86,112,19,4,74,118,54,74,26,44,5,8,20,80,118
2010-06-21 00:00:00.000,Wimbledon Great Britain Grand Slams,GRASS,3,Jurgen Melzer,Viktor Troicki,Jurgen Melzer,6-7(5); 4-6; 6-3; 7-6(6); 6-3,R64,197,17,6,106,174,79,106,41,68,4,6,27,120,174,32,2,100,152,80,100,28,52,8,11,25,108,152
2010-06-21 00:00:00.000,Wimbledon Great Britain Grand Slams,GRASS,3,Tomas Berdych,Benjamin Becker,Tomas Berdych,7-5; 6-3; 6-4,R64,111,9,2,39,76,35,39,31,37,1,1,16,66,76,8,7,46,92,37,46,22,46,4,7,15,59,92
2010-06-21 00:00:00.000,Wimbledon Great Britain Grand Slams,GRASS,3,Denis Istomin,Rainer Schuettler,Denis Istomin,6-3; 7-6(5); 4-6; 4-6; 6-1,R64,180,11,1,89,138,63,89,26,49,10,16,23,89,138,6,4,97,151,60,97,27,54,4,13,25,87,151
2010-06-21 00:00:00.000,Wimbledon Great Britain Grand Slams,GRASS,3,Victor Hanescu,Marsel Ilhan,Victor Hanescu,6-4; 6-4; 3-6; 6-3,R64,139,17,3,80,110,63,80,16,30,6,7,19,79,110,11,4,84,115,64,84,13,31,6,9,19,77,115
2010-06-21 00:00:00.000,Wimbledon Great Britain Grand Slams,GRASS,3,Daniel Brands,Nikolay Davydenko,Daniel Brands,1-6; 7-6(5); 7-6(8); 6-1,R64,144,21,5,88,121,64,88,18,33,1,5,19,82,121,8,3,88,118,62,88,16,30,4,8,19,78,118
2010-06-21 00:00:00.000,Wimbledon Great Britain Grand Slams,GRASS,3,Novak Djokovic,Taylor Dent,Novak Djokovic,7-6(5); 6-1; 6-4,R64,117,9,1,58,89,47,58,21,31,1,1,15,68,89,12,11,51,105,43,51,19,54,3,6,14,62,105
2010-06-21 00:00:00.000,Wimbledon Great Britain Grand Slams,GRASS,3,Albert Montanes,Brendan Evans,Albert Montanes,3-6; 6-3; 6-7(5); 6-1; 6-4,R64,138,14,3,98,139,78,98,25,41,3,4,24,103,139,20,12,73,127,60,73,29,54,2,6,23,89,127
2010-06-21 00:00:00.000,Wimbledon Great Britain Grand Slams,GRASS,3,Gael Monfils,Karol Beck,Gael Monfils,6-4; 6-4; 6-7(4); 6-4,R64,170,27,6,85,136,68,85,29,51,7,7,21,97,136,11,4,91,139,69,91,25,48,12,15,21,94,139
2010-06-21 00:00:00.000,Wimbledon Great Britain Grand Slams,GRASS,3,Lleyton Hewitt,Evgeny Korolev,Lleyton Hewitt,6-4; 6-4; 3-0 RET,R64,84,10,0,37,55,32,37,11,18,1,2,11,43,55,10,3,45,78,33,45,8,33,4,9,12,41,78
2010-06-21 00:00:00.000,Wimbledon Great Britain Grand Slams,GRASS,3,Florian Mayer,Mardy Fish,Florian Mayer,6-7(2); 6-3; 6-4; 6-4,R64,171,4,4,106,164,74,106,32,58,13,14,21,106,164,30,1,68,107,58,68,18,39,4,8,20,76,107
2010-06-21 00:00:00.000,Wimbledon Great Britain Grand Slams,GRASS,3,Yen-Hsun Lu,Michal Przysiezny,Yen-Hsun Lu,6-4; 7-6(7); 6-3,R64,145,21,5,57,97,46,57,20,40,5,7,16,66,97,4,4,51,95,35,51,23,44,7,11,15,58,95
2010-06-21 00:00:00.000,Wimbledon Great Britain Grand Slams,GRASS,3,Philipp Kohlschreiber,Teymuraz Gabashvili,Philipp Kohlschreiber,7-6(6); 5-7; 2-6; 7-6(5); 9-7,R64,257,23,7,125,181,98,125,30,56,8,12,30,128,181,19,8,130,206,98,130,41,76,13,15,30,139,206
2010-06-21 00:00:00.000,Wimbledon Great Britain Grand Slams,GRASS,3,Andy Roddick,Michael Llodra,Andy Roddick,4-6; 6-4; 6-1; 7-6(2),R64,143,25,1,86,119,70,86,15,33,4,5,20,85,119,23,5,60,97,48,60,21,37,0,3,19,69,97
2010-06-21 00:00:00.000,Wimbledon Great Britain Grand Slams,GRASS,3,Fabio Fognini,Michael Russell,Fabio Fognini,3-6; 5-7; 7-5; 7-6(6); 6-3,R64,252,10,7,112,179,77,112,27,67,3,13,28,104,179,8,7,111,172,67,111,35,61,11,20,26,102,172
2010-06-21 00:00:00.000,Wimbledon Great Britain Grand Slams,GRASS,3,Julien Benneteau,Andreas Beck,Julien Benneteau,3-6; 6-2; 4-6; 7-6(5); 6-3,R64,216,36,4,100,148,80,100,21,48,12,16,23,101,148,8,13,91,172,67,91,39,81,10,16,25,106,172
2010-06-21 00:00:00.000,Wimbledon Great Britain Grand Slams,GRASS,3,Tobias Kamke,Andreas Seppi,Tobias Kamke,3-6; 6-2; 6-3; 6-4,R64,162,6,3,71,128,49,71,36,57,13,14,18,85,128,7,5,77,134,57,77,22,57,10,14,18,79,134
2010-06-21 00:00:00.000,Wimbledon Great Britain Grand Slams,GRASS,3,Jo-Wilfried Tsonga,Alexandr Dolgopolov,Jo-Wilfried Tsonga,6-4; 6-4; 6-7(5); 5-7; 10-8,R64,235,33,6,127,187,102,127,34,60,10,11,31,136,187,29,11,117,208,87,117,53,91,12,15,31,140,208
2010-06-21 00:00:00.000,Wimbledon Great Britain Grand Slams,GRASS,3,Xavier Malisse,Julian Reister,Xavier Malisse,6-7(7); 6-4; 6-1; 6-4,R64,154,13,1,59,112,45,59,35,53,2,4,20,80,112,6,3,95,130,56,95,22,35,4,10,19,78,130
2010-06-21 00:00:00.000,Wimbledon Great Britain Grand Slams,GRASS,3,Sam Querrey,Ivan Dodig,Sam Querrey,6-2; 5-7; 6-3; 7-6(10),R64,154,28,2,82,120,67,82,25,38,2,3,20,92,120,14,4,71,123,55,71,28,52,2,6,21,83,123
2010-06-21 00:00:00.000,Wimbledon Great Britain Grand Slams,GRASS,3,Gilles Simon,Illya Marchenko,Gilles Simon,W/O,R64,0,0,0,0,0,0,0,0,0,0,0,0,0,0,0,0,0,0,0,0,0,0,0,0,0,0,0
2010-06-21 00:00:00.000,Wimbledon Great Britain Grand Slams,GRASS,3,Andy Murray,Jarkko Nieminen,Andy Murray,6-3; 6-4; 6-2,R64,102,18,1,49,78,42,49,17,29,4,4,14,59,78,0,3,59,88,40,59,13,29,6,10,13,53,88
2010-06-21 00:00:00.000,Wimbledon Great Britain Grand Slams,GRASS,3,Robin Soderling,Marcel Granollers,Robin Soderling,7-5; 6-1; 6-4,R64,99,15,4,47,78,42,47,20,31,0,0,15,62,78,8,1,46,80,34,46,15,34,2,6,14,49,80
2010-06-21 00:00:00.000,Wimbledon Great Britain Grand Slams,GRASS,3,Thomaz Bellucci,Martin Fischer,Thomaz Bellucci,6-7(11); 7-6(4); 7-6(1); 6-2,R64,205,21,5,85,158,69,85,35,73,10,13,22,104,158,3,4,95,141,64,95,24,46,0,5,22,88,141
2010-06-21 00:00:00.000,Wimbledon Great Britain Grand Slams,GRASS,3,Jeremy Chardy,Lukas Lacko,Jeremy Chardy,6-3; 7-6(4); 4-6; 6-7(5); 8-6,R64,218,35,8,107,196,90,107,48,89,8,10,29,138,196,18,7,104,159,85,104,34,55,1,4,28,119,159
2010-06-21 00:00:00.000,Wimbledon Great Britain Grand Slams,GRASS,3,David Ferrer,Florent Serra,David Ferrer,6-4; 7-5; 6-7(6); 6-3,R64,172,19,2,90,138,66,90,28,48,3,6,22,94,138,8,1,80,130,54,80,22,50,1,7,21,76,130
2010-06-21 00:00:00.000,Wimbledon Great Britain Grand Slams,GRASS,3,Paul-Henri Mathieu,Mikhail Youzhny,Paul-Henri Mathieu,6-4; 2-6; 2-6; 6-3; 6-4,R64,212,7,4,69,144,51,69,37,75,8,14,23,88,144,12,4,94,142,64,94,26,48,9,14,22,90,142
2010-06-21 00:00:00.000,Wimbledon Great Britain Grand Slams,GRASS,3,Thiemo de Bakker,John Isner,Thiemo de Bakker,6-0; 6-3; 6-2,R64,74,11,1,39,55,36,39,9,16,0,0,11,45,55,0,2,58,78,26,58,10,20,6,13,12,36,78
2010-06-21 00:00:00.000,Wimbledon Great Britain Grand Slams,GRASS,3,Philipp Petzschner,Lukasz Kubot,Philipp Petzschner,6-4; 3-6; 4-6; 6-3; 6-2,R64,163,9,4,76,115,62,76,23,39,1,3,23,85,115,15,12,96,149,74,96,21,53,9,13,23,95,149
2010-06-21 00:00:00.000,Wimbledon Great Britain Grand Slams,GRASS,3,Rafael Nadal,Robin Haase,Rafael Nadal,5-7; 6-2; 3-6; 6-0; 6-3,R64,142,5,2,73,107,62,73,23,34,0,2,22,85,107,28,2,76,111,57,76,16,35,4,10,22,73,111
2010-06-21 00:00:00.000,Wimbledon Great Britain Grand Slams,GRASS,3,Roger Federer,Arnaud Clement,Roger Federer,6-2; 6-4; 6-2,R32,95,7,3,44,68,37,44,16,24,1,1,13,53,68,5,0,44,76,32,44,11,32,5,10,13,43,76
2010-06-21 00:00:00.000,Wimbledon Great Britain Grand Slams,GRASS,3,Jurgen Melzer,Feliciano Lopez,Jurgen Melzer,4-6; 6-3; 6-2; 6-4,R32,149,18,6,75,118,58,75,24,43,9,11,19,82,118,13,4,51,105,38,51,26,54,5,10,18,64,105
2010-06-21 00:00:00.000,Wimbledon Great Britain Grand Slams,GRASS,3,Tomas Berdych,Denis Istomin,Tomas Berdych,6-7(1); 7-6(5); 6-7(8); 6-3; 6-4,R32,233,34,5,109,175,96,109,36,66,3,4,28,132,175,20,3,131,179,101,131,26,48,10,13,27,127,179
2010-06-21 00:00:00.000,Wimbledon Great Britain Grand Slams,GRASS,3,Daniel Brands,Victor Hanescu,Daniel Brands,6-7(7); 6-7(3); 7-6(7); 6-3; 3-0 RET,R32,205,24,4,89,149,73,89,37,60,2,3,24,110,149,23,5,108,154,82,108,24,46,2,6,24,106,154
2010-06-21 00:00:00.000,Wimbledon Great Britain Grand Slams,GRASS,3,Novak Djokovic,Albert Montanes,Novak Djokovic,6-1; 6-4; 6-4,R32,101,11,5,50,75,41,50,16,25,0,0,14,57,75,5,2,61,93,41,61,13,32,5,9,13,54,93
2010-06-21 00:00:00.000,Wimbledon Great Britain Grand Slams,GRASS,3,Lleyton Hewitt,Gael Monfils,Lleyton Hewitt,6-3; 7-6(9); 6-4,R32,129,2,2,49,93,42,49,27,44,2,3,16,69,93,21,4,58,106,44,58,19,48,7,10,15,63,106
2010-06-21 00:00:00.000,Wimbledon Great Britain Grand Slams,GRASS,3,Yen-Hsun Lu,Florian Mayer,Yen-Hsun Lu,6-4; 6-4; 2-1 RET,R32,96,12,2,40,61,34,40,13,21,2,2,11,47,61,2,2,46,76,34,46,11,30,7,10,12,45,76
2010-06-21 00:00:00.000,Wimbledon Great Britain Grand Slams,GRASS,3,Andy Roddick,Philipp Kohlschreiber,Andy Roddick,7-5; 6-7(5); 6-3; 6-3,R32,176,28,0,86,121,73,86,21,35,7,7,21,94,121,13,3,89,139,66,89,22,50,5,9,21,88,139
2010-06-21 00:00:00.000,Wimbledon Great Britain Grand Slams,GRASS,3,Julien Benneteau,Fabio Fognini,Julien Benneteau,6-4; 6-1; 4-6; 6-3,R32,141,10,4,75,110,52,75,19,35,4,8,18,71,110,7,7,76,124,52,76,16,48,11,19,18,68,124
2010-06-21 00:00:00.000,Wimbledon Great Britain Grand Slams,GRASS,3,Jo-Wilfried Tsonga,Tobias Kamke,Jo-Wilfried Tsonga,6-1; 6-4; 7-6(1),R32,97,19,1,47,83,43,47,23,36,4,4,15,66,83,2,7,54,83,39,54,12,29,0,3,14,51,83
2010-06-21 00:00:00.000,Wimbledon Great Britain Grand Slams,GRASS,3,Sam Querrey,Xavier Malisse,Sam Querrey,6-7(4); 6-4; 6-2; 5-7; 9-7,R32,227,23,6,110,181,85,110,39,71,8,11,29,124,181,14,1,119,192,88,119,38,73,14,20,29,126,192
2010-06-21 00:00:00.000,Wimbledon Great Britain Grand Slams,GRASS,3,Andy Murray,Gilles Simon,Andy Murray,6-1; 6-4; 6-4,R32,110,15,1,47,72,39,47,18,25,0,0,14,57,72,2,2,49,91,32,49,19,42,5,9,13,51,91
2010-06-21 00:00:00.000,Wimbledon Great Britain Grand Slams,GRASS,3,Robin Soderling,Thomaz Bellucci,Robin Soderling,6-4; 6-2; 7-5,R32,114,15,5,52,85,47,52,18,33,3,3,15,65,85,9,3,60,99,43,60,15,39,3,7,15,58,99
2010-06-21 00:00:00.000,Wimbledon Great Britain Grand Slams,GRASS,3,David Ferrer,Jeremy Chardy,David Ferrer,7-5; 6-3; 4-6; 3-6; 7-5,R32,184,13,3,98,150,71,98,27,52,11,16,26,98,150,21,10,86,146,68,86,24,60,12,18,26,92,146
2010-06-21 00:00:00.000,Wimbledon Great Britain Grand Slams,GRASS,3,Paul-Henri Mathieu,Thiemo de Bakker,Paul-Henri Mathieu,7-6(5); 7-6(6); 6-7(8); 6-4,R32,195,16,6,83,150,72,83,42,67,1,1,23,114,150,32,5,99,159,84,99,30,60,5,6,23,114,159
2010-06-21 00:00:00.000,Wimbledon Great Britain Grand Slams,GRASS,3,Rafael Nadal,Philipp Petzschner,Rafael Nadal,6-4; 4-6; 6-7(5); 6-2; 6-3,R32,225,12,1,96,142,77,96,28,46,1,2,25,105,142,25,3,101,168,79,101,29,67,10,14,24,108,168
2010-06-21 00:00:00.000,Wimbledon Great Britain Grand Slams,GRASS,3,Roger Federer,Jurgen Melzer,Roger Federer,6-3; 6-2; 6-3,R16,84,11,2,34,65,29,34,21,31,0,1,13,50,65,6,3,55,77,29,55,10,22,4,10,13,39,77
2010-06-21 00:00:00.000,Wimbledon Great Britain Grand Slams,GRASS,3,Tomas Berdych,Daniel Brands,Tomas Berdych,4-6; 7-6(1); 7-5; 6-3,R16,184,20,5,77,132,62,77,33,55,5,7,22,95,132,17,4,92,141,66,92,23,49,5,8,21,89,141
2010-06-21 00:00:00.000,Wimbledon Great Britain Grand Slams,GRASS,3,Novak Djokovic,Lleyton Hewitt,Novak Djokovic,7-5; 6-4; 3-6; 6-4,R16,174,9,9,75,124,57,75,26,49,6,9,21,83,124,5,2,68,111,53,68,22,43,5,9,20,75,111
2010-06-21 00:00:00.000,Wimbledon Great Britain Grand Slams,GRASS,3,Yen-Hsun Lu,Andy Roddick,Yen-Hsun Lu,4-6; 7-6(3); 7-6(4); 6-7(5); 9-7,R16,276,22,4,124,206,101,124,45,82,7,8,31,146,206,38,8,129,189,108,129,31,60,1,2,31,139,189
2010-06-21 00:00:00.000,Wimbledon Great Britain Grand Slams,GRASS,3,Jo-Wilfried Tsonga,Julien Benneteau,Jo-Wilfried Tsonga,6-1; 6-4; 3-6; 6-1,R16,119,14,2,57,93,48,57,18,36,1,3,17,66,93,5,7,54,89,32,54,19,35,3,9,16,51,89
2010-06-21 00:00:00.000,Wimbledon Great Britain Grand Slams,GRASS,3,Andy Murray,Sam Querrey,Andy Murray,7-5; 6-3; 6-4,R16,126,10,3,43,95,36,43,33,52,7,8,16,69,95,13,9,75,115,53,75,15,40,8,12,15,68,115
2010-06-21 00:00:00.000,Wimbledon Great Britain Grand Slams,GRASS,3,Robin Soderling,David Ferrer,Robin Soderling,6-2; 5-7; 6-2; 3-6; 7-5,R16,183,19,11,101,159,79,101,24,58,7,11,25,103,159,16,8,89,142,66,89,23,53,10,16,24,89,142
2010-06-21 00:00:00.000,Wimbledon Great Britain Grand Slams,GRASS,3,Rafael Nadal,Paul-Henri Mathieu,Rafael Nadal,6-4; 6-2; 6-2,R16,121,8,1,44,68,38,44,16,24,2,2,13,54,68,3,4,52,100,33,52,22,48,10,15,13,55,100
2010-06-21 00:00:00.000,Wimbledon Great Britain Grand Slams,GRASS,3,Tomas Berdych,Roger Federer,Tomas Berdych,6-4; 3-6; 6-1; 6-4,Q,155,12,6,72,124,59,72,23,52,7,8,18,82,124,14,1,82,121,57,82,19,39,2,6,18,76,121
2010-06-21 00:00:00.000,Wimbledon Great Britain Grand Slams,GRASS,3,Novak Djokovic,Yen-Hsun Lu,Novak Djokovic,6-3; 6-2; 6-2,Q,111,4,3,41,65,35,41,18,24,0,0,13,53,65,4,2,54,87,35,54,11,33,10,15,12,46,87
2010-06-21 00:00:00.000,Wimbledon Great Britain Grand Slams,GRASS,3,Andy Murray,Jo-Wilfried Tsonga,Andy Murray,6-7(5); 7-6(5); 6-2; 6-2,Q,169,14,2,65,119,54,65,34,54,5,6,20,88,119,14,8,95,146,63,95,26,51,11,16,20,89,146
2010-06-21 00:00:00.000,Wimbledon Great Britain Grand Slams,GRASS,3,Rafael Nadal,Robin Soderling,Rafael Nadal,3-6; 6-3; 7-6(4); 6-1,Q,163,12,3,85,126,59,85,25,41,4,7,19,84,126,17,6,62,104,51,62,16,42,4,9,18,67,104
2010-06-21 00:00:00.000,Wimbledon Great Britain Grand Slams,GRASS,3,Tomas Berdych,Novak Djokovic,Tomas Berdych,6-3; 7-6(9); 6-3,S,138,11,2,58,102,47,58,28,44,3,4,16,75,102,9,8,64,88,47,64,10,24,4,7,14,57,88
2010-06-21 00:00:00.000,Wimbledon Great Britain Grand Slams,GRASS,3,Rafael Nadal,Andy Murray,Rafael Nadal,6-4; 7-6(6); 6-4,S,142,4,2,68,97,53,68,17,29,2,3,16,70,97,15,2,55,92,43,55,21,37,1,4,16,64,92
2010-06-21 00:00:00.000,Wimbledon Great Britain Grand Slams,GRASS,3,Rafael Nadal,Tomas Berdych,Rafael Nadal,6-3; 7-5; 6-4,F,133,5,3,62,90,48,62,18,28,4,4,15,66,90,13,0,48,81,35,48,19,33,2,6,16,54,81
2010-07-05 00:00:00.000,Newport RI; U.S.A. ATP World Tour 250,GRASS,2,Sam Querrey,Jesse Levine,Sam Querrey,6-3; 6-3,R32,59,15,2,34,51,29,34,10,17,2,2,9,39,51,2,3,31,51,21,31,9,20,2,5,9,30,51
2010-07-05 00:00:00.000,Newport RI; U.S.A. ATP World Tour 250,GRASS,2,Dustin Brown,Bjorn Phau,Dustin Brown,7-6(3); 6-7(7); 6-4,R32,127,20,14,67,129,54,67,31,62,7,9,17,85,129,10,14,60,118,44,60,33,58,7,10,17,77,118
2010-07-05 00:00:00.000,Newport RI; U.S.A. ATP World Tour 250,GRASS,2,Brian Dabul,Carsten Ball,Brian Dabul,5-7; 6-2; 0-1 RET,R32,77,6,2,38,59,28,38,12,21,1,2,10,40,59,6,7,46,72,31,46,12,26,6,8,11,43,72
2010-07-05 00:00:00.000,Newport RI; U.S.A. ATP World Tour 250,GRASS,2,Go Soeda,Taylor Dent,Go Soeda,6-4; 3-6; 6-4,R32,110,3,2,54,83,40,54,17,29,5,7,14,57,83,10,9,57,102,41,57,20,45,9,12,15,61,102
2010-07-05 00:00:00.000,Newport RI; U.S.A. ATP World Tour 250,GRASS,2,Olivier Rochus,Edouard Roger-Vasselin,Olivier Rochus,7-6(2); 6-4,R32,103,0,2,53,81,34,53,17,28,8,10,11,51,81,9,4,46,70,29,46,11,24,1,4,11,40,70
2010-07-05 00:00:00.000,Newport RI; U.S.A. ATP World Tour 250,GRASS,2,Sergei Bubka,Chris Guccione,Sergei Bubka,7-6(0); 6-4,R32,76,10,1,38,61,32,38,18,23,2,2,11,50,61,5,2,38,69,27,38,20,31,1,2,11,47,69
2010-07-05 00:00:00.000,Newport RI; U.S.A. ATP World Tour 250,GRASS,2,Raven Klaasen,Ilija Bozoljac,Raven Klaasen,7-6(5); 7-6(0),R32,110,9,1,49,79,39,49,21,30,2,2,12,60,79,17,15,41,92,33,41,27,51,9,9,12,60,92
2010-07-05 00:00:00.000,Newport RI; U.S.A. ATP World Tour 250,GRASS,2,Rajeev Ram,Ivan Navarro,Rajeev Ram,6-3; 7-6(3),R32,72,12,4,37,63,36,37,16,26,2,2,11,52,63,8,3,31,57,26,31,14,26,1,2,10,40,57
2010-07-05 00:00:00.000,Newport RI; U.S.A. ATP World Tour 250,GRASS,2,Mardy Fish,Michael Russell,Mardy Fish,6-1; 6-2,R32,52,7,1,21,34,19,21,9,13,0,0,7,28,34,4,2,32,47,16,32,4,15,2,7,8,20,47
2010-07-05 00:00:00.000,Newport RI; U.S.A. ATP World Tour 250,GRASS,2,Somdev Devvarman,Kevin Kim,Somdev Devvarman,6-4; 6-3,R32,64,7,7,28,65,22,28,22,37,3,3,10,44,65,4,7,26,49,20,26,11,23,1,3,9,31,49
2010-07-05 00:00:00.000,Newport RI; U.S.A. ATP World Tour 250,GRASS,2,Frank Dancevic,Marc Gicquel,Frank Dancevic,7-5; 6-4,R32,73,14,3,33,66,28,33,18,33,5,5,11,46,66,4,2,38,70,25,38,18,32,2,4,11,43,70
2010-07-05 00:00:00.000,Newport RI; U.S.A. ATP World Tour 250,GRASS,2,Nicolas Mahut,Alejandro Falla,Nicolas Mahut,6-3; 1-6; 6-3,R32,83,5,3,42,73,33,42,17,31,5,7,13,50,73,4,4,36,63,27,36,15,27,1,3,12,42,63
2010-07-05 00:00:00.000,Newport RI; U.S.A. ATP World Tour 250,GRASS,2,Ryan Harrison,Karol Beck,Ryan Harrison,6-1; 6-2,R32,59,7,0,28,43,22,28,10,15,0,0,8,32,43,0,4,24,55,14,24,13,31,4,8,7,27,55
2010-07-05 00:00:00.000,Newport RI; U.S.A. ATP World Tour 250,GRASS,2,Denis Kudla,Santiago Ventura,Denis Kudla,6-3; 3-6; 7-5,R32,111,10,4,48,89,30,48,23,41,5,10,15,53,89,4,6,65,98,43,65,11,33,7,13,15,54,98
2010-07-05 00:00:00.000,Newport RI; U.S.A. ATP World Tour 250,GRASS,2,Richard Bloomfield,Christophe Rochus,Richard Bloomfield,7-6(1); 6-3,R32,82,19,3,34,65,27,34,22,31,3,3,10,49,65,2,1,63,81,42,63,7,18,8,10,11,49,81
2010-07-05 00:00:00.000,Newport RI; U.S.A. ATP World Tour 250,GRASS,2,Santiago Giraldo,Alexander Peya,Santiago Giraldo,7-6(1); 1-6; 6-4,R32,124,3,4,72,94,50,72,9,22,5,9,15,59,94,4,3,52,80,35,52,17,28,3,5,14,52,80
2010-07-05 00:00:00.000,Newport RI; U.S.A. ATP World Tour 250,GRASS,2,Dustin Brown,Sam Querrey,Dustin Brown,6-4; 6-3,R16,47,14,4,34,51,33,34,5,17,0,0,9,38,51,3,4,26,53,20,26,13,27,0,3,10,33,53
2010-07-05 00:00:00.000,Newport RI; U.S.A. ATP World Tour 250,GRASS,2,Brian Dabul,Go Soeda,Brian Dabul,7-5; 6-2,R16,91,3,0,41,56,34,41,7,15,2,2,10,41,56,6,6,41,76,28,41,14,35,12,15,10,42,76
2010-07-05 00:00:00.000,Newport RI; U.S.A. ATP World Tour 250,GRASS,2,Olivier Rochus,Sergei Bubka,Olivier Rochus,6-3; 6-3,R16,70,3,0,35,57,28,35,13,22,3,3,9,41,57,8,1,29,57,18,29,13,28,3,6,9,31,57
2010-07-05 00:00:00.000,Newport RI; U.S.A. ATP World Tour 250,GRASS,2,Raven Klaasen,Rajeev Ram,Raven Klaasen,5-7; 6-1; 7-6(3),R16,117,12,4,61,89,48,61,15,28,2,5,16,63,89,12,13,50,100,39,50,21,50,6,10,15,60,100
2010-07-05 00:00:00.000,Newport RI; U.S.A. ATP World Tour 250,GRASS,2,Mardy Fish,Somdev Devvarman,Mardy Fish,6-2; 6-0,R16,66,6,1,24,49,19,24,14,25,5,5,7,33,49,1,6,34,60,20,34,6,26,9,14,7,26,60
2010-07-05 00:00:00.000,Newport RI; U.S.A. ATP World Tour 250,GRASS,2,Frank Dancevic,Nicolas Mahut,Frank Dancevic,7-6(5); 6-3,R16,76,13,1,36,66,31,36,19,30,0,0,11,50,66,10,7,41,59,35,41,8,18,2,3,10,43,59
2010-07-05 00:00:00.000,Newport RI; U.S.A. ATP World Tour 250,GRASS,2,Ryan Harrison,Denis Kudla,Ryan Harrison,7-5; 7-6(5),R16,103,8,3,46,74,33,46,16,28,5,8,12,49,74,1,3,46,93,30,46,23,47,9,13,12,53,93
2010-07-05 00:00:00.000,Newport RI; U.S.A. ATP World Tour 250,GRASS,2,Richard Bloomfield,Santiago Giraldo,Richard Bloomfield,6-3; 7-6(5),R16,88,9,5,36,72,31,36,18,36,1,2,11,49,72,7,2,40,71,28,40,17,31,2,4,10,45,71
2010-07-05 00:00:00.000,Newport RI; U.S.A. ATP World Tour 250,GRASS,2,Brian Dabul,Dustin Brown,Brian Dabul,6-4; 6-4,Q,68,2,0,50,64,40,50,7,14,2,2,10,47,64,7,3,34,60,24,34,14,26,2,4,10,38,60
2010-07-05 00:00:00.000,Newport RI; U.S.A. ATP World Tour 250,GRASS,2,Olivier Rochus,Raven Klaasen,Olivier Rochus,6-1; 6-3,Q,60,4,0,32,44,24,32,9,12,2,2,8,33,44,3,1,28,49,18,28,7,21,3,7,8,25,49
2010-07-05 00:00:00.000,Newport RI; U.S.A. ATP World Tour 250,GRASS,2,Mardy Fish,Frank Dancevic,Mardy Fish,6-7(6); 6-4; 6-4,Q,134,7,2,45,91,38,45,26,46,2,5,16,64,91,6,5,54,98,42,54,15,44,1,6,16,57,98
2010-07-05 00:00:00.000,Newport RI; U.S.A. ATP World Tour 250,GRASS,2,Richard Bloomfield,Ryan Harrison,Richard Bloomfield,5-7; 7-6(3); 7-5,Q,147,4,4,79,120,60,79,21,41,7,9,18,81,120,13,7,77,112,62,77,13,35,1,3,18,75,112
2010-07-05 00:00:00.000,Newport RI; U.S.A. ATP World Tour 250,GRASS,2,Olivier Rochus,Brian Dabul,Olivier Rochus,6-3; 6-2,S,86,1,4,30,52,24,30,12,22,3,4,9,36,52,4,1,42,69,21,42,14,27,6,10,8,35,69
2010-07-05 00:00:00.000,Newport RI; U.S.A. ATP World Tour 250,GRASS,2,Mardy Fish,Richard Bloomfield,Mardy Fish,7-6(5); 6-4,S,91,9,1,30,58,26,30,23,28,0,0,11,49,58,7,5,46,71,33,46,17,25,1,2,11,50,71
2010-07-05 00:00:00.000,Newport RI; U.S.A. ATP World Tour 250,GRASS,2,Mardy Fish,Olivier Rochus,Mardy Fish,5-7; 6-3; 6-4,F,123,24,3,53,88,47,53,17,35,2,3,16,64,88,2,3,56,87,42,56,19,31,3,5,15,61,87
2010-07-12 00:00:00.000,Bsstad Sweden ATP World Tour 250,CLAY,2,Robin Soderling,N/A Bye,Robin Soderling,,R32,0,0,0,0,0,0,0,0,0,0,0,0,0,0,0,0,0,0,0,0,0,0,0,0,0,0,0
2010-07-12 00:00:00.000,Bsstad Sweden ATP World Tour 250,CLAY,2,Andreas Vinciguerra,Daniel Brands,Andreas Vinciguerra,7-6(6); 6-7(5); 6-4,R32,129,11,2,70,106,54,70,21,36,1,3,17,75,106,12,4,72,107,56,72,17,35,3,6,17,73,107
2010-07-12 00:00:00.000,Bsstad Sweden ATP World Tour 250,CLAY,2,Andreas Seppi,Marcel Granollers,Andreas Seppi,6-4; 6-2,R32,87,0,2,35,65,20,35,16,30,4,6,9,36,65,4,4,37,56,19,37,8,19,2,7,9,27,56
2010-07-12 00:00:00.000,Bsstad Sweden ATP World Tour 250,CLAY,2,Potito Starace,Florent Serra,Potito Starace,6-2; 6-2,R32,61,5,0,40,50,30,40,6,10,3,3,8,36,50,1,0,32,45,17,32,6,13,4,8,8,23,45
2010-07-12 00:00:00.000,Bsstad Sweden ATP World Tour 250,CLAY,2,David Ferrer,N/A Bye,David Ferrer,,R32,0,0,0,0,0,0,0,0,0,0,0,0,0,0,0,0,0,0,0,0,0,0,0,0,0,0,0
2010-07-12 00:00:00.000,Bsstad Sweden ATP World Tour 250,CLAY,2,Fabio Fognini,Filip Prpic,Fabio Fognini,6-7(7); 6-3; 6-4,R32,135,5,5,65,110,49,65,21,45,7,9,16,70,110,2,4,58,96,36,58,20,38,3,7,15,56,96
2010-07-12 00:00:00.000,Bsstad Sweden ATP World Tour 250,CLAY,2,Pere Riba,Peter Luczak,Pere Riba,4-6; 6-2; 7-6(6),R32,164,7,3,59,102,34,59,23,43,4,9,15,57,102,1,4,58,100,35,58,19,42,2,8,15,54,100
2010-07-12 00:00:00.000,Bsstad Sweden ATP World Tour 250,CLAY,2,Pablo Cuevas,Paul-Henri Mathieu,Pablo Cuevas,7-6(2); 7-6(3),R32,113,6,1,46,70,37,46,14,24,0,2,12,51,70,4,3,52,87,36,52,18,35,7,9,12,54,87
2010-07-12 00:00:00.000,Bsstad Sweden ATP World Tour 250,CLAY,2,Franko Skugor,Denis Istomin,Franko Skugor,7-6(5); 7-6(7),R32,151,3,1,60,88,43,60,13,28,4,7,12,56,88,7,2,77,102,50,77,10,25,10,13,12,60,102
2010-07-12 00:00:00.000,Bsstad Sweden ATP World Tour 250,CLAY,2,Ervin Eleskovic,Jerzy Janowicz,Ervin Eleskovic,6-3; 6-4,R32,75,9,4,36,62,30,36,14,26,1,1,10,44,62,2,4,30,47,22,30,9,17,1,3,9,31,47
2010-07-12 00:00:00.000,Bsstad Sweden ATP World Tour 250,CLAY,2,Jarkko Nieminen,Christian Lindell,Jarkko Nieminen,4-6; 6-0; 6-4,R32,98,3,5,54,73,42,54,7,19,2,4,13,49,73,8,2,45,69,28,45,11,24,3,8,13,39,69
2010-07-12 00:00:00.000,Bsstad Sweden ATP World Tour 250,CLAY,2,Nicolas Almagro,N/A Bye,Nicolas Almagro,,R32,0,0,0,0,0,0,0,0,0,0,0,0,0,0,0,0,0,0,0,0,0,0,0,0,0,0,0
2010-07-12 00:00:00.000,Bsstad Sweden ATP World Tour 250,CLAY,2,Tommy Robredo,Michal Przysiezny,Tommy Robredo,7-6(3); 6-3,R32,80,7,0,52,60,44,52,6,8,0,0,11,50,60,3,5,37,66,26,37,18,29,5,6,10,44,66
2010-07-12 00:00:00.000,Bsstad Sweden ATP World Tour 250,CLAY,2,Andrey Golubev,Maximo Gonzalez,Andrey Golubev,6-3; 6-2,R32,67,5,0,36,49,30,36,3,13,0,1,9,33,49,0,1,34,50,18,34,6,16,1,5,8,24,50
2010-07-12 00:00:00.000,Bsstad Sweden ATP World Tour 250,CLAY,2,Stephane Robert,Jonathan Dasnieres de Veigy,Stephane Robert,6-4; 6-1,R32,75,3,1,39,57,27,39,11,18,1,2,9,38,57,2,0,43,55,20,43,7,12,4,8,8,27,55
2010-07-12 00:00:00.000,Bsstad Sweden ATP World Tour 250,CLAY,2,Fernando Verdasco,N/A Bye,Fernando Verdasco,,R32,0,0,0,0,0,0,0,0,0,0,0,0,0,0,0,0,0,0,0,0,0,0,0,0,0,0,0
2010-07-12 00:00:00.000,Bsstad Sweden ATP World Tour 250,CLAY,2,Robin Soderling,Andreas Vinciguerra,Robin Soderling,6-2; 6-7(6); 6-2,R16,112,15,7,50,87,41,50,20,37,0,0,14,61,87,6,6,54,97,35,54,23,43,5,9,14,58,97
2010-07-12 00:00:00.000,Bsstad Sweden ATP World Tour 250,CLAY,2,Andreas Seppi,Potito Starace,Andreas Seppi,6-4; 3-6; 7-6(7),R16,151,6,2,58,95,42,58,16,37,4,7,15,58,95,10,0,93,111,59,93,10,18,3,6,16,69,111
2010-07-12 00:00:00.000,Bsstad Sweden ATP World Tour 250,CLAY,2,David Ferrer,Fabio Fognini,David Ferrer,6-3; 7-5,R16,97,0,2,41,68,27,41,16,27,3,5,10,43,68,2,5,38,65,26,38,7,27,2,7,11,33,65
2010-07-12 00:00:00.000,Bsstad Sweden ATP World Tour 250,CLAY,2,Pablo Cuevas,Pere Riba,Pablo Cuevas,6-4; 6-2,R16,80,5,1,37,53,30,37,9,16,0,0,9,39,53,4,0,41,65,28,41,7,24,5,8,9,35,65
2010-07-12 00:00:00.000,Bsstad Sweden ATP World Tour 250,CLAY,2,Franko Skugor,Ervin Eleskovic,Franko Skugor,6-2; 6-3,R16,73,4,0,33,51,26,33,13,18,2,2,9,39,51,2,4,24,53,17,24,13,29,3,6,8,30,53
2010-07-12 00:00:00.000,Bsstad Sweden ATP World Tour 250,CLAY,2,Nicolas Almagro,Jarkko Nieminen,Nicolas Almagro,6-4; 6-4,R16,82,7,0,40,63,30,40,14,23,0,0,10,44,63,3,3,44,69,29,44,14,25,7,9,10,43,69
2010-07-12 00:00:00.000,Bsstad Sweden ATP World Tour 250,CLAY,2,Tommy Robredo,Andrey Golubev,Tommy Robredo,3-6; 6-3; 6-2,R16,105,2,3,52,77,40,52,14,25,5,7,13,54,77,3,1,56,84,35,56,15,28,8,12,13,50,84
2010-07-12 00:00:00.000,Bsstad Sweden ATP World Tour 250,CLAY,2,Fernando Verdasco,Stephane Robert,Fernando Verdasco,6-1; 6-1,R16,66,0,2,30,41,22,30,8,11,0,0,7,30,41,0,5,32,59,18,32,9,27,6,11,7,27,59
2010-07-12 00:00:00.000,Bsstad Sweden ATP World Tour 250,CLAY,2,Robin Soderling,Andreas Seppi,Robin Soderling,4-6; 7-5; 7-6(5),Q,145,13,5,56,102,44,56,23,46,2,5,17,67,102,5,2,63,112,40,63,28,49,4,7,17,68,112
2010-07-12 00:00:00.000,Bsstad Sweden ATP World Tour 250,CLAY,2,David Ferrer,Pablo Cuevas,David Ferrer,6-3; 6-3,Q,76,2,2,28,53,20,28,19,25,2,2,9,39,53,2,1,35,54,25,35,9,19,4,7,9,34,54
2010-07-12 00:00:00.000,Bsstad Sweden ATP World Tour 250,CLAY,2,Nicolas Almagro,Franko Skugor,Nicolas Almagro,4-6; 6-4; 6-0,Q,94,7,1,53,74,42,53,12,21,3,4,13,54,74,6,2,45,76,28,45,17,31,1,5,13,45,76
2010-07-12 00:00:00.000,Bsstad Sweden ATP World Tour 250,CLAY,2,Tommy Robredo,Fernando Verdasco,Tommy Robredo,6-4; 6-3,Q,83,2,0,56,62,36,56,5,6,1,2,10,41,62,1,4,48,60,30,48,5,12,6,9,9,35,60
2010-07-12 00:00:00.000,Bsstad Sweden ATP World Tour 250,CLAY,2,Robin Soderling,David Ferrer,Robin Soderling,4-6; 6-3; 6-2,S,118,11,1,45,84,35,45,26,39,8,9,14,61,84,4,3,50,72,33,50,12,22,2,5,13,45,72
2010-07-12 00:00:00.000,Bsstad Sweden ATP World Tour 250,CLAY,2,Nicolas Almagro,Tommy Robredo,Nicolas Almagro,6-1; 6-3,S,68,5,0,27,51,23,27,13,24,2,2,8,36,51,0,0,42,51,21,42,6,9,4,8,8,27,51
2010-07-12 00:00:00.000,Bsstad Sweden ATP World Tour 250,CLAY,2,Nicolas Almagro,Robin Soderling,Nicolas Almagro,7-5; 3-6; 6-2,F,117,3,0,45,83,33,45,24,38,6,7,14,57,83,8,5,52,84,46,52,12,32,8,11,15,58,84
2010-07-12 00:00:00.000,Stuttgart Germany ATP World Tour 250,CLAY,2,Nikolay Davydenko,N/A Bye,Nikolay Davydenko,,R32,0,0,0,0,0,0,0,0,0,0,0,0,0,0,0,0,0,0,0,0,0,0,0,0,0,0,0
2010-07-12 00:00:00.000,Stuttgart Germany ATP World Tour 250,CLAY,2,Daniel Gimeno-Traver,Jeremy Chardy,Daniel Gimeno-Traver,7-5; 6-7(6); 6-3,R32,155,18,5,67,110,49,67,26,43,1,3,17,75,110,9,6,62,116,42,62,30,54,9,13,16,72,116
2010-07-12 00:00:00.000,Stuttgart Germany ATP World Tour 250,CLAY,2,Bjorn Phau,Victor Crivoi,Bjorn Phau,6-2; 6-3,R32,69,2,3,31,55,22,31,15,24,4,4,8,37,55,2,1,36,55,19,36,11,19,5,9,9,30,55
2010-07-12 00:00:00.000,Stuttgart Germany ATP World Tour 250,CLAY,2,Marco Chiudinelli,Victor Hanescu,Marco Chiudinelli,7-6(4); 6-3,R32,95,4,6,47,81,38,47,18,34,4,4,11,56,81,5,0,40,56,33,40,9,16,1,2,10,42,56
2010-07-12 00:00:00.000,Stuttgart Germany ATP World Tour 250,CLAY,2,Gael Monfils,N/A Bye,Gael Monfils,,R32,0,0,0,0,0,0,0,0,0,0,0,0,0,0,0,0,0,0,0,0,0,0,0,0,0,0,0
2010-07-12 00:00:00.000,Stuttgart Germany ATP World Tour 250,CLAY,2,Pablo Andujar,Bastian Knittel,Pablo Andujar,4-6; 6-4; 6-3,R32,148,1,3,68,90,49,68,10,22,1,3,15,59,90,5,11,55,89,42,55,12,34,7,10,14,54,89
2010-07-12 00:00:00.000,Stuttgart Germany ATP World Tour 250,CLAY,2,Guillermo Garcia-Lopez,Ivan Navarro,Guillermo Garcia-Lopez,4-6; 6-3; 6-2,R32,136,3,1,55,83,40,55,17,28,0,2,14,57,83,4,6,50,87,35,50,16,37,7,11,13,51,87
2010-07-12 00:00:00.000,Stuttgart Germany ATP World Tour 250,CLAY,2,Florian Mayer,Philipp Kohlschreiber,Florian Mayer,6-4; 6-2,R32,83,1,1,43,64,32,43,12,21,7,7,9,44,64,1,2,37,64,22,37,13,27,6,9,9,35,64
2010-07-12 00:00:00.000,Stuttgart Germany ATP World Tour 250,CLAY,2,Gilles Simon,Dustin Brown,Gilles Simon,6-3; 3-6; 7-6(1),R32,111,4,2,60,92,49,60,17,32,2,3,15,66,92,7,5,63,113,45,63,25,50,7,8,15,70,113
2010-07-12 00:00:00.000,Stuttgart Germany ATP World Tour 250,CLAY,2,Simon Greul,Michael Berrer,Simon Greul,7-6(6); 6-4,R32,117,3,4,47,82,34,47,21,35,8,9,11,55,82,2,2,49,79,33,49,16,30,7,9,11,49,79
2010-07-12 00:00:00.000,Stuttgart Germany ATP World Tour 250,CLAY,2,Horacio Zeballos,Andreas Beck,Horacio Zeballos,6-4; 7-5,R32,87,9,0,44,59,36,44,9,15,1,1,11,45,59,2,3,32,65,24,32,18,33,5,7,11,42,65
2010-07-12 00:00:00.000,Stuttgart Germany ATP World Tour 250,CLAY,2,Juan Carlos Ferrero,N/A Bye,Juan Carlos Ferrero,,R32,0,0,0,0,0,0,0,0,0,0,0,0,0,0,0,0,0,0,0,0,0,0,0,0,0,0,0
2010-07-12 00:00:00.000,Stuttgart Germany ATP World Tour 250,CLAY,2,Albert Montanes,Philipp Petzschner,Albert Montanes,2-6; 7-5; 6-2,R32,105,5,3,54,74,39,54,15,20,2,4,14,54,74,8,2,52,90,39,52,17,38,5,8,14,56,90
2010-07-12 00:00:00.000,Stuttgart Germany ATP World Tour 250,CLAY,2,Juan Ignacio Chela,Eduardo Schwank,Juan Ignacio Chela,6-2; 7-5,R32,84,2,0,32,57,21,32,17,25,3,5,10,38,57,0,1,36,54,21,36,7,18,2,7,10,28,54
2010-07-12 00:00:00.000,Stuttgart Germany ATP World Tour 250,CLAY,2,Mischa Zverev,Sergiy Stakhovsky,Mischa Zverev,6-4; 6-3,R32,86,2,1,28,48,22,28,9,20,1,3,9,31,48,2,3,43,66,27,43,6,23,2,7,10,33,66
2010-07-12 00:00:00.000,Stuttgart Germany ATP World Tour 250,CLAY,2,Jurgen Melzer,N/A Bye,Jurgen Melzer,,R32,0,0,0,0,0,0,0,0,0,0,0,0,0,0,0,0,0,0,0,0,0,0,0,0,0,0,0
2010-07-12 00:00:00.000,Stuttgart Germany ATP World Tour 250,CLAY,2,Daniel Gimeno-Traver,Nikolay Davydenko,Daniel Gimeno-Traver,7-6(7); 2-6; 6-1,R16,132,12,7,55,102,40,55,24,47,6,9,14,64,102,3,6,63,94,44,63,14,31,8,11,13,58,94
2010-07-12 00:00:00.000,Stuttgart Germany ATP World Tour 250,CLAY,2,Marco Chiudinelli,Bjorn Phau,Marco Chiudinelli,7-6(3); 6-3,R16,104,9,4,45,75,35,45,16,30,3,4,11,51,75,2,2,36,66,22,36,19,30,2,4,10,41,66
2010-07-12 00:00:00.000,Stuttgart Germany ATP World Tour 250,CLAY,2,Gael Monfils,Pablo Andujar,Gael Monfils,6-4; 5-7; 6-4,R16,135,7,1,56,87,42,56,18,31,3,6,16,60,87,0,5,66,100,44,66,17,34,4,8,16,61,100
2010-07-12 00:00:00.000,Stuttgart Germany ATP World Tour 250,CLAY,2,Florian Mayer,Guillermo Garcia-Lopez,Florian Mayer,6-3; 6-1,R16,81,2,2,23,49,21,23,11,26,4,5,8,32,49,1,4,34,68,18,34,14,34,9,14,8,32,68
2010-07-12 00:00:00.000,Stuttgart Germany ATP World Tour 250,CLAY,2,Simon Greul,Gilles Simon,Simon Greul,6-4; 7-5,R16,89,4,2,47,71,35,47,15,24,7,8,11,50,71,4,3,36,65,25,36,14,29,4,7,11,39,65
2010-07-12 00:00:00.000,Stuttgart Germany ATP World Tour 250,CLAY,2,Juan Carlos Ferrero,Horacio Zeballos,Juan Carlos Ferrero,6-7(1); 7-6(3); 6-2,R16,136,10,2,73,106,49,73,22,33,5,7,16,71,106,11,3,56,100,40,56,26,44,2,6,16,66,100
2010-07-12 00:00:00.000,Stuttgart Germany ATP World Tour 250,CLAY,2,Albert Montanes,Juan Ignacio Chela,Albert Montanes,7-5; 3-6; 6-2,R16,130,4,7,44,81,31,44,12,37,4,10,14,43,81,5,4,66,101,39,66,12,35,6,14,15,51,101
2010-07-12 00:00:00.000,Stuttgart Germany ATP World Tour 250,CLAY,2,Jurgen Melzer,Mischa Zverev,Jurgen Melzer,7-5; 7-5,R16,101,4,3,44,76,28,44,20,32,4,6,12,48,76,5,3,52,76,35,52,10,24,7,11,12,45,76
2010-07-12 00:00:00.000,Stuttgart Germany ATP World Tour 250,CLAY,2,Daniel Gimeno-Traver,Marco Chiudinelli,Daniel Gimeno-Traver,6-1; 6-3,Q,62,8,3,25,43,21,25,12,18,2,2,8,33,43,1,3,41,58,23,41,7,17,6,10,8,30,58
2010-07-12 00:00:00.000,Stuttgart Germany ATP World Tour 250,CLAY,2,Gael Monfils,Florian Mayer,Gael Monfils,5-7; 6-3; 6-4,Q,131,11,4,47,83,33,47,25,36,3,6,15,58,83,3,4,70,112,48,70,16,42,10,15,16,64,112
2010-07-12 00:00:00.000,Stuttgart Germany ATP World Tour 250,CLAY,2,Juan Carlos Ferrero,Simon Greul,Juan Carlos Ferrero,6-3; 7-5,Q,77,1,1,44,60,34,44,8,16,1,2,11,42,60,5,3,36,54,26,36,8,18,4,7,10,34,54
2010-07-12 00:00:00.000,Stuttgart Germany ATP World Tour 250,CLAY,2,Albert Montanes,Jurgen Melzer,Albert Montanes,6-4; 6-1,Q,57,6,1,26,47,21,26,14,21,0,1,9,35,47,0,4,23,41,10,23,10,18,3,7,8,20,41
2010-07-12 00:00:00.000,Stuttgart Germany ATP World Tour 250,CLAY,2,Gael Monfils,Daniel Gimeno-Traver,Gael Monfils,6-4; 4-6; 6-0,S,113,12,4,46,89,35,46,25,43,3,4,13,60,89,3,2,41,89,26,41,25,48,7,11,13,51,89
2010-07-12 00:00:00.000,Stuttgart Germany ATP World Tour 250,CLAY,2,Albert Montanes,Juan Carlos Ferrero,Albert Montanes,6-3; 7-6(6),S,103,5,3,38,67,30,38,14,29,0,2,11,44,67,0,0,56,70,33,56,6,14,4,7,10,39,70
2010-07-12 00:00:00.000,Stuttgart Germany ATP World Tour 250,CLAY,2,Albert Montanes,Gael Monfils,Albert Montanes,6-2; 1-2 RET,F,55,1,0,19,29,14,19,7,10,0,0,5,21,29,1,3,23,48,15,23,11,25,3,5,6,26,48
2010-07-19 00:00:00.000,Atlanta GA; USA ATP World Tour 250,HARD,2,Andy Roddick,N/A Bye,Andy Roddick,,R32,0,0,0,0,0,0,0,0,0,0,0,0,0,0,0,0,0,0,0,0,0,0,0,0,0,0,0
2010-07-19 00:00:00.000,Atlanta GA; USA ATP World Tour 250,HARD,2,Rajeev Ram,Karol Beck,Rajeev Ram,6-4; 7-6(4),R32,89,11,2,37,64,26,37,14,27,1,5,11,40,64,2,6,30,65,17,30,17,35,3,8,11,34,65
2010-07-19 00:00:00.000,Atlanta GA; USA ATP World Tour 250,HARD,2,Illya Marchenko,Kristof Vliegen,Illya Marchenko,6-4; 7-6(4),R32,120,1,2,50,77,37,50,14,27,4,6,11,51,77,3,5,44,85,30,44,18,41,7,10,11,48,85
2010-07-19 00:00:00.000,Atlanta GA; USA ATP World Tour 250,HARD,2,Xavier Malisse,Ryan Sweeting,Xavier Malisse,7-6(1); 6-3,R32,76,5,2,21,55,17,21,19,34,3,6,10,36,55,8,5,36,63,23,36,10,27,2,7,11,33,63
2010-07-19 00:00:00.000,Atlanta GA; USA ATP World Tour 250,HARD,2,Horacio Zeballos,N/A Bye,Horacio Zeballos,,R32,0,0,0,0,0,0,0,0,0,0,0,0,0,0,0,0,0,0,0,0,0,0,0,0,0,0,0
2010-07-19 00:00:00.000,Atlanta GA; USA ATP World Tour 250,HARD,2,Taylor Dent,James Blake,Taylor Dent,6-3; 3-6; 6-4,R32,111,8,13,64,111,45,64,24,47,12,14,14,69,111,7,8,43,92,31,43,27,49,6,9,14,58,92
2010-07-19 00:00:00.000,Atlanta GA; USA ATP World Tour 250,HARD,2,Robby Ginepri,Nick Lindahl,Robby Ginepri,7-6(4); 6-2,R32,82,8,1,37,58,26,37,13,21,2,4,10,39,58,8,6,43,78,31,43,12,35,8,12,10,43,78
2010-07-19 00:00:00.000,Atlanta GA; USA ATP World Tour 250,HARD,2,Mardy Fish,James Ward,Mardy Fish,6-1; 6-2,R32,84,9,4,25,53,21,25,14,28,2,3,8,35,53,3,2,33,65,19,33,10,32,7,12,7,29,65
2010-07-19 00:00:00.000,Atlanta GA; USA ATP World Tour 250,HARD,2,Kevin Anderson,Janko Tipsarevic,Kevin Anderson,6-3; 7-5,R32,78,12,8,37,60,29,37,13,23,0,1,11,42,60,8,2,31,56,23,31,13,25,7,10,10,36,56
2010-07-19 00:00:00.000,Atlanta GA; USA ATP World Tour 250,HARD,2,Donald Young,Dudi Sela,Donald Young,7-5; 6-0,R32,66,4,5,32,54,24,32,9,22,6,8,9,33,54,0,5,25,52,10,25,11,27,4,10,9,21,52
2010-07-19 00:00:00.000,Atlanta GA; USA ATP World Tour 250,HARD,2,Lukas Lacko,Igor Kunitsyn,Lukas Lacko,4-6; 7-6(4); 7-6(4),R32,129,10,8,58,110,49,58,25,52,6,9,17,74,110,3,3,63,99,44,63,24,36,0,2,17,68,99
2010-07-19 00:00:00.000,Atlanta GA; USA ATP World Tour 250,HARD,2,Lleyton Hewitt,N/A Bye,Lleyton Hewitt,,R32,0,0,0,0,0,0,0,0,0,0,0,0,0,0,0,0,0,0,0,0,0,0,0,0,0,0,0
2010-07-19 00:00:00.000,Atlanta GA; USA ATP World Tour 250,HARD,2,Michael Russell,Benjamin Becker,Michael Russell,6-3; 6-3,R32,89,3,2,26,53,18,26,16,27,3,5,9,34,53,7,7,28,71,22,28,13,43,4,9,9,35,71
2010-07-19 00:00:00.000,Atlanta GA; USA ATP World Tour 250,HARD,2,Rainer Schuettler,Teymuraz Gabashvili,Rainer Schuettler,6-1; 6-4,R32,84,0,3,37,61,27,37,10,24,6,8,9,37,61,2,10,19,57,13,19,13,38,2,7,8,26,57
2010-07-19 00:00:00.000,Atlanta GA; USA ATP World Tour 250,HARD,2,Gilles Muller,Michal Przysiezny,Gilles Muller,6-4; 4-6; 7-6(4),R32,145,21,5,46,90,42,46,25,44,0,1,16,67,90,6,7,55,112,41,55,32,57,6,7,16,73,112
2010-07-19 00:00:00.000,Atlanta GA; USA ATP World Tour 250,HARD,2,John Isner,N/A Bye,John Isner,,R32,0,0,0,0,0,0,0,0,0,0,0,0,0,0,0,0,0,0,0,0,0,0,0,0,0,0,0
2010-07-19 00:00:00.000,Atlanta GA; USA ATP World Tour 250,HARD,2,Andy Roddick,Rajeev Ram,Andy Roddick,6-1; 6-7(1); 6-3,R16,116,15,2,70,99,50,70,20,29,4,4,15,70,99,12,4,42,80,32,42,21,38,1,4,13,53,80
2010-07-19 00:00:00.000,Atlanta GA; USA ATP World Tour 250,HARD,2,Xavier Malisse,Illya Marchenko,Xavier Malisse,6-3; 6-3,R16,123,5,2,32,71,24,32,17,39,8,10,9,41,71,2,6,35,61,17,35,11,26,5,10,9,28,61
2010-07-19 00:00:00.000,Atlanta GA; USA ATP World Tour 250,HARD,2,Taylor Dent,Horacio Zeballos,Taylor Dent,4-6; 6-2; 6-0,R16,96,4,9,37,82,26,37,29,45,5,6,12,55,82,5,0,46,72,25,46,12,26,5,10,12,37,72
2010-07-19 00:00:00.000,Atlanta GA; USA ATP World Tour 250,HARD,2,Mardy Fish,Robby Ginepri,Mardy Fish,6-1; 7-5,R16,90,9,2,30,64,26,30,20,34,6,6,10,46,64,4,2,31,57,18,31,16,26,1,4,9,34,57
2010-07-19 00:00:00.000,Atlanta GA; USA ATP World Tour 250,HARD,2,Kevin Anderson,Donald Young,Kevin Anderson,7-5; 6-3,R16,84,8,5,40,60,30,40,12,20,0,1,11,42,60,3,2,44,73,28,44,15,29,7,10,10,43,73
2010-07-19 00:00:00.000,Atlanta GA; USA ATP World Tour 250,HARD,2,Lukas Lacko,Lleyton Hewitt,Lukas Lacko,6-4; 6-2,R16,84,7,1,37,55,25,37,10,18,4,6,9,35,55,3,7,27,71,19,27,16,44,5,10,9,35,71
2010-07-19 00:00:00.000,Atlanta GA; USA ATP World Tour 250,HARD,2,Michael Russell,Rainer Schuettler,Michael Russell,1-6; 6-2; 7-5,R16,129,3,2,49,80,29,49,16,31,5,11,13,45,80,7,3,33,76,20,33,18,43,5,12,14,38,76
2010-07-19 00:00:00.000,Atlanta GA; USA ATP World Tour 250,HARD,2,John Isner,Gilles Muller,John Isner,4-6; 7-6(6); 7-6(7),R16,154,33,5,78,120,63,78,23,42,8,9,17,86,120,29,4,75,107,63,75,20,32,2,2,17,83,107
2010-07-19 00:00:00.000,Atlanta GA; USA ATP World Tour 250,HARD,2,Andy Roddick,Xavier Malisse,Andy Roddick,4-6; 6-3; 6-4,Q,130,17,2,63,95,48,63,18,32,5,6,15,66,95,9,2,38,78,32,38,21,40,2,4,14,53,78
2010-07-19 00:00:00.000,Atlanta GA; USA ATP World Tour 250,HARD,2,Mardy Fish,Taylor Dent,Mardy Fish,6-3; 6-0,Q,54,6,1,25,40,22,25,10,15,0,0,8,32,40,2,4,16,36,10,16,8,20,2,6,7,18,36
2010-07-19 00:00:00.000,Atlanta GA; USA ATP World Tour 250,HARD,2,Kevin Anderson,Lukas Lacko,Kevin Anderson,6-3; 6-4,Q,77,10,3,33,55,28,33,14,22,0,0,10,42,55,4,1,24,48,19,24,15,24,0,2,9,34,48
2010-07-19 00:00:00.000,Atlanta GA; USA ATP World Tour 250,HARD,2,John Isner,Michael Russell,John Isner,6-1; 6-2,Q,56,11,2,28,41,25,28,7,13,0,0,8,32,41,0,4,26,41,15,26,5,15,4,8,7,20,41
2010-07-19 00:00:00.000,Atlanta GA; USA ATP World Tour 250,HARD,2,Mardy Fish,Andy Roddick,Mardy Fish,7-6(5); 6-3,S,102,9,3,28,70,27,28,22,42,3,3,11,49,70,8,2,37,59,27,37,13,22,0,1,10,40,59
2010-07-19 00:00:00.000,Atlanta GA; USA ATP World Tour 250,HARD,2,John Isner,Kevin Anderson,John Isner,6-3; 6-7(7); 6-3,S,150,20,6,71,109,55,71,23,38,7,7,16,78,109,14,2,42,76,34,42,24,34,0,2,14,58,76
2010-07-19 00:00:00.000,Atlanta GA; USA ATP World Tour 250,HARD,2,Mardy Fish,John Isner,Mardy Fish,4-6; 6-4; 7-6(4),F,165,9,3,50,95,39,50,27,45,6,8,16,66,95,14,5,59,104,43,59,24,45,3,5,16,67,104
2010-07-19 00:00:00.000,Hamburg Germany ATP World Tour 500,CLAY,2,Nikolay Davydenko,N/A Bye,Nikolay Davydenko,,R64,0,0,0,0,0,0,0,0,0,0,0,0,0,0,0,0,0,0,0,0,0,0,0,0,0,0,0
2010-07-19 00:00:00.000,Hamburg Germany ATP World Tour 500,CLAY,2,Florent Serra,Evgeny Korolev,Florent Serra,7-6(7); 6-3,R64,99,6,0,58,99,38,58,23,41,10,11,11,61,99,8,5,33,64,22,33,18,31,2,4,10,40,64
2010-07-19 00:00:00.000,Hamburg Germany ATP World Tour 500,CLAY,2,Andrey Golubev,Mischa Zverev,Andrey Golubev,7-5; 6-1,R64,73,2,0,30,52,23,30,16,22,1,2,10,39,52,1,2,46,53,27,46,1,7,1,5,9,28,53
2010-07-19 00:00:00.000,Hamburg Germany ATP World Tour 500,CLAY,2,Marcel Granollers,N/A Bye,Marcel Granollers,,R64,0,0,0,0,0,0,0,0,0,0,0,0,0,0,0,0,0,0,0,0,0,0,0,0,0,0,0
2010-07-19 00:00:00.000,Hamburg Germany ATP World Tour 500,CLAY,2,Victor Hanescu,N/A Bye,Victor Hanescu,,R64,0,0,0,0,0,0,0,0,0,0,0,0,0,0,0,0,0,0,0,0,0,0,0,0,0,0,0
2010-07-19 00:00:00.000,Hamburg Germany ATP World Tour 500,CLAY,2,Julian Reister,Daniel Brands,Julian Reister,6-2; 7-6(10),R64,88,5,2,48,66,39,48,12,18,1,2,10,51,66,10,5,43,67,31,43,10,24,4,7,10,41,67
2010-07-19 00:00:00.000,Hamburg Germany ATP World Tour 500,CLAY,2,Denis Istomin,Lukas Rosol,Denis Istomin,3-6; 6-4; 6-3,R64,125,8,3,66,90,48,66,14,24,9,10,14,62,90,6,4,51,112,37,51,32,61,10,12,14,69,112
2010-07-19 00:00:00.000,Hamburg Germany ATP World Tour 500,CLAY,2,Nicolas Almagro,N/A Bye,Nicolas Almagro,,R64,0,0,0,0,0,0,0,0,0,0,0,0,0,0,0,0,0,0,0,0,0,0,0,0,0,0,0
2010-07-19 00:00:00.000,Hamburg Germany ATP World Tour 500,CLAY,2,Albert Ramos,N/A Bye,Albert Ramos,,R64,0,0,0,0,0,0,0,0,0,0,0,0,0,0,0,0,0,0,0,0,0,0,0,0,0,0,0
2010-07-19 00:00:00.000,Hamburg Germany ATP World Tour 500,CLAY,2,Maximo Gonzalez,Olivier Rochus,Maximo Gonzalez,6-4; 5-7; 6-2,R64,145,3,2,64,88,48,64,9,24,8,11,15,57,88,0,4,78,111,47,78,16,33,12,17,15,63,111
2010-07-19 00:00:00.000,Hamburg Germany ATP World Tour 500,CLAY,2,Florian Mayer,Pablo Cuevas,Florian Mayer,6-4; 6-1,R64,70,2,0,32,45,25,32,6,13,1,2,8,31,45,0,3,39,56,20,39,5,17,4,9,9,25,56
2010-07-19 00:00:00.000,Hamburg Germany ATP World Tour 500,CLAY,2,Alexandr Dolgopolov,N/A Bye,Alexandr Dolgopolov,,R64,0,0,0,0,0,0,0,0,0,0,0,0,0,0,0,0,0,0,0,0,0,0,0,0,0,0,0
2010-07-19 00:00:00.000,Hamburg Germany ATP World Tour 500,CLAY,2,Gilles Simon,N/A Bye,Gilles Simon,,R64,0,0,0,0,0,0,0,0,0,0,0,0,0,0,0,0,0,0,0,0,0,0,0,0,0,0,0
2010-07-19 00:00:00.000,Hamburg Germany ATP World Tour 500,CLAY,2,Jarkko Nieminen,Christophe Rochus,Jarkko Nieminen,6-3; 7-6(6),R64,98,12,3,66,86,43,66,11,20,6,8,11,54,86,2,2,50,74,31,50,12,24,9,12,10,43,74
2010-07-19 00:00:00.000,Hamburg Germany ATP World Tour 500,CLAY,2,Jan Hajek,Andreas Beck,Jan Hajek,6-3; 4-6; 7-5,R64,133,6,0,66,94,40,66,16,28,4,8,15,56,94,4,7,50,97,30,50,25,47,3,9,16,55,97
2010-07-19 00:00:00.000,Hamburg Germany ATP World Tour 500,CLAY,2,Juan Carlos Ferrero,N/A Bye,Juan Carlos Ferrero,,R64,0,0,0,0,0,0,0,0,0,0,0,0,0,0,0,0,0,0,0,0,0,0,0,0,0,0,0
2010-07-19 00:00:00.000,Hamburg Germany ATP World Tour 500,CLAY,2,Albert Montanes,N/A Bye,Albert Montanes,,R64,0,0,0,0,0,0,0,0,0,0,0,0,0,0,0,0,0,0,0,0,0,0,0,0,0,0,0
2010-07-19 00:00:00.000,Hamburg Germany ATP World Tour 500,CLAY,2,Pere Riba,Paul-Henri Mathieu,Pere Riba,1-6; 6-0; 6-3,R64,114,3,3,50,74,33,50,11,24,2,5,11,44,74,2,4,36,76,23,36,15,40,6,11,11,38,76
2010-07-19 00:00:00.000,Hamburg Germany ATP World Tour 500,CLAY,2,Potito Starace,Bjorn Phau,Potito Starace,7-5; 6-0,R64,78,1,1,42,54,32,42,6,12,1,2,9,38,54,2,5,27,53,16,27,9,26,4,9,9,25,53
2010-07-19 00:00:00.000,Hamburg Germany ATP World Tour 500,CLAY,2,Tommy Robredo,N/A Bye,Tommy Robredo,,R64,0,0,0,0,0,0,0,0,0,0,0,0,0,0,0,0,0,0,0,0,0,0,0,0,0,0,0
2010-07-19 00:00:00.000,Hamburg Germany ATP World Tour 500,CLAY,2,Philipp Petzschner,N/A Bye,Philipp Petzschner,,R64,0,0,0,0,0,0,0,0,0,0,0,0,0,0,0,0,0,0,0,0,0,0,0,0,0,0,0
2010-07-19 00:00:00.000,Hamburg Germany ATP World Tour 500,CLAY,2,Jeremy Chardy,Marco Chiudinelli,Jeremy Chardy,6-4; 6-1,R64,64,7,3,25,40,22,25,10,15,0,0,8,32,40,0,1,42,63,22,42,12,21,1,5,9,34,63
2010-07-19 00:00:00.000,Hamburg Germany ATP World Tour 500,CLAY,2,Eduardo Schwank,Tobias Kamke,Eduardo Schwank,6-3; 6-4,R64,86,2,0,38,65,23,38,17,27,5,7,10,40,65,2,3,32,55,21,32,10,23,8,12,9,31,55
2010-07-19 00:00:00.000,Hamburg Germany ATP World Tour 500,CLAY,2,Jurgen Melzer,N/A Bye,Jurgen Melzer,,R64,0,0,0,0,0,0,0,0,0,0,0,0,0,0,0,0,0,0,0,0,0,0,0,0,0,0,0
2010-07-19 00:00:00.000,Hamburg Germany ATP World Tour 500,CLAY,2,Thomaz Bellucci,N/A Bye,Thomaz Bellucci,,R64,0,0,0,0,0,0,0,0,0,0,0,0,0,0,0,0,0,0,0,0,0,0,0,0,0,0,0
2010-07-19 00:00:00.000,Hamburg Germany ATP World Tour 500,CLAY,2,Simone Bolelli,Simon Greul,Simone Bolelli,7-6(4); 7-6(4),R64,119,9,1,58,80,46,58,11,22,3,4,12,57,80,3,1,55,79,43,55,12,24,0,1,12,55,79
2010-07-19 00:00:00.000,Hamburg Germany ATP World Tour 500,CLAY,2,Juan Ignacio Chela,Sergiy Stakhovsky,Juan Ignacio Chela,6-2; 6-3,R64,62,1,0,33,39,28,33,4,6,0,0,8,32,39,0,3,38,58,20,38,10,20,4,8,9,30,58
2010-07-19 00:00:00.000,Hamburg Germany ATP World Tour 500,CLAY,2,Philipp Kohlschreiber,N/A Bye,Philipp Kohlschreiber,,R64,0,0,0,0,0,0,0,0,0,0,0,0,0,0,0,0,0,0,0,0,0,0,0,0,0,0,0
2010-07-19 00:00:00.000,Hamburg Germany ATP World Tour 500,CLAY,2,Michael Berrer,N/A Bye,Michael Berrer,,R64,0,0,0,0,0,0,0,0,0,0,0,0,0,0,0,0,0,0,0,0,0,0,0,0,0,0,0
2010-07-19 00:00:00.000,Hamburg Germany ATP World Tour 500,CLAY,2,Andreas Seppi,Stephane Robert,Andreas Seppi,6-4; 6-3,R64,65,7,2,34,49,27,34,7,15,2,3,9,34,49,3,1,30,54,19,30,12,24,3,7,10,31,54
2010-07-19 00:00:00.000,Hamburg Germany ATP World Tour 500,CLAY,2,Fabio Fognini,Ruben Ramirez Hidalgo,Fabio Fognini,7-6(4); 6-4,R64,113,4,6,51,83,35,51,15,32,5,8,11,50,83,5,3,48,81,34,48,12,33,3,7,11,46,81
2010-07-19 00:00:00.000,Hamburg Germany ATP World Tour 500,CLAY,2,Marc Gicquel,N/A Bye,Marc Gicquel,,R64,0,0,0,0,0,0,0,0,0,0,0,0,0,0,0,0,0,0,0,0,0,0,0,0,0,0,0
2010-07-19 00:00:00.000,Hamburg Germany ATP World Tour 500,CLAY,2,Nikolay Davydenko,Florent Serra,Nikolay Davydenko,6-3; 6-1,R32,57,1,3,30,41,24,30,8,11,0,0,8,32,41,2,0,34,50,18,34,8,16,3,7,8,26,50
2010-07-19 00:00:00.000,Hamburg Germany ATP World Tour 500,CLAY,2,Andrey Golubev,Marcel Granollers,Andrey Golubev,6-4; 7-5,R32,96,4,1,44,70,32,44,15,26,9,10,11,47,70,0,1,49,65,32,49,9,16,5,8,11,41,65
2010-07-19 00:00:00.000,Hamburg Germany ATP World Tour 500,CLAY,2,Julian Reister,Victor Hanescu,Julian Reister,7-6(4); 6-4,R32,99,4,1,45,64,34,45,10,19,2,4,11,44,64,4,0,53,77,37,53,9,24,1,4,11,46,77
2010-07-19 00:00:00.000,Hamburg Germany ATP World Tour 500,CLAY,2,Denis Istomin,Nicolas Almagro,Denis Istomin,7-6(5); 7-6(7),R32,119,9,2,62,95,51,62,15,33,4,5,12,66,95,10,2,54,81,38,54,19,27,1,2,12,57,81
2010-07-19 00:00:00.000,Hamburg Germany ATP World Tour 500,CLAY,2,Maximo Gonzalez,Albert Ramos,Maximo Gonzalez,7-6(5); 6-7(3); 6-2,R32,188,2,2,90,116,60,90,8,26,6,10,16,68,116,6,5,70,129,49,70,22,59,10,16,16,71,129
2010-07-19 00:00:00.000,Hamburg Germany ATP World Tour 500,CLAY,2,Florian Mayer,Alexandr Dolgopolov,Florian Mayer,4-6; 7-6(2); 6-3,R32,110,5,0,62,83,44,62,12,21,2,5,15,56,83,6,2,48,93,36,48,23,45,6,10,16,59,93
2010-07-19 00:00:00.000,Hamburg Germany ATP World Tour 500,CLAY,2,Jarkko Nieminen,Gilles Simon,Jarkko Nieminen,6-4; 3-6; 7-5,R32,126,5,1,68,95,43,68,17,27,8,11,15,60,95,5,2,46,88,34,46,24,42,3,7,16,58,88
2010-07-19 00:00:00.000,Hamburg Germany ATP World Tour 500,CLAY,2,Juan Carlos Ferrero,Jan Hajek,Juan Carlos Ferrero,7-6(4); 6-1,R32,75,4,0,41,59,32,41,11,18,1,2,10,43,59,3,1,42,61,26,42,10,19,5,8,9,36,61
2010-07-19 00:00:00.000,Hamburg Germany ATP World Tour 500,CLAY,2,Pere Riba,Albert Montanes,Pere Riba,6-4; 5-7; 7-6(4),R32,152,7,2,56,100,36,56,27,44,5,9,17,63,100,9,3,77,110,49,77,17,33,5,9,17,66,110
2010-07-19 00:00:00.000,Hamburg Germany ATP World Tour 500,CLAY,2,Potito Starace,Tommy Robredo,Potito Starace,7-6(10); 5-7; 6-1,R32,132,3,2,76,92,56,76,7,16,1,4,16,63,92,5,0,71,98,49,71,12,27,2,6,15,61,98
2010-07-19 00:00:00.000,Hamburg Germany ATP World Tour 500,CLAY,2,Jeremy Chardy,Philipp Petzschner,Jeremy Chardy,6-3; 6-3,R32,70,6,0,31,48,25,31,11,17,0,0,9,36,48,4,4,30,65,22,30,15,35,5,8,9,37,65
2010-07-19 00:00:00.000,Hamburg Germany ATP World Tour 500,CLAY,2,Jurgen Melzer,Eduardo Schwank,Jurgen Melzer,6-4; 6-1,R32,56,7,2,18,40,17,18,13,22,0,1,8,30,40,0,3,24,41,11,24,9,17,1,6,9,20,41
2010-07-19 00:00:00.000,Hamburg Germany ATP World Tour 500,CLAY,2,Thomaz Bellucci,Simone Bolelli,Thomaz Bellucci,6-1; 3-6; 6-3,R32,117,5,1,43,76,38,43,16,33,3,5,13,54,76,1,1,47,73,34,47,9,26,3,7,12,43,73
2010-07-19 00:00:00.000,Hamburg Germany ATP World Tour 500,CLAY,2,Philipp Kohlschreiber,Juan Ignacio Chela,Philipp Kohlschreiber,2-6; 6-2; 6-4,R32,116,5,1,58,84,39,58,14,26,8,10,13,53,84,1,1,58,84,38,58,12,26,4,7,13,50,84
2010-07-19 00:00:00.000,Hamburg Germany ATP World Tour 500,CLAY,2,Andreas Seppi,Michael Berrer,Andreas Seppi,6-2; 7-6(4),R32,94,2,1,36,55,31,36,15,19,0,0,10,46,55,7,1,56,70,37,56,7,14,1,3,10,44,70
2010-07-19 00:00:00.000,Hamburg Germany ATP World Tour 500,CLAY,2,Fabio Fognini,Marc Gicquel,Fabio Fognini,6-4; 6-4,R32,89,2,1,44,68,26,44,12,24,6,9,10,38,68,3,1,30,63,17,30,15,33,8,13,10,32,63
2010-07-19 00:00:00.000,Hamburg Germany ATP World Tour 500,CLAY,2,Andrey Golubev,Nikolay Davydenko,Andrey Golubev,6-4; 6-4,R16,89,3,1,48,68,35,48,10,20,3,4,10,45,68,0,1,51,66,28,51,9,15,4,7,10,37,66
2010-07-19 00:00:00.000,Hamburg Germany ATP World Tour 500,CLAY,2,Denis Istomin,Julian Reister,Denis Istomin,3-6; 6-3; 7-6(3),R16,129,11,0,72,96,53,72,12,24,8,10,15,65,96,1,1,68,95,46,68,15,27,6,8,15,61,95
2010-07-19 00:00:00.000,Hamburg Germany ATP World Tour 500,CLAY,2,Florian Mayer,Maximo Gonzalez,Florian Mayer,7-6(1); 6-0,R16,88,2,0,38,58,28,38,11,20,4,5,9,39,58,0,1,37,59,20,37,9,22,7,11,9,29,59
2010-07-19 00:00:00.000,Hamburg Germany ATP World Tour 500,CLAY,2,Juan Carlos Ferrero,Jarkko Nieminen,Juan Carlos Ferrero,6-2; 3-6; 6-4,R16,106,3,0,48,71,37,48,14,23,0,1,13,51,71,4,3,52,84,41,52,12,32,5,8,14,53,84
2010-07-19 00:00:00.000,Hamburg Germany ATP World Tour 500,CLAY,2,Potito Starace,Pere Riba,Potito Starace,4-6; 6-4; 6-4,R16,126,1,0,65,75,45,65,9,10,4,7,15,54,75,1,2,63,99,37,63,20,36,9,13,15,57,99
2010-07-19 00:00:00.000,Hamburg Germany ATP World Tour 500,CLAY,2,Jurgen Melzer,Jeremy Chardy,Jurgen Melzer,7-5; 7-6(4),R16,115,7,0,47,78,32,47,21,31,6,8,12,53,78,10,2,53,95,36,53,22,42,11,14,12,58,95
2010-07-19 00:00:00.000,Hamburg Germany ATP World Tour 500,CLAY,2,Thomaz Bellucci,Philipp Kohlschreiber,Thomaz Bellucci,7-5; 6-4,R16,112,8,4,42,74,29,42,15,32,2,4,11,44,74,7,0,46,70,29,46,10,24,8,12,11,39,70
2010-07-19 00:00:00.000,Hamburg Germany ATP World Tour 500,CLAY,2,Andreas Seppi,Fabio Fognini,Andreas Seppi,6-4; 6-4,R16,91,4,3,40,70,29,40,14,30,7,9,10,43,70,4,8,29,69,18,29,19,40,5,9,10,37,69
2010-07-19 00:00:00.000,Hamburg Germany ATP World Tour 500,CLAY,2,Andrey Golubev,Denis Istomin,Andrey Golubev,6-4; 6-1,Q,71,4,0,33,43,25,33,6,10,5,6,8,31,43,2,1,48,68,26,48,9,20,8,13,9,35,68
2010-07-19 00:00:00.000,Hamburg Germany ATP World Tour 500,CLAY,2,Florian Mayer,Juan Carlos Ferrero,Florian Mayer,6-7(3); 6-2; 6-3,Q,152,7,1,62,95,44,62,19,33,2,3,14,63,95,3,0,87,115,53,87,13,28,14,19,15,66,115
2010-07-19 00:00:00.000,Hamburg Germany ATP World Tour 500,CLAY,2,Jurgen Melzer,Potito Starace,Jurgen Melzer,6-4; 6-1,Q,68,8,2,29,40,22,29,8,11,0,1,8,30,40,2,1,55,74,30,55,6,19,8,13,9,36,74
2010-07-19 00:00:00.000,Hamburg Germany ATP World Tour 500,CLAY,2,Andreas Seppi,Thomaz Bellucci,Andreas Seppi,7-6(0); 5-7; 7-5,Q,192,3,3,71,129,50,71,32,58,5,8,18,82,129,10,2,61,113,43,61,24,52,3,6,18,67,113
2010-07-19 00:00:00.000,Hamburg Germany ATP World Tour 500,CLAY,2,Andrey Golubev,Florian Mayer,Andrey Golubev,7-6(6); 6-4,S,102,2,4,43,74,33,43,17,31,3,4,11,50,74,3,1,53,78,38,53,12,25,7,9,11,50,78
2010-07-19 00:00:00.000,Hamburg Germany ATP World Tour 500,CLAY,2,Jurgen Melzer,Andreas Seppi,Jurgen Melzer,6-4; 6-2,S,80,5,1,38,64,24,38,19,26,5,5,9,43,64,2,0,29,50,19,29,11,21,2,5,9,30,50
2010-07-19 00:00:00.000,Hamburg Germany ATP World Tour 500,CLAY,2,Andrey Golubev,Jurgen Melzer,Andrey Golubev,6-3; 7-5,F,90,7,3,45,76,35,45,18,31,5,5,11,53,76,4,0,36,53,28,36,8,17,2,4,10,36,53
2010-07-25 00:00:00.000,Gstaad Switzerland ATP World Tour 250,CLAY,2,Mikhail Youzhny,Marc Gicquel,Mikhail Youzhny,6-2; 6-2,R32,73,5,3,30,56,25,30,11,26,4,5,8,36,56,4,4,29,55,14,29,12,26,4,9,8,26,55
2010-07-25 00:00:00.000,Gstaad Switzerland ATP World Tour 250,CLAY,2,Alexander Sadecky,Yann Marti,Alexander Sadecky,7-5; 1-6; 6-0,R32,117,3,6,39,75,30,39,18,36,1,4,13,48,75,1,7,35,86,23,35,23,51,4,8,12,46,86
2010-07-25 00:00:00.000,Gstaad Switzerland ATP World Tour 250,CLAY,2,Yuri Schukin,Andrey Golubev,Yuri Schukin,7-6(4); 2-6; 6-3,R32,123,1,3,43,80,32,43,23,37,2,5,14,55,80,5,7,70,117,44,70,26,47,8,11,15,70,117
2010-07-25 00:00:00.000,Gstaad Switzerland ATP World Tour 250,CLAY,2,Frederico Gil,Tommy Robredo,Frederico Gil,4-6; 7-5; 6-1,R32,135,0,2,71,95,46,71,17,24,5,7,15,63,95,3,2,59,95,39,59,17,36,7,11,14,56,95
2010-07-25 00:00:00.000,Gstaad Switzerland ATP World Tour 250,CLAY,2,Albert Montanes,Pere Riba,Albert Montanes,4-6; 6-3; 7-6(5),R32,135,3,3,67,107,44,67,22,40,7,12,15,66,107,4,9,48,104,36,48,22,56,5,11,16,58,104
2010-07-25 00:00:00.000,Gstaad Switzerland ATP World Tour 250,CLAY,2,Andreas Haider-Maurer,Denis Istomin,Andreas Haider-Maurer,6-3; 6-7(5); 6-4,R32,141,8,1,63,110,47,63,23,47,6,8,16,70,110,11,6,73,109,48,73,17,36,7,11,15,65,109
2010-07-25 00:00:00.000,Gstaad Switzerland ATP World Tour 250,CLAY,2,Daniel Brands,Peter Luczak,Daniel Brands,6-4; 7-5,R32,87,15,2,45,65,34,45,15,20,2,2,11,49,65,2,1,46,71,33,46,12,25,9,11,11,45,71
2010-07-25 00:00:00.000,Gstaad Switzerland ATP World Tour 250,CLAY,2,Richard Gasquet,Farrukh Dustov,Richard Gasquet,6-3; 6-4,R32,78,2,1,29,49,21,29,19,20,0,0,10,40,49,3,0,49,64,34,49,5,15,5,7,9,39,64
2010-07-25 00:00:00.000,Gstaad Switzerland ATP World Tour 250,CLAY,2,Daniel Gimeno-Traver,Victor Hanescu,Daniel Gimeno-Traver,6-4; 6-4,R32,75,8,1,28,48,27,28,14,20,3,3,10,41,48,3,3,50,72,36,50,7,22,4,6,10,43,72
2010-07-25 00:00:00.000,Gstaad Switzerland ATP World Tour 250,CLAY,2,Andreas Beck,Agustin Velotti,Andreas Beck,6-3; 6-1,R32,70,4,4,24,44,21,24,12,20,0,0,8,33,44,4,1,32,63,18,32,14,31,7,11,8,32,63
2010-07-25 00:00:00.000,Gstaad Switzerland ATP World Tour 250,CLAY,2,Igor Andreev,Florent Serra,Igor Andreev,6-4; 2-6; 6-4,R32,104,7,3,53,87,35,53,19,34,7,10,14,54,87,3,1,50,86,33,50,21,36,4,7,14,54,86
2010-07-25 00:00:00.000,Gstaad Switzerland ATP World Tour 250,CLAY,2,Marco Chiudinelli,Thomaz Bellucci,Marco Chiudinelli,7-6(6); 0-6; 6-4,R32,136,2,6,54,86,38,54,18,32,4,7,14,56,86,7,6,50,102,37,50,29,52,6,7,14,66,102
2010-07-25 00:00:00.000,Gstaad Switzerland ATP World Tour 250,CLAY,2,Jeremy Chardy,Paul-Henri Mathieu,Jeremy Chardy,6-1; 6-3,R32,83,10,5,28,61,23,28,19,33,4,4,8,42,61,2,3,24,57,12,24,15,33,6,10,8,27,57
2010-07-25 00:00:00.000,Gstaad Switzerland ATP World Tour 250,CLAY,2,Jarkko Nieminen,Thiago Alves,Jarkko Nieminen,6-4; 4-6; 6-3,R32,127,8,7,60,94,38,60,16,34,3,8,15,54,94,2,2,65,97,37,65,14,32,9,15,14,51,97
2010-07-25 00:00:00.000,Gstaad Switzerland ATP World Tour 250,CLAY,2,Michael Lammer,Dustin Brown,Michael Lammer,7-5; 7-5,R32,85,3,0,40,62,31,40,16,22,2,3,12,47,62,12,2,37,73,26,37,18,36,4,7,12,44,73
2010-07-25 00:00:00.000,Gstaad Switzerland ATP World Tour 250,CLAY,2,Nicolas Almagro,Marcel Granollers,Nicolas Almagro,7-6(5); 3-6; 6-3,R32,134,8,9,54,97,42,54,25,43,4,6,15,67,97,5,4,63,107,43,63,26,44,5,7,15,69,107
2010-07-25 00:00:00.000,Gstaad Switzerland ATP World Tour 250,CLAY,2,Mikhail Youzhny,Alexander Sadecky,Mikhail Youzhny,7-5; 6-4,R16,83,7,5,46,74,34,46,15,28,1,2,11,49,74,3,2,36,58,26,36,11,22,1,4,11,37,58
2010-07-25 00:00:00.000,Gstaad Switzerland ATP World Tour 250,CLAY,2,Yuri Schukin,Frederico Gil,Yuri Schukin,6-3; 6-3,R16,93,2,4,31,64,17,31,18,33,6,9,9,35,64,1,3,53,74,23,53,10,21,7,13,9,33,74
2010-07-25 00:00:00.000,Gstaad Switzerland ATP World Tour 250,CLAY,2,Albert Montanes,Andreas Haider-Maurer,Albert Montanes,3-6; 6-1; 6-0,R16,82,2,1,42,66,33,42,14,24,5,6,11,47,66,5,4,34,62,22,34,10,28,3,8,11,32,62
2010-07-25 00:00:00.000,Gstaad Switzerland ATP World Tour 250,CLAY,2,Richard Gasquet,Daniel Brands,Richard Gasquet,6-7(5); 6-3; 6-0,R16,96,9,2,46,77,38,46,21,31,1,1,13,59,77,7,8,49,85,33,49,16,36,7,12,14,49,85
2010-07-25 00:00:00.000,Gstaad Switzerland ATP World Tour 250,CLAY,2,Daniel Gimeno-Traver,Andreas Beck,Daniel Gimeno-Traver,7-5; 6-4,R16,90,8,1,35,58,25,35,17,23,1,2,11,42,58,1,4,45,73,30,45,14,28,3,6,11,44,73
2010-07-25 00:00:00.000,Gstaad Switzerland ATP World Tour 250,CLAY,2,Igor Andreev,Marco Chiudinelli,Igor Andreev,6-3; 6-7(6); 7-6(6),R16,149,16,3,65,116,51,65,27,51,9,12,17,78,116,2,2,70,105,46,70,19,35,4,8,16,65,105
2010-07-25 00:00:00.000,Gstaad Switzerland ATP World Tour 250,CLAY,2,Jeremy Chardy,Jarkko Nieminen,Jeremy Chardy,7-5; 6-2,R16,82,8,3,39,70,29,39,15,31,2,4,10,44,70,2,4,45,80,26,45,13,35,6,11,10,39,80
2010-07-25 00:00:00.000,Gstaad Switzerland ATP World Tour 250,CLAY,2,Nicolas Almagro,Michael Lammer,Nicolas Almagro,3-6; 6-3; 6-2,R16,105,6,4,48,74,28,48,14,26,2,7,13,42,74,2,1,56,88,32,56,10,32,5,12,13,42,88
2010-07-25 00:00:00.000,Gstaad Switzerland ATP World Tour 250,CLAY,2,Yuri Schukin,Mikhail Youzhny,Yuri Schukin,6-4; 2-6; 7-5,Q,133,3,4,66,94,46,66,13,28,4,7,15,59,94,9,2,73,99,48,73,13,26,9,12,15,61,99
2010-07-25 00:00:00.000,Gstaad Switzerland ATP World Tour 250,CLAY,2,Richard Gasquet,Albert Montanes,Richard Gasquet,7-6(5); 6-4,Q,99,9,3,37,74,27,37,22,37,2,3,11,49,74,2,3,45,83,32,45,20,38,7,9,11,52,83
2010-07-25 00:00:00.000,Gstaad Switzerland ATP World Tour 250,CLAY,2,Daniel Gimeno-Traver,Igor Andreev,Daniel Gimeno-Traver,6-2; 6-4,Q,72,1,2,31,52,24,31,12,21,4,5,9,36,52,2,2,39,56,23,39,7,17,5,9,9,30,56
2010-07-25 00:00:00.000,Gstaad Switzerland ATP World Tour 250,CLAY,2,Nicolas Almagro,Jeremy Chardy,Nicolas Almagro,6-2; 7-6(5),Q,82,3,2,40,67,30,40,13,27,7,9,10,43,67,2,5,44,72,29,44,10,28,6,10,10,39,72
2010-07-25 00:00:00.000,Gstaad Switzerland ATP World Tour 250,CLAY,2,Richard Gasquet,Yuri Schukin,Richard Gasquet,6-3; 6-4,S,89,6,6,42,72,33,42,16,30,2,2,10,49,72,2,1,32,57,25,32,12,25,4,6,9,37,57
2010-07-25 00:00:00.000,Gstaad Switzerland ATP World Tour 250,CLAY,2,Nicolas Almagro,Daniel Gimeno-Traver,Nicolas Almagro,7-6(7); 3-6; 6-3,S,121,3,3,52,87,46,52,21,35,1,2,15,67,87,7,4,66,105,52,66,19,39,5,6,15,71,105
2010-07-25 00:00:00.000,Gstaad Switzerland ATP World Tour 250,CLAY,2,Nicolas Almagro,Richard Gasquet,Nicolas Almagro,7-5; 6-1,F,75,17,3,31,48,27,31,8,17,2,3,9,35,48,1,3,66,83,37,66,6,17,13,18,10,43,83
2010-07-26 00:00:00.000,Los Angeles CA; U.S.A. ATP World Tour 250,HARD,2,Andy Murray,N/A Bye,Andy Murray,,R32,0,0,0,0,0,0,0,0,0,0,0,0,0,0,0,0,0,0,0,0,0,0,0,0,0,0,0
2010-07-26 00:00:00.000,Los Angeles CA; U.S.A. ATP World Tour 250,HARD,2,Tim Smyczek,Teymuraz Gabashvili,Tim Smyczek,6-2; 6-3,R32,71,1,0,33,51,23,33,13,18,4,5,9,36,51,1,6,30,59,21,30,9,29,3,7,8,30,59
2010-07-26 00:00:00.000,Los Angeles CA; U.S.A. ATP World Tour 250,HARD,2,Alejandro Falla,Karol Beck,Alejandro Falla,7-6(3); 6-4,R32,114,6,5,43,94,29,43,27,51,11,13,11,56,94,0,7,38,76,25,38,20,38,7,10,11,45,76
2010-07-26 00:00:00.000,Los Angeles CA; U.S.A. ATP World Tour 250,HARD,2,Ernests Gulbis,Lukas Lacko,Ernests Gulbis,7-5; 7-5,R32,102,11,3,51,77,39,51,13,26,5,6,12,52,77,2,2,42,74,30,42,17,32,4,7,12,47,74
2010-07-26 00:00:00.000,Los Angeles CA; U.S.A. ATP World Tour 250,HARD,2,Feliciano Lopez,N/A Bye,Feliciano Lopez,,R32,0,0,0,0,0,0,0,0,0,0,0,0,0,0,0,0,0,0,0,0,0,0,0,0,0,0,0
2010-07-26 00:00:00.000,Los Angeles CA; U.S.A. ATP World Tour 250,HARD,2,Dudi Sela,Xavier Malisse,Dudi Sela,6-1; 4-6; 6-3,R32,108,3,4,41,84,27,41,24,43,3,6,13,51,84,6,3,50,82,33,50,11,32,5,11,13,44,82
2010-07-26 00:00:00.000,Los Angeles CA; U.S.A. ATP World Tour 250,HARD,2,James Blake,Leonardo Mayer,James Blake,6-1; 6-4,R32,64,7,0,32,54,27,32,14,22,5,5,9,41,54,1,3,30,53,19,30,11,23,7,10,8,30,53
2010-07-26 00:00:00.000,Los Angeles CA; U.S.A. ATP World Tour 250,HARD,2,Benjamin Becker,Giovanni Lapentti,Benjamin Becker,7-5; 7-6(6),R32,114,5,5,44,78,40,44,14,34,2,4,12,54,78,4,5,56,86,37,56,15,30,3,6,12,52,86
2010-07-26 00:00:00.000,Los Angeles CA; U.S.A. ATP World Tour 250,HARD,2,Janko Tipsarevic,Santiago Giraldo,Janko Tipsarevic,6-1; 6-0,R32,51,7,2,24,46,21,24,11,22,2,2,7,32,46,4,0,19,34,8,19,2,15,3,8,6,10,34
2010-07-26 00:00:00.000,Los Angeles CA; U.S.A. ATP World Tour 250,HARD,2,Somdev Devvarman,Steve Johnson,Somdev Devvarman,6-4; 6-4,R32,94,7,2,45,71,35,45,12,26,4,5,10,47,71,2,5,34,70,24,34,16,36,9,12,10,40,70
2010-07-26 00:00:00.000,Los Angeles CA; U.S.A. ATP World Tour 250,HARD,2,Ryan Sweeting,Kristof Vliegen,Ryan Sweeting,2-6; 6-3; 6-4,R32,125,0,3,70,94,37,70,13,24,2,8,13,50,94,3,3,45,86,27,45,16,41,3,10,14,43,86
2010-07-26 00:00:00.000,Los Angeles CA; U.S.A. ATP World Tour 250,HARD,2,Marcos Baghdatis,N/A Bye,Marcos Baghdatis,,R32,0,0,0,0,0,0,0,0,0,0,0,0,0,0,0,0,0,0,0,0,0,0,0,0,0,0,0
2010-07-26 00:00:00.000,Los Angeles CA; U.S.A. ATP World Tour 250,HARD,2,Rainer Schuettler,Horacio Zeballos,Rainer Schuettler,6-3; 3-0 RET,R32,48,8,0,22,32,18,22,5,10,0,1,6,23,32,0,3,30,49,17,30,6,19,6,10,6,23,49
2010-07-26 00:00:00.000,Los Angeles CA; U.S.A. ATP World Tour 250,HARD,2,Robby Ginepri,Ilija Bozoljac,Robby Ginepri,6-3; 6-4,R32,68,2,1,40,54,31,40,11,14,1,1,10,42,54,5,2,23,48,17,23,15,25,3,5,9,32,48
2010-07-26 00:00:00.000,Los Angeles CA; U.S.A. ATP World Tour 250,HARD,2,Kevin Anderson,Illya Marchenko,Kevin Anderson,6-3; 6-2,R32,92,5,5,41,70,31,41,13,29,5,6,9,44,70,1,3,28,54,18,28,10,26,4,8,8,28,54
2010-07-26 00:00:00.000,Los Angeles CA; U.S.A. ATP World Tour 250,HARD,2,Sam Querrey,N/A Bye,Sam Querrey,,R32,0,0,0,0,0,0,0,0,0,0,0,0,0,0,0,0,0,0,0,0,0,0,0,0,0,0,0
2010-07-26 00:00:00.000,Los Angeles CA; U.S.A. ATP World Tour 250,HARD,2,Andy Murray,Tim Smyczek,Andy Murray,6-1; 4-6; 6-2,R16,115,3,0,39,71,31,39,15,32,3,7,13,46,71,2,3,75,106,41,75,10,31,11,18,12,51,106
2010-07-26 00:00:00.000,Los Angeles CA; U.S.A. ATP World Tour 250,HARD,2,Alejandro Falla,Ernests Gulbis,Alejandro Falla,4-6; 6-3; 7-6(8),R16,136,2,5,67,109,49,67,20,42,6,10,16,69,109,6,4,43,86,32,43,23,43,1,5,15,55,86
2010-07-26 00:00:00.000,Los Angeles CA; U.S.A. ATP World Tour 250,HARD,2,Feliciano Lopez,Dudi Sela,Feliciano Lopez,7-6(2); 6-4,R16,98,12,2,45,73,35,45,17,28,1,1,11,52,73,2,1,34,69,22,34,25,35,5,6,11,47,69
2010-07-26 00:00:00.000,Los Angeles CA; U.S.A. ATP World Tour 250,HARD,2,James Blake,Benjamin Becker,James Blake,7-5; 7-6(5),R16,98,6,5,45,77,36,45,17,32,2,3,12,53,77,9,4,38,92,29,38,24,54,6,8,12,53,92
2010-07-26 00:00:00.000,Los Angeles CA; U.S.A. ATP World Tour 250,HARD,2,Janko Tipsarevic,Somdev Devvarman,Janko Tipsarevic,7-6(9); 6-2,R16,134,4,2,39,76,26,39,19,37,3,6,10,45,76,8,4,50,89,33,50,13,39,8,13,10,46,89
2010-07-26 00:00:00.000,Los Angeles CA; U.S.A. ATP World Tour 250,HARD,2,Marcos Baghdatis,Ryan Sweeting,Marcos Baghdatis,3-6; 6-2; 6-3,R16,111,11,5,53,92,39,53,16,39,6,9,13,55,92,3,2,64,75,39,64,6,11,5,10,13,45,75
2010-07-26 00:00:00.000,Los Angeles CA; U.S.A. ATP World Tour 250,HARD,2,Rainer Schuettler,Robby Ginepri,Rainer Schuettler,6-3; 3-6; 6-4,R16,125,1,5,48,91,36,48,24,43,9,11,14,60,91,3,4,54,86,35,54,18,32,4,7,14,53,86
2010-07-26 00:00:00.000,Los Angeles CA; U.S.A. ATP World Tour 250,HARD,2,Sam Querrey,Kevin Anderson,Sam Querrey,7-6(8); 4-6; 6-0,R16,134,11,6,63,113,43,63,22,50,12,16,14,65,113,9,12,58,101,41,58,11,43,7,13,14,52,101
2010-07-26 00:00:00.000,Los Angeles CA; U.S.A. ATP World Tour 250,HARD,2,Andy Murray,Alejandro Falla,Andy Murray,7-6(3); 6-1,Q,97,5,2,33,78,25,33,23,45,7,9,10,48,78,1,6,29,65,19,29,15,36,5,9,9,34,65
2010-07-26 00:00:00.000,Los Angeles CA; U.S.A. ATP World Tour 250,HARD,2,Feliciano Lopez,James Blake,Feliciano Lopez,3-6; 7-6(6); 6-4,Q,117,18,4,55,104,43,55,27,49,6,8,15,70,104,7,5,49,87,38,49,24,38,0,2,16,62,87
2010-07-26 00:00:00.000,Los Angeles CA; U.S.A. ATP World Tour 250,HARD,2,Janko Tipsarevic,Marcos Baghdatis,Janko Tipsarevic,6-3; 7-5,Q,100,7,1,40,70,31,40,15,30,1,2,11,46,70,3,5,31,62,22,31,15,31,6,9,10,37,62
2010-07-26 00:00:00.000,Los Angeles CA; U.S.A. ATP World Tour 250,HARD,2,Sam Querrey,Rainer Schuettler,Sam Querrey,6-2; 3-6; 7-6(4),Q,141,14,9,63,112,46,63,19,49,11,16,14,65,112,4,3,68,107,38,68,18,39,3,9,15,56,107
2010-07-26 00:00:00.000,Los Angeles CA; U.S.A. ATP World Tour 250,HARD,2,Andy Murray,Feliciano Lopez,Andy Murray,6-0; 1-6; 6-4,S,98,7,0,45,69,28,45,13,24,3,6,12,41,69,5,2,25,63,19,25,17,38,4,8,11,36,63
2010-07-26 00:00:00.000,Los Angeles CA; U.S.A. ATP World Tour 250,HARD,2,Sam Querrey,Janko Tipsarevic,Sam Querrey,6-7(3); 7-6(5); 6-4,S,167,19,6,69,119,55,69,26,50,11,12,17,81,119,5,3,57,116,43,57,34,59,10,12,17,77,116
2010-07-26 00:00:00.000,Los Angeles CA; U.S.A. ATP World Tour 250,HARD,2,Sam Querrey,Andy Murray,Sam Querrey,5-7; 7-6(2); 6-3,F,142,9,4,68,115,52,68,22,47,6,8,17,74,115,7,3,64,96,48,64,14,32,3,5,16,62,96
2010-07-26 00:00:00.000,Umag Croatia ATP World Tour 250,CLAY,2,Nikolay Davydenko,N/A Bye,Nikolay Davydenko,,R32,0,0,0,0,0,0,0,0,0,0,0,0,0,0,0,0,0,0,0,0,0,0,0,0,0,0,0
2010-07-26 00:00:00.000,Umag Croatia ATP World Tour 250,CLAY,2,Stephane Robert,Olivier Patience,Stephane Robert,6-3; 6-2,R32,64,3,3,31,56,19,31,13,25,2,4,8,32,56,2,1,27,49,15,27,3,22,1,7,9,18,49
2010-07-26 00:00:00.000,Umag Croatia ATP World Tour 250,CLAY,2,Simone Bolelli,Antonio Veic,Simone Bolelli,7-6(3); 6-3,R32,115,4,0,56,71,39,56,7,15,4,6,11,46,71,0,3,50,78,31,50,13,28,4,7,10,44,78
2010-07-26 00:00:00.000,Umag Croatia ATP World Tour 250,CLAY,2,Juan Ignacio Chela,Ruben Ramirez Hidalgo,Juan Ignacio Chela,6-4; 6-1,R32,94,2,0,22,43,16,22,17,21,1,1,8,33,43,0,0,46,73,27,46,11,27,5,9,9,38,73
2010-07-26 00:00:00.000,Umag Croatia ATP World Tour 250,CLAY,2,Ivan Ljubicic,N/A Bye,Ivan Ljubicic,,R32,0,0,0,0,0,0,0,0,0,0,0,0,0,0,0,0,0,0,0,0,0,0,0,0,0,0,0
2010-07-26 00:00:00.000,Umag Croatia ATP World Tour 250,CLAY,2,Ivan Dodig,Ivan Navarro,Ivan Dodig,6-3; 6-4,R32,99,5,3,30,60,24,30,17,30,3,5,10,41,60,5,1,40,66,21,40,12,26,3,7,9,33,66
2010-07-26 00:00:00.000,Umag Croatia ATP World Tour 250,CLAY,2,Bjorn Phau,Fabio Fognini,Bjorn Phau,6-1; 6-4,R32,67,1,0,34,49,26,34,6,15,1,2,8,32,49,0,2,32,55,17,32,9,23,5,10,9,26,55
2010-07-26 00:00:00.000,Umag Croatia ATP World Tour 250,CLAY,2,Potito Starace,Sergiy Stakhovsky,Potito Starace,6-3; 6-7(5); 6-0,R32,116,3,0,59,74,43,59,9,15,3,4,13,52,74,1,4,60,101,39,60,15,41,8,14,14,54,101
2010-07-26 00:00:00.000,Umag Croatia ATP World Tour 250,CLAY,2,Alexandr Dolgopolov,Paolo Lorenzi,Alexandr Dolgopolov,6-3; 6-7(6); 7-6(3),R32,156,7,2,57,135,38,57,42,78,10,14,17,80,135,3,3,74,111,44,74,20,37,4,9,16,64,111
2010-07-26 00:00:00.000,Umag Croatia ATP World Tour 250,CLAY,2,Franko Skugor,Filippo Volandri,Franko Skugor,6-2; 6-1,R32,56,3,1,16,34,13,16,13,18,0,1,7,26,34,0,4,36,54,18,36,4,18,8,14,8,22,54
2010-07-26 00:00:00.000,Umag Croatia ATP World Tour 250,CLAY,2,Pablo Cuevas,Simone Vagnozzi,Pablo Cuevas,6-4; 6-1,R32,67,1,2,39,54,28,39,9,15,0,1,9,37,54,0,3,32,50,19,32,7,18,6,10,8,26,50
2010-07-26 00:00:00.000,Umag Croatia ATP World Tour 250,CLAY,2,Juan Carlos Ferrero,N/A Bye,Juan Carlos Ferrero,,R32,0,0,0,0,0,0,0,0,0,0,0,0,0,0,0,0,0,0,0,0,0,0,0,0,0,0,0
2010-07-26 00:00:00.000,Umag Croatia ATP World Tour 250,CLAY,2,Olivier Rochus,Philipp Petzschner,Olivier Rochus,6-2; 6-3,R32,85,2,1,26,56,20,26,19,30,0,0,9,39,56,2,1,34,60,23,34,9,26,5,8,8,32,60
2010-07-26 00:00:00.000,Umag Croatia ATP World Tour 250,CLAY,2,Andreas Seppi,Maximo Gonzalez,Andreas Seppi,6-3; 3-6; 6-1,R32,111,6,1,39,77,31,39,22,38,5,7,13,53,77,0,1,48,76,28,48,14,28,10,14,12,42,76
2010-07-26 00:00:00.000,Umag Croatia ATP World Tour 250,CLAY,2,Jan Hajek,Gerald Melzer,Jan Hajek,6-4; 6-3,R32,80,3,2,42,62,32,42,8,20,5,7,10,40,62,4,6,30,59,20,30,10,29,4,8,9,30,59
2010-07-26 00:00:00.000,Umag Croatia ATP World Tour 250,CLAY,2,Jurgen Melzer,N/A Bye,Jurgen Melzer,,R32,0,0,0,0,0,0,0,0,0,0,0,0,0,0,0,0,0,0,0,0,0,0,0,0,0,0,0
2010-07-26 00:00:00.000,Umag Croatia ATP World Tour 250,CLAY,2,Nikolay Davydenko,Stephane Robert,Nikolay Davydenko,6-1; 6-2,R16,53,0,0,34,43,27,34,7,9,0,0,8,34,43,0,1,25,40,14,25,5,15,3,7,7,19,40
2010-07-26 00:00:00.000,Umag Croatia ATP World Tour 250,CLAY,2,Juan Ignacio Chela,Simone Bolelli,Juan Ignacio Chela,7-6(5); 6-7(4); 6-1,R16,162,2,2,75,110,52,75,13,35,5,10,16,65,110,1,2,61,87,34,61,14,26,2,9,15,48,87
2010-07-26 00:00:00.000,Umag Croatia ATP World Tour 250,CLAY,2,Ivan Ljubicic,Ivan Dodig,Ivan Ljubicic,4-6; 6-4; 6-2,R16,151,6,1,47,94,30,47,27,47,10,14,14,57,94,2,5,44,83,29,44,15,39,3,9,14,44,83
2010-07-26 00:00:00.000,Umag Croatia ATP World Tour 250,CLAY,2,Potito Starace,Bjorn Phau,Potito Starace,6-4; 6-0,R16,61,1,1,37,45,27,37,7,8,1,1,8,34,45,0,4,28,47,17,28,8,19,6,10,8,25,47
2010-07-26 00:00:00.000,Umag Croatia ATP World Tour 250,CLAY,2,Alexandr Dolgopolov,Franko Skugor,Alexandr Dolgopolov,7-6(1); 6-3,R16,90,6,2,32,71,23,32,26,39,5,5,10,49,71,3,2,41,73,31,41,13,32,3,5,11,44,73
2010-07-26 00:00:00.000,Umag Croatia ATP World Tour 250,CLAY,2,Juan Carlos Ferrero,Pablo Cuevas,Juan Carlos Ferrero,4-6; 6-4; 6-4,R16,129,1,0,71,95,41,71,15,24,9,12,15,56,95,4,2,57,90,38,57,15,33,4,8,15,53,90
2010-07-26 00:00:00.000,Umag Croatia ATP World Tour 250,CLAY,2,Andreas Seppi,Olivier Rochus,Andreas Seppi,6-4; 6-2,R16,81,2,0,29,51,19,29,15,22,1,2,9,34,51,0,1,39,64,22,39,13,25,7,11,9,35,64
2010-07-26 00:00:00.000,Umag Croatia ATP World Tour 250,CLAY,2,Jurgen Melzer,Jan Hajek,Jurgen Melzer,6-1; 6-0,R16,46,4,2,32,45,23,32,8,13,2,2,7,31,45,2,3,22,38,10,22,5,16,2,7,6,15,38
2010-07-26 00:00:00.000,Umag Croatia ATP World Tour 250,CLAY,2,Juan Ignacio Chela,Nikolay Davydenko,Juan Ignacio Chela,6-2; 6-1,Q,65,0,0,28,44,20,28,8,16,5,7,7,28,44,1,3,36,49,14,36,3,13,4,11,8,17,49
2010-07-26 00:00:00.000,Umag Croatia ATP World Tour 250,CLAY,2,Potito Starace,Ivan Ljubicic,Potito Starace,6-4; 7-6(6),Q,113,0,0,68,83,44,68,10,15,3,5,11,54,83,7,3,47,88,33,47,17,41,7,10,11,50,88
2010-07-26 00:00:00.000,Umag Croatia ATP World Tour 250,CLAY,2,Juan Carlos Ferrero,Alexandr Dolgopolov,Juan Carlos Ferrero,6-1; 6-2,Q,50,1,2,37,51,30,37,6,14,4,4,8,36,51,1,3,19,38,9,19,7,19,3,7,7,16,38
2010-07-26 00:00:00.000,Umag Croatia ATP World Tour 250,CLAY,2,Andreas Seppi,Jurgen Melzer,Andreas Seppi,6-1; 6-4,Q,66,2,0,26,47,20,26,15,21,3,4,9,35,47,3,2,32,55,18,32,8,23,7,11,8,26,55
2010-07-26 00:00:00.000,Umag Croatia ATP World Tour 250,CLAY,2,Potito Starace,Juan Ignacio Chela,Potito Starace,6-7(4); 6-3; 6-2,S,148,1,0,69,98,41,69,19,29,14,17,14,60,98,0,6,59,99,35,59,16,40,3,10,15,51,99
2010-07-26 00:00:00.000,Umag Croatia ATP World Tour 250,CLAY,2,Juan Carlos Ferrero,Andreas Seppi,Juan Carlos Ferrero,6-4; 6-2,S,80,1,0,31,50,23,31,9,19,2,4,9,32,50,3,1,39,57,21,39,6,18,5,10,9,27,57
2010-07-26 00:00:00.000,Umag Croatia ATP World Tour 250,CLAY,2,Juan Carlos Ferrero,Potito Starace,Juan Carlos Ferrero,6-4; 6-4,F,80,1,1,36,50,31,36,9,14,0,0,10,40,50,2,2,51,65,32,51,9,14,4,6,10,41,65
2010-08-01 00:00:00.000,Washington DC; USA ATP World Tour 500,HARD,2,Tomas Berdych,N/A Bye,Tomas Berdych,,R64,0,0,0,0,0,0,0,0,0,0,0,0,0,0,0,0,0,0,0,0,0,0,0,0,0,0,0
2010-08-01 00:00:00.000,Washington DC; USA ATP World Tour 500,HARD,2,Dmitry Tursunov,Teymuraz Gabashvili,Dmitry Tursunov,5-7; 7-5; 6-4,R64,163,7,3,61,107,48,61,23,46,7,9,17,71,107,7,4,64,118,48,64,24,54,5,8,17,72,118
2010-08-01 00:00:00.000,Washington DC; USA ATP World Tour 500,HARD,2,Kristof Vliegen,Richard Gasquet,Kristof Vliegen,6-3 RET,R64,38,6,0,18,25,12,18,2,7,0,1,4,14,25,0,3,19,33,11,19,3,14,3,6,5,14,33
2010-08-01 00:00:00.000,Washington DC; USA ATP World Tour 500,HARD,2,Andrey Golubev,N/A Bye,Andrey Golubev,,R64,0,0,0,0,0,0,0,0,0,0,0,0,0,0,0,0,0,0,0,0,0,0,0,0,0,0,0
2010-08-01 00:00:00.000,Washington DC; USA ATP World Tour 500,HARD,2,Julien Benneteau,N/A Bye,Julien Benneteau,,R64,0,0,0,0,0,0,0,0,0,0,0,0,0,0,0,0,0,0,0,0,0,0,0,0,0,0,0
2010-08-01 00:00:00.000,Washington DC; USA ATP World Tour 500,HARD,2,Xavier Malisse,Santiago Giraldo,Xavier Malisse,4-6; 6-3; 6-4,R64,113,13,0,58,104,44,58,22,46,11,13,15,66,104,3,5,34,80,24,34,28,46,2,5,14,52,80
2010-08-01 00:00:00.000,Washington DC; USA ATP World Tour 500,HARD,2,Thiemo de Bakker,Lukas Lacko,Thiemo de Bakker,5-7; 6-3; 6-3,R64,125,11,3,70,112,49,70,21,42,8,10,15,70,112,7,3,42,86,32,42,25,44,5,9,15,57,86
2010-08-01 00:00:00.000,Washington DC; USA ATP World Tour 500,HARD,2,John Isner,N/A Bye,John Isner,,R64,0,0,0,0,0,0,0,0,0,0,0,0,0,0,0,0,0,0,0,0,0,0,0,0,0,0,0
2010-08-01 00:00:00.000,Washington DC; USA ATP World Tour 500,HARD,2,Fernando Verdasco,N/A Bye,Fernando Verdasco,,R64,0,0,0,0,0,0,0,0,0,0,0,0,0,0,0,0,0,0,0,0,0,0,0,0,0,0,0
2010-08-01 00:00:00.000,Washington DC; USA ATP World Tour 500,HARD,2,Michael Berrer,Karol Beck,Michael Berrer,6-3; 6-4,R64,80,6,8,34,65,26,34,15,31,2,3,10,41,65,5,7,26,59,16,26,17,33,2,5,9,33,59
2010-08-01 00:00:00.000,Washington DC; USA ATP World Tour 500,HARD,2,Ryan Sweeting,James Blake,Ryan Sweeting,3-6; 6-3; 6-4,R64,93,2,3,73,89,46,73,11,16,5,7,14,57,89,9,3,37,76,28,37,21,39,0,3,14,49,76
2010-08-01 00:00:00.000,Washington DC; USA ATP World Tour 500,HARD,2,Michael Llodra,N/A Bye,Michael Llodra,,R64,0,0,0,0,0,0,0,0,0,0,0,0,0,0,0,0,0,0,0,0,0,0,0,0,0,0,0
2010-08-01 00:00:00.000,Washington DC; USA ATP World Tour 500,HARD,2,Ernests Gulbis,N/A Bye,Ernests Gulbis,,R64,0,0,0,0,0,0,0,0,0,0,0,0,0,0,0,0,0,0,0,0,0,0,0,0,0,0,0
2010-08-01 00:00:00.000,Washington DC; USA ATP World Tour 500,HARD,2,Illya Marchenko,Rainer Schuettler,Illya Marchenko,6-4; 3-6; 6-4,R64,144,5,3,53,90,35,53,19,37,2,5,14,54,90,4,1,62,108,44,62,19,46,9,13,15,63,108
2010-08-01 00:00:00.000,Washington DC; USA ATP World Tour 500,HARD,2,Horacio Zeballos,Michal Przysiezny,Horacio Zeballos,3-6; 7-6(5); 6-4,R64,130,9,5,75,114,52,75,22,39,7,8,15,74,114,16,3,47,89,38,47,27,42,0,1,16,65,89
2010-08-01 00:00:00.000,Washington DC; USA ATP World Tour 500,HARD,2,Marcos Baghdatis,N/A Bye,Marcos Baghdatis,,R64,0,0,0,0,0,0,0,0,0,0,0,0,0,0,0,0,0,0,0,0,0,0,0,0,0,0,0
2010-08-01 00:00:00.000,Washington DC; USA ATP World Tour 500,HARD,2,Sam Querrey,N/A Bye,Sam Querrey,,R64,0,0,0,0,0,0,0,0,0,0,0,0,0,0,0,0,0,0,0,0,0,0,0,0,0,0,0
2010-08-01 00:00:00.000,Washington DC; USA ATP World Tour 500,HARD,2,Janko Tipsarevic,Arnaud Clement,Janko Tipsarevic,6-4; 6-0,R64,74,5,1,19,41,15,19,14,22,0,1,8,29,41,2,2,21,55,13,21,13,34,4,9,8,26,55
2010-08-01 00:00:00.000,Washington DC; USA ATP World Tour 500,HARD,2,Alejandro Falla,Yen-Hsun Lu,Alejandro Falla,7-5; 6-1,R64,83,3,4,38,72,29,38,19,34,10,10,10,48,72,3,4,32,56,23,32,10,24,3,6,9,33,56
2010-08-01 00:00:00.000,Washington DC; USA ATP World Tour 500,HARD,2,Lleyton Hewitt,N/A Bye,Lleyton Hewitt,,R64,0,0,0,0,0,0,0,0,0,0,0,0,0,0,0,0,0,0,0,0,0,0,0,0,0,0,0
2010-08-01 00:00:00.000,Washington DC; USA ATP World Tour 500,HARD,2,Mardy Fish,N/A Bye,Mardy Fish,,R64,0,0,0,0,0,0,0,0,0,0,0,0,0,0,0,0,0,0,0,0,0,0,0,0,0,0,0
2010-08-01 00:00:00.000,Washington DC; USA ATP World Tour 500,HARD,2,Viktor Troicki,Kevin Kim,Viktor Troicki,6-1; 6-2,R64,57,8,0,28,41,22,28,10,13,0,0,8,32,41,2,2,27,57,16,27,10,30,3,7,7,26,57
2010-08-01 00:00:00.000,Washington DC; USA ATP World Tour 500,HARD,2,Denis Istomin,Leonardo Mayer,Denis Istomin,6-4; 5-7; 7-6(5),R64,147,10,3,62,108,50,62,29,46,5,6,17,79,108,9,3,52,96,47,52,25,44,1,2,17,72,96
2010-08-01 00:00:00.000,Washington DC; USA ATP World Tour 500,HARD,2,Marin Cilic,N/A Bye,Marin Cilic,,R64,0,0,0,0,0,0,0,0,0,0,0,0,0,0,0,0,0,0,0,0,0,0,0,0,0,0,0
2010-08-01 00:00:00.000,Washington DC; USA ATP World Tour 500,HARD,2,Stanislas Wawrinka,N/A Bye,Stanislas Wawrinka,,R64,0,0,0,0,0,0,0,0,0,0,0,0,0,0,0,0,0,0,0,0,0,0,0,0,0,0,0
2010-08-01 00:00:00.000,Washington DC; USA ATP World Tour 500,HARD,2,David Nalbandian,Rajeev Ram,David Nalbandian,6-4; 6-0,R64,52,3,2,25,43,19,25,13,18,0,0,8,32,43,6,2,22,42,16,22,8,20,1,5,8,24,42
2010-08-01 00:00:00.000,Washington DC; USA ATP World Tour 500,HARD,2,Marco Chiudinelli,Brian Dabul,Marco Chiudinelli,7-6(3); 6-2,R64,93,6,3,38,69,25,38,23,31,4,5,10,48,69,3,4,41,62,29,41,8,21,4,7,10,37,62
2010-08-01 00:00:00.000,Washington DC; USA ATP World Tour 500,HARD,2,Radek Stepanek,N/A Bye,Radek Stepanek,,R64,0,0,0,0,0,0,0,0,0,0,0,0,0,0,0,0,0,0,0,0,0,0,0,0,0,0,0
2010-08-01 00:00:00.000,Washington DC; USA ATP World Tour 500,HARD,2,Gilles Simon,N/A Bye,Gilles Simon,,R64,0,0,0,0,0,0,0,0,0,0,0,0,0,0,0,0,0,0,0,0,0,0,0,0,0,0,0
2010-08-01 00:00:00.000,Washington DC; USA ATP World Tour 500,HARD,2,Igor Kunitsyn,Kei Nishikori,Igor Kunitsyn,6-2; 6-3,R64,68,3,0,28,52,23,28,15,24,0,0,9,38,52,3,2,38,56,26,38,5,18,4,7,8,31,56
2010-08-01 00:00:00.000,Washington DC; USA ATP World Tour 500,HARD,2,Grega Zemlja,Benjamin Becker,Grega Zemlja,6-2; 6-3,R64,57,8,0,29,44,24,29,12,15,0,0,9,36,44,2,3,27,45,18,27,7,18,4,7,8,25,45
2010-08-01 00:00:00.000,Washington DC; USA ATP World Tour 500,HARD,2,Andy Roddick,N/A Bye,Andy Roddick,,R64,0,0,0,0,0,0,0,0,0,0,0,0,0,0,0,0,0,0,0,0,0,0,0,0,0,0,0
2010-08-01 00:00:00.000,Washington DC; USA ATP World Tour 500,HARD,2,Tomas Berdych,Dmitry Tursunov,Tomas Berdych,7-6(2); 4-6; 6-1,R32,138,12,3,43,89,37,43,24,46,5,7,15,61,89,4,7,60,97,40,60,17,37,6,9,14,57,97
2010-08-01 00:00:00.000,Washington DC; USA ATP World Tour 500,HARD,2,Andrey Golubev,Kristof Vliegen,Andrey Golubev,6-2; 7-6(7),R32,114,3,5,41,73,31,41,18,32,1,2,10,49,73,0,5,38,80,24,38,23,42,5,8,10,47,80
2010-08-01 00:00:00.000,Washington DC; USA ATP World Tour 500,HARD,2,Xavier Malisse,Julien Benneteau,Xavier Malisse,7-5; 6-4,R32,79,5,0,37,62,29,37,16,25,2,3,11,45,62,6,4,39,61,26,39,11,22,3,6,11,37,61
2010-08-01 00:00:00.000,Washington DC; USA ATP World Tour 500,HARD,2,John Isner,Thiemo de Bakker,John Isner,7-6(6); 7-6(8),R32,109,15,3,63,87,50,63,13,24,0,0,12,63,87,9,1,55,84,45,55,17,29,1,1,12,62,84
2010-08-01 00:00:00.000,Washington DC; USA ATP World Tour 500,HARD,2,Fernando Verdasco,Michael Berrer,Fernando Verdasco,4-6; 7-5; 7-6(6),R32,162,10,10,66,99,54,66,15,33,2,5,17,69,99,4,5,71,118,48,71,27,47,1,4,17,75,118
2010-08-01 00:00:00.000,Washington DC; USA ATP World Tour 500,HARD,2,Ryan Sweeting,Michael Llodra,Ryan Sweeting,6-4; 6-2,R32,63,2,3,54,64,32,54,5,10,9,12,9,37,64,0,2,39,56,19,39,3,17,3,9,9,22,56
2010-08-01 00:00:00.000,Washington DC; USA ATP World Tour 500,HARD,2,Illya Marchenko,Ernests Gulbis,Illya Marchenko,6-1; 1-0 RET,R32,36,6,0,14,22,12,14,5,8,0,0,4,17,22,2,5,17,30,11,17,2,13,1,4,4,13,30
2010-08-01 00:00:00.000,Washington DC; USA ATP World Tour 500,HARD,2,Marcos Baghdatis,Horacio Zeballos,Marcos Baghdatis,7-6(3); 7-6(5),R32,119,17,4,43,77,37,43,21,34,4,5,12,58,77,8,5,47,85,38,47,18,38,3,4,12,56,85
2010-08-01 00:00:00.000,Washington DC; USA ATP World Tour 500,HARD,2,Janko Tipsarevic,Sam Querrey,Janko Tipsarevic,7-6(3); 6-3,R32,78,16,0,31,55,29,31,20,24,0,0,11,49,55,13,3,37,64,31,37,12,27,1,2,10,43,64
2010-08-01 00:00:00.000,Washington DC; USA ATP World Tour 500,HARD,2,Alejandro Falla,Lleyton Hewitt,Alejandro Falla,7-5; 3-2 RET,R32,91,4,3,27,61,18,27,20,34,8,9,8,38,61,1,3,30,56,21,30,11,26,0,3,9,32,56
2010-08-01 00:00:00.000,Washington DC; USA ATP World Tour 500,HARD,2,Mardy Fish,Viktor Troicki,Mardy Fish,6-4; 6-3,R32,85,4,2,28,55,19,28,15,27,4,6,9,34,55,3,6,34,67,23,34,12,33,6,11,10,35,67
2010-08-01 00:00:00.000,Washington DC; USA ATP World Tour 500,HARD,2,Marin Cilic,Denis Istomin,Marin Cilic,6-4; 6-2,R32,88,4,0,44,66,31,44,13,22,5,5,9,44,66,7,1,36,59,22,36,10,23,6,9,9,32,59
2010-08-01 00:00:00.000,Washington DC; USA ATP World Tour 500,HARD,2,David Nalbandian,Stanislas Wawrinka,David Nalbandian,6-1; 6-3,R32,69,1,1,26,46,21,26,13,20,0,0,8,34,46,5,2,30,52,19,30,7,22,3,7,8,26,52
2010-08-01 00:00:00.000,Washington DC; USA ATP World Tour 500,HARD,2,Marco Chiudinelli,Radek Stepanek,Marco Chiudinelli,6-1; 6-3,R32,71,5,4,21,48,19,21,16,27,2,2,8,35,48,2,4,19,47,11,19,14,28,3,7,8,25,47
2010-08-01 00:00:00.000,Washington DC; USA ATP World Tour 500,HARD,2,Gilles Simon,Igor Kunitsyn,Gilles Simon,6-1; 6-2,R32,52,5,0,16,37,14,16,18,21,0,0,8,32,37,1,1,27,50,19,27,6,23,5,9,7,25,50
2010-08-01 00:00:00.000,Washington DC; USA ATP World Tour 500,HARD,2,Andy Roddick,Grega Zemlja,Andy Roddick,6-4; 6-4,R32,84,4,0,29,49,26,29,14,20,0,0,10,40,49,8,1,29,57,21,29,17,28,0,2,10,38,57
2010-08-01 00:00:00.000,Washington DC; USA ATP World Tour 500,HARD,2,Tomas Berdych,Andrey Golubev,Tomas Berdych,6-3; 5-7; 7-5,R16,141,4,4,45,90,40,45,24,45,0,2,17,64,90,5,3,73,105,50,73,15,32,4,7,16,65,105
2010-08-01 00:00:00.000,Washington DC; USA ATP World Tour 500,HARD,2,Xavier Malisse,John Isner,Xavier Malisse,6-4; 3-6; 7-6(5),R16,122,11,2,51,88,42,51,25,37,2,3,15,67,88,18,4,82,110,59,82,15,28,7,8,16,74,110
2010-08-01 00:00:00.000,Washington DC; USA ATP World Tour 500,HARD,2,Fernando Verdasco,Ryan Sweeting,Fernando Verdasco,6-4; 7-5,R16,89,3,5,59,81,42,59,8,22,5,7,11,50,81,1,1,54,62,33,54,2,8,3,7,11,35,62
2010-08-01 00:00:00.000,Washington DC; USA ATP World Tour 500,HARD,2,Marcos Baghdatis,Illya Marchenko,Marcos Baghdatis,6-3; 6-7(5); 6-3,R16,160,5,2,55,101,44,55,26,46,3,4,16,70,101,1,4,55,101,38,55,25,46,8,11,14,63,101
2010-08-01 00:00:00.000,Washington DC; USA ATP World Tour 500,HARD,2,Janko Tipsarevic,Alejandro Falla,Janko Tipsarevic,6-3; 6-4,R16,88,7,3,44,65,32,44,11,21,3,4,10,43,65,0,2,35,65,20,35,16,30,5,8,9,36,65
2010-08-01 00:00:00.000,Washington DC; USA ATP World Tour 500,HARD,2,Marin Cilic,Mardy Fish,Marin Cilic,6-4; 4-6; 6-2,R16,136,5,3,47,88,37,47,23,41,5,7,14,60,88,10,1,51,91,34,51,22,40,4,8,14,56,91
2010-08-01 00:00:00.000,Washington DC; USA ATP World Tour 500,HARD,2,David Nalbandian,Marco Chiudinelli,David Nalbandian,6-1; 6-0,R16,45,4,4,19,36,16,19,10,17,2,2,6,26,36,0,4,25,38,8,25,4,13,1,7,7,12,38
2010-08-01 00:00:00.000,Washington DC; USA ATP World Tour 500,HARD,2,Gilles Simon,Andy Roddick,Gilles Simon,6-3; 6-3,R16,70,7,1,23,51,21,23,18,28,2,2,9,39,51,3,0,26,47,21,26,7,21,2,5,9,28,47
2010-08-01 00:00:00.000,Washington DC; USA ATP World Tour 500,HARD,2,Xavier Malisse,Tomas Berdych,Xavier Malisse,6-4; 3-6; 6-2,Q,130,7,2,38,80,30,38,23,42,1,3,13,53,80,8,2,51,96,39,51,18,45,5,9,14,57,96
2010-08-01 00:00:00.000,Washington DC; USA ATP World Tour 500,HARD,2,Marcos Baghdatis,Fernando Verdasco,Marcos Baghdatis,7-6(3); 6-4,Q,102,7,8,40,83,29,40,19,43,8,11,11,48,83,4,7,34,60,22,34,12,26,1,5,11,34,60
2010-08-01 00:00:00.000,Washington DC; USA ATP World Tour 500,HARD,2,Marin Cilic,Janko Tipsarevic,Marin Cilic,7-6(4); 6-4,Q,110,6,3,46,75,34,46,19,29,2,2,11,53,75,3,2,37,70,28,37,19,33,3,4,11,47,70
2010-08-01 00:00:00.000,Washington DC; USA ATP World Tour 500,HARD,2,David Nalbandian,Gilles Simon,David Nalbandian,3-6; 6-2; 6-3,Q,118,3,3,42,80,32,42,13,38,4,9,13,45,80,5,6,48,94,29,48,19,46,11,18,13,48,94
2010-08-01 00:00:00.000,Washington DC; USA ATP World Tour 500,HARD,2,Marcos Baghdatis,Xavier Malisse,Marcos Baghdatis,6-2; 7-6(4),S,108,11,2,31,72,27,31,21,41,2,3,10,48,72,6,0,41,66,27,41,12,25,3,6,10,39,66
2010-08-01 00:00:00.000,Washington DC; USA ATP World Tour 500,HARD,2,David Nalbandian,Marin Cilic,David Nalbandian,6-2; 6-2,S,73,3,0,25,47,17,25,16,22,4,5,8,33,47,1,4,29,52,18,29,6,23,3,8,8,24,52
2010-08-01 00:00:00.000,Washington DC; USA ATP World Tour 500,HARD,2,David Nalbandian,Marcos Baghdatis,David Nalbandian,6-2; 7-6(4),F,120,3,7,46,93,33,46,21,47,9,11,10,54,93,5,3,31,75,20,31,19,44,5,9,10,39,75
2010-08-09 00:00:00.000,ATP World Tour Masters 1000 Canada Toronto; Canada ATP World Tour Masters 1000,HARD,2,Rafael Nadal,N/A Bye,Rafael Nadal,,R64,0,0,0,0,0,0,0,0,0,0,0,0,0,0,0,0,0,0,0,0,0,0,0,0,0,0,0
2010-08-09 00:00:00.000,ATP World Tour Masters 1000 Canada Toronto; Canada ATP World Tour Masters 1000,HARD,2,Stanislas Wawrinka,Frank Dancevic,Stanislas Wawrinka,6-1; 6-4,R64,78,5,2,32,58,28,32,12,26,3,3,9,40,58,2,3,31,56,19,31,11,25,6,9,8,30,56
2010-08-09 00:00:00.000,ATP World Tour Masters 1000 Canada Toronto; Canada ATP World Tour Masters 1000,HARD,2,Kevin Anderson,Leonardo Mayer,Kevin Anderson,7-6(2); 6-4,R64,112,14,4,50,79,42,50,14,29,3,3,11,56,79,8,5,40,67,32,40,13,27,2,3,11,45,67
2010-08-09 00:00:00.000,ATP World Tour Masters 1000 Canada Toronto; Canada ATP World Tour Masters 1000,HARD,2,Sam Querrey,Michael Russell,Sam Querrey,3-6; 6-1; 6-4,R64,100,12,0,34,65,30,34,21,31,0,1,13,51,65,5,2,57,84,39,57,13,27,7,10,13,52,84
2010-08-09 00:00:00.000,ATP World Tour Masters 1000 Canada Toronto; Canada ATP World Tour Masters 1000,HARD,2,Viktor Troicki,Marin Cilic,Viktor Troicki,6-4; 7-6(2),R64,110,11,2,59,81,43,59,14,22,4,4,11,57,81,7,8,46,77,36,46,14,31,2,3,11,50,77
2010-08-09 00:00:00.000,ATP World Tour Masters 1000 Canada Toronto; Canada ATP World Tour Masters 1000,HARD,2,Philipp Kohlschreiber,Janko Tipsarevic,Philipp Kohlschreiber,2-2 RET,R64,24,1,0,6,9,6,6,2,3,0,0,2,8,9,0,1,7,17,5,7,6,10,2,2,2,11,17
2010-08-09 00:00:00.000,ATP World Tour Masters 1000 Canada Toronto; Canada ATP World Tour Masters 1000,HARD,2,Yen-Hsun Lu,Pierre-Ludovic Duclos,Yen-Hsun Lu,6-4; 6-4,R64,90,2,2,35,53,29,35,12,18,2,2,10,41,53,4,1,44,67,31,44,11,23,3,5,10,42,67
2010-08-09 00:00:00.000,ATP World Tour Masters 1000 Canada Toronto; Canada ATP World Tour Masters 1000,HARD,2,Paul-Henri Mathieu,N/A Bye,Paul-Henri Mathieu,,R64,0,0,0,0,0,0,0,0,0,0,0,0,0,0,0,0,0,0,0,0,0,0,0,0,0,0,0
2010-08-09 00:00:00.000,ATP World Tour Masters 1000 Canada Toronto; Canada ATP World Tour Masters 1000,HARD,2,Andy Murray,N/A Bye,Andy Murray,,R64,0,0,0,0,0,0,0,0,0,0,0,0,0,0,0,0,0,0,0,0,0,0,0,0,0,0,0
2010-08-09 00:00:00.000,ATP World Tour Masters 1000 Canada Toronto; Canada ATP World Tour Masters 1000,HARD,2,Xavier Malisse,Michael Berrer,Xavier Malisse,7-6(2); 6-2,R64,81,8,2,40,59,38,40,10,19,1,1,10,48,59,4,3,35,60,29,35,9,25,1,3,10,38,60
2010-08-09 00:00:00.000,ATP World Tour Masters 1000 Canada Toronto; Canada ATP World Tour Masters 1000,HARD,2,Thiemo de Bakker,Feliciano Lopez,Thiemo de Bakker,7-6(2); 6-3,R64,89,10,0,43,60,32,43,15,17,0,0,11,47,60,7,1,42,65,33,42,9,23,1,2,10,42,65
2010-08-09 00:00:00.000,ATP World Tour Masters 1000 Canada Toronto; Canada ATP World Tour Masters 1000,HARD,2,Gael Monfils,Somdev Devvarman,Gael Monfils,7-6(3); 6-3,R64,84,4,4,37,66,32,37,14,29,3,4,11,46,66,5,2,31,53,20,31,14,22,0,2,10,34,53
2010-08-09 00:00:00.000,ATP World Tour Masters 1000 Canada Toronto; Canada ATP World Tour Masters 1000,HARD,2,David Nalbandian,David Ferrer,David Nalbandian,7-5; 3-6; 6-3,R64,135,3,3,61,101,37,61,18,40,7,12,15,55,101,3,0,63,89,35,63,14,26,5,11,15,49,89
2010-08-09 00:00:00.000,ATP World Tour Masters 1000 Canada Toronto; Canada ATP World Tour Masters 1000,HARD,2,Tommy Robredo,Jarkko Nieminen,Tommy Robredo,6-1; 6-4,R64,79,5,1,32,48,23,32,10,16,4,5,8,33,48,1,3,46,73,25,46,12,27,9,14,9,37,73
2010-08-09 00:00:00.000,ATP World Tour Masters 1000 Canada Toronto; Canada ATP World Tour Masters 1000,HARD,2,Ernests Gulbis,Thomaz Bellucci,Ernests Gulbis,6-1; 6-4,R64,89,5,7,37,64,30,37,9,27,5,6,9,39,64,3,2,36,54,19,36,7,18,3,7,8,26,54
2010-08-09 00:00:00.000,ATP World Tour Masters 1000 Canada Toronto; Canada ATP World Tour Masters 1000,HARD,2,Robin Soderling,N/A Bye,Robin Soderling,,R64,0,0,0,0,0,0,0,0,0,0,0,0,0,0,0,0,0,0,0,0,0,0,0,0,0,0,0
2010-08-09 00:00:00.000,ATP World Tour Masters 1000 Canada Toronto; Canada ATP World Tour Masters 1000,HARD,2,Tomas Berdych,N/A Bye,Tomas Berdych,,R64,0,0,0,0,0,0,0,0,0,0,0,0,0,0,0,0,0,0,0,0,0,0,0,0,0,0,0
2010-08-09 00:00:00.000,ATP World Tour Masters 1000 Canada Toronto; Canada ATP World Tour Masters 1000,HARD,2,Sergiy Stakhovsky,Richard Gasquet,Sergiy Stakhovsky,7-5; 6-1,R64,87,11,1,44,68,36,44,9,24,8,9,9,45,68,1,1,34,58,22,34,9,24,4,9,10,31,58
2010-08-09 00:00:00.000,ATP World Tour Masters 1000 Canada Toronto; Canada ATP World Tour Masters 1000,HARD,2,Alexandr Dolgopolov,Philipp Petzschner,Alexandr Dolgopolov,1-6; 6-2; 7-6(4),R64,100,13,5,39,86,32,39,22,47,7,10,13,54,86,9,4,50,94,37,50,22,44,6,9,14,59,94
2010-08-09 00:00:00.000,ATP World Tour Masters 1000 Canada Toronto; Canada ATP World Tour Masters 1000,HARD,2,Mikhail Youzhny,Gilles Simon,Mikhail Youzhny,6-4; 6-4,R64,103,3,2,32,63,23,32,15,31,2,4,10,38,63,1,3,36,58,24,36,8,22,1,5,10,32,58
2010-08-09 00:00:00.000,ATP World Tour Masters 1000 Canada Toronto; Canada ATP World Tour Masters 1000,HARD,2,Nicolas Almagro,Illya Marchenko,Nicolas Almagro,7-5; 5-7; 6-4,R64,133,5,0,71,102,54,71,14,31,1,3,17,68,102,5,4,58,96,39,58,23,38,1,4,17,62,96
2010-08-09 00:00:00.000,ATP World Tour Masters 1000 Canada Toronto; Canada ATP World Tour Masters 1000,HARD,2,Michael Llodra,Santiago Giraldo,Michael Llodra,7-6(6); 7-5,R64,96,5,3,39,68,36,39,15,29,0,1,12,51,68,4,4,57,79,37,57,13,22,4,6,12,50,79
2010-08-09 00:00:00.000,ATP World Tour Masters 1000 Canada Toronto; Canada ATP World Tour Masters 1000,HARD,2,Juan Ignacio Chela,Alejandro Falla,Juan Ignacio Chela,6-0; 6-3,R64,68,1,0,26,45,21,26,13,19,1,1,8,34,45,1,0,28,45,15,28,7,17,4,8,7,22,45
2010-08-09 00:00:00.000,ATP World Tour Masters 1000 Canada Toronto; Canada ATP World Tour Masters 1000,HARD,2,Roger Federer,N/A Bye,Roger Federer,,R64,0,0,0,0,0,0,0,0,0,0,0,0,0,0,0,0,0,0,0,0,0,0,0,0,0,0,0
2010-08-09 00:00:00.000,ATP World Tour Masters 1000 Canada Toronto; Canada ATP World Tour Masters 1000,HARD,2,Nikolay Davydenko,N/A Bye,Nikolay Davydenko,,R64,0,0,0,0,0,0,0,0,0,0,0,0,0,0,0,0,0,0,0,0,0,0,0,0,0,0,0
2010-08-09 00:00:00.000,ATP World Tour Masters 1000 Canada Toronto; Canada ATP World Tour Masters 1000,HARD,2,Fabio Fognini,Radek Stepanek,Fabio Fognini,6-2; 6-4,R64,78,1,3,42,65,29,42,9,23,4,6,9,38,65,2,3,36,50,22,36,3,14,3,8,9,25,50
2010-08-09 00:00:00.000,ATP World Tour Masters 1000 Canada Toronto; Canada ATP World Tour Masters 1000,HARD,2,Jeremy Chardy,Marcos Baghdatis,Jeremy Chardy,7-5; 2-6; 7-6(4),R64,152,15,6,64,118,42,64,29,54,6,10,16,71,118,13,5,52,99,40,52,24,47,4,7,16,64,99
2010-08-09 00:00:00.000,ATP World Tour Masters 1000 Canada Toronto; Canada ATP World Tour Masters 1000,HARD,2,Fernando Verdasco,Eduardo Schwank,Fernando Verdasco,6-0; 5-7; 6-2,R64,99,5,3,57,71,42,57,7,14,3,5,13,49,71,3,6,49,82,27,49,14,33,4,10,13,41,82
2010-08-09 00:00:00.000,ATP World Tour Masters 1000 Canada Toronto; Canada ATP World Tour Masters 1000,HARD,2,Peter Polansky,Jurgen Melzer,Peter Polansky,7-6(6); 6-4,R64,107,3,2,44,74,36,44,16,30,2,2,11,52,74,10,2,57,86,39,57,15,29,7,8,11,54,86
2010-08-09 00:00:00.000,ATP World Tour Masters 1000 Canada Toronto; Canada ATP World Tour Masters 1000,HARD,2,Victor Hanescu,Milos Raonic,Victor Hanescu,6-4; 6-4,R64,69,4,1,37,55,28,37,13,18,1,1,10,41,55,4,4,36,67,27,36,15,31,3,5,10,42,67
2010-08-09 00:00:00.000,ATP World Tour Masters 1000 Canada Toronto; Canada ATP World Tour Masters 1000,HARD,2,Julien Benneteau,Denis Istomin,Julien Benneteau,6-4; 6-4,R64,74,6,2,38,53,35,38,8,15,2,2,10,43,53,6,1,29,52,22,29,15,23,2,4,10,37,52
2010-08-09 00:00:00.000,ATP World Tour Masters 1000 Canada Toronto; Canada ATP World Tour Masters 1000,HARD,2,Novak Djokovic,N/A Bye,Novak Djokovic,,R64,0,0,0,0,0,0,0,0,0,0,0,0,0,0,0,0,0,0,0,0,0,0,0,0,0,0,0
2010-08-09 00:00:00.000,ATP World Tour Masters 1000 Canada Toronto; Canada ATP World Tour Masters 1000,HARD,2,Rafael Nadal,Stanislas Wawrinka,Rafael Nadal,7-6(12); 6-3,R32,142,2,3,51,79,40,51,14,28,2,3,11,54,79,8,2,40,78,30,40,20,38,7,9,10,50,78
2010-08-09 00:00:00.000,ATP World Tour Masters 1000 Canada Toronto; Canada ATP World Tour Masters 1000,HARD,2,Kevin Anderson,Sam Querrey,Kevin Anderson,7-6(4); 4-6; 6-4,R32,128,14,1,68,95,52,68,18,27,1,2,16,70,95,17,1,66,107,53,66,21,41,5,6,16,74,107
2010-08-09 00:00:00.000,ATP World Tour Masters 1000 Canada Toronto; Canada ATP World Tour Masters 1000,HARD,2,Philipp Kohlschreiber,Viktor Troicki,Philipp Kohlschreiber,6-4; 3-6; 6-0,R32,101,5,2,50,78,35,50,17,28,5,7,12,52,78,6,2,40,72,25,40,13,32,3,8,13,38,72
2010-08-09 00:00:00.000,ATP World Tour Masters 1000 Canada Toronto; Canada ATP World Tour Masters 1000,HARD,2,Yen-Hsun Lu,Paul-Henri Mathieu,Yen-Hsun Lu,3-6; 7-6(3); 7-6(5),R32,196,12,3,65,98,49,65,20,33,3,6,16,69,98,15,6,69,139,56,69,29,70,9,11,17,85,139
2010-08-09 00:00:00.000,ATP World Tour Masters 1000 Canada Toronto; Canada ATP World Tour Masters 1000,HARD,2,Andy Murray,Xavier Malisse,Andy Murray,7-5; 6-2,R32,81,7,0,24,50,21,24,18,26,1,2,10,39,50,2,5,38,67,25,38,11,29,7,11,10,36,67
2010-08-09 00:00:00.000,ATP World Tour Masters 1000 Canada Toronto; Canada ATP World Tour Masters 1000,HARD,2,Gael Monfils,Thiemo de Bakker,Gael Monfils,7-5; 6-3,R32,88,5,2,47,65,37,47,10,18,3,3,11,47,65,1,3,33,55,26,33,11,22,2,4,10,37,55
2010-08-09 00:00:00.000,ATP World Tour Masters 1000 Canada Toronto; Canada ATP World Tour Masters 1000,HARD,2,David Nalbandian,Tommy Robredo,David Nalbandian,6-3; 6-0,R32,56,1,1,29,41,25,29,5,12,3,3,7,30,41,1,3,32,48,16,32,6,16,6,11,8,22,48
2010-08-09 00:00:00.000,ATP World Tour Masters 1000 Canada Toronto; Canada ATP World Tour Masters 1000,HARD,2,Robin Soderling,Ernests Gulbis,Robin Soderling,4-6; 6-4; 6-4,R32,138,12,7,61,97,49,61,18,36,6,7,15,67,97,13,5,58,98,45,58,21,40,2,4,15,66,98
2010-08-09 00:00:00.000,ATP World Tour Masters 1000 Canada Toronto; Canada ATP World Tour Masters 1000,HARD,2,Tomas Berdych,Sergiy Stakhovsky,Tomas Berdych,6-2; 6-4,R32,90,6,2,30,55,22,30,17,25,1,1,9,39,55,7,2,46,72,30,46,9,26,7,10,9,39,72
2010-08-09 00:00:00.000,ATP World Tour Masters 1000 Canada Toronto; Canada ATP World Tour Masters 1000,HARD,2,Alexandr Dolgopolov,Mikhail Youzhny,Alexandr Dolgopolov,1-6; 7-6(4); 7-5,R32,145,20,9,60,110,45,60,23,50,8,12,16,68,110,5,3,75,109,54,75,16,34,6,8,15,70,109
2010-08-09 00:00:00.000,ATP World Tour Masters 1000 Canada Toronto; Canada ATP World Tour Masters 1000,HARD,2,Michael Llodra,Nicolas Almagro,Michael Llodra,7-6(5); 6-2,R32,85,10,3,40,62,35,40,12,22,4,4,10,47,62,5,2,52,68,35,52,9,16,3,5,10,44,68
2010-08-09 00:00:00.000,ATP World Tour Masters 1000 Canada Toronto; Canada ATP World Tour Masters 1000,HARD,2,Roger Federer,Juan Ignacio Chela,Roger Federer,7-6(7); 6-3,R32,82,9,0,38,55,33,38,10,17,0,1,10,43,55,2,2,53,85,34,53,17,32,5,8,11,51,85
2010-08-09 00:00:00.000,ATP World Tour Masters 1000 Canada Toronto; Canada ATP World Tour Masters 1000,HARD,2,Nikolay Davydenko,Fabio Fognini,Nikolay Davydenko,7-5; 6-1,R32,86,4,3,45,61,35,45,7,16,3,4,10,42,61,2,4,38,64,22,38,10,26,4,8,9,32,64
2010-08-09 00:00:00.000,ATP World Tour Masters 1000 Canada Toronto; Canada ATP World Tour Masters 1000,HARD,2,Jeremy Chardy,Fernando Verdasco,Jeremy Chardy,6-7(7); 7-6(5); 6-2,R32,172,12,3,69,109,53,69,22,40,8,9,16,75,109,5,3,86,127,58,86,19,41,14,17,16,77,127
2010-08-09 00:00:00.000,ATP World Tour Masters 1000 Canada Toronto; Canada ATP World Tour Masters 1000,HARD,2,Victor Hanescu,Peter Polansky,Victor Hanescu,6-4; 7-6(4),R32,96,7,0,56,69,40,56,7,13,3,5,11,47,69,6,1,41,67,29,41,14,26,4,7,11,43,67
2010-08-09 00:00:00.000,ATP World Tour Masters 1000 Canada Toronto; Canada ATP World Tour Masters 1000,HARD,2,Novak Djokovic,Julien Benneteau,Novak Djokovic,7-5; 7-5,R32,133,6,5,51,74,33,51,9,23,4,8,12,42,74,9,6,69,97,39,69,8,28,12,18,12,47,97
2010-08-09 00:00:00.000,ATP World Tour Masters 1000 Canada Toronto; Canada ATP World Tour Masters 1000,HARD,2,Rafael Nadal,Kevin Anderson,Rafael Nadal,6-2; 7-6(6),R16,102,1,1,36,56,27,36,16,20,0,1,10,43,56,8,1,48,69,32,48,11,21,7,10,10,43,69
2010-08-09 00:00:00.000,ATP World Tour Masters 1000 Canada Toronto; Canada ATP World Tour Masters 1000,HARD,2,Philipp Kohlschreiber,Yen-Hsun Lu,Philipp Kohlschreiber,6-7(5); 7-5; 6-0,R16,163,19,7,62,111,47,62,28,49,11,11,15,75,111,4,6,50,114,32,50,36,64,9,13,15,68,114
2010-08-09 00:00:00.000,ATP World Tour Masters 1000 Canada Toronto; Canada ATP World Tour Masters 1000,HARD,2,Andy Murray,Gael Monfils,Andy Murray,6-2; 0-6; 6-3,R16,125,1,3,36,66,27,36,10,30,4,8,11,37,66,2,5,53,89,36,53,10,36,8,13,12,46,89
2010-08-09 00:00:00.000,ATP World Tour Masters 1000 Canada Toronto; Canada ATP World Tour Masters 1000,HARD,2,David Nalbandian,Robin Soderling,David Nalbandian,4-6; 6-4; 6-1,R16,128,4,8,57,91,40,57,14,34,5,8,13,54,91,14,5,59,97,41,59,9,38,3,9,14,50,97
2010-08-09 00:00:00.000,ATP World Tour Masters 1000 Canada Toronto; Canada ATP World Tour Masters 1000,HARD,2,Tomas Berdych,Alexandr Dolgopolov,Tomas Berdych,6-3; 6-7(5); 6-4,R16,135,11,3,75,110,54,75,23,35,5,5,16,77,110,13,3,45,82,40,45,21,37,3,5,15,61,82
2010-08-09 00:00:00.000,ATP World Tour Masters 1000 Canada Toronto; Canada ATP World Tour Masters 1000,HARD,2,Roger Federer,Michael Llodra,Roger Federer,7-6(2); 6-3,R16,79,4,3,37,61,28,37,14,24,0,2,11,42,61,2,4,37,66,28,37,9,29,1,4,10,37,66
2010-08-09 00:00:00.000,ATP World Tour Masters 1000 Canada Toronto; Canada ATP World Tour Masters 1000,HARD,2,Jeremy Chardy,Nikolay Davydenko,Jeremy Chardy,6-3; 6-2,R16,60,5,2,32,48,26,32,8,16,0,1,9,34,48,0,4,25,41,13,25,8,16,1,5,8,21,41
2010-08-09 00:00:00.000,ATP World Tour Masters 1000 Canada Toronto; Canada ATP World Tour Masters 1000,HARD,2,Novak Djokovic,Victor Hanescu,Novak Djokovic,6-3; 6-4,R16,80,2,1,41,60,29,41,12,19,1,2,10,41,60,1,2,36,60,25,36,8,24,3,6,9,33,60
2010-08-09 00:00:00.000,ATP World Tour Masters 1000 Canada Toronto; Canada ATP World Tour Masters 1000,HARD,2,Rafael Nadal,Philipp Kohlschreiber,Rafael Nadal,3-6; 6-3; 6-4,Q,120,4,1,47,72,37,47,18,25,3,4,14,55,72,11,3,40,79,33,40,20,39,5,7,14,53,79
2010-08-09 00:00:00.000,ATP World Tour Masters 1000 Canada Toronto; Canada ATP World Tour Masters 1000,HARD,2,Andy Murray,David Nalbandian,Andy Murray,6-2; 6-2,Q,70,8,1,34,51,26,34,10,17,1,1,8,36,51,3,3,30,48,18,30,5,18,4,8,8,23,48
2010-08-09 00:00:00.000,ATP World Tour Masters 1000 Canada Toronto; Canada ATP World Tour Masters 1000,HARD,2,Roger Federer,Tomas Berdych,Roger Federer,6-3; 5-7; 7-6(5),Q,161,8,2,65,109,51,65,23,44,4,6,17,74,109,8,2,62,113,48,62,26,51,10,12,16,74,113
2010-08-09 00:00:00.000,ATP World Tour Masters 1000 Canada Toronto; Canada ATP World Tour Masters 1000,HARD,2,Novak Djokovic,Jeremy Chardy,Novak Djokovic,6-2; 6-3,Q,73,3,1,44,52,33,44,5,8,2,2,9,38,52,7,2,29,50,19,29,8,21,2,5,8,27,50
2010-08-09 00:00:00.000,ATP World Tour Masters 1000 Canada Toronto; Canada ATP World Tour Masters 1000,HARD,2,Andy Murray,Rafael Nadal,Andy Murray,6-3; 6-4,S,104,9,3,28,61,23,28,19,33,5,6,10,42,61,2,1,38,62,24,38,12,24,5,8,9,36,62
2010-08-09 00:00:00.000,ATP World Tour Masters 1000 Canada Toronto; Canada ATP World Tour Masters 1000,HARD,2,Roger Federer,Novak Djokovic,Roger Federer,6-1; 3-6; 7-5,S,142,11,2,55,95,40,55,17,40,6,9,14,57,95,1,3,81,118,46,81,18,37,7,12,14,64,118
2010-08-09 00:00:00.000,ATP World Tour Masters 1000 Canada Toronto; Canada ATP World Tour Masters 1000,HARD,2,Andy Murray,Roger Federer,Andy Murray,7-5; 7-5,F,125,6,5,35,65,26,35,15,30,1,4,12,41,65,4,1,43,67,27,43,11,24,5,10,12,38,67
2010-08-15 00:00:00.000,ATP World Tour Masters 1000 Cincinnati OH; U.S.A. ATP World Tour Masters 1000,HARD,2,Rafael Nadal,N/A Bye,Rafael Nadal,,R64,0,0,0,0,0,0,0,0,0,0,0,0,0,0,0,0,0,0,0,0,0,0,0,0,0,0,0
2010-08-15 00:00:00.000,ATP World Tour Masters 1000 Cincinnati OH; U.S.A. ATP World Tour Masters 1000,HARD,2,Taylor Dent,Feliciano Lopez,Taylor Dent,6-3; 6-2,R64,62,12,1,38,53,32,38,8,15,4,4,9,40,53,4,7,30,50,21,30,8,20,1,4,8,29,50
2010-08-15 00:00:00.000,ATP World Tour Masters 1000 Cincinnati OH; U.S.A. ATP World Tour Masters 1000,HARD,2,Julien Benneteau,Michael Llodra,Julien Benneteau,3-6; 6-3; 6-2,R64,87,11,5,52,71,38,52,10,19,0,2,13,48,71,9,3,61,77,42,61,6,16,4,8,13,48,77
2010-08-15 00:00:00.000,ATP World Tour Masters 1000 Cincinnati OH; U.S.A. ATP World Tour Masters 1000,HARD,2,Stanislas Wawrinka,Nicolas Almagro,Stanislas Wawrinka,6-3; 6-3,R64,71,8,2,28,52,24,28,15,24,3,3,9,39,52,3,2,29,54,19,29,12,25,2,5,9,31,54
2010-08-15 00:00:00.000,ATP World Tour Masters 1000 Cincinnati OH; U.S.A. ATP World Tour Masters 1000,HARD,2,Marcos Baghdatis,Marin Cilic,Marcos Baghdatis,6-4; 7-5,R64,106,5,3,28,72,24,28,25,44,6,7,11,49,72,4,1,35,63,24,35,16,28,1,4,11,40,63
2010-08-15 00:00:00.000,ATP World Tour Masters 1000 Cincinnati OH; U.S.A. ATP World Tour Masters 1000,HARD,2,Thomaz Bellucci,Benjamin Becker,Thomaz Bellucci,7-6(6); 7-5,R64,107,12,2,42,78,33,42,21,36,3,4,12,54,78,4,3,51,83,39,51,15,32,2,4,12,54,83
2010-08-15 00:00:00.000,ATP World Tour Masters 1000 Cincinnati OH; U.S.A. ATP World Tour Masters 1000,HARD,2,Paul-Henri Mathieu,Victor Hanescu,Paul-Henri Mathieu,6-7(6); 7-6(2); 6-3,R64,146,4,3,71,112,57,71,26,41,5,5,17,83,112,13,3,70,104,51,70,20,34,3,4,16,71,104
2010-08-15 00:00:00.000,ATP World Tour Masters 1000 Cincinnati OH; U.S.A. ATP World Tour Masters 1000,HARD,2,Tomas Berdych,N/A Bye,Tomas Berdych,,R64,0,0,0,0,0,0,0,0,0,0,0,0,0,0,0,0,0,0,0,0,0,0,0,0,0,0,0
2010-08-15 00:00:00.000,ATP World Tour Masters 1000 Cincinnati OH; U.S.A. ATP World Tour Masters 1000,HARD,2,Roger Federer,N/A Bye,Roger Federer,,R64,0,0,0,0,0,0,0,0,0,0,0,0,0,0,0,0,0,0,0,0,0,0,0,0,0,0,0
2010-08-15 00:00:00.000,ATP World Tour Masters 1000 Cincinnati OH; U.S.A. ATP World Tour Masters 1000,HARD,2,Denis Istomin,James Blake,Denis Istomin,6-3; 6-0,R64,46,10,1,22,39,19,22,13,17,0,0,8,32,39,1,3,16,39,11,16,6,23,3,7,7,17,39
2010-08-15 00:00:00.000,ATP World Tour Masters 1000 Cincinnati OH; U.S.A. ATP World Tour Masters 1000,HARD,2,Philipp Kohlschreiber,Horacio Zeballos,Philipp Kohlschreiber,6-7(2); 6-3; 6-4,R64,137,14,3,53,92,44,53,23,39,1,2,16,67,92,10,2,61,106,43,61,26,45,8,11,15,69,106
2010-08-15 00:00:00.000,ATP World Tour Masters 1000 Cincinnati OH; U.S.A. ATP World Tour Masters 1000,HARD,2,Alejandro Falla,Gael Monfils,Alejandro Falla,6-3; 6-4,R64,61,3,1,41,60,31,41,10,19,3,4,10,41,60,2,3,33,50,19,33,10,17,1,4,9,29,50
2010-08-15 00:00:00.000,ATP World Tour Masters 1000 Cincinnati OH; U.S.A. ATP World Tour Masters 1000,HARD,2,David Ferrer,Alexandr Dolgopolov,David Ferrer,3-6; 6-3; 6-4,R64,116,3,4,55,83,40,55,16,28,3,5,14,56,83,6,3,58,103,39,58,22,45,7,10,14,61,103
2010-08-15 00:00:00.000,ATP World Tour Masters 1000 Cincinnati OH; U.S.A. ATP World Tour Masters 1000,HARD,2,Sam Querrey,Philipp Petzschner,Sam Querrey,6-1; 6-4,R64,51,7,3,32,48,28,32,7,16,2,3,9,35,48,2,2,22,42,13,22,8,20,1,5,8,21,42
2010-08-15 00:00:00.000,ATP World Tour Masters 1000 Cincinnati OH; U.S.A. ATP World Tour Masters 1000,HARD,2,Robby Ginepri,Somdev Devvarman,Robby Ginepri,6-7(3); 7-6(4); 6-2,R64,155,3,3,74,113,47,74,23,39,8,11,16,70,113,6,3,64,113,48,64,17,49,8,13,16,65,113
2010-08-15 00:00:00.000,ATP World Tour Masters 1000 Cincinnati OH; U.S.A. ATP World Tour Masters 1000,HARD,2,Nikolay Davydenko,N/A Bye,Nikolay Davydenko,,R64,0,0,0,0,0,0,0,0,0,0,0,0,0,0,0,0,0,0,0,0,0,0,0,0,0,0,0
2010-08-15 00:00:00.000,ATP World Tour Masters 1000 Cincinnati OH; U.S.A. ATP World Tour Masters 1000,HARD,2,Fernando Verdasco,N/A Bye,Fernando Verdasco,,R64,0,0,0,0,0,0,0,0,0,0,0,0,0,0,0,0,0,0,0,0,0,0,0,0,0,0,0
2010-08-15 00:00:00.000,ATP World Tour Masters 1000 Cincinnati OH; U.S.A. ATP World Tour Masters 1000,HARD,2,Mardy Fish,Gilles Simon,Mardy Fish,7-6(4); 7-5,R64,104,12,2,43,77,37,43,17,34,2,3,12,54,77,10,1,40,68,32,40,15,28,1,3,12,47,68
2010-08-15 00:00:00.000,ATP World Tour Masters 1000 Cincinnati OH; U.S.A. ATP World Tour Masters 1000,HARD,2,Michael Berrer,Tommy Robredo,Michael Berrer,6-7(4); 6-4; 7-6(8),R64,148,11,3,66,106,53,66,20,40,1,3,17,73,106,7,4,79,113,51,79,24,34,5,8,17,75,113
2010-08-15 00:00:00.000,ATP World Tour Masters 1000 Cincinnati OH; U.S.A. ATP World Tour Masters 1000,HARD,2,Richard Gasquet,Mikhail Youzhny,Richard Gasquet,2-6; 6-4; 6-1,R64,105,8,0,44,70,32,44,17,26,3,5,13,49,70,2,2,44,70,29,44,13,26,2,5,12,42,70
2010-08-15 00:00:00.000,ATP World Tour Masters 1000 Cincinnati OH; U.S.A. ATP World Tour Masters 1000,HARD,2,Jurgen Melzer,Santiago Giraldo,Jurgen Melzer,6-1; 6-4,R64,58,9,1,31,50,25,31,12,19,3,4,9,37,50,4,4,30,52,19,30,6,22,3,7,8,25,52
2010-08-15 00:00:00.000,ATP World Tour Masters 1000 Cincinnati OH; U.S.A. ATP World Tour Masters 1000,HARD,2,Ernests Gulbis,Donald Young,Ernests Gulbis,7-6(5); 6-4,R64,82,11,4,40,64,34,40,13,24,1,3,11,47,64,6,7,40,66,28,40,15,26,0,3,11,43,66
2010-08-15 00:00:00.000,ATP World Tour Masters 1000 Cincinnati OH; U.S.A. ATP World Tour Masters 1000,HARD,2,Jeremy Chardy,Florian Mayer,Jeremy Chardy,6-2; 7-6(4),R64,79,11,5,37,62,30,37,13,25,2,3,10,43,62,6,0,41,72,26,41,14,31,2,5,10,40,72
2010-08-15 00:00:00.000,ATP World Tour Masters 1000 Cincinnati OH; U.S.A. ATP World Tour Masters 1000,HARD,2,Andy Murray,N/A Bye,Andy Murray,,R64,0,0,0,0,0,0,0,0,0,0,0,0,0,0,0,0,0,0,0,0,0,0,0,0,0,0,0
2010-08-15 00:00:00.000,ATP World Tour Masters 1000 Cincinnati OH; U.S.A. ATP World Tour Masters 1000,HARD,2,Robin Soderling,N/A Bye,Robin Soderling,,R64,0,0,0,0,0,0,0,0,0,0,0,0,0,0,0,0,0,0,0,0,0,0,0,0,0,0,0
2010-08-15 00:00:00.000,ATP World Tour Masters 1000 Cincinnati OH; U.S.A. ATP World Tour Masters 1000,HARD,2,Lleyton Hewitt,Yen-Hsun Lu,Lleyton Hewitt,6-4; 4-0 RET,R64,73,7,0,34,48,26,34,7,14,1,1,7,33,48,3,0,28,46,16,28,7,18,2,5,7,23,46
2010-08-15 00:00:00.000,ATP World Tour Masters 1000 Cincinnati OH; U.S.A. ATP World Tour Masters 1000,HARD,2,Thiemo de Bakker,Juan Monaco,Thiemo de Bakker,6-4; 6-7(5); 6-3,R64,144,11,2,56,100,37,56,29,44,3,5,16,66,100,5,1,65,98,44,65,15,33,1,5,15,59,98
2010-08-15 00:00:00.000,ATP World Tour Masters 1000 Cincinnati OH; U.S.A. ATP World Tour Masters 1000,HARD,2,Andy Roddick,Sergiy Stakhovsky,Andy Roddick,6-4; 6-7(5); 6-1,R64,135,10,1,57,90,46,57,22,33,3,3,15,68,90,8,4,66,116,51,66,20,50,9,12,14,71,116
2010-08-15 00:00:00.000,ATP World Tour Masters 1000 Cincinnati OH; U.S.A. ATP World Tour Masters 1000,HARD,2,David Nalbandian,Ivan Ljubicic,David Nalbandian,7-5; 6-0,R64,61,2,0,26,44,20,26,14,18,0,1,9,34,44,9,7,29,48,23,29,1,19,1,6,9,24,48
2010-08-15 00:00:00.000,ATP World Tour Masters 1000 Cincinnati OH; U.S.A. ATP World Tour Masters 1000,HARD,2,John Isner,Lukasz Kubot,John Isner,6-2; 6-3,R64,59,11,0,32,46,26,32,10,14,0,0,9,36,46,1,2,39,50,24,39,3,11,3,6,8,27,50
2010-08-15 00:00:00.000,ATP World Tour Masters 1000 Cincinnati OH; U.S.A. ATP World Tour Masters 1000,HARD,2,Viktor Troicki,Radek Stepanek,Viktor Troicki,7-5; 6-1,R64,60,10,2,29,49,24,29,16,20,0,0,10,40,49,3,3,26,47,18,26,10,21,0,3,9,28,47
2010-08-15 00:00:00.000,ATP World Tour Masters 1000 Cincinnati OH; U.S.A. ATP World Tour Masters 1000,HARD,2,Novak Djokovic,N/A Bye,Novak Djokovic,,R64,0,0,0,0,0,0,0,0,0,0,0,0,0,0,0,0,0,0,0,0,0,0,0,0,0,0,0
2010-08-15 00:00:00.000,ATP World Tour Masters 1000 Cincinnati OH; U.S.A. ATP World Tour Masters 1000,HARD,2,Rafael Nadal,Taylor Dent,Rafael Nadal,6-2; 7-5,R32,84,0,1,36,55,27,36,10,19,1,2,10,37,55,7,4,44,72,30,44,9,28,2,6,10,39,72
2010-08-15 00:00:00.000,ATP World Tour Masters 1000 Cincinnati OH; U.S.A. ATP World Tour Masters 1000,HARD,2,Julien Benneteau,Stanislas Wawrinka,Julien Benneteau,6-4; 6-2,R32,71,6,2,40,62,30,40,12,22,3,3,9,42,62,4,3,25,48,17,25,12,23,4,7,9,29,48
2010-08-15 00:00:00.000,ATP World Tour Masters 1000 Cincinnati OH; U.S.A. ATP World Tour Masters 1000,HARD,2,Marcos Baghdatis,Thomaz Bellucci,Marcos Baghdatis,6-2; 4-6; 7-6(4),R32,128,4,3,50,90,35,50,27,40,4,7,15,62,90,7,2,52,82,34,52,19,30,2,6,15,53,82
2010-08-15 00:00:00.000,ATP World Tour Masters 1000 Cincinnati OH; U.S.A. ATP World Tour Masters 1000,HARD,2,Tomas Berdych,Paul-Henri Mathieu,Tomas Berdych,6-4; 6-4,R32,85,6,1,35,54,27,35,11,19,0,1,10,38,54,6,5,24,56,20,24,13,32,1,4,10,33,56
2010-08-15 00:00:00.000,ATP World Tour Masters 1000 Cincinnati OH; U.S.A. ATP World Tour Masters 1000,HARD,2,Roger Federer,Denis Istomin,Roger Federer,5-2 RET,R32,36,2,1,12,21,11,12,5,9,0,0,4,16,21,1,1,15,23,9,15,3,8,1,2,3,12,23
2010-08-15 00:00:00.000,ATP World Tour Masters 1000 Cincinnati OH; U.S.A. ATP World Tour Masters 1000,HARD,2,Philipp Kohlschreiber,Alejandro Falla,Philipp Kohlschreiber,6-0; 1-6; 6-3,R32,79,3,2,31,58,26,31,12,27,1,3,11,38,58,0,1,43,67,27,43,11,24,5,9,11,38,67
2010-08-15 00:00:00.000,ATP World Tour Masters 1000 Cincinnati OH; U.S.A. ATP World Tour Masters 1000,HARD,2,David Ferrer,Sam Querrey,David Ferrer,7-5; 6-2,R32,88,1,2,47,66,36,47,11,19,5,5,10,47,66,4,3,34,62,26,34,10,28,7,10,10,36,62
2010-08-15 00:00:00.000,ATP World Tour Masters 1000 Cincinnati OH; U.S.A. ATP World Tour Masters 1000,HARD,2,Nikolay Davydenko,Robby Ginepri,Nikolay Davydenko,6-2; 6-7(5); 6-2,R32,134,7,2,57,94,47,57,20,37,3,3,14,67,94,6,3,68,105,41,68,19,37,5,9,14,60,105
2010-08-15 00:00:00.000,ATP World Tour Masters 1000 Cincinnati OH; U.S.A. ATP World Tour Masters 1000,HARD,2,Mardy Fish,Fernando Verdasco,Mardy Fish,7-6(1); 7-6(4),R32,136,10,0,44,85,36,44,28,41,4,4,12,64,85,5,6,61,94,46,61,16,33,5,5,12,62,94
2010-08-15 00:00:00.000,ATP World Tour Masters 1000 Cincinnati OH; U.S.A. ATP World Tour Masters 1000,HARD,2,Richard Gasquet,Michael Berrer,Richard Gasquet,6-4; 6-2,R32,83,9,2,36,54,33,36,6,18,0,0,9,39,54,4,1,44,73,24,44,17,29,11,14,9,41,73
2010-08-15 00:00:00.000,ATP World Tour Masters 1000 Cincinnati OH; U.S.A. ATP World Tour Masters 1000,HARD,2,Ernests Gulbis,Jurgen Melzer,Ernests Gulbis,6-7(8); 6-3; 7-6(5),R32,144,21,7,71,114,57,71,26,43,6,6,17,83,114,13,7,65,99,53,65,20,34,5,6,16,73,99
2010-08-15 00:00:00.000,ATP World Tour Masters 1000 Cincinnati OH; U.S.A. ATP World Tour Masters 1000,HARD,2,Andy Murray,Jeremy Chardy,Andy Murray,6-3; 6-7(3); 6-2,R32,130,8,2,43,85,32,43,25,42,1,4,15,57,85,15,7,48,103,38,48,17,55,8,14,14,55,103
2010-08-15 00:00:00.000,ATP World Tour Masters 1000 Cincinnati OH; U.S.A. ATP World Tour Masters 1000,HARD,2,Robin Soderling,Lleyton Hewitt,Robin Soderling,4-6; 6-3; 7-5,R32,116,15,1,54,90,42,54,19,36,2,4,16,61,90,9,3,47,93,38,47,23,46,4,7,15,61,93
2010-08-15 00:00:00.000,ATP World Tour Masters 1000 Cincinnati OH; U.S.A. ATP World Tour Masters 1000,HARD,2,Andy Roddick,Thiemo de Bakker,Andy Roddick,7-6(4); 6-4,R32,104,8,2,37,60,33,37,15,23,0,0,11,48,60,8,1,43,77,33,43,16,34,2,3,11,49,77
2010-08-15 00:00:00.000,ATP World Tour Masters 1000 Cincinnati OH; U.S.A. ATP World Tour Masters 1000,HARD,2,David Nalbandian,John Isner,David Nalbandian,4-5 RET,R32,36,1,1,14,25,12,14,6,11,0,1,5,18,25,5,0,15,21,12,15,4,6,0,0,4,16,21
2010-08-15 00:00:00.000,ATP World Tour Masters 1000 Cincinnati OH; U.S.A. ATP World Tour Masters 1000,HARD,2,Novak Djokovic,Viktor Troicki,Novak Djokovic,6-3; 7-5,R32,101,3,6,51,80,37,51,14,29,5,7,11,51,80,5,5,34,64,24,34,11,30,0,4,10,35,64
2010-08-15 00:00:00.000,ATP World Tour Masters 1000 Cincinnati OH; U.S.A. ATP World Tour Masters 1000,HARD,2,Rafael Nadal,Julien Benneteau,Rafael Nadal,5-7; 7-6(6); 6-2,R16,168,5,3,65,108,47,65,20,43,7,12,16,67,108,12,10,60,102,39,60,18,42,7,13,16,57,102
2010-08-15 00:00:00.000,ATP World Tour Masters 1000 Cincinnati OH; U.S.A. ATP World Tour Masters 1000,HARD,2,Marcos Baghdatis,Tomas Berdych,Marcos Baghdatis,7-5; 6-4,R16,121,10,3,36,75,30,36,21,39,3,3,11,51,75,6,3,46,80,36,46,13,34,10,12,11,49,80
2010-08-15 00:00:00.000,ATP World Tour Masters 1000 Cincinnati OH; U.S.A. ATP World Tour Masters 1000,HARD,2,Roger Federer,Philipp Kohlschreiber,Roger Federer,W/O,R16,0,0,0,0,0,0,0,0,0,0,0,0,0,0,0,0,0,0,0,0,0,0,0,0,0,0,0
2010-08-15 00:00:00.000,ATP World Tour Masters 1000 Cincinnati OH; U.S.A. ATP World Tour Masters 1000,HARD,2,Nikolay Davydenko,David Ferrer,Nikolay Davydenko,4-6; 6-3; 7-5,R16,137,4,2,59,95,41,59,14,36,5,10,16,55,95,3,2,56,89,32,56,16,33,3,9,15,48,89
2010-08-15 00:00:00.000,ATP World Tour Masters 1000 Cincinnati OH; U.S.A. ATP World Tour Masters 1000,HARD,2,Mardy Fish,Richard Gasquet,Mardy Fish,7-5; 6-2,R16,70,18,2,32,48,30,32,10,16,0,0,10,40,48,3,1,34,54,20,34,14,20,3,6,10,34,54
2010-08-15 00:00:00.000,ATP World Tour Masters 1000 Cincinnati OH; U.S.A. ATP World Tour Masters 1000,HARD,2,Andy Murray,Ernests Gulbis,Andy Murray,4-6; 6-3; 7-6(4),R16,154,3,1,66,107,52,66,19,41,6,9,16,71,107,7,7,56,96,43,56,19,40,3,6,15,62,96
2010-08-15 00:00:00.000,ATP World Tour Masters 1000 Cincinnati OH; U.S.A. ATP World Tour Masters 1000,HARD,2,Andy Roddick,Robin Soderling,Andy Roddick,6-4; 6-7(7); 7-6(5),R16,164,26,4,64,107,51,64,27,43,0,1,17,78,107,15,8,79,139,58,79,31,60,10,12,17,89,139
2010-08-15 00:00:00.000,ATP World Tour Masters 1000 Cincinnati OH; U.S.A. ATP World Tour Masters 1000,HARD,2,Novak Djokovic,David Nalbandian,Novak Djokovic,6-1; 7-6(7),R16,97,2,3,46,69,33,46,9,23,5,8,10,42,69,3,5,43,62,25,43,6,19,1,6,9,31,62
2010-08-15 00:00:00.000,ATP World Tour Masters 1000 Cincinnati OH; U.S.A. ATP World Tour Masters 1000,HARD,2,Marcos Baghdatis,Rafael Nadal,Marcos Baghdatis,6-4; 4-6; 6-4,Q,152,18,4,54,87,47,54,14,33,6,8,15,61,87,4,3,60,97,43,60,18,37,4,7,15,61,97
2010-08-15 00:00:00.000,ATP World Tour Masters 1000 Cincinnati OH; U.S.A. ATP World Tour Masters 1000,HARD,2,Roger Federer,Nikolay Davydenko,Roger Federer,6-4; 7-5,Q,99,12,1,41,71,32,41,14,30,3,4,11,46,71,5,1,54,84,29,54,18,30,8,11,11,47,84
2010-08-15 00:00:00.000,ATP World Tour Masters 1000 Cincinnati OH; U.S.A. ATP World Tour Masters 1000,HARD,2,Mardy Fish,Andy Murray,Mardy Fish,6-7(7); 6-1; 7-6(5),Q,176,13,1,64,120,50,64,30,56,4,4,15,80,120,8,2,60,108,42,60,28,48,5,8,16,70,108
2010-08-15 00:00:00.000,ATP World Tour Masters 1000 Cincinnati OH; U.S.A. ATP World Tour Masters 1000,HARD,2,Andy Roddick,Novak Djokovic,Andy Roddick,6-4; 7-5,Q,83,8,4,35,61,29,35,14,26,2,3,11,43,61,5,2,37,62,22,37,16,25,3,6,11,38,62
2010-08-15 00:00:00.000,ATP World Tour Masters 1000 Cincinnati OH; U.S.A. ATP World Tour Masters 1000,HARD,2,Roger Federer,Marcos Baghdatis,Roger Federer,6-4; 6-3,S,71,7,2,30,51,27,30,13,21,0,0,10,40,51,3,1,23,58,12,23,22,35,0,2,9,34,58
2010-08-15 00:00:00.000,ATP World Tour Masters 1000 Cincinnati OH; U.S.A. ATP World Tour Masters 1000,HARD,2,Mardy Fish,Andy Roddick,Mardy Fish,4-6; 7-6(3); 6-1,S,136,17,6,43,93,39,43,25,50,2,4,15,64,93,11,4,61,101,41,61,19,40,5,8,14,60,101
2010-08-15 00:00:00.000,ATP World Tour Masters 1000 Cincinnati OH; U.S.A. ATP World Tour Masters 1000,HARD,2,Roger Federer,Mardy Fish,Roger Federer,6-7(5); 7-6(1); 6-4,F,160,11,1,70,110,54,70,27,40,1,1,17,81,110,17,3,72,128,52,72,32,56,4,5,17,84,128
2010-08-22 00:00:00.000,New Haven CT; U.S.A. ATP World Tour 250,HARD,2,Marcos Baghdatis,N/A Bye,Marcos Baghdatis,,R64,0,0,0,0,0,0,0,0,0,0,0,0,0,0,0,0,0,0,0,0,0,0,0,0,0,0,0
2010-08-22 00:00:00.000,New Haven CT; U.S.A. ATP World Tour 250,HARD,2,Igor Andreev,Arnaud Clement,Igor Andreev,7-6(2); 6-3,R64,112,7,3,41,82,33,41,21,41,4,5,11,54,82,4,3,38,73,25,38,19,35,3,5,10,44,73
2010-08-22 00:00:00.000,New Haven CT; U.S.A. ATP World Tour 250,HARD,2,Donald Young,Stephane Robert,Donald Young,6-1; 6-2,R64,56,1,1,28,43,24,28,9,15,3,3,8,33,43,0,2,18,36,10,18,8,18,1,5,7,18,36
2010-08-22 00:00:00.000,New Haven CT; U.S.A. ATP World Tour 250,HARD,2,Juan Ignacio Chela,N/A Bye,Juan Ignacio Chela,,R64,0,0,0,0,0,0,0,0,0,0,0,0,0,0,0,0,0,0,0,0,0,0,0,0,0,0,0
2010-08-22 00:00:00.000,New Haven CT; U.S.A. ATP World Tour 250,HARD,2,Sergiy Stakhovsky,N/A Bye,Sergiy Stakhovsky,,R64,0,0,0,0,0,0,0,0,0,0,0,0,0,0,0,0,0,0,0,0,0,0,0,0,0,0,0
2010-08-22 00:00:00.000,New Haven CT; U.S.A. ATP World Tour 250,HARD,2,Peter Luczak,Leonardo Mayer,Peter Luczak,6-3; 7-6(4),R64,115,0,1,31,62,22,31,20,31,0,1,10,42,62,5,6,44,78,29,44,17,34,3,6,11,46,78
2010-08-22 00:00:00.000,New Haven CT; U.S.A. ATP World Tour 250,HARD,2,Taylor Dent,Eduardo Schwank,Taylor Dent,7-6(1); 4-6; 6-0,R64,120,11,6,69,107,48,69,20,38,10,13,14,68,107,4,10,50,93,36,50,14,43,5,10,14,50,93
2010-08-22 00:00:00.000,New Haven CT; U.S.A. ATP World Tour 250,HARD,2,Tommy Robredo,N/A Bye,Tommy Robredo,,R64,0,0,0,0,0,0,0,0,0,0,0,0,0,0,0,0,0,0,0,0,0,0,0,0,0,0,0
2010-08-22 00:00:00.000,New Haven CT; U.S.A. ATP World Tour 250,HARD,2,Philip Bester,N/A Bye,Philip Bester,,R64,0,0,0,0,0,0,0,0,0,0,0,0,0,0,0,0,0,0,0,0,0,0,0,0,0,0,0
2010-08-22 00:00:00.000,New Haven CT; U.S.A. ATP World Tour 250,HARD,2,Illya Marchenko,Andreas Beck,Illya Marchenko,6-7(4); 6-3; 6-3,R64,138,9,3,55,86,40,55,17,31,3,6,15,57,86,0,6,53,104,33,53,25,51,5,11,15,58,104
2010-08-22 00:00:00.000,New Haven CT; U.S.A. ATP World Tour 250,HARD,2,Evgeny Korolev,Frederico Gil,Evgeny Korolev,6-4; 6-2,R64,83,0,4,32,60,19,32,17,28,3,5,9,36,60,1,0,46,65,24,46,9,19,11,16,9,33,65
2010-08-22 00:00:00.000,New Haven CT; U.S.A. ATP World Tour 250,HARD,2,Michael Berrer,N/A Bye,Michael Berrer,,R64,0,0,0,0,0,0,0,0,0,0,0,0,0,0,0,0,0,0,0,0,0,0,0,0,0,0,0
2010-08-22 00:00:00.000,New Haven CT; U.S.A. ATP World Tour 250,HARD,2,Thiemo de Bakker,N/A Bye,Thiemo de Bakker,,R64,0,0,0,0,0,0,0,0,0,0,0,0,0,0,0,0,0,0,0,0,0,0,0,0,0,0,0
2010-08-22 00:00:00.000,New Haven CT; U.S.A. ATP World Tour 250,HARD,2,Mikhail Kukushkin,Simon Greul,Mikhail Kukushkin,6-3; 6-4,R64,84,2,4,24,53,17,24,14,29,3,6,9,31,53,2,6,27,59,14,27,12,32,1,7,10,26,59
2010-08-22 00:00:00.000,New Haven CT; U.S.A. ATP World Tour 250,HARD,2,Jan Hajek,Dustin Brown,Jan Hajek,7-5; 6-3,R64,77,2,2,55,79,36,55,15,24,8,9,11,51,79,9,1,31,60,22,31,13,29,1,4,10,35,60
2010-08-22 00:00:00.000,New Haven CT; U.S.A. ATP World Tour 250,HARD,2,Florian Mayer,N/A Bye,Florian Mayer,,R64,0,0,0,0,0,0,0,0,0,0,0,0,0,0,0,0,0,0,0,0,0,0,0,0,0,0,0
2010-08-22 00:00:00.000,New Haven CT; U.S.A. ATP World Tour 250,HARD,2,Alexandr Dolgopolov,N/A Bye,Alexandr Dolgopolov,,R64,0,0,0,0,0,0,0,0,0,0,0,0,0,0,0,0,0,0,0,0,0,0,0,0,0,0,0
2010-08-22 00:00:00.000,New Haven CT; U.S.A. ATP World Tour 250,HARD,2,James Blake,Pere Riba,James Blake,6-0; 6-1,R64,36,4,1,20,35,17,20,11,15,0,0,7,28,35,0,4,18,36,8,18,4,18,6,11,6,12,36
2010-08-22 00:00:00.000,New Haven CT; U.S.A. ATP World Tour 250,HARD,2,Jarkko Nieminen,Andreas Seppi,Jarkko Nieminen,6-3; 6-4,R64,69,4,1,35,54,29,35,12,19,0,0,10,41,54,4,3,36,61,27,36,11,25,2,4,9,38,61
2010-08-22 00:00:00.000,New Haven CT; U.S.A. ATP World Tour 250,HARD,2,Viktor Troicki,N/A Bye,Viktor Troicki,,R64,0,0,0,0,0,0,0,0,0,0,0,0,0,0,0,0,0,0,0,0,0,0,0,0,0,0,0
2010-08-22 00:00:00.000,New Haven CT; U.S.A. ATP World Tour 250,HARD,2,Victor Hanescu,N/A Bye,Victor Hanescu,,R64,0,0,0,0,0,0,0,0,0,0,0,0,0,0,0,0,0,0,0,0,0,0,0,0,0,0,0
2010-08-22 00:00:00.000,New Haven CT; U.S.A. ATP World Tour 250,HARD,2,Daniel Brands,Lukasz Kubot,Daniel Brands,6-4; 2-6; 7-5,R64,117,6,4,49,79,34,49,20,30,0,3,15,54,79,1,6,69,103,45,69,18,34,5,8,15,63,103
2010-08-22 00:00:00.000,New Haven CT; U.S.A. ATP World Tour 250,HARD,2,Radek Stepanek,Pablo Cuevas,Radek Stepanek,6-0; 6-4,R64,74,0,1,33,57,21,33,12,24,6,8,8,33,57,2,3,19,45,10,19,9,26,3,9,8,19,45
2010-08-22 00:00:00.000,New Haven CT; U.S.A. ATP World Tour 250,HARD,2,Fernando Gonzalez,N/A Bye,Fernando Gonzalez,,R64,0,0,0,0,0,0,0,0,0,0,0,0,0,0,0,0,0,0,0,0,0,0,0,0,0,0,0
2010-08-22 00:00:00.000,New Haven CT; U.S.A. ATP World Tour 250,HARD,2,Andrey Golubev,N/A Bye,Andrey Golubev,,R64,0,0,0,0,0,0,0,0,0,0,0,0,0,0,0,0,0,0,0,0,0,0,0,0,0,0,0
2010-08-22 00:00:00.000,New Haven CT; U.S.A. ATP World Tour 250,HARD,2,Maximo Gonzalez,Horacio Zeballos,Maximo Gonzalez,6-3; 6-4,R64,75,3,1,34,56,29,34,15,22,3,3,10,44,56,4,1,39,60,32,39,4,21,6,8,9,36,60
2010-08-22 00:00:00.000,New Haven CT; U.S.A. ATP World Tour 250,HARD,2,Teymuraz Gabashvili,Potito Starace,Teymuraz Gabashvili,7-6(3); 7-5,R64,104,4,3,41,78,32,41,16,37,2,6,12,48,78,5,2,57,84,32,57,11,27,6,11,12,43,84
2010-08-22 00:00:00.000,New Haven CT; U.S.A. ATP World Tour 250,HARD,2,Xavier Malisse,N/A Bye,Xavier Malisse,,R64,0,0,0,0,0,0,0,0,0,0,0,0,0,0,0,0,0,0,0,0,0,0,0,0,0,0,0
2010-08-22 00:00:00.000,New Haven CT; U.S.A. ATP World Tour 250,HARD,2,Denis Istomin,N/A Bye,Denis Istomin,,R64,0,0,0,0,0,0,0,0,0,0,0,0,0,0,0,0,0,0,0,0,0,0,0,0,0,0,0
2010-08-22 00:00:00.000,New Haven CT; U.S.A. ATP World Tour 250,HARD,2,Benjamin Becker,Marco Chiudinelli,Benjamin Becker,7-6(3); 6-3,R64,85,11,3,45,81,35,45,19,36,5,6,11,54,81,5,4,35,58,27,35,12,23,2,4,10,39,58
2010-08-22 00:00:00.000,New Haven CT; U.S.A. ATP World Tour 250,HARD,2,Lukas Lacko,Florent Serra,Lukas Lacko,6-1; 7-6(6),R64,79,9,0,30,55,26,30,10,25,2,4,9,36,55,1,4,38,77,23,38,16,39,7,12,10,39,77
2010-08-22 00:00:00.000,New Haven CT; U.S.A. ATP World Tour 250,HARD,2,Thomaz Bellucci,N/A Bye,Thomaz Bellucci,,R64,0,0,0,0,0,0,0,0,0,0,0,0,0,0,0,0,0,0,0,0,0,0,0,0,0,0,0
2010-08-22 00:00:00.000,New Haven CT; U.S.A. ATP World Tour 250,HARD,2,Marcos Baghdatis,Igor Andreev,Marcos Baghdatis,6-2; 6-4,R32,94,1,5,24,58,20,24,18,34,3,4,9,38,58,2,6,28,62,16,28,15,34,5,9,9,31,62
2010-08-22 00:00:00.000,New Haven CT; U.S.A. ATP World Tour 250,HARD,2,Juan Ignacio Chela,Donald Young,Juan Ignacio Chela,5-7; 6-4; 6-0,R32,121,4,3,41,75,25,41,23,34,4,8,14,48,75,0,5,56,93,28,56,18,37,9,16,14,46,93
2010-08-22 00:00:00.000,New Haven CT; U.S.A. ATP World Tour 250,HARD,2,Sergiy Stakhovsky,Peter Luczak,Sergiy Stakhovsky,2-6; 7-6(5); 7-6(1),R32,188,11,6,66,119,48,66,31,53,1,4,16,79,119,2,4,76,123,55,76,23,47,9,10,16,78,123
2010-08-22 00:00:00.000,New Haven CT; U.S.A. ATP World Tour 250,HARD,2,Tommy Robredo,Taylor Dent,Tommy Robredo,5-7; 6-4; 6-4,R32,131,1,5,54,98,39,54,27,44,5,7,16,66,98,5,9,56,98,43,56,22,42,2,5,16,65,98
2010-08-22 00:00:00.000,New Haven CT; U.S.A. ATP World Tour 250,HARD,2,Illya Marchenko,Philip Bester,Illya Marchenko,6-3; 6-3,R32,81,3,1,32,52,26,32,10,20,2,3,9,36,52,3,1,46,71,31,46,5,25,5,9,9,36,71
2010-08-22 00:00:00.000,New Haven CT; U.S.A. ATP World Tour 250,HARD,2,Evgeny Korolev,Michael Berrer,Evgeny Korolev,6-4; 7-5,R32,108,2,2,47,81,30,47,21,34,11,13,11,51,81,4,2,51,84,33,51,13,33,8,12,11,46,84
2010-08-22 00:00:00.000,New Haven CT; U.S.A. ATP World Tour 250,HARD,2,Thiemo de Bakker,Mikhail Kukushkin,Thiemo de Bakker,6-1; 6-7(6); 6-4,R32,147,15,4,55,94,39,55,21,39,1,4,15,60,94,1,4,39,92,27,39,24,53,3,9,14,51,92
2010-08-22 00:00:00.000,New Haven CT; U.S.A. ATP World Tour 250,HARD,2,Florian Mayer,Jan Hajek,Florian Mayer,6-3; 6-1,R32,51,4,2,26,41,20,26,10,15,0,1,8,30,41,0,1,31,54,17,31,9,23,5,10,8,26,54
2010-08-22 00:00:00.000,New Haven CT; U.S.A. ATP World Tour 250,HARD,2,Alexandr Dolgopolov,James Blake,Alexandr Dolgopolov,6-4; 6-2,R32,64,4,3,22,62,19,22,22,40,5,6,9,41,62,2,1,32,61,14,32,18,29,7,11,9,32,61
2010-08-22 00:00:00.000,New Haven CT; U.S.A. ATP World Tour 250,HARD,2,Viktor Troicki,Jarkko Nieminen,Viktor Troicki,7-5; 6-3,R32,70,8,1,40,58,33,40,11,18,0,0,10,44,58,1,2,39,59,28,39,12,20,3,6,11,40,59
2010-08-22 00:00:00.000,New Haven CT; U.S.A. ATP World Tour 250,HARD,2,Victor Hanescu,Daniel Brands,Victor Hanescu,6-3; 6-4,R32,72,5,1,42,61,30,42,15,19,6,6,10,45,61,4,5,32,58,24,32,11,26,3,5,9,35,58
2010-08-22 00:00:00.000,New Haven CT; U.S.A. ATP World Tour 250,HARD,2,Radek Stepanek,Fernando Gonzalez,Radek Stepanek,6-2; 6-4,R32,70,4,3,39,58,27,39,12,19,4,5,9,39,58,2,2,33,54,23,33,7,21,4,8,9,30,54
2010-08-22 00:00:00.000,New Haven CT; U.S.A. ATP World Tour 250,HARD,2,Andrey Golubev,Maximo Gonzalez,Andrey Golubev,6-3; 2-6; 6-2,R32,127,4,7,54,102,36,54,23,48,5,8,13,59,102,1,3,51,81,32,51,14,30,7,11,12,46,81
2010-08-22 00:00:00.000,New Haven CT; U.S.A. ATP World Tour 250,HARD,2,Teymuraz Gabashvili,Xavier Malisse,Teymuraz Gabashvili,4-2 RET,R32,21,1,1,7,18,7,7,8,11,0,0,3,15,18,2,1,10,15,9,10,1,5,1,2,3,10,15
2010-08-22 00:00:00.000,New Haven CT; U.S.A. ATP World Tour 250,HARD,2,Denis Istomin,Benjamin Becker,Denis Istomin,6-3; 6-1,R32,55,6,1,24,45,19,24,14,21,0,0,8,33,45,1,5,28,48,16,28,7,20,5,9,8,23,48
2010-08-22 00:00:00.000,New Haven CT; U.S.A. ATP World Tour 250,HARD,2,Lukas Lacko,Thomaz Bellucci,Lukas Lacko,6-4; 6-7(4); 6-0,R32,143,5,2,55,100,42,55,26,45,5,5,14,68,100,9,5,41,83,30,41,22,42,1,5,14,52,83
2010-08-22 00:00:00.000,New Haven CT; U.S.A. ATP World Tour 250,HARD,2,Marcos Baghdatis,Juan Ignacio Chela,Marcos Baghdatis,1-6; 6-3; 6-2,R16,86,6,2,39,72,29,39,13,33,2,6,12,42,72,2,2,35,62,23,35,12,27,4,9,12,35,62
2010-08-22 00:00:00.000,New Haven CT; U.S.A. ATP World Tour 250,HARD,2,Sergiy Stakhovsky,Tommy Robredo,Sergiy Stakhovsky,7-6(5); 6-2,R16,63,5,2,60,77,42,60,6,17,6,8,10,48,77,2,4,40,68,26,40,11,28,4,8,10,37,68
2010-08-22 00:00:00.000,New Haven CT; U.S.A. ATP World Tour 250,HARD,2,Evgeny Korolev,Illya Marchenko,Evgeny Korolev,7-6(5); 6-4,R16,108,1,3,43,75,28,43,13,32,6,10,11,41,75,0,5,35,72,23,35,16,37,6,11,11,39,72
2010-08-22 00:00:00.000,New Haven CT; U.S.A. ATP World Tour 250,HARD,2,Thiemo de Bakker,Florian Mayer,Thiemo de Bakker,6-7(2); 6-1; 7-5,R16,124,9,4,63,100,48,63,22,37,3,4,16,70,100,5,2,50,92,36,50,23,42,3,7,15,59,92
2010-08-22 00:00:00.000,New Haven CT; U.S.A. ATP World Tour 250,HARD,2,Viktor Troicki,Alexandr Dolgopolov,Viktor Troicki,6-7(4); 7-6(1); 6-2,R16,122,10,6,68,104,54,68,21,36,5,5,16,75,104,13,6,55,102,40,55,30,47,6,8,16,70,102
2010-08-22 00:00:00.000,New Haven CT; U.S.A. ATP World Tour 250,HARD,2,Radek Stepanek,Victor Hanescu,Radek Stepanek,7-6(4); 6-7(4); 6-4,R16,160,6,4,67,109,51,67,27,42,1,1,17,78,109,17,2,88,127,67,88,18,39,5,6,17,85,127
2010-08-22 00:00:00.000,New Haven CT; U.S.A. ATP World Tour 250,HARD,2,Teymuraz Gabashvili,Andrey Golubev,Teymuraz Gabashvili,6-3; 3-6; 7-6(7),R16,156,1,4,69,122,48,69,27,53,11,13,15,75,122,6,4,66,108,48,66,23,42,5,7,15,71,108
2010-08-22 00:00:00.000,New Haven CT; U.S.A. ATP World Tour 250,HARD,2,Denis Istomin,Lukas Lacko,Denis Istomin,6-2; 2-6; 6-3,R16,104,14,2,46,75,32,46,18,29,3,6,13,50,75,4,4,37,79,22,37,23,42,9,13,12,45,79
2010-08-22 00:00:00.000,New Haven CT; U.S.A. ATP World Tour 250,HARD,2,Sergiy Stakhovsky,Marcos Baghdatis,Sergiy Stakhovsky,5-7; 6-1; 7-6(4),Q,142,9,4,77,122,51,77,22,45,12,15,16,73,122,10,5,52,100,37,52,22,48,7,11,15,59,100
2010-08-22 00:00:00.000,New Haven CT; U.S.A. ATP World Tour 250,HARD,2,Thiemo de Bakker,Evgeny Korolev,Thiemo de Bakker,6-4; 6-3,Q,82,5,0,25,48,21,25,13,23,2,3,9,34,48,2,3,44,72,29,44,10,28,9,13,10,39,72
2010-08-22 00:00:00.000,New Haven CT; U.S.A. ATP World Tour 250,HARD,2,Viktor Troicki,Radek Stepanek,Viktor Troicki,6-2; 6-3,Q,66,8,5,28,52,19,28,10,24,3,6,8,29,52,3,7,29,50,12,29,7,21,5,12,9,19,50
2010-08-22 00:00:00.000,New Haven CT; U.S.A. ATP World Tour 250,HARD,2,Denis Istomin,Teymuraz Gabashvili,Denis Istomin,6-1; 3-6; 7-6(8),Q,138,13,3,58,99,46,58,16,41,6,9,14,62,99,5,3,56,96,39,56,17,40,9,13,14,56,96
2010-08-22 00:00:00.000,New Haven CT; U.S.A. ATP World Tour 250,HARD,2,Sergiy Stakhovsky,Thiemo de Bakker,Sergiy Stakhovsky,6-3; 6-4,S,82,7,0,29,50,25,29,15,21,0,0,10,40,50,8,1,39,69,29,39,11,30,3,5,9,40,69
2010-08-22 00:00:00.000,New Haven CT; U.S.A. ATP World Tour 250,HARD,2,Denis Istomin,Viktor Troicki,Denis Istomin,7-6(10); 3-6; 6-2,S,129,8,0,57,89,35,57,18,32,3,8,14,53,89,8,4,56,102,41,56,18,46,4,10,15,59,102
2010-08-22 00:00:00.000,New Haven CT; U.S.A. ATP World Tour 250,HARD,2,Sergiy Stakhovsky,Denis Istomin,Sergiy Stakhovsky,3-6; 6-3; 6-4,F,103,7,1,55,79,45,55,14,24,2,3,14,59,79,4,2,50,74,40,50,11,24,0,2,14,51,74
2010-08-30 00:00:00.000,US Open NY; U.S.A. Grand Slams,HARD,3,Rafael Nadal,Teymuraz Gabashvili,Rafael Nadal,7-6(4); 7-6(4); 6-3,R128,177,7,3,69,103,54,69,24,34,1,1,16,78,103,7,2,83,121,59,83,19,38,8,10,17,78,121
2010-08-30 00:00:00.000,US Open NY; U.S.A. Grand Slams,HARD,3,Denis Istomin,Maximo Gonzalez,Denis Istomin,7-5; 7-5; 6-1,R128,139,6,2,47,96,37,47,24,49,4,7,16,61,96,0,3,63,97,32,63,14,34,7,14,15,46,97
2010-08-30 00:00:00.000,US Open NY; U.S.A. Grand Slams,HARD,3,Gilles Simon,Donald Young,Gilles Simon,6-1; 6-4; 6-2,R128,81,9,1,32,71,28,32,27,39,2,2,13,55,71,4,5,36,66,22,36,13,30,2,7,12,35,66
2010-08-30 00:00:00.000,US Open NY; U.S.A. Grand Slams,HARD,3,Philipp Kohlschreiber,Tobias Kamke,Philipp Kohlschreiber,6-2; 4-6; 6-2; 6-4,R128,152,11,3,61,103,46,61,23,42,7,10,18,69,103,0,15,68,126,44,68,25,58,14,21,18,69,126
2010-08-30 00:00:00.000,US Open NY; U.S.A. Grand Slams,HARD,3,Feliciano Lopez,Santiago Giraldo,Feliciano Lopez,6-4; 6-4; 6-4,R128,125,16,5,47,88,42,47,24,41,6,6,15,66,88,3,0,46,80,30,46,24,34,2,5,15,54,80
2010-08-30 00:00:00.000,US Open NY; U.S.A. Grand Slams,HARD,3,Benoit Paire,Rainer Schuettler,Benoit Paire,6-3; 6-3; 4-6; 3-6; 7-6(2),R128,212,13,9,80,167,58,80,42,87,7,13,24,100,167,5,9,96,165,63,96,34,69,7,14,25,97,165
2010-08-30 00:00:00.000,US Open NY; U.S.A. Grand Slams,HARD,3,Sergiy Stakhovsky,Peter Luczak,Sergiy Stakhovsky,6-7(8); 7-5; 6-4; 6-2,R128,223,29,3,82,141,66,82,30,59,6,8,21,96,141,2,2,87,133,59,87,24,46,10,16,21,83,133
2010-08-30 00:00:00.000,US Open NY; U.S.A. Grand Slams,HARD,3,Ryan Harrison,Ivan Ljubicic,Ryan Harrison,6-3; 6-7(4); 6-3; 6-4,R128,187,13,3,79,128,52,79,38,49,3,4,21,90,128,16,8,65,138,47,65,35,73,11,15,19,82,138
2010-08-30 00:00:00.000,US Open NY; U.S.A. Grand Slams,HARD,3,David Ferrer,Alexandr Dolgopolov,David Ferrer,6-2; 6-2; 6-3,R128,86,6,3,46,78,33,46,21,32,7,8,12,54,78,8,10,31,73,20,31,17,42,1,8,13,37,73
2010-08-30 00:00:00.000,US Open NY; U.S.A. Grand Slams,HARD,3,Benjamin Becker,Daniel Brands,Benjamin Becker,7-6(1); 7-6(5); 6-4,R128,138,17,7,61,109,47,61,26,48,3,5,17,73,109,12,9,63,116,49,63,23,53,6,9,17,72,116
2010-08-30 00:00:00.000,US Open NY; U.S.A. Grand Slams,HARD,3,Daniel Gimeno-Traver,Jarkko Nieminen,Daniel Gimeno-Traver,7-6(1); 6-4; 6-3,R128,126,6,6,59,106,44,59,28,47,9,10,16,72,106,8,3,55,89,42,55,15,34,5,8,15,57,89
2010-08-30 00:00:00.000,US Open NY; U.S.A. Grand Slams,HARD,3,Jeremy Chardy,Ernests Gulbis,Jeremy Chardy,6-2; 7-6(1); 6-4,R128,127,18,5,58,100,49,58,24,42,8,8,15,73,100,10,9,52,86,39,52,16,34,2,5,15,55,86
2010-08-30 00:00:00.000,US Open NY; U.S.A. Grand Slams,HARD,3,David Nalbandian,Rik De Voest,David Nalbandian,7-6(4); 3-6; 6-4; 6-7(6); 6-4,R128,239,7,8,93,171,72,93,42,78,6,10,27,114,171,8,3,117,179,81,117,31,62,5,9,26,112,179
2010-08-30 00:00:00.000,US Open NY; U.S.A. Grand Slams,HARD,3,Florent Serra,Florian Mayer,Florent Serra,7-5; 6-2; 6-0,R128,107,4,3,44,88,33,44,29,44,5,5,13,62,88,9,4,59,96,34,59,16,37,5,11,13,50,96
2010-08-30 00:00:00.000,US Open NY; U.S.A. Grand Slams,HARD,3,Adrian Mannarino,Pere Riba,Adrian Mannarino,3-6; 6-1; 6-4; 4-6; 7-6(1),R128,228,10,6,95,159,70,95,27,64,8,13,24,97,159,15,4,79,147,56,79,34,68,9,15,24,90,147
2010-08-30 00:00:00.000,US Open NY; U.S.A. Grand Slams,HARD,3,Fernando Verdasco,Fabio Fognini,Fernando Verdasco,1-6; 7-5; 6-1; 4-6; 6-3,R128,200,13,11,73,127,54,73,21,54,10,17,22,75,127,3,11,107,184,66,107,33,77,16,25,23,99,184
2010-08-30 00:00:00.000,US Open NY; U.S.A. Grand Slams,HARD,3,Andy Murray,Lukas Lacko,Andy Murray,6-3; 6-2; 6-2,R128,111,9,3,46,77,35,46,18,31,1,2,13,53,77,5,7,46,82,31,46,10,36,8,14,12,41,82
2010-08-30 00:00:00.000,US Open NY; U.S.A. Grand Slams,HARD,3,Dustin Brown,Ruben Ramirez Hidalgo,Dustin Brown,6-4; 7-6(6); 7-5,R128,149,21,9,47,97,41,47,32,50,3,4,17,73,97,8,7,58,115,45,58,27,57,2,5,17,72,115
2010-08-30 00:00:00.000,US Open NY; U.S.A. Grand Slams,HARD,3,Juan Ignacio Chela,Yen-Hsun Lu,Juan Ignacio Chela,6-4; 4-6; 6-3; 6-3,R128,182,5,4,66,109,55,66,20,43,4,7,19,75,109,12,7,70,132,44,70,31,62,11,17,19,75,132
2010-08-30 00:00:00.000,US Open NY; U.S.A. Grand Slams,HARD,3,Stanislas Wawrinka,Mikhail Kukushkin,Stanislas Wawrinka,6-3; 6-2; 6-2,R128,107,10,4,40,67,35,40,18,27,0,0,13,53,67,3,6,52,97,28,52,22,45,8,13,12,50,97
2010-08-30 00:00:00.000,US Open NY; U.S.A. Grand Slams,HARD,3,Sam Querrey,Bradley Klahn,Sam Querrey,6-3; 4-6; 7-5; 6-4,R128,149,19,11,57,112,50,57,27,55,8,11,20,77,112,6,7,91,131,63,91,16,40,9,16,21,79,131
2010-08-30 00:00:00.000,US Open NY; U.S.A. Grand Slams,HARD,3,Marcel Granollers,Andreas Seppi,Marcel Granollers,2-6; 5-7; 6-3; 6-2; 6-3,R128,186,12,8,79,136,60,79,30,57,5,8,23,90,136,5,7,77,149,53,77,36,72,4,10,23,89,149
2010-08-30 00:00:00.000,US Open NY; U.S.A. Grand Slams,HARD,3,Guillermo Garcia-Lopez,Lukasz Kubot,Guillermo Garcia-Lopez,6-3; 6-2; 7-6(4),R128,133,9,2,56,88,42,56,20,32,7,9,15,62,88,3,6,61,99,35,61,18,38,9,14,14,53,99
2010-08-30 00:00:00.000,US Open NY; U.S.A. Grand Slams,HARD,3,Nicolas Almagro,Potito Starace,Nicolas Almagro,4-6; 6-4; 6-4; 7-6(5),R128,158,31,4,75,122,58,75,25,47,3,6,21,83,122,4,1,91,135,59,91,25,44,6,10,21,84,135
2010-08-30 00:00:00.000,US Open NY; U.S.A. Grand Slams,HARD,3,Mikhail Youzhny,Andrey Golubev,Mikhail Youzhny,6-2; 6-3; 6-3,R128,97,4,4,33,64,25,33,24,31,0,1,13,49,64,1,4,35,77,22,35,19,42,3,9,13,41,77
2010-08-30 00:00:00.000,US Open NY; U.S.A. Grand Slams,HARD,3,Dudi Sela,Xavier Malisse,Dudi Sela,7-6(1); 7-5; 6-2,R128,138,5,4,59,108,41,59,24,49,2,7,16,65,108,7,5,53,117,30,53,26,64,8,16,16,56,117
2010-08-30 00:00:00.000,US Open NY; U.S.A. Grand Slams,HARD,3,Marco Chiudinelli,Jack Sock,Marco Chiudinelli,6-1; 6-4; 1-6; 6-1,R128,134,4,5,42,92,33,42,31,50,1,3,16,64,92,4,7,49,89,31,49,23,40,6,11,15,54,89
2010-08-30 00:00:00.000,US Open NY; U.S.A. Grand Slams,HARD,3,John Isner,Frederico Gil,John Isner,6-4; 6-3; 6-4,R128,117,19,4,51,80,47,51,15,29,0,0,15,62,80,7,1,70,102,48,70,15,32,16,19,14,63,102
2010-08-30 00:00:00.000,US Open NY; U.S.A. Grand Slams,HARD,3,Julien Benneteau,Radek Stepanek,Julien Benneteau,6-4; 6-2; 4-6; 6-4,R128,187,23,11,76,124,59,76,22,48,9,12,19,81,124,8,5,68,115,48,68,23,47,8,13,19,71,115
2010-08-30 00:00:00.000,US Open NY; U.S.A. Grand Slams,HARD,3,Tommy Robredo,Lukas Rosol,Tommy Robredo,6-4; 6-3; 6-1,R128,107,2,2,45,71,38,45,17,26,1,1,13,55,71,2,6,51,94,35,51,16,43,13,18,13,51,94
2010-08-30 00:00:00.000,US Open NY; U.S.A. Grand Slams,HARD,3,Victor Hanescu,Carlos Berlocq,Victor Hanescu,6-2; 6-4; 6-3,R128,109,2,5,53,83,35,53,14,30,4,8,13,49,83,2,6,47,80,22,47,14,33,1,10,14,36,80
2010-08-30 00:00:00.000,US Open NY; U.S.A. Grand Slams,HARD,3,Michael Llodra,Tomas Berdych,Michael Llodra,7-6(3); 6-4; 6-4,R128,146,5,2,54,99,46,54,29,45,3,3,16,75,99,7,5,50,93,39,50,28,43,6,8,16,67,93
2010-08-30 00:00:00.000,US Open NY; U.S.A. Grand Slams,HARD,3,Nikolay Davydenko,Michael Russell,Nikolay Davydenko,6-4; 6-1; 6-3,R128,141,3,3,51,85,36,51,21,34,5,6,13,57,85,5,7,60,102,32,60,21,42,10,16,13,53,102
2010-08-30 00:00:00.000,US Open NY; U.S.A. Grand Slams,HARD,3,Richard Gasquet,Simon Greul,Richard Gasquet,6-3; 6-4; 6-2,R128,111,10,1,50,75,39,50,17,25,0,1,14,56,75,1,3,39,67,20,39,18,28,3,8,13,38,67
2010-08-30 00:00:00.000,US Open NY; U.S.A. Grand Slams,HARD,3,Kevin Anderson,Somdev Devvarman,Kevin Anderson,6-3; 6-4; 6-3,R128,123,12,2,61,85,47,61,12,24,1,2,14,59,85,1,1,46,81,27,46,16,35,3,8,14,43,81
2010-08-30 00:00:00.000,US Open NY; U.S.A. Grand Slams,HARD,3,Thomaz Bellucci,Tim Smyczek,Thomaz Bellucci,6-3; 7-5; 7-6(6),R128,140,9,9,59,108,50,59,23,49,2,5,17,73,108,5,5,60,107,37,60,26,47,3,8,16,63,107
2010-08-30 00:00:00.000,US Open NY; U.S.A. Grand Slams,HARD,3,Gael Monfils,Robert Kendrick,Gael Monfils,3-6; 6-3; 6-4; 6-7(5); 6-4,R128,199,16,11,87,143,69,87,28,56,0,3,25,97,143,6,11,75,174,59,75,48,99,10,16,25,107,174
2010-08-30 00:00:00.000,US Open NY; U.S.A. Grand Slams,HARD,3,Igor Andreev,Horacio Zeballos,Igor Andreev,6-3; 4-6; 7-6(4); 6-3,R128,155,10,1,76,120,61,76,28,44,6,8,21,89,120,11,3,63,107,44,63,31,44,3,6,19,75,107
2010-08-30 00:00:00.000,US Open NY; U.S.A. Grand Slams,HARD,3,Janko Tipsarevic,Olivier Rochus,Janko Tipsarevic,4-6; 7-5; 7-6(0); 6-2,R128,163,23,3,75,118,61,75,24,43,4,7,21,85,118,1,2,68,119,49,68,26,51,5,10,21,75,119
2010-08-30 00:00:00.000,US Open NY; U.S.A. Grand Slams,HARD,3,Andy Roddick,Stephane Robert,Andy Roddick,6-3; 6-2; 6-2,R128,102,8,2,48,72,38,48,15,24,4,5,13,53,72,1,5,46,79,25,46,14,33,3,9,12,39,79
2010-08-30 00:00:00.000,US Open NY; U.S.A. Grand Slams,HARD,3,Arnaud Clement,Marcos Baghdatis,Arnaud Clement,6-3; 2-6; 1-6; 6-4; 7-5,R128,207,6,6,67,129,51,67,26,62,8,15,23,77,129,22,6,67,136,50,67,35,69,6,12,23,85,136
2010-08-30 00:00:00.000,US Open NY; U.S.A. Grand Slams,HARD,3,Eduardo Schwank,Robby Ginepri,Eduardo Schwank,6-4; 7-6(3); 4-6; 6-3,R128,150,14,5,84,125,65,84,17,41,6,10,21,82,125,8,3,70,113,49,70,20,43,3,8,20,69,113
2010-08-30 00:00:00.000,US Open NY; U.S.A. Grand Slams,HARD,3,Pablo Cuevas,Julio Silva,Pablo Cuevas,7-6(0); 6-1; 6-2,R128,103,13,0,50,82,40,50,18,32,0,2,14,58,82,6,5,45,77,22,45,16,32,3,9,13,38,77
2010-08-30 00:00:00.000,US Open NY; U.S.A. Grand Slams,HARD,3,Mardy Fish,Jan Hajek,Mardy Fish,6-0; 3-6; 4-6; 6-0; 6-1,R128,156,25,4,57,95,49,57,23,38,3,5,19,72,95,9,1,96,146,61,96,16,50,7,15,19,77,146
2010-08-30 00:00:00.000,US Open NY; U.S.A. Grand Slams,HARD,3,Peter Polansky,Juan Monaco,Peter Polansky,6-2; 7-6(5); 6-3,R128,118,11,3,48,82,37,48,22,34,4,6,14,59,82,5,5,64,98,42,64,15,34,3,9,15,57,98
2010-08-30 00:00:00.000,US Open NY; U.S.A. Grand Slams,HARD,3,James Blake,Kristof Vliegen,James Blake,6-3; 6-2; 6-4,R128,105,4,3,51,95,41,51,23,44,5,6,14,64,95,3,1,42,80,25,42,20,38,2,7,13,45,80
2010-08-30 00:00:00.000,US Open NY; U.S.A. Grand Slams,HARD,3,Philipp Petzschner,Dusan Lojda,Philipp Petzschner,6-3; 6-1; 6-1,R128,87,11,2,36,66,31,36,20,30,3,3,12,51,66,1,4,40,70,26,40,9,30,4,10,11,35,70
2010-08-30 00:00:00.000,US Open NY; U.S.A. Grand Slams,HARD,3,Novak Djokovic,Viktor Troicki,Novak Djokovic,6-3; 3-6; 2-6; 7-5; 6-3,R128,220,3,4,105,161,70,105,28,56,9,14,24,98,161,23,6,108,156,75,108,20,48,9,14,23,95,156
2010-08-30 00:00:00.000,US Open NY; U.S.A. Grand Slams,HARD,3,Robin Soderling,Andreas Haider-Maurer,Robin Soderling,7-5; 6-3; 6-7(2); 5-7; 6-4,R128,232,8,13,97,169,75,97,38,72,5,8,27,113,169,34,9,100,190,80,100,41,90,10,16,28,121,190
2010-08-30 00:00:00.000,US Open NY; U.S.A. Grand Slams,HARD,3,Taylor Dent,Alejandro Falla,Taylor Dent,6-4; 7-5; 6-1,R128,123,4,5,87,123,61,87,11,36,16,19,15,72,123,6,7,56,92,33,56,13,36,3,10,14,46,92
2010-08-30 00:00:00.000,US Open NY; U.S.A. Grand Slams,HARD,3,Thiemo de Bakker,Marc Gicquel,Thiemo de Bakker,6-4; 7-5; 6-2,R128,116,14,1,42,82,33,42,27,40,1,2,15,60,82,7,2,58,102,39,58,21,44,5,10,15,60,102
2010-08-30 00:00:00.000,US Open NY; U.S.A. Grand Slams,HARD,3,Ivan Dodig,Fernando Gonzalez,Ivan Dodig,6-7(2); 6-1; 1-0 RET,R128,81,7,2,30,56,23,30,19,26,0,0,10,42,56,4,2,28,63,22,28,17,35,4,7,10,39,63
2010-08-30 00:00:00.000,US Open NY; U.S.A. Grand Slams,HARD,3,Albert Montanes,Michal Przysiezny,Albert Montanes,5-7; 1-6; 7-5; 7-6(5); 6-0,R128,218,9,7,89,138,66,89,27,49,4,8,24,93,138,20,18,92,177,69,92,40,85,8,12,25,109,177
2010-08-30 00:00:00.000,US Open NY; U.S.A. Grand Slams,HARD,3,Carsten Ball,Milos Raonic,Carsten Ball,6-7(4); 6-3; 6-3; 6-2,R128,121,20,3,65,96,54,65,23,31,1,2,19,77,96,14,5,85,137,61,85,18,52,9,15,19,79,137
2010-08-30 00:00:00.000,US Open NY; U.S.A. Grand Slams,HARD,3,Kei Nishikori,Evgeny Korolev,Kei Nishikori,7-6(0); 5-2 RET,R128,93,7,2,31,53,24,31,14,22,0,2,10,38,53,1,7,38,87,25,38,22,49,10,13,9,47,87
2010-08-30 00:00:00.000,US Open NY; U.S.A. Grand Slams,HARD,3,Marin Cilic,Illya Marchenko,Marin Cilic,7-5; 6-3; 6-1,R128,128,8,1,44,73,33,44,20,29,2,4,14,53,73,2,14,47,97,28,47,21,50,7,14,14,49,97
2010-08-30 00:00:00.000,US Open NY; U.S.A. Grand Slams,HARD,3,Jurgen Melzer,Dmitry Tursunov,Jurgen Melzer,6-4; 6-2; 3-6; 4-6; 6-2,R128,194,11,8,86,156,62,86,37,70,17,20,22,99,156,8,7,75,137,50,75,35,62,9,15,23,85,137
2010-08-30 00:00:00.000,US Open NY; U.S.A. Grand Slams,HARD,3,Ricardas Berankis,Ryan Sweeting,Ricardas Berankis,6-4; 6-7(5); 6-3; 6-2,R128,145,6,10,60,133,43,60,41,73,6,10,20,84,133,3,9,63,102,42,63,18,39,4,12,19,60,102
2010-08-30 00:00:00.000,US Open NY; U.S.A. Grand Slams,HARD,3,Ricardo Mello,Bjorn Phau,Ricardo Mello,6-4; 7-5; 4-6; 7-6(4),R128,193,5,6,77,142,52,77,36,65,7,11,22,88,142,9,9,85,167,54,85,40,82,15,21,22,94,167
2010-08-30 00:00:00.000,US Open NY; U.S.A. Grand Slams,HARD,3,Juan Carlos Ferrero,Martin Klizan,Juan Carlos Ferrero,6-1; 6-3; 6-0,R128,85,7,0,37,60,31,37,13,23,2,3,11,44,60,4,12,39,78,26,39,9,39,6,13,11,35,78
2010-08-30 00:00:00.000,US Open NY; U.S.A. Grand Slams,HARD,3,Paul-Henri Mathieu,Lleyton Hewitt,Paul-Henri Mathieu,6-3; 6-4; 5-7; 4-6; 6-1,R128,219,18,8,78,156,58,78,37,78,8,13,24,95,156,17,12,77,150,59,77,28,73,8,16,24,87,150
2010-08-30 00:00:00.000,US Open NY; U.S.A. Grand Slams,HARD,3,Guillaume Rufin,Leonardo Mayer,Guillaume Rufin,2-6; 7-6(4); 7-6(2); 6-1,R128,197,21,11,69,138,55,69,37,69,8,11,20,92,138,14,10,70,126,54,70,26,56,6,9,19,80,126
2010-08-30 00:00:00.000,US Open NY; U.S.A. Grand Slams,HARD,3,Andreas Beck,Michael Berrer,Andreas Beck,7-6(3); 6-3; 6-1,R128,132,7,5,49,89,42,49,23,40,4,5,14,65,89,7,6,54,96,32,54,22,42,9,14,14,54,96
2010-08-30 00:00:00.000,US Open NY; U.S.A. Grand Slams,HARD,3,Roger Federer,Brian Dabul,Roger Federer,6-1; 6-4; 6-2,R128,93,18,1,49,74,41,49,14,25,1,1,13,55,74,0,3,57,85,35,57,12,28,14,19,12,47,85
2010-08-30 00:00:00.000,US Open NY; U.S.A. Grand Slams,HARD,3,Rafael Nadal,Denis Istomin,Rafael Nadal,6-2; 7-6(5); 7-5,R64,164,8,3,60,92,50,60,23,32,7,7,16,73,92,10,0,66,109,47,66,22,43,3,6,16,69,109
2010-08-30 00:00:00.000,US Open NY; U.S.A. Grand Slams,HARD,3,Gilles Simon,Philipp Kohlschreiber,Gilles Simon,4-6; 6-3; 1-6; 6-1; 6-3,R64,164,11,3,69,126,54,69,25,57,2,6,21,79,126,9,3,75,128,54,75,25,53,7,13,21,79,128
2010-08-30 00:00:00.000,US Open NY; U.S.A. Grand Slams,HARD,3,Feliciano Lopez,Benoit Paire,Feliciano Lopez,6-4; 6-7(4); 5-7; 7-6(3); 6-2,R64,228,23,10,99,169,77,99,37,70,4,8,27,114,169,22,9,93,172,68,93,40,79,11,17,27,108,172
2010-08-30 00:00:00.000,US Open NY; U.S.A. Grand Slams,HARD,3,Sergiy Stakhovsky,Ryan Harrison,Sergiy Stakhovsky,6-3; 5-7; 3-6; 6-3; 7-6(6),R64,253,16,4,100,163,71,100,34,63,11,17,26,105,163,12,8,114,180,82,114,24,66,17,23,25,106,180
2010-08-30 00:00:00.000,US Open NY; U.S.A. Grand Slams,HARD,3,David Ferrer,Benjamin Becker,David Ferrer,6-3; 6-4; 6-4,R64,129,11,0,57,90,46,57,17,33,1,2,15,63,90,8,4,53,94,39,53,17,41,6,10,14,56,94
2010-08-30 00:00:00.000,US Open NY; U.S.A. Grand Slams,HARD,3,Daniel Gimeno-Traver,Jeremy Chardy,Daniel Gimeno-Traver,4-6; 6-2; 6-0; 7-6(2),R64,129,8,2,56,95,46,56,30,39,1,2,18,76,95,10,6,64,118,44,64,29,54,5,10,18,73,118
2010-08-30 00:00:00.000,US Open NY; U.S.A. Grand Slams,HARD,3,David Nalbandian,Florent Serra,David Nalbandian,7-5; 6-4; 6-2,R64,112,11,3,42,83,35,42,25,41,2,3,15,60,83,5,2,63,100,37,63,18,37,9,14,15,55,100
2010-08-30 00:00:00.000,US Open NY; U.S.A. Grand Slams,HARD,3,Fernando Verdasco,Adrian Mannarino,Fernando Verdasco,6-1; 6-2; 6-2,R64,112,7,4,50,73,39,50,13,23,2,2,12,52,73,0,5,51,91,29,51,16,40,10,16,11,45,91
2010-08-30 00:00:00.000,US Open NY; U.S.A. Grand Slams,HARD,3,Andy Murray,Dustin Brown,Andy Murray,7-5; 6-3; 6-0,R64,85,13,3,43,71,38,43,17,28,0,1,14,55,71,6,6,41,79,27,41,14,38,4,10,13,41,79
2010-08-30 00:00:00.000,US Open NY; U.S.A. Grand Slams,HARD,3,Stanislas Wawrinka,Juan Ignacio Chela,Stanislas Wawrinka,7-5; 6-3; 6-4,R64,136,13,2,47,103,42,47,29,56,7,8,16,71,103,3,2,62,96,40,62,14,34,5,9,15,54,96
2010-08-30 00:00:00.000,US Open NY; U.S.A. Grand Slams,HARD,3,Sam Querrey,Marcel Granollers,Sam Querrey,6-2; 6-3; 6-4,R64,100,11,3,49,82,41,49,18,33,3,4,14,59,82,3,2,45,80,28,45,17,35,7,12,13,45,80
2010-08-30 00:00:00.000,US Open NY; U.S.A. Grand Slams,HARD,3,Nicolas Almagro,Guillermo Garcia-Lopez,Nicolas Almagro,6-3; 7-6(5); 4-6; 7-6(4),R64,186,12,2,76,146,59,76,36,70,4,8,22,95,146,6,4,68,131,48,68,36,63,2,6,21,84,131
2010-08-30 00:00:00.000,US Open NY; U.S.A. Grand Slams,HARD,3,Mikhail Youzhny,Dudi Sela,Mikhail Youzhny,6-1; 6-3; 4-6; 6-3,R64,156,9,7,54,104,38,54,30,50,6,9,18,68,104,4,3,51,104,35,51,23,53,4,10,17,58,104
2010-08-30 00:00:00.000,US Open NY; U.S.A. Grand Slams,HARD,3,John Isner,Marco Chiudinelli,John Isner,6-3; 3-6; 7-6(7); 6-4,R64,177,24,1,76,118,64,76,26,42,1,2,20,90,118,13,5,83,121,61,83,24,38,3,5,20,85,121
2010-08-30 00:00:00.000,US Open NY; U.S.A. Grand Slams,HARD,3,Tommy Robredo,Julien Benneteau,Tommy Robredo,6-4; 6-6 RET,R64,104,5,3,46,72,31,46,16,26,2,3,11,47,72,6,1,44,60,32,44,9,16,1,3,11,41,60
2010-08-30 00:00:00.000,US Open NY; U.S.A. Grand Slams,HARD,3,Michael Llodra,Victor Hanescu,Michael Llodra,7-6(2); 6-4; 6-2,R64,130,13,6,66,97,55,66,16,31,4,5,15,71,97,12,4,67,98,44,67,17,31,3,6,15,61,98
2010-08-30 00:00:00.000,US Open NY; U.S.A. Grand Slams,HARD,3,Richard Gasquet,Nikolay Davydenko,Richard Gasquet,6-3; 6-4; 6-2,R64,113,8,5,52,93,43,52,23,41,8,8,14,66,93,4,3,51,79,35,51,11,28,3,7,13,46,79
2010-08-30 00:00:00.000,US Open NY; U.S.A. Grand Slams,HARD,3,Kevin Anderson,Thomaz Bellucci,Kevin Anderson,6-7(4); 6-4; 5-7; 6-4; 7-6(2),R64,231,14,1,110,149,90,110,28,39,3,4,28,118,149,20,6,92,165,74,92,43,73,0,2,28,117,165
2010-08-30 00:00:00.000,US Open NY; U.S.A. Grand Slams,HARD,3,Gael Monfils,Igor Andreev,Gael Monfils,6-3; 6-4; 6-3,R64,112,11,1,54,88,43,54,19,34,3,3,14,62,88,2,4,61,103,38,61,20,42,3,7,14,58,103
2010-08-30 00:00:00.000,US Open NY; U.S.A. Grand Slams,HARD,3,Janko Tipsarevic,Andy Roddick,Janko Tipsarevic,3-6; 7-5; 6-3; 7-6(4),R64,198,16,1,72,123,58,72,32,51,3,5,21,90,123,18,3,78,119,61,78,22,41,8,11,21,83,119
2010-08-30 00:00:00.000,US Open NY; U.S.A. Grand Slams,HARD,3,Arnaud Clement,Eduardo Schwank,Arnaud Clement,6-3; 5-5 RET,R64,96,3,6,34,63,24,34,14,29,2,4,10,38,63,5,2,39,57,24,39,9,18,3,6,9,33,57
2010-08-30 00:00:00.000,US Open NY; U.S.A. Grand Slams,HARD,3,Mardy Fish,Pablo Cuevas,Mardy Fish,7-5; 6-0; 6-2,R64,120,14,5,48,97,41,48,22,49,14,15,13,63,97,3,2,49,76,28,49,9,27,4,11,13,37,76
2010-08-30 00:00:00.000,US Open NY; U.S.A. Grand Slams,HARD,3,James Blake,Peter Polansky,James Blake,6-7(1); 6-3; 6-2; 6-4,R64,149,12,3,68,125,49,68,35,57,6,8,20,84,125,8,4,82,133,53,82,27,51,8,14,19,80,133
2010-08-30 00:00:00.000,US Open NY; U.S.A. Grand Slams,HARD,3,Novak Djokovic,Philipp Petzschner,Novak Djokovic,7-5; 6-3; 7-6(6),R64,143,4,8,70,101,53,70,19,31,4,5,17,72,101,6,3,66,111,45,66,23,45,8,12,16,68,111
2010-08-30 00:00:00.000,US Open NY; U.S.A. Grand Slams,HARD,3,Robin Soderling,Taylor Dent,Robin Soderling,6-2; 6-2; 6-4,R64,92,14,4,48,71,40,48,14,23,3,3,13,54,71,9,7,57,82,37,57,10,25,5,9,13,47,82
2010-08-30 00:00:00.000,US Open NY; U.S.A. Grand Slams,HARD,3,Thiemo de Bakker,Ivan Dodig,Thiemo de Bakker,6-7(4); 6-2; 6-3; 3-2 RET,R64,172,11,2,56,96,42,56,26,40,1,3,17,68,96,7,4,78,118,53,78,16,40,11,17,17,69,118
2010-08-30 00:00:00.000,US Open NY; U.S.A. Grand Slams,HARD,3,Albert Montanes,Carsten Ball,Albert Montanes,6-4; 6-3; 6-1,R64,106,7,6,57,86,43,57,16,29,2,2,13,59,86,13,7,50,91,32,50,17,41,9,14,13,49,91
2010-08-30 00:00:00.000,US Open NY; U.S.A. Grand Slams,HARD,3,Kei Nishikori,Marin Cilic,Kei Nishikori,5-7; 7-6(6); 3-6; 7-6(3); 6-1,R64,299,13,11,108,185,82,108,30,77,7,12,25,112,185,13,12,100,194,67,100,50,94,14,19,27,117,194
2010-08-30 00:00:00.000,US Open NY; U.S.A. Grand Slams,HARD,3,Jurgen Melzer,Ricardas Berankis,Jurgen Melzer,6-4; 6-7(4); 6-3; 1-6; 7-5,R64,215,9,9,86,156,62,86,33,70,6,12,25,95,156,11,20,92,182,66,92,39,90,14,21,25,105,182
2010-08-30 00:00:00.000,US Open NY; U.S.A. Grand Slams,HARD,3,Juan Carlos Ferrero,Ricardo Mello,Juan Carlos Ferrero,6-1; 6-4; 6-4,R64,118,10,4,61,101,40,61,26,40,7,8,14,66,101,4,3,45,80,30,45,16,35,3,8,13,46,80
2010-08-30 00:00:00.000,US Open NY; U.S.A. Grand Slams,HARD,3,Paul-Henri Mathieu,Guillaume Rufin,Paul-Henri Mathieu,7-6(3); 6-4; 6-3,R64,147,17,6,52,92,40,52,24,40,4,5,15,64,92,15,10,50,103,36,50,26,53,5,9,16,62,103
2010-08-30 00:00:00.000,US Open NY; U.S.A. Grand Slams,HARD,3,Roger Federer,Andreas Beck,Roger Federer,6-3; 6-4; 6-3,R64,101,15,0,40,74,32,40,22,34,1,2,14,54,74,8,11,50,86,34,50,14,36,5,10,14,48,86
2010-08-30 00:00:00.000,US Open NY; U.S.A. Grand Slams,HARD,3,Rafael Nadal,Gilles Simon,Rafael Nadal,6-4; 6-4; 6-2,R32,119,6,3,43,76,39,43,19,33,1,1,14,58,76,6,2,54,98,35,54,23,44,5,9,14,58,98
2010-08-30 00:00:00.000,US Open NY; U.S.A. Grand Slams,HARD,3,Feliciano Lopez,Sergiy Stakhovsky,Feliciano Lopez,6-3; 4-0 RET,R32,56,4,1,14,28,12,14,12,14,0,0,6,24,28,4,2,39,57,21,39,6,18,9,13,7,27,57
2010-08-30 00:00:00.000,US Open NY; U.S.A. Grand Slams,HARD,3,David Ferrer,Daniel Gimeno-Traver,David Ferrer,7-6(2); 6-2; 6-2,R32,114,4,3,45,80,38,45,24,35,1,1,14,62,80,4,3,40,90,28,40,23,50,8,12,14,51,90
2010-08-30 00:00:00.000,US Open NY; U.S.A. Grand Slams,HARD,3,Fernando Verdasco,David Nalbandian,Fernando Verdasco,6-2; 3-6; 6-3; 6-2,R32,166,14,4,63,98,50,63,18,35,2,4,17,68,98,5,9,77,149,43,77,36,72,13,19,17,79,149
2010-08-30 00:00:00.000,US Open NY; U.S.A. Grand Slams,HARD,3,Stanislas Wawrinka,Andy Murray,Stanislas Wawrinka,6-7(3); 7-6(4); 6-3; 6-3,R32,236,13,5,71,136,56,71,29,65,5,10,21,85,136,6,5,76,151,52,76,32,75,7,15,21,84,151
2010-08-30 00:00:00.000,US Open NY; U.S.A. Grand Slams,HARD,3,Sam Querrey,Nicolas Almagro,Sam Querrey,6-3; 6-4; 6-4,R32,113,19,3,55,94,46,55,21,39,5,5,15,67,94,3,2,48,85,34,48,20,37,6,9,14,54,85
2010-08-30 00:00:00.000,US Open NY; U.S.A. Grand Slams,HARD,3,Mikhail Youzhny,John Isner,Mikhail Youzhny,6-4; 6-7(7); 7-6(5); 6-4,R32,198,5,8,93,151,68,93,34,58,7,9,22,102,151,33,2,101,148,78,101,18,47,8,12,22,96,148
2010-08-30 00:00:00.000,US Open NY; U.S.A. Grand Slams,HARD,3,Tommy Robredo,Michael Llodra,Tommy Robredo,3-6; 7-6(6); 6-4; 2-1 RET,R32,124,7,1,62,88,48,62,19,26,1,3,16,67,88,12,7,82,118,59,82,18,36,7,10,18,77,118
2010-08-30 00:00:00.000,US Open NY; U.S.A. Grand Slams,HARD,3,Richard Gasquet,Kevin Anderson,Richard Gasquet,6-4; 7-6(3); 7-5,R32,150,8,4,55,99,43,55,27,44,2,4,17,70,99,8,6,74,117,53,74,17,43,8,12,17,70,117
2010-08-30 00:00:00.000,US Open NY; U.S.A. Grand Slams,HARD,3,Gael Monfils,Janko Tipsarevic,Gael Monfils,7-6(4); 6-7(4); 6-2; 6-4,R32,222,16,2,80,126,54,80,29,46,2,6,21,83,126,3,3,86,149,48,86,33,63,7,12,21,81,149
2010-08-30 00:00:00.000,US Open NY; U.S.A. Grand Slams,HARD,3,Mardy Fish,Arnaud Clement,Mardy Fish,4-6; 6-3; 6-4; 1-6; 6-3,R32,213,17,8,94,147,68,94,26,53,8,13,23,94,147,5,6,81,131,56,81,27,50,6,11,22,83,131
2010-08-30 00:00:00.000,US Open NY; U.S.A. Grand Slams,HARD,3,Novak Djokovic,James Blake,Novak Djokovic,6-1; 7-6(4); 6-3,R32,104,4,1,74,94,51,74,14,20,3,4,15,65,94,1,5,52,77,33,52,14,25,2,6,13,47,77
2010-08-30 00:00:00.000,US Open NY; U.S.A. Grand Slams,HARD,3,Robin Soderling,Thiemo de Bakker,Robin Soderling,6-2; 6-3; 6-3,R32,102,7,2,38,72,31,38,21,34,5,6,13,52,72,8,2,44,77,28,44,12,33,5,11,13,40,77
2010-08-30 00:00:00.000,US Open NY; U.S.A. Grand Slams,HARD,3,Albert Montanes,Kei Nishikori,Albert Montanes,6-2; 2-1 RET,R32,38,5,0,14,26,13,14,7,12,0,0,5,20,26,0,3,20,37,11,20,7,17,4,7,6,18,37
2010-08-30 00:00:00.000,US Open NY; U.S.A. Grand Slams,HARD,3,Jurgen Melzer,Juan Carlos Ferrero,Jurgen Melzer,7-5; 6-3; 6-1,R32,104,10,2,52,82,42,52,16,30,4,5,14,58,82,1,3,44,82,29,44,16,38,6,12,14,45,82
2010-08-30 00:00:00.000,US Open NY; U.S.A. Grand Slams,HARD,3,Roger Federer,Paul-Henri Mathieu,Roger Federer,6-4; 6-3; 6-3,R32,99,13,0,47,77,40,47,19,30,4,4,14,59,77,3,3,37,71,28,37,15,34,2,6,14,43,71
2010-08-30 00:00:00.000,US Open NY; U.S.A. Grand Slams,HARD,3,Rafael Nadal,Feliciano Lopez,Rafael Nadal,6-3; 6-4; 6-4,R16,128,9,1,50,79,45,50,18,29,4,4,15,63,79,10,5,52,100,39,52,20,48,6,9,14,59,100
2010-08-30 00:00:00.000,US Open NY; U.S.A. Grand Slams,HARD,3,Fernando Verdasco,David Ferrer,Fernando Verdasco,5-7; 6-7(8); 6-3; 6-3; 7-6(4),R16,263,16,11,115,204,81,115,47,89,12,16,27,128,204,7,5,115,180,81,115,31,65,8,14,27,112,180
2010-08-30 00:00:00.000,US Open NY; U.S.A. Grand Slams,HARD,3,Stanislas Wawrinka,Sam Querrey,Stanislas Wawrinka,7-6(9); 6-7(5); 7-5; 4-6; 6-4,R16,268,18,5,103,199,80,103,54,96,12,15,28,134,199,19,6,95,175,79,95,42,80,4,8,28,121,175
2010-08-30 00:00:00.000,US Open NY; U.S.A. Grand Slams,HARD,3,Mikhail Youzhny,Tommy Robredo,Mikhail Youzhny,7-5; 6-2; 4-6; 6-4,R16,185,1,2,71,116,52,71,31,45,2,3,20,83,116,8,5,68,122,53,68,28,54,8,12,20,81,122
2010-08-30 00:00:00.000,US Open NY; U.S.A. Grand Slams,HARD,3,Gael Monfils,Richard Gasquet,Gael Monfils,6-4; 7-5; 7-5,R16,155,14,4,67,115,55,67,19,48,6,8,17,74,115,4,7,80,116,52,80,15,36,12,17,17,67,116
2010-08-30 00:00:00.000,US Open NY; U.S.A. Grand Slams,HARD,3,Novak Djokovic,Mardy Fish,Novak Djokovic,6-3; 6-4; 6-1,R16,110,5,4,52,76,41,52,11,24,3,4,13,52,76,3,4,39,71,22,39,16,32,2,8,13,38,71
2010-08-30 00:00:00.000,US Open NY; U.S.A. Grand Slams,HARD,3,Robin Soderling,Albert Montanes,Robin Soderling,4-6; 6-3; 6-2; 6-3,R16,135,15,3,53,100,44,53,29,47,0,1,18,73,100,9,8,67,112,46,67,19,45,5,10,18,65,112
2010-08-30 00:00:00.000,US Open NY; U.S.A. Grand Slams,HARD,3,Roger Federer,Jurgen Melzer,Roger Federer,6-3; 7-6(4); 6-3,R16,123,10,1,64,105,49,64,25,41,10,12,16,74,105,1,3,64,96,38,64,18,32,4,8,14,56,96
2010-08-30 00:00:00.000,US Open NY; U.S.A. Grand Slams,HARD,3,Rafael Nadal,Fernando Verdasco,Rafael Nadal,7-5; 6-3; 6-4,Q,142,4,0,51,77,43,51,18,26,0,1,16,61,77,6,5,58,100,36,58,23,42,5,9,15,59,100
2010-08-30 00:00:00.000,US Open NY; U.S.A. Grand Slams,HARD,3,Mikhail Youzhny,Stanislas Wawrinka,Mikhail Youzhny,3-6; 7-6(7); 3-6; 6-3; 6-3,Q,240,2,7,94,144,64,94,27,50,5,10,23,91,144,16,5,89,164,69,89,32,75,8,15,25,101,164
2010-08-30 00:00:00.000,US Open NY; U.S.A. Grand Slams,HARD,3,Novak Djokovic,Gael Monfils,Novak Djokovic,7-6(2); 6-1; 6-2,Q,144,1,4,74,100,51,74,13,26,11,13,13,64,100,3,6,61,109,32,61,20,48,11,18,14,52,109
2010-08-30 00:00:00.000,US Open NY; U.S.A. Grand Slams,HARD,3,Roger Federer,Robin Soderling,Roger Federer,6-4; 6-4; 7-5,Q,116,18,2,58,91,50,58,15,33,4,6,16,65,91,2,4,54,93,36,54,20,39,1,6,16,56,93
2010-08-30 00:00:00.000,US Open NY; U.S.A. Grand Slams,HARD,3,Rafael Nadal,Mikhail Youzhny,Rafael Nadal,6-2; 6-3; 6-4,S,133,3,1,50,77,39,50,19,27,1,2,14,58,77,3,5,48,81,32,48,13,33,3,8,13,45,81
2010-08-30 00:00:00.000,US Open NY; U.S.A. Grand Slams,HARD,3,Novak Djokovic,Roger Federer,Novak Djokovic,5-7; 6-1; 5-7; 6-2; 7-5,S,224,4,3,94,151,64,94,36,57,4,7,26,100,151,12,5,84,160,62,84,35,76,6,12,25,97,160
2010-08-30 00:00:00.000,US Open NY; U.S.A. Grand Slams,HARD,3,Rafael Nadal,Novak Djokovic,Rafael Nadal,6-4; 5-7; 6-4; 6-2,F,223,8,2,75,112,55,75,21,37,1,4,20,76,112,5,4,94,143,61,94,22,49,20,25,20,83,143
2010-09-20 00:00:00.000,Bucharest Romania ATP World Tour 250,CLAY,2,Albert Montanes,N/A Bye,Albert Montanes,,R32,0,0,0,0,0,0,0,0,0,0,0,0,0,0,0,0,0,0,0,0,0,0,0,0,0,0,0
2010-09-20 00:00:00.000,Bucharest Romania ATP World Tour 250,CLAY,2,Tobias Kamke,Fabio Fognini,Tobias Kamke,6-3; 7-5,R32,97,1,2,41,71,28,41,16,30,6,9,10,44,71,2,5,37,67,22,37,11,30,3,9,11,33,67
2010-09-20 00:00:00.000,Bucharest Romania ATP World Tour 250,CLAY,2,Simone Vagnozzi,Marius Copil,Simone Vagnozzi,7-6(4); 6-4,R32,111,0,2,54,70,34,54,10,16,1,4,11,44,70,4,3,43,86,28,43,17,43,9,13,11,45,86
2010-09-20 00:00:00.000,Bucharest Romania ATP World Tour 250,CLAY,2,Jeremy Chardy,Guillaume Rufin,Jeremy Chardy,6-0; 6-2,R32,60,6,1,20,34,20,20,9,14,1,1,7,29,34,1,3,35,53,13,35,9,18,5,10,7,22,53
2010-09-20 00:00:00.000,Bucharest Romania ATP World Tour 250,CLAY,2,Juan Ignacio Chela,N/A Bye,Juan Ignacio Chela,,R32,0,0,0,0,0,0,0,0,0,0,0,0,0,0,0,0,0,0,0,0,0,0,0,0,0,0,0
2010-09-20 00:00:00.000,Bucharest Romania ATP World Tour 250,CLAY,2,Simon Greul,Michal Przysiezny,Simon Greul,6-3; 6-4,R32,75,5,7,27,53,21,27,14,26,1,3,10,35,53,1,3,42,64,28,42,5,22,5,9,9,33,64
2010-09-20 00:00:00.000,Bucharest Romania ATP World Tour 250,CLAY,2,Bjorn Phau,Albert Ramos,Bjorn Phau,1-6; 6-4; 6-0,R32,114,2,5,39,74,27,39,17,35,3,6,11,44,74,1,1,48,88,25,48,19,40,10,15,12,44,88
2010-09-20 00:00:00.000,Bucharest Romania ATP World Tour 250,CLAY,2,Adrian Ungur,Andreas Seppi,Adrian Ungur,3-6; 7-6(6); 6-4,R32,154,1,4,67,112,41,67,28,45,7,10,15,69,112,9,3,74,106,52,74,16,32,9,12,16,68,106
2010-09-20 00:00:00.000,Bucharest Romania ATP World Tour 250,CLAY,2,Marcel Granollers,Victor Hanescu,Marcel Granollers,2-6; 6-2; 6-1,R32,122,2,2,53,84,36,53,16,31,6,8,11,52,84,0,2,53,76,29,53,12,23,4,9,12,41,76
2010-09-20 00:00:00.000,Bucharest Romania ATP World Tour 250,CLAY,2,Filippo Volandri,Lukasz Kubot,Filippo Volandri,6-3; 6-0,R32,60,0,0,23,31,19,23,6,8,0,1,7,25,31,1,2,32,54,13,32,9,22,5,11,8,22,54
2010-09-20 00:00:00.000,Bucharest Romania ATP World Tour 250,CLAY,2,Victor Crivoi,Santiago Ventura,Victor Crivoi,6-4; 6-0,R32,64,0,2,27,41,20,27,9,14,1,2,8,29,41,1,1,32,57,17,32,10,25,5,10,8,27,57
2010-09-20 00:00:00.000,Bucharest Romania ATP World Tour 250,CLAY,2,Potito Starace,N/A Bye,Potito Starace,,R32,0,0,0,0,0,0,0,0,0,0,0,0,0,0,0,0,0,0,0,0,0,0,0,0,0,0,0
2010-09-20 00:00:00.000,Bucharest Romania ATP World Tour 250,CLAY,2,Carlos Berlocq,Daniel Gimeno-Traver,Carlos Berlocq,4-6; 7-5; 7-6(4),R32,182,3,3,65,103,45,65,24,38,4,7,17,69,103,5,8,72,126,53,72,24,54,8,11,17,77,126
2010-09-20 00:00:00.000,Bucharest Romania ATP World Tour 250,CLAY,2,Pablo Cuevas,Pere Riba,Pablo Cuevas,6-1; 6-1,R32,72,4,1,29,44,20,29,11,15,2,2,7,31,44,2,4,28,50,13,28,8,22,2,7,7,21,50
2010-09-20 00:00:00.000,Bucharest Romania ATP World Tour 250,CLAY,2,Pablo Andujar,Maximo Gonzalez,Pablo Andujar,6-3; 6-4,R32,101,2,1,43,64,26,43,15,21,5,7,10,41,64,2,1,32,56,21,32,9,24,4,8,9,30,56
2010-09-20 00:00:00.000,Bucharest Romania ATP World Tour 250,CLAY,2,Florian Mayer,N/A Bye,Florian Mayer,,R32,0,0,0,0,0,0,0,0,0,0,0,0,0,0,0,0,0,0,0,0,0,0,0,0,0,0,0
2010-09-20 00:00:00.000,Bucharest Romania ATP World Tour 250,CLAY,2,Albert Montanes,Tobias Kamke,Albert Montanes,6-4; 6-4,R16,83,1,1,35,54,25,35,13,19,0,1,10,38,54,1,1,23,57,16,23,18,34,2,5,10,34,57
2010-09-20 00:00:00.000,Bucharest Romania ATP World Tour 250,CLAY,2,Jeremy Chardy,Simone Vagnozzi,Jeremy Chardy,6-2; 6-4,R16,74,7,1,34,53,25,34,13,19,0,0,9,38,53,1,5,44,59,27,44,5,15,5,8,9,32,59
2010-09-20 00:00:00.000,Bucharest Romania ATP World Tour 250,CLAY,2,Juan Ignacio Chela,Simon Greul,Juan Ignacio Chela,6-1; 6-0,R16,55,1,0,27,38,19,27,10,11,0,0,7,29,38,0,0,23,39,8,23,5,16,5,10,6,13,39
2010-09-20 00:00:00.000,Bucharest Romania ATP World Tour 250,CLAY,2,Bjorn Phau,Adrian Ungur,Bjorn Phau,6-2; 6-4,R16,76,3,2,29,47,23,29,9,18,1,3,9,32,47,1,2,39,56,19,39,7,17,4,9,9,26,56
2010-09-20 00:00:00.000,Bucharest Romania ATP World Tour 250,CLAY,2,Marcel Granollers,Filippo Volandri,Marcel Granollers,4-6; 7-5; 6-1,R16,145,2,0,62,92,41,62,16,30,5,9,15,57,92,0,3,58,83,35,58,11,25,9,15,14,46,83
2010-09-20 00:00:00.000,Bucharest Romania ATP World Tour 250,CLAY,2,Potito Starace,Victor Crivoi,Potito Starace,4-6; 7-6(6); 6-4,R16,165,7,1,92,115,69,92,10,23,13,15,16,79,115,1,2,80,117,52,80,24,37,8,10,16,76,117
2010-09-20 00:00:00.000,Bucharest Romania ATP World Tour 250,CLAY,2,Pablo Cuevas,Carlos Berlocq,Pablo Cuevas,6-4; 6-0,R16,79,1,0,27,43,23,27,10,16,1,1,8,33,43,0,1,27,46,14,27,8,19,1,5,8,22,46
2010-09-20 00:00:00.000,Bucharest Romania ATP World Tour 250,CLAY,2,Pablo Andujar,Florian Mayer,Pablo Andujar,6-3; 3-6; 6-2,R16,132,2,1,65,91,44,65,12,26,5,7,13,56,91,5,2,51,79,34,51,15,28,5,9,13,49,79
2010-09-20 00:00:00.000,Bucharest Romania ATP World Tour 250,CLAY,2,Albert Montanes,Jeremy Chardy,Albert Montanes,6-3; 1-6; 6-3,Q,98,2,2,57,78,36,57,11,21,4,8,13,47,78,6,1,39,70,31,39,13,31,5,9,12,44,70
2010-09-20 00:00:00.000,Bucharest Romania ATP World Tour 250,CLAY,2,Juan Ignacio Chela,Bjorn Phau,Juan Ignacio Chela,6-3; 6-3,Q,91,0,1,39,51,28,39,3,12,4,6,9,31,51,0,3,26,54,13,26,11,28,5,10,9,24,54
2010-09-20 00:00:00.000,Bucharest Romania ATP World Tour 250,CLAY,2,Marcel Granollers,Potito Starace,Marcel Granollers,3-6; 7-6(7); 6-4,Q,150,7,1,71,90,52,71,11,19,3,6,15,63,90,1,0,88,107,58,88,11,19,7,10,16,69,107
2010-09-20 00:00:00.000,Bucharest Romania ATP World Tour 250,CLAY,2,Pablo Andujar,Pablo Cuevas,Pablo Andujar,6-4; 6-4,Q,131,1,2,45,70,27,45,16,25,8,10,10,43,70,4,0,46,86,25,46,19,40,10,14,10,44,86
2010-09-20 00:00:00.000,Bucharest Romania ATP World Tour 250,CLAY,2,Juan Ignacio Chela,Albert Montanes,Juan Ignacio Chela,6-1; 6-3,S,81,0,0,40,59,28,40,9,19,6,7,8,37,59,0,0,38,53,19,38,4,15,5,10,8,23,53
2010-09-20 00:00:00.000,Bucharest Romania ATP World Tour 250,CLAY,2,Pablo Andujar,Marcel Granollers,Pablo Andujar,7-6(5); 4-6; 6-4,S,191,1,3,67,101,42,67,22,34,6,9,16,64,101,2,2,79,121,50,79,23,42,11,14,16,73,121
2010-09-20 00:00:00.000,Bucharest Romania ATP World Tour 250,CLAY,2,Juan Ignacio Chela,Pablo Andujar,Juan Ignacio Chela,7-5; 6-1,F,89,2,1,37,59,26,37,10,22,2,4,10,36,59,0,2,35,53,19,35,9,18,1,6,9,28,53
2010-09-20 00:00:00.000,Metz France ATP World Tour 250,HARD,2,Marin Cilic,N/A Bye,Marin Cilic,,R32,0,0,0,0,0,0,0,0,0,0,0,0,0,0,0,0,0,0,0,0,0,0,0,0,0,0,0
2010-09-20 00:00:00.000,Metz France ATP World Tour 250,HARD,2,Lukas Lacko,Arnaud Clement,Lukas Lacko,6-4; 6-2,R32,62,6,3,34,52,26,34,8,18,0,1,9,34,52,3,0,22,41,16,22,7,19,0,4,9,23,41
2010-09-20 00:00:00.000,Metz France ATP World Tour 250,HARD,2,Michael Berrer,Rainer Schuettler,Michael Berrer,7-6(5); 6-2,R32,90,4,1,50,71,38,50,11,21,4,4,10,49,71,2,5,31,61,24,31,15,30,0,2,10,39,61
2010-09-20 00:00:00.000,Metz France ATP World Tour 250,HARD,2,Philipp Kohlschreiber,Thomas Fabbiano,Philipp Kohlschreiber,6-4; 6-3,R32,73,9,0,29,46,24,29,12,17,0,0,9,36,46,3,2,37,70,22,37,17,33,2,5,10,39,70
2010-09-20 00:00:00.000,Metz France ATP World Tour 250,HARD,2,Ivan Ljubicic,N/A Bye,Ivan Ljubicic,,R32,0,0,0,0,0,0,0,0,0,0,0,0,0,0,0,0,0,0,0,0,0,0,0,0,0,0,0
2010-09-20 00:00:00.000,Metz France ATP World Tour 250,HARD,2,Xavier Malisse,Edouard Roger-Vasselin,Xavier Malisse,7-6(3); 6-4,R32,98,8,3,51,81,37,51,13,30,5,7,11,50,81,3,1,39,70,24,39,14,31,4,7,11,38,70
2010-09-20 00:00:00.000,Metz France ATP World Tour 250,HARD,2,Igor Sijsling,Thierry Ascione,Igor Sijsling,6-4; 6-4,R32,61,10,0,44,56,35,44,7,12,2,2,10,42,56,4,3,46,66,30,46,10,20,3,5,10,40,66
2010-09-20 00:00:00.000,Metz France ATP World Tour 250,HARD,2,Gilles Simon,Dustin Brown,Gilles Simon,6-3; 6-4,R32,62,8,1,24,49,23,24,17,25,0,0,10,40,49,14,2,38,75,30,38,13,37,9,11,9,43,75
2010-09-20 00:00:00.000,Metz France ATP World Tour 250,HARD,2,Tommy Robredo,Daniel Brands,Tommy Robredo,6-1; 7-6(3),R32,69,7,1,35,58,33,35,12,23,3,3,10,45,58,6,2,34,52,24,34,9,18,1,3,9,33,52
2010-09-20 00:00:00.000,Metz France ATP World Tour 250,HARD,2,Denis Istomin,Florent Serra,Denis Istomin,6-4; 6-4,R32,66,8,1,30,50,22,30,11,20,0,2,10,33,50,4,1,30,55,19,30,11,25,1,5,10,30,55
2010-09-20 00:00:00.000,Metz France ATP World Tour 250,HARD,2,Paul-Henri Mathieu,Adrian Mannarino,Paul-Henri Mathieu,6-3; 6-3,R32,68,5,2,33,50,27,33,7,17,1,2,9,34,50,5,1,33,56,17,33,13,23,3,7,9,30,56
2010-09-20 00:00:00.000,Metz France ATP World Tour 250,HARD,2,Richard Gasquet,N/A Bye,Richard Gasquet,,R32,0,0,0,0,0,0,0,0,0,0,0,0,0,0,0,0,0,0,0,0,0,0,0,0,0,0,0
2010-09-20 00:00:00.000,Metz France ATP World Tour 250,HARD,2,Kristof Vliegen,Federico Delbonis,Kristof Vliegen,6-2; 4-6; 6-3,R32,114,3,1,43,73,37,43,16,30,0,1,13,53,73,7,5,43,90,32,43,22,47,6,10,14,54,90
2010-09-20 00:00:00.000,Metz France ATP World Tour 250,HARD,2,Jarkko Nieminen,Benjamin Becker,Jarkko Nieminen,6-3; 7-6(2),R32,89,4,2,61,83,44,61,8,22,2,4,11,52,83,8,7,44,73,30,44,11,29,5,8,10,41,73
2010-09-20 00:00:00.000,Metz France ATP World Tour 250,HARD,2,Mischa Zverev,Horacio Zeballos,Mischa Zverev,6-3; 6-2,R32,55,5,0,35,43,25,35,5,8,0,2,9,30,43,3,2,31,45,17,31,3,14,2,7,8,20,45
2010-09-20 00:00:00.000,Metz France ATP World Tour 250,HARD,2,Nicolas Mahut,N/A Bye,Nicolas Mahut,,R32,0,0,0,0,0,0,0,0,0,0,0,0,0,0,0,0,0,0,0,0,0,0,0,0,0,0,0
2010-09-20 00:00:00.000,Metz France ATP World Tour 250,HARD,2,Marin Cilic,Lukas Lacko,Marin Cilic,7-5; 7-6(3),R16,107,12,3,44,78,37,44,21,34,3,3,12,58,78,5,0,47,79,34,47,20,32,7,8,12,54,79
2010-09-20 00:00:00.000,Metz France ATP World Tour 250,HARD,2,Philipp Kohlschreiber,Michael Berrer,Philipp Kohlschreiber,6-4; 6-2,R16,75,2,2,34,58,30,34,12,24,4,4,9,42,58,8,3,37,57,26,37,7,20,4,7,9,33,57
2010-09-20 00:00:00.000,Metz France ATP World Tour 250,HARD,2,Xavier Malisse,Ivan Ljubicic,Xavier Malisse,7-5; 6-2,R16,80,5,1,40,58,30,40,12,18,1,1,10,42,58,12,3,29,58,23,29,11,29,3,6,10,34,58
2010-09-20 00:00:00.000,Metz France ATP World Tour 250,HARD,2,Gilles Simon,Igor Sijsling,Gilles Simon,6-1; 6-7(5); 6-3,R16,113,15,2,52,102,44,52,28,50,7,8,15,72,102,13,5,63,108,46,63,17,45,8,12,13,63,108
2010-09-20 00:00:00.000,Metz France ATP World Tour 250,HARD,2,Tommy Robredo,Denis Istomin,Tommy Robredo,6-4; 6-2,R16,73,6,0,36,50,29,36,7,14,0,1,9,36,50,1,3,34,51,21,34,6,17,0,4,9,27,51
2010-09-20 00:00:00.000,Metz France ATP World Tour 250,HARD,2,Richard Gasquet,Paul-Henri Mathieu,Richard Gasquet,4-6; 7-6(5); 7-6(3),R16,158,17,1,73,113,60,73,23,40,4,5,17,83,113,6,2,54,103,43,54,35,49,1,1,17,78,103
2010-09-20 00:00:00.000,Metz France ATP World Tour 250,HARD,2,Jarkko Nieminen,Kristof Vliegen,Jarkko Nieminen,6-4; 6-1,R16,68,3,1,43,60,30,43,9,17,6,7,9,39,60,0,0,20,41,11,20,10,21,1,5,8,21,41
2010-09-20 00:00:00.000,Metz France ATP World Tour 250,HARD,2,Mischa Zverev,Nicolas Mahut,Mischa Zverev,6-4; 6-2,R16,68,1,2,37,52,30,37,8,15,3,3,9,38,52,1,1,33,53,22,33,7,20,3,6,9,29,53
2010-09-20 00:00:00.000,Metz France ATP World Tour 250,HARD,2,Philipp Kohlschreiber,Marin Cilic,Philipp Kohlschreiber,6-4; 6-1,Q,79,6,1,40,62,29,40,15,22,4,4,9,44,62,1,1,23,47,15,23,13,24,4,7,8,28,47
2010-09-20 00:00:00.000,Metz France ATP World Tour 250,HARD,2,Gilles Simon,Xavier Malisse,Gilles Simon,7-5; 4-6; 6-1,Q,115,8,2,55,90,46,55,18,35,7,8,15,64,90,7,2,52,93,35,52,23,41,5,8,14,58,93
2010-09-20 00:00:00.000,Metz France ATP World Tour 250,HARD,2,Richard Gasquet,Tommy Robredo,Richard Gasquet,7-6(3); 7-6(5),Q,116,5,3,47,74,39,47,13,27,2,4,12,52,74,4,0,57,90,39,57,17,33,5,7,12,56,90
2010-09-20 00:00:00.000,Metz France ATP World Tour 250,HARD,2,Mischa Zverev,Jarkko Nieminen,Mischa Zverev,7-6(0); 6-3,Q,79,6,0,51,69,37,51,11,18,4,5,11,48,69,2,0,41,62,30,41,8,21,5,7,10,38,62
2010-09-20 00:00:00.000,Metz France ATP World Tour 250,HARD,2,Gilles Simon,Philipp Kohlschreiber,Gilles Simon,6-3; 6-2,S,54,8,0,29,42,26,29,10,13,0,0,9,36,42,1,0,26,43,17,26,9,17,1,4,8,26,43
2010-09-20 00:00:00.000,Metz France ATP World Tour 250,HARD,2,Mischa Zverev,Richard Gasquet,Mischa Zverev,W/O,S,0,0,0,0,0,0,0,0,0,0,0,0,0,0,0,0,0,0,0,0,0,0,0,0,0,0,0
2010-09-20 00:00:00.000,Metz France ATP World Tour 250,HARD,2,Gilles Simon,Mischa Zverev,Gilles Simon,6-3; 6-2,F,67,9,0,32,52,27,32,11,20,1,1,9,38,52,2,0,41,61,26,41,7,20,7,10,8,33,61
2010-09-27 00:00:00.000,Bangkok Thailand ATP World Tour 250,HARD,2,Rafael Nadal,N/A Bye,Rafael Nadal,,R32,0,0,0,0,0,0,0,0,0,0,0,0,0,0,0,0,0,0,0,0,0,0,0,0,0,0,0
2010-09-27 00:00:00.000,Bangkok Thailand ATP World Tour 250,HARD,2,Ruben Bemelmans,Frederik Nielsen,Ruben Bemelmans,6-2; 6-3,R32,69,5,0,39,57,28,39,7,18,7,8,8,35,57,1,3,46,66,22,46,8,20,7,12,9,30,66
2010-09-27 00:00:00.000,Bangkok Thailand ATP World Tour 250,HARD,2,Mikhail Kukushkin,Ryler DeHeart,Mikhail Kukushkin,6-3; 6-7(4); 6-4,R32,128,5,0,62,87,47,62,19,25,4,4,15,66,87,8,3,76,110,50,76,19,34,6,9,16,69,110
2010-09-27 00:00:00.000,Bangkok Thailand ATP World Tour 250,HARD,2,Olivier Rochus,Juan Martin Del Potro,Olivier Rochus,7-6(7); 6-4,R32,104,0,0,48,64,37,48,9,16,1,2,11,46,64,16,1,53,81,40,53,10,28,7,9,11,50,81
2010-09-27 00:00:00.000,Bangkok Thailand ATP World Tour 250,HARD,2,Ernests Gulbis,N/A Bye,Ernests Gulbis,,R32,0,0,0,0,0,0,0,0,0,0,0,0,0,0,0,0,0,0,0,0,0,0,0,0,0,0,0
2010-09-27 00:00:00.000,Bangkok Thailand ATP World Tour 250,HARD,2,Rainer Schuettler,Ricardo Mello,Rainer Schuettler,6-4; 6-2,R32,81,4,0,28,51,22,28,11,23,2,4,9,33,51,0,1,34,60,20,34,9,26,4,9,9,29,60
2010-09-27 00:00:00.000,Bangkok Thailand ATP World Tour 250,HARD,2,Florent Serra,Teymuraz Gabashvili,Florent Serra,6-7(1); 6-4; 6-4,R32,163,12,0,71,102,53,71,14,31,5,6,16,67,102,8,3,81,125,57,81,20,44,8,11,16,77,125
2010-09-27 00:00:00.000,Bangkok Thailand ATP World Tour 250,HARD,2,Guillermo Garcia-Lopez,Michael Berrer,Guillermo Garcia-Lopez,6-4; 7-6(4),R32,94,5,0,36,61,28,36,18,25,2,3,11,46,61,6,4,44,74,30,44,16,30,5,7,11,46,74
2010-09-27 00:00:00.000,Bangkok Thailand ATP World Tour 250,HARD,2,Viktor Troicki,Marco Chiudinelli,Viktor Troicki,6-3; 6-1,R32,65,6,2,30,46,25,30,9,16,1,1,8,34,46,0,0,29,46,13,29,9,17,1,5,8,22,46
2010-09-27 00:00:00.000,Bangkok Thailand ATP World Tour 250,HARD,2,Jarkko Nieminen,Danai Udomchoke,Jarkko Nieminen,6-3; 6-2,R32,67,4,0,43,51,32,43,5,8,2,2,9,37,51,0,2,34,52,22,34,7,18,4,7,8,29,52
2010-09-27 00:00:00.000,Bangkok Thailand ATP World Tour 250,HARD,2,Dudi Sela,Konstantin Kravchuk,Dudi Sela,6-3; 6-4,R32,106,1,0,41,65,28,41,13,24,5,6,9,41,65,3,0,40,72,20,40,19,32,5,9,10,39,72
2010-09-27 00:00:00.000,Bangkok Thailand ATP World Tour 250,HARD,2,Jurgen Melzer,N/A Bye,Jurgen Melzer,,R32,0,0,0,0,0,0,0,0,0,0,0,0,0,0,0,0,0,0,0,0,0,0,0,0,0,0,0
2010-09-27 00:00:00.000,Bangkok Thailand ATP World Tour 250,HARD,2,Thiemo de Bakker,Marc Lopez,Thiemo de Bakker,7-5; 6-0,R32,66,11,0,34,52,29,34,7,18,2,3,9,36,52,1,0,46,58,22,46,5,12,7,12,9,27,58
2010-09-27 00:00:00.000,Bangkok Thailand ATP World Tour 250,HARD,2,Daniel Brands,Illya Marchenko,Daniel Brands,6-3; 6-4,R32,83,6,0,41,65,32,41,11,24,5,6,10,43,65,4,5,38,61,28,38,8,23,2,5,9,36,61
2010-09-27 00:00:00.000,Bangkok Thailand ATP World Tour 250,HARD,2,Benjamin Becker,Mischa Zverev,Benjamin Becker,6-1; 6-4,R32,57,8,1,41,53,33,41,7,12,3,3,9,40,53,1,1,34,48,17,34,8,14,2,5,8,25,48
2010-09-27 00:00:00.000,Bangkok Thailand ATP World Tour 250,HARD,2,Fernando Verdasco,N/A Bye,Fernando Verdasco,,R32,0,0,0,0,0,0,0,0,0,0,0,0,0,0,0,0,0,0,0,0,0,0,0,0,0,0,0
2010-09-27 00:00:00.000,Bangkok Thailand ATP World Tour 250,HARD,2,Rafael Nadal,Ruben Bemelmans,Rafael Nadal,6-1; 6-4,R16,72,2,0,26,45,24,26,13,19,0,0,9,37,45,4,0,30,44,22,30,3,14,5,8,8,25,44
2010-09-27 00:00:00.000,Bangkok Thailand ATP World Tour 250,HARD,2,Mikhail Kukushkin,Olivier Rochus,Mikhail Kukushkin,6-4; 5-7; 6-3,R16,140,17,0,67,95,42,67,19,28,7,11,16,61,95,3,1,61,92,39,61,14,31,4,9,15,53,92
2010-09-27 00:00:00.000,Bangkok Thailand ATP World Tour 250,HARD,2,Ernests Gulbis,Rainer Schuettler,Ernests Gulbis,7-6(4); 6-7(4); 6-4,R16,170,16,3,79,113,59,79,19,34,4,5,17,78,113,6,2,62,115,46,62,33,53,10,12,17,79,115
2010-09-27 00:00:00.000,Bangkok Thailand ATP World Tour 250,HARD,2,Guillermo Garcia-Lopez,Florent Serra,Guillermo Garcia-Lopez,7-5; 6-7(3); 7-5,R16,163,17,4,76,132,63,76,22,56,12,14,18,85,132,13,4,81,132,60,81,22,51,5,9,18,82,132
2010-09-27 00:00:00.000,Bangkok Thailand ATP World Tour 250,HARD,2,Jarkko Nieminen,Viktor Troicki,Jarkko Nieminen,7-6(4); 6-2,R16,100,4,0,61,88,40,61,17,27,14,15,10,57,88,2,2,43,66,29,43,13,23,4,7,10,42,66
2010-09-27 00:00:00.000,Bangkok Thailand ATP World Tour 250,HARD,2,Jurgen Melzer,Dudi Sela,Jurgen Melzer,6-3; 6-4,R16,75,6,1,39,59,25,39,12,20,1,4,10,37,59,1,1,30,57,18,30,9,27,6,11,9,27,57
2010-09-27 00:00:00.000,Bangkok Thailand ATP World Tour 250,HARD,2,Daniel Brands,Thiemo de Bakker,Daniel Brands,7-6(2); 1-6; 7-6(7),R16,133,13,1,72,102,51,72,19,30,6,8,15,70,102,18,1,70,101,56,70,19,31,3,3,16,75,101
2010-09-27 00:00:00.000,Bangkok Thailand ATP World Tour 250,HARD,2,Benjamin Becker,Fernando Verdasco,Benjamin Becker,6-4; 6-4,R16,87,9,4,39,60,31,39,10,21,1,2,10,41,60,1,4,32,61,21,32,15,29,2,5,10,36,61
2010-09-27 00:00:00.000,Bangkok Thailand ATP World Tour 250,HARD,2,Rafael Nadal,Mikhail Kukushkin,Rafael Nadal,6-2; 6-3,Q,71,7,0,34,43,31,34,5,9,0,0,9,36,43,6,0,32,50,21,32,7,18,1,4,8,28,50
2010-09-27 00:00:00.000,Bangkok Thailand ATP World Tour 250,HARD,2,Guillermo Garcia-Lopez,Ernests Gulbis,Guillermo Garcia-Lopez,7-6(4); 4-6; 6-3,Q,116,10,3,62,101,48,62,21,39,3,5,16,69,101,12,2,59,83,49,59,10,24,1,3,15,59,83
2010-09-27 00:00:00.000,Bangkok Thailand ATP World Tour 250,HARD,2,Jarkko Nieminen,Jurgen Melzer,Jarkko Nieminen,6-3; 7-6(4),Q,74,8,1,46,61,38,46,10,15,0,1,11,48,61,7,2,42,59,33,42,7,17,3,5,10,40,59
2010-09-27 00:00:00.000,Bangkok Thailand ATP World Tour 250,HARD,2,Benjamin Becker,Daniel Brands,Benjamin Becker,6-4; 6-2,Q,57,8,0,31,45,27,31,10,14,0,0,9,37,45,4,0,37,49,22,37,8,12,2,5,9,30,49
2010-09-27 00:00:00.000,Bangkok Thailand ATP World Tour 250,HARD,2,Guillermo Garcia-Lopez,Rafael Nadal,Guillermo Garcia-Lopez,2-6; 7-6(3); 6-3,S,165,10,4,87,135,60,87,23,48,24,26,15,83,135,7,4,52,84,45,52,15,32,0,1,14,60,84
2010-09-27 00:00:00.000,Bangkok Thailand ATP World Tour 250,HARD,2,Jarkko Nieminen,Benjamin Becker,Jarkko Nieminen,6-3; 6-2,S,66,1,0,39,51,32,39,6,12,0,0,9,38,51,4,2,22,45,16,22,10,23,2,5,8,26,45
2010-09-27 00:00:00.000,Bangkok Thailand ATP World Tour 250,HARD,2,Guillermo Garcia-Lopez,Jarkko Nieminen,Guillermo Garcia-Lopez,6-4; 3-6; 6-4,F,116,5,3,53,89,42,53,17,36,10,12,14,59,89,7,0,75,99,52,75,12,24,7,10,15,64,99
2010-09-27 00:00:00.000,Kuala Lumpur Malaysia ATP World Tour 250,HARD,2,Robin Soderling,N/A Bye,Robin Soderling,,R32,0,0,0,0,0,0,0,0,0,0,0,0,0,0,0,0,0,0,0,0,0,0,0,0,0,0,0
2010-09-27 00:00:00.000,Kuala Lumpur Malaysia ATP World Tour 250,HARD,2,Edouard Roger-Vasselin,Frantisek Cermak,Edouard Roger-Vasselin,6-0; 6-4,R32,68,4,2,22,48,18,22,14,26,0,1,8,32,48,1,7,21,52,15,21,7,31,3,8,8,22,52
2010-09-27 00:00:00.000,Kuala Lumpur Malaysia ATP World Tour 250,HARD,2,Kevin Anderson,Alejandro Falla,Kevin Anderson,6-1; 3-6; 7-5,R32,126,7,1,53,83,39,53,17,30,1,3,14,56,83,0,4,52,93,36,52,19,41,3,7,14,55,93
2010-09-27 00:00:00.000,Kuala Lumpur Malaysia ATP World Tour 250,HARD,2,Andrey Golubev,Yen-Hsun Lu,Andrey Golubev,7-5; 6-2,R32,78,3,1,29,55,25,29,16,26,0,0,10,41,55,1,6,36,64,24,36,14,28,5,8,10,38,64
2010-09-27 00:00:00.000,Kuala Lumpur Malaysia ATP World Tour 250,HARD,2,Tomas Berdych,N/A Bye,Tomas Berdych,,R32,0,0,0,0,0,0,0,0,0,0,0,0,0,0,0,0,0,0,0,0,0,0,0,0,0,0,0
2010-09-27 00:00:00.000,Kuala Lumpur Malaysia ATP World Tour 250,HARD,2,Denis Istomin,Marsel Ilhan,Denis Istomin,2-6; 6-3; 6-4,R32,110,10,0,51,75,33,51,20,24,2,4,14,53,75,4,3,44,88,31,44,24,44,4,6,13,55,88
2010-09-27 00:00:00.000,Kuala Lumpur Malaysia ATP World Tour 250,HARD,2,Yuki Bhambri,Yew-Ming Si,Yuki Bhambri,6-2; 6-0,R32,47,1,3,27,37,20,27,5,10,0,1,7,25,37,1,1,25,35,9,25,1,10,0,6,7,10,35
2010-09-27 00:00:00.000,Kuala Lumpur Malaysia ATP World Tour 250,HARD,2,David Ferrer,Bernard Tomic,David Ferrer,6-3; 6-4,R32,99,3,3,33,64,25,33,14,31,4,6,9,39,64,3,2,49,74,31,49,6,25,9,14,10,37,74
2010-09-27 00:00:00.000,Kuala Lumpur Malaysia ATP World Tour 250,HARD,2,Marcos Baghdatis,Kei Nishikori,Marcos Baghdatis,6-1; 6-1,R32,54,8,1,26,45,23,26,10,19,3,3,7,33,45,0,5,23,37,9,23,5,14,1,6,7,14,37
2010-09-27 00:00:00.000,Kuala Lumpur Malaysia ATP World Tour 250,HARD,2,Santiago Giraldo,Michal Przysiezny,Santiago Giraldo,7-6(8); 6-1,R32,101,5,6,37,67,28,37,13,30,2,4,10,41,67,5,5,23,67,16,23,18,44,2,6,9,34,67
2010-09-27 00:00:00.000,Kuala Lumpur Malaysia ATP World Tour 250,HARD,2,Alexandr Dolgopolov,Laurent Recouderc,Alexandr Dolgopolov,6-3; 6-1,R32,50,4,1,23,42,19,23,13,19,3,4,8,32,42,0,1,24,50,14,24,7,26,3,8,8,21,50
2010-09-27 00:00:00.000,Kuala Lumpur Malaysia ATP World Tour 250,HARD,2,Mikhail Youzhny,N/A Bye,Mikhail Youzhny,,R32,0,0,0,0,0,0,0,0,0,0,0,0,0,0,0,0,0,0,0,0,0,0,0,0,0,0,0
2010-09-27 00:00:00.000,Kuala Lumpur Malaysia ATP World Tour 250,HARD,2,Sergiy Stakhovsky,Michael Russell,Sergiy Stakhovsky,2-6; 7-6(4); 6-3,R32,167,12,5,58,104,44,58,18,46,5,10,15,62,104,0,4,73,100,47,73,13,27,11,15,14,60,100
2010-09-27 00:00:00.000,Kuala Lumpur Malaysia ATP World Tour 250,HARD,2,Milos Raonic,Igor Kunitsyn,Milos Raonic,7-6(6); 6-3,R32,85,23,0,44,77,39,44,16,33,2,2,11,55,77,0,2,40,70,28,40,17,30,2,3,10,45,70
2010-09-27 00:00:00.000,Kuala Lumpur Malaysia ATP World Tour 250,HARD,2,Igor Andreev,Go Soeda,Igor Andreev,6-1; 6-4,R32,93,7,0,34,64,24,34,19,30,3,3,9,43,64,4,2,27,66,18,27,18,39,3,6,8,36,66
2010-09-27 00:00:00.000,Kuala Lumpur Malaysia ATP World Tour 250,HARD,2,Nikolay Davydenko,N/A Bye,Nikolay Davydenko,,R32,0,0,0,0,0,0,0,0,0,0,0,0,0,0,0,0,0,0,0,0,0,0,0,0,0,0,0
2010-09-27 00:00:00.000,Kuala Lumpur Malaysia ATP World Tour 250,HARD,2,Robin Soderling,Edouard Roger-Vasselin,Robin Soderling,6-0; 6-1,R16,63,4,2,20,38,16,20,11,18,2,2,6,27,38,4,5,30,60,15,30,9,30,8,14,7,24,60
2010-09-27 00:00:00.000,Kuala Lumpur Malaysia ATP World Tour 250,HARD,2,Andrey Golubev,Kevin Anderson,Andrey Golubev,6-4; 7-6(4),R16,100,3,3,42,68,32,42,13,26,0,2,11,45,68,6,3,45,68,33,45,9,23,2,5,11,42,68
2010-09-27 00:00:00.000,Kuala Lumpur Malaysia ATP World Tour 250,HARD,2,Tomas Berdych,Denis Istomin,Tomas Berdych,6-4; 6-3,R16,83,7,1,24,43,20,24,11,19,1,3,9,31,43,5,0,47,73,26,47,11,26,6,11,10,37,73
2010-09-27 00:00:00.000,Kuala Lumpur Malaysia ATP World Tour 250,HARD,2,David Ferrer,Yuki Bhambri,David Ferrer,6-2; 6-2,R16,58,0,2,24,38,21,24,5,14,0,2,8,26,38,2,6,31,50,15,31,5,19,3,9,8,20,50
2010-09-27 00:00:00.000,Kuala Lumpur Malaysia ATP World Tour 250,HARD,2,Marcos Baghdatis,Santiago Giraldo,Marcos Baghdatis,7-5; 7-5,R16,107,11,3,44,67,36,44,10,23,1,3,12,46,67,5,0,53,85,34,53,14,32,5,9,12,48,85
2010-09-27 00:00:00.000,Kuala Lumpur Malaysia ATP World Tour 250,HARD,2,Mikhail Youzhny,Alexandr Dolgopolov,Mikhail Youzhny,6-1; 5-7; 7-5,R16,115,10,2,65,99,50,65,16,34,8,10,16,66,99,13,3,48,84,36,48,19,36,2,6,15,55,84
2010-09-27 00:00:00.000,Kuala Lumpur Malaysia ATP World Tour 250,HARD,2,Milos Raonic,Sergiy Stakhovsky,Milos Raonic,6-7(8); 7-6(9); 6-3,R16,148,15,6,75,122,60,75,27,47,3,3,16,87,122,8,6,76,118,60,76,21,42,7,9,17,81,118
2010-09-27 00:00:00.000,Kuala Lumpur Malaysia ATP World Tour 250,HARD,2,Igor Andreev,Nikolay Davydenko,Igor Andreev,7-6(5); 5-7; 6-3,R16,167,7,1,68,116,48,68,22,48,5,9,17,70,116,6,6,59,109,45,59,21,50,8,12,16,66,109
2010-09-27 00:00:00.000,Kuala Lumpur Malaysia ATP World Tour 250,HARD,2,Andrey Golubev,Robin Soderling,Andrey Golubev,6-3; 6-2,Q,72,6,1,28,52,21,28,16,24,4,4,8,37,52,5,6,32,60,23,32,9,28,4,8,9,32,60
2010-09-27 00:00:00.000,Kuala Lumpur Malaysia ATP World Tour 250,HARD,2,David Ferrer,Tomas Berdych,David Ferrer,4-6; 7-5; 6-4,Q,148,5,1,68,101,47,68,21,33,6,8,16,68,101,5,3,42,80,33,42,24,38,0,3,16,57,80
2010-09-27 00:00:00.000,Kuala Lumpur Malaysia ATP World Tour 250,HARD,2,Mikhail Youzhny,Marcos Baghdatis,Mikhail Youzhny,6-7(5); 7-5; 6-1,Q,161,4,6,66,112,47,66,21,46,5,9,16,68,112,6,5,48,92,33,48,18,44,4,11,15,51,92
2010-09-27 00:00:00.000,Kuala Lumpur Malaysia ATP World Tour 250,HARD,2,Igor Andreev,Milos Raonic,Igor Andreev,6-1; 3-6; 6-3,Q,88,2,2,43,70,32,43,20,27,2,3,13,52,70,6,5,39,73,28,39,16,34,2,5,12,44,73
2010-09-27 00:00:00.000,Kuala Lumpur Malaysia ATP World Tour 250,HARD,2,Andrey Golubev,David Ferrer,Andrey Golubev,7-5; 7-6(4),S,107,4,2,44,70,32,44,19,26,1,2,12,51,70,0,0,64,85,42,64,11,21,7,9,12,53,85
2010-09-27 00:00:00.000,Kuala Lumpur Malaysia ATP World Tour 250,HARD,2,Mikhail Youzhny,Igor Andreev,Mikhail Youzhny,3-6; 6-0; 6-2,S,98,3,2,43,61,33,43,12,18,2,4,12,45,61,3,7,42,74,25,42,15,32,6,11,11,40,74
2010-09-27 00:00:00.000,Kuala Lumpur Malaysia ATP World Tour 250,HARD,2,Mikhail Youzhny,Andrey Golubev,Mikhail Youzhny,6-7(7); 6-2; 7-6(3),F,152,1,4,61,102,46,61,25,41,2,4,16,71,102,4,2,62,106,37,62,28,44,2,6,16,65,106
2010-10-04 00:00:00.000,Beijing China ATP World Tour 500,HARD,2,Novak Djokovic,Mao-Xin Gong,Novak Djokovic,6-1; 6-3,R32,71,3,1,23,41,20,23,12,18,0,0,8,32,41,1,2,38,66,17,38,15,28,7,11,8,32,66
2010-10-04 00:00:00.000,Beijing China ATP World Tour 500,HARD,2,Mardy Fish,Janko Tipsarevic,Mardy Fish,6-2; 7-6(5),R32,112,10,3,38,68,31,38,16,30,4,5,10,47,68,2,2,39,69,25,39,15,30,6,9,10,40,69
2010-10-04 00:00:00.000,Beijing China ATP World Tour 500,HARD,2,Gilles Simon,Sam Querrey,Gilles Simon,6-3; 3-6; 6-2,R32,130,2,7,51,95,34,51,20,44,11,16,13,54,95,7,10,40,93,28,40,19,53,2,9,13,47,93
2010-10-04 00:00:00.000,Beijing China ATP World Tour 500,HARD,2,Michael Berrer,Tomas Berdych,Michael Berrer,4-6; 7-5; 6-4,R32,125,4,4,55,98,43,55,18,43,5,8,15,61,98,9,2,47,69,36,47,10,22,1,5,14,46,69
2010-10-04 00:00:00.000,Beijing China ATP World Tour 500,HARD,2,Nikolay Davydenko,Florian Mayer,Nikolay Davydenko,6-3; 6-4,R32,60,3,2,33,53,27,33,10,20,2,3,10,37,53,1,0,29,45,22,29,7,16,2,5,9,29,45
2010-10-04 00:00:00.000,Beijing China ATP World Tour 500,HARD,2,Marin Cilic,Thomaz Bellucci,Marin Cilic,6-2; 6-2,R32,59,5,0,24,42,22,24,11,18,0,0,8,33,42,2,0,24,37,16,24,5,13,3,7,8,21,37
2010-10-04 00:00:00.000,Beijing China ATP World Tour 500,HARD,2,John Isner,Tsung-Hua Yang,John Isner,7-6(5); 6-3,R32,87,11,0,48,59,39,48,6,11,0,0,10,45,59,7,1,35,74,29,35,19,39,8,10,11,48,74
2010-10-04 00:00:00.000,Beijing China ATP World Tour 500,HARD,2,Philipp Kohlschreiber,Fernando Verdasco,Philipp Kohlschreiber,6-2; 7-5,R32,85,9,3,38,59,29,38,11,21,4,5,10,40,59,5,6,36,58,23,36,8,22,0,4,10,31,58
2010-10-04 00:00:00.000,Beijing China ATP World Tour 500,HARD,2,David Ferrer,Denis Istomin,David Ferrer,6-4; 6-1,R32,63,5,0,32,42,27,32,7,10,4,4,8,34,42,2,1,36,58,19,36,11,22,2,6,9,30,58
2010-10-04 00:00:00.000,Beijing China ATP World Tour 500,HARD,2,Yen-Hsun Lu,Illya Marchenko,Yen-Hsun Lu,6-4; 7-6(7),R32,120,2,4,43,83,31,43,22,40,4,6,11,53,83,2,5,38,78,28,38,20,40,3,6,11,48,78
2010-10-04 00:00:00.000,Beijing China ATP World Tour 500,HARD,2,Nicolas Almagro,Lukasz Kubot,Nicolas Almagro,7-5; 6-2,R32,96,4,1,34,57,27,34,12,23,3,4,10,39,57,4,7,45,79,27,45,14,34,8,12,10,41,79
2010-10-04 00:00:00.000,Beijing China ATP World Tour 500,HARD,2,Robin Soderling,Tommy Robredo,Robin Soderling,4-6; 6-1; 6-4,R32,92,11,1,48,76,35,48,17,28,7,8,11,52,76,8,1,39,64,24,39,15,25,2,5,11,39,64
2010-10-04 00:00:00.000,Beijing China ATP World Tour 500,HARD,2,Ivan Ljubicic,Mikhail Youzhny,Ivan Ljubicic,6-3; 7-6(3),R32,105,15,2,35,73,29,35,21,38,3,4,11,50,73,0,1,39,64,25,39,16,25,3,5,10,41,64
2010-10-04 00:00:00.000,Beijing China ATP World Tour 500,HARD,2,Alexandr Dolgopolov,Marcos Baghdatis,Alexandr Dolgopolov,6-4; 6-4,R32,83,5,1,37,77,24,37,18,40,7,10,10,42,77,1,4,26,63,18,26,15,37,5,10,10,33,63
2010-10-04 00:00:00.000,Beijing China ATP World Tour 500,HARD,2,Albert Montanes,Andrey Golubev,Albert Montanes,6-2; 3-0 RET,R32,41,1,2,17,27,14,17,6,10,0,0,5,20,27,2,3,20,33,9,20,5,13,2,6,6,14,33
2010-10-04 00:00:00.000,Beijing China ATP World Tour 500,HARD,2,Andy Murray,Paul-Henri Mathieu,Andy Murray,6-2; 6-3,R32,74,10,2,21,43,17,21,17,22,2,2,8,34,43,2,7,28,63,21,28,12,35,6,10,9,33,63
2010-10-04 00:00:00.000,Beijing China ATP World Tour 500,HARD,2,Novak Djokovic,Mardy Fish,Novak Djokovic,W/O,R16,0,0,0,0,0,0,0,0,0,0,0,0,0,0,0,0,0,0,0,0,0,0,0,0,0,0,0
2010-10-04 00:00:00.000,Beijing China ATP World Tour 500,HARD,2,Gilles Simon,Michael Berrer,Gilles Simon,6-7(6); 6-4; 7-6(4),R16,186,16,5,74,117,58,74,19,43,6,7,17,77,117,5,2,96,138,67,96,16,42,5,7,17,83,138
2010-10-04 00:00:00.000,Beijing China ATP World Tour 500,HARD,2,Nikolay Davydenko,Marin Cilic,Nikolay Davydenko,7-5; 7-5,R16,113,0,4,43,78,32,43,18,35,5,7,12,50,78,5,2,42,71,31,42,11,29,3,7,12,42,71
2010-10-04 00:00:00.000,Beijing China ATP World Tour 500,HARD,2,John Isner,Philipp Kohlschreiber,John Isner,7-6(3); 3-6; 6-3,R16,132,20,1,74,103,53,74,18,29,3,4,15,71,103,13,2,62,100,47,62,21,38,4,5,15,68,100
2010-10-04 00:00:00.000,Beijing China ATP World Tour 500,HARD,2,David Ferrer,Yen-Hsun Lu,David Ferrer,6-3; 3-6; 6-1,R16,119,3,4,44,71,33,44,13,27,1,4,13,46,71,1,1,41,86,25,41,21,45,7,12,12,46,86
2010-10-04 00:00:00.000,Beijing China ATP World Tour 500,HARD,2,Robin Soderling,Nicolas Almagro,Robin Soderling,7-5; 4-6; 6-3,R16,117,22,5,55,86,50,55,14,31,2,3,16,64,86,18,1,68,103,48,68,17,35,5,7,15,65,103
2010-10-04 00:00:00.000,Beijing China ATP World Tour 500,HARD,2,Ivan Ljubicic,Alexandr Dolgopolov,Ivan Ljubicic,6-3; 7-6(2),R16,82,11,1,31,60,25,31,18,29,0,1,11,43,60,5,2,35,64,28,35,11,29,1,3,10,39,64
2010-10-04 00:00:00.000,Beijing China ATP World Tour 500,HARD,2,Andy Murray,Albert Montanes,Andy Murray,7-5; 6-3,R16,96,9,3,32,63,27,32,17,31,3,5,11,44,63,2,3,41,78,26,41,17,37,6,10,10,43,78
2010-10-04 00:00:00.000,Beijing China ATP World Tour 500,HARD,2,Novak Djokovic,Gilles Simon,Novak Djokovic,6-3; 6-2,Q,85,4,0,50,68,36,50,12,18,7,7,9,48,68,2,0,31,46,20,31,7,15,4,7,8,27,46
2010-10-04 00:00:00.000,Beijing China ATP World Tour 500,HARD,2,John Isner,Nikolay Davydenko,John Isner,7-6(2); 6-4,Q,97,18,0,57,85,43,57,15,28,6,6,11,58,85,1,5,52,69,38,52,9,17,2,3,11,47,69
2010-10-04 00:00:00.000,Beijing China ATP World Tour 500,HARD,2,David Ferrer,Robin Soderling,David Ferrer,6-2; 6-4,Q,81,4,2,39,60,28,39,11,21,4,5,9,39,60,2,5,29,59,17,29,13,30,5,9,9,30,59
2010-10-04 00:00:00.000,Beijing China ATP World Tour 500,HARD,2,Ivan Ljubicic,Andy Murray,Ivan Ljubicic,6-3; 6-2,Q,67,12,0,28,48,25,28,11,20,0,0,9,36,48,4,1,32,54,23,32,8,22,2,5,8,31,54
2010-10-04 00:00:00.000,Beijing China ATP World Tour 500,HARD,2,Novak Djokovic,John Isner,Novak Djokovic,7-6(1); 6-2,S,87,5,0,30,53,24,30,17,23,1,2,10,41,53,7,3,51,79,35,51,9,28,9,12,10,44,79
2010-10-04 00:00:00.000,Beijing China ATP World Tour 500,HARD,2,David Ferrer,Ivan Ljubicic,David Ferrer,6-4; 4-6; 6-4,S,146,5,1,60,89,40,60,19,29,3,5,15,59,89,6,1,63,104,41,63,21,41,6,9,15,62,104
2010-10-04 00:00:00.000,Beijing China ATP World Tour 500,HARD,2,Novak Djokovic,David Ferrer,Novak Djokovic,6-2; 6-4,F,84,3,1,32,49,25,32,10,17,0,1,9,35,49,2,1,33,58,23,33,8,25,2,6,9,31,58
2010-10-04 00:00:00.000,Tokyo Japan ATP World Tour 500,HARD,2,Rafael Nadal,Santiago Giraldo,Rafael Nadal,6-4; 6-4,R32,110,4,2,44,71,33,44,14,27,4,4,10,47,71,8,1,47,72,30,47,15,25,5,7,10,45,72
2010-10-04 00:00:00.000,Tokyo Japan ATP World Tour 500,HARD,2,Milos Raonic,Florent Serra,Milos Raonic,6-4; 3-6; 6-4,R32,102,22,5,53,85,43,53,16,32,6,7,14,59,85,7,1,73,98,48,73,17,25,8,10,15,65,98
2010-10-04 00:00:00.000,Tokyo Japan ATP World Tour 500,HARD,2,Richard Gasquet,Thiemo de Bakker,Richard Gasquet,6-3; 7-6(6),R32,99,8,3,47,80,36,47,17,33,6,7,11,53,80,7,1,44,73,36,44,10,29,7,9,10,46,73
2010-10-04 00:00:00.000,Tokyo Japan ATP World Tour 500,HARD,2,Dmitry Tursunov,Ernests Gulbis,Dmitry Tursunov,6-3; 6-4,R32,74,7,2,33,55,26,33,15,22,0,0,10,41,55,11,4,37,58,29,37,8,21,2,4,9,37,58
2010-10-04 00:00:00.000,Tokyo Japan ATP World Tour 500,HARD,2,Jurgen Melzer,Juan Monaco,Jurgen Melzer,6-4; 4-6; 6-1,R32,108,3,1,50,70,34,50,11,20,2,5,13,45,70,2,4,61,81,39,61,5,20,2,8,14,44,81
2010-10-04 00:00:00.000,Tokyo Japan ATP World Tour 500,HARD,2,Viktor Troicki,Kei Nishikori,Viktor Troicki,6-4; 6-2,R32,82,8,4,27,48,25,27,8,21,1,3,9,33,48,0,4,45,79,26,45,13,34,9,14,9,39,79
2010-10-04 00:00:00.000,Tokyo Japan ATP World Tour 500,HARD,2,Guillermo Garcia-Lopez,Rajeev Ram,Guillermo Garcia-Lopez,6-7(3); 6-4; 7-6(1),R32,129,17,2,57,104,44,57,31,47,7,8,17,75,104,17,5,65,107,53,65,18,42,3,5,17,71,107
2010-10-04 00:00:00.000,Tokyo Japan ATP World Tour 500,HARD,2,Feliciano Lopez,Juan Martin Del Potro,Feliciano Lopez,6-3; 6-0,R32,81,11,5,35,67,29,35,12,32,11,12,8,41,67,5,4,25,52,11,25,10,27,5,10,7,21,52
2010-10-04 00:00:00.000,Tokyo Japan ATP World Tour 500,HARD,2,Marco Chiudinelli,Michael Llodra,Marco Chiudinelli,6-3; 6-0,R32,61,3,2,28,43,21,28,10,15,2,2,7,31,43,3,2,31,53,15,31,10,22,2,7,8,25,53
2010-10-04 00:00:00.000,Tokyo Japan ATP World Tour 500,HARD,2,Radek Stepanek,Alejandro Falla,Radek Stepanek,2-6; 7-6(5); 7-6(5),R32,170,9,3,69,112,45,69,25,43,3,7,16,70,112,4,5,65,112,43,65,28,47,3,5,16,71,112
2010-10-04 00:00:00.000,Tokyo Japan ATP World Tour 500,HARD,2,Daniel Gimeno-Traver,Eduardo Schwank,Daniel Gimeno-Traver,6-4; 6-4,R32,101,12,3,40,64,29,40,16,24,2,2,10,45,64,9,4,42,67,29,42,14,25,3,5,10,43,67
2010-10-04 00:00:00.000,Tokyo Japan ATP World Tour 500,HARD,2,Jarkko Nieminen,Jo-Wilfried Tsonga,Jarkko Nieminen,6-4; 5-7; 6-1,R32,120,3,3,49,74,41,49,14,25,1,3,15,55,74,14,6,63,104,45,63,15,41,10,14,14,60,104
2010-10-04 00:00:00.000,Tokyo Japan ATP World Tour 500,HARD,2,Gael Monfils,Go Soeda,Gael Monfils,7-6(10); 6-4,R32,112,10,4,53,87,35,53,18,34,4,7,11,53,87,1,4,43,81,29,43,18,38,5,9,11,47,81
2010-10-04 00:00:00.000,Tokyo Japan ATP World Tour 500,HARD,2,Andreas Seppi,Ivan Dodig,Andreas Seppi,3-6; 6-4; 6-2,R32,109,6,4,49,79,36,49,16,30,5,7,13,52,79,16,2,50,74,34,50,13,24,2,6,14,47,74
2010-10-04 00:00:00.000,Tokyo Japan ATP World Tour 500,HARD,2,Jeremy Chardy,Edouard Roger-Vasselin,Jeremy Chardy,6-3; 7-6(2),R32,89,13,2,40,64,35,40,14,24,1,1,11,49,64,1,3,42,71,32,42,11,29,2,3,10,43,71
2010-10-04 00:00:00.000,Tokyo Japan ATP World Tour 500,HARD,2,Andy Roddick,Tatsuma Ito,Andy Roddick,6-4; 6-3,R32,83,8,2,28,51,24,28,14,23,2,3,10,38,51,3,2,30,61,19,30,15,31,4,7,9,34,61
2010-10-04 00:00:00.000,Tokyo Japan ATP World Tour 500,HARD,2,Rafael Nadal,Milos Raonic,Rafael Nadal,6-4; 6-4,R16,73,5,1,44,58,35,44,9,14,5,5,10,44,58,14,1,35,52,30,35,5,17,0,2,10,35,52
2010-10-04 00:00:00.000,Tokyo Japan ATP World Tour 500,HARD,2,Dmitry Tursunov,Richard Gasquet,Dmitry Tursunov,7-6(2); 1-6; 6-4,R16,123,6,1,51,83,38,51,23,32,4,7,15,61,83,6,4,61,94,44,61,18,33,5,6,14,62,94
2010-10-04 00:00:00.000,Tokyo Japan ATP World Tour 500,HARD,2,Viktor Troicki,Jurgen Melzer,Viktor Troicki,7-6(7); 3-6; 7-6(3),R16,141,18,5,68,101,59,68,13,33,3,7,17,72,101,10,3,70,118,45,70,31,48,1,3,16,76,118
2010-10-04 00:00:00.000,Tokyo Japan ATP World Tour 500,HARD,2,Guillermo Garcia-Lopez,Feliciano Lopez,Guillermo Garcia-Lopez,7-6(5); 6-4,R16,92,8,3,29,64,24,29,28,35,4,4,11,52,64,12,4,41,79,32,41,19,38,1,2,11,51,79
2010-10-04 00:00:00.000,Tokyo Japan ATP World Tour 500,HARD,2,Radek Stepanek,Marco Chiudinelli,Radek Stepanek,5-7; 7-6(7); 4-1 RET,R16,144,12,2,63,93,51,63,14,30,2,3,15,65,93,7,9,57,97,47,57,17,40,5,6,14,64,97
2010-10-04 00:00:00.000,Tokyo Japan ATP World Tour 500,HARD,2,Jarkko Nieminen,Daniel Gimeno-Traver,Jarkko Nieminen,6-3; 7-6(8),R16,86,3,0,50,68,38,50,14,18,2,2,11,52,68,7,0,44,62,32,44,12,18,2,3,10,44,62
2010-10-04 00:00:00.000,Tokyo Japan ATP World Tour 500,HARD,2,Gael Monfils,Andreas Seppi,Gael Monfils,6-4; 6-4,R16,77,7,2,55,65,37,55,7,10,3,4,10,44,65,3,3,39,70,23,39,16,31,5,8,10,39,70
2010-10-04 00:00:00.000,Tokyo Japan ATP World Tour 500,HARD,2,Andy Roddick,Jeremy Chardy,Andy Roddick,6-4; 7-6(4),R16,91,5,1,48,63,40,48,11,15,1,1,11,51,63,6,0,47,68,35,47,12,21,0,1,11,47,68
2010-10-04 00:00:00.000,Tokyo Japan ATP World Tour 500,HARD,2,Rafael Nadal,Dmitry Tursunov,Rafael Nadal,6-4; 6-1,Q,73,5,1,22,42,17,22,14,20,0,1,8,31,42,3,1,47,63,27,47,4,16,5,10,9,31,63
2010-10-04 00:00:00.000,Tokyo Japan ATP World Tour 500,HARD,2,Viktor Troicki,Guillermo Garcia-Lopez,Viktor Troicki,6-2; 3-6; 6-4,Q,98,14,5,49,78,35,49,13,29,5,8,13,48,78,7,4,44,78,30,44,15,34,1,6,14,45,78
2010-10-04 00:00:00.000,Tokyo Japan ATP World Tour 500,HARD,2,Radek Stepanek,Jarkko Nieminen,Radek Stepanek,W/O,Q,0,0,0,0,0,0,0,0,0,0,0,0,0,0,0,0,0,0,0,0,0,0,0,0,0,0,0
2010-10-04 00:00:00.000,Tokyo Japan ATP World Tour 500,HARD,2,Gael Monfils,Andy Roddick,Gael Monfils,7-6(5); 4-6; 7-6(6),Q,176,16,0,72,108,59,72,22,36,2,3,17,81,108,8,0,86,130,67,86,23,44,10,10,17,90,130
2010-10-04 00:00:00.000,Tokyo Japan ATP World Tour 500,HARD,2,Rafael Nadal,Viktor Troicki,Rafael Nadal,7-6(4); 4-6; 7-6(7),S,158,18,3,70,113,53,70,25,43,2,5,17,78,113,26,4,71,102,56,71,19,31,2,4,17,75,102
2010-10-04 00:00:00.000,Tokyo Japan ATP World Tour 500,HARD,2,Gael Monfils,Radek Stepanek,Gael Monfils,6-3; 6-3,S,70,5,1,45,54,34,45,5,9,1,1,9,39,54,2,0,38,57,25,38,9,19,2,5,9,34,57
2010-10-04 00:00:00.000,Tokyo Japan ATP World Tour 500,HARD,2,Rafael Nadal,Gael Monfils,Rafael Nadal,6-1; 7-5,F,77,1,1,31,51,28,31,12,20,0,0,10,40,51,9,0,40,47,26,40,3,7,1,4,9,29,47
2010-10-10 00:00:00.000,ATP World Tour Masters 1000 Shanghai China ATP World Tour Masters 1000,HARD,2,Rafael Nadal,N/A Bye,Rafael Nadal,,R64,0,0,0,0,0,0,0,0,0,0,0,0,0,0,0,0,0,0,0,0,0,0,0,0,0,0,0
2010-10-10 00:00:00.000,ATP World Tour Masters 1000 Shanghai China ATP World Tour Masters 1000,HARD,2,Stanislas Wawrinka,Gilles Simon,Stanislas Wawrinka,6-4; 6-1,R64,76,2,3,22,50,17,22,18,28,2,2,8,35,50,3,5,32,61,19,32,14,29,2,6,9,33,61
2010-10-10 00:00:00.000,ATP World Tour Masters 1000 Shanghai China ATP World Tour Masters 1000,HARD,2,Daniel Gimeno-Traver,Denis Istomin,Daniel Gimeno-Traver,3-6; 6-3; 6-3,R64,90,10,5,48,76,42,48,12,28,1,2,13,54,76,4,4,49,85,35,49,18,36,6,9,14,53,85
2010-10-10 00:00:00.000,ATP World Tour Masters 1000 Shanghai China ATP World Tour Masters 1000,HARD,2,Jurgen Melzer,Tsung-Hua Yang,Jurgen Melzer,6-4; 7-6(5),R64,108,3,0,29,68,21,29,25,39,1,3,11,46,68,7,2,42,80,30,42,18,38,4,7,11,48,80
2010-10-10 00:00:00.000,ATP World Tour Masters 1000 Shanghai China ATP World Tour Masters 1000,HARD,2,Thiemo de Bakker,Fernando Verdasco,Thiemo de Bakker,7-6(4); 7-5,R64,113,7,2,52,74,38,52,14,22,3,4,12,52,74,6,5,44,73,35,44,13,29,2,4,12,48,73
2010-10-10 00:00:00.000,ATP World Tour Masters 1000 Shanghai China ATP World Tour Masters 1000,HARD,2,Juan Monaco,Florent Serra,Juan Monaco,6-4; 7-6(3),R64,103,7,0,53,64,36,53,6,11,1,4,11,42,64,2,1,56,84,31,56,12,28,7,11,11,43,84
2010-10-10 00:00:00.000,ATP World Tour Masters 1000 Shanghai China ATP World Tour Masters 1000,HARD,2,Mischa Zverev,Sergiy Stakhovsky,Mischa Zverev,6-1; 4-6; 7-6(7),R64,132,2,1,52,86,37,52,16,34,0,5,14,53,86,4,3,62,103,37,62,17,41,6,13,15,54,103
2010-10-10 00:00:00.000,ATP World Tour Masters 1000 Shanghai China ATP World Tour Masters 1000,HARD,2,Nikolay Davydenko,N/A Bye,Nikolay Davydenko,,R64,0,0,0,0,0,0,0,0,0,0,0,0,0,0,0,0,0,0,0,0,0,0,0,0,0,0,0
2010-10-10 00:00:00.000,ATP World Tour Masters 1000 Shanghai China ATP World Tour Masters 1000,HARD,2,Andy Murray,N/A Bye,Andy Murray,,R64,0,0,0,0,0,0,0,0,0,0,0,0,0,0,0,0,0,0,0,0,0,0,0,0,0,0,0
2010-10-10 00:00:00.000,ATP World Tour Masters 1000 Shanghai China ATP World Tour Masters 1000,HARD,2,Yan Bai,Radek Stepanek,Yan Bai,6-3; 6-4,R64,88,3,1,42,64,27,42,13,22,4,6,10,40,64,2,4,39,57,23,39,8,18,0,4,9,31,57
2010-10-10 00:00:00.000,ATP World Tour Masters 1000 Shanghai China ATP World Tour Masters 1000,HARD,2,Jeremy Chardy,Marcos Baghdatis,Jeremy Chardy,7-6(4); 6-1,R64,100,1,3,46,79,31,46,20,33,5,6,10,51,79,6,1,40,65,28,40,11,25,5,8,9,39,65
2010-10-10 00:00:00.000,ATP World Tour Masters 1000 Shanghai China ATP World Tour Masters 1000,HARD,2,Alexandr Dolgopolov,Nicolas Almagro,Alexandr Dolgopolov,2-6; 7-5; 7-6(3),R64,125,9,1,41,90,32,41,28,49,2,6,16,60,90,4,4,65,105,42,65,24,40,3,6,16,66,105
2010-10-10 00:00:00.000,ATP World Tour Masters 1000 Shanghai China ATP World Tour Masters 1000,HARD,2,Jo-Wilfried Tsonga,Feliciano Lopez,Jo-Wilfried Tsonga,7-6(4); 6-3,R64,85,9,1,36,64,33,36,19,28,2,2,11,52,64,5,3,34,65,26,34,17,31,4,5,10,43,65
2010-10-10 00:00:00.000,ATP World Tour Masters 1000 Shanghai China ATP World Tour Masters 1000,HARD,2,Sam Querrey,Michael Berrer,Sam Querrey,6-3; 7-6(6),R64,85,18,1,51,68,41,51,11,17,4,4,11,52,68,4,3,34,59,24,34,18,25,1,2,10,42,59
2010-10-10 00:00:00.000,ATP World Tour Masters 1000 Shanghai China ATP World Tour Masters 1000,HARD,2,Florian Mayer,Kevin Anderson,Florian Mayer,6-2; 6-2,R64,64,1,1,33,51,27,33,9,18,1,1,8,36,51,5,3,40,55,26,40,3,15,5,9,8,29,55
2010-10-10 00:00:00.000,ATP World Tour Masters 1000 Shanghai China ATP World Tour Masters 1000,HARD,2,Mikhail Youzhny,N/A Bye,Mikhail Youzhny,,R64,0,0,0,0,0,0,0,0,0,0,0,0,0,0,0,0,0,0,0,0,0,0,0,0,0,0,0
2010-10-10 00:00:00.000,ATP World Tour Masters 1000 Shanghai China ATP World Tour Masters 1000,HARD,2,Robin Soderling,N/A Bye,Robin Soderling,,R64,0,0,0,0,0,0,0,0,0,0,0,0,0,0,0,0,0,0,0,0,0,0,0,0,0,0,0
2010-10-10 00:00:00.000,ATP World Tour Masters 1000 Shanghai China ATP World Tour Masters 1000,HARD,2,Janko Tipsarevic,Andrey Golubev,Janko Tipsarevic,6-3; 6-4,R64,83,2,1,32,55,26,32,13,23,1,2,10,39,55,5,1,43,72,27,43,13,29,8,11,9,40,72
2010-10-10 00:00:00.000,ATP World Tour Masters 1000 Shanghai China ATP World Tour Masters 1000,HARD,2,Thomaz Bellucci,Marsel Ilhan,Thomaz Bellucci,6-1; 2-6; 7-6(4),R64,125,6,2,48,77,32,48,18,29,5,8,13,50,77,9,4,61,94,45,61,10,33,10,14,14,55,94
2010-10-10 00:00:00.000,ATP World Tour Masters 1000 Shanghai China ATP World Tour Masters 1000,HARD,2,David Ferrer,Michael Llodra,David Ferrer,7-6(2); 6-1,R64,69,4,2,32,52,29,32,15,20,0,0,10,44,52,0,3,35,61,20,35,16,26,1,3,9,36,61
2010-10-10 00:00:00.000,ATP World Tour Masters 1000 Shanghai China ATP World Tour Masters 1000,HARD,2,Andreas Seppi,Marin Cilic,Andreas Seppi,6-2; 6-2,R64,57,1,0,32,40,26,32,6,8,0,0,8,32,40,2,2,23,47,14,23,11,24,4,8,8,25,47
2010-10-10 00:00:00.000,ATP World Tour Masters 1000 Shanghai China ATP World Tour Masters 1000,HARD,2,Yen-Hsun Lu,Di Wu,Yen-Hsun Lu,6-1; 6-4,R64,66,4,2,31,46,24,31,8,15,0,1,8,32,46,1,2,34,58,20,34,8,24,0,5,9,28,58
2010-10-10 00:00:00.000,ATP World Tour Masters 1000 Shanghai China ATP World Tour Masters 1000,HARD,2,John Isner,Lukasz Kubot,John Isner,4-6; 7-6(9); 7-6(7),R64,169,24,0,90,121,67,90,19,31,5,6,17,86,121,9,5,74,108,60,74,23,34,3,3,17,83,108
2010-10-10 00:00:00.000,ATP World Tour Masters 1000 Shanghai China ATP World Tour Masters 1000,HARD,2,Roger Federer,N/A Bye,Roger Federer,,R64,0,0,0,0,0,0,0,0,0,0,0,0,0,0,0,0,0,0,0,0,0,0,0,0,0,0,0
2010-10-10 00:00:00.000,ATP World Tour Masters 1000 Shanghai China ATP World Tour Masters 1000,HARD,2,Tomas Berdych,N/A Bye,Tomas Berdych,,R64,0,0,0,0,0,0,0,0,0,0,0,0,0,0,0,0,0,0,0,0,0,0,0,0,0,0,0
2010-10-10 00:00:00.000,ATP World Tour Masters 1000 Shanghai China ATP World Tour Masters 1000,HARD,2,Tommy Robredo,Albert Montanes,Tommy Robredo,6-3; 7-6(4),R64,94,9,0,46,68,34,46,16,22,3,4,11,50,68,0,4,44,71,31,44,14,27,4,6,10,45,71
2010-10-10 00:00:00.000,ATP World Tour Masters 1000 Shanghai China ATP World Tour Masters 1000,HARD,2,Guillermo Garcia-Lopez,Eduardo Schwank,Guillermo Garcia-Lopez,6-7(8); 6-2; 6-4,R64,130,6,4,58,100,44,58,23,42,1,2,15,67,100,6,6,69,100,49,69,14,31,9,13,15,63,100
2010-10-10 00:00:00.000,ATP World Tour Masters 1000 Shanghai China ATP World Tour Masters 1000,HARD,2,Andy Roddick,Philipp Kohlschreiber,Andy Roddick,6-3; 2-1 RET,R64,52,5,0,24,31,21,24,4,7,2,2,6,25,31,4,1,18,39,11,18,11,21,3,5,6,22,39
2010-10-10 00:00:00.000,ATP World Tour Masters 1000 Shanghai China ATP World Tour Masters 1000,HARD,2,Gael Monfils,Benjamin Becker,Gael Monfils,6-1; 7-5,R64,68,7,1,44,67,31,44,16,23,3,3,10,47,67,1,3,36,54,22,36,8,18,1,4,9,30,54
2010-10-10 00:00:00.000,ATP World Tour Masters 1000 Shanghai China ATP World Tour Masters 1000,HARD,2,Richard Gasquet,Ernests Gulbis,Richard Gasquet,6-1; 6-4,R64,74,4,0,33,48,26,33,8,15,1,2,9,34,48,1,5,28,62,15,28,17,34,5,9,8,32,62
2010-10-10 00:00:00.000,ATP World Tour Masters 1000 Shanghai China ATP World Tour Masters 1000,HARD,2,Ivan Ljubicic,Ze Zhang,Ivan Ljubicic,5-7; 6-3; 6-4,R64,153,11,4,63,99,46,63,19,36,6,8,16,65,99,11,4,80,105,57,80,7,25,7,10,15,64,105
2010-10-10 00:00:00.000,ATP World Tour Masters 1000 Shanghai China ATP World Tour Masters 1000,HARD,2,Novak Djokovic,N/A Bye,Novak Djokovic,,R64,0,0,0,0,0,0,0,0,0,0,0,0,0,0,0,0,0,0,0,0,0,0,0,0,0,0,0
2010-10-10 00:00:00.000,ATP World Tour Masters 1000 Shanghai China ATP World Tour Masters 1000,HARD,2,Rafael Nadal,Stanislas Wawrinka,Rafael Nadal,6-4; 6-4,R32,96,2,0,39,61,31,39,13,22,3,3,10,44,61,7,3,28,53,22,28,12,25,1,3,10,34,53
2010-10-10 00:00:00.000,ATP World Tour Masters 1000 Shanghai China ATP World Tour Masters 1000,HARD,2,Jurgen Melzer,Daniel Gimeno-Traver,Jurgen Melzer,6-3; 7-6(2),R32,78,5,2,42,67,35,42,12,25,2,3,11,47,67,10,1,38,63,27,38,13,25,4,6,10,40,63
2010-10-10 00:00:00.000,ATP World Tour Masters 1000 Shanghai China ATP World Tour Masters 1000,HARD,2,Juan Monaco,Thiemo de Bakker,Juan Monaco,2-6; 6-3; 6-4,R32,157,1,4,80,114,53,80,16,34,14,16,14,69,114,5,2,55,88,41,55,18,33,5,7,13,59,88
2010-10-10 00:00:00.000,ATP World Tour Masters 1000 Shanghai China ATP World Tour Masters 1000,HARD,2,Mischa Zverev,Nikolay Davydenko,Mischa Zverev,6-4; 7-6(3),R32,109,3,3,65,90,46,65,8,25,5,7,11,54,90,2,4,48,65,33,48,6,17,1,4,11,39,65
2010-10-10 00:00:00.000,ATP World Tour Masters 1000 Shanghai China ATP World Tour Masters 1000,HARD,2,Andy Murray,Yan Bai,Andy Murray,6-2; 6-2,R32,81,3,4,33,49,28,33,6,16,3,4,8,34,49,1,2,40,72,19,40,15,32,8,13,8,34,72
2010-10-10 00:00:00.000,ATP World Tour Masters 1000 Shanghai China ATP World Tour Masters 1000,HARD,2,Jeremy Chardy,Alexandr Dolgopolov,Jeremy Chardy,6-1; 5-7; 6-2,R32,97,10,3,43,73,35,43,18,30,0,1,14,53,73,10,7,44,87,32,44,18,43,7,11,13,50,87
2010-10-10 00:00:00.000,ATP World Tour Masters 1000 Shanghai China ATP World Tour Masters 1000,HARD,2,Jo-Wilfried Tsonga,Sam Querrey,Jo-Wilfried Tsonga,7-6(7); 6-1,R32,80,10,2,45,70,36,45,10,25,3,4,10,46,70,5,3,36,57,24,36,10,21,2,5,9,34,57
2010-10-10 00:00:00.000,ATP World Tour Masters 1000 Shanghai China ATP World Tour Masters 1000,HARD,2,Florian Mayer,Mikhail Youzhny,Florian Mayer,6-4; 6-7(5); 6-1,R32,134,10,1,62,99,49,62,18,37,4,5,15,67,99,9,3,58,96,42,58,20,38,4,8,14,62,96
2010-10-10 00:00:00.000,ATP World Tour Masters 1000 Shanghai China ATP World Tour Masters 1000,HARD,2,Robin Soderling,Janko Tipsarevic,Robin Soderling,6-3; 7-6(5),R32,103,9,0,33,66,29,33,20,33,2,3,11,49,66,6,1,40,75,30,40,17,35,6,8,10,47,75
2010-10-10 00:00:00.000,ATP World Tour Masters 1000 Shanghai China ATP World Tour Masters 1000,HARD,2,David Ferrer,Thomaz Bellucci,David Ferrer,7-6(7); 6-3,R32,121,2,1,40,66,26,40,16,26,3,6,11,42,66,4,1,46,86,29,46,17,40,10,14,10,46,86
2010-10-10 00:00:00.000,ATP World Tour Masters 1000 Shanghai China ATP World Tour Masters 1000,HARD,2,Andreas Seppi,Yen-Hsun Lu,Andreas Seppi,7-6(4); 6-3,R32,78,9,1,39,64,31,39,16,25,2,3,11,47,64,4,3,46,69,32,46,11,23,3,5,10,43,69
2010-10-10 00:00:00.000,ATP World Tour Masters 1000 Shanghai China ATP World Tour Masters 1000,HARD,2,Roger Federer,John Isner,Roger Federer,6-3; 6-4,R32,63,5,1,32,53,27,32,14,21,0,0,10,41,53,7,2,34,51,24,34,8,17,1,3,9,32,51
2010-10-10 00:00:00.000,ATP World Tour Masters 1000 Shanghai China ATP World Tour Masters 1000,HARD,2,Tomas Berdych,Tommy Robredo,Tomas Berdych,6-0; 6-4,R32,84,4,2,29,55,22,29,9,26,1,3,8,31,55,4,0,31,48,16,31,3,17,0,6,8,19,48
2010-10-10 00:00:00.000,ATP World Tour Masters 1000 Shanghai China ATP World Tour Masters 1000,HARD,2,Guillermo Garcia-Lopez,Andy Roddick,Guillermo Garcia-Lopez,3-6; 3-2 RET,R32,57,4,5,26,46,21,26,6,20,6,8,7,27,46,7,0,27,35,19,27,7,8,0,1,7,26,35
2010-10-10 00:00:00.000,ATP World Tour Masters 1000 Shanghai China ATP World Tour Masters 1000,HARD,2,Richard Gasquet,Gael Monfils,Richard Gasquet,6-4; 3-6; 6-4,R32,102,2,2,60,96,41,60,21,36,7,10,15,62,96,11,1,45,69,37,45,12,24,0,3,14,49,69
2010-10-10 00:00:00.000,ATP World Tour Masters 1000 Shanghai China ATP World Tour Masters 1000,HARD,2,Novak Djokovic,Ivan Ljubicic,Novak Djokovic,6-3; 6-3,R32,81,4,1,32,57,26,32,17,25,6,6,9,43,57,6,1,34,58,21,34,11,24,7,10,9,32,58
2010-10-10 00:00:00.000,ATP World Tour Masters 1000 Shanghai China ATP World Tour Masters 1000,HARD,2,Jurgen Melzer,Rafael Nadal,Jurgen Melzer,6-1; 3-6; 6-3,R16,119,14,1,41,71,34,41,18,30,2,3,13,52,71,1,1,61,82,37,61,12,21,9,12,12,49,82
2010-10-10 00:00:00.000,ATP World Tour Masters 1000 Shanghai China ATP World Tour Masters 1000,HARD,2,Juan Monaco,Mischa Zverev,Juan Monaco,6-0; 6-2,R16,65,5,0,29,46,23,29,11,17,5,5,7,34,46,1,1,32,47,12,32,8,15,5,10,7,20,47
2010-10-10 00:00:00.000,ATP World Tour Masters 1000 Shanghai China ATP World Tour Masters 1000,HARD,2,Andy Murray,Jeremy Chardy,Andy Murray,6-3; 6-4,R16,81,9,2,34,63,29,34,16,29,5,5,10,45,63,7,1,37,54,27,37,7,17,4,6,9,34,54
2010-10-10 00:00:00.000,ATP World Tour Masters 1000 Shanghai China ATP World Tour Masters 1000,HARD,2,Jo-Wilfried Tsonga,Florian Mayer,Jo-Wilfried Tsonga,7-5; 6-3,R16,85,5,1,30,65,23,30,20,35,3,4,11,43,65,3,3,38,65,23,38,15,27,3,6,10,38,65
2010-10-10 00:00:00.000,ATP World Tour Masters 1000 Shanghai China ATP World Tour Masters 1000,HARD,2,Robin Soderling,David Ferrer,Robin Soderling,7-5; 6-4,R16,106,7,4,46,78,35,46,14,32,5,7,11,49,78,1,2,49,73,30,49,13,24,10,14,11,43,73
2010-10-10 00:00:00.000,ATP World Tour Masters 1000 Shanghai China ATP World Tour Masters 1000,HARD,2,Roger Federer,Andreas Seppi,Roger Federer,6-3; 6-4,R16,74,6,1,42,66,32,42,13,24,4,5,10,45,66,0,1,33,53,19,33,12,20,6,9,9,31,53
2010-10-10 00:00:00.000,ATP World Tour Masters 1000 Shanghai China ATP World Tour Masters 1000,HARD,2,Guillermo Garcia-Lopez,Tomas Berdych,Guillermo Garcia-Lopez,7-6(4); 6-3,R16,100,5,2,48,81,34,48,19,33,1,2,11,53,81,4,1,33,64,30,33,14,31,4,6,10,44,64
2010-10-10 00:00:00.000,ATP World Tour Masters 1000 Shanghai China ATP World Tour Masters 1000,HARD,2,Novak Djokovic,Richard Gasquet,Novak Djokovic,6-1; 6-1,R16,58,4,2,33,45,25,33,7,12,1,1,7,32,45,3,2,33,44,17,33,2,11,4,9,7,19,44
2010-10-10 00:00:00.000,ATP World Tour Masters 1000 Shanghai China ATP World Tour Masters 1000,HARD,2,Juan Monaco,Jurgen Melzer,Juan Monaco,6-7(6); 7-5; 6-2,Q,170,3,2,70,104,42,70,23,34,3,7,16,65,104,6,2,52,100,30,52,25,48,2,9,16,55,100
2010-10-10 00:00:00.000,ATP World Tour Masters 1000 Shanghai China ATP World Tour Masters 1000,HARD,2,Andy Murray,Jo-Wilfried Tsonga,Andy Murray,6-2; 6-2,Q,55,5,0,22,41,19,22,14,19,0,0,8,33,41,2,5,19,40,12,19,7,21,0,4,8,19,40
2010-10-10 00:00:00.000,ATP World Tour Masters 1000 Shanghai China ATP World Tour Masters 1000,HARD,2,Roger Federer,Robin Soderling,Roger Federer,6-1; 6-1,Q,54,5,2,24,39,18,24,10,15,0,0,7,28,39,3,3,24,45,9,24,8,21,1,6,7,17,45
2010-10-10 00:00:00.000,ATP World Tour Masters 1000 Shanghai China ATP World Tour Masters 1000,HARD,2,Novak Djokovic,Guillermo Garcia-Lopez,Novak Djokovic,6-2; 6-3,Q,66,4,2,36,51,28,36,7,15,2,3,9,35,51,3,4,34,55,16,34,11,21,6,10,8,27,55
2010-10-10 00:00:00.000,ATP World Tour Masters 1000 Shanghai China ATP World Tour Masters 1000,HARD,2,Andy Murray,Juan Monaco,Andy Murray,6-4; 6-1,S,86,2,3,22,45,20,22,15,23,2,3,9,35,45,2,0,31,49,15,31,8,18,3,7,8,23,49
2010-10-10 00:00:00.000,ATP World Tour Masters 1000 Shanghai China ATP World Tour Masters 1000,HARD,2,Roger Federer,Novak Djokovic,Roger Federer,7-5; 6-4,S,102,7,3,45,73,34,45,15,28,4,5,11,49,73,4,4,48,75,30,48,15,27,1,4,11,45,75
2010-10-10 00:00:00.000,ATP World Tour Masters 1000 Shanghai China ATP World Tour Masters 1000,HARD,2,Andy Murray,Roger Federer,Andy Murray,6-3; 6-2,F,85,6,1,28,53,23,28,14,25,6,6,8,37,53,3,2,48,69,31,48,5,21,4,8,9,36,69
2010-10-18 00:00:00.000,Moscow Russia ATP World Tour 250,HARD,2,Nikolay Davydenko,N/A Bye,Nikolay Davydenko,,R32,0,0,0,0,0,0,0,0,0,0,0,0,0,0,0,0,0,0,0,0,0,0,0,0,0,0,0
2010-10-18 00:00:00.000,Moscow Russia ATP World Tour 250,HARD,2,Pablo Cuevas,Daniel Brands,Pablo Cuevas,6-2; 7-6(7),R32,85,8,3,42,61,36,42,13,19,4,4,10,49,61,3,3,45,72,31,45,14,27,4,6,10,45,72
2010-10-18 00:00:00.000,Moscow Russia ATP World Tour 250,HARD,2,Mikhail Kukushkin,Jeremy Chardy,Mikhail Kukushkin,6-2; 6-4,R32,77,8,2,31,60,22,31,19,29,2,2,9,41,60,8,1,36,58,22,36,12,22,1,4,9,34,58
2010-10-18 00:00:00.000,Moscow Russia ATP World Tour 250,HARD,2,Radek Stepanek,Victor Hanescu,Radek Stepanek,7-6(5); 6-3,R32,81,2,1,45,65,36,45,14,20,0,0,11,50,65,2,0,49,59,37,49,7,10,1,2,10,44,59
2010-10-18 00:00:00.000,Moscow Russia ATP World Tour 250,HARD,2,Jo-Wilfried Tsonga,N/A Bye,Jo-Wilfried Tsonga,,R32,0,0,0,0,0,0,0,0,0,0,0,0,0,0,0,0,0,0,0,0,0,0,0,0,0,0,0
2010-10-18 00:00:00.000,Moscow Russia ATP World Tour 250,HARD,2,Viktor Troicki,Dmitry Tursunov,Viktor Troicki,5-7; 6-4; 6-3,R32,117,15,5,43,82,35,43,20,39,3,6,15,55,82,6,3,57,93,35,57,20,36,5,10,16,55,93
2010-10-18 00:00:00.000,Moscow Russia ATP World Tour 250,HARD,2,Victor Crivoi,Andrey Kuznetsov,Victor Crivoi,7-6(4); 6-3,R32,97,7,0,52,82,37,52,16,30,3,5,11,53,82,0,4,34,66,22,34,16,32,4,7,10,38,66
2010-10-18 00:00:00.000,Moscow Russia ATP World Tour 250,HARD,2,Horacio Zeballos,Janko Tipsarevic,Horacio Zeballos,4-6; 6-4; 6-3,R32,116,12,3,47,93,38,47,25,46,5,6,14,63,93,8,5,63,99,45,63,20,36,4,7,15,65,99
2010-10-18 00:00:00.000,Moscow Russia ATP World Tour 250,HARD,2,Sergiy Stakhovsky,Michael Russell,Sergiy Stakhovsky,6-4; 3-6; 7-5,R32,165,3,0,49,90,35,49,23,41,2,4,15,58,90,2,8,73,113,53,73,17,40,8,11,16,70,113
2010-10-18 00:00:00.000,Moscow Russia ATP World Tour 250,HARD,2,Alexandr Dolgopolov,Ilya Belyaev,Alexandr Dolgopolov,6-2; 6-4,R32,58,5,1,23,44,19,23,18,21,1,1,9,37,44,1,2,21,55,13,21,17,34,2,5,9,30,55
2010-10-18 00:00:00.000,Moscow Russia ATP World Tour 250,HARD,2,Potito Starace,Teymuraz Gabashvili,Potito Starace,3-6; 7-5; 6-1,R32,108,5,1,56,65,48,56,5,9,0,1,14,53,65,6,3,60,94,40,60,19,34,8,11,14,59,94
2010-10-18 00:00:00.000,Moscow Russia ATP World Tour 250,HARD,2,Marcos Baghdatis,N/A Bye,Marcos Baghdatis,,R32,0,0,0,0,0,0,0,0,0,0,0,0,0,0,0,0,0,0,0,0,0,0,0,0,0,0,0
2010-10-18 00:00:00.000,Moscow Russia ATP World Tour 250,HARD,2,Andrey Golubev,Maximo Gonzalez,Andrey Golubev,6-3; 6-2,R32,77,2,1,38,66,26,38,18,28,3,3,9,44,66,0,3,34,49,21,34,7,15,3,6,8,28,49
2010-10-18 00:00:00.000,Moscow Russia ATP World Tour 250,HARD,2,Igor Kunitsyn,Igor Andreev,Igor Kunitsyn,6-4; 7-6(5),R32,93,6,1,51,71,41,51,9,20,1,2,11,50,71,8,2,44,71,35,44,9,27,1,3,11,44,71
2010-10-18 00:00:00.000,Moscow Russia ATP World Tour 250,HARD,2,Denis Istomin,Illya Marchenko,Denis Istomin,6-7(4); 6-2; 6-2,R32,139,9,0,73,93,55,73,11,20,5,5,14,66,93,7,6,68,115,47,68,21,47,10,14,14,68,115
2010-10-18 00:00:00.000,Moscow Russia ATP World Tour 250,HARD,2,Paul-Henri Mathieu,N/A Bye,Paul-Henri Mathieu,,R32,0,0,0,0,0,0,0,0,0,0,0,0,0,0,0,0,0,0,0,0,0,0,0,0,0,0,0
2010-10-18 00:00:00.000,Moscow Russia ATP World Tour 250,HARD,2,Pablo Cuevas,Nikolay Davydenko,Pablo Cuevas,7-6(6); 7-6(5),R16,109,5,1,50,76,40,50,14,26,0,2,12,54,76,2,2,54,83,38,54,17,29,1,3,12,55,83
2010-10-18 00:00:00.000,Moscow Russia ATP World Tour 250,HARD,2,Radek Stepanek,Mikhail Kukushkin,Radek Stepanek,6-3; 6-2,R16,70,11,1,42,52,33,42,4,10,1,1,9,37,52,2,0,28,47,18,28,9,19,4,7,8,27,47
2010-10-18 00:00:00.000,Moscow Russia ATP World Tour 250,HARD,2,Viktor Troicki,Jo-Wilfried Tsonga,Viktor Troicki,3-6; 6-3; 7-5,R16,124,14,2,49,99,40,49,25,50,4,6,15,65,99,13,3,61,102,45,61,19,41,6,9,15,64,102
2010-10-18 00:00:00.000,Moscow Russia ATP World Tour 250,HARD,2,Horacio Zeballos,Victor Crivoi,Horacio Zeballos,7-5; 7-6(1),R16,93,10,0,48,78,38,48,19,30,3,3,12,57,78,5,1,53,80,37,53,17,27,4,5,12,54,80
2010-10-18 00:00:00.000,Moscow Russia ATP World Tour 250,HARD,2,Alexandr Dolgopolov,Sergiy Stakhovsky,Alexandr Dolgopolov,6-2; 7-6(4),R16,81,4,1,40,69,31,40,15,29,5,6,10,46,69,4,2,37,57,24,37,10,20,1,4,10,34,57
2010-10-18 00:00:00.000,Moscow Russia ATP World Tour 250,HARD,2,Marcos Baghdatis,Potito Starace,Marcos Baghdatis,6-4; 6-3,R16,62,11,3,25,53,22,25,19,28,1,1,10,41,53,4,1,37,49,27,37,4,12,0,2,9,31,49
2010-10-18 00:00:00.000,Moscow Russia ATP World Tour 250,HARD,2,Igor Kunitsyn,Andrey Golubev,Igor Kunitsyn,6-4; 7-5,R16,89,0,0,47,68,28,47,14,21,4,7,11,42,68,7,6,52,75,35,52,6,23,6,11,11,41,75
2010-10-18 00:00:00.000,Moscow Russia ATP World Tour 250,HARD,2,Denis Istomin,Paul-Henri Mathieu,Denis Istomin,1-6; 7-5; 6-3,R16,118,12,3,56,74,40,56,12,18,2,4,14,52,74,12,1,60,97,41,60,21,37,5,7,14,62,97
2010-10-18 00:00:00.000,Moscow Russia ATP World Tour 250,HARD,2,Pablo Cuevas,Radek Stepanek,Pablo Cuevas,6-4; 7-6(3),Q,103,10,1,48,76,33,48,17,28,2,4,11,50,76,2,1,56,74,34,56,11,18,2,5,11,45,74
2010-10-18 00:00:00.000,Moscow Russia ATP World Tour 250,HARD,2,Viktor Troicki,Horacio Zeballos,Viktor Troicki,6-2; 6-1,Q,65,6,5,22,42,21,22,10,20,2,2,7,31,42,1,4,26,57,13,26,11,31,4,9,8,24,57
2010-10-18 00:00:00.000,Moscow Russia ATP World Tour 250,HARD,2,Marcos Baghdatis,Alexandr Dolgopolov,Marcos Baghdatis,6-2; 7-6(7),Q,82,7,3,32,60,27,32,19,28,0,0,10,46,60,7,1,38,72,27,38,19,34,5,7,10,46,72
2010-10-18 00:00:00.000,Moscow Russia ATP World Tour 250,HARD,2,Denis Istomin,Igor Kunitsyn,Denis Istomin,6-2; 6-4,Q,71,10,3,28,46,23,28,11,18,0,1,9,34,46,0,0,44,65,25,44,8,21,4,8,9,33,65
2010-10-18 00:00:00.000,Moscow Russia ATP World Tour 250,HARD,2,Viktor Troicki,Pablo Cuevas,Viktor Troicki,6-3; 6-3,S,71,10,2,27,47,22,27,11,20,0,1,9,33,47,1,1,38,63,25,38,8,25,7,11,9,33,63
2010-10-18 00:00:00.000,Moscow Russia ATP World Tour 250,HARD,2,Marcos Baghdatis,Denis Istomin,Marcos Baghdatis,6-4; 6-7(5); 7-6(2),S,147,16,3,62,109,57,62,21,47,9,11,17,78,109,12,4,74,107,57,74,15,33,8,11,17,72,107
2010-10-18 00:00:00.000,Moscow Russia ATP World Tour 250,HARD,2,Viktor Troicki,Marcos Baghdatis,Viktor Troicki,3-6; 6-4; 6-3,F,105,7,3,46,77,37,46,16,31,2,4,14,53,77,7,2,40,79,34,40,17,39,2,5,14,51,79
2010-10-18 00:00:00.000,Stockholm Sweden ATP World Tour 250,HARD,2,Roger Federer,N/A Bye,Roger Federer,,R32,0,0,0,0,0,0,0,0,0,0,0,0,0,0,0,0,0,0,0,0,0,0,0,0,0,0,0
2010-10-18 00:00:00.000,Stockholm Sweden ATP World Tour 250,HARD,2,Taylor Dent,Michal Przysiezny,Taylor Dent,6-2 RET,R32,34,5,0,11,17,11,11,5,6,0,0,4,16,17,0,2,11,27,8,11,5,16,2,4,4,13,27
2010-10-18 00:00:00.000,Stockholm Sweden ATP World Tour 250,HARD,2,Robin Haase,Filip Prpic,Robin Haase,7-6(4); 3-6; 6-4,R32,140,6,3,50,88,43,50,24,38,1,3,16,67,88,10,0,79,121,53,79,26,42,10,11,15,79,121
2010-10-18 00:00:00.000,Stockholm Sweden ATP World Tour 250,HARD,2,Stanislas Wawrinka,Andreas Seppi,Stanislas Wawrinka,6-2; 6-2,R32,79,7,0,34,48,27,34,5,14,6,7,8,32,48,2,2,41,76,21,41,15,35,11,16,8,36,76
2010-10-18 00:00:00.000,Stockholm Sweden ATP World Tour 250,HARD,2,Ivan Ljubicic,N/A Bye,Ivan Ljubicic,,R32,0,0,0,0,0,0,0,0,0,0,0,0,0,0,0,0,0,0,0,0,0,0,0,0,0,0,0
2010-10-18 00:00:00.000,Stockholm Sweden ATP World Tour 250,HARD,2,Arnaud Clement,Olivier Rochus,Arnaud Clement,6-0; 6-4,R32,92,8,0,36,53,29,36,5,17,6,7,8,34,53,2,5,48,78,24,48,12,30,11,16,8,36,78
2010-10-18 00:00:00.000,Stockholm Sweden ATP World Tour 250,HARD,2,Tobias Kamke,Jan Hajek,Tobias Kamke,6-0; 6-2,R32,63,3,0,36,49,26,36,4,13,5,6,7,30,49,1,4,24,51,15,24,4,27,7,13,7,19,51
2010-10-18 00:00:00.000,Stockholm Sweden ATP World Tour 250,HARD,2,Ivan Dodig,Tommy Robredo,Ivan Dodig,6-3; 6-2,R32,64,3,0,30,48,27,30,7,18,0,1,9,34,48,2,1,30,47,15,30,9,17,3,7,8,24,47
2010-10-18 00:00:00.000,Stockholm Sweden ATP World Tour 250,HARD,2,James Blake,Thomaz Bellucci,James Blake,3-6; 6-4; 6-4,R32,102,7,4,62,99,48,62,16,37,5,7,15,64,99,4,2,42,75,37,42,17,33,2,4,14,54,75
2010-10-18 00:00:00.000,Stockholm Sweden ATP World Tour 250,HARD,2,Matthias Bachinger,Lukasz Kubot,Matthias Bachinger,6-4; 4-6; 6-3,R32,124,10,1,54,81,44,54,15,27,2,3,15,59,81,5,7,65,109,45,65,21,44,7,9,14,66,109
2010-10-18 00:00:00.000,Stockholm Sweden ATP World Tour 250,HARD,2,Jarkko Nieminen,Michael Berrer,Jarkko Nieminen,4-6; 6-1; 6-4,R32,118,4,5,44,80,35,44,18,36,4,6,14,53,80,7,1,57,90,38,57,16,33,10,14,13,54,90
2010-10-18 00:00:00.000,Stockholm Sweden ATP World Tour 250,HARD,2,Tomas Berdych,N/A Bye,Tomas Berdych,,R32,0,0,0,0,0,0,0,0,0,0,0,0,0,0,0,0,0,0,0,0,0,0,0,0,0,0,0
2010-10-18 00:00:00.000,Stockholm Sweden ATP World Tour 250,HARD,2,Florian Mayer,Feliciano Lopez,Florian Mayer,6-2; 6-2,R32,56,5,0,38,49,30,38,7,11,2,2,8,37,49,4,3,35,50,21,35,5,15,2,6,8,26,50
2010-10-18 00:00:00.000,Stockholm Sweden ATP World Tour 250,HARD,2,Michael Ryderstedt,Daniel Gimeno-Traver,Michael Ryderstedt,7-6(3); 6-3,R32,90,5,2,44,66,35,44,16,22,2,2,11,51,66,8,3,46,76,32,46,15,30,4,5,10,47,76
2010-10-18 00:00:00.000,Stockholm Sweden ATP World Tour 250,HARD,2,Benjamin Becker,Thomas Schoorel,Benjamin Becker,6-3; 6-0,R32,61,8,2,28,44,23,28,8,16,2,2,7,31,44,3,3,30,53,19,30,7,23,3,8,8,26,53
2010-10-18 00:00:00.000,Stockholm Sweden ATP World Tour 250,HARD,2,Robin Soderling,N/A Bye,Robin Soderling,,R32,0,0,0,0,0,0,0,0,0,0,0,0,0,0,0,0,0,0,0,0,0,0,0,0,0,0,0
2010-10-18 00:00:00.000,Stockholm Sweden ATP World Tour 250,HARD,2,Roger Federer,Taylor Dent,Roger Federer,6-1; 6-2,R16,51,3,1,34,48,29,34,6,14,2,2,8,35,48,1,2,22,42,12,22,7,20,3,7,7,19,42
2010-10-18 00:00:00.000,Stockholm Sweden ATP World Tour 250,HARD,2,Stanislas Wawrinka,Robin Haase,Stanislas Wawrinka,7-5; 6-7(6); 6-4,R16,147,12,2,77,120,58,77,23,43,10,11,17,81,120,2,5,68,105,50,68,22,37,6,9,17,72,105
2010-10-18 00:00:00.000,Stockholm Sweden ATP World Tour 250,HARD,2,Ivan Ljubicic,Arnaud Clement,Ivan Ljubicic,6-3; 6-4,R16,78,12,1,35,55,28,35,14,20,0,0,10,42,55,3,2,31,56,19,31,15,25,4,6,9,34,56
2010-10-18 00:00:00.000,Stockholm Sweden ATP World Tour 250,HARD,2,Ivan Dodig,Tobias Kamke,Ivan Dodig,6-1; 6-1,R16,53,3,3,23,47,19,23,15,24,2,2,7,34,47,0,1,24,35,10,24,3,11,0,5,7,13,35
2010-10-18 00:00:00.000,Stockholm Sweden ATP World Tour 250,HARD,2,James Blake,Matthias Bachinger,James Blake,6-4; 3-6; 7-6(2),R16,109,3,5,65,111,46,65,20,46,9,13,15,66,111,6,4,52,84,38,52,15,32,1,5,16,53,84
2010-10-18 00:00:00.000,Stockholm Sweden ATP World Tour 250,HARD,2,Jarkko Nieminen,Tomas Berdych,Jarkko Nieminen,6-1; 6-4,R16,86,0,1,43,60,32,43,10,17,2,2,9,42,60,9,1,25,48,17,25,11,23,4,7,8,28,48
2010-10-18 00:00:00.000,Stockholm Sweden ATP World Tour 250,HARD,2,Florian Mayer,Michael Ryderstedt,Florian Mayer,6-4; 6-4,R16,75,3,0,36,59,28,36,14,23,1,1,10,42,59,9,3,30,60,20,30,17,30,5,7,10,37,60
2010-10-18 00:00:00.000,Stockholm Sweden ATP World Tour 250,HARD,2,Robin Soderling,Benjamin Becker,Robin Soderling,6-3; 6-3,R16,65,5,0,32,44,25,32,11,12,0,0,9,36,44,2,6,24,54,17,24,13,30,2,5,9,30,54
2010-10-18 00:00:00.000,Stockholm Sweden ATP World Tour 250,HARD,2,Roger Federer,Stanislas Wawrinka,Roger Federer,2-6; 6-3; 6-2,Q,108,6,2,55,84,36,55,17,29,6,9,13,53,84,4,0,39,75,24,39,19,36,5,9,12,43,75
2010-10-18 00:00:00.000,Stockholm Sweden ATP World Tour 250,HARD,2,Ivan Ljubicic,Ivan Dodig,Ivan Ljubicic,4-6; 6-2; 6-4,Q,139,10,1,51,82,41,51,17,31,0,1,14,58,82,6,2,53,96,39,53,19,43,4,7,14,58,96
2010-10-18 00:00:00.000,Stockholm Sweden ATP World Tour 250,HARD,2,Jarkko Nieminen,James Blake,Jarkko Nieminen,6-0; 6-2,Q,50,5,1,29,44,23,29,8,15,2,2,7,31,44,0,2,20,42,9,20,8,22,3,8,7,17,42
2010-10-18 00:00:00.000,Stockholm Sweden ATP World Tour 250,HARD,2,Florian Mayer,Robin Soderling,Florian Mayer,7-6(8); 6-1,Q,82,5,3,49,73,39,49,16,24,4,4,10,55,73,5,1,36,57,27,36,12,21,1,3,9,39,57
2010-10-18 00:00:00.000,Stockholm Sweden ATP World Tour 250,HARD,2,Roger Federer,Ivan Ljubicic,Roger Federer,7-6(5); 6-2,S,78,10,0,41,60,33,41,10,19,1,2,10,43,60,5,1,46,65,31,46,7,19,2,5,10,38,65
2010-10-18 00:00:00.000,Stockholm Sweden ATP World Tour 250,HARD,2,Florian Mayer,Jarkko Nieminen,Florian Mayer,4-6; 6-4; 7-6(3),S,134,4,2,70,112,50,70,25,42,8,10,16,75,112,3,3,62,94,44,62,18,32,0,2,16,62,94
2010-10-18 00:00:00.000,Stockholm Sweden ATP World Tour 250,HARD,2,Roger Federer,Florian Mayer,Roger Federer,6-4; 6-3,F,64,4,0,33,54,28,33,11,21,1,2,10,39,54,6,0,44,57,26,44,7,13,4,7,9,33,57
2010-10-25 00:00:00.000,Montpellier France ATP World Tour 250,HARD,2,Nikolay Davydenko,N/A Bye,Nikolay Davydenko,,R32,0,0,0,0,0,0,0,0,0,0,0,0,0,0,0,0,0,0,0,0,0,0,0,0,0,0,0
2010-10-25 00:00:00.000,Montpellier France ATP World Tour 250,HARD,2,Mischa Zverev,Robin Haase,Mischa Zverev,7-6(7); 7-6(5),R32,108,0,3,67,94,47,67,16,27,8,9,12,63,94,11,3,54,92,45,54,16,38,6,7,12,61,92
2010-10-25 00:00:00.000,Montpellier France ATP World Tour 250,HARD,2,Michael Llodra,Olivier Rochus,Michael Llodra,2-3 RET,R32,23,4,2,12,19,9,12,1,7,1,2,3,10,19,4,0,13,17,10,13,2,4,3,3,2,12,17
2010-10-25 00:00:00.000,Montpellier France ATP World Tour 250,HARD,2,Albert Montanes,Arnaud Clement,Albert Montanes,6-4; 6-4,R32,80,4,2,36,57,30,36,13,21,3,3,10,43,57,7,4,33,62,26,33,12,29,4,6,10,38,62
2010-10-25 00:00:00.000,Montpellier France ATP World Tour 250,HARD,2,Ivan Ljubicic,N/A Bye,Ivan Ljubicic,,R32,0,0,0,0,0,0,0,0,0,0,0,0,0,0,0,0,0,0,0,0,0,0,0,0,0,0,0
2010-10-25 00:00:00.000,Montpellier France ATP World Tour 250,HARD,2,Taylor Dent,Romain Jouan,Taylor Dent,6-7(5); 6-3; 6-4,R32,118,20,9,62,116,54,62,24,54,6,6,16,78,116,6,3,47,92,35,47,28,45,5,7,15,63,92
2010-10-25 00:00:00.000,Montpellier France ATP World Tour 250,HARD,2,Jarkko Nieminen,Florent Serra,Jarkko Nieminen,6-7(4); 7-5; 6-1,R32,120,9,2,64,102,46,64,20,38,5,8,15,66,102,7,3,70,112,49,70,14,42,10,17,16,63,112
2010-10-25 00:00:00.000,Montpellier France ATP World Tour 250,HARD,2,Richard Gasquet,Julian Reister,Richard Gasquet,6-7(8); 6-3; 6-3,R32,126,11,3,54,88,45,54,21,34,4,5,15,66,88,5,2,69,106,47,69,19,37,4,8,15,66,106
2010-10-25 00:00:00.000,Montpellier France ATP World Tour 250,HARD,2,John Isner,Benoit Paire,John Isner,7-5; 6-2,R32,67,10,0,39,52,35,39,7,13,1,1,10,42,52,9,3,38,68,28,38,12,30,6,9,10,40,68
2010-10-25 00:00:00.000,Montpellier France ATP World Tour 250,HARD,2,Adrian Mannarino,Lukas Lacko,Adrian Mannarino,6-3; 6-7(4); 6-4,R32,127,15,2,65,98,50,65,14,33,4,6,15,64,98,8,5,64,99,48,64,16,35,5,10,16,64,99
2010-10-25 00:00:00.000,Montpellier France ATP World Tour 250,HARD,2,Steve Darcis,Eduardo Schwank,Steve Darcis,6-2; 7-5,R32,81,9,2,34,54,28,34,14,20,2,2,10,42,54,5,3,41,68,29,41,10,27,4,7,10,39,68
2010-10-25 00:00:00.000,Montpellier France ATP World Tour 250,HARD,2,Gael Monfils,N/A Bye,Gael Monfils,,R32,0,0,0,0,0,0,0,0,0,0,0,0,0,0,0,0,0,0,0,0,0,0,0,0,0,0,0
2010-10-25 00:00:00.000,Montpellier France ATP World Tour 250,HARD,2,David Nalbandian,Marcel Granollers,David Nalbandian,6-4; 6-4,R32,88,5,5,35,60,30,35,8,25,4,6,10,38,60,5,4,45,82,30,45,14,37,9,13,10,44,82
2010-10-25 00:00:00.000,Montpellier France ATP World Tour 250,HARD,2,Gilles Simon,Nicolas Mahut,Gilles Simon,6-4; 6-4,R32,79,10,0,34,56,28,34,15,22,4,4,10,43,56,5,4,51,79,37,51,10,28,9,11,10,47,79
2010-10-25 00:00:00.000,Montpellier France ATP World Tour 250,HARD,2,Frederico Gil,Edouard Roger-Vasselin,Frederico Gil,6-4; 2-6; 7-5,R32,151,3,4,76,112,47,76,18,36,9,13,15,65,112,5,4,59,93,39,59,20,34,4,8,15,59,93
2010-10-25 00:00:00.000,Montpellier France ATP World Tour 250,HARD,2,Jo-Wilfried Tsonga,N/A Bye,Jo-Wilfried Tsonga,,R32,0,0,0,0,0,0,0,0,0,0,0,0,0,0,0,0,0,0,0,0,0,0,0,0,0,0,0
2010-10-25 00:00:00.000,Montpellier France ATP World Tour 250,HARD,2,Nikolay Davydenko,Mischa Zverev,Nikolay Davydenko,7-5; 6-3,R16,95,12,0,50,82,38,50,19,32,10,10,11,57,82,2,1,37,63,29,37,10,26,3,5,10,39,63
2010-10-25 00:00:00.000,Montpellier France ATP World Tour 250,HARD,2,Albert Montanes,Michael Llodra,Albert Montanes,6-4; 7-6(5),R16,90,3,1,46,80,36,46,21,34,4,4,11,57,80,10,1,44,68,33,44,14,24,3,4,11,47,68
2010-10-25 00:00:00.000,Montpellier France ATP World Tour 250,HARD,2,Ivan Ljubicic,Taylor Dent,Ivan Ljubicic,7-5; 6-4,R16,87,5,1,38,58,29,38,14,20,0,1,11,43,58,4,3,32,62,25,32,14,30,3,6,11,39,62
2010-10-25 00:00:00.000,Montpellier France ATP World Tour 250,HARD,2,Jarkko Nieminen,Richard Gasquet,Jarkko Nieminen,4-6; 7-6(6); 6-2,R16,115,2,3,56,82,43,56,17,26,0,2,15,60,82,7,3,51,95,39,51,26,44,4,7,15,65,95
2010-10-25 00:00:00.000,Montpellier France ATP World Tour 250,HARD,2,John Isner,Adrian Mannarino,John Isner,7-6(5); 6-7(5); 6-3,R16,132,27,0,94,115,72,94,12,21,6,6,17,84,115,8,1,50,96,43,50,29,46,0,1,16,72,96
2010-10-25 00:00:00.000,Montpellier France ATP World Tour 250,HARD,2,Gael Monfils,Steve Darcis,Gael Monfils,6-4; 6-4,R16,67,5,2,30,53,24,30,14,23,1,2,10,38,53,1,2,36,53,26,36,6,17,0,3,10,32,53
2010-10-25 00:00:00.000,Montpellier France ATP World Tour 250,HARD,2,Gilles Simon,David Nalbandian,Gilles Simon,3-6; 7-6(5); 7-5,R16,135,11,2,54,98,43,54,20,44,4,8,16,63,98,6,7,58,104,43,58,22,46,3,7,17,65,104
2010-10-25 00:00:00.000,Montpellier France ATP World Tour 250,HARD,2,Jo-Wilfried Tsonga,Frederico Gil,Jo-Wilfried Tsonga,6-3; 6-4,R16,77,11,2,43,63,33,43,13,20,5,5,10,46,63,1,0,43,63,27,43,10,20,0,2,9,37,63
2010-10-25 00:00:00.000,Montpellier France ATP World Tour 250,HARD,2,Albert Montanes,Nikolay Davydenko,Albert Montanes,3-6; 7-6(3); 7-6(4),Q,139,4,0,67,115,44,67,29,48,8,12,16,73,115,15,3,56,97,46,56,18,41,0,3,17,64,97
2010-10-25 00:00:00.000,Montpellier France ATP World Tour 250,HARD,2,Ivan Ljubicic,Jarkko Nieminen,Ivan Ljubicic,4-6; 6-3; 7-6(6),Q,118,24,0,66,89,54,66,12,23,1,2,16,66,89,10,0,73,95,57,73,8,22,5,6,15,65,95
2010-10-25 00:00:00.000,Montpellier France ATP World Tour 250,HARD,2,Gael Monfils,John Isner,Gael Monfils,3-6; 6-4; 6-4,Q,104,11,4,53,74,43,53,12,21,2,3,14,55,74,12,0,69,99,46,69,18,30,8,10,15,64,99
2010-10-25 00:00:00.000,Montpellier France ATP World Tour 250,HARD,2,Jo-Wilfried Tsonga,Gilles Simon,Jo-Wilfried Tsonga,6-3; 6-7(0); 6-3,Q,118,19,2,71,101,55,71,14,30,5,6,16,69,101,7,1,52,83,37,52,18,31,2,5,14,55,83
2010-10-25 00:00:00.000,Montpellier France ATP World Tour 250,HARD,2,Ivan Ljubicic,Albert Montanes,Ivan Ljubicic,6-3; 7-6(4),S,77,18,0,34,57,31,34,19,23,0,0,11,50,57,6,1,38,65,30,38,17,27,5,6,10,47,65
2010-10-25 00:00:00.000,Montpellier France ATP World Tour 250,HARD,2,Gael Monfils,Jo-Wilfried Tsonga,Gael Monfils,7-6(2); 2-6; 6-4,S,106,11,3,61,88,49,61,15,27,3,5,15,64,88,5,0,58,87,42,58,20,29,4,5,15,62,87
2010-10-25 00:00:00.000,Montpellier France ATP World Tour 250,HARD,2,Gael Monfils,Ivan Ljubicic,Gael Monfils,6-2; 5-7; 6-1,F,112,11,6,67,95,49,67,12,28,5,7,14,61,95,6,3,41,74,29,41,14,33,1,6,13,43,74
2010-10-25 00:00:00.000,St. Petersburg Russia ATP World Tour 250,HARD,2,Mikhail Youzhny,Daniel Brands,Mikhail Youzhny,6-4; 6-1,R32,62,3,1,23,35,22,23,10,12,0,0,8,32,35,2,2,45,62,28,45,6,17,2,6,9,34,62
2010-10-25 00:00:00.000,St. Petersburg Russia ATP World Tour 250,HARD,2,Evgeny Donskoy,Andrey Kuznetsov,Evgeny Donskoy,7-5; 7-6(2),R32,110,7,4,48,89,36,48,20,41,10,13,12,56,89,2,6,48,85,28,48,19,37,2,6,12,47,85
2010-10-25 00:00:00.000,St. Petersburg Russia ATP World Tour 250,HARD,2,Rajeev Ram,Pablo Andujar,Rajeev Ram,6-3; 6-7(5); 6-3,R32,147,17,2,80,112,59,80,14,32,5,7,16,73,112,1,3,57,96,37,57,20,39,1,5,14,57,96
2010-10-25 00:00:00.000,St. Petersburg Russia ATP World Tour 250,HARD,2,Victor Hanescu,Horacio Zeballos,Victor Hanescu,6-2; 6-0,R32,54,5,0,20,32,18,20,10,12,0,0,7,28,32,3,3,32,55,17,32,7,23,5,10,7,24,55
2010-10-25 00:00:00.000,St. Petersburg Russia ATP World Tour 250,HARD,2,Yen-Hsun Lu,Potito Starace,Yen-Hsun Lu,6-2; 6-2,R32,59,5,2,25,42,21,25,12,17,0,0,8,33,42,3,3,32,49,19,32,5,17,2,6,8,24,49
2010-10-25 00:00:00.000,St. Petersburg Russia ATP World Tour 250,HARD,2,Dmitry Tursunov,Michal Przysiezny,Dmitry Tursunov,3-6; 6-3; 6-2,R32,87,9,3,35,60,30,35,19,25,1,2,13,49,60,15,3,44,78,30,44,21,34,2,5,13,51,78
2010-10-25 00:00:00.000,St. Petersburg Russia ATP World Tour 250,HARD,2,Alexandr Dolgopolov,Fabio Fognini,Alexandr Dolgopolov,7-6(5); 6-4,R32,80,10,1,51,79,33,51,17,28,4,6,11,50,79,0,7,46,73,27,46,16,27,2,5,11,43,73
2010-10-25 00:00:00.000,St. Petersburg Russia ATP World Tour 250,HARD,2,Rainer Schuettler,Viktor Troicki,Rainer Schuettler,6-3; 4-6; 6-3,R32,130,0,2,55,99,33,55,27,44,9,12,14,60,99,6,1,46,78,31,46,14,32,3,8,14,45,78
2010-10-25 00:00:00.000,St. Petersburg Russia ATP World Tour 250,HARD,2,Mikhail Kukushkin,Jeremy Chardy,Mikhail Kukushkin,6-7(3); 6-1; 6-0,R32,112,10,0,43,72,32,43,17,29,2,4,12,49,72,8,8,68,104,41,68,9,36,11,19,13,50,104
2010-10-25 00:00:00.000,St. Petersburg Russia ATP World Tour 250,HARD,2,Teymuraz Gabashvili,Filippo Volandri,Teymuraz Gabashvili,3-6; 6-3; 6-2,R32,109,5,1,47,75,34,47,15,28,2,5,13,49,75,2,6,42,80,25,42,17,38,3,8,13,42,80
2010-10-25 00:00:00.000,St. Petersburg Russia ATP World Tour 250,HARD,2,Michael Russell,Igor Andreev,Michael Russell,6-1; 7-5,R32,92,0,1,51,67,31,51,11,16,9,11,10,42,67,5,3,30,59,18,30,12,29,5,10,9,30,59
2010-10-25 00:00:00.000,St. Petersburg Russia ATP World Tour 250,HARD,2,Janko Tipsarevic,Igor Kunitsyn,Janko Tipsarevic,6-4; 6-2,R32,64,7,0,29,42,25,29,11,13,0,0,9,36,42,1,3,35,51,24,35,6,16,2,5,9,30,51
2010-10-25 00:00:00.000,St. Petersburg Russia ATP World Tour 250,HARD,2,Illya Marchenko,Denis Istomin,Illya Marchenko,6-2; 2-2 RET,R32,52,2,2,12,33,11,12,14,21,2,2,6,25,33,2,0,23,41,15,23,8,18,0,2,6,23,41
2010-10-25 00:00:00.000,St. Petersburg Russia ATP World Tour 250,HARD,2,Konstantin Kravchuk,Frantisek Cermak,Konstantin Kravchuk,6-2; 6-3,R32,67,13,1,29,47,25,29,12,18,2,2,9,37,47,2,5,31,52,17,31,11,21,6,9,8,28,52
2010-10-25 00:00:00.000,St. Petersburg Russia ATP World Tour 250,HARD,2,Paul-Henri Mathieu,Maximo Gonzalez,Paul-Henri Mathieu,6-4; 6-3,R32,102,6,2,39,63,31,39,13,24,1,2,10,44,63,2,2,57,83,34,57,11,26,9,12,9,45,83
2010-10-25 00:00:00.000,St. Petersburg Russia ATP World Tour 250,HARD,2,Benjamin Becker,Sergiy Stakhovsky,Benjamin Becker,6-4; 5-7; 6-4,R32,131,8,2,56,89,43,56,23,33,3,4,16,66,89,5,2,74,105,54,74,14,31,3,5,16,68,105
2010-10-25 00:00:00.000,St. Petersburg Russia ATP World Tour 250,HARD,2,Mikhail Youzhny,Evgeny Donskoy,Mikhail Youzhny,3-6; 6-3; 6-2,R16,129,3,4,34,73,27,34,19,39,1,4,13,46,73,8,3,53,92,34,53,17,39,11,16,13,51,92
2010-10-25 00:00:00.000,St. Petersburg Russia ATP World Tour 250,HARD,2,Victor Hanescu,Rajeev Ram,Victor Hanescu,7-6(1); 3-6; 6-3,R16,107,10,1,60,82,52,60,13,22,0,1,15,65,82,7,0,55,83,41,55,18,28,0,1,15,59,83
2010-10-25 00:00:00.000,St. Petersburg Russia ATP World Tour 250,HARD,2,Dmitry Tursunov,Yen-Hsun Lu,Dmitry Tursunov,6-1; 6-4,R16,60,5,1,31,44,27,31,10,13,0,0,9,37,44,4,2,36,51,19,36,9,15,2,5,8,28,51
2010-10-25 00:00:00.000,St. Petersburg Russia ATP World Tour 250,HARD,2,Alexandr Dolgopolov,Rainer Schuettler,Alexandr Dolgopolov,6-4; 6-2,R16,51,11,0,30,44,27,30,9,14,0,0,9,36,44,3,0,35,45,21,35,7,10,1,4,9,28,45
2010-10-25 00:00:00.000,St. Petersburg Russia ATP World Tour 250,HARD,2,Mikhail Kukushkin,Teymuraz Gabashvili,Mikhail Kukushkin,6-3; 6-4,R16,72,5,0,39,57,32,39,11,18,1,1,10,43,57,2,2,22,44,19,22,11,22,0,2,9,30,44
2010-10-25 00:00:00.000,St. Petersburg Russia ATP World Tour 250,HARD,2,Janko Tipsarevic,Michael Russell,Janko Tipsarevic,6-2; 7-5,R16,111,7,1,38,61,30,38,15,23,3,3,10,45,61,1,4,54,74,33,54,8,20,5,8,10,41,74
2010-10-25 00:00:00.000,St. Petersburg Russia ATP World Tour 250,HARD,2,Illya Marchenko,Konstantin Kravchuk,Illya Marchenko,6-4; 6-4,R16,99,1,1,38,64,31,38,13,26,5,5,10,44,64,4,4,41,69,30,41,12,28,5,7,10,42,69
2010-10-25 00:00:00.000,St. Petersburg Russia ATP World Tour 250,HARD,2,Benjamin Becker,Paul-Henri Mathieu,Benjamin Becker,6-4; 6-2,R16,76,6,2,29,45,28,29,9,16,2,2,9,37,45,5,4,43,75,26,43,17,32,7,10,9,43,75
2010-10-25 00:00:00.000,St. Petersburg Russia ATP World Tour 250,HARD,2,Mikhail Youzhny,Victor Hanescu,Mikhail Youzhny,6-7(5); 6-3; 7-6(6),Q,167,9,1,65,107,55,65,26,42,4,4,17,81,107,5,2,80,108,59,80,15,28,3,4,16,74,108
2010-10-25 00:00:00.000,St. Petersburg Russia ATP World Tour 250,HARD,2,Dmitry Tursunov,Alexandr Dolgopolov,Dmitry Tursunov,6-4; 6-2,Q,67,6,0,30,51,27,30,10,21,2,3,9,37,51,5,1,36,54,23,36,6,18,1,5,9,29,54
2010-10-25 00:00:00.000,St. Petersburg Russia ATP World Tour 250,HARD,2,Mikhail Kukushkin,Janko Tipsarevic,Mikhail Kukushkin,7-5; 3-6; 6-4,Q,159,4,2,62,102,47,62,18,40,8,11,16,65,102,10,0,59,92,46,59,16,33,3,6,15,62,92
2010-10-25 00:00:00.000,St. Petersburg Russia ATP World Tour 250,HARD,2,Illya Marchenko,Benjamin Becker,Illya Marchenko,6-4; 2-6; 6-2,Q,112,3,8,52,77,36,52,12,25,3,6,13,48,77,2,2,40,73,30,40,13,33,2,6,13,43,73
2010-10-25 00:00:00.000,St. Petersburg Russia ATP World Tour 250,HARD,2,Mikhail Youzhny,Dmitry Tursunov,Mikhail Youzhny,7-5; 4-6; 7-6(8),S,186,7,2,71,117,54,71,21,46,7,10,17,75,117,14,2,76,116,55,76,23,40,9,12,17,78,116
2010-10-25 00:00:00.000,St. Petersburg Russia ATP World Tour 250,HARD,2,Mikhail Kukushkin,Illya Marchenko,Mikhail Kukushkin,6-3; 6-4,S,95,2,2,27,51,19,27,15,24,1,3,10,34,51,2,3,39,61,29,39,6,22,4,8,9,35,61
2010-10-25 00:00:00.000,St. Petersburg Russia ATP World Tour 250,HARD,2,Mikhail Kukushkin,Mikhail Youzhny,Mikhail Kukushkin,6-3; 7-6(2),F,146,2,2,39,74,28,39,19,35,3,5,10,47,74,5,1,54,81,32,54,13,27,7,11,11,45,81
2010-10-25 00:00:00.000,Vienna Austria ATP World Tour 250,HARD,2,Jurgen Melzer,N/A Bye,Jurgen Melzer,,R32,0,0,0,0,0,0,0,0,0,0,0,0,0,0,0,0,0,0,0,0,0,0,0,0,0,0,0
2010-10-25 00:00:00.000,Vienna Austria ATP World Tour 250,HARD,2,Lukasz Kubot,James Blake,Lukasz Kubot,6-4; 6-4,R32,70,7,6,28,53,25,28,8,25,3,6,10,33,53,1,2,36,61,24,36,8,25,0,5,10,32,61
2010-10-25 00:00:00.000,Vienna Austria ATP World Tour 250,HARD,2,Tobias Kamke,Matthias Bachinger,Tobias Kamke,6-4; 6-4,R32,84,1,0,45,66,34,45,12,21,4,4,10,46,66,4,3,49,68,33,49,10,19,6,8,10,43,68
2010-10-25 00:00:00.000,Vienna Austria ATP World Tour 250,HARD,2,Philipp Kohlschreiber,Alejandro Falla,Philipp Kohlschreiber,6-0; 6-3,R32,55,5,2,29,46,23,29,8,17,0,1,8,31,46,1,2,25,43,14,25,4,18,5,10,7,18,43
2010-10-25 00:00:00.000,Vienna Austria ATP World Tour 250,HARD,2,Nicolas Almagro,N/A Bye,Nicolas Almagro,,R32,0,0,0,0,0,0,0,0,0,0,0,0,0,0,0,0,0,0,0,0,0,0,0,0,0,0,0
2010-10-25 00:00:00.000,Vienna Austria ATP World Tour 250,HARD,2,Santiago Giraldo,Xavier Malisse,Santiago Giraldo,6-4; 1-6; 6-1,R32,93,8,1,53,78,34,53,14,25,4,7,12,48,78,7,1,46,72,30,46,14,26,3,7,12,44,72
2010-10-25 00:00:00.000,Vienna Austria ATP World Tour 250,HARD,2,Grega Zemlja,Marsel Ilhan,Grega Zemlja,4-6; 6-1; 7-5,R32,117,11,2,53,89,39,53,22,36,4,6,15,61,89,6,0,61,87,40,61,14,26,9,13,14,54,87
2010-10-25 00:00:00.000,Vienna Austria ATP World Tour 250,HARD,2,Juan Ignacio Chela,Andrej Martin,Juan Ignacio Chela,6-3; 6-3,R32,68,2,1,36,52,24,36,12,16,0,1,9,36,52,0,2,38,56,23,38,7,18,3,7,9,30,56
2010-10-25 00:00:00.000,Vienna Austria ATP World Tour 250,HARD,2,Michael Berrer,Guillermo Garcia-Lopez,Michael Berrer,6-3; 4-6; 7-5,R32,127,9,5,57,94,45,57,18,37,8,10,15,63,94,10,12,58,105,44,58,20,47,11,15,16,64,105
2010-10-25 00:00:00.000,Vienna Austria ATP World Tour 250,HARD,2,Pablo Cuevas,Thiemo de Bakker,Pablo Cuevas,7-6(6); 1-6; 6-4,R32,109,12,1,59,95,47,59,18,36,6,9,15,65,95,6,2,50,81,43,50,19,31,3,4,14,62,81
2010-10-25 00:00:00.000,Vienna Austria ATP World Tour 250,HARD,2,Bjorn Phau,Florian Mayer,Bjorn Phau,6-2; 6-4,R32,63,5,2,34,54,28,34,12,20,1,1,9,40,54,1,1,31,55,20,31,11,24,5,8,9,31,55
2010-10-25 00:00:00.000,Vienna Austria ATP World Tour 250,HARD,2,Marcos Baghdatis,N/A Bye,Marcos Baghdatis,,R32,0,0,0,0,0,0,0,0,0,0,0,0,0,0,0,0,0,0,0,0,0,0,0,0,0,0,0
2010-10-25 00:00:00.000,Vienna Austria ATP World Tour 250,HARD,2,Andreas Haider-Maurer,Thomas Muster,Andreas Haider-Maurer,6-2; 7-6(5),R32,76,6,3,27,55,26,27,17,28,0,0,10,43,55,5,2,40,66,25,40,16,26,4,6,10,41,66
2010-10-25 00:00:00.000,Vienna Austria ATP World Tour 250,HARD,2,Andreas Seppi,Martin Fischer,Andreas Seppi,6-3; 6-3,R32,71,5,3,33,50,23,33,12,17,2,3,9,35,50,1,2,28,63,18,28,15,35,5,9,9,33,63
2010-10-25 00:00:00.000,Vienna Austria ATP World Tour 250,HARD,2,Jan Hajek,Pere Riba,Jan Hajek,6-0; 6-2,R32,47,3,1,20,37,16,20,12,17,0,0,7,28,37,0,3,14,41,8,14,10,27,1,6,7,18,41
2010-10-25 00:00:00.000,Vienna Austria ATP World Tour 250,HARD,2,Marin Cilic,N/A Bye,Marin Cilic,,R32,0,0,0,0,0,0,0,0,0,0,0,0,0,0,0,0,0,0,0,0,0,0,0,0,0,0,0
2010-10-25 00:00:00.000,Vienna Austria ATP World Tour 250,HARD,2,Jurgen Melzer,Lukasz Kubot,Jurgen Melzer,7-6(3); 7-6(2),R16,132,6,1,58,88,38,58,16,30,4,7,12,54,88,13,9,56,89,41,56,11,33,3,6,12,52,89
2010-10-25 00:00:00.000,Vienna Austria ATP World Tour 250,HARD,2,Philipp Kohlschreiber,Tobias Kamke,Philipp Kohlschreiber,6-4; 3-6; 6-1,R16,116,3,5,57,95,38,57,21,38,10,12,13,59,95,1,0,51,77,33,51,13,26,5,9,13,46,77
2010-10-25 00:00:00.000,Vienna Austria ATP World Tour 250,HARD,2,Nicolas Almagro,Santiago Giraldo,Nicolas Almagro,7-6(4); 6-7(3); 6-3,R16,128,12,2,56,106,44,56,29,50,3,5,17,73,106,13,5,60,92,46,60,17,32,2,5,16,63,92
2010-10-25 00:00:00.000,Vienna Austria ATP World Tour 250,HARD,2,Juan Ignacio Chela,Grega Zemlja,Juan Ignacio Chela,2-6; 7-6(5); 6-3,R16,134,2,4,68,103,47,68,21,35,3,5,15,68,103,8,0,64,95,45,64,21,31,6,7,14,66,95
2010-10-25 00:00:00.000,Vienna Austria ATP World Tour 250,HARD,2,Michael Berrer,Pablo Cuevas,Michael Berrer,5-7; 6-3; 6-3,R16,116,5,3,45,80,35,45,20,35,1,3,15,55,80,9,4,56,89,39,56,15,33,2,6,15,54,89
2010-10-25 00:00:00.000,Vienna Austria ATP World Tour 250,HARD,2,Marcos Baghdatis,Bjorn Phau,Marcos Baghdatis,7-5; 6-2,R16,73,11,5,33,63,29,33,15,30,2,2,10,44,63,3,1,32,59,18,32,18,27,3,6,10,36,59
2010-10-25 00:00:00.000,Vienna Austria ATP World Tour 250,HARD,2,Andreas Haider-Maurer,Andreas Seppi,Andreas Haider-Maurer,6-3; 6-7(7); 7-6(2),R16,150,18,7,68,121,52,68,26,53,6,9,17,78,121,10,4,64,98,42,64,23,34,1,5,16,65,98
2010-10-25 00:00:00.000,Vienna Austria ATP World Tour 250,HARD,2,Marin Cilic,Jan Hajek,Marin Cilic,7-6(4); 6-2,R16,98,11,0,46,71,36,46,14,25,9,10,10,50,71,6,4,36,71,27,36,14,35,4,7,10,41,71
2010-10-25 00:00:00.000,Vienna Austria ATP World Tour 250,HARD,2,Jurgen Melzer,Philipp Kohlschreiber,Jurgen Melzer,W/O,Q,0,0,0,0,0,0,0,0,0,0,0,0,0,0,0,0,0,0,0,0,0,0,0,0,0,0,0
2010-10-25 00:00:00.000,Vienna Austria ATP World Tour 250,HARD,2,Nicolas Almagro,Juan Ignacio Chela,Nicolas Almagro,7-5; 3-6; 6-3,Q,113,9,1,56,90,38,56,19,34,3,6,15,57,90,1,0,56,95,34,56,22,39,5,9,15,56,95
2010-10-25 00:00:00.000,Vienna Austria ATP World Tour 250,HARD,2,Michael Berrer,Marcos Baghdatis,Michael Berrer,5-7; 6-1; 6-4,Q,112,6,2,43,73,37,43,20,30,0,1,15,57,73,4,3,48,88,35,48,21,40,7,10,14,56,88
2010-10-25 00:00:00.000,Vienna Austria ATP World Tour 250,HARD,2,Andreas Haider-Maurer,Marin Cilic,Andreas Haider-Maurer,7-6(1); 6-4,Q,106,10,4,38,65,32,38,16,27,1,2,11,48,65,12,0,49,77,31,49,15,28,3,5,11,46,77
2010-10-25 00:00:00.000,Vienna Austria ATP World Tour 250,HARD,2,Jurgen Melzer,Nicolas Almagro,Jurgen Melzer,6-4; 6-4,S,93,2,1,32,55,27,32,15,23,2,3,10,42,55,8,4,54,77,38,54,7,23,6,9,10,45,77
2010-10-25 00:00:00.000,Vienna Austria ATP World Tour 250,HARD,2,Andreas Haider-Maurer,Michael Berrer,Andreas Haider-Maurer,7-6(6); 6-7(1); 6-3,S,150,15,7,58,100,48,58,29,42,1,2,17,77,100,14,1,64,102,52,64,22,38,3,5,16,74,102
2010-10-25 00:00:00.000,Vienna Austria ATP World Tour 250,HARD,2,Jurgen Melzer,Andreas Haider-Maurer,Jurgen Melzer,6-7(10); 7-6(4); 6-4,F,168,13,2,74,110,57,74,23,36,3,4,17,80,110,17,6,75,122,58,75,23,47,10,12,17,81,122
2010-10-31 00:00:00.000,Valencia Spain ATP World Tour 500,HARD,2,Andy Murray,Feliciano Lopez,Andy Murray,6-3; 7-6(1),R32,87,7,1,31,64,25,31,21,33,2,3,11,46,64,6,3,30,59,24,30,12,29,0,2,10,36,59
2010-10-31 00:00:00.000,Valencia Spain ATP World Tour 500,HARD,2,Juan Monaco,Roberto Bautista Agut,Juan Monaco,6-0; 7-6(7),R32,116,0,2,40,75,32,40,17,35,5,5,9,49,75,0,1,49,76,28,49,15,27,5,8,9,43,76
2010-10-31 00:00:00.000,Valencia Spain ATP World Tour 500,HARD,2,Pablo Andujar,Dmitry Tursunov,Pablo Andujar,6-4; 3-6; 1-1 RET,R32,102,1,4,41,63,30,41,9,22,3,5,10,39,63,5,3,38,67,25,38,18,29,4,6,11,43,67
2010-10-31 00:00:00.000,Valencia Spain ATP World Tour 500,HARD,2,Marcel Granollers,Benoit Paire,Marcel Granollers,6-2; 6-4,R32,72,5,1,31,57,24,31,13,26,1,2,9,37,57,2,2,24,51,17,24,11,27,5,9,9,28,51
2010-10-31 00:00:00.000,Valencia Spain ATP World Tour 500,HARD,2,Fernando Verdasco,Michael Russell,Fernando Verdasco,6-4; 6-1,R32,75,5,2,25,43,17,25,14,18,2,3,8,31,43,2,2,43,57,22,43,4,14,2,7,9,26,57
2010-10-31 00:00:00.000,Valencia Spain ATP World Tour 500,HARD,2,Gilles Simon,Sergiy Stakhovsky,Gilles Simon,6-3; 6-3,R32,82,3,0,30,55,22,30,17,25,1,1,9,39,55,2,4,38,68,24,38,13,30,9,12,9,37,68
2010-10-31 00:00:00.000,Valencia Spain ATP World Tour 500,HARD,2,Juan Ignacio Chela,Philipp Kohlschreiber,Juan Ignacio Chela,6-2; 3-6; 6-2,R32,107,1,2,56,80,40,56,11,24,6,8,12,51,80,6,3,58,90,36,58,16,32,6,11,13,52,90
2010-10-31 00:00:00.000,Valencia Spain ATP World Tour 500,HARD,2,Nikolay Davydenko,Javier Marti,Nikolay Davydenko,6-2; 6-2,R32,71,1,0,28,44,22,28,9,16,2,3,8,31,44,1,2,38,59,14,38,12,21,4,9,8,26,59
2010-10-31 00:00:00.000,Valencia Spain ATP World Tour 500,HARD,2,Pablo Cuevas,Albert Ramos,Pablo Cuevas,6-3; 6-4,R32,87,3,0,29,50,24,29,16,21,0,0,10,40,50,1,3,38,72,22,38,21,34,8,10,9,43,72
2010-10-31 00:00:00.000,Valencia Spain ATP World Tour 500,HARD,2,Potito Starace,Victor Hanescu,Potito Starace,4-6; 6-4; 6-2,R32,110,2,2,58,100,38,58,22,42,7,10,14,60,100,5,4,56,75,38,56,7,19,6,11,14,45,75
2010-10-31 00:00:00.000,Valencia Spain ATP World Tour 500,HARD,2,Teymuraz Gabashvili,Arnaud Clement,Teymuraz Gabashvili,6-4; 6-2,R32,80,3,0,28,48,23,28,11,20,0,1,9,34,48,3,4,29,61,24,29,9,32,3,7,9,33,61
2010-10-31 00:00:00.000,Valencia Spain ATP World Tour 500,HARD,2,David Ferrer,Guillermo Garcia-Lopez,David Ferrer,6-7(3); 6-3; 6-3,R32,133,0,2,65,110,41,65,25,45,7,9,15,66,110,1,6,45,96,29,45,27,51,2,7,15,56,96
2010-10-31 00:00:00.000,Valencia Spain ATP World Tour 500,HARD,2,Gael Monfils,Eduardo Schwank,Gael Monfils,6-3; 6-3,R32,66,5,1,36,49,26,36,8,13,1,2,9,34,49,2,0,38,58,22,38,9,20,2,6,9,31,58
2010-10-31 00:00:00.000,Valencia Spain ATP World Tour 500,HARD,2,Stanislas Wawrinka,Andreas Seppi,Stanislas Wawrinka,7-6(2); 7-5,R32,123,9,1,56,86,42,56,14,30,6,8,12,56,86,4,3,54,94,33,54,20,40,6,9,12,53,94
2010-10-31 00:00:00.000,Valencia Spain ATP World Tour 500,HARD,2,Daniel Gimeno-Traver,Nicolas Almagro,Daniel Gimeno-Traver,6-4; 3-6; 6-3,R32,111,12,6,44,79,39,44,15,35,5,7,14,54,79,3,1,53,89,38,53,17,36,4,7,14,55,89
2010-10-31 00:00:00.000,Valencia Spain ATP World Tour 500,HARD,2,Robin Soderling,Albert Montanes,Robin Soderling,6-1; 6-4,R32,62,14,2,28,48,26,28,12,20,1,1,9,38,48,4,3,31,57,20,31,11,26,2,5,8,31,57
2010-10-31 00:00:00.000,Valencia Spain ATP World Tour 500,HARD,2,Juan Monaco,Andy Murray,Juan Monaco,6-2; 3-6; 6-2,R16,132,2,3,49,74,35,49,16,25,4,6,12,51,74,4,4,36,77,23,36,18,41,3,8,13,41,77
2010-10-31 00:00:00.000,Valencia Spain ATP World Tour 500,HARD,2,Marcel Granollers,Pablo Andujar,Marcel Granollers,6-2; 6-2,R16,77,1,1,32,52,22,32,10,20,3,5,8,32,52,2,2,38,58,20,38,4,20,5,11,8,24,58
2010-10-31 00:00:00.000,Valencia Spain ATP World Tour 500,HARD,2,Gilles Simon,Fernando Verdasco,Gilles Simon,6-1; 6-3,R16,57,1,0,27,44,22,27,11,17,1,1,8,33,44,3,5,26,41,17,26,4,15,0,4,8,21,41
2010-10-31 00:00:00.000,Valencia Spain ATP World Tour 500,HARD,2,Nikolay Davydenko,Juan Ignacio Chela,Nikolay Davydenko,7-6(0); 6-2,R16,94,3,2,46,65,25,46,10,19,6,10,10,35,65,1,3,34,63,15,34,9,29,2,8,10,24,63
2010-10-31 00:00:00.000,Valencia Spain ATP World Tour 500,HARD,2,Potito Starace,Pablo Cuevas,Potito Starace,7-6(2); 2-6; 6-2,R16,115,4,2,66,93,46,66,16,27,5,7,14,62,93,7,1,43,80,37,43,17,37,1,3,14,54,80
2010-10-31 00:00:00.000,Valencia Spain ATP World Tour 500,HARD,2,David Ferrer,Teymuraz Gabashvili,David Ferrer,6-4; 6-1,R16,71,0,0,25,36,22,25,10,11,0,0,8,32,36,3,3,31,61,21,31,12,30,5,9,9,33,61
2010-10-31 00:00:00.000,Valencia Spain ATP World Tour 500,HARD,2,Gael Monfils,Stanislas Wawrinka,Gael Monfils,6-2; 6-4,R16,91,1,2,31,51,20,31,15,20,1,2,9,35,51,1,0,38,74,22,38,16,36,10,14,9,38,74
2010-10-31 00:00:00.000,Valencia Spain ATP World Tour 500,HARD,2,Robin Soderling,Daniel Gimeno-Traver,Robin Soderling,6-2; 6-3,R16,62,5,1,26,45,24,26,13,19,2,2,9,37,45,7,2,23,50,16,23,12,27,1,4,8,28,50
2010-10-31 00:00:00.000,Valencia Spain ATP World Tour 500,HARD,2,Marcel Granollers,Juan Monaco,Marcel Granollers,1-6; 6-3; 6-4,Q,136,2,5,47,87,34,47,13,40,6,11,13,47,87,2,4,55,87,31,55,17,32,2,7,13,48,87
2010-10-31 00:00:00.000,Valencia Spain ATP World Tour 500,HARD,2,Gilles Simon,Nikolay Davydenko,Gilles Simon,6-4; 6-7(5); 6-3,Q,149,5,0,67,109,48,67,18,42,4,7,16,66,109,3,1,47,87,33,47,19,40,1,6,15,52,87
2010-10-31 00:00:00.000,Valencia Spain ATP World Tour 500,HARD,2,David Ferrer,Potito Starace,David Ferrer,7-5; 6-4,Q,88,7,0,37,57,33,37,12,20,2,2,11,45,57,3,0,55,79,34,55,12,24,6,8,11,46,79
2010-10-31 00:00:00.000,Valencia Spain ATP World Tour 500,HARD,2,Robin Soderling,Gael Monfils,Robin Soderling,6-3; 6-2,Q,54,5,2,32,49,24,32,13,17,0,0,9,37,49,5,3,31,41,17,31,6,10,1,4,8,23,41
2010-10-31 00:00:00.000,Valencia Spain ATP World Tour 500,HARD,2,Marcel Granollers,Gilles Simon,Marcel Granollers,6-4; 6-4,S,94,6,2,39,61,28,39,10,22,2,4,10,38,61,2,6,45,72,28,45,11,27,9,13,10,39,72
2010-10-31 00:00:00.000,Valencia Spain ATP World Tour 500,HARD,2,David Ferrer,Robin Soderling,David Ferrer,6-3; 3-6; 6-3,S,117,0,1,57,83,42,57,13,26,3,5,14,55,83,8,0,44,81,32,44,19,37,3,6,13,51,81
2010-10-31 00:00:00.000,Valencia Spain ATP World Tour 500,HARD,2,David Ferrer,Marcel Granollers,David Ferrer,7-5; 6-3,F,109,1,2,56,75,43,56,9,19,3,4,11,52,75,6,3,42,74,28,42,15,32,4,7,10,43,74
2010-11-01 00:00:00.000,Basel Switzerland ATP World Tour 500,HARD,2,Roger Federer,Alexandr Dolgopolov,Roger Federer,6-4; 5-2 RET,R32,52,9,1,20,37,19,20,14,17,0,0,8,33,37,4,1,30,54,19,30,13,24,2,5,9,32,54
2010-11-01 00:00:00.000,Basel Switzerland ATP World Tour 500,HARD,2,Janko Tipsarevic,Denis Istomin,Janko Tipsarevic,6-2; 6-4,R32,75,5,2,33,58,25,33,16,25,2,2,9,41,58,3,0,36,57,23,36,8,21,1,4,9,31,57
2010-11-01 00:00:00.000,Basel Switzerland ATP World Tour 500,HARD,2,Radek Stepanek,Thiemo de Bakker,Radek Stepanek,6-3; 7-6(5),R32,88,5,4,43,66,35,43,8,23,1,3,11,43,66,9,0,44,69,29,44,11,25,6,9,10,40,69
2010-11-01 00:00:00.000,Basel Switzerland ATP World Tour 500,HARD,2,Santiago Giraldo,Karol Beck,Santiago Giraldo,6-2; 6-1,R32,75,6,1,19,50,15,19,18,31,2,2,7,33,50,1,5,30,62,15,30,15,32,5,10,8,30,62
2010-11-01 00:00:00.000,Basel Switzerland ATP World Tour 500,HARD,2,Andy Roddick,Sam Querrey,Andy Roddick,7-5; 7-6(6),R32,98,16,1,53,70,47,53,9,17,1,1,12,56,70,13,1,47,77,37,47,16,30,1,2,12,53,77
2010-11-01 00:00:00.000,Basel Switzerland ATP World Tour 500,HARD,2,Andrey Golubev,Xavier Malisse,Andrey Golubev,7-5; 6-2,R32,74,3,1,27,52,19,27,18,25,0,1,10,37,52,4,5,38,64,24,38,10,26,4,8,10,34,64
2010-11-01 00:00:00.000,Basel Switzerland ATP World Tour 500,HARD,2,David Nalbandian,Jan Hajek,David Nalbandian,6-3; 6-4,R32,75,2,3,32,60,28,32,16,28,5,5,10,44,60,4,6,29,59,20,29,16,30,3,5,9,36,59
2010-11-01 00:00:00.000,Basel Switzerland ATP World Tour 500,HARD,2,Marin Cilic,Marco Chiudinelli,Marin Cilic,6-3; 6-3,R32,89,7,3,32,59,26,32,15,27,4,4,9,41,59,1,2,31,58,22,31,12,27,6,9,9,34,58
2010-11-01 00:00:00.000,Basel Switzerland ATP World Tour 500,HARD,2,Paul-Henri Mathieu,Florian Mayer,Paul-Henri Mathieu,6-3; 6-3,R32,66,4,1,34,52,26,34,13,18,0,0,9,39,52,4,1,30,57,22,30,12,27,3,6,9,34,57
2010-11-01 00:00:00.000,Basel Switzerland ATP World Tour 500,HARD,2,Viktor Troicki,Michael Berrer,Viktor Troicki,6-3; 6-0,R32,49,7,1,22,40,18,22,14,18,0,0,8,32,40,2,2,26,40,18,26,3,14,5,9,7,21,40
2010-11-01 00:00:00.000,Basel Switzerland ATP World Tour 500,HARD,2,Richard Gasquet,Yen-Hsun Lu,Richard Gasquet,6-3; 6-1,R32,79,2,0,32,49,27,32,9,17,3,3,8,36,49,3,4,41,74,24,41,13,33,10,14,8,37,74
2010-11-01 00:00:00.000,Basel Switzerland ATP World Tour 500,HARD,2,Tobias Kamke,Tomas Berdych,Tobias Kamke,6-4; 6-1,R32,82,1,0,27,44,19,27,13,17,0,0,8,32,44,6,2,37,68,26,37,11,31,7,11,9,37,68
2010-11-01 00:00:00.000,Basel Switzerland ATP World Tour 500,HARD,2,John Isner,Michael Llodra,John Isner,4-6; 7-5; 6-3,R32,105,20,1,60,78,50,60,8,18,1,3,16,58,78,11,5,63,98,47,63,15,35,9,12,15,62,98
2010-11-01 00:00:00.000,Basel Switzerland ATP World Tour 500,HARD,2,Robin Haase,Stephane Bohli,Robin Haase,6-4; 6-3,R32,63,7,0,31,47,27,31,10,16,0,0,9,37,47,7,1,25,56,19,25,17,31,3,6,10,36,56
2010-11-01 00:00:00.000,Basel Switzerland ATP World Tour 500,HARD,2,Jarkko Nieminen,Daniel Brands,Jarkko Nieminen,6-3; 6-2,R32,68,4,5,39,55,28,39,9,16,0,1,9,37,55,1,1,41,60,21,41,10,19,6,10,8,31,60
2010-11-01 00:00:00.000,Basel Switzerland ATP World Tour 500,HARD,2,Novak Djokovic,Ernests Gulbis,Novak Djokovic,6-4; 6-2,R32,72,5,1,35,52,25,35,12,17,1,2,9,37,52,5,2,36,57,24,36,6,21,3,7,9,30,57
2010-11-01 00:00:00.000,Basel Switzerland ATP World Tour 500,HARD,2,Roger Federer,Janko Tipsarevic,Roger Federer,6-3; 6-4,R16,61,8,1,25,47,25,25,15,22,0,0,10,40,47,2,1,36,55,24,36,9,19,0,2,9,33,55
2010-11-01 00:00:00.000,Basel Switzerland ATP World Tour 500,HARD,2,Radek Stepanek,Santiago Giraldo,Radek Stepanek,3-6; 6-2; 6-0,R16,101,8,3,55,87,38,55,16,32,10,12,12,54,87,3,3,44,67,22,44,9,23,2,7,11,31,67
2010-11-01 00:00:00.000,Basel Switzerland ATP World Tour 500,HARD,2,Andy Roddick,Andrey Golubev,Andy Roddick,6-3; 6-4,R16,76,10,0,37,54,34,37,5,17,0,1,10,39,54,3,3,39,58,23,39,10,19,5,8,9,33,58
2010-11-01 00:00:00.000,Basel Switzerland ATP World Tour 500,HARD,2,David Nalbandian,Marin Cilic,David Nalbandian,4-6; 6-4; 6-4,R16,120,3,2,48,78,38,48,19,30,2,4,15,57,78,9,4,62,91,44,62,16,29,7,10,15,60,91
2010-11-01 00:00:00.000,Basel Switzerland ATP World Tour 500,HARD,2,Viktor Troicki,Paul-Henri Mathieu,Viktor Troicki,W/O,R16,0,0,0,0,0,0,0,0,0,0,0,0,0,0,0,0,0,0,0,0,0,0,0,0,0,0,0
2010-11-01 00:00:00.000,Basel Switzerland ATP World Tour 500,HARD,2,Richard Gasquet,Tobias Kamke,Richard Gasquet,6-4; 7-5,R16,90,2,2,38,55,30,38,10,17,2,4,11,40,55,1,3,37,72,27,37,14,35,8,12,11,41,72
2010-11-01 00:00:00.000,Basel Switzerland ATP World Tour 500,HARD,2,Robin Haase,John Isner,Robin Haase,6-2; 6-7(5); 7-5,R16,123,9,3,63,97,54,63,22,34,8,8,16,76,97,13,2,84,109,56,84,15,25,4,7,16,71,109
2010-11-01 00:00:00.000,Basel Switzerland ATP World Tour 500,HARD,2,Novak Djokovic,Jarkko Nieminen,Novak Djokovic,6-4; 7-6(6),R16,118,7,1,45,78,37,45,16,33,4,4,11,53,78,2,0,61,84,38,61,14,23,1,2,11,52,84
2010-11-01 00:00:00.000,Basel Switzerland ATP World Tour 500,HARD,2,Roger Federer,Radek Stepanek,Roger Federer,6-3; 6-2,Q,60,7,1,28,45,24,28,12,17,0,0,9,36,45,2,1,34,47,22,34,7,13,3,6,8,29,47
2010-11-01 00:00:00.000,Basel Switzerland ATP World Tour 500,HARD,2,Andy Roddick,David Nalbandian,Andy Roddick,6-4; 6-4,Q,75,11,0,36,49,30,36,10,13,0,0,10,40,49,5,2,36,61,26,36,13,25,2,4,10,39,61
2010-11-01 00:00:00.000,Basel Switzerland ATP World Tour 500,HARD,2,Viktor Troicki,Richard Gasquet,Viktor Troicki,6-4; 6-2,Q,67,12,2,35,57,31,35,10,22,0,0,9,41,57,0,4,28,51,22,28,10,23,1,4,9,32,51
2010-11-01 00:00:00.000,Basel Switzerland ATP World Tour 500,HARD,2,Novak Djokovic,Robin Haase,Novak Djokovic,6-2; 6-3,Q,79,5,1,33,53,25,33,13,20,4,5,9,38,53,2,3,31,65,20,31,13,34,8,12,8,33,65
2010-11-01 00:00:00.000,Basel Switzerland ATP World Tour 500,HARD,2,Roger Federer,Andy Roddick,Roger Federer,6-2; 6-4,S,70,13,1,31,53,29,31,9,22,4,5,9,38,53,4,4,34,54,24,34,7,20,4,8,9,31,54
2010-11-01 00:00:00.000,Basel Switzerland ATP World Tour 500,HARD,2,Novak Djokovic,Viktor Troicki,Novak Djokovic,7-6(4); 6-4,S,98,3,2,37,68,28,37,19,31,2,3,11,47,68,8,1,40,67,32,40,13,27,3,5,11,45,67
2010-11-01 00:00:00.000,Basel Switzerland ATP World Tour 500,HARD,2,Roger Federer,Novak Djokovic,Roger Federer,6-4; 3-6; 6-1,F,115,6,4,49,84,39,49,19,35,4,5,13,58,84,4,2,57,82,37,57,16,25,5,8,13,53,82
2010-11-07 00:00:00.000,ATP World Tour Masters 1000 Paris France ATP World Tour Masters 1000,HARD,2,Roger Federer,N/A Bye,Roger Federer,,R64,0,0,0,0,0,0,0,0,0,0,0,0,0,0,0,0,0,0,0,0,0,0,0,0,0,0,0
2010-11-07 00:00:00.000,ATP World Tour Masters 1000 Paris France ATP World Tour Masters 1000,HARD,2,Richard Gasquet,Nicolas Mahut,Richard Gasquet,7-5; 4-6; 7-6(7),R64,147,11,5,64,104,56,64,20,40,1,2,17,76,104,17,7,71,120,58,71,23,49,7,8,17,81,120
2010-11-07 00:00:00.000,ATP World Tour Masters 1000 Paris France ATP World Tour Masters 1000,HARD,2,Radek Stepanek,Michael Russell,Radek Stepanek,6-2; 6-0,R64,49,8,0,26,35,23,26,6,9,1,1,7,29,35,4,5,22,41,13,22,5,19,3,8,7,18,41
2010-11-07 00:00:00.000,ATP World Tour Masters 1000 Paris France ATP World Tour Masters 1000,HARD,2,Nicolas Almagro,N/A Bye,Nicolas Almagro,,R64,0,0,0,0,0,0,0,0,0,0,0,0,0,0,0,0,0,0,0,0,0,0,0,0,0,0,0
2010-11-07 00:00:00.000,ATP World Tour Masters 1000 Paris France ATP World Tour Masters 1000,HARD,2,Jurgen Melzer,N/A Bye,Jurgen Melzer,,R64,0,0,0,0,0,0,0,0,0,0,0,0,0,0,0,0,0,0,0,0,0,0,0,0,0,0,0
2010-11-07 00:00:00.000,ATP World Tour Masters 1000 Paris France ATP World Tour Masters 1000,HARD,2,Santiago Giraldo,Thiemo de Bakker,Santiago Giraldo,6-7(3); 6-4; 7-5,R64,166,5,1,72,124,51,72,31,52,8,9,17,82,124,17,6,58,116,45,58,29,58,12,15,17,74,116
2010-11-07 00:00:00.000,ATP World Tour Masters 1000 Paris France ATP World Tour Masters 1000,HARD,2,Fabio Fognini,Michael Berrer,Fabio Fognini,7-5; 3-6; 6-4,R64,121,5,2,63,105,40,63,24,42,2,5,15,64,105,8,3,54,88,44,54,14,34,4,8,16,58,88
2010-11-07 00:00:00.000,ATP World Tour Masters 1000 Paris France ATP World Tour Masters 1000,HARD,2,David Ferrer,N/A Bye,David Ferrer,,R64,0,0,0,0,0,0,0,0,0,0,0,0,0,0,0,0,0,0,0,0,0,0,0,0,0,0,0
2010-11-07 00:00:00.000,ATP World Tour Masters 1000 Paris France ATP World Tour Masters 1000,HARD,2,Andy Murray,N/A Bye,Andy Murray,,R64,0,0,0,0,0,0,0,0,0,0,0,0,0,0,0,0,0,0,0,0,0,0,0,0,0,0,0
2010-11-07 00:00:00.000,ATP World Tour Masters 1000 Paris France ATP World Tour Masters 1000,HARD,2,David Nalbandian,Marcel Granollers,David Nalbandian,6-3; 6-1,R64,67,2,3,32,52,27,32,7,20,3,4,8,34,52,5,5,27,54,17,27,9,27,4,9,8,26,54
2010-11-07 00:00:00.000,ATP World Tour Masters 1000 Paris France ATP World Tour Masters 1000,HARD,2,Sergiy Stakhovsky,Illya Marchenko,Sergiy Stakhovsky,6-2; 6-2,R64,73,9,2,35,50,30,35,7,15,2,2,8,37,50,2,3,39,63,21,39,11,24,8,12,8,32,63
2010-11-07 00:00:00.000,ATP World Tour Masters 1000 Paris France ATP World Tour Masters 1000,HARD,2,Marin Cilic,N/A Bye,Marin Cilic,,R64,0,0,0,0,0,0,0,0,0,0,0,0,0,0,0,0,0,0,0,0,0,0,0,0,0,0,0
2010-11-07 00:00:00.000,ATP World Tour Masters 1000 Paris France ATP World Tour Masters 1000,HARD,2,Gael Monfils,N/A Bye,Gael Monfils,,R64,0,0,0,0,0,0,0,0,0,0,0,0,0,0,0,0,0,0,0,0,0,0,0,0,0,0,0
2010-11-07 00:00:00.000,ATP World Tour Masters 1000 Paris France ATP World Tour Masters 1000,HARD,2,Benjamin Becker,Denis Istomin,Benjamin Becker,6-4; 6-4,R64,79,7,3,36,60,31,36,10,24,3,4,10,41,60,3,3,30,60,20,30,16,30,4,7,10,36,60
2010-11-07 00:00:00.000,ATP World Tour Masters 1000 Paris France ATP World Tour Masters 1000,HARD,2,Arnaud Clement,Feliciano Lopez,Arnaud Clement,6-7(8); 7-6(7); 6-3,R64,161,22,1,76,122,60,76,29,46,0,0,17,89,122,30,8,59,106,49,59,27,47,4,5,16,76,106
2010-11-07 00:00:00.000,ATP World Tour Masters 1000 Paris France ATP World Tour Masters 1000,HARD,2,Fernando Verdasco,N/A Bye,Fernando Verdasco,,R64,0,0,0,0,0,0,0,0,0,0,0,0,0,0,0,0,0,0,0,0,0,0,0,0,0,0,0
2010-11-07 00:00:00.000,ATP World Tour Masters 1000 Paris France ATP World Tour Masters 1000,HARD,2,Andy Roddick,N/A Bye,Andy Roddick,,R64,0,0,0,0,0,0,0,0,0,0,0,0,0,0,0,0,0,0,0,0,0,0,0,0,0,0,0
2010-11-07 00:00:00.000,ATP World Tour Masters 1000 Paris France ATP World Tour Masters 1000,HARD,2,Jarkko Nieminen,Xavier Malisse,Jarkko Nieminen,6-4; 6-3,R64,75,1,1,39,60,27,39,14,21,4,5,10,41,60,6,4,39,69,26,39,13,30,6,9,9,39,69
2010-11-07 00:00:00.000,ATP World Tour Masters 1000 Paris France ATP World Tour Masters 1000,HARD,2,Ernests Gulbis,Juan Ignacio Chela,Ernests Gulbis,7-5; 2-2 RET,R64,61,9,3,26,42,23,26,10,16,0,0,8,33,42,2,2,31,61,24,31,14,30,5,6,8,38,61
2010-11-07 00:00:00.000,ATP World Tour Masters 1000 Paris France ATP World Tour Masters 1000,HARD,2,Mikhail Youzhny,N/A Bye,Mikhail Youzhny,,R64,0,0,0,0,0,0,0,0,0,0,0,0,0,0,0,0,0,0,0,0,0,0,0,0,0,0,0
2010-11-07 00:00:00.000,ATP World Tour Masters 1000 Paris France ATP World Tour Masters 1000,HARD,2,Ivan Ljubicic,N/A Bye,Ivan Ljubicic,,R64,0,0,0,0,0,0,0,0,0,0,0,0,0,0,0,0,0,0,0,0,0,0,0,0,0,0,0
2010-11-07 00:00:00.000,ATP World Tour Masters 1000 Paris France ATP World Tour Masters 1000,HARD,2,Stanislas Wawrinka,Josselin Ouanna,Stanislas Wawrinka,6-3; 7-5,R64,84,9,3,38,63,30,38,17,25,2,2,11,47,63,5,4,31,65,26,31,15,34,2,4,10,41,65
2010-11-07 00:00:00.000,ATP World Tour Masters 1000 Paris France ATP World Tour Masters 1000,HARD,2,Gilles Simon,Andrey Golubev,Gilles Simon,3-6; 6-4; 6-3,R64,104,6,1,45,79,32,45,22,34,1,3,14,54,79,10,6,44,76,35,44,16,32,3,6,14,51,76
2010-11-07 00:00:00.000,ATP World Tour Masters 1000 Paris France ATP World Tour Masters 1000,HARD,2,Robin Soderling,N/A Bye,Robin Soderling,,R64,0,0,0,0,0,0,0,0,0,0,0,0,0,0,0,0,0,0,0,0,0,0,0,0,0,0,0
2010-11-07 00:00:00.000,ATP World Tour Masters 1000 Paris France ATP World Tour Masters 1000,HARD,2,Tomas Berdych,N/A Bye,Tomas Berdych,,R64,0,0,0,0,0,0,0,0,0,0,0,0,0,0,0,0,0,0,0,0,0,0,0,0,0,0,0
2010-11-07 00:00:00.000,ATP World Tour Masters 1000 Paris France ATP World Tour Masters 1000,HARD,2,Florent Serra,Albert Montanes,Florent Serra,4-6; 6-1; 7-6(3),R64,108,7,3,69,105,50,69,22,36,11,13,15,72,105,8,3,48,93,30,48,29,45,6,9,14,59,93
2010-11-07 00:00:00.000,ATP World Tour Masters 1000 Paris France ATP World Tour Masters 1000,HARD,2,Thomaz Bellucci,Philipp Kohlschreiber,Thomaz Bellucci,7-6(5); 5-7; 6-3,R64,130,21,4,58,105,45,58,29,47,7,8,16,74,105,20,3,62,101,51,62,19,39,2,4,17,70,101
2010-11-07 00:00:00.000,ATP World Tour Masters 1000 Paris France ATP World Tour Masters 1000,HARD,2,Nikolay Davydenko,N/A Bye,Nikolay Davydenko,,R64,0,0,0,0,0,0,0,0,0,0,0,0,0,0,0,0,0,0,0,0,0,0,0,0,0,0,0
2010-11-07 00:00:00.000,ATP World Tour Masters 1000 Paris France ATP World Tour Masters 1000,HARD,2,John Isner,N/A Bye,John Isner,,R64,0,0,0,0,0,0,0,0,0,0,0,0,0,0,0,0,0,0,0,0,0,0,0,0,0,0,0
2010-11-07 00:00:00.000,ATP World Tour Masters 1000 Paris France ATP World Tour Masters 1000,HARD,2,Michael Llodra,Potito Starace,Michael Llodra,6-4; 6-1,R64,67,7,5,27,55,23,27,15,28,3,4,9,38,55,2,1,28,47,16,28,8,19,2,6,8,24,47
2010-11-07 00:00:00.000,ATP World Tour Masters 1000 Paris France ATP World Tour Masters 1000,HARD,2,Juan Monaco,Sam Querrey,Juan Monaco,7-6(7); 6-2,R64,85,6,1,53,74,41,53,12,21,3,3,10,53,74,11,2,46,68,33,46,9,22,4,6,10,42,68
2010-11-07 00:00:00.000,ATP World Tour Masters 1000 Paris France ATP World Tour Masters 1000,HARD,2,Novak Djokovic,N/A Bye,Novak Djokovic,,R64,0,0,0,0,0,0,0,0,0,0,0,0,0,0,0,0,0,0,0,0,0,0,0,0,0,0,0
2010-11-07 00:00:00.000,ATP World Tour Masters 1000 Paris France ATP World Tour Masters 1000,HARD,2,Roger Federer,Richard Gasquet,Roger Federer,6-4; 6-4,R32,69,7,0,26,50,23,26,17,24,0,0,10,40,50,5,1,47,65,30,47,11,18,3,5,10,41,65
2010-11-07 00:00:00.000,ATP World Tour Masters 1000 Paris France ATP World Tour Masters 1000,HARD,2,Radek Stepanek,Nicolas Almagro,Radek Stepanek,7-6(3); 6-4,R32,82,5,1,45,67,35,45,17,22,2,2,11,52,67,14,1,37,61,33,37,12,24,2,3,11,45,61
2010-11-07 00:00:00.000,ATP World Tour Masters 1000 Paris France ATP World Tour Masters 1000,HARD,2,Jurgen Melzer,Santiago Giraldo,Jurgen Melzer,6-3; 7-6(6),R32,97,4,2,37,72,27,37,23,35,1,2,11,50,72,8,2,44,88,27,44,25,44,9,11,10,52,88
2010-11-07 00:00:00.000,ATP World Tour Masters 1000 Paris France ATP World Tour Masters 1000,HARD,2,David Ferrer,Fabio Fognini,David Ferrer,3-6; 6-4; 7-6(4),R32,144,5,4,69,109,45,69,22,40,7,10,15,67,109,4,7,73,119,53,73,21,46,9,12,16,74,119
2010-11-07 00:00:00.000,ATP World Tour Masters 1000 Paris France ATP World Tour Masters 1000,HARD,2,Andy Murray,David Nalbandian,Andy Murray,2-6; 6-4; 6-3,R32,114,18,4,40,75,33,40,20,35,2,4,14,53,75,6,1,47,70,38,47,11,23,2,4,13,49,70
2010-11-07 00:00:00.000,ATP World Tour Masters 1000 Paris France ATP World Tour Masters 1000,HARD,2,Marin Cilic,Sergiy Stakhovsky,Marin Cilic,6-4; 4-6; 6-3,R32,112,9,2,53,91,41,53,18,38,8,10,14,59,91,10,4,49,83,37,49,17,34,4,8,15,54,83
2010-11-07 00:00:00.000,ATP World Tour Masters 1000 Paris France ATP World Tour Masters 1000,HARD,2,Gael Monfils,Benjamin Becker,Gael Monfils,7-6(4); 6-4,R32,110,10,0,43,76,26,43,19,33,6,9,11,45,76,5,5,48,89,29,48,20,41,3,7,11,49,89
2010-11-07 00:00:00.000,ATP World Tour Masters 1000 Paris France ATP World Tour Masters 1000,HARD,2,Fernando Verdasco,Arnaud Clement,Fernando Verdasco,3-6; 6-3; 6-0,R32,110,11,9,46,83,32,46,19,37,2,5,12,51,83,5,4,33,74,25,33,15,41,4,10,12,40,74
2010-11-07 00:00:00.000,ATP World Tour Masters 1000 Paris France ATP World Tour Masters 1000,HARD,2,Andy Roddick,Jarkko Nieminen,Andy Roddick,6-1; 6-4,R32,62,9,0,29,46,24,29,13,17,0,0,9,37,46,4,4,31,52,24,31,5,21,3,6,8,29,52
2010-11-07 00:00:00.000,ATP World Tour Masters 1000 Paris France ATP World Tour Masters 1000,HARD,2,Ernests Gulbis,Mikhail Youzhny,Ernests Gulbis,6-4; 3-0 RET,R32,57,7,1,20,36,18,20,9,16,3,3,6,27,36,4,2,22,49,17,22,8,27,6,9,7,25,49
2010-11-07 00:00:00.000,ATP World Tour Masters 1000 Paris France ATP World Tour Masters 1000,HARD,2,Stanislas Wawrinka,Ivan Ljubicic,Stanislas Wawrinka,6-4; 6-4,R32,86,11,0,33,53,27,33,14,20,1,1,10,41,53,9,6,47,77,34,47,11,30,5,7,10,45,77
2010-11-07 00:00:00.000,ATP World Tour Masters 1000 Paris France ATP World Tour Masters 1000,HARD,2,Robin Soderling,Gilles Simon,Robin Soderling,6-4; 6-0,R32,63,11,3,29,52,26,29,9,23,4,4,8,35,52,3,1,22,45,14,22,9,23,1,5,8,23,45
2010-11-07 00:00:00.000,ATP World Tour Masters 1000 Paris France ATP World Tour Masters 1000,HARD,2,Tomas Berdych,Florent Serra,Tomas Berdych,6-3; 6-1,R32,47,7,0,19,33,18,19,14,14,0,0,8,32,33,5,3,31,47,17,31,7,16,1,5,8,24,47
2010-11-07 00:00:00.000,ATP World Tour Masters 1000 Paris France ATP World Tour Masters 1000,HARD,2,Nikolay Davydenko,Thomaz Bellucci,Nikolay Davydenko,6-3; 6-0,R32,56,1,0,28,41,24,28,8,13,0,0,8,32,41,4,1,25,47,17,25,7,22,7,11,7,24,47
2010-11-07 00:00:00.000,ATP World Tour Masters 1000 Paris France ATP World Tour Masters 1000,HARD,2,Michael Llodra,John Isner,Michael Llodra,6-3; 6-4,R32,60,14,3,30,50,28,30,12,20,0,0,10,40,50,4,0,28,49,20,28,13,21,2,4,9,33,49
2010-11-07 00:00:00.000,ATP World Tour Masters 1000 Paris France ATP World Tour Masters 1000,HARD,2,Novak Djokovic,Juan Monaco,Novak Djokovic,6-4; 6-3,R32,84,8,2,37,67,27,37,17,30,7,8,10,44,67,1,3,33,46,21,33,7,13,1,4,9,28,46
2010-11-07 00:00:00.000,ATP World Tour Masters 1000 Paris France ATP World Tour Masters 1000,HARD,2,Roger Federer,Radek Stepanek,Roger Federer,6-4; 6-3,R16,79,11,0,39,57,30,39,13,18,2,2,10,43,57,4,2,45,68,30,45,10,23,2,4,9,40,68
2010-11-07 00:00:00.000,ATP World Tour Masters 1000 Paris France ATP World Tour Masters 1000,HARD,2,Jurgen Melzer,David Ferrer,Jurgen Melzer,7-6(6); 2-6; 6-3,R16,130,4,6,60,101,42,60,15,41,10,15,15,57,101,7,1,73,108,46,73,17,35,8,12,14,63,108
2010-11-07 00:00:00.000,ATP World Tour Masters 1000 Paris France ATP World Tour Masters 1000,HARD,2,Andy Murray,Marin Cilic,Andy Murray,7-6(6); 3-6; 6-3,R16,127,11,5,58,96,43,58,24,38,4,6,15,67,96,14,3,58,86,46,58,14,28,5,7,15,60,86
2010-11-07 00:00:00.000,ATP World Tour Masters 1000 Paris France ATP World Tour Masters 1000,HARD,2,Gael Monfils,Fernando Verdasco,Gael Monfils,6-7(4); 7-6(2); 7-5,R16,165,10,3,72,118,56,72,24,46,3,5,18,80,118,3,9,82,129,59,82,24,47,9,12,18,83,129
2010-11-07 00:00:00.000,ATP World Tour Masters 1000 Paris France ATP World Tour Masters 1000,HARD,2,Andy Roddick,Ernests Gulbis,Andy Roddick,6-3; 7-6(8),R16,93,12,0,53,67,42,53,10,14,1,1,11,52,67,9,4,48,71,37,48,10,23,2,3,10,47,71
2010-11-07 00:00:00.000,ATP World Tour Masters 1000 Paris France ATP World Tour Masters 1000,HARD,2,Robin Soderling,Stanislas Wawrinka,Robin Soderling,7-6(3); 6-3,R16,89,7,0,40,61,30,40,11,21,1,3,10,41,61,10,3,32,66,25,32,12,34,4,8,11,37,66
2010-11-07 00:00:00.000,ATP World Tour Masters 1000 Paris France ATP World Tour Masters 1000,HARD,2,Nikolay Davydenko,Tomas Berdych,Nikolay Davydenko,4-6; 7-6(5); 6-0,R16,136,11,5,66,99,48,66,18,33,6,7,14,66,99,10,3,43,84,35,43,18,41,5,8,14,53,84
2010-11-07 00:00:00.000,ATP World Tour Masters 1000 Paris France ATP World Tour Masters 1000,HARD,2,Michael Llodra,Novak Djokovic,Michael Llodra,7-6(6); 6-2,R16,93,6,4,41,70,37,41,13,29,3,3,10,50,70,4,3,46,64,34,46,8,18,2,4,10,42,64
2010-11-07 00:00:00.000,ATP World Tour Masters 1000 Paris France ATP World Tour Masters 1000,HARD,2,Roger Federer,Jurgen Melzer,Roger Federer,6-1; 7-6(4),Q,70,18,2,38,55,35,38,9,17,0,0,10,44,55,3,0,34,61,25,34,13,27,4,6,9,38,61
2010-11-07 00:00:00.000,ATP World Tour Masters 1000 Paris France ATP World Tour Masters 1000,HARD,2,Gael Monfils,Andy Murray,Gael Monfils,6-2; 2-6; 6-3,Q,108,6,0,47,68,36,47,10,21,3,5,12,46,68,3,4,42,83,33,42,17,41,7,11,13,50,83
2010-11-07 00:00:00.000,ATP World Tour Masters 1000 Paris France ATP World Tour Masters 1000,HARD,2,Robin Soderling,Andy Roddick,Robin Soderling,7-5; 6-4,Q,87,18,3,38,64,34,38,15,26,2,2,11,49,64,15,2,53,75,39,53,8,22,6,8,11,47,75
2010-11-07 00:00:00.000,ATP World Tour Masters 1000 Paris France ATP World Tour Masters 1000,HARD,2,Michael Llodra,Nikolay Davydenko,Michael Llodra,7-5; 6-1,Q,75,9,5,23,53,21,23,18,30,3,4,10,39,53,1,3,25,48,14,25,12,23,1,5,9,26,48
2010-11-07 00:00:00.000,ATP World Tour Masters 1000 Paris France ATP World Tour Masters 1000,HARD,2,Gael Monfils,Roger Federer,Gael Monfils,7-6(7); 6-7(1); 7-6(4),S,161,15,5,74,124,60,74,29,50,6,7,18,89,124,18,1,76,122,65,76,25,46,3,4,18,90,122
2010-11-07 00:00:00.000,ATP World Tour Masters 1000 Paris France ATP World Tour Masters 1000,HARD,2,Robin Soderling,Michael Llodra,Robin Soderling,6-7(0); 7-5; 7-6(6),S,169,19,5,80,137,60,80,32,57,5,6,18,92,137,24,7,65,109,57,65,22,44,2,4,18,79,109
2010-11-07 00:00:00.000,ATP World Tour Masters 1000 Paris France ATP World Tour Masters 1000,HARD,2,Robin Soderling,Gael Monfils,Robin Soderling,6-1; 7-6(1),F,77,9,4,34,58,30,34,15,24,0,0,10,45,58,8,2,30,54,21,30,12,24,1,3,9,33,54
2011-01-02 00:00:00.000,Brisbane Australia ATP World Tour 250,HARD,2,Robin Soderling,Ryan Harrison,Robin Soderling,6-2; 6-4,R32,66,8,3,32,52,26,32,13,20,1,1,9,39,52,4,1,27,50,16,27,12,23,1,4,9,28,50
2011-01-02 00:00:00.000,Brisbane Australia ATP World Tour 250,HARD,2,Michael Berrer,Dudi Sela,Michael Berrer,1-6; 7-6(3); 6-2,R32,152,9,3,54,99,34,54,28,45,8,10,13,62,99,16,4,59,103,42,59,20,44,3,5,14,62,103
2011-01-02 00:00:00.000,Brisbane Australia ATP World Tour 250,HARD,2,Matthew Ebden,John Millman,Matthew Ebden,4-6; 6-2; 6-4,R32,104,12,1,63,85,46,63,9,22,1,3,14,55,85,4,3,58,76,42,58,6,18,4,8,14,48,76
2011-01-02 00:00:00.000,Brisbane Australia ATP World Tour 250,HARD,2,Denis Istomin,Thiemo de Bakker,Denis Istomin,7-6(5); 6-4,R32,93,6,1,43,63,33,43,16,20,2,2,11,49,63,10,1,43,72,31,43,17,29,2,3,11,48,72
2011-01-02 00:00:00.000,Brisbane Australia ATP World Tour 250,HARD,2,Mardy Fish,Adrian Mannarino,Mardy Fish,6-1; 6-4,R32,79,11,0,28,51,23,28,16,23,1,1,9,39,51,1,6,37,68,24,37,11,31,3,6,8,35,68
2011-01-02 00:00:00.000,Brisbane Australia ATP World Tour 250,HARD,2,Radek Stepanek,Tobias Kamke,Radek Stepanek,5-7; 6-1; 6-4,R32,124,7,3,47,80,37,47,16,33,2,5,15,53,80,4,7,50,87,33,50,19,37,5,10,14,52,87
2011-01-02 00:00:00.000,Brisbane Australia ATP World Tour 250,HARD,2,Ricardas Berankis,Arnaud Clement,Ricardas Berankis,6-4; 6-3,R32,86,8,2,30,55,24,30,13,25,1,2,9,37,55,6,3,37,64,26,37,11,27,5,9,10,37,64
2011-01-02 00:00:00.000,Brisbane Australia ATP World Tour 250,HARD,2,Florian Mayer,Bernard Tomic,Florian Mayer,6-2; 6-2,R32,55,12,0,25,35,23,25,9,10,0,0,8,32,35,5,0,34,58,22,34,6,24,1,5,8,28,58
2011-01-02 00:00:00.000,Brisbane Australia ATP World Tour 250,HARD,2,Feliciano Lopez,Philipp Petzschner,Feliciano Lopez,6-4; 7-6(11),R32,100,11,7,39,77,33,39,21,38,4,5,11,54,77,9,5,30,68,25,30,22,38,0,2,11,47,68
2011-01-02 00:00:00.000,Brisbane Australia ATP World Tour 250,HARD,2,Kevin Anderson,Peter Luczak,Kevin Anderson,6-4; 6-4,R32,72,18,0,33,44,31,33,9,11,0,0,10,40,44,4,2,41,58,28,41,10,17,1,3,10,38,58
2011-01-02 00:00:00.000,Brisbane Australia ATP World Tour 250,HARD,2,Santiago Giraldo,Gilles Simon,Santiago Giraldo,6-2; 6-3,R32,86,2,0,57,74,37,57,9,17,5,5,8,46,74,5,2,30,53,22,30,8,23,1,5,9,30,53
2011-01-02 00:00:00.000,Brisbane Australia ATP World Tour 250,HARD,2,Benjamin Becker,Fernando Verdasco,Benjamin Becker,6-1; 6-7(2); 6-3,R32,133,6,4,53,99,42,53,23,46,6,7,15,65,99,10,5,47,78,34,47,14,31,1,5,13,48,78
2011-01-02 00:00:00.000,Brisbane Australia ATP World Tour 250,HARD,2,Marcos Baghdatis,Florent Serra,Marcos Baghdatis,3-6; 7-5; 6-4,R32,142,13,2,46,91,35,46,22,45,3,6,15,57,91,7,2,62,103,44,62,19,41,4,8,16,63,103
2011-01-02 00:00:00.000,Brisbane Australia ATP World Tour 250,HARD,2,Lukasz Kubot,Daniel Brands,Lukasz Kubot,6-2; 6-2,R32,70,7,1,31,51,24,31,13,20,6,6,8,37,51,6,4,29,45,16,29,7,16,1,5,8,23,45
2011-01-02 00:00:00.000,Brisbane Australia ATP World Tour 250,HARD,2,Alexandr Dolgopolov,Igor Andreev,Alexandr Dolgopolov,6-4; 6-2,R32,67,7,3,29,55,26,29,14,26,1,1,9,40,55,2,1,34,55,22,34,9,21,5,8,9,31,55
2011-01-02 00:00:00.000,Brisbane Australia ATP World Tour 250,HARD,2,Andy Roddick,Marinko Matosevic,Andy Roddick,6-3; 6-2,R32,73,5,1,29,47,23,29,13,18,3,4,9,36,47,2,0,22,48,12,22,12,26,2,6,8,24,48
2011-01-02 00:00:00.000,Brisbane Australia ATP World Tour 250,HARD,2,Robin Soderling,Michael Berrer,Robin Soderling,6-3; 7-6(7),R16,96,9,1,51,74,40,51,13,23,2,2,11,53,74,8,1,43,68,32,43,14,25,2,3,10,46,68
2011-01-02 00:00:00.000,Brisbane Australia ATP World Tour 250,HARD,2,Matthew Ebden,Denis Istomin,Matthew Ebden,6-4; 6-4,R16,73,5,1,45,62,32,45,7,17,0,2,10,39,62,1,7,30,56,18,30,14,26,1,5,10,32,56
2011-01-02 00:00:00.000,Brisbane Australia ATP World Tour 250,HARD,2,Radek Stepanek,Mardy Fish,Radek Stepanek,6-3; 6-1,R16,78,3,2,32,45,28,32,6,13,3,3,8,34,45,9,2,40,60,23,40,6,20,6,10,8,29,60
2011-01-02 00:00:00.000,Brisbane Australia ATP World Tour 250,HARD,2,Florian Mayer,Ricardas Berankis,Florian Mayer,6-4; 4-6; 6-4,R16,131,4,1,52,83,33,52,15,31,3,9,15,48,83,6,6,56,109,38,56,20,53,15,22,15,58,109
2011-01-02 00:00:00.000,Brisbane Australia ATP World Tour 250,HARD,2,Kevin Anderson,Feliciano Lopez,Kevin Anderson,6-3; 6-1,R16,56,15,1,27,38,24,27,8,11,0,0,8,32,38,6,0,38,53,22,38,6,15,5,9,8,28,53
2011-01-02 00:00:00.000,Brisbane Australia ATP World Tour 250,HARD,2,Santiago Giraldo,Benjamin Becker,Santiago Giraldo,6-3; 6-4,R16,78,2,0,52,73,36,52,13,21,6,6,10,49,73,7,0,26,43,21,26,10,17,0,2,9,31,43
2011-01-02 00:00:00.000,Brisbane Australia ATP World Tour 250,HARD,2,Marcos Baghdatis,Lukasz Kubot,Marcos Baghdatis,6-2; 6-2,R16,65,5,1,26,47,19,26,12,21,3,4,8,31,47,0,4,26,49,13,26,8,23,4,9,8,21,49
2011-01-02 00:00:00.000,Brisbane Australia ATP World Tour 250,HARD,2,Andy Roddick,Alexandr Dolgopolov,Andy Roddick,6-4; 6-1,R16,57,15,1,30,42,26,30,8,12,2,3,9,34,42,7,3,33,56,21,33,9,23,7,11,8,30,56
2011-01-02 00:00:00.000,Brisbane Australia ATP World Tour 250,HARD,2,Robin Soderling,Matthew Ebden,Robin Soderling,6-3; 6-2,Q,72,9,3,39,55,30,39,7,16,0,0,9,37,55,5,3,39,60,25,39,9,21,3,6,8,34,60
2011-01-02 00:00:00.000,Brisbane Australia ATP World Tour 250,HARD,2,Radek Stepanek,Florian Mayer,Radek Stepanek,6-3; 6-3,Q,83,3,0,24,50,20,24,16,26,1,2,9,36,50,1,2,43,71,27,43,11,28,9,13,9,38,71
2011-01-02 00:00:00.000,Brisbane Australia ATP World Tour 250,HARD,2,Kevin Anderson,Santiago Giraldo,Kevin Anderson,2-6; 6-3; 6-4,Q,114,12,3,54,82,41,54,10,28,6,10,14,51,82,3,1,46,70,34,46,11,24,3,7,13,45,70
2011-01-02 00:00:00.000,Brisbane Australia ATP World Tour 250,HARD,2,Andy Roddick,Marcos Baghdatis,Andy Roddick,6-2; 6-3,Q,74,7,0,31,48,24,31,10,17,3,4,9,34,48,3,0,19,49,15,19,10,30,4,8,8,25,49
2011-01-02 00:00:00.000,Brisbane Australia ATP World Tour 250,HARD,2,Robin Soderling,Radek Stepanek,Robin Soderling,6-3; 7-5,S,82,7,1,36,55,31,36,12,19,0,1,11,43,55,9,3,39,64,27,39,9,25,2,5,10,36,64
2011-01-02 00:00:00.000,Brisbane Australia ATP World Tour 250,HARD,2,Andy Roddick,Kevin Anderson,Andy Roddick,6-2; 4-6; 6-2,S,113,15,1,47,70,41,47,9,23,0,1,13,50,70,13,4,53,82,33,53,16,29,5,9,13,49,82
2011-01-02 00:00:00.000,Brisbane Australia ATP World Tour 250,HARD,2,Robin Soderling,Andy Roddick,Robin Soderling,6-3; 7-5,F,95,16,2,39,54,35,39,9,15,0,0,11,44,54,12,1,44,67,33,44,9,23,8,10,10,42,67
2011-01-03 00:00:00.000,Chennai India ATP World Tour 250,HARD,2,Tomas Berdych,Frederico Gil,Tomas Berdych,6-0; 6-1,R32,45,4,1,22,32,20,22,8,10,0,0,7,28,32,0,1,25,33,10,25,0,8,1,6,6,10,33
2011-01-03 00:00:00.000,Chennai India ATP World Tour 250,HARD,2,Ivan Dodig,Marcos Daniel,Ivan Dodig,6-2; 6-2,R32,70,1,1,26,44,21,26,12,18,0,0,8,33,44,0,3,24,48,15,24,9,24,1,5,8,24,48
2011-01-03 00:00:00.000,Chennai India ATP World Tour 250,HARD,2,Robert Kendrick,Denis Gremelmayr,Robert Kendrick,7-6(1); 6-4,R32,78,12,6,50,72,38,50,12,22,1,2,11,50,72,5,0,46,69,29,46,14,23,4,6,11,43,69
2011-01-03 00:00:00.000,Chennai India ATP World Tour 250,HARD,2,Blaz Kavcic,Jeremy Chardy,Blaz Kavcic,6-3; 6-2,R32,70,1,0,34,45,20,34,9,11,2,4,8,29,45,3,2,30,53,14,30,9,23,2,8,9,23,53
2011-01-03 00:00:00.000,Chennai India ATP World Tour 250,HARD,2,Stanislas Wawrinka,Rohan Bopanna,Stanislas Wawrinka,6-4; 6-4,R32,67,8,5,35,56,28,35,13,21,2,2,10,41,56,7,3,32,60,24,32,13,28,3,5,10,37,60
2011-01-03 00:00:00.000,Chennai India ATP World Tour 250,HARD,2,David Goffin,Somdev Devvarman,David Goffin,6-2; 6-4,R32,86,2,1,39,60,27,39,15,21,3,3,9,42,60,2,1,34,54,21,34,10,20,2,5,9,31,54
2011-01-03 00:00:00.000,Chennai India ATP World Tour 250,HARD,2,Yuichi Sugita,Dustin Brown,Yuichi Sugita,6-4; 2-6; 6-2,R32,89,2,2,48,71,36,48,10,23,1,4,13,46,71,13,3,35,81,23,35,25,46,6,10,13,48,81
2011-01-03 00:00:00.000,Chennai India ATP World Tour 250,HARD,2,Robin Haase,Frank Dancevic,Robin Haase,6-7(6); 6-4; 6-4,R32,145,7,3,68,109,47,68,26,41,6,8,16,73,109,14,2,70,120,47,70,26,50,6,10,16,73,120
2011-01-03 00:00:00.000,Chennai India ATP World Tour 250,HARD,2,Xavier Malisse,Marsel Ilhan,Xavier Malisse,6-3; 6-1,R32,71,4,0,19,38,15,19,12,19,0,2,8,27,38,2,4,34,61,18,34,9,27,8,14,8,27,61
2011-01-03 00:00:00.000,Chennai India ATP World Tour 250,HARD,2,Stephane Robert,Andreas Haider-Maurer,Stephane Robert,6-4; 6-4,R32,71,0,0,26,54,20,26,20,28,3,4,10,40,54,2,7,20,54,16,20,17,34,1,4,10,33,54
2011-01-03 00:00:00.000,Chennai India ATP World Tour 250,HARD,2,Bjorn Phau,Simone Bolelli,Bjorn Phau,6-2; 6-2,R32,74,2,1,24,42,21,24,10,18,1,2,8,31,42,1,0,40,57,21,40,6,17,4,9,8,27,57
2011-01-03 00:00:00.000,Chennai India ATP World Tour 250,HARD,2,Richard Gasquet,Edouard Roger-Vasselin,Richard Gasquet,6-1; 6-3,R32,73,1,0,33,47,27,33,7,14,0,0,8,34,47,3,3,34,58,19,34,10,24,4,8,8,29,58
2011-01-03 00:00:00.000,Chennai India ATP World Tour 250,HARD,2,Janko Tipsarevic,Eduardo Schwank,Janko Tipsarevic,6-3; 6-4,R32,80,9,2,29,53,27,29,14,24,3,3,10,41,53,0,2,34,54,23,34,11,20,2,4,9,34,54
2011-01-03 00:00:00.000,Chennai India ATP World Tour 250,HARD,2,Alexander Kudryavtsev,Yuki Bhambri,Alexander Kudryavtsev,6-2; 6-1,R32,50,4,1,17,36,16,17,10,19,0,1,7,26,36,2,3,24,43,11,24,7,19,4,10,8,18,43
2011-01-03 00:00:00.000,Chennai India ATP World Tour 250,HARD,2,Alejandro Falla,Rui Machado,Alejandro Falla,7-5; 6-3,R32,100,3,3,38,64,25,38,15,26,4,6,10,40,64,1,4,41,70,26,41,11,29,2,7,11,37,70
2011-01-03 00:00:00.000,Chennai India ATP World Tour 250,HARD,2,Kei Nishikori,Marin Cilic,Kei Nishikori,4-6; 7-6(0); 6-2,R32,154,1,2,66,106,51,66,22,40,10,11,15,73,106,5,4,49,92,37,49,23,43,3,5,15,60,92
2011-01-03 00:00:00.000,Chennai India ATP World Tour 250,HARD,2,Tomas Berdych,Ivan Dodig,Tomas Berdych,6-2; 6-4,R16,87,1,1,31,49,23,31,11,18,1,2,9,34,49,6,4,30,57,17,30,12,27,3,7,9,29,57
2011-01-03 00:00:00.000,Chennai India ATP World Tour 250,HARD,2,Blaz Kavcic,Robert Kendrick,Blaz Kavcic,6-2; 6-2,R16,57,4,2,31,43,27,31,6,12,0,0,8,33,43,4,1,23,44,12,23,10,21,1,5,8,22,44
2011-01-03 00:00:00.000,Chennai India ATP World Tour 250,HARD,2,Stanislas Wawrinka,David Goffin,Stanislas Wawrinka,7-6(3); 7-6(3),R16,116,7,2,50,86,35,50,21,36,4,6,12,56,86,5,3,64,91,41,64,15,27,5,7,12,56,91
2011-01-03 00:00:00.000,Chennai India ATP World Tour 250,HARD,2,Robin Haase,Yuichi Sugita,Robin Haase,4-6; 6-3; 6-4,R16,114,10,2,56,91,38,56,20,35,5,8,15,58,91,2,2,47,82,35,47,14,35,2,6,14,49,82
2011-01-03 00:00:00.000,Chennai India ATP World Tour 250,HARD,2,Xavier Malisse,Stephane Robert,Xavier Malisse,6-2; 6-2,R16,58,3,1,26,43,24,26,10,17,0,0,8,34,43,0,3,25,45,18,25,6,20,1,5,8,24,45
2011-01-03 00:00:00.000,Chennai India ATP World Tour 250,HARD,2,Bjorn Phau,Richard Gasquet,Bjorn Phau,1-6; 7-6(5); 7-6(4),R16,151,4,3,63,104,41,63,19,41,8,14,15,60,104,8,6,71,111,51,71,15,40,2,6,16,66,111
2011-01-03 00:00:00.000,Chennai India ATP World Tour 250,HARD,2,Janko Tipsarevic,Alexander Kudryavtsev,Janko Tipsarevic,6-2; 7-6(3),R16,82,7,0,31,56,27,31,19,25,0,0,10,46,56,5,0,47,73,33,47,11,26,3,5,10,44,73
2011-01-03 00:00:00.000,Chennai India ATP World Tour 250,HARD,2,Kei Nishikori,Alejandro Falla,Kei Nishikori,4-6; 6-3; 6-2,R16,129,4,5,53,82,34,53,17,29,4,8,14,51,82,1,5,68,100,38,68,14,32,14,20,13,52,100
2011-01-03 00:00:00.000,Chennai India ATP World Tour 250,HARD,2,Tomas Berdych,Blaz Kavcic,Tomas Berdych,6-3; 6-3,Q,85,3,1,41,59,28,41,6,18,4,6,9,34,59,2,9,34,56,22,34,5,22,4,9,9,27,56
2011-01-03 00:00:00.000,Chennai India ATP World Tour 250,HARD,2,Stanislas Wawrinka,Robin Haase,Stanislas Wawrinka,3-6; 6-3; 6-3,Q,115,7,1,56,82,40,56,14,26,4,6,14,54,82,4,2,59,95,38,59,18,36,11,14,13,56,95
2011-01-03 00:00:00.000,Chennai India ATP World Tour 250,HARD,2,Xavier Malisse,Bjorn Phau,Xavier Malisse,6-0; 6-2,Q,72,5,0,33,53,25,33,12,20,7,7,7,37,53,0,4,32,50,17,32,4,18,1,6,7,21,50
2011-01-03 00:00:00.000,Chennai India ATP World Tour 250,HARD,2,Janko Tipsarevic,Kei Nishikori,Janko Tipsarevic,6-4; 6-4,Q,103,5,0,45,63,29,45,15,18,4,5,10,44,63,1,1,45,68,26,45,14,23,3,6,10,40,68
2011-01-03 00:00:00.000,Chennai India ATP World Tour 250,HARD,2,Stanislas Wawrinka,Tomas Berdych,Stanislas Wawrinka,6-4; 6-1,S,76,7,1,33,50,22,33,12,17,1,1,8,34,50,4,2,34,51,22,34,7,17,1,5,9,29,51
2011-01-03 00:00:00.000,Chennai India ATP World Tour 250,HARD,2,Xavier Malisse,Janko Tipsarevic,Xavier Malisse,3-6; 6-3; 6-2,S,98,8,0,42,63,36,42,11,21,0,2,13,47,63,11,1,49,77,39,49,9,28,4,8,13,48,77
2011-01-03 00:00:00.000,Chennai India ATP World Tour 250,HARD,2,Stanislas Wawrinka,Xavier Malisse,Stanislas Wawrinka,7-5; 4-6; 6-1,F,134,5,0,54,90,40,54,22,36,3,5,15,62,90,1,2,44,83,32,44,21,39,4,8,14,53,83
2011-01-03 00:00:00.000,Doha Qatar ATP World Tour 250,HARD,2,Rafael Nadal,Karol Beck,Rafael Nadal,6-3; 6-0,R32,70,1,2,33,47,26,33,7,14,4,5,8,33,47,4,4,30,53,16,30,6,23,9,14,7,22,53
2011-01-03 00:00:00.000,Doha Qatar ATP World Tour 250,HARD,2,Lukas Lacko,Pere Riba,Lukas Lacko,5-7; 7-6(7); 7-6(4),R32,157,12,4,69,123,54,69,32,54,5,7,18,86,123,19,7,73,134,58,73,31,61,4,5,18,89,134
2011-01-03 00:00:00.000,Doha Qatar ATP World Tour 250,HARD,2,Antonio Veic,Sherif Sabry,Antonio Veic,3-6; 7-5; 6-0,R32,125,1,2,54,81,38,54,11,27,5,9,13,49,81,1,1,47,90,28,47,21,43,5,12,14,49,90
2011-01-03 00:00:00.000,Doha Qatar ATP World Tour 250,HARD,2,Ernests Gulbis,Victor Hanescu,Ernests Gulbis,6-3; 7-6(6),R32,91,11,2,41,63,31,41,13,22,0,2,11,44,63,6,0,51,67,33,51,8,16,1,4,10,41,67
2011-01-03 00:00:00.000,Doha Qatar ATP World Tour 250,HARD,2,Nikolay Davydenko,Fabio Fognini,Nikolay Davydenko,6-1; 6-4,R32,64,6,1,29,46,24,29,12,17,0,0,9,36,46,2,1,31,47,18,31,8,16,2,5,8,26,47
2011-01-03 00:00:00.000,Doha Qatar ATP World Tour 250,HARD,2,Jarkko Nieminen,Michal Przysiezny,Jarkko Nieminen,6-2; 3-6; 6-3,R32,123,7,2,37,63,31,37,18,26,1,2,13,49,63,7,1,72,110,47,72,15,38,11,14,13,62,110
2011-01-03 00:00:00.000,Doha Qatar ATP World Tour 250,HARD,2,Ivo Karlovic,Lukas Rosol,Ivo Karlovic,7-6(5); 7-6(7),R32,113,23,1,65,90,54,65,11,25,7,7,12,65,90,10,2,51,91,40,51,25,40,5,5,12,65,91
2011-01-03 00:00:00.000,Doha Qatar ATP World Tour 250,HARD,2,Philipp Kohlschreiber,Andreas Seppi,Philipp Kohlschreiber,6-2; 6-4,R32,78,3,2,33,55,24,33,16,22,2,2,9,40,55,4,2,32,57,20,32,15,25,2,5,9,35,57
2011-01-03 00:00:00.000,Doha Qatar ATP World Tour 250,HARD,2,Guillermo Garcia-Lopez,Mikhail Kukushkin,Guillermo Garcia-Lopez,6-1; 7-6(1),R32,90,0,3,37,73,25,37,20,36,4,6,10,45,73,3,1,34,56,19,34,9,22,0,4,9,28,56
2011-01-03 00:00:00.000,Doha Qatar ATP World Tour 250,HARD,2,Illya Marchenko,Mischa Zverev,Illya Marchenko,7-6(4); 6-4,R32,113,1,5,49,83,34,49,18,34,4,6,11,52,83,3,1,49,77,28,49,16,28,8,11,11,44,77
2011-01-03 00:00:00.000,Doha Qatar ATP World Tour 250,HARD,2,Sergei Bubka,Daniel Gimeno-Traver,Sergei Bubka,6-0; 6-3,R32,54,10,0,32,43,26,32,7,11,0,0,8,33,43,1,1,27,45,17,27,5,18,2,6,7,22,45
2011-01-03 00:00:00.000,Doha Qatar ATP World Tour 250,HARD,2,Jo-Wilfried Tsonga,Ruben Ramirez Hidalgo,Jo-Wilfried Tsonga,6-2; 6-0,R32,59,10,1,25,36,23,25,5,11,0,0,7,28,36,2,1,27,45,13,27,7,18,4,9,7,20,45
2011-01-03 00:00:00.000,Doha Qatar ATP World Tour 250,HARD,2,Viktor Troicki,Sergiy Stakhovsky,Viktor Troicki,6-4; 7-5,R32,78,5,0,34,54,27,34,17,20,0,0,11,44,54,1,0,41,58,27,41,12,17,1,3,11,39,58
2011-01-03 00:00:00.000,Doha Qatar ATP World Tour 250,HARD,2,Teymuraz Gabashvili,Rainer Schuettler,Teymuraz Gabashvili,6-4; 7-6(2),R32,115,3,1,45,81,32,45,21,36,4,5,11,53,81,6,0,50,74,31,50,13,24,7,9,11,44,74
2011-01-03 00:00:00.000,Doha Qatar ATP World Tour 250,HARD,2,Marco Chiudinelli,Reda El Amrani,Marco Chiudinelli,3-6; 7-6(3); 6-3,R32,133,5,1,69,101,49,69,22,32,6,8,16,71,101,14,5,54,92,40,54,20,38,10,11,14,60,92
2011-01-03 00:00:00.000,Doha Qatar ATP World Tour 250,HARD,2,Roger Federer,Thomas Schoorel,Roger Federer,7-6(3); 6-3,R32,79,13,0,46,70,37,46,16,24,6,6,11,53,70,4,2,43,66,30,43,12,23,1,2,10,42,66
2011-01-03 00:00:00.000,Doha Qatar ATP World Tour 250,HARD,2,Rafael Nadal,Lukas Lacko,Rafael Nadal,7-6(3); 0-6; 6-3,R16,138,9,4,60,93,38,60,13,33,9,14,13,51,93,8,3,56,91,36,56,16,35,5,9,14,52,91
2011-01-03 00:00:00.000,Doha Qatar ATP World Tour 250,HARD,2,Ernests Gulbis,Antonio Veic,Ernests Gulbis,6-3; 6-1,R16,49,10,1,31,38,28,31,5,7,0,0,8,33,38,4,3,30,51,19,30,7,21,5,9,8,26,51
2011-01-03 00:00:00.000,Doha Qatar ATP World Tour 250,HARD,2,Nikolay Davydenko,Jarkko Nieminen,Nikolay Davydenko,6-4; 7-5,R16,95,4,5,45,76,33,45,13,31,5,7,11,46,76,4,2,37,63,25,37,9,26,4,8,11,34,63
2011-01-03 00:00:00.000,Doha Qatar ATP World Tour 250,HARD,2,Ivo Karlovic,Philipp Kohlschreiber,Ivo Karlovic,7-6(5); 6-7(4); 7-6(2),R16,169,28,2,85,128,68,85,26,43,3,3,18,94,128,15,2,78,113,63,78,22,35,0,0,18,85,113
2011-01-03 00:00:00.000,Doha Qatar ATP World Tour 250,HARD,2,Guillermo Garcia-Lopez,Illya Marchenko,Guillermo Garcia-Lopez,6-1; 6-4,R16,83,4,2,37,54,31,37,8,17,1,1,9,39,54,5,4,26,51,17,26,11,25,1,4,8,28,51
2011-01-03 00:00:00.000,Doha Qatar ATP World Tour 250,HARD,2,Jo-Wilfried Tsonga,Sergei Bubka,Jo-Wilfried Tsonga,6-2; 6-4,R16,75,10,2,35,48,31,35,6,13,1,1,9,37,48,7,2,46,70,31,46,8,24,5,8,9,39,70
2011-01-03 00:00:00.000,Doha Qatar ATP World Tour 250,HARD,2,Viktor Troicki,Teymuraz Gabashvili,Viktor Troicki,6-3; 6-1,R16,50,17,0,31,40,29,31,3,9,0,0,8,32,40,2,1,23,38,13,23,6,15,1,5,8,19,38
2011-01-03 00:00:00.000,Doha Qatar ATP World Tour 250,HARD,2,Roger Federer,Marco Chiudinelli,Roger Federer,7-6(5); 7-5,R16,108,7,1,43,67,33,43,17,24,0,1,12,50,67,1,2,52,84,36,52,14,32,3,5,12,50,84
2011-01-03 00:00:00.000,Doha Qatar ATP World Tour 250,HARD,2,Rafael Nadal,Ernests Gulbis,Rafael Nadal,7-6(3); 6-3,Q,111,4,1,37,61,29,37,16,24,5,6,10,45,61,12,2,53,79,36,53,10,26,3,6,11,46,79
2011-01-03 00:00:00.000,Doha Qatar ATP World Tour 250,HARD,2,Nikolay Davydenko,Ivo Karlovic,Nikolay Davydenko,6-3; 7-5,Q,76,2,2,52,64,40,52,6,12,2,2,11,46,64,14,3,38,53,29,38,6,15,1,3,10,35,53
2011-01-03 00:00:00.000,Doha Qatar ATP World Tour 250,HARD,2,Jo-Wilfried Tsonga,Guillermo Garcia-Lopez,Jo-Wilfried Tsonga,7-6(4); 7-6(9),Q,111,11,1,58,88,49,58,14,30,4,6,12,63,88,2,6,51,74,39,51,14,23,0,2,12,53,74
2011-01-03 00:00:00.000,Doha Qatar ATP World Tour 250,HARD,2,Roger Federer,Viktor Troicki,Roger Federer,6-2; 6-2,Q,65,0,0,30,43,24,30,8,13,0,0,8,32,43,5,3,38,64,21,38,11,26,12,16,8,32,64
2011-01-03 00:00:00.000,Doha Qatar ATP World Tour 250,HARD,2,Nikolay Davydenko,Rafael Nadal,Nikolay Davydenko,6-3; 6-2,S,85,5,2,37,56,26,37,9,19,7,9,9,35,56,1,1,39,58,19,39,8,19,5,10,8,27,58
2011-01-03 00:00:00.000,Doha Qatar ATP World Tour 250,HARD,2,Roger Federer,Jo-Wilfried Tsonga,Roger Federer,6-3; 7-6(2),S,85,3,0,40,60,33,40,16,20,0,0,11,49,60,3,1,46,68,29,46,14,22,2,3,10,43,68
2011-01-03 00:00:00.000,Doha Qatar ATP World Tour 250,HARD,2,Roger Federer,Nikolay Davydenko,Roger Federer,6-3; 6-4,F,80,5,1,34,51,27,34,13,17,0,0,10,40,51,5,2,35,61,28,35,8,26,6,8,9,36,61
2011-01-10 00:00:00.000,Auckland New Zealand ATP World Tour 250,HARD,2,David Ferrer,N/A Bye,David Ferrer,,R32,0,0,0,0,0,0,0,0,0,0,0,0,0,0,0,0,0,0,0,0,0,0,0,0,0,0,0
2011-01-10 00:00:00.000,Auckland New Zealand ATP World Tour 250,HARD,2,Tobias Kamke,Pere Riba,Tobias Kamke,6-3; 6-4,R32,66,3,3,33,60,25,33,15,27,4,6,10,40,60,2,0,21,45,13,21,11,24,2,6,9,24,45
2011-01-10 00:00:00.000,Auckland New Zealand ATP World Tour 250,HARD,2,Marcel Granollers,Bobby Reynolds,Marcel Granollers,6-4; 6-3,R32,102,3,2,32,59,24,32,17,27,1,2,10,41,59,6,3,46,77,31,46,11,31,10,13,9,42,77
2011-01-10 00:00:00.000,Auckland New Zealand ATP World Tour 250,HARD,2,Philipp Kohlschreiber,Carlos Berlocq,Philipp Kohlschreiber,2-6; 6-3; 6-1,R32,102,6,5,40,75,26,40,20,35,6,8,12,46,75,5,1,42,67,24,42,16,25,6,10,12,40,67
2011-01-10 00:00:00.000,Auckland New Zealand ATP World Tour 250,HARD,2,Albert Montanes,N/A Bye,Albert Montanes,,R32,0,0,0,0,0,0,0,0,0,0,0,0,0,0,0,0,0,0,0,0,0,0,0,0,0,0,0
2011-01-10 00:00:00.000,Auckland New Zealand ATP World Tour 250,HARD,2,Santiago Giraldo,Daniel Gimeno-Traver,Santiago Giraldo,6-2; 6-4,R32,77,2,0,45,65,32,45,12,20,5,5,9,44,65,2,6,20,50,14,20,14,30,0,3,9,28,50
2011-01-10 00:00:00.000,Auckland New Zealand ATP World Tour 250,HARD,2,Tommy Robredo,Michael Venus,Tommy Robredo,6-7(6); 6-3; 6-0,R32,96,11,0,56,77,41,56,18,21,0,1,14,59,77,7,8,45,80,35,45,11,35,3,8,13,46,80
2011-01-10 00:00:00.000,Auckland New Zealand ATP World Tour 250,HARD,2,Thomaz Bellucci,Michael Russell,Thomaz Bellucci,6-4; 6-7(4); 7-5,R32,168,9,4,61,102,47,61,19,41,4,7,17,66,102,3,5,83,118,57,83,16,35,7,12,17,73,118
2011-01-10 00:00:00.000,Auckland New Zealand ATP World Tour 250,HARD,2,David Nalbandian,Fabio Fognini,David Nalbandian,7-6(3); 6-4,R32,110,3,2,46,70,34,46,14,24,2,3,11,48,70,4,4,58,103,38,58,22,45,12,14,11,60,103
2011-01-10 00:00:00.000,Auckland New Zealand ATP World Tour 250,HARD,2,Philipp Petzschner,Thiemo de Bakker,Philipp Petzschner,6-1; 6-7(5); 7-6(3),R32,136,17,4,63,114,49,63,30,51,2,2,16,79,114,7,0,52,97,38,52,28,45,2,4,15,66,97
2011-01-10 00:00:00.000,Auckland New Zealand ATP World Tour 250,HARD,2,Robin Haase,Pablo Cuevas,Robin Haase,3-6; 7-6(3); 7-6(3),R32,141,7,1,67,108,53,67,18,41,2,5,17,71,108,5,1,74,119,50,74,23,45,3,4,16,73,119
2011-01-10 00:00:00.000,Auckland New Zealand ATP World Tour 250,HARD,2,John Isner,N/A Bye,John Isner,,R32,0,0,0,0,0,0,0,0,0,0,0,0,0,0,0,0,0,0,0,0,0,0,0,0,0,0,0
2011-01-10 00:00:00.000,Auckland New Zealand ATP World Tour 250,HARD,2,Adrian Mannarino,Juan Monaco,Adrian Mannarino,6-4; 6-3,R32,77,4,0,31,49,21,31,11,18,2,5,10,32,49,1,1,39,57,19,39,8,18,6,11,9,27,57
2011-01-10 00:00:00.000,Auckland New Zealand ATP World Tour 250,HARD,2,Arnaud Clement,Xavier Malisse,Arnaud Clement,4-6; 6-2; 7-5,R32,150,7,2,50,89,34,50,23,39,0,3,15,57,89,5,2,63,108,43,63,18,45,9,14,15,61,108
2011-01-10 00:00:00.000,Auckland New Zealand ATP World Tour 250,HARD,2,Victor Hanescu,Kevin Anderson,Victor Hanescu,7-6(7); 6-7(3); 6-4,R32,161,6,0,82,113,54,82,19,31,5,7,17,73,113,10,7,75,116,54,75,22,41,7,10,17,76,116
2011-01-10 00:00:00.000,Auckland New Zealand ATP World Tour 250,HARD,2,Nicolas Almagro,N/A Bye,Nicolas Almagro,,R32,0,0,0,0,0,0,0,0,0,0,0,0,0,0,0,0,0,0,0,0,0,0,0,0,0,0,0
2011-01-10 00:00:00.000,Auckland New Zealand ATP World Tour 250,HARD,2,David Ferrer,Tobias Kamke,David Ferrer,3-6; 7-6(1); 6-4,R16,150,7,1,72,103,49,72,19,31,1,2,15,68,103,1,5,72,119,50,72,25,47,5,6,16,75,119
2011-01-10 00:00:00.000,Auckland New Zealand ATP World Tour 250,HARD,2,Philipp Kohlschreiber,Marcel Granollers,Philipp Kohlschreiber,6-4; 3-6; 6-2,R16,114,10,3,43,69,35,43,12,26,1,3,13,47,69,2,1,47,83,31,47,18,36,4,8,14,49,83
2011-01-10 00:00:00.000,Auckland New Zealand ATP World Tour 250,HARD,2,Santiago Giraldo,Albert Montanes,Santiago Giraldo,6-3; 4-6; 6-4,R16,116,6,3,66,96,45,66,19,30,4,6,15,64,96,6,2,53,81,41,53,12,28,4,7,14,53,81
2011-01-10 00:00:00.000,Auckland New Zealand ATP World Tour 250,HARD,2,Thomaz Bellucci,Tommy Robredo,Thomaz Bellucci,6-4; 3-6; 6-1,R16,108,6,1,48,73,40,48,11,25,3,4,13,51,73,5,3,60,85,40,60,11,25,5,8,13,51,85
2011-01-10 00:00:00.000,Auckland New Zealand ATP World Tour 250,HARD,2,David Nalbandian,Philipp Petzschner,David Nalbandian,6-3; 6-2,R16,63,3,3,30,56,24,30,16,26,4,4,9,40,56,3,2,23,46,19,23,8,23,3,6,8,27,46
2011-01-10 00:00:00.000,Auckland New Zealand ATP World Tour 250,HARD,2,John Isner,Robin Haase,John Isner,3-6; 7-6(4); 7-5,R16,133,22,2,82,124,61,82,19,42,8,10,17,80,124,8,2,54,87,44,54,22,33,0,1,16,66,87
2011-01-10 00:00:00.000,Auckland New Zealand ATP World Tour 250,HARD,2,Adrian Mannarino,Arnaud Clement,Adrian Mannarino,7-5; 6-4,R16,111,4,1,36,59,27,36,15,23,1,3,11,42,59,5,2,48,81,35,48,10,33,6,10,11,45,81
2011-01-10 00:00:00.000,Auckland New Zealand ATP World Tour 250,HARD,2,Nicolas Almagro,Victor Hanescu,Nicolas Almagro,6-4; 7-6(3),R16,98,5,2,39,76,29,39,22,37,5,6,11,51,76,6,1,52,73,37,52,8,21,1,3,11,45,73
2011-01-10 00:00:00.000,Auckland New Zealand ATP World Tour 250,HARD,2,David Ferrer,Philipp Kohlschreiber,David Ferrer,6-3; 6-7(4); 6-3,Q,163,5,2,83,123,59,83,21,40,11,12,16,80,123,4,4,61,117,39,61,28,56,12,15,14,67,117
2011-01-10 00:00:00.000,Auckland New Zealand ATP World Tour 250,HARD,2,Santiago Giraldo,Thomaz Bellucci,Santiago Giraldo,6-2; 6-4,Q,78,5,0,37,56,26,37,11,19,1,2,9,37,56,3,2,32,49,18,32,8,17,2,6,9,26,49
2011-01-10 00:00:00.000,Auckland New Zealand ATP World Tour 250,HARD,2,David Nalbandian,John Isner,David Nalbandian,6-4; 7-6(3),Q,85,4,2,34,65,28,34,22,31,3,3,11,50,65,8,3,53,68,39,53,8,15,0,1,11,47,68
2011-01-10 00:00:00.000,Auckland New Zealand ATP World Tour 250,HARD,2,Nicolas Almagro,Adrian Mannarino,Nicolas Almagro,7-6(3); 6-7(1); 6-2,Q,124,11,3,44,87,38,44,30,43,0,1,16,68,87,3,5,62,100,52,62,15,38,6,9,16,67,100
2011-01-10 00:00:00.000,Auckland New Zealand ATP World Tour 250,HARD,2,David Ferrer,Santiago Giraldo,David Ferrer,6-3; 7-5,S,74,4,0,40,58,32,40,12,18,1,2,11,44,58,2,0,36,52,28,36,6,16,2,5,10,34,52
2011-01-10 00:00:00.000,Auckland New Zealand ATP World Tour 250,HARD,2,David Nalbandian,Nicolas Almagro,David Nalbandian,6-4; 6-2,S,86,1,3,40,65,27,40,16,25,4,4,9,43,65,8,4,35,66,23,35,13,31,3,6,9,36,66
2011-01-10 00:00:00.000,Auckland New Zealand ATP World Tour 250,HARD,2,David Ferrer,David Nalbandian,David Ferrer,6-3; 6-2,F,69,2,1,41,56,30,41,10,15,3,3,9,40,56,2,0,29,49,15,29,12,20,2,5,8,27,49
2011-01-10 00:00:00.000,Sydney Australia ATP World Tour 250,HARD,2,Sam Querrey,N/A Bye,Sam Querrey,,R32,0,0,0,0,0,0,0,0,0,0,0,0,0,0,0,0,0,0,0,0,0,0,0,0,0,0,0
2011-01-10 00:00:00.000,Sydney Australia ATP World Tour 250,HARD,2,Alexandr Dolgopolov,Bernard Tomic,Alexandr Dolgopolov,6-7(3); 6-1; 6-2,R32,85,22,1,45,83,36,45,28,38,5,5,14,64,83,4,5,55,81,38,55,11,26,1,5,13,49,81
2011-01-10 00:00:00.000,Sydney Australia ATP World Tour 250,HARD,2,Frederico Gil,Jarkko Nieminen,Frederico Gil,6-2 RET,R32,32,1,0,19,26,14,19,4,7,4,4,4,18,26,0,0,12,20,6,12,5,8,0,2,4,11,20
2011-01-10 00:00:00.000,Sydney Australia ATP World Tour 250,HARD,2,Gilles Simon,Yen-Hsun Lu,Gilles Simon,6-0; 6-3,R32,57,4,0,26,38,23,26,9,12,0,0,8,32,38,0,1,28,47,16,28,7,19,4,8,7,23,47
2011-01-10 00:00:00.000,Sydney Australia ATP World Tour 250,HARD,2,Ernests Gulbis,N/A Bye,Ernests Gulbis,,R32,0,0,0,0,0,0,0,0,0,0,0,0,0,0,0,0,0,0,0,0,0,0,0,0,0,0,0
2011-01-10 00:00:00.000,Sydney Australia ATP World Tour 250,HARD,2,Igor Andreev,Jeremy Chardy,Igor Andreev,6-2; 6-4,R32,72,4,4,33,56,28,33,11,23,4,5,9,39,56,3,6,26,55,18,26,12,29,4,8,9,30,55
2011-01-10 00:00:00.000,Sydney Australia ATP World Tour 250,HARD,2,Sergiy Stakhovsky,Benjamin Becker,Sergiy Stakhovsky,7-6(3); 7-6(6),R32,105,8,1,52,80,38,52,17,28,4,6,12,55,80,6,4,60,94,39,60,19,34,6,8,12,58,94
2011-01-10 00:00:00.000,Sydney Australia ATP World Tour 250,HARD,2,Guillermo Garcia-Lopez,Chris Guccione,Guillermo Garcia-Lopez,7-6(5); 7-5,R32,110,8,5,55,86,40,55,18,31,4,4,12,58,86,13,3,69,103,51,69,13,34,13,14,12,64,103
2011-01-10 00:00:00.000,Sydney Australia ATP World Tour 250,HARD,2,Richard Gasquet,Matthew Ebden,Richard Gasquet,6-4; 6-3,R32,71,11,1,41,58,33,41,10,17,2,2,10,43,58,3,0,27,56,17,27,16,29,5,7,9,33,56
2011-01-10 00:00:00.000,Sydney Australia ATP World Tour 250,HARD,2,Andreas Seppi,Denis Istomin,Andreas Seppi,6-1; 6-0,R32,51,4,1,27,45,19,27,12,18,1,1,7,31,45,2,1,32,44,14,32,4,12,4,9,6,18,44
2011-01-10 00:00:00.000,Sydney Australia ATP World Tour 250,HARD,2,Juan Ignacio Chela,Radek Stepanek,Juan Ignacio Chela,4-6; 6-0; 6-3,R32,119,5,1,57,88,39,57,18,31,7,9,13,57,88,3,2,39,71,25,39,14,32,3,8,12,39,71
2011-01-10 00:00:00.000,Sydney Australia ATP World Tour 250,HARD,2,Viktor Troicki,N/A Bye,Viktor Troicki,,R32,0,0,0,0,0,0,0,0,0,0,0,0,0,0,0,0,0,0,0,0,0,0,0,0,0,0,0
2011-01-10 00:00:00.000,Sydney Australia ATP World Tour 250,HARD,2,Juan Martin Del Potro,Feliciano Lopez,Juan Martin Del Potro,6-7(5); 7-6(9); 7-6(3),R32,200,21,7,85,148,68,85,33,63,7,8,18,101,148,20,3,66,124,50,66,33,58,2,3,18,83,124
2011-01-10 00:00:00.000,Sydney Australia ATP World Tour 250,HARD,2,Florian Mayer,James Ward,Florian Mayer,7-5; 6-0,R32,70,0,0,33,49,25,33,9,16,2,3,9,34,49,3,5,39,66,21,39,11,27,3,8,9,32,66
2011-01-10 00:00:00.000,Sydney Australia ATP World Tour 250,HARD,2,Potito Starace,Julien Benneteau,Potito Starace,6-7(6); 6-3; 6-4,R32,140,3,2,68,98,40,68,20,30,2,6,16,60,98,4,4,50,95,33,50,18,45,2,8,15,51,95
2011-01-10 00:00:00.000,Sydney Australia ATP World Tour 250,HARD,2,Lukasz Kubot,N/A Bye,Lukasz Kubot,,R32,0,0,0,0,0,0,0,0,0,0,0,0,0,0,0,0,0,0,0,0,0,0,0,0,0,0,0
2011-01-10 00:00:00.000,Sydney Australia ATP World Tour 250,HARD,2,Alexandr Dolgopolov,Sam Querrey,Alexandr Dolgopolov,6-4; 6-3,R16,62,7,2,26,50,21,26,14,24,1,2,9,35,50,4,5,42,70,26,42,11,28,6,10,10,37,70
2011-01-10 00:00:00.000,Sydney Australia ATP World Tour 250,HARD,2,Gilles Simon,Frederico Gil,Gilles Simon,6-1; 6-3,R16,66,4,2,23,42,15,23,13,19,0,2,8,28,42,0,1,28,56,15,28,8,28,4,10,8,23,56
2011-01-10 00:00:00.000,Sydney Australia ATP World Tour 250,HARD,2,Ernests Gulbis,Igor Andreev,Ernests Gulbis,2-6; 6-4; 6-3,R16,140,17,5,45,79,37,45,18,34,1,3,14,55,79,6,5,60,101,42,60,20,41,10,12,13,62,101
2011-01-10 00:00:00.000,Sydney Australia ATP World Tour 250,HARD,2,Sergiy Stakhovsky,Guillermo Garcia-Lopez,Sergiy Stakhovsky,6-3; 6-4,R16,65,8,0,35,48,31,35,9,13,0,0,10,40,48,2,4,30,58,22,30,13,28,3,5,9,35,58
2011-01-10 00:00:00.000,Sydney Australia ATP World Tour 250,HARD,2,Richard Gasquet,Andreas Seppi,Richard Gasquet,3-6; 7-5; 6-4,R16,125,10,3,62,90,45,62,16,28,1,3,16,61,90,8,3,59,103,45,59,21,44,8,10,15,66,103
2011-01-10 00:00:00.000,Sydney Australia ATP World Tour 250,HARD,2,Viktor Troicki,Juan Ignacio Chela,Viktor Troicki,6-2; 6-3,R16,84,8,0,29,45,24,29,11,16,3,3,8,35,45,1,3,45,82,25,45,17,37,7,11,9,42,82
2011-01-10 00:00:00.000,Sydney Australia ATP World Tour 250,HARD,2,Florian Mayer,Juan Martin Del Potro,Florian Mayer,6-2; 7-5,R16,74,10,2,35,49,29,35,11,14,0,0,10,40,49,4,3,26,58,19,26,16,32,1,4,10,35,58
2011-01-10 00:00:00.000,Sydney Australia ATP World Tour 250,HARD,2,Potito Starace,Lukasz Kubot,Potito Starace,7-6(5); 2-6; 6-3,R16,132,7,1,74,102,48,74,15,28,7,11,15,63,102,10,7,49,83,37,49,16,34,4,7,14,53,83
2011-01-10 00:00:00.000,Sydney Australia ATP World Tour 250,HARD,2,Gilles Simon,Alexandr Dolgopolov,Gilles Simon,6-4; 6-3,Q,76,3,2,33,58,27,33,16,25,2,2,10,43,58,4,1,32,58,22,32,13,26,3,5,9,35,58
2011-01-10 00:00:00.000,Sydney Australia ATP World Tour 250,HARD,2,Ernests Gulbis,Sergiy Stakhovsky,Ernests Gulbis,6-4; 6-4,Q,93,3,4,45,74,32,45,16,29,5,6,10,48,74,5,1,37,61,22,37,15,24,4,7,10,37,61
2011-01-10 00:00:00.000,Sydney Australia ATP World Tour 250,HARD,2,Viktor Troicki,Richard Gasquet,Viktor Troicki,6-4; 6-4,Q,77,8,1,33,62,26,33,15,29,3,4,10,41,62,3,1,37,56,24,37,10,19,2,5,10,34,56
2011-01-10 00:00:00.000,Sydney Australia ATP World Tour 250,HARD,2,Florian Mayer,Potito Starace,Florian Mayer,6-4; 6-1,Q,65,3,0,30,47,23,30,9,17,2,4,9,32,47,0,1,33,56,17,33,8,23,1,6,8,25,56
2011-01-10 00:00:00.000,Sydney Australia ATP World Tour 250,HARD,2,Gilles Simon,Ernests Gulbis,Gilles Simon,7-6(1); 6-0,S,73,2,4,31,58,24,31,16,27,1,2,9,40,58,3,4,28,48,17,28,5,20,0,4,9,22,48
2011-01-10 00:00:00.000,Sydney Australia ATP World Tour 250,HARD,2,Viktor Troicki,Florian Mayer,Viktor Troicki,6-4; 7-6(4),S,84,13,4,36,69,32,36,12,33,2,5,11,44,69,2,1,51,73,27,51,15,22,4,8,11,42,73
2011-01-10 00:00:00.000,Sydney Australia ATP World Tour 250,HARD,2,Gilles Simon,Viktor Troicki,Gilles Simon,7-5; 7-6(4),F,119,3,2,46,86,25,46,22,40,3,7,12,47,86,5,3,42,82,30,42,13,40,8,13,12,43,82
2011-01-17 00:00:00.000,Australian Open Australia Grand Slams,HARD,3,Rafael Nadal,Marcos Daniel,Rafael Nadal,6-0; 5-0 RET,R128,47,4,3,19,35,16,19,9,16,4,4,5,25,35,0,0,17,26,2,17,0,9,0,6,6,2,26
2011-01-17 00:00:00.000,Australian Open Australia Grand Slams,HARD,3,Ryan Sweeting,Daniel Gimeno-Traver,Ryan Sweeting,6-4; 6-4; 6-1,R128,111,3,6,84,113,59,84,12,29,11,12,13,71,113,10,2,47,77,31,47,12,30,1,7,14,43,77
2011-01-17 00:00:00.000,Australian Open Australia Grand Slams,HARD,3,Bernard Tomic,Jeremy Chardy,Bernard Tomic,6-3; 6-2; 7-6(5),R128,110,2,3,62,92,44,62,22,30,2,2,15,66,92,12,7,56,92,41,56,14,36,3,6,14,55,92
2011-01-17 00:00:00.000,Australian Open Australia Grand Slams,HARD,3,Feliciano Lopez,Alejandro Falla,Feliciano Lopez,6-3; 7-6(6); 6-3,R128,134,17,6,61,102,46,61,21,41,7,10,16,67,102,6,3,59,95,38,59,16,36,7,12,14,54,95
2011-01-17 00:00:00.000,Australian Open Australia Grand Slams,HARD,3,John Isner,Florent Serra,John Isner,6-3; 7-6(8); 6-3,R128,110,27,4,77,106,62,77,14,29,3,4,16,76,106,4,5,58,92,43,58,17,34,2,5,14,60,92
2011-01-17 00:00:00.000,Australian Open Australia Grand Slams,HARD,3,Radek Stepanek,Denis Gremelmayr,Radek Stepanek,6-3; 6-2; 6-3,R128,84,7,1,37,65,30,37,20,28,2,3,13,50,65,5,1,46,88,27,46,20,42,4,10,13,47,88
2011-01-17 00:00:00.000,Australian Open Australia Grand Slams,HARD,3,Santiago Giraldo,Rui Machado,Santiago Giraldo,6-4; 6-3; 5-7; 6-1,R128,149,7,2,61,100,40,61,24,39,4,9,19,64,100,9,5,76,125,43,76,20,49,4,13,19,63,125
2011-01-17 00:00:00.000,Australian Open Australia Grand Slams,HARD,3,Marin Cilic,Donald Young,Marin Cilic,6-3; 6-2; 6-1,R128,91,8,0,42,67,34,42,16,25,1,1,12,50,67,1,3,47,75,28,47,11,28,5,11,12,39,75
2011-01-17 00:00:00.000,Australian Open Australia Grand Slams,HARD,3,Mikhail Youzhny,Marsel Ilhan,Mikhail Youzhny,6-2; 6-3; 7-6(5),R128,131,3,0,59,89,50,59,20,30,5,5,15,70,89,10,5,61,96,45,61,17,35,5,8,14,62,96
2011-01-17 00:00:00.000,Australian Open Australia Grand Slams,HARD,3,Blaz Kavcic,Kevin Anderson,Blaz Kavcic,2-6; 6-4; 7-6(4); 7-6(5),R128,201,4,2,93,142,69,93,21,49,6,11,21,90,142,23,2,84,131,64,84,23,47,5,9,21,87,131
2011-01-17 00:00:00.000,Australian Open Australia Grand Slams,HARD,3,Milos Raonic,Bjorn Phau,Milos Raonic,7-6(3); 6-3; 7-6(8),R128,127,27,6,68,104,57,68,23,36,0,0,17,80,104,5,3,58,107,44,58,28,49,1,2,16,72,107
2011-01-17 00:00:00.000,Australian Open Australia Grand Slams,HARD,3,Michael Llodra,Juan Ignacio Chela,Michael Llodra,6-3; 3-6; 6-2; 6-4,R128,143,9,5,67,109,50,67,21,42,7,10,18,71,109,3,5,67,112,43,67,19,45,5,11,18,62,112
2011-01-17 00:00:00.000,Australian Open Australia Grand Slams,HARD,3,David Nalbandian,Lleyton Hewitt,David Nalbandian,3-6; 6-4; 3-6; 7-6(1); 9-7,R128,288,7,6,136,210,88,136,37,74,23,29,28,125,210,10,5,103,176,73,103,35,73,6,12,28,108,176
2011-01-17 00:00:00.000,Australian Open Australia Grand Slams,HARD,3,Ricardas Berankis,Marinko Matosevic,Ricardas Berankis,6-4; 6-2; 7-5,R128,113,7,1,50,86,37,50,20,36,1,4,15,57,86,4,4,54,95,31,54,20,41,8,15,15,51,95
2011-01-17 00:00:00.000,Australian Open Australia Grand Slams,HARD,3,Michael Russell,Matthew Ebden,Michael Russell,6-3; 6-2; 5-7; 7-6(9),R128,203,4,3,104,147,69,104,19,43,5,11,21,88,147,13,2,83,133,55,83,20,50,5,13,20,75,133
2011-01-17 00:00:00.000,Australian Open Australia Grand Slams,HARD,3,David Ferrer,Jarkko Nieminen,David Ferrer,6-4; 6-3; 1-6; 6-2,R128,119,4,2,62,89,49,62,15,27,0,3,17,64,89,6,0,60,105,41,60,20,45,6,11,17,61,105
2011-01-17 00:00:00.000,Australian Open Australia Grand Slams,HARD,3,Robin Soderling,Potito Starace,Robin Soderling,6-4; 6-2; 6-2,R128,94,12,0,40,68,35,40,18,28,0,0,13,53,68,4,2,47,80,34,47,10,33,3,8,13,44,80
2011-01-17 00:00:00.000,Australian Open Australia Grand Slams,HARD,3,Gilles Muller,Simon Stadler,Gilles Muller,6-3; 7-6(5); 6-4,R128,134,11,1,74,108,56,74,19,34,6,8,16,75,108,3,1,62,91,40,62,17,29,4,8,15,57,91
2011-01-17 00:00:00.000,Australian Open Australia Grand Slams,HARD,3,Jan Hernych,Denis Istomin,Jan Hernych,6-3; 6-4; 3-6; 6-2,R128,153,4,1,76,116,50,76,26,40,11,13,18,76,116,2,3,81,118,50,81,19,37,10,15,18,69,118
2011-01-17 00:00:00.000,Australian Open Australia Grand Slams,HARD,3,Thomaz Bellucci,Ricardo Mello,Thomaz Bellucci,7-5; 7-5; 4-6; 3-6; 6-3,R128,237,15,9,95,175,73,95,32,80,16,22,26,105,175,4,4,97,165,58,97,38,68,10,17,26,96,165
2011-01-17 00:00:00.000,Australian Open Australia Grand Slams,HARD,3,Benjamin Becker,Ernests Gulbis,Benjamin Becker,7-6(5); 6-2; 6-4,R128,118,12,2,56,93,47,56,20,37,4,5,15,67,93,12,6,65,92,49,65,9,27,2,6,15,58,92
2011-01-17 00:00:00.000,Australian Open Australia Grand Slams,HARD,3,Alexandr Dolgopolov,Mikhail Kukushkin,Alexandr Dolgopolov,6-3; 6-2; 6-4,R128,100,16,3,35,75,31,35,23,40,0,2,14,54,75,1,5,47,79,28,47,11,32,8,14,13,39,79
2011-01-17 00:00:00.000,Australian Open Australia Grand Slams,HARD,3,Andreas Seppi,Arnaud Clement,Andreas Seppi,3-6; 2-6; 7-5; 6-3; 6-2,R128,219,12,5,81,142,60,81,29,61,3,8,23,89,142,5,8,96,169,62,96,38,73,16,22,23,100,169
2011-01-17 00:00:00.000,Australian Open Australia Grand Slams,HARD,3,Jo-Wilfried Tsonga,Philipp Petzschner,Jo-Wilfried Tsonga,4-6; 2-6; 6-2; 6-3; 6-4,R128,195,11,5,109,166,75,109,25,57,13,18,23,100,166,14,7,72,129,52,72,24,57,7,13,22,76,129
2011-01-17 00:00:00.000,Australian Open Australia Grand Slams,HARD,3,Jurgen Melzer,Vincent Millot,Jurgen Melzer,6-2; 6-4; 6-2,R128,108,4,1,48,81,36,48,20,33,2,3,13,56,81,5,3,60,94,29,60,19,34,10,16,13,48,94
2011-01-17 00:00:00.000,Australian Open Australia Grand Slams,HARD,3,Pere Riba,Carsten Ball,Pere Riba,1-6; 7-6(5); 6-2; 2-6; 6-4,R128,172,10,6,72,132,44,72,38,60,3,8,22,82,132,23,11,92,134,70,92,19,42,5,9,23,89,134
2011-01-17 00:00:00.000,Australian Open Australia Grand Slams,HARD,3,Juan Martin Del Potro,Dudi Sela,Juan Martin Del Potro,7-6(13); 6-4; 6-4,R128,159,19,3,71,112,54,71,20,41,3,5,16,74,112,4,1,52,96,37,52,25,44,2,6,16,62,96
2011-01-17 00:00:00.000,Australian Open Australia Grand Slams,HARD,3,Marcos Baghdatis,Grega Zemlja,Marcos Baghdatis,3-6; 7-5; 6-1; 4-6; 6-2,R128,203,15,3,72,137,54,72,35,65,9,13,23,89,137,9,5,87,162,57,87,37,75,15,22,23,94,162
2011-01-17 00:00:00.000,Australian Open Australia Grand Slams,HARD,3,Guillermo Garcia-Lopez,Michael Berrer,Guillermo Garcia-Lopez,6-4; 6-4; 3-6; 6-3,R128,152,8,5,77,118,55,77,19,41,10,14,19,74,118,16,4,86,124,53,86,16,38,5,12,19,69,124
2011-01-17 00:00:00.000,Australian Open Australia Grand Slams,HARD,3,Eduardo Schwank,Leonardo Mayer,Eduardo Schwank,6-2; 6-0; 6-4,R128,102,6,0,36,60,29,36,19,24,0,0,12,48,60,2,5,55,85,31,55,12,30,7,13,12,43,85
2011-01-17 00:00:00.000,Australian Open Australia Grand Slams,HARD,3,Illya Marchenko,Ruben Ramirez Hidalgo,Illya Marchenko,6-3; 6-4; 6-1,R128,133,9,8,49,88,35,49,18,39,11,14,13,53,88,1,5,35,84,21,35,17,49,4,12,13,38,84
2011-01-17 00:00:00.000,Australian Open Australia Grand Slams,HARD,3,Andy Murray,Karol Beck,Andy Murray,6-3; 6-1; 4-2 RET,R128,102,2,3,38,66,33,38,14,28,3,3,11,47,66,5,5,50,83,32,50,12,33,4,9,11,44,83
2011-01-17 00:00:00.000,Australian Open Australia Grand Slams,HARD,3,Tomas Berdych,Marco Crugnola,Tomas Berdych,6-4; 6-0; 6-2,R128,99,2,1,41,65,36,41,10,24,0,1,12,46,65,0,9,50,81,29,50,10,31,4,11,12,39,81
2011-01-17 00:00:00.000,Australian Open Australia Grand Slams,HARD,3,Philipp Kohlschreiber,Tobias Kamke,Philipp Kohlschreiber,1-6; 4-6; 7-6(6); 6-4; 6-4,R128,231,7,2,110,166,68,110,30,56,9,15,24,98,166,6,7,99,170,70,99,38,71,13,18,25,108,170
2011-01-17 00:00:00.000,Australian Open Australia Grand Slams,HARD,3,Adrian Mannarino,Ryan Harrison,Adrian Mannarino,6-4; 6-3; 6-4,R128,106,4,3,47,79,39,47,17,32,3,4,14,56,79,9,2,60,93,36,60,18,33,5,10,15,54,93
2011-01-17 00:00:00.000,Australian Open Australia Grand Slams,HARD,3,Richard Gasquet,Frank Dancevic,Richard Gasquet,6-3; 6-4; 6-4,R128,121,5,2,50,80,36,50,19,30,1,4,15,55,80,2,0,61,96,35,61,17,35,8,14,14,52,96
2011-01-17 00:00:00.000,Australian Open Australia Grand Slams,HARD,3,Florian Mayer,Nikolay Davydenko,Florian Mayer,6-3; 4-6; 7-6(4); 6-4,R128,185,3,2,92,137,63,92,28,45,10,13,20,91,137,4,6,95,149,69,95,23,54,9,14,21,92,149
2011-01-17 00:00:00.000,Australian Open Australia Grand Slams,HARD,3,Kei Nishikori,Fabio Fognini,Kei Nishikori,6-1; 6-4; 6-7(4); 6-4,R128,188,6,3,89,129,61,89,20,40,11,14,19,81,129,3,5,80,134,52,80,22,54,7,15,20,74,134
2011-01-17 00:00:00.000,Australian Open Australia Grand Slams,HARD,3,Janko Tipsarevic,Mischa Zverev,Janko Tipsarevic,6-3; 6-1; 6-4,R128,132,13,4,51,88,43,51,17,37,3,3,13,60,88,7,6,66,101,42,66,12,35,11,16,13,54,101
2011-01-17 00:00:00.000,Australian Open Australia Grand Slams,HARD,3,Fernando Verdasco,Rainer Schuettler,Fernando Verdasco,6-1; 6-3; 6-2,R128,104,8,1,41,68,35,41,16,27,1,1,12,51,68,5,5,48,89,31,48,15,41,8,14,12,46,89
2011-01-17 00:00:00.000,Australian Open Australia Grand Slams,HARD,3,Nicolas Almagro,Stephane Robert,Nicolas Almagro,6-4; 6-3; 6-7(4); 7-5,R128,157,22,4,84,141,67,84,31,57,6,8,22,98,141,7,5,80,132,58,80,25,52,5,10,21,83,132
2011-01-17 00:00:00.000,Australian Open Australia Grand Slams,HARD,3,Igor Andreev,Filippo Volandri,Igor Andreev,6-3; 7-6(3); 6-3,R128,153,6,4,62,107,45,62,17,45,8,14,16,62,107,0,8,62,110,36,62,17,48,10,18,14,53,110
2011-01-17 00:00:00.000,Australian Open Australia Grand Slams,HARD,3,Benoit Paire,Flavio Cipolla,Benoit Paire,6-1; 7-5; 6-1,R128,102,8,3,45,81,38,45,19,36,1,1,13,57,81,2,4,63,95,38,63,13,32,10,16,13,51,95
2011-01-17 00:00:00.000,Australian Open Australia Grand Slams,HARD,3,Ivan Ljubicic,Peter Luczak,Ivan Ljubicic,6-3; 6-3; 7-6(2),R128,152,19,1,58,92,50,58,21,34,5,5,15,71,92,8,2,70,117,50,70,20,47,9,12,15,70,117
2011-01-17 00:00:00.000,Australian Open Australia Grand Slams,HARD,3,Viktor Troicki,Dmitry Tursunov,Viktor Troicki,6-2; 3-6; 6-2; 6-0,R128,142,10,1,54,93,39,54,23,39,4,6,15,62,93,8,4,65,111,37,65,20,46,10,18,16,57,111
2011-01-17 00:00:00.000,Australian Open Australia Grand Slams,HARD,3,Nicolas Mahut,Brian Dabul,Nicolas Mahut,6-3; 6-4; 6-4,R128,111,7,3,57,92,48,57,16,35,3,4,15,64,92,1,0,45,76,26,45,22,31,4,8,14,48,76
2011-01-17 00:00:00.000,Australian Open Australia Grand Slams,HARD,3,Ivan Dodig,Ivo Karlovic,Ivan Dodig,6-4; 3-6; 6-7(5); 6-4; 6-4,R128,177,10,7,85,132,71,85,33,47,2,3,25,104,132,48,6,106,152,85,106,25,46,5,8,26,110,152
2011-01-17 00:00:00.000,Australian Open Australia Grand Slams,HARD,3,Novak Djokovic,Marcel Granollers,Novak Djokovic,6-1; 6-3; 6-1,R128,91,7,1,45,66,34,45,14,21,1,2,12,48,66,3,3,31,65,21,31,8,34,5,12,11,29,65
2011-01-17 00:00:00.000,Australian Open Australia Grand Slams,HARD,3,Andy Roddick,Jan Hajek,Andy Roddick,6-1; 6-2; 6-2,R128,100,18,2,50,74,40,50,13,24,5,5,12,53,74,2,3,43,74,25,43,11,31,7,13,11,36,74
2011-01-17 00:00:00.000,Australian Open Australia Grand Slams,HARD,3,Igor Kunitsyn,Michal Przysiezny,Igor Kunitsyn,6-7(1); 6-4; 6-4; 7-6(6),R128,203,8,1,80,135,53,80,31,55,3,8,22,84,135,16,7,93,159,61,93,28,66,9,16,22,89,159
2011-01-17 00:00:00.000,Australian Open Australia Grand Slams,HARD,3,Robin Haase,Carlos Berlocq,Robin Haase,6-4; 6-3; 7-6(5),R128,148,4,5,60,105,44,60,27,45,4,6,15,71,105,4,3,49,99,35,49,23,50,3,8,16,58,99
2011-01-17 00:00:00.000,Australian Open Australia Grand Slams,HARD,3,Juan Monaco,Simon Greul,Juan Monaco,7-6(5); 7-6(4); 6-2,R128,179,5,1,76,105,51,76,14,29,5,10,16,65,105,4,7,75,128,43,75,22,53,14,21,16,65,128
2011-01-17 00:00:00.000,Australian Open Australia Grand Slams,HARD,3,Stanislas Wawrinka,Teymuraz Gabashvili,Stanislas Wawrinka,7-6(3); 6-4; 6-4,R128,147,11,5,60,111,48,60,27,51,1,2,16,75,111,4,4,58,107,39,58,27,49,7,10,16,66,107
2011-01-17 00:00:00.000,Australian Open Australia Grand Slams,HARD,3,Grigor Dimitrov,Andrey Golubev,Grigor Dimitrov,6-1; 6-4; 6-2,R128,93,2,2,40,70,31,40,23,30,3,3,13,54,70,2,2,52,87,30,52,15,35,8,13,12,45,87
2011-01-17 00:00:00.000,Australian Open Australia Grand Slams,HARD,3,Frederico Gil,Pablo Cuevas,Frederico Gil,6-4; 6-7(7); 4-6; 6-3; 9-7,R128,264,4,3,120,192,81,120,37,72,12,18,29,118,192,20,7,106,190,70,106,40,84,8,16,28,110,190
2011-01-17 00:00:00.000,Australian Open Australia Grand Slams,HARD,3,Gael Monfils,Thiemo de Bakker,Gael Monfils,6-7(5); 2-6; 7-5; 6-2; 6-1,R128,218,13,4,84,131,64,84,23,47,4,9,23,87,131,14,5,123,191,79,123,25,68,19,28,24,104,191
2011-01-17 00:00:00.000,Australian Open Australia Grand Slams,HARD,3,Mardy Fish,Victor Hanescu,Mardy Fish,2-6; 4-6; 6-3; 7-5; 6-3,R128,212,12,3,79,138,60,79,30,59,7,12,24,90,138,10,1,109,146,74,109,19,37,7,13,24,93,146
2011-01-17 00:00:00.000,Australian Open Australia Grand Slams,HARD,3,Tommy Robredo,Somdev Devvarman,Tommy Robredo,7-6(4); 6-3; 6-4,R128,157,9,0,64,104,47,64,24,40,6,8,16,71,104,6,2,71,107,49,71,15,36,8,12,15,64,107
2011-01-17 00:00:00.000,Australian Open Australia Grand Slams,HARD,3,Sergiy Stakhovsky,Daniel Brands,Sergiy Stakhovsky,6-2; 6-3; 6-4,R128,91,7,1,52,77,40,52,13,25,0,2,14,53,77,5,3,48,74,34,48,5,26,4,10,13,39,74
2011-01-17 00:00:00.000,Australian Open Australia Grand Slams,HARD,3,Lukasz Kubot,Sam Querrey,Lukasz Kubot,5-7; 6-2; 3-6; 6-1; 8-6,R128,200,7,8,110,161,83,110,21,51,8,12,25,104,161,19,4,115,172,72,115,29,57,6,13,25,101,172
2011-01-17 00:00:00.000,Australian Open Australia Grand Slams,HARD,3,Albert Montanes,Dustin Brown,Albert Montanes,6-4; 6-2; 3-6; 2-6; 7-5,R128,158,1,3,78,134,53,78,39,56,9,12,23,92,134,29,7,118,172,90,118,17,54,9,13,24,107,172
2011-01-17 00:00:00.000,Australian Open Australia Grand Slams,HARD,3,Xavier Malisse,Pablo Andujar,Xavier Malisse,6-1; 6-2; 7-6(3),R128,121,1,3,49,84,33,49,23,35,1,3,14,56,84,1,0,51,77,27,51,14,26,3,9,13,41,77
2011-01-17 00:00:00.000,Australian Open Australia Grand Slams,HARD,3,Gilles Simon,Yen-Hsun Lu,Gilles Simon,6-7(3); 6-2; 6-4; 6-2,R128,217,6,2,59,123,45,59,38,64,5,6,19,83,123,3,4,75,126,48,75,25,51,5,11,19,73,126
2011-01-17 00:00:00.000,Australian Open Australia Grand Slams,HARD,3,Roger Federer,Lukas Lacko,Roger Federer,6-1; 6-1; 6-3,R128,84,8,1,38,59,33,38,14,21,0,1,12,47,59,3,1,56,83,33,56,6,27,7,14,11,39,83
2011-01-17 00:00:00.000,Australian Open Australia Grand Slams,HARD,3,Rafael Nadal,Ryan Sweeting,Rafael Nadal,6-2; 6-1; 6-1,R64,102,7,4,41,64,34,41,12,23,1,2,11,46,64,2,5,58,78,26,58,8,20,7,15,11,34,78
2011-01-17 00:00:00.000,Australian Open Australia Grand Slams,HARD,3,Bernard Tomic,Feliciano Lopez,Bernard Tomic,7-6(4); 7-6(3); 6-3,R64,129,10,3,65,103,53,65,21,38,6,8,17,74,103,20,1,55,91,39,55,22,36,2,5,16,61,91
2011-01-17 00:00:00.000,Australian Open Australia Grand Slams,HARD,3,John Isner,Radek Stepanek,John Isner,4-6; 6-4; 6-2; 6-1,R64,129,20,5,75,99,59,75,15,24,7,8,18,74,99,3,3,52,88,38,52,19,36,2,7,17,57,88
2011-01-17 00:00:00.000,Australian Open Australia Grand Slams,HARD,3,Marin Cilic,Santiago Giraldo,Marin Cilic,6-3; 7-6(1); 6-1,R64,120,13,7,48,103,40,48,33,55,11,12,15,73,103,2,2,48,71,31,48,12,23,1,5,13,43,71
2011-01-17 00:00:00.000,Australian Open Australia Grand Slams,HARD,3,Mikhail Youzhny,Blaz Kavcic,Mikhail Youzhny,6-3; 6-1; 5-7; 4-6; 6-1,R64,219,14,4,84,146,62,84,34,62,10,13,23,96,146,6,8,88,143,57,88,26,55,3,10,22,83,143
2011-01-17 00:00:00.000,Australian Open Australia Grand Slams,HARD,3,Milos Raonic,Michael Llodra,Milos Raonic,7-6(3); 6-3; 7-6(4),R64,138,21,1,62,95,55,62,22,33,1,2,17,77,95,10,2,66,108,51,66,21,42,4,6,16,72,108
2011-01-17 00:00:00.000,Australian Open Australia Grand Slams,HARD,3,Ricardas Berankis,David Nalbandian,Ricardas Berankis,6-1; 6-0; 2-0 RET,R64,59,8,1,25,43,21,25,13,18,1,1,8,34,43,0,3,29,46,13,29,4,17,6,12,8,17,46
2011-01-17 00:00:00.000,Australian Open Australia Grand Slams,HARD,3,David Ferrer,Michael Russell,David Ferrer,6-0; 6-1; 7-5,R64,109,8,3,39,63,32,39,17,24,0,0,12,49,63,4,4,47,82,31,47,10,35,7,14,13,41,82
2011-01-17 00:00:00.000,Australian Open Australia Grand Slams,HARD,3,Robin Soderling,Gilles Muller,Robin Soderling,6-3; 7-6(1); 6-1,R64,105,6,5,45,78,42,45,22,33,0,0,15,64,78,7,1,45,75,35,45,12,30,1,4,13,47,75
2011-01-17 00:00:00.000,Australian Open Australia Grand Slams,HARD,3,Jan Hernych,Thomaz Bellucci,Jan Hernych,6-2; 6-7(11); 6-4; 6-7(3); 8-6,R64,276,12,6,143,203,98,143,26,60,13,17,28,124,203,25,5,123,196,84,123,29,73,7,15,28,113,196
2011-01-17 00:00:00.000,Australian Open Australia Grand Slams,HARD,3,Alexandr Dolgopolov,Benjamin Becker,Alexandr Dolgopolov,6-3; 6-0; 3-6; 7-6(3),R64,137,18,2,50,93,43,50,31,43,0,1,18,74,93,9,3,63,115,44,63,25,52,5,9,18,69,115
2011-01-17 00:00:00.000,Australian Open Australia Grand Slams,HARD,3,Jo-Wilfried Tsonga,Andreas Seppi,Jo-Wilfried Tsonga,6-3; 7-6(1); 7-6(5),R64,150,20,4,78,121,62,78,19,43,6,8,17,81,121,8,3,55,96,42,55,20,41,3,6,16,62,96
2011-01-17 00:00:00.000,Australian Open Australia Grand Slams,HARD,3,Jurgen Melzer,Pere Riba,Jurgen Melzer,6-2; 6-4; 6-2,R64,103,9,2,49,73,38,49,12,24,0,1,13,50,73,5,6,42,83,27,42,16,41,4,10,13,43,83
2011-01-17 00:00:00.000,Australian Open Australia Grand Slams,HARD,3,Marcos Baghdatis,Juan Martin Del Potro,Marcos Baghdatis,6-1; 6-3; 4-6; 6-3,R64,162,15,5,51,103,45,51,25,52,3,5,18,70,103,9,3,76,109,46,76,17,33,6,12,17,63,109
2011-01-17 00:00:00.000,Australian Open Australia Grand Slams,HARD,3,Guillermo Garcia-Lopez,Eduardo Schwank,Guillermo Garcia-Lopez,6-4; 7-6(8); 6-1,R64,127,4,4,46,85,40,46,24,39,1,2,15,64,85,2,8,72,112,48,72,17,40,5,9,14,65,112
2011-01-17 00:00:00.000,Australian Open Australia Grand Slams,HARD,3,Andy Murray,Illya Marchenko,Andy Murray,6-1; 6-3; 6-3,R64,117,16,0,52,82,41,52,13,30,3,4,13,54,82,5,4,38,71,21,38,13,33,2,8,12,34,71
2011-01-17 00:00:00.000,Australian Open Australia Grand Slams,HARD,3,Tomas Berdych,Philipp Kohlschreiber,Tomas Berdych,4-6; 6-2; 6-3; 6-4,R64,183,10,6,70,121,59,70,25,51,2,3,19,84,121,13,5,74,120,54,74,17,46,5,9,18,71,120
2011-01-17 00:00:00.000,Australian Open Australia Grand Slams,HARD,3,Richard Gasquet,Adrian Mannarino,Richard Gasquet,6-3; 7-6(4); 6-4,R64,132,12,3,65,95,50,65,18,30,2,4,16,68,95,5,3,64,107,39,64,21,43,7,11,15,60,107
2011-01-17 00:00:00.000,Australian Open Australia Grand Slams,HARD,3,Kei Nishikori,Florian Mayer,Kei Nishikori,6-4; 6-3; 0-6; 6-3,R64,144,2,5,66,116,43,66,28,50,6,10,17,71,116,7,5,76,118,52,76,16,42,7,12,17,68,118
2011-01-17 00:00:00.000,Australian Open Australia Grand Slams,HARD,3,Fernando Verdasco,Janko Tipsarevic,Fernando Verdasco,2-6; 4-6; 6-4; 7-6(0); 6-0,R64,232,23,7,97,151,75,97,21,54,15,20,23,96,151,17,6,85,154,57,85,32,69,7,12,23,89,154
2011-01-17 00:00:00.000,Australian Open Australia Grand Slams,HARD,3,Nicolas Almagro,Igor Andreev,Nicolas Almagro,7-5; 2-6; 4-6; 7-6(10); 7-5,R64,234,10,5,87,163,68,87,40,76,6,12,27,108,163,21,5,116,175,86,116,28,59,8,13,27,114,175
2011-01-17 00:00:00.000,Australian Open Australia Grand Slams,HARD,3,Ivan Ljubicic,Benoit Paire,Ivan Ljubicic,6-3; 6-7(2); 6-4; 7-6(5),R64,185,8,1,79,128,53,79,30,49,0,3,21,83,128,13,5,76,145,55,76,32,69,10,16,22,87,145
2011-01-17 00:00:00.000,Australian Open Australia Grand Slams,HARD,3,Viktor Troicki,Nicolas Mahut,Viktor Troicki,6-4; 6-2; 1-6; 6-3,R64,162,12,4,63,118,51,63,18,55,10,15,17,69,118,7,4,78,116,49,78,14,38,10,17,17,63,116
2011-01-17 00:00:00.000,Australian Open Australia Grand Slams,HARD,3,Novak Djokovic,Ivan Dodig,Novak Djokovic,7-5; 6-7(8); 6-0; 6-2,R64,201,9,3,78,121,59,78,27,43,4,5,19,86,121,8,6,84,146,56,84,30,62,13,20,19,86,146
2011-01-17 00:00:00.000,Australian Open Australia Grand Slams,HARD,3,Andy Roddick,Igor Kunitsyn,Andy Roddick,7-6(7); 6-2; 6-3,R64,124,17,5,55,82,47,55,20,27,3,3,15,67,82,4,0,59,91,40,59,19,32,4,7,14,59,91
2011-01-17 00:00:00.000,Australian Open Australia Grand Slams,HARD,3,Robin Haase,Juan Monaco,Robin Haase,6-4; 6-4; 3-6; 6-2,R64,184,9,3,99,148,64,99,23,49,12,17,19,87,148,2,2,84,121,49,84,17,37,8,16,18,66,121
2011-01-17 00:00:00.000,Australian Open Australia Grand Slams,HARD,3,Stanislas Wawrinka,Grigor Dimitrov,Stanislas Wawrinka,7-5; 6-3; 6-3,R64,101,8,0,43,80,33,43,24,37,5,7,15,57,80,2,6,43,82,31,43,17,39,4,10,15,48,82
2011-01-17 00:00:00.000,Australian Open Australia Grand Slams,HARD,3,Gael Monfils,Frederico Gil,Gael Monfils,6-4; 6-3; 1-6; 6-2,R64,149,8,5,70,104,49,70,17,34,3,7,17,66,104,0,0,91,127,50,91,20,36,5,11,17,70,127
2011-01-17 00:00:00.000,Australian Open Australia Grand Slams,HARD,3,Tommy Robredo,Mardy Fish,Tommy Robredo,1-6; 6-3; 6-3; 6-3,R64,153,1,2,76,105,55,76,14,29,5,8,17,69,105,12,5,69,117,48,69,19,48,9,14,17,67,117
2011-01-17 00:00:00.000,Australian Open Australia Grand Slams,HARD,3,Sergiy Stakhovsky,Lukasz Kubot,Sergiy Stakhovsky,6-3; 6-4; 6-4,R64,127,9,5,57,85,38,57,12,28,3,8,15,50,85,5,8,60,92,34,60,10,32,6,14,14,44,92
2011-01-17 00:00:00.000,Australian Open Australia Grand Slams,HARD,3,Xavier Malisse,Albert Montanes,Xavier Malisse,6-4; 6-0; 6-1,R64,99,7,0,33,64,25,33,19,31,2,4,11,44,64,5,3,45,84,22,45,13,39,9,17,12,35,84
2011-01-17 00:00:00.000,Australian Open Australia Grand Slams,HARD,3,Roger Federer,Gilles Simon,Roger Federer,6-2; 6-3; 4-6; 4-6; 6-3,R64,193,11,1,77,126,61,77,21,49,4,9,23,82,126,8,5,88,155,49,88,37,67,10,18,23,86,155
2011-01-17 00:00:00.000,Australian Open Australia Grand Slams,HARD,3,Rafael Nadal,Bernard Tomic,Rafael Nadal,6-2; 7-5; 6-3,R32,150,4,4,56,97,38,56,22,41,6,8,14,60,97,11,3,70,103,42,70,13,33,12,19,15,55,103
2011-01-17 00:00:00.000,Australian Open Australia Grand Slams,HARD,3,Marin Cilic,John Isner,Marin Cilic,4-6; 6-2; 6-7(5); 7-6(2); 9-7,R32,273,22,8,106,186,81,106,54,80,10,11,29,135,186,26,5,128,185,97,128,31,57,6,9,29,128,185
2011-01-17 00:00:00.000,Australian Open Australia Grand Slams,HARD,3,Milos Raonic,Mikhail Youzhny,Milos Raonic,6-4; 7-5; 4-6; 6-4,R32,166,28,2,77,113,55,77,22,36,1,5,21,77,113,3,1,71,117,45,71,26,46,2,8,21,71,117
2011-01-17 00:00:00.000,Australian Open Australia Grand Slams,HARD,3,David Ferrer,Ricardas Berankis,David Ferrer,6-2; 6-2; 6-1,R32,91,5,1,33,57,29,33,14,24,0,1,11,43,57,1,5,52,91,26,52,13,39,11,19,12,39,91
2011-01-17 00:00:00.000,Australian Open Australia Grand Slams,HARD,3,Robin Soderling,Jan Hernych,Robin Soderling,6-3; 6-1; 6-4,R32,118,10,3,45,75,38,45,16,30,2,3,13,54,75,0,1,60,92,32,60,14,32,6,12,13,46,92
2011-01-17 00:00:00.000,Australian Open Australia Grand Slams,HARD,3,Alexandr Dolgopolov,Jo-Wilfried Tsonga,Alexandr Dolgopolov,3-6; 6-3; 3-6; 6-1; 6-1,R32,139,9,3,57,107,45,57,25,50,5,10,20,70,107,6,8,70,116,50,70,15,46,6,15,21,65,116
2011-01-17 00:00:00.000,Australian Open Australia Grand Slams,HARD,3,Jurgen Melzer,Marcos Baghdatis,Jurgen Melzer,6-7(5); 6-2; 6-1; 4-3 RET,R32,141,6,5,76,112,55,76,20,36,6,8,17,75,112,4,0,60,97,38,60,19,37,6,13,17,57,97
2011-01-17 00:00:00.000,Australian Open Australia Grand Slams,HARD,3,Andy Murray,Guillermo Garcia-Lopez,Andy Murray,6-1; 6-1; 6-2,R32,82,10,1,37,58,29,37,12,21,1,2,11,41,58,3,5,45,69,26,45,5,24,3,11,11,31,69
2011-01-17 00:00:00.000,Australian Open Australia Grand Slams,HARD,3,Tomas Berdych,Richard Gasquet,Tomas Berdych,6-2; 7-6(3); 6-2,R32,124,9,1,57,80,44,57,15,23,3,4,14,59,80,10,5,55,101,39,55,18,46,5,10,14,57,101
2011-01-17 00:00:00.000,Australian Open Australia Grand Slams,HARD,3,Fernando Verdasco,Kei Nishikori,Fernando Verdasco,6-2; 6-4; 6-3,R32,120,3,2,59,81,43,59,13,22,3,4,13,56,81,1,3,57,83,36,57,9,26,4,10,14,45,83
2011-01-17 00:00:00.000,Australian Open Australia Grand Slams,HARD,3,Nicolas Almagro,Ivan Ljubicic,Nicolas Almagro,6-4; 7-6(8); 6-3,R32,126,11,2,55,88,46,55,24,33,2,2,16,70,88,11,2,48,87,40,48,21,39,1,3,15,61,87
2011-01-17 00:00:00.000,Australian Open Australia Grand Slams,HARD,3,Novak Djokovic,Viktor Troicki,Novak Djokovic,6-2 RET,R32,40,1,0,17,22,10,17,4,5,0,1,4,14,22,2,1,23,38,15,23,2,15,3,6,4,17,38
2011-01-17 00:00:00.000,Australian Open Australia Grand Slams,HARD,3,Andy Roddick,Robin Haase,Andy Roddick,2-6; 7-6(2); 6-2; 6-2,R32,146,32,3,74,107,58,74,18,33,3,6,18,76,107,10,5,71,115,49,71,19,44,4,9,18,68,115
2011-01-17 00:00:00.000,Australian Open Australia Grand Slams,HARD,3,Stanislas Wawrinka,Gael Monfils,Stanislas Wawrinka,7-6(4); 6-2; 6-3,R32,155,11,2,60,95,45,60,19,35,4,6,14,64,95,3,7,69,120,42,69,22,51,15,21,15,64,120
2011-01-17 00:00:00.000,Australian Open Australia Grand Slams,HARD,3,Tommy Robredo,Sergiy Stakhovsky,Tommy Robredo,5-7; 6-2; 6-4; 6-2,R32,184,3,4,85,136,55,85,29,51,15,19,19,84,136,2,4,82,123,51,82,16,41,6,14,19,67,123
2011-01-17 00:00:00.000,Australian Open Australia Grand Slams,HARD,3,Roger Federer,Xavier Malisse,Roger Federer,6-3; 6-3; 6-1,R32,105,6,1,50,83,35,50,17,33,1,3,13,52,83,4,2,51,85,27,51,12,34,10,17,12,39,85
2011-01-17 00:00:00.000,Australian Open Australia Grand Slams,HARD,3,Rafael Nadal,Marin Cilic,Rafael Nadal,6-2; 6-4; 6-3,R16,151,3,3,62,85,49,62,11,23,2,2,13,60,85,8,4,55,100,42,55,15,45,9,14,14,57,100
2011-01-17 00:00:00.000,Australian Open Australia Grand Slams,HARD,3,David Ferrer,Milos Raonic,David Ferrer,4-6; 6-2; 6-3; 6-4,R16,156,3,1,80,113,62,80,18,33,7,9,19,80,113,15,2,77,127,50,77,26,50,9,14,18,76,127
2011-01-17 00:00:00.000,Australian Open Australia Grand Slams,HARD,3,Alexandr Dolgopolov,Robin Soderling,Alexandr Dolgopolov,1-6; 6-3; 6-1; 4-6; 6-2,R16,156,11,2,55,105,43,55,22,50,3,9,20,65,105,6,6,86,138,51,86,20,52,8,17,21,71,138
2011-01-17 00:00:00.000,Australian Open Australia Grand Slams,HARD,3,Andy Murray,Jurgen Melzer,Andy Murray,6-3; 6-1; 6-1,R16,104,13,3,40,70,33,40,17,30,7,8,12,50,70,1,1,47,72,24,47,8,25,7,14,11,32,72
2011-01-17 00:00:00.000,Australian Open Australia Grand Slams,HARD,3,Tomas Berdych,Fernando Verdasco,Tomas Berdych,6-4; 6-2; 6-3,R16,118,11,1,43,66,38,43,17,23,0,1,14,55,66,10,4,45,79,31,45,15,34,8,13,13,46,79
2011-01-17 00:00:00.000,Australian Open Australia Grand Slams,HARD,3,Novak Djokovic,Nicolas Almagro,Novak Djokovic,6-3; 6-4; 6-0,R16,104,12,4,56,75,48,56,9,19,3,3,13,57,75,5,2,46,78,28,46,14,32,8,13,12,42,78
2011-01-17 00:00:00.000,Australian Open Australia Grand Slams,HARD,3,Stanislas Wawrinka,Andy Roddick,Stanislas Wawrinka,6-3; 6-4; 6-4,R16,142,24,2,39,79,36,39,26,40,3,3,15,62,79,9,4,70,112,50,70,18,42,10,13,14,68,112
2011-01-17 00:00:00.000,Australian Open Australia Grand Slams,HARD,3,Roger Federer,Tommy Robredo,Roger Federer,6-3; 3-6; 6-3; 6-2,R16,145,11,1,73,105,58,73,19,32,1,2,18,77,105,7,1,68,109,49,68,20,41,6,10,17,69,109
2011-01-17 00:00:00.000,Australian Open Australia Grand Slams,HARD,3,David Ferrer,Rafael Nadal,David Ferrer,6-4; 6-2; 6-3,Q,153,8,2,50,73,36,50,13,23,6,8,14,49,73,2,1,69,104,38,69,13,35,8,15,13,51,104
2011-01-17 00:00:00.000,Australian Open Australia Grand Slams,HARD,3,Andy Murray,Alexandr Dolgopolov,Andy Murray,7-5; 6-3; 6-7(3); 6-3,Q,186,9,5,69,118,52,69,30,49,1,5,22,82,118,16,5,92,158,65,92,23,66,11,18,20,88,158
2011-01-17 00:00:00.000,Australian Open Australia Grand Slams,HARD,3,Novak Djokovic,Tomas Berdych,Novak Djokovic,6-1; 7-6(5); 6-1,Q,152,10,1,62,91,51,62,12,29,1,2,14,63,91,6,5,52,96,37,52,15,44,5,10,12,52,96
2011-01-17 00:00:00.000,Australian Open Australia Grand Slams,HARD,3,Roger Federer,Stanislas Wawrinka,Roger Federer,6-1; 6-3; 6-3,Q,107,5,0,58,75,42,58,13,17,1,1,13,55,75,1,0,47,81,27,47,19,34,2,6,12,46,81
2011-01-17 00:00:00.000,Australian Open Australia Grand Slams,HARD,3,Andy Murray,David Ferrer,Andy Murray,4-6; 7-6(2); 6-1; 7-6(2),S,226,9,3,91,151,68,91,22,60,13,18,21,90,151,5,2,94,142,57,94,23,48,5,11,20,80,142
2011-01-17 00:00:00.000,Australian Open Australia Grand Slams,HARD,3,Novak Djokovic,Roger Federer,Novak Djokovic,7-6(3); 7-5; 6-4,S,180,6,5,86,125,63,86,16,39,7,10,17,79,125,5,0,62,105,45,62,20,43,9,14,17,65,105
2011-01-17 00:00:00.000,Australian Open Australia Grand Slams,HARD,3,Novak Djokovic,Andy Murray,Novak Djokovic,6-4; 6-2; 6-3,F,159,5,0,48,75,35,48,15,27,1,4,14,50,75,6,4,59,109,37,59,16,50,11,18,13,53,109
2011-01-31 00:00:00.000,Johannesburg South Africa ATP World Tour 250,HARD,2,Frank Dancevic,Feliciano Lopez,Frank Dancevic,6-7(5); 6-2; 7-6(8),R32,129,22,4,72,115,56,72,26,43,10,10,16,82,115,28,2,62,97,51,62,20,35,2,4,16,71,97
2011-01-31 00:00:00.000,Johannesburg South Africa ATP World Tour 250,HARD,2,Fritz Wolmarans,Igor Sijsling,Fritz Wolmarans,4-6; 6-3; 6-4,R32,93,25,5,57,76,49,57,10,19,1,2,15,59,76,3,5,50,80,39,50,15,30,0,2,14,54,80
2011-01-31 00:00:00.000,Johannesburg South Africa ATP World Tour 250,HARD,2,Denis Gremelmayr,Nikala Scholtz,Denis Gremelmayr,6-4; 7-5,R32,82,7,5,33,58,33,33,14,25,2,2,11,47,58,9,1,37,65,30,37,14,28,3,5,11,44,65
2011-01-31 00:00:00.000,Johannesburg South Africa ATP World Tour 250,HARD,2,Adrian Mannarino,Yuri Schukin,Adrian Mannarino,7-6(4); 7-6(6),R32,134,8,3,40,77,33,40,25,37,2,4,12,58,77,4,5,54,106,39,54,28,52,9,11,12,67,106
2011-01-31 00:00:00.000,Johannesburg South Africa ATP World Tour 250,HARD,2,Kevin Anderson,Stephane Bohli,Kevin Anderson,4-6; 6-4; 6-2,R32,125,14,8,48,84,42,48,18,36,6,7,14,60,84,4,7,41,81,29,41,23,40,2,5,14,52,81
2011-01-31 00:00:00.000,Johannesburg South Africa ATP World Tour 250,HARD,2,Dudi Sela,Edouard Roger-Vasselin,Dudi Sela,1-6; 7-5; 6-4,R32,118,0,6,52,91,39,52,20,39,6,8,14,59,91,4,5,49,89,37,49,21,40,1,3,15,58,89
2011-01-31 00:00:00.000,Johannesburg South Africa ATP World Tour 250,HARD,2,Karol Beck,Brian Dabul,Karol Beck,7-5; 7-6(4),R32,102,5,4,48,81,35,48,19,33,2,3,12,54,81,2,1,38,67,27,38,20,29,1,3,12,47,67
2011-01-31 00:00:00.000,Johannesburg South Africa ATP World Tour 250,HARD,2,Go Soeda,Rainer Schuettler,Go Soeda,3-6; 6-4; 6-4,R32,137,7,5,40,99,30,40,34,59,4,6,14,64,99,5,4,59,95,40,59,21,36,8,11,15,61,95
2011-01-31 00:00:00.000,Johannesburg South Africa ATP World Tour 250,HARD,2,Michal Przysiezny,Martin Fischer,Michal Przysiezny,6-1; 6-2,R32,54,6,3,15,39,13,15,17,24,0,1,8,30,39,2,5,28,44,15,28,3,16,5,10,7,18,44
2011-01-31 00:00:00.000,Johannesburg South Africa ATP World Tour 250,HARD,2,Rik De Voest,Stefano Galvani,Rik De Voest,6-3; 5-7; 7-6(6),R32,160,5,1,59,114,45,59,30,55,6,9,17,75,114,1,6,64,115,41,64,31,51,6,9,16,72,115
2011-01-31 00:00:00.000,Johannesburg South Africa ATP World Tour 250,HARD,2,Somdev Devvarman,Raven Klaasen,Somdev Devvarman,6-4; 6-3,R32,83,1,0,37,50,27,37,12,13,1,1,9,39,50,2,2,45,68,29,45,11,23,6,9,10,40,68
2011-01-31 00:00:00.000,Johannesburg South Africa ATP World Tour 250,HARD,2,Jesse Huta Galung,Janko Tipsarevic,Jesse Huta Galung,6-7(4); 6-4; 7-6(4),R32,163,17,2,79,132,63,79,20,53,7,10,17,83,132,11,2,51,98,41,51,26,47,1,5,17,67,98
2011-01-31 00:00:00.000,Johannesburg South Africa ATP World Tour 250,HARD,2,Dustin Brown,Florent Serra,Dustin Brown,6-4; 6-4,R32,55,15,5,33,51,27,33,11,18,1,2,10,38,51,4,2,43,64,29,43,8,21,8,11,10,37,64
2011-01-31 00:00:00.000,Johannesburg South Africa ATP World Tour 250,HARD,2,Izak Van der Merwe,Stephane Robert,Izak Van der Merwe,6-3; 6-2,R32,66,5,7,30,56,24,30,16,26,1,1,9,40,56,1,6,21,51,16,21,10,30,2,5,8,26,51
2011-01-31 00:00:00.000,Johannesburg South Africa ATP World Tour 250,HARD,2,Simon Greul,Thiago Alves,Simon Greul,6-2; 7-5,R32,78,9,4,28,53,22,28,18,25,0,1,10,40,53,2,7,42,75,28,42,13,33,8,12,10,41,75
2011-01-31 00:00:00.000,Johannesburg South Africa ATP World Tour 250,HARD,2,Milos Raonic,Yen-Hsun Lu,Milos Raonic,6-3; 6-3,R32,76,14,1,27,42,24,27,12,15,0,0,9,36,42,1,5,28,62,21,28,15,34,0,3,9,36,62
2011-01-31 00:00:00.000,Johannesburg South Africa ATP World Tour 250,HARD,2,Frank Dancevic,Fritz Wolmarans,Frank Dancevic,7-6(4); 6-3,R16,96,6,5,44,75,35,44,14,31,1,2,11,49,75,9,3,42,64,28,42,13,22,5,7,10,41,64
2011-01-31 00:00:00.000,Johannesburg South Africa ATP World Tour 250,HARD,2,Adrian Mannarino,Denis Gremelmayr,Adrian Mannarino,6-7(2); 6-4; 6-4,R16,128,3,4,52,93,37,52,24,41,2,4,16,61,93,4,4,54,97,39,54,20,43,5,9,16,59,97
2011-01-31 00:00:00.000,Johannesburg South Africa ATP World Tour 250,HARD,2,Kevin Anderson,Dudi Sela,Kevin Anderson,6-2; 6-4,R16,69,13,2,35,49,27,35,8,14,0,1,9,35,49,1,5,31,51,21,31,4,20,1,5,9,25,51
2011-01-31 00:00:00.000,Johannesburg South Africa ATP World Tour 250,HARD,2,Karol Beck,Go Soeda,Karol Beck,3-6; 7-5; 6-0,R16,127,7,7,45,85,34,45,21,40,3,5,13,55,85,3,5,46,90,25,46,24,44,5,10,14,49,90
2011-01-31 00:00:00.000,Johannesburg South Africa ATP World Tour 250,HARD,2,Rik De Voest,Michal Przysiezny,Rik De Voest,6-3; 6-4,R16,82,4,0,36,67,28,36,17,31,7,8,10,45,67,2,2,25,53,17,25,14,28,3,6,9,31,53
2011-01-31 00:00:00.000,Johannesburg South Africa ATP World Tour 250,HARD,2,Somdev Devvarman,Jesse Huta Galung,Somdev Devvarman,6-3; 6-4,R16,89,3,0,50,72,31,50,16,22,5,6,10,47,72,4,2,31,67,22,31,16,36,3,6,9,38,67
2011-01-31 00:00:00.000,Johannesburg South Africa ATP World Tour 250,HARD,2,Izak Van der Merwe,Dustin Brown,Izak Van der Merwe,4-6; 7-5; 6-3,R16,119,4,14,55,107,40,55,23,52,9,13,16,63,107,9,5,49,90,33,49,22,41,8,13,15,55,90
2011-01-31 00:00:00.000,Johannesburg South Africa ATP World Tour 250,HARD,2,Simon Greul,Milos Raonic,Simon Greul,7-6(5); 6-4,R16,106,7,5,48,83,38,48,20,35,7,7,11,58,83,11,2,41,75,30,41,22,34,5,6,11,52,75
2011-01-31 00:00:00.000,Johannesburg South Africa ATP World Tour 250,HARD,2,Adrian Mannarino,Frank Dancevic,Adrian Mannarino,6-3; 6-2,Q,54,2,2,33,52,26,33,13,19,1,1,9,39,52,3,4,22,40,15,22,7,18,0,3,8,22,40
2011-01-31 00:00:00.000,Johannesburg South Africa ATP World Tour 250,HARD,2,Kevin Anderson,Karol Beck,Kevin Anderson,6-3; 6-1,Q,59,7,1,28,45,22,28,13,17,2,2,8,35,45,7,3,20,43,13,20,9,23,0,4,8,22,43
2011-01-31 00:00:00.000,Johannesburg South Africa ATP World Tour 250,HARD,2,Somdev Devvarman,Rik De Voest,Somdev Devvarman,3-6; 7-6(5); 6-1,Q,145,3,4,51,91,31,51,24,40,4,8,13,55,91,5,3,61,112,43,61,18,51,7,13,15,61,112
2011-01-31 00:00:00.000,Johannesburg South Africa ATP World Tour 250,HARD,2,Izak Van der Merwe,Simon Greul,Izak Van der Merwe,7-6(5); 6-2,Q,101,11,4,43,72,32,43,15,29,2,3,10,47,72,2,7,34,67,22,34,18,33,5,8,10,40,67
2011-01-31 00:00:00.000,Johannesburg South Africa ATP World Tour 250,HARD,2,Kevin Anderson,Adrian Mannarino,Kevin Anderson,6-7(3); 6-0; 6-4,S,124,19,4,47,73,40,47,15,26,1,2,14,55,73,3,2,50,90,32,50,19,40,3,8,14,51,90
2011-01-31 00:00:00.000,Johannesburg South Africa ATP World Tour 250,HARD,2,Somdev Devvarman,Izak Van der Merwe,Somdev Devvarman,6-2; 6-4,S,87,2,0,31,48,24,31,13,17,2,2,9,37,48,5,5,32,68,23,32,16,36,6,9,9,39,68
2011-01-31 00:00:00.000,Johannesburg South Africa ATP World Tour 250,HARD,2,Kevin Anderson,Somdev Devvarman,Kevin Anderson,4-6; 6-3; 6-2,F,139,11,3,60,95,46,60,16,35,7,9,14,62,95,7,1,52,83,35,52,12,31,6,10,13,47,83
2011-01-31 00:00:00.000,Santiago Chile ATP World Tour 250,CLAY,2,David Nalbandian,Carlos Berlocq,David Nalbandian,6-2; 2-6; 6-2,R32,117,2,10,48,95,34,48,22,47,8,11,12,56,95,4,1,40,67,27,40,12,27,3,8,12,39,67
2011-01-31 00:00:00.000,Santiago Chile ATP World Tour 250,CLAY,2,Horacio Zeballos,Ricardo Hocevar,Horacio Zeballos,7-6(2); 6-4,R32,108,7,1,44,72,33,44,17,28,4,5,11,50,72,6,2,47,78,36,47,13,31,1,3,11,49,78
2011-01-31 00:00:00.000,Santiago Chile ATP World Tour 250,CLAY,2,Pablo Andujar,Peter Luczak,Pablo Andujar,6-4; 6-4,R32,93,1,5,34,54,23,34,13,20,2,4,10,36,54,5,5,32,60,22,32,11,28,1,5,10,33,60
2011-01-31 00:00:00.000,Santiago Chile ATP World Tour 250,CLAY,2,Potito Starace,Paul Capdeville,Potito Starace,3-6; 6-3; 6-4,R32,130,5,2,63,89,39,63,14,26,8,11,14,53,89,4,5,48,90,32,48,21,42,6,10,14,53,90
2011-01-31 00:00:00.000,Santiago Chile ATP World Tour 250,CLAY,2,Juan Ignacio Chela,Jorge Aguilar,Juan Ignacio Chela,6-3; 7-5,R32,130,2,4,63,107,41,63,22,44,12,14,11,63,107,1,2,31,63,23,31,11,32,3,7,10,34,63
2011-01-31 00:00:00.000,Santiago Chile ATP World Tour 250,CLAY,2,Caio Zampieri,Nicolas Massu,Caio Zampieri,7-6(7); 7-5,R32,158,5,2,50,83,36,50,16,33,5,7,12,52,83,1,1,60,94,36,60,17,34,6,9,12,53,94
2011-01-31 00:00:00.000,Santiago Chile ATP World Tour 250,CLAY,2,Igor Andreev,Eduardo Schwank,Igor Andreev,6-3; 7-6(4),R32,102,5,1,47,70,35,47,17,23,0,0,11,52,70,3,3,49,68,35,49,10,19,3,4,10,45,68
2011-01-31 00:00:00.000,Santiago Chile ATP World Tour 250,CLAY,2,Santiago Giraldo,Facundo Bagnis,Santiago Giraldo,2-6; 6-3; 6-2,R32,99,2,3,40,74,29,40,19,34,2,5,13,48,74,3,11,31,66,23,31,15,35,2,6,12,38,66
2011-01-31 00:00:00.000,Santiago Chile ATP World Tour 250,CLAY,2,Fabio Fognini,Lukasz Kubot,Fabio Fognini,7-6(6); 6-2,R32,106,2,5,42,64,35,42,10,22,2,3,10,45,64,2,6,36,70,27,36,14,34,4,7,10,41,70
2011-01-31 00:00:00.000,Santiago Chile ATP World Tour 250,CLAY,2,Albert Ramos,Leonardo Mayer,Albert Ramos,6-4; 6-4,R32,86,0,1,30,56,25,30,17,26,3,3,10,42,56,1,5,36,60,26,36,14,24,6,8,10,40,60
2011-01-31 00:00:00.000,Santiago Chile ATP World Tour 250,CLAY,2,Rui Machado,Felipe Rios,Rui Machado,6-2; 6-0,R32,58,2,5,21,42,17,21,12,21,0,0,7,29,42,0,6,29,44,15,29,3,15,0,5,7,18,44
2011-01-31 00:00:00.000,Santiago Chile ATP World Tour 250,CLAY,2,Thomaz Bellucci,Filippo Volandri,Thomaz Bellucci,6-2; 6-2,R32,62,2,3,22,45,15,22,15,23,2,3,8,30,45,1,2,27,49,15,27,7,22,0,5,8,22,49
2011-01-31 00:00:00.000,Santiago Chile ATP World Tour 250,CLAY,2,Tommy Robredo,Frederico Gil,Tommy Robredo,2-6; 6-3; 6-4,R32,112,5,4,49,73,32,49,14,24,5,9,14,46,73,5,3,45,81,31,45,18,36,4,8,13,49,81
2011-01-31 00:00:00.000,Santiago Chile ATP World Tour 250,CLAY,2,Ricardo Mello,Ruben Ramirez Hidalgo,Ricardo Mello,6-4; 6-7(5); 7-6(6),R32,172,3,6,69,122,49,69,23,53,1,5,17,72,122,9,9,63,111,45,63,21,48,3,8,17,66,111
2011-01-31 00:00:00.000,Santiago Chile ATP World Tour 250,CLAY,2,Joao Souza,Pablo Cuevas,Joao Souza,6-4; 7-5,R32,109,5,1,45,77,30,45,13,32,1,4,11,43,77,5,0,45,81,26,45,17,36,5,10,11,43,81
2011-01-31 00:00:00.000,Santiago Chile ATP World Tour 250,CLAY,2,Maximo Gonzalez,Juan Monaco,Maximo Gonzalez,6-4; 3-6; 6-4,R32,164,1,4,57,105,33,57,25,48,7,12,15,58,105,6,6,65,98,43,65,12,33,5,10,14,55,98
2011-01-31 00:00:00.000,Santiago Chile ATP World Tour 250,CLAY,2,Horacio Zeballos,David Nalbandian,Horacio Zeballos,6-2; 7-5,R16,80,8,3,37,65,29,37,11,28,5,7,10,40,65,0,4,34,57,18,34,13,23,4,9,10,31,57
2011-01-31 00:00:00.000,Santiago Chile ATP World Tour 250,CLAY,2,Potito Starace,Pablo Andujar,Potito Starace,6-4; 6-1,R16,87,3,2,43,65,33,43,11,22,5,5,9,44,65,2,5,24,46,18,24,10,22,1,4,8,28,46
2011-01-31 00:00:00.000,Santiago Chile ATP World Tour 250,CLAY,2,Juan Ignacio Chela,Caio Zampieri,Juan Ignacio Chela,6-2; 6-3,R16,84,0,6,30,56,23,30,11,26,4,6,8,34,56,0,4,31,58,17,31,7,27,6,12,9,24,58
2011-01-31 00:00:00.000,Santiago Chile ATP World Tour 250,CLAY,2,Santiago Giraldo,Igor Andreev,Santiago Giraldo,7-6(7); 4-6; 6-2,R16,149,0,1,61,103,42,61,26,42,2,4,15,68,103,8,9,49,99,37,49,25,50,7,10,15,62,99
2011-01-31 00:00:00.000,Santiago Chile ATP World Tour 250,CLAY,2,Fabio Fognini,Albert Ramos,Fabio Fognini,3-6; 7-5; 6-4,R16,176,4,5,68,106,48,68,13,38,11,15,15,61,106,5,7,63,115,45,63,20,52,10,15,16,65,115
2011-01-31 00:00:00.000,Santiago Chile ATP World Tour 250,CLAY,2,Thomaz Bellucci,Rui Machado,Thomaz Bellucci,7-5; 1-6; 6-1,R16,114,3,2,40,75,30,40,20,35,4,6,13,50,75,1,2,58,82,38,58,13,24,5,8,13,51,82
2011-01-31 00:00:00.000,Santiago Chile ATP World Tour 250,CLAY,2,Tommy Robredo,Ricardo Mello,Tommy Robredo,6-0; 7-6(7),R16,85,2,3,31,58,26,31,14,27,4,5,9,40,58,0,4,29,62,21,29,14,33,4,8,9,35,62
2011-01-31 00:00:00.000,Santiago Chile ATP World Tour 250,CLAY,2,Maximo Gonzalez,Joao Souza,Maximo Gonzalez,4-6; 6-3; 6-1,R16,127,2,2,52,78,36,52,18,26,2,3,13,54,78,8,6,43,82,33,43,16,39,6,10,13,49,82
2011-01-31 00:00:00.000,Santiago Chile ATP World Tour 250,CLAY,2,Potito Starace,Horacio Zeballos,Potito Starace,6-7(9); 6-3; 7-6(2),Q,163,3,0,85,115,64,85,20,30,6,6,17,84,115,11,4,73,113,54,73,19,40,5,6,16,73,113
2011-01-31 00:00:00.000,Santiago Chile ATP World Tour 250,CLAY,2,Santiago Giraldo,Juan Ignacio Chela,Santiago Giraldo,6-4; 6-3,Q,86,6,0,38,66,26,38,16,28,4,5,9,42,66,1,3,37,60,23,37,12,23,6,10,10,35,60
2011-01-31 00:00:00.000,Santiago Chile ATP World Tour 250,CLAY,2,Fabio Fognini,Thomaz Bellucci,Fabio Fognini,1-6; 6-2; 7-6(0),Q,140,3,8,65,106,40,65,19,41,7,13,14,59,106,7,2,47,82,34,47,12,35,2,7,13,46,82
2011-01-31 00:00:00.000,Santiago Chile ATP World Tour 250,CLAY,2,Tommy Robredo,Maximo Gonzalez,Tommy Robredo,6-3; 6-1,Q,68,5,1,31,49,26,31,12,18,3,3,8,38,49,1,1,41,53,21,41,5,12,3,7,8,26,53
2011-01-31 00:00:00.000,Santiago Chile ATP World Tour 250,CLAY,2,Santiago Giraldo,Potito Starace,Santiago Giraldo,4-6; 7-6(2); 6-1,S,125,3,1,52,84,40,52,19,32,2,3,14,59,84,2,2,65,101,38,65,22,36,5,8,15,60,101
2011-01-31 00:00:00.000,Santiago Chile ATP World Tour 250,CLAY,2,Tommy Robredo,Fabio Fognini,Tommy Robredo,4-6; 6-2; 6-3,S,128,3,9,54,93,36,54,20,39,10,14,14,56,93,0,6,59,97,42,59,9,38,9,15,13,51,97
2011-01-31 00:00:00.000,Santiago Chile ATP World Tour 250,CLAY,2,Tommy Robredo,Santiago Giraldo,Tommy Robredo,6-2; 2-6; 7-6(5),F,137,3,9,52,97,37,52,20,45,5,9,14,57,97,5,2,43,90,32,43,22,47,3,7,14,54,90
2011-01-31 00:00:00.000,Zagreb Croatia ATP World Tour 250,HARD,2,Marin Cilic,N/A Bye,Marin Cilic,,R32,0,0,0,0,0,0,0,0,0,0,0,0,0,0,0,0,0,0,0,0,0,0,0,0,0,0,0
2011-01-31 00:00:00.000,Zagreb Croatia ATP World Tour 250,HARD,2,Igor Kunitsyn,Jaroslav Pospisil,Igor Kunitsyn,6-3; 6-2,R32,76,3,1,26,42,19,26,7,16,3,6,8,26,42,2,11,29,62,16,29,8,33,7,14,9,24,62
2011-01-31 00:00:00.000,Zagreb Croatia ATP World Tour 250,HARD,2,Radek Stepanek,Stefan Koubek,Radek Stepanek,6-3; 6-2,R32,58,1,1,24,43,15,24,15,19,0,1,8,30,43,0,2,37,50,19,37,4,13,1,6,9,23,50
2011-01-31 00:00:00.000,Zagreb Croatia ATP World Tour 250,HARD,2,Florian Mayer,Franko Skugor,Florian Mayer,3-6; 6-3; 7-6(6),R32,141,5,3,62,99,42,62,20,37,5,8,15,62,99,6,1,75,117,53,75,19,42,12,15,15,72,117
2011-01-31 00:00:00.000,Zagreb Croatia ATP World Tour 250,HARD,2,Richard Gasquet,N/A Bye,Richard Gasquet,,R32,0,0,0,0,0,0,0,0,0,0,0,0,0,0,0,0,0,0,0,0,0,0,0,0,0,0,0
2011-01-31 00:00:00.000,Zagreb Croatia ATP World Tour 250,HARD,2,Arnaud Clement,Mikhail Kukushkin,Arnaud Clement,6-4; 6-3,R32,102,5,3,35,63,25,35,16,28,4,5,9,41,63,2,1,39,68,26,39,12,29,5,9,10,38,68
2011-01-31 00:00:00.000,Zagreb Croatia ATP World Tour 250,HARD,2,Blaz Kavcic,Mischa Zverev,Blaz Kavcic,6-2; 7-5,R32,76,6,2,34,55,24,34,13,21,0,1,10,37,55,1,5,32,53,20,32,8,21,3,7,10,28,53
2011-01-31 00:00:00.000,Zagreb Croatia ATP World Tour 250,HARD,2,Michael Berrer,Nikola Mektic,Michael Berrer,7-5; 6-1,R32,73,8,2,36,56,27,36,14,20,0,0,10,41,56,5,0,33,54,22,33,11,21,1,4,9,33,54
2011-01-31 00:00:00.000,Zagreb Croatia ATP World Tour 250,HARD,2,Philipp Petzschner,Jan Hajek,Philipp Petzschner,6-3; 6-3,R32,72,8,3,23,55,19,23,20,32,1,1,9,39,55,3,2,43,66,24,43,15,23,8,11,9,39,66
2011-01-31 00:00:00.000,Zagreb Croatia ATP World Tour 250,HARD,2,Alex Bogomolov Jr.,Antonio Veic,Alex Bogomolov Jr.,2-6; 7-6(4); 7-6(2),R32,169,1,4,84,117,49,84,18,33,7,13,16,67,117,12,6,64,110,48,64,17,46,10,14,16,65,110
2011-01-31 00:00:00.000,Zagreb Croatia ATP World Tour 250,HARD,2,Lukas Lacko,Marsel Ilhan,Lukas Lacko,4-6; 6-4; 7-5,R32,126,10,8,57,99,44,57,24,42,5,7,16,68,99,8,5,67,101,49,67,16,34,3,6,16,65,101
2011-01-31 00:00:00.000,Zagreb Croatia ATP World Tour 250,HARD,2,Guillermo Garcia-Lopez,N/A Bye,Guillermo Garcia-Lopez,,R32,0,0,0,0,0,0,0,0,0,0,0,0,0,0,0,0,0,0,0,0,0,0,0,0,0,0,0
2011-01-31 00:00:00.000,Zagreb Croatia ATP World Tour 250,HARD,2,Ivan Dodig,Marcel Granollers,Ivan Dodig,6-3; 6-2,R32,66,10,3,26,47,22,26,13,21,2,3,9,35,47,0,2,25,44,15,25,7,19,1,5,8,22,44
2011-01-31 00:00:00.000,Zagreb Croatia ATP World Tour 250,HARD,2,Illya Marchenko,Dusan Lajovic,Illya Marchenko,7-5; 6-2,R32,78,5,2,31,51,21,31,12,20,1,3,10,33,51,3,2,45,68,24,45,7,23,6,11,10,31,68
2011-01-31 00:00:00.000,Zagreb Croatia ATP World Tour 250,HARD,2,Daniel Brands,Ivo Karlovic,Daniel Brands,7-5; 6-7(3); 7-6(1),R32,120,16,2,74,98,64,74,16,24,1,1,18,80,98,32,5,73,101,59,73,18,28,1,2,18,77,101
2011-01-31 00:00:00.000,Zagreb Croatia ATP World Tour 250,HARD,2,Ivan Ljubicic,N/A Bye,Ivan Ljubicic,,R32,0,0,0,0,0,0,0,0,0,0,0,0,0,0,0,0,0,0,0,0,0,0,0,0,0,0,0
2011-01-31 00:00:00.000,Zagreb Croatia ATP World Tour 250,HARD,2,Marin Cilic,Igor Kunitsyn,Marin Cilic,7-6(3); 6-2,R16,98,10,1,32,61,25,32,18,29,1,2,10,43,61,5,2,44,78,28,44,15,34,5,8,10,43,78
2011-01-31 00:00:00.000,Zagreb Croatia ATP World Tour 250,HARD,2,Florian Mayer,Radek Stepanek,Florian Mayer,7-6(3); 6-3,R16,103,3,2,55,82,40,55,17,27,5,5,10,57,82,2,5,48,77,34,48,14,29,4,6,11,48,77
2011-01-31 00:00:00.000,Zagreb Croatia ATP World Tour 250,HARD,2,Richard Gasquet,Arnaud Clement,Richard Gasquet,W/O,R16,0,0,0,0,0,0,0,0,0,0,0,0,0,0,0,0,0,0,0,0,0,0,0,0,0,0,0
2011-01-31 00:00:00.000,Zagreb Croatia ATP World Tour 250,HARD,2,Michael Berrer,Blaz Kavcic,Michael Berrer,6-4; 6-1,R16,71,6,1,31,41,22,31,7,10,1,2,8,29,41,5,2,43,68,23,43,12,25,8,13,9,35,68
2011-01-31 00:00:00.000,Zagreb Croatia ATP World Tour 250,HARD,2,Alex Bogomolov Jr.,Philipp Petzschner,Alex Bogomolov Jr.,6-1; 6-2,R16,53,1,3,34,47,28,34,7,13,1,1,8,35,47,7,3,23,44,12,23,8,21,4,8,7,20,44
2011-01-31 00:00:00.000,Zagreb Croatia ATP World Tour 250,HARD,2,Guillermo Garcia-Lopez,Lukas Lacko,Guillermo Garcia-Lopez,6-1; 2-6; 6-2,R16,87,6,6,36,71,27,36,17,35,5,9,12,44,71,3,1,39,69,22,39,11,30,2,8,11,33,69
2011-01-31 00:00:00.000,Zagreb Croatia ATP World Tour 250,HARD,2,Ivan Dodig,Illya Marchenko,Ivan Dodig,6-2; 6-3,R16,80,3,0,34,52,27,34,9,18,2,3,9,36,52,0,4,28,50,21,28,7,22,3,7,8,28,50
2011-01-31 00:00:00.000,Zagreb Croatia ATP World Tour 250,HARD,2,Ivan Ljubicic,Daniel Brands,Ivan Ljubicic,6-2; 6-3,R16,68,7,2,26,51,22,26,17,25,0,0,9,39,51,4,1,36,59,21,36,11,23,2,5,8,32,59
2011-01-31 00:00:00.000,Zagreb Croatia ATP World Tour 250,HARD,2,Florian Mayer,Marin Cilic,Florian Mayer,6-3; 6-4,Q,81,3,1,43,64,29,43,13,21,4,5,10,42,64,5,4,31,51,22,31,8,20,1,4,9,30,51
2011-01-31 00:00:00.000,Zagreb Croatia ATP World Tour 250,HARD,2,Michael Berrer,Richard Gasquet,Michael Berrer,5-2 RET,Q,34,1,1,13,22,11,13,5,9,2,2,3,16,22,3,0,23,34,13,23,4,11,4,6,4,17,34
2011-01-31 00:00:00.000,Zagreb Croatia ATP World Tour 250,HARD,2,Guillermo Garcia-Lopez,Alex Bogomolov Jr.,Guillermo Garcia-Lopez,6-2; 7-6(6),Q,99,12,3,47,79,36,47,15,32,9,11,10,51,79,2,2,54,68,34,54,5,14,2,6,10,39,68
2011-01-31 00:00:00.000,Zagreb Croatia ATP World Tour 250,HARD,2,Ivan Dodig,Ivan Ljubicic,Ivan Dodig,6-4; 6-4,Q,110,8,1,44,74,37,44,14,30,4,4,10,51,74,4,1,42,73,29,42,14,31,7,9,10,43,73
2011-01-31 00:00:00.000,Zagreb Croatia ATP World Tour 250,HARD,2,Michael Berrer,Florian Mayer,Michael Berrer,6-1; 6-4,S,59,7,1,32,47,28,32,10,15,1,1,9,38,47,1,1,42,60,22,42,9,18,5,8,8,31,60
2011-01-31 00:00:00.000,Zagreb Croatia ATP World Tour 250,HARD,2,Ivan Dodig,Guillermo Garcia-Lopez,Ivan Dodig,4-6; 7-6(5); 6-4,S,172,10,4,63,106,52,63,17,43,7,10,16,69,106,7,5,59,106,42,59,26,47,7,10,16,68,106
2011-01-31 00:00:00.000,Zagreb Croatia ATP World Tour 250,HARD,2,Ivan Dodig,Michael Berrer,Ivan Dodig,6-3; 6-4,F,98,16,7,55,83,45,55,8,28,7,7,10,53,83,2,1,40,55,29,40,6,15,1,3,9,35,55
2011-02-07 00:00:00.000,Costa Do Sauipe Brazil ATP World Tour 250,CLAY,2,Nicolas Almagro,N/A Bye,Nicolas Almagro,,R32,0,0,0,0,0,0,0,0,0,0,0,0,0,0,0,0,0,0,0,0,0,0,0,0,0,0,0
2011-02-07 00:00:00.000,Costa Do Sauipe Brazil ATP World Tour 250,CLAY,2,Joao Souza,Guilherme Clezar,Joao Souza,6-3; 6-2,R32,71,5,1,33,48,25,33,13,15,1,1,9,38,48,3,1,41,54,23,41,6,13,2,5,8,29,54
2011-02-07 00:00:00.000,Costa Do Sauipe Brazil ATP World Tour 250,CLAY,2,Rui Machado,Facundo Bagnis,Rui Machado,6-4; 6-2,R32,102,2,1,53,70,38,53,8,17,7,7,9,46,70,1,3,32,65,20,32,17,33,5,8,9,37,65
2011-02-07 00:00:00.000,Costa Do Sauipe Brazil ATP World Tour 250,CLAY,2,Filippo Volandri,Victor Hanescu,Filippo Volandri,7-5; 6-1,R32,88,0,2,55,72,38,55,8,17,2,3,10,46,72,0,1,37,53,21,37,6,16,1,5,9,27,53
2011-02-07 00:00:00.000,Costa Do Sauipe Brazil ATP World Tour 250,CLAY,2,Thomaz Bellucci,N/A Bye,Thomaz Bellucci,,R32,0,0,0,0,0,0,0,0,0,0,0,0,0,0,0,0,0,0,0,0,0,0,0,0,0,0,0
2011-02-07 00:00:00.000,Costa Do Sauipe Brazil ATP World Tour 250,CLAY,2,Carlos Berlocq,Andre Ghem,Carlos Berlocq,6-4; 6-3,R32,89,2,2,27,50,23,27,14,23,1,1,9,37,50,3,1,32,58,23,32,12,26,2,5,10,35,58
2011-02-07 00:00:00.000,Costa Do Sauipe Brazil ATP World Tour 250,CLAY,2,Lukasz Kubot,Eduardo Schwank,Lukasz Kubot,6-7(5); 7-5; 7-6(2),R32,189,6,5,66,118,52,66,25,52,4,7,18,77,118,4,2,76,119,48,76,28,43,7,11,18,76,119
2011-02-07 00:00:00.000,Costa Do Sauipe Brazil ATP World Tour 250,CLAY,2,Juan Ignacio Chela,Rogerio Dutra Silva,Juan Ignacio Chela,6-7(4); 7-6(4); 6-3,R32,177,2,1,75,100,56,75,14,25,1,2,16,70,100,6,1,75,117,55,75,19,42,5,8,17,74,117
2011-02-07 00:00:00.000,Costa Do Sauipe Brazil ATP World Tour 250,CLAY,2,Potito Starace,Pablo Cuevas,Potito Starace,6-4; 5-7; 6-4,R32,129,3,1,70,85,51,70,6,15,1,5,16,57,85,4,3,67,109,47,67,17,42,7,12,16,64,109
2011-02-07 00:00:00.000,Costa Do Sauipe Brazil ATP World Tour 250,CLAY,2,Leonardo Mayer,Igor Andreev,Leonardo Mayer,4-6; 6-4; 7-6(2),R32,154,4,5,55,96,42,55,23,41,6,8,16,65,96,5,2,54,104,44,54,24,50,5,7,16,68,104
2011-02-07 00:00:00.000,Costa Do Sauipe Brazil ATP World Tour 250,CLAY,2,Ruben Ramirez Hidalgo,Fernando Romboli,Ruben Ramirez Hidalgo,6-4; 6-2,R32,78,2,2,30,52,24,30,12,22,0,1,9,36,52,1,3,29,53,17,29,11,24,2,6,9,28,53
2011-02-07 00:00:00.000,Costa Do Sauipe Brazil ATP World Tour 250,CLAY,2,Alexandr Dolgopolov,N/A Bye,Alexandr Dolgopolov,,R32,0,0,0,0,0,0,0,0,0,0,0,0,0,0,0,0,0,0,0,0,0,0,0,0,0,0,0
2011-02-07 00:00:00.000,Costa Do Sauipe Brazil ATP World Tour 250,CLAY,2,Tommy Robredo,Fabio Fognini,Tommy Robredo,6-3; 6-7(4); 6-3,R32,151,9,1,57,91,43,57,23,34,3,5,16,66,91,2,2,58,103,37,58,25,45,9,13,14,62,103
2011-02-07 00:00:00.000,Costa Do Sauipe Brazil ATP World Tour 250,CLAY,2,Pablo Andujar,Daniel Gimeno-Traver,Pablo Andujar,6-3; 6-1,R32,78,0,0,37,50,25,37,9,13,1,1,8,34,50,1,6,38,65,21,38,13,27,4,8,8,34,65
2011-02-07 00:00:00.000,Costa Do Sauipe Brazil ATP World Tour 250,CLAY,2,Ricardo Mello,Santiago Giraldo,Ricardo Mello,6-4; 6-3,R32,73,2,0,37,62,29,37,14,25,5,6,10,43,62,5,1,30,49,21,30,9,19,4,7,9,30,49
2011-02-07 00:00:00.000,Costa Do Sauipe Brazil ATP World Tour 250,CLAY,2,Albert Montanes,N/A Bye,Albert Montanes,,R32,0,0,0,0,0,0,0,0,0,0,0,0,0,0,0,0,0,0,0,0,0,0,0,0,0,0,0
2011-02-07 00:00:00.000,Costa Do Sauipe Brazil ATP World Tour 250,CLAY,2,Nicolas Almagro,Joao Souza,Nicolas Almagro,6-2; 6-2,R16,71,7,1,21,51,18,21,17,30,1,1,8,35,51,3,1,28,48,18,28,7,20,4,8,8,25,48
2011-02-07 00:00:00.000,Costa Do Sauipe Brazil ATP World Tour 250,CLAY,2,Rui Machado,Filippo Volandri,Rui Machado,6-2; 6-1,R16,72,0,1,32,38,24,32,4,6,0,0,7,28,38,0,1,32,55,19,32,7,23,8,13,8,26,55
2011-02-07 00:00:00.000,Costa Do Sauipe Brazil ATP World Tour 250,CLAY,2,Thomaz Bellucci,Carlos Berlocq,Thomaz Bellucci,6-4; 7-5,R16,104,6,3,36,60,31,36,10,24,2,4,11,41,60,2,1,41,66,25,41,12,25,4,8,11,37,66
2011-02-07 00:00:00.000,Costa Do Sauipe Brazil ATP World Tour 250,CLAY,2,Juan Ignacio Chela,Lukasz Kubot,Juan Ignacio Chela,3-6; 7-5; 6-3,R16,164,1,1,61,98,39,61,17,37,7,12,15,56,98,4,6,69,104,44,69,13,35,6,12,15,57,104
2011-02-07 00:00:00.000,Costa Do Sauipe Brazil ATP World Tour 250,CLAY,2,Potito Starace,Leonardo Mayer,Potito Starace,6-4; 7-6(9),R16,109,2,0,61,79,43,61,11,18,1,1,11,54,79,3,1,55,74,41,55,9,19,2,3,11,50,74
2011-02-07 00:00:00.000,Costa Do Sauipe Brazil ATP World Tour 250,CLAY,2,Alexandr Dolgopolov,Ruben Ramirez Hidalgo,Alexandr Dolgopolov,7-5; 6-4,R16,97,14,1,39,66,31,39,17,27,2,2,11,48,66,5,1,40,70,30,40,14,30,4,6,11,44,70
2011-02-07 00:00:00.000,Costa Do Sauipe Brazil ATP World Tour 250,CLAY,2,Pablo Andujar,Tommy Robredo,Pablo Andujar,6-4; 5-7; 6-2,R16,152,1,2,77,109,47,77,19,32,8,11,15,66,109,4,2,48,82,32,48,20,34,3,8,15,52,82
2011-02-07 00:00:00.000,Costa Do Sauipe Brazil ATP World Tour 250,CLAY,2,Ricardo Mello,Albert Montanes,Ricardo Mello,6-3; 6-3,R16,66,2,0,27,43,24,27,12,16,0,0,9,36,43,1,4,33,59,24,33,11,26,3,6,9,35,59
2011-02-07 00:00:00.000,Costa Do Sauipe Brazil ATP World Tour 250,CLAY,2,Nicolas Almagro,Rui Machado,Nicolas Almagro,6-2; 6-4,Q,86,12,9,34,72,27,34,16,38,6,8,9,43,72,1,1,38,49,21,38,2,11,4,9,9,23,49
2011-02-07 00:00:00.000,Costa Do Sauipe Brazil ATP World Tour 250,CLAY,2,Juan Ignacio Chela,Thomaz Bellucci,Juan Ignacio Chela,6-1; 6-2,Q,81,0,1,34,53,24,34,12,19,3,3,8,36,53,4,3,24,40,13,24,7,16,4,8,7,20,40
2011-02-07 00:00:00.000,Costa Do Sauipe Brazil ATP World Tour 250,CLAY,2,Alexandr Dolgopolov,Potito Starace,Alexandr Dolgopolov,6-3; 6-4,Q,74,10,3,30,63,24,30,17,33,6,7,10,41,63,3,1,41,53,24,41,6,12,0,3,9,30,53
2011-02-07 00:00:00.000,Costa Do Sauipe Brazil ATP World Tour 250,CLAY,2,Ricardo Mello,Pablo Andujar,Ricardo Mello,6-1; 6-0,Q,59,4,0,29,43,21,29,10,14,1,1,7,31,43,1,4,18,33,7,18,3,15,0,5,6,10,33
2011-02-07 00:00:00.000,Costa Do Sauipe Brazil ATP World Tour 250,CLAY,2,Nicolas Almagro,Juan Ignacio Chela,Nicolas Almagro,1-6; 6-2; 6-4,S,99,4,0,45,69,33,45,14,24,2,4,12,47,69,4,0,48,69,31,48,13,21,5,8,13,44,69
2011-02-07 00:00:00.000,Costa Do Sauipe Brazil ATP World Tour 250,CLAY,2,Alexandr Dolgopolov,Ricardo Mello,Alexandr Dolgopolov,6-2; 6-1,S,59,4,2,28,46,23,28,10,18,3,3,7,33,46,0,1,26,47,14,26,7,21,4,9,8,21,47
2011-02-07 00:00:00.000,Costa Do Sauipe Brazil ATP World Tour 250,CLAY,2,Nicolas Almagro,Alexandr Dolgopolov,Nicolas Almagro,6-3; 7-6(3),F,89,3,1,39,71,30,39,20,32,0,0,11,50,71,5,1,31,56,24,31,17,25,4,5,10,41,56
2011-02-07 00:00:00.000,Rotterdam The Netherlands ATP World Tour 500,HARD,2,Robin Soderling,Robin Haase,Robin Soderling,6-3; 6-2,R32,53,8,0,29,42,26,29,10,13,0,0,9,36,42,11,1,31,48,20,31,8,17,7,10,8,28,48
2011-02-07 00:00:00.000,Rotterdam The Netherlands ATP World Tour 500,HARD,2,Philipp Kohlschreiber,Yen-Hsun Lu,Philipp Kohlschreiber,6-4; 7-6(5),R32,88,6,1,45,60,36,45,11,15,0,1,11,47,60,2,1,43,64,31,43,12,21,1,3,11,43,64
2011-02-07 00:00:00.000,Rotterdam The Netherlands ATP World Tour 500,HARD,2,Thiemo de Bakker,Philipp Petzschner,Thiemo de Bakker,6-4; 0-6; 6-1,R32,88,5,1,36,75,24,36,23,39,2,5,12,47,75,8,3,38,67,30,38,13,29,4,7,11,43,67
2011-02-07 00:00:00.000,Rotterdam The Netherlands ATP World Tour 500,HARD,2,Mikhail Youzhny,Marcel Granollers,Mikhail Youzhny,6-2; 7-6(6),R32,95,2,5,37,64,29,37,12,27,0,2,10,41,64,2,3,35,68,21,35,18,33,5,9,10,39,68
2011-02-07 00:00:00.000,Rotterdam The Netherlands ATP World Tour 500,HARD,2,Jarkko Nieminen,David Ferrer,Jarkko Nieminen,6-3; 6-4,R32,75,1,2,38,66,30,38,11,28,4,6,10,41,66,7,5,39,56,23,39,7,17,6,10,9,30,56
2011-02-07 00:00:00.000,Rotterdam The Netherlands ATP World Tour 500,HARD,2,Viktor Troicki,Thomas Schoorel,Viktor Troicki,6-2; 7-6(1),R32,78,13,2,35,58,33,35,13,23,2,2,10,46,58,5,2,47,72,32,47,11,25,5,7,10,43,72
2011-02-07 00:00:00.000,Rotterdam The Netherlands ATP World Tour 500,HARD,2,Marin Cilic,Mischa Zverev,Marin Cilic,6-2; 6-4,R32,63,5,1,34,47,30,34,8,13,0,0,9,38,47,0,1,33,54,19,33,13,21,5,8,9,32,54
2011-02-07 00:00:00.000,Rotterdam The Netherlands ATP World Tour 500,HARD,2,Jurgen Melzer,Jesse Huta Galung,Jurgen Melzer,6-4; 6-4,R32,78,6,1,39,61,24,39,15,22,0,1,10,39,61,11,4,30,55,21,30,13,25,3,6,10,34,55
2011-02-07 00:00:00.000,Rotterdam The Netherlands ATP World Tour 500,HARD,2,Jo-Wilfried Tsonga,Grigor Dimitrov,Jo-Wilfried Tsonga,6-4; 6-4,R32,75,11,2,36,57,30,36,14,21,0,0,10,44,57,4,6,35,64,28,35,13,29,4,6,10,41,64
2011-02-07 00:00:00.000,Rotterdam The Netherlands ATP World Tour 500,HARD,2,Michael Llodra,Nikolay Davydenko,Michael Llodra,6-3; 7-6(4),R32,94,12,2,50,71,41,50,10,21,2,2,11,51,71,1,1,47,69,32,47,12,22,5,6,10,44,69
2011-02-07 00:00:00.000,Rotterdam The Netherlands ATP World Tour 500,HARD,2,Dmitry Tursunov,Andrey Golubev,Dmitry Tursunov,6-4; 7-5,R32,87,6,3,41,64,35,41,12,23,4,4,11,47,64,8,2,34,67,27,34,15,33,1,3,11,42,67
2011-02-07 00:00:00.000,Rotterdam The Netherlands ATP World Tour 500,HARD,2,Tomas Berdych,Guillermo Garcia-Lopez,Tomas Berdych,6-1; 6-2,R32,55,3,0,25,38,23,25,9,13,0,0,8,32,38,3,3,25,48,14,25,8,23,1,5,7,22,48
2011-02-07 00:00:00.000,Rotterdam The Netherlands ATP World Tour 500,HARD,2,Ivan Ljubicic,Sergiy Stakhovsky,Ivan Ljubicic,7-6(3); 6-3,R32,103,5,2,38,72,30,38,21,34,0,1,11,51,72,5,1,54,81,36,54,14,27,5,7,10,50,81
2011-02-07 00:00:00.000,Rotterdam The Netherlands ATP World Tour 500,HARD,2,Benoit Paire,Gilles Simon,Benoit Paire,6-2; 2-6; 6-3,R32,98,5,1,51,100,37,51,19,49,10,14,13,56,100,2,1,40,68,27,40,10,28,2,7,12,37,68
2011-02-07 00:00:00.000,Rotterdam The Netherlands ATP World Tour 500,HARD,2,Feliciano Lopez,Florian Mayer,Feliciano Lopez,6-3; 6-4,R32,61,12,3,35,52,31,35,10,17,3,3,10,41,52,1,1,31,53,20,31,13,22,2,4,9,33,53
2011-02-07 00:00:00.000,Rotterdam The Netherlands ATP World Tour 500,HARD,2,Marcos Baghdatis,Andy Murray,Marcos Baghdatis,6-4; 6-1,R32,61,9,0,29,54,24,29,11,25,6,8,9,35,54,5,2,26,44,15,26,5,18,3,8,8,20,44
2011-02-07 00:00:00.000,Rotterdam The Netherlands ATP World Tour 500,HARD,2,Robin Soderling,Philipp Kohlschreiber,Robin Soderling,6-3; 5-7; 7-6(7),R16,142,16,2,63,96,49,63,21,33,1,4,17,70,96,12,3,66,113,47,66,23,47,5,8,16,70,113
2011-02-07 00:00:00.000,Rotterdam The Netherlands ATP World Tour 500,HARD,2,Mikhail Youzhny,Thiemo de Bakker,Mikhail Youzhny,6-4; 6-4,R16,75,5,3,27,51,21,27,17,24,2,3,10,38,51,5,2,29,55,20,29,15,26,1,4,10,35,55
2011-02-07 00:00:00.000,Rotterdam The Netherlands ATP World Tour 500,HARD,2,Viktor Troicki,Jarkko Nieminen,Viktor Troicki,7-6(4); 7-5,R16,88,6,0,40,73,34,40,19,33,1,2,12,53,73,3,0,49,72,30,49,16,23,0,2,12,46,72
2011-02-07 00:00:00.000,Rotterdam The Netherlands ATP World Tour 500,HARD,2,Marin Cilic,Jurgen Melzer,Marin Cilic,6-2; 6-4,R16,72,2,2,27,52,22,27,16,25,1,1,9,38,52,5,3,27,52,20,27,9,25,0,3,9,29,52
2011-02-07 00:00:00.000,Rotterdam The Netherlands ATP World Tour 500,HARD,2,Jo-Wilfried Tsonga,Michael Llodra,Jo-Wilfried Tsonga,4-6; 6-4; 6-4,R16,129,16,5,58,98,47,58,20,40,3,4,15,67,98,12,1,54,100,41,54,24,46,6,8,15,65,100
2011-02-07 00:00:00.000,Rotterdam The Netherlands ATP World Tour 500,HARD,2,Tomas Berdych,Dmitry Tursunov,Tomas Berdych,6-4; 4-6; 7-5,R16,125,16,2,50,72,45,50,15,22,0,1,16,60,72,13,5,63,98,47,63,18,35,5,7,16,65,98
2011-02-07 00:00:00.000,Rotterdam The Netherlands ATP World Tour 500,HARD,2,Ivan Ljubicic,Benoit Paire,Ivan Ljubicic,6-0; 6-4,R16,64,5,1,33,49,25,33,8,16,1,2,8,33,49,4,2,24,49,15,24,9,25,1,6,8,24,49
2011-02-07 00:00:00.000,Rotterdam The Netherlands ATP World Tour 500,HARD,2,Marcos Baghdatis,Feliciano Lopez,Marcos Baghdatis,7-6(3); 6-3,R16,80,10,1,37,66,34,37,16,29,0,0,11,50,66,12,1,33,55,29,33,12,22,1,2,10,41,55
2011-02-07 00:00:00.000,Rotterdam The Netherlands ATP World Tour 500,HARD,2,Robin Soderling,Mikhail Youzhny,Robin Soderling,6-4; 7-6(5),Q,114,13,5,50,87,39,50,18,37,5,5,11,57,87,7,2,42,73,31,42,17,31,5,6,11,48,73
2011-02-07 00:00:00.000,Rotterdam The Netherlands ATP World Tour 500,HARD,2,Viktor Troicki,Marin Cilic,Viktor Troicki,7-5; 6-3,Q,88,11,0,54,76,37,54,14,22,9,10,11,51,76,2,1,28,58,18,28,18,30,3,6,10,36,58
2011-02-07 00:00:00.000,Rotterdam The Netherlands ATP World Tour 500,HARD,2,Jo-Wilfried Tsonga,Tomas Berdych,Jo-Wilfried Tsonga,W/O,Q,0,0,0,0,0,0,0,0,0,0,0,0,0,0,0,0,0,0,0,0,0,0,0,0,0,0,0
2011-02-07 00:00:00.000,Rotterdam The Netherlands ATP World Tour 500,HARD,2,Ivan Ljubicic,Marcos Baghdatis,Ivan Ljubicic,6-4; 6-7(6); 7-6(4),Q,145,18,0,66,107,56,66,20,41,1,3,17,76,107,12,3,53,92,40,53,27,39,2,5,17,67,92
2011-02-07 00:00:00.000,Rotterdam The Netherlands ATP World Tour 500,HARD,2,Robin Soderling,Viktor Troicki,Robin Soderling,7-5; 6-4,S,74,13,1,38,55,32,38,9,17,1,2,11,41,55,11,0,47,69,29,47,12,22,5,8,11,41,69
2011-02-07 00:00:00.000,Rotterdam The Netherlands ATP World Tour 500,HARD,2,Jo-Wilfried Tsonga,Ivan Ljubicic,Jo-Wilfried Tsonga,6-4; 7-6(6),S,97,13,1,49,65,42,49,8,16,1,2,11,50,65,7,1,36,70,27,36,20,34,0,2,11,47,70
2011-02-07 00:00:00.000,Rotterdam The Netherlands ATP World Tour 500,HARD,2,Robin Soderling,Jo-Wilfried Tsonga,Robin Soderling,6-3; 3-6; 6-3,F,83,12,3,51,72,41,51,11,21,2,4,14,52,72,20,0,42,65,32,42,13,23,0,3,13,45,65
2011-02-07 00:00:00.000,San Jose CA; U.S.A. ATP World Tour 250,HARD,2,Fernando Verdasco,Rajeev Ram,Fernando Verdasco,6-3; 6-2,R32,61,8,1,25,43,22,25,14,18,0,0,9,36,43,5,2,38,58,25,38,7,20,5,8,8,32,58
2011-02-07 00:00:00.000,San Jose CA; U.S.A. ATP World Tour 250,HARD,2,Ivo Karlovic,Ryan Sweeting,Ivo Karlovic,6-4; 6-4,R32,70,19,1,42,58,36,42,7,16,1,1,10,43,58,1,2,34,54,27,34,10,20,2,4,10,37,54
2011-02-07 00:00:00.000,San Jose CA; U.S.A. ATP World Tour 250,HARD,2,Michael Russell,Alex Kuznetsov,Michael Russell,6-4; 6-2,R32,89,1,3,29,51,22,29,10,22,3,5,9,32,51,3,2,35,65,18,35,12,30,6,11,9,30,65
2011-02-07 00:00:00.000,San Jose CA; U.S.A. ATP World Tour 250,HARD,2,Denis Istomin,Roman Borvanov,Denis Istomin,6-3; 7-5,R32,77,7,1,42,56,34,42,9,14,2,2,10,43,56,7,5,40,65,30,40,9,25,4,7,11,39,65
2011-02-07 00:00:00.000,San Jose CA; U.S.A. ATP World Tour 250,HARD,2,Lukas Lacko,Sam Querrey,Lukas Lacko,7-6(6); 6-3,R32,77,10,2,43,75,33,43,17,32,1,2,11,50,75,12,2,33,58,26,33,12,25,1,3,10,38,58
2011-02-07 00:00:00.000,San Jose CA; U.S.A. ATP World Tour 250,HARD,2,Juan Martin Del Potro,Teymuraz Gabashvili,Juan Martin Del Potro,6-3; 6-2,R32,78,9,1,28,49,25,28,13,21,1,1,9,38,49,9,3,30,58,18,30,14,28,6,9,8,32,58
2011-02-07 00:00:00.000,San Jose CA; U.S.A. ATP World Tour 250,HARD,2,Brian Dabul,Alejandro Falla,Brian Dabul,6-4; 6-3,R32,88,1,1,24,53,19,24,14,29,0,2,10,33,53,1,1,30,64,19,30,17,34,5,9,9,36,64
2011-02-07 00:00:00.000,San Jose CA; U.S.A. ATP World Tour 250,HARD,2,Lleyton Hewitt,Bjorn Phau,Lleyton Hewitt,6-3; 6-3,R32,71,1,3,30,52,21,30,10,22,0,2,9,31,52,2,4,32,55,19,32,7,23,4,9,9,26,55
2011-02-07 00:00:00.000,San Jose CA; U.S.A. ATP World Tour 250,HARD,2,Ricardas Berankis,Benjamin Becker,Ricardas Berankis,6-3; 7-6(2),R32,98,7,3,41,72,36,41,17,31,7,7,10,53,72,6,2,45,80,33,45,16,35,1,3,11,49,80
2011-02-07 00:00:00.000,San Jose CA; U.S.A. ATP World Tour 250,HARD,2,Donald Young,Dustin Brown,Donald Young,7-6(2); 6-4,R32,75,4,5,43,69,33,43,17,26,4,5,11,50,69,5,1,41,74,29,41,16,33,2,4,11,45,74
2011-02-07 00:00:00.000,San Jose CA; U.S.A. ATP World Tour 250,HARD,2,James Blake,Jesse Levine,James Blake,7-5; 6-1,R32,74,3,2,30,55,25,30,14,25,0,1,10,39,55,1,2,52,72,26,52,10,20,7,11,9,36,72
2011-02-07 00:00:00.000,San Jose CA; U.S.A. ATP World Tour 250,HARD,2,Milos Raonic,Xavier Malisse,Milos Raonic,6-3; 6-4,R32,78,20,3,36,61,30,36,14,25,1,1,10,44,61,3,1,40,61,26,40,12,21,5,7,9,38,61
2011-02-07 00:00:00.000,San Jose CA; U.S.A. ATP World Tour 250,HARD,2,Kei Nishikori,Jan Hajek,Kei Nishikori,6-1; 7-6(6),R32,79,5,1,40,61,33,40,10,21,2,4,10,43,61,3,2,36,60,23,36,9,24,3,7,9,32,60
2011-02-07 00:00:00.000,San Jose CA; U.S.A. ATP World Tour 250,HARD,2,Tim Smyczek,Robert Farah,Tim Smyczek,7-5; 3-6; 6-3,R32,126,4,2,47,84,34,47,23,37,2,4,15,57,84,6,2,57,90,39,57,17,33,4,7,15,56,90
2011-02-07 00:00:00.000,San Jose CA; U.S.A. ATP World Tour 250,HARD,2,Robert Kendrick,Igor Kunitsyn,Robert Kendrick,7-5; 3-6; 6-4,R32,137,9,4,60,102,41,60,23,42,5,8,16,64,102,3,4,62,114,44,62,27,52,10,13,15,71,114
2011-02-07 00:00:00.000,San Jose CA; U.S.A. ATP World Tour 250,HARD,2,Gael Monfils,Bradley Klahn,Gael Monfils,6-3; 6-2,R32,62,10,4,27,49,25,27,13,22,1,1,9,38,49,1,4,29,50,18,29,9,21,2,5,8,27,50
2011-02-07 00:00:00.000,San Jose CA; U.S.A. ATP World Tour 250,HARD,2,Fernando Verdasco,Ivo Karlovic,Fernando Verdasco,7-5; 7-5,R16,91,3,1,40,59,32,40,16,19,0,0,12,48,59,14,1,49,69,36,49,11,20,0,2,12,47,69
2011-02-07 00:00:00.000,San Jose CA; U.S.A. ATP World Tour 250,HARD,2,Denis Istomin,Michael Russell,Denis Istomin,7-6(7); 7-6(4),R16,126,9,1,45,78,37,45,21,33,3,5,12,58,78,4,4,63,98,46,63,17,35,5,7,12,63,98
2011-02-07 00:00:00.000,San Jose CA; U.S.A. ATP World Tour 250,HARD,2,Juan Martin Del Potro,Lukas Lacko,Juan Martin Del Potro,6-1; 7-6(1),R16,100,9,4,35,67,31,35,17,32,4,5,10,48,67,3,1,32,61,19,32,13,29,5,8,9,32,61
2011-02-07 00:00:00.000,San Jose CA; U.S.A. ATP World Tour 250,HARD,2,Lleyton Hewitt,Brian Dabul,Lleyton Hewitt,3-6; 7-5; 6-3,R16,131,11,2,56,93,40,56,22,37,6,8,15,62,93,1,2,57,88,44,57,15,31,3,6,15,59,88
2011-02-07 00:00:00.000,San Jose CA; U.S.A. ATP World Tour 250,HARD,2,Ricardas Berankis,Donald Young,Ricardas Berankis,6-4; 5-7; 7-5,R16,143,8,3,49,100,38,49,30,51,5,8,17,68,100,5,6,73,131,51,73,26,58,12,16,17,77,131
2011-02-07 00:00:00.000,San Jose CA; U.S.A. ATP World Tour 250,HARD,2,Milos Raonic,James Blake,Milos Raonic,6-2; 7-6(4),R16,70,13,2,35,54,32,35,12,19,2,3,10,44,54,8,0,39,60,28,39,7,21,1,4,10,35,60
2011-02-07 00:00:00.000,San Jose CA; U.S.A. ATP World Tour 250,HARD,2,Tim Smyczek,Kei Nishikori,Tim Smyczek,6-4; 3-6; 6-1,R16,112,1,1,51,81,35,51,15,30,6,9,13,50,81,4,4,57,83,29,57,15,26,4,9,13,44,83
2011-02-07 00:00:00.000,San Jose CA; U.S.A. ATP World Tour 250,HARD,2,Gael Monfils,Robert Kendrick,Gael Monfils,6-2; 5-7; 6-4,R16,106,15,6,50,83,41,50,16,33,4,6,15,57,83,4,2,59,96,41,59,18,37,4,8,15,59,96
2011-02-07 00:00:00.000,San Jose CA; U.S.A. ATP World Tour 250,HARD,2,Fernando Verdasco,Denis Istomin,Fernando Verdasco,6-4; 6-4,Q,85,7,2,44,59,34,44,9,15,2,2,10,43,59,3,0,33,53,20,33,16,20,1,3,10,36,53
2011-02-07 00:00:00.000,San Jose CA; U.S.A. ATP World Tour 250,HARD,2,Juan Martin Del Potro,Lleyton Hewitt,Juan Martin Del Potro,6-2; 6-3,Q,76,7,1,32,46,26,32,8,14,3,3,8,34,46,3,5,44,74,28,44,9,30,7,11,9,37,74
2011-02-07 00:00:00.000,San Jose CA; U.S.A. ATP World Tour 250,HARD,2,Milos Raonic,Ricardas Berankis,Milos Raonic,6-4; 7-6(2),Q,84,12,1,40,61,35,40,14,21,1,1,11,49,61,7,7,40,72,33,40,15,32,2,3,11,48,72
2011-02-07 00:00:00.000,San Jose CA; U.S.A. ATP World Tour 250,HARD,2,Gael Monfils,Tim Smyczek,Gael Monfils,6-4; 7-6(6),Q,105,5,3,50,84,40,50,17,34,6,6,11,57,84,2,2,53,86,35,53,21,33,7,8,11,56,86
2011-02-07 00:00:00.000,San Jose CA; U.S.A. ATP World Tour 250,HARD,2,Fernando Verdasco,Juan Martin Del Potro,Fernando Verdasco,6-4; 6-4,S,97,5,1,34,56,28,34,14,22,0,1,10,42,56,8,0,40,60,25,40,13,20,3,6,10,38,60
2011-02-07 00:00:00.000,San Jose CA; U.S.A. ATP World Tour 250,HARD,2,Milos Raonic,Gael Monfils,Milos Raonic,W/O,S,0,0,0,0,0,0,0,0,0,0,0,0,0,0,0,0,0,0,0,0,0,0,0,0,0,0,0
2011-02-07 00:00:00.000,San Jose CA; U.S.A. ATP World Tour 250,HARD,2,Milos Raonic,Fernando Verdasco,Milos Raonic,7-6(6); 7-6(5),F,112,13,3,56,81,49,56,12,25,1,1,12,61,81,9,1,49,68,41,49,16,19,0,0,12,57,68
2011-02-14 00:00:00.000,Buenos Aires Argentina ATP World Tour 250,CLAY,2,Nicolas Almagro,Pablo Galdon,Nicolas Almagro,6-1; 6-2,R32,57,7,1,26,47,19,26,15,21,3,3,8,34,47,1,0,24,40,13,24,8,16,1,5,7,21,40
2011-02-14 00:00:00.000,Buenos Aires Argentina ATP World Tour 250,CLAY,2,Leonardo Mayer,Federico Delbonis,Leonardo Mayer,7-6(1); 7-5,R32,106,3,0,45,66,33,45,14,21,0,2,12,47,66,3,1,47,78,32,47,14,31,2,5,12,46,78
2011-02-14 00:00:00.000,Buenos Aires Argentina ATP World Tour 250,CLAY,2,Pablo Cuevas,Lukasz Kubot,Pablo Cuevas,5-7; 7-5; 6-3,R32,141,5,0,62,104,43,62,23,42,6,10,17,66,104,3,4,53,86,34,53,19,33,0,5,16,53,86
2011-02-14 00:00:00.000,Buenos Aires Argentina ATP World Tour 250,CLAY,2,Jose Acasuso,Alexandr Dolgopolov,Jose Acasuso,6-2; 6-4,R32,75,2,0,29,52,19,29,20,23,2,2,9,39,52,5,0,36,59,21,36,14,23,3,6,9,35,59
2011-02-14 00:00:00.000,Buenos Aires Argentina ATP World Tour 250,CLAY,2,David Nalbandian,Potito Starace,David Nalbandian,6-4; 6-4,R32,76,1,1,37,56,27,37,12,19,2,3,10,39,56,3,2,52,64,32,52,6,12,2,5,10,38,64
2011-02-14 00:00:00.000,Buenos Aires Argentina ATP World Tour 250,CLAY,2,Juan Pablo Brzezicki,Filippo Volandri,Juan Pablo Brzezicki,6-1; 6-3,R32,73,0,0,37,49,24,37,7,12,2,4,8,31,49,0,2,44,57,18,44,6,13,3,9,8,24,57
2011-02-14 00:00:00.000,Buenos Aires Argentina ATP World Tour 250,CLAY,2,Albert Ramos,Joao Souza,Albert Ramos,6-4; 6-0,R32,75,0,1,30,43,27,30,6,13,1,1,8,33,43,3,3,30,52,16,30,10,22,2,6,8,26,52
2011-02-14 00:00:00.000,Buenos Aires Argentina ATP World Tour 250,CLAY,2,Tommy Robredo,Maximo Gonzalez,Tommy Robredo,7-5; 6-2,R32,94,1,2,48,66,38,48,8,18,3,3,10,46,66,0,1,48,66,33,48,6,18,3,6,10,39,66
2011-02-14 00:00:00.000,Buenos Aires Argentina ATP World Tour 250,CLAY,2,Juan Ignacio Chela,Rui Machado,Juan Ignacio Chela,4-6; 6-2; 6-2,R32,120,1,0,53,80,31,53,20,27,2,4,13,51,80,2,1,69,88,41,69,8,19,5,10,13,49,88
2011-02-14 00:00:00.000,Buenos Aires Argentina ATP World Tour 250,CLAY,2,Horacio Zeballos,Pablo Andujar,Horacio Zeballos,7-6(3); 6-2,R32,103,3,0,44,71,31,44,17,27,5,6,10,48,71,0,3,37,64,22,37,16,27,4,7,10,38,64
2011-02-14 00:00:00.000,Buenos Aires Argentina ATP World Tour 250,CLAY,2,Fabio Fognini,Frederico Gil,Fabio Fognini,1-6; 6-2; 6-2,R32,109,2,5,42,72,27,42,18,30,5,7,11,45,72,2,2,62,89,37,62,14,27,8,12,12,51,89
2011-02-14 00:00:00.000,Buenos Aires Argentina ATP World Tour 250,CLAY,2,Albert Montanes,Ruben Ramirez Hidalgo,Albert Montanes,6-1; 7-6(0),R32,105,4,1,33,57,24,33,16,24,2,4,10,40,57,0,6,49,82,28,49,14,33,14,18,9,42,82
2011-02-14 00:00:00.000,Buenos Aires Argentina ATP World Tour 250,CLAY,2,Juan Monaco,Ivan Navarro,Juan Monaco,6-2; 7-6(2),R32,93,4,1,37,55,33,37,13,18,4,4,10,46,55,7,2,47,68,29,47,10,21,3,5,10,39,68
2011-02-14 00:00:00.000,Buenos Aires Argentina ATP World Tour 250,CLAY,2,Eduardo Schwank,Igor Andreev,Eduardo Schwank,6-4; 7-6(5),R32,92,4,4,41,64,32,41,14,23,0,1,11,46,64,3,2,37,67,30,37,16,30,5,7,11,46,67
2011-02-14 00:00:00.000,Buenos Aires Argentina ATP World Tour 250,CLAY,2,Victor Hanescu,Daniel Gimeno-Traver,Victor Hanescu,6-3; 7-6(2),R32,96,1,2,43,72,31,43,15,29,1,3,11,46,72,4,1,40,70,27,40,12,30,4,7,10,39,70
2011-02-14 00:00:00.000,Buenos Aires Argentina ATP World Tour 250,CLAY,2,Stanislas Wawrinka,Carlos Berlocq,Stanislas Wawrinka,6-4; 3-6; 6-3,R32,142,2,6,54,94,33,54,19,40,8,13,14,52,94,2,1,56,83,32,56,14,27,5,11,14,46,83
2011-02-14 00:00:00.000,Buenos Aires Argentina ATP World Tour 250,CLAY,2,Nicolas Almagro,Leonardo Mayer,Nicolas Almagro,6-7(3); 6-1; 6-3,R16,134,9,2,48,86,41,48,22,38,3,4,14,63,86,2,2,50,91,35,50,19,41,3,8,14,54,91
2011-02-14 00:00:00.000,Buenos Aires Argentina ATP World Tour 250,CLAY,2,Jose Acasuso,Pablo Cuevas,Jose Acasuso,6-7(2); 7-5; 6-1,R16,162,4,0,70,108,50,70,19,38,7,9,16,69,108,3,1,57,98,39,57,21,41,7,12,15,60,98
2011-02-14 00:00:00.000,Buenos Aires Argentina ATP World Tour 250,CLAY,2,David Nalbandian,Juan Pablo Brzezicki,David Nalbandian,6-1; 6-2,R16,69,0,2,31,39,20,31,4,8,1,3,7,24,39,0,1,49,66,16,49,7,17,7,14,8,23,66
2011-02-14 00:00:00.000,Buenos Aires Argentina ATP World Tour 250,CLAY,2,Tommy Robredo,Albert Ramos,Tommy Robredo,6-3; 7-5,R16,107,1,3,37,58,29,37,11,21,1,3,11,40,58,2,3,44,71,26,44,14,27,6,10,10,40,71
2011-02-14 00:00:00.000,Buenos Aires Argentina ATP World Tour 250,CLAY,2,Juan Ignacio Chela,Horacio Zeballos,Juan Ignacio Chela,7-5; 6-2,R16,86,1,1,34,54,26,34,15,20,3,3,10,41,54,3,0,45,63,32,45,6,18,3,6,10,38,63
2011-02-14 00:00:00.000,Buenos Aires Argentina ATP World Tour 250,CLAY,2,Albert Montanes,Fabio Fognini,Albert Montanes,6-2; 4-6; 6-4,R16,143,3,3,70,97,44,70,17,27,7,9,14,61,97,6,4,59,91,38,59,16,32,5,9,14,54,91
2011-02-14 00:00:00.000,Buenos Aires Argentina ATP World Tour 250,CLAY,2,Juan Monaco,Eduardo Schwank,Juan Monaco,7-6(5); 6-2,R16,113,2,3,47,64,31,47,8,17,3,6,10,39,64,2,0,50,81,26,50,17,31,8,13,10,43,81
2011-02-14 00:00:00.000,Buenos Aires Argentina ATP World Tour 250,CLAY,2,Stanislas Wawrinka,Victor Hanescu,Stanislas Wawrinka,6-7(2); 6-1; 7-6(4),R16,169,5,1,64,101,48,64,22,37,1,2,16,70,101,7,2,76,109,57,76,11,33,4,7,15,68,109
2011-02-14 00:00:00.000,Buenos Aires Argentina ATP World Tour 250,CLAY,2,Nicolas Almagro,Jose Acasuso,Nicolas Almagro,7-5; 6-3,Q,86,3,2,34,64,24,34,19,30,3,5,11,43,64,1,2,26,56,19,26,12,30,4,8,10,31,56
2011-02-14 00:00:00.000,Buenos Aires Argentina ATP World Tour 250,CLAY,2,Tommy Robredo,David Nalbandian,Tommy Robredo,6-4; 6-4,Q,89,6,2,51,72,36,51,10,21,1,2,10,46,72,1,1,34,54,20,34,13,20,5,8,10,33,54
2011-02-14 00:00:00.000,Buenos Aires Argentina ATP World Tour 250,CLAY,2,Juan Ignacio Chela,Albert Montanes,Juan Ignacio Chela,6-4; 3-6; 6-3,Q,145,3,1,59,93,30,59,20,34,3,9,14,50,93,0,3,52,98,27,52,22,46,7,14,14,49,98
2011-02-14 00:00:00.000,Buenos Aires Argentina ATP World Tour 250,CLAY,2,Stanislas Wawrinka,Juan Monaco,Stanislas Wawrinka,7-5; 6-3,Q,125,5,4,56,91,36,56,18,35,11,13,11,54,91,1,1,49,75,25,49,14,26,3,7,10,39,75
2011-02-14 00:00:00.000,Buenos Aires Argentina ATP World Tour 250,CLAY,2,Nicolas Almagro,Tommy Robredo,Nicolas Almagro,7-5; 6-1,S,84,5,0,33,46,30,33,10,13,0,0,10,40,46,3,0,39,65,24,39,13,26,5,8,9,37,65
2011-02-14 00:00:00.000,Buenos Aires Argentina ATP World Tour 250,CLAY,2,Juan Ignacio Chela,Stanislas Wawrinka,Juan Ignacio Chela,6-2; 6-2,S,57,2,0,28,42,24,28,8,14,0,0,8,32,42,2,0,26,42,14,26,5,16,0,4,8,19,42
2011-02-14 00:00:00.000,Buenos Aires Argentina ATP World Tour 250,CLAY,2,Nicolas Almagro,Juan Ignacio Chela,Nicolas Almagro,6-3; 3-6; 6-4,F,125,1,1,54,86,39,54,13,32,7,11,14,52,86,2,2,61,93,36,61,18,32,7,12,14,54,93
2011-02-14 00:00:00.000,Marseille France ATP World Tour 250,HARD,2,Robin Soderling,N/A Bye,Robin Soderling,,R32,0,0,0,0,0,0,0,0,0,0,0,0,0,0,0,0,0,0,0,0,0,0,0,0,0,0,0
2011-02-14 00:00:00.000,Marseille France ATP World Tour 250,HARD,2,Nicolas Mahut,Andrey Kumantsov,Nicolas Mahut,6-2; 6-0,R32,50,7,2,17,36,16,17,13,19,3,3,7,29,36,2,2,27,43,15,27,3,16,3,8,7,18,43
2011-02-14 00:00:00.000,Marseille France ATP World Tour 250,HARD,2,Tobias Kamke,Thomas Schoorel,Tobias Kamke,6-0; 6-2,R32,62,2,0,29,42,21,29,10,13,2,2,7,31,42,2,2,34,53,20,34,5,19,9,14,7,25,53
2011-02-14 00:00:00.000,Marseille France ATP World Tour 250,HARD,2,Michael Llodra,Julien Benneteau,Michael Llodra,6-4; 4-6; 6-3,R32,100,10,7,52,80,45,52,14,28,2,3,15,59,80,3,0,53,72,39,53,14,19,1,3,14,53,72
2011-02-14 00:00:00.000,Marseille France ATP World Tour 250,HARD,2,Jurgen Melzer,N/A Bye,Jurgen Melzer,,R32,0,0,0,0,0,0,0,0,0,0,0,0,0,0,0,0,0,0,0,0,0,0,0,0,0,0,0
2011-02-14 00:00:00.000,Marseille France ATP World Tour 250,HARD,2,Andreas Seppi,Robin Haase,Andreas Seppi,5-7; 6-4; 7-6(2),R32,150,3,2,68,113,46,68,29,45,4,6,17,75,113,19,2,59,110,46,59,24,51,4,6,17,70,110
2011-02-14 00:00:00.000,Marseille France ATP World Tour 250,HARD,2,Dmitry Tursunov,Grigor Dimitrov,Dmitry Tursunov,6-7(6); 7-5; 7-6(4),R32,160,12,8,69,123,57,69,30,54,4,4,18,87,123,17,3,59,105,52,59,27,46,1,2,18,79,105
2011-02-14 00:00:00.000,Marseille France ATP World Tour 250,HARD,2,Ivan Ljubicic,Andrey Golubev,Ivan Ljubicic,6-2; 6-4,R32,66,6,1,30,48,26,30,11,18,1,1,9,37,48,1,4,28,51,17,28,12,23,3,6,9,29,51
2011-02-14 00:00:00.000,Marseille France ATP World Tour 250,HARD,2,Jo-Wilfried Tsonga,Benoit Paire,Jo-Wilfried Tsonga,6-1; 6-2,R32,56,10,4,33,53,30,33,7,20,4,4,8,37,53,0,2,26,44,14,26,9,18,1,5,7,23,44
2011-02-14 00:00:00.000,Marseille France ATP World Tour 250,HARD,2,Sergiy Stakhovsky,Illya Marchenko,Sergiy Stakhovsky,6-4; 6-3,R32,78,4,0,30,53,22,30,15,23,1,3,10,37,53,3,4,26,48,16,26,8,22,0,4,9,24,48
2011-02-14 00:00:00.000,Marseille France ATP World Tour 250,HARD,2,Gilles Simon,Nikolay Davydenko,Gilles Simon,7-6(6); 6-4,R32,99,4,2,41,69,31,41,14,28,0,3,11,45,69,2,3,34,70,23,34,14,36,2,6,11,37,70
2011-02-14 00:00:00.000,Marseille France ATP World Tour 250,HARD,2,Mikhail Youzhny,N/A Bye,Mikhail Youzhny,,R32,0,0,0,0,0,0,0,0,0,0,0,0,0,0,0,0,0,0,0,0,0,0,0,0,0,0,0
2011-02-14 00:00:00.000,Marseille France ATP World Tour 250,HARD,2,Philipp Petzschner,Ernests Gulbis,Philipp Petzschner,7-6(2); 6-1,R32,75,11,3,29,60,28,29,17,31,3,3,10,45,60,11,4,48,66,33,48,8,18,9,11,9,41,66
2011-02-14 00:00:00.000,Marseille France ATP World Tour 250,HARD,2,Marin Cilic,Stephane Bohli,Marin Cilic,6-7(6); 6-3; 6-2,R32,121,16,2,46,81,42,46,24,35,0,0,15,66,81,7,1,52,87,38,52,19,35,4,7,14,57,87
2011-02-14 00:00:00.000,Marseille France ATP World Tour 250,HARD,2,Edouard Roger-Vasselin,Arnaud Clement,Edouard Roger-Vasselin,6-3; 6-2,R32,80,4,1,30,49,25,30,12,19,0,0,9,37,49,10,2,26,54,21,26,10,28,3,6,8,31,54
2011-02-14 00:00:00.000,Marseille France ATP World Tour 250,HARD,2,Tomas Berdych,N/A Bye,Tomas Berdych,,R32,0,0,0,0,0,0,0,0,0,0,0,0,0,0,0,0,0,0,0,0,0,0,0,0,0,0,0
2011-02-14 00:00:00.000,Marseille France ATP World Tour 250,HARD,2,Robin Soderling,Nicolas Mahut,Robin Soderling,7-6(8); 7-6(5),R16,101,12,4,52,80,43,52,15,28,2,3,12,58,80,10,1,54,77,42,54,14,23,1,2,12,56,77
2011-02-14 00:00:00.000,Marseille France ATP World Tour 250,HARD,2,Michael Llodra,Tobias Kamke,Michael Llodra,6-3; 6-4,R16,70,12,3,32,58,27,32,16,26,2,2,10,43,58,1,2,34,55,22,34,12,21,3,5,9,34,55
2011-02-14 00:00:00.000,Marseille France ATP World Tour 250,HARD,2,Jurgen Melzer,Andreas Seppi,Jurgen Melzer,7-5; 6-3,R16,86,11,1,41,67,29,41,15,26,6,7,10,44,67,2,0,37,64,19,37,18,27,8,12,11,37,64
2011-02-14 00:00:00.000,Marseille France ATP World Tour 250,HARD,2,Dmitry Tursunov,Ivan Ljubicic,Dmitry Tursunov,7-6(4); 6-3,R16,79,6,1,45,64,36,45,13,19,0,0,11,49,64,15,2,41,59,33,41,6,18,0,1,10,39,59
2011-02-14 00:00:00.000,Marseille France ATP World Tour 250,HARD,2,Jo-Wilfried Tsonga,Sergiy Stakhovsky,Jo-Wilfried Tsonga,5-7; 6-4; 6-2,R16,109,11,1,50,81,44,50,16,31,0,1,15,60,81,11,0,60,93,43,60,14,33,1,4,15,57,93
2011-02-14 00:00:00.000,Marseille France ATP World Tour 250,HARD,2,Mikhail Youzhny,Gilles Simon,Mikhail Youzhny,3-6; 6-3; 6-3,R16,113,5,2,43,68,30,43,14,25,2,5,13,44,68,12,3,42,90,36,42,17,48,6,11,14,53,90
2011-02-14 00:00:00.000,Marseille France ATP World Tour 250,HARD,2,Marin Cilic,Philipp Petzschner,Marin Cilic,7-6(3); 6-3,R16,102,6,1,33,73,23,33,26,40,3,4,11,49,73,1,3,37,76,27,37,19,39,4,6,10,46,76
2011-02-14 00:00:00.000,Marseille France ATP World Tour 250,HARD,2,Tomas Berdych,Edouard Roger-Vasselin,Tomas Berdych,6-3; 6-4,R16,74,11,3,38,55,34,38,8,17,0,0,10,42,55,2,0,36,52,22,36,11,16,6,8,9,33,52
2011-02-14 00:00:00.000,Marseille France ATP World Tour 250,HARD,2,Robin Soderling,Michael Llodra,Robin Soderling,6-1; 6-4,Q,63,13,3,45,63,34,45,10,18,5,5,9,44,63,4,3,36,51,20,36,8,15,3,6,8,28,51
2011-02-14 00:00:00.000,Marseille France ATP World Tour 250,HARD,2,Dmitry Tursunov,Jurgen Melzer,Dmitry Tursunov,6-4; 2-6; 6-1,Q,102,3,2,51,82,35,51,15,31,4,7,13,50,82,10,5,32,74,25,32,19,42,3,7,12,44,74
2011-02-14 00:00:00.000,Marseille France ATP World Tour 250,HARD,2,Mikhail Youzhny,Jo-Wilfried Tsonga,Mikhail Youzhny,6-4; 2-6; 6-4,Q,119,2,1,51,81,35,51,18,30,1,3,14,53,81,17,3,52,87,43,52,17,35,9,11,14,60,87
2011-02-14 00:00:00.000,Marseille France ATP World Tour 250,HARD,2,Marin Cilic,Tomas Berdych,Marin Cilic,6-3; 6-4,Q,82,4,2,28,49,24,28,14,21,1,1,9,38,49,8,1,39,59,27,39,10,20,3,6,10,37,59
2011-02-14 00:00:00.000,Marseille France ATP World Tour 250,HARD,2,Robin Soderling,Dmitry Tursunov,Robin Soderling,7-5; 6-1,S,75,11,2,30,53,26,30,16,23,0,0,10,42,53,5,6,28,56,20,28,11,28,3,6,9,31,56
2011-02-14 00:00:00.000,Marseille France ATP World Tour 250,HARD,2,Marin Cilic,Mikhail Youzhny,Marin Cilic,6-2; 1-6; 7-5,S,127,12,3,48,90,34,48,20,42,6,9,13,54,90,12,1,54,84,42,54,10,30,5,9,14,52,84
2011-02-14 00:00:00.000,Marseille France ATP World Tour 250,HARD,2,Robin Soderling,Marin Cilic,Robin Soderling,6-7(8); 6-3; 6-3,F,126,12,1,66,94,50,66,16,28,2,4,15,66,94,16,5,59,103,46,59,15,44,3,8,15,61,103
2011-02-14 00:00:00.000,Memphis TN; U.S.A. ATP World Tour 500,HARD,2,Andy Roddick,Ricardas Berankis,Andy Roddick,4-6; 6-2; 6-3,R32,92,23,4,44,76,38,44,16,32,1,2,14,54,76,5,5,28,74,21,28,27,46,3,6,13,48,74
2011-02-14 00:00:00.000,Memphis TN; U.S.A. ATP World Tour 500,HARD,2,Janko Tipsarevic,Ryan Sweeting,Janko Tipsarevic,6-0; 7-6(7),R32,77,6,2,27,60,23,27,20,33,3,4,9,43,60,2,4,34,59,20,34,11,25,4,8,9,31,59
2011-02-14 00:00:00.000,Memphis TN; U.S.A. ATP World Tour 500,HARD,2,Adrian Mannarino,Jan Hajek,Adrian Mannarino,6-2; 6-2,R32,60,4,2,27,47,21,27,12,20,3,4,8,33,47,4,1,26,44,15,26,6,18,2,7,8,21,44
2011-02-14 00:00:00.000,Memphis TN; U.S.A. ATP World Tour 500,HARD,2,Lleyton Hewitt,Yen-Hsun Lu,Lleyton Hewitt,6-4; 7-6(3),R32,88,5,3,37,66,29,37,17,29,0,1,11,46,66,5,6,40,66,26,40,16,26,3,5,11,42,66
2011-02-14 00:00:00.000,Memphis TN; U.S.A. ATP World Tour 500,HARD,2,Florent Serra,Xavier Malisse,Florent Serra,6-2; 1-0 RET,R32,41,4,1,17,23,12,17,3,6,0,1,4,15,23,3,0,20,37,10,20,6,17,5,9,5,16,37
2011-02-14 00:00:00.000,Memphis TN; U.S.A. ATP World Tour 500,HARD,2,Michael Russell,Ivo Karlovic,Michael Russell,6-1; 7-6(1),R32,65,5,2,31,47,29,31,11,16,0,0,9,40,47,8,2,40,64,28,40,10,24,5,8,10,38,64
2011-02-14 00:00:00.000,Memphis TN; U.S.A. ATP World Tour 500,HARD,2,Ivan Dodig,Rainer Schuettler,Ivan Dodig,3-6; 6-3; 6-4,R32,130,10,7,45,88,34,45,22,43,6,8,14,56,88,5,0,46,84,34,46,19,38,4,7,14,53,84
2011-02-14 00:00:00.000,Memphis TN; U.S.A. ATP World Tour 500,HARD,2,Juan Martin Del Potro,John Isner,Juan Martin Del Potro,6-4; 6-3,R32,74,8,1,33,52,27,33,11,19,3,3,9,38,52,12,4,33,62,23,33,13,29,1,4,10,36,62
2011-02-14 00:00:00.000,Memphis TN; U.S.A. ATP World Tour 500,HARD,2,Sam Querrey,Denis Istomin,Sam Querrey,6-7(5); 7-6(5); 6-4,R32,142,19,5,58,109,51,58,28,51,3,3,17,79,109,10,3,87,120,66,87,18,33,1,2,17,84,120
2011-02-14 00:00:00.000,Memphis TN; U.S.A. ATP World Tour 500,HARD,2,Brian Dabul,Michal Przysiezny,Brian Dabul,7-5; 6-4,R32,90,2,1,44,65,36,44,12,21,1,1,11,48,65,3,1,40,65,28,40,16,25,3,5,11,44,65
2011-02-14 00:00:00.000,Memphis TN; U.S.A. ATP World Tour 500,HARD,2,Lukas Lacko,Dudi Sela,Lukas Lacko,6-7(4); 7-5; 6-3,R32,138,5,2,64,123,44,64,35,59,9,12,17,79,123,3,3,67,101,47,67,16,34,6,11,16,63,101
2011-02-14 00:00:00.000,Memphis TN; U.S.A. ATP World Tour 500,HARD,2,Mardy Fish,Teymuraz Gabashvili,Mardy Fish,6-1; 7-5,R32,87,9,3,37,61,31,37,10,24,1,2,10,41,61,2,3,32,59,20,32,12,27,2,6,9,32,59
2011-02-14 00:00:00.000,Memphis TN; U.S.A. ATP World Tour 500,HARD,2,Robert Kendrick,Kevin Anderson,Robert Kendrick,5-7; 6-3; 7-6(4),R32,154,13,3,63,107,50,63,25,44,5,7,17,75,107,20,3,87,131,63,87,19,44,16,18,16,82,131
2011-02-14 00:00:00.000,Memphis TN; U.S.A. ATP World Tour 500,HARD,2,James Blake,Ricardo Mello,James Blake,6-4; 6-3,R32,66,3,3,31,60,22,31,17,29,4,5,9,39,60,0,3,39,62,24,39,10,23,2,6,10,34,62
2011-02-14 00:00:00.000,Memphis TN; U.S.A. ATP World Tour 500,HARD,2,Radek Stepanek,Benjamin Becker,Radek Stepanek,6-4; 6-2,R32,86,5,1,34,67,26,34,18,33,6,7,9,44,67,5,2,34,65,26,34,9,31,5,9,9,35,65
2011-02-14 00:00:00.000,Memphis TN; U.S.A. ATP World Tour 500,HARD,2,Milos Raonic,Fernando Verdasco,Milos Raonic,6-4; 3-6; 7-6(5),R32,122,16,4,59,85,49,59,14,26,1,2,15,63,85,12,4,70,107,53,70,21,37,9,10,16,74,107
2011-02-14 00:00:00.000,Memphis TN; U.S.A. ATP World Tour 500,HARD,2,Andy Roddick,Janko Tipsarevic,Andy Roddick,6-1; 7-6(8),R16,91,14,4,39,61,31,39,12,22,0,1,10,43,61,5,3,35,66,24,35,15,31,3,6,9,39,66
2011-02-14 00:00:00.000,Memphis TN; U.S.A. ATP World Tour 500,HARD,2,Lleyton Hewitt,Adrian Mannarino,Lleyton Hewitt,6-7(9); 7-5; 6-0,R16,158,12,3,62,107,44,62,25,45,8,11,15,69,107,9,4,58,119,39,58,25,61,10,17,15,64,119
2011-02-14 00:00:00.000,Memphis TN; U.S.A. ATP World Tour 500,HARD,2,Michael Russell,Florent Serra,Michael Russell,6-4; 6-4,R16,59,11,1,31,46,29,31,11,15,0,0,10,40,46,4,3,34,56,26,34,11,22,5,7,10,37,56
2011-02-14 00:00:00.000,Memphis TN; U.S.A. ATP World Tour 500,HARD,2,Juan Martin Del Potro,Ivan Dodig,Juan Martin Del Potro,6-4; 6-4,R16,85,4,2,33,56,28,33,13,23,1,1,10,41,56,6,0,24,53,18,24,17,29,2,4,10,35,53
2011-02-14 00:00:00.000,Memphis TN; U.S.A. ATP World Tour 500,HARD,2,Sam Querrey,Brian Dabul,Sam Querrey,6-3; 7-6(3),R16,80,8,6,35,64,31,35,15,29,2,3,11,46,64,5,2,45,62,29,45,10,17,2,4,10,39,62
2011-02-14 00:00:00.000,Memphis TN; U.S.A. ATP World Tour 500,HARD,2,Mardy Fish,Lukas Lacko,Mardy Fish,6-7(5); 6-4; 7-6(3),R16,160,11,6,60,107,45,60,29,47,2,4,17,74,107,5,4,68,122,48,68,28,54,11,14,17,76,122
2011-02-14 00:00:00.000,Memphis TN; U.S.A. ATP World Tour 500,HARD,2,Robert Kendrick,James Blake,Robert Kendrick,7-6(5); 6-3,R16,69,8,4,38,73,29,38,18,35,1,2,10,47,73,7,2,45,63,32,45,8,18,3,6,11,40,63
2011-02-14 00:00:00.000,Memphis TN; U.S.A. ATP World Tour 500,HARD,2,Milos Raonic,Radek Stepanek,Milos Raonic,6-4; 6-7(10); 7-6(1),R16,152,38,4,78,116,64,78,20,38,2,3,17,84,116,8,3,77,119,57,77,21,42,6,8,17,78,119
2011-02-14 00:00:00.000,Memphis TN; U.S.A. ATP World Tour 500,HARD,2,Andy Roddick,Lleyton Hewitt,Andy Roddick,4-6; 6-3; 6-4,Q,133,21,6,58,98,46,58,20,40,3,4,15,66,98,11,6,53,106,40,53,25,53,9,11,14,65,106
2011-02-14 00:00:00.000,Memphis TN; U.S.A. ATP World Tour 500,HARD,2,Juan Martin Del Potro,Michael Russell,Juan Martin Del Potro,6-4; 6-2,Q,88,7,0,30,53,25,30,14,23,0,0,9,39,53,2,5,33,57,23,33,9,24,2,5,9,32,57
2011-02-14 00:00:00.000,Memphis TN; U.S.A. ATP World Tour 500,HARD,2,Mardy Fish,Sam Querrey,Mardy Fish,6-3; 6-4,Q,79,8,0,37,61,25,37,17,24,3,4,10,42,61,4,4,33,60,25,33,9,27,2,5,9,34,60
2011-02-14 00:00:00.000,Memphis TN; U.S.A. ATP World Tour 500,HARD,2,Milos Raonic,Robert Kendrick,Milos Raonic,6-4; 3-6; 6-3,Q,113,20,4,62,94,48,62,14,32,8,9,14,62,94,4,1,43,78,36,43,18,35,3,5,14,54,78
2011-02-14 00:00:00.000,Memphis TN; U.S.A. ATP World Tour 500,HARD,2,Andy Roddick,Juan Martin Del Potro,Andy Roddick,6-3; 6-4,S,95,13,1,35,56,30,35,10,21,1,2,10,40,56,8,0,36,69,22,36,18,33,7,10,9,40,69
2011-02-14 00:00:00.000,Memphis TN; U.S.A. ATP World Tour 500,HARD,2,Milos Raonic,Mardy Fish,Milos Raonic,6-4; 4-6; 6-3,S,119,23,3,55,84,47,55,12,29,5,6,14,59,84,3,2,43,81,33,43,22,38,2,5,15,55,81
2011-02-14 00:00:00.000,Memphis TN; U.S.A. ATP World Tour 500,HARD,2,Andy Roddick,Milos Raonic,Andy Roddick,7-6(7); 6-7(11); 7-5,F,157,20,4,67,113,54,67,31,46,6,8,18,85,113,32,3,74,123,61,74,26,49,7,10,18,87,123
2011-02-21 00:00:00.000,Acapulco Mexico ATP World Tour 500,CLAY,2,David Ferrer,Adrian Ungur,David Ferrer,6-1; 6-3,R32,62,0,1,32,49,23,32,9,17,3,4,8,32,49,0,1,27,46,12,27,9,19,3,8,8,21,46
2011-02-21 00:00:00.000,Acapulco Mexico ATP World Tour 500,CLAY,2,Santiago Gonzalez,Daniel Garza,Santiago Gonzalez,6-2; 7-6(5),R32,94,8,4,40,69,32,40,13,29,0,1,10,45,69,1,2,50,75,32,50,11,25,7,10,10,43,75
2011-02-21 00:00:00.000,Acapulco Mexico ATP World Tour 500,CLAY,2,Pablo Cuevas,Potito Starace,Pablo Cuevas,6-4; 6-4,R32,81,2,1,27,52,21,27,17,25,3,4,10,38,52,1,5,50,74,29,50,12,24,7,10,10,41,74
2011-02-21 00:00:00.000,Acapulco Mexico ATP World Tour 500,CLAY,2,Juan Monaco,Horacio Zeballos,Juan Monaco,7-5; 7-6(3),R32,139,7,1,40,75,30,40,20,35,3,6,12,50,75,6,3,53,101,36,53,19,48,11,15,12,55,101
2011-02-21 00:00:00.000,Acapulco Mexico ATP World Tour 500,CLAY,2,Stanislas Wawrinka,Pablo Andujar,Stanislas Wawrinka,7-6(5); 3-6; 6-0,R32,123,3,3,58,98,38,58,22,40,9,13,13,60,98,2,4,57,82,37,57,11,25,5,11,14,48,82
2011-02-21 00:00:00.000,Acapulco Mexico ATP World Tour 500,CLAY,2,Fabio Fognini,Maximo Gonzalez,Fabio Fognini,6-3; 6-4,R32,92,1,4,42,80,25,42,20,38,7,10,10,45,80,0,1,35,50,17,35,8,15,2,7,9,25,50
2011-02-21 00:00:00.000,Acapulco Mexico ATP World Tour 500,CLAY,2,Carlos Berlocq,Daniel Munoz-De La Nava,Carlos Berlocq,6-3; 5-7; 6-1,R32,157,2,1,49,91,29,49,24,42,5,9,14,53,91,5,5,47,89,25,47,20,42,5,12,14,45,89
2011-02-21 00:00:00.000,Acapulco Mexico ATP World Tour 500,CLAY,2,Alexandr Dolgopolov,Paul Capdeville,Alexandr Dolgopolov,7-5; 6-2,R32,82,10,5,27,57,21,27,14,30,0,2,10,35,57,2,2,45,67,27,45,7,22,5,10,10,34,67
2011-02-21 00:00:00.000,Acapulco Mexico ATP World Tour 500,CLAY,2,Albert Montanes,Daniel Gimeno-Traver,Albert Montanes,6-2; 6-1,R32,69,2,3,26,50,22,26,11,24,4,5,8,33,50,2,7,20,49,11,20,9,29,5,10,7,20,49
2011-02-21 00:00:00.000,Acapulco Mexico ATP World Tour 500,CLAY,2,Santiago Giraldo,Albert Ramos,Santiago Giraldo,4-6; 7-5; 7-5,R32,158,3,1,68,103,48,68,14,35,7,11,17,62,103,3,2,65,111,41,65,24,46,4,9,17,65,111
2011-02-21 00:00:00.000,Acapulco Mexico ATP World Tour 500,CLAY,2,Filippo Volandri,Frederico Gil,Filippo Volandri,6-1; 3-6; 6-4,R32,132,0,3,64,93,34,64,15,29,11,16,13,49,93,1,3,45,78,27,45,11,33,5,12,13,38,78
2011-02-21 00:00:00.000,Acapulco Mexico ATP World Tour 500,CLAY,2,Nicolas Almagro,Victor Hanescu,Nicolas Almagro,6-3; 6-2,R32,81,5,0,36,66,26,36,16,30,1,2,9,42,66,2,1,34,51,18,34,7,17,2,6,8,25,51
2011-02-21 00:00:00.000,Acapulco Mexico ATP World Tour 500,CLAY,2,Eduardo Schwank,Juan Ignacio Chela,Eduardo Schwank,3-6; 6-5 RET,R32,80,4,4,37,64,24,37,13,27,2,5,10,37,64,1,2,35,51,26,35,9,16,0,2,10,35,51
2011-02-21 00:00:00.000,Acapulco Mexico ATP World Tour 500,CLAY,2,Lukasz Kubot,Ruben Ramirez Hidalgo,Lukasz Kubot,7-5; 6-0,R32,103,4,4,24,44,21,24,10,20,0,2,9,31,44,2,9,45,82,26,45,11,37,9,15,9,37,82
2011-02-21 00:00:00.000,Acapulco Mexico ATP World Tour 500,CLAY,2,Ivan Navarro,Manuel Sanchez,Ivan Navarro,6-1; 3-6; 6-1,R32,111,4,2,44,65,35,44,12,21,2,3,12,47,65,6,4,27,60,16,27,19,33,4,8,11,35,60
2011-02-21 00:00:00.000,Acapulco Mexico ATP World Tour 500,CLAY,2,Thomaz Bellucci,Fernando Verdasco,Thomaz Bellucci,6-2; 4-6; 6-3,R32,127,6,5,60,84,48,60,11,24,7,8,14,59,84,7,5,55,80,35,55,13,25,1,4,13,48,80
2011-02-21 00:00:00.000,Acapulco Mexico ATP World Tour 500,CLAY,2,David Ferrer,Santiago Gonzalez,David Ferrer,6-2; 6-2,R16,52,2,0,25,41,19,25,13,16,0,0,8,32,41,3,2,30,45,21,30,4,15,6,10,8,25,45
2011-02-21 00:00:00.000,Acapulco Mexico ATP World Tour 500,CLAY,2,Juan Monaco,Pablo Cuevas,Juan Monaco,6-3; 6-4,R16,106,3,2,45,76,34,45,13,31,5,6,10,47,76,0,1,33,54,17,33,14,21,1,4,9,31,54
2011-02-21 00:00:00.000,Acapulco Mexico ATP World Tour 500,CLAY,2,Stanislas Wawrinka,Fabio Fognini,Stanislas Wawrinka,5-7; 6-3; 7-5,R16,169,2,3,71,107,41,71,22,36,5,10,16,63,107,4,3,74,122,42,74,21,48,7,14,17,63,122
2011-02-21 00:00:00.000,Acapulco Mexico ATP World Tour 500,CLAY,2,Alexandr Dolgopolov,Carlos Berlocq,Alexandr Dolgopolov,6-4; 6-1,R16,72,4,0,21,41,18,21,15,20,0,0,8,33,41,4,5,36,60,21,36,8,24,2,6,9,29,60
2011-02-21 00:00:00.000,Acapulco Mexico ATP World Tour 500,CLAY,2,Santiago Giraldo,Albert Montanes,Santiago Giraldo,6-3; 6-4,R16,78,5,0,33,60,28,33,17,27,6,6,10,45,60,1,1,32,53,22,32,11,21,1,3,9,33,53
2011-02-21 00:00:00.000,Acapulco Mexico ATP World Tour 500,CLAY,2,Nicolas Almagro,Filippo Volandri,Nicolas Almagro,6-2; 6-2,R16,71,4,0,29,56,24,29,11,27,2,3,8,35,56,0,6,36,53,17,36,8,17,2,7,8,25,53
2011-02-21 00:00:00.000,Acapulco Mexico ATP World Tour 500,CLAY,2,Lukasz Kubot,Eduardo Schwank,Lukasz Kubot,6-7(8); 6-4; 6-4,R16,179,4,9,61,101,43,61,24,40,3,6,16,67,101,2,2,72,113,42,72,26,41,8,13,16,68,113
2011-02-21 00:00:00.000,Acapulco Mexico ATP World Tour 500,CLAY,2,Thomaz Bellucci,Ivan Navarro,Thomaz Bellucci,1-6; 6-4; 6-3,R16,140,4,1,50,81,35,50,19,31,1,3,13,54,81,3,5,44,91,31,44,26,47,4,6,13,57,91
2011-02-21 00:00:00.000,Acapulco Mexico ATP World Tour 500,CLAY,2,David Ferrer,Juan Monaco,David Ferrer,2-6; 7-5; 6-2,Q,164,1,6,63,100,39,63,18,37,10,14,14,57,100,1,1,50,92,31,50,21,42,2,7,14,52,92
2011-02-21 00:00:00.000,Acapulco Mexico ATP World Tour 500,CLAY,2,Alexandr Dolgopolov,Stanislas Wawrinka,Alexandr Dolgopolov,6-4; 7-6(6),Q,115,11,3,52,95,37,52,21,43,9,11,11,58,95,4,0,50,77,27,50,19,27,6,9,11,46,77
2011-02-21 00:00:00.000,Acapulco Mexico ATP World Tour 500,CLAY,2,Nicolas Almagro,Santiago Giraldo,Nicolas Almagro,7-6(0); 5-7; 6-4,Q,146,7,3,57,100,42,57,20,43,2,7,17,62,100,4,1,71,113,44,71,20,42,5,10,17,64,113
2011-02-21 00:00:00.000,Acapulco Mexico ATP World Tour 500,CLAY,2,Thomaz Bellucci,Lukasz Kubot,Thomaz Bellucci,6-7(5); 6-3; 6-4,Q,189,5,3,61,100,44,61,15,39,3,7,15,59,100,2,9,75,126,47,75,20,51,12,19,16,67,126
2011-02-21 00:00:00.000,Acapulco Mexico ATP World Tour 500,CLAY,2,David Ferrer,Alexandr Dolgopolov,David Ferrer,5-7; 6-1; 6-1,S,114,3,5,40,71,33,40,17,31,7,9,13,50,71,7,7,48,104,34,48,19,56,11,17,13,53,104
2011-02-21 00:00:00.000,Acapulco Mexico ATP World Tour 500,CLAY,2,Nicolas Almagro,Thomaz Bellucci,Nicolas Almagro,7-6(4); 6-4,S,104,9,1,43,75,32,43,20,32,3,3,11,52,75,5,3,38,65,31,38,15,27,1,2,11,46,65
2011-02-21 00:00:00.000,Acapulco Mexico ATP World Tour 500,CLAY,2,David Ferrer,Nicolas Almagro,David Ferrer,7-6(4); 6-7(2); 6-2,F,162,6,2,64,113,45,64,25,49,9,13,16,70,113,4,4,53,105,36,53,22,52,1,7,16,58,105
2011-02-21 00:00:00.000,Delray Beach FL; U.S.A. ATP World Tour 250,HARD,2,Dudi Sela,Marinko Matosevic,Dudi Sela,3-6; 6-1; 6-2,R32,95,2,4,41,74,28,41,20,33,7,9,12,48,74,2,2,38,66,21,38,15,28,3,8,12,36,66
2011-02-21 00:00:00.000,Delray Beach FL; U.S.A. ATP World Tour 250,HARD,2,Ivan Dodig,Igor Kunitsyn,Ivan Dodig,6-4; 2-6; 6-3,R32,133,18,6,58,109,40,58,23,51,7,10,14,63,109,6,0,35,68,27,35,17,33,2,5,13,44,68
2011-02-21 00:00:00.000,Delray Beach FL; U.S.A. ATP World Tour 250,HARD,2,Blaz Kavcic,Robert Farah,Blaz Kavcic,6-1; 6-4,R32,80,1,1,30,44,22,30,9,14,0,1,8,31,44,8,3,32,54,18,32,8,22,4,9,9,26,54
2011-02-21 00:00:00.000,Delray Beach FL; U.S.A. ATP World Tour 250,HARD,2,Janko Tipsarevic,Ivo Karlovic,Janko Tipsarevic,7-6(14); 7-6(1),R32,115,12,1,56,80,50,56,12,24,1,2,12,62,80,18,1,58,87,44,58,15,29,2,3,12,59,87
2011-02-21 00:00:00.000,Delray Beach FL; U.S.A. ATP World Tour 250,HARD,2,Sam Querrey,Dustin Brown,Sam Querrey,6-3; 5-7; 6-3,R32,88,4,7,64,87,46,64,11,23,4,7,15,57,87,10,2,56,83,41,56,10,27,2,7,15,51,83
2011-02-21 00:00:00.000,Delray Beach FL; U.S.A. ATP World Tour 250,HARD,2,Ryan Sweeting,Igor Andreev,Ryan Sweeting,6-2; 6-3,R32,64,2,1,37,52,26,37,10,15,1,2,9,36,52,4,4,32,50,21,32,5,18,2,6,8,26,50
2011-02-21 00:00:00.000,Delray Beach FL; U.S.A. ATP World Tour 250,HARD,2,Kei Nishikori,Brian Dabul,Kei Nishikori,6-2; 7-6(5),R32,99,5,2,38,68,30,38,13,30,2,4,10,43,68,1,2,35,65,24,35,11,30,2,6,10,35,65
2011-02-21 00:00:00.000,Delray Beach FL; U.S.A. ATP World Tour 250,HARD,2,James Blake,Benjamin Becker,James Blake,7-5; 6-4,R32,76,7,1,39,75,32,39,18,36,2,3,11,50,75,6,1,24,60,20,24,17,36,2,5,11,37,60
2011-02-21 00:00:00.000,Delray Beach FL; U.S.A. ATP World Tour 250,HARD,2,Kevin Anderson,Donald Young,Kevin Anderson,6-7(5); 7-6(4); 6-2,R32,151,22,2,89,122,69,89,16,33,10,10,16,85,122,6,8,54,100,41,54,29,46,2,4,16,70,100
2011-02-21 00:00:00.000,Delray Beach FL; U.S.A. ATP World Tour 250,HARD,2,Florent Serra,Ryan Harrison,Florent Serra,3-6; 6-3; 7-5,R32,116,5,0,66,91,49,66,15,25,4,5,15,64,91,11,6,58,102,44,58,20,44,9,11,15,64,102
2011-02-21 00:00:00.000,Delray Beach FL; U.S.A. ATP World Tour 250,HARD,2,Juan Martin Del Potro,Ricardas Berankis,Juan Martin Del Potro,6-4; 6-1,R32,77,2,2,34,62,27,34,13,28,7,8,9,40,62,1,3,26,47,19,26,6,21,1,5,8,25,47
2011-02-21 00:00:00.000,Delray Beach FL; U.S.A. ATP World Tour 250,HARD,2,Teymuraz Gabashvili,John Isner,Teymuraz Gabashvili,6-4; 5-7; 7-6(13),R32,151,7,5,60,97,50,60,25,37,0,2,17,75,97,21,4,85,110,68,85,10,25,3,5,17,78,110
2011-02-21 00:00:00.000,Delray Beach FL; U.S.A. ATP World Tour 250,HARD,2,Adrian Mannarino,Leonardo Mayer,Adrian Mannarino,1-6; 7-6(3); 6-4,R32,134,5,5,60,95,41,60,17,35,1,5,15,58,95,4,4,46,89,35,46,24,43,5,7,14,59,89
2011-02-21 00:00:00.000,Delray Beach FL; U.S.A. ATP World Tour 250,HARD,2,Alejandro Falla,Jan Hajek,Alejandro Falla,6-1; 2-0 RET,R32,27,0,0,15,23,11,15,6,8,0,0,4,17,23,0,2,17,28,5,17,5,11,2,6,5,10,28
2011-02-21 00:00:00.000,Delray Beach FL; U.S.A. ATP World Tour 250,HARD,2,Ricardo Mello,Rainer Schuettler,Ricardo Mello,2-6; 6-2; 6-3,R32,91,2,0,39,67,28,39,17,28,1,3,12,45,67,6,2,45,75,33,45,13,30,4,8,13,46,75
2011-02-21 00:00:00.000,Delray Beach FL; U.S.A. ATP World Tour 250,HARD,2,Mardy Fish,Bjorn Phau,Mardy Fish,5-0 RET,R32,20,2,0,10,14,8,10,4,4,0,0,3,12,14,2,0,8,12,2,8,2,4,0,2,2,4,12
2011-02-21 00:00:00.000,Delray Beach FL; U.S.A. ATP World Tour 250,HARD,2,Ivan Dodig,Dudi Sela,Ivan Dodig,2-6; 6-3; 6-2,R16,118,8,3,52,79,34,52,16,27,2,4,13,50,79,3,2,45,85,29,45,22,40,6,9,12,51,85
2011-02-21 00:00:00.000,Delray Beach FL; U.S.A. ATP World Tour 250,HARD,2,Janko Tipsarevic,Blaz Kavcic,Janko Tipsarevic,6-2; 6-7(8); 6-3,R16,163,15,4,60,105,45,60,27,45,13,15,15,72,105,5,3,69,110,45,69,20,41,10,15,14,65,110
2011-02-21 00:00:00.000,Delray Beach FL; U.S.A. ATP World Tour 250,HARD,2,Ryan Sweeting,Sam Querrey,Ryan Sweeting,7-6(5); 6-4,R16,85,7,3,47,71,35,47,14,24,5,6,11,49,71,5,4,49,82,32,49,18,33,6,8,11,50,82
2011-02-21 00:00:00.000,Delray Beach FL; U.S.A. ATP World Tour 250,HARD,2,Kei Nishikori,James Blake,Kei Nishikori,6-3; 6-4,R16,64,3,1,37,57,30,37,13,20,2,2,10,43,57,5,4,30,50,23,30,9,20,0,2,9,32,50
2011-02-21 00:00:00.000,Delray Beach FL; U.S.A. ATP World Tour 250,HARD,2,Kevin Anderson,Florent Serra,Kevin Anderson,6-1; 6-4,R16,55,6,2,33,45,29,33,8,12,1,1,9,37,45,1,2,17,44,13,17,11,27,1,4,8,24,44
2011-02-21 00:00:00.000,Delray Beach FL; U.S.A. ATP World Tour 250,HARD,2,Juan Martin Del Potro,Teymuraz Gabashvili,Juan Martin Del Potro,6-1; 6-1,R16,70,4,0,24,35,22,24,6,11,0,0,7,28,35,2,1,14,42,5,14,12,28,3,8,7,17,42
2011-02-21 00:00:00.000,Delray Beach FL; U.S.A. ATP World Tour 250,HARD,2,Alejandro Falla,Adrian Mannarino,Alejandro Falla,6-3; 6-2,R16,78,4,3,22,45,15,22,16,23,1,2,8,31,45,5,2,47,75,25,47,10,28,8,13,9,35,75
2011-02-21 00:00:00.000,Delray Beach FL; U.S.A. ATP World Tour 250,HARD,2,Mardy Fish,Ricardo Mello,Mardy Fish,6-2; 6-1,R16,55,8,2,24,36,20,24,8,12,0,0,7,28,36,1,5,20,45,10,20,10,25,3,8,8,20,45
2011-02-21 00:00:00.000,Delray Beach FL; U.S.A. ATP World Tour 250,HARD,2,Janko Tipsarevic,Ivan Dodig,Janko Tipsarevic,7-6(0); 6-1,Q,79,4,0,38,59,32,38,15,21,3,3,10,47,59,8,4,36,53,27,36,6,17,0,2,9,33,53
2011-02-21 00:00:00.000,Delray Beach FL; U.S.A. ATP World Tour 250,HARD,2,Kei Nishikori,Ryan Sweeting,Kei Nishikori,6-7(5); 6-2; 6-4,Q,131,5,3,60,92,47,60,18,32,3,3,15,65,92,8,3,58,101,41,58,22,43,4,7,15,63,101
2011-02-21 00:00:00.000,Delray Beach FL; U.S.A. ATP World Tour 250,HARD,2,Juan Martin Del Potro,Kevin Anderson,Juan Martin Del Potro,6-4; 6-4,Q,83,6,0,34,54,27,34,14,20,0,0,10,41,54,4,1,33,53,28,33,9,20,0,2,10,37,53
2011-02-21 00:00:00.000,Delray Beach FL; U.S.A. ATP World Tour 250,HARD,2,Mardy Fish,Alejandro Falla,Mardy Fish,6-1; 6-4,Q,86,6,2,35,63,27,35,17,28,3,3,9,44,63,1,4,36,60,21,36,12,24,8,11,8,33,60
2011-02-21 00:00:00.000,Delray Beach FL; U.S.A. ATP World Tour 250,HARD,2,Janko Tipsarevic,Kei Nishikori,Janko Tipsarevic,6-4; 6-4,S,86,5,0,29,52,25,29,16,23,1,1,10,41,52,1,6,43,63,34,43,5,20,0,2,10,39,63
2011-02-21 00:00:00.000,Delray Beach FL; U.S.A. ATP World Tour 250,HARD,2,Juan Martin Del Potro,Mardy Fish,Juan Martin Del Potro,6-1; 7-5,S,96,1,1,34,56,26,34,10,22,2,4,10,36,56,2,1,32,56,19,32,8,24,2,7,9,27,56
2011-02-21 00:00:00.000,Delray Beach FL; U.S.A. ATP World Tour 250,HARD,2,Juan Martin Del Potro,Janko Tipsarevic,Juan Martin Del Potro,6-4; 6-4,F,114,5,2,45,75,29,45,19,30,10,11,10,48,75,8,3,31,63,24,31,15,32,2,5,10,39,63
2011-02-21 00:00:00.000,Dubai U.A.E. ATP World Tour 500,HARD,2,Roger Federer,Somdev Devvarman,Roger Federer,6-3; 6-3,R32,76,4,4,36,54,30,36,10,18,2,2,9,40,54,2,3,38,69,24,38,14,31,4,7,9,38,69
2011-02-21 00:00:00.000,Dubai U.A.E. ATP World Tour 500,HARD,2,Marcel Granollers,Dmitry Tursunov,Marcel Granollers,6-1; 6-3,R32,72,4,1,29,44,23,29,10,15,0,0,8,33,44,5,2,36,57,21,36,9,21,9,13,8,30,57
2011-02-21 00:00:00.000,Dubai U.A.E. ATP World Tour 500,HARD,2,Sergiy Stakhovsky,Omar Awadhy,Sergiy Stakhovsky,6-4; 6-2,R32,55,3,4,38,56,27,38,9,18,0,2,9,36,56,0,6,42,77,22,42,14,35,6,11,9,36,77
2011-02-21 00:00:00.000,Dubai U.A.E. ATP World Tour 500,HARD,2,Ernests Gulbis,Michael Berrer,Ernests Gulbis,6-3; 6-4,R32,94,10,7,48,77,35,48,14,29,3,3,10,49,77,4,3,39,64,29,39,9,25,5,7,9,38,64
2011-02-21 00:00:00.000,Dubai U.A.E. ATP World Tour 500,HARD,2,Gilles Simon,Mikhail Youzhny,Gilles Simon,6-3; 7-5,R32,92,8,4,30,68,24,30,22,38,0,1,11,46,68,0,2,34,58,24,34,12,24,5,8,10,36,58
2011-02-21 00:00:00.000,Dubai U.A.E. ATP World Tour 500,HARD,2,Lukas Rosol,Karol Beck,Lukas Rosol,7-6(2); 6-3,R32,89,14,1,33,64,29,33,20,31,1,1,11,49,64,4,5,36,72,27,36,18,36,2,3,10,45,72
2011-02-21 00:00:00.000,Dubai U.A.E. ATP World Tour 500,HARD,2,Richard Gasquet,Grigor Dimitrov,Richard Gasquet,6-2; 6-4,R32,64,9,1,37,49,31,37,8,12,3,3,9,39,49,3,6,29,56,21,29,11,27,4,7,9,32,56
2011-02-21 00:00:00.000,Dubai U.A.E. ATP World Tour 500,HARD,2,Sergei Bubka,Ivan Ljubicic,Sergei Bubka,6-1; 0-1 RET,R32,41,1,2,10,25,9,10,9,15,0,0,4,18,25,3,0,15,32,10,15,7,17,2,4,4,17,32
2011-02-21 00:00:00.000,Dubai U.A.E. ATP World Tour 500,HARD,2,Philipp Kohlschreiber,Viktor Troicki,Philipp Kohlschreiber,6-1; 7-6(2),R32,83,4,2,35,64,25,35,19,29,2,3,10,44,64,5,4,28,63,20,28,17,35,4,7,9,37,63
2011-02-21 00:00:00.000,Dubai U.A.E. ATP World Tour 500,HARD,2,Philipp Petzschner,Andreas Seppi,Philipp Petzschner,3-6; 7-6(2); 6-2,R32,106,14,7,46,93,36,46,24,47,6,9,14,60,93,8,2,43,85,34,43,20,42,4,8,15,54,85
2011-02-21 00:00:00.000,Dubai U.A.E. ATP World Tour 500,HARD,2,Nikolay Davydenko,Guillermo Garcia-Lopez,Nikolay Davydenko,6-2; 6-0,R32,57,1,1,39,51,25,39,7,12,4,5,7,32,51,0,5,19,37,7,19,4,18,2,8,7,11,37
2011-02-21 00:00:00.000,Dubai U.A.E. ATP World Tour 500,HARD,2,Tomas Berdych,Jeremy Chardy,Tomas Berdych,6-2; 6-3,R32,66,4,2,20,39,15,20,15,19,1,2,8,30,39,5,2,28,55,13,28,12,27,3,8,9,25,55
2011-02-21 00:00:00.000,Dubai U.A.E. ATP World Tour 500,HARD,2,Andrey Golubev,Marcos Baghdatis,Andrey Golubev,4-0 RET,R32,25,1,0,3,9,3,3,5,6,0,0,2,8,9,3,5,14,30,10,14,3,16,9,11,2,13,30
2011-02-21 00:00:00.000,Dubai U.A.E. ATP World Tour 500,HARD,2,Florian Mayer,Jarkko Nieminen,Florian Mayer,6-4; 6-2,R32,65,6,0,35,58,25,35,12,23,5,7,9,37,58,0,3,32,57,19,32,8,25,5,10,9,27,57
2011-02-21 00:00:00.000,Dubai U.A.E. ATP World Tour 500,HARD,2,Feliciano Lopez,Yen-Hsun Lu,Feliciano Lopez,5-0 RET,R32,21,3,0,5,10,4,5,4,5,0,0,2,8,10,0,2,22,26,9,22,1,4,3,6,3,10,26
2011-02-21 00:00:00.000,Dubai U.A.E. ATP World Tour 500,HARD,2,Novak Djokovic,Michael Llodra,Novak Djokovic,6-3; 6-3,R32,64,4,1,33,51,26,33,13,18,3,3,9,39,51,1,0,34,52,20,34,10,18,1,4,9,30,52
2011-02-21 00:00:00.000,Dubai U.A.E. ATP World Tour 500,HARD,2,Roger Federer,Marcel Granollers,Roger Federer,6-3; 6-4,R16,70,4,3,35,61,28,35,15,26,2,2,10,43,61,3,2,33,53,21,33,14,20,6,8,9,35,53
2011-02-21 00:00:00.000,Dubai U.A.E. ATP World Tour 500,HARD,2,Sergiy Stakhovsky,Ernests Gulbis,Sergiy Stakhovsky,6-3; 5-7; 6-1,R16,117,11,1,47,75,40,47,14,28,3,5,14,54,75,7,9,60,100,40,60,16,40,9,14,14,56,100
2011-02-21 00:00:00.000,Dubai U.A.E. ATP World Tour 500,HARD,2,Gilles Simon,Lukas Rosol,Gilles Simon,6-2; 6-3,R16,54,6,1,23,47,18,23,13,24,0,2,9,31,47,2,5,27,45,16,27,3,18,2,7,8,19,45
2011-02-21 00:00:00.000,Dubai U.A.E. ATP World Tour 500,HARD,2,Richard Gasquet,Sergei Bubka,Richard Gasquet,6-2; 7-5,R16,79,6,3,31,59,24,31,16,28,2,3,10,40,59,6,3,24,55,19,24,12,31,2,6,10,31,55
2011-02-21 00:00:00.000,Dubai U.A.E. ATP World Tour 500,HARD,2,Philipp Petzschner,Philipp Kohlschreiber,Philipp Petzschner,6-0; 4-6; 6-2,R16,95,4,1,34,68,27,34,22,34,1,2,12,49,68,6,4,36,74,24,36,15,38,8,13,12,39,74
2011-02-21 00:00:00.000,Dubai U.A.E. ATP World Tour 500,HARD,2,Tomas Berdych,Nikolay Davydenko,Tomas Berdych,6-3; 7-6(5),R16,104,3,2,41,74,31,41,16,33,6,8,11,47,74,1,2,39,54,28,39,6,15,2,5,10,34,54
2011-02-21 00:00:00.000,Dubai U.A.E. ATP World Tour 500,HARD,2,Florian Mayer,Andrey Golubev,Florian Mayer,6-3; 6-4,R16,75,1,2,34,61,26,34,14,27,3,4,10,40,61,3,2,30,57,19,30,13,27,4,7,9,32,57
2011-02-21 00:00:00.000,Dubai U.A.E. ATP World Tour 500,HARD,2,Novak Djokovic,Feliciano Lopez,Novak Djokovic,6-3; 2-6; 6-4,R16,109,6,2,48,73,34,48,15,25,1,4,14,49,73,7,6,36,74,29,36,19,38,3,6,13,48,74
2011-02-21 00:00:00.000,Dubai U.A.E. ATP World Tour 500,HARD,2,Roger Federer,Sergiy Stakhovsky,Roger Federer,6-3; 6-4,Q,73,6,2,42,67,30,42,14,25,8,9,10,44,67,3,1,30,57,21,30,13,27,6,9,9,34,57
2011-02-21 00:00:00.000,Dubai U.A.E. ATP World Tour 500,HARD,2,Richard Gasquet,Gilles Simon,Richard Gasquet,5-7; 6-2; 6-4,Q,124,4,1,51,92,36,51,24,41,3,5,15,60,92,4,4,50,85,35,50,15,35,3,7,15,50,85
2011-02-21 00:00:00.000,Dubai U.A.E. ATP World Tour 500,HARD,2,Tomas Berdych,Philipp Petzschner,Tomas Berdych,7-5; 6-4,Q,107,6,1,43,77,30,43,16,34,6,8,11,46,77,11,1,31,65,19,31,18,34,6,10,11,37,65
2011-02-21 00:00:00.000,Dubai U.A.E. ATP World Tour 500,HARD,2,Novak Djokovic,Florian Mayer,Novak Djokovic,7-5; 6-1,Q,76,6,2,42,62,36,42,8,20,4,5,10,44,62,3,4,30,57,18,30,11,27,3,7,9,29,57
2011-02-21 00:00:00.000,Dubai U.A.E. ATP World Tour 500,HARD,2,Roger Federer,Richard Gasquet,Roger Federer,6-2; 7-5,S,74,6,1,38,57,30,38,9,19,1,2,10,39,57,7,4,45,67,24,45,12,22,4,8,10,36,67
2011-02-21 00:00:00.000,Dubai U.A.E. ATP World Tour 500,HARD,2,Novak Djokovic,Tomas Berdych,Novak Djokovic,6-7(5); 6-2; 4-2 RET,S,142,10,2,53,84,40,53,20,31,4,4,13,60,84,9,1,42,86,34,42,18,44,2,5,13,52,86
2011-02-21 00:00:00.000,Dubai U.A.E. ATP World Tour 500,HARD,2,Novak Djokovic,Roger Federer,Novak Djokovic,6-3; 6-3,F,72,5,0,33,49,27,33,9,16,1,2,9,36,49,5,1,35,58,22,35,9,23,6,10,9,31,58
2011-03-10 00:00:00.000,ATP World Tour Masters 1000 Indian Wells CA; U.S.A. ATP World Tour Masters 1000,HARD,2,Rafael Nadal,N/A Bye,Rafael Nadal,,R128,0,0,0,0,0,0,0,0,0,0,0,0,0,0,0,0,0,0,0,0,0,0,0,0,0,0,0
2011-03-10 00:00:00.000,ATP World Tour Masters 1000 Indian Wells CA; U.S.A. ATP World Tour Masters 1000,HARD,2,Rik De Voest,Pere Riba,Rik De Voest,6-4 RET,R128,43,2,0,19,30,16,19,6,11,0,0,5,22,30,1,1,15,34,8,15,12,19,1,2,5,20,34
2011-03-10 00:00:00.000,ATP World Tour Masters 1000 Indian Wells CA; U.S.A. ATP World Tour Masters 1000,HARD,2,Ryan Sweeting,Marcel Granollers,Ryan Sweeting,6-4; 6-1,R128,86,3,3,37,53,27,37,8,16,4,5,8,35,53,1,5,34,68,21,34,13,34,5,10,9,34,68
2011-03-10 00:00:00.000,ATP World Tour Masters 1000 Indian Wells CA; U.S.A. ATP World Tour Masters 1000,HARD,2,Juan Monaco,N/A Bye,Juan Monaco,,R128,0,0,0,0,0,0,0,0,0,0,0,0,0,0,0,0,0,0,0,0,0,0,0,0,0,0,0
2011-03-10 00:00:00.000,ATP World Tour Masters 1000 Indian Wells CA; U.S.A. ATP World Tour Masters 1000,HARD,2,Marcos Baghdatis,N/A Bye,Marcos Baghdatis,,R128,0,0,0,0,0,0,0,0,0,0,0,0,0,0,0,0,0,0,0,0,0,0,0,0,0,0,0
2011-03-10 00:00:00.000,ATP World Tour Masters 1000 Indian Wells CA; U.S.A. ATP World Tour Masters 1000,HARD,2,Somdev Devvarman,Adrian Mannarino,Somdev Devvarman,6-2; 6-3,R128,84,6,0,34,51,27,34,9,17,4,4,8,36,51,3,3,41,67,23,41,13,26,5,9,9,36,67
2011-03-10 00:00:00.000,ATP World Tour Masters 1000 Indian Wells CA; U.S.A. ATP World Tour Masters 1000,HARD,2,Xavier Malisse,Flavio Cipolla,Xavier Malisse,6-1; 6-4,R128,70,8,0,30,54,24,30,12,24,1,2,9,36,54,1,5,27,48,15,27,9,21,1,5,8,24,48
2011-03-10 00:00:00.000,ATP World Tour Masters 1000 Indian Wells CA; U.S.A. ATP World Tour Masters 1000,HARD,2,Jo-Wilfried Tsonga,N/A Bye,Jo-Wilfried Tsonga,,R128,0,0,0,0,0,0,0,0,0,0,0,0,0,0,0,0,0,0,0,0,0,0,0,0,0,0,0
2011-03-10 00:00:00.000,ATP World Tour Masters 1000 Indian Wells CA; U.S.A. ATP World Tour Masters 1000,HARD,2,Nicolas Almagro,N/A Bye,Nicolas Almagro,,R128,0,0,0,0,0,0,0,0,0,0,0,0,0,0,0,0,0,0,0,0,0,0,0,0,0,0,0
2011-03-10 00:00:00.000,ATP World Tour Masters 1000 Indian Wells CA; U.S.A. ATP World Tour Masters 1000,HARD,2,Michael Russell,Kevin Anderson,Michael Russell,6-7(4); 6-3; 6-4,R128,151,0,2,75,100,56,75,18,25,5,5,16,74,100,12,3,58,98,43,58,21,40,5,7,15,64,98
2011-03-10 00:00:00.000,ATP World Tour Masters 1000 Indian Wells CA; U.S.A. ATP World Tour Masters 1000,HARD,2,Jarkko Nieminen,Denis Istomin,Jarkko Nieminen,2-6; 7-5; 7-5,R128,137,1,7,66,108,43,66,12,42,6,14,16,55,108,6,3,69,97,39,69,11,28,8,16,16,50,97
2011-03-10 00:00:00.000,ATP World Tour Masters 1000 Indian Wells CA; U.S.A. ATP World Tour Masters 1000,HARD,2,Albert Montanes,N/A Bye,Albert Montanes,,R128,0,0,0,0,0,0,0,0,0,0,0,0,0,0,0,0,0,0,0,0,0,0,0,0,0,0,0
2011-03-10 00:00:00.000,ATP World Tour Masters 1000 Indian Wells CA; U.S.A. ATP World Tour Masters 1000,HARD,2,Gilles Simon,N/A Bye,Gilles Simon,,R128,0,0,0,0,0,0,0,0,0,0,0,0,0,0,0,0,0,0,0,0,0,0,0,0,0,0,0
2011-03-10 00:00:00.000,ATP World Tour Masters 1000 Indian Wells CA; U.S.A. ATP World Tour Masters 1000,HARD,2,Rainer Schuettler,Robin Haase,Rainer Schuettler,7-6(4); 7-5,R128,131,4,1,66,95,43,66,13,29,6,9,12,56,95,1,5,53,93,33,53,19,40,4,8,12,52,93
2011-03-10 00:00:00.000,ATP World Tour Masters 1000 Indian Wells CA; U.S.A. ATP World Tour Masters 1000,HARD,2,Ivo Karlovic,Marinko Matosevic,Ivo Karlovic,7-6(2); 6-7(3); 6-2,R128,128,17,2,61,93,52,61,16,32,0,1,16,68,93,6,2,59,103,45,59,21,44,3,6,16,66,103
2011-03-10 00:00:00.000,ATP World Tour Masters 1000 Indian Wells CA; U.S.A. ATP World Tour Masters 1000,HARD,2,David Ferrer,N/A Bye,David Ferrer,,R128,0,0,0,0,0,0,0,0,0,0,0,0,0,0,0,0,0,0,0,0,0,0,0,0,0,0,0
2011-03-10 00:00:00.000,ATP World Tour Masters 1000 Indian Wells CA; U.S.A. ATP World Tour Masters 1000,HARD,2,Robin Soderling,N/A Bye,Robin Soderling,,R128,0,0,0,0,0,0,0,0,0,0,0,0,0,0,0,0,0,0,0,0,0,0,0,0,0,0,0
2011-03-10 00:00:00.000,ATP World Tour Masters 1000 Indian Wells CA; U.S.A. ATP World Tour Masters 1000,HARD,2,Michael Berrer,Bjorn Phau,Michael Berrer,6-4; 4-6; 6-4,R128,128,5,11,65,95,48,65,10,30,4,7,15,58,95,3,7,59,92,42,59,15,33,2,6,15,57,92
2011-03-10 00:00:00.000,ATP World Tour Masters 1000 Indian Wells CA; U.S.A. ATP World Tour Masters 1000,HARD,2,Tim Smyczek,Illya Marchenko,Tim Smyczek,2-6; 6-3; 6-2,R128,132,3,2,40,76,27,40,20,36,3,6,13,47,76,4,5,50,91,30,50,21,41,10,14,12,51,91
2011-03-10 00:00:00.000,ATP World Tour Masters 1000 Indian Wells CA; U.S.A. ATP World Tour Masters 1000,HARD,2,Philipp Kohlschreiber,N/A Bye,Philipp Kohlschreiber,,R128,0,0,0,0,0,0,0,0,0,0,0,0,0,0,0,0,0,0,0,0,0,0,0,0,0,0,0
2011-03-10 00:00:00.000,ATP World Tour Masters 1000 Indian Wells CA; U.S.A. ATP World Tour Masters 1000,HARD,2,Alexandr Dolgopolov,N/A Bye,Alexandr Dolgopolov,,R128,0,0,0,0,0,0,0,0,0,0,0,0,0,0,0,0,0,0,0,0,0,0,0,0,0,0,0
2011-03-10 00:00:00.000,ATP World Tour Masters 1000 Indian Wells CA; U.S.A. ATP World Tour Masters 1000,HARD,2,Victor Hanescu,Andreas Seppi,Victor Hanescu,4-6; 7-6(5); 6-3,R128,123,8,1,51,82,41,51,19,31,0,2,15,60,82,8,4,54,102,42,54,24,48,7,10,16,66,102
2011-03-10 00:00:00.000,ATP World Tour Masters 1000 Indian Wells CA; U.S.A. ATP World Tour Masters 1000,HARD,2,Juan Martin Del Potro,Radek Stepanek,Juan Martin Del Potro,6-4; 6-0,R128,85,5,3,27,57,21,27,16,30,5,6,8,37,57,3,3,33,55,14,33,11,22,3,8,8,25,55
2011-03-10 00:00:00.000,ATP World Tour Masters 1000 Indian Wells CA; U.S.A. ATP World Tour Masters 1000,HARD,2,Ivan Ljubicic,N/A Bye,Ivan Ljubicic,,R128,0,0,0,0,0,0,0,0,0,0,0,0,0,0,0,0,0,0,0,0,0,0,0,0,0,0,0
2011-03-10 00:00:00.000,ATP World Tour Masters 1000 Indian Wells CA; U.S.A. ATP World Tour Masters 1000,HARD,2,Fernando Verdasco,N/A Bye,Fernando Verdasco,,R128,0,0,0,0,0,0,0,0,0,0,0,0,0,0,0,0,0,0,0,0,0,0,0,0,0,0,0
2011-03-10 00:00:00.000,ATP World Tour Masters 1000 Indian Wells CA; U.S.A. ATP World Tour Masters 1000,HARD,2,Ricardas Berankis,Alex Bogomolov Jr.,Ricardas Berankis,1-6; 6-3; 6-4,R128,113,4,4,30,74,21,30,23,44,3,7,13,44,74,5,4,62,85,40,62,10,23,5,9,13,50,85
2011-03-10 00:00:00.000,ATP World Tour Masters 1000 Indian Wells CA; U.S.A. ATP World Tour Masters 1000,HARD,2,Janko Tipsarevic,Tobias Kamke,Janko Tipsarevic,6-2; 6-0,R128,57,5,1,17,34,16,17,12,17,0,0,7,28,34,1,2,24,43,10,24,7,19,1,6,7,17,43
2011-03-10 00:00:00.000,ATP World Tour Masters 1000 Indian Wells CA; U.S.A. ATP World Tour Masters 1000,HARD,2,Sam Querrey,N/A Bye,Sam Querrey,,R128,0,0,0,0,0,0,0,0,0,0,0,0,0,0,0,0,0,0,0,0,0,0,0,0,0,0,0
2011-03-10 00:00:00.000,ATP World Tour Masters 1000 Indian Wells CA; U.S.A. ATP World Tour Masters 1000,HARD,2,Tommy Robredo,N/A Bye,Tommy Robredo,,R128,0,0,0,0,0,0,0,0,0,0,0,0,0,0,0,0,0,0,0,0,0,0,0,0,0,0,0
2011-03-10 00:00:00.000,ATP World Tour Masters 1000 Indian Wells CA; U.S.A. ATP World Tour Masters 1000,HARD,2,Mischa Zverev,Matthew Ebden,Mischa Zverev,6-4; 6-3,R128,68,2,0,35,49,30,35,8,14,2,2,9,38,49,3,3,44,67,26,44,14,23,4,7,10,40,67
2011-03-10 00:00:00.000,ATP World Tour Masters 1000 Indian Wells CA; U.S.A. ATP World Tour Masters 1000,HARD,2,Donald Young,Potito Starace,Donald Young,2-6; 6-3; 6-3,R128,119,3,4,45,96,27,45,29,51,9,12,13,56,96,2,0,41,71,25,41,19,30,2,6,13,44,71
2011-03-10 00:00:00.000,ATP World Tour Masters 1000 Indian Wells CA; U.S.A. ATP World Tour Masters 1000,HARD,2,Andy Murray,N/A Bye,Andy Murray,,R128,0,0,0,0,0,0,0,0,0,0,0,0,0,0,0,0,0,0,0,0,0,0,0,0,0,0,0
2011-03-10 00:00:00.000,ATP World Tour Masters 1000 Indian Wells CA; U.S.A. ATP World Tour Masters 1000,HARD,2,Andy Roddick,N/A Bye,Andy Roddick,,R128,0,0,0,0,0,0,0,0,0,0,0,0,0,0,0,0,0,0,0,0,0,0,0,0,0,0,0
2011-03-10 00:00:00.000,ATP World Tour Masters 1000 Indian Wells CA; U.S.A. ATP World Tour Masters 1000,HARD,2,James Blake,Chris Guccione,James Blake,3-6; 6-3; 6-2,R128,96,6,5,38,70,34,38,20,32,3,4,13,54,70,19,6,49,87,39,49,14,38,5,8,13,53,87
2011-03-10 00:00:00.000,ATP World Tour Masters 1000 Indian Wells CA; U.S.A. ATP World Tour Masters 1000,HARD,2,Ricardo Mello,Ruben Ramirez Hidalgo,Ricardo Mello,6-4; 6-3,R128,95,3,0,34,46,23,34,9,12,0,1,9,32,46,2,3,50,86,30,50,16,36,13,17,10,46,86
2011-03-10 00:00:00.000,ATP World Tour Masters 1000 Indian Wells CA; U.S.A. ATP World Tour Masters 1000,HARD,2,John Isner,N/A Bye,John Isner,,R128,0,0,0,0,0,0,0,0,0,0,0,0,0,0,0,0,0,0,0,0,0,0,0,0,0,0,0
2011-03-10 00:00:00.000,ATP World Tour Masters 1000 Indian Wells CA; U.S.A. ATP World Tour Masters 1000,HARD,2,Richard Gasquet,N/A Bye,Richard Gasquet,,R128,0,0,0,0,0,0,0,0,0,0,0,0,0,0,0,0,0,0,0,0,0,0,0,0,0,0,0
2011-03-10 00:00:00.000,ATP World Tour Masters 1000 Indian Wells CA; U.S.A. ATP World Tour Masters 1000,HARD,2,Pablo Cuevas,Pablo Andujar,Pablo Cuevas,7-5; 6-3,R128,79,1,3,34,59,28,34,17,25,0,0,11,45,59,0,3,37,59,25,37,14,22,1,3,10,39,59
2011-03-10 00:00:00.000,ATP World Tour Masters 1000 Indian Wells CA; U.S.A. ATP World Tour Masters 1000,HARD,2,Julien Benneteau,Feliciano Lopez,Julien Benneteau,6-4; 6-4,R128,85,7,3,45,72,33,45,16,27,4,4,10,49,72,6,2,29,55,22,29,16,26,4,6,10,38,55
2011-03-10 00:00:00.000,ATP World Tour Masters 1000 Indian Wells CA; U.S.A. ATP World Tour Masters 1000,HARD,2,Jurgen Melzer,N/A Bye,Jurgen Melzer,,R128,0,0,0,0,0,0,0,0,0,0,0,0,0,0,0,0,0,0,0,0,0,0,0,0,0,0,0
2011-03-10 00:00:00.000,ATP World Tour Masters 1000 Indian Wells CA; U.S.A. ATP World Tour Masters 1000,HARD,2,Viktor Troicki,N/A Bye,Viktor Troicki,,R128,0,0,0,0,0,0,0,0,0,0,0,0,0,0,0,0,0,0,0,0,0,0,0,0,0,0,0
2011-03-10 00:00:00.000,ATP World Tour Masters 1000 Indian Wells CA; U.S.A. ATP World Tour Masters 1000,HARD,2,Bernard Tomic,Rohan Bopanna,Bernard Tomic,6-7(5); 7-6(1); 6-4,R128,109,14,3,65,102,52,65,25,37,2,2,17,77,102,23,2,55,104,46,55,31,49,6,7,17,77,104
2011-03-10 00:00:00.000,ATP World Tour Masters 1000 Indian Wells CA; U.S.A. ATP World Tour Masters 1000,HARD,2,Santiago Giraldo,Daniel Gimeno-Traver,Santiago Giraldo,6-4; 6-7(5); 6-3,R128,149,4,4,63,107,45,63,24,44,1,3,16,69,107,5,6,55,106,38,55,25,51,6,10,15,63,106
2011-03-10 00:00:00.000,ATP World Tour Masters 1000 Indian Wells CA; U.S.A. ATP World Tour Masters 1000,HARD,2,Michael Llodra,N/A Bye,Michael Llodra,,R128,0,0,0,0,0,0,0,0,0,0,0,0,0,0,0,0,0,0,0,0,0,0,0,0,0,0,0
2011-03-10 00:00:00.000,ATP World Tour Masters 1000 Indian Wells CA; U.S.A. ATP World Tour Masters 1000,HARD,2,Ernests Gulbis,N/A Bye,Ernests Gulbis,,R128,0,0,0,0,0,0,0,0,0,0,0,0,0,0,0,0,0,0,0,0,0,0,0,0,0,0,0
2011-03-10 00:00:00.000,ATP World Tour Masters 1000 Indian Wells CA; U.S.A. ATP World Tour Masters 1000,HARD,2,Yen-Hsun Lu,Lleyton Hewitt,Yen-Hsun Lu,6-2; 6-3,R128,83,2,2,42,71,31,42,13,29,6,8,9,44,71,0,5,20,44,14,20,4,24,3,8,8,18,44
2011-03-10 00:00:00.000,ATP World Tour Masters 1000 Indian Wells CA; U.S.A. ATP World Tour Masters 1000,HARD,2,Andrey Golubev,Florian Mayer,Andrey Golubev,6-2; 6-1,R128,45,4,0,24,37,21,24,11,13,0,0,8,32,37,1,2,21,34,8,21,7,13,0,4,7,15,34
2011-03-10 00:00:00.000,ATP World Tour Masters 1000 Indian Wells CA; U.S.A. ATP World Tour Masters 1000,HARD,2,Novak Djokovic,N/A Bye,Novak Djokovic,,R128,0,0,0,0,0,0,0,0,0,0,0,0,0,0,0,0,0,0,0,0,0,0,0,0,0,0,0
2011-03-10 00:00:00.000,ATP World Tour Masters 1000 Indian Wells CA; U.S.A. ATP World Tour Masters 1000,HARD,2,Tomas Berdych,N/A Bye,Tomas Berdych,,R128,0,0,0,0,0,0,0,0,0,0,0,0,0,0,0,0,0,0,0,0,0,0,0,0,0,0,0
2011-03-10 00:00:00.000,ATP World Tour Masters 1000 Indian Wells CA; U.S.A. ATP World Tour Masters 1000,HARD,2,Lukasz Kubot,Mikhail Kukushkin,Lukasz Kubot,7-6(8); 6-4,R128,122,8,9,54,87,41,54,18,33,5,6,11,59,87,6,2,54,78,39,54,11,24,4,6,11,50,78
2011-03-10 00:00:00.000,ATP World Tour Masters 1000 Indian Wells CA; U.S.A. ATP World Tour Masters 1000,HARD,2,Benjamin Becker,Thiemo de Bakker,Benjamin Becker,6-2; 7-5,R128,86,11,2,28,53,25,28,16,25,0,0,10,41,53,7,2,35,68,24,35,17,33,4,7,10,41,68
2011-03-10 00:00:00.000,ATP World Tour Masters 1000 Indian Wells CA; U.S.A. ATP World Tour Masters 1000,HARD,2,Thomaz Bellucci,N/A Bye,Thomaz Bellucci,,R128,0,0,0,0,0,0,0,0,0,0,0,0,0,0,0,0,0,0,0,0,0,0,0,0,0,0,0
2011-03-10 00:00:00.000,ATP World Tour Masters 1000 Indian Wells CA; U.S.A. ATP World Tour Masters 1000,HARD,2,Marin Cilic,N/A Bye,Marin Cilic,,R128,0,0,0,0,0,0,0,0,0,0,0,0,0,0,0,0,0,0,0,0,0,0,0,0,0,0,0
2011-03-10 00:00:00.000,ATP World Tour Masters 1000 Indian Wells CA; U.S.A. ATP World Tour Masters 1000,HARD,2,Florent Serra,Teymuraz Gabashvili,Florent Serra,6-4; 6-7(1); 7-6(4),R128,166,5,2,64,119,44,64,24,55,7,11,17,68,119,7,5,49,100,38,49,25,51,8,13,17,63,100
2011-03-10 00:00:00.000,ATP World Tour Masters 1000 Indian Wells CA; U.S.A. ATP World Tour Masters 1000,HARD,2,Nikolay Davydenko,Fabio Fognini,Nikolay Davydenko,5-7; 6-2; 6-4,R128,128,0,5,63,90,38,63,17,27,4,8,15,55,90,4,5,59,104,39,59,15,45,10,16,15,54,104
2011-03-10 00:00:00.000,ATP World Tour Masters 1000 Indian Wells CA; U.S.A. ATP World Tour Masters 1000,HARD,2,Stanislas Wawrinka,N/A Bye,Stanislas Wawrinka,,R128,0,0,0,0,0,0,0,0,0,0,0,0,0,0,0,0,0,0,0,0,0,0,0,0,0,0,0
2011-03-10 00:00:00.000,ATP World Tour Masters 1000 Indian Wells CA; U.S.A. ATP World Tour Masters 1000,HARD,2,Mardy Fish,N/A Bye,Mardy Fish,,R128,0,0,0,0,0,0,0,0,0,0,0,0,0,0,0,0,0,0,0,0,0,0,0,0,0,0,0
2011-03-10 00:00:00.000,ATP World Tour Masters 1000 Indian Wells CA; U.S.A. ATP World Tour Masters 1000,HARD,2,Milos Raonic,Marsel Ilhan,Milos Raonic,6-2; 7-6(4),R128,85,10,3,28,61,24,28,21,33,2,3,10,45,61,3,2,46,71,25,46,16,25,4,7,10,41,71
2011-03-10 00:00:00.000,ATP World Tour Masters 1000 Indian Wells CA; U.S.A. ATP World Tour Masters 1000,HARD,2,Ryan Harrison,Jeremy Chardy,Ryan Harrison,6-7(5); 7-6(2); 6-3,R128,157,13,2,71,113,57,71,17,42,9,12,17,74,113,9,9,75,116,47,75,19,41,6,10,16,66,116
2011-03-10 00:00:00.000,ATP World Tour Masters 1000 Indian Wells CA; U.S.A. ATP World Tour Masters 1000,HARD,2,Guillermo Garcia-Lopez,N/A Bye,Guillermo Garcia-Lopez,,R128,0,0,0,0,0,0,0,0,0,0,0,0,0,0,0,0,0,0,0,0,0,0,0,0,0,0,0
2011-03-10 00:00:00.000,ATP World Tour Masters 1000 Indian Wells CA; U.S.A. ATP World Tour Masters 1000,HARD,2,Juan Ignacio Chela,N/A Bye,Juan Ignacio Chela,,R128,0,0,0,0,0,0,0,0,0,0,0,0,0,0,0,0,0,0,0,0,0,0,0,0,0,0,0
2011-03-10 00:00:00.000,ATP World Tour Masters 1000 Indian Wells CA; U.S.A. ATP World Tour Masters 1000,HARD,2,Philipp Petzschner,Dustin Brown,Philipp Petzschner,6-4; 7-5,R128,84,5,7,35,71,27,35,19,36,1,2,11,46,71,3,1,39,70,25,39,18,31,4,7,11,43,70
2011-03-10 00:00:00.000,ATP World Tour Masters 1000 Indian Wells CA; U.S.A. ATP World Tour Masters 1000,HARD,2,Igor Andreev,Kei Nishikori,Igor Andreev,6-4; 6-7(2); 6-4,R128,153,9,0,55,102,38,55,30,47,3,5,16,68,102,1,6,56,106,40,56,27,50,5,9,16,67,106
2011-03-10 00:00:00.000,ATP World Tour Masters 1000 Indian Wells CA; U.S.A. ATP World Tour Masters 1000,HARD,2,Roger Federer,N/A Bye,Roger Federer,,R128,0,0,0,0,0,0,0,0,0,0,0,0,0,0,0,0,0,0,0,0,0,0,0,0,0,0,0
2011-03-10 00:00:00.000,ATP World Tour Masters 1000 Indian Wells CA; U.S.A. ATP World Tour Masters 1000,HARD,2,Rafael Nadal,Rik De Voest,Rafael Nadal,6-0; 6-2,R64,60,1,3,16,34,16,16,12,18,0,0,7,28,34,1,2,28,48,15,28,7,20,3,8,7,22,48
2011-03-10 00:00:00.000,ATP World Tour Masters 1000 Indian Wells CA; U.S.A. ATP World Tour Masters 1000,HARD,2,Ryan Sweeting,Juan Monaco,Ryan Sweeting,6-1; 0-6; 6-1,R64,106,2,0,49,68,29,49,12,19,8,11,10,41,68,2,1,55,77,31,55,10,22,4,9,10,41,77
2011-03-10 00:00:00.000,ATP World Tour Masters 1000 Indian Wells CA; U.S.A. ATP World Tour Masters 1000,HARD,2,Somdev Devvarman,Marcos Baghdatis,Somdev Devvarman,7-5; 6-0,R64,73,0,1,27,46,23,27,13,19,2,3,9,36,46,5,6,26,57,18,26,11,31,3,8,9,29,57
2011-03-10 00:00:00.000,ATP World Tour Masters 1000 Indian Wells CA; U.S.A. ATP World Tour Masters 1000,HARD,2,Xavier Malisse,Jo-Wilfried Tsonga,Xavier Malisse,7-6(6); 7-5,R64,94,3,0,44,72,34,44,18,28,2,4,12,52,72,8,3,44,75,34,44,13,31,5,8,12,47,75
2011-03-10 00:00:00.000,ATP World Tour Masters 1000 Indian Wells CA; U.S.A. ATP World Tour Masters 1000,HARD,2,Nicolas Almagro,Michael Russell,Nicolas Almagro,6-4; 6-4,R64,79,9,3,39,57,32,39,10,18,2,3,10,42,57,1,4,49,69,33,49,8,20,8,11,10,41,69
2011-03-10 00:00:00.000,ATP World Tour Masters 1000 Indian Wells CA; U.S.A. ATP World Tour Masters 1000,HARD,2,Albert Montanes,Jarkko Nieminen,Albert Montanes,7-6(5); 2-6; 7-6(2),R64,147,4,8,68,112,51,68,20,44,6,10,16,71,112,6,1,76,115,51,76,23,39,6,8,16,74,115
2011-03-10 00:00:00.000,ATP World Tour Masters 1000 Indian Wells CA; U.S.A. ATP World Tour Masters 1000,HARD,2,Gilles Simon,Rainer Schuettler,Gilles Simon,6-3; 7-6(5),R64,100,4,4,36,68,27,36,18,32,2,4,11,45,68,2,2,38,68,25,38,15,30,3,6,10,40,68
2011-03-10 00:00:00.000,ATP World Tour Masters 1000 Indian Wells CA; U.S.A. ATP World Tour Masters 1000,HARD,2,Ivo Karlovic,David Ferrer,Ivo Karlovic,7-6(3); 6-3,R64,96,9,5,42,73,36,42,15,31,3,3,11,51,73,1,5,31,68,22,31,21,37,3,4,10,43,68
2011-03-10 00:00:00.000,ATP World Tour Masters 1000 Indian Wells CA; U.S.A. ATP World Tour Masters 1000,HARD,2,Robin Soderling,Michael Berrer,Robin Soderling,6-3; 7-6(4),R64,100,6,2,49,75,33,49,18,26,8,10,11,51,75,9,3,41,70,30,41,11,29,4,7,10,41,70
2011-03-10 00:00:00.000,ATP World Tour Masters 1000 Indian Wells CA; U.S.A. ATP World Tour Masters 1000,HARD,2,Philipp Kohlschreiber,Tim Smyczek,Philipp Kohlschreiber,2-6; 6-2; 7-6(6),R64,132,2,4,56,95,40,56,19,39,9,12,14,59,95,4,4,61,98,37,61,24,37,6,9,14,61,98
2011-03-10 00:00:00.000,ATP World Tour Masters 1000 Indian Wells CA; U.S.A. ATP World Tour Masters 1000,HARD,2,Alexandr Dolgopolov,Victor Hanescu,Alexandr Dolgopolov,6-4; 6-4,R64,73,7,2,30,58,23,30,19,28,2,3,10,42,58,2,3,49,64,32,49,6,15,2,5,10,38,64
2011-03-10 00:00:00.000,ATP World Tour Masters 1000 Indian Wells CA; U.S.A. ATP World Tour Masters 1000,HARD,2,Juan Martin Del Potro,Ivan Ljubicic,Juan Martin Del Potro,5-7; 6-4; 6-2,R64,158,8,2,47,87,38,47,25,40,4,5,15,63,87,8,3,46,99,35,46,26,53,4,7,15,61,99
2011-03-10 00:00:00.000,ATP World Tour Masters 1000 Indian Wells CA; U.S.A. ATP World Tour Masters 1000,HARD,2,Fernando Verdasco,Ricardas Berankis,Fernando Verdasco,7-5; 2-0 RET,R64,72,2,3,32,49,24,32,7,17,2,3,7,31,49,2,3,30,60,22,30,9,30,5,8,7,31,60
2011-03-10 00:00:00.000,ATP World Tour Masters 1000 Indian Wells CA; U.S.A. ATP World Tour Masters 1000,HARD,2,Sam Querrey,Janko Tipsarevic,Sam Querrey,6-4; 6-4,R64,82,11,1,40,59,34,40,9,19,2,2,10,43,59,2,4,41,68,30,41,12,27,6,8,10,42,68
2011-03-10 00:00:00.000,ATP World Tour Masters 1000 Indian Wells CA; U.S.A. ATP World Tour Masters 1000,HARD,2,Tommy Robredo,Mischa Zverev,Tommy Robredo,6-3; 3-6; 7-5,R64,138,8,6,43,83,28,43,25,40,2,6,15,53,83,4,1,79,119,50,79,15,40,15,20,15,65,119
2011-03-10 00:00:00.000,ATP World Tour Masters 1000 Indian Wells CA; U.S.A. ATP World Tour Masters 1000,HARD,2,Donald Young,Andy Murray,Donald Young,7-6(4); 6-3,R64,94,1,7,31,59,26,31,13,28,1,3,10,39,59,8,4,38,77,31,38,11,39,1,5,11,42,77
2011-03-10 00:00:00.000,ATP World Tour Masters 1000 Indian Wells CA; U.S.A. ATP World Tour Masters 1000,HARD,2,Andy Roddick,James Blake,Andy Roddick,6-3; 7-5,R64,90,13,0,32,57,30,32,14,25,4,5,11,44,57,4,5,44,86,23,44,24,42,12,15,10,47,86
2011-03-10 00:00:00.000,ATP World Tour Masters 1000 Indian Wells CA; U.S.A. ATP World Tour Masters 1000,HARD,2,John Isner,Ricardo Mello,John Isner,6-3; 7-6(2),R64,79,12,2,43,60,35,43,14,17,0,0,11,49,60,1,0,46,65,28,46,14,19,3,4,10,42,65
2011-03-10 00:00:00.000,ATP World Tour Masters 1000 Indian Wells CA; U.S.A. ATP World Tour Masters 1000,HARD,2,Richard Gasquet,Pablo Cuevas,Richard Gasquet,7-5; 6-3,R64,75,8,0,40,58,35,40,10,18,1,1,11,45,58,5,0,36,49,26,36,7,13,1,3,10,33,49
2011-03-10 00:00:00.000,ATP World Tour Masters 1000 Indian Wells CA; U.S.A. ATP World Tour Masters 1000,HARD,2,Jurgen Melzer,Julien Benneteau,Jurgen Melzer,1-6; 6-1; 6-4,R64,100,6,2,43,70,25,43,18,27,4,7,12,43,70,3,7,45,73,31,45,11,28,3,7,12,42,73
2011-03-10 00:00:00.000,ATP World Tour Masters 1000 Indian Wells CA; U.S.A. ATP World Tour Masters 1000,HARD,2,Viktor Troicki,Bernard Tomic,Viktor Troicki,6-4; 6-4,R64,94,10,3,33,72,28,33,17,39,5,6,10,45,72,3,4,37,75,24,37,18,38,5,8,10,42,75
2011-03-10 00:00:00.000,ATP World Tour Masters 1000 Indian Wells CA; U.S.A. ATP World Tour Masters 1000,HARD,2,Michael Llodra,Santiago Giraldo,Michael Llodra,7-6(6); 6-4,R64,89,11,2,39,63,30,39,17,24,2,3,11,47,63,2,0,53,76,34,53,15,23,5,7,11,49,76
2011-03-10 00:00:00.000,ATP World Tour Masters 1000 Indian Wells CA; U.S.A. ATP World Tour Masters 1000,HARD,2,Ernests Gulbis,Yen-Hsun Lu,Ernests Gulbis,6-7(1); 7-6(7); 6-1,R64,130,19,3,58,103,49,58,20,45,1,3,16,69,103,2,5,60,96,43,60,17,36,1,5,15,60,96
2011-03-10 00:00:00.000,ATP World Tour Masters 1000 Indian Wells CA; U.S.A. ATP World Tour Masters 1000,HARD,2,Novak Djokovic,Andrey Golubev,Novak Djokovic,6-0; 6-4,R64,60,0,2,23,36,18,23,11,13,0,1,8,29,36,3,2,22,43,12,22,8,21,1,6,8,20,43
2011-03-10 00:00:00.000,ATP World Tour Masters 1000 Indian Wells CA; U.S.A. ATP World Tour Masters 1000,HARD,2,Tomas Berdych,Lukasz Kubot,Tomas Berdych,6-4; 6-1,R64,74,8,2,24,42,22,24,11,18,0,1,9,33,42,7,7,38,58,24,38,6,20,3,7,8,30,58
2011-03-10 00:00:00.000,ATP World Tour Masters 1000 Indian Wells CA; U.S.A. ATP World Tour Masters 1000,HARD,2,Thomaz Bellucci,Benjamin Becker,Thomaz Bellucci,6-3; 7-6(5),R64,89,6,1,47,69,39,47,12,22,2,2,11,51,69,6,6,34,61,28,34,16,27,1,2,10,44,61
2011-03-10 00:00:00.000,ATP World Tour Masters 1000 Indian Wells CA; U.S.A. ATP World Tour Masters 1000,HARD,2,Marin Cilic,Florent Serra,Marin Cilic,6-1; 6-3,R64,55,11,1,26,43,24,26,10,17,2,2,8,34,43,3,3,32,48,19,32,6,16,3,7,8,25,48
2011-03-10 00:00:00.000,ATP World Tour Masters 1000 Indian Wells CA; U.S.A. ATP World Tour Masters 1000,HARD,2,Stanislas Wawrinka,Nikolay Davydenko,Stanislas Wawrinka,3-6; 7-6(5); 6-4,R64,161,3,4,63,103,43,63,18,40,7,12,15,61,103,0,5,81,104,51,81,9,23,5,10,16,60,104
2011-03-10 00:00:00.000,ATP World Tour Masters 1000 Indian Wells CA; U.S.A. ATP World Tour Masters 1000,HARD,2,Milos Raonic,Mardy Fish,Milos Raonic,7-5; 6-4,R64,121,10,3,52,90,37,52,22,38,8,8,11,59,90,6,0,34,67,29,34,14,33,0,2,11,43,67
2011-03-10 00:00:00.000,ATP World Tour Masters 1000 Indian Wells CA; U.S.A. ATP World Tour Masters 1000,HARD,2,Ryan Harrison,Guillermo Garcia-Lopez,Ryan Harrison,6-3; 7-6(4),R64,105,7,4,47,86,32,47,16,39,7,11,11,48,86,0,4,39,66,25,39,9,27,2,7,10,34,66
2011-03-10 00:00:00.000,ATP World Tour Masters 1000 Indian Wells CA; U.S.A. ATP World Tour Masters 1000,HARD,2,Juan Ignacio Chela,Philipp Petzschner,Juan Ignacio Chela,4-6; 7-5; 6-2,R64,144,3,0,59,79,44,59,11,20,3,6,15,55,79,12,5,60,117,43,60,21,57,9,14,15,64,117
2011-03-10 00:00:00.000,ATP World Tour Masters 1000 Indian Wells CA; U.S.A. ATP World Tour Masters 1000,HARD,2,Roger Federer,Igor Andreev,Roger Federer,7-5; 7-6(4),R64,95,4,4,37,69,34,37,17,32,0,1,12,51,69,2,0,43,74,33,43,15,31,3,5,12,48,74
2011-03-10 00:00:00.000,ATP World Tour Masters 1000 Indian Wells CA; U.S.A. ATP World Tour Masters 1000,HARD,2,Rafael Nadal,Ryan Sweeting,Rafael Nadal,6-3; 6-1,R32,69,3,0,21,37,20,21,12,16,0,0,8,32,37,3,4,31,57,19,31,10,26,3,7,8,29,57
2011-03-10 00:00:00.000,ATP World Tour Masters 1000 Indian Wells CA; U.S.A. ATP World Tour Masters 1000,HARD,2,Somdev Devvarman,Xavier Malisse,Somdev Devvarman,6-1; 3-6; 7-6(5),R32,121,5,0,49,84,37,49,22,35,1,2,14,59,84,6,2,44,87,32,44,27,43,2,4,14,59,87
2011-03-10 00:00:00.000,ATP World Tour Masters 1000 Indian Wells CA; U.S.A. ATP World Tour Masters 1000,HARD,2,Albert Montanes,Nicolas Almagro,Albert Montanes,4-6; 6-2; 6-4,R32,112,3,4,59,97,47,59,16,38,8,9,14,63,97,12,9,42,86,36,42,17,44,2,5,14,53,86
2011-03-10 00:00:00.000,ATP World Tour Masters 1000 Indian Wells CA; U.S.A. ATP World Tour Masters 1000,HARD,2,Ivo Karlovic,Gilles Simon,Ivo Karlovic,6-3; 6-3,R32,63,11,2,32,50,30,32,9,18,2,2,9,39,50,2,2,26,45,16,26,12,19,1,4,9,28,45
2011-03-10 00:00:00.000,ATP World Tour Masters 1000 Indian Wells CA; U.S.A. ATP World Tour Masters 1000,HARD,2,Philipp Kohlschreiber,Robin Soderling,Philipp Kohlschreiber,7-6(8); 6-4,R32,98,14,3,35,69,27,35,20,34,1,3,11,47,69,6,4,55,77,37,55,9,22,5,8,11,46,77
2011-03-10 00:00:00.000,ATP World Tour Masters 1000 Indian Wells CA; U.S.A. ATP World Tour Masters 1000,HARD,2,Juan Martin Del Potro,Alexandr Dolgopolov,Juan Martin Del Potro,7-6(3); 6-3,R32,98,5,2,31,66,24,31,16,35,1,3,10,40,66,8,7,41,80,30,41,14,39,2,6,11,44,80
2011-03-10 00:00:00.000,ATP World Tour Masters 1000 Indian Wells CA; U.S.A. ATP World Tour Masters 1000,HARD,2,Sam Querrey,Fernando Verdasco,Sam Querrey,7-5; 6-4,R32,95,8,3,48,75,39,48,13,27,8,8,11,52,75,7,3,46,64,32,46,8,18,3,5,11,40,64
2011-03-10 00:00:00.000,ATP World Tour Masters 1000 Indian Wells CA; U.S.A. ATP World Tour Masters 1000,HARD,2,Tommy Robredo,Donald Young,Tommy Robredo,6-0; 6-4,R32,69,2,1,28,42,23,28,7,14,1,2,8,30,42,1,7,36,57,19,36,8,21,6,11,8,27,57
2011-03-10 00:00:00.000,ATP World Tour Masters 1000 Indian Wells CA; U.S.A. ATP World Tour Masters 1000,HARD,2,Andy Roddick,John Isner,Andy Roddick,7-5; 6-2,R32,68,9,0,32,47,26,32,14,15,0,0,10,40,47,15,2,38,54,29,38,5,16,0,3,10,34,54
2011-03-10 00:00:00.000,ATP World Tour Masters 1000 Indian Wells CA; U.S.A. ATP World Tour Masters 1000,HARD,2,Richard Gasquet,Jurgen Melzer,Richard Gasquet,6-1; 6-3,R32,62,7,1,30,47,25,30,10,17,3,3,8,35,47,2,4,28,52,18,28,7,24,1,5,8,25,52
2011-03-10 00:00:00.000,ATP World Tour Masters 1000 Indian Wells CA; U.S.A. ATP World Tour Masters 1000,HARD,2,Viktor Troicki,Michael Llodra,Viktor Troicki,6-3; 6-3,R32,66,5,0,34,53,26,34,13,19,2,2,9,39,53,4,1,34,54,23,34,9,20,6,9,9,32,54
2011-03-10 00:00:00.000,ATP World Tour Masters 1000 Indian Wells CA; U.S.A. ATP World Tour Masters 1000,HARD,2,Novak Djokovic,Ernests Gulbis,Novak Djokovic,6-0; 6-1,R32,54,4,0,25,44,18,25,13,19,5,5,7,31,44,0,5,20,36,9,20,3,16,1,6,6,12,36
2011-03-10 00:00:00.000,ATP World Tour Masters 1000 Indian Wells CA; U.S.A. ATP World Tour Masters 1000,HARD,2,Tomas Berdych,Thomaz Bellucci,Tomas Berdych,6-3; 6-2,R32,75,2,1,28,48,25,28,13,20,2,2,9,38,48,3,2,35,50,21,35,6,15,5,8,8,27,50
2011-03-10 00:00:00.000,ATP World Tour Masters 1000 Indian Wells CA; U.S.A. ATP World Tour Masters 1000,HARD,2,Stanislas Wawrinka,Marin Cilic,Stanislas Wawrinka,7-5; 6-3,R32,99,3,1,38,58,28,38,15,20,1,2,11,43,58,2,0,31,68,19,31,21,37,7,10,10,40,68
2011-03-10 00:00:00.000,ATP World Tour Masters 1000 Indian Wells CA; U.S.A. ATP World Tour Masters 1000,HARD,2,Ryan Harrison,Milos Raonic,Ryan Harrison,7-6(1); 4-6; 6-4,R32,149,11,1,63,105,48,63,23,42,8,10,16,71,105,17,0,66,98,46,66,20,32,5,7,16,66,98
2011-03-10 00:00:00.000,ATP World Tour Masters 1000 Indian Wells CA; U.S.A. ATP World Tour Masters 1000,HARD,2,Roger Federer,Juan Ignacio Chela,Roger Federer,6-0; 6-2,R32,58,2,0,25,42,20,25,10,17,1,1,7,30,42,0,6,27,49,15,27,6,22,4,9,7,21,49
2011-03-10 00:00:00.000,ATP World Tour Masters 1000 Indian Wells CA; U.S.A. ATP World Tour Masters 1000,HARD,2,Rafael Nadal,Somdev Devvarman,Rafael Nadal,7-5; 6-4,R16,115,0,2,40,68,28,40,18,28,2,3,11,46,68,4,4,54,72,34,54,5,18,6,9,11,39,72
2011-03-10 00:00:00.000,ATP World Tour Masters 1000 Indian Wells CA; U.S.A. ATP World Tour Masters 1000,HARD,2,Ivo Karlovic,Albert Montanes,Ivo Karlovic,7-6(7); 6-2,R16,93,16,3,44,67,38,44,11,23,3,3,10,49,67,3,4,48,74,34,48,13,26,6,8,10,47,74
2011-03-10 00:00:00.000,ATP World Tour Masters 1000 Indian Wells CA; U.S.A. ATP World Tour Masters 1000,HARD,2,Juan Martin Del Potro,Philipp Kohlschreiber,Juan Martin Del Potro,7-6(3); 7-6(7),R16,142,13,2,48,88,40,48,21,40,2,4,12,61,88,11,5,50,95,33,50,26,45,6,8,12,59,95
2011-03-10 00:00:00.000,ATP World Tour Masters 1000 Indian Wells CA; U.S.A. ATP World Tour Masters 1000,HARD,2,Tommy Robredo,Sam Querrey,Tommy Robredo,6-1; 6-3,R16,83,1,1,38,53,26,38,11,15,3,3,8,37,53,3,6,29,57,19,29,11,28,8,12,8,30,57
2011-03-10 00:00:00.000,ATP World Tour Masters 1000 Indian Wells CA; U.S.A. ATP World Tour Masters 1000,HARD,2,Richard Gasquet,Andy Roddick,Richard Gasquet,6-3; 7-6(5),R16,106,8,2,44,69,34,44,15,25,4,5,11,49,69,7,1,49,77,33,49,15,28,5,7,10,48,77
2011-03-10 00:00:00.000,ATP World Tour Masters 1000 Indian Wells CA; U.S.A. ATP World Tour Masters 1000,HARD,2,Novak Djokovic,Viktor Troicki,Novak Djokovic,6-0; 6-1,R16,66,1,4,40,60,29,40,10,20,4,4,7,39,60,3,5,26,43,12,26,4,17,4,9,6,16,43
2011-03-10 00:00:00.000,ATP World Tour Masters 1000 Indian Wells CA; U.S.A. ATP World Tour Masters 1000,HARD,2,Stanislas Wawrinka,Tomas Berdych,Stanislas Wawrinka,3-6; 6-4; 6-4,R16,158,8,3,51,94,39,51,19,43,5,9,15,58,94,0,0,42,92,27,42,24,50,6,10,14,51,92
2011-03-10 00:00:00.000,ATP World Tour Masters 1000 Indian Wells CA; U.S.A. ATP World Tour Masters 1000,HARD,2,Roger Federer,Ryan Harrison,Roger Federer,7-6(4); 6-3,R16,85,10,3,42,68,33,42,14,26,6,8,11,47,68,4,3,36,65,25,36,12,29,4,7,10,37,65
2011-03-10 00:00:00.000,ATP World Tour Masters 1000 Indian Wells CA; U.S.A. ATP World Tour Masters 1000,HARD,2,Rafael Nadal,Ivo Karlovic,Rafael Nadal,5-7; 6-1; 7-6(7),Q,144,6,2,49,81,38,49,27,32,0,1,16,65,81,23,4,62,102,46,62,20,40,6,8,15,66,102
2011-03-10 00:00:00.000,ATP World Tour Masters 1000 Indian Wells CA; U.S.A. ATP World Tour Masters 1000,HARD,2,Juan Martin Del Potro,Tommy Robredo,Juan Martin Del Potro,W/O,Q,0,0,0,0,0,0,0,0,0,0,0,0,0,0,0,0,0,0,0,0,0,0,0,0,0,0,0
2011-03-10 00:00:00.000,ATP World Tour Masters 1000 Indian Wells CA; U.S.A. ATP World Tour Masters 1000,HARD,2,Novak Djokovic,Richard Gasquet,Novak Djokovic,6-2; 6-4,Q,95,2,1,31,54,26,31,9,23,1,3,9,35,54,2,2,49,72,26,49,9,23,7,12,9,35,72
2011-03-10 00:00:00.000,ATP World Tour Masters 1000 Indian Wells CA; U.S.A. ATP World Tour Masters 1000,HARD,2,Roger Federer,Stanislas Wawrinka,Roger Federer,6-3; 6-4,Q,64,2,2,29,52,26,29,15,23,2,2,10,41,52,0,1,32,50,25,32,8,18,1,3,9,33,50
2011-03-10 00:00:00.000,ATP World Tour Masters 1000 Indian Wells CA; U.S.A. ATP World Tour Masters 1000,HARD,2,Rafael Nadal,Juan Martin Del Potro,Rafael Nadal,6-4; 6-4,S,112,4,2,31,55,25,31,14,24,2,3,10,39,55,3,2,43,63,26,43,10,20,1,4,10,36,63
2011-03-10 00:00:00.000,ATP World Tour Masters 1000 Indian Wells CA; U.S.A. ATP World Tour Masters 1000,HARD,2,Novak Djokovic,Roger Federer,Novak Djokovic,6-3; 3-6; 6-2,S,127,3,4,57,85,36,57,15,28,6,9,13,51,85,1,2,48,85,33,48,15,37,5,10,13,48,85
2011-03-10 00:00:00.000,ATP World Tour Masters 1000 Indian Wells CA; U.S.A. ATP World Tour Masters 1000,HARD,2,Novak Djokovic,Rafael Nadal,Novak Djokovic,4-6; 6-3; 6-2,F,146,4,4,55,89,41,55,18,34,6,9,14,59,89,2,0,29,69,20,29,23,40,3,8,13,43,69
2011-03-23 00:00:00.000,ATP World Tour Masters 1000 Miami FL; U.S.A. ATP World Tour Masters 1000,HARD,2,Rafael Nadal,N/A Bye,Rafael Nadal,,R128,0,0,0,0,0,0,0,0,0,0,0,0,0,0,0,0,0,0,0,0,0,0,0,0,0,0,0
2011-03-23 00:00:00.000,ATP World Tour Masters 1000 Miami FL; U.S.A. ATP World Tour Masters 1000,HARD,2,Kei Nishikori,Jeremy Chardy,Kei Nishikori,7-6(5); 6-2,R128,95,3,1,53,68,37,53,12,15,2,2,10,49,68,11,11,42,84,38,42,14,42,5,7,10,52,84
2011-03-23 00:00:00.000,ATP World Tour Masters 1000 Miami FL; U.S.A. ATP World Tour Masters 1000,HARD,2,Feliciano Lopez,Ricardas Berankis,Feliciano Lopez,4-6; 7-6(5); 6-3,R128,146,19,8,47,100,44,47,24,53,6,8,15,68,100,9,5,58,116,39,58,33,58,6,9,16,72,116
2011-03-23 00:00:00.000,ATP World Tour Masters 1000 Miami FL; U.S.A. ATP World Tour Masters 1000,HARD,2,Juan Ignacio Chela,N/A Bye,Juan Ignacio Chela,,R128,0,0,0,0,0,0,0,0,0,0,0,0,0,0,0,0,0,0,0,0,0,0,0,0,0,0,0
2011-03-23 00:00:00.000,ATP World Tour Masters 1000 Miami FL; U.S.A. ATP World Tour Masters 1000,HARD,2,Alexandr Dolgopolov,N/A Bye,Alexandr Dolgopolov,,R128,0,0,0,0,0,0,0,0,0,0,0,0,0,0,0,0,0,0,0,0,0,0,0,0,0,0,0
2011-03-23 00:00:00.000,ATP World Tour Masters 1000 Miami FL; U.S.A. ATP World Tour Masters 1000,HARD,2,Andreas Seppi,Mischa Zverev,Andreas Seppi,6-2; 6-7(9); 6-1,R128,117,6,2,56,89,41,56,19,33,0,1,14,60,89,2,0,64,92,40,64,12,28,4,9,13,52,92
2011-03-23 00:00:00.000,ATP World Tour Masters 1000 Miami FL; U.S.A. ATP World Tour Masters 1000,HARD,2,Teymuraz Gabashvili,Daniel Brands,Teymuraz Gabashvili,6-2; 7-6(5),R128,106,4,7,37,63,29,37,12,26,3,5,10,41,63,5,10,57,89,35,57,10,32,6,10,10,45,89
2011-03-23 00:00:00.000,ATP World Tour Masters 1000 Miami FL; U.S.A. ATP World Tour Masters 1000,HARD,2,Jo-Wilfried Tsonga,N/A Bye,Jo-Wilfried Tsonga,,R128,0,0,0,0,0,0,0,0,0,0,0,0,0,0,0,0,0,0,0,0,0,0,0,0,0,0,0
2011-03-23 00:00:00.000,ATP World Tour Masters 1000 Miami FL; U.S.A. ATP World Tour Masters 1000,HARD,2,Nicolas Almagro,N/A Bye,Nicolas Almagro,,R128,0,0,0,0,0,0,0,0,0,0,0,0,0,0,0,0,0,0,0,0,0,0,0,0,0,0,0
2011-03-23 00:00:00.000,ATP World Tour Masters 1000 Miami FL; U.S.A. ATP World Tour Masters 1000,HARD,2,Frederico Gil,Paul Capdeville,Frederico Gil,6-1; 3-6; 7-6(6),R128,144,4,3,64,105,43,64,20,41,5,9,14,63,105,6,6,65,96,43,65,11,31,3,8,14,54,96
2011-03-23 00:00:00.000,ATP World Tour Masters 1000 Miami FL; U.S.A. ATP World Tour Masters 1000,HARD,2,Florian Mayer,Ivo Karlovic,Florian Mayer,6-4; 7-6(6),R128,75,2,1,32,57,29,32,20,25,0,0,11,49,57,10,0,44,67,35,44,13,23,1,2,11,48,67
2011-03-23 00:00:00.000,ATP World Tour Masters 1000 Miami FL; U.S.A. ATP World Tour Masters 1000,HARD,2,Albert Montanes,N/A Bye,Albert Montanes,,R128,0,0,0,0,0,0,0,0,0,0,0,0,0,0,0,0,0,0,0,0,0,0,0,0,0,0,0
2011-03-23 00:00:00.000,ATP World Tour Masters 1000 Miami FL; U.S.A. ATP World Tour Masters 1000,HARD,2,Ernests Gulbis,N/A Bye,Ernests Gulbis,,R128,0,0,0,0,0,0,0,0,0,0,0,0,0,0,0,0,0,0,0,0,0,0,0,0,0,0,0
2011-03-23 00:00:00.000,ATP World Tour Masters 1000 Miami FL; U.S.A. ATP World Tour Masters 1000,HARD,2,Carlos Berlocq,Jack Sock,Carlos Berlocq,7-5; 7-6(6),R128,141,4,5,48,89,34,48,19,41,10,13,12,53,89,4,4,39,80,20,39,25,41,3,7,12,45,80
2011-03-23 00:00:00.000,ATP World Tour Masters 1000 Miami FL; U.S.A. ATP World Tour Masters 1000,HARD,2,Ruben Ramirez Hidalgo,Adrian Mannarino,Ruben Ramirez Hidalgo,7-6(3); 6-7(3); 6-2,R128,161,3,5,49,115,37,49,33,66,6,9,16,70,115,2,7,62,104,46,62,15,42,3,8,16,61,104
2011-03-23 00:00:00.000,ATP World Tour Masters 1000 Miami FL; U.S.A. ATP World Tour Masters 1000,HARD,2,Tomas Berdych,N/A Bye,Tomas Berdych,,R128,0,0,0,0,0,0,0,0,0,0,0,0,0,0,0,0,0,0,0,0,0,0,0,0,0,0,0
2011-03-23 00:00:00.000,ATP World Tour Masters 1000 Miami FL; U.S.A. ATP World Tour Masters 1000,HARD,2,Roger Federer,N/A Bye,Roger Federer,,R128,0,0,0,0,0,0,0,0,0,0,0,0,0,0,0,0,0,0,0,0,0,0,0,0,0,0,0
2011-03-23 00:00:00.000,ATP World Tour Masters 1000 Miami FL; U.S.A. ATP World Tour Masters 1000,HARD,2,Radek Stepanek,Fabio Fognini,Radek Stepanek,6-3; 7-6(5),R128,87,1,1,41,68,28,41,17,27,1,3,11,45,68,2,9,35,65,26,35,11,30,1,4,10,37,65
2011-03-23 00:00:00.000,ATP World Tour Masters 1000 Miami FL; U.S.A. ATP World Tour Masters 1000,HARD,2,Sergiy Stakhovsky,Grigor Dimitrov,Sergiy Stakhovsky,6-2; 6-4,R128,68,4,2,29,52,21,29,14,23,2,3,9,35,52,1,2,32,62,19,32,14,30,5,9,9,33,62
2011-03-23 00:00:00.000,ATP World Tour Masters 1000 Miami FL; U.S.A. ATP World Tour Masters 1000,HARD,2,Juan Monaco,N/A Bye,Juan Monaco,,R128,0,0,0,0,0,0,0,0,0,0,0,0,0,0,0,0,0,0,0,0,0,0,0,0,0,0,0
2011-03-23 00:00:00.000,ATP World Tour Masters 1000 Miami FL; U.S.A. ATP World Tour Masters 1000,HARD,2,Marcos Baghdatis,N/A Bye,Marcos Baghdatis,,R128,0,0,0,0,0,0,0,0,0,0,0,0,0,0,0,0,0,0,0,0,0,0,0,0,0,0,0
2011-03-23 00:00:00.000,ATP World Tour Masters 1000 Miami FL; U.S.A. ATP World Tour Masters 1000,HARD,2,Olivier Rochus,Blaz Kavcic,Olivier Rochus,3-6; 6-4; 7-5,R128,190,2,8,57,117,36,57,29,60,8,14,16,65,117,10,8,67,116,42,67,20,49,10,16,15,62,116
2011-03-23 00:00:00.000,ATP World Tour Masters 1000 Miami FL; U.S.A. ATP World Tour Masters 1000,HARD,2,Yen-Hsun Lu,Pere Riba,Yen-Hsun Lu,6-3; 6-2,R128,61,3,1,23,42,20,23,11,19,4,5,8,31,42,4,7,23,52,12,23,13,29,3,8,9,25,52
2011-03-23 00:00:00.000,ATP World Tour Masters 1000 Miami FL; U.S.A. ATP World Tour Masters 1000,HARD,2,Mikhail Youzhny,N/A Bye,Mikhail Youzhny,,R128,0,0,0,0,0,0,0,0,0,0,0,0,0,0,0,0,0,0,0,0,0,0,0,0,0,0,0
2011-03-23 00:00:00.000,ATP World Tour Masters 1000 Miami FL; U.S.A. ATP World Tour Masters 1000,HARD,2,Jurgen Melzer,N/A Bye,Jurgen Melzer,,R128,0,0,0,0,0,0,0,0,0,0,0,0,0,0,0,0,0,0,0,0,0,0,0,0,0,0,0
2011-03-23 00:00:00.000,ATP World Tour Masters 1000 Miami FL; U.S.A. ATP World Tour Masters 1000,HARD,2,Philipp Petzschner,Florent Serra,Philipp Petzschner,6-1; 7-5,R128,70,6,1,18,49,13,18,15,31,2,5,9,28,49,2,1,30,58,14,30,11,28,5,12,10,25,58
2011-03-23 00:00:00.000,ATP World Tour Masters 1000 Miami FL; U.S.A. ATP World Tour Masters 1000,HARD,2,Janko Tipsarevic,Robin Haase,Janko Tipsarevic,6-4; 7-6(5),R128,103,4,1,38,68,31,38,16,30,1,2,11,47,68,10,5,52,88,35,52,17,36,7,9,11,52,88
2011-03-23 00:00:00.000,ATP World Tour Masters 1000 Miami FL; U.S.A. ATP World Tour Masters 1000,HARD,2,Marin Cilic,N/A Bye,Marin Cilic,,R128,0,0,0,0,0,0,0,0,0,0,0,0,0,0,0,0,0,0,0,0,0,0,0,0,0,0,0
2011-03-23 00:00:00.000,ATP World Tour Masters 1000 Miami FL; U.S.A. ATP World Tour Masters 1000,HARD,2,Gilles Simon,N/A Bye,Gilles Simon,,R128,0,0,0,0,0,0,0,0,0,0,0,0,0,0,0,0,0,0,0,0,0,0,0,0,0,0,0
2011-03-23 00:00:00.000,ATP World Tour Masters 1000 Miami FL; U.S.A. ATP World Tour Masters 1000,HARD,2,Rainer Schuettler,Ryan Harrison,Rainer Schuettler,7-5; 6-2,R128,86,3,3,43,64,29,43,13,21,3,4,10,42,64,2,5,31,58,19,31,14,27,2,6,10,33,58
2011-03-23 00:00:00.000,ATP World Tour Masters 1000 Miami FL; U.S.A. ATP World Tour Masters 1000,HARD,2,Pablo Cuevas,Michael Berrer,Pablo Cuevas,6-4; 7-6(2),R128,97,5,2,40,61,35,40,11,21,1,2,11,46,61,4,4,51,78,38,51,9,27,7,9,11,47,78
2011-03-23 00:00:00.000,ATP World Tour Masters 1000 Miami FL; U.S.A. ATP World Tour Masters 1000,HARD,2,Andy Roddick,N/A Bye,Andy Roddick,,R128,0,0,0,0,0,0,0,0,0,0,0,0,0,0,0,0,0,0,0,0,0,0,0,0,0,0,0
2011-03-23 00:00:00.000,ATP World Tour Masters 1000 Miami FL; U.S.A. ATP World Tour Masters 1000,HARD,2,David Ferrer,N/A Bye,David Ferrer,,R128,0,0,0,0,0,0,0,0,0,0,0,0,0,0,0,0,0,0,0,0,0,0,0,0,0,0,0
2011-03-23 00:00:00.000,ATP World Tour Masters 1000 Miami FL; U.S.A. ATP World Tour Masters 1000,HARD,2,Igor Kunitsyn,Robert Kendrick,Igor Kunitsyn,5-4 RET,R128,30,2,0,17,27,12,17,7,10,2,2,4,19,27,8,2,14,25,14,14,3,11,0,1,5,17,25
2011-03-23 00:00:00.000,ATP World Tour Masters 1000 Miami FL; U.S.A. ATP World Tour Masters 1000,HARD,2,Somdev Devvarman,Potito Starace,Somdev Devvarman,6-2; 6-4,R128,70,1,0,30,47,23,30,11,17,3,4,9,34,47,0,3,36,59,22,36,9,23,1,5,9,31,59
2011-03-23 00:00:00.000,ATP World Tour Masters 1000 Miami FL; U.S.A. ATP World Tour Masters 1000,HARD,2,Milos Raonic,N/A Bye,Milos Raonic,,R128,0,0,0,0,0,0,0,0,0,0,0,0,0,0,0,0,0,0,0,0,0,0,0,0,0,0,0
2011-03-23 00:00:00.000,ATP World Tour Masters 1000 Miami FL; U.S.A. ATP World Tour Masters 1000,HARD,2,Michael Llodra,N/A Bye,Michael Llodra,,R128,0,0,0,0,0,0,0,0,0,0,0,0,0,0,0,0,0,0,0,0,0,0,0,0,0,0,0
2011-03-23 00:00:00.000,ATP World Tour Masters 1000 Miami FL; U.S.A. ATP World Tour Masters 1000,HARD,2,Xavier Malisse,Ryan Sweeting,Xavier Malisse,7-6(3); 6-4,R128,90,9,1,50,74,38,50,13,24,4,6,11,51,74,5,5,44,75,33,44,12,31,4,7,11,45,75
2011-03-23 00:00:00.000,ATP World Tour Masters 1000 Miami FL; U.S.A. ATP World Tour Masters 1000,HARD,2,Marcel Granollers,Benjamin Becker,Marcel Granollers,6-4; 6-7(4); 6-4,R128,157,5,3,73,115,47,73,25,42,3,5,16,72,115,8,4,43,97,30,43,32,54,6,10,16,62,97
2011-03-23 00:00:00.000,ATP World Tour Masters 1000 Miami FL; U.S.A. ATP World Tour Masters 1000,HARD,2,Stanislas Wawrinka,N/A Bye,Stanislas Wawrinka,,R128,0,0,0,0,0,0,0,0,0,0,0,0,0,0,0,0,0,0,0,0,0,0,0,0,0,0,0
2011-03-23 00:00:00.000,ATP World Tour Masters 1000 Miami FL; U.S.A. ATP World Tour Masters 1000,HARD,2,Mardy Fish,N/A Bye,Mardy Fish,,R128,0,0,0,0,0,0,0,0,0,0,0,0,0,0,0,0,0,0,0,0,0,0,0,0,0,0,0
2011-03-23 00:00:00.000,ATP World Tour Masters 1000 Miami FL; U.S.A. ATP World Tour Masters 1000,HARD,2,Julien Benneteau,Daniel Gimeno-Traver,Julien Benneteau,6-4; 6-3,R128,78,2,3,41,68,31,41,11,27,6,8,10,42,68,5,3,29,52,22,29,6,23,2,6,9,28,52
2011-03-23 00:00:00.000,ATP World Tour Masters 1000 Miami FL; U.S.A. ATP World Tour Masters 1000,HARD,2,Paolo Lorenzi,Ivan Ljubicic,Paolo Lorenzi,7-6(7); 6-1,R128,104,0,4,44,62,33,44,8,18,3,5,10,41,62,4,3,35,72,21,35,18,37,6,10,9,39,72
2011-03-23 00:00:00.000,ATP World Tour Masters 1000 Miami FL; U.S.A. ATP World Tour Masters 1000,HARD,2,Richard Gasquet,N/A Bye,Richard Gasquet,,R128,0,0,0,0,0,0,0,0,0,0,0,0,0,0,0,0,0,0,0,0,0,0,0,0,0,0,0
2011-03-23 00:00:00.000,ATP World Tour Masters 1000 Miami FL; U.S.A. ATP World Tour Masters 1000,HARD,2,Philipp Kohlschreiber,N/A Bye,Philipp Kohlschreiber,,R128,0,0,0,0,0,0,0,0,0,0,0,0,0,0,0,0,0,0,0,0,0,0,0,0,0,0,0
2011-03-23 00:00:00.000,ATP World Tour Masters 1000 Miami FL; U.S.A. ATP World Tour Masters 1000,HARD,2,Juan Martin Del Potro,Ricardo Mello,Juan Martin Del Potro,6-4; 6-4,R128,82,3,1,35,50,28,35,6,15,0,2,10,34,50,1,1,32,58,20,32,12,26,1,5,10,32,58
2011-03-23 00:00:00.000,ATP World Tour Masters 1000 Miami FL; U.S.A. ATP World Tour Masters 1000,HARD,2,Ivan Dodig,Andrey Golubev,Ivan Dodig,6-7(7); 6-4; 6-0,R128,134,8,3,54,94,37,54,26,40,2,4,14,63,94,0,4,47,85,32,47,16,38,2,8,14,48,85
2011-03-23 00:00:00.000,ATP World Tour Masters 1000 Miami FL; U.S.A. ATP World Tour Masters 1000,HARD,2,Robin Soderling,N/A Bye,Robin Soderling,,R128,0,0,0,0,0,0,0,0,0,0,0,0,0,0,0,0,0,0,0,0,0,0,0,0,0,0,0
2011-03-23 00:00:00.000,ATP World Tour Masters 1000 Miami FL; U.S.A. ATP World Tour Masters 1000,HARD,2,Andy Murray,N/A Bye,Andy Murray,,R128,0,0,0,0,0,0,0,0,0,0,0,0,0,0,0,0,0,0,0,0,0,0,0,0,0,0,0
2011-03-23 00:00:00.000,ATP World Tour Masters 1000 Miami FL; U.S.A. ATP World Tour Masters 1000,HARD,2,Alex Bogomolov Jr.,Victor Hanescu,Alex Bogomolov Jr.,6-3; 4-6; 7-5,R128,142,2,6,73,111,52,73,14,38,8,12,15,66,111,5,4,56,95,37,56,15,39,6,12,16,52,95
2011-03-23 00:00:00.000,ATP World Tour Masters 1000 Miami FL; U.S.A. ATP World Tour Masters 1000,HARD,2,Igor Andreev,Santiago Giraldo,Igor Andreev,6-1; 2-6; 6-1,R128,91,3,4,40,70,31,40,13,30,3,5,11,44,70,4,4,43,76,27,43,14,33,5,10,11,41,76
2011-03-23 00:00:00.000,ATP World Tour Masters 1000 Miami FL; U.S.A. ATP World Tour Masters 1000,HARD,2,John Isner,N/A Bye,John Isner,,R128,0,0,0,0,0,0,0,0,0,0,0,0,0,0,0,0,0,0,0,0,0,0,0,0,0,0,0
2011-03-23 00:00:00.000,ATP World Tour Masters 1000 Miami FL; U.S.A. ATP World Tour Masters 1000,HARD,2,Guillermo Garcia-Lopez,N/A Bye,Guillermo Garcia-Lopez,,R128,0,0,0,0,0,0,0,0,0,0,0,0,0,0,0,0,0,0,0,0,0,0,0,0,0,0,0
2011-03-23 00:00:00.000,ATP World Tour Masters 1000 Miami FL; U.S.A. ATP World Tour Masters 1000,HARD,2,Kevin Anderson,Nikolay Davydenko,Kevin Anderson,6-4; 6-3,R128,78,5,2,32,46,27,32,10,14,0,0,9,37,46,4,2,39,56,25,39,7,17,0,3,10,32,56
2011-03-23 00:00:00.000,ATP World Tour Masters 1000 Miami FL; U.S.A. ATP World Tour Masters 1000,HARD,2,Pablo Andujar,Bernard Tomic,Pablo Andujar,6-4; 3-6; 7-5,R128,149,0,7,48,98,29,48,26,50,5,10,15,55,98,4,3,58,96,39,58,18,38,3,9,16,57,96
2011-03-23 00:00:00.000,ATP World Tour Masters 1000 Miami FL; U.S.A. ATP World Tour Masters 1000,HARD,2,Fernando Verdasco,N/A Bye,Fernando Verdasco,,R128,0,0,0,0,0,0,0,0,0,0,0,0,0,0,0,0,0,0,0,0,0,0,0,0,0,0,0
2011-03-23 00:00:00.000,ATP World Tour Masters 1000 Miami FL; U.S.A. ATP World Tour Masters 1000,HARD,2,Viktor Troicki,N/A Bye,Viktor Troicki,,R128,0,0,0,0,0,0,0,0,0,0,0,0,0,0,0,0,0,0,0,0,0,0,0,0,0,0,0
2011-03-23 00:00:00.000,ATP World Tour Masters 1000 Miami FL; U.S.A. ATP World Tour Masters 1000,HARD,2,Marsel Ilhan,Tobias Kamke,Marsel Ilhan,6-2; 6-1,R128,54,4,1,24,40,20,24,9,16,1,1,7,29,40,1,2,29,55,17,29,8,26,6,11,8,25,55
2011-03-23 00:00:00.000,ATP World Tour Masters 1000 Miami FL; U.S.A. ATP World Tour Masters 1000,HARD,2,Mikhail Kukushkin,Jarkko Nieminen,Mikhail Kukushkin,3-6; 6-3; 6-2,R128,114,6,2,45,95,31,45,27,50,11,13,13,58,95,5,4,45,75,31,45,15,30,3,7,13,46,75
2011-03-23 00:00:00.000,ATP World Tour Masters 1000 Miami FL; U.S.A. ATP World Tour Masters 1000,HARD,2,Sam Querrey,N/A Bye,Sam Querrey,,R128,0,0,0,0,0,0,0,0,0,0,0,0,0,0,0,0,0,0,0,0,0,0,0,0,0,0,0
2011-03-23 00:00:00.000,ATP World Tour Masters 1000 Miami FL; U.S.A. ATP World Tour Masters 1000,HARD,2,Thomaz Bellucci,N/A Bye,Thomaz Bellucci,,R128,0,0,0,0,0,0,0,0,0,0,0,0,0,0,0,0,0,0,0,0,0,0,0,0,0,0,0
2011-03-23 00:00:00.000,ATP World Tour Masters 1000 Miami FL; U.S.A. ATP World Tour Masters 1000,HARD,2,James Blake,Michael Russell,James Blake,3-6; 7-6(7); 7-6(3),R128,140,5,8,57,113,40,57,28,56,2,7,17,68,113,4,2,66,99,43,66,22,33,2,5,16,65,99
2011-03-23 00:00:00.000,ATP World Tour Masters 1000 Miami FL; U.S.A. ATP World Tour Masters 1000,HARD,2,Denis Istomin,Donald Young,Denis Istomin,6-4; 6-3,R128,67,6,3,40,59,31,40,11,19,3,4,10,42,59,1,3,26,49,18,26,12,23,3,6,9,30,49
2011-03-23 00:00:00.000,ATP World Tour Masters 1000 Miami FL; U.S.A. ATP World Tour Masters 1000,HARD,2,Novak Djokovic,N/A Bye,Novak Djokovic,,R128,0,0,0,0,0,0,0,0,0,0,0,0,0,0,0,0,0,0,0,0,0,0,0,0,0,0,0
2011-03-23 00:00:00.000,ATP World Tour Masters 1000 Miami FL; U.S.A. ATP World Tour Masters 1000,HARD,2,Rafael Nadal,Kei Nishikori,Rafael Nadal,6-4; 6-4,R64,109,2,2,37,63,28,37,18,26,4,4,10,46,63,2,2,38,61,29,38,10,23,4,6,10,39,61
2011-03-23 00:00:00.000,ATP World Tour Masters 1000 Miami FL; U.S.A. ATP World Tour Masters 1000,HARD,2,Feliciano Lopez,Juan Ignacio Chela,Feliciano Lopez,7-6(3); 3-6; 6-4,R64,127,18,11,45,94,37,45,24,49,2,5,16,61,94,2,7,59,99,42,59,22,40,7,9,15,64,99
2011-03-23 00:00:00.000,ATP World Tour Masters 1000 Miami FL; U.S.A. ATP World Tour Masters 1000,HARD,2,Alexandr Dolgopolov,Andreas Seppi,Alexandr Dolgopolov,6-1; 5-3 RET,R64,58,8,3,24,44,21,24,11,20,0,1,8,32,44,0,5,18,48,9,18,14,30,5,9,7,23,48
2011-03-23 00:00:00.000,ATP World Tour Masters 1000 Miami FL; U.S.A. ATP World Tour Masters 1000,HARD,2,Jo-Wilfried Tsonga,Teymuraz Gabashvili,Jo-Wilfried Tsonga,6-3; 6-7(3); 6-3,R64,129,15,1,56,97,46,56,17,41,6,9,16,63,97,4,6,52,84,36,52,12,32,1,6,14,48,84
2011-03-23 00:00:00.000,ATP World Tour Masters 1000 Miami FL; U.S.A. ATP World Tour Masters 1000,HARD,2,Nicolas Almagro,Frederico Gil,Nicolas Almagro,6-4; 3-6; 6-2,R64,113,11,6,35,78,28,35,25,43,4,5,13,53,78,8,2,56,82,38,56,16,26,6,9,14,54,82
2011-03-23 00:00:00.000,ATP World Tour Masters 1000 Miami FL; U.S.A. ATP World Tour Masters 1000,HARD,2,Florian Mayer,Albert Montanes,Florian Mayer,6-4; 3-1 RET,R64,50,3,0,19,33,16,19,13,14,0,0,7,29,33,0,2,29,43,17,29,9,14,0,2,7,26,43
2011-03-23 00:00:00.000,ATP World Tour Masters 1000 Miami FL; U.S.A. ATP World Tour Masters 1000,HARD,2,Carlos Berlocq,Ernests Gulbis,Carlos Berlocq,6-1; 2-6; 6-4,R64,110,5,6,42,74,33,42,13,32,2,5,13,46,74,9,4,44,79,31,44,14,35,3,7,12,45,79
2011-03-23 00:00:00.000,ATP World Tour Masters 1000 Miami FL; U.S.A. ATP World Tour Masters 1000,HARD,2,Tomas Berdych,Ruben Ramirez Hidalgo,Tomas Berdych,6-1; 6-7(4); 6-0,R64,132,8,0,34,68,28,34,20,34,6,8,12,48,68,1,9,51,100,30,51,18,49,8,16,13,48,100
2011-03-23 00:00:00.000,ATP World Tour Masters 1000 Miami FL; U.S.A. ATP World Tour Masters 1000,HARD,2,Roger Federer,Radek Stepanek,Roger Federer,6-3; 6-3,R64,62,7,1,33,47,27,33,10,14,1,1,9,37,47,4,3,28,44,21,28,4,16,0,3,9,25,44
2011-03-23 00:00:00.000,ATP World Tour Masters 1000 Miami FL; U.S.A. ATP World Tour Masters 1000,HARD,2,Juan Monaco,Sergiy Stakhovsky,Juan Monaco,6-4; 6-7(2); 6-4,R64,153,4,2,74,99,46,74,17,25,3,6,16,63,99,5,3,72,113,49,72,15,41,13,18,16,64,113
2011-03-23 00:00:00.000,ATP World Tour Masters 1000 Miami FL; U.S.A. ATP World Tour Masters 1000,HARD,2,Olivier Rochus,Marcos Baghdatis,Olivier Rochus,6-2; 4-6; 6-4,R64,131,2,2,54,81,34,54,11,27,3,8,14,45,81,9,7,38,90,28,38,18,52,5,12,14,46,90
2011-03-23 00:00:00.000,ATP World Tour Masters 1000 Miami FL; U.S.A. ATP World Tour Masters 1000,HARD,2,Mikhail Youzhny,Yen-Hsun Lu,Mikhail Youzhny,6-1; 6-0,R64,54,2,1,20,37,17,20,12,17,2,2,7,29,37,1,5,19,40,9,19,6,21,8,13,6,15,40
2011-03-23 00:00:00.000,ATP World Tour Masters 1000 Miami FL; U.S.A. ATP World Tour Masters 1000,HARD,2,Philipp Petzschner,Jurgen Melzer,Philipp Petzschner,6-3; 6-4,R64,86,3,3,32,67,23,32,21,35,5,6,10,44,67,5,3,40,63,26,40,10,23,7,10,9,36,63
2011-03-23 00:00:00.000,ATP World Tour Masters 1000 Miami FL; U.S.A. ATP World Tour Masters 1000,HARD,2,Janko Tipsarevic,Marin Cilic,Janko Tipsarevic,6-3; 7-6(4),R64,104,5,5,38,66,31,38,14,28,4,6,11,45,66,5,4,38,72,27,38,14,34,3,6,10,41,72
2011-03-23 00:00:00.000,ATP World Tour Masters 1000 Miami FL; U.S.A. ATP World Tour Masters 1000,HARD,2,Gilles Simon,Rainer Schuettler,Gilles Simon,6-4; 6-3,R64,77,6,2,31,61,23,31,16,30,2,4,10,39,61,0,3,36,59,18,36,12,23,2,6,9,30,59
2011-03-23 00:00:00.000,ATP World Tour Masters 1000 Miami FL; U.S.A. ATP World Tour Masters 1000,HARD,2,Pablo Cuevas,Andy Roddick,Pablo Cuevas,6-4; 7-6(4),R64,117,15,1,44,73,35,44,19,29,4,4,11,54,73,9,6,49,89,35,49,22,40,6,7,11,57,89
2011-03-23 00:00:00.000,ATP World Tour Masters 1000 Miami FL; U.S.A. ATP World Tour Masters 1000,HARD,2,David Ferrer,Igor Kunitsyn,David Ferrer,6-2; 6-1,R64,80,3,2,24,41,17,24,10,17,1,2,7,27,41,0,5,32,71,16,32,15,39,9,15,8,31,71
2011-03-23 00:00:00.000,ATP World Tour Masters 1000 Miami FL; U.S.A. ATP World Tour Masters 1000,HARD,2,Somdev Devvarman,Milos Raonic,Somdev Devvarman,7-6(5); 7-5,R64,121,6,2,50,91,39,50,19,41,5,8,12,58,91,12,7,40,79,29,40,15,39,1,5,12,44,79
2011-03-23 00:00:00.000,ATP World Tour Masters 1000 Miami FL; U.S.A. ATP World Tour Masters 1000,HARD,2,Michael Llodra,Xavier Malisse,Michael Llodra,6-2; 6-3,R64,67,7,1,33,56,25,33,13,23,2,3,9,38,56,1,5,26,49,18,26,6,23,6,10,8,24,49
2011-03-23 00:00:00.000,ATP World Tour Masters 1000 Miami FL; U.S.A. ATP World Tour Masters 1000,HARD,2,Marcel Granollers,Stanislas Wawrinka,Marcel Granollers,6-0; 6-7(4); 6-3,R64,135,5,1,66,96,55,66,13,30,6,6,14,68,96,3,3,54,92,39,54,15,38,3,7,13,54,92
2011-03-23 00:00:00.000,ATP World Tour Masters 1000 Miami FL; U.S.A. ATP World Tour Masters 1000,HARD,2,Mardy Fish,Julien Benneteau,Mardy Fish,6-4; 6-3,R64,80,8,1,34,56,28,34,15,22,2,2,10,43,56,2,1,33,47,20,33,10,14,3,5,9,30,47
2011-03-23 00:00:00.000,ATP World Tour Masters 1000 Miami FL; U.S.A. ATP World Tour Masters 1000,HARD,2,Richard Gasquet,Paolo Lorenzi,Richard Gasquet,6-2; 6-3,R64,70,8,1,39,54,32,39,7,15,1,1,9,39,54,2,3,28,46,18,28,7,18,4,7,8,25,46
2011-03-23 00:00:00.000,ATP World Tour Masters 1000 Miami FL; U.S.A. ATP World Tour Masters 1000,HARD,2,Juan Martin Del Potro,Philipp Kohlschreiber,Juan Martin Del Potro,6-7(3); 6-4; 7-5,R64,183,10,7,58,109,40,58,28,51,6,10,17,68,109,8,6,66,105,46,66,17,39,5,11,17,63,105
2011-03-23 00:00:00.000,ATP World Tour Masters 1000 Miami FL; U.S.A. ATP World Tour Masters 1000,HARD,2,Robin Soderling,Ivan Dodig,Robin Soderling,3-6; 6-2; 6-4,R64,119,3,2,50,85,32,50,18,35,3,7,14,50,85,9,5,37,80,25,37,21,43,6,11,13,46,80
2011-03-23 00:00:00.000,ATP World Tour Masters 1000 Miami FL; U.S.A. ATP World Tour Masters 1000,HARD,2,Alex Bogomolov Jr.,Andy Murray,Alex Bogomolov Jr.,6-1; 7-5,R64,95,0,0,31,50,17,31,12,19,2,5,9,29,50,3,3,32,62,17,32,10,30,4,11,10,27,62
2011-03-23 00:00:00.000,ATP World Tour Masters 1000 Miami FL; U.S.A. ATP World Tour Masters 1000,HARD,2,John Isner,Igor Andreev,John Isner,6-4; 5-7; 7-6(2),R64,138,13,6,74,108,54,74,17,34,3,6,17,71,108,6,5,58,103,43,58,23,45,3,6,17,66,103
2011-03-23 00:00:00.000,ATP World Tour Masters 1000 Miami FL; U.S.A. ATP World Tour Masters 1000,HARD,2,Kevin Anderson,Guillermo Garcia-Lopez,Kevin Anderson,6-3; 5-7; 6-4,R64,142,18,1,78,102,58,78,11,24,4,6,16,69,102,5,5,43,85,36,43,21,42,4,7,15,57,85
2011-03-23 00:00:00.000,ATP World Tour Masters 1000 Miami FL; U.S.A. ATP World Tour Masters 1000,HARD,2,Pablo Andujar,Fernando Verdasco,Pablo Andujar,3-6; 7-6(3); 6-4,R64,154,4,2,79,118,55,79,21,39,5,6,15,76,118,11,9,64,97,56,64,11,33,2,3,16,67,97
2011-03-23 00:00:00.000,ATP World Tour Masters 1000 Miami FL; U.S.A. ATP World Tour Masters 1000,HARD,2,Viktor Troicki,Marsel Ilhan,Viktor Troicki,6-3; 6-3,R64,64,4,0,33,51,26,33,11,18,2,3,9,37,51,0,0,33,48,19,33,6,15,1,5,9,25,48
2011-03-23 00:00:00.000,ATP World Tour Masters 1000 Miami FL; U.S.A. ATP World Tour Masters 1000,HARD,2,Sam Querrey,Mikhail Kukushkin,Sam Querrey,6-3; 6-2,R64,72,13,0,34,59,30,34,12,25,2,2,9,42,59,3,5,30,57,17,30,14,27,7,10,8,31,57
2011-03-23 00:00:00.000,ATP World Tour Masters 1000 Miami FL; U.S.A. ATP World Tour Masters 1000,HARD,2,James Blake,Thomaz Bellucci,James Blake,2-6; 6-4; 7-6(6),R64,120,3,4,59,96,46,59,19,37,3,5,15,65,96,14,3,49,91,42,49,27,42,1,2,15,69,91
2011-03-23 00:00:00.000,ATP World Tour Masters 1000 Miami FL; U.S.A. ATP World Tour Masters 1000,HARD,2,Novak Djokovic,Denis Istomin,Novak Djokovic,6-0; 6-1,R64,49,0,2,26,41,19,26,10,15,2,2,7,29,41,1,1,18,29,4,18,4,11,1,6,6,8,29
2011-03-23 00:00:00.000,ATP World Tour Masters 1000 Miami FL; U.S.A. ATP World Tour Masters 1000,HARD,2,Rafael Nadal,Feliciano Lopez,Rafael Nadal,6-3; 6-3,R32,78,2,1,30,45,27,30,9,15,0,0,9,36,45,7,1,24,51,19,24,11,27,3,6,9,30,51
2011-03-23 00:00:00.000,ATP World Tour Masters 1000 Miami FL; U.S.A. ATP World Tour Masters 1000,HARD,2,Alexandr Dolgopolov,Jo-Wilfried Tsonga,Alexandr Dolgopolov,6-7(2); 6-4; 7-5,R32,152,4,5,53,118,44,53,33,65,8,10,17,77,118,13,2,66,108,51,66,21,42,3,7,17,72,108
2011-03-23 00:00:00.000,ATP World Tour Masters 1000 Miami FL; U.S.A. ATP World Tour Masters 1000,HARD,2,Florian Mayer,Nicolas Almagro,Florian Mayer,6-1; 3-6; 6-1,R32,94,7,1,37,65,30,37,18,28,3,4,12,48,65,8,2,40,75,27,40,16,35,4,8,11,43,75
2011-03-23 00:00:00.000,ATP World Tour Masters 1000 Miami FL; U.S.A. ATP World Tour Masters 1000,HARD,2,Tomas Berdych,Carlos Berlocq,Tomas Berdych,7-6(8); 7-5,R32,135,7,5,44,80,35,44,17,36,5,8,12,52,80,8,6,65,96,44,65,12,31,4,8,12,56,96
2011-03-23 00:00:00.000,ATP World Tour Masters 1000 Miami FL; U.S.A. ATP World Tour Masters 1000,HARD,2,Roger Federer,Juan Monaco,Roger Federer,7-6(4); 6-4,R32,104,3,2,32,64,27,32,19,32,1,2,11,46,64,2,2,51,81,36,51,14,30,7,9,11,50,81
2011-03-23 00:00:00.000,ATP World Tour Masters 1000 Miami FL; U.S.A. ATP World Tour Masters 1000,HARD,2,Olivier Rochus,Mikhail Youzhny,Olivier Rochus,1-6; 6-3; 6-3,R32,126,4,2,53,83,35,53,14,30,9,12,12,49,83,6,2,45,84,29,45,20,39,6,10,13,49,84
2011-03-23 00:00:00.000,ATP World Tour Masters 1000 Miami FL; U.S.A. ATP World Tour Masters 1000,HARD,2,Janko Tipsarevic,Philipp Petzschner,Janko Tipsarevic,6-3; 6-3,R32,74,3,2,25,43,23,25,11,18,1,2,9,34,43,8,1,36,62,25,36,10,26,3,7,9,35,62
2011-03-23 00:00:00.000,ATP World Tour Masters 1000 Miami FL; U.S.A. ATP World Tour Masters 1000,HARD,2,Gilles Simon,Pablo Cuevas,Gilles Simon,4-6; 6-1; 6-2,R32,121,4,2,46,77,37,46,18,31,4,5,13,55,77,2,5,46,79,30,46,13,33,5,9,12,43,79
2011-03-23 00:00:00.000,ATP World Tour Masters 1000 Miami FL; U.S.A. ATP World Tour Masters 1000,HARD,2,David Ferrer,Somdev Devvarman,David Ferrer,6-4; 6-2,R32,102,2,3,33,59,19,33,15,26,2,5,9,34,59,2,1,31,68,16,31,14,37,8,14,9,30,68
2011-03-23 00:00:00.000,ATP World Tour Masters 1000 Miami FL; U.S.A. ATP World Tour Masters 1000,HARD,2,Marcel Granollers,Michael Llodra,Marcel Granollers,7-5; 3-6; 7-5,R32,155,6,2,59,102,42,59,21,43,6,10,16,63,102,3,6,78,122,50,78,20,44,15,20,17,70,122
2011-03-23 00:00:00.000,ATP World Tour Masters 1000 Miami FL; U.S.A. ATP World Tour Masters 1000,HARD,2,Mardy Fish,Richard Gasquet,Mardy Fish,6-4; 6-3,R32,92,8,4,21,57,18,21,23,36,2,3,10,41,57,2,1,28,54,18,28,13,26,2,5,9,31,54
2011-03-23 00:00:00.000,ATP World Tour Masters 1000 Miami FL; U.S.A. ATP World Tour Masters 1000,HARD,2,Juan Martin Del Potro,Robin Soderling,Juan Martin Del Potro,6-3; 6-2,R32,77,12,1,25,45,22,25,14,20,0,0,9,36,45,5,0,38,55,21,38,10,17,8,11,8,31,55
2011-03-23 00:00:00.000,ATP World Tour Masters 1000 Miami FL; U.S.A. ATP World Tour Masters 1000,HARD,2,John Isner,Alex Bogomolov Jr.,John Isner,6-2; 7-6(4),R32,82,11,2,35,53,31,35,13,18,0,0,10,44,53,0,2,43,68,29,43,13,25,2,4,10,42,68
2011-03-23 00:00:00.000,ATP World Tour Masters 1000 Miami FL; U.S.A. ATP World Tour Masters 1000,HARD,2,Kevin Anderson,Pablo Andujar,Kevin Anderson,6-2; 6-3,R32,75,8,0,31,44,29,31,8,13,0,0,9,37,44,0,2,23,49,16,23,11,26,3,6,8,27,49
2011-03-23 00:00:00.000,ATP World Tour Masters 1000 Miami FL; U.S.A. ATP World Tour Masters 1000,HARD,2,Viktor Troicki,Sam Querrey,Viktor Troicki,7-6(5); 3-6; 7-5,R32,155,7,4,72,118,50,72,26,46,6,9,16,76,118,17,2,64,111,45,64,28,47,6,9,17,73,111
2011-03-23 00:00:00.000,ATP World Tour Masters 1000 Miami FL; U.S.A. ATP World Tour Masters 1000,HARD,2,Novak Djokovic,James Blake,Novak Djokovic,6-2; 6-0,R32,53,5,1,27,37,24,27,5,10,0,0,7,29,37,2,4,24,48,14,24,7,24,3,8,7,21,48
2011-03-23 00:00:00.000,ATP World Tour Masters 1000 Miami FL; U.S.A. ATP World Tour Masters 1000,HARD,2,Rafael Nadal,Alexandr Dolgopolov,Rafael Nadal,6-1; 6-2,R16,60,3,0,29,42,25,29,7,13,0,0,8,32,42,4,4,21,43,13,21,6,22,3,7,7,19,43
2011-03-23 00:00:00.000,ATP World Tour Masters 1000 Miami FL; U.S.A. ATP World Tour Masters 1000,HARD,2,Tomas Berdych,Florian Mayer,Tomas Berdych,6-3; 2-6; 7-6(4),R16,144,9,8,53,101,43,53,24,48,2,4,15,67,101,8,3,51,87,43,51,19,36,1,2,14,62,87
2011-03-23 00:00:00.000,ATP World Tour Masters 1000 Miami FL; U.S.A. ATP World Tour Masters 1000,HARD,2,Roger Federer,Olivier Rochus,Roger Federer,6-3; 6-1,R16,53,6,1,25,37,22,25,10,12,0,0,8,32,37,1,3,32,56,21,32,8,24,7,11,8,29,56
2011-03-23 00:00:00.000,ATP World Tour Masters 1000 Miami FL; U.S.A. ATP World Tour Masters 1000,HARD,2,Gilles Simon,Janko Tipsarevic,Gilles Simon,4-6; 7-6(3); 6-2,R16,153,2,6,54,90,41,54,16,36,1,4,15,57,90,2,2,54,100,39,54,23,46,3,7,15,62,100
2011-03-23 00:00:00.000,ATP World Tour Masters 1000 Miami FL; U.S.A. ATP World Tour Masters 1000,HARD,2,David Ferrer,Marcel Granollers,David Ferrer,6-1; 6-2,R16,61,3,1,28,40,24,28,9,12,2,2,8,33,40,3,1,20,40,11,20,8,20,2,6,7,19,40
2011-03-23 00:00:00.000,ATP World Tour Masters 1000 Miami FL; U.S.A. ATP World Tour Masters 1000,HARD,2,Mardy Fish,Juan Martin Del Potro,Mardy Fish,7-5; 7-6(5),R16,145,10,3,51,85,43,51,15,34,5,6,12,58,85,6,3,53,85,36,53,18,32,6,8,12,54,85
2011-03-23 00:00:00.000,ATP World Tour Masters 1000 Miami FL; U.S.A. ATP World Tour Masters 1000,HARD,2,Kevin Anderson,John Isner,Kevin Anderson,6-3; 7-6(4),R16,102,6,2,42,62,37,42,13,20,3,3,11,50,62,12,0,37,61,29,37,13,24,0,1,10,42,61
2011-03-23 00:00:00.000,ATP World Tour Masters 1000 Miami FL; U.S.A. ATP World Tour Masters 1000,HARD,2,Novak Djokovic,Viktor Troicki,Novak Djokovic,6-3; 6-2,R16,84,3,2,42,67,30,42,15,25,2,2,9,45,67,3,2,29,49,15,29,12,20,3,6,8,27,49
2011-03-23 00:00:00.000,ATP World Tour Masters 1000 Miami FL; U.S.A. ATP World Tour Masters 1000,HARD,2,Rafael Nadal,Tomas Berdych,Rafael Nadal,6-2; 3-6; 6-3,Q,137,8,2,55,81,38,55,17,26,6,7,13,55,81,11,0,40,75,30,40,18,35,4,7,13,48,75
2011-03-23 00:00:00.000,ATP World Tour Masters 1000 Miami FL; U.S.A. ATP World Tour Masters 1000,HARD,2,Roger Federer,Gilles Simon,Roger Federer,3-0 RET,Q,11,0,0,3,5,2,3,2,2,0,0,1,4,5,0,0,6,9,1,6,0,3,0,2,2,1,9
2011-03-23 00:00:00.000,ATP World Tour Masters 1000 Miami FL; U.S.A. ATP World Tour Masters 1000,HARD,2,Mardy Fish,David Ferrer,Mardy Fish,7-5; 6-2,Q,82,4,2,33,51,30,33,11,18,2,2,10,41,51,3,5,39,61,25,39,12,22,1,4,10,37,61
2011-03-23 00:00:00.000,ATP World Tour Masters 1000 Miami FL; U.S.A. ATP World Tour Masters 1000,HARD,2,Novak Djokovic,Kevin Anderson,Novak Djokovic,6-4; 6-2,Q,108,6,2,42,64,34,42,10,22,5,5,9,44,64,4,2,40,62,24,40,10,22,1,4,9,34,62
2011-03-23 00:00:00.000,ATP World Tour Masters 1000 Miami FL; U.S.A. ATP World Tour Masters 1000,HARD,2,Rafael Nadal,Roger Federer,Rafael Nadal,6-3; 6-2,S,79,0,0,34,45,28,34,7,11,2,2,8,35,45,6,1,35,58,20,35,11,23,1,5,9,31,58
2011-03-23 00:00:00.000,ATP World Tour Masters 1000 Miami FL; U.S.A. ATP World Tour Masters 1000,HARD,2,Novak Djokovic,Mardy Fish,Novak Djokovic,6-3; 6-1,S,86,4,0,39,56,29,39,8,17,4,4,8,37,56,4,1,26,48,16,26,10,22,3,7,8,26,48
2011-03-23 00:00:00.000,ATP World Tour Masters 1000 Miami FL; U.S.A. ATP World Tour Masters 1000,HARD,2,Novak Djokovic,Rafael Nadal,Novak Djokovic,4-6; 6-3; 7-6(4),F,202,3,0,54,95,36,54,29,41,2,4,16,65,95,5,6,66,110,46,66,20,44,7,9,15,66,110
2011-04-04 00:00:00.000,Casablanca Morocco ATP World Tour 250,CLAY,2,Albert Montanes,N/A Bye,Albert Montanes,,R32,0,0,0,0,0,0,0,0,0,0,0,0,0,0,0,0,0,0,0,0,0,0,0,0,0,0,0
2011-04-04 00:00:00.000,Casablanca Morocco ATP World Tour 250,CLAY,2,Filippo Volandri,Julien Benneteau,Filippo Volandri,7-5; 6-3,R32,99,0,1,47,67,34,47,9,20,4,6,11,43,67,3,3,49,70,29,49,8,21,5,9,10,37,70
2011-04-04 00:00:00.000,Casablanca Morocco ATP World Tour 250,CLAY,2,Blaz Kavcic,Reda El Amrani,Blaz Kavcic,3-4 RET,R32,32,0,3,20,26,12,20,2,6,1,3,4,14,26,1,0,10,16,6,10,3,6,0,1,3,9,16
2011-04-04 00:00:00.000,Casablanca Morocco ATP World Tour 250,CLAY,2,Fabio Fognini,Gerard Granollers,Fabio Fognini,6-2; 4-6; 6-3,R32,136,5,10,48,100,31,48,25,52,8,13,14,56,100,0,3,59,89,29,59,15,30,8,15,13,44,89
2011-04-04 00:00:00.000,Casablanca Morocco ATP World Tour 250,CLAY,2,Andrey Golubev,N/A Bye,Andrey Golubev,,R32,0,0,0,0,0,0,0,0,0,0,0,0,0,0,0,0,0,0,0,0,0,0,0,0,0,0,0
2011-04-04 00:00:00.000,Casablanca Morocco ATP World Tour 250,CLAY,2,Pere Riba,Jesse Huta Galung,Pere Riba,6-3; 6-3,R32,64,2,1,30,48,23,30,13,18,0,0,9,36,48,7,3,31,50,23,31,7,19,0,3,9,30,50
2011-04-04 00:00:00.000,Casablanca Morocco ATP World Tour 250,CLAY,2,Pablo Andujar,Florent Serra,Pablo Andujar,6-1; 3-6; 6-2,R32,90,3,1,40,66,28,40,17,26,1,3,12,45,66,0,0,37,65,26,37,11,28,3,8,12,37,65
2011-04-04 00:00:00.000,Casablanca Morocco ATP World Tour 250,CLAY,2,Jeremy Chardy,Bjorn Phau,Jeremy Chardy,6-2; 7-5,R32,99,6,4,43,76,30,43,17,33,3,4,10,47,76,1,5,40,73,29,40,12,33,10,14,10,41,73
2011-04-04 00:00:00.000,Casablanca Morocco ATP World Tour 250,CLAY,2,Potito Starace,Daniel Brands,Potito Starace,7-5; 6-2,R32,76,1,0,43,53,35,43,8,10,1,1,10,43,53,8,2,39,63,27,39,12,24,4,7,10,39,63
2011-04-04 00:00:00.000,Casablanca Morocco ATP World Tour 250,CLAY,2,Ruben Ramirez Hidalgo,Rui Machado,Ruben Ramirez Hidalgo,7-5; 6-1,R32,93,2,0,31,57,20,31,19,26,1,2,10,39,57,0,4,19,49,12,19,15,30,4,8,9,27,49
2011-04-04 00:00:00.000,Casablanca Morocco ATP World Tour 250,CLAY,2,Frederico Gil,Simone Bolelli,Frederico Gil,6-3; 6-1,R32,71,2,0,23,42,19,23,13,19,0,0,8,32,42,1,1,39,57,21,39,8,18,4,8,8,29,57
2011-04-04 00:00:00.000,Casablanca Morocco ATP World Tour 250,CLAY,2,Gilles Simon,N/A Bye,Gilles Simon,,R32,0,0,0,0,0,0,0,0,0,0,0,0,0,0,0,0,0,0,0,0,0,0,0,0,0,0,0
2011-04-04 00:00:00.000,Casablanca Morocco ATP World Tour 250,CLAY,2,Victor Hanescu,Daniel Gimeno-Traver,Victor Hanescu,4-6; 6-4; 6-4,R32,150,0,6,58,111,41,58,25,53,13,17,15,66,111,5,5,53,99,36,53,19,46,5,10,15,55,99
2011-04-04 00:00:00.000,Casablanca Morocco ATP World Tour 250,CLAY,2,Michael Berrer,Nicolas Devilder,Michael Berrer,6-3; 6-3,R32,84,4,2,26,52,18,26,13,26,5,8,9,31,52,2,0,33,58,16,33,9,25,5,11,9,25,58
2011-04-04 00:00:00.000,Casablanca Morocco ATP World Tour 250,CLAY,2,Andrey Kuznetsov,Sergio Gutierrez-Ferrol,Andrey Kuznetsov,6-1; 7-6(5),R32,77,3,0,36,57,22,36,14,21,2,4,9,36,57,7,4,26,61,21,26,10,35,2,7,10,31,61
2011-04-04 00:00:00.000,Casablanca Morocco ATP World Tour 250,CLAY,2,Marcos Baghdatis,N/A Bye,Marcos Baghdatis,,R32,0,0,0,0,0,0,0,0,0,0,0,0,0,0,0,0,0,0,0,0,0,0,0,0,0,0,0
2011-04-04 00:00:00.000,Casablanca Morocco ATP World Tour 250,CLAY,2,Albert Montanes,Filippo Volandri,Albert Montanes,6-1; 6-4,R16,78,8,0,25,51,21,25,10,26,4,7,9,31,51,0,3,36,62,15,36,12,26,6,12,8,27,62
2011-04-04 00:00:00.000,Casablanca Morocco ATP World Tour 250,CLAY,2,Fabio Fognini,Blaz Kavcic,Fabio Fognini,1-6; 7-5; 7-5,R16,154,3,8,62,106,30,62,21,44,14,22,15,51,106,2,7,54,96,31,54,16,42,7,15,16,47,96
2011-04-04 00:00:00.000,Casablanca Morocco ATP World Tour 250,CLAY,2,Pere Riba,Andrey Golubev,Pere Riba,0-6; 6-1; 7-5,R16,96,3,4,32,70,22,32,21,38,7,12,13,43,70,1,3,37,67,24,37,15,30,3,8,12,39,67
2011-04-04 00:00:00.000,Casablanca Morocco ATP World Tour 250,CLAY,2,Pablo Andujar,Jeremy Chardy,Pablo Andujar,7-6(6); 6-1,R16,90,1,0,43,61,32,43,10,18,0,2,10,42,61,4,2,32,56,20,32,14,24,7,11,9,34,56
2011-04-04 00:00:00.000,Casablanca Morocco ATP World Tour 250,CLAY,2,Potito Starace,Ruben Ramirez Hidalgo,Potito Starace,6-4; 6-3,R16,91,0,2,31,48,23,31,12,17,2,3,9,35,48,1,5,36,70,24,36,14,34,4,8,10,38,70
2011-04-04 00:00:00.000,Casablanca Morocco ATP World Tour 250,CLAY,2,Gilles Simon,Frederico Gil,Gilles Simon,6-3; 6-4,R16,84,4,3,34,62,28,34,15,28,1,1,10,43,62,2,1,31,52,23,31,10,21,0,2,9,33,52
2011-04-04 00:00:00.000,Casablanca Morocco ATP World Tour 250,CLAY,2,Victor Hanescu,Michael Berrer,Victor Hanescu,6-4; 7-6(4),R16,101,6,3,40,66,31,40,16,26,3,4,11,47,66,3,6,38,73,30,38,18,35,4,6,11,48,73
2011-04-04 00:00:00.000,Casablanca Morocco ATP World Tour 250,CLAY,2,Andrey Kuznetsov,Marcos Baghdatis,Andrey Kuznetsov,6-4; 4-6; 6-4,R16,124,1,3,44,90,29,44,28,46,5,9,15,57,90,6,9,35,101,26,35,33,66,7,12,15,59,101
2011-04-04 00:00:00.000,Casablanca Morocco ATP World Tour 250,CLAY,2,Albert Montanes,Fabio Fognini,Albert Montanes,7-6(1); 6-1,Q,101,3,5,31,70,24,31,22,39,0,1,10,46,70,2,7,34,65,26,34,9,31,1,4,9,35,65
2011-04-04 00:00:00.000,Casablanca Morocco ATP World Tour 250,CLAY,2,Pablo Andujar,Pere Riba,Pablo Andujar,6-2; 6-2,Q,74,3,1,35,44,29,35,2,9,0,1,8,31,44,3,3,26,59,18,26,9,33,7,12,8,27,59
2011-04-04 00:00:00.000,Casablanca Morocco ATP World Tour 250,CLAY,2,Potito Starace,Gilles Simon,Potito Starace,6-4; 3-6; 6-4,Q,140,2,3,62,96,41,62,16,34,7,11,14,57,96,3,4,53,95,35,53,19,42,8,13,15,54,95
2011-04-04 00:00:00.000,Casablanca Morocco ATP World Tour 250,CLAY,2,Victor Hanescu,Andrey Kuznetsov,Victor Hanescu,6-7(1); 7-5; 6-2,Q,133,5,2,66,101,46,66,19,35,5,8,16,65,101,2,2,46,96,32,46,24,50,5,11,16,56,96
2011-04-04 00:00:00.000,Casablanca Morocco ATP World Tour 250,CLAY,2,Pablo Andujar,Albert Montanes,Pablo Andujar,6-4; 6-4,S,114,2,2,65,84,38,65,8,19,13,16,10,46,84,4,5,41,67,25,41,8,26,8,13,10,33,67
2011-04-04 00:00:00.000,Casablanca Morocco ATP World Tour 250,CLAY,2,Potito Starace,Victor Hanescu,Potito Starace,6-1; 6-7(3); 7-6(2),S,150,2,0,78,104,52,78,14,26,1,4,16,66,104,2,3,63,93,39,63,20,30,5,10,15,59,93
2011-04-04 00:00:00.000,Casablanca Morocco ATP World Tour 250,CLAY,2,Pablo Andujar,Potito Starace,Pablo Andujar,6-1; 6-2,F,75,0,2,31,54,25,31,12,23,2,2,8,37,54,2,0,33,47,17,33,7,14,4,8,7,24,47
2011-04-04 00:00:00.000,Houston TX; U.S.A. ATP World Tour 250,CLAY,2,Mardy Fish,N/A Bye,Mardy Fish,,R32,0,0,0,0,0,0,0,0,0,0,0,0,0,0,0,0,0,0,0,0,0,0,0,0,0,0,0
2011-04-04 00:00:00.000,Houston TX; U.S.A. ATP World Tour 250,CLAY,2,Albert Ramos,Brian Dabul,Albert Ramos,6-4; 7-5,R32,96,5,1,45,74,31,45,17,29,5,6,11,48,74,2,3,53,68,37,53,5,15,4,7,11,42,68
2011-04-04 00:00:00.000,Houston TX; U.S.A. ATP World Tour 250,CLAY,2,Igor Andreev,Michael Russell,Igor Andreev,6-2; 6-3,R32,73,3,1,37,55,26,37,12,18,2,3,9,38,55,2,6,24,52,16,24,11,28,4,8,8,27,52
2011-04-04 00:00:00.000,Houston TX; U.S.A. ATP World Tour 250,CLAY,2,Kei Nishikori,Franko Skugor,Kei Nishikori,6-3; 6-2,R32,75,2,1,38,61,27,38,15,23,2,2,9,42,61,1,2,30,50,21,30,6,20,3,6,8,27,50
2011-04-04 00:00:00.000,Houston TX; U.S.A. ATP World Tour 250,CLAY,2,Guillermo Garcia-Lopez,N/A Bye,Guillermo Garcia-Lopez,,R32,0,0,0,0,0,0,0,0,0,0,0,0,0,0,0,0,0,0,0,0,0,0,0,0,0,0,0
2011-04-04 00:00:00.000,Houston TX; U.S.A. ATP World Tour 250,CLAY,2,Somdev Devvarman,Robert Kendrick,Somdev Devvarman,6-2; 6-1,R32,62,1,1,32,48,22,32,10,16,3,4,8,32,48,1,4,30,57,15,30,9,27,9,14,7,24,57
2011-04-04 00:00:00.000,Houston TX; U.S.A. ATP World Tour 250,CLAY,2,James Blake,Carlos Berlocq,James Blake,6-7(3); 6-3; 6-4,R32,158,5,3,66,139,46,66,37,73,18,20,16,83,139,1,3,68,92,43,68,12,24,6,10,15,55,92
2011-04-04 00:00:00.000,Houston TX; U.S.A. ATP World Tour 250,CLAY,2,Pablo Cuevas,Ricardo Mello,Pablo Cuevas,6-2; 6-0,R32,53,3,1,17,34,16,17,12,17,0,0,7,28,34,0,1,24,43,10,24,7,19,4,9,7,17,43
2011-04-04 00:00:00.000,Houston TX; U.S.A. ATP World Tour 250,CLAY,2,Ivo Karlovic,Benjamin Becker,Ivo Karlovic,7-6(5); 6-4,R32,90,8,0,34,59,32,34,19,25,0,0,11,51,59,6,3,39,71,34,39,17,32,3,4,11,51,71
2011-04-04 00:00:00.000,Houston TX; U.S.A. ATP World Tour 250,CLAY,2,Igor Kunitsyn,Mischa Zverev,Igor Kunitsyn,7-6(1); 6-2,R32,122,1,3,34,69,21,34,19,35,6,10,10,40,69,0,2,46,78,19,46,16,32,8,14,10,35,78
2011-04-04 00:00:00.000,Houston TX; U.S.A. ATP World Tour 250,CLAY,2,Horacio Zeballos,Ryan Harrison,Horacio Zeballos,6-4; 6-3,R32,96,2,1,38,68,29,38,12,30,4,5,9,41,68,5,3,31,67,18,31,18,36,3,7,10,36,67
2011-04-04 00:00:00.000,Houston TX; U.S.A. ATP World Tour 250,CLAY,2,John Isner,N/A Bye,John Isner,,R32,0,0,0,0,0,0,0,0,0,0,0,0,0,0,0,0,0,0,0,0,0,0,0,0,0,0,0
2011-04-04 00:00:00.000,Houston TX; U.S.A. ATP World Tour 250,CLAY,2,Grigor Dimitrov,Rainer Schuettler,Grigor Dimitrov,6-0; 6-2,R32,64,2,1,25,43,21,25,7,18,4,5,7,28,43,0,7,23,54,12,23,11,31,7,13,7,23,54
2011-04-04 00:00:00.000,Houston TX; U.S.A. ATP World Tour 250,CLAY,2,Teymuraz Gabashvili,Paul Capdeville,Teymuraz Gabashvili,6-4; 7-6(4),R32,110,2,3,43,66,28,43,14,23,0,3,11,42,66,4,1,49,86,30,49,18,37,5,9,11,48,86
2011-04-04 00:00:00.000,Houston TX; U.S.A. ATP World Tour 250,CLAY,2,Ryan Sweeting,Tim Smyczek,Ryan Sweeting,6-2; 6-2,R32,70,3,0,32,48,23,32,11,16,3,4,8,34,48,0,5,28,47,15,28,5,19,3,8,8,20,47
2011-04-04 00:00:00.000,Houston TX; U.S.A. ATP World Tour 250,CLAY,2,Sam Querrey,N/A Bye,Sam Querrey,,R32,0,0,0,0,0,0,0,0,0,0,0,0,0,0,0,0,0,0,0,0,0,0,0,0,0,0,0
2011-04-04 00:00:00.000,Houston TX; U.S.A. ATP World Tour 250,CLAY,2,Mardy Fish,Albert Ramos,Mardy Fish,6-3; 6-4,R16,93,3,2,36,63,27,36,16,27,8,9,10,43,63,3,4,23,52,18,23,12,29,3,6,9,30,52
2011-04-04 00:00:00.000,Houston TX; U.S.A. ATP World Tour 250,CLAY,2,Kei Nishikori,Igor Andreev,Kei Nishikori,6-3; 6-3,R16,76,3,1,38,56,28,38,12,18,1,1,9,40,56,2,4,34,53,25,34,7,19,4,7,9,32,53
2011-04-04 00:00:00.000,Houston TX; U.S.A. ATP World Tour 250,CLAY,2,Guillermo Garcia-Lopez,Somdev Devvarman,Guillermo Garcia-Lopez,6-4; 6-1,R16,88,0,5,19,50,13,19,18,31,0,2,9,31,50,1,1,29,58,16,29,11,29,4,9,8,27,58
2011-04-04 00:00:00.000,Houston TX; U.S.A. ATP World Tour 250,CLAY,2,Pablo Cuevas,James Blake,Pablo Cuevas,7-5; 6-1,R16,70,8,1,35,49,31,35,10,14,2,2,10,41,49,2,4,38,67,28,38,10,29,5,8,9,38,67
2011-04-04 00:00:00.000,Houston TX; U.S.A. ATP World Tour 250,CLAY,2,Ivo Karlovic,Igor Kunitsyn,Ivo Karlovic,6-4; 6-1,R16,66,12,3,31,48,26,31,8,17,1,2,9,34,48,1,1,35,53,20,35,9,18,5,9,8,29,53
2011-04-04 00:00:00.000,Houston TX; U.S.A. ATP World Tour 250,CLAY,2,John Isner,Horacio Zeballos,John Isner,7-5; 6-3,R16,71,14,2,33,52,28,33,14,19,0,0,10,42,52,2,0,34,61,21,34,17,27,1,4,11,38,61
2011-04-04 00:00:00.000,Houston TX; U.S.A. ATP World Tour 250,CLAY,2,Teymuraz Gabashvili,Grigor Dimitrov,Teymuraz Gabashvili,7-6(4); 6-3,R16,138,0,10,46,85,30,46,18,39,8,12,11,48,85,4,7,36,83,23,36,20,47,6,11,10,43,83
2011-04-04 00:00:00.000,Houston TX; U.S.A. ATP World Tour 250,CLAY,2,Ryan Sweeting,Sam Querrey,Ryan Sweeting,3-6; 7-6(5); 6-3,R16,135,1,5,108,141,60,108,16,33,18,24,16,76,141,13,7,59,99,40,59,16,40,5,10,14,56,99
2011-04-04 00:00:00.000,Houston TX; U.S.A. ATP World Tour 250,CLAY,2,Kei Nishikori,Mardy Fish,Kei Nishikori,6-3; 6-2,Q,71,1,5,23,46,22,23,14,23,0,0,9,36,46,1,2,28,42,17,28,7,14,2,5,8,24,42
2011-04-04 00:00:00.000,Houston TX; U.S.A. ATP World Tour 250,CLAY,2,Pablo Cuevas,Guillermo Garcia-Lopez,Pablo Cuevas,1-6; 7-6(4); 6-3,Q,147,5,4,37,78,23,37,21,41,1,7,13,44,78,1,5,65,102,39,65,15,37,4,10,15,54,102
2011-04-04 00:00:00.000,Houston TX; U.S.A. ATP World Tour 250,CLAY,2,Ivo Karlovic,John Isner,Ivo Karlovic,7-6(2); 6-7(2); 7-6(9),Q,196,24,5,87,135,70,87,24,48,10,11,18,94,135,23,3,67,116,56,67,32,49,0,1,18,88,116
2011-04-04 00:00:00.000,Houston TX; U.S.A. ATP World Tour 250,CLAY,2,Ryan Sweeting,Teymuraz Gabashvili,Ryan Sweeting,3-6; 6-3; 6-1,Q,100,5,4,39,66,28,39,17,27,3,5,12,45,66,1,5,34,71,25,34,16,37,2,7,13,41,71
2011-04-04 00:00:00.000,Houston TX; U.S.A. ATP World Tour 250,CLAY,2,Kei Nishikori,Pablo Cuevas,Kei Nishikori,6-3; 7-5,S,104,2,3,34,71,24,34,18,37,6,9,11,42,71,2,1,33,58,18,33,11,25,4,9,10,29,58
2011-04-04 00:00:00.000,Houston TX; U.S.A. ATP World Tour 250,CLAY,2,Ryan Sweeting,Ivo Karlovic,Ryan Sweeting,7-6(3); 6-3,S,99,2,4,48,68,42,48,10,20,4,4,11,52,68,12,4,44,81,34,44,17,37,3,4,10,51,81
2011-04-04 00:00:00.000,Houston TX; U.S.A. ATP World Tour 250,CLAY,2,Ryan Sweeting,Kei Nishikori,Ryan Sweeting,6-4; 7-6(3),F,120,5,6,54,92,37,54,20,38,4,5,11,57,92,1,0,39,68,30,39,14,29,3,5,11,44,68
2011-04-10 00:00:00.000,ATP World Tour Masters 1000 Monte Carlo Monaco ATP World Tour Masters 1000,CLAY,2,Rafael Nadal,N/A Bye,Rafael Nadal,,R64,0,0,0,0,0,0,0,0,0,0,0,0,0,0,0,0,0,0,0,0,0,0,0,0,0,0,0
2011-04-10 00:00:00.000,ATP World Tour Masters 1000 Monte Carlo Monaco ATP World Tour Masters 1000,CLAY,2,Jarkko Nieminen,Julien Benneteau,Jarkko Nieminen,4-6; 6-3; 7-6(3),R64,144,5,3,74,97,51,74,11,23,5,9,16,62,97,5,1,77,107,48,77,14,30,7,11,15,62,107
2011-04-10 00:00:00.000,ATP World Tour Masters 1000 Monte Carlo Monaco ATP World Tour Masters 1000,CLAY,2,Guillermo Garcia-Lopez,Vincent Millot,Guillermo Garcia-Lopez,6-2; 6-4,R64,78,0,2,37,57,24,37,12,20,5,7,9,36,57,1,3,25,53,13,25,12,28,6,11,9,25,53
2011-04-10 00:00:00.000,ATP World Tour Masters 1000 Monte Carlo Monaco ATP World Tour Masters 1000,CLAY,2,Richard Gasquet,Denis Istomin,Richard Gasquet,5-7; 6-3; 6-4,R64,161,2,5,45,94,30,45,31,49,2,5,16,61,94,2,4,68,107,40,68,22,39,11,15,15,62,107
2011-04-10 00:00:00.000,ATP World Tour Masters 1000 Monte Carlo Monaco ATP World Tour Masters 1000,CLAY,2,Jo-Wilfried Tsonga,Juan Monaco,Jo-Wilfried Tsonga,4-6; 6-3; 6-2,R64,151,6,3,62,95,37,62,14,33,3,8,13,51,95,1,3,56,92,32,56,13,36,7,15,14,45,92
2011-04-10 00:00:00.000,ATP World Tour Masters 1000 Monte Carlo Monaco ATP World Tour Masters 1000,CLAY,2,Ivan Ljubicic,Jeremy Chardy,Ivan Ljubicic,6-1; 6-2,R64,64,5,3,35,54,27,35,9,19,3,3,8,36,54,2,5,23,41,13,23,5,18,3,7,7,18,41
2011-04-10 00:00:00.000,ATP World Tour Masters 1000 Monte Carlo Monaco ATP World Tour Masters 1000,CLAY,2,Olivier Rochus,Juan Ignacio Chela,Olivier Rochus,6-4; 5-7; 7-5,R64,185,3,4,69,110,37,69,22,41,8,15,17,59,110,4,2,73,119,40,73,22,46,9,17,17,62,119
2011-04-10 00:00:00.000,ATP World Tour Masters 1000 Monte Carlo Monaco ATP World Tour Masters 1000,CLAY,2,Tomas Berdych,N/A Bye,Tomas Berdych,,R64,0,0,0,0,0,0,0,0,0,0,0,0,0,0,0,0,0,0,0,0,0,0,0,0,0,0,0
2011-04-10 00:00:00.000,ATP World Tour Masters 1000 Monte Carlo Monaco ATP World Tour Masters 1000,CLAY,2,Andy Murray,N/A Bye,Andy Murray,,R64,0,0,0,0,0,0,0,0,0,0,0,0,0,0,0,0,0,0,0,0,0,0,0,0,0,0,0
2011-04-10 00:00:00.000,ATP World Tour Masters 1000 Monte Carlo Monaco ATP World Tour Masters 1000,CLAY,2,Radek Stepanek,Marcos Baghdatis,Radek Stepanek,3-6; 6-1; 7-6(7),R64,154,3,3,56,95,40,56,21,39,5,7,14,61,95,4,5,41,110,27,41,35,69,5,8,14,62,110
2011-04-10 00:00:00.000,ATP World Tour Masters 1000 Monte Carlo Monaco ATP World Tour Masters 1000,CLAY,2,Albert Montanes,Xavier Malisse,Albert Montanes,6-4; 6-2,R64,82,0,1,35,51,23,35,12,16,4,5,9,35,51,1,2,33,67,19,33,17,34,4,8,9,36,67
2011-04-10 00:00:00.000,ATP World Tour Masters 1000 Monte Carlo Monaco ATP World Tour Masters 1000,CLAY,2,Gilles Simon,Thomaz Bellucci,Gilles Simon,6-3; 6-2,R64,94,1,2,48,79,32,48,17,31,6,7,9,49,79,2,2,19,40,12,19,8,21,1,5,8,20,40
2011-04-10 00:00:00.000,ATP World Tour Masters 1000 Monte Carlo Monaco ATP World Tour Masters 1000,CLAY,2,Florian Mayer,Mikhail Youzhny,Florian Mayer,6-3; 2-6; 6-3,R64,124,4,6,43,88,27,43,21,45,5,11,13,48,88,1,4,43,83,23,43,18,40,6,13,13,41,83
2011-04-10 00:00:00.000,ATP World Tour Masters 1000 Monte Carlo Monaco ATP World Tour Masters 1000,CLAY,2,Frederico Gil,Sergiy Stakhovsky,Frederico Gil,6-1; 6-3,R64,68,1,1,36,50,25,36,7,14,3,4,8,32,50,1,3,33,49,17,33,4,16,5,10,8,21,49
2011-04-10 00:00:00.000,ATP World Tour Masters 1000 Monte Carlo Monaco ATP World Tour Masters 1000,CLAY,2,Daniel Gimeno-Traver,Santiago Giraldo,Daniel Gimeno-Traver,7-6(4); 7-5,R64,124,3,5,42,78,25,42,19,36,5,10,12,44,78,3,4,57,95,35,57,14,38,8,14,12,49,95
2011-04-10 00:00:00.000,ATP World Tour Masters 1000 Monte Carlo Monaco ATP World Tour Masters 1000,CLAY,2,Gael Monfils,N/A Bye,Gael Monfils,,R64,0,0,0,0,0,0,0,0,0,0,0,0,0,0,0,0,0,0,0,0,0,0,0,0,0,0,0
2011-04-10 00:00:00.000,ATP World Tour Masters 1000 Monte Carlo Monaco ATP World Tour Masters 1000,CLAY,2,Fernando Verdasco,N/A Bye,Fernando Verdasco,,R64,0,0,0,0,0,0,0,0,0,0,0,0,0,0,0,0,0,0,0,0,0,0,0,0,0,0,0
2011-04-10 00:00:00.000,ATP World Tour Masters 1000 Monte Carlo Monaco ATP World Tour Masters 1000,CLAY,2,Tommy Robredo,Ivan Dodig,Tommy Robredo,6-4; 6-2,R64,77,1,0,39,56,29,39,10,17,2,2,9,39,56,1,3,23,49,16,23,14,26,2,5,9,30,49
2011-04-10 00:00:00.000,ATP World Tour Masters 1000 Monte Carlo Monaco ATP World Tour Masters 1000,CLAY,2,Fabio Fognini,Kevin Anderson,Fabio Fognini,3-6; 6-2; 6-2,R64,114,1,3,29,60,18,29,21,31,0,3,12,39,60,6,1,53,78,33,53,7,25,5,11,13,40,78
2011-04-10 00:00:00.000,ATP World Tour Masters 1000 Monte Carlo Monaco ATP World Tour Masters 1000,CLAY,2,Viktor Troicki,Jean-Rene Lisnard,Viktor Troicki,7-6(4); 6-1,R64,121,3,2,45,78,31,45,18,33,4,6,10,49,78,0,2,38,76,22,38,17,38,4,8,9,39,76
2011-04-10 00:00:00.000,ATP World Tour Masters 1000 Monte Carlo Monaco ATP World Tour Masters 1000,CLAY,2,Ernests Gulbis,Alexandr Dolgopolov,Ernests Gulbis,6-1; 6-4,R64,70,9,3,26,50,19,26,17,24,1,2,9,36,50,1,4,25,59,17,25,12,34,4,8,8,29,59
2011-04-10 00:00:00.000,ATP World Tour Masters 1000 Monte Carlo Monaco ATP World Tour Masters 1000,CLAY,2,Milos Raonic,Michael Llodra,Milos Raonic,6-3; 0-6; 6-0,R64,79,5,2,44,67,36,44,5,23,6,9,10,41,67,4,5,32,61,22,32,10,29,2,7,11,32,61
2011-04-10 00:00:00.000,ATP World Tour Masters 1000 Monte Carlo Monaco ATP World Tour Masters 1000,CLAY,2,Feliciano Lopez,Janko Tipsarevic,Feliciano Lopez,4-6; 6-3; 7-6(4),R64,145,18,2,60,104,49,60,24,44,3,5,16,73,104,7,4,52,96,38,52,26,44,3,5,15,64,96
2011-04-10 00:00:00.000,ATP World Tour Masters 1000 Monte Carlo Monaco ATP World Tour Masters 1000,CLAY,2,David Ferrer,N/A Bye,David Ferrer,,R64,0,0,0,0,0,0,0,0,0,0,0,0,0,0,0,0,0,0,0,0,0,0,0,0,0,0,0
2011-04-10 00:00:00.000,ATP World Tour Masters 1000 Monte Carlo Monaco ATP World Tour Masters 1000,CLAY,2,Jurgen Melzer,N/A Bye,Jurgen Melzer,,R64,0,0,0,0,0,0,0,0,0,0,0,0,0,0,0,0,0,0,0,0,0,0,0,0,0,0,0
2011-04-10 00:00:00.000,ATP World Tour Masters 1000 Monte Carlo Monaco ATP World Tour Masters 1000,CLAY,2,Robin Haase,Nikolay Davydenko,Robin Haase,7-5; 4-6; 6-4,R64,165,5,1,72,120,48,72,20,48,12,17,16,68,120,0,4,79,114,43,79,18,35,13,19,16,61,114
2011-04-10 00:00:00.000,ATP World Tour Masters 1000 Monte Carlo Monaco ATP World Tour Masters 1000,CLAY,2,Maximo Gonzalez,Victor Hanescu,Maximo Gonzalez,3-6; 7-5; 6-1,R64,141,0,2,68,99,40,68,16,31,7,11,14,56,99,6,1,70,109,40,70,17,39,12,18,14,57,109
2011-04-10 00:00:00.000,ATP World Tour Masters 1000 Monte Carlo Monaco ATP World Tour Masters 1000,CLAY,2,Nicolas Almagro,Marcel Granollers,Nicolas Almagro,6-3; 6-3,R64,87,3,5,41,63,34,41,7,22,2,3,9,41,63,0,1,30,54,21,30,8,24,1,5,9,29,54
2011-04-10 00:00:00.000,ATP World Tour Masters 1000 Monte Carlo Monaco ATP World Tour Masters 1000,CLAY,2,Marin Cilic,Filippo Volandri,Marin Cilic,6-2; 6-1,R64,65,3,1,21,34,19,21,9,13,0,0,7,28,34,0,2,33,52,15,33,11,19,4,9,8,26,52
2011-04-10 00:00:00.000,ATP World Tour Masters 1000 Monte Carlo Monaco ATP World Tour Masters 1000,CLAY,2,Pere Riba,Potito Starace,Pere Riba,4-6; 6-3; 6-3,R64,131,2,5,49,90,32,49,23,41,7,10,14,55,90,1,3,76,100,43,76,11,24,12,17,14,54,100
2011-04-10 00:00:00.000,ATP World Tour Masters 1000 Monte Carlo Monaco ATP World Tour Masters 1000,CLAY,2,Philipp Kohlschreiber,Andrey Golubev,Philipp Kohlschreiber,5-7; 7-6(6); 6-4,R64,150,2,6,68,120,44,68,31,52,9,13,17,75,120,1,3,66,106,44,66,20,40,4,8,17,64,106
2011-04-10 00:00:00.000,ATP World Tour Masters 1000 Monte Carlo Monaco ATP World Tour Masters 1000,CLAY,2,Roger Federer,N/A Bye,Roger Federer,,R64,0,0,0,0,0,0,0,0,0,0,0,0,0,0,0,0,0,0,0,0,0,0,0,0,0,0,0
2011-04-10 00:00:00.000,ATP World Tour Masters 1000 Monte Carlo Monaco ATP World Tour Masters 1000,CLAY,2,Rafael Nadal,Jarkko Nieminen,Rafael Nadal,6-2; 6-2,R32,69,0,1,26,40,22,26,10,14,0,0,8,32,40,0,3,28,48,16,28,8,20,5,9,8,24,48
2011-04-10 00:00:00.000,ATP World Tour Masters 1000 Monte Carlo Monaco ATP World Tour Masters 1000,CLAY,2,Richard Gasquet,Guillermo Garcia-Lopez,Richard Gasquet,6-2; 6-1,R32,83,2,4,31,51,24,31,10,20,4,5,8,34,51,0,3,35,51,16,35,6,16,8,13,7,22,51
2011-04-10 00:00:00.000,ATP World Tour Masters 1000 Monte Carlo Monaco ATP World Tour Masters 1000,CLAY,2,Ivan Ljubicic,Jo-Wilfried Tsonga,Ivan Ljubicic,7-6(2); 6-4,R32,130,5,3,54,91,39,54,18,37,3,5,11,57,91,4,0,44,73,31,44,14,29,3,6,11,45,73
2011-04-10 00:00:00.000,ATP World Tour Masters 1000 Monte Carlo Monaco ATP World Tour Masters 1000,CLAY,2,Tomas Berdych,Olivier Rochus,Tomas Berdych,6-2; 6-3,R32,107,8,1,42,76,31,42,17,34,6,7,9,48,76,1,1,35,58,22,35,6,23,7,11,8,28,58
2011-04-10 00:00:00.000,ATP World Tour Masters 1000 Monte Carlo Monaco ATP World Tour Masters 1000,CLAY,2,Andy Murray,Radek Stepanek,Andy Murray,6-1; 6-4,R32,92,7,1,28,47,22,28,11,19,4,5,8,33,47,2,0,44,69,25,44,9,25,3,8,9,34,69
2011-04-10 00:00:00.000,ATP World Tour Masters 1000 Monte Carlo Monaco ATP World Tour Masters 1000,CLAY,2,Gilles Simon,Albert Montanes,Gilles Simon,6-3; 6-4,R32,93,1,0,33,66,21,33,19,33,7,9,10,40,66,2,3,38,69,21,38,15,31,4,8,9,36,69
2011-04-10 00:00:00.000,ATP World Tour Masters 1000 Monte Carlo Monaco ATP World Tour Masters 1000,CLAY,2,Frederico Gil,Florian Mayer,Frederico Gil,7-5; 6-1,R32,83,2,0,38,58,23,38,13,20,4,6,9,36,58,1,4,29,61,19,29,9,32,2,8,10,28,61
2011-04-10 00:00:00.000,ATP World Tour Masters 1000 Monte Carlo Monaco ATP World Tour Masters 1000,CLAY,2,Gael Monfils,Daniel Gimeno-Traver,Gael Monfils,7-5; 6-2,R32,93,1,3,39,55,28,39,8,16,5,7,10,36,55,4,3,38,73,21,38,18,35,9,14,10,39,73
2011-04-10 00:00:00.000,ATP World Tour Masters 1000 Monte Carlo Monaco ATP World Tour Masters 1000,CLAY,2,Tommy Robredo,Fernando Verdasco,Tommy Robredo,6-4; 6-3,R32,91,2,1,40,60,29,40,12,20,5,7,10,41,60,3,6,28,53,18,28,11,25,1,5,9,29,53
2011-04-10 00:00:00.000,ATP World Tour Masters 1000 Monte Carlo Monaco ATP World Tour Masters 1000,CLAY,2,Viktor Troicki,Fabio Fognini,Viktor Troicki,6-3; 4-6; 6-4,R32,129,2,0,53,89,30,53,16,36,5,12,14,46,89,0,2,58,90,31,58,12,32,6,15,15,43,90
2011-04-10 00:00:00.000,ATP World Tour Masters 1000 Monte Carlo Monaco ATP World Tour Masters 1000,CLAY,2,Milos Raonic,Ernests Gulbis,Milos Raonic,6-4; 7-5,R32,91,7,1,38,62,29,38,12,24,1,3,11,41,62,4,4,34,59,23,34,13,25,0,4,11,36,59
2011-04-10 00:00:00.000,ATP World Tour Masters 1000 Monte Carlo Monaco ATP World Tour Masters 1000,CLAY,2,David Ferrer,Feliciano Lopez,David Ferrer,6-2; 6-0,R32,56,5,1,24,36,21,24,8,12,1,1,7,29,36,2,6,32,50,16,32,6,18,5,10,7,22,50
2011-04-10 00:00:00.000,ATP World Tour Masters 1000 Monte Carlo Monaco ATP World Tour Masters 1000,CLAY,2,Jurgen Melzer,Robin Haase,Jurgen Melzer,3-6; 6-1; 6-2,R32,91,5,0,46,60,33,46,7,14,3,6,12,40,60,5,2,39,65,24,39,11,26,6,12,12,35,65
2011-04-10 00:00:00.000,ATP World Tour Masters 1000 Monte Carlo Monaco ATP World Tour Masters 1000,CLAY,2,Nicolas Almagro,Maximo Gonzalez,Nicolas Almagro,6-7(6); 7-5; 7-6(10),R32,180,10,5,63,115,45,63,27,52,6,10,18,72,115,3,1,88,129,56,88,20,41,10,15,18,76,129
2011-04-10 00:00:00.000,ATP World Tour Masters 1000 Monte Carlo Monaco ATP World Tour Masters 1000,CLAY,2,Marin Cilic,Pere Riba,Marin Cilic,5-2 RET,R32,36,4,0,10,14,9,10,3,4,0,0,3,12,14,0,0,19,32,9,19,7,13,6,8,4,16,32
2011-04-10 00:00:00.000,ATP World Tour Masters 1000 Monte Carlo Monaco ATP World Tour Masters 1000,CLAY,2,Roger Federer,Philipp Kohlschreiber,Roger Federer,6-2; 6-1,R32,50,5,2,33,46,29,33,6,13,1,1,8,35,46,3,2,29,41,15,29,5,12,3,7,7,20,41
2011-04-10 00:00:00.000,ATP World Tour Masters 1000 Monte Carlo Monaco ATP World Tour Masters 1000,CLAY,2,Rafael Nadal,Richard Gasquet,Rafael Nadal,6-2; 6-4,R16,94,3,2,33,50,25,33,11,17,0,1,9,36,50,1,0,32,63,18,32,15,31,5,9,9,33,63
2011-04-10 00:00:00.000,ATP World Tour Masters 1000 Monte Carlo Monaco ATP World Tour Masters 1000,CLAY,2,Ivan Ljubicic,Tomas Berdych,Ivan Ljubicic,6-4; 6-2,R16,81,5,1,32,54,27,32,12,22,1,1,9,39,54,1,0,26,45,19,26,10,19,1,4,9,29,45
2011-04-10 00:00:00.000,ATP World Tour Masters 1000 Monte Carlo Monaco ATP World Tour Masters 1000,CLAY,2,Andy Murray,Gilles Simon,Andy Murray,6-3; 6-3,R16,95,0,1,27,49,19,27,10,22,2,5,9,29,49,2,2,33,69,15,33,16,36,4,10,9,31,69
2011-04-10 00:00:00.000,ATP World Tour Masters 1000 Monte Carlo Monaco ATP World Tour Masters 1000,CLAY,2,Frederico Gil,Gael Monfils,Frederico Gil,7-6(6); 6-2,R16,121,1,1,49,78,36,49,17,29,3,3,10,53,78,2,4,45,69,28,45,10,24,3,5,10,38,69
2011-04-10 00:00:00.000,ATP World Tour Masters 1000 Monte Carlo Monaco ATP World Tour Masters 1000,CLAY,2,Viktor Troicki,Tommy Robredo,Viktor Troicki,3-6; 2-1 RET,R16,67,2,1,29,40,18,29,4,11,4,6,6,22,40,1,0,28,43,18,28,9,15,4,5,6,27,43
2011-04-10 00:00:00.000,ATP World Tour Masters 1000 Monte Carlo Monaco ATP World Tour Masters 1000,CLAY,2,David Ferrer,Milos Raonic,David Ferrer,6-1; 6-3,R16,77,0,1,24,45,16,24,13,21,1,2,8,29,45,1,2,26,55,15,26,11,29,5,10,8,26,55
2011-04-10 00:00:00.000,ATP World Tour Masters 1000 Monte Carlo Monaco ATP World Tour Masters 1000,CLAY,2,Jurgen Melzer,Nicolas Almagro,Jurgen Melzer,6-1; 6-4,R16,91,2,1,32,48,25,32,8,16,2,3,8,33,48,1,3,25,51,15,25,8,26,2,7,9,23,51
2011-04-10 00:00:00.000,ATP World Tour Masters 1000 Monte Carlo Monaco ATP World Tour Masters 1000,CLAY,2,Roger Federer,Marin Cilic,Roger Federer,6-4; 6-3,R16,72,0,0,38,54,30,38,12,16,1,1,10,42,54,3,2,26,52,19,26,15,26,2,4,9,34,52
2011-04-10 00:00:00.000,ATP World Tour Masters 1000 Monte Carlo Monaco ATP World Tour Masters 1000,CLAY,2,Rafael Nadal,Ivan Ljubicic,Rafael Nadal,6-1; 6-3,Q,80,0,1,32,46,24,32,8,14,5,6,8,32,46,3,0,32,47,13,32,7,15,2,7,8,20,47
2011-04-10 00:00:00.000,ATP World Tour Masters 1000 Monte Carlo Monaco ATP World Tour Masters 1000,CLAY,2,Andy Murray,Frederico Gil,Andy Murray,6-2; 6-1,Q,72,6,1,22,44,19,22,13,22,3,3,7,32,44,3,0,33,48,16,33,5,15,2,7,8,21,48
2011-04-10 00:00:00.000,ATP World Tour Masters 1000 Monte Carlo Monaco ATP World Tour Masters 1000,CLAY,2,David Ferrer,Viktor Troicki,David Ferrer,6-3; 6-3,Q,84,1,5,27,47,19,27,10,20,0,3,9,29,47,1,5,31,61,15,31,9,30,3,9,9,24,61
2011-04-10 00:00:00.000,ATP World Tour Masters 1000 Monte Carlo Monaco ATP World Tour Masters 1000,CLAY,2,Jurgen Melzer,Roger Federer,Jurgen Melzer,6-4; 6-4,Q,104,2,2,37,74,25,37,25,37,7,7,10,50,74,2,0,44,66,29,44,11,22,3,5,10,40,66
2011-04-10 00:00:00.000,ATP World Tour Masters 1000 Monte Carlo Monaco ATP World Tour Masters 1000,CLAY,2,Rafael Nadal,Andy Murray,Rafael Nadal,6-4; 2-6; 6-1,S,179,3,2,56,82,33,56,11,26,6,12,13,44,82,2,1,57,105,31,57,18,48,12,19,12,49,105
2011-04-10 00:00:00.000,ATP World Tour Masters 1000 Monte Carlo Monaco ATP World Tour Masters 1000,CLAY,2,David Ferrer,Jurgen Melzer,David Ferrer,6-3; 6-2,S,79,2,4,41,69,32,41,11,28,8,9,9,43,69,2,4,20,41,12,20,8,21,0,4,8,20,41
2011-04-10 00:00:00.000,ATP World Tour Masters 1000 Monte Carlo Monaco ATP World Tour Masters 1000,CLAY,2,Rafael Nadal,David Ferrer,Rafael Nadal,6-4; 7-5,F,137,0,3,51,83,33,51,18,32,5,7,11,51,83,0,2,36,70,25,36,15,34,7,11,11,40,70
2011-04-18 00:00:00.000,Barcelona Spain ATP World Tour 500,CLAY,2,Rafael Nadal,N/A Bye,Rafael Nadal,,R64,0,0,0,0,0,0,0,0,0,0,0,0,0,0,0,0,0,0,0,0,0,0,0,0,0,0,0
2011-04-18 00:00:00.000,Barcelona Spain ATP World Tour 500,CLAY,2,Daniel Gimeno-Traver,Potito Starace,Daniel Gimeno-Traver,4-6; 6-1; 2-0 RET,R64,72,6,0,30,57,25,30,15,27,2,3,10,40,57,1,1,42,48,24,42,4,6,3,6,9,28,48
2011-04-18 00:00:00.000,Barcelona Spain ATP World Tour 500,CLAY,2,Albert Ramos,Ruben Ramirez Hidalgo,Albert Ramos,4-6; 7-6(5); 7-5,R64,192,5,3,61,102,43,61,18,41,7,13,17,61,102,1,0,80,127,49,80,20,47,12,18,17,69,127
2011-04-18 00:00:00.000,Barcelona Spain ATP World Tour 500,CLAY,2,Santiago Giraldo,Thomaz Bellucci,Santiago Giraldo,7-5; 6-3,R64,106,3,1,58,91,39,58,12,33,7,10,11,51,91,2,1,34,59,21,34,10,25,3,8,10,31,59
2011-04-18 00:00:00.000,Barcelona Spain ATP World Tour 500,CLAY,2,Richard Gasquet,Juan Ignacio Chela,Richard Gasquet,2-6; 7-6(2); 6-4,R64,153,1,6,67,106,45,67,17,39,6,11,15,62,106,3,1,77,104,48,77,13,27,5,9,15,61,104
2011-04-18 00:00:00.000,Barcelona Spain ATP World Tour 500,CLAY,2,Blaz Kavcic,Tobias Kamke,Blaz Kavcic,6-2; 6-3,R64,84,3,1,42,53,30,42,6,11,3,4,8,36,53,1,0,40,60,20,40,9,20,1,6,9,29,60
2011-04-18 00:00:00.000,Barcelona Spain ATP World Tour 500,CLAY,2,Robin Haase,Flavio Cipolla,Robin Haase,6-4; 6-3,R64,90,2,2,38,66,23,38,17,28,8,10,10,40,66,1,1,42,63,22,42,9,21,4,8,9,31,63
2011-04-18 00:00:00.000,Barcelona Spain ATP World Tour 500,CLAY,2,Gael Monfils,N/A Bye,Gael Monfils,,R64,0,0,0,0,0,0,0,0,0,0,0,0,0,0,0,0,0,0,0,0,0,0,0,0,0,0,0
2011-04-18 00:00:00.000,Barcelona Spain ATP World Tour 500,CLAY,2,Robin Soderling,N/A Bye,Robin Soderling,,R64,0,0,0,0,0,0,0,0,0,0,0,0,0,0,0,0,0,0,0,0,0,0,0,0,0,0,0
2011-04-18 00:00:00.000,Barcelona Spain ATP World Tour 500,CLAY,2,Ivan Dodig,Vincent Millot,Ivan Dodig,6-2; 6-3,R64,85,2,0,38,64,23,38,15,26,5,7,9,38,64,1,1,35,54,14,35,10,19,4,9,8,24,54
2011-04-18 00:00:00.000,Barcelona Spain ATP World Tour 500,CLAY,2,Simon Greul,Robert Kendrick,Simon Greul,6-4; 6-4,R64,73,1,2,36,63,29,36,14,27,2,3,10,43,63,2,1,36,56,25,36,8,20,0,3,10,33,56
2011-04-18 00:00:00.000,Barcelona Spain ATP World Tour 500,CLAY,2,Milos Raonic,Radek Stepanek,Milos Raonic,6-4; 6-2,R64,73,7,1,28,49,25,28,11,21,0,0,9,36,49,2,2,35,56,23,35,10,21,4,7,9,33,56
2011-04-18 00:00:00.000,Barcelona Spain ATP World Tour 500,CLAY,2,Guillermo Garcia-Lopez,Denis Istomin,Guillermo Garcia-Lopez,7-6(6); 6-3,R64,94,1,5,42,63,29,42,8,21,3,7,11,37,63,1,1,48,64,27,48,4,16,3,8,10,31,64
2011-04-18 00:00:00.000,Barcelona Spain ATP World Tour 500,CLAY,2,Feliciano Lopez,Mikhail Kukushkin,Feliciano Lopez,6-2; 6-7(7); 6-4,R64,148,16,2,51,90,43,51,20,39,4,6,15,63,90,5,2,68,121,44,68,26,53,14,19,15,70,121
2011-04-18 00:00:00.000,Barcelona Spain ATP World Tour 500,CLAY,2,Kei Nishikori,Pere Riba,Kei Nishikori,6-2 RET,R64,37,0,1,13,23,9,13,7,10,2,3,4,16,23,0,1,13,26,6,13,4,13,1,4,4,10,26
2011-04-18 00:00:00.000,Barcelona Spain ATP World Tour 500,CLAY,2,Rui Machado,N/A Bye,Rui Machado,,R64,0,0,0,0,0,0,0,0,0,0,0,0,0,0,0,0,0,0,0,0,0,0,0,0,0,0,0
2011-04-18 00:00:00.000,Barcelona Spain ATP World Tour 500,CLAY,2,Jurgen Melzer,N/A Bye,Jurgen Melzer,,R64,0,0,0,0,0,0,0,0,0,0,0,0,0,0,0,0,0,0,0,0,0,0,0,0,0,0,0
2011-04-18 00:00:00.000,Barcelona Spain ATP World Tour 500,CLAY,2,Marcel Granollers,Daniel Brands,Marcel Granollers,7-5; 6-7(5); 6-1,R64,168,2,4,76,114,54,76,18,38,7,10,16,72,114,1,3,88,114,51,88,12,26,6,12,15,63,114
2011-04-18 00:00:00.000,Barcelona Spain ATP World Tour 500,CLAY,2,Benoit Paire,Pablo Carreno Busta,Benoit Paire,6-7(7); 6-3; 6-2,R64,129,5,4,49,106,38,49,28,57,3,6,14,66,106,2,3,60,100,38,60,17,40,4,11,15,55,100
2011-04-18 00:00:00.000,Barcelona Spain ATP World Tour 500,CLAY,2,Albert Montanes,Teymuraz Gabashvili,Albert Montanes,6-2; 6-2,R64,107,4,2,45,72,32,45,13,27,9,10,8,45,72,0,2,44,66,22,44,10,22,6,11,8,32,66
2011-04-18 00:00:00.000,Barcelona Spain ATP World Tour 500,CLAY,2,Kevin Anderson,Pablo Cuevas,Kevin Anderson,7-5; 3-6; 6-4,R64,140,6,2,68,91,51,68,13,23,6,8,16,64,91,5,1,68,103,47,68,19,35,8,10,15,66,103
2011-04-18 00:00:00.000,Barcelona Spain ATP World Tour 500,CLAY,2,Victor Hanescu,Andrey Golubev,Victor Hanescu,6-3; 6-2,R64,85,0,1,38,53,29,38,6,15,0,1,9,35,53,4,3,29,57,17,29,13,28,6,10,8,30,57
2011-04-18 00:00:00.000,Barcelona Spain ATP World Tour 500,CLAY,2,Carlos Berlocq,Jarkko Nieminen,Carlos Berlocq,6-4; 4-6; 6-2,R64,144,3,4,66,100,43,66,17,34,11,15,14,60,100,2,3,66,103,44,66,11,37,11,17,14,55,103
2011-04-18 00:00:00.000,Barcelona Spain ATP World Tour 500,CLAY,2,David Ferrer,N/A Bye,David Ferrer,,R64,0,0,0,0,0,0,0,0,0,0,0,0,0,0,0,0,0,0,0,0,0,0,0,0,0,0,0
2011-04-18 00:00:00.000,Barcelona Spain ATP World Tour 500,CLAY,2,Nicolas Almagro,N/A Bye,Nicolas Almagro,,R64,0,0,0,0,0,0,0,0,0,0,0,0,0,0,0,0,0,0,0,0,0,0,0,0,0,0,0
2011-04-18 00:00:00.000,Barcelona Spain ATP World Tour 500,CLAY,2,Pablo Andujar,Gerard Granollers,Pablo Andujar,6-0; 6-1,R64,58,5,2,28,44,25,28,7,16,0,0,7,32,44,1,1,30,41,13,30,3,11,3,8,6,16,41
2011-04-18 00:00:00.000,Barcelona Spain ATP World Tour 500,CLAY,2,Edouard Roger-Vasselin,Andrey Kuznetsov,Edouard Roger-Vasselin,6-2; 6-4,R64,77,1,0,31,47,22,31,11,16,1,2,9,33,47,0,2,34,68,20,34,16,34,4,8,9,36,68
2011-04-18 00:00:00.000,Barcelona Spain ATP World Tour 500,CLAY,2,Nikolay Davydenko,Alexandr Dolgopolov,Nikolay Davydenko,6-4; 7-6(6),R64,100,2,5,65,85,43,65,9,20,7,9,11,52,85,4,2,46,82,32,46,15,36,0,3,11,47,82
2011-04-18 00:00:00.000,Barcelona Spain ATP World Tour 500,CLAY,2,Juan Monaco,Grigor Dimitrov,Juan Monaco,6-4; 6-1,R64,78,1,1,40,56,26,40,9,16,7,8,8,35,56,0,2,28,47,17,28,6,19,0,5,9,23,47
2011-04-18 00:00:00.000,Barcelona Spain ATP World Tour 500,CLAY,2,Simone Vagnozzi,Fabio Fognini,Simone Vagnozzi,2-6; 4-2 RET,R64,62,0,2,26,41,19,26,3,15,3,7,7,22,41,3,0,30,50,18,30,7,20,3,6,7,25,50
2011-04-18 00:00:00.000,Barcelona Spain ATP World Tour 500,CLAY,2,Juan Carlos Ferrero,Xavier Malisse,Juan Carlos Ferrero,6-4; 6-2,R64,81,2,0,51,66,33,51,9,15,3,4,9,42,66,1,2,32,58,22,32,11,26,5,9,9,33,58
2011-04-18 00:00:00.000,Barcelona Spain ATP World Tour 500,CLAY,2,Mischa Zverev,N/A Bye,Mischa Zverev,,R64,0,0,0,0,0,0,0,0,0,0,0,0,0,0,0,0,0,0,0,0,0,0,0,0,0,0,0
2011-04-18 00:00:00.000,Barcelona Spain ATP World Tour 500,CLAY,2,Rafael Nadal,Daniel Gimeno-Traver,Rafael Nadal,6-1; 6-1,R32,66,2,0,24,39,20,24,9,15,0,0,7,29,39,4,1,25,43,16,25,2,18,4,9,7,18,43
2011-04-18 00:00:00.000,Barcelona Spain ATP World Tour 500,CLAY,2,Santiago Giraldo,Albert Ramos,Santiago Giraldo,6-3; 4-6; 6-3,R32,142,9,3,71,111,47,71,18,40,7,10,14,65,111,3,2,72,91,40,72,11,19,5,10,14,51,91
2011-04-18 00:00:00.000,Barcelona Spain ATP World Tour 500,CLAY,2,Richard Gasquet,Blaz Kavcic,Richard Gasquet,6-3; 4-6; 6-2,R32,118,1,0,50,73,38,50,15,23,4,7,14,53,73,4,2,69,89,38,69,13,20,5,10,13,51,89
2011-04-18 00:00:00.000,Barcelona Spain ATP World Tour 500,CLAY,2,Gael Monfils,Robin Haase,Gael Monfils,3-6; 7-6(3); 6-2,R32,124,4,4,53,91,30,53,21,38,4,9,15,51,91,3,0,77,94,43,77,9,17,9,14,14,52,94
2011-04-18 00:00:00.000,Barcelona Spain ATP World Tour 500,CLAY,2,Ivan Dodig,Robin Soderling,Ivan Dodig,6-2; 6-4,R32,83,9,1,39,63,27,39,12,24,7,9,9,39,63,0,4,30,50,15,30,10,20,2,7,9,25,50
2011-04-18 00:00:00.000,Barcelona Spain ATP World Tour 500,CLAY,2,Milos Raonic,Simon Greul,Milos Raonic,6-3; 4-6; 7-6(5),R32,140,10,2,59,91,49,59,12,32,7,9,15,61,91,6,2,79,111,51,79,19,32,8,11,16,70,111
2011-04-18 00:00:00.000,Barcelona Spain ATP World Tour 500,CLAY,2,Feliciano Lopez,Guillermo Garcia-Lopez,Feliciano Lopez,6-7(2); 6-3; 6-4,R32,125,13,3,55,94,39,55,25,39,2,3,16,64,94,4,1,54,84,40,54,19,30,1,4,15,59,84
2011-04-18 00:00:00.000,Barcelona Spain ATP World Tour 500,CLAY,2,Kei Nishikori,Rui Machado,Kei Nishikori,6-1; 6-4,R32,180,1,2,33,49,28,33,9,16,2,2,9,37,49,0,1,37,56,24,37,7,19,1,4,8,31,56
2011-04-18 00:00:00.000,Barcelona Spain ATP World Tour 500,CLAY,2,Jurgen Melzer,Marcel Granollers,Jurgen Melzer,6-1; 6-3,R32,83,2,3,37,59,25,37,11,22,2,3,8,36,59,2,4,29,51,13,29,8,22,4,9,8,21,51
2011-04-18 00:00:00.000,Barcelona Spain ATP World Tour 500,CLAY,2,Albert Montanes,Benoit Paire,Albert Montanes,6-7(3); 6-1; 6-4,R32,122,1,3,80,105,54,80,13,25,7,9,15,67,105,5,3,57,95,35,57,19,38,6,11,14,54,95
2011-04-18 00:00:00.000,Barcelona Spain ATP World Tour 500,CLAY,2,Victor Hanescu,Kevin Anderson,Victor Hanescu,6-4; 6-4,R32,90,4,0,35,47,31,35,9,12,0,0,10,40,47,6,2,57,82,37,57,12,25,10,12,10,49,82
2011-04-18 00:00:00.000,Barcelona Spain ATP World Tour 500,CLAY,2,David Ferrer,Carlos Berlocq,David Ferrer,6-2; 6-2,R32,91,1,1,38,58,26,38,14,20,4,4,8,40,58,1,5,37,65,25,37,8,28,3,7,8,33,65
2011-04-18 00:00:00.000,Barcelona Spain ATP World Tour 500,CLAY,2,Nicolas Almagro,Pablo Andujar,Nicolas Almagro,7-5; 7-6(1),R32,117,8,2,36,78,26,36,25,42,5,8,12,51,78,0,2,45,79,28,45,17,34,3,7,12,45,79
2011-04-18 00:00:00.000,Barcelona Spain ATP World Tour 500,CLAY,2,Nikolay Davydenko,Edouard Roger-Vasselin,Nikolay Davydenko,6-2; 7-6(11),R32,108,0,1,60,77,37,60,9,17,6,9,10,46,77,2,1,55,82,27,55,13,27,7,12,10,40,82
2011-04-18 00:00:00.000,Barcelona Spain ATP World Tour 500,CLAY,2,Simone Vagnozzi,Juan Monaco,Simone Vagnozzi,6-3; 6-2,R32,83,0,1,30,47,18,30,14,17,4,5,8,32,47,0,3,53,67,30,53,4,14,6,11,9,34,67
2011-04-18 00:00:00.000,Barcelona Spain ATP World Tour 500,CLAY,2,Juan Carlos Ferrero,Mischa Zverev,Juan Carlos Ferrero,6-4; 7-5,R32,100,3,1,53,72,35,53,11,19,2,4,11,46,72,0,0,39,62,22,39,13,23,4,8,11,35,62
2011-04-18 00:00:00.000,Barcelona Spain ATP World Tour 500,CLAY,2,Rafael Nadal,Santiago Giraldo,Rafael Nadal,6-3; 6-1,R16,83,1,2,34,53,24,34,10,19,2,3,8,34,53,2,2,33,54,16,33,9,21,6,11,8,25,54
2011-04-18 00:00:00.000,Barcelona Spain ATP World Tour 500,CLAY,2,Gael Monfils,Richard Gasquet,Gael Monfils,6-4; 7-6(7),R16,97,0,3,68,78,44,68,5,10,3,5,11,49,78,1,2,56,76,36,56,10,20,4,7,11,46,76
2011-04-18 00:00:00.000,Barcelona Spain ATP World Tour 500,CLAY,2,Ivan Dodig,Milos Raonic,Ivan Dodig,7-6(0); 4-6; 6-3,R16,150,9,3,82,114,57,82,15,32,8,11,16,72,114,5,0,69,102,50,69,12,33,5,8,15,62,102
2011-04-18 00:00:00.000,Barcelona Spain ATP World Tour 500,CLAY,2,Feliciano Lopez,Kei Nishikori,Feliciano Lopez,6-4; 7-6(5),R16,106,4,2,44,80,32,44,21,36,3,4,11,53,80,0,2,52,75,31,52,18,23,6,8,11,49,75
2011-04-18 00:00:00.000,Barcelona Spain ATP World Tour 500,CLAY,2,Jurgen Melzer,Albert Montanes,Jurgen Melzer,6-7(2); 6-3; 6-2,R16,124,7,2,77,111,52,77,17,34,13,15,15,69,111,6,2,54,85,33,54,19,31,4,9,14,52,85
2011-04-18 00:00:00.000,Barcelona Spain ATP World Tour 500,CLAY,2,David Ferrer,Victor Hanescu,David Ferrer,6-3; 6-2,R16,65,1,0,26,45,26,26,10,19,0,0,9,36,45,0,0,35,49,20,35,9,14,3,6,8,29,49
2011-04-18 00:00:00.000,Barcelona Spain ATP World Tour 500,CLAY,2,Nicolas Almagro,Nikolay Davydenko,Nicolas Almagro,7-6(2); 6-3,R16,98,6,1,48,77,29,48,21,29,4,6,11,50,77,1,1,43,64,26,43,10,21,3,6,10,36,64
2011-04-18 00:00:00.000,Barcelona Spain ATP World Tour 500,CLAY,2,Juan Carlos Ferrero,Simone Vagnozzi,Juan Carlos Ferrero,7-6(3); 4-6; 6-4,R16,163,1,0,83,114,46,83,16,31,13,20,16,62,114,0,1,84,109,42,84,16,25,7,14,16,58,109
2011-04-18 00:00:00.000,Barcelona Spain ATP World Tour 500,CLAY,2,Rafael Nadal,Gael Monfils,Rafael Nadal,6-2; 6-2,Q,75,1,1,23,40,18,23,14,17,0,0,8,32,40,0,0,52,62,29,52,3,10,5,9,8,32,62
2011-04-18 00:00:00.000,Barcelona Spain ATP World Tour 500,CLAY,2,Ivan Dodig,Feliciano Lopez,Ivan Dodig,6-4; 2-6; 6-4,Q,116,6,0,49,74,36,49,16,25,1,3,14,52,74,11,0,57,91,39,57,20,34,7,9,14,59,91
2011-04-18 00:00:00.000,Barcelona Spain ATP World Tour 500,CLAY,2,David Ferrer,Jurgen Melzer,David Ferrer,6-3; 6-3,Q,87,0,3,40,61,32,40,8,21,4,5,9,40,61,1,2,36,58,21,36,9,22,5,9,9,30,58
2011-04-18 00:00:00.000,Barcelona Spain ATP World Tour 500,CLAY,2,Nicolas Almagro,Juan Carlos Ferrero,Nicolas Almagro,6-3; 6-3,Q,65,6,1,22,47,17,22,14,25,3,5,9,31,47,2,1,42,62,21,42,9,20,11,16,9,30,62
2011-04-18 00:00:00.000,Barcelona Spain ATP World Tour 500,CLAY,2,Rafael Nadal,Ivan Dodig,Rafael Nadal,6-3; 6-2,S,88,1,0,35,49,24,35,7,14,2,4,8,31,49,2,2,23,48,12,23,7,25,2,8,9,19,48
2011-04-18 00:00:00.000,Barcelona Spain ATP World Tour 500,CLAY,2,David Ferrer,Nicolas Almagro,David Ferrer,6-3; 6-4,S,97,3,1,43,65,31,43,11,22,3,4,10,42,65,5,1,36,69,23,36,15,33,9,12,9,38,69
2011-04-18 00:00:00.000,Barcelona Spain ATP World Tour 500,CLAY,2,Rafael Nadal,David Ferrer,Rafael Nadal,6-2; 6-4,F,109,0,1,41,61,23,41,10,20,5,8,9,33,61,2,1,48,69,24,48,6,21,10,16,9,30,69
2011-04-24 00:00:00.000,Munich Germany ATP World Tour 250,CLAY,2,Mikhail Youzhny,Matthias Bachinger,Mikhail Youzhny,7-5; 6-2,R32,98,3,1,42,66,28,42,17,24,6,7,10,45,66,2,2,37,63,20,37,15,26,2,6,10,35,63
2011-04-24 00:00:00.000,Munich Germany ATP World Tour 250,CLAY,2,Philipp Petzschner,Ivan Dodig,Philipp Petzschner,6-1; 6-4,R32,69,3,2,22,49,18,22,17,27,1,2,9,35,49,0,0,30,45,17,30,6,15,1,5,8,23,45
2011-04-24 00:00:00.000,Munich Germany ATP World Tour 250,CLAY,2,Potito Starace,Jan Hajek,Potito Starace,3-6; 6-4; 6-0,R32,103,4,1,58,81,38,58,11,23,7,10,12,49,81,2,3,55,89,36,55,9,34,9,15,13,45,89
2011-04-24 00:00:00.000,Munich Germany ATP World Tour 250,CLAY,2,Sergiy Stakhovsky,Denis Istomin,Sergiy Stakhovsky,5-1 RET,R32,22,2,0,8,13,8,8,4,5,0,0,3,12,13,1,0,14,21,6,14,3,7,1,3,3,9,21
2011-04-24 00:00:00.000,Munich Germany ATP World Tour 250,CLAY,2,Marcos Baghdatis,Julien Benneteau,Marcos Baghdatis,7-6(2); 6-3,R32,101,12,0,34,59,27,34,16,25,1,2,10,43,59,4,3,56,84,35,56,14,28,6,9,11,49,84
2011-04-24 00:00:00.000,Munich Germany ATP World Tour 250,CLAY,2,Grigor Dimitrov,Andreas Beck,Grigor Dimitrov,6-1; 6-4,R32,64,7,1,32,45,27,32,9,13,0,0,9,36,45,1,0,30,47,18,30,8,17,5,8,8,26,47
2011-04-24 00:00:00.000,Munich Germany ATP World Tour 250,CLAY,2,Teymuraz Gabashvili,Rainer Schuettler,Teymuraz Gabashvili,3-6; 6-4; 6-3,R32,123,0,2,68,92,44,68,15,24,9,11,14,59,92,4,1,66,88,43,66,12,22,9,12,14,55,88
2011-04-24 00:00:00.000,Munich Germany ATP World Tour 250,CLAY,2,Florian Mayer,Steve Darcis,Florian Mayer,6-1; 6-2,R32,60,1,0,24,44,18,24,9,20,2,4,7,27,44,0,0,34,50,11,34,4,16,3,10,8,15,50
2011-04-24 00:00:00.000,Munich Germany ATP World Tour 250,CLAY,2,Nikolay Davydenko,Andrey Kuznetsov,Nikolay Davydenko,6-1; 7-6(4),R32,89,4,1,45,67,34,45,13,22,4,5,10,47,67,1,1,46,73,29,46,11,27,5,8,9,40,73
2011-04-24 00:00:00.000,Munich Germany ATP World Tour 250,CLAY,2,Julian Reister,Daniel Brands,Julian Reister,7-6(1); 6-1,R32,87,4,0,48,56,38,48,4,8,1,1,9,42,56,8,1,61,85,37,61,10,24,7,10,10,47,85
2011-04-24 00:00:00.000,Munich Germany ATP World Tour 250,CLAY,2,Horacio Zeballos,Robert Kendrick,Horacio Zeballos,6-4; 6-4,R32,73,13,2,40,50,35,40,7,10,0,0,10,42,50,4,1,44,74,30,44,14,30,8,10,10,44,74
2011-04-24 00:00:00.000,Munich Germany ATP World Tour 250,CLAY,2,Marin Cilic,Simone Bolelli,Marin Cilic,7-5; 7-6(4),R32,123,11,4,50,90,39,50,21,40,8,9,12,60,90,0,0,57,75,39,57,10,18,1,3,12,49,75
2011-04-24 00:00:00.000,Munich Germany ATP World Tour 250,CLAY,2,Philipp Kohlschreiber,Robert Farah,Philipp Kohlschreiber,6-3; 6-1,R32,68,3,0,24,41,18,24,11,17,3,5,8,29,41,3,2,34,51,16,34,6,17,5,11,8,22,51
2011-04-24 00:00:00.000,Munich Germany ATP World Tour 250,CLAY,2,Denis Gremelmayr,Robin Haase,Denis Gremelmayr,6-4; 4-6; 6-4,R32,125,3,3,61,97,35,61,19,36,5,10,15,54,97,6,2,63,99,37,63,17,36,5,11,15,54,99
2011-04-24 00:00:00.000,Munich Germany ATP World Tour 250,CLAY,2,Radek Stepanek,Andrey Golubev,Radek Stepanek,6-1; 4-6; 6-3,R32,107,4,3,60,82,37,60,12,22,3,6,13,49,82,5,6,51,82,32,51,11,31,3,9,13,43,82
2011-04-24 00:00:00.000,Munich Germany ATP World Tour 250,CLAY,2,Dustin Brown,Stanislas Wawrinka,Dustin Brown,6-7(6); 6-4; 7-5,R32,134,10,2,60,108,48,60,27,48,4,6,17,75,108,4,1,78,114,58,78,16,36,2,6,17,74,114
2011-04-24 00:00:00.000,Munich Germany ATP World Tour 250,CLAY,2,Philipp Petzschner,Mikhail Youzhny,Philipp Petzschner,7-6(5); 3-6; 6-2,R16,136,3,2,54,79,44,54,12,25,0,2,14,56,79,0,1,59,89,39,59,18,30,0,3,15,57,89
2011-04-24 00:00:00.000,Munich Germany ATP World Tour 250,CLAY,2,Potito Starace,Sergiy Stakhovsky,Potito Starace,6-4; 6-2,R16,73,2,1,44,51,33,44,6,7,3,3,9,39,51,2,2,35,59,24,35,10,24,7,10,9,34,59
2011-04-24 00:00:00.000,Munich Germany ATP World Tour 250,CLAY,2,Grigor Dimitrov,Marcos Baghdatis,Grigor Dimitrov,3-6; 7-6(6); 6-2,R16,131,8,1,59,93,42,59,22,34,3,4,14,64,93,8,2,39,84,32,39,27,45,0,2,15,59,84
2011-04-24 00:00:00.000,Munich Germany ATP World Tour 250,CLAY,2,Florian Mayer,Teymuraz Gabashvili,Florian Mayer,6-4; 7-6(1),R16,110,2,3,47,84,35,47,21,37,4,5,11,56,84,2,2,57,79,35,57,12,22,3,5,11,47,79
2011-04-24 00:00:00.000,Munich Germany ATP World Tour 250,CLAY,2,Nikolay Davydenko,Julian Reister,Nikolay Davydenko,3-6; 7-6(5); 6-1,R16,147,1,3,94,115,60,94,9,21,11,15,15,69,115,2,1,63,94,40,63,14,31,5,9,13,54,94
2011-04-24 00:00:00.000,Munich Germany ATP World Tour 250,CLAY,2,Marin Cilic,Horacio Zeballos,Marin Cilic,6-3; 7-6(7),R16,111,8,0,36,64,29,36,17,28,0,1,10,46,64,5,4,62,93,43,62,12,31,4,7,11,55,93
2011-04-24 00:00:00.000,Munich Germany ATP World Tour 250,CLAY,2,Philipp Kohlschreiber,Denis Gremelmayr,Philipp Kohlschreiber,6-3; 6-3,R16,69,2,1,39,58,32,39,9,19,4,4,9,41,58,8,0,31,51,22,31,10,20,3,6,9,32,51
2011-04-24 00:00:00.000,Munich Germany ATP World Tour 250,CLAY,2,Radek Stepanek,Dustin Brown,Radek Stepanek,7-6(6); 6-7(5); 6-3,R16,170,1,6,81,130,50,81,27,49,9,13,17,77,130,16,4,83,137,55,83,24,54,14,19,16,79,137
2011-04-24 00:00:00.000,Munich Germany ATP World Tour 250,CLAY,2,Philipp Petzschner,Potito Starace,Philipp Petzschner,7-6(3); 7-6(6),Q,107,7,1,54,76,45,54,14,22,2,2,12,59,76,1,1,70,89,50,70,9,19,2,2,12,59,89
2011-04-24 00:00:00.000,Munich Germany ATP World Tour 250,CLAY,2,Florian Mayer,Grigor Dimitrov,Florian Mayer,7-6(4); 3-6; 6-4,Q,143,3,3,76,118,50,76,24,42,9,12,16,74,118,8,4,61,92,45,61,19,31,4,6,15,64,92
2011-04-24 00:00:00.000,Munich Germany ATP World Tour 250,CLAY,2,Nikolay Davydenko,Marin Cilic,Nikolay Davydenko,7-5; 6-3,Q,109,3,2,54,77,38,54,12,23,6,7,11,50,77,6,3,36,66,25,36,14,30,4,7,10,39,66
2011-04-24 00:00:00.000,Munich Germany ATP World Tour 250,CLAY,2,Radek Stepanek,Philipp Kohlschreiber,Radek Stepanek,6-4; 6-0,Q,74,3,2,26,55,18,26,17,29,4,5,8,35,55,3,0,34,49,20,34,4,15,2,7,8,24,49
2011-04-24 00:00:00.000,Munich Germany ATP World Tour 250,CLAY,2,Florian Mayer,Philipp Petzschner,Florian Mayer,6-3; 6-4,S,73,6,1,38,58,30,38,10,20,5,6,10,40,58,2,0,41,60,27,41,9,19,5,8,9,36,60
2011-04-24 00:00:00.000,Munich Germany ATP World Tour 250,CLAY,2,Nikolay Davydenko,Radek Stepanek,Nikolay Davydenko,6-3; 4-0 RET,S,72,2,0,34,45,25,34,7,11,2,2,7,32,45,1,1,30,54,18,30,8,24,8,11,6,26,54
2011-04-24 00:00:00.000,Munich Germany ATP World Tour 250,CLAY,2,Nikolay Davydenko,Florian Mayer,Nikolay Davydenko,6-3; 3-6; 6-1,F,109,7,2,63,89,45,63,14,26,5,6,13,59,89,4,1,51,85,34,51,16,34,5,8,12,50,85
2011-04-25 00:00:00.000,Belgrade Serbia ATP World Tour 250,CLAY,2,Novak Djokovic,N/A Bye,Novak Djokovic,,R32,0,0,0,0,0,0,0,0,0,0,0,0,0,0,0,0,0,0,0,0,0,0,0,0,0,0,0
2011-04-25 00:00:00.000,Belgrade Serbia ATP World Tour 250,CLAY,2,Adrian Ungur,Ruben Ramirez Hidalgo,Adrian Ungur,6-7(2); 6-3; 6-4,R32,168,5,3,73,106,47,73,21,33,4,7,16,68,106,3,5,78,112,51,78,12,34,4,9,15,63,112
2011-04-25 00:00:00.000,Belgrade Serbia ATP World Tour 250,CLAY,2,Blaz Kavcic,Tobias Kamke,Blaz Kavcic,7-6(0); 6-1,R32,108,3,5,49,76,36,49,13,27,5,7,10,49,76,1,3,47,78,25,47,14,31,8,12,9,39,78
2011-04-25 00:00:00.000,Belgrade Serbia ATP World Tour 250,CLAY,2,Ricardo Mello,John Isner,Ricardo Mello,6-4; 7-6(4),R32,75,2,2,47,63,40,47,10,16,4,5,11,50,63,18,5,55,75,37,55,10,20,3,5,11,47,75
2011-04-25 00:00:00.000,Belgrade Serbia ATP World Tour 250,CLAY,2,Guillermo Garcia-Lopez,N/A Bye,Guillermo Garcia-Lopez,,R32,0,0,0,0,0,0,0,0,0,0,0,0,0,0,0,0,0,0,0,0,0,0,0,0,0,0,0
2011-04-25 00:00:00.000,Belgrade Serbia ATP World Tour 250,CLAY,2,Somdev Devvarman,Mikhail Kukushkin,Somdev Devvarman,1-6; 6-4; 6-2,R32,134,2,2,57,94,33,57,18,37,8,13,12,51,94,0,3,44,90,26,44,20,46,8,14,13,46,90
2011-04-25 00:00:00.000,Belgrade Serbia ATP World Tour 250,CLAY,2,Mischa Zverev,Dudi Sela,Mischa Zverev,7-6(4); 3-6; 6-3,R32,165,0,2,90,135,52,90,22,45,14,19,15,74,135,2,2,56,104,37,56,24,48,4,9,15,61,104
2011-04-25 00:00:00.000,Belgrade Serbia ATP World Tour 250,CLAY,2,Janko Tipsarevic,Kei Nishikori,Janko Tipsarevic,2-6; 6-2; 7-6(0),R32,138,6,3,52,93,35,52,24,41,5,8,14,59,93,1,6,54,92,39,54,16,38,7,10,14,55,92
2011-04-25 00:00:00.000,Belgrade Serbia ATP World Tour 250,CLAY,2,Feliciano Lopez,Juan Monaco,Feliciano Lopez,6-4; 7-5,R32,99,4,1,36,66,26,36,19,30,0,1,11,45,66,2,4,34,58,24,34,12,24,1,4,11,36,58
2011-04-25 00:00:00.000,Belgrade Serbia ATP World Tour 250,CLAY,2,Fernando Gonzalez,Martin Klizan,Fernando Gonzalez,6-2; 6-4,R32,76,4,2,26,57,19,26,15,31,6,9,9,34,57,2,6,32,55,16,32,8,23,5,11,9,24,55
2011-04-25 00:00:00.000,Belgrade Serbia ATP World Tour 250,CLAY,2,Michael Berrer,Alexander Peya,Michael Berrer,4-6; 6-3; 6-4,R32,146,1,5,59,90,43,59,15,31,7,10,14,58,90,1,6,92,120,58,92,11,28,10,15,15,69,120
2011-04-25 00:00:00.000,Belgrade Serbia ATP World Tour 250,CLAY,2,Albert Montanes,N/A Bye,Albert Montanes,,R32,0,0,0,0,0,0,0,0,0,0,0,0,0,0,0,0,0,0,0,0,0,0,0,0,0,0,0
2011-04-25 00:00:00.000,Belgrade Serbia ATP World Tour 250,CLAY,2,Illya Marchenko,Ernests Gulbis,Illya Marchenko,6-2; 6-4,R32,76,2,3,34,55,26,34,12,21,3,4,9,38,55,1,4,25,49,16,25,10,24,1,5,9,26,49
2011-04-25 00:00:00.000,Belgrade Serbia ATP World Tour 250,CLAY,2,Filippo Volandri,Dusan Lajovic,Filippo Volandri,6-1; 6-4,R32,93,1,5,61,85,33,61,12,24,15,18,8,45,85,1,4,25,54,13,25,8,29,4,11,9,21,54
2011-04-25 00:00:00.000,Belgrade Serbia ATP World Tour 250,CLAY,2,Marcel Granollers,Franko Skugor,Marcel Granollers,7-5; 6-1,R32,90,1,3,45,60,29,45,8,15,3,5,9,37,60,1,3,32,65,11,32,16,33,6,12,10,27,65
2011-04-25 00:00:00.000,Belgrade Serbia ATP World Tour 250,CLAY,2,Viktor Troicki,N/A Bye,Viktor Troicki,,R32,0,0,0,0,0,0,0,0,0,0,0,0,0,0,0,0,0,0,0,0,0,0,0,0,0,0,0
2011-04-25 00:00:00.000,Belgrade Serbia ATP World Tour 250,CLAY,2,Novak Djokovic,Adrian Ungur,Novak Djokovic,6-2; 6-3,R16,68,1,1,33,56,23,33,12,23,4,6,9,35,56,0,4,20,42,11,20,7,22,1,6,8,18,42
2011-04-25 00:00:00.000,Belgrade Serbia ATP World Tour 250,CLAY,2,Blaz Kavcic,Ricardo Mello,Blaz Kavcic,7-5; 6-3,R16,115,1,4,56,87,41,56,9,31,5,8,11,50,87,2,1,47,70,25,47,7,23,6,11,10,32,70
2011-04-25 00:00:00.000,Belgrade Serbia ATP World Tour 250,CLAY,2,Somdev Devvarman,Guillermo Garcia-Lopez,Somdev Devvarman,7-6(6); 2-6; 7-6(8),R16,194,4,1,83,126,55,83,18,43,10,16,16,73,126,4,6,58,110,39,58,30,52,1,5,16,69,110
2011-04-25 00:00:00.000,Belgrade Serbia ATP World Tour 250,CLAY,2,Janko Tipsarevic,Mischa Zverev,Janko Tipsarevic,6-2; 6-0,R16,53,0,1,22,39,17,22,12,17,0,0,7,29,39,1,0,28,38,12,28,3,10,4,9,7,15,38
2011-04-25 00:00:00.000,Belgrade Serbia ATP World Tour 250,CLAY,2,Feliciano Lopez,Fernando Gonzalez,Feliciano Lopez,6-4; 7-6(4),R16,91,6,4,46,77,41,46,13,31,5,6,11,54,77,3,3,36,68,29,36,20,32,3,5,11,49,68
2011-04-25 00:00:00.000,Belgrade Serbia ATP World Tour 250,CLAY,2,Albert Montanes,Michael Berrer,Albert Montanes,3-6; 6-2; 6-2,R16,90,6,0,41,71,29,41,22,30,2,3,12,51,71,1,2,57,79,36,57,10,22,2,6,13,46,79
2011-04-25 00:00:00.000,Belgrade Serbia ATP World Tour 250,CLAY,2,Filippo Volandri,Illya Marchenko,Filippo Volandri,6-3; 1-6; 6-3,R16,138,0,2,44,76,21,44,18,32,7,13,12,39,76,2,5,55,103,30,55,20,48,8,15,13,50,103
2011-04-25 00:00:00.000,Belgrade Serbia ATP World Tour 250,CLAY,2,Marcel Granollers,Viktor Troicki,Marcel Granollers,6-2; 6-3,R16,99,0,1,41,59,24,41,5,18,6,10,8,29,59,0,1,36,65,15,36,10,29,5,13,9,25,65
2011-04-25 00:00:00.000,Belgrade Serbia ATP World Tour 250,CLAY,2,Novak Djokovic,Blaz Kavcic,Novak Djokovic,6-3; 6-2,Q,86,2,3,36,59,26,36,12,23,1,2,9,38,59,0,5,24,47,11,24,13,23,1,5,8,24,47
2011-04-25 00:00:00.000,Belgrade Serbia ATP World Tour 250,CLAY,2,Janko Tipsarevic,Somdev Devvarman,Janko Tipsarevic,6-3; 3-6; 6-4,Q,159,5,4,37,82,27,37,25,45,4,7,14,52,82,2,1,51,96,30,51,24,45,2,6,14,54,96
2011-04-25 00:00:00.000,Belgrade Serbia ATP World Tour 250,CLAY,2,Feliciano Lopez,Albert Montanes,Feliciano Lopez,6-4; 6-4,Q,95,10,3,43,66,32,43,15,23,5,5,10,47,66,4,2,47,84,33,47,17,37,7,9,10,50,84
2011-04-25 00:00:00.000,Belgrade Serbia ATP World Tour 250,CLAY,2,Filippo Volandri,Marcel Granollers,Filippo Volandri,6-2; 6-4,Q,83,0,1,53,66,34,53,10,13,4,4,9,44,66,0,1,30,52,18,30,12,22,2,5,9,30,52
2011-04-25 00:00:00.000,Belgrade Serbia ATP World Tour 250,CLAY,2,Novak Djokovic,Janko Tipsarevic,Novak Djokovic,W/O,S,0,0,0,0,0,0,0,0,0,0,0,0,0,0,0,0,0,0,0,0,0,0,0,0,0,0,0
2011-04-25 00:00:00.000,Belgrade Serbia ATP World Tour 250,CLAY,2,Feliciano Lopez,Filippo Volandri,Feliciano Lopez,7-6(3); 6-2,S,96,5,4,45,75,35,45,12,30,9,11,10,47,75,1,4,38,61,24,38,10,23,0,4,10,34,61
2011-04-25 00:00:00.000,Belgrade Serbia ATP World Tour 250,CLAY,2,Novak Djokovic,Feliciano Lopez,Novak Djokovic,7-6(4); 6-2,F,116,4,6,46,78,37,46,16,32,7,7,10,53,78,6,2,42,67,29,42,13,25,2,4,10,42,67
2011-04-25 00:00:00.000,Estoril Portugal ATP World Tour 250,CLAY,2,Robin Soderling,N/A Bye,Robin Soderling,,R32,0,0,0,0,0,0,0,0,0,0,0,0,0,0,0,0,0,0,0,0,0,0,0,0,0,0,0
2011-04-25 00:00:00.000,Estoril Portugal ATP World Tour 250,CLAY,2,Jeremy Chardy,Adrian Mannarino,Jeremy Chardy,6-4; 6-3,R32,91,8,4,34,63,26,34,11,29,5,7,9,37,63,1,3,47,76,27,47,11,29,12,17,10,38,76
2011-04-25 00:00:00.000,Estoril Portugal ATP World Tour 250,CLAY,2,Alejandro Falla,Pablo Andujar,Alejandro Falla,4-6; 6-1; 4-4 RET,R32,122,2,0,39,65,27,39,22,26,2,4,13,49,65,2,3,46,78,29,46,15,32,5,8,12,44,78
2011-04-25 00:00:00.000,Estoril Portugal ATP World Tour 250,CLAY,2,Juan Martin Del Potro,Pedro Sousa,Juan Martin Del Potro,6-2; 3-6; 6-3,R32,112,4,2,47,74,34,47,14,27,1,3,13,48,74,6,1,51,81,35,51,10,30,3,7,13,45,81
2011-04-25 00:00:00.000,Estoril Portugal ATP World Tour 250,CLAY,2,Jo-Wilfried Tsonga,N/A Bye,Jo-Wilfried Tsonga,,R32,0,0,0,0,0,0,0,0,0,0,0,0,0,0,0,0,0,0,0,0,0,0,0,0,0,0,0
2011-04-25 00:00:00.000,Estoril Portugal ATP World Tour 250,CLAY,2,Pablo Cuevas,Pere Riba,Pablo Cuevas,6-2; 6-4,R32,68,4,1,29,44,27,29,9,15,0,0,9,36,44,2,5,38,69,26,38,12,31,4,7,9,38,69
2011-04-25 00:00:00.000,Estoril Portugal ATP World Tour 250,CLAY,2,Edouard Roger-Vasselin,Marcos Daniel,Edouard Roger-Vasselin,6-3; 6-1,R32,82,3,2,31,48,22,31,9,17,2,4,8,31,48,0,0,46,62,20,46,5,16,4,10,8,25,62
2011-04-25 00:00:00.000,Estoril Portugal ATP World Tour 250,CLAY,2,Thomaz Bellucci,Frederik Nielsen,Thomaz Bellucci,7-5; 6-1,R32,77,4,0,28,51,20,28,16,23,1,2,9,36,51,0,1,49,70,26,49,10,21,8,13,10,36,70
2011-04-25 00:00:00.000,Estoril Portugal ATP World Tour 250,CLAY,2,Milos Raonic,Igor Andreev,Milos Raonic,6-4; 6-4,R32,85,4,5,44,71,33,44,15,27,8,8,10,48,71,4,3,40,56,29,40,6,16,1,3,10,35,56
2011-04-25 00:00:00.000,Estoril Portugal ATP World Tour 250,CLAY,2,Joao Sousa,Gastao Elias,Joao Sousa,7-6(6); 3-6; 5-2 RET,R32,153,5,0,60,92,39,60,15,32,3,7,14,54,92,4,5,53,91,40,53,15,38,4,8,14,55,91
2011-04-25 00:00:00.000,Estoril Portugal ATP World Tour 250,CLAY,2,Carlos Berlocq,Daniel Gimeno-Traver,Carlos Berlocq,6-4; 6-3,R32,76,0,0,40,51,29,40,10,11,1,2,10,39,51,1,2,27,53,21,27,11,26,3,6,9,32,53
2011-04-25 00:00:00.000,Estoril Portugal ATP World Tour 250,CLAY,2,Gilles Simon,N/A Bye,Gilles Simon,,R32,0,0,0,0,0,0,0,0,0,0,0,0,0,0,0,0,0,0,0,0,0,0,0,0,0,0,0
2011-04-25 00:00:00.000,Estoril Portugal ATP World Tour 250,CLAY,2,Kevin Anderson,Thiemo de Bakker,Kevin Anderson,5-7; 6-3; 6-2,R32,146,2,0,58,81,39,58,16,23,4,7,15,55,81,4,1,58,91,35,58,17,33,5,10,14,52,91
2011-04-25 00:00:00.000,Estoril Portugal ATP World Tour 250,CLAY,2,Victor Hanescu,Rui Machado,Victor Hanescu,6-3; 6-3,R32,82,4,1,48,63,36,48,7,15,1,1,9,43,63,3,1,34,52,23,34,8,18,4,7,9,31,52
2011-04-25 00:00:00.000,Estoril Portugal ATP World Tour 250,CLAY,2,Frederico Gil,Flavio Cipolla,Frederico Gil,6-3; 6-2,R32,87,1,4,38,62,28,38,10,24,1,3,9,38,62,1,3,42,52,21,42,2,10,3,8,8,23,52
2011-04-25 00:00:00.000,Estoril Portugal ATP World Tour 250,CLAY,2,Fernando Verdasco,N/A Bye,Fernando Verdasco,,R32,0,0,0,0,0,0,0,0,0,0,0,0,0,0,0,0,0,0,0,0,0,0,0,0,0,0,0
2011-04-25 00:00:00.000,Estoril Portugal ATP World Tour 250,CLAY,2,Robin Soderling,Jeremy Chardy,Robin Soderling,6-1; 6-7(4); 6-1,R16,118,5,2,49,84,34,49,20,35,2,5,14,54,84,6,5,49,90,31,49,12,41,9,16,12,43,90
2011-04-25 00:00:00.000,Estoril Portugal ATP World Tour 250,CLAY,2,Juan Martin Del Potro,Alejandro Falla,Juan Martin Del Potro,6-2; 6-1,R16,71,3,0,23,38,20,23,12,15,0,0,8,32,38,2,3,36,57,19,36,9,21,3,7,7,28,57
2011-04-25 00:00:00.000,Estoril Portugal ATP World Tour 250,CLAY,2,Pablo Cuevas,Jo-Wilfried Tsonga,Pablo Cuevas,6-2; 7-6(0),R16,78,3,1,34,52,29,34,13,18,0,1,10,42,52,3,2,39,60,25,39,9,21,4,7,10,34,60
2011-04-25 00:00:00.000,Estoril Portugal ATP World Tour 250,CLAY,2,Thomaz Bellucci,Edouard Roger-Vasselin,Thomaz Bellucci,6-3; 5-7; 7-5,R16,178,6,3,71,113,49,71,21,42,6,9,17,70,113,5,1,78,106,50,78,14,28,9,13,16,64,106
2011-04-25 00:00:00.000,Estoril Portugal ATP World Tour 250,CLAY,2,Milos Raonic,Joao Sousa,Milos Raonic,6-3; 6-3,R16,71,6,2,29,44,20,29,11,15,1,3,9,31,44,1,2,31,56,18,31,9,25,1,6,9,27,56
2011-04-25 00:00:00.000,Estoril Portugal ATP World Tour 250,CLAY,2,Gilles Simon,Carlos Berlocq,Gilles Simon,6-2; 6-1,R16,84,1,3,40,58,30,40,10,18,5,5,8,40,58,1,1,31,51,17,31,7,20,6,10,7,24,51
2011-04-25 00:00:00.000,Estoril Portugal ATP World Tour 250,CLAY,2,Kevin Anderson,Victor Hanescu,Kevin Anderson,6-4; 6-2,R16,84,4,0,33,53,26,33,11,20,0,0,9,37,53,0,0,43,58,28,43,8,15,2,5,9,36,58
2011-04-25 00:00:00.000,Estoril Portugal ATP World Tour 250,CLAY,2,Fernando Verdasco,Frederico Gil,Fernando Verdasco,6-1; 7-6(5),R16,103,2,7,41,63,30,41,10,22,3,5,10,40,63,1,3,44,67,23,44,12,23,4,8,9,35,67
2011-04-25 00:00:00.000,Estoril Portugal ATP World Tour 250,CLAY,2,Juan Martin Del Potro,Robin Soderling,Juan Martin Del Potro,6-4; 7-5,Q,117,6,4,49,81,36,49,16,32,5,6,11,52,81,3,3,41,60,28,41,10,19,2,5,11,38,60
2011-04-25 00:00:00.000,Estoril Portugal ATP World Tour 250,CLAY,2,Pablo Cuevas,Thomaz Bellucci,Pablo Cuevas,6-4; 6-2,Q,80,5,1,29,52,24,29,14,23,2,2,9,38,52,1,0,30,49,20,30,8,19,2,5,9,28,49
2011-04-25 00:00:00.000,Estoril Portugal ATP World Tour 250,CLAY,2,Milos Raonic,Gilles Simon,Milos Raonic,7-6(4); 4-6; 6-3,Q,151,7,1,70,109,49,70,16,39,3,8,16,65,109,2,2,52,92,33,52,22,40,6,11,15,55,92
2011-04-25 00:00:00.000,Estoril Portugal ATP World Tour 250,CLAY,2,Fernando Verdasco,Kevin Anderson,Fernando Verdasco,6-7(2); 6-2; 6-3,Q,156,3,1,83,99,60,83,7,16,4,5,15,67,99,5,0,65,92,41,65,15,27,5,9,14,56,92
2011-04-25 00:00:00.000,Estoril Portugal ATP World Tour 250,CLAY,2,Juan Martin Del Potro,Pablo Cuevas,Juan Martin Del Potro,6-2; 7-6(6),S,109,4,0,37,60,31,37,14,23,0,0,10,45,60,3,0,41,75,28,41,19,34,11,13,10,47,75
2011-04-25 00:00:00.000,Estoril Portugal ATP World Tour 250,CLAY,2,Fernando Verdasco,Milos Raonic,Fernando Verdasco,6-4 RET,S,42,0,0,22,26,18,22,2,4,0,0,5,20,26,6,2,19,31,14,19,6,12,1,2,5,20,31
2011-04-25 00:00:00.000,Estoril Portugal ATP World Tour 250,CLAY,2,Juan Martin Del Potro,Fernando Verdasco,Juan Martin Del Potro,6-2; 6-2,F,76,2,2,35,48,26,35,7,13,2,3,8,33,48,2,3,31,46,15,31,5,15,1,6,8,20,46
2011-05-01 00:00:00.000,ATP World Tour Masters 1000 Madrid Spain ATP World Tour Masters 1000,CLAY,2,Rafael Nadal,N/A Bye,Rafael Nadal,,R64,0,0,0,0,0,0,0,0,0,0,0,0,0,0,0,0,0,0,0,0,0,0,0,0,0,0,0
2011-05-01 00:00:00.000,ATP World Tour Masters 1000 Madrid Spain ATP World Tour Masters 1000,CLAY,2,Marcos Baghdatis,Alejandro Falla,Marcos Baghdatis,6-3; 3-6; 7-6(5),R64,155,11,3,49,99,38,49,26,50,3,5,15,64,99,9,0,74,114,47,74,25,40,11,13,15,72,114
2011-05-01 00:00:00.000,ATP World Tour Masters 1000 Madrid Spain ATP World Tour Masters 1000,CLAY,2,Marin Cilic,Potito Starace,Marin Cilic,7-6(5); 6-4,R64,94,11,1,41,73,31,41,17,32,4,6,11,48,73,0,0,56,77,34,56,10,21,3,6,11,44,77
2011-05-01 00:00:00.000,ATP World Tour Masters 1000 Madrid Spain ATP World Tour Masters 1000,CLAY,2,Juan Martin Del Potro,Mikhail Youzhny,Juan Martin Del Potro,6-1; 3-6; 6-3,R64,127,8,3,57,79,42,57,13,22,4,5,13,55,79,5,1,43,74,28,43,16,31,7,10,12,44,74
2011-05-01 00:00:00.000,ATP World Tour Masters 1000 Madrid Spain ATP World Tour Masters 1000,CLAY,2,Flavio Cipolla,Andy Roddick,Flavio Cipolla,6-4; 6-7(7); 6-3,R64,183,3,3,78,114,51,78,23,36,8,10,16,74,114,5,2,77,113,49,77,20,36,6,10,15,69,113
2011-05-01 00:00:00.000,ATP World Tour Masters 1000 Madrid Spain ATP World Tour Masters 1000,CLAY,2,Michael Llodra,Sam Querrey,Michael Llodra,6-2; 6-3,R64,63,2,6,37,56,28,37,10,19,3,4,9,38,56,3,0,33,51,19,33,7,18,4,8,8,26,51
2011-05-01 00:00:00.000,ATP World Tour Masters 1000 Madrid Spain ATP World Tour Masters 1000,CLAY,2,Daniel Gimeno-Traver,Richard Gasquet,Daniel Gimeno-Traver,3-6; 6-4; 6-3,R64,135,3,1,57,88,40,57,13,31,8,12,14,53,88,3,4,74,110,45,74,15,36,7,12,14,60,110
2011-05-01 00:00:00.000,ATP World Tour Masters 1000 Madrid Spain ATP World Tour Masters 1000,CLAY,2,Jurgen Melzer,N/A Bye,Jurgen Melzer,,R64,0,0,0,0,0,0,0,0,0,0,0,0,0,0,0,0,0,0,0,0,0,0,0,0,0,0,0
2011-05-01 00:00:00.000,ATP World Tour Masters 1000 Madrid Spain ATP World Tour Masters 1000,CLAY,2,Roger Federer,N/A Bye,Roger Federer,,R64,0,0,0,0,0,0,0,0,0,0,0,0,0,0,0,0,0,0,0,0,0,0,0,0,0,0,0
2011-05-01 00:00:00.000,ATP World Tour Masters 1000 Madrid Spain ATP World Tour Masters 1000,CLAY,2,Feliciano Lopez,Milos Raonic,Feliciano Lopez,4-6; 7-6(2); 6-4,R64,124,12,0,63,97,51,63,19,34,1,2,16,70,97,23,1,65,91,53,65,13,26,2,3,16,66,91
2011-05-01 00:00:00.000,ATP World Tour Masters 1000 Madrid Spain ATP World Tour Masters 1000,CLAY,2,Xavier Malisse,Victor Hanescu,Xavier Malisse,3-6; 6-4; 7-5,R64,128,12,0,67,103,49,67,20,36,5,6,15,69,103,7,2,85,108,55,85,15,23,4,6,16,70,108
2011-05-01 00:00:00.000,ATP World Tour Masters 1000 Madrid Spain ATP World Tour Masters 1000,CLAY,2,Yen-Hsun Lu,Fernando Verdasco,Yen-Hsun Lu,7-6(7); 7-5,R64,124,4,4,60,86,44,60,12,26,5,6,12,56,86,3,4,64,81,46,64,8,17,3,5,12,54,81
2011-05-01 00:00:00.000,ATP World Tour Masters 1000 Madrid Spain ATP World Tour Masters 1000,CLAY,2,Jo-Wilfried Tsonga,Nicolas Almagro,Jo-Wilfried Tsonga,6-1; 6-3,R64,67,8,3,30,46,26,30,9,16,2,2,8,35,46,1,0,32,46,17,32,7,14,3,7,8,24,46
2011-05-01 00:00:00.000,ATP World Tour Masters 1000 Madrid Spain ATP World Tour Masters 1000,CLAY,2,Pere Riba,Kei Nishikori,Pere Riba,6-2; 6-4,R64,79,7,4,35,55,25,35,7,20,5,8,9,32,55,0,4,34,54,15,34,8,20,5,11,9,23,54
2011-05-01 00:00:00.000,ATP World Tour Masters 1000 Madrid Spain ATP World Tour Masters 1000,CLAY,2,Santiago Giraldo,Alexandr Dolgopolov,Santiago Giraldo,6-1; 7-5,R64,67,2,0,45,65,33,45,10,20,5,6,10,43,65,2,4,23,53,16,23,14,30,4,8,9,30,53
2011-05-01 00:00:00.000,ATP World Tour Masters 1000 Madrid Spain ATP World Tour Masters 1000,CLAY,2,Robin Soderling,N/A Bye,Robin Soderling,,R64,0,0,0,0,0,0,0,0,0,0,0,0,0,0,0,0,0,0,0,0,0,0,0,0,0,0,0
2011-05-01 00:00:00.000,ATP World Tour Masters 1000 Madrid Spain ATP World Tour Masters 1000,CLAY,2,Tomas Berdych,N/A Bye,Tomas Berdych,,R64,0,0,0,0,0,0,0,0,0,0,0,0,0,0,0,0,0,0,0,0,0,0,0,0,0,0,0
2011-05-01 00:00:00.000,ATP World Tour Masters 1000 Madrid Spain ATP World Tour Masters 1000,CLAY,2,Marcel Granollers,Nikolay Davydenko,Marcel Granollers,7-5; 6-2,R64,95,1,0,37,55,28,37,12,18,0,0,10,40,55,1,3,50,66,32,50,7,16,5,8,10,39,66
2011-05-01 00:00:00.000,ATP World Tour Masters 1000 Madrid Spain ATP World Tour Masters 1000,CLAY,2,Juan Monaco,Andrey Golubev,Juan Monaco,2-6; 6-2; 6-2,R64,98,0,0,40,55,27,40,10,15,0,3,12,37,55,6,1,41,77,25,41,14,36,5,10,12,39,77
2011-05-01 00:00:00.000,ATP World Tour Masters 1000 Madrid Spain ATP World Tour Masters 1000,CLAY,2,Gael Monfils,Ivo Karlovic,Gael Monfils,6-3; 7-6(6),R64,82,3,3,50,61,40,50,5,11,0,0,10,45,61,6,2,46,72,34,46,12,26,4,6,11,46,72
2011-05-01 00:00:00.000,ATP World Tour Masters 1000 Madrid Spain ATP World Tour Masters 1000,CLAY,2,Florian Mayer,Viktor Troicki,Florian Mayer,4-6; 7-5; 6-4,R64,143,1,5,67,104,49,67,12,37,8,12,16,61,104,5,1,54,97,35,54,22,43,10,15,16,57,97
2011-05-01 00:00:00.000,ATP World Tour Masters 1000 Madrid Spain ATP World Tour Masters 1000,CLAY,2,Thomaz Bellucci,Pablo Andujar,Thomaz Bellucci,6-4; 6-2,R64,91,4,1,35,56,24,35,13,21,2,3,9,37,56,1,4,40,69,22,40,15,29,8,12,9,37,69
2011-05-01 00:00:00.000,ATP World Tour Masters 1000 Madrid Spain ATP World Tour Masters 1000,CLAY,2,Gilles Simon,Ivan Ljubicic,Gilles Simon,7-5; 7-6(8),R64,116,5,1,40,71,32,40,23,31,0,0,12,55,71,8,3,50,90,38,50,20,40,3,4,12,58,90
2011-05-01 00:00:00.000,ATP World Tour Masters 1000 Madrid Spain ATP World Tour Masters 1000,CLAY,2,Andy Murray,N/A Bye,Andy Murray,,R64,0,0,0,0,0,0,0,0,0,0,0,0,0,0,0,0,0,0,0,0,0,0,0,0,0,0,0
2011-05-01 00:00:00.000,ATP World Tour Masters 1000 Madrid Spain ATP World Tour Masters 1000,CLAY,2,David Ferrer,N/A Bye,David Ferrer,,R64,0,0,0,0,0,0,0,0,0,0,0,0,0,0,0,0,0,0,0,0,0,0,0,0,0,0,0
2011-05-01 00:00:00.000,ATP World Tour Masters 1000 Madrid Spain ATP World Tour Masters 1000,CLAY,2,Adrian Mannarino,Juan Ignacio Chela,Adrian Mannarino,4-6; 6-4; 6-4,R64,144,13,1,64,102,42,64,16,38,5,10,15,58,102,4,2,79,115,48,79,13,36,5,11,15,61,115
2011-05-01 00:00:00.000,ATP World Tour Masters 1000 Madrid Spain ATP World Tour Masters 1000,CLAY,2,Sergiy Stakhovsky,Albert Montanes,Sergiy Stakhovsky,7-6(6); 3-6; 7-6(5),R64,144,7,1,69,113,50,69,24,44,2,4,16,74,113,2,4,67,109,53,67,22,42,2,3,17,75,109
2011-05-01 00:00:00.000,ATP World Tour Masters 1000 Madrid Spain ATP World Tour Masters 1000,CLAY,2,John Isner,Mardy Fish,John Isner,7-6(5); 4-6; 7-6(3),R64,174,13,1,78,111,56,78,23,33,3,4,17,79,111,6,2,91,123,67,91,19,32,6,6,17,86,123
2011-05-01 00:00:00.000,ATP World Tour Masters 1000 Madrid Spain ATP World Tour Masters 1000,CLAY,2,Guillermo Garcia-Lopez,Stanislas Wawrinka,Guillermo Garcia-Lopez,6-4; 5-7; 6-4,R64,165,3,2,57,111,42,57,29,54,5,7,16,71,111,5,2,69,105,50,69,14,36,5,8,16,64,105
2011-05-01 00:00:00.000,ATP World Tour Masters 1000 Madrid Spain ATP World Tour Masters 1000,CLAY,2,Thiemo de Bakker,Juan Carlos Ferrero,Thiemo de Bakker,2-6; 7-5; 6-4,R64,123,10,3,47,85,37,47,22,38,4,6,15,59,85,5,0,66,90,46,66,16,24,5,7,15,62,90
2011-05-01 00:00:00.000,ATP World Tour Masters 1000 Madrid Spain ATP World Tour Masters 1000,CLAY,2,Kevin Anderson,Olivier Rochus,Kevin Anderson,6-2; 6-4,R64,73,12,4,34,54,28,34,9,20,3,4,9,37,54,0,0,25,44,13,25,9,19,0,4,9,22,44
2011-05-01 00:00:00.000,ATP World Tour Masters 1000 Madrid Spain ATP World Tour Masters 1000,CLAY,2,Novak Djokovic,N/A Bye,Novak Djokovic,,R64,0,0,0,0,0,0,0,0,0,0,0,0,0,0,0,0,0,0,0,0,0,0,0,0,0,0,0
2011-05-01 00:00:00.000,ATP World Tour Masters 1000 Madrid Spain ATP World Tour Masters 1000,CLAY,2,Rafael Nadal,Marcos Baghdatis,Rafael Nadal,6-1; 6-3,R32,82,1,0,23,41,19,23,14,18,0,0,8,33,41,3,1,26,54,19,26,9,28,1,5,8,28,54
2011-05-01 00:00:00.000,ATP World Tour Masters 1000 Madrid Spain ATP World Tour Masters 1000,CLAY,2,Juan Martin Del Potro,Marin Cilic,Juan Martin Del Potro,6-3; 6-0,R32,64,2,1,23,35,21,23,7,12,0,0,7,28,35,2,2,23,44,13,23,6,21,1,6,8,19,44
2011-05-01 00:00:00.000,ATP World Tour Masters 1000 Madrid Spain ATP World Tour Masters 1000,CLAY,2,Michael Llodra,Flavio Cipolla,Michael Llodra,6-4; 6-2,R32,77,3,0,32,49,24,32,11,17,0,1,9,35,49,0,2,34,59,21,34,11,25,5,9,9,32,59
2011-05-01 00:00:00.000,ATP World Tour Masters 1000 Madrid Spain ATP World Tour Masters 1000,CLAY,2,Daniel Gimeno-Traver,Jurgen Melzer,Daniel Gimeno-Traver,7-6(8); 6-3,R32,95,5,1,41,62,25,41,10,21,3,7,10,35,62,4,2,57,80,32,57,7,23,4,10,11,39,80
2011-05-01 00:00:00.000,ATP World Tour Masters 1000 Madrid Spain ATP World Tour Masters 1000,CLAY,2,Roger Federer,Feliciano Lopez,Roger Federer,7-6(13); 6-7(1); 7-6(7),R32,176,25,3,93,136,75,93,28,43,4,5,18,103,136,23,1,89,130,73,89,23,41,5,6,18,96,130
2011-05-01 00:00:00.000,ATP World Tour Masters 1000 Madrid Spain ATP World Tour Masters 1000,CLAY,2,Xavier Malisse,Yen-Hsun Lu,Xavier Malisse,6-2; 6-2,R32,57,7,1,28,40,23,28,9,12,0,0,8,32,40,1,0,29,46,19,29,6,17,2,6,8,25,46
2011-05-01 00:00:00.000,ATP World Tour Masters 1000 Madrid Spain ATP World Tour Masters 1000,CLAY,2,Jo-Wilfried Tsonga,Pere Riba,Jo-Wilfried Tsonga,6-4; 6-2,R32,200,6,2,36,49,28,36,7,13,2,3,9,35,49,2,1,31,57,17,31,13,26,4,8,9,30,57
2011-05-01 00:00:00.000,ATP World Tour Masters 1000 Madrid Spain ATP World Tour Masters 1000,CLAY,2,Robin Soderling,Santiago Giraldo,Robin Soderling,6-3; 6-3,R32,80,9,2,30,52,25,30,10,22,2,3,9,35,52,3,1,40,74,27,40,12,34,6,10,9,39,74
2011-05-01 00:00:00.000,ATP World Tour Masters 1000 Madrid Spain ATP World Tour Masters 1000,CLAY,2,Tomas Berdych,Marcel Granollers,Tomas Berdych,6-4; 6-0,R32,76,1,0,27,41,19,27,9,14,2,4,8,28,41,0,0,40,54,15,40,8,14,3,9,8,23,54
2011-05-01 00:00:00.000,ATP World Tour Masters 1000 Madrid Spain ATP World Tour Masters 1000,CLAY,2,Juan Monaco,Gael Monfils,Juan Monaco,6-2; 3-0 RET,R32,64,0,0,24,31,16,24,6,7,3,3,5,22,31,2,3,34,51,18,34,5,17,4,8,6,23,51
2011-05-01 00:00:00.000,ATP World Tour Masters 1000 Madrid Spain ATP World Tour Masters 1000,CLAY,2,Thomaz Bellucci,Florian Mayer,Thomaz Bellucci,6-7(5); 6-3; 3-0 RET,R32,102,11,1,49,69,36,49,13,20,0,2,12,49,69,2,2,58,83,31,58,12,25,6,11,12,43,83
2011-05-01 00:00:00.000,ATP World Tour Masters 1000 Madrid Spain ATP World Tour Masters 1000,CLAY,2,Andy Murray,Gilles Simon,Andy Murray,6-4; 3-6; 6-0,R32,143,8,3,59,95,39,59,18,36,8,10,12,57,95,4,2,46,88,28,46,20,42,10,15,13,48,88
2011-05-01 00:00:00.000,ATP World Tour Masters 1000 Madrid Spain ATP World Tour Masters 1000,CLAY,2,David Ferrer,Adrian Mannarino,David Ferrer,7-5; 0-6; 6-0,R32,115,4,5,62,100,41,62,15,38,8,12,12,56,100,0,0,32,66,18,32,19,34,0,5,12,37,66
2011-05-01 00:00:00.000,ATP World Tour Masters 1000 Madrid Spain ATP World Tour Masters 1000,CLAY,2,Sergiy Stakhovsky,John Isner,Sergiy Stakhovsky,7-5; 4-6; 7-6(3),R32,136,5,1,70,103,53,70,21,33,3,4,17,74,103,7,2,69,103,49,69,21,34,1,2,17,70,103
2011-05-01 00:00:00.000,ATP World Tour Masters 1000 Madrid Spain ATP World Tour Masters 1000,CLAY,2,Guillermo Garcia-Lopez,Thiemo de Bakker,Guillermo Garcia-Lopez,6-2; 6-3,R32,73,1,1,21,50,20,21,18,29,1,1,9,38,50,1,1,25,50,15,25,14,25,3,6,8,29,50
2011-05-01 00:00:00.000,ATP World Tour Masters 1000 Madrid Spain ATP World Tour Masters 1000,CLAY,2,Novak Djokovic,Kevin Anderson,Novak Djokovic,6-3; 6-4,R32,101,2,2,39,55,32,39,9,16,2,2,10,41,55,7,0,39,64,28,39,11,25,4,6,9,39,64
2011-05-01 00:00:00.000,ATP World Tour Masters 1000 Madrid Spain ATP World Tour Masters 1000,CLAY,2,Rafael Nadal,Juan Martin Del Potro,Rafael Nadal,W/O,R16,0,0,0,0,0,0,0,0,0,0,0,0,0,0,0,0,0,0,0,0,0,0,0,0,0,0,0
2011-05-01 00:00:00.000,ATP World Tour Masters 1000 Madrid Spain ATP World Tour Masters 1000,CLAY,2,Michael Llodra,Daniel Gimeno-Traver,Michael Llodra,1-6; 6-4; 7-6(4),R16,138,7,2,80,120,57,80,17,40,13,16,15,74,120,5,0,58,87,41,58,21,29,2,3,14,62,87
2011-05-01 00:00:00.000,ATP World Tour Masters 1000 Madrid Spain ATP World Tour Masters 1000,CLAY,2,Roger Federer,Xavier Malisse,Roger Federer,6-4; 6-3,R16,71,5,0,32,52,24,32,14,20,1,2,10,38,52,6,1,28,55,21,28,11,27,3,6,9,32,55
2011-05-01 00:00:00.000,ATP World Tour Masters 1000 Madrid Spain ATP World Tour Masters 1000,CLAY,2,Robin Soderling,Jo-Wilfried Tsonga,Robin Soderling,7-6(8); 7-5,R16,133,5,2,49,77,40,49,17,28,3,3,12,57,77,13,0,63,96,49,63,15,33,5,6,12,64,96
2011-05-01 00:00:00.000,ATP World Tour Masters 1000 Madrid Spain ATP World Tour Masters 1000,CLAY,2,Tomas Berdych,Juan Monaco,Tomas Berdych,7-5; 6-3,R16,109,4,2,38,70,31,38,15,32,4,5,11,46,70,0,0,36,59,24,36,12,23,3,6,10,36,59
2011-05-01 00:00:00.000,ATP World Tour Masters 1000 Madrid Spain ATP World Tour Masters 1000,CLAY,2,Thomaz Bellucci,Andy Murray,Thomaz Bellucci,6-4; 6-2,R16,91,4,1,36,57,29,36,11,21,3,3,9,40,57,1,2,34,56,21,34,11,22,0,3,9,32,56
2011-05-01 00:00:00.000,ATP World Tour Masters 1000 Madrid Spain ATP World Tour Masters 1000,CLAY,2,David Ferrer,Sergiy Stakhovsky,David Ferrer,6-3; 7-6(3),R16,89,2,2,39,56,34,39,13,17,3,4,11,47,56,5,0,41,65,29,41,13,24,5,7,10,42,65
2011-05-01 00:00:00.000,ATP World Tour Masters 1000 Madrid Spain ATP World Tour Masters 1000,CLAY,2,Novak Djokovic,Guillermo Garcia-Lopez,Novak Djokovic,6-1; 6-2,R16,51,5,1,21,34,21,21,11,13,0,0,8,32,34,3,2,24,37,16,24,3,13,3,7,7,19,37
2011-05-01 00:00:00.000,ATP World Tour Masters 1000 Madrid Spain ATP World Tour Masters 1000,CLAY,2,Rafael Nadal,Michael Llodra,Rafael Nadal,6-2; 6-2,Q,75,1,0,30,41,25,30,8,11,0,0,8,33,41,4,1,44,72,28,44,8,28,8,12,8,36,72
2011-05-01 00:00:00.000,ATP World Tour Masters 1000 Madrid Spain ATP World Tour Masters 1000,CLAY,2,Roger Federer,Robin Soderling,Roger Federer,7-6(2); 6-4,Q,103,8,2,44,73,34,44,19,29,2,2,11,53,73,8,5,41,77,32,41,18,36,5,6,11,50,77
2011-05-01 00:00:00.000,ATP World Tour Masters 1000 Madrid Spain ATP World Tour Masters 1000,CLAY,2,Thomaz Bellucci,Tomas Berdych,Thomaz Bellucci,7-6(2); 6-3,Q,94,5,1,39,60,33,39,16,21,0,0,11,49,60,2,1,37,61,27,37,15,24,0,1,10,42,61
2011-05-01 00:00:00.000,ATP World Tour Masters 1000 Madrid Spain ATP World Tour Masters 1000,CLAY,2,Novak Djokovic,David Ferrer,Novak Djokovic,6-4; 4-6; 6-3,Q,148,6,1,56,85,43,56,12,29,3,6,14,55,85,1,2,58,93,36,58,15,35,6,11,15,51,93
2011-05-01 00:00:00.000,ATP World Tour Masters 1000 Madrid Spain ATP World Tour Masters 1000,CLAY,2,Rafael Nadal,Roger Federer,Rafael Nadal,5-7; 6-1; 6-3,S,156,1,0,82,101,55,82,10,19,9,11,14,65,101,0,1,63,103,41,63,16,40,7,12,14,57,103
2011-05-01 00:00:00.000,ATP World Tour Masters 1000 Madrid Spain ATP World Tour Masters 1000,CLAY,2,Novak Djokovic,Thomaz Bellucci,Novak Djokovic,4-6; 6-4; 6-1,S,130,6,1,51,80,35,51,18,29,1,3,14,53,80,5,1,48,75,30,48,16,27,4,8,13,46,75
2011-05-01 00:00:00.000,ATP World Tour Masters 1000 Madrid Spain ATP World Tour Masters 1000,CLAY,2,Novak Djokovic,Rafael Nadal,Novak Djokovic,7-5; 6-4,F,138,3,1,33,58,23,33,13,25,3,6,11,36,58,3,0,52,75,29,52,9,23,7,12,11,38,75
2011-05-08 00:00:00.000,ATP World Tour Masters 1000 Rome Italy ATP World Tour Masters 1000,CLAY,2,Rafael Nadal,N/A Bye,Rafael Nadal,,R64,0,0,0,0,0,0,0,0,0,0,0,0,0,0,0,0,0,0,0,0,0,0,0,0,0,0,0
2011-05-08 00:00:00.000,ATP World Tour Masters 1000 Rome Italy ATP World Tour Masters 1000,CLAY,2,Paolo Lorenzi,Thomaz Bellucci,Paolo Lorenzi,7-6(5); 6-3,R64,108,2,2,45,66,31,45,12,21,3,5,11,43,66,2,2,48,72,31,48,11,24,6,9,10,42,72
2011-05-08 00:00:00.000,ATP World Tour Masters 1000 Rome Italy ATP World Tour Masters 1000,CLAY,2,Feliciano Lopez,Michael Llodra,Feliciano Lopez,7-6(2); 6-1,R64,86,4,0,31,61,26,31,22,30,2,2,10,48,61,4,1,32,53,22,32,13,21,2,4,9,35,53
2011-05-08 00:00:00.000,ATP World Tour Masters 1000 Rome Italy ATP World Tour Masters 1000,CLAY,2,Philipp Kohlschreiber,Mikhail Youzhny,Philipp Kohlschreiber,6-4; 6-2,R64,94,3,4,47,70,34,47,12,23,7,7,9,46,70,3,3,37,52,27,37,6,15,0,3,9,33,52
2011-05-08 00:00:00.000,ATP World Tour Masters 1000 Rome Italy ATP World Tour Masters 1000,CLAY,2,Mardy Fish,Santiago Giraldo,Mardy Fish,4-6; 6-2; 6-2,R64,145,4,2,48,67,34,48,10,19,2,5,13,44,67,2,2,75,109,43,75,14,34,7,13,13,57,109
2011-05-08 00:00:00.000,ATP World Tour Masters 1000 Rome Italy ATP World Tour Masters 1000,CLAY,2,Ivan Ljubicic,Flavio Cipolla,Ivan Ljubicic,6-2; 6-3,R64,73,4,0,29,46,24,29,14,17,2,2,9,38,46,0,1,24,41,14,24,9,17,0,3,8,23,41
2011-05-08 00:00:00.000,ATP World Tour Masters 1000 Rome Italy ATP World Tour Masters 1000,CLAY,2,Marin Cilic,Ivo Karlovic,Marin Cilic,6-4; 1-0 RET,R64,62,3,3,17,24,15,17,2,7,0,1,5,17,24,5,3,35,49,20,35,4,14,7,10,6,24,49
2011-05-08 00:00:00.000,ATP World Tour Masters 1000 Rome Italy ATP World Tour Masters 1000,CLAY,2,Carlos Berlocq,N/A Bye,Carlos Berlocq,,R64,0,0,0,0,0,0,0,0,0,0,0,0,0,0,0,0,0,0,0,0,0,0,0,0,0,0,0
2011-05-08 00:00:00.000,ATP World Tour Masters 1000 Rome Italy ATP World Tour Masters 1000,CLAY,2,Roger Federer,N/A Bye,Roger Federer,,R64,0,0,0,0,0,0,0,0,0,0,0,0,0,0,0,0,0,0,0,0,0,0,0,0,0,0,0
2011-05-08 00:00:00.000,ATP World Tour Masters 1000 Rome Italy ATP World Tour Masters 1000,CLAY,2,Jo-Wilfried Tsonga,Marcos Baghdatis,Jo-Wilfried Tsonga,6-3; 6-2,R64,75,6,1,24,41,20,24,13,17,0,0,8,33,41,1,2,32,55,18,32,10,23,7,11,9,28,55
2011-05-08 00:00:00.000,ATP World Tour Masters 1000 Rome Italy ATP World Tour Masters 1000,CLAY,2,Igor Andreev,Pere Riba,Igor Andreev,6-4; 7-5,R64,99,1,1,45,60,27,45,10,15,2,5,11,37,60,0,1,39,65,20,39,14,26,6,11,11,34,65
2011-05-08 00:00:00.000,ATP World Tour Masters 1000 Rome Italy ATP World Tour Masters 1000,CLAY,2,Richard Gasquet,Albert Montanes,Richard Gasquet,6-2; 6-3,R64,73,7,1,38,57,29,38,9,19,1,2,9,38,57,3,2,23,44,15,23,9,21,3,7,8,24,44
2011-05-08 00:00:00.000,ATP World Tour Masters 1000 Rome Italy ATP World Tour Masters 1000,CLAY,2,Jarkko Nieminen,Adrian Mannarino,Jarkko Nieminen,7-5; 2-6; 6-3,R64,127,3,1,71,96,42,71,20,25,5,7,15,62,96,4,0,59,92,39,59,19,33,2,4,14,58,92
2011-05-08 00:00:00.000,ATP World Tour Masters 1000 Rome Italy ATP World Tour Masters 1000,CLAY,2,Sergiy Stakhovsky,Victor Hanescu,Sergiy Stakhovsky,6-3; 1-6; 7-6(6),R64,127,6,0,69,99,49,69,14,30,4,7,14,63,99,5,2,56,73,48,56,7,17,1,3,14,55,73
2011-05-08 00:00:00.000,ATP World Tour Masters 1000 Rome Italy ATP World Tour Masters 1000,CLAY,2,Juan Monaco,Andreas Seppi,Juan Monaco,6-1; 4-6; 6-2,R64,134,5,1,40,66,34,40,12,26,1,2,12,46,66,3,0,52,96,31,52,20,44,6,11,13,51,96
2011-05-08 00:00:00.000,ATP World Tour Masters 1000 Rome Italy ATP World Tour Masters 1000,CLAY,2,Tomas Berdych,N/A Bye,Tomas Berdych,,R64,0,0,0,0,0,0,0,0,0,0,0,0,0,0,0,0,0,0,0,0,0,0,0,0,0,0,0
2011-05-08 00:00:00.000,ATP World Tour Masters 1000 Rome Italy ATP World Tour Masters 1000,CLAY,2,Jurgen Melzer,N/A Bye,Jurgen Melzer,,R64,0,0,0,0,0,0,0,0,0,0,0,0,0,0,0,0,0,0,0,0,0,0,0,0,0,0,0
2011-05-08 00:00:00.000,ATP World Tour Masters 1000 Rome Italy ATP World Tour Masters 1000,CLAY,2,Florian Mayer,Andrey Golubev,Florian Mayer,6-4; 6-3,R64,79,2,0,37,53,25,37,10,16,1,2,9,35,53,1,5,42,70,25,42,12,28,3,7,10,37,70
2011-05-08 00:00:00.000,ATP World Tour Masters 1000 Rome Italy ATP World Tour Masters 1000,CLAY,2,Juan Ignacio Chela,John Isner,Juan Ignacio Chela,6-4; 6-1,R64,72,2,2,38,49,31,38,6,11,2,2,8,37,49,2,1,38,56,24,38,5,18,1,5,9,29,56
2011-05-08 00:00:00.000,ATP World Tour Masters 1000 Rome Italy ATP World Tour Masters 1000,CLAY,2,Gilles Simon,Andy Roddick,Gilles Simon,6-3; 6-3,R64,82,4,2,29,51,23,29,12,22,0,1,9,35,51,1,0,39,57,22,39,8,18,4,8,9,30,57
2011-05-08 00:00:00.000,ATP World Tour Masters 1000 Rome Italy ATP World Tour Masters 1000,CLAY,2,Viktor Troicki,Nikolay Davydenko,Viktor Troicki,6-4; 7-5,R64,100,6,0,50,73,37,50,13,23,4,4,11,50,73,1,1,49,67,33,49,10,18,4,6,11,43,67
2011-05-08 00:00:00.000,ATP World Tour Masters 1000 Rome Italy ATP World Tour Masters 1000,CLAY,2,Potito Starace,Alexandr Dolgopolov,Potito Starace,6-3; 6-3,R64,62,1,0,44,52,32,44,5,8,0,0,9,37,52,2,1,30,52,18,30,11,22,1,4,9,29,52
2011-05-08 00:00:00.000,ATP World Tour Masters 1000 Rome Italy ATP World Tour Masters 1000,CLAY,2,Xavier Malisse,Guillermo Garcia-Lopez,Xavier Malisse,7-5; 6-2,R64,97,4,2,32,55,29,32,11,23,2,3,10,40,55,1,6,40,71,28,40,10,31,6,10,10,38,71
2011-05-08 00:00:00.000,ATP World Tour Masters 1000 Rome Italy ATP World Tour Masters 1000,CLAY,2,Andy Murray,N/A Bye,Andy Murray,,R64,0,0,0,0,0,0,0,0,0,0,0,0,0,0,0,0,0,0,0,0,0,0,0,0,0,0,0
2011-05-08 00:00:00.000,ATP World Tour Masters 1000 Rome Italy ATP World Tour Masters 1000,CLAY,2,Robin Soderling,N/A Bye,Robin Soderling,,R64,0,0,0,0,0,0,0,0,0,0,0,0,0,0,0,0,0,0,0,0,0,0,0,0,0,0,0
2011-05-08 00:00:00.000,ATP World Tour Masters 1000 Rome Italy ATP World Tour Masters 1000,CLAY,2,Fernando Verdasco,Milos Raonic,Fernando Verdasco,6-4; 6-4,R64,99,1,2,46,60,38,46,6,14,2,2,10,44,60,5,1,42,76,29,42,16,34,8,10,10,45,76
2011-05-08 00:00:00.000,ATP World Tour Masters 1000 Rome Italy ATP World Tour Masters 1000,CLAY,2,Sam Querrey,Kevin Anderson,Sam Querrey,7-6(1); 1-0 RET,R64,81,5,6,27,56,24,27,15,29,7,7,7,39,56,3,2,18,41,14,18,14,23,3,3,6,28,41
2011-05-08 00:00:00.000,ATP World Tour Masters 1000 Rome Italy ATP World Tour Masters 1000,CLAY,2,Nicolas Almagro,Simone Bolelli,Nicolas Almagro,6-0; 7-5,R64,75,4,0,33,49,26,33,10,16,0,1,9,36,49,1,0,39,52,21,39,7,13,2,7,9,28,52
2011-05-08 00:00:00.000,ATP World Tour Masters 1000 Rome Italy ATP World Tour Masters 1000,CLAY,2,Stanislas Wawrinka,Fabio Fognini,Stanislas Wawrinka,6-7(5); 6-2; 6-4,R64,141,9,0,63,92,50,63,16,29,4,5,15,66,92,1,4,65,104,43,65,20,39,1,5,15,63,104
2011-05-08 00:00:00.000,ATP World Tour Masters 1000 Rome Italy ATP World Tour Masters 1000,CLAY,2,Filippo Volandri,Thiemo de Bakker,Filippo Volandri,6-1; 6-2,R64,64,0,0,39,49,26,39,8,10,2,2,8,34,49,1,2,24,46,15,24,6,22,5,9,7,21,46
2011-05-08 00:00:00.000,ATP World Tour Masters 1000 Rome Italy ATP World Tour Masters 1000,CLAY,2,Lukasz Kubot,Pablo Cuevas,Lukasz Kubot,7-6(1); 2-6; 6-2,R64,163,4,7,53,94,41,53,20,41,6,8,14,61,94,9,2,82,122,52,82,19,40,13,15,14,71,122
2011-05-08 00:00:00.000,ATP World Tour Masters 1000 Rome Italy ATP World Tour Masters 1000,CLAY,2,Novak Djokovic,N/A Bye,Novak Djokovic,,R64,0,0,0,0,0,0,0,0,0,0,0,0,0,0,0,0,0,0,0,0,0,0,0,0,0,0,0
2011-05-08 00:00:00.000,ATP World Tour Masters 1000 Rome Italy ATP World Tour Masters 1000,CLAY,2,Rafael Nadal,Paolo Lorenzi,Rafael Nadal,6-7(5); 6-4; 6-0,R32,157,2,3,57,80,43,57,11,23,1,3,14,54,80,4,1,66,99,43,66,13,33,7,13,14,56,99
2011-05-08 00:00:00.000,ATP World Tour Masters 1000 Rome Italy ATP World Tour Masters 1000,CLAY,2,Feliciano Lopez,Philipp Kohlschreiber,Feliciano Lopez,6-4; 3-6; 6-3,R32,146,12,2,52,84,40,52,16,32,2,4,14,56,84,7,3,60,101,40,60,22,41,10,13,14,62,101
2011-05-08 00:00:00.000,ATP World Tour Masters 1000 Rome Italy ATP World Tour Masters 1000,CLAY,2,Mardy Fish,Ivan Ljubicic,Mardy Fish,7-6(2); 5-7; 6-2,R32,179,10,1,58,99,46,58,22,41,5,8,16,68,99,13,1,58,104,40,58,25,46,6,10,16,65,104
2011-05-08 00:00:00.000,ATP World Tour Masters 1000 Rome Italy ATP World Tour Masters 1000,CLAY,2,Marin Cilic,Carlos Berlocq,Marin Cilic,6-4; 6-3,R32,84,0,0,25,51,17,25,17,26,4,6,9,34,51,2,2,32,50,19,32,6,18,3,8,10,25,50
2011-05-08 00:00:00.000,ATP World Tour Masters 1000 Rome Italy ATP World Tour Masters 1000,CLAY,2,Roger Federer,Jo-Wilfried Tsonga,Roger Federer,6-4; 6-2,R32,83,2,0,43,66,32,43,13,23,7,7,9,45,66,3,0,28,53,17,28,14,25,4,7,9,31,53
2011-05-08 00:00:00.000,ATP World Tour Masters 1000 Rome Italy ATP World Tour Masters 1000,CLAY,2,Richard Gasquet,Igor Andreev,Richard Gasquet,6-1; 6-2,R32,61,4,1,25,44,18,25,13,19,2,3,8,31,44,0,1,20,33,8,20,3,13,2,7,7,11,33
2011-05-08 00:00:00.000,ATP World Tour Masters 1000 Rome Italy ATP World Tour Masters 1000,CLAY,2,Jarkko Nieminen,Sergiy Stakhovsky,Jarkko Nieminen,6-7(3); 6-3; 6-4,R32,149,2,2,68,111,47,68,19,43,6,9,16,66,111,4,0,61,96,37,61,22,35,5,10,15,59,96
2011-05-08 00:00:00.000,ATP World Tour Masters 1000 Rome Italy ATP World Tour Masters 1000,CLAY,2,Tomas Berdych,Juan Monaco,Tomas Berdych,6-2; 6-2,R32,90,2,0,27,50,19,27,14,23,4,5,8,33,50,1,1,27,44,12,27,8,17,1,6,8,20,44
2011-05-08 00:00:00.000,ATP World Tour Masters 1000 Rome Italy ATP World Tour Masters 1000,CLAY,2,Florian Mayer,Jurgen Melzer,Florian Mayer,6-4 RET,R32,42,4,0,16,26,13,16,7,10,0,0,5,20,26,2,1,22,31,14,22,6,9,0,1,5,20,31
2011-05-08 00:00:00.000,ATP World Tour Masters 1000 Rome Italy ATP World Tour Masters 1000,CLAY,2,Juan Ignacio Chela,Gilles Simon,Juan Ignacio Chela,6-4; 6-2,R32,92,0,3,38,53,28,38,7,15,1,2,9,35,53,3,2,29,59,14,29,14,30,4,8,9,28,59
2011-05-08 00:00:00.000,ATP World Tour Masters 1000 Rome Italy ATP World Tour Masters 1000,CLAY,2,Potito Starace,Viktor Troicki,Potito Starace,6-4; 6-4,R32,106,0,0,59,72,36,59,7,13,8,10,10,43,72,3,1,43,74,29,43,12,31,4,8,10,41,74
2011-05-08 00:00:00.000,ATP World Tour Masters 1000 Rome Italy ATP World Tour Masters 1000,CLAY,2,Andy Murray,Xavier Malisse,Andy Murray,6-2; 2-6; 6-3,R32,119,9,2,47,92,33,47,18,45,8,13,13,51,92,3,1,54,80,30,54,10,26,3,9,12,40,80
2011-05-08 00:00:00.000,ATP World Tour Masters 1000 Rome Italy ATP World Tour Masters 1000,CLAY,2,Robin Soderling,Fernando Verdasco,Robin Soderling,2-6; 7-5; 6-4,R32,163,3,2,66,102,42,66,13,36,6,12,15,55,102,3,6,68,104,44,68,13,36,7,13,15,57,104
2011-05-08 00:00:00.000,ATP World Tour Masters 1000 Rome Italy ATP World Tour Masters 1000,CLAY,2,Nicolas Almagro,Sam Querrey,Nicolas Almagro,6-3; 7-6(4),R32,109,4,2,50,78,35,50,12,28,6,9,11,47,78,5,2,44,73,31,44,12,29,2,6,10,43,73
2011-05-08 00:00:00.000,ATP World Tour Masters 1000 Rome Italy ATP World Tour Masters 1000,CLAY,2,Stanislas Wawrinka,Filippo Volandri,Stanislas Wawrinka,6-1; 3-6; 6-2,R32,114,4,5,66,91,39,66,10,25,8,12,12,49,91,0,4,46,69,26,46,9,23,5,12,12,35,69
2011-05-08 00:00:00.000,ATP World Tour Masters 1000 Rome Italy ATP World Tour Masters 1000,CLAY,2,Novak Djokovic,Lukasz Kubot,Novak Djokovic,6-0; 6-3,R32,67,0,0,30,43,23,30,10,13,0,0,8,33,43,1,3,33,50,19,33,4,17,1,5,7,23,50
2011-05-08 00:00:00.000,ATP World Tour Masters 1000 Rome Italy ATP World Tour Masters 1000,CLAY,2,Rafael Nadal,Feliciano Lopez,Rafael Nadal,6-4; 6-2,R16,76,3,0,36,41,29,36,5,5,1,2,9,34,41,3,0,38,57,21,38,10,19,2,6,9,31,57
2011-05-08 00:00:00.000,ATP World Tour Masters 1000 Rome Italy ATP World Tour Masters 1000,CLAY,2,Marin Cilic,Mardy Fish,Marin Cilic,7-6(6); 6-3,R16,114,6,4,37,80,27,37,30,43,1,1,11,57,80,10,0,43,63,32,43,14,20,0,1,10,46,63
2011-05-08 00:00:00.000,ATP World Tour Masters 1000 Rome Italy ATP World Tour Masters 1000,CLAY,2,Richard Gasquet,Roger Federer,Richard Gasquet,4-6; 7-6(2); 7-6(4),R16,140,6,2,79,106,52,79,20,27,3,6,17,72,106,8,2,59,93,49,59,19,34,1,3,17,68,93
2011-05-08 00:00:00.000,ATP World Tour Masters 1000 Rome Italy ATP World Tour Masters 1000,CLAY,2,Tomas Berdych,Jarkko Nieminen,Tomas Berdych,6-2; 6-7(4); 6-2,R16,162,6,3,43,91,33,43,30,48,3,4,14,63,91,2,4,67,118,41,67,23,51,9,14,14,64,118
2011-05-08 00:00:00.000,ATP World Tour Masters 1000 Rome Italy ATP World Tour Masters 1000,CLAY,2,Florian Mayer,Juan Ignacio Chela,Florian Mayer,7-5; 6-4,R16,111,2,2,56,82,39,56,12,26,9,11,11,51,82,3,3,50,74,31,50,10,24,7,11,11,41,74
2011-05-08 00:00:00.000,ATP World Tour Masters 1000 Rome Italy ATP World Tour Masters 1000,CLAY,2,Andy Murray,Potito Starace,Andy Murray,6-2; 6-3,R16,67,3,1,32,45,26,32,8,13,0,1,9,34,45,0,1,41,49,24,41,1,8,5,9,8,25,49
2011-05-08 00:00:00.000,ATP World Tour Masters 1000 Rome Italy ATP World Tour Masters 1000,CLAY,2,Robin Soderling,Nicolas Almagro,Robin Soderling,6-3; 3-6; 6-4,R16,126,3,2,53,83,39,53,18,30,4,6,14,57,83,10,0,40,82,26,40,27,42,2,5,14,53,82
2011-05-08 00:00:00.000,ATP World Tour Masters 1000 Rome Italy ATP World Tour Masters 1000,CLAY,2,Novak Djokovic,Stanislas Wawrinka,Novak Djokovic,6-4; 6-1,R16,94,2,0,37,61,27,37,15,24,6,6,9,42,61,4,0,44,56,26,44,5,12,6,9,8,31,56
2011-05-08 00:00:00.000,ATP World Tour Masters 1000 Rome Italy ATP World Tour Masters 1000,CLAY,2,Rafael Nadal,Marin Cilic,Rafael Nadal,6-1; 6-3,Q,86,2,0,31,45,25,31,9,14,0,0,8,34,45,3,0,31,53,18,31,8,22,3,7,8,26,53
2011-05-08 00:00:00.000,ATP World Tour Masters 1000 Rome Italy ATP World Tour Masters 1000,CLAY,2,Richard Gasquet,Tomas Berdych,Richard Gasquet,4-6; 6-2; 6-4,Q,138,8,0,64,90,45,64,14,26,5,7,14,59,90,3,1,53,81,36,53,14,28,3,7,14,50,81
2011-05-08 00:00:00.000,ATP World Tour Masters 1000 Rome Italy ATP World Tour Masters 1000,CLAY,2,Andy Murray,Florian Mayer,Andy Murray,1-6; 6-1; 6-1,Q,96,1,1,36,66,22,36,16,30,3,7,11,38,66,0,1,43,62,22,43,5,19,7,13,10,27,62
2011-05-08 00:00:00.000,ATP World Tour Masters 1000 Rome Italy ATP World Tour Masters 1000,CLAY,2,Novak Djokovic,Robin Soderling,Novak Djokovic,6-3; 6-0,Q,77,4,1,31,50,20,31,13,19,3,4,8,33,50,2,1,30,46,16,30,3,16,4,9,7,19,46
2011-05-08 00:00:00.000,ATP World Tour Masters 1000 Rome Italy ATP World Tour Masters 1000,CLAY,2,Rafael Nadal,Richard Gasquet,Rafael Nadal,7-5; 6-1,S,94,4,0,40,54,31,40,8,14,4,4,9,39,54,1,1,32,56,19,32,11,24,1,5,10,30,56
2011-05-08 00:00:00.000,ATP World Tour Masters 1000 Rome Italy ATP World Tour Masters 1000,CLAY,2,Novak Djokovic,Andy Murray,Novak Djokovic,6-1; 3-6; 7-6(2),S,182,4,2,66,96,44,66,14,30,5,10,14,58,96,6,4,62,98,40,62,13,36,7,13,14,53,98
2011-05-08 00:00:00.000,ATP World Tour Masters 1000 Rome Italy ATP World Tour Masters 1000,CLAY,2,Novak Djokovic,Rafael Nadal,Novak Djokovic,6-4; 6-4,F,133,0,1,46,61,31,46,7,15,1,3,10,38,61,2,1,49,69,33,49,5,20,7,11,10,38,69
2011-05-15 00:00:00.000,Nice France ATP World Tour 250,CLAY,2,David Ferrer,N/A Bye,David Ferrer,,R32,0,0,0,0,0,0,0,0,0,0,0,0,0,0,0,0,0,0,0,0,0,0,0,0,0,0,0
2011-05-15 00:00:00.000,Nice France ATP World Tour 250,CLAY,2,Andreas Seppi,Edouard Roger-Vasselin,Andreas Seppi,3-6; 6-3; 6-2,R32,112,7,2,49,76,37,49,16,27,3,4,13,53,76,9,4,51,96,37,51,19,45,6,9,13,56,96
2011-05-15 00:00:00.000,Nice France ATP World Tour 250,CLAY,2,Pere Riba,Guillaume Rufin,Pere Riba,6-2; 6-2,R32,70,5,1,22,39,17,22,8,17,1,3,8,25,39,0,4,23,52,12,23,9,29,1,7,8,21,52
2011-05-15 00:00:00.000,Nice France ATP World Tour 250,CLAY,2,Alexandr Dolgopolov,Filippo Volandri,Alexandr Dolgopolov,7-5; 6-3,R32,81,3,4,30,69,22,30,23,39,7,9,11,45,69,0,0,50,66,28,50,7,16,8,12,10,35,66
2011-05-15 00:00:00.000,Nice France ATP World Tour 250,CLAY,2,Michael Russell,N/A Bye,Michael Russell,,R32,0,0,0,0,0,0,0,0,0,0,0,0,0,0,0,0,0,0,0,0,0,0,0,0,0,0,0
2011-05-15 00:00:00.000,Nice France ATP World Tour 250,CLAY,2,Victor Hanescu,Benoit Paire,Victor Hanescu,6-0; 6-1,R32,55,2,1,28,48,17,28,16,20,6,6,7,33,48,1,5,16,43,8,16,9,27,4,9,6,17,43
2011-05-15 00:00:00.000,Nice France ATP World Tour 250,CLAY,2,Robin Haase,Yen-Hsun Lu,Robin Haase,6-3; 6-4,R32,84,5,2,32,54,25,32,11,22,2,4,10,36,54,1,3,41,70,24,41,13,29,8,12,9,37,70
2011-05-15 00:00:00.000,Nice France ATP World Tour 250,CLAY,2,Sergiy Stakhovsky,Teymuraz Gabashvili,Sergiy Stakhovsky,7-6(5); 6-3,R32,108,6,3,45,70,34,45,12,25,3,4,10,46,70,1,7,61,87,37,61,11,26,5,8,11,48,87
2011-05-15 00:00:00.000,Nice France ATP World Tour 250,CLAY,2,Julien Benneteau,Marcos Baghdatis,Julien Benneteau,7-6(3); 6-2,R32,95,1,3,49,71,35,49,12,22,2,3,10,47,71,3,1,30,62,21,30,14,32,1,4,10,35,62
2011-05-15 00:00:00.000,Nice France ATP World Tour 250,CLAY,2,Pablo Andujar,Grigor Dimitrov,Pablo Andujar,5-0 RET,R32,19,2,0,5,11,4,5,4,6,0,0,2,8,11,0,0,10,18,4,10,1,8,1,4,3,5,18
2011-05-15 00:00:00.000,Nice France ATP World Tour 250,CLAY,2,Carlos Berlocq,Andreas Haider-Maurer,Carlos Berlocq,5-7; 6-3; 6-0,R32,125,3,0,41,70,28,41,21,29,4,6,13,49,70,3,4,42,86,26,42,22,44,4,10,14,48,86
2011-05-15 00:00:00.000,Nice France ATP World Tour 250,CLAY,2,Nicolas Almagro,N/A Bye,Nicolas Almagro,,R32,0,0,0,0,0,0,0,0,0,0,0,0,0,0,0,0,0,0,0,0,0,0,0,0,0,0,0
2011-05-15 00:00:00.000,Nice France ATP World Tour 250,CLAY,2,Ernests Gulbis,Fabio Fognini,Ernests Gulbis,3-6; 6-3; 6-3,R32,118,5,4,45,88,36,45,20,43,9,11,13,56,88,6,4,51,78,37,51,11,27,5,9,14,48,78
2011-05-15 00:00:00.000,Nice France ATP World Tour 250,CLAY,2,Denis Istomin,Olivier Rochus,Denis Istomin,6-2; 7-6(5),R32,100,10,4,43,72,32,43,13,29,3,5,10,45,72,0,3,39,71,23,39,15,32,4,8,10,38,71
2011-05-15 00:00:00.000,Nice France ATP World Tour 250,CLAY,2,Adrian Mannarino,Somdev Devvarman,Adrian Mannarino,6-3; 7-6(7),R32,116,2,1,45,92,29,45,28,47,5,7,11,57,92,2,1,36,66,25,36,16,30,4,7,10,41,66
2011-05-15 00:00:00.000,Nice France ATP World Tour 250,CLAY,2,Tomas Berdych,N/A Bye,Tomas Berdych,,R32,0,0,0,0,0,0,0,0,0,0,0,0,0,0,0,0,0,0,0,0,0,0,0,0,0,0,0
2011-05-15 00:00:00.000,Nice France ATP World Tour 250,CLAY,2,David Ferrer,Andreas Seppi,David Ferrer,6-3; 6-2,R16,71,6,2,23,45,22,23,14,22,0,0,9,36,45,2,2,26,55,21,26,10,29,6,9,8,31,55
2011-05-15 00:00:00.000,Nice France ATP World Tour 250,CLAY,2,Alexandr Dolgopolov,Pere Riba,Alexandr Dolgopolov,7-6(5); 7-6(5),R16,105,8,1,43,84,35,43,21,41,1,3,12,56,84,5,2,43,82,31,43,23,39,3,5,12,54,82
2011-05-15 00:00:00.000,Nice France ATP World Tour 250,CLAY,2,Victor Hanescu,Michael Russell,Victor Hanescu,7-5; 6-2,R16,76,4,2,40,53,35,40,5,13,0,1,10,40,53,1,4,36,56,22,36,8,20,2,6,10,30,56
2011-05-15 00:00:00.000,Nice France ATP World Tour 250,CLAY,2,Robin Haase,Sergiy Stakhovsky,Robin Haase,6-2; 6-4,R16,83,4,1,28,49,21,28,7,21,3,6,9,28,49,4,2,37,58,18,37,8,21,4,10,9,26,58
2011-05-15 00:00:00.000,Nice France ATP World Tour 250,CLAY,2,Pablo Andujar,Julien Benneteau,Pablo Andujar,6-3; 6-4,R16,90,3,1,42,69,31,42,16,27,3,3,10,47,69,4,3,32,49,21,32,11,17,2,4,9,32,49
2011-05-15 00:00:00.000,Nice France ATP World Tour 250,CLAY,2,Nicolas Almagro,Carlos Berlocq,Nicolas Almagro,6-7(5); 6-4; 6-3,R16,143,5,6,53,92,41,53,17,39,4,6,15,58,92,2,5,52,96,37,52,19,44,3,8,16,56,96
2011-05-15 00:00:00.000,Nice France ATP World Tour 250,CLAY,2,Ernests Gulbis,Denis Istomin,Ernests Gulbis,6-3; 4-6; 6-3,R16,125,3,2,47,85,36,47,24,38,2,3,14,60,85,9,3,61,94,43,61,14,33,5,8,14,57,94
2011-05-15 00:00:00.000,Nice France ATP World Tour 250,CLAY,2,Tomas Berdych,Adrian Mannarino,Tomas Berdych,6-1; 6-4,R16,64,3,2,35,49,28,35,10,14,1,1,9,38,49,2,2,29,47,18,29,8,18,2,5,8,26,47
2011-05-15 00:00:00.000,Nice France ATP World Tour 250,CLAY,2,Alexandr Dolgopolov,David Ferrer,Alexandr Dolgopolov,6-4; 1-6; 7-5,Q,112,6,3,46,88,30,46,25,42,3,7,14,55,88,2,3,52,83,34,52,20,31,5,9,15,54,83
2011-05-15 00:00:00.000,Nice France ATP World Tour 250,CLAY,2,Victor Hanescu,Robin Haase,Victor Hanescu,6-2; 2-0 RET,Q,56,2,0,21,29,18,21,3,8,0,0,5,21,29,3,2,33,49,18,33,5,16,6,9,5,23,49
2011-05-15 00:00:00.000,Nice France ATP World Tour 250,CLAY,2,Nicolas Almagro,Pablo Andujar,Nicolas Almagro,6-1; 6-4,Q,82,6,3,30,59,23,30,14,29,6,7,8,37,59,1,1,39,63,20,39,10,24,3,8,9,30,63
2011-05-15 00:00:00.000,Nice France ATP World Tour 250,CLAY,2,Tomas Berdych,Ernests Gulbis,Tomas Berdych,6-1; 6-4,Q,84,5,0,27,45,21,27,13,18,0,1,9,34,45,2,1,41,67,27,41,7,26,10,14,8,34,67
2011-05-15 00:00:00.000,Nice France ATP World Tour 250,CLAY,2,Victor Hanescu,Alexandr Dolgopolov,Victor Hanescu,6-3; 6-3,S,73,0,2,42,60,32,42,8,18,3,4,9,40,60,3,0,34,57,24,34,5,23,4,8,9,29,57
2011-05-15 00:00:00.000,Nice France ATP World Tour 250,CLAY,2,Nicolas Almagro,Tomas Berdych,Nicolas Almagro,6-4; 6-4,S,88,6,1,27,55,24,27,15,28,2,3,10,39,55,5,1,38,60,23,38,13,22,0,3,10,36,60
2011-05-15 00:00:00.000,Nice France ATP World Tour 250,CLAY,2,Nicolas Almagro,Victor Hanescu,Nicolas Almagro,6-7(5); 6-3; 6-3,F,139,10,4,42,88,31,42,23,46,4,8,15,54,88,2,1,72,106,42,72,15,34,9,16,15,57,106
2011-05-22 00:00:00.000,Roland Garros France Grand Slams,CLAY,3,Rafael Nadal,John Isner,Rafael Nadal,6-4; 6-7(2); 6-7(2); 6-2; 6-4,R128,241,8,1,97,134,79,97,26,37,0,1,26,105,134,13,3,112,165,76,112,31,53,10,15,26,107,165
2011-05-22 00:00:00.000,Roland Garros France Grand Slams,CLAY,3,Pablo Andujar,Santiago Giraldo,Pablo Andujar,7-6(5); 6-3; 6-3,R128,156,6,0,76,117,50,76,22,41,13,15,15,72,117,1,1,62,100,42,62,15,38,9,14,15,57,100
2011-05-22 00:00:00.000,Roland Garros France Grand Slams,CLAY,3,Antonio Veic,Pablo Cuevas,Antonio Veic,4-6; 6-3; 6-2; 3-1 RET,R128,117,11,3,58,89,45,58,19,31,6,8,16,64,89,10,2,47,89,28,47,21,42,1,6,15,49,89
2011-05-22 00:00:00.000,Roland Garros France Grand Slams,CLAY,3,Nikolay Davydenko,Denis Gremelmayr,Nikolay Davydenko,7-6(2); 6-1; 6-3,R128,129,4,3,70,101,49,70,20,31,9,10,14,69,101,0,0,48,84,28,48,20,36,7,12,14,48,84
2011-05-22 00:00:00.000,Roland Garros France Grand Slams,CLAY,3,Sam Querrey,Philipp Kohlschreiber,Sam Querrey,3-6; 6-1; 6-2; 6-4,R128,125,12,5,53,102,38,53,33,49,4,5,17,71,102,7,4,59,104,43,59,21,45,8,13,17,64,104
2011-05-22 00:00:00.000,Roland Garros France Grand Slams,CLAY,3,Ivan Ljubicic,Somdev Devvarman,Ivan Ljubicic,6-4; 6-3; 6-4,R128,122,10,0,51,84,39,51,23,33,3,4,15,62,84,4,1,59,93,40,59,16,34,5,9,14,56,93
2011-05-22 00:00:00.000,Roland Garros France Grand Slams,CLAY,3,Xavier Malisse,Dmitry Tursunov,Xavier Malisse,7-5; 3-6; 6-3; 3-6; 6-1,R128,180,15,2,85,142,64,85,26,57,6,10,23,90,142,11,5,93,145,59,93,28,52,7,13,23,87,145
2011-05-22 00:00:00.000,Roland Garros France Grand Slams,CLAY,3,Fernando Verdasco,Juan Monaco,Fernando Verdasco,6-2; 7-5; 4-6; 6-4,R128,207,7,9,86,140,65,86,24,54,8,11,20,89,140,0,2,75,126,41,75,31,51,6,12,20,72,126
2011-05-22 00:00:00.000,Roland Garros France Grand Slams,CLAY,3,Mardy Fish,Ricardo Mello,Mardy Fish,6-2; 6-7(11); 6-2; 6-4,R128,185,12,2,64,113,50,64,26,49,0,2,19,76,113,3,4,81,143,52,81,28,62,18,25,19,80,143
2011-05-22 00:00:00.000,Roland Garros France Grand Slams,CLAY,3,Robin Haase,Daniel Gimeno-Traver,Robin Haase,6-2; 7-6(3); 6-3,R128,115,7,1,64,95,51,64,17,31,5,6,15,68,95,3,3,60,101,39,60,22,41,9,13,14,61,101
2011-05-22 00:00:00.000,Roland Garros France Grand Slams,CLAY,3,Jeremy Chardy,Grigor Dimitrov,Jeremy Chardy,6-2; 6-4; 6-4,R128,95,4,4,43,75,36,43,19,32,1,2,14,55,75,4,6,42,73,28,42,16,31,2,7,14,44,73
2011-05-22 00:00:00.000,Roland Garros France Grand Slams,CLAY,3,Gilles Simon,Michael Russell,Gilles Simon,6-3; 4-6; 6-1; 6-0,R128,138,4,3,47,95,35,47,29,48,2,4,16,64,95,1,6,79,101,41,79,7,22,7,15,16,48,101
2011-05-22 00:00:00.000,Roland Garros France Grand Slams,CLAY,3,Marcos Baghdatis,Frederico Gil,Marcos Baghdatis,7-6(4); 6-2; 6-2,R128,144,8,1,60,102,47,60,23,42,9,10,14,70,102,1,3,65,113,43,65,19,48,10,15,14,62,113
2011-05-22 00:00:00.000,Roland Garros France Grand Slams,CLAY,3,Leonardo Mayer,Dustin Brown,Leonardo Mayer,3-6; 7-6(5); 6-2; 6-2,R128,154,6,3,75,115,52,75,27,40,4,6,18,79,115,5,4,64,126,48,64,29,62,5,10,19,77,126
2011-05-22 00:00:00.000,Roland Garros France Grand Slams,CLAY,3,Albert Ramos,Javier Marti,Albert Ramos,6-3; 6-7(5); 4-6; 6-1; 6-3,R128,267,9,7,113,187,67,113,38,74,20,28,24,105,187,3,11,132,178,74,132,15,46,19,31,23,89,178
2011-05-22 00:00:00.000,Roland Garros France Grand Slams,CLAY,3,Robin Soderling,Ryan Harrison,Robin Soderling,6-1; 6-7(5); 6-3; 7-5,R128,168,11,5,72,116,58,72,26,44,3,5,21,84,116,14,4,63,125,41,63,33,62,10,16,19,74,125
2011-05-22 00:00:00.000,Roland Garros France Grand Slams,CLAY,3,Andy Murray,Eric Prodon,Andy Murray,6-4; 6-1; 6-3,R128,104,12,2,45,77,39,45,14,32,3,5,13,53,77,0,3,47,80,23,47,16,33,4,11,13,39,80
2011-05-22 00:00:00.000,Roland Garros France Grand Slams,CLAY,3,Simone Bolelli,Frank Dancevic,Simone Bolelli,6-1; 6-3; 6-7(5); 6-2,R128,147,7,0,77,102,61,77,19,25,4,4,18,80,102,10,1,77,128,46,77,29,51,7,13,18,75,128
2011-05-22 00:00:00.000,Roland Garros France Grand Slams,CLAY,3,Arnaud Clement,Filippo Volandri,Arnaud Clement,6-3; 1-6; 7-6(9); 6-4,R128,201,6,4,64,126,50,64,27,62,3,8,19,77,126,3,3,97,134,65,97,17,37,6,11,19,82,134
2011-05-22 00:00:00.000,Roland Garros France Grand Slams,CLAY,3,Michael Berrer,Milos Raonic,Michael Berrer,6-4; 4-6; 6-3; 6-4,R128,150,5,2,74,119,53,74,29,45,6,8,20,82,119,7,4,57,101,40,57,27,44,1,5,19,67,101
2011-05-22 00:00:00.000,Roland Garros France Grand Slams,CLAY,3,Alexandr Dolgopolov,Rainer Schuettler,Alexandr Dolgopolov,6-3; 6-3; 6-1,R128,90,14,3,42,68,35,42,13,26,0,1,12,48,68,3,7,57,98,36,57,12,41,12,19,13,48,98
2011-05-22 00:00:00.000,Roland Garros France Grand Slams,CLAY,3,Andreas Haider-Maurer,Ryan Sweeting,Andreas Haider-Maurer,6-1; 6-7(5); 6-2; 6-0,R128,148,10,7,69,122,56,69,29,53,5,5,17,85,122,3,8,69,108,43,69,17,39,8,15,16,60,108
2011-05-22 00:00:00.000,Roland Garros France Grand Slams,CLAY,3,Tobias Kamke,Olivier Rochus,Tobias Kamke,6-7(5); 6-3; 6-3; 6-2,R128,171,14,2,69,131,47,69,33,62,6,9,19,80,131,5,4,79,123,52,79,16,44,10,18,19,68,123
2011-05-22 00:00:00.000,Roland Garros France Grand Slams,CLAY,3,Viktor Troicki,Julian Reister,Viktor Troicki,6-4; 6-3; 6-3,R128,114,20,1,53,86,46,53,15,33,6,7,14,61,86,1,0,58,88,35,58,15,30,5,10,14,50,88
2011-05-22 00:00:00.000,Roland Garros France Grand Slams,CLAY,3,Lukasz Kubot,Nicolas Almagro,Lukasz Kubot,3-6; 2-6; 7-6(3); 7-6(5); 6-4,R128,230,5,10,105,175,65,105,36,70,10,19,26,101,175,18,6,87,154,67,87,33,67,7,13,25,100,154
2011-05-22 00:00:00.000,Roland Garros France Grand Slams,CLAY,3,Carlos Berlocq,Bernard Tomic,Carlos Berlocq,7-5; 6-4; 6-2,R128,127,4,2,52,79,40,52,14,27,0,3,15,54,79,1,5,69,107,43,69,14,38,11,18,15,57,107
2011-05-22 00:00:00.000,Roland Garros France Grand Slams,CLAY,3,Alejandro Falla,Potito Starace,Alejandro Falla,7-6(2); 6-1; 6-1,R128,116,1,3,53,82,43,53,18,29,7,7,13,61,82,3,2,65,92,39,65,12,27,3,8,13,51,92
2011-05-22 00:00:00.000,Roland Garros France Grand Slams,CLAY,3,Florian Mayer,Igor Kunitsyn,Florian Mayer,6-3; 4-6; 6-4; 6-3,R128,177,6,1,72,129,52,72,24,57,7,12,19,76,129,2,0,76,129,46,76,25,53,7,15,19,71,129
2011-05-22 00:00:00.000,Roland Garros France Grand Slams,CLAY,3,Kevin Anderson,Nicolas Mahut,Kevin Anderson,6-4; 6-4; 6-7(6); 6-3,R128,186,22,3,80,123,64,80,25,43,5,7,21,89,123,9,6,111,154,74,111,21,43,12,17,20,95,154
2011-05-22 00:00:00.000,Roland Garros France Grand Slams,CLAY,3,Juan Ignacio Chela,Tim Smyczek,Juan Ignacio Chela,7-6(5); 6-1; 6-1,R128,104,1,2,63,78,45,63,7,15,2,5,13,52,78,0,1,57,85,24,57,14,28,5,13,13,38,85
2011-05-22 00:00:00.000,Roland Garros France Grand Slams,CLAY,3,Lukas Rosol,Edouard Roger-Vasselin,Lukas Rosol,3-6; 6-2; 6-4; 3-6; 7-5,R128,186,13,10,102,171,77,102,28,69,10,14,24,105,171,8,2,89,139,64,89,23,50,3,8,24,87,139
2011-05-22 00:00:00.000,Roland Garros France Grand Slams,CLAY,3,Jurgen Melzer,Andreas Beck,Jurgen Melzer,6-3; 6-4; 6-2,R128,118,6,2,48,84,35,48,23,36,7,8,14,58,84,2,3,55,85,34,55,13,30,6,11,13,47,85
2011-05-22 00:00:00.000,Roland Garros France Grand Slams,CLAY,3,David Ferrer,Jarkko Nieminen,David Ferrer,6-3; 6-3; 6-1,R128,85,4,0,42,61,37,42,15,19,0,0,13,52,61,3,2,46,72,27,46,13,26,5,10,12,40,72
2011-05-22 00:00:00.000,Roland Garros France Grand Slams,CLAY,3,Julien Benneteau,Rui Machado,Julien Benneteau,4-6; 6-1; 6-2; 6-0,R128,149,7,3,63,101,44,63,21,38,4,6,16,65,101,0,6,61,103,31,61,20,42,6,14,15,51,103
2011-05-22 00:00:00.000,Roland Garros France Grand Slams,CLAY,3,Kei Nishikori,Yen-Hsun Lu,Kei Nishikori,6-1; 6-3; 6-4,R128,145,1,5,71,106,46,71,16,35,12,15,13,62,106,0,6,72,115,39,72,15,43,21,29,13,54,115
2011-05-22 00:00:00.000,Roland Garros France Grand Slams,CLAY,3,Sergiy Stakhovsky,David Guez,Sergiy Stakhovsky,6-7(7); 6-3; 6-3; 6-3,R128,173,13,1,76,125,57,76,23,49,6,10,20,80,125,0,2,68,122,42,68,26,54,10,18,19,68,122
2011-05-22 00:00:00.000,Roland Garros France Grand Slams,CLAY,3,Steve Darcis,Michael Llodra,Steve Darcis,6-7(5); 6-3; 6-3; 6-3,R128,146,6,3,71,119,57,71,30,48,3,4,20,87,119,11,6,75,117,56,75,20,42,7,12,19,76,117
2011-05-22 00:00:00.000,Roland Garros France Grand Slams,CLAY,3,Philipp Petzschner,Mischa Zverev,Philipp Petzschner,7-6(3); 6-0; 6-4,R128,103,12,1,59,89,46,59,20,30,3,3,14,66,89,1,3,58,95,35,58,19,37,4,8,14,54,95
2011-05-22 00:00:00.000,Roland Garros France Grand Slams,CLAY,3,Guillaume Rufin,Adrian Mannarino,Guillaume Rufin,6-2; 6-3; 6-2,R128,91,11,2,40,67,33,40,18,27,1,2,13,51,67,2,1,47,72,28,47,10,25,4,10,12,38,72
2011-05-22 00:00:00.000,Roland Garros France Grand Slams,CLAY,3,Gael Monfils,Bjorn Phau,Gael Monfils,4-6; 6-3; 7-5; 6-0,R128,137,5,1,52,96,42,52,29,44,2,4,19,71,96,3,5,60,112,37,60,26,52,7,13,18,63,112
2011-05-22 00:00:00.000,Roland Garros France Grand Slams,CLAY,3,Stanislas Wawrinka,Augustin Gensse,Stanislas Wawrinka,4-6; 6-3; 6-4; 6-2,R128,147,6,4,76,120,55,76,27,44,7,9,19,82,120,0,2,81,108,54,81,9,27,5,10,18,63,108
2011-05-22 00:00:00.000,Roland Garros France Grand Slams,CLAY,3,Thomas Schoorel,Maximo Gonzalez,Thomas Schoorel,7-6(5); 6-3; 6-3,R128,143,9,2,61,92,45,61,22,31,2,2,15,67,92,2,0,81,103,49,81,15,22,7,10,15,64,103
2011-05-22 00:00:00.000,Roland Garros France Grand Slams,CLAY,3,Igor Andreev,Florent Serra,Igor Andreev,6-4; 6-1; 6-3,R128,92,6,0,39,63,33,39,14,24,2,4,13,47,63,3,1,51,92,32,51,13,41,4,11,13,45,92
2011-05-22 00:00:00.000,Roland Garros France Grand Slams,CLAY,3,Jo-Wilfried Tsonga,Jan Hajek,Jo-Wilfried Tsonga,6-3; 6-2; 6-2,R128,118,8,1,48,82,35,48,22,34,2,2,13,57,82,3,1,46,72,28,46,12,26,3,8,12,40,72
2011-05-22 00:00:00.000,Roland Garros France Grand Slams,CLAY,3,Janko Tipsarevic,Brian Dabul,Janko Tipsarevic,7-6(1); 6-1; 6-0,R128,125,9,2,44,85,35,44,21,41,1,3,13,56,85,2,9,45,80,24,45,12,35,5,12,12,36,80
2011-05-22 00:00:00.000,Roland Garros France Grand Slams,CLAY,3,Pere Riba,Ivan Dodig,Pere Riba,6-3; 3-6; 7-6(6); 6-4,R128,201,10,5,70,133,53,70,36,63,7,9,20,89,133,7,4,81,134,60,81,27,53,9,12,20,87,134
2011-05-22 00:00:00.000,Roland Garros France Grand Slams,CLAY,3,Maxime Teixeira,Vincent Millot,Maxime Teixeira,6-2; 5-7; 6-7(4); 6-4; 6-1,R128,232,5,1,138,182,84,138,21,44,12,19,25,105,182,2,6,93,172,60,93,29,79,8,19,24,89,172
2011-05-22 00:00:00.000,Roland Garros France Grand Slams,CLAY,3,Roger Federer,Feliciano Lopez,Roger Federer,6-3; 6-4; 7-6(3),R128,119,12,0,56,89,48,56,20,33,0,0,16,68,89,7,3,63,99,41,63,22,36,7,9,15,63,99
2011-05-22 00:00:00.000,Roland Garros France Grand Slams,CLAY,3,Stephane Robert,Tomas Berdych,Stephane Robert,3-6; 3-6; 6-2; 6-2; 9-7,R128,203,12,6,82,153,63,82,31,71,7,12,25,94,153,16,3,93,155,72,93,23,62,13,20,25,95,155
2011-05-22 00:00:00.000,Roland Garros France Grand Slams,CLAY,3,Fabio Fognini,Denis Istomin,Fabio Fognini,6-4; 6-2; 6-2,R128,103,1,7,45,83,35,45,18,38,6,8,13,53,83,1,3,45,79,26,45,14,34,3,10,13,40,79
2011-05-22 00:00:00.000,Roland Garros France Grand Slams,CLAY,3,Marsel Ilhan,Tommy Haas,Marsel Ilhan,6-4; 4-6; 7-6(1); 6-4,R128,177,25,1,79,116,65,79,17,37,4,8,21,82,116,15,7,82,137,55,82,28,55,10,15,21,83,137
2011-05-22 00:00:00.000,Roland Garros France Grand Slams,CLAY,3,Guillermo Garcia-Lopez,Robert Kendrick,Guillermo Garcia-Lopez,6-1; 7-5; 4-6; 6-3,R128,148,4,6,54,109,37,54,38,55,6,8,19,75,109,10,4,70,119,47,70,22,49,5,11,19,69,119
2011-05-22 00:00:00.000,Roland Garros France Grand Slams,CLAY,3,Ruben Ramirez Hidalgo,Marin Cilic,Ruben Ramirez Hidalgo,7-6(5); 6-4; 6-4,R128,173,1,3,61,109,44,61,24,48,3,6,16,68,109,9,1,62,112,44,62,19,50,6,11,16,63,112
2011-05-22 00:00:00.000,Roland Garros France Grand Slams,CLAY,3,Albert Montanes,Marc Gicquel,Albert Montanes,6-4; 6-4; 6-2,R128,105,10,2,47,89,37,47,24,42,2,3,14,61,89,1,3,38,78,24,38,21,40,3,8,14,45,78
2011-05-22 00:00:00.000,Roland Garros France Grand Slams,CLAY,3,Mikhail Kukushkin,Daniel Brands,Mikhail Kukushkin,6-2; 6-4; 6-4,R128,116,4,0,59,82,44,59,17,23,6,6,14,61,82,4,3,58,88,40,58,14,30,5,9,14,54,88
2011-05-22 00:00:00.000,Roland Garros France Grand Slams,CLAY,3,Mikhail Youzhny,Go Soeda,Mikhail Youzhny,7-5; 6-2; 6-4,R128,142,2,4,60,100,41,60,23,40,7,9,15,64,100,1,5,57,95,36,57,14,38,5,11,15,50,95
2011-05-22 00:00:00.000,Roland Garros France Grand Slams,CLAY,3,Richard Gasquet,Radek Stepanek,Richard Gasquet,7-5; 6-3; 6-0,R128,123,6,2,64,98,49,64,18,34,5,5,14,67,98,3,2,49,78,32,49,11,29,3,8,13,43,78
2011-05-22 00:00:00.000,Roland Garros France Grand Slams,CLAY,3,Marcel Granollers,Alex Bogomolov Jr.,Marcel Granollers,6-3; 3-6; 7-6(6); 6-2,R128,178,4,1,77,121,62,77,25,44,6,7,19,87,121,1,2,91,119,61,91,20,28,7,10,19,81,119
2011-05-22 00:00:00.000,Roland Garros France Grand Slams,CLAY,3,Andreas Seppi,Teymuraz Gabashvili,Andreas Seppi,6-3; 7-5; 7-5,R128,133,8,1,67,96,54,67,15,29,1,2,17,69,96,4,5,69,111,46,69,20,42,9,13,16,66,111
2011-05-22 00:00:00.000,Roland Garros France Grand Slams,CLAY,3,Thomaz Bellucci,Andrey Golubev,Thomaz Bellucci,6-4; 6-4; 6-7(4); 7-6(5),R128,199,7,2,78,129,63,78,33,51,3,5,22,96,129,10,7,98,151,73,98,26,53,7,11,22,99,151
2011-05-22 00:00:00.000,Roland Garros France Grand Slams,CLAY,3,Juan Martin Del Potro,Ivo Karlovic,Juan Martin Del Potro,6-7(7); 6-3; 7-5; 6-4,R128,193,11,4,85,128,70,85,29,43,5,5,22,99,128,22,4,99,147,79,99,20,48,13,16,21,99,147
2011-05-22 00:00:00.000,Roland Garros France Grand Slams,CLAY,3,Blaz Kavcic,Ernests Gulbis,Blaz Kavcic,6-1; 6-4; 6-2,R128,116,9,6,50,78,37,50,15,28,4,6,13,52,78,6,9,51,93,32,51,12,42,4,11,12,44,93
2011-05-22 00:00:00.000,Roland Garros France Grand Slams,CLAY,3,Victor Hanescu,Benoit Paire,Victor Hanescu,7-5; 4-6; 6-1; 7-6(4),R128,163,2,6,93,145,59,93,30,52,8,13,21,89,145,5,7,65,131,47,65,24,66,9,16,20,71,131
2011-05-22 00:00:00.000,Roland Garros France Grand Slams,CLAY,3,Novak Djokovic,Thiemo de Bakker,Novak Djokovic,6-2; 6-1; 6-3,R128,92,0,2,47,59,39,47,10,12,1,1,12,49,59,5,3,52,80,32,52,10,28,10,16,12,42,80
2011-05-22 00:00:00.000,Roland Garros France Grand Slams,CLAY,3,Rafael Nadal,Pablo Andujar,Rafael Nadal,7-5; 6-3; 7-6(4),R64,198,6,4,86,126,57,86,18,40,11,16,17,75,126,1,2,72,110,43,72,13,38,4,11,16,56,110
2011-05-22 00:00:00.000,Roland Garros France Grand Slams,CLAY,3,Antonio Veic,Nikolay Davydenko,Antonio Veic,3-6; 6-2; 7-5; 3-6; 6-1,R64,199,5,3,76,140,48,76,32,64,12,19,22,80,140,2,5,110,143,62,110,16,33,6,16,23,78,143
2011-05-22 00:00:00.000,Roland Garros France Grand Slams,CLAY,3,Ivan Ljubicic,Sam Querrey,Ivan Ljubicic,7-6(2); 6-4; 6-4,R64,125,11,0,50,94,45,50,25,44,1,1,16,70,94,8,2,47,90,31,47,31,43,1,3,16,62,90
2011-05-22 00:00:00.000,Roland Garros France Grand Slams,CLAY,3,Fernando Verdasco,Xavier Malisse,Fernando Verdasco,4-6; 6-3; 7-6(5); 6-1,R64,159,7,1,104,138,65,104,24,34,8,11,20,89,138,4,2,77,121,53,77,20,44,6,11,18,73,121
2011-05-22 00:00:00.000,Roland Garros France Grand Slams,CLAY,3,Mardy Fish,Robin Haase,Mardy Fish,7-6(1); 6-2; 6-1,R64,132,2,2,42,81,34,42,26,39,1,1,13,60,81,3,1,70,113,41,70,21,43,12,17,14,62,113
2011-05-22 00:00:00.000,Roland Garros France Grand Slams,CLAY,3,Gilles Simon,Jeremy Chardy,Gilles Simon,4-6; 6-4; 6-1; 6-4,R64,158,3,5,79,128,53,79,25,49,9,13,19,78,128,3,5,60,104,38,60,21,44,4,11,18,59,104
2011-05-22 00:00:00.000,Roland Garros France Grand Slams,CLAY,3,Leonardo Mayer,Marcos Baghdatis,Leonardo Mayer,7-5; 6-4; 7-6(6),R64,152,1,4,44,89,35,44,34,45,0,1,17,69,89,6,1,68,116,45,68,28,48,3,6,17,73,116
2011-05-22 00:00:00.000,Roland Garros France Grand Slams,CLAY,3,Robin Soderling,Albert Ramos,Robin Soderling,6-3; 6-4; 6-4,R64,116,7,7,48,82,40,48,20,34,0,1,15,60,82,8,2,57,89,38,57,17,32,3,7,14,55,89
2011-05-22 00:00:00.000,Roland Garros France Grand Slams,CLAY,3,Andy Murray,Simone Bolelli,Andy Murray,7-6(3); 6-4; 7-5,R64,171,10,7,72,109,50,72,18,37,9,13,17,68,109,2,1,68,103,38,68,18,35,8,14,17,56,103
2011-05-22 00:00:00.000,Roland Garros France Grand Slams,CLAY,3,Michael Berrer,Arnaud Clement,Michael Berrer,7-6(6); 3-6; 7-5; 6-4,R64,216,9,4,98,149,68,98,25,51,13,18,22,93,149,4,2,89,137,59,89,24,48,4,9,21,83,137
2011-05-22 00:00:00.000,Roland Garros France Grand Slams,CLAY,3,Alexandr Dolgopolov,Andreas Haider-Maurer,Alexandr Dolgopolov,6-2; 6-4; 6-2,R64,96,6,2,47,82,36,47,22,35,6,6,13,58,82,4,7,37,79,27,37,17,42,3,8,13,44,79
2011-05-22 00:00:00.000,Roland Garros France Grand Slams,CLAY,3,Viktor Troicki,Tobias Kamke,Viktor Troicki,6-2; 6-2; 7-6(4),R64,127,12,4,57,91,43,57,15,34,2,5,14,58,91,1,6,57,104,30,57,22,47,12,19,14,52,104
2011-05-22 00:00:00.000,Roland Garros France Grand Slams,CLAY,3,Lukasz Kubot,Carlos Berlocq,Lukasz Kubot,6-3; 7-6(4); 6-3,R64,169,5,7,71,108,54,71,18,37,6,9,16,72,108,2,5,63,95,39,63,15,32,1,6,14,54,95
2011-05-22 00:00:00.000,Roland Garros France Grand Slams,CLAY,3,Alejandro Falla,Florian Mayer,Alejandro Falla,4-6; 7-6(4); 6-1; 6-2,R64,178,4,3,81,129,57,81,24,48,8,11,19,81,129,6,3,80,142,52,80,26,62,8,14,18,78,142
2011-05-22 00:00:00.000,Roland Garros France Grand Slams,CLAY,3,Juan Ignacio Chela,Kevin Anderson,Juan Ignacio Chela,3-6; 6-3; 6-4; 4-6; 6-2,R64,201,3,1,133,147,90,133,8,14,13,16,23,98,147,12,3,104,150,66,104,27,46,11,16,23,93,150
2011-05-22 00:00:00.000,Roland Garros France Grand Slams,CLAY,3,Lukas Rosol,Jurgen Melzer,Lukas Rosol,6-7(4); 6-4; 4-6; 7-6(3); 6-4,R64,239,14,6,124,214,89,124,42,90,8,13,27,131,214,8,7,116,184,81,116,34,68,13,19,27,115,184
2011-05-22 00:00:00.000,Roland Garros France Grand Slams,CLAY,3,David Ferrer,Julien Benneteau,David Ferrer,6-3; 6-4; 6-2,R64,119,3,0,44,73,40,44,19,29,1,1,14,59,73,4,2,71,102,46,71,12,31,12,16,13,58,102
2011-05-22 00:00:00.000,Roland Garros France Grand Slams,CLAY,3,Sergiy Stakhovsky,Kei Nishikori,Sergiy Stakhovsky,6-1; 3-6; 6-3; 7-6(3),R64,168,9,2,69,114,50,69,27,45,2,5,19,77,114,1,7,83,130,50,83,24,47,7,12,18,74,130
2011-05-22 00:00:00.000,Roland Garros France Grand Slams,CLAY,3,Steve Darcis,Philipp Petzschner,Steve Darcis,7-5; 6-4; 6-4,R64,116,4,2,51,91,37,51,28,40,4,5,16,65,91,7,2,55,93,41,55,17,38,6,10,16,58,93
2011-05-22 00:00:00.000,Roland Garros France Grand Slams,CLAY,3,Gael Monfils,Guillaume Rufin,Gael Monfils,6-3; 1-6; 6-1; 6-3,R64,158,2,3,53,102,37,53,31,49,6,8,16,68,102,7,11,60,131,42,60,30,71,15,20,16,72,131
2011-05-22 00:00:00.000,Roland Garros France Grand Slams,CLAY,3,Stanislas Wawrinka,Thomas Schoorel,Stanislas Wawrinka,6-3; 6-2; 6-4,R64,98,10,3,51,88,39,51,23,37,3,3,14,62,88,4,1,53,80,35,53,12,27,5,9,13,47,80
2011-05-22 00:00:00.000,Roland Garros France Grand Slams,CLAY,3,Jo-Wilfried Tsonga,Igor Andreev,Jo-Wilfried Tsonga,6-3; 7-6(4); 6-3,R64,156,12,4,61,105,52,61,24,44,3,4,16,76,105,2,1,56,97,38,56,25,41,4,7,14,63,97
2011-05-22 00:00:00.000,Roland Garros France Grand Slams,CLAY,3,Janko Tipsarevic,Pere Riba,Janko Tipsarevic,6-1; 6-3; 6-0,R64,82,6,1,36,58,30,36,13,22,1,2,11,43,58,4,3,31,63,15,31,12,32,4,12,11,27,63
2011-05-22 00:00:00.000,Roland Garros France Grand Slams,CLAY,3,Roger Federer,Maxime Teixeira,Roger Federer,6-3; 6-0; 6-2,R64,84,7,0,44,63,36,44,12,19,0,1,12,48,63,0,3,39,73,20,39,14,34,6,13,11,34,73
2011-05-22 00:00:00.000,Roland Garros France Grand Slams,CLAY,3,Fabio Fognini,Stephane Robert,Fabio Fognini,6-2; 6-1; 6-0,R64,69,2,1,41,54,36,41,8,13,0,0,11,44,54,0,5,27,66,15,27,13,39,9,16,10,28,66
2011-05-22 00:00:00.000,Roland Garros France Grand Slams,CLAY,3,Guillermo Garcia-Lopez,Marsel Ilhan,Guillermo Garcia-Lopez,6-4; 1-6; 6-2; 4-6; 13-11,R64,238,13,17,95,171,77,95,38,76,10,14,29,115,171,24,3,103,176,83,103,34,73,9,14,30,117,176
2011-05-22 00:00:00.000,Roland Garros France Grand Slams,CLAY,3,Albert Montanes,Ruben Ramirez Hidalgo,Albert Montanes,6-7(5); 6-4; 6-1; 6-2,R64,190,13,8,61,113,49,61,28,52,6,9,19,77,113,8,8,85,141,55,85,19,56,11,19,18,74,141
2011-05-22 00:00:00.000,Roland Garros France Grand Slams,CLAY,3,Mikhail Youzhny,Mikhail Kukushkin,Mikhail Youzhny,6-3; 7-5; 6-4,R64,165,4,3,55,93,45,55,20,38,6,7,16,65,93,5,1,54,107,32,54,30,53,9,13,15,62,107
2011-05-22 00:00:00.000,Roland Garros France Grand Slams,CLAY,3,Richard Gasquet,Marcel Granollers,Richard Gasquet,4-6; 6-3; 6-2; 6-4,R64,179,4,2,62,106,47,62,28,44,3,5,19,75,106,3,2,86,127,53,86,21,41,10,15,18,74,127
2011-05-22 00:00:00.000,Roland Garros France Grand Slams,CLAY,3,Thomaz Bellucci,Andreas Seppi,Thomaz Bellucci,6-1; 6-2; 6-4,R64,90,10,2,40,67,35,40,19,27,2,2,13,54,67,3,4,37,71,23,37,14,34,0,5,12,37,71
2011-05-22 00:00:00.000,Roland Garros France Grand Slams,CLAY,3,Juan Martin Del Potro,Blaz Kavcic,Juan Martin Del Potro,6-3; 6-2; 6-4,R64,132,3,5,50,84,38,50,14,34,4,7,14,52,84,5,4,48,80,30,48,10,32,5,12,13,40,80
2011-05-22 00:00:00.000,Roland Garros France Grand Slams,CLAY,3,Novak Djokovic,Victor Hanescu,Novak Djokovic,6-4; 6-1; 2-3 RET,R64,89,2,0,40,54,35,40,11,14,0,0,11,46,54,3,0,46,74,29,46,15,28,5,8,11,44,74
2011-05-22 00:00:00.000,Roland Garros France Grand Slams,CLAY,3,Rafael Nadal,Antonio Veic,Rafael Nadal,6-1; 6-3; 6-0,R32,101,1,0,48,66,30,48,14,18,3,5,11,44,66,0,1,33,56,11,33,5,23,1,10,11,16,56
2011-05-22 00:00:00.000,Roland Garros France Grand Slams,CLAY,3,Ivan Ljubicic,Fernando Verdasco,Ivan Ljubicic,6-3; 7-6(6); 6-4,R32,134,11,2,63,95,55,63,14,32,0,2,16,69,95,3,4,69,95,41,69,17,26,3,7,15,58,95
2011-05-22 00:00:00.000,Roland Garros France Grand Slams,CLAY,3,Gilles Simon,Mardy Fish,Gilles Simon,6-3; 6-4; 6-2,R32,120,2,1,48,86,36,48,21,38,5,6,14,57,86,3,2,40,73,26,40,16,33,4,9,13,42,73
2011-05-22 00:00:00.000,Roland Garros France Grand Slams,CLAY,3,Robin Soderling,Leonardo Mayer,Robin Soderling,6-1; 6-4; 6-3,R32,109,6,0,50,81,36,50,17,31,1,3,13,53,81,6,1,57,81,31,57,10,24,4,11,13,41,81
2011-05-22 00:00:00.000,Roland Garros France Grand Slams,CLAY,3,Andy Murray,Michael Berrer,Andy Murray,6-2; 6-3; 6-2,R32,127,7,0,53,79,41,53,11,26,1,2,13,52,79,1,5,57,91,32,57,15,34,14,20,12,47,91
2011-05-22 00:00:00.000,Roland Garros France Grand Slams,CLAY,3,Viktor Troicki,Alexandr Dolgopolov,Viktor Troicki,6-4; 3-6; 6-3; 6-4,R32,166,12,2,65,107,50,65,24,42,4,7,19,74,107,12,3,82,148,55,82,33,66,13,18,19,88,148
2011-05-22 00:00:00.000,Roland Garros France Grand Slams,CLAY,3,Alejandro Falla,Lukasz Kubot,Alejandro Falla,6-7(4); 6-4; 7-5; 6-4,R32,227,5,1,79,131,53,79,31,52,3,7,22,84,131,8,7,104,162,71,104,23,58,11,18,22,94,162
2011-05-22 00:00:00.000,Roland Garros France Grand Slams,CLAY,3,Juan Ignacio Chela,Lukas Rosol,Juan Ignacio Chela,6-2; 6-4; 3-6; 7-6(5),R32,155,5,1,88,120,55,88,19,32,9,14,19,74,120,11,2,78,134,48,78,28,56,10,17,20,76,134
2011-05-22 00:00:00.000,Roland Garros France Grand Slams,CLAY,3,David Ferrer,Sergiy Stakhovsky,David Ferrer,6-1; 6-1; 6-3,R32,96,2,0,45,67,36,45,15,22,2,2,12,51,67,2,3,40,72,25,40,10,32,1,7,11,35,72
2011-05-22 00:00:00.000,Roland Garros France Grand Slams,CLAY,3,Gael Monfils,Steve Darcis,Gael Monfils,6-3; 6-4; 7-5,R32,122,7,2,68,106,49,68,20,38,7,9,16,69,106,1,1,58,89,38,58,12,31,4,9,15,50,89
2011-05-22 00:00:00.000,Roland Garros France Grand Slams,CLAY,3,Stanislas Wawrinka,Jo-Wilfried Tsonga,Stanislas Wawrinka,4-6; 6-7(3); 7-6(5); 6-2; 6-3,R32,243,7,2,113,177,79,113,37,64,8,12,26,116,177,10,0,106,149,77,106,22,43,5,11,25,99,149
2011-05-22 00:00:00.000,Roland Garros France Grand Slams,CLAY,3,Roger Federer,Janko Tipsarevic,Roger Federer,6-1; 6-4; 6-3,R32,90,10,2,51,76,43,51,14,25,1,1,13,57,76,1,1,36,71,28,36,13,35,1,6,13,41,71
2011-05-22 00:00:00.000,Roland Garros France Grand Slams,CLAY,3,Fabio Fognini,Guillermo Garcia-Lopez,Fabio Fognini,4-6; 6-3; 6-3; 6-1,R32,144,11,7,62,103,47,62,20,41,2,6,18,67,103,3,5,69,109,38,69,20,40,6,14,17,58,109
2011-05-22 00:00:00.000,Roland Garros France Grand Slams,CLAY,3,Albert Montanes,Mikhail Youzhny,Albert Montanes,6-1; 7-6(0); 6-1,R32,138,5,3,51,99,34,51,30,48,9,11,14,64,99,2,6,45,79,25,45,13,34,1,7,12,38,79
2011-05-22 00:00:00.000,Roland Garros France Grand Slams,CLAY,3,Richard Gasquet,Thomaz Bellucci,Richard Gasquet,6-2; 6-3; 3-6; 6-3,R32,164,10,1,70,107,50,70,21,37,2,5,18,71,107,3,3,66,112,41,66,20,46,10,16,17,61,112
2011-05-22 00:00:00.000,Roland Garros France Grand Slams,CLAY,3,Novak Djokovic,Juan Martin Del Potro,Novak Djokovic,6-3; 3-6; 6-3; 6-2,R32,176,6,2,57,96,44,57,25,39,3,5,18,69,96,5,3,66,113,43,66,21,47,7,12,17,64,113
2011-05-22 00:00:00.000,Roland Garros France Grand Slams,CLAY,3,Rafael Nadal,Ivan Ljubicic,Rafael Nadal,7-5; 6-3; 6-3,R16,146,2,1,49,72,40,49,15,23,2,4,15,55,72,9,2,56,109,40,56,18,53,14,20,15,58,109
2011-05-22 00:00:00.000,Roland Garros France Grand Slams,CLAY,3,Robin Soderling,Gilles Simon,Robin Soderling,6-2; 6-3; 7-6(5),R16,136,4,5,54,99,41,54,25,45,6,7,14,66,99,6,4,53,90,36,53,18,37,3,8,15,54,90
2011-05-22 00:00:00.000,Roland Garros France Grand Slams,CLAY,3,Andy Murray,Viktor Troicki,Andy Murray,4-6; 4-6; 6-3; 6-2; 7-5,R16,236,12,1,85,150,65,85,27,65,6,13,25,92,150,4,3,111,174,67,111,28,63,14,23,24,95,174
2011-05-22 00:00:00.000,Roland Garros France Grand Slams,CLAY,3,Juan Ignacio Chela,Alejandro Falla,Juan Ignacio Chela,4-6; 6-2; 1-6; 7-6(5); 6-2,R16,235,2,4,100,161,65,100,24,61,11,20,22,89,161,7,1,89,152,47,89,33,63,9,19,23,80,152
2011-05-22 00:00:00.000,Roland Garros France Grand Slams,CLAY,3,Gael Monfils,David Ferrer,Gael Monfils,6-4; 2-6; 7-5; 1-6; 8-6,R16,247,11,5,86,147,62,86,27,61,2,10,25,89,147,5,5,107,182,74,107,32,75,15,22,26,106,182
2011-05-22 00:00:00.000,Roland Garros France Grand Slams,CLAY,3,Roger Federer,Stanislas Wawrinka,Roger Federer,6-3; 6-2; 7-5,R16,106,8,2,49,77,40,49,18,28,1,2,15,58,77,5,1,59,83,38,59,11,24,1,6,14,49,83
2011-05-22 00:00:00.000,Roland Garros France Grand Slams,CLAY,3,Fabio Fognini,Albert Montanes,Fabio Fognini,4-6; 6-4; 3-6; 6-3; 11-9,R16,262,7,9,112,201,79,112,48,89,14,19,29,127,201,7,7,90,176,63,90,51,86,10,16,29,114,176
2011-05-22 00:00:00.000,Roland Garros France Grand Slams,CLAY,3,Novak Djokovic,Richard Gasquet,Novak Djokovic,6-4; 6-4; 6-2,R16,107,8,0,49,70,44,49,14,21,3,3,14,58,70,6,2,53,86,35,53,15,33,4,8,14,50,86
2011-05-22 00:00:00.000,Roland Garros France Grand Slams,CLAY,3,Rafael Nadal,Robin Soderling,Rafael Nadal,6-4; 6-1; 7-6(3),Q,155,4,0,69,90,44,69,15,21,4,6,14,59,90,5,3,54,94,37,54,14,40,5,11,15,51,94
2011-05-22 00:00:00.000,Roland Garros France Grand Slams,CLAY,3,Andy Murray,Juan Ignacio Chela,Andy Murray,7-6(2); 7-5; 6-2,Q,173,9,4,61,118,41,61,29,57,12,17,16,70,118,2,5,73,115,40,73,16,42,8,16,16,56,115
2011-05-22 00:00:00.000,Roland Garros France Grand Slams,CLAY,3,Roger Federer,Gael Monfils,Roger Federer,6-4; 6-3; 7-6(3),Q,154,4,3,47,88,36,47,25,41,1,4,16,61,88,4,11,87,133,54,87,19,46,11,16,15,73,133
2011-05-22 00:00:00.000,Roland Garros France Grand Slams,CLAY,3,Novak Djokovic,Fabio Fognini,Novak Djokovic,W/O,Q,0,0,0,0,0,0,0,0,0,0,0,0,0,0,0,0,0,0,0,0,0,0,0,0,0,0,0
2011-05-22 00:00:00.000,Roland Garros France Grand Slams,CLAY,3,Rafael Nadal,Andy Murray,Rafael Nadal,6-4; 7-5; 6-4,S,197,2,3,87,119,60,87,14,32,15,18,16,74,119,5,4,67,104,44,67,13,37,7,13,16,57,104
2011-05-22 00:00:00.000,Roland Garros France Grand Slams,CLAY,3,Roger Federer,Novak Djokovic,Roger Federer,7-6(5); 6-3; 3-6; 7-6(5),S,219,18,2,91,141,70,91,25,50,9,13,21,95,141,7,2,112,168,67,112,34,56,21,25,21,101,168
2011-05-22 00:00:00.000,Roland Garros France Grand Slams,CLAY,3,Rafael Nadal,Roger Federer,Rafael Nadal,7-5; 7-6(3); 5-7; 6-1,F,220,4,3,106,147,69,106,21,41,10,15,22,90,147,11,1,80,126,55,80,18,46,8,15,21,73,126
2011-06-06 00:00:00.000,Halle Germany ATP World Tour 250,GRASS,2,Lleyton Hewitt,Leonardo Mayer,Lleyton Hewitt,6-2; 6-3,R32,69,6,2,32,53,25,32,14,21,3,3,9,39,53,2,1,30,51,18,30,11,21,1,4,8,29,51
2011-06-06 00:00:00.000,Halle Germany ATP World Tour 250,GRASS,2,Andreas Seppi,Tommy Haas,Andreas Seppi,6-2; 6-7(6); 6-3,R32,126,5,2,65,103,47,65,21,38,7,9,15,68,103,4,6,60,89,40,60,13,29,7,12,14,53,89
2011-06-06 00:00:00.000,Halle Germany ATP World Tour 250,GRASS,2,Philipp Kohlschreiber,Cedrik-Marcel Stebe,Philipp Kohlschreiber,6-4; 3-6; 6-1,R32,129,5,4,47,76,36,47,15,29,3,5,13,51,76,4,3,56,92,39,56,13,36,8,12,13,52,92
2011-06-06 00:00:00.000,Halle Germany ATP World Tour 250,GRASS,2,Alexandr Dolgopolov,Robin Haase,Alexandr Dolgopolov,6-7(4); 6-4; 6-4,R32,111,9,4,49,80,41,49,17,31,0,3,16,58,80,12,4,64,103,46,64,17,39,3,8,16,63,103
2011-06-06 00:00:00.000,Halle Germany ATP World Tour 250,GRASS,2,Gael Monfils,Florent Serra,Gael Monfils,6-4; 6-3,R32,57,14,2,29,48,26,29,12,19,0,0,9,38,48,2,0,45,63,32,45,7,18,4,7,10,39,63
2011-06-06 00:00:00.000,Halle Germany ATP World Tour 250,GRASS,2,Ivan Dodig,Pere Riba,Ivan Dodig,7-6(4); 7-6(6),R32,106,13,2,57,78,44,57,13,21,1,1,12,57,78,13,6,65,108,50,65,19,43,7,7,12,69,108
2011-06-06 00:00:00.000,Halle Germany ATP World Tour 250,GRASS,2,Yen-Hsun Lu,Jarkko Nieminen,Yen-Hsun Lu,7-6(2); 6-3,R32,91,4,2,55,75,40,55,14,20,0,0,11,54,75,6,1,37,63,27,37,14,26,2,3,10,41,63
2011-06-06 00:00:00.000,Halle Germany ATP World Tour 250,GRASS,2,Florian Mayer,Dustin Brown,Florian Mayer,7-6(6); 2-6; 6-3,R32,80,7,1,58,79,47,58,13,21,1,3,15,60,79,20,6,55,85,49,55,10,30,1,2,14,59,85
2011-06-06 00:00:00.000,Halle Germany ATP World Tour 250,GRASS,2,Milos Raonic,Pablo Andujar,Milos Raonic,6-3; 6-1,R32,66,12,2,25,42,22,25,11,17,0,0,8,33,42,2,2,33,61,20,33,12,28,3,7,8,32,61
2011-06-06 00:00:00.000,Halle Germany ATP World Tour 250,GRASS,2,Tobias Kamke,Julian Reister,Tobias Kamke,4-3 RET,R32,30,2,3,10,22,6,10,6,12,1,2,3,12,22,0,3,15,26,9,15,4,11,2,4,4,13,26
2011-06-06 00:00:00.000,Halle Germany ATP World Tour 250,GRASS,2,Daniel Gimeno-Traver,Andrey Golubev,Daniel Gimeno-Traver,1-6; 7-6(5); 6-2,R32,113,10,3,44,72,35,44,17,28,2,4,13,52,72,1,3,46,88,30,46,26,42,5,7,14,56,88
2011-06-06 00:00:00.000,Halle Germany ATP World Tour 250,GRASS,2,Philipp Petzschner,Dominik Meffert,Philipp Petzschner,6-2; 7-6(5),R32,79,7,0,36,61,28,36,15,25,2,4,10,43,61,7,4,45,66,29,45,10,21,5,9,10,39,66
2011-06-06 00:00:00.000,Halle Germany ATP World Tour 250,GRASS,2,Viktor Troicki,Mischa Zverev,Viktor Troicki,6-2; 6-3,R32,52,4,3,36,54,28,36,12,18,3,3,9,40,54,1,0,31,43,18,31,8,12,0,3,8,26,43
2011-06-06 00:00:00.000,Halle Germany ATP World Tour 250,GRASS,2,Igor Andreev,Potito Starace,Igor Andreev,6-4; 6-4,R32,69,8,0,34,50,27,34,13,16,0,0,10,40,50,6,1,51,71,33,51,10,20,5,7,10,43,71
2011-06-06 00:00:00.000,Halle Germany ATP World Tour 250,GRASS,2,Jan Hernych,Sergiy Stakhovsky,Jan Hernych,6-3; 6-7(5); 7-6(8),R32,161,3,3,88,126,63,88,20,38,19,20,16,83,126,13,4,92,137,65,92,20,45,7,10,17,85,137
2011-06-06 00:00:00.000,Halle Germany ATP World Tour 250,GRASS,2,Tomas Berdych,Ruben Bemelmans,Tomas Berdych,5-7; 7-6(8); 6-4,R32,136,10,2,57,97,48,57,26,40,1,2,17,74,97,5,2,78,119,57,78,24,41,8,9,17,81,119
2011-06-06 00:00:00.000,Halle Germany ATP World Tour 250,GRASS,2,Lleyton Hewitt,Andreas Seppi,Lleyton Hewitt,6-4; 6-4,R16,81,3,2,32,56,27,32,12,24,1,2,10,39,56,9,0,36,60,27,36,9,24,1,4,10,36,60
2011-06-06 00:00:00.000,Halle Germany ATP World Tour 250,GRASS,2,Philipp Kohlschreiber,Alexandr Dolgopolov,Philipp Kohlschreiber,6-3; 7-6(5),R16,77,5,1,35,63,30,35,18,28,0,0,11,48,63,9,3,35,63,24,35,18,28,3,4,10,42,63
2011-06-06 00:00:00.000,Halle Germany ATP World Tour 250,GRASS,2,Gael Monfils,Ivan Dodig,Gael Monfils,6-2; 6-3,R16,52,2,2,25,40,21,25,9,15,1,2,8,30,40,1,1,32,52,18,32,8,20,0,5,9,26,52
2011-06-06 00:00:00.000,Halle Germany ATP World Tour 250,GRASS,2,Florian Mayer,Yen-Hsun Lu,Florian Mayer,7-6(4); 3-6; 6-4,R16,135,13,3,70,114,51,70,22,44,8,9,15,73,114,4,4,70,100,54,70,14,30,5,6,16,68,100
2011-06-06 00:00:00.000,Halle Germany ATP World Tour 250,GRASS,2,Milos Raonic,Tobias Kamke,Milos Raonic,7-6(2); 6-3,R16,72,14,0,42,56,38,42,11,14,1,1,11,49,56,3,1,31,55,24,31,16,24,0,1,10,40,55
2011-06-06 00:00:00.000,Halle Germany ATP World Tour 250,GRASS,2,Philipp Petzschner,Daniel Gimeno-Traver,Philipp Petzschner,6-2; 6-4,R16,72,7,0,32,52,24,32,13,20,2,3,9,37,52,4,2,44,63,26,44,7,19,3,7,9,33,63
2011-06-06 00:00:00.000,Halle Germany ATP World Tour 250,GRASS,2,Viktor Troicki,Igor Andreev,Viktor Troicki,6-3; 6-1,R16,53,5,4,24,42,19,24,10,18,1,2,8,29,42,1,4,27,46,13,27,7,19,1,6,8,20,46
2011-06-06 00:00:00.000,Halle Germany ATP World Tour 250,GRASS,2,Tomas Berdych,Jan Hernych,Tomas Berdych,6-3; 7-6(7),R16,107,11,1,54,87,40,54,17,33,6,7,11,57,87,6,0,64,88,39,64,13,24,8,10,10,52,88
2011-06-06 00:00:00.000,Halle Germany ATP World Tour 250,GRASS,2,Philipp Kohlschreiber,Lleyton Hewitt,Philipp Kohlschreiber,7-6(4); 6-3,Q,91,14,1,43,66,33,43,15,23,0,0,11,48,66,9,2,39,68,26,39,18,29,5,6,10,44,68
2011-06-06 00:00:00.000,Halle Germany ATP World Tour 250,GRASS,2,Gael Monfils,Florian Mayer,Gael Monfils,6-4; 6-4,Q,65,5,0,38,57,29,38,12,19,2,3,10,41,57,2,2,34,51,23,34,9,17,1,4,10,32,51
2011-06-06 00:00:00.000,Halle Germany ATP World Tour 250,GRASS,2,Philipp Petzschner,Milos Raonic,Philipp Petzschner,6-3; 6-7(6); 6-3,Q,114,8,3,60,99,49,60,24,39,3,3,16,73,99,8,4,61,94,46,61,17,33,5,7,14,63,94
2011-06-06 00:00:00.000,Halle Germany ATP World Tour 250,GRASS,2,Tomas Berdych,Viktor Troicki,Tomas Berdych,7-6(3); 6-1,Q,81,13,2,45,70,33,45,16,25,3,3,10,49,70,11,2,41,61,27,41,9,20,3,5,9,36,61
2011-06-06 00:00:00.000,Halle Germany ATP World Tour 250,GRASS,2,Philipp Kohlschreiber,Gael Monfils,Philipp Kohlschreiber,6-3; 6-3,S,78,1,2,27,52,24,27,13,25,0,0,9,37,52,0,6,39,64,22,39,14,25,5,8,9,36,64
2011-06-06 00:00:00.000,Halle Germany ATP World Tour 250,GRASS,2,Philipp Petzschner,Tomas Berdych,Philipp Petzschner,7-6(7); 2-6; 6-3,S,139,15,5,71,121,49,71,23,50,8,12,15,72,121,11,3,50,84,37,50,18,34,0,3,14,55,84
2011-06-06 00:00:00.000,Halle Germany ATP World Tour 250,GRASS,2,Philipp Kohlschreiber,Philipp Petzschner,Philipp Kohlschreiber,7-6(5); 2-0 RET,F,62,9,1,31,41,26,31,6,10,0,0,7,32,41,6,3,34,56,24,34,10,22,1,2,7,34,56
2011-06-06 00:00:00.000,London / Queen's Club Great Britain ATP World Tour 250,GRASS,2,Rafael Nadal,N/A Bye,Rafael Nadal,,R64,0,0,0,0,0,0,0,0,0,0,0,0,0,0,0,0,0,0,0,0,0,0,0,0,0,0,0
2011-06-06 00:00:00.000,London / Queen's Club Great Britain ATP World Tour 250,GRASS,2,Matthew Ebden,Somdev Devvarman,Matthew Ebden,7-5; 6-3,R64,97,4,1,58,77,43,58,9,19,10,11,11,52,77,2,0,42,57,25,42,8,15,2,5,10,33,57
2011-06-06 00:00:00.000,London / Queen's Club Great Britain ATP World Tour 250,GRASS,2,Radek Stepanek,Go Soeda,Radek Stepanek,6-1; 6-3,R64,66,4,3,30,43,25,30,8,13,2,2,8,33,43,1,2,20,55,14,20,13,35,4,8,8,27,55
2011-06-06 00:00:00.000,London / Queen's Club Great Britain ATP World Tour 250,GRASS,2,Ivan Ljubicic,Ryan Sweeting,Ivan Ljubicic,7-6(6); 6-2,R64,74,11,1,37,58,28,37,14,21,0,1,10,42,58,4,5,42,66,27,42,11,24,2,5,10,38,66
2011-06-06 00:00:00.000,London / Queen's Club Great Britain ATP World Tour 250,GRASS,2,Michael Llodra,Jaroslav Pospisil,Michael Llodra,6-3; 6-2,R64,62,5,2,40,56,30,40,10,16,2,2,9,40,56,0,2,25,46,21,25,5,21,1,4,8,26,46
2011-06-06 00:00:00.000,London / Queen's Club Great Britain ATP World Tour 250,GRASS,2,Julien Benneteau,Daniel Brands,Julien Benneteau,6-7(6); 6-1; 6-4,R64,110,15,2,66,87,52,66,12,21,1,2,15,64,87,11,4,66,96,43,66,13,30,4,8,14,56,96
2011-06-06 00:00:00.000,London / Queen's Club Great Britain ATP World Tour 250,GRASS,2,Michael Berrer,Ryan Harrison,Michael Berrer,7-6(7); 2-6; 7-5,R64,142,3,4,83,116,63,83,14,33,6,8,16,77,116,7,4,66,109,50,66,25,43,6,7,16,75,109
2011-06-06 00:00:00.000,London / Queen's Club Great Britain ATP World Tour 250,GRASS,2,Jo-Wilfried Tsonga,N/A Bye,Jo-Wilfried Tsonga,,R64,0,0,0,0,0,0,0,0,0,0,0,0,0,0,0,0,0,0,0,0,0,0,0,0,0,0,0
2011-06-06 00:00:00.000,London / Queen's Club Great Britain ATP World Tour 250,GRASS,2,Stanislas Wawrinka,N/A Bye,Stanislas Wawrinka,,R64,0,0,0,0,0,0,0,0,0,0,0,0,0,0,0,0,0,0,0,0,0,0,0,0,0,0,0
2011-06-06 00:00:00.000,London / Queen's Club Great Britain ATP World Tour 250,GRASS,2,James Ward,Daniel Cox,James Ward,6-3; 6-1,R64,61,8,1,26,41,21,26,12,15,0,0,8,33,41,2,4,33,59,18,33,12,26,3,7,8,30,59
2011-06-06 00:00:00.000,London / Queen's Club Great Britain ATP World Tour 250,GRASS,2,Rainer Schuettler,Bobby Reynolds,Rainer Schuettler,6-1; 6-1,R64,65,2,3,35,53,28,35,7,18,6,6,7,35,53,0,1,32,52,19,32,5,20,6,11,7,24,52
2011-06-06 00:00:00.000,London / Queen's Club Great Britain ATP World Tour 250,GRASS,2,Sam Querrey,Kei Nishikori,Sam Querrey,6-3; 6-4,R64,76,10,0,41,62,35,41,11,21,7,7,10,46,62,4,3,44,64,27,44,12,20,3,5,9,39,64
2011-06-06 00:00:00.000,London / Queen's Club Great Britain ATP World Tour 250,GRASS,2,Juan Martin Del Potro,Denis Istomin,Juan Martin Del Potro,6-4; 6-2,R64,82,5,1,33,47,27,33,9,14,0,1,9,36,47,6,2,50,68,26,50,9,18,5,9,9,35,68
2011-06-06 00:00:00.000,London / Queen's Club Great Britain ATP World Tour 250,GRASS,2,Igor Kunitsyn,Alex Bogomolov Jr.,Igor Kunitsyn,6-4; 6-6 RET,R64,100,7,0,38,69,27,38,22,31,5,6,11,49,69,3,0,66,82,38,66,10,16,9,11,11,48,82
2011-06-06 00:00:00.000,London / Queen's Club Great Britain ATP World Tour 250,GRASS,2,Adrian Mannarino,Ernests Gulbis,Adrian Mannarino,6-3; 6-3,R64,61,3,1,25,48,22,25,16,23,1,1,9,38,48,5,2,39,59,27,39,6,20,4,7,9,33,59
2011-06-06 00:00:00.000,London / Queen's Club Great Britain ATP World Tour 250,GRASS,2,Gilles Simon,N/A Bye,Gilles Simon,,R64,0,0,0,0,0,0,0,0,0,0,0,0,0,0,0,0,0,0,0,0,0,0,0,0,0,0,0
2011-06-06 00:00:00.000,London / Queen's Club Great Britain ATP World Tour 250,GRASS,2,Fernando Verdasco,N/A Bye,Fernando Verdasco,,R64,0,0,0,0,0,0,0,0,0,0,0,0,0,0,0,0,0,0,0,0,0,0,0,0,0,0,0
2011-06-06 00:00:00.000,London / Queen's Club Great Britain ATP World Tour 250,GRASS,2,Nicolas Mahut,Oliver Golding,Nicolas Mahut,6-3; 6-4,R64,70,9,1,41,57,34,41,11,16,3,3,10,45,57,5,5,35,61,27,35,11,26,3,5,9,38,61
2011-06-06 00:00:00.000,London / Queen's Club Great Britain ATP World Tour 250,GRASS,2,Ilija Bozoljac,Mikhail Kukushkin,Ilija Bozoljac,6-4; 6-4,R64,70,10,2,37,56,32,37,10,19,0,0,10,42,56,1,0,39,64,26,39,14,25,2,4,10,40,64
2011-06-06 00:00:00.000,London / Queen's Club Great Britain ATP World Tour 250,GRASS,2,David Nalbandian,Illya Marchenko,David Nalbandian,6-3; 6-4,R64,83,4,2,31,59,26,31,17,28,2,2,10,43,59,5,1,28,58,19,28,15,30,6,8,9,34,58
2011-06-06 00:00:00.000,London / Queen's Club Great Britain ATP World Tour 250,GRASS,2,Kevin Anderson,Ivo Karlovic,Kevin Anderson,6-4; 7-6(2),R64,91,11,1,44,64,36,44,14,20,1,1,11,50,64,18,5,49,73,41,49,9,24,1,2,11,50,73
2011-06-06 00:00:00.000,London / Queen's Club Great Britain ATP World Tour 250,GRASS,2,Donald Young,Andreas Haider-Maurer,Donald Young,6-4; 6-7(5); 6-2,R64,114,7,2,71,99,50,71,16,28,6,8,15,66,99,5,4,57,97,39,57,18,40,2,7,15,57,97
2011-06-06 00:00:00.000,London / Queen's Club Great Britain ATP World Tour 250,GRASS,2,Feliciano Lopez,Dmitry Tursunov,Feliciano Lopez,7-6(4); 6-3,R64,91,18,2,53,75,42,53,11,22,4,5,11,53,75,8,1,42,62,29,42,11,20,3,5,10,40,62
2011-06-06 00:00:00.000,London / Queen's Club Great Britain ATP World Tour 250,GRASS,2,Andy Roddick,N/A Bye,Andy Roddick,,R64,0,0,0,0,0,0,0,0,0,0,0,0,0,0,0,0,0,0,0,0,0,0,0,0,0,0,0
2011-06-06 00:00:00.000,London / Queen's Club Great Britain ATP World Tour 250,GRASS,2,Marin Cilic,N/A Bye,Marin Cilic,,R64,0,0,0,0,0,0,0,0,0,0,0,0,0,0,0,0,0,0,0,0,0,0,0,0,0,0,0
2011-06-06 00:00:00.000,London / Queen's Club Great Britain ATP World Tour 250,GRASS,2,Arnaud Clement,Benoit Paire,Arnaud Clement,7-5; 6-3,R64,82,4,1,42,59,35,42,8,17,1,2,10,43,59,10,4,44,74,30,44,11,30,3,7,11,41,74
2011-06-06 00:00:00.000,London / Queen's Club Great Britain ATP World Tour 250,GRASS,2,Marsel Ilhan,Jan Hajek,Marsel Ilhan,6-4; 6-4,R64,83,12,1,52,71,38,52,9,19,2,2,10,47,71,2,2,56,80,34,56,14,24,4,6,10,48,80
2011-06-06 00:00:00.000,London / Queen's Club Great Britain ATP World Tour 250,GRASS,2,Thomaz Bellucci,Grigor Dimitrov,Thomaz Bellucci,3-6; 7-6(8); 6-2,R64,114,4,0,62,91,46,62,16,29,3,4,14,62,91,12,2,75,103,56,75,11,28,5,7,15,67,103
2011-06-06 00:00:00.000,London / Queen's Club Great Britain ATP World Tour 250,GRASS,2,Janko Tipsarevic,Blaz Kavcic,Janko Tipsarevic,6-4; 6-4,R64,86,2,1,30,56,23,30,18,26,0,1,10,41,56,8,4,43,70,28,43,13,27,11,14,10,41,70
2011-06-06 00:00:00.000,London / Queen's Club Great Britain ATP World Tour 250,GRASS,2,Michael Russell,Denis Gremelmayr,Michael Russell,6-3; 7-5,R64,77,6,4,42,63,28,42,11,21,2,5,11,39,63,3,2,36,66,19,36,13,30,6,11,10,32,66
2011-06-06 00:00:00.000,London / Queen's Club Great Britain ATP World Tour 250,GRASS,2,Xavier Malisse,Matthias Bachinger,Xavier Malisse,6-4; 6-4,R64,65,8,1,34,55,29,34,12,21,2,3,10,41,55,3,2,34,54,23,34,10,20,2,5,10,33,54
2011-06-06 00:00:00.000,London / Queen's Club Great Britain ATP World Tour 250,GRASS,2,Andy Murray,N/A Bye,Andy Murray,,R64,0,0,0,0,0,0,0,0,0,0,0,0,0,0,0,0,0,0,0,0,0,0,0,0,0,0,0
2011-06-06 00:00:00.000,London / Queen's Club Great Britain ATP World Tour 250,GRASS,2,Rafael Nadal,Matthew Ebden,Rafael Nadal,6-4; 6-4,R32,75,6,2,36,58,29,36,13,22,1,1,10,42,58,7,2,32,55,26,32,10,23,1,3,10,36,55
2011-06-06 00:00:00.000,London / Queen's Club Great Britain ATP World Tour 250,GRASS,2,Radek Stepanek,Ivan Ljubicic,Radek Stepanek,0-6; 7-5; 6-4,R32,109,3,5,66,96,45,66,13,30,6,10,14,58,96,15,0,50,73,42,50,9,23,5,8,14,51,73
2011-06-06 00:00:00.000,London / Queen's Club Great Britain ATP World Tour 250,GRASS,2,Michael Llodra,Julien Benneteau,Michael Llodra,6-4; 7-5,R32,95,7,2,33,63,28,33,20,30,4,4,11,48,63,8,5,63,83,44,63,6,20,3,5,11,50,83
2011-06-06 00:00:00.000,London / Queen's Club Great Britain ATP World Tour 250,GRASS,2,Jo-Wilfried Tsonga,Michael Berrer,Jo-Wilfried Tsonga,6-0; 6-1,R32,47,6,3,26,43,21,26,10,17,2,2,7,31,43,1,4,17,32,6,17,6,15,2,7,6,12,32
2011-06-06 00:00:00.000,London / Queen's Club Great Britain ATP World Tour 250,GRASS,2,James Ward,Stanislas Wawrinka,James Ward,7-6(3); 6-3,R32,77,8,2,42,71,34,42,20,29,3,3,11,54,71,6,2,44,71,32,44,15,27,5,6,10,47,71
2011-06-06 00:00:00.000,London / Queen's Club Great Britain ATP World Tour 250,GRASS,2,Sam Querrey,Rainer Schuettler,Sam Querrey,7-6(6); 5-7; 6-3,R32,139,15,1,65,106,53,65,23,41,2,4,17,76,106,7,6,97,139,68,97,18,42,14,16,16,86,139
2011-06-06 00:00:00.000,London / Queen's Club Great Britain ATP World Tour 250,GRASS,2,Juan Martin Del Potro,Igor Kunitsyn,Juan Martin Del Potro,6-4; 6-4,R32,68,9,2,38,52,33,38,8,14,2,2,10,41,52,2,1,33,54,23,33,13,21,1,3,10,36,54
2011-06-06 00:00:00.000,London / Queen's Club Great Britain ATP World Tour 250,GRASS,2,Adrian Mannarino,Gilles Simon,Adrian Mannarino,6-7(4); 6-4; 3-0 RET,R32,127,0,1,55,89,36,55,12,34,4,9,13,48,89,3,3,50,96,31,50,16,46,11,18,12,47,96
2011-06-06 00:00:00.000,London / Queen's Club Great Britain ATP World Tour 250,GRASS,2,Fernando Verdasco,Nicolas Mahut,Fernando Verdasco,6-2; 6-3,R32,63,6,3,37,56,27,37,11,19,4,5,9,38,56,1,3,31,52,17,31,8,21,3,7,8,25,52
2011-06-06 00:00:00.000,London / Queen's Club Great Britain ATP World Tour 250,GRASS,2,David Nalbandian,Ilija Bozoljac,David Nalbandian,6-4; 6-4,R32,72,6,2,37,58,28,37,12,21,2,3,10,40,58,6,6,32,67,22,32,15,35,6,9,10,37,67
2011-06-06 00:00:00.000,London / Queen's Club Great Britain ATP World Tour 250,GRASS,2,Kevin Anderson,Donald Young,Kevin Anderson,6-2; 6-4,R32,72,9,2,44,62,35,44,7,18,2,2,9,42,62,4,3,41,60,26,41,9,19,4,7,9,35,60
2011-06-06 00:00:00.000,London / Queen's Club Great Britain ATP World Tour 250,GRASS,2,Andy Roddick,Feliciano Lopez,Andy Roddick,7-6(2); 6-7(5); 6-4,R32,133,15,4,73,98,62,73,13,25,3,4,17,75,98,35,10,78,114,62,78,13,36,4,6,17,75,114
2011-06-06 00:00:00.000,London / Queen's Club Great Britain ATP World Tour 250,GRASS,2,Marin Cilic,Arnaud Clement,Marin Cilic,6-4; 6-4,R32,90,11,3,35,62,27,35,14,27,3,5,10,41,62,2,2,35,63,25,35,10,28,4,8,10,35,63
2011-06-06 00:00:00.000,London / Queen's Club Great Britain ATP World Tour 250,GRASS,2,Thomaz Bellucci,Marsel Ilhan,Thomaz Bellucci,6-2; 6-7(3); 7-6(5),R32,144,9,3,80,119,49,80,25,39,5,8,16,74,119,10,6,67,115,47,67,20,48,7,12,16,67,115
2011-06-06 00:00:00.000,London / Queen's Club Great Britain ATP World Tour 250,GRASS,2,Janko Tipsarevic,Michael Russell,Janko Tipsarevic,7-6(3); 7-6(5),R32,116,6,3,52,82,43,52,14,30,2,3,12,57,82,3,3,57,84,44,57,13,27,4,5,12,57,84
2011-06-06 00:00:00.000,London / Queen's Club Great Britain ATP World Tour 250,GRASS,2,Andy Murray,Xavier Malisse,Andy Murray,6-3; 5-7; 6-3,R32,108,12,1,55,89,38,55,25,34,5,6,15,63,89,10,2,65,88,45,65,11,23,4,7,15,56,88
2011-06-06 00:00:00.000,London / Queen's Club Great Britain ATP World Tour 250,GRASS,2,Rafael Nadal,Radek Stepanek,Rafael Nadal,6-3; 5-7; 6-1,R16,144,7,4,65,102,40,65,21,37,13,16,14,61,102,1,2,60,91,38,60,10,31,9,15,14,48,91
2011-06-06 00:00:00.000,London / Queen's Club Great Britain ATP World Tour 250,GRASS,2,Jo-Wilfried Tsonga,Michael Llodra,Jo-Wilfried Tsonga,4-3 RET,R16,23,2,1,19,23,16,19,1,4,0,0,4,17,23,0,0,11,15,10,11,3,4,0,0,3,13,15
2011-06-06 00:00:00.000,London / Queen's Club Great Britain ATP World Tour 250,GRASS,2,James Ward,Sam Querrey,James Ward,3-6; 6-3; 6-4,R16,95,13,4,53,86,43,53,18,33,3,4,14,61,86,4,1,60,80,41,60,14,20,1,3,14,55,80
2011-06-06 00:00:00.000,London / Queen's Club Great Britain ATP World Tour 250,GRASS,2,Adrian Mannarino,Juan Martin Del Potro,Adrian Mannarino,7-6(3); 7-6(7),R16,121,5,1,68,98,42,68,21,30,8,10,12,63,98,16,2,52,77,40,52,11,25,0,2,12,51,77
2011-06-06 00:00:00.000,London / Queen's Club Great Britain ATP World Tour 250,GRASS,2,Fernando Verdasco,David Nalbandian,Fernando Verdasco,7-5; 6-1,R16,74,9,3,39,59,31,39,14,20,4,4,10,45,59,2,2,32,58,21,32,13,26,4,7,9,34,58
2011-06-06 00:00:00.000,London / Queen's Club Great Britain ATP World Tour 250,GRASS,2,Andy Roddick,Kevin Anderson,Andy Roddick,6-4; 6-4,R16,79,8,2,45,62,35,45,9,17,3,3,10,44,62,13,0,39,54,28,39,9,15,1,3,10,37,54
2011-06-06 00:00:00.000,London / Queen's Club Great Britain ATP World Tour 250,GRASS,2,Marin Cilic,Thomaz Bellucci,Marin Cilic,7-6(3); 0-6; 6-3,R16,114,3,5,55,85,42,55,14,30,5,9,14,56,85,9,0,59,86,43,59,13,27,1,3,13,56,86
2011-06-06 00:00:00.000,London / Queen's Club Great Britain ATP World Tour 250,GRASS,2,Andy Murray,Janko Tipsarevic,Andy Murray,6-4; 7-6(3),R16,126,11,1,45,65,33,45,12,20,1,3,11,45,65,3,1,44,71,25,44,17,27,3,6,11,42,71
2011-06-06 00:00:00.000,London / Queen's Club Great Britain ATP World Tour 250,GRASS,2,Jo-Wilfried Tsonga,Rafael Nadal,Jo-Wilfried Tsonga,6-7(3); 6-4; 6-1,Q,122,25,4,51,82,44,51,16,31,4,5,14,60,82,6,2,66,92,38,66,18,26,6,11,15,56,92
2011-06-06 00:00:00.000,London / Queen's Club Great Britain ATP World Tour 250,GRASS,2,James Ward,Adrian Mannarino,James Ward,6-2; 6-7(14); 6-4,Q,128,7,5,65,99,50,65,14,34,2,4,15,64,99,2,1,70,102,47,70,14,32,6,11,15,61,102
2011-06-06 00:00:00.000,London / Queen's Club Great Britain ATP World Tour 250,GRASS,2,Andy Roddick,Fernando Verdasco,Andy Roddick,6-2; 6-2,Q,65,3,2,33,50,24,33,11,17,0,0,8,35,50,5,3,30,52,18,30,9,22,7,11,8,27,52
2011-06-06 00:00:00.000,London / Queen's Club Great Britain ATP World Tour 250,GRASS,2,Andy Murray,Marin Cilic,Andy Murray,W/O,Q,0,0,0,0,0,0,0,0,0,0,0,0,0,0,0,0,0,0,0,0,0,0,0,0,0,0,0
2011-06-06 00:00:00.000,London / Queen's Club Great Britain ATP World Tour 250,GRASS,2,Jo-Wilfried Tsonga,James Ward,Jo-Wilfried Tsonga,6-3; 7-6(7),S,82,14,6,45,65,41,45,9,20,2,3,11,50,65,7,0,46,73,34,46,14,27,4,6,10,48,73
2011-06-06 00:00:00.000,London / Queen's Club Great Britain ATP World Tour 250,GRASS,2,Andy Murray,Andy Roddick,Andy Murray,6-3; 6-1,S,59,13,0,22,41,18,22,14,19,0,0,8,32,41,3,1,38,46,20,38,4,8,2,6,8,24,46
2011-06-06 00:00:00.000,London / Queen's Club Great Britain ATP World Tour 250,GRASS,2,Andy Murray,Jo-Wilfried Tsonga,Andy Murray,3-6; 7-6(2); 6-4,F,146,11,3,54,85,45,54,17,31,2,3,15,62,85,10,1,69,113,52,69,22,44,9,10,16,74,113
2011-06-12 00:00:00.000,Eastbourne Great Britain ATP World Tour 250,GRASS,2,Jo-Wilfried Tsonga,Denis Istomin,Jo-Wilfried Tsonga,6-2; 7-5,R32,91,8,0,38,61,28,38,13,23,5,6,10,41,61,7,3,52,75,36,52,6,23,14,18,10,42,75
2011-06-12 00:00:00.000,Eastbourne Great Britain ATP World Tour 250,GRASS,2,Radek Stepanek,Colin Fleming,Radek Stepanek,6-3; 6-4,R32,85,3,2,44,63,26,44,12,19,5,7,9,38,63,3,0,43,65,28,43,6,22,6,11,10,34,65
2011-06-12 00:00:00.000,Eastbourne Great Britain ATP World Tour 250,GRASS,2,Kei Nishikori,Evgeny Kirillov,Kei Nishikori,7-5; 6-1,R32,59,5,1,34,58,25,34,18,24,4,4,10,43,58,4,0,29,50,19,29,11,21,2,5,9,30,50
2011-06-12 00:00:00.000,Eastbourne Great Britain ATP World Tour 250,GRASS,2,Rainer Schuettler,Sergiy Stakhovsky,Rainer Schuettler,6-3; 6-2,R32,58,1,0,36,54,29,36,11,18,1,1,9,40,54,2,0,25,41,18,25,6,16,3,6,8,24,41
2011-06-12 00:00:00.000,Eastbourne Great Britain ATP World Tour 250,GRASS,2,Janko Tipsarevic,James Ward,Janko Tipsarevic,6-3; 4-6; 6-2,R32,111,4,1,49,85,36,49,24,36,5,6,14,60,85,10,6,57,89,39,57,14,32,7,10,13,53,89
2011-06-12 00:00:00.000,Eastbourne Great Britain ATP World Tour 250,GRASS,2,Mikhail Kukushkin,Yen-Hsun Lu,Mikhail Kukushkin,6-3; 6-3,R32,74,0,0,26,45,18,26,11,19,1,3,9,29,45,2,2,49,69,25,49,8,20,8,13,9,33,69
2011-06-12 00:00:00.000,Eastbourne Great Britain ATP World Tour 250,GRASS,2,Grigor Dimitrov,Daniel Evans,Grigor Dimitrov,2-6; 7-6(5); 6-4,R32,100,11,6,68,103,53,68,15,35,6,9,15,68,103,4,6,56,85,44,56,18,29,2,4,15,62,85
2011-06-12 00:00:00.000,Eastbourne Great Britain ATP World Tour 250,GRASS,2,Kevin Anderson,Alexander Slabinsky,Kevin Anderson,7-5; 6-3,R32,75,16,1,34,50,31,34,13,16,0,0,11,44,50,7,3,37,65,32,37,10,28,4,6,10,42,65
2011-06-12 00:00:00.000,Eastbourne Great Britain ATP World Tour 250,GRASS,2,Igor Kunitsyn,Pablo Andujar,Igor Kunitsyn,7-5; 6-1,R32,78,3,0,43,56,30,43,9,13,2,3,10,39,56,0,1,33,60,20,33,11,27,6,10,9,31,60
2011-06-12 00:00:00.000,Eastbourne Great Britain ATP World Tour 250,GRASS,2,Illya Marchenko,Frederico Gil,Illya Marchenko,6-1; 6-3,R32,59,6,1,30,47,21,30,14,17,3,3,8,35,47,1,0,30,46,15,30,9,16,2,6,8,24,46
2011-06-12 00:00:00.000,Eastbourne Great Britain ATP World Tour 250,GRASS,2,Julien Benneteau,Ryan Sweeting,Julien Benneteau,6-2; 7-6(4),R32,81,4,2,41,60,29,41,12,19,1,2,10,41,60,4,5,38,68,26,38,13,30,7,10,10,39,68
2011-06-12 00:00:00.000,Eastbourne Great Britain ATP World Tour 250,GRASS,2,Somdev Devvarman,Guillermo Garcia-Lopez,Somdev Devvarman,6-3; 6-4,R32,89,7,1,43,76,31,43,17,33,9,10,10,48,76,3,2,29,54,20,29,11,25,0,3,9,31,54
2011-06-12 00:00:00.000,Eastbourne Great Britain ATP World Tour 250,GRASS,2,Donald Young,Daniel Cox,Donald Young,6-1; 7-5,R32,71,6,3,48,64,36,48,9,16,3,3,10,45,64,3,8,40,65,26,40,11,25,5,8,9,37,65
2011-06-12 00:00:00.000,Eastbourne Great Britain ATP World Tour 250,GRASS,2,Andreas Seppi,Tobias Kamke,Andreas Seppi,3-6; 6-1; 6-4,R32,85,0,1,50,72,37,50,15,22,2,3,13,52,72,1,4,42,69,35,42,10,27,3,6,13,45,69
2011-06-12 00:00:00.000,Eastbourne Great Britain ATP World Tour 250,GRASS,2,Olivier Rochus,Lleyton Hewitt,Olivier Rochus,6-2; 3-0 RET,R32,48,2,1,16,26,12,16,8,10,0,0,5,20,26,3,2,24,45,13,24,7,21,7,11,6,20,45
2011-06-12 00:00:00.000,Eastbourne Great Britain ATP World Tour 250,GRASS,2,Carlos Berlocq,Alexandr Dolgopolov,Carlos Berlocq,7-5; 6-2,R32,72,6,1,41,64,29,41,13,23,2,4,10,42,64,5,2,35,63,23,35,10,28,5,10,10,33,63
2011-06-12 00:00:00.000,Eastbourne Great Britain ATP World Tour 250,GRASS,2,Radek Stepanek,Jo-Wilfried Tsonga,Radek Stepanek,6-2; 6-3,R16,60,3,1,35,46,28,35,5,11,0,0,8,33,46,4,0,37,58,20,37,12,21,2,6,9,32,58
2011-06-12 00:00:00.000,Eastbourne Great Britain ATP World Tour 250,GRASS,2,Kei Nishikori,Rainer Schuettler,Kei Nishikori,6-4; 4-6; 6-2,R16,106,3,2,51,80,35,51,19,29,0,2,14,54,80,3,3,56,84,35,56,13,28,5,9,14,48,84
2011-06-12 00:00:00.000,Eastbourne Great Britain ATP World Tour 250,GRASS,2,Janko Tipsarevic,Mikhail Kukushkin,Janko Tipsarevic,6-3; 7-6(2),R16,107,6,3,28,62,24,28,25,34,4,4,11,49,62,4,1,45,78,28,45,20,33,7,8,10,48,78
2011-06-12 00:00:00.000,Eastbourne Great Britain ATP World Tour 250,GRASS,2,Grigor Dimitrov,Kevin Anderson,Grigor Dimitrov,6-3; 6-2,R16,61,8,5,27,49,23,27,14,22,0,0,9,37,49,8,1,36,50,21,36,8,14,4,7,8,29,50
2011-06-12 00:00:00.000,Eastbourne Great Britain ATP World Tour 250,GRASS,2,Igor Kunitsyn,Illya Marchenko,Igor Kunitsyn,6-3; 1-6; 6-2,R16,92,3,2,42,68,29,42,12,26,6,10,12,41,68,7,4,36,61,26,36,11,25,0,5,12,37,61
2011-06-12 00:00:00.000,Eastbourne Great Britain ATP World Tour 250,GRASS,2,Julien Benneteau,Somdev Devvarman,Julien Benneteau,7-6(1); 6-7(6); 6-3,R16,154,3,2,70,95,49,70,18,25,5,7,16,67,95,7,2,71,118,49,71,22,47,6,10,17,71,118
2011-06-12 00:00:00.000,Eastbourne Great Britain ATP World Tour 250,GRASS,2,Andreas Seppi,Donald Young,Andreas Seppi,7-6(1); 6-3,R16,72,8,1,49,71,38,49,13,22,3,4,11,51,71,4,2,42,51,31,42,4,9,0,2,10,35,51
2011-06-12 00:00:00.000,Eastbourne Great Britain ATP World Tour 250,GRASS,2,Olivier Rochus,Carlos Berlocq,Olivier Rochus,3-6; 7-6(5); 7-6(3),R16,186,1,3,77,105,55,77,18,28,5,8,16,73,105,27,3,76,115,61,76,18,39,4,6,17,79,115
2011-06-12 00:00:00.000,Eastbourne Great Britain ATP World Tour 250,GRASS,2,Kei Nishikori,Radek Stepanek,Kei Nishikori,6-2; 6-3,Q,86,2,4,41,69,26,41,14,28,9,11,9,40,69,0,4,35,58,19,35,8,23,5,10,8,27,58
2011-06-12 00:00:00.000,Eastbourne Great Britain ATP World Tour 250,GRASS,2,Janko Tipsarevic,Grigor Dimitrov,Janko Tipsarevic,6-3; 7-6(2),Q,88,3,1,44,69,28,44,14,25,6,9,10,42,69,4,8,41,70,26,41,10,29,1,6,11,36,70
2011-06-12 00:00:00.000,Eastbourne Great Britain ATP World Tour 250,GRASS,2,Igor Kunitsyn,Julien Benneteau,Igor Kunitsyn,6-3; 6-2,Q,75,4,2,34,56,26,34,14,22,2,2,9,40,56,2,3,25,49,16,25,12,24,2,5,8,28,49
2011-06-12 00:00:00.000,Eastbourne Great Britain ATP World Tour 250,GRASS,2,Andreas Seppi,Olivier Rochus,Andreas Seppi,6-2; 6-7(5); 6-3,Q,116,10,2,53,91,43,53,23,38,2,2,15,66,91,2,1,51,86,34,51,19,35,2,5,14,53,86
2011-06-12 00:00:00.000,Eastbourne Great Britain ATP World Tour 250,GRASS,2,Janko Tipsarevic,Kei Nishikori,Janko Tipsarevic,6-2; 6-4,S,78,3,0,31,50,26,31,12,19,1,1,9,38,50,4,3,39,57,25,39,9,18,3,6,9,34,57
2011-06-12 00:00:00.000,Eastbourne Great Britain ATP World Tour 250,GRASS,2,Andreas Seppi,Igor Kunitsyn,Andreas Seppi,6-4; 2-6; 6-4,S,126,8,6,59,96,42,59,15,37,9,13,14,57,96,8,2,71,98,41,71,15,27,8,12,14,56,98
2011-06-12 00:00:00.000,Eastbourne Great Britain ATP World Tour 250,GRASS,2,Andreas Seppi,Janko Tipsarevic,Andreas Seppi,7-6(5); 3-6; 5-3 RET,F,155,4,1,58,91,43,58,13,33,2,7,14,56,91,6,3,71,109,44,71,19,38,5,10,15,63,109
2011-06-12 00:00:00.000,s-Hertogenbosch The Netherlands ATP World Tour 250,GRASS,2,Michael Berrer,Nicolas Almagro,Michael Berrer,3-6; 7-6(5); 6-4,R32,98,7,2,56,88,45,56,23,32,2,3,15,68,88,15,4,48,87,41,48,27,39,3,4,16,68,87
2011-06-12 00:00:00.000,s-Hertogenbosch The Netherlands ATP World Tour 250,GRASS,2,Santiago Giraldo,Michael Russell,Santiago Giraldo,7-6(4); 6-3,R32,91,0,1,44,67,33,44,14,23,1,2,11,47,67,5,1,45,70,31,45,11,25,2,4,10,42,70
2011-06-12 00:00:00.000,s-Hertogenbosch The Netherlands ATP World Tour 250,GRASS,2,Dmitry Tursunov,Robert Kendrick,Dmitry Tursunov,6-2; 7-6(3),R32,70,6,3,35,57,30,35,11,22,0,1,10,41,57,7,3,34,59,21,34,14,25,3,6,10,35,59
2011-06-12 00:00:00.000,s-Hertogenbosch The Netherlands ATP World Tour 250,GRASS,2,Nicolas Mahut,Adrian Mannarino,Nicolas Mahut,7-6(2); 6-3,R32,81,6,3,39,61,26,39,12,22,0,2,10,38,61,1,5,39,65,26,39,11,26,1,5,11,37,65
2011-06-12 00:00:00.000,s-Hertogenbosch The Netherlands ATP World Tour 250,GRASS,2,Xavier Malisse,Alejandro Falla,Xavier Malisse,6-3; 6-1,R32,56,3,0,28,42,19,28,9,14,0,1,8,28,42,0,2,25,47,13,25,8,22,6,11,8,21,47
2011-06-12 00:00:00.000,s-Hertogenbosch The Netherlands ATP World Tour 250,GRASS,2,Jesse Huta Galung,Julian Reister,Jesse Huta Galung,6-2; 3-6; 7-5,R32,126,4,4,48,90,35,48,23,42,5,7,14,58,90,4,2,68,97,47,68,12,29,3,7,15,59,97
2011-06-12 00:00:00.000,s-Hertogenbosch The Netherlands ATP World Tour 250,GRASS,2,Filippo Volandri,Ricardo Mello,Filippo Volandri,6-4; 7-6(5),R32,93,4,3,49,68,34,49,11,19,2,4,11,45,68,4,2,59,95,33,59,21,36,6,9,11,54,95
2011-06-12 00:00:00.000,s-Hertogenbosch The Netherlands ATP World Tour 250,GRASS,2,Alex Bogomolov Jr.,Jeremy Chardy,Alex Bogomolov Jr.,3-6; 6-4; 7-6(7),R32,145,3,3,90,115,60,90,10,25,6,9,16,70,115,9,4,62,117,40,62,32,55,9,11,15,72,117
2011-06-12 00:00:00.000,s-Hertogenbosch The Netherlands ATP World Tour 250,GRASS,2,Javier Marti,Daniel Gimeno-Traver,Javier Marti,6-3; 7-6(4),R32,89,0,1,49,70,38,49,12,21,2,3,11,50,70,8,2,40,70,31,40,13,30,3,5,10,44,70
2011-06-12 00:00:00.000,s-Hertogenbosch The Netherlands ATP World Tour 250,GRASS,2,Teymuraz Gabashvili,Konstantin Kravchuk,Teymuraz Gabashvili,6-4; 1-6; 6-4,R32,121,1,3,48,73,35,48,11,25,1,4,13,46,73,9,4,56,90,40,56,17,34,6,9,14,57,90
2011-06-12 00:00:00.000,s-Hertogenbosch The Netherlands ATP World Tour 250,GRASS,2,Andreas Haider-Maurer,Blaz Kavcic,Andreas Haider-Maurer,6-4; 6-7(3); 6-4,R32,126,9,4,52,88,48,52,20,36,0,0,16,68,88,6,7,61,99,47,61,22,38,4,6,16,69,99
2011-06-12 00:00:00.000,s-Hertogenbosch The Netherlands ATP World Tour 250,GRASS,2,Ivan Dodig,Victor Hanescu,Ivan Dodig,6-4; 7-5,R32,98,10,1,62,85,44,62,13,23,7,7,11,57,85,2,2,40,66,30,40,14,26,3,5,11,44,66
2011-06-12 00:00:00.000,s-Hertogenbosch The Netherlands ATP World Tour 250,GRASS,2,Jarkko Nieminen,Maximo Gonzalez,Jarkko Nieminen,7-5; 6-1,R32,70,1,0,44,55,28,44,8,11,2,4,10,36,55,2,3,44,58,21,44,5,14,3,8,9,26,58
2011-06-12 00:00:00.000,s-Hertogenbosch The Netherlands ATP World Tour 250,GRASS,2,Denis Gremelmayr,Ludovic Walter,Denis Gremelmayr,6-3; 7-6(5),R32,72,8,1,39,63,34,39,16,24,2,2,11,50,63,11,2,37,54,33,37,10,17,0,1,10,43,54
2011-06-12 00:00:00.000,s-Hertogenbosch The Netherlands ATP World Tour 250,GRASS,2,Robin Haase,Mischa Zverev,Robin Haase,6-3; 6-4,R32,67,7,2,32,57,26,32,14,25,2,3,10,40,57,1,3,38,64,26,38,12,26,7,10,9,38,64
2011-06-12 00:00:00.000,s-Hertogenbosch The Netherlands ATP World Tour 250,GRASS,2,Marcos Baghdatis,Arnaud Clement,Marcos Baghdatis,7-6(4); 6-3,R32,95,7,1,43,73,36,43,12,30,4,6,11,48,73,3,4,35,67,28,35,13,32,5,8,10,41,67
2011-06-12 00:00:00.000,s-Hertogenbosch The Netherlands ATP World Tour 250,GRASS,2,Santiago Giraldo,Michael Berrer,Santiago Giraldo,7-6(6); 6-3,R16,103,1,0,60,79,41,60,11,19,6,8,11,52,79,2,2,40,72,28,40,15,32,7,10,10,43,72
2011-06-12 00:00:00.000,s-Hertogenbosch The Netherlands ATP World Tour 250,GRASS,2,Dmitry Tursunov,Nicolas Mahut,Dmitry Tursunov,7-6(2); 3-6; 6-3,R16,149,11,2,59,102,43,59,24,43,7,9,15,67,102,12,1,63,107,45,63,22,44,7,9,15,67,107
2011-06-12 00:00:00.000,s-Hertogenbosch The Netherlands ATP World Tour 250,GRASS,2,Xavier Malisse,Jesse Huta Galung,Xavier Malisse,7-6(2); 6-4,R16,97,7,1,41,72,33,41,16,31,7,8,11,49,72,11,5,42,80,32,42,16,38,5,7,11,48,80
2011-06-12 00:00:00.000,s-Hertogenbosch The Netherlands ATP World Tour 250,GRASS,2,Alex Bogomolov Jr.,Filippo Volandri,Alex Bogomolov Jr.,7-6(2); 6-2,R16,84,2,2,39,59,29,39,14,20,3,4,10,43,59,1,8,48,74,32,48,11,26,7,10,10,43,74
2011-06-12 00:00:00.000,s-Hertogenbosch The Netherlands ATP World Tour 250,GRASS,2,Teymuraz Gabashvili,Javier Marti,Teymuraz Gabashvili,7-6(6); 6-3,R16,102,1,1,39,62,29,39,12,23,0,3,11,41,62,4,3,45,78,26,45,17,33,6,10,10,43,78
2011-06-12 00:00:00.000,s-Hertogenbosch The Netherlands ATP World Tour 250,GRASS,2,Ivan Dodig,Andreas Haider-Maurer,Ivan Dodig,6-4; 6-3,R16,84,5,2,36,56,26,36,11,20,2,3,9,37,56,4,3,39,64,24,39,9,25,2,6,10,33,64
2011-06-12 00:00:00.000,s-Hertogenbosch The Netherlands ATP World Tour 250,GRASS,2,Denis Gremelmayr,Jarkko Nieminen,Denis Gremelmayr,7-6(3); 2-6; 7-6(5),R16,140,7,5,70,129,47,70,28,59,5,11,16,75,129,8,0,74,107,47,74,18,33,2,6,16,65,107
2011-06-12 00:00:00.000,s-Hertogenbosch The Netherlands ATP World Tour 250,GRASS,2,Marcos Baghdatis,Robin Haase,Marcos Baghdatis,7-5; 6-4,R16,80,5,4,38,67,33,38,15,29,3,3,11,48,67,10,3,43,66,33,43,11,23,0,2,11,44,66
2011-06-12 00:00:00.000,s-Hertogenbosch The Netherlands ATP World Tour 250,GRASS,2,Dmitry Tursunov,Santiago Giraldo,Dmitry Tursunov,6-3; 4-6; 6-4,Q,118,9,2,61,91,47,61,13,30,2,5,15,60,91,5,1,68,86,46,68,8,18,3,7,14,54,86
2011-06-12 00:00:00.000,s-Hertogenbosch The Netherlands ATP World Tour 250,GRASS,2,Xavier Malisse,Alex Bogomolov Jr.,Xavier Malisse,6-2; 6-4,Q,83,5,3,34,65,28,34,12,31,10,12,9,40,65,0,3,35,56,18,35,8,21,1,6,9,26,56
2011-06-12 00:00:00.000,s-Hertogenbosch The Netherlands ATP World Tour 250,GRASS,2,Ivan Dodig,Teymuraz Gabashvili,Ivan Dodig,2-6; 6-1; 6-2,Q,118,16,3,51,79,39,51,12,28,5,7,12,51,79,1,1,51,87,31,51,18,36,5,9,11,49,87
2011-06-12 00:00:00.000,s-Hertogenbosch The Netherlands ATP World Tour 250,GRASS,2,Marcos Baghdatis,Denis Gremelmayr,Marcos Baghdatis,6-1; 6-0,Q,47,4,2,21,35,19,21,7,14,2,2,6,26,35,4,0,33,45,14,33,2,12,8,14,7,16,45
2011-06-12 00:00:00.000,s-Hertogenbosch The Netherlands ATP World Tour 250,GRASS,2,Dmitry Tursunov,Xavier Malisse,Dmitry Tursunov,6-3; 7-6(1),S,104,2,8,37,63,25,37,9,26,0,3,10,34,63,5,2,41,74,30,41,17,33,3,5,11,47,74
2011-06-12 00:00:00.000,s-Hertogenbosch The Netherlands ATP World Tour 250,GRASS,2,Ivan Dodig,Marcos Baghdatis,Ivan Dodig,7-6(4); 6-1,S,89,4,2,43,67,30,43,15,24,2,3,9,45,67,1,4,40,62,26,40,10,22,0,4,10,36,62
2011-06-12 00:00:00.000,s-Hertogenbosch The Netherlands ATP World Tour 250,GRASS,2,Dmitry Tursunov,Ivan Dodig,Dmitry Tursunov,6-3; 6-2,F,76,2,3,41,60,31,41,10,19,3,3,9,41,60,7,1,33,51,20,33,8,18,4,7,8,28,51
2011-06-20 00:00:00.000,Wimbledon Great Britain Grand Slams,GRASS,3,Rafael Nadal,Michael Russell,Rafael Nadal,6-4; 6-2; 6-2,R128,118,4,2,47,70,36,47,13,23,1,3,13,49,70,2,2,56,82,28,56,13,26,3,10,13,41,82
2011-06-20 00:00:00.000,Wimbledon Great Britain Grand Slams,GRASS,3,Ryan Sweeting,Pablo Andujar,Ryan Sweeting,3-6; 4-6; 6-1; 7-6(1); 6-1,R128,224,3,8,81,142,56,81,31,61,10,16,23,87,142,1,8,101,169,62,101,29,68,10,18,22,91,169
2011-06-20 00:00:00.000,Wimbledon Great Britain Grand Slams,GRASS,3,Gilles Muller,Tommy Haas,Gilles Muller,7-6(5); 7-6(3); 3-6; 6-3,R128,162,37,2,100,131,78,100,19,31,5,7,21,97,131,16,3,94,135,66,94,31,41,5,7,21,97,135
2011-06-20 00:00:00.000,Wimbledon Great Britain Grand Slams,GRASS,3,Milos Raonic,Marc Gicquel,Milos Raonic,6-3; 7-6(3); 6-3,R128,96,25,0,57,87,49,57,21,30,1,1,16,70,87,5,2,55,86,39,55,18,31,1,3,14,57,86
2011-06-20 00:00:00.000,Wimbledon Great Britain Grand Slams,GRASS,3,Juan Martin Del Potro,Flavio Cipolla,Juan Martin Del Potro,6-1; 6-4; 6-3,R128,99,14,1,46,67,41,46,10,21,2,3,13,51,67,1,5,49,75,29,49,10,26,3,9,13,39,75
2011-06-20 00:00:00.000,Wimbledon Great Britain Grand Slams,GRASS,3,Olivier Rochus,Kenny De Schepper,Olivier Rochus,6-7(6); 3-6; 6-3; 6-1; 6-4,R128,189,4,7,87,153,65,87,38,66,4,6,24,103,153,35,14,91,147,77,91,19,56,9,14,23,96,147
2011-06-20 00:00:00.000,Wimbledon Great Britain Grand Slams,GRASS,3,Dudi Sela,Frederico Gil,Dudi Sela,6-4; 6-1; 6-4,R128,112,4,3,54,86,46,54,14,32,2,3,14,60,86,0,0,63,93,39,63,13,30,7,12,13,52,93
2011-06-20 00:00:00.000,Wimbledon Great Britain Grand Slams,GRASS,3,Gilles Simon,Edouard Roger-Vasselin,Gilles Simon,4-6; 6-4; 6-3; 7-6(3),R128,179,7,1,72,135,54,72,36,63,7,10,21,90,135,2,4,95,141,65,95,19,46,13,17,20,84,141
2011-06-20 00:00:00.000,Wimbledon Great Britain Grand Slams,GRASS,3,Mardy Fish,Marcel Granollers,Mardy Fish,7-6(3); 7-6(5); 6-4,R128,142,26,1,69,95,58,69,18,26,0,0,17,76,95,2,1,74,124,59,74,22,50,2,3,17,81,124
2011-06-20 00:00:00.000,Wimbledon Great Britain Grand Slams,GRASS,3,Denis Istomin,Philipp Kohlschreiber,Denis Istomin,4-6; 6-3; 6-3; 6-3,R128,145,18,3,70,107,61,70,18,37,3,4,19,79,107,7,4,71,121,50,71,26,50,3,7,18,76,121
2011-06-20 00:00:00.000,Wimbledon Great Britain Grand Slams,GRASS,3,Robin Haase,Pere Riba,Robin Haase,6-4; 6-4; 6-4,R128,90,25,1,63,86,52,63,12,23,4,5,15,64,86,9,9,65,101,49,65,10,36,5,9,15,59,101
2011-06-20 00:00:00.000,Wimbledon Great Britain Grand Slams,GRASS,3,Fernando Verdasco,Radek Stepanek,Fernando Verdasco,2-6; 4-6; 6-3; 7-6(6); 9-7,R128,236,12,8,125,190,95,125,27,65,12,17,28,122,190,6,4,111,159,87,111,23,48,1,5,27,110,159
2011-06-20 00:00:00.000,Wimbledon Great Britain Grand Slams,GRASS,3,Juan Ignacio Chela,Marinko Matosevic,Juan Ignacio Chela,6-4; 6-4; 6-7(6); 6-2,R128,163,3,2,66,121,45,66,34,55,6,11,20,79,121,7,3,97,147,59,97,19,50,10,19,20,78,147
2011-06-20 00:00:00.000,Wimbledon Great Britain Grand Slams,GRASS,3,Alex Bogomolov Jr.,Donald Young,Alex Bogomolov Jr.,7-5; 4-6; 6-3; 6-1,R128,170,7,5,93,117,66,93,12,24,6,9,19,78,117,10,8,86,142,54,86,23,56,11,18,19,77,142
2011-06-20 00:00:00.000,Wimbledon Great Britain Grand Slams,GRASS,3,Julien Benneteau,Ruben Bemelmans,Julien Benneteau,6-4; 6-2; 3-6; 4-6; 6-1,R128,160,22,4,88,124,72,88,18,36,4,6,22,90,124,7,5,85,136,64,85,25,51,8,13,22,89,136
2011-06-20 00:00:00.000,Wimbledon Great Britain Grand Slams,GRASS,3,Tomas Berdych,Filippo Volandri,Tomas Berdych,6-2; 6-2; 6-1,R128,94,12,1,33,62,29,33,19,29,0,0,12,48,62,1,8,47,84,27,47,15,37,8,14,11,42,84
2011-06-20 00:00:00.000,Wimbledon Great Britain Grand Slams,GRASS,3,Andy Murray,Daniel Gimeno-Traver,Andy Murray,4-6; 6-3; 6-0; 6-0,R128,128,13,1,59,84,53,59,12,25,2,3,16,65,84,2,2,54,101,30,54,21,47,8,15,15,51,101
2011-06-20 00:00:00.000,Wimbledon Great Britain Grand Slams,GRASS,3,Tobias Kamke,Blaz Kavcic,Tobias Kamke,6-3; 7-6(4); 5-7; 6-1,R128,172,5,7,93,153,67,93,26,60,8,13,21,93,153,2,12,66,118,43,66,21,52,5,12,19,64,118
2011-06-20 00:00:00.000,Wimbledon Great Britain Grand Slams,GRASS,3,Sergiy Stakhovsky,Daniel Cox,Sergiy Stakhovsky,6-2; 6-4; 6-4,R128,95,6,2,45,74,36,45,21,29,0,0,14,57,74,2,3,49,81,30,49,20,32,10,14,14,50,81
2011-06-20 00:00:00.000,Wimbledon Great Britain Grand Slams,GRASS,3,Ivan Ljubicic,Marin Cilic,Ivan Ljubicic,7-6(2); 3-6; 6-3; 6-4,R128,165,21,2,69,122,56,69,28,53,9,12,20,84,122,9,3,61,109,45,61,28,48,2,6,20,73,109
2011-06-20 00:00:00.000,Wimbledon Great Britain Grand Slams,GRASS,3,Richard Gasquet,Santiago Giraldo,Richard Gasquet,7-5; 6-3; 7-6(3),R128,123,13,3,73,108,48,73,19,35,8,12,17,67,108,9,1,72,100,41,72,14,28,6,12,16,55,100
2011-06-20 00:00:00.000,Wimbledon Great Britain Grand Slams,GRASS,3,Igor Kunitsyn,Igor Sijsling,Igor Kunitsyn,6-3; 6-4; 6-2,R128,98,4,1,55,88,47,55,15,33,3,3,14,62,88,16,3,47,75,37,47,9,28,5,9,13,46,75
2011-06-20 00:00:00.000,Wimbledon Great Britain Grand Slams,GRASS,3,Simone Bolelli,Martin Fischer,Simone Bolelli,7-5; 6-4; 6-4,R128,138,7,2,63,97,47,63,19,34,7,9,16,66,97,2,1,72,103,43,72,15,31,3,8,16,58,103
2011-06-20 00:00:00.000,Wimbledon Great Britain Grand Slams,GRASS,3,Stanislas Wawrinka,Potito Starace,Stanislas Wawrinka,6-3; 6-4; 6-4,R128,102,11,1,47,78,40,47,21,31,0,0,15,61,78,1,2,73,106,47,73,14,33,13,16,14,61,106
2011-06-20 00:00:00.000,Wimbledon Great Britain Grand Slams,GRASS,3,Gael Monfils,Matthias Bachinger,Gael Monfils,6-4; 7-6(3); 6-3,R128,110,14,5,71,99,55,71,12,28,3,6,16,67,99,5,4,65,98,42,65,14,33,6,11,15,56,98
2011-06-20 00:00:00.000,Wimbledon Great Britain Grand Slams,GRASS,3,Grega Zemlja,Lukas Lacko,Grega Zemlja,6-4; 3-6; 7-6(8); 6-4,R128,158,10,1,91,124,64,91,22,33,1,3,20,86,124,2,4,97,157,61,97,37,60,8,11,21,98,157
2011-06-20 00:00:00.000,Wimbledon Great Britain Grand Slams,GRASS,3,Lukasz Kubot,Arnaud Clement,Lukasz Kubot,6-4; 6-2; 3-6; 5-7; 6-4,R128,209,6,2,87,130,66,87,25,43,6,10,24,91,130,12,2,81,147,58,81,36,66,4,10,25,94,147
2011-06-20 00:00:00.000,Wimbledon Great Britain Grand Slams,GRASS,3,Ivo Karlovic,Janko Tipsarevic,Ivo Karlovic,7-5; 3-1 RET,R128,59,14,1,27,43,25,27,9,16,0,0,8,34,43,1,0,31,51,20,31,10,20,2,4,8,30,51
2011-06-20 00:00:00.000,Wimbledon Great Britain Grand Slams,GRASS,3,Rainer Schuettler,Thomaz Bellucci,Rainer Schuettler,7-6(3); 6-4; 6-2,R128,131,2,1,62,95,44,62,21,33,4,6,15,65,95,9,1,63,106,40,63,19,43,5,10,15,59,106
2011-06-20 00:00:00.000,Wimbledon Great Britain Grand Slams,GRASS,3,Feliciano Lopez,Michael Berrer,Feliciano Lopez,6-4; 7-5; 6-3,R128,108,16,2,44,75,39,44,23,31,0,0,15,62,75,7,3,65,100,48,65,14,35,5,9,16,62,100
2011-06-20 00:00:00.000,Wimbledon Great Britain Grand Slams,GRASS,3,Victor Hanescu,Jaroslav Pospisil,Victor Hanescu,6-4; 6-3; 6-2,R128,106,18,0,49,71,42,49,8,22,2,4,13,50,71,4,8,42,80,28,42,14,38,4,11,14,42,80
2011-06-20 00:00:00.000,Wimbledon Great Britain Grand Slams,GRASS,3,Andy Roddick,Andreas Beck,Andy Roddick,6-4; 7-6(6); 6-3,R128,135,30,1,65,90,55,65,11,25,1,1,15,66,90,2,1,74,110,46,74,20,36,4,7,16,66,110
2011-06-20 00:00:00.000,Wimbledon Great Britain Grand Slams,GRASS,3,David Ferrer,Benoit Paire,David Ferrer,6-4; 6-4; 6-4,R128,115,3,4,53,86,44,53,16,33,4,6,15,60,86,6,7,53,101,38,53,17,48,3,8,15,55,101
2011-06-20 00:00:00.000,Wimbledon Great Britain Grand Slams,GRASS,3,Ryan Harrison,Ivan Dodig,Ryan Harrison,7-6(5); 6-0; 7-5,R128,134,7,4,57,86,47,57,17,29,3,4,15,64,86,8,4,66,105,46,66,15,39,4,9,15,61,105
2011-06-20 00:00:00.000,Wimbledon Great Britain Grand Slams,GRASS,3,Karol Beck,Carlos Berlocq,Karol Beck,4-6; 7-6(6); 4-6; 6-2; 6-4,R128,243,14,6,101,170,79,101,35,69,11,15,25,114,170,12,3,109,164,78,109,26,55,9,14,25,104,164
2011-06-20 00:00:00.000,Wimbledon Great Britain Grand Slams,GRASS,3,Guillermo Garcia-Lopez,Andrey Golubev,Guillermo Garcia-Lopez,6-3; 6-3 RET,R128,71,3,2,35,50,25,35,6,15,0,2,9,31,50,1,0,34,54,21,34,5,20,3,8,9,26,54
2011-06-20 00:00:00.000,Wimbledon Great Britain Grand Slams,GRASS,3,Fernando Gonzalez,Alexandr Dolgopolov,Fernando Gonzalez,6-3; 6-7(6); 7-6(3); 6-4,R128,138,25,1,82,126,66,82,30,44,2,3,22,96,126,18,7,81,136,67,81,24,55,5,8,21,91,136
2011-06-20 00:00:00.000,Wimbledon Great Britain Grand Slams,GRASS,3,Rik De Voest,Ruben Ramirez Hidalgo,Rik De Voest,6-2; 6-3; 6-2,R128,127,10,0,69,106,48,69,23,37,9,9,13,71,106,4,7,53,101,27,53,25,48,11,16,12,52,101
2011-06-20 00:00:00.000,Wimbledon Great Britain Grand Slams,GRASS,3,Grigor Dimitrov,Cedrik-Marcel Stebe,Grigor Dimitrov,7-5; 7-5; 7-6(5),R128,160,3,3,87,121,59,87,20,34,6,9,18,79,121,3,3,79,117,51,79,18,38,5,10,18,69,117
2011-06-20 00:00:00.000,Wimbledon Great Britain Grand Slams,GRASS,3,Jo-Wilfried Tsonga,Go Soeda,Jo-Wilfried Tsonga,6-3; 7-6(4); 6-2,R128,132,18,5,63,99,50,63,19,36,12,13,15,69,99,4,6,59,110,41,59,22,51,6,10,14,63,110
2011-06-20 00:00:00.000,Wimbledon Great Britain Grand Slams,GRASS,3,Nicolas Almagro,Jarkko Nieminen,Nicolas Almagro,6-7(5); 6-3; 6-4; 6-4,R128,143,18,1,75,119,60,75,28,44,2,3,21,88,119,7,7,83,124,59,83,25,41,6,10,20,84,124
2011-06-20 00:00:00.000,Wimbledon Great Britain Grand Slams,GRASS,3,John Isner,Nicolas Mahut,John Isner,7-6(4); 6-2; 7-6(6),R128,123,8,2,66,97,52,66,20,31,1,2,16,72,97,8,6,68,104,48,68,21,36,2,5,16,69,104
2011-06-20 00:00:00.000,Wimbledon Great Britain Grand Slams,GRASS,3,Somdev Devvarman,Denis Gremelmayr,Somdev Devvarman,6-4; 4-2 RET,R128,65,9,0,34,54,25,34,13,20,4,4,8,38,54,2,1,33,53,20,33,13,20,6,8,8,33,53
2011-06-20 00:00:00.000,Wimbledon Great Britain Grand Slams,GRASS,3,Mikhail Youzhny,Juan Monaco,Mikhail Youzhny,4-6; 6-2; 6-2; 4-6; 6-4,R128,193,4,2,88,135,63,88,26,47,2,6,23,89,135,6,2,103,136,61,103,21,33,9,16,23,82,136
2011-06-20 00:00:00.000,Wimbledon Great Britain Grand Slams,GRASS,3,David Nalbandian,Julian Reister,David Nalbandian,7-5; 6-2; 6-3,R128,106,9,3,55,81,42,55,17,26,2,4,15,59,81,7,8,66,103,43,66,12,37,4,10,14,55,103
2011-06-20 00:00:00.000,Wimbledon Great Britain Grand Slams,GRASS,3,Andreas Haider-Maurer,Florent Serra,Andreas Haider-Maurer,7-6(5); 6-3; 6-3,R128,111,39,7,72,107,64,72,13,35,3,3,15,77,107,8,7,60,99,43,60,20,39,5,8,15,63,99
2011-06-20 00:00:00.000,Wimbledon Great Britain Grand Slams,GRASS,3,Adrian Mannarino,Conor Niland,Adrian Mannarino,4-6; 6-4; 7-6(7); 4-6; 6-4,R128,240,4,5,116,184,77,116,35,68,12,19,26,112,184,10,8,122,184,79,122,31,62,13,20,26,110,184
2011-06-20 00:00:00.000,Wimbledon Great Britain Grand Slams,GRASS,3,Roger Federer,Mikhail Kukushkin,Roger Federer,7-6(2); 6-4; 6-2,R128,102,12,1,57,80,51,57,17,23,3,3,15,68,80,4,1,61,93,41,61,18,32,4,7,15,59,93
2011-06-20 00:00:00.000,Wimbledon Great Britain Grand Slams,GRASS,3,Robin Soderling,Philipp Petzschner,Robin Soderling,6-4; 6-4; 2-6; 7-6(5),R128,194,8,6,97,169,69,97,31,72,16,21,20,100,169,6,3,85,128,61,85,20,43,6,11,20,81,128
2011-06-20 00:00:00.000,Wimbledon Great Britain Grand Slams,GRASS,3,Lleyton Hewitt,Kei Nishikori,Lleyton Hewitt,6-1; 7-6(4); 6-7(7); 6-3,R128,187,5,7,88,140,64,88,28,52,5,7,20,92,140,2,6,76,132,50,76,29,56,4,10,20,79,132
2011-06-20 00:00:00.000,Wimbledon Great Britain Grand Slams,GRASS,3,Igor Andreev,Teymuraz Gabashvili,Igor Andreev,6-4; 7-6(5); 6-7(4); 4-6; 6-3,R128,218,19,6,110,167,88,110,29,57,5,8,27,117,167,10,5,103,163,75,103,36,60,10,14,26,111,163
2011-06-20 00:00:00.000,Wimbledon Great Britain Grand Slams,GRASS,3,Bernard Tomic,Nikolay Davydenko,Bernard Tomic,7-5; 6-3; 7-5,R128,112,6,1,73,92,57,73,13,19,2,3,17,70,92,4,6,72,107,47,72,16,35,11,15,16,63,107
2011-06-20 00:00:00.000,Wimbledon Great Britain Grand Slams,GRASS,3,Florian Mayer,Daniel Evans,Florian Mayer,7-6(5); 7-6(1); 3-6; 6-4,R128,173,12,2,92,128,66,92,19,36,2,7,21,85,128,11,14,92,149,64,92,26,57,9,14,22,90,149
2011-06-20 00:00:00.000,Wimbledon Great Britain Grand Slams,GRASS,3,Xavier Malisse,Mischa Zverev,Xavier Malisse,6-2; 6-3; 6-2,R128,87,7,3,56,82,42,56,14,26,5,6,13,56,82,5,1,54,76,27,54,11,22,4,10,12,38,76
2011-06-20 00:00:00.000,Wimbledon Great Britain Grand Slams,GRASS,3,Dmitry Tursunov,Ernests Gulbis,Dmitry Tursunov,6-3; 3-6; 7-6(12); 7-6(1),R128,167,10,6,87,137,65,87,35,50,7,9,21,100,137,24,5,105,138,81,105,17,33,5,7,21,98,138
2011-06-20 00:00:00.000,Wimbledon Great Britain Grand Slams,GRASS,3,Jurgen Melzer,Alejandro Falla,Jurgen Melzer,3-6; 7-6(5); 6-2; 6-2,R128,159,8,3,88,137,65,88,26,49,4,5,18,91,137,5,2,89,128,61,89,22,39,13,17,19,83,128
2011-06-20 00:00:00.000,Wimbledon Great Britain Grand Slams,GRASS,3,Viktor Troicki,Maximo Gonzalez,Viktor Troicki,3-6; 6-0; 7-6(3); 6-3,R128,133,28,7,78,120,58,78,24,42,6,8,19,82,120,0,4,68,102,47,68,16,34,5,9,17,63,102
2011-06-20 00:00:00.000,Wimbledon Great Britain Grand Slams,GRASS,3,Yen-Hsun Lu,Tommy Robredo,Yen-Hsun Lu,6-4; 6-4; 6-1,R128,97,6,2,44,70,36,44,17,26,1,1,13,53,70,2,2,44,77,28,44,18,33,1,6,14,46,77
2011-06-20 00:00:00.000,Wimbledon Great Britain Grand Slams,GRASS,3,Ricardo Mello,Frank Dancevic,Ricardo Mello,3-6; 3-6; 6-4; 7-6(6); 6-2,R128,168,2,4,103,156,67,103,33,53,8,13,24,100,156,23,7,86,145,62,86,34,59,7,12,24,96,145
2011-06-20 00:00:00.000,Wimbledon Great Britain Grand Slams,GRASS,3,Michael Llodra,James Ward,Michael Llodra,6-3; 7-6(4); 6-3,R128,117,10,4,77,105,64,77,12,28,5,5,16,76,105,6,10,50,98,41,50,21,48,3,5,14,62,98
2011-06-20 00:00:00.000,Wimbledon Great Britain Grand Slams,GRASS,3,Marcos Baghdatis,James Blake,Marcos Baghdatis,6-4; 6-2; 6-7(5); 4-6; 6-4,R128,168,17,3,90,143,69,90,31,53,3,6,25,100,143,6,5,117,170,80,117,24,53,5,11,25,104,170
2011-06-20 00:00:00.000,Wimbledon Great Britain Grand Slams,GRASS,3,Andreas Seppi,Albert Montanes,Andreas Seppi,6-4; 6-4; 7-5,R128,107,12,3,65,98,49,65,18,33,4,6,16,67,98,9,7,59,104,43,59,20,45,4,9,16,63,104
2011-06-20 00:00:00.000,Wimbledon Great Britain Grand Slams,GRASS,3,Kevin Anderson,Illya Marchenko,Kevin Anderson,6-7(5); 7-6(7); 6-4; 4-6; 6-1,R128,232,18,4,111,150,85,111,26,39,6,8,26,111,150,6,7,100,167,74,100,36,67,6,10,25,110,167
2011-06-20 00:00:00.000,Wimbledon Great Britain Grand Slams,GRASS,3,Novak Djokovic,Jeremy Chardy,Novak Djokovic,6-4; 6-1; 6-1,R128,80,9,1,45,61,38,45,12,16,1,1,12,50,61,9,2,44,75,30,44,8,31,4,10,12,38,75
2011-06-20 00:00:00.000,Wimbledon Great Britain Grand Slams,GRASS,3,Rafael Nadal,Ryan Sweeting,Rafael Nadal,6-3; 6-2; 6-4,R64,127,9,0,54,77,42,54,15,23,1,2,14,57,77,4,10,61,102,40,61,15,41,9,14,13,55,102
2011-06-20 00:00:00.000,Wimbledon Great Britain Grand Slams,GRASS,3,Gilles Muller,Milos Raonic,Gilles Muller,2-3 RET,R64,24,5,0,13,15,10,13,0,2,2,3,3,10,15,5,0,11,14,6,11,3,3,1,1,2,9,14
2011-06-20 00:00:00.000,Wimbledon Great Britain Grand Slams,GRASS,3,Juan Martin Del Potro,Olivier Rochus,Juan Martin Del Potro,6-7(7); 6-1; 6-0; 6-4,R64,158,30,3,67,96,60,67,20,29,2,2,18,80,96,1,7,81,137,53,81,23,56,10,16,17,76,137
2011-06-20 00:00:00.000,Wimbledon Great Britain Grand Slams,GRASS,3,Gilles Simon,Dudi Sela,Gilles Simon,7-6(3); 6-4; 7-5,R64,124,3,1,54,98,44,54,22,44,3,6,17,66,98,3,0,76,111,47,76,19,35,9,14,17,66,111
2011-06-20 00:00:00.000,Wimbledon Great Britain Grand Slams,GRASS,3,Mardy Fish,Denis Istomin,Mardy Fish,7-6(6); 6-4; 6-4,R64,136,13,2,61,100,50,61,23,39,4,5,16,73,100,13,3,76,106,56,76,12,30,3,6,16,68,106
2011-06-20 00:00:00.000,Wimbledon Great Britain Grand Slams,GRASS,3,Robin Haase,Fernando Verdasco,Robin Haase,6-3; 6-4; 4-6; 6-2,R64,152,12,3,67,115,53,67,24,48,4,6,19,77,115,12,11,93,149,61,93,23,56,16,21,18,84,149
2011-06-20 00:00:00.000,Wimbledon Great Britain Grand Slams,GRASS,3,Alex Bogomolov Jr.,Juan Ignacio Chela,Alex Bogomolov Jr.,6-0; 6-3; 6-4,R64,92,5,3,55,74,43,55,11,19,1,1,13,54,74,2,3,68,90,38,68,9,22,9,14,12,47,90
2011-06-20 00:00:00.000,Wimbledon Great Britain Grand Slams,GRASS,3,Tomas Berdych,Julien Benneteau,Tomas Berdych,6-1; 6-4; 6-2,R64,97,10,1,38,65,34,38,16,27,0,1,13,50,65,7,4,52,74,32,52,4,22,2,8,12,36,74
2011-06-20 00:00:00.000,Wimbledon Great Britain Grand Slams,GRASS,3,Andy Murray,Tobias Kamke,Andy Murray,6-3; 6-3; 7-5,R64,117,6,3,45,84,38,45,24,39,1,1,15,62,84,0,5,49,86,34,49,20,37,4,8,15,54,86
2011-06-20 00:00:00.000,Wimbledon Great Britain Grand Slams,GRASS,3,Ivan Ljubicic,Sergiy Stakhovsky,Ivan Ljubicic,6-4; 6-4; 6-2,R64,114,10,1,54,83,42,54,14,29,5,6,14,56,83,7,1,61,86,40,61,10,25,4,9,14,50,86
2011-06-20 00:00:00.000,Wimbledon Great Britain Grand Slams,GRASS,3,Richard Gasquet,Igor Kunitsyn,Richard Gasquet,6-1; 6-4; 6-4,R64,98,10,1,48,78,38,48,17,30,0,2,14,55,78,4,1,44,76,28,44,13,32,2,8,13,41,76
2011-06-20 00:00:00.000,Wimbledon Great Britain Grand Slams,GRASS,3,Simone Bolelli,Stanislas Wawrinka,Simone Bolelli,7-6(5); 6-3; 7-6(4),R64,153,4,0,86,129,58,86,24,43,12,15,17,82,129,13,2,58,97,46,58,18,39,4,8,16,64,97
2011-06-20 00:00:00.000,Wimbledon Great Britain Grand Slams,GRASS,3,Gael Monfils,Grega Zemlja,Gael Monfils,4-6; 6-3; 6-3; 7-6(7),R64,134,15,2,84,121,63,84,22,37,6,9,20,85,121,4,1,88,125,61,88,19,37,5,10,20,80,125
2011-06-20 00:00:00.000,Wimbledon Great Britain Grand Slams,GRASS,3,Lukasz Kubot,Ivo Karlovic,Lukasz Kubot,7-6(2); 6-3; 6-3,R64,123,5,3,65,94,55,65,18,29,4,4,15,73,94,19,2,62,86,46,62,11,24,5,8,15,57,86
2011-06-20 00:00:00.000,Wimbledon Great Britain Grand Slams,GRASS,3,Feliciano Lopez,Rainer Schuettler,Feliciano Lopez,7-6(3); 6-7(3); 6-2; 6-2,R64,172,28,6,80,123,68,80,23,43,7,8,20,91,123,8,6,86,155,58,86,34,69,9,14,20,92,155
2011-06-20 00:00:00.000,Wimbledon Great Britain Grand Slams,GRASS,3,Andy Roddick,Victor Hanescu,Andy Roddick,6-4; 6-3; 6-4,R64,112,15,0,43,66,40,43,17,23,1,1,14,57,66,8,2,65,95,43,65,15,30,6,10,15,58,95
2011-06-20 00:00:00.000,Wimbledon Great Britain Grand Slams,GRASS,3,David Ferrer,Ryan Harrison,David Ferrer,6-7(6); 6-1; 4-6; 6-3; 6-2,R64,210,7,3,89,126,71,89,18,37,0,3,23,89,126,10,8,99,166,67,99,28,67,17,25,23,95,166
2011-06-20 00:00:00.000,Wimbledon Great Britain Grand Slams,GRASS,3,Karol Beck,Guillermo Garcia-Lopez,Karol Beck,7-6(5); 6-4; 3-6; 6-4,R64,183,9,7,80,129,59,80,25,49,8,12,20,84,129,1,2,80,125,56,80,23,45,3,8,21,79,125
2011-06-20 00:00:00.000,Wimbledon Great Britain Grand Slams,GRASS,3,Fernando Gonzalez,Rik De Voest,Fernando Gonzalez,6-4; 6-4; 6-4,R64,105,6,1,44,80,35,44,25,36,3,4,15,60,80,7,2,70,102,44,70,16,32,4,8,15,60,102
2011-06-20 00:00:00.000,Wimbledon Great Britain Grand Slams,GRASS,3,Jo-Wilfried Tsonga,Grigor Dimitrov,Jo-Wilfried Tsonga,6-7(4); 6-4; 6-4; 7-6(8),R64,213,19,8,103,166,75,103,32,63,14,16,22,107,166,3,5,118,170,78,118,25,52,8,12,22,103,170
2011-06-20 00:00:00.000,Wimbledon Great Britain Grand Slams,GRASS,3,Nicolas Almagro,John Isner,Nicolas Almagro,7-6(3); 7-6(5); 6-7(5); 6-3,R64,159,25,2,90,140,80,90,30,50,0,0,23,110,140,28,2,103,142,86,103,19,39,3,4,22,105,142
2011-06-20 00:00:00.000,Wimbledon Great Britain Grand Slams,GRASS,3,Mikhail Youzhny,Somdev Devvarman,Mikhail Youzhny,6-2; 6-4; 6-4,R64,117,4,1,60,90,46,60,17,30,6,6,14,63,90,3,0,59,85,39,59,10,26,4,8,14,49,85
2011-06-20 00:00:00.000,Wimbledon Great Britain Grand Slams,GRASS,3,David Nalbandian,Andreas Haider-Maurer,David Nalbandian,6-3; 3-6; 6-4; 6-4,R64,157,7,9,62,116,47,62,32,54,6,8,19,79,116,13,7,72,129,55,72,26,57,14,18,19,81,129
2011-06-20 00:00:00.000,Wimbledon Great Britain Grand Slams,GRASS,3,Roger Federer,Adrian Mannarino,Roger Federer,6-2; 6-3; 6-2,R64,88,11,0,41,64,35,41,18,23,3,3,13,53,64,0,1,44,75,24,44,15,31,5,10,12,39,75
2011-06-20 00:00:00.000,Wimbledon Great Britain Grand Slams,GRASS,3,Robin Soderling,Lleyton Hewitt,Robin Soderling,6-7(5); 3-6; 7-5; 6-4; 6-4,R64,234,28,5,101,154,82,101,24,53,5,7,26,106,154,15,1,85,166,62,85,50,81,2,6,27,112,166
2011-06-20 00:00:00.000,Wimbledon Great Britain Grand Slams,GRASS,3,Bernard Tomic,Igor Andreev,Bernard Tomic,4-6; 5-7; 6-3; 6-4; 6-1,R64,164,10,1,106,146,74,106,23,40,7,10,24,97,146,11,8,80,141,56,80,30,61,2,8,24,86,141
2011-06-20 00:00:00.000,Wimbledon Great Britain Grand Slams,GRASS,3,Xavier Malisse,Florian Mayer,Xavier Malisse,1-6; 6-3; 6-2; 6-2,R64,95,7,0,49,88,40,49,20,39,3,5,16,60,88,8,5,49,89,38,49,16,40,2,7,16,54,89
2011-06-20 00:00:00.000,Wimbledon Great Britain Grand Slams,GRASS,3,Jurgen Melzer,Dmitry Tursunov,Jurgen Melzer,6-3; 2-6; 7-6(5); 7-6(1),R64,188,9,3,85,140,58,85,30,55,6,11,20,88,140,12,9,99,152,66,99,23,53,9,14,21,89,152
2011-06-20 00:00:00.000,Wimbledon Great Britain Grand Slams,GRASS,3,Yen-Hsun Lu,Viktor Troicki,Yen-Hsun Lu,7-6(5); 6-4; 6-4,R64,134,3,3,63,96,49,63,19,33,5,6,16,68,96,17,8,56,107,47,56,21,51,3,6,16,68,107
2011-06-20 00:00:00.000,Wimbledon Great Britain Grand Slams,GRASS,3,Michael Llodra,Ricardo Mello,Michael Llodra,6-2; 4-6; 6-2; 6-3,R64,133,23,1,69,103,57,69,20,34,3,4,18,77,103,4,2,91,132,56,91,17,41,10,15,17,73,132
2011-06-20 00:00:00.000,Wimbledon Great Britain Grand Slams,GRASS,3,Marcos Baghdatis,Andreas Seppi,Marcos Baghdatis,6-4; 7-6(4); 7-5,R64,147,14,3,57,114,46,57,31,57,7,10,17,77,114,9,2,70,109,48,70,20,39,6,11,17,68,109
2011-06-20 00:00:00.000,Wimbledon Great Britain Grand Slams,GRASS,3,Novak Djokovic,Kevin Anderson,Novak Djokovic,6-3; 6-4; 6-2,R64,114,7,4,64,87,48,64,12,23,5,6,14,60,87,8,3,50,72,30,50,9,22,4,9,13,39,72
2011-06-20 00:00:00.000,Wimbledon Great Britain Grand Slams,GRASS,3,Rafael Nadal,Gilles Muller,Rafael Nadal,7-6(6); 7-6(5); 6-0,R32,144,7,1,66,93,55,66,18,27,2,2,15,73,93,17,6,70,96,57,70,11,26,3,6,15,68,96
2011-06-20 00:00:00.000,Wimbledon Great Britain Grand Slams,GRASS,3,Juan Martin Del Potro,Gilles Simon,Juan Martin Del Potro,7-6(8); 7-6(5); 7-5,R32,166,12,0,72,112,58,72,25,40,5,6,18,83,112,11,0,87,127,60,87,21,40,5,7,18,81,127
2011-06-20 00:00:00.000,Wimbledon Great Britain Grand Slams,GRASS,3,Mardy Fish,Robin Haase,Mardy Fish,6-3; 6-7(5); 6-2; 1-1 RET,R32,154,11,3,58,99,48,58,25,41,3,3,16,73,99,10,7,107,155,66,107,23,48,17,20,15,89,155
2011-06-20 00:00:00.000,Wimbledon Great Britain Grand Slams,GRASS,3,Tomas Berdych,Alex Bogomolov Jr.,Tomas Berdych,6-2; 6-4; 6-3,R32,103,16,1,36,69,32,36,23,33,0,0,13,55,69,2,4,59,84,37,59,10,25,4,9,14,47,84
2011-06-20 00:00:00.000,Wimbledon Great Britain Grand Slams,GRASS,3,Andy Murray,Ivan Ljubicic,Andy Murray,6-4; 4-6; 6-1; 7-6(4),R32,176,15,7,73,120,57,73,21,47,3,6,20,78,120,9,4,83,122,58,83,15,39,7,12,19,73,122
2011-06-20 00:00:00.000,Wimbledon Great Britain Grand Slams,GRASS,3,Richard Gasquet,Simone Bolelli,Richard Gasquet,6-3; 6-2; 6-4,R32,105,12,1,60,84,46,60,14,24,3,4,14,60,84,0,0,47,78,26,47,17,31,4,9,13,43,78
2011-06-20 00:00:00.000,Wimbledon Great Britain Grand Slams,GRASS,3,Lukasz Kubot,Gael Monfils,Lukasz Kubot,6-3; 3-6; 6-3; 6-3,R32,136,4,6,73,123,48,73,27,50,6,9,18,75,123,17,6,64,101,50,64,13,37,3,9,18,63,101
2011-06-20 00:00:00.000,Wimbledon Great Britain Grand Slams,GRASS,3,Feliciano Lopez,Andy Roddick,Feliciano Lopez,7-6(2); 7-6(2); 6-4,R32,138,28,3,70,106,57,70,20,36,3,4,17,77,106,23,6,69,109,54,69,20,40,4,6,17,74,109
2011-06-20 00:00:00.000,Wimbledon Great Britain Grand Slams,GRASS,3,David Ferrer,Karol Beck,David Ferrer,6-4; 6-3; 6-3,R32,123,3,1,60,86,43,60,17,26,5,6,14,60,86,4,3,53,98,35,53,19,45,6,11,14,54,98
2011-06-20 00:00:00.000,Wimbledon Great Britain Grand Slams,GRASS,3,Jo-Wilfried Tsonga,Fernando Gonzalez,Jo-Wilfried Tsonga,6-3; 6-4; 6-3,R32,84,29,3,56,72,50,56,9,16,3,3,14,59,72,3,0,46,76,35,46,14,30,4,8,14,49,76
2011-06-20 00:00:00.000,Wimbledon Great Britain Grand Slams,GRASS,3,Mikhail Youzhny,Nicolas Almagro,Mikhail Youzhny,4-6; 6-3; 7-6(3); 6-3,R32,163,18,3,92,128,78,92,18,36,10,11,21,96,128,8,4,68,122,55,68,26,54,5,7,19,81,122
2011-06-20 00:00:00.000,Wimbledon Great Britain Grand Slams,GRASS,3,Roger Federer,David Nalbandian,Roger Federer,6-4; 6-2; 6-4,R32,106,14,0,63,89,49,63,14,26,2,3,14,63,89,5,3,52,85,34,52,16,33,2,7,14,50,85
2011-06-20 00:00:00.000,Wimbledon Great Britain Grand Slams,GRASS,3,Bernard Tomic,Robin Soderling,Bernard Tomic,6-1; 6-4; 7-5,R32,112,13,1,69,100,53,69,18,31,5,5,15,71,100,10,0,48,78,36,48,11,30,3,7,14,47,78
2011-06-20 00:00:00.000,Wimbledon Great Britain Grand Slams,GRASS,3,Xavier Malisse,Jurgen Melzer,Xavier Malisse,7-6(5); 6-3; 6-0,R32,96,19,0,51,78,42,51,14,27,5,6,13,56,78,7,1,57,87,35,57,13,30,1,7,14,48,87
2011-06-20 00:00:00.000,Wimbledon Great Britain Grand Slams,GRASS,3,Michael Llodra,Yen-Hsun Lu,Michael Llodra,6-3; 6-3; 6-1,R32,103,19,3,52,74,43,52,12,22,3,3,13,55,74,3,4,51,86,32,51,13,35,7,12,12,45,86
2011-06-20 00:00:00.000,Wimbledon Great Britain Grand Slams,GRASS,3,Novak Djokovic,Marcos Baghdatis,Novak Djokovic,6-4; 4-6; 6-3; 6-4,R32,195,10,4,80,122,60,80,24,42,4,5,20,84,122,14,4,70,132,51,70,33,62,8,11,19,84,132
2011-06-20 00:00:00.000,Wimbledon Great Britain Grand Slams,GRASS,3,Rafael Nadal,Juan Martin Del Potro,Rafael Nadal,7-6(6); 3-6; 7-6(4); 6-4,R16,232,13,1,94,129,74,94,19,35,2,3,21,93,129,11,4,100,142,76,100,21,42,4,5,22,97,142
2011-06-20 00:00:00.000,Wimbledon Great Britain Grand Slams,GRASS,3,Mardy Fish,Tomas Berdych,Mardy Fish,7-6(5); 6-4; 6-4,R16,142,23,2,58,93,53,58,18,35,2,2,16,71,93,7,3,62,110,46,62,27,48,5,7,16,73,110
2011-06-20 00:00:00.000,Wimbledon Great Britain Grand Slams,GRASS,3,Andy Murray,Richard Gasquet,Andy Murray,7-6(3); 6-3; 6-2,R16,124,14,2,56,93,45,56,22,37,2,2,15,67,93,2,2,62,84,43,62,11,22,2,5,14,54,84
2011-06-20 00:00:00.000,Wimbledon Great Britain Grand Slams,GRASS,3,Feliciano Lopez,Lukasz Kubot,Feliciano Lopez,3-6; 6-7(5); 7-6(7); 7-5; 7-5,R16,258,28,6,94,177,75,94,41,83,5,8,28,116,177,27,8,127,184,95,127,24,57,6,10,29,119,184
2011-06-20 00:00:00.000,Wimbledon Great Britain Grand Slams,GRASS,3,Jo-Wilfried Tsonga,David Ferrer,Jo-Wilfried Tsonga,6-3; 6-4; 7-6(1),R16,123,12,2,54,82,50,54,15,28,2,2,15,65,82,7,5,61,101,42,61,24,40,6,9,16,66,101
2011-06-20 00:00:00.000,Wimbledon Great Britain Grand Slams,GRASS,3,Roger Federer,Mikhail Youzhny,Roger Federer,6-7(5); 6-3; 6-3; 6-3,R16,182,14,1,71,114,60,71,22,43,6,7,19,82,114,6,6,89,140,58,89,22,51,8,14,20,80,140
2011-06-20 00:00:00.000,Wimbledon Great Britain Grand Slams,GRASS,3,Bernard Tomic,Xavier Malisse,Bernard Tomic,6-1; 7-5; 6-4,R16,81,10,0,61,83,44,61,20,22,2,2,15,64,83,13,6,47,81,34,47,16,34,7,11,14,50,81
2011-06-20 00:00:00.000,Wimbledon Great Britain Grand Slams,GRASS,3,Novak Djokovic,Michael Llodra,Novak Djokovic,6-3; 6-3; 6-3,R16,101,9,1,50,72,42,50,16,22,0,0,14,58,72,8,7,44,82,32,44,16,38,7,11,13,48,82
2011-06-20 00:00:00.000,Wimbledon Great Britain Grand Slams,GRASS,3,Rafael Nadal,Mardy Fish,Rafael Nadal,6-3; 6-3; 5-7; 6-4,Q,173,5,1,71,105,55,71,20,34,4,7,20,75,105,12,0,65,123,49,65,23,58,6,12,20,72,123
2011-06-20 00:00:00.000,Wimbledon Great Britain Grand Slams,GRASS,3,Andy Murray,Feliciano Lopez,Andy Murray,6-3; 6-4; 6-4,Q,121,13,3,47,84,40,47,24,37,2,2,15,64,84,7,5,63,98,48,63,11,35,7,10,14,59,98
2011-06-20 00:00:00.000,Wimbledon Great Britain Grand Slams,GRASS,3,Jo-Wilfried Tsonga,Roger Federer,Jo-Wilfried Tsonga,3-6; 6-7(3); 6-4; 6-4; 6-4,Q,188,18,4,102,145,74,102,29,43,0,1,25,103,145,17,1,103,137,80,103,24,34,6,9,26,104,137
2011-06-20 00:00:00.000,Wimbledon Great Britain Grand Slams,GRASS,3,Novak Djokovic,Bernard Tomic,Novak Djokovic,6-2; 3-6; 6-3; 7-5,Q,161,14,4,69,109,54,69,18,40,2,5,19,72,109,7,2,94,144,59,94,24,50,9,15,19,83,144
2011-06-20 00:00:00.000,Wimbledon Great Britain Grand Slams,GRASS,3,Rafael Nadal,Andy Murray,Rafael Nadal,5-7; 6-2; 6-2; 6-4,S,179,6,1,70,103,57,70,19,33,3,4,19,76,103,15,5,66,113,48,66,23,47,3,8,19,71,113
2011-06-20 00:00:00.000,Wimbledon Great Britain Grand Slams,GRASS,3,Novak Djokovic,Jo-Wilfried Tsonga,Novak Djokovic,7-6(4); 6-2; 6-7(9); 6-3,S,187,5,1,79,120,61,79,28,41,2,5,21,89,120,12,5,90,133,61,90,20,43,6,12,20,81,133
2011-06-20 00:00:00.000,Wimbledon Great Britain Grand Slams,GRASS,3,Novak Djokovic,Rafael Nadal,Novak Djokovic,6-4; 6-1; 1-6; 6-3,F,148,7,1,69,95,50,69,14,26,3,6,17,64,95,5,1,64,82,43,64,8,18,1,6,16,51,82
2011-07-04 00:00:00.000,Newport RI; U.S.A. ATP World Tour 250,GRASS,2,John Isner,Karol Beck,John Isner,6-3; 6-2,R32,64,10,2,33,51,26,33,13,18,2,2,9,39,51,2,10,21,51,13,21,14,30,3,6,8,27,51
2011-07-04 00:00:00.000,Newport RI; U.S.A. ATP World Tour 250,GRASS,2,Arnaud Clement,Ryan Harrison,Arnaud Clement,6-4; 6-1,R32,75,1,0,32,58,23,32,16,26,0,0,9,39,58,6,6,27,51,17,27,11,24,5,8,8,28,51
2011-07-04 00:00:00.000,Newport RI; U.S.A. ATP World Tour 250,GRASS,2,Ruben Bemelmans,Denis Gremelmayr,Ruben Bemelmans,6-4; 6-2,R32,66,2,6,28,61,22,28,17,33,5,6,9,39,61,2,3,33,61,19,33,13,28,7,11,9,32,61
2011-07-04 00:00:00.000,Newport RI; U.S.A. ATP World Tour 250,GRASS,2,Alex Bogomolov Jr.,Mischa Zverev,Alex Bogomolov Jr.,4-6; 6-3; 6-1,R32,94,1,3,51,81,35,51,16,30,5,7,13,51,81,2,1,40,74,27,40,12,34,3,8,13,39,74
2011-07-04 00:00:00.000,Newport RI; U.S.A. ATP World Tour 250,GRASS,2,Jimmy Wang,Igor Kunitsyn,Jimmy Wang,4-6; 7-5; 6-2,R32,151,4,2,55,95,39,55,18,40,4,9,15,57,95,4,5,51,97,29,51,20,46,5,12,15,49,97
2011-07-04 00:00:00.000,Newport RI; U.S.A. ATP World Tour 250,GRASS,2,Edouard Roger-Vasselin,Richard Bloomfield,Edouard Roger-Vasselin,6-4; 6-0,R32,72,3,2,21,38,19,21,10,17,0,1,8,29,38,7,10,21,60,14,21,15,39,6,11,8,29,60
2011-07-04 00:00:00.000,Newport RI; U.S.A. ATP World Tour 250,GRASS,2,Donald Young,Paul Capdeville,Donald Young,6-2; 6-1,R32,52,3,2,25,39,21,25,8,14,0,1,8,29,39,0,5,38,66,18,38,11,28,6,11,7,29,66
2011-07-04 00:00:00.000,Newport RI; U.S.A. ATP World Tour 250,GRASS,2,Tobias Kamke,Alex Bogdanovic,Tobias Kamke,7-6(3); 6-3,R32,97,5,6,44,86,29,44,22,42,11,14,11,51,86,2,4,35,65,22,35,12,30,0,4,10,34,65
2011-07-04 00:00:00.000,Newport RI; U.S.A. ATP World Tour 250,GRASS,2,Olivier Rochus,Greg Jones,Olivier Rochus,6-4; 3-6; 6-3,R32,100,7,4,49,80,38,49,21,31,0,1,14,59,80,15,1,43,71,36,43,16,28,2,4,14,52,71
2011-07-04 00:00:00.000,Newport RI; U.S.A. ATP World Tour 250,GRASS,2,Nicolas Mahut,Sebastian Decoud,Nicolas Mahut,6-1; 6-0,R32,52,8,2,20,34,18,20,11,14,1,1,7,29,34,1,2,29,52,11,29,10,23,6,11,6,21,52
2011-07-04 00:00:00.000,Newport RI; U.S.A. ATP World Tour 250,GRASS,2,Matthias Bachinger,Dustin Brown,Matthias Bachinger,7-6(7); 6-7(5); 6-1,R32,111,11,3,51,97,45,51,30,46,2,2,16,75,97,12,8,50,98,38,50,29,48,2,4,15,67,98
2011-07-04 00:00:00.000,Newport RI; U.S.A. ATP World Tour 250,GRASS,2,Matthew Ebden,Ryan Sweeting,Matthew Ebden,6-4; 6-2,R32,73,8,3,36,57,28,36,8,21,4,6,9,36,57,1,8,38,70,22,38,13,32,6,11,9,35,70
2011-07-04 00:00:00.000,Newport RI; U.S.A. ATP World Tour 250,GRASS,2,Tommy Haas,Michael Berrer,Tommy Haas,7-6(9); 6-4,R32,93,8,3,48,77,36,48,14,29,4,5,11,50,77,3,5,39,69,29,39,17,30,4,6,11,46,69
2011-07-04 00:00:00.000,Newport RI; U.S.A. ATP World Tour 250,GRASS,2,Michael Yani,Dudi Sela,Michael Yani,7-6(5); 6-3,R32,97,4,6,42,80,30,42,19,38,3,5,10,49,80,2,7,39,78,26,39,15,39,3,7,11,41,78
2011-07-04 00:00:00.000,Newport RI; U.S.A. ATP World Tour 250,GRASS,2,Denis Kudla,Ivo Karlovic,Denis Kudla,7-6(4); 4-6; 6-4,R32,130,11,5,55,113,38,55,38,58,4,6,16,76,113,24,7,57,90,45,57,22,33,1,3,16,67,90
2011-07-04 00:00:00.000,Newport RI; U.S.A. ATP World Tour 250,GRASS,2,Grigor Dimitrov,Brian Dabul,Grigor Dimitrov,6-2; 6-4,R32,63,8,2,26,52,23,26,15,26,3,3,9,38,52,2,2,38,51,23,38,8,13,3,6,9,31,51
2011-07-04 00:00:00.000,Newport RI; U.S.A. ATP World Tour 250,GRASS,2,John Isner,Arnaud Clement,John Isner,7-6(6); 6-4,R16,111,11,4,45,65,36,45,12,20,0,1,11,48,65,2,9,47,94,33,47,24,47,10,12,11,57,94
2011-07-04 00:00:00.000,Newport RI; U.S.A. ATP World Tour 250,GRASS,2,Alex Bogomolov Jr.,Ruben Bemelmans,Alex Bogomolov Jr.,2-6; 6-0; 6-1,R16,73,0,1,54,71,33,54,11,17,5,7,11,44,71,4,5,37,61,25,37,9,24,3,8,10,34,61
2011-07-04 00:00:00.000,Newport RI; U.S.A. ATP World Tour 250,GRASS,2,Edouard Roger-Vasselin,Jimmy Wang,Edouard Roger-Vasselin,7-5; 6-4,R16,90,1,4,39,59,25,39,11,20,2,5,11,36,59,0,2,43,76,25,43,14,33,9,14,11,39,76
2011-07-04 00:00:00.000,Newport RI; U.S.A. ATP World Tour 250,GRASS,2,Tobias Kamke,Donald Young,Tobias Kamke,7-6(3); 6-4,R16,98,2,7,35,76,21,35,25,41,3,6,11,46,76,0,4,46,85,29,46,17,39,8,12,11,46,85
2011-07-04 00:00:00.000,Newport RI; U.S.A. ATP World Tour 250,GRASS,2,Olivier Rochus,Nicolas Mahut,Olivier Rochus,6-4; 7-6(3),R16,118,0,4,56,100,37,56,25,44,16,18,11,62,100,7,6,37,67,26,37,13,30,1,4,11,39,67
2011-07-04 00:00:00.000,Newport RI; U.S.A. ATP World Tour 250,GRASS,2,Matthew Ebden,Matthias Bachinger,Matthew Ebden,2-6; 6-4; 6-4,R16,110,8,8,46,83,32,46,18,37,5,9,14,50,83,5,2,48,87,34,48,16,39,3,7,14,50,87
2011-07-04 00:00:00.000,Newport RI; U.S.A. ATP World Tour 250,GRASS,2,Michael Yani,Tommy Haas,Michael Yani,5-2 RET,R16,34,0,1,8,17,4,8,5,9,0,1,3,9,17,1,4,14,31,6,14,7,17,4,7,4,13,31
2011-07-04 00:00:00.000,Newport RI; U.S.A. ATP World Tour 250,GRASS,2,Denis Kudla,Grigor Dimitrov,Denis Kudla,6-1; 6-4,R16,62,4,1,31,64,23,31,19,33,6,7,9,42,64,2,2,30,45,17,30,7,15,2,6,8,24,45
2011-07-04 00:00:00.000,Newport RI; U.S.A. ATP World Tour 250,GRASS,2,John Isner,Alex Bogomolov Jr.,John Isner,7-6(5); 6-4,Q,94,21,1,51,67,40,51,9,16,0,0,11,49,67,0,5,54,82,37,54,15,28,2,3,11,52,82
2011-07-04 00:00:00.000,Newport RI; U.S.A. ATP World Tour 250,GRASS,2,Tobias Kamke,Edouard Roger-Vasselin,Tobias Kamke,3-6; 6-1; 6-3,Q,99,1,5,41,73,30,41,17,32,3,4,12,47,73,3,2,51,84,36,51,15,33,9,13,13,51,84
2011-07-04 00:00:00.000,Newport RI; U.S.A. ATP World Tour 250,GRASS,2,Olivier Rochus,Matthew Ebden,Olivier Rochus,7-6(5); 6-3,Q,87,2,1,33,70,28,33,23,37,2,2,11,51,70,5,4,39,62,28,39,14,23,0,1,10,42,62
2011-07-04 00:00:00.000,Newport RI; U.S.A. ATP World Tour 250,GRASS,2,Michael Yani,Denis Kudla,Michael Yani,6-3; 6-7(5); 7-5,Q,131,7,5,64,112,37,64,23,48,3,8,16,60,112,3,8,56,109,31,56,25,53,5,13,17,56,109
2011-07-04 00:00:00.000,Newport RI; U.S.A. ATP World Tour 250,GRASS,2,John Isner,Tobias Kamke,John Isner,7-5; 7-6(4),S,98,12,3,49,65,42,49,11,16,1,1,12,53,65,4,8,41,90,32,41,26,49,5,6,12,58,90
2011-07-04 00:00:00.000,Newport RI; U.S.A. ATP World Tour 250,GRASS,2,Olivier Rochus,Michael Yani,Olivier Rochus,6-2; 6-4,S,73,3,1,32,48,27,32,10,16,0,0,9,37,48,8,2,43,64,29,43,9,21,3,6,9,38,64
2011-07-04 00:00:00.000,Newport RI; U.S.A. ATP World Tour 250,GRASS,2,John Isner,Olivier Rochus,John Isner,6-3; 7-6(6),F,103,22,1,42,64,38,42,14,22,1,1,11,52,64,1,1,47,84,31,47,21,37,9,10,10,52,84
2011-07-11 00:00:00.000,Bsstad Sweden ATP World Tour 250,CLAY,2,Robin Soderling,N/A Bye,Robin Soderling,,R32,0,0,0,0,0,0,0,0,0,0,0,0,0,0,0,0,0,0,0,0,0,0,0,0,0,0,0
2011-07-11 00:00:00.000,Bsstad Sweden ATP World Tour 250,CLAY,2,Diego Junqueira,Igor Andreev,Diego Junqueira,7-6(3); 3-6; 6-4,R32,141,0,1,70,90,48,70,10,20,6,10,16,58,90,4,4,59,95,43,59,17,36,8,11,15,60,95
2011-07-11 00:00:00.000,Bsstad Sweden ATP World Tour 250,CLAY,2,Jonathan Dasnieres de Veigy,Andreas Vinciguerra,Jonathan Dasnieres de Veigy,6-1; 1-6; 6-3,R32,101,3,7,46,69,34,46,9,23,2,5,12,43,69,1,2,61,82,39,61,7,21,6,10,11,46,82
2011-07-11 00:00:00.000,Bsstad Sweden ATP World Tour 250,CLAY,2,Potito Starace,Julian Reister,Potito Starace,7-6(6); 6-3,R32,88,0,0,51,67,34,51,12,16,2,4,11,46,67,5,4,37,61,24,37,14,24,4,7,10,38,61
2011-07-11 00:00:00.000,Bsstad Sweden ATP World Tour 250,CLAY,2,Tomas Berdych,N/A Bye,Tomas Berdych,,R32,0,0,0,0,0,0,0,0,0,0,0,0,0,0,0,0,0,0,0,0,0,0,0,0,0,0,0
2011-07-11 00:00:00.000,Bsstad Sweden ATP World Tour 250,CLAY,2,Teymuraz Gabashvili,Michael Yani,Teymuraz Gabashvili,6-3; 3-6; 6-3,R32,129,3,5,52,93,36,52,24,41,0,1,14,60,93,7,1,60,90,41,60,14,30,9,11,13,55,90
2011-07-11 00:00:00.000,Bsstad Sweden ATP World Tour 250,CLAY,2,Blaz Kavcic,Julien Benneteau,Blaz Kavcic,6-4; 4-6; 7-5,R32,174,4,2,80,110,47,80,13,30,8,14,16,60,110,5,4,69,103,45,69,8,34,3,10,16,53,103
2011-07-11 00:00:00.000,Bsstad Sweden ATP World Tour 250,CLAY,2,Juan Monaco,Carlos Berlocq,Juan Monaco,6-7(5); 7-6(7); 6-2,R32,212,0,3,97,145,63,97,27,48,16,18,16,90,145,3,2,72,116,48,72,22,44,4,8,16,70,116
2011-07-11 00:00:00.000,Bsstad Sweden ATP World Tour 250,CLAY,2,Ruben Ramirez Hidalgo,Andrey Golubev,Ruben Ramirez Hidalgo,6-7(4); 6-1; 6-2,R32,131,1,3,50,95,30,50,25,45,7,10,13,55,95,2,7,48,88,30,48,12,40,1,9,14,42,88
2011-07-11 00:00:00.000,Bsstad Sweden ATP World Tour 250,CLAY,2,Michael Ryderstedt,Maximo Gonzalez,Michael Ryderstedt,6-4; 2-6; 6-2,R32,125,6,0,53,77,36,53,15,24,1,3,13,51,77,4,3,55,90,35,55,19,35,4,7,13,54,90
2011-07-11 00:00:00.000,Bsstad Sweden ATP World Tour 250,CLAY,2,Guillermo Olaso,Antonio Veic,Guillermo Olaso,6-4; 6-1,R32,76,2,4,35,61,26,35,12,26,5,6,8,38,61,2,4,35,55,19,35,9,20,5,10,9,28,55
2011-07-11 00:00:00.000,Bsstad Sweden ATP World Tour 250,CLAY,2,Nicolas Almagro,N/A Bye,Nicolas Almagro,,R32,0,0,0,0,0,0,0,0,0,0,0,0,0,0,0,0,0,0,0,0,0,0,0,0,0,0,0
2011-07-11 00:00:00.000,Bsstad Sweden ATP World Tour 250,CLAY,2,Filippo Volandri,Tommy Robredo,Filippo Volandri,7-5; 5-5 RET,R32,110,0,2,48,64,29,48,9,16,1,5,11,38,64,1,1,45,80,25,45,18,35,6,11,11,43,80
2011-07-11 00:00:00.000,Bsstad Sweden ATP World Tour 250,CLAY,2,Andreas Haider-Maurer,Mikhail Kukushkin,Andreas Haider-Maurer,7-5; 6-2,R32,86,11,3,42,74,30,42,12,32,5,8,10,42,74,0,1,28,48,14,28,8,20,2,8,10,22,48
2011-07-11 00:00:00.000,Bsstad Sweden ATP World Tour 250,CLAY,2,Pere Riba,Christian Lindell,Pere Riba,6-4; 6-2,R32,89,3,1,30,54,23,30,13,24,2,4,9,36,54,1,1,35,57,16,35,11,22,2,7,9,27,57
2011-07-11 00:00:00.000,Bsstad Sweden ATP World Tour 250,CLAY,2,David Ferrer,N/A Bye,David Ferrer,,R32,0,0,0,0,0,0,0,0,0,0,0,0,0,0,0,0,0,0,0,0,0,0,0,0,0,0,0
2011-07-11 00:00:00.000,Bsstad Sweden ATP World Tour 250,CLAY,2,Robin Soderling,Diego Junqueira,Robin Soderling,6-0; 6-1,R16,47,3,1,25,35,19,25,7,10,0,1,7,26,35,1,1,22,32,5,22,2,10,1,7,6,7,32
2011-07-11 00:00:00.000,Bsstad Sweden ATP World Tour 250,CLAY,2,Potito Starace,Jonathan Dasnieres de Veigy,Potito Starace,6-0; 6-7(5); 6-2,R16,134,0,1,68,87,46,68,10,19,5,7,13,56,87,3,3,71,100,43,71,8,29,9,16,13,51,100
2011-07-11 00:00:00.000,Bsstad Sweden ATP World Tour 250,CLAY,2,Tomas Berdych,Teymuraz Gabashvili,Tomas Berdych,6-2; 6-2,R16,86,9,2,34,54,24,34,13,20,1,1,8,37,54,0,1,25,56,16,25,13,31,2,6,8,29,56
2011-07-11 00:00:00.000,Bsstad Sweden ATP World Tour 250,CLAY,2,Blaz Kavcic,Juan Monaco,Blaz Kavcic,W/O,R16,0,0,0,0,0,0,0,0,0,0,0,0,0,0,0,0,0,0,0,0,0,0,0,0,0,0,0
2011-07-11 00:00:00.000,Bsstad Sweden ATP World Tour 250,CLAY,2,Michael Ryderstedt,Ruben Ramirez Hidalgo,Michael Ryderstedt,6-4; 6-2,R16,91,6,4,44,64,33,44,8,20,6,7,9,41,64,0,0,35,55,19,35,12,20,2,6,9,31,55
2011-07-11 00:00:00.000,Bsstad Sweden ATP World Tour 250,CLAY,2,Nicolas Almagro,Guillermo Olaso,Nicolas Almagro,6-2; 6-3,R16,56,3,5,30,55,25,30,12,25,2,2,8,37,55,3,2,29,52,17,29,12,23,2,6,9,29,52
2011-07-11 00:00:00.000,Bsstad Sweden ATP World Tour 250,CLAY,2,Andreas Haider-Maurer,Filippo Volandri,Andreas Haider-Maurer,6-3; 7-6(7),R16,95,5,5,44,78,38,44,12,34,3,5,11,50,78,0,1,48,65,30,48,8,17,1,4,10,38,65
2011-07-11 00:00:00.000,Bsstad Sweden ATP World Tour 250,CLAY,2,David Ferrer,Pere Riba,David Ferrer,6-2; 7-6(4),R16,125,1,3,34,72,27,34,24,38,4,4,10,51,72,3,4,49,91,36,49,16,42,6,8,10,52,91
2011-07-11 00:00:00.000,Bsstad Sweden ATP World Tour 250,CLAY,2,Robin Soderling,Potito Starace,Robin Soderling,6-3; 6-4,Q,72,6,3,25,50,22,25,18,25,0,0,10,40,50,4,1,40,61,25,40,10,21,2,4,9,35,61
2011-07-11 00:00:00.000,Bsstad Sweden ATP World Tour 250,CLAY,2,Tomas Berdych,Blaz Kavcic,Tomas Berdych,6-1; 6-4,Q,79,2,3,31,54,23,31,14,23,0,0,9,37,54,1,1,31,49,17,31,11,18,3,6,8,28,49
2011-07-11 00:00:00.000,Bsstad Sweden ATP World Tour 250,CLAY,2,Nicolas Almagro,Michael Ryderstedt,Nicolas Almagro,6-4; 7-6(4),Q,83,11,5,38,67,28,38,16,29,1,4,11,44,67,3,3,43,72,30,43,14,29,5,9,11,44,72
2011-07-11 00:00:00.000,Bsstad Sweden ATP World Tour 250,CLAY,2,David Ferrer,Andreas Haider-Maurer,David Ferrer,6-1; 6-1,Q,56,2,0,19,37,13,19,16,18,2,2,7,29,37,2,0,20,40,9,20,7,20,4,9,7,16,40
2011-07-11 00:00:00.000,Bsstad Sweden ATP World Tour 250,CLAY,2,Robin Soderling,Tomas Berdych,Robin Soderling,6-1; 6-0,S,71,3,0,29,47,20,29,11,18,4,4,7,31,47,2,2,32,56,14,32,10,24,6,11,6,24,56
2011-07-11 00:00:00.000,Bsstad Sweden ATP World Tour 250,CLAY,2,David Ferrer,Nicolas Almagro,David Ferrer,6-1; 6-3,S,64,5,2,34,51,24,34,9,17,2,3,8,33,51,3,1,25,46,10,25,9,21,1,6,8,19,46
2011-07-11 00:00:00.000,Bsstad Sweden ATP World Tour 250,CLAY,2,Robin Soderling,David Ferrer,Robin Soderling,6-2; 6-2,F,67,4,3,21,41,18,21,11,20,0,1,8,29,41,3,2,32,59,16,32,11,27,6,11,8,27,59
2011-07-11 00:00:00.000,Stuttgart Germany ATP World Tour 250,CLAY,2,Victor Hanescu,Gael Monfils,Victor Hanescu,2-6; 7-6(7); 6-4,R32,137,2,2,57,99,36,57,24,42,1,5,15,60,99,13,8,59,102,43,59,21,43,4,7,15,64,102
2011-07-11 00:00:00.000,Stuttgart Germany ATP World Tour 250,CLAY,2,Pavol Cervenak,Mischa Zverev,Pavol Cervenak,6-4; 4-6; 6-2,R32,121,4,4,46,85,34,46,19,39,4,7,14,53,85,1,2,41,74,26,41,17,33,1,6,14,43,74
2011-07-11 00:00:00.000,Stuttgart Germany ATP World Tour 250,CLAY,2,Sergiy Stakhovsky,Jaroslav Pospisil,Sergiy Stakhovsky,4-6; 6-2; 7-6(5),R32,160,8,0,49,93,39,49,29,44,5,6,15,68,93,2,9,63,122,44,63,32,59,13,15,15,76,122
2011-07-11 00:00:00.000,Stuttgart Germany ATP World Tour 250,CLAY,2,Federico Delbonis,Florian Mayer,Federico Delbonis,6-2; 6-3,R32,70,2,5,27,54,24,27,15,27,5,5,9,39,54,2,7,31,64,19,31,15,33,3,6,8,34,64
2011-07-11 00:00:00.000,Stuttgart Germany ATP World Tour 250,CLAY,2,Mikhail Youzhny,Philipp Petzschner,Mikhail Youzhny,6-3; 6-3,R32,71,4,3,33,52,27,33,10,19,1,2,9,37,52,4,2,33,56,18,33,12,23,3,7,9,30,56
2011-07-11 00:00:00.000,Stuttgart Germany ATP World Tour 250,CLAY,2,Juan Carlos Ferrero,Bastian Knittel,Juan Carlos Ferrero,6-2; 6-4,R32,82,3,4,26,54,19,26,17,28,5,7,9,36,54,3,10,40,71,23,40,10,31,6,11,9,33,71
2011-07-11 00:00:00.000,Stuttgart Germany ATP World Tour 250,CLAY,2,Benoit Paire,Evgeny Donskoy,Benoit Paire,6-7(3); 6-4; 6-2,R32,127,8,5,60,118,45,60,29,58,12,14,15,74,118,3,5,48,100,38,48,22,52,3,8,15,60,100
2011-07-11 00:00:00.000,Stuttgart Germany ATP World Tour 250,CLAY,2,Marcel Granollers,Andreas Seppi,Marcel Granollers,6-3; 3-6; 6-1,R32,195,3,5,50,82,33,50,17,32,6,9,13,50,82,2,4,41,86,26,41,21,45,4,9,12,47,86
2011-07-11 00:00:00.000,Stuttgart Germany ATP World Tour 250,CLAY,2,Cedrik-Marcel Stebe,Nikolay Davydenko,Cedrik-Marcel Stebe,3-6; 6-1; 6-4,R32,123,2,5,47,86,29,47,17,39,6,11,13,46,86,1,6,59,82,34,59,8,23,8,15,13,42,82
2011-07-11 00:00:00.000,Stuttgart Germany ATP World Tour 250,CLAY,2,Fabio Fognini,Robin Kern,Fabio Fognini,6-4; 6-1,R32,64,1,5,19,50,16,19,16,31,3,4,8,32,50,3,5,32,67,21,32,13,35,7,12,9,34,67
2011-07-11 00:00:00.000,Stuttgart Germany ATP World Tour 250,CLAY,2,Pablo Andujar,Victor Crivoi,Pablo Andujar,6-2; 6-1,R32,72,1,3,33,50,19,33,9,17,6,8,7,28,50,0,1,29,45,13,29,3,16,1,8,8,16,45
2011-07-11 00:00:00.000,Stuttgart Germany ATP World Tour 250,CLAY,2,Albert Montanes,Gilles Simon,Albert Montanes,4-6; 7-6(5); 6-2,R32,119,4,10,48,93,33,48,23,45,8,13,15,56,93,5,4,51,89,32,51,20,38,3,9,15,52,89
2011-07-11 00:00:00.000,Stuttgart Germany ATP World Tour 250,CLAY,2,Guillermo Garcia-Lopez,Radek Stepanek,Guillermo Garcia-Lopez,6-1; 6-3,R32,76,3,4,29,54,22,29,13,25,4,4,8,35,54,3,7,30,55,20,30,8,25,4,8,8,28,55
2011-07-11 00:00:00.000,Stuttgart Germany ATP World Tour 250,CLAY,2,Lukasz Kubot,Daniel Gimeno-Traver,Lukasz Kubot,7-6(2); 3-6; 6-2,R32,122,4,7,53,88,43,53,18,35,5,7,14,61,88,13,3,44,77,34,44,18,33,0,3,15,52,77
2011-07-11 00:00:00.000,Stuttgart Germany ATP World Tour 250,CLAY,2,Jeremy Chardy,Tobias Kamke,Jeremy Chardy,7-6(1); 6-1,R32,77,8,3,38,73,31,38,18,35,2,3,10,49,73,2,5,30,56,18,30,13,26,3,6,9,31,56
2011-07-11 00:00:00.000,Stuttgart Germany ATP World Tour 250,CLAY,2,Santiago Giraldo,Jurgen Melzer,Santiago Giraldo,6-4; 7-5,R32,89,7,0,34,59,27,34,14,25,3,5,11,41,59,6,4,34,64,24,34,13,30,6,10,11,37,64
2011-07-11 00:00:00.000,Stuttgart Germany ATP World Tour 250,CLAY,2,Pavol Cervenak,Victor Hanescu,Pavol Cervenak,6-3; 7-6(6),R16,88,4,4,45,73,33,45,15,28,4,6,11,48,73,2,2,39,61,24,39,11,22,1,4,10,35,61
2011-07-11 00:00:00.000,Stuttgart Germany ATP World Tour 250,CLAY,2,Federico Delbonis,Sergiy Stakhovsky,Federico Delbonis,6-4; 6-3,R16,77,3,3,39,63,26,39,13,24,4,6,9,39,63,1,1,40,58,26,40,5,18,5,10,10,31,58
2011-07-11 00:00:00.000,Stuttgart Germany ATP World Tour 250,CLAY,2,Juan Carlos Ferrero,Mikhail Youzhny,Juan Carlos Ferrero,6-7(6); 6-2; 6-2,R16,136,5,0,58,94,42,58,22,36,3,5,14,64,94,5,6,53,101,31,53,26,48,5,11,14,57,101
2011-07-11 00:00:00.000,Stuttgart Germany ATP World Tour 250,CLAY,2,Marcel Granollers,Benoit Paire,Marcel Granollers,6-4; 7-5,R16,104,0,1,55,73,36,55,9,18,5,7,11,45,73,1,1,35,74,26,35,17,39,5,9,11,43,74
2011-07-11 00:00:00.000,Stuttgart Germany ATP World Tour 250,CLAY,2,Cedrik-Marcel Stebe,Fabio Fognini,Cedrik-Marcel Stebe,7-6(5); 6-4,R16,147,1,6,50,102,24,50,28,52,11,16,11,52,102,2,3,55,96,32,55,16,41,6,12,11,48,96
2011-07-11 00:00:00.000,Stuttgart Germany ATP World Tour 250,CLAY,2,Pablo Andujar,Albert Montanes,Pablo Andujar,2-6; 6-4; 6-3,R16,129,3,4,42,85,29,42,20,43,6,10,13,49,85,4,8,51,98,38,51,16,47,8,13,14,54,98
2011-07-11 00:00:00.000,Stuttgart Germany ATP World Tour 250,CLAY,2,Lukasz Kubot,Guillermo Garcia-Lopez,Lukasz Kubot,4-6; 6-4; 6-3,R16,145,2,6,57,88,41,57,17,31,2,5,15,58,88,5,5,41,79,25,41,23,38,2,6,14,48,79
2011-07-11 00:00:00.000,Stuttgart Germany ATP World Tour 250,CLAY,2,Santiago Giraldo,Jeremy Chardy,Santiago Giraldo,1-6; 7-5; 6-4,R16,121,4,2,57,96,38,57,21,39,7,11,15,59,96,1,9,47,90,35,47,21,43,3,6,14,56,90
2011-07-11 00:00:00.000,Stuttgart Germany ATP World Tour 250,CLAY,2,Federico Delbonis,Pavol Cervenak,Federico Delbonis,6-1; 6-2,Q,71,2,1,25,50,17,25,18,25,1,1,8,35,50,1,4,27,49,17,27,7,22,9,13,7,24,49
2011-07-11 00:00:00.000,Stuttgart Germany ATP World Tour 250,CLAY,2,Juan Carlos Ferrero,Marcel Granollers,Juan Carlos Ferrero,6-4; 6-3,Q,88,1,3,34,60,20,34,15,26,5,8,10,35,60,2,2,38,53,19,38,4,15,5,10,9,23,53
2011-07-11 00:00:00.000,Stuttgart Germany ATP World Tour 250,CLAY,2,Pablo Andujar,Cedrik-Marcel Stebe,Pablo Andujar,6-2; 6-1,Q,67,0,2,29,44,21,29,8,15,2,3,7,29,44,1,4,16,41,8,16,7,25,0,6,8,15,41
2011-07-11 00:00:00.000,Stuttgart Germany ATP World Tour 250,CLAY,2,Lukasz Kubot,Santiago Giraldo,Lukasz Kubot,7-5; 5-7; 6-3,Q,148,4,4,62,104,39,62,25,42,6,9,16,64,104,5,0,70,105,46,70,18,35,5,10,17,64,105
2011-07-11 00:00:00.000,Stuttgart Germany ATP World Tour 250,CLAY,2,Juan Carlos Ferrero,Federico Delbonis,Juan Carlos Ferrero,3-6; 6-4; 6-4,S,125,1,1,55,96,33,55,27,41,9,11,14,60,96,3,3,44,81,31,44,22,37,3,6,15,53,81
2011-07-11 00:00:00.000,Stuttgart Germany ATP World Tour 250,CLAY,2,Pablo Andujar,Lukasz Kubot,Pablo Andujar,6-4; 3-6; 6-4,S,144,3,5,50,88,33,50,20,38,7,11,14,53,88,4,9,56,96,38,56,17,40,4,9,15,55,96
2011-07-11 00:00:00.000,Stuttgart Germany ATP World Tour 250,CLAY,2,Juan Carlos Ferrero,Pablo Andujar,Juan Carlos Ferrero,6-4; 6-0,F,79,3,0,25,45,19,25,11,20,0,1,8,30,45,1,7,31,59,17,31,10,28,5,10,8,27,59
2011-07-18 00:00:00.000,Atlanta GA; USA ATP World Tour 250,HARD,2,Mardy Fish,N/A Bye,Mardy Fish,,R32,0,0,0,0,0,0,0,0,0,0,0,0,0,0,0,0,0,0,0,0,0,0,0,0,0,0,0
2011-07-18 00:00:00.000,Atlanta GA; USA ATP World Tour 250,HARD,2,Nicolas Mahut,Ricardas Berankis,Nicolas Mahut,7-6(5); 6-2,R32,93,6,5,28,68,22,28,21,40,4,6,10,43,68,5,5,33,74,22,33,17,41,3,7,10,39,74
2011-07-18 00:00:00.000,Atlanta GA; USA ATP World Tour 250,HARD,2,Tatsuma Ito,Michael Berrer,Tatsuma Ito,7-6(6); 6-4,R32,98,4,3,49,80,42,49,14,31,1,1,11,56,80,10,4,40,72,32,40,18,32,1,2,11,50,72
2011-07-18 00:00:00.000,Atlanta GA; USA ATP World Tour 250,HARD,2,Somdev Devvarman,Ryan Sweeting,Somdev Devvarman,6-4; 3-6; 6-4,R32,144,5,7,59,101,44,59,15,42,6,11,14,59,101,3,12,60,101,39,60,18,41,6,12,15,57,101
2011-07-18 00:00:00.000,Atlanta GA; USA ATP World Tour 250,HARD,2,Xavier Malisse,N/A Bye,Xavier Malisse,,R32,0,0,0,0,0,0,0,0,0,0,0,0,0,0,0,0,0,0,0,0,0,0,0,0,0,0,0
2011-07-18 00:00:00.000,Atlanta GA; USA ATP World Tour 250,HARD,2,Ryan Harrison,Yuichi Sugita,Ryan Harrison,6-1; 7-6(5),R32,97,4,3,39,64,34,39,12,25,1,1,10,46,64,1,3,43,76,28,43,16,33,11,13,9,44,76
2011-07-18 00:00:00.000,Atlanta GA; USA ATP World Tour 250,HARD,2,Lleyton Hewitt,Phillip Simmonds,Lleyton Hewitt,6-4; 6-4,R32,94,5,3,28,52,25,28,14,24,1,2,10,39,52,7,6,37,67,26,37,13,30,2,5,10,39,67
2011-07-18 00:00:00.000,Atlanta GA; USA ATP World Tour 250,HARD,2,Rajeev Ram,Grigor Dimitrov,Rajeev Ram,6-4; 6-4,R32,74,5,1,35,49,32,35,8,14,0,0,10,40,49,5,3,38,67,24,38,18,29,4,6,10,42,67
2011-07-18 00:00:00.000,Atlanta GA; USA ATP World Tour 250,HARD,2,Marinko Matosevic,Igor Kunitsyn,Marinko Matosevic,6-7(3); 6-2; 7-5,R32,170,10,5,58,98,46,58,19,40,2,5,16,65,98,4,4,60,111,43,60,23,51,6,12,16,66,111
2011-07-18 00:00:00.000,Atlanta GA; USA ATP World Tour 250,HARD,2,Yen-Hsun Lu,Matthias Bachinger,Yen-Hsun Lu,7-5; 7-6(4),R32,106,0,7,34,65,28,34,18,31,1,4,12,46,65,10,7,46,90,34,46,19,44,5,9,12,53,90
2011-07-18 00:00:00.000,Atlanta GA; USA ATP World Tour 250,HARD,2,James Blake,Ernests Gulbis,James Blake,5-7; 7-6(5); 6-2,R32,159,8,7,65,132,50,65,30,67,17,20,16,80,132,17,5,61,101,46,61,16,40,5,9,16,62,101
2011-07-18 00:00:00.000,Atlanta GA; USA ATP World Tour 250,HARD,2,John Isner,N/A Bye,John Isner,,R32,0,0,0,0,0,0,0,0,0,0,0,0,0,0,0,0,0,0,0,0,0,0,0,0,0,0,0
2011-07-18 00:00:00.000,Atlanta GA; USA ATP World Tour 250,HARD,2,Gilles Muller,Alex Bogomolov Jr.,Gilles Muller,6-3; 7-6(6),R32,95,17,4,30,62,25,30,20,32,0,1,11,45,62,6,3,54,82,30,54,17,28,4,6,10,47,82
2011-07-18 00:00:00.000,Atlanta GA; USA ATP World Tour 250,HARD,2,Robby Ginepri,Tommy Haas,Robby Ginepri,6-4; 7-5,R32,105,9,2,57,82,37,57,12,25,6,8,11,49,82,5,5,44,77,30,44,13,33,10,14,11,43,77
2011-07-18 00:00:00.000,Atlanta GA; USA ATP World Tour 250,HARD,2,Michael Russell,Donald Young,Michael Russell,6-0; 6-3,R32,92,2,2,35,48,26,35,7,13,0,1,8,33,48,0,2,25,47,14,25,6,22,2,7,7,20,47
2011-07-18 00:00:00.000,Atlanta GA; USA ATP World Tour 250,HARD,2,Kevin Anderson,N/A Bye,Kevin Anderson,,R32,0,0,0,0,0,0,0,0,0,0,0,0,0,0,0,0,0,0,0,0,0,0,0,0,0,0,0
2011-07-18 00:00:00.000,Atlanta GA; USA ATP World Tour 250,HARD,2,Mardy Fish,Nicolas Mahut,Mardy Fish,6-3; 6-3,R16,83,6,2,39,53,30,39,8,14,4,5,9,38,53,1,6,31,60,18,31,10,29,8,12,9,28,60
2011-07-18 00:00:00.000,Atlanta GA; USA ATP World Tour 250,HARD,2,Somdev Devvarman,Tatsuma Ito,Somdev Devvarman,6-1; 6-3,R16,61,4,0,21,35,21,21,11,14,0,0,8,32,35,1,4,20,47,11,20,12,27,4,8,8,23,47
2011-07-18 00:00:00.000,Atlanta GA; USA ATP World Tour 250,HARD,2,Ryan Harrison,Xavier Malisse,Ryan Harrison,6-7(3); 6-4; 6-4,R16,139,7,7,54,96,45,54,21,42,2,4,16,66,96,6,3,51,102,38,51,28,51,4,8,16,66,102
2011-07-18 00:00:00.000,Atlanta GA; USA ATP World Tour 250,HARD,2,Rajeev Ram,Lleyton Hewitt,Rajeev Ram,7-5; 2-6; 6-2,R16,118,8,4,47,78,36,47,11,31,3,7,14,47,78,7,9,46,84,34,46,17,38,5,10,14,51,84
2011-07-18 00:00:00.000,Atlanta GA; USA ATP World Tour 250,HARD,2,Yen-Hsun Lu,Marinko Matosevic,Yen-Hsun Lu,3-6; 6-1; 6-2,R16,128,4,7,41,84,25,41,25,43,8,11,12,50,84,4,5,45,78,27,45,12,33,2,8,12,39,78
2011-07-18 00:00:00.000,Atlanta GA; USA ATP World Tour 250,HARD,2,John Isner,James Blake,John Isner,7-6(8); 6-7(3); 7-5,R16,170,30,7,87,131,70,87,22,44,7,8,18,92,131,7,6,64,114,54,64,26,50,1,3,18,80,114
2011-07-18 00:00:00.000,Atlanta GA; USA ATP World Tour 250,HARD,2,Gilles Muller,Robby Ginepri,Gilles Muller,7-6(6); 2-6; 6-2,R16,116,15,3,48,91,38,48,25,43,5,7,14,63,91,8,1,43,82,31,43,26,39,0,2,14,57,82
2011-07-18 00:00:00.000,Atlanta GA; USA ATP World Tour 250,HARD,2,Kevin Anderson,Michael Russell,Kevin Anderson,6-1; 7-5,R16,85,10,0,34,50,26,34,12,16,0,1,10,38,50,2,7,33,56,23,33,6,23,4,8,9,29,56
2011-07-18 00:00:00.000,Atlanta GA; USA ATP World Tour 250,HARD,2,Mardy Fish,Somdev Devvarman,Mardy Fish,6-4; 6-3,Q,93,4,0,37,51,30,37,5,14,2,4,10,35,51,0,2,45,72,24,45,13,27,8,12,9,37,72
2011-07-18 00:00:00.000,Atlanta GA; USA ATP World Tour 250,HARD,2,Ryan Harrison,Rajeev Ram,Ryan Harrison,4-6; 6-1; 7-6(5),Q,137,10,3,57,95,41,57,23,38,4,6,15,64,95,3,2,47,88,30,47,25,41,2,5,14,55,88
2011-07-18 00:00:00.000,Atlanta GA; USA ATP World Tour 250,HARD,2,John Isner,Yen-Hsun Lu,John Isner,6-1; 6-2,Q,56,8,1,33,42,29,33,4,9,1,1,8,33,42,2,5,24,39,13,24,5,15,2,6,7,18,39
2011-07-18 00:00:00.000,Atlanta GA; USA ATP World Tour 250,HARD,2,Gilles Muller,Kevin Anderson,Gilles Muller,7-6(3); 7-6(3),Q,127,14,4,57,88,45,57,15,31,6,7,12,60,88,12,4,47,75,39,47,13,28,3,4,12,52,75
2011-07-18 00:00:00.000,Atlanta GA; USA ATP World Tour 250,HARD,2,Mardy Fish,Ryan Harrison,Mardy Fish,6-2; 6-4,S,79,2,1,24,50,18,24,19,26,1,1,9,37,50,3,2,28,54,17,28,13,26,3,6,9,30,54
2011-07-18 00:00:00.000,Atlanta GA; USA ATP World Tour 250,HARD,2,John Isner,Gilles Muller,John Isner,7-5; 6-7(3); 6-1,S,148,28,0,66,92,51,66,20,26,2,2,16,71,92,16,4,62,104,46,62,22,42,5,8,15,68,104
2011-07-18 00:00:00.000,Atlanta GA; USA ATP World Tour 250,HARD,2,Mardy Fish,John Isner,Mardy Fish,3-6; 7-6(6); 6-2,F,136,13,1,45,74,39,45,19,29,3,5,14,58,74,15,6,65,94,46,65,13,29,3,6,15,59,94
2011-07-18 00:00:00.000,Hamburg Germany ATP World Tour 500,CLAY,2,Gael Monfils,N/A Bye,Gael Monfils,,R64,0,0,0,0,0,0,0,0,0,0,0,0,0,0,0,0,0,0,0,0,0,0,0,0,0,0,0
2011-07-18 00:00:00.000,Hamburg Germany ATP World Tour 500,CLAY,2,Albert Ramos,Adrian Mannarino,Albert Ramos,6-2; 6-4,R64,69,4,1,32,50,27,32,9,18,2,3,9,36,50,2,2,26,48,18,26,9,22,2,6,9,27,48
2011-07-18 00:00:00.000,Hamburg Germany ATP World Tour 500,CLAY,2,Radek Stepanek,Andreas Beck,Radek Stepanek,7-5; 7-6(2),R64,115,8,2,65,93,47,65,17,28,4,4,12,64,93,3,0,48,76,32,48,19,28,0,1,12,51,76
2011-07-18 00:00:00.000,Hamburg Germany ATP World Tour 500,CLAY,2,Andreas Seppi,N/A Bye,Andreas Seppi,,R64,0,0,0,0,0,0,0,0,0,0,0,0,0,0,0,0,0,0,0,0,0,0,0,0,0,0,0
2011-07-18 00:00:00.000,Hamburg Germany ATP World Tour 500,CLAY,2,Alexandr Dolgopolov,N/A Bye,Alexandr Dolgopolov,,R64,0,0,0,0,0,0,0,0,0,0,0,0,0,0,0,0,0,0,0,0,0,0,0,0,0,0,0
2011-07-18 00:00:00.000,Hamburg Germany ATP World Tour 500,CLAY,2,Jarkko Nieminen,Santiago Giraldo,Jarkko Nieminen,6-4; 6-3,R64,73,2,2,38,53,29,38,9,15,2,3,10,38,53,5,1,38,63,23,38,12,25,1,4,9,35,63
2011-07-18 00:00:00.000,Hamburg Germany ATP World Tour 500,CLAY,2,Sergiy Stakhovsky,Maximo Gonzalez,Sergiy Stakhovsky,6-2; 6-3,R64,64,1,0,32,51,21,32,15,19,2,3,9,36,51,0,1,29,44,16,29,7,15,1,5,8,23,44
2011-07-18 00:00:00.000,Hamburg Germany ATP World Tour 500,CLAY,2,Gilles Simon,N/A Bye,Gilles Simon,,R64,0,0,0,0,0,0,0,0,0,0,0,0,0,0,0,0,0,0,0,0,0,0,0,0,0,0,0
2011-07-18 00:00:00.000,Hamburg Germany ATP World Tour 500,CLAY,2,Mikhail Youzhny,N/A Bye,Mikhail Youzhny,,R64,0,0,0,0,0,0,0,0,0,0,0,0,0,0,0,0,0,0,0,0,0,0,0,0,0,0,0
2011-07-18 00:00:00.000,Hamburg Germany ATP World Tour 500,CLAY,2,Carlos Berlocq,Robin Haase,Carlos Berlocq,6-2; 6-2,R64,85,3,1,30,51,22,30,10,21,1,3,8,32,51,2,0,26,58,15,26,9,32,5,11,8,24,58
2011-07-18 00:00:00.000,Hamburg Germany ATP World Tour 500,CLAY,2,Julian Reister,Denis Istomin,Julian Reister,6-3; 6-4,R64,74,0,3,30,55,21,30,17,25,1,2,10,38,55,4,1,37,57,22,37,10,20,2,5,9,32,57
2011-07-18 00:00:00.000,Hamburg Germany ATP World Tour 500,CLAY,2,Guillermo Garcia-Lopez,N/A Bye,Guillermo Garcia-Lopez,,R64,0,0,0,0,0,0,0,0,0,0,0,0,0,0,0,0,0,0,0,0,0,0,0,0,0,0,0
2011-07-18 00:00:00.000,Hamburg Germany ATP World Tour 500,CLAY,2,Marin Cilic,N/A Bye,Marin Cilic,,R64,0,0,0,0,0,0,0,0,0,0,0,0,0,0,0,0,0,0,0,0,0,0,0,0,0,0,0
2011-07-18 00:00:00.000,Hamburg Germany ATP World Tour 500,CLAY,2,Bastian Knittel,Ivan Dodig,Bastian Knittel,6-4; 6-3,R64,83,0,4,35,57,26,35,10,22,4,6,10,36,57,2,2,26,49,17,26,7,23,1,5,9,24,49
2011-07-18 00:00:00.000,Hamburg Germany ATP World Tour 500,CLAY,2,Tobias Kamke,Pere Riba,Tobias Kamke,6-1; 6-1,R64,75,0,2,35,50,26,35,8,15,1,1,7,34,50,1,4,29,58,16,29,9,29,10,15,7,25,58
2011-07-18 00:00:00.000,Hamburg Germany ATP World Tour 500,CLAY,2,Juan Ignacio Chela,N/A Bye,Juan Ignacio Chela,,R64,0,0,0,0,0,0,0,0,0,0,0,0,0,0,0,0,0,0,0,0,0,0,0,0,0,0,0
2011-07-18 00:00:00.000,Hamburg Germany ATP World Tour 500,CLAY,2,Florian Mayer,N/A Bye,Florian Mayer,,R64,0,0,0,0,0,0,0,0,0,0,0,0,0,0,0,0,0,0,0,0,0,0,0,0,0,0,0
2011-07-18 00:00:00.000,Hamburg Germany ATP World Tour 500,CLAY,2,Marsel Ilhan,Philipp Petzschner,Marsel Ilhan,6-2; 4-6; 7-6(5),R64,137,8,1,72,110,46,72,22,38,9,12,15,68,110,5,5,51,92,37,51,20,41,1,5,15,57,92
2011-07-18 00:00:00.000,Hamburg Germany ATP World Tour 500,CLAY,2,Juan Monaco,Simone Bolelli,Juan Monaco,6-3; 7-5,R64,102,1,0,43,60,32,43,9,17,0,2,11,41,60,3,1,41,65,25,41,10,24,5,9,10,35,65
2011-07-18 00:00:00.000,Hamburg Germany ATP World Tour 500,CLAY,2,Janko Tipsarevic,N/A Bye,Janko Tipsarevic,,R64,0,0,0,0,0,0,0,0,0,0,0,0,0,0,0,0,0,0,0,0,0,0,0,0,0,0,0
2011-07-18 00:00:00.000,Hamburg Germany ATP World Tour 500,CLAY,2,Albert Montanes,N/A Bye,Albert Montanes,,R64,0,0,0,0,0,0,0,0,0,0,0,0,0,0,0,0,0,0,0,0,0,0,0,0,0,0,0
2011-07-18 00:00:00.000,Hamburg Germany ATP World Tour 500,CLAY,2,Philipp Kohlschreiber,Andrey Golubev,Philipp Kohlschreiber,7-5; 6-3,R64,97,3,4,32,63,24,32,19,31,3,4,10,43,63,3,1,36,72,24,36,18,36,6,10,11,42,72
2011-07-18 00:00:00.000,Hamburg Germany ATP World Tour 500,CLAY,2,Lukas Rosol,Potito Starace,Lukas Rosol,7-6(5); 6-1,R64,71,4,1,37,60,30,37,10,23,3,4,9,40,60,4,1,60,76,35,60,7,16,5,9,10,42,76
2011-07-18 00:00:00.000,Hamburg Germany ATP World Tour 500,CLAY,2,Nicolas Almagro,N/A Bye,Nicolas Almagro,,R64,0,0,0,0,0,0,0,0,0,0,0,0,0,0,0,0,0,0,0,0,0,0,0,0,0,0,0
2011-07-18 00:00:00.000,Hamburg Germany ATP World Tour 500,CLAY,2,Fernando Verdasco,N/A Bye,Fernando Verdasco,,R64,0,0,0,0,0,0,0,0,0,0,0,0,0,0,0,0,0,0,0,0,0,0,0,0,0,0,0
2011-07-18 00:00:00.000,Hamburg Germany ATP World Tour 500,CLAY,2,Pablo Andujar,Julien Benneteau,Pablo Andujar,6-2; 6-2,R64,80,2,1,34,53,24,34,12,19,2,2,8,36,53,2,4,40,56,24,40,4,16,4,8,8,28,56
2011-07-18 00:00:00.000,Hamburg Germany ATP World Tour 500,CLAY,2,Cedrik-Marcel Stebe,Juan Carlos Ferrero,Cedrik-Marcel Stebe,6-3; 6-2,R64,76,3,1,31,53,22,31,14,22,4,5,9,36,53,2,1,37,56,20,37,7,19,4,8,8,27,56
2011-07-18 00:00:00.000,Hamburg Germany ATP World Tour 500,CLAY,2,Nikolay Davydenko,N/A Bye,Nikolay Davydenko,,R64,0,0,0,0,0,0,0,0,0,0,0,0,0,0,0,0,0,0,0,0,0,0,0,0,0,0,0
2011-07-18 00:00:00.000,Hamburg Germany ATP World Tour 500,CLAY,2,Fabio Fognini,N/A Bye,Fabio Fognini,,R64,0,0,0,0,0,0,0,0,0,0,0,0,0,0,0,0,0,0,0,0,0,0,0,0,0,0,0
2011-07-18 00:00:00.000,Hamburg Germany ATP World Tour 500,CLAY,2,Victor Crivoi,Guillermo Olaso,Victor Crivoi,6-4; 6-3,R64,77,12,0,37,51,31,37,6,14,0,0,9,37,51,3,5,41,70,31,41,8,29,4,7,10,39,70
2011-07-18 00:00:00.000,Hamburg Germany ATP World Tour 500,CLAY,2,Daniel Gimeno-Traver,Marcel Granollers,Daniel Gimeno-Traver,6-3 RET,R64,34,1,0,13,25,11,13,9,12,0,0,5,20,25,0,0,25,28,16,25,2,3,3,4,4,18,28
2011-07-18 00:00:00.000,Hamburg Germany ATP World Tour 500,CLAY,2,Jurgen Melzer,N/A Bye,Jurgen Melzer,,R64,0,0,0,0,0,0,0,0,0,0,0,0,0,0,0,0,0,0,0,0,0,0,0,0,0,0,0
2011-07-18 00:00:00.000,Hamburg Germany ATP World Tour 500,CLAY,2,Gael Monfils,Albert Ramos,Gael Monfils,6-4; 6-2,R32,73,5,1,32,55,27,32,14,23,5,5,9,41,55,2,2,36,58,22,36,10,22,2,5,9,32,58
2011-07-18 00:00:00.000,Hamburg Germany ATP World Tour 500,CLAY,2,Radek Stepanek,Andreas Seppi,Radek Stepanek,6-1; 7-5,R32,88,2,4,36,63,24,36,16,27,3,5,10,40,63,5,1,37,60,16,37,11,23,0,5,9,27,60
2011-07-18 00:00:00.000,Hamburg Germany ATP World Tour 500,CLAY,2,Jarkko Nieminen,Alexandr Dolgopolov,Jarkko Nieminen,6-3; 1-6; 6-4,R32,86,3,1,41,69,25,41,16,28,1,5,13,41,69,12,3,45,81,31,45,15,36,3,7,13,46,81
2011-07-18 00:00:00.000,Hamburg Germany ATP World Tour 500,CLAY,2,Gilles Simon,Sergiy Stakhovsky,Gilles Simon,6-2; 6-1,R32,63,0,1,20,36,14,20,8,16,0,2,7,22,36,0,1,43,64,18,43,8,21,4,11,8,26,64
2011-07-18 00:00:00.000,Hamburg Germany ATP World Tour 500,CLAY,2,Mikhail Youzhny,Carlos Berlocq,Mikhail Youzhny,7-5; 7-6(7),R32,139,6,1,40,74,32,40,20,34,1,2,12,52,74,5,6,52,86,38,52,13,34,7,9,12,51,86
2011-07-18 00:00:00.000,Hamburg Germany ATP World Tour 500,CLAY,2,Julian Reister,Guillermo Garcia-Lopez,Julian Reister,7-6(5); 6-2,R32,107,2,2,51,76,37,51,12,25,8,10,10,49,76,3,6,40,68,27,40,9,28,3,7,10,36,68
2011-07-18 00:00:00.000,Hamburg Germany ATP World Tour 500,CLAY,2,Marin Cilic,Bastian Knittel,Marin Cilic,6-3; 6-7(4); 6-4,R32,180,16,5,69,122,54,69,26,53,10,12,16,80,122,3,6,77,119,52,77,16,42,10,14,15,68,119
2011-07-18 00:00:00.000,Hamburg Germany ATP World Tour 500,CLAY,2,Tobias Kamke,Juan Ignacio Chela,Tobias Kamke,6-1; 6-4,R32,91,0,2,36,54,27,36,10,18,2,3,9,37,54,0,1,48,71,26,48,10,23,8,12,8,36,71
2011-07-18 00:00:00.000,Hamburg Germany ATP World Tour 500,CLAY,2,Florian Mayer,Marsel Ilhan,Florian Mayer,6-4; 7-6(5),R32,88,8,1,29,59,21,29,16,30,0,3,11,37,59,2,1,56,81,38,56,6,25,5,9,11,44,81
2011-07-18 00:00:00.000,Hamburg Germany ATP World Tour 500,CLAY,2,Juan Monaco,Janko Tipsarevic,Juan Monaco,6-2; 6-4,R32,95,4,1,36,51,29,36,10,15,4,4,9,39,51,6,4,46,74,30,46,12,28,9,12,9,42,74
2011-07-18 00:00:00.000,Hamburg Germany ATP World Tour 500,CLAY,2,Philipp Kohlschreiber,Albert Montanes,Philipp Kohlschreiber,6-1; 3-2 RET,R32,46,5,1,17,31,13,17,11,14,0,0,6,24,31,0,2,33,44,21,33,2,11,8,11,6,23,44
2011-07-18 00:00:00.000,Hamburg Germany ATP World Tour 500,CLAY,2,Nicolas Almagro,Lukas Rosol,Nicolas Almagro,6-4; 6-4,R32,67,7,2,29,60,23,29,17,31,3,4,10,40,60,10,1,36,54,27,36,7,18,1,4,10,34,54
2011-07-18 00:00:00.000,Hamburg Germany ATP World Tour 500,CLAY,2,Fernando Verdasco,Pablo Andujar,Fernando Verdasco,6-2; 6-3,R32,86,1,2,45,56,23,45,6,11,3,7,9,29,56,1,1,40,62,18,40,7,22,8,15,8,25,62
2011-07-18 00:00:00.000,Hamburg Germany ATP World Tour 500,CLAY,2,Cedrik-Marcel Stebe,Nikolay Davydenko,Cedrik-Marcel Stebe,6-3; 7-6(5),R32,112,5,0,49,82,32,49,14,33,6,9,10,46,82,0,3,52,71,28,52,7,19,3,8,11,35,71
2011-07-18 00:00:00.000,Hamburg Germany ATP World Tour 500,CLAY,2,Fabio Fognini,Victor Crivoi,Fabio Fognini,6-1; 7-5,R32,81,6,2,43,56,30,43,6,13,4,6,9,36,56,3,2,38,65,21,38,8,27,3,9,10,29,65
2011-07-18 00:00:00.000,Hamburg Germany ATP World Tour 500,CLAY,2,Jurgen Melzer,Daniel Gimeno-Traver,Jurgen Melzer,6-3; 5-7; 6-1,R32,110,3,1,57,83,38,57,14,26,5,8,14,52,83,1,3,40,77,22,40,21,37,0,6,14,43,77
2011-07-18 00:00:00.000,Hamburg Germany ATP World Tour 500,CLAY,2,Gael Monfils,Radek Stepanek,Gael Monfils,6-4; 6-4,R16,83,10,3,36,66,27,36,16,30,5,6,10,43,66,2,1,38,62,26,38,11,24,5,8,10,37,62
2011-07-18 00:00:00.000,Hamburg Germany ATP World Tour 500,CLAY,2,Gilles Simon,Jarkko Nieminen,Gilles Simon,7-6(4); 3-6; 6-4,R16,140,6,1,62,97,42,62,14,35,10,16,16,56,97,1,3,61,103,39,61,20,42,4,9,15,59,103
2011-07-18 00:00:00.000,Hamburg Germany ATP World Tour 500,CLAY,2,Mikhail Youzhny,Julian Reister,Mikhail Youzhny,6-3; 6-3,R16,85,1,0,31,49,27,31,12,18,0,0,9,39,49,7,2,49,71,30,49,9,22,4,7,9,39,71
2011-07-18 00:00:00.000,Hamburg Germany ATP World Tour 500,CLAY,2,Marin Cilic,Tobias Kamke,Marin Cilic,3-6; 6-3; 6-2,R16,124,7,3,48,85,35,48,19,37,2,4,13,54,85,2,0,49,78,27,49,19,29,1,5,13,46,78
2011-07-18 00:00:00.000,Hamburg Germany ATP World Tour 500,CLAY,2,Florian Mayer,Juan Monaco,Florian Mayer,7-5; 7-5,R16,108,1,2,52,79,33,52,14,27,4,7,12,47,79,1,1,53,75,29,53,10,22,5,10,12,39,75
2011-07-18 00:00:00.000,Hamburg Germany ATP World Tour 500,CLAY,2,Nicolas Almagro,Philipp Kohlschreiber,Nicolas Almagro,6-3; 7-5,R16,85,7,1,34,54,28,34,13,20,0,1,11,41,54,6,1,30,67,22,30,17,37,8,11,10,39,67
2011-07-18 00:00:00.000,Hamburg Germany ATP World Tour 500,CLAY,2,Fernando Verdasco,Cedrik-Marcel Stebe,Fernando Verdasco,7-5; 6-2,R16,93,2,2,50,57,35,50,2,7,1,3,10,37,57,4,5,38,63,24,38,9,25,2,7,10,33,63
2011-07-18 00:00:00.000,Hamburg Germany ATP World Tour 500,CLAY,2,Jurgen Melzer,Fabio Fognini,Jurgen Melzer,6-2; 6-3,R16,71,0,0,35,49,25,35,8,14,0,0,8,33,49,0,4,33,55,22,33,6,22,2,6,9,28,55
2011-07-18 00:00:00.000,Hamburg Germany ATP World Tour 500,CLAY,2,Gilles Simon,Gael Monfils,Gilles Simon,6-4; 3-6; 6-0,Q,125,2,0,55,87,38,55,15,32,4,6,12,53,87,2,3,53,82,32,53,12,29,2,7,13,44,82
2011-07-18 00:00:00.000,Hamburg Germany ATP World Tour 500,CLAY,2,Mikhail Youzhny,Marin Cilic,Mikhail Youzhny,4-6; 6-3; 7-6(6),Q,181,2,2,79,120,51,79,21,41,2,5,16,72,120,7,3,61,100,43,61,17,39,6,9,15,60,100
2011-07-18 00:00:00.000,Hamburg Germany ATP World Tour 500,CLAY,2,Nicolas Almagro,Florian Mayer,Nicolas Almagro,7-6(5); 7-6(3),Q,108,13,1,61,86,41,61,16,25,0,1,12,57,86,5,4,64,95,48,64,13,31,5,6,12,61,95
2011-07-18 00:00:00.000,Hamburg Germany ATP World Tour 500,CLAY,2,Fernando Verdasco,Jurgen Melzer,Fernando Verdasco,6-3; 2-6; 6-4,Q,129,1,1,78,91,43,78,9,13,8,12,14,52,91,3,4,66,89,42,66,11,23,4,8,13,53,89
2011-07-18 00:00:00.000,Hamburg Germany ATP World Tour 500,CLAY,2,Gilles Simon,Mikhail Youzhny,Gilles Simon,3-6; 6-3; 6-1,S,124,6,2,50,82,35,50,14,32,10,13,12,49,82,1,0,51,74,31,51,7,23,0,6,13,38,74
2011-07-18 00:00:00.000,Hamburg Germany ATP World Tour 500,CLAY,2,Nicolas Almagro,Fernando Verdasco,Nicolas Almagro,6-4; 6-1,S,84,7,0,35,50,29,35,9,15,1,1,9,38,50,0,1,46,68,25,46,11,22,2,5,8,36,68
2011-07-18 00:00:00.000,Hamburg Germany ATP World Tour 500,CLAY,2,Gilles Simon,Nicolas Almagro,Gilles Simon,6-4; 4-6; 6-4,F,158,6,1,73,124,50,73,23,51,15,18,15,73,124,9,1,61,105,42,61,21,44,11,15,15,63,105
2011-07-25 00:00:00.000,Gstaad Switzerland ATP World Tour 250,CLAY,2,Nicolas Almagro,N/A Bye,Nicolas Almagro,,R32,0,0,0,0,0,0,0,0,0,0,0,0,0,0,0,0,0,0,0,0,0,0,0,0,0,0,0
2011-07-25 00:00:00.000,Gstaad Switzerland ATP World Tour 250,CLAY,2,Jarkko Nieminen,Victor Hanescu,Jarkko Nieminen,7-5; 6-2,R32,73,2,2,35,60,25,35,15,25,0,1,10,40,60,7,2,43,65,29,43,6,22,7,11,10,35,65
2011-07-25 00:00:00.000,Gstaad Switzerland ATP World Tour 250,CLAY,2,Daniel Gimeno-Traver,Steve Darcis,Daniel Gimeno-Traver,6-4; 5-7; 7-5,R32,148,10,4,69,110,49,69,22,41,9,12,17,71,110,4,5,61,116,38,61,30,55,12,16,17,68,116
2011-07-25 00:00:00.000,Gstaad Switzerland ATP World Tour 250,CLAY,2,Feliciano Lopez,Michael Lammer,Feliciano Lopez,6-4; 6-7(4); 6-3,R32,143,18,6,51,98,40,51,26,47,5,6,16,66,98,1,3,61,96,40,61,19,35,3,6,15,59,96
2011-07-25 00:00:00.000,Gstaad Switzerland ATP World Tour 250,CLAY,2,Fernando Verdasco,N/A Bye,Fernando Verdasco,,R32,0,0,0,0,0,0,0,0,0,0,0,0,0,0,0,0,0,0,0,0,0,0,0,0,0,0,0
2011-07-25 00:00:00.000,Gstaad Switzerland ATP World Tour 250,CLAY,2,Frederico Gil,Joao Souza,Frederico Gil,4-6; 6-3; 6-4,R32,139,4,5,53,85,35,53,14,32,4,8,15,49,85,18,4,69,108,45,69,16,39,7,12,14,61,108
2011-07-25 00:00:00.000,Gstaad Switzerland ATP World Tour 250,CLAY,2,Julien Benneteau,Lukas Rosol,Julien Benneteau,6-2; 6-7(6); 6-3,R32,123,9,3,62,104,51,62,20,42,8,8,15,71,104,7,7,62,106,44,62,21,44,5,8,14,65,106
2011-07-25 00:00:00.000,Gstaad Switzerland ATP World Tour 250,CLAY,2,Matthias Bachinger,Pablo Andujar,Matthias Bachinger,6-1; 6-4,R32,67,9,2,36,61,31,36,13,25,2,2,9,44,61,0,3,22,43,12,22,12,21,1,4,8,24,43
2011-07-25 00:00:00.000,Gstaad Switzerland ATP World Tour 250,CLAY,2,Santiago Giraldo,Guillermo Garcia-Lopez,Santiago Giraldo,5-7; 6-2; 6-1,R32,99,3,1,51,75,38,51,14,24,0,2,14,52,75,7,2,48,68,34,48,7,20,3,8,13,41,68
2011-07-25 00:00:00.000,Gstaad Switzerland ATP World Tour 250,CLAY,2,Andreas Haider-Maurer,Yann Marti,Andreas Haider-Maurer,6-1; 6-4,R32,63,6,1,35,50,29,35,9,15,4,4,9,38,50,3,4,31,55,23,31,9,24,4,7,8,32,55
2011-07-25 00:00:00.000,Gstaad Switzerland ATP World Tour 250,CLAY,2,Denis Istomin,Martin Fischer,Denis Istomin,6-3; 3-6; 6-4,R32,124,5,4,58,100,39,58,19,42,12,16,14,58,100,3,1,54,90,29,54,21,36,6,11,14,50,90
2011-07-25 00:00:00.000,Gstaad Switzerland ATP World Tour 250,CLAY,2,Mikhail Youzhny,N/A Bye,Mikhail Youzhny,,R32,0,0,0,0,0,0,0,0,0,0,0,0,0,0,0,0,0,0,0,0,0,0,0,0,0,0,0
2011-07-25 00:00:00.000,Gstaad Switzerland ATP World Tour 250,CLAY,2,Marcel Granollers,Stephane Bohli,Marcel Granollers,6-1; 6-0,R32,60,3,0,21,35,17,21,7,14,1,2,6,24,35,1,3,27,50,16,27,1,23,2,9,7,17,50
2011-07-25 00:00:00.000,Gstaad Switzerland ATP World Tour 250,CLAY,2,Igor Andreev,Mischa Zverev,Igor Andreev,6-3; 6-2,R32,70,3,2,30,59,23,30,18,29,0,0,9,41,59,3,2,35,55,20,35,10,20,6,9,8,30,55
2011-07-25 00:00:00.000,Gstaad Switzerland ATP World Tour 250,CLAY,2,Peter Luczak,Alexander Sadecky,Peter Luczak,3-6; 6-3; 7-6(4),R32,135,1,5,61,102,42,61,22,41,3,7,15,64,102,14,7,61,95,46,61,12,34,4,8,15,58,95
2011-07-25 00:00:00.000,Gstaad Switzerland ATP World Tour 250,CLAY,2,Stanislas Wawrinka,N/A Bye,Stanislas Wawrinka,,R32,0,0,0,0,0,0,0,0,0,0,0,0,0,0,0,0,0,0,0,0,0,0,0,0,0,0,0
2011-07-25 00:00:00.000,Gstaad Switzerland ATP World Tour 250,CLAY,2,Nicolas Almagro,Jarkko Nieminen,Nicolas Almagro,7-6(3); 6-3,R16,61,12,3,34,61,30,34,20,27,1,1,11,50,61,4,2,39,61,31,39,10,22,2,3,10,41,61
2011-07-25 00:00:00.000,Gstaad Switzerland ATP World Tour 250,CLAY,2,Feliciano Lopez,Daniel Gimeno-Traver,Feliciano Lopez,6-3; 6-4,R16,73,7,3,41,62,32,41,9,21,1,2,10,41,62,4,2,47,67,32,47,7,20,8,11,9,39,67
2011-07-25 00:00:00.000,Gstaad Switzerland ATP World Tour 250,CLAY,2,Fernando Verdasco,Frederico Gil,Fernando Verdasco,6-3; 6-2,R16,77,4,2,41,57,28,41,10,16,5,5,8,38,57,4,2,49,72,28,49,10,23,10,14,9,38,72
2011-07-25 00:00:00.000,Gstaad Switzerland ATP World Tour 250,CLAY,2,Julien Benneteau,Matthias Bachinger,Julien Benneteau,6-4; 6-4,R16,82,2,3,36,62,28,36,14,26,7,8,10,42,62,9,4,42,70,27,42,15,28,8,11,10,42,70
2011-07-25 00:00:00.000,Gstaad Switzerland ATP World Tour 250,CLAY,2,Andreas Haider-Maurer,Santiago Giraldo,Andreas Haider-Maurer,3-6; 6-2; 6-4,R16,111,7,6,55,88,39,55,18,33,4,6,14,57,88,6,2,60,85,36,60,15,25,3,6,13,51,85
2011-07-25 00:00:00.000,Gstaad Switzerland ATP World Tour 250,CLAY,2,Mikhail Youzhny,Denis Istomin,Mikhail Youzhny,6-3; 6-2,R16,74,0,3,29,50,20,29,14,21,2,3,9,34,50,5,2,31,58,15,31,13,27,9,13,8,28,58
2011-07-25 00:00:00.000,Gstaad Switzerland ATP World Tour 250,CLAY,2,Marcel Granollers,Igor Andreev,Marcel Granollers,6-1; 6-3,R16,78,3,3,32,55,27,32,11,23,3,3,8,38,55,2,2,22,44,12,22,9,22,0,4,8,21,44
2011-07-25 00:00:00.000,Gstaad Switzerland ATP World Tour 250,CLAY,2,Stanislas Wawrinka,Peter Luczak,Stanislas Wawrinka,6-3; 7-5,R16,83,9,4,27,58,22,27,21,31,1,2,11,43,58,1,0,40,61,28,40,6,21,4,7,10,34,61
2011-07-25 00:00:00.000,Gstaad Switzerland ATP World Tour 250,CLAY,2,Nicolas Almagro,Feliciano Lopez,Nicolas Almagro,6-4; 7-5,Q,72,8,2,37,61,34,37,15,24,3,3,11,49,61,4,2,34,60,24,34,15,26,1,3,11,39,60
2011-07-25 00:00:00.000,Gstaad Switzerland ATP World Tour 250,CLAY,2,Fernando Verdasco,Julien Benneteau,Fernando Verdasco,6-4; 5-7; 6-1,Q,132,8,4,68,89,47,68,12,21,6,8,14,59,89,5,9,51,95,35,51,19,44,4,9,15,54,95
2011-07-25 00:00:00.000,Gstaad Switzerland ATP World Tour 250,CLAY,2,Mikhail Youzhny,Andreas Haider-Maurer,Mikhail Youzhny,6-4; 5-7; 6-4,Q,140,2,2,65,96,45,65,17,31,2,5,16,62,96,3,4,53,92,39,53,21,39,5,9,16,60,92
2011-07-25 00:00:00.000,Gstaad Switzerland ATP World Tour 250,CLAY,2,Marcel Granollers,Stanislas Wawrinka,Marcel Granollers,6-3; 6-2,Q,70,1,1,27,39,22,27,6,12,0,1,8,28,39,2,0,33,54,19,33,8,21,2,7,9,27,54
2011-07-25 00:00:00.000,Gstaad Switzerland ATP World Tour 250,CLAY,2,Fernando Verdasco,Nicolas Almagro,Fernando Verdasco,6-7(2); 7-6(2); 6-3,S,130,13,8,69,112,50,69,25,43,4,5,16,75,112,10,6,64,106,54,64,18,42,3,6,17,72,106
2011-07-25 00:00:00.000,Gstaad Switzerland ATP World Tour 250,CLAY,2,Marcel Granollers,Mikhail Youzhny,Marcel Granollers,6-3; 3-6; 6-2,S,126,5,0,50,77,34,50,15,27,4,8,13,49,77,1,1,73,90,38,73,8,17,9,15,13,46,90
2011-07-25 00:00:00.000,Gstaad Switzerland ATP World Tour 250,CLAY,2,Marcel Granollers,Fernando Verdasco,Marcel Granollers,6-4; 3-6; 6-3,F,144,5,3,50,82,42,50,17,32,4,5,14,59,82,2,3,61,92,41,61,18,31,6,8,14,59,92
2011-07-25 00:00:00.000,Los Angeles CA; U.S.A. ATP World Tour 250,HARD,2,Mardy Fish,N/A Bye,Mardy Fish,,R32,0,0,0,0,0,0,0,0,0,0,0,0,0,0,0,0,0,0,0,0,0,0,0,0,0,0,0
2011-07-25 00:00:00.000,Los Angeles CA; U.S.A. ATP World Tour 250,HARD,2,Gilles Muller,Steve Johnson,Gilles Muller,2-6; 6-3; 6-4,R32,117,16,5,54,90,39,54,19,36,5,7,14,58,90,8,6,46,78,37,46,16,32,5,7,13,53,78
2011-07-25 00:00:00.000,Los Angeles CA; U.S.A. ATP World Tour 250,HARD,2,Ryan Sweeting,Somdev Devvarman,Ryan Sweeting,6-4; 7-6(6),R32,112,0,9,44,80,25,44,16,36,4,9,11,41,80,1,1,40,64,20,40,13,24,1,7,11,33,64
2011-07-25 00:00:00.000,Los Angeles CA; U.S.A. ATP World Tour 250,HARD,2,Igor Kunitsyn,Fernando Gonzalez,Igor Kunitsyn,6-4; 6-3,R32,92,4,3,29,63,23,29,20,34,5,5,9,43,63,8,5,49,87,36,49,14,38,10,13,10,50,87
2011-07-25 00:00:00.000,Los Angeles CA; U.S.A. ATP World Tour 250,HARD,2,Marcos Baghdatis,N/A Bye,Marcos Baghdatis,,R32,0,0,0,0,0,0,0,0,0,0,0,0,0,0,0,0,0,0,0,0,0,0,0,0,0,0,0
2011-07-25 00:00:00.000,Los Angeles CA; U.S.A. ATP World Tour 250,HARD,2,Yen-Hsun Lu,Robby Ginepri,Yen-Hsun Lu,6-4; 7-5,R32,97,4,3,45,69,31,45,17,24,5,6,11,48,69,3,1,43,75,27,43,17,32,9,12,11,44,75
2011-07-25 00:00:00.000,Los Angeles CA; U.S.A. ATP World Tour 250,HARD,2,Ryan Harrison,Ricardas Berankis,Ryan Harrison,6-7(4); 7-5; 6-3,R32,133,9,4,57,89,47,57,17,32,0,2,16,64,89,6,6,58,110,40,58,26,52,4,9,17,66,110
2011-07-25 00:00:00.000,Los Angeles CA; U.S.A. ATP World Tour 250,HARD,2,Michael Russell,Dmitry Tursunov,Michael Russell,6-7(5); 6-0; 6-2,R32,112,5,3,57,80,44,57,12,23,2,4,13,56,80,0,2,64,95,31,64,16,31,12,19,13,47,95
2011-07-25 00:00:00.000,Los Angeles CA; U.S.A. ATP World Tour 250,HARD,2,Grigor Dimitrov,Tommy Haas,Grigor Dimitrov,6-3; 6-2,R32,66,4,7,23,52,19,23,9,29,3,6,8,28,52,2,5,28,56,14,28,9,28,4,11,9,23,56
2011-07-25 00:00:00.000,Los Angeles CA; U.S.A. ATP World Tour 250,HARD,2,Alex Bogomolov Jr.,Greg Jones,Alex Bogomolov Jr.,4-6; 6-1; 6-1,R32,97,5,2,46,69,36,46,10,23,5,7,12,46,69,5,6,53,86,33,53,10,33,8,14,12,43,86
2011-07-25 00:00:00.000,Los Angeles CA; U.S.A. ATP World Tour 250,HARD,2,Alejandro Falla,Laurynas Grigelis,Alejandro Falla,6-2; 6-4,R32,67,1,2,24,55,19,24,21,31,1,1,9,40,55,0,4,31,55,19,31,11,24,3,6,9,30,55
2011-07-25 00:00:00.000,Los Angeles CA; U.S.A. ATP World Tour 250,HARD,2,Thomaz Bellucci,N/A Bye,Thomaz Bellucci,,R32,0,0,0,0,0,0,0,0,0,0,0,0,0,0,0,0,0,0,0,0,0,0,0,0,0,0,0
2011-07-25 00:00:00.000,Los Angeles CA; U.S.A. ATP World Tour 250,HARD,2,Ernests Gulbis,Xavier Malisse,Ernests Gulbis,2-6; 6-3; 7-6(5),R32,120,13,5,58,94,45,58,19,36,3,5,15,64,94,6,4,50,88,41,50,19,38,4,5,14,60,88
2011-07-25 00:00:00.000,Los Angeles CA; U.S.A. ATP World Tour 250,HARD,2,Daniel Kosakowski,Tim Smyczek,Daniel Kosakowski,2-6; 6-1; 6-3,R32,124,5,3,49,92,34,49,19,43,7,10,12,53,92,1,3,41,70,25,41,15,29,4,9,12,40,70
2011-07-25 00:00:00.000,Los Angeles CA; U.S.A. ATP World Tour 250,HARD,2,James Blake,Michael Berrer,James Blake,6-2; 6-3,R32,62,1,2,37,59,28,37,11,22,5,6,9,39,59,1,1,32,42,15,32,5,10,0,4,8,20,42
2011-07-25 00:00:00.000,Los Angeles CA; U.S.A. ATP World Tour 250,HARD,2,Juan Martin Del Potro,N/A Bye,Juan Martin Del Potro,,R32,0,0,0,0,0,0,0,0,0,0,0,0,0,0,0,0,0,0,0,0,0,0,0,0,0,0,0
2011-07-25 00:00:00.000,Los Angeles CA; U.S.A. ATP World Tour 250,HARD,2,Mardy Fish,Gilles Muller,Mardy Fish,7-6(1); 6-1,R16,79,6,1,42,64,34,42,12,22,3,4,10,46,64,6,4,27,56,18,27,12,29,1,4,9,30,56
2011-07-25 00:00:00.000,Los Angeles CA; U.S.A. ATP World Tour 250,HARD,2,Igor Kunitsyn,Ryan Sweeting,Igor Kunitsyn,7-6(4); 7-6(6),R16,122,4,2,39,82,25,39,23,43,1,5,12,48,82,2,8,46,88,33,46,17,42,5,9,12,50,88
2011-07-25 00:00:00.000,Los Angeles CA; U.S.A. ATP World Tour 250,HARD,2,Yen-Hsun Lu,Marcos Baghdatis,Yen-Hsun Lu,6-3; 6-4,R16,74,3,3,31,56,26,31,15,25,0,0,10,41,56,7,2,23,45,18,23,12,22,1,3,9,30,45
2011-07-25 00:00:00.000,Los Angeles CA; U.S.A. ATP World Tour 250,HARD,2,Ryan Harrison,Michael Russell,Ryan Harrison,6-3; 6-4,R16,82,7,1,33,52,27,33,11,19,1,2,10,38,52,1,2,36,61,23,36,11,25,6,9,9,34,61
2011-07-25 00:00:00.000,Los Angeles CA; U.S.A. ATP World Tour 250,HARD,2,Alex Bogomolov Jr.,Grigor Dimitrov,Alex Bogomolov Jr.,6-4; 6-3,R16,82,0,4,41,58,27,41,9,17,2,4,10,36,58,3,3,35,60,20,35,12,25,3,7,9,32,60
2011-07-25 00:00:00.000,Los Angeles CA; U.S.A. ATP World Tour 250,HARD,2,Thomaz Bellucci,Alejandro Falla,Thomaz Bellucci,6-0; 6-1,R16,53,1,3,24,37,19,24,7,13,2,2,6,26,37,0,4,35,55,18,35,3,20,10,16,7,21,55
2011-07-25 00:00:00.000,Los Angeles CA; U.S.A. ATP World Tour 250,HARD,2,Ernests Gulbis,Daniel Kosakowski,Ernests Gulbis,6-2; 6-4,R16,78,8,1,32,53,28,32,12,21,2,2,9,40,53,3,3,29,55,17,29,14,26,2,5,9,31,55
2011-07-25 00:00:00.000,Los Angeles CA; U.S.A. ATP World Tour 250,HARD,2,Juan Martin Del Potro,James Blake,Juan Martin Del Potro,6-4; 7-6(3),R16,103,6,5,40,72,34,40,15,32,1,2,11,49,72,4,2,44,80,33,44,13,36,4,6,11,46,80
2011-07-25 00:00:00.000,Los Angeles CA; U.S.A. ATP World Tour 250,HARD,2,Mardy Fish,Igor Kunitsyn,Mardy Fish,6-2; 6-4,Q,74,6,1,29,49,22,29,11,20,2,4,9,33,49,1,1,27,53,14,27,11,26,1,6,9,25,53
2011-07-25 00:00:00.000,Los Angeles CA; U.S.A. ATP World Tour 250,HARD,2,Ryan Harrison,Yen-Hsun Lu,Ryan Harrison,3-6; 6-3; 6-4,Q,144,8,4,71,114,47,71,22,43,10,12,14,69,114,2,6,45,78,30,45,20,33,2,5,14,50,78
2011-07-25 00:00:00.000,Los Angeles CA; U.S.A. ATP World Tour 250,HARD,2,Alex Bogomolov Jr.,Thomaz Bellucci,Alex Bogomolov Jr.,1-6; 6-4; 6-1,Q,122,3,2,56,81,34,56,12,25,6,10,12,46,81,6,4,47,82,32,47,12,35,7,12,12,44,82
2011-07-25 00:00:00.000,Los Angeles CA; U.S.A. ATP World Tour 250,HARD,2,Ernests Gulbis,Juan Martin Del Potro,Ernests Gulbis,6-2; 6-4,Q,97,8,1,32,54,24,32,13,22,2,3,9,37,54,2,3,34,60,18,34,12,26,2,6,9,30,60
2011-07-25 00:00:00.000,Los Angeles CA; U.S.A. ATP World Tour 250,HARD,2,Mardy Fish,Ryan Harrison,Mardy Fish,6-0; 4-6; 7-6(3),S,131,7,2,41,81,31,41,26,40,1,3,14,57,81,6,8,49,85,31,49,18,36,2,6,14,49,85
2011-07-25 00:00:00.000,Los Angeles CA; U.S.A. ATP World Tour 250,HARD,2,Ernests Gulbis,Alex Bogomolov Jr.,Ernests Gulbis,6-2; 7-6(4),S,112,11,0,35,64,29,35,17,29,0,0,10,46,64,3,0,63,81,39,63,8,18,7,9,10,47,81
2011-07-25 00:00:00.000,Los Angeles CA; U.S.A. ATP World Tour 250,HARD,2,Ernests Gulbis,Mardy Fish,Ernests Gulbis,5-7; 6-4; 6-4,F,163,10,7,60,103,43,60,24,43,3,5,16,67,103,14,1,56,93,38,56,24,37,3,6,16,62,93
2011-07-25 00:00:00.000,Umag Croatia ATP World Tour 250,CLAY,2,Juan Ignacio Chela,N/A Bye,Juan Ignacio Chela,,R32,0,0,0,0,0,0,0,0,0,0,0,0,0,0,0,0,0,0,0,0,0,0,0,0,0,0,0
2011-07-25 00:00:00.000,Umag Croatia ATP World Tour 250,CLAY,2,Potito Starace,Thiemo de Bakker,Potito Starace,6-7(5); 6-2; 6-1,R32,117,7,2,61,84,44,61,16,23,3,4,14,60,84,3,7,35,87,25,35,22,52,4,9,13,47,87
2011-07-25 00:00:00.000,Umag Croatia ATP World Tour 250,CLAY,2,Olivier Rochus,Sergiy Stakhovsky,Olivier Rochus,6-4; 6-4,R32,105,2,2,45,71,31,45,17,26,5,5,10,48,71,5,3,44,75,31,44,14,31,5,7,10,45,75
2011-07-25 00:00:00.000,Umag Croatia ATP World Tour 250,CLAY,2,Fabio Fognini,Rui Machado,Fabio Fognini,6-4; 6-3,R32,87,3,1,28,55,18,28,12,27,1,4,9,30,55,0,5,48,74,24,48,12,26,5,11,10,36,74
2011-07-25 00:00:00.000,Umag Croatia ATP World Tour 250,CLAY,2,Marin Cilic,N/A Bye,Marin Cilic,,R32,0,0,0,0,0,0,0,0,0,0,0,0,0,0,0,0,0,0,0,0,0,0,0,0,0,0,0
2011-07-25 00:00:00.000,Umag Croatia ATP World Tour 250,CLAY,2,Robin Haase,Simone Vagnozzi,Robin Haase,3-6; 6-3; 6-1,R32,122,5,3,61,100,40,61,14,39,13,18,12,54,100,0,2,59,79,30,59,8,20,1,9,13,38,79
2011-07-25 00:00:00.000,Umag Croatia ATP World Tour 250,CLAY,2,Diego Junqueira,Antonio Veic,Diego Junqueira,6-4; 7-5,R32,113,0,1,58,79,33,58,10,21,7,11,11,43,79,2,7,30,68,21,30,12,38,0,6,11,33,68
2011-07-25 00:00:00.000,Umag Croatia ATP World Tour 250,CLAY,2,Andreas Seppi,Dusan Lajovic,Andreas Seppi,6-4; 6-2,R32,84,2,1,35,57,27,35,10,22,1,2,9,37,57,2,3,49,78,27,49,13,29,8,12,9,40,78
2011-07-25 00:00:00.000,Umag Croatia ATP World Tour 250,CLAY,2,Tommy Robredo,Ruben Ramirez Hidalgo,Tommy Robredo,6-3; 6-2,R32,79,4,4,32,60,27,32,15,28,0,0,9,42,60,1,7,28,51,20,28,7,23,6,9,8,27,51
2011-07-25 00:00:00.000,Umag Croatia ATP World Tour 250,CLAY,2,Carlos Berlocq,Blaz Kavcic,Carlos Berlocq,6-4; 6-7(7); 6-4,R32,221,4,8,56,103,41,56,25,47,8,11,16,66,103,2,8,68,126,42,68,29,58,11,16,16,71,126
2011-07-25 00:00:00.000,Umag Croatia ATP World Tour 250,CLAY,2,Juan Carlos Ferrero,Maximo Gonzalez,Juan Carlos Ferrero,3-6; 6-3; 1-1 RET,R32,87,6,0,30,48,21,30,13,18,0,2,10,34,48,2,4,43,73,30,43,13,30,6,8,10,43,73
2011-07-25 00:00:00.000,Umag Croatia ATP World Tour 250,CLAY,2,Ivan Ljubicic,N/A Bye,Ivan Ljubicic,,R32,0,0,0,0,0,0,0,0,0,0,0,0,0,0,0,0,0,0,0,0,0,0,0,0,0,0,0
2011-07-25 00:00:00.000,Umag Croatia ATP World Tour 250,CLAY,2,Albert Ramos,Ivan Dodig,Albert Ramos,6-4; 3-6; 6-2,R32,156,1,2,43,81,31,43,19,38,4,7,13,50,81,6,6,51,98,40,51,15,47,8,13,14,55,98
2011-07-25 00:00:00.000,Umag Croatia ATP World Tour 250,CLAY,2,Gianluca Naso,Mate Delic,Gianluca Naso,6-4; 6-2,R32,76,4,4,22,52,22,22,16,30,4,4,9,38,52,3,0,41,68,25,41,12,27,5,8,9,37,68
2011-07-25 00:00:00.000,Umag Croatia ATP World Tour 250,CLAY,2,Filippo Volandri,Mate Pavic,Filippo Volandri,6-4; 6-0,R32,69,0,0,30,45,21,30,9,15,2,3,8,30,45,0,2,28,55,15,28,9,27,2,7,8,24,55
2011-07-25 00:00:00.000,Umag Croatia ATP World Tour 250,CLAY,2,Alexandr Dolgopolov,N/A Bye,Alexandr Dolgopolov,,R32,0,0,0,0,0,0,0,0,0,0,0,0,0,0,0,0,0,0,0,0,0,0,0,0,0,0,0
2011-07-25 00:00:00.000,Umag Croatia ATP World Tour 250,CLAY,2,Potito Starace,Juan Ignacio Chela,Potito Starace,6-4; 4-6; 7-5,R16,148,5,3,72,110,48,72,18,38,5,9,16,66,110,1,7,63,104,41,63,19,41,5,10,16,60,104
2011-07-25 00:00:00.000,Umag Croatia ATP World Tour 250,CLAY,2,Fabio Fognini,Olivier Rochus,Fabio Fognini,6-4; 6-1,R16,76,1,4,34,58,24,34,10,24,6,8,8,34,58,0,0,33,60,15,33,12,27,5,11,9,27,60
2011-07-25 00:00:00.000,Umag Croatia ATP World Tour 250,CLAY,2,Marin Cilic,Robin Haase,Marin Cilic,4-6; 6-4; 6-3,R16,142,9,2,36,92,31,36,29,56,7,9,14,60,92,5,3,58,102,40,58,20,44,6,10,15,60,102
2011-07-25 00:00:00.000,Umag Croatia ATP World Tour 250,CLAY,2,Andreas Seppi,Diego Junqueira,Andreas Seppi,7-5; 6-1,R16,89,3,4,37,72,30,37,17,35,5,6,10,47,72,0,1,45,65,23,45,12,20,9,13,9,35,65
2011-07-25 00:00:00.000,Umag Croatia ATP World Tour 250,CLAY,2,Carlos Berlocq,Tommy Robredo,Carlos Berlocq,W/O,R16,0,0,0,0,0,0,0,0,0,0,0,0,0,0,0,0,0,0,0,0,0,0,0,0,0,0,0
2011-07-25 00:00:00.000,Umag Croatia ATP World Tour 250,CLAY,2,Juan Carlos Ferrero,Ivan Ljubicic,Juan Carlos Ferrero,1-6; 6-3; 6-4,R16,115,0,2,49,75,31,49,15,26,5,9,13,46,75,7,2,27,75,18,27,26,48,6,10,13,44,75
2011-07-25 00:00:00.000,Umag Croatia ATP World Tour 250,CLAY,2,Albert Ramos,Gianluca Naso,Albert Ramos,6-1; 6-3,R16,73,4,2,29,46,22,29,12,17,4,4,8,34,46,2,1,27,53,21,27,8,26,8,12,8,29,53
2011-07-25 00:00:00.000,Umag Croatia ATP World Tour 250,CLAY,2,Alexandr Dolgopolov,Filippo Volandri,Alexandr Dolgopolov,6-1; 6-2,R16,55,5,2,16,50,13,16,22,34,5,5,8,35,50,0,3,18,37,12,18,6,19,2,6,7,18,37
2011-07-25 00:00:00.000,Umag Croatia ATP World Tour 250,CLAY,2,Fabio Fognini,Potito Starace,Fabio Fognini,3-6; 6-3; 6-1,Q,106,4,3,49,84,35,49,18,35,4,6,12,53,84,1,2,51,77,34,51,12,26,4,9,13,46,77
2011-07-25 00:00:00.000,Umag Croatia ATP World Tour 250,CLAY,2,Marin Cilic,Andreas Seppi,Marin Cilic,6-1; 6-3,Q,72,1,1,29,46,24,29,10,17,1,1,8,34,46,1,1,34,53,17,34,9,19,5,9,8,26,53
2011-07-25 00:00:00.000,Umag Croatia ATP World Tour 250,CLAY,2,Juan Carlos Ferrero,Carlos Berlocq,Juan Carlos Ferrero,6-1; 7-6(5),Q,84,0,1,38,53,21,38,6,15,2,6,9,27,53,0,2,38,58,17,38,4,20,4,11,10,21,58
2011-07-25 00:00:00.000,Umag Croatia ATP World Tour 250,CLAY,2,Alexandr Dolgopolov,Albert Ramos,Alexandr Dolgopolov,6-3; 7-5,Q,85,5,0,28,70,20,28,28,42,1,2,11,48,70,2,3,43,61,27,43,9,18,2,5,10,36,61
2011-07-25 00:00:00.000,Umag Croatia ATP World Tour 250,CLAY,2,Marin Cilic,Fabio Fognini,Marin Cilic,6-2; 6-2,S,74,2,2,29,50,22,29,11,21,2,3,8,33,50,0,8,29,57,15,29,10,28,3,8,8,25,57
2011-07-25 00:00:00.000,Umag Croatia ATP World Tour 250,CLAY,2,Alexandr Dolgopolov,Juan Carlos Ferrero,Alexandr Dolgopolov,6-4; 6-4,S,86,9,3,28,67,24,28,19,39,1,2,10,43,67,0,1,42,65,22,42,16,23,7,10,10,38,65
2011-07-25 00:00:00.000,Umag Croatia ATP World Tour 250,CLAY,2,Alexandr Dolgopolov,Marin Cilic,Alexandr Dolgopolov,6-4; 3-6; 6-3,F,134,6,1,32,74,28,32,24,42,2,4,14,52,74,4,5,52,106,35,52,27,54,9,12,14,62,106
2011-07-31 00:00:00.000,Kitzbnhel Austria ATP World Tour 250,CLAY,2,Juan Ignacio Chela,N/A Bye,Juan Ignacio Chela,,R32,0,0,0,0,0,0,0,0,0,0,0,0,0,0,0,0,0,0,0,0,0,0,0,0,0,0,0
2011-07-31 00:00:00.000,Kitzbnhel Austria ATP World Tour 250,CLAY,2,Daniel Gimeno-Traver,Dominic Thiem,Daniel Gimeno-Traver,6-4; 6-2,R32,66,2,2,24,43,22,24,11,19,0,1,9,33,43,2,5,19,53,15,19,12,34,3,7,9,27,53
2011-07-31 00:00:00.000,Kitzbnhel Austria ATP World Tour 250,CLAY,2,Antonio Veic,Andreas Haider-Maurer,Antonio Veic,6-7(3); 6-4; 6-2,R32,143,5,1,51,89,34,51,23,38,5,9,15,57,89,7,8,57,104,36,57,21,47,8,15,15,57,104
2011-07-31 00:00:00.000,Kitzbnhel Austria ATP World Tour 250,CLAY,2,Marcel Granollers,Filippo Volandri,Marcel Granollers,6-4; 6-2,R32,87,3,1,28,53,25,28,12,25,1,2,9,37,53,0,1,33,54,17,33,12,21,1,5,9,29,54
2011-07-31 00:00:00.000,Kitzbnhel Austria ATP World Tour 250,CLAY,2,Fabio Fognini,N/A Bye,Fabio Fognini,,R32,0,0,0,0,0,0,0,0,0,0,0,0,0,0,0,0,0,0,0,0,0,0,0,0,0,0,0
2011-07-31 00:00:00.000,Kitzbnhel Austria ATP World Tour 250,CLAY,2,Santiago Giraldo,Daniel Brands,Santiago Giraldo,6-3; 6-3,R32,69,4,0,40,62,33,40,12,22,6,6,9,45,62,1,3,36,54,26,36,7,18,3,6,9,33,54
2011-07-31 00:00:00.000,Kitzbnhel Austria ATP World Tour 250,CLAY,2,Albert Montanes,Javier Marti,Albert Montanes,6-3; 6-2,R32,70,1,4,34,49,27,34,6,15,2,4,9,33,49,2,4,32,55,14,32,11,23,2,7,8,25,55
2011-07-31 00:00:00.000,Kitzbnhel Austria ATP World Tour 250,CLAY,2,Philipp Kohlschreiber,Thomas Muster,Philipp Kohlschreiber,6-3; 6-0,R32,66,8,4,32,52,23,32,11,20,3,4,7,34,52,1,2,29,57,15,29,8,28,7,13,8,23,57
2011-07-31 00:00:00.000,Kitzbnhel Austria ATP World Tour 250,CLAY,2,Pablo Andujar,Lukas Rosol,Pablo Andujar,3-6; 6-3; 6-3,R32,122,6,6,59,96,39,59,19,37,9,12,13,58,96,9,4,54,90,36,54,16,36,7,12,14,52,90
2011-07-31 00:00:00.000,Kitzbnhel Austria ATP World Tour 250,CLAY,2,Albert Ramos,Igor Andreev,Albert Ramos,6-0; 6-7(2); 6-4,R32,146,6,8,59,101,44,59,18,42,9,11,14,62,101,1,4,52,91,32,52,17,39,7,13,14,49,91
2011-07-31 00:00:00.000,Kitzbnhel Austria ATP World Tour 250,CLAY,2,Joao Souza,Jerzy Janowicz,Joao Souza,6-3; 4-6; 7-6(3),R32,142,8,5,57,87,46,57,19,30,1,2,15,65,87,8,8,72,106,55,72,16,34,9,11,16,71,106
2011-07-31 00:00:00.000,Kitzbnhel Austria ATP World Tour 250,CLAY,2,Diego Junqueira,N/A Bye,Diego Junqueira,,R32,0,0,0,0,0,0,0,0,0,0,0,0,0,0,0,0,0,0,0,0,0,0,0,0,0,0,0
2011-07-31 00:00:00.000,Kitzbnhel Austria ATP World Tour 250,CLAY,2,Andreas Seppi,Denis Istomin,Andreas Seppi,6-2; 6-2,R32,61,2,2,25,48,21,25,14,23,2,2,8,35,48,1,4,33,53,19,33,7,20,7,11,8,26,53
2011-07-31 00:00:00.000,Kitzbnhel Austria ATP World Tour 250,CLAY,2,Pere Riba,Victor Hanescu,Pere Riba,7-6(3); 6-4,R32,100,9,4,46,75,34,46,14,29,6,8,11,48,75,2,3,43,68,28,43,14,25,5,8,11,42,68
2011-07-31 00:00:00.000,Kitzbnhel Austria ATP World Tour 250,CLAY,2,Robin Haase,Potito Starace,Robin Haase,6-3; 2-0 RET,R32,43,6,1,17,31,15,17,9,14,0,0,6,24,31,1,0,21,29,13,21,3,8,1,3,5,16,29
2011-07-31 00:00:00.000,Kitzbnhel Austria ATP World Tour 250,CLAY,2,Feliciano Lopez,N/A Bye,Feliciano Lopez,,R32,0,0,0,0,0,0,0,0,0,0,0,0,0,0,0,0,0,0,0,0,0,0,0,0,0,0,0
2011-07-31 00:00:00.000,Kitzbnhel Austria ATP World Tour 250,CLAY,2,Juan Ignacio Chela,Daniel Gimeno-Traver,Juan Ignacio Chela,6-4; 3-6; 6-3,R16,135,2,5,49,84,33,49,19,35,4,7,14,52,84,8,1,44,91,31,44,21,47,5,9,14,52,91
2011-07-31 00:00:00.000,Kitzbnhel Austria ATP World Tour 250,CLAY,2,Marcel Granollers,Antonio Veic,Marcel Granollers,6-0; 3-6; 6-4,R16,125,3,1,37,65,24,37,17,28,0,3,12,41,65,3,1,45,78,26,45,14,33,5,11,13,40,78
2011-07-31 00:00:00.000,Kitzbnhel Austria ATP World Tour 250,CLAY,2,Santiago Giraldo,Fabio Fognini,Santiago Giraldo,6-3; 6-4,R16,85,3,1,37,58,23,37,10,21,1,4,10,33,58,3,3,40,72,23,40,11,32,4,9,9,34,72
2011-07-31 00:00:00.000,Kitzbnhel Austria ATP World Tour 250,CLAY,2,Albert Montanes,Philipp Kohlschreiber,Albert Montanes,6-4; 7-5,R16,81,8,6,45,65,35,45,5,20,3,5,11,40,65,3,3,28,61,19,28,16,33,2,6,11,35,61
2011-07-31 00:00:00.000,Kitzbnhel Austria ATP World Tour 250,CLAY,2,Pablo Andujar,Albert Ramos,Pablo Andujar,6-2; 6-1,R16,79,0,2,31,48,20,31,12,17,2,3,8,32,48,4,0,27,53,15,27,9,26,4,9,7,24,53
2011-07-31 00:00:00.000,Kitzbnhel Austria ATP World Tour 250,CLAY,2,Joao Souza,Diego Junqueira,Joao Souza,6-2; 6-2,R16,85,4,2,30,44,23,30,10,14,1,1,8,33,44,2,2,30,49,19,30,7,19,2,6,8,26,49
2011-07-31 00:00:00.000,Kitzbnhel Austria ATP World Tour 250,CLAY,2,Andreas Seppi,Pere Riba,Andreas Seppi,7-5; 6-4,R16,91,5,5,39,69,27,39,13,30,2,5,11,40,69,2,3,28,61,19,28,13,33,3,8,11,32,61
2011-07-31 00:00:00.000,Kitzbnhel Austria ATP World Tour 250,CLAY,2,Robin Haase,Feliciano Lopez,Robin Haase,1-6; 6-4; 6-3,R16,114,5,3,34,73,21,34,26,39,0,3,13,47,73,9,3,45,71,35,45,14,26,3,6,13,49,71
2011-07-31 00:00:00.000,Kitzbnhel Austria ATP World Tour 250,CLAY,2,Juan Ignacio Chela,Marcel Granollers,Juan Ignacio Chela,6-3; 6-4,Q,96,0,1,35,50,28,35,8,15,1,2,9,36,50,3,2,46,69,30,46,8,23,6,10,10,38,69
2011-07-31 00:00:00.000,Kitzbnhel Austria ATP World Tour 250,CLAY,2,Albert Montanes,Santiago Giraldo,Albert Montanes,6-1; 7-6(0),Q,80,6,3,40,65,31,40,12,25,1,3,10,43,65,7,0,35,58,24,35,6,23,7,11,9,30,58
2011-07-31 00:00:00.000,Kitzbnhel Austria ATP World Tour 250,CLAY,2,Joao Souza,Pablo Andujar,Joao Souza,6-3; 6-4,Q,83,8,5,31,55,27,31,11,24,0,2,10,38,55,1,0,25,52,17,25,11,27,3,7,9,28,52
2011-07-31 00:00:00.000,Kitzbnhel Austria ATP World Tour 250,CLAY,2,Robin Haase,Andreas Seppi,Robin Haase,6-4; 6-2,Q,93,6,1,42,78,27,42,15,36,3,7,9,42,78,2,6,27,57,14,27,8,30,4,11,9,22,57
2011-07-31 00:00:00.000,Kitzbnhel Austria ATP World Tour 250,CLAY,2,Albert Montanes,Juan Ignacio Chela,Albert Montanes,6-2; 7-5,S,92,1,4,34,56,27,34,9,22,2,5,10,36,56,1,2,58,75,28,58,8,17,8,14,10,36,75
2011-07-31 00:00:00.000,Kitzbnhel Austria ATP World Tour 250,CLAY,2,Robin Haase,Joao Souza,Robin Haase,6-1; 6-7(3); 6-4,S,130,14,0,40,74,34,40,23,34,1,2,14,57,74,7,3,59,99,41,59,18,40,5,10,15,59,99
2011-07-31 00:00:00.000,Kitzbnhel Austria ATP World Tour 250,CLAY,2,Robin Haase,Albert Montanes,Robin Haase,6-4; 4-6; 6-1,F,121,4,4,43,93,30,43,26,50,7,10,14,56,93,3,3,34,73,24,34,18,39,5,10,13,42,73
2011-07-31 00:00:00.000,Washington DC; USA ATP World Tour 500,HARD,2,Gael Monfils,N/A Bye,Gael Monfils,,R64,0,0,0,0,0,0,0,0,0,0,0,0,0,0,0,0,0,0,0,0,0,0,0,0,0,0,0
2011-07-31 00:00:00.000,Washington DC; USA ATP World Tour 500,HARD,2,Ryan Sweeting,Alex Bogomolov Jr.,Ryan Sweeting,6-2; 6-4,R64,81,7,2,35,57,24,35,12,22,1,3,9,36,57,4,3,29,57,18,29,9,28,2,7,9,27,57
2011-07-31 00:00:00.000,Washington DC; USA ATP World Tour 500,HARD,2,Flavio Cipolla,Marsel Ilhan,Flavio Cipolla,7-5; 6-0,R64,89,0,2,35,54,22,35,12,19,2,4,9,34,54,0,2,27,58,14,27,13,31,3,9,9,27,58
2011-07-31 00:00:00.000,Washington DC; USA ATP World Tour 500,HARD,2,Dmitry Tursunov,N/A Bye,Dmitry Tursunov,,R64,0,0,0,0,0,0,0,0,0,0,0,0,0,0,0,0,0,0,0,0,0,0,0,0,0,0,0
2011-07-31 00:00:00.000,Washington DC; USA ATP World Tour 500,HARD,2,Michael Llodra,N/A Bye,Michael Llodra,,R64,0,0,0,0,0,0,0,0,0,0,0,0,0,0,0,0,0,0,0,0,0,0,0,0,0,0,0
2011-07-31 00:00:00.000,Washington DC; USA ATP World Tour 500,HARD,2,Grigor Dimitrov,Tim Smyczek,Grigor Dimitrov,4-6; 7-6(3); 7-6(3),R64,159,12,7,70,111,49,70,24,41,3,6,17,73,111,2,1,109,140,69,109,15,31,13,15,17,84,140
2011-07-31 00:00:00.000,Washington DC; USA ATP World Tour 500,HARD,2,Michael Berrer,Paolo Lorenzi,Michael Berrer,7-5; 6-1,R64,78,3,2,38,54,28,38,7,16,2,4,10,35,54,1,4,35,59,20,35,8,24,2,7,9,28,59
2011-07-31 00:00:00.000,Washington DC; USA ATP World Tour 500,HARD,2,Janko Tipsarevic,N/A Bye,Janko Tipsarevic,,R64,0,0,0,0,0,0,0,0,0,0,0,0,0,0,0,0,0,0,0,0,0,0,0,0,0,0,0
2011-07-31 00:00:00.000,Washington DC; USA ATP World Tour 500,HARD,2,Viktor Troicki,N/A Bye,Viktor Troicki,,R64,0,0,0,0,0,0,0,0,0,0,0,0,0,0,0,0,0,0,0,0,0,0,0,0,0,0,0
2011-07-31 00:00:00.000,Washington DC; USA ATP World Tour 500,HARD,2,Ryan Harrison,Mischa Zverev,Ryan Harrison,6-4; 1-6; 6-1,R64,94,2,10,41,76,28,41,19,35,1,4,12,47,76,3,3,57,86,39,57,10,29,8,12,12,49,86
2011-07-31 00:00:00.000,Washington DC; USA ATP World Tour 500,HARD,2,Chris Guccione,Alejandro Falla,Chris Guccione,7-6(3); 6-3,R64,70,11,1,36,56,35,36,12,20,3,3,10,47,56,4,5,38,67,30,38,14,29,0,2,11,44,67
2011-07-31 00:00:00.000,Washington DC; USA ATP World Tour 500,HARD,2,Kevin Anderson,N/A Bye,Kevin Anderson,,R64,0,0,0,0,0,0,0,0,0,0,0,0,0,0,0,0,0,0,0,0,0,0,0,0,0,0,0
2011-07-31 00:00:00.000,Washington DC; USA ATP World Tour 500,HARD,2,John Isner,N/A Bye,John Isner,,R64,0,0,0,0,0,0,0,0,0,0,0,0,0,0,0,0,0,0,0,0,0,0,0,0,0,0,0
2011-07-31 00:00:00.000,Washington DC; USA ATP World Tour 500,HARD,2,Tobias Kamke,Denis Kudla,Tobias Kamke,6-4; 6-2,R64,70,4,0,29,47,25,29,10,18,2,3,9,35,47,2,4,33,65,20,33,14,32,3,7,9,34,65
2011-07-31 00:00:00.000,Washington DC; USA ATP World Tour 500,HARD,2,James Blake,Tatsuma Ito,James Blake,6-3; 6-3,R64,57,3,1,34,55,25,34,14,21,5,6,9,39,55,1,3,29,56,15,29,13,27,1,5,9,28,56
2011-07-31 00:00:00.000,Washington DC; USA ATP World Tour 500,HARD,2,David Nalbandian,N/A Bye,David Nalbandian,,R64,0,0,0,0,0,0,0,0,0,0,0,0,0,0,0,0,0,0,0,0,0,0,0,0,0,0,0
2011-07-31 00:00:00.000,Washington DC; USA ATP World Tour 500,HARD,2,Marcos Baghdatis,N/A Bye,Marcos Baghdatis,,R64,0,0,0,0,0,0,0,0,0,0,0,0,0,0,0,0,0,0,0,0,0,0,0,0,0,0,0
2011-07-31 00:00:00.000,Washington DC; USA ATP World Tour 500,HARD,2,Somdev Devvarman,Denis Gremelmayr,Somdev Devvarman,6-2; 6-3,R64,59,7,3,28,48,26,28,9,20,2,3,9,35,48,1,3,15,43,8,15,12,28,0,4,8,20,43
2011-07-31 00:00:00.000,Washington DC; USA ATP World Tour 500,HARD,2,Tommy Haas,Amer Delic,Tommy Haas,6-2; 6-3,R64,63,6,3,26,48,24,26,13,22,1,1,9,37,48,8,1,32,57,20,32,12,25,3,6,8,32,57
2011-07-31 00:00:00.000,Washington DC; USA ATP World Tour 500,HARD,2,Thomaz Bellucci,N/A Bye,Thomaz Bellucci,,R64,0,0,0,0,0,0,0,0,0,0,0,0,0,0,0,0,0,0,0,0,0,0,0,0,0,0,0
2011-07-31 00:00:00.000,Washington DC; USA ATP World Tour 500,HARD,2,Xavier Malisse,N/A Bye,Xavier Malisse,,R64,0,0,0,0,0,0,0,0,0,0,0,0,0,0,0,0,0,0,0,0,0,0,0,0,0,0,0
2011-07-31 00:00:00.000,Washington DC; USA ATP World Tour 500,HARD,2,Michael Russell,Ivo Karlovic,Michael Russell,6-4; 7-6(4),R64,94,3,5,39,76,32,39,23,37,1,1,11,55,76,10,3,42,61,36,42,11,19,2,3,11,47,61
2011-07-31 00:00:00.000,Washington DC; USA ATP World Tour 500,HARD,2,Donald Young,Artem Sitak,Donald Young,6-0; 6-3,R64,64,3,1,24,35,23,24,9,11,0,0,8,32,35,2,2,24,60,12,24,15,36,7,11,7,27,60
2011-07-31 00:00:00.000,Washington DC; USA ATP World Tour 500,HARD,2,Jurgen Melzer,N/A Bye,Jurgen Melzer,,R64,0,0,0,0,0,0,0,0,0,0,0,0,0,0,0,0,0,0,0,0,0,0,0,0,0,0,0
2011-07-31 00:00:00.000,Washington DC; USA ATP World Tour 500,HARD,2,Fernando Verdasco,N/A Bye,Fernando Verdasco,,R64,0,0,0,0,0,0,0,0,0,0,0,0,0,0,0,0,0,0,0,0,0,0,0,0,0,0,0
2011-07-31 00:00:00.000,Washington DC; USA ATP World Tour 500,HARD,2,Marinko Matosevic,Ricardas Berankis,Marinko Matosevic,7-6(3); 3-6; 6-1,R64,115,3,6,42,78,35,42,16,36,2,5,14,51,78,16,9,46,107,31,46,28,61,8,12,14,59,107
2011-07-31 00:00:00.000,Washington DC; USA ATP World Tour 500,HARD,2,Matthew Ebden,Rajeev Ram,Matthew Ebden,6-1; 3-2 RET,R64,48,2,2,19,31,17,19,6,12,0,1,6,23,31,0,1,30,50,16,30,7,20,2,6,6,23,50
2011-07-31 00:00:00.000,Washington DC; USA ATP World Tour 500,HARD,2,Nikolay Davydenko,N/A Bye,Nikolay Davydenko,,R64,0,0,0,0,0,0,0,0,0,0,0,0,0,0,0,0,0,0,0,0,0,0,0,0,0,0,0
2011-07-31 00:00:00.000,Washington DC; USA ATP World Tour 500,HARD,2,Jarkko Nieminen,N/A Bye,Jarkko Nieminen,,R64,0,0,0,0,0,0,0,0,0,0,0,0,0,0,0,0,0,0,0,0,0,0,0,0,0,0,0
2011-07-31 00:00:00.000,Washington DC; USA ATP World Tour 500,HARD,2,Igor Kunitsyn,Gilles Muller,Igor Kunitsyn,6-4; 3-6; 7-6(5),R64,114,10,2,49,84,42,49,21,35,1,2,15,63,84,18,2,54,91,42,54,24,37,0,1,16,66,91
2011-07-31 00:00:00.000,Washington DC; USA ATP World Tour 500,HARD,2,Radek Stepanek,Philipp Petzschner,Radek Stepanek,6-7(2); 6-4; 6-0,R64,132,5,5,48,78,41,48,19,30,1,1,14,60,78,10,7,42,108,34,42,30,66,7,11,14,64,108
2011-07-31 00:00:00.000,Washington DC; USA ATP World Tour 500,HARD,2,Wayne Odesnik,N/A Bye,Wayne Odesnik,,R64,0,0,0,0,0,0,0,0,0,0,0,0,0,0,0,0,0,0,0,0,0,0,0,0,0,0,0
2011-07-31 00:00:00.000,Washington DC; USA ATP World Tour 500,HARD,2,Gael Monfils,Ryan Sweeting,Gael Monfils,6-3; 7-6(3),R32,85,17,3,47,66,39,47,8,19,1,2,11,47,66,2,4,41,75,25,41,20,34,3,5,10,45,75
2011-07-31 00:00:00.000,Washington DC; USA ATP World Tour 500,HARD,2,Dmitry Tursunov,Flavio Cipolla,Dmitry Tursunov,6-1; 6-4,R32,77,3,5,26,49,22,26,13,23,1,2,9,35,49,0,2,21,53,12,21,15,32,6,10,8,27,53
2011-07-31 00:00:00.000,Washington DC; USA ATP World Tour 500,HARD,2,Grigor Dimitrov,Michael Llodra,Grigor Dimitrov,4-3 RET,R32,31,2,1,12,26,6,12,10,14,3,3,3,16,26,1,2,11,21,6,11,7,10,0,1,4,13,21
2011-07-31 00:00:00.000,Washington DC; USA ATP World Tour 500,HARD,2,Janko Tipsarevic,Michael Berrer,Janko Tipsarevic,6-3; 6-4,R32,83,6,3,32,53,25,32,15,21,0,0,10,40,53,7,1,45,73,30,45,12,28,8,10,9,42,73
2011-07-31 00:00:00.000,Washington DC; USA ATP World Tour 500,HARD,2,Viktor Troicki,Ryan Harrison,Viktor Troicki,7-5; 6-2,R32,77,13,3,34,66,26,34,19,32,3,4,10,45,66,0,3,29,51,17,29,11,22,2,6,10,28,51
2011-07-31 00:00:00.000,Washington DC; USA ATP World Tour 500,HARD,2,Kevin Anderson,Chris Guccione,Kevin Anderson,3-6; 6-2; 7-6(0),R32,124,13,1,61,93,47,61,18,32,0,2,15,65,93,9,4,51,95,37,51,22,44,6,8,14,59,95
2011-07-31 00:00:00.000,Washington DC; USA ATP World Tour 500,HARD,2,John Isner,Tobias Kamke,John Isner,6-1; 6-3,R32,66,6,1,29,45,26,29,8,16,3,3,8,34,45,0,3,32,56,18,32,10,24,10,14,8,28,56
2011-07-31 00:00:00.000,Washington DC; USA ATP World Tour 500,HARD,2,James Blake,David Nalbandian,James Blake,6-2; 6-4,R32,73,7,3,39,62,31,39,12,23,3,3,9,43,62,1,3,31,63,23,31,12,32,4,7,9,35,63
2011-07-31 00:00:00.000,Washington DC; USA ATP World Tour 500,HARD,2,Marcos Baghdatis,Somdev Devvarman,Marcos Baghdatis,6-2; 0-6; 7-5,R32,123,6,6,41,87,29,41,23,46,7,11,13,52,87,1,1,49,93,32,49,21,44,9,13,13,53,93
2011-07-31 00:00:00.000,Washington DC; USA ATP World Tour 500,HARD,2,Thomaz Bellucci,Tommy Haas,Thomaz Bellucci,7-6(3); 3-6; 6-3,R32,147,9,8,73,116,52,73,12,43,10,16,15,64,116,4,7,58,99,36,58,20,41,5,11,15,56,99
2011-07-31 00:00:00.000,Washington DC; USA ATP World Tour 500,HARD,2,Michael Russell,Xavier Malisse,Michael Russell,7-6(4); 2-3 RET,R32,73,5,3,31,49,24,31,8,18,0,2,8,32,49,4,2,28,63,20,28,20,35,4,6,9,40,63
2011-07-31 00:00:00.000,Washington DC; USA ATP World Tour 500,HARD,2,Donald Young,Jurgen Melzer,Donald Young,6-7(6); 6-4; 3-1 RET,R32,117,8,6,57,85,39,57,16,28,4,6,13,55,85,1,5,50,91,31,50,21,41,6,10,13,52,91
2011-07-31 00:00:00.000,Washington DC; USA ATP World Tour 500,HARD,2,Fernando Verdasco,Marinko Matosevic,Fernando Verdasco,6-4; 6-4,R32,88,3,6,36,54,28,36,11,18,3,4,10,39,54,2,1,47,79,28,47,16,32,3,6,10,44,79
2011-07-31 00:00:00.000,Washington DC; USA ATP World Tour 500,HARD,2,Nikolay Davydenko,Matthew Ebden,Nikolay Davydenko,6-3; 7-5,R32,90,3,6,46,65,36,46,11,19,3,4,11,47,65,4,4,38,66,24,38,15,28,2,5,10,39,66
2011-07-31 00:00:00.000,Washington DC; USA ATP World Tour 500,HARD,2,Jarkko Nieminen,Igor Kunitsyn,Jarkko Nieminen,7-5; 6-4,R32,91,4,3,40,64,27,40,14,24,2,4,11,41,64,4,4,35,70,18,35,18,35,2,6,11,36,70
2011-07-31 00:00:00.000,Washington DC; USA ATP World Tour 500,HARD,2,Radek Stepanek,Wayne Odesnik,Radek Stepanek,6-1; 6-1,R32,57,1,1,24,35,22,24,6,11,0,0,7,28,35,2,2,28,40,14,28,2,12,2,7,7,16,40
2011-07-31 00:00:00.000,Washington DC; USA ATP World Tour 500,HARD,2,Gael Monfils,Dmitry Tursunov,Gael Monfils,6-2; 7-6(9),R16,100,8,1,40,66,32,40,17,26,3,4,10,49,66,3,4,45,74,32,45,12,29,4,7,10,44,74
2011-07-31 00:00:00.000,Washington DC; USA ATP World Tour 500,HARD,2,Janko Tipsarevic,Grigor Dimitrov,Janko Tipsarevic,6-4; 6-2,R16,75,2,0,23,46,20,23,15,23,1,2,9,35,46,1,4,31,60,18,31,14,29,3,7,9,32,60
2011-07-31 00:00:00.000,Washington DC; USA ATP World Tour 500,HARD,2,Viktor Troicki,Kevin Anderson,Viktor Troicki,6-3; 6-3,R16,68,5,3,29,51,25,29,11,22,3,4,9,36,51,4,0,35,53,21,35,8,18,2,6,9,29,53
2011-07-31 00:00:00.000,Washington DC; USA ATP World Tour 500,HARD,2,John Isner,James Blake,John Isner,7-6(0); 1-6; 7-6(4),R16,133,13,7,71,110,47,71,23,39,5,8,15,70,110,11,7,57,105,46,57,26,48,4,5,16,72,105
2011-07-31 00:00:00.000,Washington DC; USA ATP World Tour 500,HARD,2,Marcos Baghdatis,Thomaz Bellucci,Marcos Baghdatis,3-6; 6-3; 6-2,R16,99,15,2,40,70,33,40,18,30,2,4,13,51,70,4,6,50,81,34,50,11,31,4,8,13,45,81
2011-07-31 00:00:00.000,Washington DC; USA ATP World Tour 500,HARD,2,Donald Young,Michael Russell,Donald Young,6-3; 6-3,R16,81,2,2,30,50,21,30,13,20,3,4,9,34,50,1,3,32,57,20,32,9,25,1,5,9,29,57
2011-07-31 00:00:00.000,Washington DC; USA ATP World Tour 500,HARD,2,Fernando Verdasco,Nikolay Davydenko,Fernando Verdasco,6-4; 7-5,R16,93,4,3,44,73,32,44,15,29,7,8,11,47,73,0,5,39,63,28,39,10,24,1,4,11,38,63
2011-07-31 00:00:00.000,Washington DC; USA ATP World Tour 500,HARD,2,Radek Stepanek,Jarkko Nieminen,Radek Stepanek,6-4; 3-6; 6-2,R16,127,9,2,59,85,40,59,13,26,9,12,13,53,85,3,6,55,97,35,55,20,42,9,14,14,55,97
2011-07-31 00:00:00.000,Washington DC; USA ATP World Tour 500,HARD,2,Gael Monfils,Janko Tipsarevic,Gael Monfils,6-4; 6-4,Q,94,4,6,35,62,31,35,12,27,1,2,10,43,62,0,3,39,77,23,39,18,38,3,6,10,41,77
2011-07-31 00:00:00.000,Washington DC; USA ATP World Tour 500,HARD,2,John Isner,Viktor Troicki,John Isner,7-6(5); 3-6; 6-1,Q,106,10,2,63,80,51,63,8,17,1,3,14,59,80,10,4,42,82,33,42,24,40,2,5,14,57,82
2011-07-31 00:00:00.000,Washington DC; USA ATP World Tour 500,HARD,2,Donald Young,Marcos Baghdatis,Donald Young,6-3; 7-6(4),Q,87,2,3,45,69,34,45,9,24,3,5,11,43,69,4,1,21,56,17,21,17,35,0,3,10,34,56
2011-07-31 00:00:00.000,Washington DC; USA ATP World Tour 500,HARD,2,Radek Stepanek,Fernando Verdasco,Radek Stepanek,6-4; 6-4,Q,111,1,4,35,72,24,35,21,37,7,8,10,45,72,8,5,52,75,33,52,8,23,7,10,10,41,75
2011-07-31 00:00:00.000,Washington DC; USA ATP World Tour 500,HARD,2,Gael Monfils,John Isner,Gael Monfils,6-4; 3-6; 7-6(6),S,147,12,3,61,96,46,61,23,35,1,2,15,69,96,19,0,74,111,55,74,22,37,5,6,16,77,111
2011-07-31 00:00:00.000,Washington DC; USA ATP World Tour 500,HARD,2,Radek Stepanek,Donald Young,Radek Stepanek,6-3; 6-3,S,79,3,0,29,55,23,29,18,26,2,2,9,41,55,1,0,31,48,20,31,8,17,1,4,9,28,48
2011-07-31 00:00:00.000,Washington DC; USA ATP World Tour 500,HARD,2,Radek Stepanek,Gael Monfils,Radek Stepanek,6-4; 6-4,F,93,2,2,21,56,19,21,22,35,0,0,10,41,56,8,4,34,52,26,34,10,18,0,2,10,36,52
2011-08-08 00:00:00.000,ATP World Tour Masters 1000 Canada Montreal; Canada ATP World Tour Masters 1000,HARD,2,Novak Djokovic,N/A Bye,Novak Djokovic,,R64,0,0,0,0,0,0,0,0,0,0,0,0,0,0,0,0,0,0,0,0,0,0,0,0,0,0,0
2011-08-08 00:00:00.000,ATP World Tour Masters 1000 Canada Montreal; Canada ATP World Tour Masters 1000,HARD,2,Nikolay Davydenko,Flavio Cipolla,Nikolay Davydenko,6-3; 6-3,R64,94,2,5,47,66,30,47,9,19,3,5,9,39,66,0,3,38,60,19,38,9,22,2,7,9,28,60
2011-08-08 00:00:00.000,ATP World Tour Masters 1000 Canada Montreal; Canada ATP World Tour Masters 1000,HARD,2,Marin Cilic,Andreas Seppi,Marin Cilic,7-5; 6-4,R64,92,8,4,32,60,27,32,15,28,0,2,11,42,60,3,7,40,81,25,40,19,41,6,10,11,44,81
2011-08-08 00:00:00.000,ATP World Tour Masters 1000 Canada Montreal; Canada ATP World Tour Masters 1000,HARD,2,Juan Martin Del Potro,Jarkko Nieminen,Juan Martin Del Potro,6-4; 6-0,R64,69,13,3,33,49,26,33,10,16,3,3,8,36,49,3,2,22,49,12,22,11,27,3,7,8,23,49
2011-08-08 00:00:00.000,ATP World Tour Masters 1000 Canada Montreal; Canada ATP World Tour Masters 1000,HARD,2,Viktor Troicki,Michael Yani,Viktor Troicki,2-6; 6-3; 6-1,R64,84,11,2,40,72,34,40,15,32,2,4,12,49,72,4,4,45,71,27,45,13,26,4,8,12,40,71
2011-08-08 00:00:00.000,ATP World Tour Masters 1000 Canada Montreal; Canada ATP World Tour Masters 1000,HARD,2,John Isner,Marcos Baghdatis,John Isner,6-3; 6-4,R64,73,8,0,38,53,32,38,9,15,0,0,10,41,53,4,1,24,49,18,24,14,25,1,3,9,32,49
2011-08-08 00:00:00.000,ATP World Tour Masters 1000 Canada Montreal; Canada ATP World Tour Masters 1000,HARD,2,Alex Bogomolov Jr.,Adrian Mannarino,Alex Bogomolov Jr.,6-2; 7-6(4),R64,81,8,1,40,54,36,40,9,14,1,1,10,45,54,3,3,44,72,32,44,12,28,2,4,10,44,72
2011-08-08 00:00:00.000,ATP World Tour Masters 1000 Canada Montreal; Canada ATP World Tour Masters 1000,HARD,2,Gael Monfils,N/A Bye,Gael Monfils,,R64,0,0,0,0,0,0,0,0,0,0,0,0,0,0,0,0,0,0,0,0,0,0,0,0,0,0,0
2011-08-08 00:00:00.000,ATP World Tour Masters 1000 Canada Montreal; Canada ATP World Tour Masters 1000,HARD,2,Roger Federer,N/A Bye,Roger Federer,,R64,0,0,0,0,0,0,0,0,0,0,0,0,0,0,0,0,0,0,0,0,0,0,0,0,0,0,0
2011-08-08 00:00:00.000,ATP World Tour Masters 1000 Canada Montreal; Canada ATP World Tour Masters 1000,HARD,2,Vasek Pospisil,Juan Ignacio Chela,Vasek Pospisil,4-6; 6-3; 6-4,R64,143,7,5,49,99,38,49,24,50,5,7,15,62,99,0,5,42,82,32,42,21,40,2,5,14,53,82
2011-08-08 00:00:00.000,ATP World Tour Masters 1000 Canada Montreal; Canada ATP World Tour Masters 1000,HARD,2,Bernard Tomic,Yen-Hsun Lu,Bernard Tomic,7-6(5); 6-3,R64,103,7,2,55,92,42,55,14,37,8,10,11,56,92,5,4,39,72,25,39,16,33,1,4,10,41,72
2011-08-08 00:00:00.000,ATP World Tour Masters 1000 Canada Montreal; Canada ATP World Tour Masters 1000,HARD,2,Jo-Wilfried Tsonga,Fabio Fognini,Jo-Wilfried Tsonga,6-4; 7-6(0),R64,95,5,3,29,57,21,29,19,28,1,3,11,40,57,3,5,40,75,26,40,16,35,6,9,11,42,75
2011-08-08 00:00:00.000,ATP World Tour Masters 1000 Canada Montreal; Canada ATP World Tour Masters 1000,HARD,2,Richard Gasquet,Florian Mayer,Richard Gasquet,6-3; 6-2,R64,70,6,2,33,62,27,33,15,29,5,5,9,42,62,2,2,19,43,12,19,11,24,3,6,8,23,43
2011-08-08 00:00:00.000,ATP World Tour Masters 1000 Canada Montreal; Canada ATP World Tour Masters 1000,HARD,2,Thomaz Bellucci,Andrey Golubev,Thomaz Bellucci,7-5; 7-6(6),R64,107,11,2,47,75,38,47,14,28,5,7,12,52,75,3,7,52,89,34,52,18,37,5,8,12,52,89
2011-08-08 00:00:00.000,ATP World Tour Masters 1000 Canada Montreal; Canada ATP World Tour Masters 1000,HARD,2,Sergiy Stakhovsky,Philipp Kohlschreiber,Sergiy Stakhovsky,6-2; 7-5,R64,99,15,5,43,74,37,43,12,31,6,6,10,49,74,6,4,39,82,25,39,21,43,7,10,10,46,82
2011-08-08 00:00:00.000,ATP World Tour Masters 1000 Canada Montreal; Canada ATP World Tour Masters 1000,HARD,2,Nicolas Almagro,N/A Bye,Nicolas Almagro,,R64,0,0,0,0,0,0,0,0,0,0,0,0,0,0,0,0,0,0,0,0,0,0,0,0,0,0,0
2011-08-08 00:00:00.000,ATP World Tour Masters 1000 Canada Montreal; Canada ATP World Tour Masters 1000,HARD,2,Mardy Fish,N/A Bye,Mardy Fish,,R64,0,0,0,0,0,0,0,0,0,0,0,0,0,0,0,0,0,0,0,0,0,0,0,0,0,0,0
2011-08-08 00:00:00.000,ATP World Tour Masters 1000 Canada Montreal; Canada ATP World Tour Masters 1000,HARD,2,Feliciano Lopez,Radek Stepanek,Feliciano Lopez,6-4; 4-6; 6-4,R64,131,7,4,52,94,42,52,19,42,9,11,15,61,94,2,3,43,80,31,43,23,37,1,4,15,54,80
2011-08-08 00:00:00.000,ATP World Tour Masters 1000 Canada Montreal; Canada ATP World Tour Masters 1000,HARD,2,Ernests Gulbis,Juan Carlos Ferrero,Ernests Gulbis,3-6; 6-1; 7-5,R64,134,13,5,56,89,44,56,18,33,4,5,14,62,89,2,3,57,94,37,57,21,37,2,5,14,58,94
2011-08-08 00:00:00.000,ATP World Tour Masters 1000 Canada Montreal; Canada ATP World Tour Masters 1000,HARD,2,Michael Llodra,Mikhail Youzhny,Michael Llodra,3-6; 6-3; 7-6(4),R64,128,10,2,60,94,45,60,22,34,3,5,15,67,94,8,5,61,101,45,61,23,40,5,7,15,68,101
2011-08-08 00:00:00.000,ATP World Tour Masters 1000 Canada Montreal; Canada ATP World Tour Masters 1000,HARD,2,Stanislas Wawrinka,David Nalbandian,Stanislas Wawrinka,6-1; 6-4,R64,69,8,3,21,45,17,21,16,24,1,2,9,33,45,1,5,23,53,16,23,11,30,4,8,8,27,53
2011-08-08 00:00:00.000,ATP World Tour Masters 1000 Canada Montreal; Canada ATP World Tour Masters 1000,HARD,2,Michael Russell,Albert Montanes,Michael Russell,7-5; 6-2,R64,79,3,4,36,57,27,36,10,21,0,2,10,37,57,1,4,32,64,19,32,12,32,7,12,10,31,64
2011-08-08 00:00:00.000,ATP World Tour Masters 1000 Canada Montreal; Canada ATP World Tour Masters 1000,HARD,2,Kevin Anderson,Pablo Andujar,Kevin Anderson,6-4; 6-4,R64,92,11,3,36,58,24,36,15,22,4,5,10,39,58,0,4,35,62,26,35,10,27,2,5,10,36,62
2011-08-08 00:00:00.000,ATP World Tour Masters 1000 Canada Montreal; Canada ATP World Tour Masters 1000,HARD,2,Andy Murray,N/A Bye,Andy Murray,,R64,0,0,0,0,0,0,0,0,0,0,0,0,0,0,0,0,0,0,0,0,0,0,0,0,0,0,0
2011-08-08 00:00:00.000,ATP World Tour Masters 1000 Canada Montreal; Canada ATP World Tour Masters 1000,HARD,2,Tomas Berdych,N/A Bye,Tomas Berdych,,R64,0,0,0,0,0,0,0,0,0,0,0,0,0,0,0,0,0,0,0,0,0,0,0,0,0,0,0
2011-08-08 00:00:00.000,ATP World Tour Masters 1000 Canada Montreal; Canada ATP World Tour Masters 1000,HARD,2,Alexandr Dolgopolov,Erik Chvojka,Alexandr Dolgopolov,6-3; 5-7; 6-4,R64,133,12,4,43,86,36,43,25,43,1,3,16,61,86,7,7,75,116,57,75,12,41,14,17,15,69,116
2011-08-08 00:00:00.000,ATP World Tour Masters 1000 Canada Montreal; Canada ATP World Tour Masters 1000,HARD,2,Ivo Karlovic,Juan Monaco,Ivo Karlovic,6-7(2); 6-3; 7-6(5),R64,154,15,2,68,101,55,68,20,33,0,1,17,75,101,2,2,80,112,60,80,18,32,7,9,16,78,112
2011-08-08 00:00:00.000,ATP World Tour Masters 1000 Canada Montreal; Canada ATP World Tour Masters 1000,HARD,2,Philipp Petzschner,Gilles Simon,Philipp Petzschner,7-5; 6-2,R64,90,5,2,33,58,27,33,13,25,7,8,10,40,58,2,5,32,70,21,32,17,38,5,9,10,38,70
2011-08-08 00:00:00.000,ATP World Tour Masters 1000 Canada Montreal; Canada ATP World Tour Masters 1000,HARD,2,Fernando Verdasco,Tobias Kamke,Fernando Verdasco,5-7; 6-3; 6-3,R64,126,3,5,64,92,47,64,16,28,5,6,15,63,92,2,5,59,98,43,59,18,39,6,9,15,61,98
2011-08-08 00:00:00.000,ATP World Tour Masters 1000 Canada Montreal; Canada ATP World Tour Masters 1000,HARD,2,Janko Tipsarevic,Alejandro Falla,Janko Tipsarevic,7-5; 6-1,R64,78,5,3,29,58,24,29,18,29,0,0,10,42,58,1,5,28,65,20,28,17,37,7,10,9,37,65
2011-08-08 00:00:00.000,ATP World Tour Masters 1000 Canada Montreal; Canada ATP World Tour Masters 1000,HARD,2,Ivan Dodig,Jeremy Chardy,Ivan Dodig,6-3; 6-4,R64,82,11,4,32,56,27,32,15,24,0,0,10,42,56,9,4,29,56,23,29,11,27,1,3,9,34,56
2011-08-08 00:00:00.000,ATP World Tour Masters 1000 Canada Montreal; Canada ATP World Tour Masters 1000,HARD,2,Rafael Nadal,N/A Bye,Rafael Nadal,,R64,0,0,0,0,0,0,0,0,0,0,0,0,0,0,0,0,0,0,0,0,0,0,0,0,0,0,0
2011-08-08 00:00:00.000,ATP World Tour Masters 1000 Canada Montreal; Canada ATP World Tour Masters 1000,HARD,2,Novak Djokovic,Nikolay Davydenko,Novak Djokovic,7-5; 6-1,R32,96,2,3,38,60,20,38,12,22,4,8,10,32,60,1,4,51,67,24,51,4,16,7,14,9,28,67
2011-08-08 00:00:00.000,ATP World Tour Masters 1000 Canada Montreal; Canada ATP World Tour Masters 1000,HARD,2,Marin Cilic,Juan Martin Del Potro,Marin Cilic,6-3; 6-4,R32,84,4,4,28,51,26,28,15,23,0,0,10,41,51,5,0,28,48,21,28,11,20,0,2,9,32,48
2011-08-08 00:00:00.000,ATP World Tour Masters 1000 Canada Montreal; Canada ATP World Tour Masters 1000,HARD,2,Viktor Troicki,John Isner,Viktor Troicki,6-4; 3-6; 6-2,R32,107,9,3,46,79,36,46,18,33,8,10,13,54,79,4,4,57,83,36,57,12,26,1,5,14,48,83
2011-08-08 00:00:00.000,ATP World Tour Masters 1000 Canada Montreal; Canada ATP World Tour Masters 1000,HARD,2,Gael Monfils,Alex Bogomolov Jr.,Gael Monfils,6-2; 7-6(5),R32,96,6,2,30,65,28,30,19,35,0,0,10,47,65,5,3,35,65,26,35,17,30,3,5,10,43,65
2011-08-08 00:00:00.000,ATP World Tour Masters 1000 Canada Montreal; Canada ATP World Tour Masters 1000,HARD,2,Roger Federer,Vasek Pospisil,Roger Federer,7-5; 6-3,R32,78,4,0,30,52,25,30,19,22,0,0,11,44,52,8,4,35,64,24,35,15,29,0,2,10,39,64
2011-08-08 00:00:00.000,ATP World Tour Masters 1000 Canada Montreal; Canada ATP World Tour Masters 1000,HARD,2,Jo-Wilfried Tsonga,Bernard Tomic,Jo-Wilfried Tsonga,6-3; 7-6(1),R32,78,15,4,33,60,30,33,17,27,1,2,11,47,60,0,1,48,71,33,48,10,23,5,7,10,43,71
2011-08-08 00:00:00.000,ATP World Tour Masters 1000 Canada Montreal; Canada ATP World Tour Masters 1000,HARD,2,Richard Gasquet,Thomaz Bellucci,Richard Gasquet,6-1; 6-4,R32,79,4,2,27,52,22,27,16,25,3,3,9,38,52,1,1,36,61,23,36,10,25,4,7,8,33,61
2011-08-08 00:00:00.000,ATP World Tour Masters 1000 Canada Montreal; Canada ATP World Tour Masters 1000,HARD,2,Nicolas Almagro,Sergiy Stakhovsky,Nicolas Almagro,6-2; 7-6(5),R32,86,7,0,36,57,30,36,15,21,2,3,10,45,57,5,5,39,78,26,39,18,39,7,10,10,44,78
2011-08-08 00:00:00.000,ATP World Tour Masters 1000 Canada Montreal; Canada ATP World Tour Masters 1000,HARD,2,Mardy Fish,Feliciano Lopez,Mardy Fish,6-2; 6-3,R32,67,9,1,32,54,27,32,13,22,2,2,9,40,54,4,2,28,51,17,28,12,23,7,10,8,29,51
2011-08-08 00:00:00.000,ATP World Tour Masters 1000 Canada Montreal; Canada ATP World Tour Masters 1000,HARD,2,Ernests Gulbis,Michael Llodra,Ernests Gulbis,6-4; 1-0 RET,R32,51,2,1,14,24,13,14,7,10,0,0,5,20,24,3,5,36,57,24,36,7,21,9,11,6,31,57
2011-08-08 00:00:00.000,ATP World Tour Masters 1000 Canada Montreal; Canada ATP World Tour Masters 1000,HARD,2,Stanislas Wawrinka,Michael Russell,Stanislas Wawrinka,6-3; 6-2,R32,72,4,3,32,61,26,32,17,29,2,2,9,43,61,1,9,20,48,15,20,10,28,3,6,8,25,48
2011-08-08 00:00:00.000,ATP World Tour Masters 1000 Canada Montreal; Canada ATP World Tour Masters 1000,HARD,2,Kevin Anderson,Andy Murray,Kevin Anderson,6-3; 6-1,R32,70,5,2,30,46,26,30,9,16,2,2,8,35,46,3,5,22,46,15,22,8,24,1,5,8,23,46
2011-08-08 00:00:00.000,ATP World Tour Masters 1000 Canada Montreal; Canada ATP World Tour Masters 1000,HARD,2,Tomas Berdych,Alexandr Dolgopolov,Tomas Berdych,4-6; 6-2; 6-3,R32,103,9,6,51,84,39,51,15,33,4,6,14,54,84,11,4,34,75,25,34,22,41,2,6,13,47,75
2011-08-08 00:00:00.000,ATP World Tour Masters 1000 Canada Montreal; Canada ATP World Tour Masters 1000,HARD,2,Ivo Karlovic,Philipp Petzschner,Ivo Karlovic,6-7(0); 7-6(2); 7-6(6),R32,175,17,2,71,114,60,71,24,43,4,5,18,84,114,9,7,62,131,47,62,42,69,1,2,18,89,131
2011-08-08 00:00:00.000,ATP World Tour Masters 1000 Canada Montreal; Canada ATP World Tour Masters 1000,HARD,2,Janko Tipsarevic,Fernando Verdasco,Janko Tipsarevic,6-4; 6-7(5); 6-3,R32,178,4,12,67,120,48,67,20,53,1,5,16,68,120,4,15,82,124,53,82,13,42,16,22,15,66,124
2011-08-08 00:00:00.000,ATP World Tour Masters 1000 Canada Montreal; Canada ATP World Tour Masters 1000,HARD,2,Ivan Dodig,Rafael Nadal,Ivan Dodig,1-6; 7-6(5); 7-6(5),R32,189,19,3,67,116,46,67,23,49,6,11,15,69,116,7,2,56,107,42,56,28,51,1,4,16,70,107
2011-08-08 00:00:00.000,ATP World Tour Masters 1000 Canada Montreal; Canada ATP World Tour Masters 1000,HARD,2,Novak Djokovic,Marin Cilic,Novak Djokovic,7-5; 6-2,R16,95,1,1,48,66,37,48,9,18,3,3,10,46,66,6,4,34,57,21,34,14,23,4,7,10,35,57
2011-08-08 00:00:00.000,ATP World Tour Masters 1000 Canada Montreal; Canada ATP World Tour Masters 1000,HARD,2,Gael Monfils,Viktor Troicki,Gael Monfils,3-6; 7-6(0); 7-6(5),R16,156,3,2,73,122,49,73,31,49,8,12,17,80,122,3,4,58,95,49,58,17,37,2,4,16,66,95
2011-08-08 00:00:00.000,ATP World Tour Masters 1000 Canada Montreal; Canada ATP World Tour Masters 1000,HARD,2,Jo-Wilfried Tsonga,Roger Federer,Jo-Wilfried Tsonga,7-6(3); 4-6; 6-1,R16,134,7,2,52,91,40,52,25,39,3,4,15,65,91,10,2,58,93,43,58,16,35,7,9,14,59,93
2011-08-08 00:00:00.000,ATP World Tour Masters 1000 Canada Montreal; Canada ATP World Tour Masters 1000,HARD,2,Nicolas Almagro,Richard Gasquet,Nicolas Almagro,7-6(5); 6-3,R16,106,6,2,42,83,27,42,23,41,11,13,11,50,83,5,6,40,70,27,40,12,30,3,6,10,39,70
2011-08-08 00:00:00.000,ATP World Tour Masters 1000 Canada Montreal; Canada ATP World Tour Masters 1000,HARD,2,Mardy Fish,Ernests Gulbis,Mardy Fish,4-6; 6-3; 6-4,R16,142,5,3,53,96,41,53,22,43,3,5,15,63,96,12,4,56,91,40,56,17,35,9,12,14,57,91
2011-08-08 00:00:00.000,ATP World Tour Masters 1000 Canada Montreal; Canada ATP World Tour Masters 1000,HARD,2,Stanislas Wawrinka,Kevin Anderson,Stanislas Wawrinka,6-4; 4-6; 6-4,R16,144,3,4,50,82,42,50,17,32,1,2,15,59,82,6,4,54,96,42,54,21,42,6,8,15,63,96
2011-08-08 00:00:00.000,ATP World Tour Masters 1000 Canada Montreal; Canada ATP World Tour Masters 1000,HARD,2,Tomas Berdych,Ivo Karlovic,Tomas Berdych,6-3; 7-6(2),R16,103,10,1,46,79,38,46,16,33,4,4,11,54,79,12,4,49,67,38,49,4,18,4,5,10,42,67
2011-08-08 00:00:00.000,ATP World Tour Masters 1000 Canada Montreal; Canada ATP World Tour Masters 1000,HARD,2,Janko Tipsarevic,Ivan Dodig,Janko Tipsarevic,6-1; 6-4,R16,70,4,2,26,47,25,26,11,21,0,0,9,36,47,7,2,29,50,20,29,8,21,5,8,8,28,50
2011-08-08 00:00:00.000,ATP World Tour Masters 1000 Canada Montreal; Canada ATP World Tour Masters 1000,HARD,2,Novak Djokovic,Gael Monfils,Novak Djokovic,6-2; 6-1,Q,74,1,0,41,56,28,41,10,15,3,3,8,38,56,3,3,19,39,13,19,5,20,5,9,7,18,39
2011-08-08 00:00:00.000,ATP World Tour Masters 1000 Canada Montreal; Canada ATP World Tour Masters 1000,HARD,2,Jo-Wilfried Tsonga,Nicolas Almagro,Jo-Wilfried Tsonga,6-4; 6-4,Q,88,10,1,33,60,25,33,17,27,3,3,10,42,60,6,2,35,53,25,35,9,18,1,3,10,34,53
2011-08-08 00:00:00.000,ATP World Tour Masters 1000 Canada Montreal; Canada ATP World Tour Masters 1000,HARD,2,Mardy Fish,Stanislas Wawrinka,Mardy Fish,6-3; 6-7(8); 6-0,Q,141,6,2,51,93,36,51,18,42,10,15,13,54,93,1,1,44,86,22,44,14,42,3,13,14,36,86
2011-08-08 00:00:00.000,ATP World Tour Masters 1000 Canada Montreal; Canada ATP World Tour Masters 1000,HARD,2,Janko Tipsarevic,Tomas Berdych,Janko Tipsarevic,6-4; 6-4,Q,88,10,3,38,66,31,38,16,28,4,4,10,47,66,5,2,30,54,23,30,14,24,1,3,10,37,54
2011-08-08 00:00:00.000,ATP World Tour Masters 1000 Canada Montreal; Canada ATP World Tour Masters 1000,HARD,2,Novak Djokovic,Jo-Wilfried Tsonga,Novak Djokovic,6-4; 3-0 RET,S,59,1,0,28,39,22,28,8,11,0,0,7,30,39,4,2,26,39,17,26,5,13,3,5,6,22,39
2011-08-08 00:00:00.000,ATP World Tour Masters 1000 Canada Montreal; Canada ATP World Tour Masters 1000,HARD,2,Mardy Fish,Janko Tipsarevic,Mardy Fish,6-3; 6-4,S,76,6,1,34,55,29,34,9,21,0,1,10,38,55,2,3,29,48,18,29,11,19,1,4,9,29,48
2011-08-08 00:00:00.000,ATP World Tour Masters 1000 Canada Montreal; Canada ATP World Tour Masters 1000,HARD,2,Novak Djokovic,Mardy Fish,Novak Djokovic,6-2; 3-6; 6-4,F,144,4,2,61,96,43,61,18,35,8,10,14,61,96,8,3,43,83,31,43,19,40,5,8,13,50,83
2011-08-14 00:00:00.000,ATP World Tour Masters 1000 Cincinnati OH; U.S.A. ATP World Tour Masters 1000,HARD,2,Novak Djokovic,N/A Bye,Novak Djokovic,,R64,0,0,0,0,0,0,0,0,0,0,0,0,0,0,0,0,0,0,0,0,0,0,0,0,0,0,0
2011-08-14 00:00:00.000,ATP World Tour Masters 1000 Cincinnati OH; U.S.A. ATP World Tour Masters 1000,HARD,2,Ryan Harrison,Juan Ignacio Chela,Ryan Harrison,6-3; 6-3,R64,72,2,1,23,47,18,23,11,24,1,4,9,29,47,0,3,27,52,15,27,7,25,3,9,9,22,52
2011-08-14 00:00:00.000,ATP World Tour Masters 1000 Cincinnati OH; U.S.A. ATP World Tour Masters 1000,HARD,2,Radek Stepanek,John Isner,Radek Stepanek,7-5; 5-7; 7-6(4),R64,166,7,10,73,119,56,73,27,46,3,4,18,83,119,21,3,82,107,66,82,11,25,3,4,18,77,107
2011-08-14 00:00:00.000,ATP World Tour Masters 1000 Cincinnati OH; U.S.A. ATP World Tour Masters 1000,HARD,2,Andrey Golubev,Stanislas Wawrinka,Andrey Golubev,3-6; 6-4; 6-1,R64,105,8,6,47,83,35,47,18,36,6,8,13,53,83,2,3,50,72,34,50,11,22,1,5,13,45,72
2011-08-14 00:00:00.000,ATP World Tour Masters 1000 Cincinnati OH; U.S.A. ATP World Tour Masters 1000,HARD,2,Philipp Kohlschreiber,Andy Roddick,Philipp Kohlschreiber,6-7(5); 7-5; 6-1,R64,135,12,1,62,103,48,62,25,41,10,11,16,73,103,17,6,54,83,41,54,16,29,4,8,15,57,83
2011-08-14 00:00:00.000,ATP World Tour Masters 1000 Cincinnati OH; U.S.A. ATP World Tour Masters 1000,HARD,2,Feliciano Lopez,Juan Carlos Ferrero,Feliciano Lopez,4-6; 6-3; 6-4,R64,115,19,3,52,82,43,52,16,30,2,3,15,59,82,1,3,52,85,33,52,24,33,6,8,14,57,85
2011-08-14 00:00:00.000,ATP World Tour Masters 1000 Cincinnati OH; U.S.A. ATP World Tour Masters 1000,HARD,2,Ivan Dodig,Ernests Gulbis,Ivan Dodig,6-3; 7-6(3),R64,100,3,1,32,65,22,32,26,33,3,4,11,48,65,3,2,30,60,23,30,15,30,2,4,10,38,60
2011-08-14 00:00:00.000,ATP World Tour Masters 1000 Cincinnati OH; U.S.A. ATP World Tour Masters 1000,HARD,2,Gael Monfils,N/A Bye,Gael Monfils,,R64,0,0,0,0,0,0,0,0,0,0,0,0,0,0,0,0,0,0,0,0,0,0,0,0,0,0,0
2011-08-14 00:00:00.000,ATP World Tour Masters 1000 Cincinnati OH; U.S.A. ATP World Tour Masters 1000,HARD,2,Roger Federer,N/A Bye,Roger Federer,,R64,0,0,0,0,0,0,0,0,0,0,0,0,0,0,0,0,0,0,0,0,0,0,0,0,0,0,0
2011-08-14 00:00:00.000,ATP World Tour Masters 1000 Cincinnati OH; U.S.A. ATP World Tour Masters 1000,HARD,2,Juan Martin Del Potro,Andreas Seppi,Juan Martin Del Potro,4-1 RET,R64,27,2,0,7,9,6,7,2,2,0,0,2,8,9,0,2,13,21,8,13,1,8,3,5,3,9,21
2011-08-14 00:00:00.000,ATP World Tour Masters 1000 Cincinnati OH; U.S.A. ATP World Tour Masters 1000,HARD,2,James Blake,Marcos Baghdatis,James Blake,3-6; 6-3; 6-2,R64,108,3,1,50,92,33,50,23,42,7,9,13,56,92,6,5,45,85,33,45,17,40,7,11,13,50,85
2011-08-14 00:00:00.000,ATP World Tour Masters 1000 Cincinnati OH; U.S.A. ATP World Tour Masters 1000,HARD,2,Fabio Fognini,Viktor Troicki,Fabio Fognini,6-4; 6-1,R64,80,1,1,34,58,25,34,12,24,3,4,9,37,58,3,3,33,64,19,33,13,31,5,9,8,32,64
2011-08-14 00:00:00.000,ATP World Tour Masters 1000 Cincinnati OH; U.S.A. ATP World Tour Masters 1000,HARD,2,Nicolas Almagro,Albert Montanes,Nicolas Almagro,7-6(5); 6-4,R64,76,8,3,26,60,26,26,23,34,0,0,11,49,60,3,4,40,70,32,40,16,30,3,4,11,48,70
2011-08-14 00:00:00.000,ATP World Tour Masters 1000 Cincinnati OH; U.S.A. ATP World Tour Masters 1000,HARD,2,Ivo Karlovic,Florian Mayer,Ivo Karlovic,6-1; 6-3,R64,57,19,0,30,38,28,30,4,8,0,0,8,32,38,1,4,36,63,20,36,12,27,7,11,8,32,63
2011-08-14 00:00:00.000,ATP World Tour Masters 1000 Cincinnati OH; U.S.A. ATP World Tour Masters 1000,HARD,2,Juan Monaco,Tommy Haas,Juan Monaco,6-7(5); 6-4; 6-3,R64,132,3,2,65,96,45,65,22,31,1,1,15,67,96,6,3,67,97,51,67,16,30,3,6,16,67,97
2011-08-14 00:00:00.000,ATP World Tour Masters 1000 Cincinnati OH; U.S.A. ATP World Tour Masters 1000,HARD,2,Tomas Berdych,N/A Bye,Tomas Berdych,,R64,0,0,0,0,0,0,0,0,0,0,0,0,0,0,0,0,0,0,0,0,0,0,0,0,0,0,0
2011-08-14 00:00:00.000,ATP World Tour Masters 1000 Cincinnati OH; U.S.A. ATP World Tour Masters 1000,HARD,2,David Ferrer,N/A Bye,David Ferrer,,R64,0,0,0,0,0,0,0,0,0,0,0,0,0,0,0,0,0,0,0,0,0,0,0,0,0,0,0
2011-08-14 00:00:00.000,ATP World Tour Masters 1000 Cincinnati OH; U.S.A. ATP World Tour Masters 1000,HARD,2,Grigor Dimitrov,Marsel Ilhan,Grigor Dimitrov,6-3; 7-5,R64,72,7,2,35,54,32,35,12,19,0,0,11,44,54,1,1,32,58,22,32,15,26,2,4,10,37,58
2011-08-14 00:00:00.000,ATP World Tour Masters 1000 Cincinnati OH; U.S.A. ATP World Tour Masters 1000,HARD,2,Janko Tipsarevic,Edouard Roger-Vasselin,Janko Tipsarevic,6-0; 3-6; 7-6(5),R64,149,9,4,44,89,38,44,24,45,7,8,13,62,89,7,4,73,110,53,73,14,37,5,8,14,67,110
2011-08-14 00:00:00.000,ATP World Tour Masters 1000 Cincinnati OH; U.S.A. ATP World Tour Masters 1000,HARD,2,Gilles Simon,Jurgen Melzer,Gilles Simon,6-7(3); 6-3; 7-5,R64,140,10,4,39,88,31,39,33,49,0,1,16,64,88,7,3,65,108,49,65,22,43,7,11,17,71,108
2011-08-14 00:00:00.000,ATP World Tour Masters 1000 Cincinnati OH; U.S.A. ATP World Tour Masters 1000,HARD,2,Jo-Wilfried Tsonga,Marin Cilic,Jo-Wilfried Tsonga,6-3; 6-4,R64,78,9,1,28,46,27,28,13,18,0,0,10,40,46,3,6,23,63,18,23,21,40,3,5,9,39,63
2011-08-14 00:00:00.000,ATP World Tour Masters 1000 Cincinnati OH; U.S.A. ATP World Tour Masters 1000,HARD,2,Alex Bogomolov Jr.,Robby Ginepri,Alex Bogomolov Jr.,6-4; 6-3,R64,94,4,3,45,75,31,45,16,30,10,11,10,47,75,3,2,25,50,18,25,10,25,0,3,9,28,50
2011-08-14 00:00:00.000,ATP World Tour Masters 1000 Cincinnati OH; U.S.A. ATP World Tour Masters 1000,HARD,2,David Nalbandian,Kei Nishikori,David Nalbandian,6-4; 6-4,R64,96,1,7,30,59,24,30,15,29,2,3,10,39,59,1,4,42,79,27,42,17,37,8,11,10,44,79
2011-08-14 00:00:00.000,ATP World Tour Masters 1000 Cincinnati OH; U.S.A. ATP World Tour Masters 1000,HARD,2,Andy Murray,N/A Bye,Andy Murray,,R64,0,0,0,0,0,0,0,0,0,0,0,0,0,0,0,0,0,0,0,0,0,0,0,0,0,0,0
2011-08-14 00:00:00.000,ATP World Tour Masters 1000 Cincinnati OH; U.S.A. ATP World Tour Masters 1000,HARD,2,Mardy Fish,N/A Bye,Mardy Fish,,R64,0,0,0,0,0,0,0,0,0,0,0,0,0,0,0,0,0,0,0,0,0,0,0,0,0,0,0
2011-08-14 00:00:00.000,ATP World Tour Masters 1000 Cincinnati OH; U.S.A. ATP World Tour Masters 1000,HARD,2,Nikolay Davydenko,Sergiy Stakhovsky,Nikolay Davydenko,6-2; 7-6(5),R64,119,0,2,45,64,33,45,12,19,4,5,10,45,64,4,1,36,64,24,36,12,28,0,3,10,36,64
2011-08-14 00:00:00.000,ATP World Tour Masters 1000 Cincinnati OH; U.S.A. ATP World Tour Masters 1000,HARD,2,Kevin Anderson,Xavier Malisse,Kevin Anderson,6-3; 7-6(6),R64,84,13,1,50,63,43,50,8,13,1,1,11,51,63,5,2,32,71,27,32,21,39,4,5,10,48,71
2011-08-14 00:00:00.000,ATP World Tour Masters 1000 Cincinnati OH; U.S.A. ATP World Tour Masters 1000,HARD,2,Richard Gasquet,Alexandr Dolgopolov,Richard Gasquet,6-1; 7-6(4),R64,71,6,3,41,66,34,41,16,25,1,1,10,50,66,6,2,32,54,23,32,11,22,3,5,9,34,54
2011-08-14 00:00:00.000,ATP World Tour Masters 1000 Cincinnati OH; U.S.A. ATP World Tour Masters 1000,HARD,2,Michael Llodra,Mikhail Youzhny,Michael Llodra,7-5; 3-6; 7-6(4),R64,131,19,5,72,106,57,72,14,34,9,12,16,71,106,6,0,71,96,44,71,18,25,2,5,17,62,96
2011-08-14 00:00:00.000,ATP World Tour Masters 1000 Cincinnati OH; U.S.A. ATP World Tour Masters 1000,HARD,2,Fernando Verdasco,Thomaz Bellucci,Fernando Verdasco,6-3; 7-6(4),R64,107,4,4,50,75,36,50,16,25,6,7,11,52,75,7,0,52,77,33,52,15,25,7,9,10,48,77
2011-08-14 00:00:00.000,ATP World Tour Masters 1000 Cincinnati OH; U.S.A. ATP World Tour Masters 1000,HARD,2,Julien Benneteau,Guillermo Garcia-Lopez,Julien Benneteau,6-3; 1-0 RET,R64,36,4,2,12,22,12,12,8,10,0,0,5,20,22,3,9,16,36,11,16,9,20,2,4,5,20,36
2011-08-14 00:00:00.000,ATP World Tour Masters 1000 Cincinnati OH; U.S.A. ATP World Tour Masters 1000,HARD,2,Rafael Nadal,N/A Bye,Rafael Nadal,,R64,0,0,0,0,0,0,0,0,0,0,0,0,0,0,0,0,0,0,0,0,0,0,0,0,0,0,0
2011-08-14 00:00:00.000,ATP World Tour Masters 1000 Cincinnati OH; U.S.A. ATP World Tour Masters 1000,HARD,2,Novak Djokovic,Ryan Harrison,Novak Djokovic,6-2; 6-3,R32,77,3,1,33,52,24,33,10,19,1,3,9,34,52,6,1,26,53,13,26,11,27,7,12,8,24,53
2011-08-14 00:00:00.000,ATP World Tour Masters 1000 Cincinnati OH; U.S.A. ATP World Tour Masters 1000,HARD,2,Radek Stepanek,Andrey Golubev,Radek Stepanek,6-3; 7-6(2),R32,97,0,3,42,68,32,42,15,26,0,1,11,47,68,5,2,38,65,28,38,11,27,2,4,10,39,65
2011-08-14 00:00:00.000,ATP World Tour Masters 1000 Cincinnati OH; U.S.A. ATP World Tour Masters 1000,HARD,2,Philipp Kohlschreiber,Feliciano Lopez,Philipp Kohlschreiber,6-1; 6-4,R32,67,5,3,24,44,21,24,15,20,0,0,9,36,44,11,4,23,46,17,23,9,23,1,4,8,26,46
2011-08-14 00:00:00.000,ATP World Tour Masters 1000 Cincinnati OH; U.S.A. ATP World Tour Masters 1000,HARD,2,Gael Monfils,Ivan Dodig,Gael Monfils,4-6; 6-3; 4-0 RET,R32,119,3,1,59,85,39,59,14,26,9,10,11,53,85,1,4,41,72,26,41,17,31,4,8,12,43,72
2011-08-14 00:00:00.000,ATP World Tour Masters 1000 Cincinnati OH; U.S.A. ATP World Tour Masters 1000,HARD,2,Roger Federer,Juan Martin Del Potro,Roger Federer,6-3; 7-5,R32,92,12,1,46,61,38,46,7,15,1,1,11,45,61,7,2,44,77,31,44,14,33,6,8,10,45,77
2011-08-14 00:00:00.000,ATP World Tour Masters 1000 Cincinnati OH; U.S.A. ATP World Tour Masters 1000,HARD,2,James Blake,Fabio Fognini,James Blake,6-4; 6-2,R32,59,7,2,37,51,30,37,9,14,1,1,9,39,51,3,4,30,57,21,30,10,27,2,5,9,31,57
2011-08-14 00:00:00.000,ATP World Tour Masters 1000 Cincinnati OH; U.S.A. ATP World Tour Masters 1000,HARD,2,Nicolas Almagro,Ivo Karlovic,Nicolas Almagro,6-3; 5-7; 7-6(2),R32,119,16,5,52,87,45,52,23,35,0,1,16,68,87,21,4,69,104,55,69,13,35,6,8,17,68,104
2011-08-14 00:00:00.000,ATP World Tour Masters 1000 Cincinnati OH; U.S.A. ATP World Tour Masters 1000,HARD,2,Tomas Berdych,Juan Monaco,Tomas Berdych,7-6(2); 6-0,R32,96,9,2,35,63,29,35,14,28,3,4,9,43,63,2,2,45,66,23,45,10,21,7,11,9,33,66
2011-08-14 00:00:00.000,ATP World Tour Masters 1000 Cincinnati OH; U.S.A. ATP World Tour Masters 1000,HARD,2,David Ferrer,Grigor Dimitrov,David Ferrer,4-6; 6-1; 7-5,R32,143,4,8,57,104,42,57,22,47,5,7,14,64,104,5,6,57,99,40,57,18,42,9,14,15,58,99
2011-08-14 00:00:00.000,ATP World Tour Masters 1000 Cincinnati OH; U.S.A. ATP World Tour Masters 1000,HARD,2,Gilles Simon,Janko Tipsarevic,Gilles Simon,6-7(3); 6-2; 6-3,R32,177,6,3,44,91,35,44,23,47,3,5,14,58,91,4,5,58,112,42,58,20,54,6,12,15,62,112
2011-08-14 00:00:00.000,ATP World Tour Masters 1000 Cincinnati OH; U.S.A. ATP World Tour Masters 1000,HARD,2,Alex Bogomolov Jr.,Jo-Wilfried Tsonga,Alex Bogomolov Jr.,6-3; 6-4,R32,72,1,2,35,54,28,35,14,19,0,0,10,42,54,5,3,34,56,26,34,9,22,4,6,9,35,56
2011-08-14 00:00:00.000,ATP World Tour Masters 1000 Cincinnati OH; U.S.A. ATP World Tour Masters 1000,HARD,2,Andy Murray,David Nalbandian,Andy Murray,6-4; 6-1,R32,77,5,2,24,47,17,24,11,23,1,4,9,28,47,0,5,33,59,15,33,9,26,10,16,8,24,59
2011-08-14 00:00:00.000,ATP World Tour Masters 1000 Cincinnati OH; U.S.A. ATP World Tour Masters 1000,HARD,2,Mardy Fish,Nikolay Davydenko,Mardy Fish,6-0; 6-2,R32,62,9,2,23,42,21,23,10,19,1,1,7,31,42,0,3,33,46,15,33,4,13,2,7,7,19,46
2011-08-14 00:00:00.000,ATP World Tour Masters 1000 Cincinnati OH; U.S.A. ATP World Tour Masters 1000,HARD,2,Richard Gasquet,Kevin Anderson,Richard Gasquet,7-6(4); 6-4,R32,100,5,1,46,65,35,46,11,19,1,2,11,46,65,12,1,50,79,35,50,14,29,2,4,11,49,79
2011-08-14 00:00:00.000,ATP World Tour Masters 1000 Cincinnati OH; U.S.A. ATP World Tour Masters 1000,HARD,2,Fernando Verdasco,Michael Llodra,Fernando Verdasco,6-4; 6-4,R32,80,1,3,47,64,31,47,13,17,3,4,10,44,64,2,4,44,63,28,44,9,19,3,6,10,37,63
2011-08-14 00:00:00.000,ATP World Tour Masters 1000 Cincinnati OH; U.S.A. ATP World Tour Masters 1000,HARD,2,Rafael Nadal,Julien Benneteau,Rafael Nadal,6-4; 7-5,R32,93,9,1,34,55,29,34,13,21,1,2,11,42,55,1,3,29,61,21,29,17,32,0,3,11,38,61
2011-08-14 00:00:00.000,ATP World Tour Masters 1000 Cincinnati OH; U.S.A. ATP World Tour Masters 1000,HARD,2,Novak Djokovic,Radek Stepanek,Novak Djokovic,6-3; 6-3,R16,82,3,1,24,51,17,24,14,27,1,4,9,31,51,3,1,35,54,13,35,10,19,6,12,9,23,54
2011-08-14 00:00:00.000,ATP World Tour Masters 1000 Cincinnati OH; U.S.A. ATP World Tour Masters 1000,HARD,2,Gael Monfils,Philipp Kohlschreiber,Gael Monfils,6-2; 6-2,R16,65,6,1,32,47,27,32,7,15,0,0,8,34,47,2,2,26,52,16,26,11,26,2,6,8,27,52
2011-08-14 00:00:00.000,ATP World Tour Masters 1000 Cincinnati OH; U.S.A. ATP World Tour Masters 1000,HARD,2,Roger Federer,James Blake,Roger Federer,6-4; 6-1,R16,55,4,1,22,41,18,22,12,19,0,1,8,30,41,4,5,37,59,22,37,8,22,9,14,9,30,59
2011-08-14 00:00:00.000,ATP World Tour Masters 1000 Cincinnati OH; U.S.A. ATP World Tour Masters 1000,HARD,2,Tomas Berdych,Nicolas Almagro,Tomas Berdych,6-2; 6-2,R16,65,11,2,23,48,22,23,14,25,1,1,8,36,48,4,4,19,46,15,19,9,27,1,5,8,24,46
2011-08-14 00:00:00.000,ATP World Tour Masters 1000 Cincinnati OH; U.S.A. ATP World Tour Masters 1000,HARD,2,Gilles Simon,David Ferrer,Gilles Simon,6-4; 6-7(3); 6-4,R16,188,7,2,66,103,47,66,19,37,5,7,16,66,103,5,3,70,123,48,70,25,53,10,14,16,73,123
2011-08-14 00:00:00.000,ATP World Tour Masters 1000 Cincinnati OH; U.S.A. ATP World Tour Masters 1000,HARD,2,Andy Murray,Alex Bogomolov Jr.,Andy Murray,6-2; 7-5,R16,102,11,6,33,59,26,33,11,26,3,5,10,37,59,0,6,47,75,24,47,13,28,6,11,10,37,75
2011-08-14 00:00:00.000,ATP World Tour Masters 1000 Cincinnati OH; U.S.A. ATP World Tour Masters 1000,HARD,2,Mardy Fish,Richard Gasquet,Mardy Fish,7-5; 7-5,R16,103,8,2,44,70,35,44,15,26,1,1,12,50,70,3,2,45,66,34,45,11,21,0,2,12,45,66
2011-08-14 00:00:00.000,ATP World Tour Masters 1000 Cincinnati OH; U.S.A. ATP World Tour Masters 1000,HARD,2,Rafael Nadal,Fernando Verdasco,Rafael Nadal,7-6(5); 6-7(4); 7-6(9),R16,218,5,2,87,123,58,87,18,36,6,10,18,76,123,8,7,101,128,68,101,13,27,2,6,18,81,128
2011-08-14 00:00:00.000,ATP World Tour Masters 1000 Cincinnati OH; U.S.A. ATP World Tour Masters 1000,HARD,2,Novak Djokovic,Gael Monfils,Novak Djokovic,3-6; 6-4; 6-3,Q,153,2,4,58,93,41,58,17,35,2,5,14,58,93,12,7,60,105,44,60,16,45,9,13,14,60,105
2011-08-14 00:00:00.000,ATP World Tour Masters 1000 Cincinnati OH; U.S.A. ATP World Tour Masters 1000,HARD,2,Tomas Berdych,Roger Federer,Tomas Berdych,6-2; 7-6(3),Q,92,10,1,36,57,31,36,12,21,0,0,10,43,57,11,2,53,81,40,53,7,28,5,7,10,47,81
2011-08-14 00:00:00.000,ATP World Tour Masters 1000 Cincinnati OH; U.S.A. ATP World Tour Masters 1000,HARD,2,Andy Murray,Gilles Simon,Andy Murray,6-3; 6-3,Q,96,8,2,41,64,31,41,10,23,3,4,9,41,64,2,3,29,62,17,29,15,33,7,11,9,32,62
2011-08-14 00:00:00.000,ATP World Tour Masters 1000 Cincinnati OH; U.S.A. ATP World Tour Masters 1000,HARD,2,Mardy Fish,Rafael Nadal,Mardy Fish,6-3; 6-4,Q,100,12,2,33,62,27,33,18,29,4,4,10,45,62,1,2,47,63,30,47,7,16,2,4,9,37,63
2011-08-14 00:00:00.000,ATP World Tour Masters 1000 Cincinnati OH; U.S.A. ATP World Tour Masters 1000,HARD,2,Novak Djokovic,Tomas Berdych,Novak Djokovic,7-5 RET,S,53,4,3,20,30,16,20,5,10,1,2,6,21,30,4,2,26,42,17,26,6,16,2,4,6,23,42
2011-08-14 00:00:00.000,ATP World Tour Masters 1000 Cincinnati OH; U.S.A. ATP World Tour Masters 1000,HARD,2,Andy Murray,Mardy Fish,Andy Murray,6-3; 7-6(8),S,139,5,4,40,78,30,40,18,38,6,9,11,48,78,7,2,46,88,29,46,19,42,11,15,10,48,88
2011-08-14 00:00:00.000,ATP World Tour Masters 1000 Cincinnati OH; U.S.A. ATP World Tour Masters 1000,HARD,2,Andy Murray,Novak Djokovic,Andy Murray,6-4; 3-0 RET,F,72,1,0,19,34,16,19,8,15,1,2,6,24,34,0,1,33,50,18,33,5,17,2,6,7,23,50
2011-08-21 00:00:00.000,Winston-Salem NC; U.S.A. ATP World Tour 250,HARD,2,Andy Roddick,N/A Bye,Andy Roddick,,R64,0,0,0,0,0,0,0,0,0,0,0,0,0,0,0,0,0,0,0,0,0,0,0,0,0,0,0
2011-08-21 00:00:00.000,Winston-Salem NC; U.S.A. ATP World Tour 250,HARD,2,Edouard Roger-Vasselin,Lukas Rosol,Edouard Roger-Vasselin,7-6(5); 2-6; 7-6(4),R64,129,6,3,68,101,46,68,17,33,1,6,16,63,101,12,5,59,109,45,59,22,50,3,6,16,67,109
2011-08-21 00:00:00.000,Winston-Salem NC; U.S.A. ATP World Tour 250,HARD,2,Blaz Kavcic,Lleyton Hewitt,Blaz Kavcic,6-4; 7-6(3),R64,100,6,4,51,77,34,51,11,26,4,7,11,45,77,7,5,47,77,32,47,11,30,4,8,11,43,77
2011-08-21 00:00:00.000,Winston-Salem NC; U.S.A. ATP World Tour 250,HARD,2,Santiago Giraldo,N/A Bye,Santiago Giraldo,,R64,0,0,0,0,0,0,0,0,0,0,0,0,0,0,0,0,0,0,0,0,0,0,0,0,0,0,0
2011-08-21 00:00:00.000,Winston-Salem NC; U.S.A. ATP World Tour 250,HARD,2,Pablo Andujar,N/A Bye,Pablo Andujar,,R64,0,0,0,0,0,0,0,0,0,0,0,0,0,0,0,0,0,0,0,0,0,0,0,0,0,0,0
2011-08-21 00:00:00.000,Winston-Salem NC; U.S.A. ATP World Tour 250,HARD,2,Kei Nishikori,Gilles Muller,Kei Nishikori,1-6; 6-4; 7-6(5),R64,133,8,3,61,95,43,61,16,34,5,8,14,59,95,26,3,45,85,40,45,21,40,2,4,15,61,85
2011-08-21 00:00:00.000,Winston-Salem NC; U.S.A. ATP World Tour 250,HARD,2,Tobias Kamke,Alejandro Falla,Tobias Kamke,6-1; 6-0,R64,59,5,2,24,49,16,24,16,25,2,2,6,32,49,1,5,17,43,10,17,6,26,3,9,7,16,43
2011-08-21 00:00:00.000,Winston-Salem NC; U.S.A. ATP World Tour 250,HARD,2,Juan Monaco,N/A Bye,Juan Monaco,,R64,0,0,0,0,0,0,0,0,0,0,0,0,0,0,0,0,0,0,0,0,0,0,0,0,0,0,0
2011-08-21 00:00:00.000,Winston-Salem NC; U.S.A. ATP World Tour 250,HARD,2,John Isner,N/A Bye,John Isner,,R64,0,0,0,0,0,0,0,0,0,0,0,0,0,0,0,0,0,0,0,0,0,0,0,0,0,0,0
2011-08-21 00:00:00.000,Winston-Salem NC; U.S.A. ATP World Tour 250,HARD,2,Dudi Sela,Filippo Volandri,Dudi Sela,6-3; 6-2,R64,68,9,1,28,49,21,28,12,21,3,4,8,33,49,0,5,30,63,16,30,14,33,7,12,9,30,63
2011-08-21 00:00:00.000,Winston-Salem NC; U.S.A. ATP World Tour 250,HARD,2,Denis Istomin,Matthias Bachinger,Denis Istomin,7-6(1); 6-1,R64,68,8,2,31,60,23,31,22,29,0,1,10,45,60,3,5,30,57,19,30,13,27,1,4,9,32,57
2011-08-21 00:00:00.000,Winston-Salem NC; U.S.A. ATP World Tour 250,HARD,2,Jarkko Nieminen,N/A Bye,Jarkko Nieminen,,R64,0,0,0,0,0,0,0,0,0,0,0,0,0,0,0,0,0,0,0,0,0,0,0,0,0,0,0
2011-08-21 00:00:00.000,Winston-Salem NC; U.S.A. ATP World Tour 250,HARD,2,Dmitry Tursunov,N/A Bye,Dmitry Tursunov,,R64,0,0,0,0,0,0,0,0,0,0,0,0,0,0,0,0,0,0,0,0,0,0,0,0,0,0,0
2011-08-21 00:00:00.000,Winston-Salem NC; U.S.A. ATP World Tour 250,HARD,2,Steve Darcis,Frederico Gil,Steve Darcis,3-6; 6-3; 6-4,R64,119,3,4,47,85,36,47,20,38,0,1,14,56,85,1,1,61,86,43,61,14,25,4,6,14,57,86
2011-08-21 00:00:00.000,Winston-Salem NC; U.S.A. ATP World Tour 250,HARD,2,Ryan Sweeting,Olivier Rochus,Ryan Sweeting,6-3; 7-5,R64,96,7,3,41,75,26,41,21,34,4,6,11,47,75,1,5,32,64,22,32,12,32,6,10,10,34,64
2011-08-21 00:00:00.000,Winston-Salem NC; U.S.A. ATP World Tour 250,HARD,2,Marcos Baghdatis,N/A Bye,Marcos Baghdatis,,R64,0,0,0,0,0,0,0,0,0,0,0,0,0,0,0,0,0,0,0,0,0,0,0,0,0,0,0
2011-08-21 00:00:00.000,Winston-Salem NC; U.S.A. ATP World Tour 250,HARD,2,Pierre-Ludovic Duclos,N/A Bye,Pierre-Ludovic Duclos,,R64,0,0,0,0,0,0,0,0,0,0,0,0,0,0,0,0,0,0,0,0,0,0,0,0,0,0,0
2011-08-21 00:00:00.000,Winston-Salem NC; U.S.A. ATP World Tour 250,HARD,2,Ryan Harrison,Victor Hanescu,Ryan Harrison,1-6; 6-3; 6-4,R64,93,5,14,33,83,27,33,23,50,1,4,13,50,83,4,3,39,63,32,39,11,24,0,3,13,43,63
2011-08-21 00:00:00.000,Winston-Salem NC; U.S.A. ATP World Tour 250,HARD,2,James Blake,Mikhail Kukushkin,James Blake,7-5; 6-1,R64,75,7,2,38,67,29,38,13,29,2,4,10,42,67,1,4,26,55,15,26,11,29,5,10,9,26,55
2011-08-21 00:00:00.000,Winston-Salem NC; U.S.A. ATP World Tour 250,HARD,2,Robin Haase,N/A Bye,Robin Haase,,R64,0,0,0,0,0,0,0,0,0,0,0,0,0,0,0,0,0,0,0,0,0,0,0,0,0,0,0
2011-08-21 00:00:00.000,Winston-Salem NC; U.S.A. ATP World Tour 250,HARD,2,Grigor Dimitrov,N/A Bye,Grigor Dimitrov,,R64,0,0,0,0,0,0,0,0,0,0,0,0,0,0,0,0,0,0,0,0,0,0,0,0,0,0,0
2011-08-21 00:00:00.000,Winston-Salem NC; U.S.A. ATP World Tour 250,HARD,2,Donald Young,Michael Berrer,Donald Young,6-3; 6-4,R64,68,4,3,30,55,22,30,18,25,2,3,10,40,55,2,5,33,52,23,33,8,19,1,4,9,31,52
2011-08-21 00:00:00.000,Winston-Salem NC; U.S.A. ATP World Tour 250,HARD,2,Carlos Berlocq,Andreas Haider-Maurer,Carlos Berlocq,7-5; 4-1 RET,R64,95,1,2,26,48,20,26,13,22,5,6,8,33,48,2,8,35,78,25,35,17,43,11,15,9,42,78
2011-08-21 00:00:00.000,Winston-Salem NC; U.S.A. ATP World Tour 250,HARD,2,Alexandr Dolgopolov,N/A Bye,Alexandr Dolgopolov,,R64,0,0,0,0,0,0,0,0,0,0,0,0,0,0,0,0,0,0,0,0,0,0,0,0,0,0,0
2011-08-21 00:00:00.000,Winston-Salem NC; U.S.A. ATP World Tour 250,HARD,2,Nikolay Davydenko,N/A Bye,Nikolay Davydenko,,R64,0,0,0,0,0,0,0,0,0,0,0,0,0,0,0,0,0,0,0,0,0,0,0,0,0,0,0
2011-08-21 00:00:00.000,Winston-Salem NC; U.S.A. ATP World Tour 250,HARD,2,Michael Russell,Adrian Mannarino,Michael Russell,6-4; 6-7(3); 6-2,R64,138,4,15,68,112,48,68,20,44,6,9,15,68,112,4,9,38,82,26,38,20,44,2,8,15,46,82
2011-08-21 00:00:00.000,Winston-Salem NC; U.S.A. ATP World Tour 250,HARD,2,Andrey Golubev,Maximo Gonzalez,Andrey Golubev,6-2; 4-6; 6-4,R64,117,7,3,45,75,31,45,15,30,2,6,14,46,75,1,3,72,118,44,72,17,46,13,19,14,61,118
2011-08-21 00:00:00.000,Winston-Salem NC; U.S.A. ATP World Tour 250,HARD,2,Sergiy Stakhovsky,N/A Bye,Sergiy Stakhovsky,,R64,0,0,0,0,0,0,0,0,0,0,0,0,0,0,0,0,0,0,0,0,0,0,0,0,0,0,0
2011-08-21 00:00:00.000,Winston-Salem NC; U.S.A. ATP World Tour 250,HARD,2,Igor Kunitsyn,N/A Bye,Igor Kunitsyn,,R64,0,0,0,0,0,0,0,0,0,0,0,0,0,0,0,0,0,0,0,0,0,0,0,0,0,0,0
2011-08-21 00:00:00.000,Winston-Salem NC; U.S.A. ATP World Tour 250,HARD,2,Julien Benneteau,Ricardo Mello,Julien Benneteau,6-1; 6-3,R64,50,4,0,25,40,22,25,10,15,0,0,8,32,40,3,2,24,39,11,24,8,15,0,4,8,19,39
2011-08-21 00:00:00.000,Winston-Salem NC; U.S.A. ATP World Tour 250,HARD,2,Igor Andreev,Bernard Tomic,Igor Andreev,6-7(5); 6-3; 6-4,R64,126,12,3,64,112,52,64,28,48,9,9,16,80,112,10,1,59,90,45,59,18,31,3,5,15,63,90
2011-08-21 00:00:00.000,Winston-Salem NC; U.S.A. ATP World Tour 250,HARD,2,Jurgen Melzer,N/A Bye,Jurgen Melzer,,R64,0,0,0,0,0,0,0,0,0,0,0,0,0,0,0,0,0,0,0,0,0,0,0,0,0,0,0
2011-08-21 00:00:00.000,Winston-Salem NC; U.S.A. ATP World Tour 250,HARD,2,Andy Roddick,Edouard Roger-Vasselin,Andy Roddick,6-2; 6-4,R32,73,11,1,33,50,27,33,12,17,0,0,9,39,50,5,1,34,53,19,34,12,19,4,7,9,31,53
2011-08-21 00:00:00.000,Winston-Salem NC; U.S.A. ATP World Tour 250,HARD,2,Santiago Giraldo,Blaz Kavcic,Santiago Giraldo,6-2; 6-3,R32,62,3,2,29,44,25,29,8,15,0,0,8,33,44,4,4,32,58,22,32,10,26,3,7,9,32,58
2011-08-21 00:00:00.000,Winston-Salem NC; U.S.A. ATP World Tour 250,HARD,2,Kei Nishikori,Pablo Andujar,Kei Nishikori,7-6(3); 6-2,R32,110,2,1,43,65,33,43,13,22,1,2,10,46,65,0,7,36,75,25,36,17,39,11,14,10,42,75
2011-08-21 00:00:00.000,Winston-Salem NC; U.S.A. ATP World Tour 250,HARD,2,Juan Monaco,Tobias Kamke,Juan Monaco,7-5; 6-0,R32,83,4,2,37,50,24,37,6,13,0,2,9,30,50,0,2,41,68,19,41,12,27,7,13,9,31,68
2011-08-21 00:00:00.000,Winston-Salem NC; U.S.A. ATP World Tour 250,HARD,2,John Isner,Dudi Sela,John Isner,7-6(3); 6-2,R32,77,17,2,45,66,37,45,12,21,4,4,10,49,66,1,7,33,64,22,33,19,31,4,6,10,41,64
2011-08-21 00:00:00.000,Winston-Salem NC; U.S.A. ATP World Tour 250,HARD,2,Jarkko Nieminen,Denis Istomin,Jarkko Nieminen,3-6; 6-4; 6-4,R32,109,4,1,65,99,45,65,16,34,5,8,15,61,99,6,3,49,79,33,49,19,30,5,8,14,52,79
2011-08-21 00:00:00.000,Winston-Salem NC; U.S.A. ATP World Tour 250,HARD,2,Steve Darcis,Dmitry Tursunov,Steve Darcis,3-6; 6-1; 6-3,R32,102,8,9,45,84,32,45,22,39,8,10,12,54,84,7,3,48,85,32,48,16,37,8,13,13,48,85
2011-08-21 00:00:00.000,Winston-Salem NC; U.S.A. ATP World Tour 250,HARD,2,Marcos Baghdatis,Ryan Sweeting,Marcos Baghdatis,7-5; 6-1,R32,77,7,4,21,56,17,21,22,35,4,5,9,39,56,2,6,32,53,21,32,6,21,0,5,10,27,53
2011-08-21 00:00:00.000,Winston-Salem NC; U.S.A. ATP World Tour 250,HARD,2,Pierre-Ludovic Duclos,Ryan Harrison,Pierre-Ludovic Duclos,7-5; 7-5,R32,94,1,0,45,66,30,45,16,21,4,6,12,46,66,2,8,42,85,27,42,21,43,8,12,12,48,85
2011-08-21 00:00:00.000,Winston-Salem NC; U.S.A. ATP World Tour 250,HARD,2,Robin Haase,James Blake,Robin Haase,6-4; 6-1,R32,62,6,3,23,51,16,23,19,28,9,10,8,35,51,6,6,32,62,23,32,9,30,3,8,9,32,62
2011-08-21 00:00:00.000,Winston-Salem NC; U.S.A. ATP World Tour 250,HARD,2,Grigor Dimitrov,Donald Young,Grigor Dimitrov,6-4; 2-6; 7-6(2),R32,124,11,7,56,90,35,56,18,34,1,6,15,53,90,3,6,65,101,46,65,14,36,8,12,15,60,101
2011-08-21 00:00:00.000,Winston-Salem NC; U.S.A. ATP World Tour 250,HARD,2,Alexandr Dolgopolov,Carlos Berlocq,Alexandr Dolgopolov,6-4; 6-4,R32,85,8,3,30,65,22,30,22,35,2,3,10,44,65,2,1,34,57,23,34,12,23,4,7,10,35,57
2011-08-21 00:00:00.000,Winston-Salem NC; U.S.A. ATP World Tour 250,HARD,2,Nikolay Davydenko,Michael Russell,Nikolay Davydenko,6-2; 6-2,R32,75,0,4,44,62,28,44,9,18,5,6,8,37,62,2,5,33,54,18,33,7,21,5,10,8,25,54
2011-08-21 00:00:00.000,Winston-Salem NC; U.S.A. ATP World Tour 250,HARD,2,Sergiy Stakhovsky,Andrey Golubev,Sergiy Stakhovsky,6-1; 2-6; 6-4,R32,90,10,2,39,71,27,39,18,32,3,7,13,45,71,1,4,41,72,25,41,15,31,3,8,12,40,72
2011-08-21 00:00:00.000,Winston-Salem NC; U.S.A. ATP World Tour 250,HARD,2,Julien Benneteau,Igor Kunitsyn,Julien Benneteau,6-3; 6-1,R32,72,3,7,25,49,19,25,14,24,1,2,8,33,49,1,1,24,49,14,24,8,25,3,8,8,22,49
2011-08-21 00:00:00.000,Winston-Salem NC; U.S.A. ATP World Tour 250,HARD,2,Igor Andreev,Jurgen Melzer,Igor Andreev,7-5; 6-3,R32,95,8,1,39,68,30,39,18,29,3,4,11,48,68,6,1,55,74,31,55,11,19,2,5,10,42,74
2011-08-21 00:00:00.000,Winston-Salem NC; U.S.A. ATP World Tour 250,HARD,2,Andy Roddick,Santiago Giraldo,Andy Roddick,6-1; 6-3,R16,67,5,0,24,40,19,24,13,16,0,0,8,32,40,1,1,25,53,17,25,10,28,2,6,8,27,53
2011-08-21 00:00:00.000,Winston-Salem NC; U.S.A. ATP World Tour 250,HARD,2,Juan Monaco,Kei Nishikori,Juan Monaco,6-0; 6-3,R16,71,1,3,27,53,20,27,14,26,8,9,7,34,53,0,0,28,49,13,28,7,21,4,10,8,20,49
2011-08-21 00:00:00.000,Winston-Salem NC; U.S.A. ATP World Tour 250,HARD,2,John Isner,Jarkko Nieminen,John Isner,7-6(4); 6-2,R16,64,10,2,35,51,30,35,14,16,0,0,10,44,51,6,1,33,58,25,33,14,25,2,4,10,39,58
2011-08-21 00:00:00.000,Winston-Salem NC; U.S.A. ATP World Tour 250,HARD,2,Marcos Baghdatis,Steve Darcis,Marcos Baghdatis,7-5; 6-0,R16,74,9,5,24,55,21,24,16,31,1,2,9,37,55,2,7,24,59,17,24,11,35,6,11,9,28,59
2011-08-21 00:00:00.000,Winston-Salem NC; U.S.A. ATP World Tour 250,HARD,2,Robin Haase,Pierre-Ludovic Duclos,Robin Haase,6-4; 7-5,R16,114,3,2,33,74,22,33,23,41,7,9,11,45,74,5,9,42,80,28,42,16,38,7,11,11,44,80
2011-08-21 00:00:00.000,Winston-Salem NC; U.S.A. ATP World Tour 250,HARD,2,Alexandr Dolgopolov,Grigor Dimitrov,Alexandr Dolgopolov,6-4; 1-6; 7-6(7),R16,133,9,6,38,93,32,38,28,55,5,8,14,60,93,10,5,59,105,43,59,26,46,7,9,15,69,105
2011-08-21 00:00:00.000,Winston-Salem NC; U.S.A. ATP World Tour 250,HARD,2,Sergiy Stakhovsky,Nikolay Davydenko,Sergiy Stakhovsky,6-4; 6-4,R16,78,6,3,32,56,26,32,13,24,2,3,10,39,56,2,4,47,64,28,47,9,17,4,7,10,37,64
2011-08-21 00:00:00.000,Winston-Salem NC; U.S.A. ATP World Tour 250,HARD,2,Julien Benneteau,Igor Andreev,Julien Benneteau,2-6; 6-1; 7-6(5),R16,154,6,4,62,102,41,62,22,40,4,7,14,63,102,8,7,51,100,36,51,20,49,5,8,13,56,100
2011-08-21 00:00:00.000,Winston-Salem NC; U.S.A. ATP World Tour 250,HARD,2,Andy Roddick,Juan Monaco,Andy Roddick,6-1; 6-4,Q,67,9,1,32,45,26,32,10,13,0,0,9,36,45,1,5,32,55,17,32,14,23,2,5,8,31,55
2011-08-21 00:00:00.000,Winston-Salem NC; U.S.A. ATP World Tour 250,HARD,2,John Isner,Marcos Baghdatis,John Isner,1-6; 6-3; 6-4,Q,111,12,4,50,78,37,50,12,28,0,3,13,49,78,6,5,26,69,21,26,26,43,6,9,13,47,69
2011-08-21 00:00:00.000,Winston-Salem NC; U.S.A. ATP World Tour 250,HARD,2,Robin Haase,Alexandr Dolgopolov,Robin Haase,6-4; 6-4,Q,60,3,5,29,56,20,29,18,27,1,2,10,38,56,15,6,35,59,26,35,9,24,5,8,10,35,59
2011-08-21 00:00:00.000,Winston-Salem NC; U.S.A. ATP World Tour 250,HARD,2,Julien Benneteau,Sergiy Stakhovsky,Julien Benneteau,3-6; 7-6(9); 6-2,Q,141,10,5,57,93,42,57,21,36,3,5,14,63,93,12,9,57,113,45,57,26,56,11,14,15,71,113
2011-08-21 00:00:00.000,Winston-Salem NC; U.S.A. ATP World Tour 250,HARD,2,John Isner,Andy Roddick,John Isner,7-6(7); 6-4,S,95,8,1,41,69,35,41,17,28,1,2,11,52,69,10,2,47,67,42,47,6,20,1,3,11,48,67
2011-08-21 00:00:00.000,Winston-Salem NC; U.S.A. ATP World Tour 250,HARD,2,Julien Benneteau,Robin Haase,Julien Benneteau,3-6; 7-6(7); 7-6(6),S,152,11,10,68,117,49,68,23,49,2,6,16,72,117,10,5,65,106,49,65,21,41,5,8,17,70,106
2011-08-21 00:00:00.000,Winston-Salem NC; U.S.A. ATP World Tour 250,HARD,2,John Isner,Julien Benneteau,John Isner,4-6; 6-3; 6-4,F,121,19,5,61,85,51,61,10,24,2,3,15,61,85,6,1,47,78,36,47,20,31,4,6,14,56,78
2011-08-29 00:00:00.000,US Open NY; U.S.A. Grand Slams,HARD,3,Novak Djokovic,Conor Niland,Novak Djokovic,6-0; 5-1 RET,R128,44,3,1,22,30,19,22,5,8,0,0,6,24,30,1,2,15,30,6,15,2,15,1,6,6,8,30
2011-08-29 00:00:00.000,US Open NY; U.S.A. Grand Slams,HARD,3,Carlos Berlocq,Pere Riba,Carlos Berlocq,7-5; 6-0; 6-1,R128,114,8,7,48,77,41,48,12,29,2,3,12,53,77,2,6,41,85,22,41,15,44,7,15,13,37,85
2011-08-29 00:00:00.000,US Open NY; U.S.A. Grand Slams,HARD,3,Potito Starace,Michael Berrer,Potito Starace,6-4; 4-6; 6-3; 6-2,R128,159,6,4,82,119,60,82,21,37,11,12,18,81,119,9,5,78,130,55,78,24,52,14,19,19,79,130
2011-08-29 00:00:00.000,US Open NY; U.S.A. Grand Slams,HARD,3,Nikolay Davydenko,Ivan Dodig,Nikolay Davydenko,6-7(6); 6-3; 6-0; 2-6; 6-2,R128,242,2,7,126,163,87,126,16,37,12,16,22,103,163,9,8,80,148,50,80,31,68,8,15,21,81,148
2011-08-29 00:00:00.000,US Open NY; U.S.A. Grand Slams,HARD,3,Alexandr Dolgopolov,Frederico Gil,Alexandr Dolgopolov,6-4; 6-2; 7-5,R128,118,10,7,41,102,32,41,34,61,7,9,15,66,102,1,7,58,94,35,58,16,36,4,10,15,51,94
2011-08-29 00:00:00.000,US Open NY; U.S.A. Grand Slams,HARD,3,Flavio Cipolla,Kei Nishikori,Flavio Cipolla,6-4; 6-2 RET,R128,75,2,3,30,50,24,30,11,20,1,2,9,35,50,3,5,31,51,20,31,7,20,3,7,9,27,51
2011-08-29 00:00:00.000,US Open NY; U.S.A. Grand Slams,HARD,3,Ivo Karlovic,Fernando Gonzalez,Ivo Karlovic,6-4; 6-4; 7-6(3),R128,116,23,3,60,90,52,60,19,30,1,1,16,71,90,3,3,51,98,37,51,29,47,4,6,16,66,98
2011-08-29 00:00:00.000,US Open NY; U.S.A. Grand Slams,HARD,3,Richard Gasquet,Sergiy Stakhovsky,Richard Gasquet,6-4; 6-4; 6-0,R128,113,8,1,51,79,39,51,16,28,4,5,13,55,79,3,5,51,81,29,51,14,30,7,13,13,43,81
2011-08-29 00:00:00.000,US Open NY; U.S.A. Grand Slams,HARD,3,Tomas Berdych,Romain Jouan,Tomas Berdych,6-2; 7-6(4); 6-1,R128,116,7,5,48,81,41,48,20,33,2,3,14,61,81,0,3,36,81,21,36,23,45,4,9,13,44,81
2011-08-29 00:00:00.000,US Open NY; U.S.A. Grand Slams,HARD,3,Fabio Fognini,Horacio Zeballos,Fabio Fognini,5-7; 6-4; 7-6(5); 6-4,R128,189,11,7,80,139,61,80,33,59,3,7,22,94,139,6,12,74,138,58,74,30,64,5,10,22,88,138
2011-08-29 00:00:00.000,US Open NY; U.S.A. Grand Slams,HARD,3,Philipp Petzschner,Albert Ramos,Philipp Petzschner,7-5; 6-7(2); 6-3; 6-7(5); 6-3,R128,264,12,7,109,194,82,109,42,85,6,7,26,124,194,10,7,112,179,82,112,34,67,10,16,28,116,179
2011-08-29 00:00:00.000,US Open NY; U.S.A. Grand Slams,HARD,3,Janko Tipsarevic,Augustin Gensse,Janko Tipsarevic,6-2; 7-5; 6-0,R128,118,5,4,35,77,32,35,26,42,4,4,13,58,77,4,3,67,96,38,67,12,29,8,14,13,50,96
2011-08-29 00:00:00.000,US Open NY; U.S.A. Grand Slams,HARD,3,Marcel Granollers,Xavier Malisse,Marcel Granollers,6-4; 6-4; 6-4,R128,121,2,3,46,81,37,46,17,35,2,5,15,54,81,7,1,56,93,37,56,14,37,4,10,15,51,93
2011-08-29 00:00:00.000,US Open NY; U.S.A. Grand Slams,HARD,3,Mikhail Kukushkin,Albert Montanes,Mikhail Kukushkin,7-5; 6-2; 3-6; 7-6(5),R128,181,9,3,69,130,53,69,33,61,6,9,21,86,130,3,7,69,127,52,69,29,58,6,10,20,81,127
2011-08-29 00:00:00.000,US Open NY; U.S.A. Grand Slams,HARD,3,Juan Carlos Ferrero,Pablo Andujar,Juan Carlos Ferrero,1-6; 7-5; 5-7; 6-1; 6-3,R128,212,10,6,96,163,57,96,36,67,17,23,23,93,163,5,5,95,162,61,95,32,67,8,16,24,93,162
2011-08-29 00:00:00.000,US Open NY; U.S.A. Grand Slams,HARD,3,Gael Monfils,Grigor Dimitrov,Gael Monfils,7-6(4); 6-3; 6-4,R128,159,2,3,64,111,43,64,27,47,7,10,16,70,111,3,5,68,117,43,68,22,49,8,13,15,65,117
2011-08-29 00:00:00.000,US Open NY; U.S.A. Grand Slams,HARD,3,Roger Federer,Santiago Giraldo,Roger Federer,6-4; 6-3; 6-2,R128,106,5,3,51,83,36,51,15,32,0,3,14,51,83,2,2,52,98,32,52,15,46,11,18,13,47,98
2011-08-29 00:00:00.000,US Open NY; U.S.A. Grand Slams,HARD,3,Dudi Sela,Thomaz Bellucci,Dudi Sela,4-6; 2-6; 6-4; 6-3; 6-0,R128,207,9,10,64,136,46,64,36,72,6,12,22,82,136,9,6,75,134,50,75,27,59,7,13,21,77,134
2011-08-29 00:00:00.000,US Open NY; U.S.A. Grand Slams,HARD,3,Bernard Tomic,Michael Yani,Bernard Tomic,6-3; 6-4; 6-4,R128,110,9,3,63,105,49,63,19,42,4,5,15,68,105,4,1,47,81,33,47,17,34,3,7,14,50,81
2011-08-29 00:00:00.000,US Open NY; U.S.A. Grand Slams,HARD,3,Marin Cilic,Ryan Harrison,Marin Cilic,6-2; 7-5; 7-6(6),R128,146,2,4,43,95,29,43,33,52,3,7,16,62,95,1,7,41,96,21,41,29,55,2,9,16,50,96
2011-08-29 00:00:00.000,US Open NY; U.S.A. Grand Slams,HARD,3,Radek Stepanek,Philipp Kohlschreiber,Radek Stepanek,6-4; 6-1; 6-3,R128,120,3,5,46,85,37,46,22,39,2,2,13,59,85,6,3,40,81,28,40,19,41,4,9,13,47,81
2011-08-29 00:00:00.000,US Open NY; U.S.A. Grand Slams,HARD,3,Juan Monaco,Andreas Seppi,Juan Monaco,7-6(1); 6-2; 6-2,R128,118,3,3,53,89,37,53,16,36,4,8,14,53,89,6,6,51,85,29,51,8,34,3,11,14,37,85
2011-08-29 00:00:00.000,US Open NY; U.S.A. Grand Slams,HARD,3,Tommy Haas,Jonathan Dasnieres de Veigy,Tommy Haas,6-3; 6-4; 6-7(5); 6-1,R128,170,18,9,81,125,59,81,25,44,8,10,20,84,125,5,2,78,119,54,78,12,41,4,10,18,66,119
2011-08-29 00:00:00.000,US Open NY; U.S.A. Grand Slams,HARD,3,Alejandro Falla,Viktor Troicki,Alejandro Falla,3-6; 6-3; 4-6; 7-5; 7-5,R128,220,3,3,81,158,59,81,44,77,8,13,26,103,158,13,5,108,172,82,108,23,64,16,22,26,105,172
2011-08-29 00:00:00.000,US Open NY; U.S.A. Grand Slams,HARD,3,Jo-Wilfried Tsonga,Yen-Hsun Lu,Jo-Wilfried Tsonga,6-4; 6-4; 6-4,R128,129,6,5,53,89,40,53,23,36,3,4,15,63,89,6,3,45,80,32,45,19,35,5,9,15,51,80
2011-08-29 00:00:00.000,US Open NY; U.S.A. Grand Slams,HARD,3,Sergei Bubka,Andreas Haider-Maurer,Sergei Bubka,6-3; 6-2; 3-6; 6-4,R128,134,25,2,67,97,56,67,17,30,2,3,18,73,97,14,10,63,118,47,63,28,55,5,9,18,75,118
2011-08-29 00:00:00.000,US Open NY; U.S.A. Grand Slams,HARD,3,Marsel Ilhan,Frank Dancevic,Marsel Ilhan,6-3; 6-2; 1-0 RET,R128,76,7,2,31,56,27,31,13,25,2,2,10,40,56,4,2,25,49,17,25,10,24,3,7,9,27,49
2011-08-29 00:00:00.000,US Open NY; U.S.A. Grand Slams,HARD,3,Fernando Verdasco,Jarkko Nieminen,Fernando Verdasco,3-6; 6-4; 6-1; 6-4,R128,156,8,1,74,112,59,74,16,38,4,7,18,75,112,2,6,65,118,45,65,23,53,10,16,18,68,118
2011-08-29 00:00:00.000,US Open NY; U.S.A. Grand Slams,HARD,3,Michael Llodra,Victor Hanescu,Michael Llodra,6-2; 4-6; 4-6; 6-3; 6-2,R128,169,11,8,75,126,59,75,27,51,1,4,23,86,126,2,5,53,121,41,53,37,68,7,13,22,78,121
2011-08-29 00:00:00.000,US Open NY; U.S.A. Grand Slams,HARD,3,Kevin Anderson,Go Soeda,Kevin Anderson,6-1; 6-3; 6-0,R128,98,9,1,40,59,33,40,16,19,0,0,11,49,59,0,3,49,84,27,49,13,35,6,13,11,40,84
2011-08-29 00:00:00.000,US Open NY; U.S.A. Grand Slams,HARD,3,Malek Jaziri,Thiemo de Bakker,Malek Jaziri,4-6; 6-1; 6-4; 6-2,R128,163,9,4,57,100,47,57,23,43,5,7,18,70,100,12,8,68,129,52,68,22,61,11,17,17,74,129
2011-08-29 00:00:00.000,US Open NY; U.S.A. Grand Slams,HARD,3,Mardy Fish,Tobias Kamke,Mardy Fish,6-2; 6-2; 6-1,R128,103,4,4,43,73,37,43,15,30,5,6,12,52,73,0,7,41,75,21,41,15,34,1,8,11,36,75
2011-08-29 00:00:00.000,US Open NY; U.S.A. Grand Slams,HARD,3,Rogerio Dutra Silva,Louk Sorensen,Rogerio Dutra Silva,6-0; 3-6; 6-4; 1-0 RET,R128,135,1,1,43,85,33,43,24,42,4,5,13,57,85,6,1,55,85,35,55,17,30,7,11,14,52,85
2011-08-29 00:00:00.000,US Open NY; U.S.A. Grand Slams,HARD,3,Alex Bogomolov Jr.,Steve Johnson,Alex Bogomolov Jr.,4-6; 4-6; 6-3; 7-6(3); 6-3,R128,220,8,8,106,157,77,106,32,51,7,11,26,109,157,23,7,110,176,80,110,30,66,10,14,24,110,176
2011-08-29 00:00:00.000,US Open NY; U.S.A. Grand Slams,HARD,3,Robby Ginepri,Joao Souza,Robby Ginepri,6-3; 6-4; 6-7(5); 6-1,R128,177,8,3,85,141,52,85,36,56,12,14,20,88,141,10,5,72,114,48,72,17,42,4,10,18,65,114
2011-08-29 00:00:00.000,US Open NY; U.S.A. Grand Slams,HARD,3,John Isner,Marcos Baghdatis,John Isner,7-6(2); 7-6(11); 2-6; 6-4,R128,192,14,3,100,138,76,100,22,38,3,5,21,98,138,11,5,65,138,55,65,42,73,4,5,21,97,138
2011-08-29 00:00:00.000,US Open NY; U.S.A. Grand Slams,HARD,3,Juan Martin Del Potro,Filippo Volandri,Juan Martin Del Potro,6-3; 6-1; 6-1,R128,88,18,3,38,56,34,38,11,18,0,0,11,45,56,0,5,39,77,23,39,14,38,7,14,12,37,77
2011-08-29 00:00:00.000,US Open NY; U.S.A. Grand Slams,HARD,3,Diego Junqueira,Karol Beck,Diego Junqueira,6-2 RET,R128,32,0,2,12,21,10,12,6,9,0,0,4,16,21,0,5,20,32,11,20,4,12,1,3,4,15,32
2011-08-29 00:00:00.000,US Open NY; U.S.A. Grand Slams,HARD,3,Guillermo Garcia-Lopez,Daniel Gimeno-Traver,Guillermo Garcia-Lopez,6-3; 1-6; 7-6(1); 4-6; 7-6(4),R128,237,8,13,76,167,57,76,42,91,15,23,25,99,167,8,10,93,174,65,93,39,81,17,23,25,104,174
2011-08-29 00:00:00.000,US Open NY; U.S.A. Grand Slams,HARD,3,Gilles Simon,Ricardo Mello,Gilles Simon,3-6; 6-3; 6-4; 3-6; 6-4,R128,212,9,8,82,155,64,82,36,73,4,6,23,100,155,2,4,103,168,69,103,38,65,12,15,24,107,168
2011-08-29 00:00:00.000,US Open NY; U.S.A. Grand Slams,HARD,3,Stanislas Wawrinka,Maximo Gonzalez,Stanislas Wawrinka,3-6; 6-4; 6-1; 6-3,R128,148,10,5,53,98,42,53,26,45,3,6,18,68,98,4,3,69,116,35,69,28,47,10,16,17,63,116
2011-08-29 00:00:00.000,US Open NY; U.S.A. Grand Slams,HARD,3,Donald Young,Lukas Lacko,Donald Young,6-4; 6-2; 6-4,R128,133,0,1,51,76,37,51,18,25,3,5,14,55,76,7,7,70,121,40,70,23,51,11,17,14,63,121
2011-08-29 00:00:00.000,US Open NY; U.S.A. Grand Slams,HARD,3,Steve Darcis,Dmitry Tursunov,Steve Darcis,6-7(4); 4-6; 7-5; 6-1; 7-6(0),R128,231,20,13,92,169,71,92,38,77,5,11,27,109,169,7,12,91,171,60,91,39,80,10,18,26,99,171
2011-08-29 00:00:00.000,US Open NY; U.S.A. Grand Slams,HARD,3,Juan Ignacio Chela,Marinko Matosevic,Juan Ignacio Chela,3-1 RET,R128,27,0,2,13,20,8,13,4,7,3,3,2,12,20,0,1,7,11,3,7,2,4,0,1,2,5,11
2011-08-29 00:00:00.000,US Open NY; U.S.A. Grand Slams,HARD,3,Feliciano Lopez,Tatsuma Ito,Feliciano Lopez,6-2; 6-4; 6-4,R128,118,18,3,49,87,40,49,23,38,5,5,14,63,87,3,6,52,94,34,52,20,42,3,7,14,54,94
2011-08-29 00:00:00.000,US Open NY; U.S.A. Grand Slams,HARD,3,Vasek Pospisil,Lukas Rosol,Vasek Pospisil,6-1; 6-2; 6-1,R128,82,13,6,43,77,35,43,18,34,6,6,11,53,77,3,7,33,68,20,33,10,35,6,13,11,30,68
2011-08-29 00:00:00.000,US Open NY; U.S.A. Grand Slams,HARD,3,Robin Haase,Rui Machado,Robin Haase,6-0; 6-4; 6-4,R128,92,7,2,44,68,36,44,15,24,0,1,13,51,68,1,3,41,80,24,41,17,39,3,9,13,41,80
2011-08-29 00:00:00.000,US Open NY; U.S.A. Grand Slams,HARD,3,Andy Murray,Somdev Devvarman,Andy Murray,7-6(5); 6-2; 6-3,R128,147,8,3,54,89,42,54,17,35,5,8,14,59,89,1,4,77,115,42,77,17,38,7,14,15,59,115
2011-08-29 00:00:00.000,US Open NY; U.S.A. Grand Slams,HARD,3,David Ferrer,Igor Andreev,David Ferrer,2-6; 6-3; 6-0; 6-4,R128,145,4,6,59,103,46,59,23,44,2,4,17,69,103,3,3,56,99,38,56,20,43,1,6,16,58,99
2011-08-29 00:00:00.000,US Open NY; U.S.A. Grand Slams,HARD,3,James Blake,Jesse Huta Galung,James Blake,6-4; 6-2; 4-6; 6-4,R128,141,12,8,65,109,52,65,20,44,6,10,19,72,109,7,6,52,115,35,52,28,63,6,13,19,63,115
2011-08-29 00:00:00.000,US Open NY; U.S.A. Grand Slams,HARD,3,Jean-Rene Lisnard,Olivier Rochus,Jean-Rene Lisnard,7-6(5); 6-2; 6-4,R128,171,7,4,70,123,45,70,24,53,10,15,15,69,123,5,6,71,117,44,71,17,46,9,17,15,61,117
2011-08-29 00:00:00.000,US Open NY; U.S.A. Grand Slams,HARD,3,Florian Mayer,Adrian Mannarino,Florian Mayer,6-2; 6-0; 6-1,R128,76,3,1,32,54,29,32,13,22,2,2,10,42,54,1,6,30,69,15,30,14,39,6,14,11,29,69
2011-08-29 00:00:00.000,US Open NY; U.S.A. Grand Slams,HARD,3,Andy Roddick,Michael Russell,Andy Roddick,6-2; 6-4; 4-6; 7-5,R128,177,14,4,81,118,56,81,22,37,3,6,20,78,118,0,8,68,113,42,68,24,45,4,10,20,66,113
2011-08-29 00:00:00.000,US Open NY; U.S.A. Grand Slams,HARD,3,Jack Sock,Marc Gicquel,Jack Sock,6-4; 6-3; 1-6; 6-4,R128,147,13,6,61,107,47,61,24,46,3,6,18,71,107,7,8,54,111,44,54,27,57,4,8,18,71,111
2011-08-29 00:00:00.000,US Open NY; U.S.A. Grand Slams,HARD,3,Denis Istomin,Ryan Sweeting,Denis Istomin,3-6; 7-5; 6-4; 7-6(4),R128,167,9,0,78,137,53,78,32,59,5,11,22,85,137,3,10,77,140,53,77,29,63,12,18,21,82,140
2011-08-29 00:00:00.000,US Open NY; U.S.A. Grand Slams,HARD,3,Julien Benneteau,Nicolas Almagro,Julien Benneteau,6-2; 6-4; 6-3,R128,124,5,3,61,100,44,61,19,39,12,13,13,63,100,12,2,41,82,28,41,18,41,4,10,14,46,82
2011-08-29 00:00:00.000,US Open NY; U.S.A. Grand Slams,HARD,3,Ernests Gulbis,Mikhail Youzhny,Ernests Gulbis,6-2; 6-4; 6-4,R128,140,14,5,62,99,48,62,18,37,10,10,14,66,99,4,3,44,86,31,44,19,42,3,7,14,50,86
2011-08-29 00:00:00.000,US Open NY; U.S.A. Grand Slams,HARD,3,Gilles Muller,Edouard Roger-Vasselin,Gilles Muller,7-6(5); 6-4; 6-4,R128,154,23,8,57,110,50,57,24,53,6,8,16,74,110,4,4,61,112,39,61,28,51,7,11,16,67,112
2011-08-29 00:00:00.000,US Open NY; U.S.A. Grand Slams,HARD,3,Igor Kunitsyn,Matthias Bachinger,Igor Kunitsyn,2-6; 1-6; 6-1; 6-4; 6-4,R128,205,8,4,88,149,54,88,31,61,6,12,21,85,149,12,5,81,151,57,81,29,70,7,13,21,86,151
2011-08-29 00:00:00.000,US Open NY; U.S.A. Grand Slams,HARD,3,Jurgen Melzer,Eric Prodon,Jurgen Melzer,6-2; 7-6(4); 6-2,R128,114,13,2,60,91,46,60,12,31,2,5,14,58,91,4,10,45,97,28,45,19,52,9,15,14,47,97
2011-08-29 00:00:00.000,US Open NY; U.S.A. Grand Slams,HARD,3,Ivan Ljubicic,Blaz Kavcic,Ivan Ljubicic,7-6(5); 3-6; 6-1; 7-5,R128,175,23,2,63,120,55,63,34,57,5,6,20,89,120,4,11,82,137,63,82,25,55,8,11,20,88,137
2011-08-29 00:00:00.000,US Open NY; U.S.A. Grand Slams,HARD,3,David Nalbandian,Bobby Reynolds,David Nalbandian,4-6; 6-3; 6-4; 6-3,R128,180,10,8,65,130,48,65,39,65,10,11,19,87,130,11,8,78,135,52,78,29,57,9,13,19,81,135
2011-08-29 00:00:00.000,US Open NY; U.S.A. Grand Slams,HARD,3,Nicolas Mahut,Robert Farah,Nicolas Mahut,3-6; 6-7(4); 6-2; 6-4; 6-0,R128,190,14,9,80,137,60,80,32,57,8,11,22,92,137,5,8,72,147,48,72,38,75,12,20,23,86,147
2011-08-29 00:00:00.000,US Open NY; U.S.A. Grand Slams,HARD,3,Rafael Nadal,Andrey Golubev,Rafael Nadal,6-3; 7-6(1); 7-5,R128,169,6,4,60,94,40,60,16,34,4,10,17,56,94,7,7,62,122,35,62,24,60,14,22,16,59,122
2011-08-29 00:00:00.000,US Open NY; U.S.A. Grand Slams,HARD,3,Novak Djokovic,Carlos Berlocq,Novak Djokovic,6-0; 6-0; 6-2,R64,90,5,0,37,56,25,37,12,19,2,4,10,37,56,2,6,44,67,17,44,5,23,10,20,10,22,67
2011-08-29 00:00:00.000,US Open NY; U.S.A. Grand Slams,HARD,3,Nikolay Davydenko,Potito Starace,Nikolay Davydenko,6-2; 6-4; 7-5,R64,126,0,5,65,88,46,65,13,23,5,8,15,59,88,5,4,63,110,37,63,20,47,13,20,15,57,110
2011-08-29 00:00:00.000,US Open NY; U.S.A. Grand Slams,HARD,3,Alexandr Dolgopolov,Flavio Cipolla,Alexandr Dolgopolov,6-0; 7-5; 2-6; 5-7; 6-4,R64,200,13,11,68,158,52,68,39,90,7,15,24,91,158,0,12,89,152,46,89,33,63,6,16,24,79,152
2011-08-29 00:00:00.000,US Open NY; U.S.A. Grand Slams,HARD,3,Ivo Karlovic,Richard Gasquet,Ivo Karlovic,6-4; 6-2; 2-6; 7-6(4),R64,157,29,1,84,118,65,84,15,34,4,7,19,80,118,8,4,63,113,49,63,26,50,2,6,19,75,113
2011-08-29 00:00:00.000,US Open NY; U.S.A. Grand Slams,HARD,3,Tomas Berdych,Fabio Fognini,Tomas Berdych,7-5; 6-0; 6-0,R64,103,10,0,37,71,34,37,18,34,2,2,12,52,71,5,5,42,78,23,42,16,36,4,11,12,39,78
2011-08-29 00:00:00.000,US Open NY; U.S.A. Grand Slams,HARD,3,Janko Tipsarevic,Philipp Petzschner,Janko Tipsarevic,6-0; 6-3; 3-6; 6-3,R64,133,12,5,57,99,41,57,29,42,4,5,17,70,99,10,5,41,88,34,41,23,47,5,10,16,57,88
2011-08-29 00:00:00.000,US Open NY; U.S.A. Grand Slams,HARD,3,Marcel Granollers,Mikhail Kukushkin,Marcel Granollers,7-5; 6-3; 6-4,R64,140,6,7,55,92,41,55,17,37,1,4,16,58,92,2,5,44,92,29,44,22,48,7,13,15,51,92
2011-08-29 00:00:00.000,US Open NY; U.S.A. Grand Slams,HARD,3,Juan Carlos Ferrero,Gael Monfils,Juan Carlos Ferrero,7-6(5); 5-7; 6-7(5); 6-4; 6-4,R64,288,1,8,100,181,68,100,48,81,6,9,28,116,181,20,10,108,188,77,108,42,80,11,16,28,119,188
2011-08-29 00:00:00.000,US Open NY; U.S.A. Grand Slams,HARD,3,Roger Federer,Dudi Sela,Roger Federer,6-3; 6-2; 6-2,R64,77,6,1,43,60,38,43,14,17,0,0,13,52,60,0,1,43,71,25,43,15,28,6,11,12,40,71
2011-08-29 00:00:00.000,US Open NY; U.S.A. Grand Slams,HARD,3,Marin Cilic,Bernard Tomic,Marin Cilic,6-1; 6-0; 6-2,R64,80,8,1,29,54,21,29,21,25,5,5,10,42,54,5,4,42,75,22,42,9,33,4,12,11,31,75
2011-08-29 00:00:00.000,US Open NY; U.S.A. Grand Slams,HARD,3,Juan Monaco,Radek Stepanek,Juan Monaco,6-4; 6-1; 2-0 RET,R64,103,0,1,40,54,27,40,9,14,3,4,9,36,54,3,4,43,78,27,43,11,35,6,12,10,38,78
2011-08-29 00:00:00.000,US Open NY; U.S.A. Grand Slams,HARD,3,Tommy Haas,Alejandro Falla,Tommy Haas,7-6(5); 6-1; 7-5,R64,136,5,6,55,96,43,55,22,41,3,5,15,65,96,9,3,55,111,35,55,27,56,5,11,16,62,111
2011-08-29 00:00:00.000,US Open NY; U.S.A. Grand Slams,HARD,3,Jo-Wilfried Tsonga,Sergei Bubka,Jo-Wilfried Tsonga,6-3; 7-5; 6-2,R64,105,5,4,48,90,38,48,23,42,1,2,15,61,90,4,1,42,75,32,42,12,33,2,7,14,44,75
2011-08-29 00:00:00.000,US Open NY; U.S.A. Grand Slams,HARD,3,Fernando Verdasco,Marsel Ilhan,Fernando Verdasco,6-4; 6-3; 6-1,R64,99,10,3,38,63,33,38,17,25,0,1,13,50,63,3,3,54,87,34,54,13,33,4,10,13,47,87
2011-08-29 00:00:00.000,US Open NY; U.S.A. Grand Slams,HARD,3,Kevin Anderson,Michael Llodra,Kevin Anderson,6-1; 6-2; 6-2,R64,93,14,1,53,63,42,53,8,10,1,1,12,50,63,2,6,39,82,23,39,16,43,7,13,11,39,82
2011-08-29 00:00:00.000,US Open NY; U.S.A. Grand Slams,HARD,3,Mardy Fish,Malek Jaziri,Mardy Fish,6-2; 6-2; 6-4,R64,113,7,3,44,84,33,44,26,40,2,2,13,59,84,4,7,50,95,30,50,21,45,11,16,13,51,95
2011-08-29 00:00:00.000,US Open NY; U.S.A. Grand Slams,HARD,3,Alex Bogomolov Jr.,Rogerio Dutra Silva,Alex Bogomolov Jr.,6-4; 6-3; 7-5,R64,158,0,3,83,107,57,83,11,24,5,7,16,68,107,3,1,46,101,29,46,28,55,7,12,15,57,101
2011-08-29 00:00:00.000,US Open NY; U.S.A. Grand Slams,HARD,3,John Isner,Robby Ginepri,John Isner,6-4; 6-3; 6-4,R64,108,20,0,58,85,50,58,16,27,2,2,15,66,85,4,4,43,76,29,43,21,33,1,4,14,50,76
2011-08-29 00:00:00.000,US Open NY; U.S.A. Grand Slams,HARD,3,Juan Martin Del Potro,Diego Junqueira,Juan Martin Del Potro,6-2; 6-1; 7-5,R64,131,9,2,55,80,40,55,15,25,2,4,14,55,80,0,1,73,92,32,73,12,19,7,14,13,44,92
2011-08-29 00:00:00.000,US Open NY; U.S.A. Grand Slams,HARD,3,Gilles Simon,Guillermo Garcia-Lopez,Gilles Simon,6-4; 6-7(4); 7-5; 6-3,R64,219,11,3,75,134,57,75,31,59,4,6,21,88,134,2,9,78,142,52,78,30,64,6,13,22,82,142
2011-08-29 00:00:00.000,US Open NY; U.S.A. Grand Slams,HARD,3,Donald Young,Stanislas Wawrinka,Donald Young,7-6(7); 3-6; 2-6; 6-3; 7-6(1),R64,260,0,9,102,170,63,102,34,68,10,20,25,97,170,8,7,108,181,71,108,31,73,7,15,25,102,181
2011-08-29 00:00:00.000,US Open NY; U.S.A. Grand Slams,HARD,3,Juan Ignacio Chela,Steve Darcis,Juan Ignacio Chela,6-2; 6-4; 6-4,R64,115,3,0,40,76,32,40,24,36,2,3,14,56,76,4,3,48,95,34,48,21,47,7,12,14,55,95
2011-08-29 00:00:00.000,US Open NY; U.S.A. Grand Slams,HARD,3,Feliciano Lopez,Vasek Pospisil,Feliciano Lopez,5-7; 6-4; 7-6(3); 7-6(5),R64,202,21,7,84,146,71,84,32,62,4,7,23,103,146,19,8,84,158,61,84,44,74,8,11,23,105,158
2011-08-29 00:00:00.000,US Open NY; U.S.A. Grand Slams,HARD,3,Andy Murray,Robin Haase,Andy Murray,6-7(5); 2-6; 6-2; 6-0; 6-4,R64,203,21,8,80,145,62,80,26,65,14,20,22,88,145,6,7,88,148,54,88,25,60,6,16,22,79,148
2011-08-29 00:00:00.000,US Open NY; U.S.A. Grand Slams,HARD,3,David Ferrer,James Blake,David Ferrer,6-4; 6-3; 6-4,R64,114,0,1,60,91,41,60,19,31,7,9,15,60,91,1,5,51,89,37,51,16,38,7,13,14,53,89
2011-08-29 00:00:00.000,US Open NY; U.S.A. Grand Slams,HARD,3,Florian Mayer,Jean-Rene Lisnard,Florian Mayer,6-2; 7-5; 6-2,R64,111,6,5,42,81,34,42,21,39,5,7,14,55,81,3,5,37,87,26,37,18,50,8,15,14,44,87
2011-08-29 00:00:00.000,US Open NY; U.S.A. Grand Slams,HARD,3,Andy Roddick,Jack Sock,Andy Roddick,6-3; 6-3; 6-4,R64,120,11,1,60,84,44,60,16,24,6,7,14,60,84,9,2,46,79,31,46,13,33,0,5,14,44,79
2011-08-29 00:00:00.000,US Open NY; U.S.A. Grand Slams,HARD,3,Julien Benneteau,Denis Istomin,Julien Benneteau,6-4; 6-4; 6-4,R64,136,3,8,61,99,43,61,17,38,3,6,15,60,99,7,2,53,94,36,53,18,41,5,11,15,54,94
2011-08-29 00:00:00.000,US Open NY; U.S.A. Grand Slams,HARD,3,Gilles Muller,Ernests Gulbis,Gilles Muller,3-6; 7-6(4); 6-4; 7-6(5),R64,228,19,10,84,158,69,84,35,74,10,14,22,104,158,19,14,84,140,69,84,25,56,5,8,21,94,140
2011-08-29 00:00:00.000,US Open NY; U.S.A. Grand Slams,HARD,3,Igor Kunitsyn,Jurgen Melzer,Igor Kunitsyn,3-6; 6-3; 1-6; 6-2; 7-6(5),R64,207,6,4,94,167,59,94,32,73,13,21,23,91,167,8,9,66,135,48,66,31,69,5,12,22,79,135
2011-08-29 00:00:00.000,US Open NY; U.S.A. Grand Slams,HARD,3,David Nalbandian,Ivan Ljubicic,David Nalbandian,6-4; 1-6; 6-3; 6-2,R64,144,5,6,55,93,37,55,23,38,2,6,17,60,93,15,8,51,115,42,51,22,64,10,16,17,64,115
2011-08-29 00:00:00.000,US Open NY; U.S.A. Grand Slams,HARD,3,Rafael Nadal,Nicolas Mahut,Rafael Nadal,6-2; 6-2 RET,R64,81,3,1,34,49,28,34,8,15,4,4,8,36,49,2,5,36,65,21,36,11,29,2,6,9,32,65
2011-08-29 00:00:00.000,US Open NY; U.S.A. Grand Slams,HARD,3,Novak Djokovic,Nikolay Davydenko,Novak Djokovic,6-3; 6-4; 6-2,R32,127,4,0,49,80,37,49,20,31,1,2,14,57,80,1,2,59,81,33,59,10,22,7,12,13,43,81
2011-08-29 00:00:00.000,US Open NY; U.S.A. Grand Slams,HARD,3,Alexandr Dolgopolov,Ivo Karlovic,Alexandr Dolgopolov,6-7(4); 6-2; 6-4; 6-4,R32,161,22,1,58,110,48,58,30,52,3,5,20,78,110,23,4,80,129,62,80,19,49,8,14,20,81,129
2011-08-29 00:00:00.000,US Open NY; U.S.A. Grand Slams,HARD,3,Janko Tipsarevic,Tomas Berdych,Janko Tipsarevic,6-4; 5-0 RET,R32,70,4,1,25,45,17,25,13,20,0,0,7,30,45,0,3,23,45,13,23,9,22,0,4,8,22,45
2011-08-29 00:00:00.000,US Open NY; U.S.A. Grand Slams,HARD,3,Juan Carlos Ferrero,Marcel Granollers,Juan Carlos Ferrero,6-1; 4-3 RET,R32,51,3,1,31,41,25,31,5,10,1,1,7,30,41,1,1,26,39,16,26,5,13,1,4,7,21,39
2011-08-29 00:00:00.000,US Open NY; U.S.A. Grand Slams,HARD,3,Roger Federer,Marin Cilic,Roger Federer,6-3; 4-6; 6-4; 6-2,R32,160,6,3,63,108,47,63,28,45,7,9,19,75,108,12,5,57,119,39,57,32,62,8,14,18,71,119
2011-08-29 00:00:00.000,US Open NY; U.S.A. Grand Slams,HARD,3,Juan Monaco,Tommy Haas,Juan Monaco,6-7(3); 6-3; 6-2; 6-3,R32,189,6,4,84,125,61,84,24,41,2,4,19,85,125,7,6,80,139,57,80,22,59,10,17,19,79,139
2011-08-29 00:00:00.000,US Open NY; U.S.A. Grand Slams,HARD,3,Jo-Wilfried Tsonga,Fernando Verdasco,Jo-Wilfried Tsonga,6-3; 7-5; 6-4,R32,126,11,2,54,91,44,54,19,37,2,4,16,63,91,4,3,65,81,44,65,4,16,3,8,15,48,81
2011-08-29 00:00:00.000,US Open NY; U.S.A. Grand Slams,HARD,3,Mardy Fish,Kevin Anderson,Mardy Fish,6-4; 7-6(4); 7-6(3),R32,200,12,2,69,127,48,69,35,58,7,9,17,83,127,6,4,75,121,45,75,28,46,10,13,17,73,121
2011-08-29 00:00:00.000,US Open NY; U.S.A. Grand Slams,HARD,3,John Isner,Alex Bogomolov Jr.,John Isner,7-6(9); 6-4; 6-4,R32,153,19,3,72,101,61,72,17,29,8,8,16,78,101,3,6,76,114,56,76,20,38,6,8,16,76,114
2011-08-29 00:00:00.000,US Open NY; U.S.A. Grand Slams,HARD,3,Gilles Simon,Juan Martin Del Potro,Gilles Simon,4-6; 7-6(5); 6-2; 7-6(3),R32,237,11,4,90,151,70,90,31,61,12,14,21,101,151,3,5,89,152,64,89,32,63,9,12,21,96,152
2011-08-29 00:00:00.000,US Open NY; U.S.A. Grand Slams,HARD,3,Donald Young,Juan Ignacio Chela,Donald Young,7-5; 6-4; 6-3,R32,135,4,3,63,89,47,63,16,26,5,7,16,63,89,1,1,64,107,38,64,22,43,5,10,15,60,107
2011-08-29 00:00:00.000,US Open NY; U.S.A. Grand Slams,HARD,3,Andy Murray,Feliciano Lopez,Andy Murray,6-1; 6-4; 6-2,R32,114,3,0,55,74,41,55,15,19,2,2,13,56,74,5,8,36,81,24,36,18,45,8,13,12,42,81
2011-08-29 00:00:00.000,US Open NY; U.S.A. Grand Slams,HARD,3,David Ferrer,Florian Mayer,David Ferrer,6-1; 6-2; 7-6(2),R32,107,5,4,52,93,40,52,24,41,3,4,14,64,93,6,3,44,76,31,44,13,32,3,8,13,44,76
2011-08-29 00:00:00.000,US Open NY; U.S.A. Grand Slams,HARD,3,Andy Roddick,Julien Benneteau,Andy Roddick,6-1; 6-4; 7-6(5),R32,128,21,0,60,91,49,60,21,31,3,3,15,70,91,17,4,60,97,44,60,18,37,9,12,14,62,97
2011-08-29 00:00:00.000,US Open NY; U.S.A. Grand Slams,HARD,3,Gilles Muller,Igor Kunitsyn,Gilles Muller,6-1; 6-4; 6-4,R32,115,22,4,45,86,39,45,24,41,4,4,14,63,86,2,4,38,81,28,38,20,43,5,9,13,48,81
2011-08-29 00:00:00.000,US Open NY; U.S.A. Grand Slams,HARD,3,Rafael Nadal,David Nalbandian,Rafael Nadal,7-6(5); 6-1; 7-5,R32,159,2,4,79,102,55,79,10,23,5,8,15,65,102,6,7,48,91,30,48,17,43,4,10,16,47,91
2011-08-29 00:00:00.000,US Open NY; U.S.A. Grand Slams,HARD,3,Novak Djokovic,Alexandr Dolgopolov,Novak Djokovic,7-6(14); 6-4; 6-2,R16,146,2,3,69,105,52,69,19,36,4,6,15,71,105,5,5,41,94,32,41,22,53,2,7,15,54,94
2011-08-29 00:00:00.000,US Open NY; U.S.A. Grand Slams,HARD,3,Janko Tipsarevic,Juan Carlos Ferrero,Janko Tipsarevic,7-5; 6-7(3); 7-5; 6-2,R16,223,20,3,81,128,61,81,35,47,2,2,22,96,128,8,8,86,152,63,86,33,66,6,10,22,96,152
2011-08-29 00:00:00.000,US Open NY; U.S.A. Grand Slams,HARD,3,Roger Federer,Juan Monaco,Roger Federer,6-1; 6-2; 6-0,R16,82,14,1,39,59,33,39,13,20,0,0,11,46,59,1,2,45,68,18,45,11,23,7,14,10,29,68
2011-08-29 00:00:00.000,US Open NY; U.S.A. Grand Slams,HARD,3,Jo-Wilfried Tsonga,Mardy Fish,Jo-Wilfried Tsonga,6-4; 6-7(5); 3-6; 6-4; 6-2,R16,225,12,3,95,164,70,95,41,69,6,8,25,111,164,3,4,85,138,62,85,31,53,2,6,24,93,138
2011-08-29 00:00:00.000,US Open NY; U.S.A. Grand Slams,HARD,3,John Isner,Gilles Simon,John Isner,7-6(2); 3-6; 7-6(2); 7-6(4),R16,219,26,5,100,158,67,100,34,58,7,12,22,101,158,6,1,102,148,74,102,24,46,5,9,23,98,148
2011-08-29 00:00:00.000,US Open NY; U.S.A. Grand Slams,HARD,3,Andy Murray,Donald Young,Andy Murray,6-2; 6-3; 6-3,R16,118,5,3,35,74,24,35,22,39,2,5,13,46,74,2,5,46,78,22,46,12,32,3,11,13,34,78
2011-08-29 00:00:00.000,US Open NY; U.S.A. Grand Slams,HARD,3,Andy Roddick,David Ferrer,Andy Roddick,6-3; 6-4; 3-6; 6-3,R16,160,19,2,77,112,55,77,24,35,7,9,19,79,112,12,4,58,104,41,58,26,46,3,7,18,67,104
2011-08-29 00:00:00.000,US Open NY; U.S.A. Grand Slams,HARD,3,Rafael Nadal,Gilles Muller,Rafael Nadal,7-6(1); 6-1; 6-2,R16,128,5,4,54,74,44,54,11,20,0,2,14,55,74,11,1,50,92,33,50,14,42,6,12,13,47,92
2011-08-29 00:00:00.000,US Open NY; U.S.A. Grand Slams,HARD,3,Novak Djokovic,Janko Tipsarevic,Novak Djokovic,7-6(2); 6-7(3); 6-0; 3-0 RET,Q,207,8,2,82,126,53,82,22,44,9,13,17,75,126,10,5,71,108,46,71,8,37,5,13,17,54,108
2011-08-29 00:00:00.000,US Open NY; U.S.A. Grand Slams,HARD,3,Roger Federer,Jo-Wilfried Tsonga,Roger Federer,6-4; 6-3; 6-3,Q,113,5,2,61,86,47,61,11,25,1,3,14,58,86,5,2,45,85,31,45,16,40,7,13,14,47,85
2011-08-29 00:00:00.000,US Open NY; U.S.A. Grand Slams,HARD,3,Andy Murray,John Isner,Andy Murray,7-5; 6-4; 3-6; 7-6(2),Q,204,14,2,87,128,68,87,26,41,5,6,21,94,128,17,5,91,135,67,91,22,44,3,5,22,89,135
2011-08-29 00:00:00.000,US Open NY; U.S.A. Grand Slams,HARD,3,Rafael Nadal,Andy Roddick,Rafael Nadal,6-2; 6-1; 6-3,Q,113,6,1,46,67,38,46,12,21,4,4,12,50,67,9,3,40,68,25,40,9,28,1,7,12,34,68
2011-08-29 00:00:00.000,US Open NY; U.S.A. Grand Slams,HARD,3,Novak Djokovic,Roger Federer,Novak Djokovic,6-7(7); 4-6; 6-3; 6-2; 7-5,S,231,8,6,82,140,68,82,32,58,2,5,26,100,140,11,4,101,164,68,101,35,63,6,12,25,103,164
2011-08-29 00:00:00.000,US Open NY; U.S.A. Grand Slams,HARD,3,Rafael Nadal,Andy Murray,Rafael Nadal,6-4; 6-2; 3-6; 6-2,S,204,3,1,75,111,54,75,20,36,8,10,17,74,111,8,2,65,121,43,65,26,56,12,18,18,69,121
2011-08-29 00:00:00.000,US Open NY; U.S.A. Grand Slams,HARD,3,Novak Djokovic,Rafael Nadal,Novak Djokovic,6-2; 6-4; 6-7(3); 6-1,F,250,7,1,84,127,55,84,19,43,8,14,19,74,127,2,3,96,141,50,96,19,45,15,27,18,69,141
2011-09-19 00:00:00.000,Bucharest Romania ATP World Tour 250,CLAY,2,Juan Ignacio Chela,N/A Bye,Juan Ignacio Chela,,R32,0,0,0,0,0,0,0,0,0,0,0,0,0,0,0,0,0,0,0,0,0,0,0,0,0,0,0
2011-09-19 00:00:00.000,Bucharest Romania ATP World Tour 250,CLAY,2,Florent Serra,Gianluca Naso,Florent Serra,6-2; 6-4,R32,70,2,1,38,52,31,38,9,14,1,1,9,40,52,7,2,36,53,24,36,7,17,0,3,9,31,53
2011-09-19 00:00:00.000,Bucharest Romania ATP World Tour 250,CLAY,2,Igor Andreev,Peter Torebko,Igor Andreev,5-7; 6-4; 7-5,R32,153,1,5,69,102,48,69,14,33,3,7,17,62,102,12,4,56,100,38,56,22,44,4,9,17,60,100
2011-09-19 00:00:00.000,Bucharest Romania ATP World Tour 250,CLAY,2,Andreas Seppi,Eric Prodon,Andreas Seppi,6-1; 4-6; 6-1,R32,102,3,1,55,86,34,55,19,31,10,12,12,53,86,3,4,48,80,29,48,11,32,7,13,12,40,80
2011-09-19 00:00:00.000,Bucharest Romania ATP World Tour 250,CLAY,2,Pablo Andujar,N/A Bye,Pablo Andujar,,R32,0,0,0,0,0,0,0,0,0,0,0,0,0,0,0,0,0,0,0,0,0,0,0,0,0,0,0
2011-09-19 00:00:00.000,Bucharest Romania ATP World Tour 250,CLAY,2,Marius Copil,Victor Crivoi,Marius Copil,6-3; 6-3,R32,76,7,1,30,52,25,30,12,22,0,0,9,37,52,1,1,44,58,27,44,5,14,8,11,9,32,58
2011-09-19 00:00:00.000,Bucharest Romania ATP World Tour 250,CLAY,2,Frederico Gil,Jeremy Chardy,Frederico Gil,2-6; 6-4; 6-3,R32,135,5,4,65,86,45,65,11,21,1,3,14,56,86,5,7,63,96,46,63,15,33,8,10,13,61,96
2011-09-19 00:00:00.000,Bucharest Romania ATP World Tour 250,CLAY,2,Alessandro Giannessi,Albert Montanes,Alessandro Giannessi,7-5; 6-4,R32,108,2,2,48,73,31,48,12,25,7,10,11,43,73,2,5,38,72,21,38,17,34,4,9,11,38,72
2011-09-19 00:00:00.000,Bucharest Romania ATP World Tour 250,CLAY,2,Joao Souza,Tommy Robredo,Joao Souza,6-4; 7-6(5),R32,123,5,2,52,81,40,52,13,29,5,7,11,53,81,5,2,45,71,30,45,15,26,5,8,11,45,71
2011-09-19 00:00:00.000,Bucharest Romania ATP World Tour 250,CLAY,2,Adrian Ungur,Lukas Rosol,Adrian Ungur,6-4; 6-1,R32,66,3,4,34,51,26,34,10,17,3,3,8,36,51,2,4,34,66,19,34,16,32,9,13,9,35,66
2011-09-19 00:00:00.000,Bucharest Romania ATP World Tour 250,CLAY,2,Filippo Volandri,Rui Machado,Filippo Volandri,6-3; 6-3,R32,86,0,4,36,53,28,36,8,17,3,5,9,36,53,0,3,41,61,20,41,9,20,5,10,9,29,61
2011-09-19 00:00:00.000,Bucharest Romania ATP World Tour 250,CLAY,2,Marcel Granollers,N/A Bye,Marcel Granollers,,R32,0,0,0,0,0,0,0,0,0,0,0,0,0,0,0,0,0,0,0,0,0,0,0,0,0,0,0
2011-09-19 00:00:00.000,Bucharest Romania ATP World Tour 250,CLAY,2,Pere Riba,Potito Starace,Pere Riba,6-1; 3-2 RET,R32,59,3,0,33,50,26,33,7,17,2,2,6,33,50,1,2,22,34,13,22,3,12,2,5,6,16,34
2011-09-19 00:00:00.000,Bucharest Romania ATP World Tour 250,CLAY,2,Albert Ramos,Victor Hanescu,Albert Ramos,6-4; 6-3,R32,79,3,1,30,50,24,30,12,20,4,5,9,36,50,1,0,39,56,22,39,9,17,2,6,10,31,56
2011-09-19 00:00:00.000,Bucharest Romania ATP World Tour 250,CLAY,2,Carlos Berlocq,Andreas Haider-Maurer,Carlos Berlocq,6-2; 6-1,R32,78,2,0,19,32,16,19,12,13,0,0,7,28,32,0,3,29,60,12,29,14,31,7,12,8,26,60
2011-09-19 00:00:00.000,Bucharest Romania ATP World Tour 250,CLAY,2,Florian Mayer,N/A Bye,Florian Mayer,,R32,0,0,0,0,0,0,0,0,0,0,0,0,0,0,0,0,0,0,0,0,0,0,0,0,0,0,0
2011-09-19 00:00:00.000,Bucharest Romania ATP World Tour 250,CLAY,2,Juan Ignacio Chela,Florent Serra,Juan Ignacio Chela,6-1; 6-0,R16,62,2,1,30,38,24,30,3,8,5,5,6,27,38,1,0,32,54,12,32,9,22,5,11,7,21,54
2011-09-19 00:00:00.000,Bucharest Romania ATP World Tour 250,CLAY,2,Andreas Seppi,Igor Andreev,Andreas Seppi,6-2; 3-6; 6-1,R16,106,4,0,49,80,35,49,21,31,9,10,12,56,80,3,3,48,76,28,48,15,28,2,6,12,43,76
2011-09-19 00:00:00.000,Bucharest Romania ATP World Tour 250,CLAY,2,Pablo Andujar,Marius Copil,Pablo Andujar,6-2; 6-3,R16,76,1,0,34,48,22,34,11,14,3,4,8,33,48,5,4,32,49,17,32,4,17,2,7,9,21,49
2011-09-19 00:00:00.000,Bucharest Romania ATP World Tour 250,CLAY,2,Alessandro Giannessi,Frederico Gil,Alessandro Giannessi,7-6(2); 0-6; 6-3,R16,145,0,6,71,107,48,71,14,36,8,13,14,62,107,6,0,43,71,30,43,15,28,1,4,13,45,71
2011-09-19 00:00:00.000,Bucharest Romania ATP World Tour 250,CLAY,2,Joao Souza,Adrian Ungur,Joao Souza,4-6; 7-6(6); 6-1,R16,165,13,3,64,98,43,64,19,34,6,9,15,62,98,3,3,80,125,46,80,24,45,12,16,14,70,125
2011-09-19 00:00:00.000,Bucharest Romania ATP World Tour 250,CLAY,2,Filippo Volandri,Marcel Granollers,Filippo Volandri,6-1; 6-3,R16,76,0,2,37,49,24,37,8,12,3,4,8,32,49,2,0,31,51,16,31,8,20,3,8,8,24,51
2011-09-19 00:00:00.000,Bucharest Romania ATP World Tour 250,CLAY,2,Albert Ramos,Pere Riba,Albert Ramos,2-6; 6-4; 7-5,R16,175,7,6,66,100,48,66,15,34,9,12,15,63,100,3,2,55,101,40,55,21,46,7,10,15,61,101
2011-09-19 00:00:00.000,Bucharest Romania ATP World Tour 250,CLAY,2,Florian Mayer,Carlos Berlocq,Florian Mayer,6-2; 0-6; 6-4,R16,112,1,1,44,70,27,44,12,26,4,9,12,39,70,4,1,53,78,34,53,9,25,7,12,12,43,78
2011-09-19 00:00:00.000,Bucharest Romania ATP World Tour 250,CLAY,2,Juan Ignacio Chela,Andreas Seppi,Juan Ignacio Chela,7-5; 6-3,Q,113,5,2,50,78,26,50,17,28,6,10,11,43,78,2,2,40,70,22,40,9,30,5,11,10,31,70
2011-09-19 00:00:00.000,Bucharest Romania ATP World Tour 250,CLAY,2,Pablo Andujar,Alessandro Giannessi,Pablo Andujar,6-3; 6-4,Q,96,3,2,58,73,42,58,5,15,9,10,10,47,73,1,4,31,50,21,31,7,19,0,3,9,28,50
2011-09-19 00:00:00.000,Bucharest Romania ATP World Tour 250,CLAY,2,Filippo Volandri,Joao Souza,Filippo Volandri,6-2; 6-0,Q,61,1,0,36,45,22,36,4,9,2,4,7,26,45,0,1,26,36,6,26,2,10,4,11,7,8,36
2011-09-19 00:00:00.000,Bucharest Romania ATP World Tour 250,CLAY,2,Florian Mayer,Albert Ramos,Florian Mayer,6-1; 6-2,Q,67,3,3,34,49,27,34,8,15,2,2,8,35,49,0,1,24,46,11,24,10,22,6,10,7,21,46
2011-09-19 00:00:00.000,Bucharest Romania ATP World Tour 250,CLAY,2,Pablo Andujar,Juan Ignacio Chela,Pablo Andujar,6-4; 7-5,S,112,3,1,50,66,34,50,7,16,7,10,11,41,66,0,1,62,75,31,62,6,13,7,12,11,37,75
2011-09-19 00:00:00.000,Bucharest Romania ATP World Tour 250,CLAY,2,Florian Mayer,Filippo Volandri,Florian Mayer,7-6(3); 6-2,S,98,7,0,38,70,28,38,16,32,7,9,10,44,70,0,2,50,67,28,50,6,17,6,10,10,34,67
2011-09-19 00:00:00.000,Bucharest Romania ATP World Tour 250,CLAY,2,Florian Mayer,Pablo Andujar,Florian Mayer,6-3; 6-1,F,71,0,1,27,48,20,27,11,21,2,3,8,31,48,1,2,37,51,20,37,4,14,2,7,8,24,51
2011-09-19 00:00:00.000,Metz France ATP World Tour 250,HARD,2,Jo-Wilfried Tsonga,N/A Bye,Jo-Wilfried Tsonga,,R32,0,0,0,0,0,0,0,0,0,0,0,0,0,0,0,0,0,0,0,0,0,0,0,0,0,0,0
2011-09-19 00:00:00.000,Metz France ATP World Tour 250,HARD,2,Mathieu Rodrigues,Mikhail Kukushkin,Mathieu Rodrigues,6-2; 3-6; 6-4,R32,141,1,4,48,95,33,48,22,47,6,10,14,55,95,4,3,47,90,30,47,22,43,9,14,13,52,90
2011-09-19 00:00:00.000,Metz France ATP World Tour 250,HARD,2,Nicolas Mahut,Diego Junqueira,Nicolas Mahut,6-3; 6-2,R32,61,7,2,27,42,25,27,11,15,0,0,9,36,42,1,0,34,48,21,34,6,14,3,6,8,27,48
2011-09-19 00:00:00.000,Metz France ATP World Tour 250,HARD,2,Arnaud Clement,Michael Llodra,Arnaud Clement,6-3; 6-4,R32,80,3,1,29,62,20,29,22,33,3,4,10,42,62,7,3,41,56,28,41,6,15,3,6,9,34,56
2011-09-19 00:00:00.000,Metz France ATP World Tour 250,HARD,2,Alexandr Dolgopolov,N/A Bye,Alexandr Dolgopolov,,R32,0,0,0,0,0,0,0,0,0,0,0,0,0,0,0,0,0,0,0,0,0,0,0,0,0,0,0
2011-09-19 00:00:00.000,Metz France ATP World Tour 250,HARD,2,Marcos Baghdatis,Matthias Bachinger,Marcos Baghdatis,7-5; 6-2,R32,76,3,0,32,55,28,32,14,23,1,1,10,42,55,5,2,38,61,26,38,10,23,4,7,10,36,61
2011-09-19 00:00:00.000,Metz France ATP World Tour 250,HARD,2,Igor Kunitsyn,Kenny De Schepper,Igor Kunitsyn,7-5; 5-7; 6-4,R32,143,1,0,64,98,47,64,19,34,0,2,17,66,98,15,7,67,118,49,67,22,51,11,14,17,71,118
2011-09-19 00:00:00.000,Metz France ATP World Tour 250,HARD,2,Xavier Malisse,Michael Berrer,Xavier Malisse,6-4; 3-6; 6-4,R32,102,12,1,46,80,36,46,22,34,1,2,14,58,80,8,3,49,83,39,49,20,34,5,7,15,59,83
2011-09-19 00:00:00.000,Metz France ATP World Tour 250,HARD,2,Philipp Kohlschreiber,Jonathan Dasnieres de Veigy,Philipp Kohlschreiber,6-4; 7-6(4),R32,86,10,5,45,79,35,45,21,34,5,5,11,56,79,3,0,38,53,34,38,9,15,0,1,11,43,53
2011-09-19 00:00:00.000,Metz France ATP World Tour 250,HARD,2,Igor Sijsling,Grigor Dimitrov,Igor Sijsling,6-2; 6-2,R32,54,10,2,24,42,22,24,11,18,2,2,8,33,42,1,2,35,46,20,35,4,11,2,6,8,24,46
2011-09-19 00:00:00.000,Metz France ATP World Tour 250,HARD,2,Nicolas Renavand,Tobias Kamke,Nicolas Renavand,7-5; 6-4,R32,89,8,2,49,70,32,49,10,21,7,10,11,42,70,4,6,35,78,21,35,19,43,2,7,11,40,78
2011-09-19 00:00:00.000,Metz France ATP World Tour 250,HARD,2,Ivan Ljubicic,N/A Bye,Ivan Ljubicic,,R32,0,0,0,0,0,0,0,0,0,0,0,0,0,0,0,0,0,0,0,0,0,0,0,0,0,0,0
2011-09-19 00:00:00.000,Metz France ATP World Tour 250,HARD,2,Gilles Muller,Philipp Petzschner,Gilles Muller,7-6(2); 7-6(5),R32,105,8,2,54,93,46,54,16,39,5,6,12,62,93,5,0,46,67,36,46,15,21,0,1,12,51,67
2011-09-19 00:00:00.000,Metz France ATP World Tour 250,HARD,2,Benoit Paire,Andrey Golubev,Benoit Paire,7-5; 6-2,R32,70,8,2,26,50,22,26,16,24,0,1,10,38,50,2,1,46,70,24,46,12,24,6,10,10,36,70
2011-09-19 00:00:00.000,Metz France ATP World Tour 250,HARD,2,Olivier Rochus,Stephane Robert,Olivier Rochus,6-1; 6-3,R32,72,0,0,37,58,29,37,10,21,5,5,8,39,58,0,0,18,47,12,18,12,29,1,5,8,24,47
2011-09-19 00:00:00.000,Metz France ATP World Tour 250,HARD,2,Richard Gasquet,N/A Bye,Richard Gasquet,,R32,0,0,0,0,0,0,0,0,0,0,0,0,0,0,0,0,0,0,0,0,0,0,0,0,0,0,0
2011-09-19 00:00:00.000,Metz France ATP World Tour 250,HARD,2,Jo-Wilfried Tsonga,Mathieu Rodrigues,Jo-Wilfried Tsonga,6-3; 6-4,R16,76,10,1,35,54,30,35,8,19,0,1,10,38,54,4,2,37,70,25,37,14,33,9,12,9,39,70
2011-09-19 00:00:00.000,Metz France ATP World Tour 250,HARD,2,Nicolas Mahut,Arnaud Clement,Nicolas Mahut,3-6; 7-5; 6-3,R16,153,15,3,59,89,45,59,14,30,3,5,15,59,89,11,5,68,114,49,68,19,46,9,12,15,68,114
2011-09-19 00:00:00.000,Metz France ATP World Tour 250,HARD,2,Alexandr Dolgopolov,Marcos Baghdatis,Alexandr Dolgopolov,6-7(5); 7-5; 6-3,R16,141,10,6,61,116,48,61,30,55,6,7,17,78,116,4,2,48,92,35,48,27,44,3,6,16,62,92
2011-09-19 00:00:00.000,Metz France ATP World Tour 250,HARD,2,Xavier Malisse,Igor Kunitsyn,Xavier Malisse,6-4; 6-2,R16,77,5,1,24,48,20,24,9,24,3,5,9,29,48,3,2,38,62,21,38,9,24,3,8,9,30,62
2011-09-19 00:00:00.000,Metz France ATP World Tour 250,HARD,2,Igor Sijsling,Philipp Kohlschreiber,Igor Sijsling,6-4; 7-5,R16,79,10,3,39,63,35,39,12,24,1,1,11,47,63,7,2,31,63,23,31,19,32,5,7,11,42,63
2011-09-19 00:00:00.000,Metz France ATP World Tour 250,HARD,2,Ivan Ljubicic,Nicolas Renavand,Ivan Ljubicic,7-5; 7-5,R16,79,13,0,33,57,29,33,19,24,0,0,12,48,57,4,0,42,66,31,42,12,24,0,2,12,43,66
2011-09-19 00:00:00.000,Metz France ATP World Tour 250,HARD,2,Gilles Muller,Benoit Paire,Gilles Muller,7-6(5); 6-4,R16,92,12,2,42,68,37,42,13,26,0,0,11,50,68,7,3,30,64,22,30,21,34,0,1,11,43,64
2011-09-19 00:00:00.000,Metz France ATP World Tour 250,HARD,2,Richard Gasquet,Olivier Rochus,Richard Gasquet,6-2; 6-1,R16,65,10,3,31,49,28,31,8,18,1,1,8,36,49,0,1,27,47,11,27,12,20,2,6,7,23,47
2011-09-19 00:00:00.000,Metz France ATP World Tour 250,HARD,2,Jo-Wilfried Tsonga,Nicolas Mahut,Jo-Wilfried Tsonga,4-6; 6-3; 7-5,Q,123,20,3,54,84,45,54,19,30,3,4,16,64,84,7,3,57,89,40,57,17,32,1,3,15,57,89
2011-09-19 00:00:00.000,Metz France ATP World Tour 250,HARD,2,Alexandr Dolgopolov,Xavier Malisse,Alexandr Dolgopolov,6-3; 1-0 RET,Q,36,7,0,15,27,14,15,7,12,0,0,5,21,27,0,0,10,25,5,10,9,15,2,4,5,14,25
2011-09-19 00:00:00.000,Metz France ATP World Tour 250,HARD,2,Ivan Ljubicic,Igor Sijsling,Ivan Ljubicic,6-4; 6-3,Q,74,13,0,34,59,26,34,17,25,1,1,10,43,59,6,3,26,52,20,26,14,26,5,7,9,34,52
2011-09-19 00:00:00.000,Metz France ATP World Tour 250,HARD,2,Gilles Muller,Richard Gasquet,Gilles Muller,6-3; 6-4,Q,71,11,2,34,59,28,34,17,25,6,6,10,45,59,4,0,36,47,29,36,3,11,2,4,9,32,47
2011-09-19 00:00:00.000,Metz France ATP World Tour 250,HARD,2,Jo-Wilfried Tsonga,Alexandr Dolgopolov,Jo-Wilfried Tsonga,6-4; 6-4,S,77,6,0,31,52,27,31,12,21,0,1,10,39,52,2,0,31,59,23,31,12,28,0,3,10,35,59
2011-09-19 00:00:00.000,Metz France ATP World Tour 250,HARD,2,Ivan Ljubicic,Gilles Muller,Ivan Ljubicic,7-6(3); 7-6(5),S,111,26,2,51,81,45,51,16,30,1,1,12,61,81,18,2,47,73,42,47,13,26,0,0,12,55,73
2011-09-19 00:00:00.000,Metz France ATP World Tour 250,HARD,2,Jo-Wilfried Tsonga,Ivan Ljubicic,Jo-Wilfried Tsonga,6-3; 6-7(4); 6-3,F,156,14,4,43,80,37,43,17,37,2,4,14,54,80,12,5,55,110,38,55,26,55,7,13,16,64,110
2011-09-26 00:00:00.000,Bangkok Thailand ATP World Tour 250,HARD,2,Andy Murray,N/A Bye,Andy Murray,,R32,0,0,0,0,0,0,0,0,0,0,0,0,0,0,0,0,0,0,0,0,0,0,0,0,0,0,0
2011-09-26 00:00:00.000,Bangkok Thailand ATP World Tour 250,HARD,2,Michael Berrer,Marco Chiudinelli,Michael Berrer,7-6(4); 6-3,R32,93,7,1,48,70,36,48,12,22,7,8,11,48,70,3,2,43,62,29,43,10,19,0,2,10,39,62
2011-09-26 00:00:00.000,Bangkok Thailand ATP World Tour 250,HARD,2,Simone Bolelli,Ernests Gulbis,Simone Bolelli,7-6(5); 7-6(5),R32,116,10,0,52,73,40,52,13,21,1,3,12,53,73,19,4,62,88,45,62,11,26,3,5,12,56,88
2011-09-26 00:00:00.000,Bangkok Thailand ATP World Tour 250,HARD,2,Grigor Dimitrov,Ivan Dodig,Grigor Dimitrov,6-2; 7-5,R32,92,4,2,41,59,32,41,11,18,3,4,10,43,59,3,1,36,61,22,36,12,25,5,9,10,34,61
2011-09-26 00:00:00.000,Bangkok Thailand ATP World Tour 250,HARD,2,Gilles Simon,N/A Bye,Gilles Simon,,R32,0,0,0,0,0,0,0,0,0,0,0,0,0,0,0,0,0,0,0,0,0,0,0,0,0,0,0
2011-09-26 00:00:00.000,Bangkok Thailand ATP World Tour 250,HARD,2,Yen-Hsun Lu,Joao Souza,Yen-Hsun Lu,6-2; 7-5,R32,80,8,2,36,60,27,36,18,24,3,3,10,45,60,11,1,47,60,28,47,5,13,2,5,10,33,60
2011-09-26 00:00:00.000,Bangkok Thailand ATP World Tour 250,HARD,2,Matthias Bachinger,Greg Jones,Matthias Bachinger,7-5; 6-4,R32,96,9,1,43,53,39,43,5,10,0,0,11,44,53,9,0,59,92,39,59,17,33,12,14,11,56,92
2011-09-26 00:00:00.000,Bangkok Thailand ATP World Tour 250,HARD,2,Danai Udomchoke,Fabio Fognini,Danai Udomchoke,6-4; 3-6; 6-2,R32,118,4,3,44,74,31,44,17,30,3,6,13,48,74,4,7,54,88,34,54,16,34,3,8,14,50,88
2011-09-26 00:00:00.000,Bangkok Thailand ATP World Tour 250,HARD,2,Tobias Kamke,Pablo Andujar,Tobias Kamke,6-0; 6-1,R32,56,0,1,25,42,19,25,10,17,0,0,7,29,42,0,3,25,39,11,25,5,14,2,7,6,16,39
2011-09-26 00:00:00.000,Bangkok Thailand ATP World Tour 250,HARD,2,Go Soeda,Karol Beck,Go Soeda,3-6; 7-6(0); 7-6(4),R32,176,1,5,72,121,51,72,21,49,7,10,16,72,121,11,4,65,113,46,65,25,48,5,7,17,71,113
2011-09-26 00:00:00.000,Bangkok Thailand ATP World Tour 250,HARD,2,Donald Young,Igor Andreev,Donald Young,7-6(6); 2-1 RET,R32,83,0,1,45,62,29,45,7,17,2,4,7,36,62,3,2,39,62,20,39,13,23,4,7,8,33,62
2011-09-26 00:00:00.000,Bangkok Thailand ATP World Tour 250,HARD,2,Guillermo Garcia-Lopez,N/A Bye,Guillermo Garcia-Lopez,,R32,0,0,0,0,0,0,0,0,0,0,0,0,0,0,0,0,0,0,0,0,0,0,0,0,0,0,0
2011-09-26 00:00:00.000,Bangkok Thailand ATP World Tour 250,HARD,2,Robin Haase,Kittipong Wachiramanowong,Robin Haase,6-3; 7-6(1),R32,84,9,2,35,61,29,35,12,26,1,3,10,41,61,3,0,48,72,28,48,12,24,7,11,11,40,72
2011-09-26 00:00:00.000,Bangkok Thailand ATP World Tour 250,HARD,2,Jarkko Nieminen,Dominic Thiem,Jarkko Nieminen,6-1; 4-6; 7-5,R32,118,5,3,62,93,41,62,19,31,1,4,15,60,93,3,2,42,85,28,42,19,43,2,7,14,47,85
2011-09-26 00:00:00.000,Bangkok Thailand ATP World Tour 250,HARD,2,Santiago Giraldo,Dudi Sela,Santiago Giraldo,6-2; 6-3,R32,72,7,0,31,49,21,31,14,18,2,3,9,35,49,0,2,39,56,21,39,7,17,3,7,8,28,56
2011-09-26 00:00:00.000,Bangkok Thailand ATP World Tour 250,HARD,2,Gael Monfils,N/A Bye,Gael Monfils,,R32,0,0,0,0,0,0,0,0,0,0,0,0,0,0,0,0,0,0,0,0,0,0,0,0,0,0,0
2011-09-26 00:00:00.000,Bangkok Thailand ATP World Tour 250,HARD,2,Andy Murray,Michael Berrer,Andy Murray,6-4; 6-2,R16,71,3,0,35,53,26,35,14,18,2,2,9,40,53,3,1,36,47,26,36,3,11,4,7,9,29,47
2011-09-26 00:00:00.000,Bangkok Thailand ATP World Tour 250,HARD,2,Grigor Dimitrov,Simone Bolelli,Grigor Dimitrov,7-6(8); 6-1,R16,99,11,3,33,54,29,33,11,21,0,0,9,40,54,1,0,62,79,34,62,8,17,4,7,10,42,79
2011-09-26 00:00:00.000,Bangkok Thailand ATP World Tour 250,HARD,2,Gilles Simon,Yen-Hsun Lu,Gilles Simon,6-7(4); 7-5; 6-4,R16,174,12,1,68,116,47,68,26,48,1,3,17,73,116,11,5,72,116,55,72,18,44,5,9,17,73,116
2011-09-26 00:00:00.000,Bangkok Thailand ATP World Tour 250,HARD,2,Matthias Bachinger,Danai Udomchoke,Matthias Bachinger,7-6(5); 6-3,R16,101,8,1,42,66,30,42,11,24,3,6,10,41,66,0,3,59,85,34,59,9,26,6,11,11,43,85
2011-09-26 00:00:00.000,Bangkok Thailand ATP World Tour 250,HARD,2,Go Soeda,Tobias Kamke,Go Soeda,6-2; 7-6(7),R16,92,3,1,34,66,23,34,20,32,2,4,10,43,66,1,2,38,62,23,38,11,24,2,6,10,34,62
2011-09-26 00:00:00.000,Bangkok Thailand ATP World Tour 250,HARD,2,Donald Young,Guillermo Garcia-Lopez,Donald Young,6-1; 6-7(0); 7-5,R16,159,2,2,63,100,42,63,24,37,4,6,16,66,100,9,0,64,108,37,64,25,44,7,12,15,62,108
2011-09-26 00:00:00.000,Bangkok Thailand ATP World Tour 250,HARD,2,Jarkko Nieminen,Robin Haase,Jarkko Nieminen,7-6(5); 7-6(4),R16,97,3,1,59,80,40,59,11,21,0,3,12,51,80,11,4,49,77,38,49,11,28,1,4,12,49,77
2011-09-26 00:00:00.000,Bangkok Thailand ATP World Tour 250,HARD,2,Gael Monfils,Santiago Giraldo,Gael Monfils,6-4; 4-6; 6-1,R16,119,11,5,52,86,39,52,20,34,5,6,13,59,86,2,3,59,98,35,59,22,39,5,9,14,57,98
2011-09-26 00:00:00.000,Bangkok Thailand ATP World Tour 250,HARD,2,Andy Murray,Grigor Dimitrov,Andy Murray,6-4; 6-4,Q,89,2,0,31,59,23,31,20,28,3,3,10,43,59,4,3,36,58,26,36,11,22,1,3,10,37,58
2011-09-26 00:00:00.000,Bangkok Thailand ATP World Tour 250,HARD,2,Gilles Simon,Matthias Bachinger,Gilles Simon,3-6; 6-3; 6-2,Q,96,2,4,60,92,45,60,15,32,6,7,13,60,92,12,5,48,77,37,48,12,29,3,6,13,49,77
2011-09-26 00:00:00.000,Bangkok Thailand ATP World Tour 250,HARD,2,Donald Young,Go Soeda,Donald Young,6-1; 6-2,Q,56,4,0,35,40,28,35,4,5,0,0,8,32,40,5,1,22,43,9,22,10,21,4,8,7,19,43
2011-09-26 00:00:00.000,Bangkok Thailand ATP World Tour 250,HARD,2,Gael Monfils,Jarkko Nieminen,Gael Monfils,7-5; 7-6(4),Q,97,8,3,60,73,44,60,4,13,0,2,12,48,73,2,0,53,83,34,53,16,30,4,7,12,50,83
2011-09-26 00:00:00.000,Bangkok Thailand ATP World Tour 250,HARD,2,Andy Murray,Gilles Simon,Andy Murray,6-2; 3-6; 6-2,S,113,7,0,42,64,32,42,11,22,0,2,12,43,64,5,1,49,79,28,49,17,30,5,10,13,45,79
2011-09-26 00:00:00.000,Bangkok Thailand ATP World Tour 250,HARD,2,Donald Young,Gael Monfils,Donald Young,4-6; 7-6(5); 7-6(5),S,167,0,3,80,110,48,80,16,30,5,10,17,64,110,13,8,76,127,46,76,29,51,6,10,17,75,127
2011-09-26 00:00:00.000,Bangkok Thailand ATP World Tour 250,HARD,2,Andy Murray,Donald Young,Andy Murray,6-2; 6-0,F,48,5,0,28,37,23,28,6,9,0,0,7,29,37,0,1,25,34,8,25,4,9,0,5,7,12,34
2011-09-26 00:00:00.000,Kuala Lumpur Malaysia ATP World Tour 250,HARD,2,Nicolas Almagro,N/A Bye,Nicolas Almagro,,R32,0,0,0,0,0,0,0,0,0,0,0,0,0,0,0,0,0,0,0,0,0,0,0,0,0,0,0
2011-09-26 00:00:00.000,Kuala Lumpur Malaysia ATP World Tour 250,HARD,2,Albert Ramos,Mikhail Kukushkin,Albert Ramos,4-6; 6-3; 4-2 RET,R32,130,4,4,46,81,33,46,21,35,4,6,13,54,81,4,2,53,87,35,53,16,34,5,8,12,51,87
2011-09-26 00:00:00.000,Kuala Lumpur Malaysia ATP World Tour 250,HARD,2,Philipp Petzschner,Mischa Zverev,Philipp Petzschner,7-5; 6-3,R32,73,4,3,29,54,21,29,16,25,3,5,10,37,54,2,3,49,77,28,49,10,28,3,8,11,38,77
2011-09-26 00:00:00.000,Kuala Lumpur Malaysia ATP World Tour 250,HARD,2,Kei Nishikori,Teymuraz Gabashvili,Kei Nishikori,3-6; 6-4; 6-1,R32,132,2,1,50,86,33,50,18,36,7,11,13,51,86,4,6,48,82,29,48,14,34,7,13,13,43,82
2011-09-26 00:00:00.000,Kuala Lumpur Malaysia ATP World Tour 250,HARD,2,Janko Tipsarevic,N/A Bye,Janko Tipsarevic,,R32,0,0,0,0,0,0,0,0,0,0,0,0,0,0,0,0,0,0,0,0,0,0,0,0,0,0,0
2011-09-26 00:00:00.000,Kuala Lumpur Malaysia ATP World Tour 250,HARD,2,Flavio Cipolla,Bernard Tomic,Flavio Cipolla,6-2; 6-2,R32,73,0,3,41,54,29,41,7,13,5,6,8,36,54,3,3,30,47,17,30,5,17,3,8,8,22,47
2011-09-26 00:00:00.000,Kuala Lumpur Malaysia ATP World Tour 250,HARD,2,Lukasz Kubot,Lukas Rosol,Lukasz Kubot,6-3; 6-3,R32,78,4,6,31,53,26,31,11,22,4,5,9,37,53,3,4,33,63,21,33,14,30,4,8,9,35,63
2011-09-26 00:00:00.000,Kuala Lumpur Malaysia ATP World Tour 250,HARD,2,Nikolay Davydenko,Ryan Harrison,Nikolay Davydenko,6-3; 6-2,R32,89,1,5,38,63,20,38,13,25,9,12,8,33,63,2,3,37,59,14,37,10,22,4,11,9,24,59
2011-09-26 00:00:00.000,Kuala Lumpur Malaysia ATP World Tour 250,HARD,2,Marcos Baghdatis,Alex Bogomolov Jr.,Marcos Baghdatis,7-6(3); 6-4,R32,105,6,3,35,69,26,35,24,34,2,2,11,50,69,2,1,49,65,34,49,10,16,2,3,11,44,65
2011-09-26 00:00:00.000,Kuala Lumpur Malaysia ATP World Tour 250,HARD,2,Somdev Devvarman,Mikhail Ledovskikh,Somdev Devvarman,7-6(5); 6-4,R32,100,5,1,36,60,30,36,16,24,0,1,11,46,60,8,3,47,81,36,47,14,34,4,6,11,50,81
2011-09-26 00:00:00.000,Kuala Lumpur Malaysia ATP World Tour 250,HARD,2,Rik De Voest,Ryan Sweeting,Rik De Voest,4-6; 6-3; 6-3,R32,133,1,2,69,102,49,69,14,33,8,11,14,63,102,5,11,47,85,35,47,14,38,3,8,14,49,85
2011-09-26 00:00:00.000,Kuala Lumpur Malaysia ATP World Tour 250,HARD,2,Jurgen Melzer,N/A Bye,Jurgen Melzer,,R32,0,0,0,0,0,0,0,0,0,0,0,0,0,0,0,0,0,0,0,0,0,0,0,0,0,0,0
2011-09-26 00:00:00.000,Kuala Lumpur Malaysia ATP World Tour 250,HARD,2,Dmitry Tursunov,Paul Capdeville,Dmitry Tursunov,6-2; 2-6; 6-1,R32,134,7,4,57,96,37,57,20,39,4,6,12,57,96,8,5,58,88,36,58,12,30,10,14,11,48,88
2011-09-26 00:00:00.000,Kuala Lumpur Malaysia ATP World Tour 250,HARD,2,David Goffin,Matthew Ebden,David Goffin,6-4; 7-6(4),R32,96,2,2,36,71,28,36,20,35,3,4,11,48,71,8,1,42,63,33,42,9,21,1,3,11,42,63
2011-09-26 00:00:00.000,Kuala Lumpur Malaysia ATP World Tour 250,HARD,2,Denis Istomin,Marinko Matosevic,Denis Istomin,6-3; 6-2,R32,74,4,1,38,60,32,38,10,22,1,1,9,42,60,6,4,43,63,29,43,5,20,7,10,8,34,63
2011-09-26 00:00:00.000,Kuala Lumpur Malaysia ATP World Tour 250,HARD,2,Viktor Troicki,N/A Bye,Viktor Troicki,,R32,0,0,0,0,0,0,0,0,0,0,0,0,0,0,0,0,0,0,0,0,0,0,0,0,0,0,0
2011-09-26 00:00:00.000,Kuala Lumpur Malaysia ATP World Tour 250,HARD,2,Nicolas Almagro,Albert Ramos,Nicolas Almagro,7-6(2); 7-6(4),R16,103,5,4,42,87,35,42,23,45,1,3,12,58,87,5,2,52,86,33,52,21,34,1,3,12,54,86
2011-09-26 00:00:00.000,Kuala Lumpur Malaysia ATP World Tour 250,HARD,2,Kei Nishikori,Philipp Petzschner,Kei Nishikori,6-3; 4-6; 7-5,R16,139,6,5,68,108,44,68,20,40,3,7,16,64,108,5,1,48,89,37,48,14,41,1,6,15,51,89
2011-09-26 00:00:00.000,Kuala Lumpur Malaysia ATP World Tour 250,HARD,2,Janko Tipsarevic,Flavio Cipolla,Janko Tipsarevic,6-2; 6-4,R16,94,5,1,25,45,22,25,11,20,1,2,9,33,45,0,0,59,73,32,59,6,14,13,17,9,38,73
2011-09-26 00:00:00.000,Kuala Lumpur Malaysia ATP World Tour 250,HARD,2,Nikolay Davydenko,Lukasz Kubot,Nikolay Davydenko,6-3; 7-6(2),R16,96,2,4,46,65,32,46,9,19,0,3,11,41,65,5,6,44,70,28,44,8,26,2,6,10,36,70
2011-09-26 00:00:00.000,Kuala Lumpur Malaysia ATP World Tour 250,HARD,2,Marcos Baghdatis,Somdev Devvarman,Marcos Baghdatis,7-5; 6-4,R16,105,6,3,43,79,33,43,15,36,10,12,11,48,79,3,1,49,74,28,49,13,25,2,6,11,41,74
2011-09-26 00:00:00.000,Kuala Lumpur Malaysia ATP World Tour 250,HARD,2,Jurgen Melzer,Rik De Voest,Jurgen Melzer,6-0; 6-4,R16,64,4,0,37,49,32,37,5,12,1,1,8,37,49,2,1,35,52,22,35,7,17,4,8,8,29,52
2011-09-26 00:00:00.000,Kuala Lumpur Malaysia ATP World Tour 250,HARD,2,Dmitry Tursunov,David Goffin,Dmitry Tursunov,6-3; 6-3,R16,84,8,4,44,73,32,44,16,29,10,10,9,48,73,6,4,31,54,24,31,8,23,3,6,9,32,54
2011-09-26 00:00:00.000,Kuala Lumpur Malaysia ATP World Tour 250,HARD,2,Viktor Troicki,Denis Istomin,Viktor Troicki,6-1; 6-4,R16,78,4,1,28,54,22,28,16,26,3,3,8,38,54,2,0,45,67,26,45,10,22,7,11,9,36,67
2011-09-26 00:00:00.000,Kuala Lumpur Malaysia ATP World Tour 250,HARD,2,Kei Nishikori,Nicolas Almagro,Kei Nishikori,6-7(5); 6-4; 6-4,Q,135,5,4,66,109,45,66,25,43,3,5,16,70,109,2,5,53,97,38,53,24,44,2,6,16,62,97
2011-09-26 00:00:00.000,Kuala Lumpur Malaysia ATP World Tour 250,HARD,2,Janko Tipsarevic,Nikolay Davydenko,Janko Tipsarevic,3-1 RET,Q,22,1,1,4,8,3,4,1,4,0,1,2,4,8,0,0,10,11,3,10,0,1,1,3,2,3,11
2011-09-26 00:00:00.000,Kuala Lumpur Malaysia ATP World Tour 250,HARD,2,Marcos Baghdatis,Jurgen Melzer,Marcos Baghdatis,6-3; 7-6(3),Q,89,13,2,40,67,34,40,17,27,4,4,11,51,67,4,1,38,63,25,38,17,25,5,6,10,42,63
2011-09-26 00:00:00.000,Kuala Lumpur Malaysia ATP World Tour 250,HARD,2,Viktor Troicki,Dmitry Tursunov,Viktor Troicki,6-4; 6-4,Q,77,8,3,33,57,26,33,9,24,1,4,10,35,57,3,1,34,51,18,34,7,17,2,7,10,25,51
2011-09-26 00:00:00.000,Kuala Lumpur Malaysia ATP World Tour 250,HARD,2,Janko Tipsarevic,Kei Nishikori,Janko Tipsarevic,6-4; 6-3,S,110,4,2,40,60,33,40,10,20,6,6,9,43,60,3,1,33,59,23,33,14,26,1,4,10,37,59
2011-09-26 00:00:00.000,Kuala Lumpur Malaysia ATP World Tour 250,HARD,2,Marcos Baghdatis,Viktor Troicki,Marcos Baghdatis,6-3; 6-1,S,84,3,0,29,61,18,29,17,32,5,7,8,35,61,1,2,23,48,13,23,4,25,1,7,8,17,48
2011-09-26 00:00:00.000,Kuala Lumpur Malaysia ATP World Tour 250,HARD,2,Janko Tipsarevic,Marcos Baghdatis,Janko Tipsarevic,6-4; 7-5,F,126,9,0,40,79,27,40,21,39,8,11,11,48,79,9,2,35,75,25,35,15,40,6,11,11,40,75
2011-10-03 00:00:00.000,Beijing China ATP World Tour 500,HARD,2,Jo-Wilfried Tsonga,Grigor Dimitrov,Jo-Wilfried Tsonga,7-6(5); 7-5,R32,108,9,3,50,79,38,50,19,29,2,3,12,57,79,7,0,43,64,32,43,16,21,2,4,12,48,64
2011-10-03 00:00:00.000,Beijing China ATP World Tour 500,HARD,2,Ze Zhang,Zhe Li,Ze Zhang,6-1; 6-3,R32,74,3,4,27,46,24,27,10,19,2,2,8,34,46,2,3,43,57,26,43,4,14,5,9,8,30,57
2011-10-03 00:00:00.000,Beijing China ATP World Tour 500,HARD,2,Juan Carlos Ferrero,Thomaz Bellucci,Juan Carlos Ferrero,6-1; 7-6(4),R32,84,2,3,34,62,34,34,14,28,4,4,10,48,62,6,1,39,63,29,39,10,24,2,4,9,39,63
2011-10-03 00:00:00.000,Beijing China ATP World Tour 500,HARD,2,Marcel Granollers,Gilles Simon,Marcel Granollers,6-3; 6-1,R32,69,1,0,29,44,21,29,10,15,2,3,8,31,44,1,7,19,47,12,19,9,28,0,5,8,21,47
2011-10-03 00:00:00.000,Beijing China ATP World Tour 500,HARD,2,Tomas Berdych,Jurgen Melzer,Tomas Berdych,7-5; 7-5,R32,97,5,2,36,68,28,36,24,32,3,3,12,52,68,4,3,46,68,33,46,11,22,1,3,12,44,68
2011-10-03 00:00:00.000,Beijing China ATP World Tour 500,HARD,2,Philipp Kohlschreiber,Tommy Robredo,Philipp Kohlschreiber,6-3; 7-6(0),R32,93,1,3,38,68,30,38,17,30,3,4,10,47,68,5,4,35,65,26,35,10,30,0,3,11,36,65
2011-10-03 00:00:00.000,Beijing China ATP World Tour 500,HARD,2,Fernando Verdasco,Michael Llodra,Fernando Verdasco,6-2; 6-4,R32,72,3,1,36,42,33,36,3,6,0,0,9,36,42,4,4,34,65,28,34,9,31,7,10,9,37,65
2011-10-03 00:00:00.000,Beijing China ATP World Tour 500,HARD,2,Flavio Cipolla,Alexandr Dolgopolov,Flavio Cipolla,6-1; 1-6; 6-0,R32,95,1,3,42,72,28,42,17,30,5,7,10,45,72,3,7,30,68,20,30,16,38,7,12,10,36,68
2011-10-03 00:00:00.000,Beijing China ATP World Tour 500,HARD,2,Ivan Ljubicic,Teymuraz Gabashvili,Ivan Ljubicic,7-5; 7-5,R32,98,14,3,37,56,30,37,10,19,0,3,12,40,56,4,6,41,75,25,41,15,34,3,8,12,40,75
2011-10-03 00:00:00.000,Beijing China ATP World Tour 500,HARD,2,Florian Mayer,Albert Ramos,Florian Mayer,6-2; 6-4,R32,72,1,3,33,54,27,33,12,21,4,4,9,39,54,2,3,39,65,25,39,11,26,7,10,9,36,65
2011-10-03 00:00:00.000,Beijing China ATP World Tour 500,HARD,2,Feliciano Lopez,Marsel Ilhan,Feliciano Lopez,6-2; 7-6(6),R32,99,10,3,37,65,33,37,18,28,3,3,10,51,65,11,4,42,77,30,42,21,35,3,5,10,51,77
2011-10-03 00:00:00.000,Beijing China ATP World Tour 500,HARD,2,Mikhail Youzhny,Nicolas Almagro,Mikhail Youzhny,6-3; 6-2,R32,69,3,3,25,49,20,25,12,24,4,5,8,32,49,7,2,26,57,21,26,7,31,5,10,9,28,57
2011-10-03 00:00:00.000,Beijing China ATP World Tour 500,HARD,2,Kevin Anderson,Andy Roddick,Kevin Anderson,6-4; 7-5,R32,102,8,1,39,62,32,39,11,23,4,6,11,43,62,5,1,46,64,30,46,7,18,6,10,11,37,64
2011-10-03 00:00:00.000,Beijing China ATP World Tour 500,HARD,2,Albert Montanes,Paul Capdeville,Albert Montanes,6-3; 6-3,R32,53,12,1,25,47,24,25,13,22,1,1,9,37,47,5,4,25,54,14,25,18,29,2,5,9,32,54
2011-10-03 00:00:00.000,Beijing China ATP World Tour 500,HARD,2,Marin Cilic,Di Wu,Marin Cilic,6-2; 6-0,R32,55,3,3,17,33,15,17,9,16,0,1,7,24,33,0,1,28,44,11,28,5,16,3,9,7,16,44
2011-10-03 00:00:00.000,Beijing China ATP World Tour 500,HARD,2,Fabio Fognini,Grega Zemlja,Fabio Fognini,6-4; 6-1,R32,68,4,3,33,50,25,33,10,17,1,1,8,35,50,1,5,36,60,21,36,11,24,5,9,9,32,60
2011-10-03 00:00:00.000,Beijing China ATP World Tour 500,HARD,2,Jo-Wilfried Tsonga,Ze Zhang,Jo-Wilfried Tsonga,6-3; 6-4,R16,76,8,1,34,57,28,34,13,23,3,4,10,41,57,4,5,37,60,24,37,9,23,4,7,9,33,60
2011-10-03 00:00:00.000,Beijing China ATP World Tour 500,HARD,2,Juan Carlos Ferrero,Marcel Granollers,Juan Carlos Ferrero,6-4; 6-4,R16,98,5,4,33,62,27,33,18,29,3,3,10,45,62,6,2,34,61,26,34,13,27,2,4,10,39,61
2011-10-03 00:00:00.000,Beijing China ATP World Tour 500,HARD,2,Tomas Berdych,Philipp Kohlschreiber,Tomas Berdych,6-2; 6-0,R16,63,4,3,17,38,14,17,13,21,1,2,7,27,38,3,2,26,54,14,26,7,28,7,13,7,21,54
2011-10-03 00:00:00.000,Beijing China ATP World Tour 500,HARD,2,Fernando Verdasco,Flavio Cipolla,Fernando Verdasco,2-6; 6-1; 6-2,R16,104,2,2,52,65,36,52,6,13,2,5,12,42,65,0,2,51,70,28,51,9,19,3,8,11,37,70
2011-10-03 00:00:00.000,Beijing China ATP World Tour 500,HARD,2,Ivan Ljubicic,Florian Mayer,Ivan Ljubicic,6-0; 2-6; 6-3,R16,113,13,1,30,64,28,30,17,34,2,4,12,45,64,6,2,35,67,24,35,15,32,4,8,11,39,67
2011-10-03 00:00:00.000,Beijing China ATP World Tour 500,HARD,2,Mikhail Youzhny,Feliciano Lopez,Mikhail Youzhny,6-7(5); 6-2; 7-5,R16,144,4,8,59,105,43,59,22,46,7,10,16,65,105,20,10,55,100,41,55,20,45,4,10,16,61,100
2011-10-03 00:00:00.000,Beijing China ATP World Tour 500,HARD,2,Kevin Anderson,Albert Montanes,Kevin Anderson,7-6(3); 7-6(4),R16,129,13,5,57,89,45,57,11,32,3,6,12,56,89,3,10,46,89,30,46,21,43,5,8,12,51,89
2011-10-03 00:00:00.000,Beijing China ATP World Tour 500,HARD,2,Marin Cilic,Fabio Fognini,Marin Cilic,6-2; 6-7(1); 6-3,R16,114,8,3,38,70,31,38,16,32,0,3,14,47,70,0,9,59,101,36,59,16,42,6,13,15,52,101
2011-10-03 00:00:00.000,Beijing China ATP World Tour 500,HARD,2,Jo-Wilfried Tsonga,Juan Carlos Ferrero,Jo-Wilfried Tsonga,6-3; 6-4,Q,71,10,3,36,58,32,36,11,22,0,0,10,43,58,0,1,33,45,23,33,7,12,0,2,9,30,45
2011-10-03 00:00:00.000,Beijing China ATP World Tour 500,HARD,2,Tomas Berdych,Fernando Verdasco,Tomas Berdych,6-1; 6-0,Q,66,1,1,25,41,17,25,11,16,0,1,7,28,41,0,5,27,45,11,27,4,18,2,8,6,15,45
2011-10-03 00:00:00.000,Beijing China ATP World Tour 500,HARD,2,Ivan Ljubicic,Mikhail Youzhny,Ivan Ljubicic,7-6(4); 6-7(4); 6-2,Q,172,17,4,55,103,45,55,23,48,4,7,16,68,103,1,9,70,129,43,70,30,59,15,20,16,73,129
2011-10-03 00:00:00.000,Beijing China ATP World Tour 500,HARD,2,Marin Cilic,Kevin Anderson,Marin Cilic,7-6(4); 4-6; 6-1,Q,144,6,4,51,93,38,51,21,42,3,6,15,59,93,7,5,63,100,46,63,13,37,6,10,14,59,100
2011-10-03 00:00:00.000,Beijing China ATP World Tour 500,HARD,2,Tomas Berdych,Jo-Wilfried Tsonga,Tomas Berdych,6-4; 4-6; 6-1,S,127,8,4,48,77,42,48,14,29,0,1,14,56,77,10,2,52,86,38,52,14,34,6,9,13,52,86
2011-10-03 00:00:00.000,Beijing China ATP World Tour 500,HARD,2,Marin Cilic,Ivan Ljubicic,Marin Cilic,6-4; 6-3,S,98,13,1,34,61,28,34,14,27,7,7,9,42,61,9,2,34,66,24,34,14,32,6,9,10,38,66
2011-10-03 00:00:00.000,Beijing China ATP World Tour 500,HARD,2,Tomas Berdych,Marin Cilic,Tomas Berdych,3-6; 6-4; 6-1,F,121,7,1,52,84,37,52,18,32,3,5,13,55,84,7,1,37,71,21,37,23,34,1,5,13,44,71
2011-10-03 00:00:00.000,Tokyo Japan ATP World Tour 500,HARD,2,Rafael Nadal,Go Soeda,Rafael Nadal,6-3; 6-2,R32,91,3,0,44,52,30,44,5,8,3,3,8,35,52,0,0,34,60,15,34,16,26,4,8,9,31,60
2011-10-03 00:00:00.000,Tokyo Japan ATP World Tour 500,HARD,2,Milos Raonic,Yuichi Sugita,Milos Raonic,6-7(4); 6-3; 7-6(1),R32,132,16,2,78,102,63,78,10,24,1,2,17,73,102,3,3,68,95,52,68,12,27,3,5,16,64,95
2011-10-03 00:00:00.000,Tokyo Japan ATP World Tour 500,HARD,2,Santiago Giraldo,Robin Haase,Santiago Giraldo,6-3; 7-6(5),R32,84,4,1,54,78,44,54,14,24,4,4,11,58,78,8,1,40,62,32,40,11,22,0,1,10,43,62
2011-10-03 00:00:00.000,Tokyo Japan ATP World Tour 500,HARD,2,Dmitry Tursunov,Janko Tipsarevic,Dmitry Tursunov,7-6(6); 6-7(3); 7-5,R32,181,14,5,76,124,50,76,26,48,5,9,18,76,124,13,4,72,108,50,72,19,36,1,6,18,69,108
2011-10-03 00:00:00.000,Tokyo Japan ATP World Tour 500,HARD,2,Mardy Fish,Ryan Harrison,Mardy Fish,6-4; 3-6; 7-5,R32,164,2,2,70,108,46,70,21,38,11,15,16,67,108,7,4,59,99,37,59,20,40,7,11,15,57,99
2011-10-03 00:00:00.000,Tokyo Japan ATP World Tour 500,HARD,2,Ernests Gulbis,Lukasz Kubot,Ernests Gulbis,6-3; 3-6; 7-5,R32,150,16,3,56,90,46,56,19,34,3,4,15,65,90,2,2,65,105,49,65,17,40,7,9,15,66,105
2011-10-03 00:00:00.000,Tokyo Japan ATP World Tour 500,HARD,2,Tatsuma Ito,Dudi Sela,Tatsuma Ito,6-4; 3-6; 6-3,R32,132,2,1,52,78,33,52,15,26,3,7,14,48,78,3,1,62,99,36,62,20,37,10,15,14,56,99
2011-10-03 00:00:00.000,Tokyo Japan ATP World Tour 500,HARD,2,Bernard Tomic,Viktor Troicki,Bernard Tomic,7-6(6); 7-6(1),R32,103,2,2,53,75,41,53,15,22,4,5,12,56,75,7,2,49,83,40,49,15,34,5,6,12,55,83
2011-10-03 00:00:00.000,Tokyo Japan ATP World Tour 500,HARD,2,Radek Stepanek,Somdev Devvarman,Radek Stepanek,6-4; 6-3,R32,92,2,1,36,56,25,36,13,20,5,7,10,38,56,1,0,42,60,22,42,11,18,4,8,9,33,60
2011-10-03 00:00:00.000,Tokyo Japan ATP World Tour 500,HARD,2,Marco Chiudinelli,Guillermo Garcia-Lopez,Marco Chiudinelli,6-1; 4-6; 6-4,R32,148,6,1,74,100,47,74,11,26,7,10,14,58,100,3,4,35,80,21,35,24,45,3,8,13,45,80
2011-10-03 00:00:00.000,Tokyo Japan ATP World Tour 500,HARD,2,Matthew Ebden,Pablo Andujar,Matthew Ebden,6-7(4); 6-4; 6-4,R32,147,8,4,72,107,53,72,19,35,7,8,16,72,107,0,5,65,104,49,65,18,39,5,8,16,67,104
2011-10-03 00:00:00.000,Tokyo Japan ATP World Tour 500,HARD,2,David Ferrer,Kei Nishikori,David Ferrer,6-4; 6-3,R32,89,1,2,43,67,32,43,10,24,5,7,10,42,67,4,2,39,59,23,39,9,20,6,10,9,32,59
2011-10-03 00:00:00.000,Tokyo Japan ATP World Tour 500,HARD,2,Ivan Dodig,Juan Monaco,Ivan Dodig,6-2; 2-6; 7-6(1),R32,163,8,3,52,99,40,52,22,47,6,9,14,62,99,0,3,55,88,34,55,21,33,3,6,14,55,88
2011-10-03 00:00:00.000,Tokyo Japan ATP World Tour 500,HARD,2,David Nalbandian,Lukas Rosol,David Nalbandian,6-1; 6-1,R32,49,5,1,20,34,17,20,11,14,0,0,7,28,34,5,2,32,53,17,32,7,21,12,17,7,24,53
2011-10-03 00:00:00.000,Tokyo Japan ATP World Tour 500,HARD,2,Alex Bogomolov Jr.,Jarkko Nieminen,Alex Bogomolov Jr.,6-4; 6-4,R32,93,3,1,44,53,31,44,6,9,2,3,10,37,53,2,1,55,78,31,55,14,23,7,10,10,45,78
2011-10-03 00:00:00.000,Tokyo Japan ATP World Tour 500,HARD,2,Andy Murray,Marcos Baghdatis,Andy Murray,7-6(4); 2-6; 6-4,R32,153,8,1,51,93,38,51,21,42,4,8,15,59,93,6,3,69,117,47,69,21,48,6,9,15,68,117
2011-10-03 00:00:00.000,Tokyo Japan ATP World Tour 500,HARD,2,Rafael Nadal,Milos Raonic,Rafael Nadal,7-5; 6-3,R16,91,2,1,43,56,33,43,12,13,0,0,11,45,56,8,1,28,50,24,28,11,22,0,2,10,35,50
2011-10-03 00:00:00.000,Tokyo Japan ATP World Tour 500,HARD,2,Santiago Giraldo,Dmitry Tursunov,Santiago Giraldo,6-4; 7-6(4),R16,118,6,1,46,71,32,46,17,25,1,2,11,49,71,9,4,52,73,34,52,13,21,5,7,11,47,73
2011-10-03 00:00:00.000,Tokyo Japan ATP World Tour 500,HARD,2,Mardy Fish,Ernests Gulbis,Mardy Fish,6-2; 6-4,R16,77,4,0,29,51,25,29,13,22,3,3,9,38,51,7,3,37,57,26,37,7,20,3,6,9,33,57
2011-10-03 00:00:00.000,Tokyo Japan ATP World Tour 500,HARD,2,Bernard Tomic,Tatsuma Ito,Bernard Tomic,6-7(4); 6-1; 7-5,R16,144,15,1,72,99,52,72,13,27,7,9,15,65,99,10,5,61,114,38,61,25,53,13,19,16,63,114
2011-10-03 00:00:00.000,Tokyo Japan ATP World Tour 500,HARD,2,Radek Stepanek,Marco Chiudinelli,Radek Stepanek,7-5; 6-7(5); 6-1,R16,148,10,3,78,105,59,78,11,27,7,9,16,70,105,3,3,64,102,42,64,16,38,7,12,15,58,102
2011-10-03 00:00:00.000,Tokyo Japan ATP World Tour 500,HARD,2,David Ferrer,Matthew Ebden,David Ferrer,4-6; 6-2; 6-2,R16,116,6,4,44,72,28,44,16,28,2,5,13,44,72,4,3,47,85,30,47,14,38,2,8,13,44,85
2011-10-03 00:00:00.000,Tokyo Japan ATP World Tour 500,HARD,2,David Nalbandian,Ivan Dodig,David Nalbandian,7-6(2); 6-2,R16,115,2,3,34,70,24,34,19,36,3,6,10,43,70,14,4,47,82,29,47,11,35,7,12,10,40,82
2011-10-03 00:00:00.000,Tokyo Japan ATP World Tour 500,HARD,2,Andy Murray,Alex Bogomolov Jr.,Andy Murray,6-1; 6-2,R16,58,11,0,22,35,21,22,7,13,0,0,7,28,35,0,2,33,47,16,33,4,14,3,8,8,20,47
2011-10-03 00:00:00.000,Tokyo Japan ATP World Tour 500,HARD,2,Rafael Nadal,Santiago Giraldo,Rafael Nadal,7-6(6); 6-3,Q,123,5,0,48,70,37,48,15,22,3,4,11,52,70,2,0,41,66,24,41,17,25,2,4,10,41,66
2011-10-03 00:00:00.000,Tokyo Japan ATP World Tour 500,HARD,2,Mardy Fish,Bernard Tomic,Mardy Fish,6-7(5); 6-4; 6-1,Q,131,10,2,51,85,41,51,14,34,3,5,14,55,85,7,5,65,103,44,65,12,38,3,9,15,56,103
2011-10-03 00:00:00.000,Tokyo Japan ATP World Tour 500,HARD,2,David Ferrer,Radek Stepanek,David Ferrer,6-2; 7-6(3),Q,104,3,3,49,82,34,49,20,33,5,6,10,54,82,3,1,44,64,27,44,10,20,3,6,10,37,64
2011-10-03 00:00:00.000,Tokyo Japan ATP World Tour 500,HARD,2,Andy Murray,David Nalbandian,Andy Murray,6-4; 7-5,Q,99,9,3,33,60,28,33,14,27,1,3,11,42,60,3,2,48,71,33,48,6,23,4,8,11,39,71
2011-10-03 00:00:00.000,Tokyo Japan ATP World Tour 500,HARD,2,Rafael Nadal,Mardy Fish,Rafael Nadal,7-5; 6-1,S,96,2,1,28,48,20,28,17,20,0,0,9,37,48,5,0,37,63,24,37,13,26,2,6,10,37,63
2011-10-03 00:00:00.000,Tokyo Japan ATP World Tour 500,HARD,2,Andy Murray,David Ferrer,Andy Murray,6-2; 6-3,S,81,4,0,25,48,21,25,14,23,1,1,8,35,48,2,3,36,57,17,36,11,21,2,6,9,28,57
2011-10-03 00:00:00.000,Tokyo Japan ATP World Tour 500,HARD,2,Andy Murray,Rafael Nadal,Andy Murray,3-6; 6-2; 6-0,F,136,6,1,39,64,31,39,16,25,5,6,11,47,64,3,0,53,77,23,53,17,24,4,9,12,40,77
2011-10-09 00:00:00.000,ATP World Tour Masters 1000 Shanghai Shanghai; China ATP World Tour Masters 1000,HARD,2,Rafael Nadal,N/A Bye,Rafael Nadal,,R64,0,0,0,0,0,0,0,0,0,0,0,0,0,0,0,0,0,0,0,0,0,0,0,0,0,0,0
2011-10-09 00:00:00.000,ATP World Tour Masters 1000 Shanghai Shanghai; China ATP World Tour Masters 1000,HARD,2,Guillermo Garcia-Lopez,Somdev Devvarman,Guillermo Garcia-Lopez,6-4; 6-3,R64,87,2,4,26,66,20,26,22,40,6,7,10,42,66,2,1,24,53,20,24,11,29,2,5,9,31,53
2011-10-09 00:00:00.000,ATP World Tour Masters 1000 Shanghai Shanghai; China ATP World Tour Masters 1000,HARD,2,David Nalbandian,Ernests Gulbis,David Nalbandian,7-5; 6-4,R64,92,6,3,36,67,30,36,17,31,2,3,11,47,67,10,9,38,69,31,38,11,31,9,12,11,42,69
2011-10-09 00:00:00.000,ATP World Tour Masters 1000 Shanghai Shanghai; China ATP World Tour Masters 1000,HARD,2,Florian Mayer,Fabio Fognini,Florian Mayer,6-0; 6-2,R64,48,4,0,19,35,18,19,11,16,0,0,7,29,35,1,3,26,41,12,26,4,15,1,6,7,16,41
2011-10-09 00:00:00.000,ATP World Tour Masters 1000 Shanghai Shanghai; China ATP World Tour Masters 1000,HARD,2,Feliciano Lopez,Janko Tipsarevic,Feliciano Lopez,7-6(2); 7-6(3),R64,123,12,3,37,78,30,37,24,41,2,4,12,54,78,7,4,48,84,29,48,23,36,4,6,12,52,84
2011-10-09 00:00:00.000,ATP World Tour Masters 1000 Shanghai Shanghai; China ATP World Tour Masters 1000,HARD,2,Alex Bogomolov Jr.,Marcel Granollers,Alex Bogomolov Jr.,6-2; 6-3,R64,82,1,0,39,55,25,39,13,16,6,6,8,38,55,1,5,31,57,20,31,10,26,2,6,9,30,57
2011-10-09 00:00:00.000,ATP World Tour Masters 1000 Shanghai Shanghai; China ATP World Tour Masters 1000,HARD,2,Radek Stepanek,Ze Zhang,Radek Stepanek,6-3; 6-3,R64,69,5,1,38,56,28,38,12,18,2,3,9,40,56,3,4,35,53,22,35,6,18,4,8,9,28,53
2011-10-09 00:00:00.000,ATP World Tour Masters 1000 Shanghai Shanghai; China ATP World Tour Masters 1000,HARD,2,Tomas Berdych,N/A Bye,Tomas Berdych,,R64,0,0,0,0,0,0,0,0,0,0,0,0,0,0,0,0,0,0,0,0,0,0,0,0,0,0,0
2011-10-09 00:00:00.000,ATP World Tour Masters 1000 Shanghai Shanghai; China ATP World Tour Masters 1000,HARD,2,David Ferrer,N/A Bye,David Ferrer,,R64,0,0,0,0,0,0,0,0,0,0,0,0,0,0,0,0,0,0,0,0,0,0,0,0,0,0,0
2011-10-09 00:00:00.000,ATP World Tour Masters 1000 Shanghai Shanghai; China ATP World Tour Masters 1000,HARD,2,Milos Raonic,Michael Llodra,Milos Raonic,6-7(2); 6-2; 7-6(5),R64,138,11,1,71,108,52,71,22,37,7,8,16,74,108,3,8,73,117,53,73,23,44,11,14,16,76,117
2011-10-09 00:00:00.000,ATP World Tour Masters 1000 Shanghai Shanghai; China ATP World Tour Masters 1000,HARD,2,Juan Carlos Ferrero,Mikhail Youzhny,Juan Carlos Ferrero,7-6(4); 6-4,R64,112,4,0,38,65,30,38,21,27,3,3,11,51,65,6,5,61,102,45,61,19,41,13,14,11,64,102
2011-10-09 00:00:00.000,ATP World Tour Masters 1000 Shanghai Shanghai; China ATP World Tour Masters 1000,HARD,2,Fernando Verdasco,Zhe Li,Fernando Verdasco,6-2; 6-2,R64,75,6,0,35,53,27,35,9,18,1,1,8,36,53,5,2,29,50,20,29,6,21,2,6,8,26,50
2011-10-09 00:00:00.000,ATP World Tour Masters 1000 Shanghai Shanghai; China ATP World Tour Masters 1000,HARD,2,Andy Roddick,Yen-Hsun Lu,Andy Roddick,6-2; 3-6; 6-2,R64,112,10,2,41,71,32,41,18,30,4,5,12,50,71,7,7,49,87,35,49,16,38,7,11,13,51,87
2011-10-09 00:00:00.000,ATP World Tour Masters 1000 Shanghai Shanghai; China ATP World Tour Masters 1000,HARD,2,Grigor Dimitrov,Marsel Ilhan,Grigor Dimitrov,2-6; 6-1; 6-4,R64,104,11,7,46,84,36,46,16,38,6,9,13,52,84,1,5,51,92,32,51,20,41,8,12,12,52,92
2011-10-09 00:00:00.000,ATP World Tour Masters 1000 Shanghai Shanghai; China ATP World Tour Masters 1000,HARD,2,Tommy Robredo,Stephane Bohli,Tommy Robredo,7-6(3); 7-6(4),R64,122,4,4,60,88,40,60,17,28,6,8,12,57,88,3,1,48,83,37,48,16,35,5,7,12,53,83
2011-10-09 00:00:00.000,ATP World Tour Masters 1000 Shanghai Shanghai; China ATP World Tour Masters 1000,HARD,2,Nicolas Almagro,N/A Bye,Nicolas Almagro,,R64,0,0,0,0,0,0,0,0,0,0,0,0,0,0,0,0,0,0,0,0,0,0,0,0,0,0,0
2011-10-09 00:00:00.000,ATP World Tour Masters 1000 Shanghai Shanghai; China ATP World Tour Masters 1000,HARD,2,Mardy Fish,N/A Bye,Mardy Fish,,R64,0,0,0,0,0,0,0,0,0,0,0,0,0,0,0,0,0,0,0,0,0,0,0,0,0,0,0
2011-10-09 00:00:00.000,ATP World Tour Masters 1000 Shanghai Shanghai; China ATP World Tour Masters 1000,HARD,2,Bernard Tomic,Kevin Anderson,Bernard Tomic,7-6(5); 6-7(4); 6-3,R64,157,7,1,74,110,57,74,25,36,2,2,17,82,110,25,3,83,133,68,83,20,50,11,12,16,88,133
2011-10-09 00:00:00.000,ATP World Tour Masters 1000 Shanghai Shanghai; China ATP World Tour Masters 1000,HARD,2,Albert Ramos,Marin Cilic,Albert Ramos,6-3; 6-4,R64,86,3,0,31,61,24,31,17,30,1,2,10,41,61,5,3,30,57,22,30,12,27,3,6,9,34,57
2011-10-09 00:00:00.000,ATP World Tour Masters 1000 Shanghai Shanghai; China ATP World Tour Masters 1000,HARD,2,Alexandr Dolgopolov,Lukasz Kubot,Alexandr Dolgopolov,6-4; 7-6(6),R64,100,8,2,22,65,14,22,28,43,0,2,11,42,65,5,2,46,78,31,46,15,32,7,10,11,46,78
2011-10-09 00:00:00.000,ATP World Tour Masters 1000 Shanghai Shanghai; China ATP World Tour Masters 1000,HARD,2,Jurgen Melzer,Ivan Ljubicic,Jurgen Melzer,6-4; 6-2,R64,76,4,1,27,47,23,27,13,20,2,3,9,36,47,5,4,31,60,18,31,14,29,4,8,9,32,60
2011-10-09 00:00:00.000,ATP World Tour Masters 1000 Shanghai Shanghai; China ATP World Tour Masters 1000,HARD,2,Santiago Giraldo,Ivan Dodig,Santiago Giraldo,1-6; 6-3; 6-4,R64,120,3,0,44,85,32,44,23,41,2,4,13,55,85,8,7,42,76,36,42,16,34,3,5,13,52,76
2011-10-09 00:00:00.000,ATP World Tour Masters 1000 Shanghai Shanghai; China ATP World Tour Masters 1000,HARD,2,Kei Nishikori,Robin Haase,Kei Nishikori,0-6; 7-5; 7-6(5),R64,133,4,7,55,99,36,55,20,44,5,11,15,56,99,8,7,48,99,35,48,24,51,4,8,15,59,99
2011-10-09 00:00:00.000,ATP World Tour Masters 1000 Shanghai Shanghai; China ATP World Tour Masters 1000,HARD,2,Jo-Wilfried Tsonga,N/A Bye,Jo-Wilfried Tsonga,,R64,0,0,0,0,0,0,0,0,0,0,0,0,0,0,0,0,0,0,0,0,0,0,0,0,0,0,0
2011-10-09 00:00:00.000,ATP World Tour Masters 1000 Shanghai Shanghai; China ATP World Tour Masters 1000,HARD,2,Gilles Simon,N/A Bye,Gilles Simon,,R64,0,0,0,0,0,0,0,0,0,0,0,0,0,0,0,0,0,0,0,0,0,0,0,0,0,0,0
2011-10-09 00:00:00.000,ATP World Tour Masters 1000 Shanghai Shanghai; China ATP World Tour Masters 1000,HARD,2,Albert Montanes,Mikhail Kukushkin,Albert Montanes,6-2; 5-7; 7-6(5),R64,132,3,9,69,113,52,69,18,44,9,13,16,70,113,12,7,48,102,36,48,25,54,4,9,16,61,102
2011-10-09 00:00:00.000,ATP World Tour Masters 1000 Shanghai Shanghai; China ATP World Tour Masters 1000,HARD,2,Matthew Ebden,Pablo Andujar,Matthew Ebden,6-4; 6-4,R64,71,4,2,23,50,19,23,21,27,0,0,10,40,50,4,1,43,62,28,43,13,19,3,5,10,41,62
2011-10-09 00:00:00.000,ATP World Tour Masters 1000 Shanghai Shanghai; China ATP World Tour Masters 1000,HARD,2,Ryan Harrison,Viktor Troicki,Ryan Harrison,6-3; 6-3,R64,82,1,3,38,64,26,38,11,26,4,6,9,37,64,5,3,34,59,21,34,8,25,4,9,9,29,59
2011-10-09 00:00:00.000,ATP World Tour Masters 1000 Shanghai Shanghai; China ATP World Tour Masters 1000,HARD,2,Stanislas Wawrinka,Juan Monaco,Stanislas Wawrinka,3-6; 6-3; 6-3,R64,127,6,6,49,89,32,49,18,40,4,9,14,50,89,1,4,34,75,22,34,17,41,5,11,13,39,75
2011-10-09 00:00:00.000,ATP World Tour Masters 1000 Shanghai Shanghai; China ATP World Tour Masters 1000,HARD,2,Donald Young,Mao-Xin Gong,Donald Young,6-1; 6-4,R64,74,2,1,35,54,25,35,15,19,6,6,9,40,54,0,1,32,52,17,32,10,20,2,5,8,27,52
2011-10-09 00:00:00.000,ATP World Tour Masters 1000 Shanghai Shanghai; China ATP World Tour Masters 1000,HARD,2,Dmitry Tursunov,Thomaz Bellucci,Dmitry Tursunov,6-7(5); 6-4; 7-5,R64,166,10,4,60,111,42,60,28,51,4,7,17,70,111,9,6,66,110,45,66,21,44,6,11,17,66,110
2011-10-09 00:00:00.000,ATP World Tour Masters 1000 Shanghai Shanghai; China ATP World Tour Masters 1000,HARD,2,Andy Murray,N/A Bye,Andy Murray,,R64,0,0,0,0,0,0,0,0,0,0,0,0,0,0,0,0,0,0,0,0,0,0,0,0,0,0,0
2011-10-09 00:00:00.000,ATP World Tour Masters 1000 Shanghai Shanghai; China ATP World Tour Masters 1000,HARD,2,Rafael Nadal,Guillermo Garcia-Lopez,Rafael Nadal,6-3; 6-2,R32,105,1,1,29,44,23,29,10,15,0,1,9,33,44,3,8,44,77,26,44,12,33,11,15,8,38,77
2011-10-09 00:00:00.000,ATP World Tour Masters 1000 Shanghai Shanghai; China ATP World Tour Masters 1000,HARD,2,Florian Mayer,David Nalbandian,Florian Mayer,6-3; 6-4,R32,74,5,2,29,50,24,29,10,21,1,2,9,34,50,4,5,34,62,25,34,8,28,3,7,10,33,62
2011-10-09 00:00:00.000,ATP World Tour Masters 1000 Shanghai Shanghai; China ATP World Tour Masters 1000,HARD,2,Feliciano Lopez,Alex Bogomolov Jr.,Feliciano Lopez,7-6(4); 3-6; 6-3,R32,152,8,14,65,120,49,65,25,55,14,16,15,74,120,4,0,78,108,55,78,14,30,6,8,15,69,108
2011-10-09 00:00:00.000,ATP World Tour Masters 1000 Shanghai Shanghai; China ATP World Tour Masters 1000,HARD,2,Tomas Berdych,Radek Stepanek,Tomas Berdych,6-4; 6-3,R32,78,6,1,30,48,27,30,11,18,2,3,10,38,48,2,2,34,58,24,34,10,24,3,6,9,34,58
2011-10-09 00:00:00.000,ATP World Tour Masters 1000 Shanghai Shanghai; China ATP World Tour Masters 1000,HARD,2,David Ferrer,Milos Raonic,David Ferrer,7-5; 7-6(7),R32,104,5,1,48,76,35,48,17,28,2,4,12,52,76,11,0,49,77,38,49,11,28,1,4,12,49,77
2011-10-09 00:00:00.000,ATP World Tour Masters 1000 Shanghai Shanghai; China ATP World Tour Masters 1000,HARD,2,Juan Carlos Ferrero,Fernando Verdasco,Juan Carlos Ferrero,4-6; 6-3; 6-2,R32,127,3,2,68,97,44,68,15,29,8,11,13,59,97,6,6,49,74,31,49,11,25,1,7,14,42,74
2011-10-09 00:00:00.000,ATP World Tour Masters 1000 Shanghai Shanghai; China ATP World Tour Masters 1000,HARD,2,Andy Roddick,Grigor Dimitrov,Andy Roddick,7-6(3); 7-5,R32,122,7,2,46,73,35,46,13,27,3,6,12,48,73,6,7,53,87,35,53,13,34,3,7,12,48,87
2011-10-09 00:00:00.000,ATP World Tour Masters 1000 Shanghai Shanghai; China ATP World Tour Masters 1000,HARD,2,Nicolas Almagro,Tommy Robredo,Nicolas Almagro,7-5; 6-3,R32,81,4,2,39,69,31,39,19,30,3,3,11,50,69,1,2,34,59,26,34,11,25,6,8,10,37,59
2011-10-09 00:00:00.000,ATP World Tour Masters 1000 Shanghai Shanghai; China ATP World Tour Masters 1000,HARD,2,Bernard Tomic,Mardy Fish,Bernard Tomic,4-6; 6-1; 6-4,R32,118,3,2,49,78,37,49,19,29,0,1,14,56,78,9,2,51,91,34,51,20,40,5,8,13,54,91
2011-10-09 00:00:00.000,ATP World Tour Masters 1000 Shanghai Shanghai; China ATP World Tour Masters 1000,HARD,2,Alexandr Dolgopolov,Albert Ramos,Alexandr Dolgopolov,5-7; 6-3; 6-2,R32,107,8,1,39,79,31,39,25,40,2,3,14,56,79,4,8,60,95,43,60,14,35,6,10,15,57,95
2011-10-09 00:00:00.000,ATP World Tour Masters 1000 Shanghai Shanghai; China ATP World Tour Masters 1000,HARD,2,Santiago Giraldo,Jurgen Melzer,Santiago Giraldo,4-6; 6-4; 7-6(5),R32,144,5,3,78,116,53,78,22,38,7,9,16,75,116,3,2,64,98,49,64,17,34,0,2,16,66,98
2011-10-09 00:00:00.000,ATP World Tour Masters 1000 Shanghai Shanghai; China ATP World Tour Masters 1000,HARD,2,Kei Nishikori,Jo-Wilfried Tsonga,Kei Nishikori,6-7(1); 6-4; 6-4,R32,148,4,2,58,97,40,58,22,39,1,3,16,62,97,11,5,50,96,37,50,24,46,5,9,16,61,96
2011-10-09 00:00:00.000,ATP World Tour Masters 1000 Shanghai Shanghai; China ATP World Tour Masters 1000,HARD,2,Gilles Simon,Albert Montanes,Gilles Simon,6-1; 6-1,R32,57,8,1,28,51,22,28,12,23,6,6,7,34,51,0,4,21,40,8,21,8,19,3,8,7,16,40
2011-10-09 00:00:00.000,ATP World Tour Masters 1000 Shanghai Shanghai; China ATP World Tour Masters 1000,HARD,2,Matthew Ebden,Ryan Harrison,Matthew Ebden,6-4; 6-2,R32,72,5,2,43,66,32,43,10,23,5,6,9,42,66,5,2,28,50,15,28,12,22,2,6,9,27,50
2011-10-09 00:00:00.000,ATP World Tour Masters 1000 Shanghai Shanghai; China ATP World Tour Masters 1000,HARD,2,Stanislas Wawrinka,Donald Young,Stanislas Wawrinka,6-7(5); 7-6(2); 6-2,R32,145,9,6,64,102,48,64,22,38,6,8,16,70,102,2,2,71,113,39,71,29,42,6,10,16,68,113
2011-10-09 00:00:00.000,ATP World Tour Masters 1000 Shanghai Shanghai; China ATP World Tour Masters 1000,HARD,2,Andy Murray,Dmitry Tursunov,Andy Murray,W/O,R32,0,0,0,0,0,0,0,0,0,0,0,0,0,0,0,0,0,0,0,0,0,0,0,0,0,0,0
2011-10-09 00:00:00.000,ATP World Tour Masters 1000 Shanghai Shanghai; China ATP World Tour Masters 1000,HARD,2,Florian Mayer,Rafael Nadal,Florian Mayer,7-6(5); 6-3,R16,108,5,1,37,64,33,37,15,27,0,0,10,48,64,2,0,53,72,37,53,11,19,2,4,11,48,72
2011-10-09 00:00:00.000,ATP World Tour Masters 1000 Shanghai Shanghai; China ATP World Tour Masters 1000,HARD,2,Feliciano Lopez,Tomas Berdych,Feliciano Lopez,6-4; 6-4,R16,81,7,0,32,52,26,32,15,20,0,0,10,41,52,7,1,39,59,29,39,10,20,1,3,10,39,59
2011-10-09 00:00:00.000,ATP World Tour Masters 1000 Shanghai Shanghai; China ATP World Tour Masters 1000,HARD,2,David Ferrer,Juan Carlos Ferrero,David Ferrer,1-6; 7-5; 6-2,R16,120,11,5,40,84,29,40,25,44,6,9,14,54,84,2,0,43,74,27,43,19,31,4,7,13,46,74
2011-10-09 00:00:00.000,ATP World Tour Masters 1000 Shanghai Shanghai; China ATP World Tour Masters 1000,HARD,2,Andy Roddick,Nicolas Almagro,Andy Roddick,6-3; 6-4,R16,72,11,0,35,48,32,35,8,13,0,0,10,40,48,4,2,32,50,23,32,9,18,0,2,9,32,50
2011-10-09 00:00:00.000,ATP World Tour Masters 1000 Shanghai Shanghai; China ATP World Tour Masters 1000,HARD,2,Alexandr Dolgopolov,Bernard Tomic,Alexandr Dolgopolov,5-7; 6-1; 6-0,R16,79,11,2,32,69,26,32,18,37,5,8,12,44,69,3,6,46,76,27,46,8,30,4,12,13,35,76
2011-10-09 00:00:00.000,ATP World Tour Masters 1000 Shanghai Shanghai; China ATP World Tour Masters 1000,HARD,2,Kei Nishikori,Santiago Giraldo,Kei Nishikori,7-6(6); 4-6; 6-3,R16,158,4,4,60,111,43,60,26,51,9,12,16,69,111,3,5,55,106,41,55,26,51,9,12,15,67,106
2011-10-09 00:00:00.000,ATP World Tour Masters 1000 Shanghai Shanghai; China ATP World Tour Masters 1000,HARD,2,Matthew Ebden,Gilles Simon,Matthew Ebden,6-2; 2-6; 7-6(8),R16,128,7,3,58,99,42,58,21,41,6,9,14,63,99,14,4,52,97,37,52,24,45,6,9,14,61,97
2011-10-09 00:00:00.000,ATP World Tour Masters 1000 Shanghai Shanghai; China ATP World Tour Masters 1000,HARD,2,Andy Murray,Stanislas Wawrinka,Andy Murray,6-4; 3-6; 6-3,R16,132,4,3,55,86,40,55,13,31,4,7,14,53,86,5,2,44,78,30,44,17,34,1,5,14,47,78
2011-10-09 00:00:00.000,ATP World Tour Masters 1000 Shanghai Shanghai; China ATP World Tour Masters 1000,HARD,2,Feliciano Lopez,Florian Mayer,Feliciano Lopez,6-2; 6-4,Q,69,10,2,24,49,19,24,19,25,1,1,9,38,49,2,3,36,59,21,36,12,23,3,6,9,33,59
2011-10-09 00:00:00.000,ATP World Tour Masters 1000 Shanghai Shanghai; China ATP World Tour Masters 1000,HARD,2,David Ferrer,Andy Roddick,David Ferrer,6-7(5); 6-2; 7-6(2),Q,154,11,5,69,114,56,69,26,45,5,5,16,82,114,11,2,63,105,49,63,21,42,2,4,16,70,105
2011-10-09 00:00:00.000,ATP World Tour Masters 1000 Shanghai Shanghai; China ATP World Tour Masters 1000,HARD,2,Kei Nishikori,Alexandr Dolgopolov,Kei Nishikori,6-4; 6-3,Q,87,1,0,29,52,22,29,13,23,6,7,9,35,52,9,3,36,77,24,36,15,41,5,9,10,39,77
2011-10-09 00:00:00.000,ATP World Tour Masters 1000 Shanghai Shanghai; China ATP World Tour Masters 1000,HARD,2,Andy Murray,Matthew Ebden,Andy Murray,6-3; 6-2,Q,85,7,2,26,44,20,26,14,18,1,1,8,34,44,0,5,37,71,26,37,10,34,7,11,9,36,71
2011-10-09 00:00:00.000,ATP World Tour Masters 1000 Shanghai Shanghai; China ATP World Tour Masters 1000,HARD,2,David Ferrer,Feliciano Lopez,David Ferrer,6-7(5); 6-3; 6-3,S,131,11,6,54,89,44,54,24,35,2,2,15,68,89,12,5,57,101,40,57,24,44,2,5,15,64,101
2011-10-09 00:00:00.000,ATP World Tour Masters 1000 Shanghai Shanghai; China ATP World Tour Masters 1000,HARD,2,Andy Murray,Kei Nishikori,Andy Murray,6-3; 6-0,S,57,7,1,23,35,22,23,7,12,0,0,7,29,35,0,3,29,47,17,29,4,18,4,9,8,21,47
2011-10-09 00:00:00.000,ATP World Tour Masters 1000 Shanghai Shanghai; China ATP World Tour Masters 1000,HARD,2,Andy Murray,David Ferrer,Andy Murray,7-5; 6-4,F,106,7,4,37,59,32,37,9,22,2,4,11,41,59,1,4,35,80,24,35,20,45,5,9,11,44,80
2011-10-17 00:00:00.000,Moscow Russia ATP World Tour 250,HARD,2,Janko Tipsarevic,N/A Bye,Janko Tipsarevic,,R32,0,0,0,0,0,0,0,0,0,0,0,0,0,0,0,0,0,0,0,0,0,0,0,0,0,0,0
2011-10-17 00:00:00.000,Moscow Russia ATP World Tour 250,HARD,2,Igor Kunitsyn,Andrey Kuznetsov,Igor Kunitsyn,7-5; 4-6; 6-3,R32,137,4,1,68,118,49,68,24,50,9,12,16,73,118,8,2,52,85,36,52,17,33,1,5,15,53,85
2011-10-17 00:00:00.000,Moscow Russia ATP World Tour 250,HARD,2,Julien Benneteau,Evgeny Donskoy,Julien Benneteau,6-4; 6-3,R32,69,5,0,29,45,23,29,13,16,0,0,9,36,45,5,0,45,61,30,45,7,16,1,4,10,37,61
2011-10-17 00:00:00.000,Moscow Russia ATP World Tour 250,HARD,2,Dmitry Tursunov,Albert Ramos,Dmitry Tursunov,7-6(5); 6-4,R32,91,4,5,36,64,31,36,15,28,3,5,11,46,64,9,2,48,73,35,48,11,25,6,9,11,46,73
2011-10-17 00:00:00.000,Moscow Russia ATP World Tour 250,HARD,2,Nikolay Davydenko,N/A Bye,Nikolay Davydenko,,R32,0,0,0,0,0,0,0,0,0,0,0,0,0,0,0,0,0,0,0,0,0,0,0,0,0,0,0
2011-10-17 00:00:00.000,Moscow Russia ATP World Tour 250,HARD,2,Teymuraz Gabashvili,Karol Beck,Teymuraz Gabashvili,6-2; 6-4,R32,93,2,1,47,69,27,47,15,22,8,9,9,42,69,3,3,26,60,19,26,14,34,3,7,9,33,60
2011-10-17 00:00:00.000,Moscow Russia ATP World Tour 250,HARD,2,Michael Berrer,Sergiy Stakhovsky,Michael Berrer,6-2; 6-4,R32,74,5,1,34,54,26,34,14,20,4,4,9,40,54,2,1,42,60,27,42,8,18,6,9,9,35,60
2011-10-17 00:00:00.000,Moscow Russia ATP World Tour 250,HARD,2,Andreas Seppi,Igor Andreev,Andreas Seppi,2-6; 6-3; 7-6(4),R32,125,6,1,57,92,44,57,18,35,6,9,15,62,92,7,2,52,91,39,52,21,39,3,5,14,60,91
2011-10-17 00:00:00.000,Moscow Russia ATP World Tour 250,HARD,2,Gilles Muller,Konstantin Kravchuk,Gilles Muller,7-6(5); 6-4,R32,90,19,1,47,69,39,47,14,22,3,3,11,53,69,11,2,39,62,31,39,15,23,0,1,11,46,62
2011-10-17 00:00:00.000,Moscow Russia ATP World Tour 250,HARD,2,Philipp Kohlschreiber,Carlos Berlocq,Philipp Kohlschreiber,7-5; 6-3,R32,91,2,1,37,61,27,37,16,24,3,4,10,43,61,5,2,45,65,30,45,7,20,2,6,11,37,65
2011-10-17 00:00:00.000,Moscow Russia ATP World Tour 250,HARD,2,Jeremy Chardy,Potito Starace,Jeremy Chardy,6-3; 6-7(5); 7-6(2),R32,125,23,3,61,105,55,61,26,44,3,3,17,81,105,9,3,69,104,56,69,18,35,3,4,16,74,104
2011-10-17 00:00:00.000,Moscow Russia ATP World Tour 250,HARD,2,Alexandr Dolgopolov,N/A Bye,Alexandr Dolgopolov,,R32,0,0,0,0,0,0,0,0,0,0,0,0,0,0,0,0,0,0,0,0,0,0,0,0,0,0,0
2011-10-17 00:00:00.000,Moscow Russia ATP World Tour 250,HARD,2,Alex Bogomolov Jr.,Dusan Lajovic,Alex Bogomolov Jr.,3-6; 6-3; 6-4,R32,118,4,4,69,93,48,69,11,24,6,9,14,59,93,6,1,60,87,40,60,11,27,6,10,14,51,87
2011-10-17 00:00:00.000,Moscow Russia ATP World Tour 250,HARD,2,Mikhail Kukushkin,Lukas Rosol,Mikhail Kukushkin,7-6(5); 7-5,R32,107,7,1,53,81,34,53,18,28,2,4,12,52,81,7,3,59,94,36,59,18,35,3,6,12,54,94
2011-10-17 00:00:00.000,Moscow Russia ATP World Tour 250,HARD,2,Pere Riba,Andreas Haider-Maurer,Pere Riba,6-2; 6-7(1); 6-3,R32,131,7,3,55,103,42,55,29,48,4,4,15,71,103,16,2,60,96,43,60,16,36,9,12,14,59,96
2011-10-17 00:00:00.000,Moscow Russia ATP World Tour 250,HARD,2,Viktor Troicki,N/A Bye,Viktor Troicki,,R32,0,0,0,0,0,0,0,0,0,0,0,0,0,0,0,0,0,0,0,0,0,0,0,0,0,0,0
2011-10-17 00:00:00.000,Moscow Russia ATP World Tour 250,HARD,2,Janko Tipsarevic,Igor Kunitsyn,Janko Tipsarevic,6-7(5); 6-1; 6-0,R16,115,8,1,44,81,37,44,18,37,1,2,13,55,81,5,1,42,81,27,42,18,39,3,9,12,45,81
2011-10-17 00:00:00.000,Moscow Russia ATP World Tour 250,HARD,2,Dmitry Tursunov,Julien Benneteau,Dmitry Tursunov,6-3; 7-6(1),R16,100,7,2,46,76,40,46,13,30,8,9,11,53,76,8,1,42,60,29,42,8,18,3,5,10,37,60
2011-10-17 00:00:00.000,Moscow Russia ATP World Tour 250,HARD,2,Nikolay Davydenko,Teymuraz Gabashvili,Nikolay Davydenko,7-5; 6-2,R16,91,3,2,36,56,25,36,10,20,3,5,10,35,56,3,2,36,63,22,36,9,27,2,7,10,31,63
2011-10-17 00:00:00.000,Moscow Russia ATP World Tour 250,HARD,2,Michael Berrer,Andreas Seppi,Michael Berrer,4-6; 6-3; 6-2,R16,96,6,3,60,85,43,60,15,25,5,6,14,58,85,4,4,48,73,34,48,12,25,1,4,13,46,73
2011-10-17 00:00:00.000,Moscow Russia ATP World Tour 250,HARD,2,Philipp Kohlschreiber,Gilles Muller,Philipp Kohlschreiber,7-6(4); 6-3,R16,81,12,1,45,61,39,45,12,16,2,2,11,51,61,9,2,41,65,32,41,14,24,4,5,10,46,65
2011-10-17 00:00:00.000,Moscow Russia ATP World Tour 250,HARD,2,Jeremy Chardy,Alexandr Dolgopolov,Jeremy Chardy,6-3; 7-6(6),R16,85,7,3,45,66,39,45,10,21,1,2,11,49,66,13,2,37,75,28,37,19,38,5,7,10,47,75
2011-10-17 00:00:00.000,Moscow Russia ATP World Tour 250,HARD,2,Alex Bogomolov Jr.,Mikhail Kukushkin,Alex Bogomolov Jr.,6-4; 3-6; 6-4,R16,137,1,1,77,101,55,77,9,24,12,14,15,64,101,4,2,51,94,37,51,23,43,3,5,14,60,94
2011-10-17 00:00:00.000,Moscow Russia ATP World Tour 250,HARD,2,Viktor Troicki,Pere Riba,Viktor Troicki,6-4; 6-4,R16,83,11,3,40,61,35,40,9,21,2,2,10,44,61,2,4,37,70,26,37,15,33,2,4,10,41,70
2011-10-17 00:00:00.000,Moscow Russia ATP World Tour 250,HARD,2,Janko Tipsarevic,Dmitry Tursunov,Janko Tipsarevic,6-4; 6-2,Q,76,7,1,29,47,26,29,13,18,3,3,9,39,47,3,3,42,60,26,42,7,18,8,11,9,33,60
2011-10-17 00:00:00.000,Moscow Russia ATP World Tour 250,HARD,2,Nikolay Davydenko,Michael Berrer,Nikolay Davydenko,6-3; 6-2,Q,81,1,5,49,69,34,49,10,20,4,5,9,44,69,3,1,34,51,22,34,4,17,1,5,8,26,51
2011-10-17 00:00:00.000,Moscow Russia ATP World Tour 250,HARD,2,Jeremy Chardy,Philipp Kohlschreiber,Jeremy Chardy,6-4; 6-3,Q,86,11,5,48,81,37,48,15,33,10,10,10,52,81,3,3,20,50,16,20,16,30,2,4,9,32,50
2011-10-17 00:00:00.000,Moscow Russia ATP World Tour 250,HARD,2,Viktor Troicki,Alex Bogomolov Jr.,Viktor Troicki,7-6(6); 6-7(1); 7-6(1),Q,218,23,5,83,137,60,83,26,54,6,10,18,86,137,2,2,117,151,72,117,17,34,14,18,18,89,151
2011-10-17 00:00:00.000,Moscow Russia ATP World Tour 250,HARD,2,Janko Tipsarevic,Nikolay Davydenko,Janko Tipsarevic,6-2; 7-5,S,99,6,0,40,69,29,40,16,29,6,7,10,45,69,0,4,38,60,26,38,6,22,1,5,10,32,60
2011-10-17 00:00:00.000,Moscow Russia ATP World Tour 250,HARD,2,Viktor Troicki,Jeremy Chardy,Viktor Troicki,6-4; 6-4,S,71,12,1,44,55,36,44,6,11,1,1,10,42,55,4,3,35,60,29,35,12,25,3,5,10,41,60
2011-10-17 00:00:00.000,Moscow Russia ATP World Tour 250,HARD,2,Janko Tipsarevic,Viktor Troicki,Janko Tipsarevic,6-4; 6-2,F,88,3,1,21,47,19,21,15,26,0,1,9,34,47,9,1,47,73,32,47,6,26,8,12,9,38,73
2011-10-17 00:00:00.000,Stockholm Sweden ATP World Tour 250,HARD,2,Gael Monfils,N/A Bye,Gael Monfils,,R32,0,0,0,0,0,0,0,0,0,0,0,0,0,0,0,0,0,0,0,0,0,0,0,0,0,0,0
2011-10-17 00:00:00.000,Stockholm Sweden ATP World Tour 250,HARD,2,Bernard Tomic,Jurgen Zopp,Bernard Tomic,7-6(5); 4-6; 6-0,R32,108,8,0,77,101,58,77,10,24,6,8,14,68,101,6,4,49,89,32,49,23,40,5,9,14,55,89
2011-10-17 00:00:00.000,Stockholm Sweden ATP World Tour 250,HARD,2,Tommy Haas,Somdev Devvarman,Tommy Haas,7-6(4); 6-4,R32,86,7,2,34,62,30,34,17,28,3,4,11,47,62,5,1,42,69,30,42,15,27,5,7,11,45,69
2011-10-17 00:00:00.000,Stockholm Sweden ATP World Tour 250,HARD,2,Kevin Anderson,Guillermo Garcia-Lopez,Kevin Anderson,7-6(1); 7-6(4),R32,128,9,3,57,80,42,57,11,23,3,6,12,53,80,4,7,61,106,37,61,23,45,10,13,12,60,106
2011-10-17 00:00:00.000,Stockholm Sweden ATP World Tour 250,HARD,2,Juan Ignacio Chela,N/A Bye,Juan Ignacio Chela,,R32,0,0,0,0,0,0,0,0,0,0,0,0,0,0,0,0,0,0,0,0,0,0,0,0,0,0,0
2011-10-17 00:00:00.000,Stockholm Sweden ATP World Tour 250,HARD,2,Grigor Dimitrov,Ryan Sweeting,Grigor Dimitrov,6-3; 6-1,R32,73,6,2,31,53,25,31,11,22,1,1,8,36,53,2,1,44,61,24,44,6,17,8,12,8,30,61
2011-10-17 00:00:00.000,Stockholm Sweden ATP World Tour 250,HARD,2,Philipp Petzschner,Lukasz Kubot,Philipp Petzschner,6-2; 7-5,R32,78,2,3,35,62,28,35,17,27,3,3,10,45,62,3,3,38,57,25,38,10,19,2,5,10,35,57
2011-10-17 00:00:00.000,Stockholm Sweden ATP World Tour 250,HARD,2,Milos Raonic,Marcos Baghdatis,Milos Raonic,7-6(5); 6-7(4); 6-4,R32,143,22,4,84,115,69,84,15,31,1,1,17,84,115,6,4,58,105,52,58,28,47,4,5,17,80,105
2011-10-17 00:00:00.000,Stockholm Sweden ATP World Tour 250,HARD,2,Tobias Kamke,Tommy Robredo,Tobias Kamke,6-2; 6-3,R32,63,2,4,28,52,24,28,11,24,2,3,9,35,52,1,1,25,45,13,25,10,20,3,7,8,23,45
2011-10-17 00:00:00.000,Stockholm Sweden ATP World Tour 250,HARD,2,Sebastian Rieschick,Michael Ryderstedt,Sebastian Rieschick,6-4; 3-6; 6-3,R32,99,12,1,51,74,40,51,14,23,3,4,14,54,74,13,5,59,88,42,59,17,29,4,6,14,59,88
2011-10-17 00:00:00.000,Stockholm Sweden ATP World Tour 250,HARD,2,Jarkko Nieminen,Marius Copil,Jarkko Nieminen,6-3; 7-6(4),R32,89,0,0,41,76,32,41,22,35,3,3,11,54,76,10,0,27,54,22,27,18,27,1,2,10,40,54
2011-10-17 00:00:00.000,Stockholm Sweden ATP World Tour 250,HARD,2,Stanislas Wawrinka,N/A Bye,Stanislas Wawrinka,,R32,0,0,0,0,0,0,0,0,0,0,0,0,0,0,0,0,0,0,0,0,0,0,0,0,0,0,0
2011-10-17 00:00:00.000,Stockholm Sweden ATP World Tour 250,HARD,2,Ivan Dodig,Adrian Mannarino,Ivan Dodig,7-6(5); 7-6(6),R32,129,19,4,58,86,46,58,14,28,3,4,12,60,86,1,1,79,120,51,79,21,41,7,8,12,72,120
2011-10-17 00:00:00.000,Stockholm Sweden ATP World Tour 250,HARD,2,David Nalbandian,Xavier Malisse,David Nalbandian,4-6; 7-6(6); 7-6(3),R32,161,8,7,67,119,48,67,27,52,2,6,17,75,119,16,3,76,124,55,76,21,48,7,10,17,76,124
2011-10-17 00:00:00.000,Stockholm Sweden ATP World Tour 250,HARD,2,James Blake,Olivier Rochus,James Blake,7-6(6); 6-3,R32,85,17,2,47,79,40,47,13,32,3,4,11,53,79,2,1,46,70,35,46,10,24,8,10,10,45,70
2011-10-17 00:00:00.000,Stockholm Sweden ATP World Tour 250,HARD,2,Juan Martin Del Potro,N/A Bye,Juan Martin Del Potro,,R32,0,0,0,0,0,0,0,0,0,0,0,0,0,0,0,0,0,0,0,0,0,0,0,0,0,0,0
2011-10-17 00:00:00.000,Stockholm Sweden ATP World Tour 250,HARD,2,Gael Monfils,Bernard Tomic,Gael Monfils,6-4; 6-7(4); 6-4,R16,111,18,3,74,102,53,74,17,28,8,9,16,70,102,4,1,80,109,54,80,15,29,7,10,16,69,109
2011-10-17 00:00:00.000,Stockholm Sweden ATP World Tour 250,HARD,2,Kevin Anderson,Tommy Haas,Kevin Anderson,6-7(3); 6-4; 6-4,R16,121,20,0,73,90,59,73,9,17,0,0,16,68,90,14,1,56,83,40,56,20,27,0,2,16,60,83
2011-10-17 00:00:00.000,Stockholm Sweden ATP World Tour 250,HARD,2,Grigor Dimitrov,Juan Ignacio Chela,Grigor Dimitrov,6-2; 5-7; 6-1,R16,109,5,1,54,79,38,54,13,25,1,4,14,51,79,0,2,40,70,26,40,10,30,4,10,13,36,70
2011-10-17 00:00:00.000,Stockholm Sweden ATP World Tour 250,HARD,2,Milos Raonic,Philipp Petzschner,Milos Raonic,6-3; 6-3,R16,73,7,0,32,46,28,32,8,14,0,0,9,36,46,4,2,30,69,20,30,19,39,4,7,9,39,69
2011-10-17 00:00:00.000,Stockholm Sweden ATP World Tour 250,HARD,2,Tobias Kamke,Sebastian Rieschick,Tobias Kamke,6-3; 6-1,R16,58,3,3,27,46,22,27,11,19,0,0,8,33,46,3,3,31,52,17,31,11,21,2,6,8,28,52
2011-10-17 00:00:00.000,Stockholm Sweden ATP World Tour 250,HARD,2,Jarkko Nieminen,Stanislas Wawrinka,Jarkko Nieminen,6-3; 6-4,R16,71,1,2,36,57,25,36,14,21,1,2,10,39,57,6,2,36,48,24,36,6,12,2,5,9,30,48
2011-10-17 00:00:00.000,Stockholm Sweden ATP World Tour 250,HARD,2,David Nalbandian,Ivan Dodig,David Nalbandian,6-1; 6-1,R16,59,2,0,24,37,21,24,8,13,1,1,7,29,37,2,0,24,49,10,24,11,25,5,10,7,21,49
2011-10-17 00:00:00.000,Stockholm Sweden ATP World Tour 250,HARD,2,James Blake,Juan Martin Del Potro,James Blake,6-4; 6-4,R16,87,3,1,34,56,28,34,13,22,0,0,10,41,56,4,0,39,64,25,39,14,25,2,4,10,39,64
2011-10-17 00:00:00.000,Stockholm Sweden ATP World Tour 250,HARD,2,Gael Monfils,Kevin Anderson,Gael Monfils,7-5; 7-5,Q,92,6,0,55,78,32,55,16,23,5,8,12,48,78,5,1,49,70,32,49,5,21,1,6,12,37,70
2011-10-17 00:00:00.000,Stockholm Sweden ATP World Tour 250,HARD,2,Milos Raonic,Grigor Dimitrov,Milos Raonic,7-5; 6-4,Q,78,14,1,39,54,33,39,11,15,0,0,11,44,54,3,1,35,64,24,35,17,29,2,4,11,41,64
2011-10-17 00:00:00.000,Stockholm Sweden ATP World Tour 250,HARD,2,Jarkko Nieminen,Tobias Kamke,Jarkko Nieminen,3-6; 7-5; 6-1,Q,122,2,5,68,95,42,68,15,27,7,11,14,57,95,2,2,45,80,25,45,15,35,2,8,14,40,80
2011-10-17 00:00:00.000,Stockholm Sweden ATP World Tour 250,HARD,2,James Blake,David Nalbandian,James Blake,W/O,Q,0,0,0,0,0,0,0,0,0,0,0,0,0,0,0,0,0,0,0,0,0,0,0,0,0,0,0
2011-10-17 00:00:00.000,Stockholm Sweden ATP World Tour 250,HARD,2,Gael Monfils,Milos Raonic,Gael Monfils,6-7(6); 6-4; 6-3,S,130,4,3,69,103,51,69,20,34,2,3,16,71,103,9,2,64,97,48,64,15,33,6,9,15,63,97
2011-10-17 00:00:00.000,Stockholm Sweden ATP World Tour 250,HARD,2,Jarkko Nieminen,James Blake,Jarkko Nieminen,7-6(5); 5-7; 6-2,S,124,5,1,66,86,44,66,14,20,4,8,16,58,86,6,7,76,135,57,76,19,59,9,14,16,76,135
2011-10-17 00:00:00.000,Stockholm Sweden ATP World Tour 250,HARD,2,Gael Monfils,Jarkko Nieminen,Gael Monfils,7-5; 3-6; 6-2,F,112,13,1,54,75,38,54,9,21,3,7,14,47,75,1,4,61,96,35,61,18,35,11,17,15,53,96
2011-10-24 00:00:00.000,St. Petersburg Russia ATP World Tour 250,HARD,2,Adrian Mannarino,Gilles Simon,Adrian Mannarino,2-6; 6-4; 6-4,R32,131,1,1,58,94,35,58,19,36,9,13,14,54,94,3,3,53,90,29,53,21,37,2,6,14,50,90
2011-10-24 00:00:00.000,St. Petersburg Russia ATP World Tour 250,HARD,2,Lukas Rosol,Ernests Gulbis,Lukas Rosol,6-3; 6-4,R32,85,4,4,32,63,22,32,22,31,1,1,10,44,63,3,8,37,64,24,37,14,27,6,8,9,38,64
2011-10-24 00:00:00.000,St. Petersburg Russia ATP World Tour 250,HARD,2,Julien Benneteau,Pere Riba,Julien Benneteau,6-2; 6-1,R32,56,5,4,31,43,28,31,6,12,3,3,8,34,43,1,5,18,42,10,18,10,24,5,9,7,20,42
2011-10-24 00:00:00.000,St. Petersburg Russia ATP World Tour 250,HARD,2,Mikhail Youzhny,Sergiy Stakhovsky,Mikhail Youzhny,6-3; 7-6(7),R32,97,1,3,41,74,26,41,22,33,0,2,11,48,74,7,2,31,59,21,31,13,28,1,4,10,34,59
2011-10-24 00:00:00.000,St. Petersburg Russia ATP World Tour 250,HARD,2,Marin Cilic,Sergei Bubka,Marin Cilic,6-4; 7-6(1),R32,111,6,1,39,78,29,39,24,39,5,6,11,53,78,4,2,52,80,37,52,11,28,6,8,11,48,80
2011-10-24 00:00:00.000,St. Petersburg Russia ATP World Tour 250,HARD,2,Somdev Devvarman,Karol Beck,Somdev Devvarman,6-2; 6-3,R32,68,2,2,29,48,24,29,8,19,1,2,8,32,48,3,4,26,54,18,26,8,28,1,6,9,26,54
2011-10-24 00:00:00.000,St. Petersburg Russia ATP World Tour 250,HARD,2,Andreas Seppi,Vasek Pospisil,Andreas Seppi,7-5; 7-6(4),R32,121,3,1,50,88,37,50,21,38,5,7,12,58,88,5,3,39,85,28,39,21,46,2,5,12,49,85
2011-10-24 00:00:00.000,St. Petersburg Russia ATP World Tour 250,HARD,2,Igor Andreev,Marcel Granollers,Igor Andreev,3-6; 6-4; 7-6(4),R32,170,2,5,69,118,49,69,24,49,11,15,16,73,118,9,2,63,98,46,63,16,35,4,7,15,62,98
2011-10-24 00:00:00.000,St. Petersburg Russia ATP World Tour 250,HARD,2,Alex Bogomolov Jr.,Igor Kunitsyn,Alex Bogomolov Jr.,6-3; 6-1,R32,66,4,0,36,45,26,36,7,9,1,1,8,33,45,6,0,45,60,26,45,4,15,4,8,8,30,60
2011-10-24 00:00:00.000,St. Petersburg Russia ATP World Tour 250,HARD,2,Philipp Kohlschreiber,Carlos Berlocq,Philipp Kohlschreiber,6-7(4); 6-3; 6-1,R32,135,2,2,57,98,41,57,23,41,9,11,14,64,98,2,2,45,79,26,45,21,34,1,7,14,47,79
2011-10-24 00:00:00.000,St. Petersburg Russia ATP World Tour 250,HARD,2,Dusan Lajovic,Jeremy Chardy,Dusan Lajovic,6-4; 6-4,R32,73,0,0,34,53,26,34,15,19,0,0,10,41,53,4,0,43,66,32,43,10,23,3,5,10,42,66
2011-10-24 00:00:00.000,St. Petersburg Russia ATP World Tour 250,HARD,2,Dudi Sela,Alexandr Dolgopolov,Dudi Sela,6-2; 6-2,R32,60,0,2,27,49,20,27,15,22,2,2,8,35,49,3,2,21,50,15,21,13,29,2,6,8,28,50
2011-10-24 00:00:00.000,St. Petersburg Russia ATP World Tour 250,HARD,2,Dmitry Tursunov,Teymuraz Gabashvili,Dmitry Tursunov,7-5; 6-3,R32,89,6,3,28,55,25,28,13,27,4,6,10,38,55,2,3,46,69,24,46,12,23,4,9,11,36,69
2011-10-24 00:00:00.000,St. Petersburg Russia ATP World Tour 250,HARD,2,Potito Starace,Ivan Nedelko,Potito Starace,6-0; 6-1,R32,45,3,0,26,43,22,26,10,17,5,5,7,32,43,1,1,10,27,3,10,4,17,0,5,6,7,27
2011-10-24 00:00:00.000,St. Petersburg Russia ATP World Tour 250,HARD,2,Michael Berrer,Mikhail Kukushkin,Michael Berrer,6-1; 4-6; 6-4,R32,139,3,3,58,88,38,58,13,30,5,9,13,51,88,4,8,54,104,33,54,19,50,9,16,14,52,104
2011-10-24 00:00:00.000,St. Petersburg Russia ATP World Tour 250,HARD,2,Janko Tipsarevic,Olivier Rochus,Janko Tipsarevic,6-2; 7-5,R32,95,10,3,32,72,22,32,22,40,5,7,10,44,72,0,6,27,54,18,27,10,27,0,5,10,28,54
2011-10-24 00:00:00.000,St. Petersburg Russia ATP World Tour 250,HARD,2,Adrian Mannarino,Lukas Rosol,Adrian Mannarino,6-2; 7-6(5),R16,91,4,3,40,66,27,40,19,26,2,3,10,46,66,5,3,45,81,31,45,15,36,5,8,10,46,81
2011-10-24 00:00:00.000,St. Petersburg Russia ATP World Tour 250,HARD,2,Mikhail Youzhny,Julien Benneteau,Mikhail Youzhny,6-4; 3-6; 6-2,R16,127,3,5,46,88,28,46,24,42,6,10,14,52,88,6,2,48,75,29,48,12,27,3,8,13,41,75
2011-10-24 00:00:00.000,St. Petersburg Russia ATP World Tour 250,HARD,2,Marin Cilic,Somdev Devvarman,Marin Cilic,5-7; 6-1; 6-3,R16,136,13,1,53,89,41,53,17,36,1,3,14,58,89,2,2,66,96,39,66,16,30,7,12,14,55,96
2011-10-24 00:00:00.000,St. Petersburg Russia ATP World Tour 250,HARD,2,Andreas Seppi,Igor Andreev,Andreas Seppi,3-6; 6-2; 6-4,R16,120,3,2,38,80,28,38,25,42,4,6,13,53,80,2,4,44,82,28,44,19,38,2,6,14,47,82
2011-10-24 00:00:00.000,St. Petersburg Russia ATP World Tour 250,HARD,2,Alex Bogomolov Jr.,Philipp Kohlschreiber,Alex Bogomolov Jr.,6-4; 3-6; 7-5,R16,150,0,3,78,101,50,78,8,23,3,7,15,58,101,8,4,59,107,36,59,24,48,7,12,16,60,107
2011-10-24 00:00:00.000,St. Petersburg Russia ATP World Tour 250,HARD,2,Dusan Lajovic,Dudi Sela,Dusan Lajovic,2-6; 6-2; 6-1,R16,98,2,1,45,62,30,45,8,17,3,6,11,38,62,1,4,55,88,29,55,13,33,7,13,12,42,88
2011-10-24 00:00:00.000,St. Petersburg Russia ATP World Tour 250,HARD,2,Potito Starace,Dmitry Tursunov,Potito Starace,6-2; 6-4,R16,78,4,1,41,54,31,41,9,13,1,1,9,40,54,5,5,29,58,20,29,14,29,5,8,9,34,58
2011-10-24 00:00:00.000,St. Petersburg Russia ATP World Tour 250,HARD,2,Janko Tipsarevic,Michael Berrer,Janko Tipsarevic,6-3; 2-0 RET,R16,54,0,2,17,29,13,17,8,12,0,1,6,21,29,1,2,24,36,12,24,4,12,3,6,5,16,36
2011-10-24 00:00:00.000,St. Petersburg Russia ATP World Tour 250,HARD,2,Mikhail Youzhny,Adrian Mannarino,Mikhail Youzhny,6-2; 6-3,Q,79,3,1,35,55,27,35,11,20,2,3,9,38,55,3,0,42,56,23,42,5,14,5,9,8,28,56
2011-10-24 00:00:00.000,St. Petersburg Russia ATP World Tour 250,HARD,2,Marin Cilic,Andreas Seppi,Marin Cilic,4-6; 7-6(8); 6-4,Q,148,13,2,61,98,51,61,21,37,1,2,16,72,98,5,4,62,107,49,62,26,45,3,4,16,75,107
2011-10-24 00:00:00.000,St. Petersburg Russia ATP World Tour 250,HARD,2,Alex Bogomolov Jr.,Dusan Lajovic,Alex Bogomolov Jr.,6-2; 6-1,Q,85,0,0,36,45,26,36,6,9,3,3,7,32,45,2,4,54,84,29,54,11,30,10,15,8,40,84
2011-10-24 00:00:00.000,St. Petersburg Russia ATP World Tour 250,HARD,2,Janko Tipsarevic,Potito Starace,Janko Tipsarevic,6-7(6); 6-2; 6-1,Q,146,12,2,42,81,35,42,28,39,2,2,14,63,81,2,4,59,103,34,59,23,44,5,9,13,57,103
2011-10-24 00:00:00.000,St. Petersburg Russia ATP World Tour 250,HARD,2,Marin Cilic,Mikhail Youzhny,Marin Cilic,6-3; 6-4,S,83,5,1,30,55,24,30,13,25,3,5,10,37,55,1,2,43,63,27,43,6,20,2,6,9,33,63
2011-10-24 00:00:00.000,St. Petersburg Russia ATP World Tour 250,HARD,2,Janko Tipsarevic,Alex Bogomolov Jr.,Janko Tipsarevic,6-2; 6-1,S,77,6,1,24,41,17,24,13,17,2,3,8,30,41,1,3,34,51,22,34,1,17,4,9,7,23,51
2011-10-24 00:00:00.000,St. Petersburg Russia ATP World Tour 250,HARD,2,Marin Cilic,Janko Tipsarevic,Marin Cilic,6-3; 3-6; 6-2,F,138,3,2,49,85,34,49,22,36,4,5,13,56,85,4,2,47,77,35,47,14,30,5,8,13,49,77
2011-10-24 00:00:00.000,Vienna Austria ATP World Tour 250,HARD,2,Jo-Wilfried Tsonga,N/A Bye,Jo-Wilfried Tsonga,,R32,0,0,0,0,0,0,0,0,0,0,0,0,0,0,0,0,0,0,0,0,0,0,0,0,0,0,0
2011-10-24 00:00:00.000,Vienna Austria ATP World Tour 250,HARD,2,Jarkko Nieminen,Robin Haase,Jarkko Nieminen,7-6(3); 6-4,R32,85,2,2,55,73,41,55,11,18,1,1,11,52,73,12,1,42,64,34,42,10,22,1,2,11,44,64
2011-10-24 00:00:00.000,Vienna Austria ATP World Tour 250,HARD,2,Xavier Malisse,Albert Ramos,Xavier Malisse,6-1; 6-4,R32,63,5,2,25,47,23,25,13,22,0,0,9,36,47,1,2,27,49,16,27,12,22,5,8,8,28,49
2011-10-24 00:00:00.000,Vienna Austria ATP World Tour 250,HARD,2,Fabio Fognini,Tommy Robredo,Fabio Fognini,7-6(7); 5-7; 2-1 RET,R32,129,3,3,63,91,48,63,16,28,2,3,14,64,91,5,1,49,85,35,49,24,36,1,1,13,59,85
2011-10-24 00:00:00.000,Vienna Austria ATP World Tour 250,HARD,2,Radek Stepanek,N/A Bye,Radek Stepanek,,R32,0,0,0,0,0,0,0,0,0,0,0,0,0,0,0,0,0,0,0,0,0,0,0,0,0,0,0
2011-10-24 00:00:00.000,Vienna Austria ATP World Tour 250,HARD,2,Daniel Brands,Martin Fischer,Daniel Brands,6-7(3); 6-2; 7-6(6),R32,144,14,2,82,115,59,82,20,33,8,9,16,79,115,3,0,75,103,53,75,15,28,6,9,16,68,103
2011-10-24 00:00:00.000,Vienna Austria ATP World Tour 250,HARD,2,Dominic Thiem,Thomas Muster,Dominic Thiem,6-2; 6-3,R32,64,5,3,30,51,24,30,8,21,2,3,8,32,51,5,4,40,57,24,40,5,17,1,6,9,29,57
2011-10-24 00:00:00.000,Vienna Austria ATP World Tour 250,HARD,2,Steve Darcis,Nikolay Davydenko,Steve Darcis,3-6; 6-0; 7-6(2),R32,126,7,0,59,88,41,59,10,29,6,11,13,51,88,0,2,67,86,32,67,10,19,5,12,14,42,86
2011-10-24 00:00:00.000,Vienna Austria ATP World Tour 250,HARD,2,Kevin Anderson,Andreas Haider-Maurer,Kevin Anderson,6-4; 6-4,R32,94,10,0,35,58,29,35,15,23,5,5,10,44,58,8,3,52,78,36,52,10,26,7,9,10,46,78
2011-10-24 00:00:00.000,Vienna Austria ATP World Tour 250,HARD,2,Marcos Baghdatis,Ryan Sweeting,Marcos Baghdatis,6-4; 6-2,R32,72,10,2,29,55,23,29,14,26,3,4,9,37,55,3,2,34,53,20,34,9,19,2,6,9,29,53
2011-10-24 00:00:00.000,Vienna Austria ATP World Tour 250,HARD,2,Guillermo Garcia-Lopez,James Blake,Guillermo Garcia-Lopez,6-2; 5-7; 6-4,R32,105,10,6,50,89,39,50,19,39,3,6,15,58,89,7,4,52,85,34,52,18,33,10,15,15,52,85
2011-10-24 00:00:00.000,Vienna Austria ATP World Tour 250,HARD,2,Jurgen Melzer,N/A Bye,Jurgen Melzer,,R32,0,0,0,0,0,0,0,0,0,0,0,0,0,0,0,0,0,0,0,0,0,0,0,0,0,0,0
2011-10-24 00:00:00.000,Vienna Austria ATP World Tour 250,HARD,2,Tommy Haas,Juan Ignacio Chela,Tommy Haas,6-7(3); 6-3; 7-6(5),R32,152,10,1,67,100,50,67,20,33,1,2,16,70,100,5,4,69,117,49,69,26,48,3,6,17,75,117
2011-10-24 00:00:00.000,Vienna Austria ATP World Tour 250,HARD,2,Aljaz Bedene,Ivo Karlovic,Aljaz Bedene,7-6(4) RET,R32,64,6,1,31,45,26,31,7,14,0,0,6,33,45,9,1,23,37,18,23,9,14,0,0,6,27,37
2011-10-24 00:00:00.000,Vienna Austria ATP World Tour 250,HARD,2,Philipp Petzschner,Pablo Andujar,Philipp Petzschner,6-2; 6-2,R32,61,5,1,21,40,15,21,14,19,2,3,8,29,40,0,1,23,51,13,23,11,28,4,9,8,24,51
2011-10-24 00:00:00.000,Vienna Austria ATP World Tour 250,HARD,2,Juan Martin Del Potro,N/A Bye,Juan Martin Del Potro,,R32,0,0,0,0,0,0,0,0,0,0,0,0,0,0,0,0,0,0,0,0,0,0,0,0,0,0,0
2011-10-24 00:00:00.000,Vienna Austria ATP World Tour 250,HARD,2,Jo-Wilfried Tsonga,Jarkko Nieminen,Jo-Wilfried Tsonga,3-6; 6-1; 3-1 RET,R16,65,14,1,38,52,28,38,9,14,0,1,10,37,52,1,1,35,60,22,35,12,25,1,4,10,34,60
2011-10-24 00:00:00.000,Vienna Austria ATP World Tour 250,HARD,2,Xavier Malisse,Fabio Fognini,Xavier Malisse,6-7(3); 6-3; 6-3,R16,120,9,3,48,83,43,48,17,35,0,1,15,60,83,5,5,59,108,38,59,25,49,6,10,15,63,108
2011-10-24 00:00:00.000,Vienna Austria ATP World Tour 250,HARD,2,Daniel Brands,Radek Stepanek,Daniel Brands,6-4; 7-6(4),R16,80,7,1,53,67,42,53,11,14,1,1,11,53,67,4,3,35,59,28,35,18,24,1,2,11,46,59
2011-10-24 00:00:00.000,Vienna Austria ATP World Tour 250,HARD,2,Steve Darcis,Dominic Thiem,Steve Darcis,6-2; 6-2,R16,65,4,1,31,43,24,31,8,12,0,0,8,32,43,6,1,26,54,20,26,9,28,5,9,8,29,54
2011-10-24 00:00:00.000,Vienna Austria ATP World Tour 250,HARD,2,Kevin Anderson,Marcos Baghdatis,Kevin Anderson,6-2; 7-6(5),R16,91,12,4,42,67,29,42,12,25,2,5,10,41,67,5,1,36,66,23,36,12,30,5,10,10,35,66
2011-10-24 00:00:00.000,Vienna Austria ATP World Tour 250,HARD,2,Jurgen Melzer,Guillermo Garcia-Lopez,Jurgen Melzer,7-5; 6-1,R16,83,7,1,48,73,32,48,17,25,5,5,10,49,73,2,6,24,51,15,24,14,27,1,4,9,29,51
2011-10-24 00:00:00.000,Vienna Austria ATP World Tour 250,HARD,2,Tommy Haas,Aljaz Bedene,Tommy Haas,4-6; 6-4; 6-1,R16,103,10,3,49,78,39,49,16,29,4,6,14,55,78,12,4,35,68,28,35,16,33,3,7,13,44,68
2011-10-24 00:00:00.000,Vienna Austria ATP World Tour 250,HARD,2,Juan Martin Del Potro,Philipp Petzschner,Juan Martin Del Potro,6-3; 6-4,R16,87,6,3,39,64,29,39,16,25,4,4,10,45,64,8,4,31,54,23,31,9,23,2,4,9,32,54
2011-10-24 00:00:00.000,Vienna Austria ATP World Tour 250,HARD,2,Jo-Wilfried Tsonga,Xavier Malisse,Jo-Wilfried Tsonga,4-6; 7-6(4); 6-4,Q,120,20,3,64,108,53,64,25,44,5,6,16,78,108,10,4,56,95,48,56,22,39,2,3,16,70,95
2011-10-24 00:00:00.000,Vienna Austria ATP World Tour 250,HARD,2,Daniel Brands,Steve Darcis,Daniel Brands,6-3; 6-4,Q,72,11,3,38,58,31,38,11,20,0,1,10,42,58,5,1,39,58,25,39,9,19,3,6,9,34,58
2011-10-24 00:00:00.000,Vienna Austria ATP World Tour 250,HARD,2,Kevin Anderson,Jurgen Melzer,Kevin Anderson,6-3; 6-3,Q,63,11,2,29,44,26,29,10,15,0,0,9,36,44,4,2,31,48,22,31,8,17,1,4,9,30,48
2011-10-24 00:00:00.000,Vienna Austria ATP World Tour 250,HARD,2,Juan Martin Del Potro,Tommy Haas,Juan Martin Del Potro,6-2; 6-4,Q,80,10,0,33,43,29,33,7,10,0,0,9,36,43,6,3,33,59,22,33,11,26,5,8,9,33,59
2011-10-24 00:00:00.000,Vienna Austria ATP World Tour 250,HARD,2,Jo-Wilfried Tsonga,Daniel Brands,Jo-Wilfried Tsonga,6-2; 7-6(4),S,84,13,1,40,59,34,40,12,19,0,0,10,46,59,4,3,52,71,36,52,8,19,7,9,10,44,71
2011-10-24 00:00:00.000,Vienna Austria ATP World Tour 250,HARD,2,Juan Martin Del Potro,Kevin Anderson,Juan Martin Del Potro,6-4; 3-6; 6-4,S,133,18,0,56,83,42,56,15,27,2,4,14,57,83,17,3,55,77,40,55,11,22,1,4,15,51,77
2011-10-24 00:00:00.000,Vienna Austria ATP World Tour 250,HARD,2,Jo-Wilfried Tsonga,Juan Martin Del Potro,Jo-Wilfried Tsonga,6-7(5); 6-3; 6-4,F,148,25,5,55,96,45,55,24,41,3,4,16,69,96,7,2,66,103,46,66,19,37,4,7,15,65,103
2011-10-31 00:00:00.000,Basel Switzerland ATP World Tour 500,HARD,2,Novak Djokovic,Xavier Malisse,Novak Djokovic,6-2; 4-6; 7-5,R32,133,8,7,47,84,38,47,21,37,6,8,15,59,84,7,3,45,94,32,45,27,49,6,10,15,59,94
2011-10-31 00:00:00.000,Basel Switzerland ATP World Tour 500,HARD,2,Lukasz Kubot,Tobias Kamke,Lukasz Kubot,5-7; 7-5; 6-2,R32,178,7,7,81,134,49,81,27,53,21,26,16,76,134,1,3,56,95,32,56,17,39,2,9,16,49,95
2011-10-31 00:00:00.000,Basel Switzerland ATP World Tour 500,HARD,2,Michael Lammer,Mikhail Youzhny,Michael Lammer,6-4; 6-3,R32,59,6,2,30,46,24,30,9,16,1,2,9,33,46,1,3,33,55,20,33,11,22,1,5,10,31,55
2011-10-31 00:00:00.000,Basel Switzerland ATP World Tour 500,HARD,2,Marcos Baghdatis,Viktor Troicki,Marcos Baghdatis,4-6; 7-6(8); 6-2,R32,163,6,2,60,115,43,60,28,55,7,11,15,71,115,4,4,41,105,31,41,31,64,2,7,15,62,105
2011-10-31 00:00:00.000,Basel Switzerland ATP World Tour 500,HARD,2,Kei Nishikori,Tomas Berdych,Kei Nishikori,3-6; 6-3; 6-2,R32,124,1,3,40,68,33,40,18,28,0,1,13,51,68,4,5,48,93,37,48,19,45,7,10,13,56,93
2011-10-31 00:00:00.000,Basel Switzerland ATP World Tour 500,HARD,2,Andreas Seppi,Gilles Muller,Andreas Seppi,7-6(4); 6-7(5); 6-2,R32,143,13,2,52,105,43,52,31,53,2,3,16,74,105,23,2,62,110,49,62,23,48,7,10,16,72,110
2011-10-31 00:00:00.000,Basel Switzerland ATP World Tour 500,HARD,2,Mikhail Kukushkin,Donald Young,Mikhail Kukushkin,6-4; 6-2,R32,87,1,2,38,69,26,38,14,31,9,12,9,40,69,2,1,35,56,20,35,5,21,3,9,9,25,56
2011-10-31 00:00:00.000,Basel Switzerland ATP World Tour 500,HARD,2,James Blake,Mardy Fish,James Blake,0-1 RET,R32,12,0,0,1,1,1,1,0,0,0,0,0,1,1,0,1,1,8,1,1,4,7,0,0,1,5,8
2011-10-31 00:00:00.000,Basel Switzerland ATP World Tour 500,HARD,2,Andy Roddick,Tommy Haas,Andy Roddick,6-3; 6-4,R32,71,12,1,35,52,30,35,11,17,0,0,10,41,52,4,4,30,53,21,30,11,23,3,5,9,32,53
2011-10-31 00:00:00.000,Basel Switzerland ATP World Tour 500,HARD,2,Radek Stepanek,Santiago Giraldo,Radek Stepanek,6-1; 6-3,R32,62,4,1,28,51,21,28,16,23,2,2,8,37,51,2,1,31,49,18,31,7,18,3,7,8,25,49
2011-10-31 00:00:00.000,Basel Switzerland ATP World Tour 500,HARD,2,Jarkko Nieminen,Thomaz Bellucci,Jarkko Nieminen,6-7(5); 6-4; 6-3,R32,127,9,3,70,100,51,70,17,30,6,7,15,68,100,7,7,65,106,45,65,20,41,3,7,16,65,106
2011-10-31 00:00:00.000,Basel Switzerland ATP World Tour 500,HARD,2,Roger Federer,Potito Starace,Roger Federer,7-6(3); 6-4,R32,79,4,5,43,65,38,43,12,22,1,1,11,50,65,7,2,40,65,32,40,13,25,2,3,11,45,65
2011-10-31 00:00:00.000,Basel Switzerland ATP World Tour 500,HARD,2,Florian Mayer,Janko Tipsarevic,Florian Mayer,5-1 RET,R32,30,0,1,5,15,5,5,7,10,0,0,3,12,15,2,1,13,29,7,13,6,16,1,3,3,13,29
2011-10-31 00:00:00.000,Basel Switzerland ATP World Tour 500,HARD,2,Ivan Ljubicic,Michael Llodra,Ivan Ljubicic,7-5; 6-4,R32,81,9,0,31,64,26,31,20,33,1,1,11,46,64,6,4,34,57,28,34,11,23,1,3,11,39,57
2011-10-31 00:00:00.000,Basel Switzerland ATP World Tour 500,HARD,2,Stanislas Wawrinka,Ivan Dodig,Stanislas Wawrinka,6-4; 6-4,R32,87,6,1,32,55,26,32,16,23,1,1,10,42,55,6,3,25,56,16,25,20,31,2,4,10,36,56
2011-10-31 00:00:00.000,Basel Switzerland ATP World Tour 500,HARD,2,Robin Haase,Marco Chiudinelli,Robin Haase,6-2; 7-6(7),R32,88,12,6,35,66,30,35,16,31,1,2,10,46,66,1,2,37,63,22,37,14,26,2,5,10,36,63
2011-10-31 00:00:00.000,Basel Switzerland ATP World Tour 500,HARD,2,Novak Djokovic,Lukasz Kubot,Novak Djokovic,6-1; 6-2,R16,55,8,2,27,43,22,27,11,16,0,0,8,33,43,0,4,23,43,15,23,6,20,3,7,7,21,43
2011-10-31 00:00:00.000,Basel Switzerland ATP World Tour 500,HARD,2,Marcos Baghdatis,Michael Lammer,Marcos Baghdatis,7-6(2); 6-7(2); 6-3,R16,160,9,7,55,118,44,55,40,63,4,4,17,84,118,1,1,50,96,40,50,31,46,4,5,16,71,96
2011-10-31 00:00:00.000,Basel Switzerland ATP World Tour 500,HARD,2,Kei Nishikori,Andreas Seppi,Kei Nishikori,6-3; 7-6(4),R16,106,2,2,40,80,29,40,22,40,2,4,11,51,80,5,1,32,56,21,32,13,24,2,5,10,34,56
2011-10-31 00:00:00.000,Basel Switzerland ATP World Tour 500,HARD,2,Mikhail Kukushkin,James Blake,Mikhail Kukushkin,6-3; 6-4,R16,77,6,0,33,53,26,33,12,20,0,1,10,38,53,3,3,38,69,26,38,11,31,7,10,9,37,69
2011-10-31 00:00:00.000,Basel Switzerland ATP World Tour 500,HARD,2,Andy Roddick,Radek Stepanek,Andy Roddick,2-6; 6-3; 6-3,R16,104,10,3,46,69,33,46,14,23,5,8,13,47,69,8,8,37,74,30,37,14,37,1,5,13,44,74
2011-10-31 00:00:00.000,Basel Switzerland ATP World Tour 500,HARD,2,Roger Federer,Jarkko Nieminen,Roger Federer,6-1; 4-6; 6-3,R16,95,10,4,42,78,37,42,15,36,3,5,13,52,78,2,6,45,82,31,45,15,37,2,7,13,46,82
2011-10-31 00:00:00.000,Basel Switzerland ATP World Tour 500,HARD,2,Florian Mayer,Ivan Ljubicic,Florian Mayer,6-3; 6-1,R16,59,4,3,30,49,25,30,8,19,3,4,8,33,49,5,2,28,49,17,28,5,21,0,5,8,22,49
2011-10-31 00:00:00.000,Basel Switzerland ATP World Tour 500,HARD,2,Stanislas Wawrinka,Robin Haase,Stanislas Wawrinka,4-6; 6-1; 6-2,R16,128,8,1,42,75,34,42,19,33,1,2,13,53,75,1,4,60,110,33,60,25,50,13,17,12,58,110
2011-10-31 00:00:00.000,Basel Switzerland ATP World Tour 500,HARD,2,Novak Djokovic,Marcos Baghdatis,Novak Djokovic,2-6; 6-2; 6-3,Q,99,4,2,50,75,35,50,16,25,1,3,13,51,75,12,7,40,71,29,40,15,31,0,3,12,44,71
2011-10-31 00:00:00.000,Basel Switzerland ATP World Tour 500,HARD,2,Kei Nishikori,Mikhail Kukushkin,Kei Nishikori,6-4; 5-7; 6-4,Q,159,2,3,48,98,32,48,24,50,4,10,16,56,98,4,1,50,106,27,50,29,56,9,16,16,56,106
2011-10-31 00:00:00.000,Basel Switzerland ATP World Tour 500,HARD,2,Roger Federer,Andy Roddick,Roger Federer,6-3; 6-2,Q,64,5,1,25,47,21,25,16,22,0,0,9,37,47,3,1,15,42,11,15,13,27,1,4,8,24,42
2011-10-31 00:00:00.000,Basel Switzerland ATP World Tour 500,HARD,2,Stanislas Wawrinka,Florian Mayer,Stanislas Wawrinka,6-2; 6-2,Q,64,7,3,16,41,15,16,17,25,0,0,8,32,41,0,2,17,53,8,17,18,36,5,9,8,26,53
2011-10-31 00:00:00.000,Basel Switzerland ATP World Tour 500,HARD,2,Kei Nishikori,Novak Djokovic,Kei Nishikori,2-6; 7-6(4); 6-0,S,136,4,2,38,82,28,38,22,44,3,7,13,50,82,6,4,61,91,41,61,10,30,2,7,13,51,91
2011-10-31 00:00:00.000,Basel Switzerland ATP World Tour 500,HARD,2,Roger Federer,Stanislas Wawrinka,Roger Federer,7-6(5); 6-2,S,88,3,3,37,62,28,37,13,25,0,1,10,41,62,3,0,41,67,28,41,9,26,2,5,10,37,67
2011-10-31 00:00:00.000,Basel Switzerland ATP World Tour 500,HARD,2,Roger Federer,Kei Nishikori,Roger Federer,6-1; 6-3,F,72,5,0,25,39,22,25,11,14,1,1,8,33,39,0,4,30,65,16,30,18,35,9,13,8,34,65
2011-10-31 00:00:00.000,Valencia Spain ATP World Tour 500,HARD,2,David Ferrer,Fernando Verdasco,David Ferrer,6-3; 6-2,R32,83,1,1,34,60,25,34,16,26,1,1,9,41,60,1,5,38,57,21,38,9,19,5,8,8,30,57
2011-10-31 00:00:00.000,Valencia Spain ATP World Tour 500,HARD,2,Vasek Pospisil,John Isner,Vasek Pospisil,6-3; 3-6; 7-6(9),R32,133,6,3,61,93,51,61,19,32,1,2,15,70,93,19,6,70,94,60,70,10,24,2,3,15,70,94
2011-10-31 00:00:00.000,Valencia Spain ATP World Tour 500,HARD,2,Nicolas Mahut,Guillermo Garcia-Lopez,Nicolas Mahut,7-6(5); 6-2,R32,99,5,3,46,72,38,46,12,26,1,1,10,50,72,4,1,34,62,25,34,16,28,4,6,10,41,62
2011-10-31 00:00:00.000,Valencia Spain ATP World Tour 500,HARD,2,Nikolay Davydenko,Gilles Simon,Nikolay Davydenko,6-4; 4-6; 6-3,R32,135,2,5,67,88,52,67,6,21,5,7,14,58,88,3,2,58,96,36,58,20,38,7,11,15,56,96
2011-10-31 00:00:00.000,Valencia Spain ATP World Tour 500,HARD,2,Juan Monaco,Nicolas Almagro,Juan Monaco,6-4; 3-6; 6-4,R32,144,2,5,56,90,39,56,20,34,9,11,14,59,90,7,3,48,93,30,48,29,45,9,12,15,59,93
2011-10-31 00:00:00.000,Valencia Spain ATP World Tour 500,HARD,2,Fabio Fognini,Daniel Gimeno-Traver,Fabio Fognini,6-4; 6-3,R32,71,1,3,35,57,27,35,9,22,0,2,10,36,57,3,4,22,54,15,22,14,32,1,5,9,29,54
2011-10-31 00:00:00.000,Valencia Spain ATP World Tour 500,HARD,2,Juan Carlos Ferrero,Igor Kunitsyn,Juan Carlos Ferrero,6-4; 7-6(2),R32,98,6,0,44,70,36,44,13,26,6,7,11,49,70,5,2,45,75,32,45,11,30,7,9,11,43,75
2011-10-31 00:00:00.000,Valencia Spain ATP World Tour 500,HARD,2,Alex Bogomolov Jr.,Feliciano Lopez,Alex Bogomolov Jr.,4-6; 6-4; 7-6(2),R32,138,5,5,81,103,55,81,11,22,8,11,16,66,103,15,4,53,103,41,53,23,50,5,8,16,64,103
2011-10-31 00:00:00.000,Valencia Spain ATP World Tour 500,HARD,2,Marcel Granollers,Alexandr Dolgopolov,Marcel Granollers,6-3; 6-4,R32,70,1,3,36,54,30,36,11,18,0,0,10,41,54,5,6,28,61,21,28,16,33,3,5,9,37,61
2011-10-31 00:00:00.000,Valencia Spain ATP World Tour 500,HARD,2,Marin Cilic,Milos Raonic,Marin Cilic,6-4; 6-4,R32,92,6,2,29,67,23,29,24,38,2,2,10,47,67,8,4,39,63,32,39,9,24,5,7,10,41,63
2011-10-31 00:00:00.000,Valencia Spain ATP World Tour 500,HARD,2,Pablo Andujar,Juan Ignacio Chela,Pablo Andujar,6-0; 7-6(7),R32,85,2,2,34,55,27,34,14,21,0,1,9,41,55,3,3,36,64,25,36,11,28,1,5,9,36,64
2011-10-31 00:00:00.000,Valencia Spain ATP World Tour 500,HARD,2,Gael Monfils,Albert Montanes,Gael Monfils,6-3; 6-1,R32,61,13,2,33,42,28,33,5,9,1,1,8,33,42,1,4,37,62,23,37,8,25,4,8,8,31,62
2011-10-31 00:00:00.000,Valencia Spain ATP World Tour 500,HARD,2,Juan Martin Del Potro,Dmitry Tursunov,Juan Martin Del Potro,6-4; 6-1,R32,76,10,0,30,48,21,30,14,18,1,1,8,35,48,3,3,23,54,15,23,13,31,4,8,9,28,54
2011-10-31 00:00:00.000,Valencia Spain ATP World Tour 500,HARD,2,Kevin Anderson,Martin Klizan,Kevin Anderson,6-1; 6-4,R32,63,9,2,37,50,26,37,9,13,3,4,9,35,50,1,5,29,46,16,29,6,17,0,4,8,22,46
2011-10-31 00:00:00.000,Valencia Spain ATP World Tour 500,HARD,2,Sam Querrey,Ernests Gulbis,Sam Querrey,6-3; 6-4,R32,72,10,2,34,56,31,34,10,22,0,0,10,41,56,4,3,40,63,27,40,13,23,6,8,9,40,63
2011-10-31 00:00:00.000,Valencia Spain ATP World Tour 500,HARD,2,Jo-Wilfried Tsonga,Javier Marti,Jo-Wilfried Tsonga,4-6; 7-5; 6-2,R32,137,10,3,57,94,46,57,18,37,4,6,15,64,94,5,6,45,88,30,45,25,43,3,7,15,55,88
2011-10-31 00:00:00.000,Valencia Spain ATP World Tour 500,HARD,2,David Ferrer,Vasek Pospisil,David Ferrer,6-3; 6-3,R16,91,2,1,45,64,28,45,13,19,5,6,9,41,64,2,2,34,60,19,34,11,26,2,6,9,30,60
2011-10-31 00:00:00.000,Valencia Spain ATP World Tour 500,HARD,2,Nikolay Davydenko,Nicolas Mahut,Nikolay Davydenko,W/O,R16,0,0,0,0,0,0,0,0,0,0,0,0,0,0,0,0,0,0,0,0,0,0,0,0,0,0,0
2011-10-31 00:00:00.000,Valencia Spain ATP World Tour 500,HARD,2,Juan Monaco,Fabio Fognini,Juan Monaco,6-3; 6-1,R16,67,1,1,24,45,19,24,11,21,2,3,8,30,45,1,5,37,58,15,37,13,21,3,8,8,28,58
2011-10-31 00:00:00.000,Valencia Spain ATP World Tour 500,HARD,2,Juan Carlos Ferrero,Alex Bogomolov Jr.,Juan Carlos Ferrero,7-6(3); 4-6; 6-2,R16,171,5,4,67,105,39,67,22,38,8,14,15,61,105,2,3,74,108,43,74,13,34,10,17,15,56,108
2011-10-31 00:00:00.000,Valencia Spain ATP World Tour 500,HARD,2,Marcel Granollers,Marin Cilic,Marcel Granollers,3-6; 6-3; 7-5,R16,134,10,0,63,96,43,63,21,33,4,6,15,64,96,10,2,48,84,39,48,19,36,2,5,15,58,84
2011-10-31 00:00:00.000,Valencia Spain ATP World Tour 500,HARD,2,Gael Monfils,Pablo Andujar,Gael Monfils,6-2; 7-6(5),R16,101,10,1,47,73,36,47,12,26,3,4,10,48,73,1,4,55,87,33,55,16,32,9,12,10,49,87
2011-10-31 00:00:00.000,Valencia Spain ATP World Tour 500,HARD,2,Juan Martin Del Potro,Kevin Anderson,Juan Martin Del Potro,6-4; 6-4,R16,91,4,2,29,51,23,29,14,22,0,1,10,37,51,4,2,32,58,20,32,16,26,3,6,10,36,58
2011-10-31 00:00:00.000,Valencia Spain ATP World Tour 500,HARD,2,Sam Querrey,Jo-Wilfried Tsonga,Sam Querrey,7-6(5); 6-2,R16,77,7,3,31,67,24,31,25,36,2,2,10,49,67,7,3,35,62,27,35,14,27,2,4,10,41,62
2011-10-31 00:00:00.000,Valencia Spain ATP World Tour 500,HARD,2,David Ferrer,Nikolay Davydenko,David Ferrer,6-3; 6-4,Q,82,4,1,36,55,29,36,11,19,2,3,10,40,55,1,5,37,62,23,37,12,25,2,5,9,35,62
2011-10-31 00:00:00.000,Valencia Spain ATP World Tour 500,HARD,2,Juan Monaco,Juan Carlos Ferrero,Juan Monaco,6-3; 6-3,Q,96,3,3,44,62,32,44,10,18,2,2,9,42,62,1,0,33,53,22,33,10,20,2,5,9,32,53
2011-10-31 00:00:00.000,Valencia Spain ATP World Tour 500,HARD,2,Marcel Granollers,Gael Monfils,Marcel Granollers,7-6(12); 3-6; 6-4,Q,146,4,1,55,91,39,55,21,36,2,6,15,60,91,10,8,64,107,49,64,20,43,3,7,16,69,107
2011-10-31 00:00:00.000,Valencia Spain ATP World Tour 500,HARD,2,Juan Martin Del Potro,Sam Querrey,Juan Martin Del Potro,6-2; 7-5,Q,78,7,2,31,48,27,31,13,17,0,0,10,40,48,4,1,43,66,26,43,12,23,4,7,10,38,66
2011-10-31 00:00:00.000,Valencia Spain ATP World Tour 500,HARD,2,Juan Monaco,David Ferrer,Juan Monaco,7-5; 1-6; 6-3,S,136,1,1,71,101,46,71,11,30,7,12,14,57,101,2,6,32,73,24,32,21,41,2,7,14,45,73
2011-10-31 00:00:00.000,Valencia Spain ATP World Tour 500,HARD,2,Marcel Granollers,Juan Martin Del Potro,Marcel Granollers,6-4; 7-6(4),S,113,4,0,36,66,29,36,20,30,2,3,11,49,66,3,2,42,73,28,42,19,31,4,6,11,47,73
2011-10-31 00:00:00.000,Valencia Spain ATP World Tour 500,HARD,2,Marcel Granollers,Juan Monaco,Marcel Granollers,6-2; 4-6; 7-6(3),F,180,7,1,60,97,43,60,20,37,6,9,15,63,97,1,1,74,98,48,74,9,24,6,10,15,57,98
2011-11-07 00:00:00.000,ATP World Tour Masters 1000 Paris France ATP World Tour Masters 1000,HARD,2,Novak Djokovic,N/A Bye,Novak Djokovic,,R64,0,0,0,0,0,0,0,0,0,0,0,0,0,0,0,0,0,0,0,0,0,0,0,0,0,0,0
2011-11-07 00:00:00.000,ATP World Tour Masters 1000 Paris France ATP World Tour Masters 1000,HARD,2,Ivan Dodig,Fabio Fognini,Ivan Dodig,4-6; 6-1; 6-3,R64,121,9,5,41,87,31,41,22,46,5,8,13,53,87,3,5,47,87,30,47,18,40,7,13,13,48,87
2011-11-07 00:00:00.000,ATP World Tour Masters 1000 Paris France ATP World Tour Masters 1000,HARD,2,Sergiy Stakhovsky,Kei Nishikori,Sergiy Stakhovsky,6-4; 6-3,R64,92,5,2,49,75,36,49,10,26,12,14,10,46,75,4,1,38,67,22,38,12,29,5,9,9,34,67
2011-11-07 00:00:00.000,ATP World Tour Masters 1000 Paris France ATP World Tour Masters 1000,HARD,2,Viktor Troicki,N/A Bye,Viktor Troicki,,R64,0,0,0,0,0,0,0,0,0,0,0,0,0,0,0,0,0,0,0,0,0,0,0,0,0,0,0
2011-11-07 00:00:00.000,ATP World Tour Masters 1000 Paris France ATP World Tour Masters 1000,HARD,2,Nicolas Almagro,N/A Bye,Nicolas Almagro,,R64,0,0,0,0,0,0,0,0,0,0,0,0,0,0,0,0,0,0,0,0,0,0,0,0,0,0,0
2011-11-07 00:00:00.000,ATP World Tour Masters 1000 Paris France ATP World Tour Masters 1000,HARD,2,Andreas Seppi,Nikolay Davydenko,Andreas Seppi,7-6(2); 7-5,R64,107,4,2,45,82,35,45,20,37,5,7,12,55,82,5,6,48,79,33,48,15,31,3,6,12,48,79
2011-11-07 00:00:00.000,ATP World Tour Masters 1000 Paris France ATP World Tour Masters 1000,HARD,2,Guillermo Garcia-Lopez,Santiago Giraldo,Guillermo Garcia-Lopez,6-4; 1-6; 6-4,R64,134,4,7,39,77,25,39,20,38,3,7,13,45,77,4,3,78,114,49,78,16,36,8,12,14,65,114
2011-11-07 00:00:00.000,ATP World Tour Masters 1000 Paris France ATP World Tour Masters 1000,HARD,2,Jo-Wilfried Tsonga,N/A Bye,Jo-Wilfried Tsonga,,R64,0,0,0,0,0,0,0,0,0,0,0,0,0,0,0,0,0,0,0,0,0,0,0,0,0,0,0
2011-11-07 00:00:00.000,ATP World Tour Masters 1000 Paris France ATP World Tour Masters 1000,HARD,2,David Ferrer,N/A Bye,David Ferrer,,R64,0,0,0,0,0,0,0,0,0,0,0,0,0,0,0,0,0,0,0,0,0,0,0,0,0,0,0
2011-11-07 00:00:00.000,ATP World Tour Masters 1000 Paris France ATP World Tour Masters 1000,HARD,2,Nicolas Mahut,Juan Carlos Ferrero,Nicolas Mahut,6-2; 6-3,R64,73,11,4,32,62,24,32,14,30,4,6,9,38,62,2,1,30,50,17,30,8,20,4,9,8,25,50
2011-11-07 00:00:00.000,ATP World Tour Masters 1000 Paris France ATP World Tour Masters 1000,HARD,2,Philipp Kohlschreiber,Mikhail Youzhny,Philipp Kohlschreiber,6-4; 6-2,R64,76,8,5,24,53,19,24,16,29,5,7,9,35,53,2,6,35,72,23,35,13,37,7,12,9,36,72
2011-11-07 00:00:00.000,ATP World Tour Masters 1000 Paris France ATP World Tour Masters 1000,HARD,2,Alexandr Dolgopolov,N/A Bye,Alexandr Dolgopolov,,R64,0,0,0,0,0,0,0,0,0,0,0,0,0,0,0,0,0,0,0,0,0,0,0,0,0,0,0
2011-11-07 00:00:00.000,ATP World Tour Masters 1000 Paris France ATP World Tour Masters 1000,HARD,2,Igor Kunitsyn,N/A Bye,Igor Kunitsyn,,R64,0,0,0,0,0,0,0,0,0,0,0,0,0,0,0,0,0,0,0,0,0,0,0,0,0,0,0
2011-11-07 00:00:00.000,ATP World Tour Masters 1000 Paris France ATP World Tour Masters 1000,HARD,2,John Isner,Stanislas Wawrinka,John Isner,6-7(3); 7-5; 7-6(5),R64,176,20,4,80,111,62,80,18,31,3,4,18,80,111,12,3,84,133,58,84,29,49,8,10,18,87,133
2011-11-07 00:00:00.000,ATP World Tour Masters 1000 Paris France ATP World Tour Masters 1000,HARD,2,Feliciano Lopez,Michael Llodra,Feliciano Lopez,7-6(7); 6-3,R64,98,7,4,44,77,29,44,20,33,3,5,11,49,77,5,3,39,76,27,39,18,37,9,12,10,45,76
2011-11-07 00:00:00.000,ATP World Tour Masters 1000 Paris France ATP World Tour Masters 1000,HARD,2,Gael Monfils,N/A Bye,Gael Monfils,,R64,0,0,0,0,0,0,0,0,0,0,0,0,0,0,0,0,0,0,0,0,0,0,0,0,0,0,0
2011-11-07 00:00:00.000,ATP World Tour Masters 1000 Paris France ATP World Tour Masters 1000,HARD,2,Mardy Fish,N/A Bye,Mardy Fish,,R64,0,0,0,0,0,0,0,0,0,0,0,0,0,0,0,0,0,0,0,0,0,0,0,0,0,0,0
2011-11-07 00:00:00.000,ATP World Tour Masters 1000 Paris France ATP World Tour Masters 1000,HARD,2,Florian Mayer,Radek Stepanek,Florian Mayer,7-5; 6-3,R64,81,1,2,34,61,26,34,13,27,1,3,10,39,61,3,4,41,70,27,41,10,29,4,9,11,37,70
2011-11-07 00:00:00.000,ATP World Tour Masters 1000 Paris France ATP World Tour Masters 1000,HARD,2,Juan Monaco,Donald Young,Juan Monaco,6-4; 6-2,R64,79,2,0,40,58,29,40,12,18,4,4,9,41,58,3,3,36,61,23,36,11,25,4,7,9,34,61
2011-11-07 00:00:00.000,ATP World Tour Masters 1000 Paris France ATP World Tour Masters 1000,HARD,2,Gilles Simon,N/A Bye,Gilles Simon,,R64,0,0,0,0,0,0,0,0,0,0,0,0,0,0,0,0,0,0,0,0,0,0,0,0,0,0,0
2011-11-07 00:00:00.000,ATP World Tour Masters 1000 Paris France ATP World Tour Masters 1000,HARD,2,Richard Gasquet,N/A Bye,Richard Gasquet,,R64,0,0,0,0,0,0,0,0,0,0,0,0,0,0,0,0,0,0,0,0,0,0,0,0,0,0,0
2011-11-07 00:00:00.000,ATP World Tour Masters 1000 Paris France ATP World Tour Masters 1000,HARD,2,Kevin Anderson,Gilles Muller,Kevin Anderson,6-3; 4-6; 6-4,R64,111,13,0,47,71,40,47,17,24,1,2,15,57,71,8,3,47,86,38,47,20,39,4,6,14,58,86
2011-11-07 00:00:00.000,ATP World Tour Masters 1000 Paris France ATP World Tour Masters 1000,HARD,2,Adrian Mannarino,Dmitry Tursunov,Adrian Mannarino,6-2; 6-2,R64,67,7,2,31,48,28,31,7,17,2,2,8,35,48,4,5,32,51,16,32,9,19,1,5,8,25,51
2011-11-07 00:00:00.000,ATP World Tour Masters 1000 Paris France ATP World Tour Masters 1000,HARD,2,Roger Federer,N/A Bye,Roger Federer,,R64,0,0,0,0,0,0,0,0,0,0,0,0,0,0,0,0,0,0,0,0,0,0,0,0,0,0,0
2011-11-07 00:00:00.000,ATP World Tour Masters 1000 Paris France ATP World Tour Masters 1000,HARD,2,Tomas Berdych,N/A Bye,Tomas Berdych,,R64,0,0,0,0,0,0,0,0,0,0,0,0,0,0,0,0,0,0,0,0,0,0,0,0,0,0,0
2011-11-07 00:00:00.000,ATP World Tour Masters 1000 Paris France ATP World Tour Masters 1000,HARD,2,Fernando Verdasco,Marin Cilic,Fernando Verdasco,3-6; 6-2; 6-3,R64,113,6,6,53,82,38,53,18,29,2,3,13,56,82,5,5,36,76,29,36,18,40,2,5,13,47,76
2011-11-07 00:00:00.000,ATP World Tour Masters 1000 Paris France ATP World Tour Masters 1000,HARD,2,Alex Bogomolov Jr.,Thomaz Bellucci,Alex Bogomolov Jr.,4-6; 7-6(4); 6-2,R64,133,4,6,44,88,37,44,23,44,2,4,15,60,88,7,7,48,103,36,48,28,55,7,10,15,64,103
2011-11-07 00:00:00.000,ATP World Tour Masters 1000 Paris France ATP World Tour Masters 1000,HARD,2,Janko Tipsarevic,N/A Bye,Janko Tipsarevic,,R64,0,0,0,0,0,0,0,0,0,0,0,0,0,0,0,0,0,0,0,0,0,0,0,0,0,0,0
2011-11-07 00:00:00.000,ATP World Tour Masters 1000 Paris France ATP World Tour Masters 1000,HARD,2,Andy Roddick,N/A Bye,Andy Roddick,,R64,0,0,0,0,0,0,0,0,0,0,0,0,0,0,0,0,0,0,0,0,0,0,0,0,0,0,0
2011-11-07 00:00:00.000,ATP World Tour Masters 1000 Paris France ATP World Tour Masters 1000,HARD,2,Julien Benneteau,Milos Raonic,Julien Benneteau,6-7(5); 7-6(5); 6-4,R64,146,11,1,76,113,61,76,20,37,1,1,17,81,113,22,3,70,103,61,70,17,33,2,3,17,78,103
2011-11-07 00:00:00.000,ATP World Tour Masters 1000 Paris France ATP World Tour Masters 1000,HARD,2,Jeremy Chardy,Marcel Granollers,Jeremy Chardy,6-3 RET,R64,28,7,1,15,24,15,15,5,9,0,0,5,20,24,1,3,13,22,9,13,5,9,0,1,4,14,22
2011-11-07 00:00:00.000,ATP World Tour Masters 1000 Paris France ATP World Tour Masters 1000,HARD,2,Andy Murray,N/A Bye,Andy Murray,,R64,0,0,0,0,0,0,0,0,0,0,0,0,0,0,0,0,0,0,0,0,0,0,0,0,0,0,0
2011-11-07 00:00:00.000,ATP World Tour Masters 1000 Paris France ATP World Tour Masters 1000,HARD,2,Novak Djokovic,Ivan Dodig,Novak Djokovic,6-4; 6-3,R32,91,3,2,29,53,26,29,15,24,0,0,10,41,53,6,4,30,61,22,30,14,31,3,5,9,36,61
2011-11-07 00:00:00.000,ATP World Tour Masters 1000 Paris France ATP World Tour Masters 1000,HARD,2,Viktor Troicki,Sergiy Stakhovsky,Viktor Troicki,6-4; 6-4,R32,87,5,2,31,61,23,31,15,30,2,4,10,38,61,1,4,33,65,20,33,16,32,5,9,10,36,65
2011-11-07 00:00:00.000,ATP World Tour Masters 1000 Paris France ATP World Tour Masters 1000,HARD,2,Andreas Seppi,Nicolas Almagro,Andreas Seppi,6-3; 7-5,R32,82,7,1,42,67,30,42,14,25,1,3,11,44,67,7,1,36,65,25,36,11,29,4,8,10,36,65
2011-11-07 00:00:00.000,ATP World Tour Masters 1000 Paris France ATP World Tour Masters 1000,HARD,2,Jo-Wilfried Tsonga,Guillermo Garcia-Lopez,Jo-Wilfried Tsonga,6-3; 6-4,R32,100,9,0,42,76,30,42,18,34,5,6,10,48,76,0,3,30,50,22,30,7,20,1,4,9,29,50
2011-11-07 00:00:00.000,ATP World Tour Masters 1000 Paris France ATP World Tour Masters 1000,HARD,2,David Ferrer,Nicolas Mahut,David Ferrer,6-4; 6-4,R32,87,2,3,27,59,19,27,22,32,2,2,10,41,59,1,3,30,62,25,30,14,32,3,5,10,39,62
2011-11-07 00:00:00.000,ATP World Tour Masters 1000 Paris France ATP World Tour Masters 1000,HARD,2,Alexandr Dolgopolov,Philipp Kohlschreiber,Alexandr Dolgopolov,6-3; 7-6(6),R32,86,11,2,34,73,27,34,24,39,2,3,11,51,73,6,4,43,78,31,43,15,35,8,10,10,46,78
2011-11-07 00:00:00.000,ATP World Tour Masters 1000 Paris France ATP World Tour Masters 1000,HARD,2,John Isner,Igor Kunitsyn,John Isner,6-4; 6-4,R32,70,7,0,40,58,30,40,10,18,2,3,10,40,58,2,0,25,51,18,25,14,26,2,5,10,32,51
2011-11-07 00:00:00.000,ATP World Tour Masters 1000 Paris France ATP World Tour Masters 1000,HARD,2,Feliciano Lopez,Gael Monfils,Feliciano Lopez,6-3; 6-4,R32,81,5,4,29,63,23,29,22,34,5,5,10,45,63,12,3,31,55,21,31,14,24,1,3,9,35,55
2011-11-07 00:00:00.000,ATP World Tour Masters 1000 Paris France ATP World Tour Masters 1000,HARD,2,Mardy Fish,Florian Mayer,Mardy Fish,6-1; 6-2,R32,56,7,0,25,41,23,25,10,16,0,0,8,33,41,1,3,25,46,14,25,7,21,4,8,7,21,46
2011-11-07 00:00:00.000,ATP World Tour Masters 1000 Paris France ATP World Tour Masters 1000,HARD,2,Juan Monaco,Gilles Simon,Juan Monaco,6-4; 6-0,R32,73,0,1,27,41,25,27,7,14,0,0,8,32,41,2,1,25,52,15,25,11,27,5,9,8,26,52
2011-11-07 00:00:00.000,ATP World Tour Masters 1000 Paris France ATP World Tour Masters 1000,HARD,2,Richard Gasquet,Kevin Anderson,Richard Gasquet,6-4; 7-6(4),R32,112,3,6,38,78,31,38,23,40,2,3,11,54,78,13,1,44,70,31,44,16,26,1,3,11,47,70
2011-11-07 00:00:00.000,ATP World Tour Masters 1000 Paris France ATP World Tour Masters 1000,HARD,2,Roger Federer,Adrian Mannarino,Roger Federer,6-2; 6-3,R32,56,4,0,26,40,23,26,13,14,0,0,9,36,40,1,3,22,43,15,22,10,21,2,5,8,25,43
2011-11-07 00:00:00.000,ATP World Tour Masters 1000 Paris France ATP World Tour Masters 1000,HARD,2,Tomas Berdych,Fernando Verdasco,Tomas Berdych,6-3; 7-5,R32,105,3,1,37,72,28,37,16,35,3,6,11,44,72,2,4,38,63,24,38,9,25,5,10,10,33,63
2011-11-07 00:00:00.000,ATP World Tour Masters 1000 Paris France ATP World Tour Masters 1000,HARD,2,Janko Tipsarevic,Alex Bogomolov Jr.,Janko Tipsarevic,6-1; 6-0,R32,51,8,1,22,39,19,22,9,17,2,2,6,28,39,2,5,20,44,9,20,6,24,3,9,7,15,44
2011-11-07 00:00:00.000,ATP World Tour Masters 1000 Paris France ATP World Tour Masters 1000,HARD,2,Andy Roddick,Julien Benneteau,Andy Roddick,6-4; 6-4,R32,83,9,1,39,60,25,39,13,21,1,3,10,38,60,7,3,36,63,26,36,8,27,4,8,10,34,63
2011-11-07 00:00:00.000,ATP World Tour Masters 1000 Paris France ATP World Tour Masters 1000,HARD,2,Andy Murray,Jeremy Chardy,Andy Murray,6-2; 6-4,R32,79,3,0,28,50,21,28,17,22,0,0,9,38,50,2,2,38,64,26,38,9,26,3,6,9,35,64
2011-11-07 00:00:00.000,ATP World Tour Masters 1000 Paris France ATP World Tour Masters 1000,HARD,2,Novak Djokovic,Viktor Troicki,Novak Djokovic,4-6; 6-3; 6-1,R16,116,3,4,62,95,41,62,15,33,11,14,13,56,95,7,3,41,78,28,41,12,37,5,11,13,40,78
2011-11-07 00:00:00.000,ATP World Tour Masters 1000 Paris France ATP World Tour Masters 1000,HARD,2,Jo-Wilfried Tsonga,Andreas Seppi,Jo-Wilfried Tsonga,6-3; 6-4,R16,76,13,1,39,63,34,39,10,24,2,2,10,44,63,2,2,31,47,20,31,11,16,1,3,9,31,47
2011-11-07 00:00:00.000,ATP World Tour Masters 1000 Paris France ATP World Tour Masters 1000,HARD,2,David Ferrer,Alexandr Dolgopolov,David Ferrer,6-3; 6-2,R16,74,2,2,32,46,24,32,7,14,2,3,8,31,46,1,4,30,70,19,30,13,40,8,13,9,32,70
2011-11-07 00:00:00.000,ATP World Tour Masters 1000 Paris France ATP World Tour Masters 1000,HARD,2,John Isner,Feliciano Lopez,John Isner,6-4; 6-2,R16,72,11,1,42,60,33,42,9,18,1,1,9,42,60,3,5,23,53,19,23,12,30,1,4,9,31,53
2011-11-07 00:00:00.000,ATP World Tour Masters 1000 Paris France ATP World Tour Masters 1000,HARD,2,Juan Monaco,Mardy Fish,Juan Monaco,1-6; 7-6(6); 1-2 RET,R16,102,0,1,39,60,28,39,12,21,1,4,10,40,60,5,0,39,69,29,39,21,30,1,2,12,50,69
2011-11-07 00:00:00.000,ATP World Tour Masters 1000 Paris France ATP World Tour Masters 1000,HARD,2,Roger Federer,Richard Gasquet,Roger Federer,6-2; 6-4,R16,66,3,1,33,44,27,33,8,11,2,3,9,35,44,2,3,33,55,22,33,7,22,2,6,9,29,55
2011-11-07 00:00:00.000,ATP World Tour Masters 1000 Paris France ATP World Tour Masters 1000,HARD,2,Tomas Berdych,Janko Tipsarevic,Tomas Berdych,7-5; 6-4,R16,102,8,4,48,75,35,48,10,27,4,7,11,45,75,4,4,32,68,21,32,16,36,4,9,11,37,68
2011-11-07 00:00:00.000,ATP World Tour Masters 1000 Paris France ATP World Tour Masters 1000,HARD,2,Andy Murray,Andy Roddick,Andy Murray,6-2; 6-2,R16,62,7,2,24,42,20,24,12,18,0,0,8,32,42,1,0,25,41,14,25,6,16,2,6,8,20,41
2011-11-07 00:00:00.000,ATP World Tour Masters 1000 Paris France ATP World Tour Masters 1000,HARD,2,Jo-Wilfried Tsonga,Novak Djokovic,Jo-Wilfried Tsonga,W/O,Q,0,0,0,0,0,0,0,0,0,0,0,0,0,0,0,0,0,0,0,0,0,0,0,0,0,0,0
2011-11-07 00:00:00.000,ATP World Tour Masters 1000 Paris France ATP World Tour Masters 1000,HARD,2,John Isner,David Ferrer,John Isner,6-3; 3-6; 6-3,Q,107,12,4,62,87,45,62,14,25,4,5,14,59,87,3,3,43,70,31,43,17,27,1,3,13,48,70
2011-11-07 00:00:00.000,ATP World Tour Masters 1000 Paris France ATP World Tour Masters 1000,HARD,2,Roger Federer,Juan Monaco,Roger Federer,6-3; 7-5,Q,85,7,0,43,70,35,43,12,27,1,2,11,47,70,4,2,38,61,26,38,11,23,3,6,10,37,61
2011-11-07 00:00:00.000,ATP World Tour Masters 1000 Paris France ATP World Tour Masters 1000,HARD,2,Tomas Berdych,Andy Murray,Tomas Berdych,4-6; 7-6(5); 6-4,Q,193,6,2,67,118,51,67,25,51,15,17,16,76,118,6,4,62,123,48,62,29,61,12,14,16,77,123
2011-11-07 00:00:00.000,ATP World Tour Masters 1000 Paris France ATP World Tour Masters 1000,HARD,2,Jo-Wilfried Tsonga,John Isner,Jo-Wilfried Tsonga,3-6; 7-6(1); 7-6(3),S,178,12,5,68,120,57,68,29,52,8,9,16,86,120,10,3,80,117,61,80,19,37,7,7,17,80,117
2011-11-07 00:00:00.000,ATP World Tour Masters 1000 Paris France ATP World Tour Masters 1000,HARD,2,Roger Federer,Tomas Berdych,Roger Federer,6-4; 6-3,S,80,5,3,32,46,29,32,7,14,0,0,9,36,46,10,6,37,67,28,37,10,30,3,6,10,38,67
2011-11-07 00:00:00.000,ATP World Tour Masters 1000 Paris France ATP World Tour Masters 1000,HARD,2,Roger Federer,Jo-Wilfried Tsonga,Roger Federer,6-1; 7-6(3),F,86,4,1,43,70,38,43,14,27,4,4,10,52,70,7,2,37,61,28,37,12,24,3,5,9,40,61