event_time,event_name,surface,num_of_sets,playerA,playerB,winner,score,round,duration_minutes,a_aces,a_double_faults,a_first_serve_hits,a_first_serve_total,a_first_serve_won,a_first_serve_played,a_second_serve_won,a_second_serve_played,a_break_points_saved,a_break_points_total,a_service_games,a_service_points_won,a_service_points_total,b_aces,b_double_faults,b_first_serve_hits,b_first_serve_total,b_first_serve_won,b_first_serve_played,b_second_serve_won,b_second_serve_played,b_break_points_saved,b_break_points_total,b_service_games,b_service_points_won,b_service_points_total
2004-01-05 00:00:00.000,Adelaide Australia ATP World Tour,HARD,2,Todd Reid,Wayne Ferreira,Todd Reid,6-0; 6-1,R32,35,1,0,21,31,20,21,8,10,0,0,7,28,31,1,3,14,33,5,14,6,19,0,5,6,11,33
2004-01-05 00:00:00.000,Adelaide Australia ATP World Tour,HARD,2,Raemon Sluiter,Guillermo Canas,Raemon Sluiter,6-4; 6-4,R32,88,4,3,47,79,34,47,19,32,7,7,10,53,79,3,0,47,59,33,47,6,12,1,3,10,39,59
2004-01-05 00:00:00.000,Adelaide Australia ATP World Tour,HARD,2,Davide Sanguinetti,Daniel Elsner,Davide Sanguinetti,6-1; 6-1,R32,42,4,1,27,41,19,27,8,14,4,5,7,27,41,1,5,18,38,6,18,5,20,4,10,7,11,38
2004-01-05 00:00:00.000,Adelaide Australia ATP World Tour,HARD,2,Jarkko Nieminen,Wesley Moodie,Jarkko Nieminen,4-6; 7-6(6); 7-5,R32,131,1,2,59,100,42,59,28,41,5,7,17,70,100,15,3,78,107,56,78,15,29,6,8,17,71,107
2004-01-05 00:00:00.000,Adelaide Australia ATP World Tour,HARD,2,Cyril Saulnier,Robby Ginepri,Cyril Saulnier,6-3; 6-4,R32,66,1,1,34,59,26,34,16,25,2,2,10,42,59,3,2,39,57,27,39,8,18,2,4,9,35,57
2004-01-05 00:00:00.000,Adelaide Australia ATP World Tour,HARD,2,Greg Rusedski,Stanislas Wawrinka,Greg Rusedski,6-4; 6-2,R32,61,10,3,36,55,30,36,11,19,2,2,9,41,55,4,3,32,56,22,32,10,24,2,5,9,32,56
2004-01-05 00:00:00.000,Adelaide Australia ATP World Tour,HARD,2,Dominik Hrbaty,Julien Benneteau,Dominik Hrbaty,6-1; 6-4,R32,55,7,0,31,49,23,31,15,18,2,2,9,38,49,3,4,32,52,25,32,5,20,3,6,8,30,52
2004-01-05 00:00:00.000,Adelaide Australia ATP World Tour,HARD,2,Alberto Martin,Mario Ancic,Alberto Martin,6-3; 6-7(6); 7-6(3),R32,142,2,5,74,113,50,74,20,39,3,6,16,70,113,12,4,59,110,44,59,20,51,3,8,17,64,110
2004-01-05 00:00:00.000,Adelaide Australia ATP World Tour,HARD,2,Taylor Dent,Luis Horna,Taylor Dent,6-2; 6-3,R32,65,8,6,22,51,17,22,20,29,2,2,9,37,51,2,2,40,54,27,40,3,14,2,5,8,30,54
2004-01-05 00:00:00.000,Adelaide Australia ATP World Tour,HARD,2,Karol Beck,Brian Vahaly,Karol Beck,6-2; 6-2,R32,63,4,1,25,46,19,25,14,21,0,0,8,33,46,0,3,27,50,13,27,10,23,1,5,8,23,50
2004-01-05 00:00:00.000,Adelaide Australia ATP World Tour,HARD,2,Thomas Johansson,Christophe Rochus,Thomas Johansson,6-1; 6-3,R32,53,5,0,21,40,19,21,14,19,0,0,8,33,40,3,3,23,45,15,23,8,22,3,7,8,23,45
2004-01-05 00:00:00.000,Adelaide Australia ATP World Tour,HARD,2,Arnaud Clement,Victor Hanescu,Arnaud Clement,6-3; 6-2,R32,68,0,1,27,44,22,27,14,17,0,0,9,36,44,5,4,32,53,21,32,10,21,5,8,8,31,53
2004-01-05 00:00:00.000,Adelaide Australia ATP World Tour,HARD,2,Nicolas Lapentti,Irakli Labadze,Nicolas Lapentti,7-5; 6-1,R32,61,5,3,28,53,24,28,17,25,1,1,10,41,53,1,3,38,49,25,38,6,11,2,5,9,31,49
2004-01-05 00:00:00.000,Adelaide Australia ATP World Tour,HARD,2,Michael Llodra,Lars Burgsmuller,Michael Llodra,6-3; 6-2,R32,60,7,3,34,54,23,34,15,20,5,6,9,38,54,1,4,24,51,18,24,8,27,3,7,8,26,51
2004-01-05 00:00:00.000,Adelaide Australia ATP World Tour,HARD,2,Wayne Arthurs,Ivo Karlovic,Wayne Arthurs,6-7(5); 7-6(4); 7-5,R32,141,14,8,65,114,56,65,30,49,3,3,18,86,114,24,7,88,129,75,88,13,41,4,5,18,88,129
2004-01-05 00:00:00.000,Adelaide Australia ATP World Tour,HARD,2,Vincent Spadea,Jurgen Melzer,Vincent Spadea,7-6(4); 6-2,R32,84,3,1,47,68,33,47,12,21,4,6,10,45,68,5,5,36,72,24,36,15,36,5,9,10,39,72
2004-01-05 00:00:00.000,Adelaide Australia ATP World Tour,HARD,2,Todd Reid,Raemon Sluiter,Todd Reid,6-3; 6-2,R16,52,3,0,45,59,33,45,8,14,3,3,9,41,59,5,2,27,44,20,27,5,17,0,3,8,25,44
2004-01-05 00:00:00.000,Adelaide Australia ATP World Tour,HARD,2,Jarkko Nieminen,Davide Sanguinetti,Jarkko Nieminen,7-6(2); 6-4,R16,77,5,2,48,72,35,48,13,24,6,8,11,48,72,4,1,41,65,30,41,9,24,1,4,11,39,65
2004-01-05 00:00:00.000,Adelaide Australia ATP World Tour,HARD,2,Cyril Saulnier,Greg Rusedski,Cyril Saulnier,6-2; 6-2,R16,54,6,1,28,43,23,28,11,15,2,2,8,34,43,3,7,37,53,21,37,5,16,8,12,8,26,53
2004-01-05 00:00:00.000,Adelaide Australia ATP World Tour,HARD,2,Dominik Hrbaty,Alberto Martin,Dominik Hrbaty,6-2; 6-3,R16,57,5,1,32,45,24,32,8,13,0,1,9,32,45,1,2,28,49,15,28,10,21,1,5,8,25,49
2004-01-05 00:00:00.000,Adelaide Australia ATP World Tour,HARD,2,Taylor Dent,Karol Beck,Taylor Dent,7-6(6); 7-5,R16,98,5,6,41,78,30,41,22,37,1,2,12,52,78,3,5,44,78,30,44,21,34,2,4,12,51,78
2004-01-05 00:00:00.000,Adelaide Australia ATP World Tour,HARD,2,Thomas Johansson,Arnaud Clement,Thomas Johansson,6-4; 6-3,R16,105,5,3,41,78,27,41,17,37,7,9,9,44,78,3,6,41,70,23,41,11,29,6,11,10,34,70
2004-01-05 00:00:00.000,Adelaide Australia ATP World Tour,HARD,2,Michael Llodra,Nicolas Lapentti,Michael Llodra,6-1; 6-3,R16,53,3,0,29,40,26,29,7,11,1,1,8,33,40,3,0,34,56,23,34,7,22,3,7,8,30,56
2004-01-05 00:00:00.000,Adelaide Australia ATP World Tour,HARD,2,Vincent Spadea,Wayne Arthurs,Vincent Spadea,6-4; 6-7(8); 6-3,R16,136,2,4,56,88,46,56,22,32,1,2,16,68,88,12,6,68,116,48,68,26,48,7,10,15,74,116
2004-01-05 00:00:00.000,Adelaide Australia ATP World Tour,HARD,2,Jarkko Nieminen,Todd Reid,Jarkko Nieminen,6-2; 7-5,Q,81,3,1,35,52,28,35,10,17,0,1,10,38,52,2,1,61,84,32,61,12,23,8,12,10,44,84
2004-01-05 00:00:00.000,Adelaide Australia ATP World Tour,HARD,2,Dominik Hrbaty,Cyril Saulnier,Dominik Hrbaty,6-4; 7-6(1),Q,125,2,2,46,73,35,46,15,27,3,4,11,50,73,9,7,34,66,28,34,15,32,2,4,11,43,66
2004-01-05 00:00:00.000,Adelaide Australia ATP World Tour,HARD,2,Taylor Dent,Thomas Johansson,Taylor Dent,7-6(2); 6-2,Q,86,14,5,35,63,33,35,13,28,3,4,10,46,63,4,4,46,80,29,46,16,34,8,11,10,45,80
2004-01-05 00:00:00.000,Adelaide Australia ATP World Tour,HARD,2,Michael Llodra,Vincent Spadea,Michael Llodra,6-4; 6-2,Q,63,2,1,26,48,23,26,15,22,1,1,9,38,48,1,2,41,62,27,41,9,21,4,7,9,36,62
2004-01-05 00:00:00.000,Adelaide Australia ATP World Tour,HARD,2,Dominik Hrbaty,Jarkko Nieminen,Dominik Hrbaty,6-4; 6-2,S,58,2,1,46,58,35,46,3,12,4,5,9,38,58,1,1,32,54,21,32,7,22,2,6,9,28,54
2004-01-05 00:00:00.000,Adelaide Australia ATP World Tour,HARD,2,Michael Llodra,Taylor Dent,Michael Llodra,6-3; 7-5,S,67,5,1,41,58,33,41,8,17,2,4,11,41,58,6,5,29,63,20,29,14,34,3,7,10,34,63
2004-01-05 00:00:00.000,Adelaide Australia ATP World Tour,HARD,2,Dominik Hrbaty,Michael Llodra,Dominik Hrbaty,6-4; 6-0,F,57,3,2,35,52,24,35,11,17,8,9,8,35,52,2,2,38,59,19,38,8,21,9,14,8,27,59
2004-01-05 00:00:00.000,Chennai India ATP World Tour,HARD,2,Carlos Moya,Noam Okun,Carlos Moya,6-3; 6-4,R32,59,9,2,36,51,30,36,9,15,1,2,10,39,51,1,1,38,53,25,38,8,15,2,5,9,33,53
2004-01-05 00:00:00.000,Chennai India ATP World Tour,HARD,2,Paul Goldstein,Olivier Mutis,Paul Goldstein,6-3; 6-3,R32,84,5,3,36,69,23,36,19,33,5,7,9,42,69,4,1,36,73,26,36,10,37,7,12,9,36,73
2004-01-05 00:00:00.000,Chennai India ATP World Tour,HARD,2,Prakash Amritraj,Harsh Mankad,Prakash Amritraj,6-3; 6-4,R32,79,4,2,41,62,35,41,11,21,4,4,10,46,62,2,3,38,60,26,38,11,22,5,7,9,37,60
2004-01-05 00:00:00.000,Chennai India ATP World Tour,HARD,2,Thierry Ascione,Rafael Nadal,Thierry Ascione,7-6(5); 6-4,R32,97,4,2,51,83,38,51,17,32,5,6,11,55,83,2,1,49,67,34,49,12,18,3,5,11,46,67
2004-01-05 00:00:00.000,Chennai India ATP World Tour,HARD,2,Sjeng Schalken,Danai Udomchoke,Sjeng Schalken,6-4; 7-5,R32,92,1,1,52,66,36,52,7,14,5,7,11,43,66,3,4,48,78,30,48,12,30,3,7,11,42,78
2004-01-05 00:00:00.000,Chennai India ATP World Tour,HARD,2,Julian Knowle,Karan Rastogi,Julian Knowle,6-4; 6-1,R32,74,3,2,27,47,22,27,13,20,1,1,8,35,47,0,2,35,60,20,35,13,25,5,9,9,33,60
2004-01-05 00:00:00.000,Chennai India ATP World Tour,HARD,2,John van Lottum,Galo Blanco,John van Lottum,7-6(6); 6-3,R32,97,4,1,43,72,36,43,18,29,3,3,11,54,72,6,5,35,70,29,35,18,35,3,4,10,47,70
2004-01-05 00:00:00.000,Chennai India ATP World Tour,HARD,2,Felix Mantilla,Jan Vacek,Felix Mantilla,6-3; 7-6(5),R32,79,3,4,37,70,28,37,23,33,2,2,11,51,70,9,2,47,70,35,47,10,23,5,6,10,45,70
2004-01-05 00:00:00.000,Chennai India ATP World Tour,HARD,2,Antony Dupuis,Alexander Popp,Antony Dupuis,6-1; 4-6; 7-6(6),R32,119,12,2,54,88,41,54,20,34,2,3,14,61,88,3,6,57,98,40,57,23,41,9,12,15,63,98
2004-01-05 00:00:00.000,Chennai India ATP World Tour,HARD,2,Jean-Rene Lisnard,Kristian Pless,Jean-Rene Lisnard,7-6(10); 6-3,R32,99,2,2,42,77,35,42,16,35,6,8,10,51,77,6,3,42,74,30,42,14,32,3,7,11,44,74
2004-01-05 00:00:00.000,Chennai India ATP World Tour,HARD,2,Kenneth Carlsen,Paul-Henri Mathieu,Kenneth Carlsen,6-2; 1-0 RET,R32,34,3,1,13,19,12,13,4,6,0,0,4,16,19,1,3,14,27,11,14,1,13,2,5,5,12,27
2004-01-05 00:00:00.000,Chennai India ATP World Tour,HARD,2,Tommy Robredo,Dmitry Tursunov,Tommy Robredo,7-5; 6-7(2); 6-4,R32,129,13,3,51,98,41,51,25,47,0,2,17,66,98,7,3,62,117,47,62,26,55,6,10,17,73,117
2004-01-05 00:00:00.000,Chennai India ATP World Tour,HARD,2,David Ferrer,Fernando Verdasco,David Ferrer,1-6; 7-5; 6-0,R32,94,3,4,42,73,30,42,16,31,2,5,12,46,73,6,3,66,91,41,66,9,25,7,12,13,50,91
2004-01-05 00:00:00.000,Chennai India ATP World Tour,HARD,2,Igor Andreev,Ruben Ramirez Hidalgo,Igor Andreev,7-6(7); 6-2,R32,95,1,1,30,68,22,30,24,38,4,5,10,46,68,2,5,38,72,26,38,17,34,0,3,10,43,72
2004-01-05 00:00:00.000,Chennai India ATP World Tour,HARD,2,Harel Levy,Albert Portas,Harel Levy,6-4; 6-2,R32,63,4,3,35,49,32,35,7,14,1,1,9,39,49,4,2,42,73,23,42,16,31,6,9,9,39,73
2004-01-05 00:00:00.000,Chennai India ATP World Tour,HARD,2,Paradorn Srichaphan,Albert Montanes,Paradorn Srichaphan,6-1; 6-3,R32,46,2,1,20,41,17,20,16,21,0,0,8,33,41,2,3,27,43,15,27,7,16,5,9,8,22,43
2004-01-05 00:00:00.000,Chennai India ATP World Tour,HARD,2,Carlos Moya,Paul Goldstein,Carlos Moya,3-6; 7-6(7); 6-4,R16,139,18,2,45,91,37,45,24,46,1,3,15,61,91,8,5,81,133,61,81,22,52,14,16,16,83,133
2004-01-05 00:00:00.000,Chennai India ATP World Tour,HARD,2,Thierry Ascione,Prakash Amritraj,Thierry Ascione,3-6; 6-1; 6-2,R16,82,7,0,44,62,32,44,13,18,2,4,12,45,62,3,2,49,75,26,49,14,26,5,10,12,40,75
2004-01-05 00:00:00.000,Chennai India ATP World Tour,HARD,2,Sjeng Schalken,Julian Knowle,Sjeng Schalken,6-3; 6-3,R16,83,2,0,35,48,25,35,9,13,3,5,9,34,48,1,5,34,66,17,34,14,32,4,9,9,31,66
2004-01-05 00:00:00.000,Chennai India ATP World Tour,HARD,2,Felix Mantilla,John van Lottum,Felix Mantilla,6-7(3); 6-4; 6-4,R16,152,10,4,73,113,50,73,19,40,11,15,16,69,113,10,3,69,114,48,69,18,45,10,16,16,66,114
2004-01-05 00:00:00.000,Chennai India ATP World Tour,HARD,2,Jean-Rene Lisnard,Antony Dupuis,Jean-Rene Lisnard,7-5; 6-3,R16,90,4,1,41,82,32,41,20,41,7,8,11,52,82,3,3,26,60,16,26,20,34,1,4,10,36,60
2004-01-05 00:00:00.000,Chennai India ATP World Tour,HARD,2,Tommy Robredo,Kenneth Carlsen,Tommy Robredo,6-2; 6-2,R16,56,4,1,25,40,23,25,10,15,0,0,8,33,40,4,3,26,46,15,26,8,20,1,5,8,23,46
2004-01-05 00:00:00.000,Chennai India ATP World Tour,HARD,2,Igor Andreev,David Ferrer,Igor Andreev,6-2; 6-3,R16,66,4,0,33,58,25,33,9,25,4,6,8,34,58,0,4,35,58,16,35,11,23,2,8,9,27,58
2004-01-05 00:00:00.000,Chennai India ATP World Tour,HARD,2,Paradorn Srichaphan,Harel Levy,Paradorn Srichaphan,6-2; 6-2,R16,51,3,1,22,39,19,22,13,17,0,0,8,32,39,1,1,28,48,16,28,8,20,6,10,8,24,48
2004-01-05 00:00:00.000,Chennai India ATP World Tour,HARD,2,Carlos Moya,Thierry Ascione,Carlos Moya,6-4; 6-4,Q,69,7,1,23,45,22,23,18,22,0,0,10,40,45,2,1,51,79,32,51,16,28,5,7,10,48,79
2004-01-05 00:00:00.000,Chennai India ATP World Tour,HARD,2,Sjeng Schalken,Felix Mantilla,Sjeng Schalken,6-2; 5-7; 7-6(6),Q,152,4,0,76,95,57,76,13,19,1,3,16,70,95,2,4,49,104,32,49,33,55,2,5,16,65,104
2004-01-05 00:00:00.000,Chennai India ATP World Tour,HARD,2,Tommy Robredo,Jean-Rene Lisnard,Tommy Robredo,6-4; 7-6(2),Q,95,1,3,44,69,34,44,8,25,2,6,11,42,69,2,6,44,92,29,44,17,48,13,18,11,46,92
2004-01-05 00:00:00.000,Chennai India ATP World Tour,HARD,2,Paradorn Srichaphan,Igor Andreev,Paradorn Srichaphan,6-3; 7-6(2),Q,81,5,2,45,69,37,45,12,24,3,4,11,49,69,2,3,31,57,23,31,15,26,0,2,10,38,57
2004-01-05 00:00:00.000,Chennai India ATP World Tour,HARD,2,Carlos Moya,Sjeng Schalken,Carlos Moya,6-3; 6-4,S,60,14,1,32,45,31,32,9,13,0,0,10,40,45,0,0,42,56,25,42,11,14,2,4,9,36,56
2004-01-05 00:00:00.000,Chennai India ATP World Tour,HARD,2,Paradorn Srichaphan,Tommy Robredo,Paradorn Srichaphan,1-6; 7-6(10); 7-5,S,133,4,3,62,98,49,62,20,36,8,10,15,69,98,5,2,60,107,48,60,27,47,4,5,16,75,107
2004-01-05 00:00:00.000,Chennai India ATP World Tour,HARD,2,Carlos Moya,Paradorn Srichaphan,Carlos Moya,6-4; 3-6; 7-6(5),F,115,8,4,49,93,40,49,25,44,0,2,16,65,93,9,2,64,90,50,64,14,26,0,1,15,64,90
2004-01-05 00:00:00.000,Doha Qatar ATP World Tour,HARD,2,Andy Roddick,Nikolay Davydenko,Andy Roddick,6-3; 6-4,R32,67,9,1,37,56,30,37,12,19,1,1,10,42,56,4,0,31,49,22,31,8,18,0,2,9,30,49
2004-01-05 00:00:00.000,Doha Qatar ATP World Tour,HARD,2,Jonas Bjorkman,Radek Stepanek,Jonas Bjorkman,6-3; 3-0 RET,R32,59,5,3,27,37,22,27,5,10,0,0,6,27,37,7,2,30,46,16,30,6,16,2,5,6,22,46
2004-01-05 00:00:00.000,Doha Qatar ATP World Tour,HARD,2,Hicham Arazi,Thomas Enqvist,Hicham Arazi,7-6(1); 2-6; 6-3,R32,129,10,1,78,111,57,78,15,33,8,11,15,72,111,15,8,67,104,52,67,13,37,7,9,14,65,104
2004-01-05 00:00:00.000,Doha Qatar ATP World Tour,HARD,2,Agustin Calleri,Filippo Volandri,Agustin Calleri,6-4; 4-6; 6-4,R32,117,4,1,60,79,41,60,13,19,0,2,15,54,79,2,7,69,91,52,69,8,22,4,7,15,60,91
2004-01-05 00:00:00.000,Doha Qatar ATP World Tour,HARD,2,Stefan Koubek,Mark Philippoussis,Stefan Koubek,3-6; 6-1; 6-4,R32,91,4,2,48,76,35,48,17,28,2,4,13,52,76,9,3,54,74,36,54,8,20,3,7,13,44,74
2004-01-05 00:00:00.000,Doha Qatar ATP World Tour,HARD,2,Hyung-Taik Lee,Vladimir Voltchkov,Hyung-Taik Lee,1-2 RET,R32,16,0,1,8,16,4,8,4,8,2,3,2,8,16,0,0,5,5,4,5,0,0,0,0,1,4,5
2004-01-05 00:00:00.000,Doha Qatar ATP World Tour,HARD,2,Ivo Heuberger,Sultan Khalfan,Ivo Heuberger,6-2; 6-2,R32,61,6,0,33,44,22,33,7,11,2,4,8,29,44,2,2,36,57,16,36,8,21,7,13,8,24,57
2004-01-05 00:00:00.000,Doha Qatar ATP World Tour,HARD,2,Nicolas Escude,Younes El Aynaoui,Nicolas Escude,6-3; 6-0,R32,66,10,2,26,39,23,26,9,13,0,0,8,32,39,1,5,27,52,16,27,9,25,4,8,7,25,52
2004-01-05 00:00:00.000,Doha Qatar ATP World Tour,HARD,2,Ivan Ljubicic,Nicolas Massu,Ivan Ljubicic,6-3; 6-3,R32,70,10,2,29,45,26,29,10,16,2,3,9,36,45,2,2,29,51,18,29,11,22,4,8,9,29,51
2004-01-05 00:00:00.000,Doha Qatar ATP World Tour,HARD,2,Robin Soderling,Jan-Michael Gambill,Robin Soderling,6-7(7); 6-3; 6-3,R32,132,11,5,65,91,50,65,10,26,1,3,15,60,91,18,8,52,115,42,52,26,63,8,13,15,68,115
2004-01-05 00:00:00.000,Doha Qatar ATP World Tour,HARD,2,Bohdan Ulihrach,Nicolas Kiefer,Bohdan Ulihrach,6-2; 6-1,R32,66,5,1,25,41,21,25,11,16,4,4,7,32,41,3,4,26,51,19,26,4,25,2,7,8,23,51
2004-01-05 00:00:00.000,Doha Qatar ATP World Tour,HARD,2,Sebastien Grosjean,Markus Hantschk,Sebastien Grosjean,6-1; 7-5,R32,93,6,1,26,61,20,26,19,35,3,5,10,39,61,2,2,40,63,23,40,9,23,5,10,9,32,63
2004-01-05 00:00:00.000,Doha Qatar ATP World Tour,HARD,2,Tim Henman,David Sanchez,Tim Henman,6-4; 6-0,R32,75,3,1,31,47,23,31,9,16,1,2,8,32,47,0,0,38,66,18,38,10,28,10,15,8,28,66
2004-01-05 00:00:00.000,Doha Qatar ATP World Tour,HARD,2,Juan Ignacio Chela,Olivier Rochus,Juan Ignacio Chela,6-1; 3-6; 7-5,R32,139,5,1,57,96,34,57,21,39,2,6,14,55,96,0,4,54,88,31,54,16,34,6,12,14,47,88
2004-01-05 00:00:00.000,Doha Qatar ATP World Tour,HARD,2,Sargis Sargsian,Gregory Carraz,Sargis Sargsian,3-6; 6-0; 6-3,R32,105,3,1,59,73,42,59,9,14,5,6,12,51,73,6,8,61,87,38,61,10,26,4,8,12,48,87
2004-01-05 00:00:00.000,Doha Qatar ATP World Tour,HARD,2,Mikhail Youzhny,Rainer Schuettler,Mikhail Youzhny,6-3; 7-6(5),R32,110,6,0,40,67,30,40,14,27,3,4,10,44,67,0,0,57,85,32,57,15,28,9,12,11,47,85
2004-01-05 00:00:00.000,Doha Qatar ATP World Tour,HARD,2,Jonas Bjorkman,Andy Roddick,Jonas Bjorkman,6-3; 6-4,R16,70,8,3,28,55,24,28,17,27,1,1,10,41,55,6,2,33,59,23,33,13,26,3,5,9,36,59
2004-01-05 00:00:00.000,Doha Qatar ATP World Tour,HARD,2,Agustin Calleri,Hicham Arazi,Agustin Calleri,4-6; 6-4; 7-5,R16,127,12,1,54,94,44,54,20,40,6,8,16,64,94,3,4,58,86,41,58,17,28,3,6,16,58,86
2004-01-05 00:00:00.000,Doha Qatar ATP World Tour,HARD,2,Hyung-Taik Lee,Stefan Koubek,Hyung-Taik Lee,6-4; 6-4,R16,92,1,1,63,82,43,63,7,19,3,4,10,50,82,3,1,55,71,34,55,8,16,4,7,10,42,71
2004-01-05 00:00:00.000,Doha Qatar ATP World Tour,HARD,2,Nicolas Escude,Ivo Heuberger,Nicolas Escude,6-3; 6-2,R16,69,5,1,32,43,24,32,7,11,1,2,8,31,43,5,3,35,60,22,35,7,25,7,12,9,29,60
2004-01-05 00:00:00.000,Doha Qatar ATP World Tour,HARD,2,Ivan Ljubicic,Robin Soderling,Ivan Ljubicic,6-2; 6-4,R16,59,11,4,37,53,33,37,7,16,3,3,9,40,53,1,2,28,46,21,28,9,18,2,5,9,30,46
2004-01-05 00:00:00.000,Doha Qatar ATP World Tour,HARD,2,Sebastien Grosjean,Bohdan Ulihrach,Sebastien Grosjean,6-1; 6-4,R16,67,8,2,28,53,25,28,14,25,1,1,9,39,53,3,2,32,50,19,32,9,18,4,7,8,28,50
2004-01-05 00:00:00.000,Doha Qatar ATP World Tour,HARD,2,Tim Henman,Juan Ignacio Chela,Tim Henman,6-3; 6-4,R16,77,2,4,43,62,32,43,12,19,1,1,10,44,62,1,0,36,53,23,36,12,17,6,8,9,35,53
2004-01-05 00:00:00.000,Doha Qatar ATP World Tour,HARD,2,Sargis Sargsian,Mikhail Youzhny,Sargis Sargsian,3-6; 6-3; 6-2,R16,113,2,3,43,71,30,43,16,28,3,6,13,46,71,4,3,39,84,24,39,22,45,7,12,13,46,84
2004-01-05 00:00:00.000,Doha Qatar ATP World Tour,HARD,2,Agustin Calleri,Jonas Bjorkman,Agustin Calleri,6-4; 6-4,Q,99,6,0,42,62,31,42,11,20,1,2,10,42,62,6,1,48,74,33,48,9,26,5,8,10,42,74
2004-01-05 00:00:00.000,Doha Qatar ATP World Tour,HARD,2,Nicolas Escude,Hyung-Taik Lee,Nicolas Escude,6-4; 6-2,Q,70,4,3,33,50,24,33,11,17,0,1,9,35,50,1,1,29,48,20,29,7,19,0,4,9,27,48
2004-01-05 00:00:00.000,Doha Qatar ATP World Tour,HARD,2,Ivan Ljubicic,Sebastien Grosjean,Ivan Ljubicic,6-3; 5-7; 6-4,Q,123,10,1,63,94,49,63,17,31,3,5,16,66,94,2,4,49,86,36,49,20,37,2,5,15,56,86
2004-01-05 00:00:00.000,Doha Qatar ATP World Tour,HARD,2,Tim Henman,Sargis Sargsian,Tim Henman,6-3; 6-1,Q,67,2,1,22,41,16,22,16,19,0,0,8,32,41,0,1,42,59,23,42,6,17,5,9,8,29,59
2004-01-05 00:00:00.000,Doha Qatar ATP World Tour,HARD,2,Nicolas Escude,Agustin Calleri,Nicolas Escude,6-2; 6-3,S,77,9,1,32,44,29,32,7,12,0,0,9,36,44,5,5,43,65,26,43,9,22,7,10,8,35,65
2004-01-05 00:00:00.000,Doha Qatar ATP World Tour,HARD,2,Ivan Ljubicic,Tim Henman,Ivan Ljubicic,7-6(2); 3-6; 7-6(5),S,159,11,1,71,109,53,71,20,38,5,7,16,73,109,5,1,65,103,50,65,23,38,4,5,17,73,103
2004-01-05 00:00:00.000,Doha Qatar ATP World Tour,HARD,2,Nicolas Escude,Ivan Ljubicic,Nicolas Escude,6-3; 7-6(4),F,94,8,1,40,65,33,40,16,25,4,4,10,49,65,7,1,50,68,35,50,9,18,1,3,11,44,68
2004-01-12 00:00:00.000,Auckland New Zealand ATP World Tour,HARD,2,Guillermo Coria,Nicolas Kiefer,Guillermo Coria,7-6(4); 6-3,R32,96,2,2,35,68,24,35,21,33,2,4,11,45,68,6,5,30,64,23,30,15,34,4,7,10,38,64
2004-01-12 00:00:00.000,Auckland New Zealand ATP World Tour,HARD,2,Dominik Hrbaty,Mark Nielsen,Dominik Hrbaty,6-3; 6-2,R32,70,3,6,43,69,30,43,15,26,5,5,9,45,69,2,3,32,54,18,32,12,22,5,8,8,30,54
2004-01-12 00:00:00.000,Auckland New Zealand ATP World Tour,HARD,2,Philipp Kohlschreiber,Luis Horna,Philipp Kohlschreiber,6-4; 6-3,R32,77,5,2,37,68,24,37,18,31,4,5,9,42,68,2,3,39,56,25,39,6,17,1,5,10,31,56
2004-01-12 00:00:00.000,Auckland New Zealand ATP World Tour,HARD,2,Gaston Gaudio,Radek Stepanek,Gaston Gaudio,7-5; 6-3,R32,87,3,2,41,64,33,41,15,23,3,3,11,48,64,3,3,35,67,26,35,16,32,3,5,10,42,67
2004-01-12 00:00:00.000,Auckland New Zealand ATP World Tour,HARD,2,Gustavo Kuerten,Alex Corretja,Gustavo Kuerten,6-7(7); 7-6(3); 7-5,R32,166,16,6,62,128,48,62,29,66,3,8,18,77,128,6,2,68,114,44,68,23,46,6,12,18,67,114
2004-01-12 00:00:00.000,Auckland New Zealand ATP World Tour,HARD,2,Alberto Martin,Stefan Koubek,Alberto Martin,6-4; 6-4,R32,77,1,5,39,65,27,39,15,26,1,3,10,42,65,1,4,50,77,28,50,12,27,10,14,10,40,77
2004-01-12 00:00:00.000,Auckland New Zealand ATP World Tour,HARD,2,Fred Hemmes,Robin Soderling,Fred Hemmes,6-2; 6-3,R32,70,6,0,36,55,28,36,11,19,2,2,9,39,55,3,4,42,66,23,42,12,24,10,13,8,35,66
2004-01-12 00:00:00.000,Auckland New Zealand ATP World Tour,HARD,2,Vincent Spadea,Todd Martin,Vincent Spadea,6-3; 6-4,R32,77,1,0,36,59,28,36,16,23,0,0,10,44,59,5,3,38,60,30,38,7,22,6,8,9,37,60
2004-01-12 00:00:00.000,Auckland New Zealand ATP World Tour,HARD,2,Fabrice Santoro,Jarkko Nieminen,Fabrice Santoro,6-1; 6-4,R32,63,3,1,29,51,19,29,10,22,1,4,9,29,51,1,3,27,54,13,27,8,27,4,10,8,21,54
2004-01-12 00:00:00.000,Auckland New Zealand ATP World Tour,HARD,2,Gregory Carraz,Karol Beck,Gregory Carraz,6-4; 6-7(3); 6-3,R32,142,14,16,69,117,54,69,17,48,10,13,16,71,117,6,3,68,125,45,68,26,57,15,20,15,71,125
2004-01-12 00:00:00.000,Auckland New Zealand ATP World Tour,HARD,2,Mario Ancic,Simon Rea,Mario Ancic,6-2; 6-1,R32,52,8,1,19,31,18,19,10,12,0,0,7,28,31,1,10,22,55,12,22,11,33,4,9,8,23,55
2004-01-12 00:00:00.000,Auckland New Zealand ATP World Tour,HARD,2,Rafael Nadal,Sjeng Schalken,Rafael Nadal,7-6(2); 6-4,R32,125,1,0,65,88,39,65,14,23,6,9,11,53,88,1,0,71,92,38,71,11,21,9,13,11,49,92
2004-01-12 00:00:00.000,Auckland New Zealand ATP World Tour,HARD,2,Raemon Sluiter,Fernando Gonzalez,Raemon Sluiter,6-3; 6-4,R32,64,7,0,37,58,32,37,13,21,4,4,10,45,58,6,5,37,58,26,37,10,21,2,4,9,36,58
2004-01-12 00:00:00.000,Auckland New Zealand ATP World Tour,HARD,2,David Sanchez,Jan-Michael Gambill,David Sanchez,7-6(5); 6-3,R32,96,8,1,58,82,40,58,14,24,3,4,11,54,82,5,3,33,64,25,33,19,31,4,6,10,44,64
2004-01-12 00:00:00.000,Auckland New Zealand ATP World Tour,HARD,2,Gilles Muller,Nicolas Lapentti,Gilles Muller,7-5; 6-7(3); 6-1,R32,142,7,4,55,94,41,55,22,39,0,2,16,63,94,8,5,65,113,44,65,19,48,4,9,15,63,113
2004-01-12 00:00:00.000,Auckland New Zealand ATP World Tour,HARD,2,Jiri Novak,Xavier Malisse,Jiri Novak,7-6(7); 6-7(4); 6-3,R32,133,4,3,69,108,48,69,21,39,2,6,17,69,108,6,3,56,113,42,56,22,57,5,10,16,64,113
2004-01-12 00:00:00.000,Auckland New Zealand ATP World Tour,HARD,2,Dominik Hrbaty,Guillermo Coria,Dominik Hrbaty,W/O,R16,0,0,0,0,0,0,0,0,0,0,0,0,0,0,0,0,0,0,0,0,0,0,0,0,0,0,0
2004-01-12 00:00:00.000,Auckland New Zealand ATP World Tour,HARD,2,Philipp Kohlschreiber,Gaston Gaudio,Philipp Kohlschreiber,7-6(3); 6-1,R16,84,10,2,37,69,25,37,16,32,7,10,10,41,69,0,3,48,67,26,48,5,19,7,12,9,31,67
2004-01-12 00:00:00.000,Auckland New Zealand ATP World Tour,HARD,2,Gustavo Kuerten,Alberto Martin,Gustavo Kuerten,6-2; 6-4,R16,81,3,0,30,54,22,30,14,24,2,3,9,36,54,6,6,56,80,34,56,9,24,9,13,9,43,80
2004-01-12 00:00:00.000,Auckland New Zealand ATP World Tour,HARD,2,Vincent Spadea,Fred Hemmes,Vincent Spadea,6-1; 6-2,R16,59,2,3,36,57,26,36,11,21,4,5,8,37,57,2,3,25,46,13,25,5,21,5,10,7,18,46
2004-01-12 00:00:00.000,Auckland New Zealand ATP World Tour,HARD,2,Gregory Carraz,Fabrice Santoro,Gregory Carraz,6-2; 6-4,R16,67,7,6,42,65,32,42,11,23,6,7,9,43,65,4,4,35,50,23,35,5,15,2,6,9,28,50
2004-01-12 00:00:00.000,Auckland New Zealand ATP World Tour,HARD,2,Rafael Nadal,Mario Ancic,Rafael Nadal,7-6(0); 7-6(6),R16,113,2,2,54,79,37,54,18,25,5,7,12,55,79,8,4,51,83,32,51,18,32,2,4,12,50,83
2004-01-12 00:00:00.000,Auckland New Zealand ATP World Tour,HARD,2,Raemon Sluiter,David Sanchez,Raemon Sluiter,7-6(3); 6-3,R16,82,10,1,43,65,37,43,10,22,1,2,11,47,65,4,2,41,67,32,41,9,26,3,5,10,41,67
2004-01-12 00:00:00.000,Auckland New Zealand ATP World Tour,HARD,2,Jiri Novak,Gilles Muller,Jiri Novak,7-6(4); 6-2,R16,77,6,3,49,69,33,49,11,20,4,7,10,44,69,2,2,37,70,24,37,13,33,7,12,10,37,70
2004-01-12 00:00:00.000,Auckland New Zealand ATP World Tour,HARD,2,Dominik Hrbaty,Philipp Kohlschreiber,Dominik Hrbaty,6-1; 3-6; 6-3,Q,82,2,1,46,73,34,46,18,27,2,3,13,52,73,6,1,37,69,27,37,15,32,4,7,12,42,69
2004-01-12 00:00:00.000,Auckland New Zealand ATP World Tour,HARD,2,Gustavo Kuerten,Vincent Spadea,Gustavo Kuerten,6-2; 7-6(4),Q,86,7,0,46,78,36,46,14,32,4,5,10,50,78,2,1,45,67,26,45,13,22,3,6,10,39,67
2004-01-12 00:00:00.000,Auckland New Zealand ATP World Tour,HARD,2,Rafael Nadal,Gregory Carraz,Rafael Nadal,2-1 RET,Q,15,0,0,7,9,6,7,2,2,0,0,2,8,9,1,0,4,5,3,4,1,1,0,0,1,4,5
2004-01-12 00:00:00.000,Auckland New Zealand ATP World Tour,HARD,2,Jiri Novak,Raemon Sluiter,Jiri Novak,4-6; 6-4; 6-4,Q,99,8,1,66,99,39,66,23,33,2,4,15,62,99,9,2,62,88,45,62,11,26,4,7,15,56,88
2004-01-12 00:00:00.000,Auckland New Zealand ATP World Tour,HARD,2,Dominik Hrbaty,Gustavo Kuerten,Dominik Hrbaty,6-3; 6-2,S,67,2,3,47,73,34,47,12,26,11,11,9,46,73,5,2,24,51,17,24,12,27,4,7,8,29,51
2004-01-12 00:00:00.000,Auckland New Zealand ATP World Tour,HARD,2,Rafael Nadal,Jiri Novak,Rafael Nadal,6-1; 6-3,S,64,1,0,31,47,24,31,11,16,1,1,8,35,47,2,3,36,65,20,36,14,29,6,10,8,34,65
2004-01-12 00:00:00.000,Auckland New Zealand ATP World Tour,HARD,2,Dominik Hrbaty,Rafael Nadal,Dominik Hrbaty,4-6; 6-2; 7-5,F,135,2,4,73,106,46,73,18,33,8,11,15,64,106,0,4,62,106,36,62,22,44,11,16,15,58,106
2004-01-12 00:00:00.000,Sydney Australia ATP World Tour,HARD,2,Chris Guccione,Juan Carlos Ferrero,Chris Guccione,6-3; 7-6(6),R32,65,19,2,34,60,33,34,16,26,3,3,11,49,60,7,4,37,58,30,37,12,21,1,2,10,42,58
2004-01-12 00:00:00.000,Sydney Australia ATP World Tour,HARD,2,Wayne Ferreira,James Blake,Wayne Ferreira,6-2; 6-4,R32,59,6,2,36,65,24,36,20,29,6,6,9,44,65,7,1,28,47,21,28,8,19,2,5,9,29,47
2004-01-12 00:00:00.000,Sydney Australia ATP World Tour,HARD,2,Felix Mantilla,Richard Gasquet,Felix Mantilla,3-0 RET,R32,13,0,0,5,6,3,5,1,1,0,0,1,4,6,0,3,6,14,4,6,1,8,1,3,2,5,14
2004-01-12 00:00:00.000,Sydney Australia ATP World Tour,HARD,2,Todd Reid,Nicolas Massu,Todd Reid,7-6(5); 2-6; 6-4,R32,142,3,5,66,96,40,66,15,30,3,8,15,55,96,6,4,65,105,42,65,20,40,7,11,15,62,105
2004-01-12 00:00:00.000,Sydney Australia ATP World Tour,HARD,2,Carlos Moya,Alex Bogomolov Jr.,Carlos Moya,7-5; 6-4,R32,78,14,2,25,52,23,25,17,27,0,1,11,40,52,0,1,66,86,39,66,10,20,10,13,11,49,86
2004-01-12 00:00:00.000,Sydney Australia ATP World Tour,HARD,2,Michael Llodra,Mikhail Youzhny,Michael Llodra,6-4; 6-2,R32,78,2,1,39,61,33,39,9,22,3,3,9,42,61,1,5,42,67,29,42,7,25,9,12,9,36,67
2004-01-12 00:00:00.000,Sydney Australia ATP World Tour,HARD,2,Tommy Robredo,Albert Costa,Tommy Robredo,6-2; 6-3,R32,67,6,3,27,51,25,27,11,24,1,1,8,36,51,6,5,24,48,19,24,9,24,0,4,9,28,48
2004-01-12 00:00:00.000,Sydney Australia ATP World Tour,HARD,2,Paradorn Srichaphan,Jonas Bjorkman,Paradorn Srichaphan,7-5; 1-6; 6-1,R32,104,9,3,49,81,37,49,15,32,6,9,13,52,81,7,2,52,79,37,52,10,27,4,8,13,47,79
2004-01-12 00:00:00.000,Sydney Australia ATP World Tour,HARD,2,Martin Verkerk,Wayne Arthurs,Martin Verkerk,6-4; 6-4,R32,71,15,2,37,55,33,37,11,18,3,3,10,44,55,9,5,37,59,26,37,11,22,3,5,10,37,59
2004-01-12 00:00:00.000,Sydney Australia ATP World Tour,HARD,2,Max Mirnyi,Agustin Calleri,Max Mirnyi,7-5; 6-3,R32,81,9,3,42,66,32,42,16,24,1,1,11,48,66,3,5,24,58,16,24,21,34,6,8,10,37,58
2004-01-12 00:00:00.000,Sydney Australia ATP World Tour,HARD,2,Greg Rusedski,Juan Ignacio Chela,Greg Rusedski,7-6(1); 7-6(5),R32,108,9,3,59,92,45,59,14,33,8,10,12,59,92,3,3,45,81,33,45,15,36,1,3,12,48,81
2004-01-12 00:00:00.000,Sydney Australia ATP World Tour,HARD,2,Mark Philippoussis,Ruben Ramirez Hidalgo,Mark Philippoussis,6-4; 5-7; 6-2,R32,107,17,7,48,80,41,48,15,32,4,7,15,56,80,4,4,60,88,37,60,16,28,5,10,15,53,88
2004-01-12 00:00:00.000,Sydney Australia ATP World Tour,HARD,2,Lleyton Hewitt,Sargis Sargsian,Lleyton Hewitt,6-4; 6-2,R32,69,4,3,27,55,19,27,18,28,3,4,9,37,55,0,2,33,54,21,33,9,21,5,9,9,30,54
2004-01-12 00:00:00.000,Sydney Australia ATP World Tour,HARD,2,Karol Kucera,Feliciano Lopez,Karol Kucera,6-7(3); 7-6(4); 6-3,R32,156,7,7,74,113,55,74,21,39,2,4,17,76,113,18,7,59,108,46,59,23,49,1,4,16,69,108
2004-01-12 00:00:00.000,Sydney Australia ATP World Tour,HARD,2,Arnaud Clement,Mardy Fish,Arnaud Clement,6-3; 6-3,R32,61,5,0,33,52,25,33,14,19,2,2,9,39,52,6,2,30,46,24,30,4,16,2,5,9,28,46
2004-01-12 00:00:00.000,Sydney Australia ATP World Tour,HARD,2,Joachim Johansson,Rainer Schuettler,Joachim Johansson,6-4; 6-4,R32,66,7,2,35,57,28,35,13,22,1,1,10,41,57,3,3,40,62,32,40,9,22,4,6,10,41,62
2004-01-12 00:00:00.000,Sydney Australia ATP World Tour,HARD,2,Wayne Ferreira,Chris Guccione,Wayne Ferreira,7-6(4); 7-5,R16,79,3,1,48,80,38,48,20,32,6,6,12,58,80,7,3,35,69,29,35,21,34,2,3,12,50,69
2004-01-12 00:00:00.000,Sydney Australia ATP World Tour,HARD,2,Todd Reid,Felix Mantilla,Todd Reid,6-4; 6-1,R16,73,5,1,49,65,30,49,10,16,10,12,9,40,65,0,2,42,67,20,42,10,25,3,8,8,30,67
2004-01-12 00:00:00.000,Sydney Australia ATP World Tour,HARD,2,Carlos Moya,Michael Llodra,Carlos Moya,7-6(5); 6-3,R16,81,5,0,36,72,32,36,19,36,0,0,11,51,72,3,4,43,65,36,43,8,22,0,1,10,44,65
2004-01-12 00:00:00.000,Sydney Australia ATP World Tour,HARD,2,Tommy Robredo,Paradorn Srichaphan,Tommy Robredo,4-6; 6-1; 7-6(3),R16,113,5,2,66,105,45,66,21,39,8,11,15,66,105,6,4,63,94,40,63,15,31,5,9,14,55,94
2004-01-12 00:00:00.000,Sydney Australia ATP World Tour,HARD,2,Martin Verkerk,Max Mirnyi,Martin Verkerk,6-7(0); 7-6(6); 7-6(5),R16,151,19,11,71,122,57,71,28,51,6,8,18,85,122,10,3,77,121,62,77,26,44,7,9,18,88,121
2004-01-12 00:00:00.000,Sydney Australia ATP World Tour,HARD,2,Mark Philippoussis,Greg Rusedski,Mark Philippoussis,6-3; 1-6; 6-4,R16,88,7,3,33,65,30,33,15,32,2,4,13,45,65,5,2,58,80,38,58,14,22,3,5,13,52,80
2004-01-12 00:00:00.000,Sydney Australia ATP World Tour,HARD,2,Lleyton Hewitt,Karol Kucera,Lleyton Hewitt,6-4; 6-1,R16,79,4,3,30,56,21,30,15,26,3,5,9,36,56,2,2,35,59,19,35,7,24,3,8,8,26,59
2004-01-12 00:00:00.000,Sydney Australia ATP World Tour,HARD,2,Arnaud Clement,Joachim Johansson,Arnaud Clement,6-4; 7-5,R16,80,4,1,36,57,26,36,16,21,3,4,11,42,57,11,3,43,70,30,43,10,27,2,5,11,40,70
2004-01-12 00:00:00.000,Sydney Australia ATP World Tour,HARD,2,Wayne Ferreira,Todd Reid,Wayne Ferreira,6-4; 6-4,Q,58,8,1,37,58,30,37,14,21,2,2,10,44,58,3,0,40,58,31,40,7,18,0,2,10,38,58
2004-01-12 00:00:00.000,Sydney Australia ATP World Tour,HARD,2,Carlos Moya,Tommy Robredo,Carlos Moya,6-1; 6-2,Q,51,7,2,24,41,21,24,11,17,0,0,8,32,41,2,1,33,53,21,33,4,20,10,14,7,25,53
2004-01-12 00:00:00.000,Sydney Australia ATP World Tour,HARD,2,Martin Verkerk,Mark Philippoussis,Martin Verkerk,6-4; 7-6(4),Q,94,8,6,35,70,28,35,23,35,3,4,11,51,70,11,1,37,66,31,37,15,29,4,6,11,46,66
2004-01-12 00:00:00.000,Sydney Australia ATP World Tour,HARD,2,Lleyton Hewitt,Arnaud Clement,Lleyton Hewitt,6-1; 4-6; 6-3,Q,103,4,1,38,68,29,38,20,30,5,7,13,49,68,7,2,40,82,25,40,23,42,4,9,13,48,82
2004-01-12 00:00:00.000,Sydney Australia ATP World Tour,HARD,2,Carlos Moya,Wayne Ferreira,Carlos Moya,6-2; 6-1,S,66,5,1,27,46,20,27,12,19,3,3,7,32,46,0,2,30,54,13,30,10,24,9,14,8,23,54
2004-01-12 00:00:00.000,Sydney Australia ATP World Tour,HARD,2,Lleyton Hewitt,Martin Verkerk,Lleyton Hewitt,6-2 RET,S,36,2,0,9,16,8,9,4,7,0,1,4,12,16,3,3,9,31,7,9,5,22,1,4,4,12,31
2004-01-12 00:00:00.000,Sydney Australia ATP World Tour,HARD,2,Lleyton Hewitt,Carlos Moya,Lleyton Hewitt,4-3 RET,F,33,4,2,16,27,14,16,5,11,2,2,3,19,27,4,0,8,19,6,8,6,11,0,1,4,12,19
2004-01-19 00:00:00.000,Australian Open Australia Grand Slams,HARD,3,Andy Roddick,Fernando Gonzalez,Andy Roddick,6-2; 7-5; 7-6(4),R128,124,20,4,56,98,47,56,24,42,4,5,16,71,98,10,5,78,121,53,78,19,43,12,16,16,72,121
2004-01-19 00:00:00.000,Australian Open Australia Grand Slams,HARD,3,Bohdan Ulihrach,Lars Burgsmuller,Bohdan Ulihrach,6-4; 3-6; 6-2; 6-1,R128,139,3,5,68,103,51,68,17,35,6,9,17,68,103,10,10,81,136,51,81,23,55,14,21,17,74,136
2004-01-19 00:00:00.000,Australian Open Australia Grand Slams,HARD,3,Juan Ignacio Chela,Irakli Labadze,Juan Ignacio Chela,6-4; 6-3; 3-6; 6-3,R128,143,2,2,83,117,55,83,19,34,6,9,19,74,117,2,10,76,109,52,76,13,33,1,6,18,65,109
2004-01-19 00:00:00.000,Australian Open Australia Grand Slams,HARD,3,Taylor Dent,Fernando Verdasco,Taylor Dent,6-2; 6-1; 2-1 RET,R128,78,3,7,23,51,20,23,18,28,1,1,9,38,51,0,3,34,62,14,34,15,28,3,8,9,29,62
2004-01-19 00:00:00.000,Australian Open Australia Grand Slams,HARD,3,Galo Blanco,Younes El Aynaoui,Galo Blanco,4-1 RET,R128,17,2,1,8,15,7,8,3,7,1,1,2,10,15,3,2,16,24,8,16,2,8,3,5,3,10,24
2004-01-19 00:00:00.000,Australian Open Australia Grand Slams,HARD,3,Jurgen Melzer,Tomas Behrend,Jurgen Melzer,6-1; 6-2; 6-2,R128,80,4,0,39,64,31,39,19,25,1,1,12,50,64,2,5,55,84,32,55,9,29,7,13,11,41,84
2004-01-19 00:00:00.000,Australian Open Australia Grand Slams,HARD,3,David Ferrer,Gilles Muller,David Ferrer,7-6(4); 6-1; 6-3,R128,103,4,5,52,94,41,52,21,42,5,7,14,62,94,4,8,42,83,29,42,16,41,2,8,14,45,83
2004-01-19 00:00:00.000,Australian Open Australia Grand Slams,HARD,3,Sjeng Schalken,Kenneth Carlsen,Sjeng Schalken,7-5; 6-3; 6-1,R128,128,3,1,73,88,55,73,8,15,3,3,14,63,88,6,5,48,82,34,48,14,34,3,8,14,48,82
2004-01-19 00:00:00.000,Australian Open Australia Grand Slams,HARD,3,Jarkko Nieminen,Nicolas Massu,Jarkko Nieminen,6-1; 6-7(5); 6-2; 6-3,R128,172,4,5,79,127,56,79,27,48,15,18,19,83,127,5,10,69,116,43,69,18,47,6,14,17,61,116
2004-01-19 00:00:00.000,Australian Open Australia Grand Slams,HARD,3,Marat Safin,Brian Vahaly,Marat Safin,6-2; 3-6; 6-3; 6-4,R128,146,19,2,68,117,50,68,29,49,6,8,18,79,117,1,9,70,119,47,70,24,49,6,11,18,71,119
2004-01-19 00:00:00.000,Australian Open Australia Grand Slams,HARD,3,Todd Martin,Antony Dupuis,Todd Martin,4-6; 4-6; 7-6(5); 7-6(4); 6-3,R128,200,26,12,102,161,78,102,34,59,3,7,27,112,161,26,8,97,162,78,97,32,65,3,6,26,110,162
2004-01-19 00:00:00.000,Australian Open Australia Grand Slams,HARD,3,Ivo Karlovic,Mardy Fish,Ivo Karlovic,7-6(0); 7-6(5); 7-6(4),R128,145,21,6,80,122,66,80,22,42,4,4,18,88,122,12,5,68,108,58,68,25,40,2,2,18,83,108
2004-01-19 00:00:00.000,Australian Open Australia Grand Slams,HARD,3,Nikolay Davydenko,Arnaud Clement,Nikolay Davydenko,6-7(6); 4-6; 6-4; 6-1; 6-2,R128,217,10,3,120,170,84,120,23,50,16,19,24,107,170,8,5,77,149,54,77,36,72,13,20,23,90,149
2004-01-19 00:00:00.000,Australian Open Australia Grand Slams,HARD,3,Olivier Patience,Igor Andreev,Olivier Patience,4-6; 4-6; 7-6(4); 6-1; 6-2,R128,181,7,4,80,137,55,80,31,57,1,5,23,86,137,6,9,74,146,53,74,36,72,9,16,24,89,146
2004-01-19 00:00:00.000,Australian Open Australia Grand Slams,HARD,3,Nicolas Lapentti,Oscar Hernandez,Nicolas Lapentti,6-1; 6-3; 6-1,R128,106,3,1,42,58,34,42,11,16,1,1,11,45,58,1,5,63,101,35,63,12,38,6,13,12,47,101
2004-01-19 00:00:00.000,Australian Open Australia Grand Slams,HARD,3,James Blake,Ivan Miranda,James Blake,6-1; 6-4; 6-4,R128,96,8,5,47,84,35,47,22,37,7,8,14,57,84,2,1,55,87,35,55,13,32,6,11,13,48,87
2004-01-19 00:00:00.000,Australian Open Australia Grand Slams,HARD,3,Andre Agassi,Todd Larkham,Andre Agassi,6-1; 6-3; 6-4,R128,99,8,3,43,77,34,43,18,34,3,4,13,52,77,2,3,63,88,35,63,11,25,6,12,13,46,88
2004-01-19 00:00:00.000,Australian Open Australia Grand Slams,HARD,3,Tomas Berdych,Nicolas Mahut,Tomas Berdych,6-4; 6-2; 5-7; 6-3,R128,166,18,9,74,133,56,74,28,59,8,12,20,84,133,10,14,62,137,40,62,34,75,14,21,19,74,137
2004-01-19 00:00:00.000,Australian Open Australia Grand Slams,HARD,3,Karol Beck,Stefan Koubek,Karol Beck,6-4; 6-0; 2-6; 6-4,R128,121,7,6,53,102,43,53,17,49,4,9,17,60,102,3,2,76,107,42,76,11,31,5,13,17,53,107
2004-01-19 00:00:00.000,Australian Open Australia Grand Slams,HARD,3,Thomas Enqvist,Vincent Spadea,Thomas Enqvist,4-6; 6-4; 6-4; 7-6(6),R128,163,10,9,80,138,62,80,28,58,3,6,21,90,138,10,1,88,143,58,88,33,55,6,10,21,91,143
2004-01-19 00:00:00.000,Australian Open Australia Grand Slams,HARD,3,Gustavo Kuerten,John van Lottum,Gustavo Kuerten,5-7; 6-0; 6-1; 2-6; 8-6,R128,195,19,8,82,152,60,82,32,70,10,17,24,92,152,5,6,70,122,44,70,22,52,2,12,23,66,122
2004-01-19 00:00:00.000,Australian Open Australia Grand Slams,HARD,3,Ivan Ljubicic,Dmitry Tursunov,Ivan Ljubicic,7-6(2); 6-4; 5-7; 6-2,R128,178,5,2,78,132,52,78,38,54,3,5,21,90,132,7,7,82,151,54,82,39,69,11,15,21,93,151
2004-01-19 00:00:00.000,Australian Open Australia Grand Slams,HARD,3,Jerome Golmard,Albert Portas,Jerome Golmard,7-6(3); 6-4; 6-1,R128,105,8,6,50,88,41,50,20,38,1,3,14,61,88,6,8,52,95,36,52,17,43,5,11,15,53,95
2004-01-19 00:00:00.000,Australian Open Australia Grand Slams,HARD,3,Paradorn Srichaphan,Jose Acasuso,Paradorn Srichaphan,7-5; 6-4; 6-0,R128,94,11,5,43,80,37,43,23,37,2,2,14,60,80,7,5,52,91,29,52,21,39,4,9,14,50,91
2004-01-19 00:00:00.000,Australian Open Australia Grand Slams,HARD,3,Sebastien Grosjean,Mikhail Youzhny,Sebastien Grosjean,6-1; 6-4; 7-5,R128,123,3,3,38,84,32,38,28,46,4,6,15,60,84,3,5,52,97,31,52,22,45,6,12,14,53,97
2004-01-19 00:00:00.000,Australian Open Australia Grand Slams,HARD,3,Jan-Michael Gambill,Gregory Carraz,Jan-Michael Gambill,6-2; 6-3 RET,R128,63,18,0,38,57,30,38,11,19,2,2,9,41,57,2,8,24,50,16,24,12,26,4,7,8,28,50
2004-01-19 00:00:00.000,Australian Open Australia Grand Slams,HARD,3,Dominik Hrbaty,Flavio Saretta,Dominik Hrbaty,6-3; 6-3; 6-3,R128,105,4,2,57,80,38,57,16,23,3,5,14,54,80,7,5,43,89,28,43,17,46,6,12,13,45,89
2004-01-19 00:00:00.000,Australian Open Australia Grand Slams,HARD,3,Gaston Gaudio,Tommy Robredo,Gaston Gaudio,6-3; 6-2; 7-6(6),R128,148,3,10,69,109,49,69,21,40,8,10,15,70,109,6,7,54,106,33,54,27,52,7,12,14,60,106
2004-01-19 00:00:00.000,Australian Open Australia Grand Slams,HARD,3,Robby Ginepri,Luis Horna,Robby Ginepri,7-5; 6-3; 6-3,R128,121,16,5,50,87,41,50,21,37,4,5,15,62,87,12,4,77,120,49,77,20,43,15,20,15,69,120
2004-01-19 00:00:00.000,Australian Open Australia Grand Slams,HARD,3,Chris Guccione,Alun Jones,Chris Guccione,6-3; 7-6(3); 6-2,R128,107,11,4,56,105,45,56,27,49,4,5,15,72,105,5,4,56,95,39,56,18,39,10,14,14,57,95
2004-01-19 00:00:00.000,Australian Open Australia Grand Slams,HARD,3,Nicolas Escude,Hyung-Taik Lee,Nicolas Escude,6-3; 7-6(5); 6-2,R128,145,15,2,56,98,42,56,21,42,5,8,15,63,98,2,3,51,96,32,51,16,45,7,13,14,48,96
2004-01-19 00:00:00.000,Australian Open Australia Grand Slams,HARD,3,Robin Soderling,Rainer Schuettler,Robin Soderling,4-6; 4-6; 7-5; 6-3; 6-4,R128,192,10,4,98,152,70,98,30,54,4,8,26,100,152,12,4,102,161,72,102,31,59,10,15,25,103,161
2004-01-19 00:00:00.000,Australian Open Australia Grand Slams,HARD,3,Cyril Saulnier,Guillermo Coria,Cyril Saulnier,7-6(7); 6-2; 6-4,R128,138,10,5,55,108,42,55,32,53,9,10,15,74,108,6,1,71,105,45,71,17,34,7,11,15,62,105
2004-01-19 00:00:00.000,Australian Open Australia Grand Slams,HARD,3,Hicham Arazi,Olivier Mutis,Hicham Arazi,7-5; 2-6; 6-0; 6-3,R128,128,5,1,54,97,40,54,26,43,5,9,18,66,97,5,5,60,104,41,60,20,44,7,14,17,61,104
2004-01-19 00:00:00.000,Australian Open Australia Grand Slams,HARD,3,Wayne Arthurs,Roko Karanusic,Wayne Arthurs,7-6(2); 6-4; 6-7(2); 6-7(5); 6-2,R128,189,23,7,94,164,79,94,41,70,2,3,27,120,164,10,3,108,167,80,108,36,59,8,12,27,116,167
2004-01-19 00:00:00.000,Australian Open Australia Grand Slams,HARD,3,Albert Costa,Greg Rusedski,Albert Costa,6-4; 6-3; 6-4,R128,108,3,2,56,84,41,56,13,28,4,7,15,54,84,8,5,45,78,31,45,13,33,5,11,14,44,78
2004-01-19 00:00:00.000,Australian Open Australia Grand Slams,HARD,3,Alex Corretja,Martin Verkerk,Alex Corretja,6-4; 1-6; 6-3; 6-4,R128,140,4,3,61,103,50,61,22,42,4,6,18,72,103,25,9,58,104,48,58,20,46,4,7,18,68,104
2004-01-19 00:00:00.000,Australian Open Australia Grand Slams,HARD,3,Mario Ancic,Raemon Sluiter,Mario Ancic,6-7(4); 6-4; 3-6; 6-4; 6-3,R128,181,15,4,80,137,63,80,37,57,0,2,25,100,137,8,6,87,150,67,87,36,63,4,8,25,103,150
2004-01-19 00:00:00.000,Australian Open Australia Grand Slams,HARD,3,Fabrice Santoro,Peter Luczak,Fabrice Santoro,7-5; 4-6; 7-5; 6-1,R128,170,17,2,66,115,54,66,32,49,7,8,21,86,115,5,7,95,143,59,95,27,48,13,17,20,86,143
2004-01-19 00:00:00.000,Australian Open Australia Grand Slams,HARD,3,Mark Philippoussis,Thomas Johansson,Mark Philippoussis,7-6(6); 6-2; 7-6(4),R128,143,19,4,71,111,57,71,21,40,2,3,16,78,111,12,6,67,110,51,67,20,43,5,8,16,71,110
2004-01-19 00:00:00.000,Australian Open Australia Grand Slams,HARD,3,Jiri Novak,Olivier Rochus,Jiri Novak,6-3; 6-3; 7-5,R128,101,5,1,63,91,48,63,12,28,5,8,15,60,91,2,2,53,85,30,53,12,32,5,12,15,42,85
2004-01-19 00:00:00.000,Australian Open Australia Grand Slams,HARD,3,Jan Vacek,Ruben Ramirez Hidalgo,Jan Vacek,6-2; 3-6; 6-3; 6-4,R128,135,8,3,60,102,44,60,28,42,4,5,18,72,102,4,6,65,121,49,65,23,56,7,11,18,72,121
2004-01-19 00:00:00.000,Australian Open Australia Grand Slams,HARD,3,Glenn Weiner,Jeff Salzenstein,Glenn Weiner,7-6(3); 4-6; 6-3; 3-6; 6-4,R128,187,34,8,86,152,67,86,41,66,9,12,25,108,152,16,8,91,145,73,91,28,54,4,7,25,101,145
2004-01-19 00:00:00.000,Australian Open Australia Grand Slams,HARD,3,Andrei Pavel,Max Mirnyi,Andrei Pavel,6-7(2); 6-3; 6-2; 7-6(2),R128,187,9,0,101,140,74,101,25,39,5,5,21,99,140,16,8,90,157,64,90,33,67,10,13,20,97,157
2004-01-19 00:00:00.000,Australian Open Australia Grand Slams,HARD,3,Alberto Martin,Feliciano Lopez,Alberto Martin,3-6; 4-6; 7-6(3); 6-4; 6-2,R128,182,4,6,94,137,68,94,32,43,1,3,24,100,137,27,17,103,185,76,103,40,82,17,20,25,116,185
2004-01-19 00:00:00.000,Australian Open Australia Grand Slams,HARD,3,Joachim Johansson,Alexander Popp,Joachim Johansson,6-4; 7-6(3); 6-4,R128,113,17,5,64,90,53,64,17,26,0,0,16,70,90,12,4,70,106,51,70,20,36,5,7,16,71,106
2004-01-19 00:00:00.000,Australian Open Australia Grand Slams,HARD,3,Filippo Volandri,Nicolas Kiefer,Filippo Volandri,6-3; 4-6; 6-3; 6-4,R128,168,4,3,75,131,47,75,36,56,8,11,19,83,131,10,11,73,132,52,73,28,59,10,16,19,80,132
2004-01-19 00:00:00.000,Australian Open Australia Grand Slams,HARD,3,Juan Carlos Ferrero,Albert Montanes,Juan Carlos Ferrero,6-0; 6-1; 6-1,R128,66,7,0,32,55,27,32,12,23,0,1,10,39,55,0,5,42,71,18,42,9,29,11,20,10,27,71
2004-01-19 00:00:00.000,Australian Open Australia Grand Slams,HARD,3,David Nalbandian,Ricardo Mello,David Nalbandian,6-2; 6-1; 6-4,R128,81,8,1,47,74,38,47,17,27,3,3,13,55,74,4,3,44,64,28,44,7,20,2,7,12,35,64
2004-01-19 00:00:00.000,Australian Open Australia Grand Slams,HARD,3,Florian Mayer,Richard Gasquet,Florian Mayer,7-5; 6-4; 6-3,R128,90,6,0,46,84,36,46,28,38,2,2,15,64,84,9,3,53,90,38,53,20,37,3,7,16,58,90
2004-01-19 00:00:00.000,Australian Open Australia Grand Slams,HARD,3,David Sanchez,Wesley Moodie,David Sanchez,6-7(1); 7-6(5); 4-6; 6-4; 6-3,R128,224,3,3,123,176,84,123,30,53,9,14,27,114,176,15,6,118,170,84,118,25,52,12,18,26,109,170
2004-01-19 00:00:00.000,Australian Open Australia Grand Slams,HARD,3,Wayne Ferreira,Victor Hanescu,Wayne Ferreira,6-4; 3-6; 7-6(3); 6-1,R128,145,5,0,72,114,46,72,30,42,1,3,18,76,114,5,5,104,143,63,104,20,39,15,20,20,83,143
2004-01-19 00:00:00.000,Australian Open Australia Grand Slams,HARD,3,Agustin Calleri,Christophe Rochus,Agustin Calleri,6-1; 3-6; 6-3; 7-5,R128,146,17,7,62,116,51,62,30,54,7,9,19,81,116,5,4,74,113,50,74,15,39,6,11,18,65,113
2004-01-19 00:00:00.000,Australian Open Australia Grand Slams,HARD,3,Guillermo Canas,Sebastien De Chaunac,Guillermo Canas,6-2; 6-2; 6-4,R128,100,1,5,51,77,44,51,12,26,2,2,13,56,77,1,6,45,80,26,45,19,35,4,9,13,45,80
2004-01-19 00:00:00.000,Australian Open Australia Grand Slams,HARD,3,Radek Stepanek,Davide Sanguinetti,Radek Stepanek,6-7(3); 3-6; 6-2; 6-3; 6-3,R128,190,17,3,91,143,71,91,25,52,7,10,23,96,143,6,4,97,163,63,97,38,66,9,16,24,101,163
2004-01-19 00:00:00.000,Australian Open Australia Grand Slams,HARD,3,Tim Henman,Jean-Rene Lisnard,Tim Henman,6-2; 6-4; 6-2,R128,95,2,3,41,71,33,41,23,30,3,3,13,56,71,3,6,34,76,23,34,20,42,5,10,13,43,76
2004-01-19 00:00:00.000,Australian Open Australia Grand Slams,HARD,3,Lleyton Hewitt,Cecil Mamiit,Lleyton Hewitt,6-2; 6-4; 0-1 RET,R128,84,4,3,28,50,23,28,14,22,1,1,9,37,50,3,3,32,64,18,32,20,32,4,7,10,38,64
2004-01-19 00:00:00.000,Australian Open Australia Grand Slams,HARD,3,Karol Kucera,Xavier Malisse,Karol Kucera,6-2; 6-3; 6-4,R128,117,7,6,51,89,40,51,20,38,1,2,14,60,89,1,5,39,81,28,39,18,42,2,7,13,46,81
2004-01-19 00:00:00.000,Australian Open Australia Grand Slams,HARD,3,Rafael Nadal,Michal Tabara,Rafael Nadal,6-1; 6-2; 6-2,R128,77,5,3,41,71,32,41,19,30,2,2,12,51,71,4,5,29,61,18,29,12,32,4,10,11,30,61
2004-01-19 00:00:00.000,Australian Open Australia Grand Slams,HARD,3,Thierry Ascione,Felix Mantilla,Thierry Ascione,7-5; 6-1; 7-6(3),R128,111,9,6,63,95,52,63,20,32,5,6,16,72,95,7,8,70,115,48,70,21,45,11,15,15,69,115
2004-01-19 00:00:00.000,Australian Open Australia Grand Slams,HARD,3,Sargis Sargsian,Jonas Bjorkman,Sargis Sargsian,6-2; 6-3; 6-1,R128,102,2,0,55,77,36,55,14,22,4,6,12,50,77,1,1,43,77,22,43,12,34,7,15,12,34,77
2004-01-19 00:00:00.000,Australian Open Australia Grand Slams,HARD,3,Todd Reid,Vadim Kutsenko,Todd Reid,6-3; 6-2; 6-3,R128,80,6,0,47,64,41,47,10,17,0,1,13,51,64,2,5,48,79,28,48,13,31,5,11,13,41,79
2004-01-19 00:00:00.000,Australian Open Australia Grand Slams,HARD,3,Jeff Morrison,Dennis van Scheppingen,Jeff Morrison,6-4; 6-2; 6-4,R128,87,17,3,41,76,34,41,19,35,1,3,14,53,76,1,7,37,83,20,37,23,46,2,8,14,43,83
2004-01-19 00:00:00.000,Australian Open Australia Grand Slams,HARD,3,Roger Federer,Alex Bogomolov Jr.,Roger Federer,6-3; 6-4; 6-0,R128,89,13,3,41,68,33,41,20,27,0,0,13,53,68,0,3,54,81,35,54,9,27,4,9,12,44,81
2004-01-19 00:00:00.000,Australian Open Australia Grand Slams,HARD,3,Andy Roddick,Bohdan Ulihrach,Andy Roddick,6-2; 6-2; 6-3,R64,73,20,2,43,66,40,43,14,23,3,3,13,54,66,2,5,39,76,26,39,16,37,4,9,12,42,76
2004-01-19 00:00:00.000,Australian Open Australia Grand Slams,HARD,3,Taylor Dent,Juan Ignacio Chela,Taylor Dent,3-6; 6-4; 4-6; 7-6(4); 7-5,R64,210,16,16,99,176,61,99,37,77,8,18,27,98,176,3,4,103,173,66,103,32,70,13,22,26,98,173
2004-01-19 00:00:00.000,Australian Open Australia Grand Slams,HARD,3,Jurgen Melzer,Galo Blanco,Jurgen Melzer,6-3; 6-4; 6-3,R64,115,11,9,68,110,54,68,18,42,10,10,14,72,110,3,5,51,87,35,51,16,36,4,8,14,51,87
2004-01-19 00:00:00.000,Australian Open Australia Grand Slams,HARD,3,Sjeng Schalken,David Ferrer,Sjeng Schalken,6-3; 6-2; 5-7; 6-1,R64,164,2,4,83,113,57,83,11,30,5,10,18,68,113,0,9,77,125,41,77,20,48,11,21,18,61,125
2004-01-19 00:00:00.000,Australian Open Australia Grand Slams,HARD,3,Marat Safin,Jarkko Nieminen,Marat Safin,7-6(5); 6-4; 4-6; 6-4,R64,159,23,0,78,128,65,78,26,50,11,13,21,91,128,1,2,94,140,68,94,25,46,6,9,21,93,140
2004-01-19 00:00:00.000,Australian Open Australia Grand Slams,HARD,3,Todd Martin,Ivo Karlovic,Todd Martin,7-6(4); 7-6(4); 7-6(7),R64,165,11,3,87,131,65,87,30,44,3,3,18,95,131,33,7,79,123,66,79,21,44,3,3,18,87,123
2004-01-19 00:00:00.000,Australian Open Australia Grand Slams,HARD,3,Olivier Patience,Nikolay Davydenko,Olivier Patience,7-6(2); 6-7(7); 6-3; 6-2,R64,176,8,2,98,144,71,98,23,46,6,9,21,94,144,4,5,101,140,63,101,20,39,9,15,20,83,140
2004-01-19 00:00:00.000,Australian Open Australia Grand Slams,HARD,3,James Blake,Nicolas Lapentti,James Blake,6-3; 7-6(4); 2-6; 6-1,R64,159,11,3,80,130,58,80,27,50,8,10,19,85,130,10,3,76,118,53,76,21,42,13,16,17,74,118
2004-01-19 00:00:00.000,Australian Open Australia Grand Slams,HARD,3,Andre Agassi,Tomas Berdych,Andre Agassi,6-0; 6-2; 6-4,R64,82,7,1,54,74,41,54,12,20,3,3,12,53,74,12,3,42,70,26,42,10,28,2,8,12,36,70
2004-01-19 00:00:00.000,Australian Open Australia Grand Slams,HARD,3,Thomas Enqvist,Karol Beck,Thomas Enqvist,7-5; 4-6; 6-3; 6-4,R64,169,8,10,79,146,57,79,33,67,7,11,21,90,146,17,7,66,132,51,66,27,66,9,15,20,78,132
2004-01-19 00:00:00.000,Australian Open Australia Grand Slams,HARD,3,Gustavo Kuerten,Ivan Ljubicic,Gustavo Kuerten,7-5; 6-7(5); 6-4; 6-3,R64,183,8,1,79,136,57,79,30,57,3,8,22,87,136,17,4,76,133,53,76,25,57,5,13,21,78,133
2004-01-19 00:00:00.000,Australian Open Australia Grand Slams,HARD,3,Paradorn Srichaphan,Jerome Golmard,Paradorn Srichaphan,6-3 RET,R64,34,4,0,27,39,21,27,5,12,4,4,5,26,39,3,2,11,24,9,11,7,13,0,1,4,16,24
2004-01-19 00:00:00.000,Australian Open Australia Grand Slams,HARD,3,Sebastien Grosjean,Jan-Michael Gambill,Sebastien Grosjean,6-4; 6-3; 6-2,R64,120,8,3,32,77,30,32,27,45,4,4,13,57,77,8,2,51,94,34,51,18,43,7,12,14,52,94
2004-01-19 00:00:00.000,Australian Open Australia Grand Slams,HARD,3,Dominik Hrbaty,Gaston Gaudio,Dominik Hrbaty,6-1; 7-5; 6-0,R64,87,3,5,47,77,37,47,15,30,5,7,13,52,77,1,4,39,67,20,39,8,28,6,14,12,28,67
2004-01-19 00:00:00.000,Australian Open Australia Grand Slams,HARD,3,Robby Ginepri,Chris Guccione,Robby Ginepri,6-4; 6-3; 6-3,R64,71,11,1,45,68,40,45,16,23,0,0,14,56,68,11,3,49,79,38,49,11,30,4,8,14,49,79
2004-01-19 00:00:00.000,Australian Open Australia Grand Slams,HARD,3,Nicolas Escude,Robin Soderling,Nicolas Escude,6-3; 7-6(4); 6-4,R64,122,17,0,64,90,51,64,15,26,2,2,15,66,90,9,5,61,106,44,61,21,45,5,8,16,65,106
2004-01-19 00:00:00.000,Australian Open Australia Grand Slams,HARD,3,Hicham Arazi,Cyril Saulnier,Hicham Arazi,3-6; 6-1; 6-2 RET,R64,80,1,2,34,69,24,34,22,35,2,4,12,46,69,2,2,35,60,24,35,10,25,0,5,12,34,60
2004-01-19 00:00:00.000,Australian Open Australia Grand Slams,HARD,3,Albert Costa,Wayne Arthurs,Albert Costa,6-7(5); 7-5; 4-6; 6-4; 8-6,R64,258,11,7,108,184,80,108,42,76,4,8,29,122,184,39,12,105,181,79,105,35,76,7,13,29,114,181
2004-01-19 00:00:00.000,Australian Open Australia Grand Slams,HARD,3,Mario Ancic,Alex Corretja,Mario Ancic,6-4; 1-6; 6-3; 6-7(4); 7-5,R64,253,8,6,104,177,72,104,35,73,12,17,25,107,177,2,8,111,170,70,111,33,59,11,17,25,103,170
2004-01-19 00:00:00.000,Australian Open Australia Grand Slams,HARD,3,Mark Philippoussis,Fabrice Santoro,Mark Philippoussis,4-6; 6-3; 6-4; 6-2,R64,156,17,3,69,116,56,69,23,47,3,5,19,79,116,9,3,84,127,56,84,19,43,11,16,18,75,127
2004-01-19 00:00:00.000,Australian Open Australia Grand Slams,HARD,3,Jiri Novak,Jan Vacek,Jiri Novak,6-2; 7-6(3); 6-4,R64,110,4,2,71,96,52,71,13,25,3,5,15,65,96,3,1,64,104,39,64,19,40,6,11,15,58,104
2004-01-19 00:00:00.000,Australian Open Australia Grand Slams,HARD,3,Andrei Pavel,Glenn Weiner,Andrei Pavel,6-4; 6-4; 6-2,R64,105,9,2,59,93,46,59,16,34,4,5,14,62,93,19,6,46,80,35,46,10,34,2,7,14,45,80
2004-01-19 00:00:00.000,Australian Open Australia Grand Slams,HARD,3,Joachim Johansson,Alberto Martin,Joachim Johansson,7-6(5); 6-3; 7-5,R64,121,10,10,60,96,50,60,20,36,2,4,17,70,96,2,5,67,107,50,67,16,40,4,8,16,66,107
2004-01-19 00:00:00.000,Australian Open Australia Grand Slams,HARD,3,Juan Carlos Ferrero,Filippo Volandri,Juan Carlos Ferrero,6-4; 7-6(3); 7-5,R64,138,2,6,59,102,43,59,22,43,1,5,17,65,102,2,7,70,114,44,70,20,44,4,10,17,64,114
2004-01-19 00:00:00.000,Australian Open Australia Grand Slams,HARD,3,David Nalbandian,Florian Mayer,David Nalbandian,6-1; 6-0; 6-3,R64,94,4,1,58,83,41,58,11,25,5,6,11,52,83,1,3,64,94,31,64,11,30,9,17,11,42,94
2004-01-19 00:00:00.000,Australian Open Australia Grand Slams,HARD,3,Wayne Ferreira,David Sanchez,Wayne Ferreira,2-6; 6-3; 6-4; 6-4,R64,138,8,2,85,123,56,85,21,38,4,7,19,77,123,1,1,76,119,50,76,21,43,9,13,18,71,119
2004-01-19 00:00:00.000,Australian Open Australia Grand Slams,HARD,3,Guillermo Canas,Agustin Calleri,Guillermo Canas,6-1; 4-6; 2-6; 7-6(2); 6-4,R64,197,13,7,72,131,44,72,29,59,6,15,23,73,131,12,7,94,171,61,94,30,77,13,23,24,91,171
2004-01-19 00:00:00.000,Australian Open Australia Grand Slams,HARD,3,Tim Henman,Radek Stepanek,Tim Henman,6-2; 4-6; 6-3; 6-0,R64,132,3,4,57,93,44,57,24,36,3,5,17,68,93,3,5,60,105,40,60,17,45,5,12,16,57,105
2004-01-19 00:00:00.000,Australian Open Australia Grand Slams,HARD,3,Lleyton Hewitt,Karol Kucera,Lleyton Hewitt,1-6; 6-1; 6-4; 6-1,R64,143,3,3,58,97,35,58,21,39,4,9,15,56,97,5,14,57,103,31,57,18,46,6,15,16,49,103
2004-01-19 00:00:00.000,Australian Open Australia Grand Slams,HARD,3,Rafael Nadal,Thierry Ascione,Rafael Nadal,6-4; 3-6; 7-5; 6-1,R64,176,0,5,76,110,55,76,16,34,6,10,19,71,110,5,4,87,142,48,87,29,55,12,19,19,77,142
2004-01-19 00:00:00.000,Australian Open Australia Grand Slams,HARD,3,Todd Reid,Sargis Sargsian,Todd Reid,6-3; 6-4; 4-6; 6-7(6); 6-4,R64,216,7,4,130,176,82,130,18,46,12,20,26,100,176,7,3,123,156,71,123,18,33,4,14,25,89,156
2004-01-19 00:00:00.000,Australian Open Australia Grand Slams,HARD,3,Roger Federer,Jeff Morrison,Roger Federer,6-2; 6-3; 6-4,R64,94,5,2,52,84,40,52,21,32,4,4,14,61,84,8,0,55,93,37,55,17,38,7,11,13,54,93
2004-01-19 00:00:00.000,Australian Open Australia Grand Slams,HARD,3,Andy Roddick,Taylor Dent,Andy Roddick,6-2; 6-0; 6-2,R32,71,4,1,37,61,32,37,11,24,0,1,11,43,61,2,11,35,68,18,35,9,33,3,11,11,27,68
2004-01-19 00:00:00.000,Australian Open Australia Grand Slams,HARD,3,Sjeng Schalken,Jurgen Melzer,Sjeng Schalken,7-6(1); 6-4; 6-1,R32,123,1,3,80,107,57,80,14,27,9,11,15,71,107,3,5,48,94,28,48,22,46,9,14,14,50,94
2004-01-19 00:00:00.000,Australian Open Australia Grand Slams,HARD,3,Marat Safin,Todd Martin,Marat Safin,7-5; 1-6; 4-6; 6-0; 7-5,R32,205,9,3,83,153,62,83,38,70,4,7,23,100,153,10,5,90,146,69,90,26,56,4,9,24,95,146
2004-01-19 00:00:00.000,Australian Open Australia Grand Slams,HARD,3,James Blake,Olivier Patience,James Blake,6-1; 6-3; 6-2,R32,75,7,1,44,68,35,44,14,24,0,1,12,49,68,3,1,53,82,29,53,8,29,6,13,12,37,82
2004-01-19 00:00:00.000,Australian Open Australia Grand Slams,HARD,3,Andre Agassi,Thomas Enqvist,Andre Agassi,6-0; 6-3; 6-3,R32,89,9,3,47,79,39,47,14,32,4,5,12,53,79,5,6,30,65,18,30,12,35,2,9,12,30,65
2004-01-19 00:00:00.000,Australian Open Australia Grand Slams,HARD,3,Paradorn Srichaphan,Gustavo Kuerten,Paradorn Srichaphan,6-3; 7-5; 6-4,R32,108,6,2,54,86,41,54,21,32,1,3,16,62,86,7,2,53,86,39,53,13,33,5,10,15,52,86
2004-01-19 00:00:00.000,Australian Open Australia Grand Slams,HARD,3,Sebastien Grosjean,Dominik Hrbaty,Sebastien Grosjean,2-6; 6-4; 6-1; 6-3,R32,131,10,0,51,90,41,51,18,39,0,3,17,59,90,1,3,71,109,45,71,17,38,6,12,17,62,109
2004-01-19 00:00:00.000,Australian Open Australia Grand Slams,HARD,3,Robby Ginepri,Nicolas Escude,Robby Ginepri,6-2; 6-3; 6-4,R32,95,10,4,57,93,41,57,20,36,6,7,14,61,93,7,4,49,74,36,49,9,25,5,10,13,45,74
2004-01-19 00:00:00.000,Australian Open Australia Grand Slams,HARD,3,Hicham Arazi,Albert Costa,Hicham Arazi,2-6; 7-6(2); 6-2; 6-1,R32,177,10,1,88,149,64,88,29,61,15,18,18,93,149,12,3,62,109,45,62,20,47,1,6,17,65,109
2004-01-19 00:00:00.000,Australian Open Australia Grand Slams,HARD,3,Mark Philippoussis,Mario Ancic,Mark Philippoussis,6-4; 7-6(2); 6-2,R32,137,9,2,49,99,40,49,29,50,6,8,15,69,99,10,0,56,96,34,56,20,40,4,9,15,54,96
2004-01-19 00:00:00.000,Australian Open Australia Grand Slams,HARD,3,Andrei Pavel,Jiri Novak,Andrei Pavel,4-6; 3-6; 7-5; 7-6(3); 6-4,R32,207,15,4,115,172,80,115,25,57,8,14,26,105,172,7,5,109,188,75,109,38,79,9,15,27,113,188
2004-01-19 00:00:00.000,Australian Open Australia Grand Slams,HARD,3,Juan Carlos Ferrero,Joachim Johansson,Juan Carlos Ferrero,6-1; 7-6(4); 6-7(5); 6-4,R32,148,14,3,79,124,66,79,23,45,3,4,21,89,124,19,7,91,131,63,91,19,40,8,12,20,82,131
2004-01-19 00:00:00.000,Australian Open Australia Grand Slams,HARD,3,David Nalbandian,Wayne Ferreira,David Nalbandian,6-2; 6-4; 7-5,R32,104,3,8,48,84,38,48,22,36,1,2,15,60,84,3,0,52,85,34,52,15,33,2,7,15,49,85
2004-01-19 00:00:00.000,Australian Open Australia Grand Slams,HARD,3,Guillermo Canas,Tim Henman,Guillermo Canas,6-7(5); 5-7; 7-6(3); 7-5; 9-7,R32,291,4,4,154,211,103,154,36,57,12,16,32,139,211,9,9,143,209,104,143,33,66,5,10,32,137,209
2004-01-19 00:00:00.000,Australian Open Australia Grand Slams,HARD,3,Lleyton Hewitt,Rafael Nadal,Lleyton Hewitt,7-6(2); 7-6(5); 6-2,R32,149,9,2,58,109,42,58,31,51,4,6,16,73,109,1,2,69,98,45,69,15,29,6,10,16,60,98
2004-01-19 00:00:00.000,Australian Open Australia Grand Slams,HARD,3,Roger Federer,Todd Reid,Roger Federer,6-3; 6-0; 6-1,R32,74,5,3,31,57,23,31,17,26,0,1,11,40,57,1,3,41,71,18,41,10,30,6,14,11,28,71
2004-01-19 00:00:00.000,Australian Open Australia Grand Slams,HARD,3,Andy Roddick,Sjeng Schalken,Andy Roddick,6-1; 6-2; 6-3,R16,79,14,1,44,69,39,44,12,25,4,4,12,51,69,1,3,49,64,29,49,3,15,0,6,12,32,64
2004-01-19 00:00:00.000,Australian Open Australia Grand Slams,HARD,3,Marat Safin,James Blake,Marat Safin,7-6(3); 6-3; 6-7(6); 6-3,R16,188,20,1,79,148,62,79,34,69,8,11,22,96,148,2,2,83,131,58,83,24,48,8,13,20,82,131
2004-01-19 00:00:00.000,Australian Open Australia Grand Slams,HARD,3,Andre Agassi,Paradorn Srichaphan,Andre Agassi,7-6(3); 6-3; 6-4,R16,126,5,3,55,93,49,55,20,38,7,8,16,69,93,7,5,67,106,46,67,17,39,11,14,15,63,106
2004-01-19 00:00:00.000,Australian Open Australia Grand Slams,HARD,3,Sebastien Grosjean,Robby Ginepri,Sebastien Grosjean,6-4; 3-6; 6-4; 6-1,R16,126,4,2,57,99,44,57,24,42,2,5,18,68,99,3,5,66,103,40,66,19,37,2,8,18,59,103
2004-01-19 00:00:00.000,Australian Open Australia Grand Slams,HARD,3,Hicham Arazi,Mark Philippoussis,Hicham Arazi,6-2; 6-2; 6-4,R16,104,7,2,55,87,43,55,17,32,10,10,13,60,87,8,5,57,87,40,57,8,30,5,10,13,48,87
2004-01-19 00:00:00.000,Australian Open Australia Grand Slams,HARD,3,Juan Carlos Ferrero,Andrei Pavel,Juan Carlos Ferrero,6-4; 3-6; 6-3; 6-2,R16,163,11,4,69,115,52,69,28,46,2,3,18,80,115,17,3,81,135,50,81,32,54,9,13,18,82,135
2004-01-19 00:00:00.000,Australian Open Australia Grand Slams,HARD,3,David Nalbandian,Guillermo Canas,David Nalbandian,6-4; 6-2; 6-1,R16,104,8,1,41,67,33,41,17,26,2,3,12,50,67,5,7,53,93,33,53,13,40,8,15,13,46,93
2004-01-19 00:00:00.000,Australian Open Australia Grand Slams,HARD,3,Roger Federer,Lleyton Hewitt,Roger Federer,4-6; 6-3; 6-0; 6-4,R16,138,14,4,69,117,51,69,27,48,6,7,18,78,117,5,5,74,113,49,74,19,39,8,13,17,68,113
2004-01-19 00:00:00.000,Australian Open Australia Grand Slams,HARD,3,Marat Safin,Andy Roddick,Marat Safin,2-6; 6-3; 7-5; 6-7(0); 6-4,Q,203,19,6,82,152,61,82,39,70,4,7,25,100,152,18,2,95,150,71,95,31,55,9,14,26,102,150
2004-01-19 00:00:00.000,Australian Open Australia Grand Slams,HARD,3,Andre Agassi,Sebastien Grosjean,Andre Agassi,6-2; 2-0 RET,Q,44,4,0,20,30,15,20,6,10,0,0,5,21,30,4,1,25,45,16,25,5,20,5,8,5,21,45
2004-01-19 00:00:00.000,Australian Open Australia Grand Slams,HARD,3,Juan Carlos Ferrero,Hicham Arazi,Juan Carlos Ferrero,6-1; 7-6(6); 7-6(5),Q,156,18,1,73,129,55,73,30,56,8,10,16,85,129,2,5,69,106,49,69,16,37,4,8,15,65,106
2004-01-19 00:00:00.000,Australian Open Australia Grand Slams,HARD,3,Roger Federer,David Nalbandian,Roger Federer,7-5; 6-4; 5-7; 6-3,Q,161,20,3,76,127,63,76,22,51,8,11,22,85,127,5,2,76,117,52,76,25,41,7,12,21,77,117
2004-01-19 00:00:00.000,Australian Open Australia Grand Slams,HARD,3,Marat Safin,Andre Agassi,Marat Safin,7-6(6); 7-6(6); 5-7; 1-6; 6-3,S,222,33,0,88,161,68,88,41,73,4,8,26,109,161,10,2,107,180,81,107,38,73,5,7,26,119,180
2004-01-19 00:00:00.000,Australian Open Australia Grand Slams,HARD,3,Roger Federer,Juan Carlos Ferrero,Roger Federer,6-4; 6-1; 6-4,S,89,11,1,60,83,50,60,10,23,4,4,14,60,83,6,0,41,71,27,41,16,30,2,6,13,43,71
2004-01-19 00:00:00.000,Australian Open Australia Grand Slams,HARD,3,Roger Federer,Marat Safin,Roger Federer,7-6(3); 6-4; 6-2,F,135,8,2,48,90,36,48,25,42,1,3,15,61,90,3,5,57,116,36,57,28,59,13,18,15,64,116
2004-02-09 00:00:00.000,Milan Italy ATP World Tour,HARD,2,Raemon Sluiter,Daniele Bracciali,Raemon Sluiter,7-5; 6-4,R32,76,10,1,39,62,30,39,15,23,3,3,11,45,62,9,0,38,60,29,38,11,22,1,3,11,40,60
2004-02-09 00:00:00.000,Milan Italy ATP World Tour,HARD,2,Thomas Johansson,Nikolay Davydenko,Thomas Johansson,6-3; 6-4,R32,71,9,3,31,48,29,31,11,17,0,0,10,40,48,3,0,39,59,27,39,8,20,3,5,9,35,59
2004-02-09 00:00:00.000,Milan Italy ATP World Tour,HARD,2,Karol Kucera,Radek Stepanek,Karol Kucera,7-6(5); 6-2,R32,74,14,0,39,56,36,39,11,17,0,0,10,47,56,3,2,49,68,35,49,9,19,0,2,10,44,68
2004-02-09 00:00:00.000,Milan Italy ATP World Tour,HARD,2,Sargis Sargsian,Andreas Seppi,Sargis Sargsian,6-1; 6-4,R32,71,10,4,36,60,28,36,13,24,3,3,9,41,60,4,0,34,52,23,34,5,18,2,5,8,28,52
2004-02-09 00:00:00.000,Milan Italy ATP World Tour,HARD,2,Tommy Robredo,Alex Corretja,Tommy Robredo,6-4; 7-5,R32,104,6,0,29,61,19,29,22,32,2,4,11,41,61,1,1,36,69,23,36,15,33,2,6,11,38,69
2004-02-09 00:00:00.000,Milan Italy ATP World Tour,HARD,2,Goran Ivanisevic,Bohdan Ulihrach,Goran Ivanisevic,7-6(2); 3-6; 7-6(3),R32,107,25,6,62,100,52,62,19,38,5,7,16,71,100,7,6,61,105,46,61,26,44,3,4,17,72,105
2004-02-09 00:00:00.000,Milan Italy ATP World Tour,HARD,2,Mario Ancic,Fabrice Santoro,Mario Ancic,6-2; 6-3,R32,62,4,1,33,45,27,33,9,12,0,0,9,36,45,1,3,39,55,23,39,7,16,4,7,8,30,55
2004-02-09 00:00:00.000,Milan Italy ATP World Tour,HARD,2,Rafael Nadal,Ivo Karlovic,Rafael Nadal,7-5; 6-7(5); 6-1,R32,122,2,2,59,89,48,59,21,30,0,0,16,69,89,25,4,66,103,45,66,20,37,3,6,15,65,103
2004-02-09 00:00:00.000,Milan Italy ATP World Tour,HARD,2,Dominik Hrbaty,Igor Andreev,Dominik Hrbaty,4-6; 6-3; 6-2,R32,83,13,1,52,75,42,52,12,23,4,6,14,54,75,12,3,44,73,31,44,13,29,3,7,13,44,73
2004-02-09 00:00:00.000,Milan Italy ATP World Tour,HARD,2,Mikhail Youzhny,Giorgio Galimberti,Mikhail Youzhny,7-6(5); 6-3,R32,94,5,4,51,70,35,51,8,19,2,5,10,43,70,2,5,46,91,29,46,18,45,3,8,11,47,91
2004-02-09 00:00:00.000,Milan Italy ATP World Tour,HARD,2,Ivo Heuberger,Alberto Martin,Ivo Heuberger,6-1; 6-4,R32,59,2,1,35,49,30,35,8,14,0,0,9,38,49,3,6,22,44,16,22,9,22,0,3,8,25,44
2004-02-09 00:00:00.000,Milan Italy ATP World Tour,HARD,2,Antony Dupuis,Feliciano Lopez,Antony Dupuis,6-3; 7-6(6),R32,89,8,0,42,70,30,42,24,28,4,4,11,54,70,17,3,61,87,46,61,9,26,6,7,10,55,87
2004-02-09 00:00:00.000,Milan Italy ATP World Tour,HARD,2,Karol Beck,Ivan Ljubicic,Karol Beck,6-4; 6-4,R32,60,14,1,34,52,31,34,11,18,1,1,10,42,52,1,1,35,51,23,35,12,16,2,4,10,35,51
2004-02-09 00:00:00.000,Milan Italy ATP World Tour,HARD,2,Gregory Carraz,Vincenzo Santopadre,Gregory Carraz,6-7(8); 6-3; 6-3,R32,123,19,2,61,91,49,61,21,30,2,2,15,70,91,6,0,76,101,51,76,13,25,4,7,15,64,101
2004-02-09 00:00:00.000,Milan Italy ATP World Tour,HARD,2,Nicolas Escude,Stephane Bohli,Nicolas Escude,6-3; 6-4,R32,69,11,1,36,55,29,36,14,19,4,4,10,43,55,3,1,28,48,20,28,12,20,2,4,9,32,48
2004-02-09 00:00:00.000,Milan Italy ATP World Tour,HARD,2,Martin Verkerk,Davide Sanguinetti,Martin Verkerk,6-4; 7-6(0),R32,89,15,2,39,70,29,39,15,31,6,9,11,44,70,4,5,39,72,25,39,15,33,3,7,11,40,72
2004-02-09 00:00:00.000,Milan Italy ATP World Tour,HARD,2,Thomas Johansson,Raemon Sluiter,Thomas Johansson,6-3; 6-3,R16,60,10,1,23,43,23,23,13,20,0,0,9,36,43,9,1,41,61,25,41,10,20,2,5,9,35,61
2004-02-09 00:00:00.000,Milan Italy ATP World Tour,HARD,2,Karol Kucera,Sargis Sargsian,Karol Kucera,6-2; 6-1,R16,62,7,3,24,45,23,24,10,21,0,0,8,33,45,0,3,19,39,8,19,8,20,2,6,7,16,39
2004-02-09 00:00:00.000,Milan Italy ATP World Tour,HARD,2,Tommy Robredo,Goran Ivanisevic,Tommy Robredo,6-4; 5-7; 7-6(4),R16,100,8,2,59,93,50,59,23,34,3,4,17,73,93,22,6,64,99,55,64,19,35,6,7,17,74,99
2004-02-09 00:00:00.000,Milan Italy ATP World Tour,HARD,2,Mario Ancic,Rafael Nadal,Mario Ancic,7-5; 6-2,R16,80,10,1,37,50,30,37,10,13,0,0,10,40,50,0,3,47,71,29,47,11,24,5,8,10,40,71
2004-02-09 00:00:00.000,Milan Italy ATP World Tour,HARD,2,Mikhail Youzhny,Dominik Hrbaty,Mikhail Youzhny,6-4; 6-3,R16,71,5,1,30,52,24,30,10,22,5,7,9,34,52,2,1,32,59,21,32,11,27,6,11,10,32,59
2004-02-09 00:00:00.000,Milan Italy ATP World Tour,HARD,2,Antony Dupuis,Ivo Heuberger,Antony Dupuis,7-6(4); 6-3,R16,83,6,1,39,62,32,39,16,23,0,0,11,48,62,9,5,44,72,31,44,15,28,5,6,10,46,72
2004-02-09 00:00:00.000,Milan Italy ATP World Tour,HARD,2,Gregory Carraz,Karol Beck,Gregory Carraz,6-4; 6-7(14); 7-6(5),R16,150,14,8,92,124,75,92,14,32,4,4,17,89,124,23,4,84,124,65,84,23,40,3,4,17,88,124
2004-02-09 00:00:00.000,Milan Italy ATP World Tour,HARD,2,Martin Verkerk,Nicolas Escude,Martin Verkerk,6-3; 6-4,R16,76,22,2,41,62,36,41,8,21,0,0,10,44,62,3,1,32,57,25,32,9,25,5,7,9,34,57
2004-02-09 00:00:00.000,Milan Italy ATP World Tour,HARD,2,Thomas Johansson,Karol Kucera,Thomas Johansson,7-6(2); 7-6(2),Q,137,9,3,42,84,31,42,24,42,3,5,12,55,84,10,2,54,91,33,54,22,37,6,8,12,55,91
2004-02-09 00:00:00.000,Milan Italy ATP World Tour,HARD,2,Mario Ancic,Tommy Robredo,Mario Ancic,6-3; 6-4,Q,73,8,0,42,54,33,42,6,12,0,1,10,39,54,1,3,42,64,26,42,10,22,7,10,9,36,64
2004-02-09 00:00:00.000,Milan Italy ATP World Tour,HARD,2,Antony Dupuis,Mikhail Youzhny,Antony Dupuis,5-7; 7-6(5); 7-6(5),Q,168,17,2,90,133,69,90,21,43,6,8,18,90,133,9,4,70,118,56,70,28,48,6,7,18,84,118
2004-02-09 00:00:00.000,Milan Italy ATP World Tour,HARD,2,Gregory Carraz,Martin Verkerk,Gregory Carraz,6-3; 7-6(3),Q,73,17,3,39,56,35,39,9,17,0,0,10,44,56,19,1,37,65,29,37,13,28,6,8,11,42,65
2004-02-09 00:00:00.000,Milan Italy ATP World Tour,HARD,2,Mario Ancic,Thomas Johansson,Mario Ancic,6-3; 6-4,S,69,13,2,43,55,34,43,8,12,3,3,10,42,55,4,1,33,56,20,33,14,23,1,3,9,34,56
2004-02-09 00:00:00.000,Milan Italy ATP World Tour,HARD,2,Antony Dupuis,Gregory Carraz,Antony Dupuis,6-4; 6-4,S,69,7,1,31,49,30,31,10,18,0,0,10,40,49,9,3,39,54,30,39,6,15,4,6,10,36,54
2004-02-09 00:00:00.000,Milan Italy ATP World Tour,HARD,2,Antony Dupuis,Mario Ancic,Antony Dupuis,6-4; 6-7(12); 7-6(5),F,162,11,1,95,135,74,95,19,40,6,6,17,93,135,21,1,70,101,60,70,19,31,0,1,17,79,101
2004-02-09 00:00:00.000,San Jose CA; U.S.A. ATP World Tour,HARD,2,Andy Roddick,Christophe Rochus,Andy Roddick,6-4; 6-2,R32,60,16,3,32,53,27,32,9,21,2,3,9,36,53,4,1,33,53,15,33,13,20,2,6,9,28,53
2004-02-09 00:00:00.000,San Jose CA; U.S.A. ATP World Tour,HARD,2,Kristof Vliegen,Alexander Popp,Kristof Vliegen,6-1; 6-3,R32,65,3,0,31,51,22,31,12,20,3,3,8,34,51,2,3,38,57,20,38,10,19,5,9,8,30,57
2004-02-09 00:00:00.000,San Jose CA; U.S.A. ATP World Tour,HARD,2,Joachim Johansson,Nicolas Kiefer,Joachim Johansson,5-7; 7-5; 6-2,R32,110,12,4,54,85,47,54,16,31,1,2,16,63,85,12,4,51,84,42,51,16,33,7,10,16,58,84
2004-02-09 00:00:00.000,San Jose CA; U.S.A. ATP World Tour,HARD,2,James Blake,Zack Fleishman,James Blake,6-1; 6-3,R32,51,6,0,34,51,25,34,7,17,2,3,8,32,51,2,2,26,45,14,26,7,19,3,8,8,21,45
2004-02-09 00:00:00.000,San Jose CA; U.S.A. ATP World Tour,HARD,2,Taylor Dent,Paul Goldstein,Taylor Dent,6-4; 6-4,R32,66,5,4,31,60,25,31,17,29,0,1,10,42,60,1,3,41,57,26,41,9,16,1,4,10,35,57
2004-02-09 00:00:00.000,San Jose CA; U.S.A. ATP World Tour,HARD,2,Robert Kendrick,Lars Burgsmuller,Robert Kendrick,6-4; 6-2,R32,65,10,2,28,47,26,28,7,19,0,1,9,33,47,1,1,39,66,21,39,13,27,7,11,9,34,66
2004-02-09 00:00:00.000,San Jose CA; U.S.A. ATP World Tour,HARD,2,Cyril Saulnier,Brian Vahaly,Cyril Saulnier,6-3; 7-6(4),R32,85,11,2,41,66,34,41,14,25,3,4,11,48,66,0,2,45,73,27,45,17,28,8,10,10,44,73
2004-02-09 00:00:00.000,San Jose CA; U.S.A. ATP World Tour,HARD,2,Robby Ginepri,Cecil Mamiit,Robby Ginepri,6-4; 6-3,R32,72,6,4,40,73,25,40,15,33,6,9,10,40,73,1,2,32,52,18,32,8,20,3,8,9,26,52
2004-02-09 00:00:00.000,San Jose CA; U.S.A. ATP World Tour,HARD,2,Vincent Spadea,Tommy Haas,Vincent Spadea,6-4; 6-2,R32,65,3,1,35,56,22,35,15,21,1,2,9,37,56,0,5,27,52,17,27,10,25,1,5,9,27,52
2004-02-09 00:00:00.000,San Jose CA; U.S.A. ATP World Tour,HARD,2,Hyung-Taik Lee,Xavier Malisse,Hyung-Taik Lee,7-6(1); 6-1,R32,75,1,0,40,60,33,40,10,20,2,3,10,43,60,6,1,28,57,17,28,15,29,3,6,9,32,57
2004-02-09 00:00:00.000,San Jose CA; U.S.A. ATP World Tour,HARD,2,Kenneth Carlsen,Jurgen Melzer,Kenneth Carlsen,6-3; 4-6; 6-3,R32,111,14,3,55,89,41,55,18,34,2,3,14,59,89,11,7,50,95,35,50,22,45,6,9,14,57,95
2004-02-09 00:00:00.000,San Jose CA; U.S.A. ATP World Tour,HARD,2,Mardy Fish,Alexander Reichel,Mardy Fish,6-1; 6-4,R32,74,5,3,32,63,24,32,19,31,6,6,9,43,63,4,4,33,57,21,33,10,24,5,8,8,31,57
2004-02-09 00:00:00.000,San Jose CA; U.S.A. ATP World Tour,HARD,2,Jan-Michael Gambill,Wayne Ferreira,Jan-Michael Gambill,6-7(12); 7-6(5); 6-1,R32,131,18,3,74,119,64,74,23,45,3,3,16,87,119,13,8,69,120,57,69,20,51,1,3,15,77,120
2004-02-09 00:00:00.000,San Jose CA; U.S.A. ATP World Tour,HARD,2,KJ Hippensteel,Dmitry Tursunov,KJ Hippensteel,7-5; 4-6; 6-3,R32,110,6,5,74,103,58,74,10,29,4,5,16,68,103,6,5,44,92,30,44,30,48,7,9,15,60,92
2004-02-09 00:00:00.000,San Jose CA; U.S.A. ATP World Tour,HARD,2,Wesley Moodie,Todd Martin,Wesley Moodie,6-4; 7-6(1),R32,81,15,1,49,65,40,49,10,16,1,1,11,50,65,8,4,48,68,39,48,4,20,0,1,11,43,68
2004-02-09 00:00:00.000,San Jose CA; U.S.A. ATP World Tour,HARD,2,Andre Agassi,Irakli Labadze,Andre Agassi,7-6(4); 6-4,R32,74,7,2,35,59,32,35,18,24,1,1,11,50,59,9,3,44,65,34,44,12,21,0,1,11,46,65
2004-02-09 00:00:00.000,San Jose CA; U.S.A. ATP World Tour,HARD,2,Andy Roddick,Kristof Vliegen,Andy Roddick,6-2; 6-3,R16,51,9,0,30,39,29,30,7,9,0,0,9,36,39,2,2,22,50,15,22,13,28,5,8,8,28,50
2004-02-09 00:00:00.000,San Jose CA; U.S.A. ATP World Tour,HARD,2,Joachim Johansson,James Blake,Joachim Johansson,6-4; 6-2,R16,56,16,4,34,51,30,34,8,17,0,0,9,38,51,3,2,40,59,25,40,11,19,6,9,9,36,59
2004-02-09 00:00:00.000,San Jose CA; U.S.A. ATP World Tour,HARD,2,Robert Kendrick,Taylor Dent,Robert Kendrick,6-4; 6-4,R16,71,7,2,36,54,30,36,12,18,0,0,10,42,54,5,4,44,75,31,44,15,31,5,7,10,46,75
2004-02-09 00:00:00.000,San Jose CA; U.S.A. ATP World Tour,HARD,2,Cyril Saulnier,Robby Ginepri,Cyril Saulnier,3-6; 7-5; 6-4,R16,113,11,7,43,92,37,43,21,49,9,12,15,58,92,6,2,51,98,38,51,23,47,8,12,16,61,98
2004-02-09 00:00:00.000,San Jose CA; U.S.A. ATP World Tour,HARD,2,Hyung-Taik Lee,Vincent Spadea,Hyung-Taik Lee,2-6; 6-4; 6-4,R16,116,1,2,66,99,42,66,15,33,4,8,14,57,99,6,0,55,81,37,55,13,26,1,5,14,50,81
2004-02-09 00:00:00.000,San Jose CA; U.S.A. ATP World Tour,HARD,2,Mardy Fish,Kenneth Carlsen,Mardy Fish,6-3; 3-6; 7-6(2),R16,130,12,2,60,109,43,60,25,49,7,10,15,68,109,5,1,53,83,40,53,16,30,0,3,15,56,83
2004-02-09 00:00:00.000,San Jose CA; U.S.A. ATP World Tour,HARD,2,Jan-Michael Gambill,KJ Hippensteel,Jan-Michael Gambill,6-3; 6-2,R16,57,4,4,30,47,26,30,9,17,0,1,9,35,47,2,1,36,55,23,36,6,19,4,8,8,29,55
2004-02-09 00:00:00.000,San Jose CA; U.S.A. ATP World Tour,HARD,2,Andre Agassi,Wesley Moodie,Andre Agassi,7-6(6); 6-4,R16,81,6,4,38,66,30,38,18,28,2,3,11,48,66,21,3,42,68,37,42,7,26,3,5,11,44,68
2004-02-09 00:00:00.000,San Jose CA; U.S.A. ATP World Tour,HARD,2,Andy Roddick,Joachim Johansson,Andy Roddick,6-3; 7-6(7),Q,66,27,1,53,74,45,53,9,21,1,1,11,54,74,15,3,37,59,28,37,17,22,2,3,10,45,59
2004-02-09 00:00:00.000,San Jose CA; U.S.A. ATP World Tour,HARD,2,Robert Kendrick,Cyril Saulnier,Robert Kendrick,7-6(6); 4-6; 6-3,Q,122,11,7,63,114,52,63,25,51,6,7,16,77,114,11,1,54,99,42,54,28,45,4,5,15,70,99
2004-02-09 00:00:00.000,San Jose CA; U.S.A. ATP World Tour,HARD,2,Mardy Fish,Hyung-Taik Lee,Mardy Fish,6-2; 6-3,Q,63,9,1,34,56,25,34,15,22,1,1,9,40,56,1,2,27,41,17,27,10,14,2,5,8,27,41
2004-02-09 00:00:00.000,San Jose CA; U.S.A. ATP World Tour,HARD,2,Andre Agassi,Jan-Michael Gambill,Andre Agassi,7-6(4); 7-5,Q,99,11,2,46,70,42,46,13,24,0,0,12,55,70,20,4,58,94,47,58,13,36,6,7,12,60,94
2004-02-09 00:00:00.000,San Jose CA; U.S.A. ATP World Tour,HARD,2,Andy Roddick,Robert Kendrick,Andy Roddick,7-6(3); 6-2,S,72,11,2,37,53,36,37,9,16,0,0,10,45,53,7,4,45,73,33,45,11,28,3,5,10,44,73
2004-02-09 00:00:00.000,San Jose CA; U.S.A. ATP World Tour,HARD,2,Mardy Fish,Andre Agassi,Mardy Fish,5-7; 6-4; 6-2,S,112,29,1,56,98,44,56,22,42,5,7,15,66,98,10,8,47,89,37,47,19,42,4,8,15,56,89
2004-02-09 00:00:00.000,San Jose CA; U.S.A. ATP World Tour,HARD,2,Andy Roddick,Mardy Fish,Andy Roddick,7-6(13); 6-4,F,96,16,1,49,69,42,49,15,20,0,0,11,57,69,17,2,46,80,37,46,19,34,4,5,11,56,80
2004-02-09 00:00:00.000,Vi±a del Mar Chile ATP World Tour,CLAY,2,Nicolas Massu,Fernando Verdasco,Nicolas Massu,6-1; 6-2,R32,57,2,4,25,45,21,25,13,20,2,2,8,34,45,1,4,24,36,15,24,2,12,2,6,7,17,36
2004-02-09 00:00:00.000,Vi±a del Mar Chile ATP World Tour,CLAY,2,Harel Levy,Frantisek Cermak,Harel Levy,6-3; 6-3,R32,69,3,0,36,58,27,36,13,22,0,0,9,40,58,2,2,40,64,25,40,9,24,5,8,9,34,64
2004-02-09 00:00:00.000,Vi±a del Mar Chile ATP World Tour,CLAY,2,Adrian Garcia,Paul Capdeville,Adrian Garcia,6-4; 6-4,R32,76,2,3,27,59,21,27,19,32,0,2,10,40,59,3,1,44,64,25,44,9,20,5,9,10,34,64
2004-02-09 00:00:00.000,Vi±a del Mar Chile ATP World Tour,CLAY,2,Fernando Gonzalez,Albert Montanes,Fernando Gonzalez,6-1; 7-5,R32,70,3,5,27,52,19,27,13,25,3,5,9,32,52,0,4,40,61,21,40,6,21,4,10,10,27,61
2004-02-09 00:00:00.000,Vi±a del Mar Chile ATP World Tour,CLAY,2,Mariano Zabaleta,David Ferrer,Mariano Zabaleta,6-4; 6-0,R32,70,3,2,37,60,30,37,9,23,7,8,8,39,60,1,0,41,57,18,41,8,16,5,10,8,26,57
2004-02-09 00:00:00.000,Vi±a del Mar Chile ATP World Tour,CLAY,2,Ruben Ramirez Hidalgo,Tomas Behrend,Ruben Ramirez Hidalgo,6-1; 3-6; 6-3,R32,95,7,0,50,83,41,50,16,33,7,8,13,57,83,4,2,34,65,29,34,13,31,2,5,12,42,65
2004-02-09 00:00:00.000,Vi±a del Mar Chile ATP World Tour,CLAY,2,Luis Horna,Guillermo Hormazabal,Luis Horna,6-4; 7-5,R32,86,5,1,50,67,35,50,10,17,3,5,11,45,67,3,5,40,75,27,40,18,35,3,7,11,45,75
2004-02-09 00:00:00.000,Vi±a del Mar Chile ATP World Tour,CLAY,2,Flavio Saretta,Hermes Gamonal,Flavio Saretta,6-2; 6-1,R32,73,1,5,19,43,17,19,12,24,1,2,7,29,43,0,3,32,52,13,32,9,20,6,12,8,22,52
2004-02-09 00:00:00.000,Vi±a del Mar Chile ATP World Tour,CLAY,2,David Sanchez,Juan Ignacio Chela,David Sanchez,6-4; 6-2,R32,73,2,1,39,57,25,39,9,18,3,5,9,34,57,1,2,30,48,17,30,6,18,3,8,9,23,48
2004-02-09 00:00:00.000,Vi±a del Mar Chile ATP World Tour,CLAY,2,Ivan Miranda,Martin Vassallo Arguello,Ivan Miranda,6-4; 6-3,R32,91,0,0,50,67,28,50,9,17,1,5,10,37,67,2,4,37,57,22,37,4,20,4,10,9,26,57
2004-02-09 00:00:00.000,Vi±a del Mar Chile ATP World Tour,CLAY,2,Jose Acasuso,Nicolas Lapentti,Jose Acasuso,7-6(5); 6-4,R32,119,5,2,39,82,30,39,19,43,6,9,11,49,82,8,2,41,75,28,41,17,34,3,7,11,45,75
2004-02-09 00:00:00.000,Vi±a del Mar Chile ATP World Tour,CLAY,2,Gaston Gaudio,Richard Gasquet,Gaston Gaudio,3-6; 6-3; 6-2,R32,108,2,6,41,76,31,41,17,35,1,4,13,48,76,6,5,51,87,34,51,12,36,2,7,13,46,87
2004-02-09 00:00:00.000,Vi±a del Mar Chile ATP World Tour,CLAY,2,Filippo Volandri,Albert Portas,Filippo Volandri,6-0; 6-4,R32,64,2,1,32,44,25,32,5,12,1,2,8,30,44,3,4,20,55,13,20,13,35,3,8,8,26,55
2004-02-09 00:00:00.000,Vi±a del Mar Chile ATP World Tour,CLAY,2,Galo Blanco,Juan Antonio Marin,Galo Blanco,6-4; 6-3,R32,88,2,4,31,58,21,31,16,27,2,4,9,37,58,2,1,26,62,14,26,16,36,5,10,10,30,62
2004-02-09 00:00:00.000,Vi±a del Mar Chile ATP World Tour,CLAY,2,Franco Squillari,Oscar Hernandez,Franco Squillari,6-4; 6-1,R32,81,0,3,29,47,24,29,11,18,0,1,9,35,47,1,2,46,65,25,46,7,19,4,8,8,32,65
2004-02-09 00:00:00.000,Vi±a del Mar Chile ATP World Tour,CLAY,2,Gustavo Kuerten,Jean-Rene Lisnard,Gustavo Kuerten,6-3; 6-3,R32,64,5,1,24,43,23,24,13,19,0,0,9,36,43,1,5,26,61,13,26,22,35,1,4,9,35,61
2004-02-09 00:00:00.000,Vi±a del Mar Chile ATP World Tour,CLAY,2,Nicolas Massu,Harel Levy,Nicolas Massu,6-2; 6-4,R16,75,5,1,26,49,20,26,17,23,1,1,9,37,49,3,0,32,47,22,32,5,15,0,3,9,27,47
2004-02-09 00:00:00.000,Vi±a del Mar Chile ATP World Tour,CLAY,2,Fernando Gonzalez,Adrian Garcia,Fernando Gonzalez,7-5; 6-1,R16,87,6,3,27,53,24,27,12,26,3,4,9,36,53,0,4,44,81,28,44,15,37,12,17,10,43,81
2004-02-09 00:00:00.000,Vi±a del Mar Chile ATP World Tour,CLAY,2,Mariano Zabaleta,Ruben Ramirez Hidalgo,Mariano Zabaleta,6-3; 4-6; 6-1,R16,125,4,5,54,98,34,54,23,44,4,7,13,57,98,3,5,42,87,21,42,25,45,9,15,13,46,87
2004-02-09 00:00:00.000,Vi±a del Mar Chile ATP World Tour,CLAY,2,Flavio Saretta,Luis Horna,Flavio Saretta,6-1; 1-0 RET,R16,41,5,0,13,24,10,13,7,11,0,0,4,17,24,1,2,11,25,4,11,7,14,1,4,4,11,25
2004-02-09 00:00:00.000,Vi±a del Mar Chile ATP World Tour,CLAY,2,David Sanchez,Ivan Miranda,David Sanchez,6-1; 6-4,R16,70,1,2,27,54,23,27,14,27,3,4,9,37,54,1,3,26,46,11,26,10,20,2,6,8,21,46
2004-02-09 00:00:00.000,Vi±a del Mar Chile ATP World Tour,CLAY,2,Gaston Gaudio,Jose Acasuso,Gaston Gaudio,6-3; 6-3,R16,71,2,0,32,46,29,32,8,14,1,1,9,37,46,3,2,24,53,16,24,15,29,0,3,9,31,53
2004-02-09 00:00:00.000,Vi±a del Mar Chile ATP World Tour,CLAY,2,Filippo Volandri,Galo Blanco,Filippo Volandri,6-2; 6-0,R16,54,2,2,30,43,24,30,7,13,2,2,7,31,43,2,2,21,42,9,21,8,21,2,7,7,17,42
2004-02-09 00:00:00.000,Vi±a del Mar Chile ATP World Tour,CLAY,2,Gustavo Kuerten,Franco Squillari,Gustavo Kuerten,6-1; 7-6(2),R16,93,7,5,48,81,33,48,18,33,7,8,10,51,81,2,1,46,74,27,46,12,28,10,13,9,39,74
2004-02-09 00:00:00.000,Vi±a del Mar Chile ATP World Tour,CLAY,2,Fernando Gonzalez,Nicolas Massu,Fernando Gonzalez,7-6(4); 6-3,Q,123,6,3,45,73,33,45,14,28,2,4,11,47,73,1,1,53,79,34,53,12,26,9,12,10,46,79
2004-02-09 00:00:00.000,Vi±a del Mar Chile ATP World Tour,CLAY,2,Flavio Saretta,Mariano Zabaleta,Flavio Saretta,6-3; 6-4,Q,94,4,2,32,57,24,32,16,25,2,3,10,40,57,2,4,37,65,25,37,13,28,9,12,9,38,65
2004-02-09 00:00:00.000,Vi±a del Mar Chile ATP World Tour,CLAY,2,David Sanchez,Gaston Gaudio,David Sanchez,7-5; 3-6; 6-2,Q,137,1,3,55,91,39,55,12,36,1,6,14,51,91,4,1,63,89,36,63,9,26,6,13,15,45,89
2004-02-09 00:00:00.000,Vi±a del Mar Chile ATP World Tour,CLAY,2,Gustavo Kuerten,Filippo Volandri,Gustavo Kuerten,6-1; 2-6; 7-6(4),Q,105,7,3,57,96,37,57,16,39,4,10,14,53,96,0,1,60,84,36,60,10,24,5,11,13,46,84
2004-02-09 00:00:00.000,Vi±a del Mar Chile ATP World Tour,CLAY,2,Fernando Gonzalez,Flavio Saretta,Fernando Gonzalez,6-2; 6-3,S,66,3,0,31,48,26,31,10,17,0,0,9,36,48,2,3,29,46,20,29,7,17,4,7,8,27,46
2004-02-09 00:00:00.000,Vi±a del Mar Chile ATP World Tour,CLAY,2,Gustavo Kuerten,David Sanchez,Gustavo Kuerten,7-6(6); 6-4,S,100,3,1,48,82,36,48,16,34,0,1,11,52,82,1,1,45,62,34,45,8,17,1,3,11,42,62
2004-02-09 00:00:00.000,Vi±a del Mar Chile ATP World Tour,CLAY,2,Fernando Gonzalez,Gustavo Kuerten,Fernando Gonzalez,7-5; 6-4,F,101,3,2,47,83,35,47,14,36,7,10,11,49,83,5,7,46,77,29,46,12,31,3,8,11,41,77
2004-02-16 00:00:00.000,Buenos Aires Argentina ATP World Tour,CLAY,2,Guillermo Coria,Luis Horna,Guillermo Coria,6-1; 6-2,R32,66,5,0,27,42,20,27,9,15,1,2,7,29,42,2,3,38,61,21,38,6,23,7,13,8,27,61
2004-02-16 00:00:00.000,Buenos Aires Argentina ATP World Tour,CLAY,2,Franco Squillari,Marc Lopez,Franco Squillari,6-0; 6-1,R32,62,5,1,19,33,15,19,6,14,0,1,6,21,33,0,2,34,57,10,34,10,23,7,14,7,20,57
2004-02-16 00:00:00.000,Buenos Aires Argentina ATP World Tour,CLAY,2,Juan Monaco,Nicolas Lapentti,Juan Monaco,7-6(2); 6-1,R32,97,1,1,30,58,23,30,16,28,1,3,9,39,58,1,3,46,75,25,46,13,29,6,11,10,38,75
2004-02-16 00:00:00.000,Buenos Aires Argentina ATP World Tour,CLAY,2,Juan Ignacio Chela,Giovanni Lapentti,Juan Ignacio Chela,7-5; 6-0,R32,80,1,0,34,61,22,34,15,27,4,6,9,37,61,1,6,38,52,16,38,5,14,3,9,9,21,52
2004-02-16 00:00:00.000,Buenos Aires Argentina ATP World Tour,CLAY,2,Nicolas Massu,Albert Montanes,Nicolas Massu,6-1; 6-3,R32,70,3,1,28,46,19,28,12,18,2,3,7,31,46,0,0,28,52,13,28,9,24,5,10,7,22,52
2004-02-16 00:00:00.000,Buenos Aires Argentina ATP World Tour,CLAY,2,Filippo Volandri,Guillermo Canas,Filippo Volandri,6-3; 4-6; 6-2,R32,113,1,1,64,86,40,64,11,22,4,8,14,51,86,0,2,49,77,26,49,14,28,2,8,13,40,77
2004-02-16 00:00:00.000,Buenos Aires Argentina ATP World Tour,CLAY,2,Richard Gasquet,Fernando Verdasco,Richard Gasquet,2-6; 7-5; 6-1,R32,122,4,3,69,101,50,69,12,32,7,9,14,62,101,3,3,58,94,38,58,18,36,5,8,13,56,94
2004-02-16 00:00:00.000,Buenos Aires Argentina ATP World Tour,CLAY,2,Agustin Calleri,Galo Blanco,Agustin Calleri,6-4; 6-2,R32,64,12,0,29,46,25,29,12,17,1,1,9,37,46,2,1,35,57,24,35,9,22,1,4,9,33,57
2004-02-16 00:00:00.000,Buenos Aires Argentina ATP World Tour,CLAY,2,Jose Acasuso,Gaston Gaudio,Jose Acasuso,6-3; 7-6(6),R32,95,4,1,35,67,22,35,20,32,1,4,11,42,67,1,1,51,71,27,51,10,20,4,8,10,37,71
2004-02-16 00:00:00.000,Buenos Aires Argentina ATP World Tour,CLAY,2,Olivier Patience,Albert Portas,Olivier Patience,6-4; 6-3,R32,71,3,1,34,53,21,34,14,19,0,2,10,35,53,2,4,36,57,22,36,8,21,4,8,9,30,57
2004-02-16 00:00:00.000,Buenos Aires Argentina ATP World Tour,CLAY,2,Flavio Saretta,Tomas Behrend,Flavio Saretta,6-4; 6-2,R32,74,3,0,26,46,21,26,10,20,1,3,9,31,46,0,3,28,54,14,28,12,26,4,9,9,26,54
2004-02-16 00:00:00.000,Buenos Aires Argentina ATP World Tour,CLAY,2,David Ferrer,Gustavo Kuerten,David Ferrer,6-3; 7-5,R32,72,1,0,49,64,35,49,11,15,1,2,11,46,64,3,0,36,59,23,36,11,23,4,7,10,34,59
2004-02-16 00:00:00.000,Buenos Aires Argentina ATP World Tour,CLAY,2,Mariano Zabaleta,Jean-Rene Lisnard,Mariano Zabaleta,6-4; 6-4,R32,88,5,0,37,52,29,37,9,15,0,1,10,38,52,1,2,40,68,27,40,14,28,7,10,10,41,68
2004-02-16 00:00:00.000,Buenos Aires Argentina ATP World Tour,CLAY,2,Oscar Hernandez,Diego Moyano,Oscar Hernandez,6-1; 4-6; 6-4,R32,139,0,0,57,83,40,57,12,26,7,10,13,52,83,0,0,59,93,34,59,17,34,5,11,14,51,93
2004-02-16 00:00:00.000,Buenos Aires Argentina ATP World Tour,CLAY,2,David Sanchez,Ruben Ramirez Hidalgo,David Sanchez,3-6; 6-0; 6-1,R32,119,2,0,47,80,27,47,21,33,7,9,11,48,80,0,7,42,82,27,42,14,40,6,12,11,41,82
2004-02-16 00:00:00.000,Buenos Aires Argentina ATP World Tour,CLAY,2,Carlos Moya,Harel Levy,Carlos Moya,6-2; 6-4,R32,67,7,4,30,56,26,30,15,26,3,3,9,41,56,1,1,31,62,19,31,17,31,7,10,9,36,62
2004-02-16 00:00:00.000,Buenos Aires Argentina ATP World Tour,CLAY,2,Guillermo Coria,Franco Squillari,Guillermo Coria,6-3; 4-6; 6-1,R16,121,4,7,63,92,46,63,10,29,7,10,13,56,92,0,5,56,88,30,56,15,32,4,10,13,45,88
2004-02-16 00:00:00.000,Buenos Aires Argentina ATP World Tour,CLAY,2,Juan Monaco,Juan Ignacio Chela,Juan Monaco,7-6(4); 6-3,R16,111,0,2,42,66,24,42,11,24,1,5,10,35,66,5,6,49,81,26,49,13,32,8,14,11,39,81
2004-02-16 00:00:00.000,Buenos Aires Argentina ATP World Tour,CLAY,2,Nicolas Massu,Filippo Volandri,Nicolas Massu,6-2; 6-4,R16,81,1,2,34,57,27,34,13,23,1,1,9,40,57,0,4,33,49,21,33,8,16,1,4,9,29,49
2004-02-16 00:00:00.000,Buenos Aires Argentina ATP World Tour,CLAY,2,Richard Gasquet,Agustin Calleri,Richard Gasquet,7-5; 6-2,R16,85,3,1,28,54,24,28,17,26,1,2,10,41,54,6,2,31,62,21,31,12,31,4,8,10,33,62
2004-02-16 00:00:00.000,Buenos Aires Argentina ATP World Tour,CLAY,2,Jose Acasuso,Olivier Patience,Jose Acasuso,3-6; 7-6(9); 6-4,R16,151,4,3,59,103,44,59,23,44,8,11,15,67,103,1,1,91,120,64,91,14,29,9,12,16,78,120
2004-02-16 00:00:00.000,Buenos Aires Argentina ATP World Tour,CLAY,2,David Ferrer,Flavio Saretta,David Ferrer,7-6(1); 3-6; 6-2,R16,139,3,4,56,90,38,56,14,34,3,7,14,52,90,6,4,46,96,32,46,18,50,2,7,15,50,96
2004-02-16 00:00:00.000,Buenos Aires Argentina ATP World Tour,CLAY,2,Mariano Zabaleta,Oscar Hernandez,Mariano Zabaleta,6-1; 6-4,R16,69,3,4,33,50,27,33,9,17,3,4,9,36,50,0,4,35,54,22,35,5,19,2,6,8,27,54
2004-02-16 00:00:00.000,Buenos Aires Argentina ATP World Tour,CLAY,2,Carlos Moya,David Sanchez,Carlos Moya,7-6(5); 1-6; 7-6(5),R16,144,10,2,67,108,45,67,17,41,7,13,16,62,108,2,3,80,120,52,80,21,40,11,14,15,73,120
2004-02-16 00:00:00.000,Buenos Aires Argentina ATP World Tour,CLAY,2,Guillermo Coria,Juan Monaco,Guillermo Coria,7-6(8); 3-6; 6-1,Q,134,1,2,58,91,43,58,12,33,3,7,14,55,91,2,2,68,97,44,68,9,29,5,10,14,53,97
2004-02-16 00:00:00.000,Buenos Aires Argentina ATP World Tour,CLAY,2,Richard Gasquet,Nicolas Massu,Richard Gasquet,6-3; 4-6; 7-5,Q,160,5,2,73,107,48,73,15,34,5,9,16,63,107,4,1,62,92,36,62,17,30,6,11,15,53,92
2004-02-16 00:00:00.000,Buenos Aires Argentina ATP World Tour,CLAY,2,Jose Acasuso,David Ferrer,Jose Acasuso,7-5; 7-6(5),Q,112,4,1,47,86,29,47,19,39,4,8,12,48,86,0,2,58,89,38,58,9,31,8,13,12,47,89
2004-02-16 00:00:00.000,Buenos Aires Argentina ATP World Tour,CLAY,2,Carlos Moya,Mariano Zabaleta,Carlos Moya,4-6; 7-6(4); 6-4,Q,152,7,2,55,98,43,55,23,43,3,5,16,66,98,2,4,77,118,53,77,21,41,8,10,16,74,118
2004-02-16 00:00:00.000,Buenos Aires Argentina ATP World Tour,CLAY,2,Guillermo Coria,Richard Gasquet,Guillermo Coria,7-6(1); 6-1,S,75,1,1,48,63,36,48,8,15,1,2,10,44,63,4,3,27,55,19,27,10,28,5,8,9,29,55
2004-02-16 00:00:00.000,Buenos Aires Argentina ATP World Tour,CLAY,2,Carlos Moya,Jose Acasuso,Carlos Moya,7-6(3); 7-5,S,117,7,5,50,90,36,50,23,40,5,6,12,59,90,5,1,41,83,29,41,22,42,6,8,12,51,83
2004-02-16 00:00:00.000,Buenos Aires Argentina ATP World Tour,CLAY,2,Guillermo Coria,Carlos Moya,Guillermo Coria,6-4; 6-1,F,72,0,0,32,40,26,32,7,8,1,1,8,33,40,1,3,39,71,23,39,14,32,7,11,9,37,71
2004-02-16 00:00:00.000,Memphis TN; U.S.A. ATP World Tour,HARD,2,Andy Roddick,Todd Martin,Andy Roddick,7-6(2); 1-6; 7-5,R32,140,17,7,70,104,52,70,13,34,11,14,15,65,104,20,4,73,116,54,73,18,43,9,11,16,72,116
2004-02-16 00:00:00.000,Memphis TN; U.S.A. ATP World Tour,HARD,2,Sebastien De Chaunac,Irakli Labadze,Sebastien De Chaunac,3-6; 6-3; 7-6(1) RET,R32,122,6,1,53,87,37,53,22,34,0,2,15,59,87,7,6,54,81,41,54,16,27,3,5,15,57,81
2004-02-16 00:00:00.000,Memphis TN; U.S.A. ATP World Tour,HARD,2,Alexander Popp,Tommy Haas,Alexander Popp,6-3; 6-3,R32,63,6,2,33,52,25,33,11,19,2,3,9,36,52,0,5,32,56,19,32,10,24,2,6,9,29,56
2004-02-16 00:00:00.000,Memphis TN; U.S.A. ATP World Tour,HARD,2,Thomas Enqvist,Vincent Spadea,Thomas Enqvist,6-4; 7-5,R32,82,9,5,36,68,28,36,11,32,1,4,11,39,68,7,6,40,67,23,40,12,27,1,6,11,35,67
2004-02-16 00:00:00.000,Memphis TN; U.S.A. ATP World Tour,HARD,2,Jan-Michael Gambill,Taylor Dent,Jan-Michael Gambill,7-6(6); 6-3,R32,77,6,1,43,63,32,43,11,20,0,2,11,43,63,5,7,50,75,35,50,11,25,6,9,10,46,75
2004-02-16 00:00:00.000,Memphis TN; U.S.A. ATP World Tour,HARD,2,Brian Baker,Antony Dupuis,Brian Baker,6-4; 7-5,R32,83,6,3,58,78,43,58,8,20,9,10,11,51,78,10,3,32,62,23,32,15,30,1,4,11,38,62
2004-02-16 00:00:00.000,Memphis TN; U.S.A. ATP World Tour,HARD,2,Jurgen Melzer,Brian Vahaly,Jurgen Melzer,6-3; 6-7(5); 7-6(4),R32,128,14,5,70,125,53,70,25,55,6,8,17,78,125,5,2,60,103,42,60,20,43,2,5,16,62,103
2004-02-16 00:00:00.000,Memphis TN; U.S.A. ATP World Tour,HARD,2,Nicolas Kiefer,Eric Taino,Nicolas Kiefer,6-4; 3-6; 6-1,R32,114,17,4,47,83,41,47,16,36,7,8,13,57,83,3,4,53,86,34,53,18,33,5,8,13,52,86
2004-02-16 00:00:00.000,Memphis TN; U.S.A. ATP World Tour,HARD,2,James Blake,Wesley Moodie,James Blake,7-6(5); 6-1,R32,63,2,1,36,56,29,36,14,20,0,0,9,43,56,7,4,38,65,29,38,13,27,1,4,10,42,65
2004-02-16 00:00:00.000,Memphis TN; U.S.A. ATP World Tour,HARD,2,Joachim Johansson,Hyung-Taik Lee,Joachim Johansson,6-4; 6-7(5); 6-2,R32,95,23,4,56,86,48,56,20,30,3,3,15,68,86,9,3,55,89,39,55,21,34,3,6,15,60,89
2004-02-16 00:00:00.000,Memphis TN; U.S.A. ATP World Tour,HARD,2,Xavier Malisse,Amer Delic,Xavier Malisse,6-4; 6-3,R32,58,10,0,32,55,23,32,17,23,3,4,10,40,55,3,0,24,47,15,24,12,23,1,4,9,27,47
2004-02-16 00:00:00.000,Memphis TN; U.S.A. ATP World Tour,HARD,2,Cyril Saulnier,Robby Ginepri,Cyril Saulnier,3-6; 7-6(3); 6-2,R32,116,8,6,56,103,42,56,27,47,10,11,14,69,103,6,1,49,96,35,49,28,47,5,7,15,63,96
2004-02-16 00:00:00.000,Memphis TN; U.S.A. ATP World Tour,HARD,2,Wayne Ferreira,Bob Bryan,Wayne Ferreira,7-6(8); 6-3,R32,72,16,1,44,67,35,44,14,23,2,3,11,49,67,5,1,46,74,33,46,13,28,4,6,10,46,74
2004-02-16 00:00:00.000,Memphis TN; U.S.A. ATP World Tour,HARD,2,Dmitry Tursunov,Christophe Rochus,Dmitry Tursunov,7-6(5); 6-3,R32,89,9,5,41,80,30,41,18,39,5,8,11,48,80,3,3,42,75,26,42,15,33,8,12,10,41,75
2004-02-16 00:00:00.000,Memphis TN; U.S.A. ATP World Tour,HARD,2,Frederic Niemeyer,Lars Burgsmuller,Frederic Niemeyer,6-2; 6-4,R32,69,20,7,35,65,32,35,13,30,4,4,9,45,65,2,5,32,64,18,32,18,32,5,8,9,36,64
2004-02-16 00:00:00.000,Memphis TN; U.S.A. ATP World Tour,HARD,2,Mardy Fish,Olivier Mutis,Mardy Fish,4-6; 6-3; 6-4,R32,87,12,2,49,79,38,49,22,30,1,2,15,60,79,8,2,49,74,36,49,15,25,1,3,14,51,74
2004-02-16 00:00:00.000,Memphis TN; U.S.A. ATP World Tour,HARD,2,Andy Roddick,Sebastien De Chaunac,Andy Roddick,6-3; 6-3,R16,66,15,1,32,43,30,32,6,11,0,0,9,36,43,6,1,42,68,28,42,11,26,3,6,9,39,68
2004-02-16 00:00:00.000,Memphis TN; U.S.A. ATP World Tour,HARD,2,Thomas Enqvist,Alexander Popp,Thomas Enqvist,2-6; 6-1; 6-4,R16,90,7,3,39,74,29,39,19,35,3,6,13,48,74,7,5,47,77,31,47,16,30,4,8,12,47,77
2004-02-16 00:00:00.000,Memphis TN; U.S.A. ATP World Tour,HARD,2,Jan-Michael Gambill,Brian Baker,Jan-Michael Gambill,6-3; 6-4,R16,59,11,0,30,48,27,30,13,18,0,0,10,40,48,2,5,35,53,28,35,5,18,2,4,9,33,53
2004-02-16 00:00:00.000,Memphis TN; U.S.A. ATP World Tour,HARD,2,Nicolas Kiefer,Jurgen Melzer,Nicolas Kiefer,7-6(5); 6-7(2); 6-3,R16,157,11,6,68,122,55,68,27,54,3,4,17,82,122,8,3,83,131,57,83,26,48,8,10,16,83,131
2004-02-16 00:00:00.000,Memphis TN; U.S.A. ATP World Tour,HARD,2,Joachim Johansson,James Blake,Joachim Johansson,6-3; 6-3,R16,46,17,3,36,46,31,36,6,10,1,1,9,37,46,7,0,27,49,16,27,13,22,1,4,9,29,49
2004-02-16 00:00:00.000,Memphis TN; U.S.A. ATP World Tour,HARD,2,Xavier Malisse,Cyril Saulnier,Xavier Malisse,7-6(4); 6-2,R16,88,5,1,37,64,27,37,17,27,3,4,10,44,64,4,3,44,79,31,44,13,35,6,9,10,44,79
2004-02-16 00:00:00.000,Memphis TN; U.S.A. ATP World Tour,HARD,2,Dmitry Tursunov,Wayne Ferreira,Dmitry Tursunov,6-4; 6-0,R16,66,9,4,32,55,24,32,10,23,3,4,8,34,55,2,1,34,63,21,34,10,29,8,13,8,31,63
2004-02-16 00:00:00.000,Memphis TN; U.S.A. ATP World Tour,HARD,2,Mardy Fish,Frederic Niemeyer,Mardy Fish,1-6; 6-3; 7-5,R16,106,3,2,58,83,38,58,14,25,4,8,14,52,83,29,10,53,95,39,53,16,42,4,8,14,55,95
2004-02-16 00:00:00.000,Memphis TN; U.S.A. ATP World Tour,HARD,2,Thomas Enqvist,Andy Roddick,Thomas Enqvist,7-6(8); 6-3,Q,78,9,3,42,73,38,42,15,31,3,3,11,53,73,17,7,42,71,32,42,14,29,4,5,10,46,71
2004-02-16 00:00:00.000,Memphis TN; U.S.A. ATP World Tour,HARD,2,Nicolas Kiefer,Jan-Michael Gambill,Nicolas Kiefer,6-3; 6-4,Q,72,9,4,32,48,31,32,9,16,0,0,10,40,48,8,6,37,66,29,37,10,29,8,10,9,39,66
2004-02-16 00:00:00.000,Memphis TN; U.S.A. ATP World Tour,HARD,2,Joachim Johansson,Xavier Malisse,Joachim Johansson,6-4; 7-5,Q,62,15,4,42,58,39,42,6,16,0,0,11,45,58,10,4,38,67,30,38,12,29,5,7,11,42,67
2004-02-16 00:00:00.000,Memphis TN; U.S.A. ATP World Tour,HARD,2,Mardy Fish,Dmitry Tursunov,Mardy Fish,6-3; 4-6; 6-4,Q,110,18,4,49,90,41,49,21,41,2,3,15,62,90,2,5,34,84,23,34,32,50,4,6,14,55,84
2004-02-16 00:00:00.000,Memphis TN; U.S.A. ATP World Tour,HARD,2,Nicolas Kiefer,Thomas Enqvist,Nicolas Kiefer,6-3; 6-3,S,78,6,2,31,52,24,31,13,21,3,4,9,37,52,7,6,36,62,25,36,7,26,2,6,9,32,62
2004-02-16 00:00:00.000,Memphis TN; U.S.A. ATP World Tour,HARD,2,Joachim Johansson,Mardy Fish,Joachim Johansson,6-2; 6-4,S,53,15,2,31,44,28,31,8,13,0,0,9,36,44,8,1,29,47,22,29,8,18,5,8,9,30,47
2004-02-16 00:00:00.000,Memphis TN; U.S.A. ATP World Tour,HARD,2,Joachim Johansson,Nicolas Kiefer,Joachim Johansson,7-6(5); 6-3,F,94,8,7,45,67,40,45,10,22,1,1,11,50,67,10,6,40,72,32,40,16,32,6,7,10,48,72
2004-02-16 00:00:00.000,Rotterdam The Netherlands ATP World Tour,HARD,2,Roger Federer,Arnaud Clement,Roger Federer,6-4; 6-3,R32,74,5,0,32,49,29,32,11,17,0,0,10,40,49,4,1,39,73,24,39,20,34,2,4,9,44,73
2004-02-16 00:00:00.000,Rotterdam The Netherlands ATP World Tour,HARD,2,Andrei Pavel,Mikhail Youzhny,Andrei Pavel,4-6; 7-6(7); 6-2,R32,121,3,2,51,83,40,51,19,32,1,3,15,59,83,9,4,69,109,46,69,17,40,6,9,15,63,109
2004-02-16 00:00:00.000,Rotterdam The Netherlands ATP World Tour,HARD,2,Tomas Cakl,Jonas Bjorkman,Tomas Cakl,7-6(2); 7-6(8),R32,110,8,6,60,109,42,60,26,49,8,10,12,68,109,13,7,48,90,38,48,20,42,3,5,12,58,90
2004-02-16 00:00:00.000,Rotterdam The Netherlands ATP World Tour,HARD,2,Tim Henman,Tommy Robredo,Tim Henman,7-5; 6-2,R32,92,3,1,34,64,27,34,19,30,1,1,10,46,64,3,1,42,74,27,42,15,32,6,9,10,42,74
2004-02-16 00:00:00.000,Rotterdam The Netherlands ATP World Tour,HARD,2,Rainer Schuettler,Stefan Koubek,Rainer Schuettler,6-3; 6-2,R32,63,4,3,21,45,18,21,12,24,1,2,8,30,45,0,4,43,62,21,43,7,19,2,7,9,28,62
2004-02-16 00:00:00.000,Rotterdam The Netherlands ATP World Tour,HARD,2,Radek Stepanek,Olivier Rochus,Radek Stepanek,5-7; 6-2; 6-2,R32,126,10,5,61,90,46,61,12,29,3,5,14,58,90,0,9,59,107,35,59,25,48,5,10,14,60,107
2004-02-16 00:00:00.000,Rotterdam The Netherlands ATP World Tour,HARD,2,Thomas Johansson,Thierry Ascione,Thomas Johansson,6-3; 6-1,R32,64,7,2,26,52,23,26,15,26,4,4,8,38,52,5,1,25,48,16,25,8,23,1,5,8,24,48
2004-02-16 00:00:00.000,Rotterdam The Netherlands ATP World Tour,HARD,2,Lleyton Hewitt,Fernando Gonzalez,Lleyton Hewitt,6-2; 6-1,R32,55,7,2,25,43,21,25,13,18,1,1,8,34,43,1,3,28,52,17,28,7,24,9,13,7,24,52
2004-02-16 00:00:00.000,Rotterdam The Netherlands ATP World Tour,HARD,2,Jarkko Nieminen,Martin Verkerk,Jarkko Nieminen,7-6(4); 6-7(4); 6-4,R32,129,8,2,73,99,57,73,16,26,0,1,17,73,99,21,5,60,100,54,60,18,40,0,2,17,72,100
2004-02-16 00:00:00.000,Rotterdam The Netherlands ATP World Tour,HARD,2,Albert Costa,Ivo Heuberger,Albert Costa,6-4; 3-0 RET,R32,69,5,1,13,33,11,13,11,20,0,1,6,22,33,9,2,27,56,19,27,9,29,5,9,7,28,56
2004-02-16 00:00:00.000,Rotterdam The Netherlands ATP World Tour,HARD,2,Max Mirnyi,Sargis Sargsian,Max Mirnyi,6-7(3); 7-6(5); 6-1,R32,142,11,0,65,104,47,65,25,39,3,4,16,72,104,5,2,66,108,47,66,24,42,5,8,15,71,108
2004-02-16 00:00:00.000,Rotterdam The Netherlands ATP World Tour,HARD,2,Nikolay Davydenko,Paradorn Srichaphan,Nikolay Davydenko,6-4; 6-3,R32,86,1,2,42,64,26,42,11,22,7,9,9,37,64,3,5,32,64,19,32,12,32,4,9,10,31,64
2004-02-16 00:00:00.000,Rotterdam The Netherlands ATP World Tour,HARD,2,Sjeng Schalken,Goran Ivanisevic,Sjeng Schalken,6-3; 6-2,R32,53,2,1,33,43,28,33,8,10,0,0,9,36,43,9,5,28,49,18,28,10,21,2,5,8,28,49
2004-02-16 00:00:00.000,Rotterdam The Netherlands ATP World Tour,HARD,2,Raemon Sluiter,Alex Corretja,Raemon Sluiter,6-4; 6-2,R32,89,12,1,28,54,24,28,14,26,5,6,9,38,54,1,4,45,77,25,45,14,32,8,12,9,39,77
2004-02-16 00:00:00.000,Rotterdam The Netherlands ATP World Tour,HARD,2,John van Lottum,Karol Kucera,John van Lottum,6-2; 7-6(4),R32,91,6,3,42,67,34,42,13,25,4,5,10,47,67,7,4,39,70,28,39,13,31,4,7,10,41,70
2004-02-16 00:00:00.000,Rotterdam The Netherlands ATP World Tour,HARD,2,Juan Carlos Ferrero,Dennis van Scheppingen,Juan Carlos Ferrero,6-3; 7-6(5),R32,84,7,2,34,63,25,34,20,29,1,2,11,45,63,3,3,38,68,26,38,14,30,4,6,10,40,68
2004-02-16 00:00:00.000,Rotterdam The Netherlands ATP World Tour,HARD,2,Roger Federer,Andrei Pavel,Roger Federer,7-6(2); 7-5,R16,96,4,4,55,85,44,55,13,30,3,4,12,57,85,1,2,47,84,30,47,23,37,6,8,12,53,84
2004-02-16 00:00:00.000,Rotterdam The Netherlands ATP World Tour,HARD,2,Tim Henman,Tomas Cakl,Tim Henman,6-2; 6-4,R16,64,8,3,30,51,25,30,13,21,4,4,9,38,51,1,2,24,54,14,24,18,30,5,8,9,32,54
2004-02-16 00:00:00.000,Rotterdam The Netherlands ATP World Tour,HARD,2,Rainer Schuettler,Radek Stepanek,Rainer Schuettler,6-3; 6-4,R16,83,10,3,44,66,32,44,13,22,7,8,10,45,66,9,2,39,60,27,39,7,21,2,5,9,34,60
2004-02-16 00:00:00.000,Rotterdam The Netherlands ATP World Tour,HARD,2,Lleyton Hewitt,Thomas Johansson,Lleyton Hewitt,7-6(6); 7-6(3),R16,111,13,4,42,93,32,42,27,51,2,4,12,59,93,12,1,41,75,33,41,18,34,2,4,12,51,75
2004-02-16 00:00:00.000,Rotterdam The Netherlands ATP World Tour,HARD,2,Jarkko Nieminen,Albert Costa,Jarkko Nieminen,6-2; 6-1,R16,65,2,1,27,42,23,27,8,15,2,2,7,31,42,3,2,26,48,15,26,7,22,1,6,8,22,48
2004-02-16 00:00:00.000,Rotterdam The Netherlands ATP World Tour,HARD,2,Max Mirnyi,Nikolay Davydenko,Max Mirnyi,7-6(3); 7-6(1),R16,104,10,2,60,89,43,60,17,29,7,9,12,60,89,1,1,64,78,44,64,6,14,4,6,12,50,78
2004-02-16 00:00:00.000,Rotterdam The Netherlands ATP World Tour,HARD,2,Raemon Sluiter,Sjeng Schalken,Raemon Sluiter,6-3; 6-4,R16,72,11,2,36,54,30,36,12,18,0,0,10,42,54,2,1,56,65,31,56,6,9,5,7,9,37,65
2004-02-16 00:00:00.000,Rotterdam The Netherlands ATP World Tour,HARD,2,Juan Carlos Ferrero,John van Lottum,Juan Carlos Ferrero,7-5; 5-7; 7-6(5),R16,163,12,2,68,109,52,68,25,41,4,5,18,77,109,9,4,66,119,50,66,29,53,10,11,18,79,119
2004-02-16 00:00:00.000,Rotterdam The Netherlands ATP World Tour,HARD,2,Tim Henman,Roger Federer,Tim Henman,6-3; 7-6(9),Q,98,6,5,44,76,35,44,15,32,3,5,11,50,76,2,3,45,75,27,45,17,30,5,8,10,44,75
2004-02-16 00:00:00.000,Rotterdam The Netherlands ATP World Tour,HARD,2,Lleyton Hewitt,Rainer Schuettler,Lleyton Hewitt,7-6(5); 6-3,Q,96,5,4,34,71,28,34,18,37,1,3,11,46,71,5,5,35,67,24,35,13,32,4,7,10,37,67
2004-02-16 00:00:00.000,Rotterdam The Netherlands ATP World Tour,HARD,2,Max Mirnyi,Jarkko Nieminen,Max Mirnyi,6-4; 7-6(3),Q,90,9,2,57,77,43,57,10,20,4,4,11,53,77,3,4,49,83,32,49,20,34,1,2,11,52,83
2004-02-16 00:00:00.000,Rotterdam The Netherlands ATP World Tour,HARD,2,Juan Carlos Ferrero,Raemon Sluiter,Juan Carlos Ferrero,1-6; 6-4; 7-6(10),Q,123,8,2,57,89,44,57,20,32,2,4,14,64,89,15,3,62,104,51,62,22,42,3,4,15,73,104
2004-02-16 00:00:00.000,Rotterdam The Netherlands ATP World Tour,HARD,2,Lleyton Hewitt,Tim Henman,Lleyton Hewitt,6-3; 6-3,S,71,4,2,25,45,22,25,11,20,0,1,9,33,45,3,2,30,58,18,30,11,28,2,6,9,29,58
2004-02-16 00:00:00.000,Rotterdam The Netherlands ATP World Tour,HARD,2,Juan Carlos Ferrero,Max Mirnyi,Juan Carlos Ferrero,6-7(2); 6-3; 7-6(4),S,143,4,1,75,116,52,75,28,41,6,7,17,80,116,15,7,72,111,57,72,18,39,5,7,16,75,111
2004-02-16 00:00:00.000,Rotterdam The Netherlands ATP World Tour,HARD,2,Lleyton Hewitt,Juan Carlos Ferrero,Lleyton Hewitt,6-7(1); 7-5; 6-4,F,162,6,5,60,112,49,60,27,52,4,5,17,76,112,6,0,84,114,58,84,16,30,6,9,17,74,114
2004-02-23 00:00:00.000,Costa Do Sauipe Brasil ATP World Tour,CLAY,2,Tomas Behrend,Carlos Moya,Tomas Behrend,6-3; 6-3,R32,74,4,2,41,60,30,41,12,19,4,5,9,42,60,3,3,30,62,17,30,15,32,4,8,9,32,62
2004-02-23 00:00:00.000,Costa Do Sauipe Brasil ATP World Tour,CLAY,2,Ruben Ramirez Hidalgo,Harel Levy,Ruben Ramirez Hidalgo,6-4; 7-6(3),R32,94,2,4,33,68,25,33,20,35,1,3,11,45,68,5,1,39,77,28,39,18,38,6,9,11,46,77
2004-02-23 00:00:00.000,Costa Do Sauipe Brasil ATP World Tour,CLAY,2,Jose Acasuso,Christophe Rochus,Jose Acasuso,6-3; 6-4,R32,73,5,1,31,57,25,31,15,26,3,4,10,40,57,0,1,29,51,17,29,11,22,3,6,9,28,51
2004-02-23 00:00:00.000,Costa Do Sauipe Brasil ATP World Tour,CLAY,2,Filippo Volandri,Felix Mantilla,Filippo Volandri,6-2; 6-2,R32,66,2,1,28,43,19,28,11,15,3,4,8,30,43,2,4,29,56,20,29,7,27,5,10,8,27,56
2004-02-23 00:00:00.000,Costa Do Sauipe Brasil ATP World Tour,CLAY,2,Gustavo Kuerten,Oscar Hernandez,Gustavo Kuerten,3-6; 6-2; 6-3,R32,130,9,2,50,101,40,50,25,51,8,9,13,65,101,2,1,46,79,29,46,18,33,4,7,13,47,79
2004-02-23 00:00:00.000,Costa Do Sauipe Brasil ATP World Tour,CLAY,2,Richard Gasquet,Franco Ferreiro,Richard Gasquet,6-0; 7-6(5),R32,104,3,0,28,55,20,28,16,27,1,3,9,36,55,2,2,36,61,19,36,11,25,6,11,9,30,61
2004-02-23 00:00:00.000,Costa Do Sauipe Brasil ATP World Tour,CLAY,2,Franco Squillari,Jean-Rene Lisnard,Franco Squillari,6-2; 7-5,R32,85,2,6,30,63,22,30,17,33,3,5,10,39,63,3,7,37,59,21,37,7,22,3,8,10,28,59
2004-02-23 00:00:00.000,Costa Do Sauipe Brasil ATP World Tour,CLAY,2,Gaston Gaudio,Ricardo Mello,Gaston Gaudio,6-2; 6-4,R32,89,3,3,34,54,28,34,11,20,2,2,9,39,54,2,4,30,62,20,30,15,32,6,9,9,35,62
2004-02-23 00:00:00.000,Costa Do Sauipe Brasil ATP World Tour,CLAY,2,Juan Ignacio Chela,Flavio Saretta,Juan Ignacio Chela,6-2; 6-2,R32,79,0,1,28,46,21,28,11,18,1,2,8,32,46,1,2,30,55,16,30,10,25,6,11,8,26,55
2004-02-23 00:00:00.000,Costa Do Sauipe Brasil ATP World Tour,CLAY,2,David Ferrer,Nicolas Lapentti,David Ferrer,6-4; 5-2 RET,R32,83,1,1,32,53,20,32,12,21,2,4,8,32,53,2,2,26,63,15,26,16,37,6,11,9,31,63
2004-02-23 00:00:00.000,Costa Do Sauipe Brasil ATP World Tour,CLAY,2,Fernando Verdasco,Guillermo Canas,Fernando Verdasco,6-1; 1-0 RET,R32,50,5,1,21,28,13,21,5,7,4,4,4,18,28,0,2,20,34,10,20,5,14,1,4,4,15,34
2004-02-23 00:00:00.000,Costa Do Sauipe Brasil ATP World Tour,CLAY,2,Agustin Calleri,Albert Portas,Agustin Calleri,6-1; 6-3,R32,66,5,3,25,48,23,25,12,23,2,2,8,35,48,4,7,35,65,24,35,11,30,7,11,8,35,65
2004-02-23 00:00:00.000,Costa Do Sauipe Brasil ATP World Tour,CLAY,2,Albert Montanes,Mariano Zabaleta,Albert Montanes,6-4; 6-1,R32,65,4,3,31,49,27,31,10,18,1,1,9,37,49,3,5,26,51,21,26,8,25,4,7,8,29,51
2004-02-23 00:00:00.000,Costa Do Sauipe Brasil ATP World Tour,CLAY,2,Galo Blanco,David Sanchez,Galo Blanco,6-3; 7-6(5),R32,101,4,1,38,65,27,38,16,27,0,2,11,43,65,1,2,41,72,26,41,17,31,3,6,10,43,72
2004-02-23 00:00:00.000,Costa Do Sauipe Brasil ATP World Tour,CLAY,2,Luis Horna,Pedro Braga,Luis Horna,6-3; 6-2,R32,73,7,3,28,49,20,28,11,21,1,2,8,31,49,4,1,32,53,18,32,7,21,1,6,9,25,53
2004-02-23 00:00:00.000,Costa Do Sauipe Brasil ATP World Tour,CLAY,2,Juan Monaco,Nicolas Massu,Juan Monaco,6-4; 6-2,R32,103,1,2,41,60,27,41,11,19,2,3,9,38,60,3,2,35,60,20,35,12,25,5,9,9,32,60
2004-02-23 00:00:00.000,Costa Do Sauipe Brasil ATP World Tour,CLAY,2,Tomas Behrend,Ruben Ramirez Hidalgo,Tomas Behrend,6-2; 6-2,R16,82,2,4,27,53,22,27,16,26,3,3,8,38,53,0,1,27,53,14,27,10,26,6,10,8,24,53
2004-02-23 00:00:00.000,Costa Do Sauipe Brasil ATP World Tour,CLAY,2,Jose Acasuso,Filippo Volandri,Jose Acasuso,7-6(4); 6-2,R16,95,8,0,39,62,32,39,13,23,3,4,10,45,62,1,4,59,83,40,59,5,24,8,11,10,45,83
2004-02-23 00:00:00.000,Costa Do Sauipe Brasil ATP World Tour,CLAY,2,Gustavo Kuerten,Richard Gasquet,Gustavo Kuerten,7-6(3); 6-3,R16,89,4,4,38,68,33,38,17,30,3,4,11,50,68,0,2,34,59,25,34,14,25,1,3,10,39,59
2004-02-23 00:00:00.000,Costa Do Sauipe Brasil ATP World Tour,CLAY,2,Franco Squillari,Gaston Gaudio,Franco Squillari,7-6(3); 6-3,R16,102,4,7,34,73,24,34,18,39,6,10,11,42,73,0,2,37,66,24,37,9,29,5,10,10,33,66
2004-02-23 00:00:00.000,Costa Do Sauipe Brasil ATP World Tour,CLAY,2,Juan Ignacio Chela,David Ferrer,Juan Ignacio Chela,6-2; 6-4,R16,74,0,2,33,54,22,33,10,21,2,5,9,32,54,0,0,30,52,12,30,9,22,2,8,9,21,52
2004-02-23 00:00:00.000,Costa Do Sauipe Brasil ATP World Tour,CLAY,2,Agustin Calleri,Fernando Verdasco,Agustin Calleri,6-4; 6-4,R16,98,6,1,35,60,28,35,16,25,2,2,10,44,60,3,5,36,66,29,36,11,30,5,7,10,40,66
2004-02-23 00:00:00.000,Costa Do Sauipe Brasil ATP World Tour,CLAY,2,Galo Blanco,Albert Montanes,Galo Blanco,6-2; 7-6(4),R16,97,4,6,42,73,31,42,19,31,7,7,10,50,73,3,1,31,56,21,31,16,25,0,2,10,37,56
2004-02-23 00:00:00.000,Costa Do Sauipe Brasil ATP World Tour,CLAY,2,Luis Horna,Juan Monaco,Luis Horna,6-4; 6-1,R16,74,2,2,30,48,20,30,11,18,1,3,8,31,48,1,1,40,54,24,40,1,14,7,13,9,25,54
2004-02-23 00:00:00.000,Costa Do Sauipe Brasil ATP World Tour,CLAY,2,Jose Acasuso,Tomas Behrend,Jose Acasuso,0-6; 6-2; 6-4,Q,105,5,5,37,76,28,37,17,39,2,5,12,45,76,8,5,46,76,31,46,16,30,7,10,12,47,76
2004-02-23 00:00:00.000,Costa Do Sauipe Brasil ATP World Tour,CLAY,2,Gustavo Kuerten,Franco Squillari,Gustavo Kuerten,3-6; 7-5; 7-5,Q,147,4,4,56,99,43,56,17,43,4,7,16,60,99,9,4,48,90,40,48,19,42,1,5,17,59,90
2004-02-23 00:00:00.000,Costa Do Sauipe Brasil ATP World Tour,CLAY,2,Agustin Calleri,Juan Ignacio Chela,Agustin Calleri,6-3; 3-6; 6-3,Q,139,6,6,62,104,42,62,17,42,9,13,14,59,104,2,3,51,80,37,51,7,29,5,10,13,44,80
2004-02-23 00:00:00.000,Costa Do Sauipe Brasil ATP World Tour,CLAY,2,Luis Horna,Galo Blanco,Luis Horna,6-1; 7-6(5),Q,75,5,2,34,51,25,34,12,17,0,2,9,37,51,4,1,33,56,19,33,10,23,0,5,10,29,56
2004-02-23 00:00:00.000,Costa Do Sauipe Brasil ATP World Tour,CLAY,2,Gustavo Kuerten,Jose Acasuso,Gustavo Kuerten,6-4; 6-3,S,78,8,1,24,49,19,24,15,25,1,3,9,34,49,2,5,23,68,15,23,20,45,7,12,10,35,68
2004-02-23 00:00:00.000,Costa Do Sauipe Brasil ATP World Tour,CLAY,2,Agustin Calleri,Luis Horna,Agustin Calleri,6-4; 5-7; 6-1,S,146,19,4,52,93,38,52,20,41,6,9,14,58,93,8,4,62,103,39,62,15,41,8,14,15,54,103
2004-02-23 00:00:00.000,Costa Do Sauipe Brasil ATP World Tour,CLAY,2,Gustavo Kuerten,Agustin Calleri,Gustavo Kuerten,3-6; 6-2; 6-3,F,115,8,3,41,72,34,41,15,31,4,6,13,49,72,8,1,39,68,28,39,14,29,3,7,13,42,68
2004-02-23 00:00:00.000,Marseille France ATP World Tour,HARD,2,Gregory Carraz,Juan Carlos Ferrero,Gregory Carraz,7-6(2); 6-7(3); 6-3,R32,133,27,4,64,103,50,64,25,39,5,6,17,75,103,12,0,69,111,51,69,23,42,6,8,16,74,111
2004-02-23 00:00:00.000,Marseille France ATP World Tour,HARD,2,Robin Soderling,Thomas Enqvist,Robin Soderling,7-6(4); 7-6(1),R32,88,20,2,56,85,45,56,13,29,3,4,12,58,85,10,3,34,71,28,34,19,37,0,1,12,47,71
2004-02-23 00:00:00.000,Marseille France ATP World Tour,HARD,2,Jarkko Nieminen,Nicolas Escude,Jarkko Nieminen,4-6; 6-4; 7-6(2),R32,152,3,4,82,120,54,82,21,38,8,10,16,75,120,10,3,67,104,48,67,18,37,2,4,16,66,104
2004-02-23 00:00:00.000,Marseille France ATP World Tour,HARD,2,Fernando Gonzalez,Karol Kucera,Fernando Gonzalez,4-6; 7-6(5) RET,R32,105,9,3,46,69,31,46,14,23,3,6,11,45,69,9,4,54,84,37,54,16,30,3,5,11,53,84
2004-02-23 00:00:00.000,Marseille France ATP World Tour,HARD,2,Alberto Martin,Paradorn Srichaphan,Alberto Martin,1-6; 6-3; 6-2,R32,102,1,2,57,82,36,57,12,25,4,7,12,48,82,6,2,42,73,28,42,14,31,3,7,12,42,73
2004-02-23 00:00:00.000,Marseille France ATP World Tour,HARD,2,Sargis Sargsian,Fabrice Santoro,Sargis Sargsian,7-5; 7-6(4),R32,106,9,9,50,80,39,50,14,30,3,5,12,53,80,3,0,44,79,28,44,17,35,3,6,12,45,79
2004-02-23 00:00:00.000,Marseille France ATP World Tour,HARD,2,Olivier Rochus,Karol Beck,Olivier Rochus,3-6; 7-6(5); 6-1,R32,118,2,2,57,95,41,57,23,38,4,5,13,64,95,15,4,55,92,47,55,11,37,1,4,15,58,92
2004-02-23 00:00:00.000,Marseille France ATP World Tour,HARD,2,Arnaud Clement,Goran Ivanisevic,Arnaud Clement,6-2; 6-7(4); 6-4,R32,111,14,3,57,87,49,57,18,30,4,4,15,67,87,15,5,61,94,48,61,16,33,6,9,15,64,94
2004-02-23 00:00:00.000,Marseille France ATP World Tour,HARD,2,Albert Costa,Hicham Arazi,Albert Costa,7-6(6); 7-6(2),R32,126,12,1,45,79,36,45,21,34,1,2,12,57,79,8,1,52,84,38,52,16,32,1,2,12,54,84
2004-02-23 00:00:00.000,Marseille France ATP World Tour,HARD,2,Dominik Hrbaty,Nicolas Mahut,Dominik Hrbaty,6-3; 7-5,R32,66,10,0,36,56,29,36,14,20,2,3,11,43,56,13,5,36,70,27,36,12,34,3,6,10,39,70
2004-02-23 00:00:00.000,Marseille France ATP World Tour,HARD,2,Cyril Saulnier,Julian Knowle,Cyril Saulnier,6-1; 6-3,R32,66,11,3,24,41,20,24,12,17,0,0,8,32,41,4,3,35,56,20,35,8,21,2,6,8,28,56
2004-02-23 00:00:00.000,Marseille France ATP World Tour,HARD,2,Max Mirnyi,Andrei Pavel,Max Mirnyi,4-6; 7-6(5); 7-5,R32,123,14,7,67,99,54,67,17,32,4,6,17,71,99,9,0,61,105,47,61,27,44,5,7,17,74,105
2004-02-23 00:00:00.000,Marseille France ATP World Tour,HARD,2,Marat Safin,Florian Mayer,Marat Safin,6-3; 6-4,R32,67,14,2,30,54,27,30,15,24,0,0,10,42,54,3,0,38,58,25,38,10,20,2,4,9,35,58
2004-02-23 00:00:00.000,Marseille France ATP World Tour,HARD,2,Jonas Bjorkman,Raemon Sluiter,Jonas Bjorkman,7-5; 6-3,R32,90,6,5,45,83,28,45,18,38,5,8,11,46,83,7,1,32,59,19,32,10,27,4,9,10,29,59
2004-02-23 00:00:00.000,Marseille France ATP World Tour,HARD,2,Marc Rosset,Davide Sanguinetti,Marc Rosset,6-1; 7-6(4),R32,77,12,1,29,52,25,29,17,23,0,1,10,42,52,2,2,45,72,34,45,7,27,5,8,9,41,72
2004-02-23 00:00:00.000,Marseille France ATP World Tour,HARD,2,Guillermo Coria,Nikolay Davydenko,Guillermo Coria,7-6(2); 6-3,R32,100,2,2,50,73,37,50,14,23,5,5,11,51,73,4,1,44,68,31,44,13,24,1,2,10,44,68
2004-02-23 00:00:00.000,Marseille France ATP World Tour,HARD,2,Robin Soderling,Gregory Carraz,Robin Soderling,6-3; 6-4,R16,52,20,2,32,47,29,32,11,15,0,0,10,40,47,10,4,36,51,26,36,6,15,3,5,9,32,51
2004-02-23 00:00:00.000,Marseille France ATP World Tour,HARD,2,Fernando Gonzalez,Jarkko Nieminen,Fernando Gonzalez,6-2; 6-3,R16,65,4,4,35,63,23,35,12,28,6,8,9,35,63,1,2,31,49,16,31,6,18,6,11,8,22,49
2004-02-23 00:00:00.000,Marseille France ATP World Tour,HARD,2,Alberto Martin,Sargis Sargsian,Alberto Martin,6-3; 6-3,R16,82,0,2,45,67,32,45,13,22,7,7,9,45,67,1,2,32,57,22,32,11,25,2,5,9,33,57
2004-02-23 00:00:00.000,Marseille France ATP World Tour,HARD,2,Arnaud Clement,Olivier Rochus,Arnaud Clement,7-6(8); 7-6(1),R16,125,16,2,46,80,40,46,17,34,1,3,12,57,80,1,2,58,94,39,58,19,36,6,8,12,58,94
2004-02-23 00:00:00.000,Marseille France ATP World Tour,HARD,2,Dominik Hrbaty,Albert Costa,Dominik Hrbaty,7-5; 4-6; 7-6(5),R16,155,14,1,70,108,55,70,22,38,4,5,17,77,108,15,4,65,112,48,65,25,47,6,7,17,73,112
2004-02-23 00:00:00.000,Marseille France ATP World Tour,HARD,2,Max Mirnyi,Cyril Saulnier,Max Mirnyi,6-4; 6-4,R16,66,10,0,32,56,26,32,16,24,1,1,10,42,56,3,3,28,55,21,28,16,27,1,3,10,37,55
2004-02-23 00:00:00.000,Marseille France ATP World Tour,HARD,2,Jonas Bjorkman,Marat Safin,Jonas Bjorkman,7-6(5); 7-5,R16,90,4,1,35,62,33,35,20,27,0,0,12,53,62,9,0,48,72,37,48,15,24,3,4,12,52,72
2004-02-23 00:00:00.000,Marseille France ATP World Tour,HARD,2,Marc Rosset,Guillermo Coria,Marc Rosset,7-6(2); 6-1,R16,83,17,4,43,63,39,43,8,20,2,2,10,47,63,3,3,46,71,31,46,11,25,5,7,9,42,71
2004-02-23 00:00:00.000,Marseille France ATP World Tour,HARD,2,Robin Soderling,Fernando Gonzalez,Robin Soderling,7-6(5); 6-3,Q,84,12,1,43,73,31,43,17,30,4,5,10,48,73,10,4,36,68,29,36,14,32,0,3,11,43,68
2004-02-23 00:00:00.000,Marseille France ATP World Tour,HARD,2,Arnaud Clement,Alberto Martin,Arnaud Clement,6-3; 6-2,Q,72,8,3,35,55,28,35,9,20,4,5,9,37,55,5,3,24,46,17,24,8,22,1,5,8,25,46
2004-02-23 00:00:00.000,Marseille France ATP World Tour,HARD,2,Dominik Hrbaty,Max Mirnyi,Dominik Hrbaty,6-3; 7-6(10),Q,88,3,0,61,76,48,61,10,15,4,4,11,58,76,14,1,53,74,40,53,11,21,1,2,10,51,74
2004-02-23 00:00:00.000,Marseille France ATP World Tour,HARD,2,Jonas Bjorkman,Marc Rosset,Jonas Bjorkman,7-5; 6-3,Q,76,8,1,45,69,36,45,12,24,0,1,11,48,69,9,1,31,52,24,31,9,21,3,6,10,33,52
2004-02-23 00:00:00.000,Marseille France ATP World Tour,HARD,2,Robin Soderling,Arnaud Clement,Robin Soderling,6-3; 6-3,S,71,8,1,36,57,27,36,11,21,5,6,9,38,57,10,2,27,52,20,27,7,25,5,9,9,27,52
2004-02-23 00:00:00.000,Marseille France ATP World Tour,HARD,2,Dominik Hrbaty,Jonas Bjorkman,Dominik Hrbaty,7-6(9); 6-3,S,91,4,0,44,68,38,44,15,24,1,1,11,53,68,11,1,50,76,40,50,10,26,6,7,10,50,76
2004-02-23 00:00:00.000,Marseille France ATP World Tour,HARD,2,Dominik Hrbaty,Robin Soderling,Dominik Hrbaty,4-6; 6-4; 6-4,F,100,15,1,60,84,51,60,11,24,3,4,15,62,84,17,2,51,88,41,51,20,37,2,4,15,61,88
2004-03-01 00:00:00.000,Acapulco Mexico ATP World Tour,CLAY,2,Carlos Moya,David Sanchez,Carlos Moya,6-3; 6-3,R32,68,4,5,34,61,29,34,13,27,3,3,9,42,61,3,0,39,60,27,39,8,21,3,6,9,35,60
2004-03-01 00:00:00.000,Acapulco Mexico ATP World Tour,CLAY,2,Richard Gasquet,Christophe Rochus,Richard Gasquet,7-6(4); 3-6; 6-3,R32,119,10,7,53,93,39,53,18,40,5,9,15,57,93,4,2,58,100,42,58,18,42,5,9,15,60,100
2004-03-01 00:00:00.000,Acapulco Mexico ATP World Tour,CLAY,2,Stefan Koubek,Harel Levy,Stefan Koubek,3-6; 7-5; 6-4,R32,118,6,3,56,89,44,56,12,33,4,9,16,56,89,6,1,53,95,36,53,19,42,8,13,15,55,95
2004-03-01 00:00:00.000,Acapulco Mexico ATP World Tour,CLAY,2,Filippo Volandri,Galo Blanco,Filippo Volandri,7-5; 4-6; 7-5,R32,159,1,4,88,118,56,88,18,30,7,11,17,74,118,9,2,51,108,33,51,33,57,6,11,17,66,108
2004-03-01 00:00:00.000,Acapulco Mexico ATP World Tour,CLAY,2,Luis Horna,Agustin Calleri,Luis Horna,7-6(5); 6-4,R32,101,3,3,40,68,31,40,15,28,1,3,11,46,68,17,3,45,78,33,45,15,33,7,10,11,48,78
2004-03-01 00:00:00.000,Acapulco Mexico ATP World Tour,CLAY,2,Oscar Hernandez,Dick Norman,Oscar Hernandez,6-4; 3-6; 7-6(6),R32,29,11,4,60,100,45,60,21,40,2,4,15,66,100,14,7,64,96,51,64,15,32,3,5,16,66,96
2004-03-01 00:00:00.000,Acapulco Mexico ATP World Tour,CLAY,2,David Ferrer,Miguel Gallardo-Valles,David Ferrer,6-2; 7-6(4),R32,87,4,1,48,64,33,48,12,16,4,6,10,45,64,1,1,41,67,26,41,13,26,3,7,10,39,67
2004-03-01 00:00:00.000,Acapulco Mexico ATP World Tour,CLAY,2,Juan Ignacio Chela,Albert Montanes,Juan Ignacio Chela,6-3; 6-4,R32,73,11,1,37,52,32,37,7,15,0,1,10,39,52,2,2,32,58,25,32,8,26,2,5,9,33,58
2004-03-01 00:00:00.000,Acapulco Mexico ATP World Tour,CLAY,2,Gaston Gaudio,Jose Acasuso,Gaston Gaudio,6-7(2); 7-6(1); 6-1,R32,146,7,5,60,97,50,60,16,37,4,6,15,66,97,5,8,56,120,37,56,31,64,2,7,16,68,120
2004-03-01 00:00:00.000,Acapulco Mexico ATP World Tour,CLAY,2,Guillermo Canas,Marc Lopez,Guillermo Canas,4-6; 7-6(3); 7-5,R32,201,6,7,63,104,48,63,20,41,4,7,17,68,104,1,1,84,115,56,84,16,31,10,13,17,72,115
2004-03-01 00:00:00.000,Acapulco Mexico ATP World Tour,CLAY,2,Ruben Ramirez Hidalgo,Albert Portas,Ruben Ramirez Hidalgo,6-3; 7-6(4),R32,92,6,6,47,79,38,47,13,32,6,8,11,51,79,5,6,43,86,28,43,20,43,5,8,10,48,86
2004-03-01 00:00:00.000,Acapulco Mexico ATP World Tour,CLAY,2,Mariano Zabaleta,Giovanni Lapentti,Mariano Zabaleta,6-7(4); 6-2; 6-3,R32,123,10,5,49,85,35,49,29,36,4,5,15,64,85,11,3,55,92,42,55,15,37,8,12,14,57,92
2004-03-01 00:00:00.000,Acapulco Mexico ATP World Tour,CLAY,2,Felix Mantilla,Olivier Patience,Felix Mantilla,6-3; 7-6(4),R32,92,9,1,60,85,44,60,11,25,10,12,11,55,85,8,4,33,59,25,33,10,26,1,4,10,35,59
2004-03-01 00:00:00.000,Acapulco Mexico ATP World Tour,CLAY,2,Fernando Verdasco,Tomas Behrend,Fernando Verdasco,6-2; 6-4,R32,57,5,2,33,46,28,33,9,13,0,0,9,37,46,1,0,45,56,28,45,5,11,8,11,9,33,56
2004-03-01 00:00:00.000,Acapulco Mexico ATP World Tour,CLAY,2,Jeff Salzenstein,Nicolas Lapentti,Jeff Salzenstein,6-1; 3-6; 6-1,R32,94,7,1,56,77,44,56,11,21,7,8,12,55,77,2,3,40,62,25,40,11,22,1,5,11,36,62
2004-03-01 00:00:00.000,Acapulco Mexico ATP World Tour,CLAY,2,Nicolas Massu,Alejandro Hernandez,Nicolas Massu,6-2; 6-0,R32,64,4,1,20,40,16,20,13,20,0,0,7,29,40,1,3,31,53,17,31,7,22,8,13,7,24,53
2004-03-01 00:00:00.000,Acapulco Mexico ATP World Tour,CLAY,2,Carlos Moya,Richard Gasquet,Carlos Moya,3-6; 6-3; 6-2,R16,106,11,0,39,68,30,39,15,29,1,4,13,45,68,0,3,40,84,25,40,22,44,6,11,13,47,84
2004-03-01 00:00:00.000,Acapulco Mexico ATP World Tour,CLAY,2,Filippo Volandri,Stefan Koubek,Filippo Volandri,6-4; 6-2,R16,65,0,0,42,55,26,42,7,13,7,10,9,33,55,1,1,38,56,18,38,5,18,6,12,9,23,56
2004-03-01 00:00:00.000,Acapulco Mexico ATP World Tour,CLAY,2,Oscar Hernandez,Luis Horna,Oscar Hernandez,3-6; 6-4; 7-6(2),R16,147,2,4,75,110,52,75,17,35,9,12,15,69,110,6,2,68,95,48,68,13,27,2,5,16,61,95
2004-03-01 00:00:00.000,Acapulco Mexico ATP World Tour,CLAY,2,Juan Ignacio Chela,David Ferrer,Juan Ignacio Chela,6-3; 6-3,R16,83,4,2,39,57,25,39,10,18,3,5,9,35,57,0,0,44,63,24,44,7,19,5,10,9,31,63
2004-03-01 00:00:00.000,Acapulco Mexico ATP World Tour,CLAY,2,Guillermo Canas,Gaston Gaudio,Guillermo Canas,6-4; 6-3,R16,107,2,4,38,79,27,38,19,41,8,11,10,46,79,1,3,41,59,25,41,6,18,3,8,9,31,59
2004-03-01 00:00:00.000,Acapulco Mexico ATP World Tour,CLAY,2,Ruben Ramirez Hidalgo,Mariano Zabaleta,Ruben Ramirez Hidalgo,7-5; 6-3,R16,97,5,6,45,76,29,45,17,31,6,8,11,46,76,2,2,34,62,20,34,14,28,3,7,10,34,62
2004-03-01 00:00:00.000,Acapulco Mexico ATP World Tour,CLAY,2,Fernando Verdasco,Felix Mantilla,Fernando Verdasco,4-6; 6-4; 6-0,R16,91,6,3,36,67,30,36,18,31,0,2,13,48,67,6,2,41,70,29,41,12,29,3,8,13,41,70
2004-03-01 00:00:00.000,Acapulco Mexico ATP World Tour,CLAY,2,Nicolas Massu,Jeff Salzenstein,Nicolas Massu,6-1; 6-3,R16,66,6,1,25,38,22,25,11,13,1,1,8,33,38,5,5,41,63,23,41,9,22,7,11,8,32,63
2004-03-01 00:00:00.000,Acapulco Mexico ATP World Tour,CLAY,2,Carlos Moya,Filippo Volandri,Carlos Moya,3-6; 7-5; 6-2,Q,117,7,4,44,85,33,44,21,41,3,6,14,54,85,1,1,70,96,43,70,13,26,8,13,15,56,96
2004-03-01 00:00:00.000,Acapulco Mexico ATP World Tour,CLAY,2,Juan Ignacio Chela,Oscar Hernandez,Juan Ignacio Chela,3-6; 6-0; 6-2,Q,102,3,2,43,65,36,43,8,22,5,7,12,44,65,0,2,54,75,30,54,8,21,3,8,11,38,75
2004-03-01 00:00:00.000,Acapulco Mexico ATP World Tour,CLAY,2,Guillermo Canas,Ruben Ramirez Hidalgo,Guillermo Canas,6-2; 6-0,Q,58,1,2,25,42,19,25,13,17,2,2,7,32,42,1,2,22,37,11,22,4,15,3,8,7,15,37
2004-03-01 00:00:00.000,Acapulco Mexico ATP World Tour,CLAY,2,Fernando Verdasco,Nicolas Massu,Fernando Verdasco,6-3; 6-4,Q,85,2,4,35,49,24,35,8,14,4,6,9,32,49,3,4,40,66,25,40,8,26,7,12,10,33,66
2004-03-01 00:00:00.000,Acapulco Mexico ATP World Tour,CLAY,2,Carlos Moya,Juan Ignacio Chela,Carlos Moya,6-2; 7-6(4),S,97,1,2,30,57,26,30,17,27,1,2,10,43,57,1,1,54,88,32,54,16,34,6,9,10,48,88
2004-03-01 00:00:00.000,Acapulco Mexico ATP World Tour,CLAY,2,Fernando Verdasco,Guillermo Canas,Fernando Verdasco,6-3; 3-6; 6-3,S,136,4,5,49,76,32,49,14,27,3,7,13,46,76,6,7,63,118,41,63,22,55,11,17,14,63,118
2004-03-01 00:00:00.000,Acapulco Mexico ATP World Tour,CLAY,2,Carlos Moya,Fernando Verdasco,Carlos Moya,6-3; 6-0,F,64,3,1,28,48,24,28,11,20,2,2,8,35,48,1,1,32,48,19,32,5,16,4,8,7,24,48
2004-03-01 00:00:00.000,Dubai U.A.E. ATP World Tour,HARD,2,Roger Federer,Marat Safin,Roger Federer,7-6(2); 7-6(4),R32,119,4,3,46,96,35,46,28,50,9,11,12,63,96,5,2,36,78,25,36,25,42,0,2,12,50,78
2004-03-01 00:00:00.000,Dubai U.A.E. ATP World Tour,HARD,2,Tommy Robredo,Jonas Bjorkman,Tommy Robredo,6-4; 6-4,R32,86,1,4,26,59,21,26,22,33,3,3,10,43,59,2,7,44,73,31,44,12,29,0,2,10,43,73
2004-03-01 00:00:00.000,Dubai U.A.E. ATP World Tour,HARD,2,Andrei Pavel,Bohdan Ulihrach,Andrei Pavel,6-1; 2-6; 7-5,R32,96,4,2,53,91,36,53,21,38,7,10,14,57,91,1,6,45,73,34,45,10,28,1,5,13,44,73
2004-03-01 00:00:00.000,Dubai U.A.E. ATP World Tour,HARD,2,Tomas Zib,Tim Henman,Tomas Zib,6-4; 3-6; 7-6(4),R32,142,2,3,59,85,40,59,17,26,1,4,15,57,85,10,5,65,115,43,65,27,50,7,10,16,70,115
2004-03-01 00:00:00.000,Dubai U.A.E. ATP World Tour,HARD,2,Jarkko Nieminen,David Nalbandian,Jarkko Nieminen,6-3; 6-4,R32,87,2,0,43,69,33,43,10,26,8,10,10,43,69,2,4,28,57,17,28,12,29,7,11,9,29,57
2004-03-01 00:00:00.000,Dubai U.A.E. ATP World Tour,HARD,2,Gregory Carraz,Omar Awadhy,Gregory Carraz,6-0; 6-0,R32,48,3,4,19,36,15,19,12,17,2,2,6,27,36,0,6,23,43,9,23,5,20,5,11,6,14,43
2004-03-01 00:00:00.000,Dubai U.A.E. ATP World Tour,HARD,2,Fabrice Santoro,Alberto Martin,Fabrice Santoro,6-3; 6-7(7); 6-4,R32,149,5,5,59,117,44,59,25,58,2,6,16,69,117,2,6,69,99,45,69,11,30,8,14,15,56,99
2004-03-01 00:00:00.000,Dubai U.A.E. ATP World Tour,HARD,2,Sjeng Schalken,Sargis Sargsian,Sjeng Schalken,6-3; 6-1,R32,69,0,2,34,47,26,34,9,13,4,4,8,35,47,0,2,32,56,20,32,10,24,6,10,8,30,56
2004-03-01 00:00:00.000,Dubai U.A.E. ATP World Tour,HARD,2,Paradorn Srichaphan,Dominik Hrbaty,Paradorn Srichaphan,4-3 RET,R32,30,1,2,16,28,10,16,7,12,2,2,3,17,28,0,1,16,29,7,16,10,13,2,3,4,17,29
2004-03-01 00:00:00.000,Dubai U.A.E. ATP World Tour,HARD,2,Ivan Ljubicic,Massimo Dell'Acqua,Ivan Ljubicic,6-3; 3-6; 6-4,R32,106,9,2,46,78,31,46,24,32,4,5,14,55,78,6,4,42,82,33,42,20,40,1,3,14,53,82
2004-03-01 00:00:00.000,Dubai U.A.E. ATP World Tour,HARD,2,Feliciano Lopez,Nikolay Davydenko,Feliciano Lopez,6-4; 6-3,R32,71,8,3,25,57,22,25,20,32,3,3,10,42,57,2,5,29,50,21,29,11,21,1,3,9,32,50
2004-03-01 00:00:00.000,Dubai U.A.E. ATP World Tour,HARD,2,Philipp Kohlschreiber,Rainer Schuettler,Philipp Kohlschreiber,3-6; 6-4; 6-4,R32,101,3,5,37,79,27,37,27,42,0,1,14,54,79,4,4,56,88,42,56,17,32,3,5,15,59,88
2004-03-01 00:00:00.000,Dubai U.A.E. ATP World Tour,HARD,2,Olivier Rochus,Mark Philippoussis,Olivier Rochus,6-2; 7-6(8),R32,89,3,4,39,66,33,39,15,27,0,0,10,48,66,8,7,39,73,30,39,17,34,7,9,10,47,73
2004-03-01 00:00:00.000,Dubai U.A.E. ATP World Tour,HARD,2,Rafael Nadal,Max Mirnyi,Rafael Nadal,6-3; 7-6(6),R32,86,1,1,40,64,31,40,18,24,0,0,11,49,64,11,2,48,72,39,48,9,24,4,5,10,48,72
2004-03-01 00:00:00.000,Dubai U.A.E. ATP World Tour,HARD,2,Dennis van Scheppingen,Mohammad Ghareeb,Dennis van Scheppingen,7-6(5); 3-6; 7-6(6),R32,119,9,7,62,120,44,62,34,58,4,7,16,78,120,9,8,43,104,38,43,36,61,4,6,17,74,104
2004-03-01 00:00:00.000,Dubai U.A.E. ATP World Tour,HARD,2,Mikhail Youzhny,Guillermo Coria,Mikhail Youzhny,4-6; 6-3; 6-4,R32,137,9,7,53,106,37,53,25,53,2,6,15,62,106,1,1,56,82,32,56,14,26,4,9,14,46,82
2004-03-01 00:00:00.000,Dubai U.A.E. ATP World Tour,HARD,2,Roger Federer,Tommy Robredo,Roger Federer,6-3; 6-4,R16,88,6,3,37,61,31,37,13,24,3,3,10,44,61,1,6,30,74,22,30,22,44,10,12,9,44,74
2004-03-01 00:00:00.000,Dubai U.A.E. ATP World Tour,HARD,2,Andrei Pavel,Tomas Zib,Andrei Pavel,7-5; 1-6; 6-1,R16,121,9,4,41,89,32,41,22,48,3,6,13,54,89,1,1,50,91,29,50,23,41,7,11,13,52,91
2004-03-01 00:00:00.000,Dubai U.A.E. ATP World Tour,HARD,2,Jarkko Nieminen,Gregory Carraz,Jarkko Nieminen,7-6(3); 6-3,R16,83,5,2,49,63,33,49,6,14,0,2,10,39,63,5,9,27,70,20,27,20,43,4,8,11,40,70
2004-03-01 00:00:00.000,Dubai U.A.E. ATP World Tour,HARD,2,Sjeng Schalken,Fabrice Santoro,Sjeng Schalken,5-7; 6-4; 6-4,R16,165,4,2,84,114,50,84,13,30,9,14,16,63,114,1,3,53,104,33,53,25,51,6,12,16,58,104
2004-03-01 00:00:00.000,Dubai U.A.E. ATP World Tour,HARD,2,Ivan Ljubicic,Paradorn Srichaphan,Ivan Ljubicic,7-6(6); 4-6; 7-5,R16,145,18,3,54,97,46,54,26,43,0,2,17,72,97,5,6,63,108,48,63,25,45,1,3,17,73,108
2004-03-01 00:00:00.000,Dubai U.A.E. ATP World Tour,HARD,2,Feliciano Lopez,Philipp Kohlschreiber,Feliciano Lopez,6-3; 6-4,R16,68,5,1,30,56,27,30,14,26,2,2,10,41,56,4,6,30,66,24,30,16,36,8,10,9,40,66
2004-03-01 00:00:00.000,Dubai U.A.E. ATP World Tour,HARD,2,Rafael Nadal,Olivier Rochus,Rafael Nadal,6-3; 7-5,R16,90,2,3,52,66,35,52,8,14,3,5,11,43,66,1,4,37,66,22,37,13,29,5,9,10,35,66
2004-03-01 00:00:00.000,Dubai U.A.E. ATP World Tour,HARD,2,Mikhail Youzhny,Dennis van Scheppingen,Mikhail Youzhny,6-4; 7-5,R16,75,5,6,29,65,23,29,18,36,1,3,11,41,65,3,1,38,57,22,38,12,19,5,9,11,34,57
2004-03-01 00:00:00.000,Dubai U.A.E. ATP World Tour,HARD,2,Roger Federer,Andrei Pavel,Roger Federer,6-3; 6-3,Q,68,3,1,31,50,25,31,12,19,0,0,9,37,50,3,2,43,66,26,43,10,23,6,9,9,36,66
2004-03-01 00:00:00.000,Dubai U.A.E. ATP World Tour,HARD,2,Jarkko Nieminen,Sjeng Schalken,Jarkko Nieminen,6-3; 6-3,Q,82,1,5,44,60,34,44,6,16,4,4,9,40,60,2,0,43,59,25,43,9,16,2,5,9,34,59
2004-03-01 00:00:00.000,Dubai U.A.E. ATP World Tour,HARD,2,Feliciano Lopez,Ivan Ljubicic,Feliciano Lopez,6-4; 7-6(4),Q,92,9,5,38,80,31,38,23,42,9,10,11,54,80,3,4,33,65,25,33,16,32,3,5,11,41,65
2004-03-01 00:00:00.000,Dubai U.A.E. ATP World Tour,HARD,2,Mikhail Youzhny,Rafael Nadal,Mikhail Youzhny,6-2; 1-6; 6-1,Q,95,4,4,34,65,26,34,13,31,4,7,11,39,65,0,1,39,62,20,39,14,23,5,10,11,34,62
2004-03-01 00:00:00.000,Dubai U.A.E. ATP World Tour,HARD,2,Roger Federer,Jarkko Nieminen,Roger Federer,7-6(7); 6-2,S,81,3,1,36,63,27,36,16,27,3,4,10,43,63,0,3,48,74,31,48,13,26,5,8,10,44,74
2004-03-01 00:00:00.000,Dubai U.A.E. ATP World Tour,HARD,2,Feliciano Lopez,Mikhail Youzhny,Feliciano Lopez,6-4; 4-6; 6-4,S,117,8,2,51,86,41,51,19,35,3,4,15,60,86,9,3,52,90,43,52,19,38,6,8,15,62,90
2004-03-01 00:00:00.000,Dubai U.A.E. ATP World Tour,HARD,2,Roger Federer,Feliciano Lopez,Roger Federer,4-6; 6-1; 6-2,F,95,6,0,43,67,34,43,17,24,0,1,13,51,67,7,3,50,91,33,50,18,41,9,13,12,51,91
2004-03-01 00:00:00.000,Scottsdale AZ; U.S.A. ATP World Tour,HARD,2,Andy Roddick,John van Lottum,Andy Roddick,6-3; 7-5,R32,146,10,1,42,71,30,42,18,29,4,5,11,48,71,4,1,31,67,23,31,15,36,5,8,10,38,67
2004-03-01 00:00:00.000,Scottsdale AZ; U.S.A. ATP World Tour,HARD,2,Alex Bogomolov Jr.,Gustavo Marcaccio,Alex Bogomolov Jr.,6-3; 5-7; 6-4,R32,116,7,4,66,96,44,66,15,30,3,7,16,59,96,1,2,59,88,41,59,12,29,1,6,15,53,88
2004-03-01 00:00:00.000,Scottsdale AZ; U.S.A. ATP World Tour,HARD,2,Jan-Michael Gambill,Brendan Evans,Jan-Michael Gambill,6-1; 6-4,R32,57,6,3,27,50,24,27,14,23,0,0,9,38,50,5,2,31,48,21,31,5,17,0,3,8,26,48
2004-03-01 00:00:00.000,Scottsdale AZ; U.S.A. ATP World Tour,HARD,2,Lars Burgsmuller,Alex Kim,Lars Burgsmuller,6-4; 3-6; 7-5,R32,139,4,4,72,112,46,72,16,40,9,14,15,62,112,1,4,72,110,42,72,18,38,10,16,16,60,110
2004-03-01 00:00:00.000,Scottsdale AZ; U.S.A. ATP World Tour,HARD,2,Vincent Spadea,Thomas Johansson,Vincent Spadea,6-4; 6-4,R32,75,6,4,37,59,28,37,13,22,2,3,10,41,59,5,4,38,65,26,38,12,27,5,8,10,38,65
2004-03-01 00:00:00.000,Scottsdale AZ; U.S.A. ATP World Tour,HARD,2,Wayne Arthurs,Alex Corretja,Wayne Arthurs,6-1; 6-4,R32,73,9,4,25,63,20,25,23,38,6,6,9,43,63,0,0,28,50,16,28,13,22,2,5,8,29,50
2004-03-01 00:00:00.000,Scottsdale AZ; U.S.A. ATP World Tour,HARD,2,Igor Andreev,Mario Ancic,Igor Andreev,4-6; 7-6(5); 6-4,R32,125,7,3,68,107,51,68,17,39,4,7,16,68,107,8,4,57,95,45,57,19,38,0,3,16,64,95
2004-03-01 00:00:00.000,Scottsdale AZ; U.S.A. ATP World Tour,HARD,2,James Blake,Martin Vassallo Arguello,James Blake,6-3; 6-1,R32,74,1,2,28,54,19,28,15,26,1,2,8,34,54,2,1,30,59,14,30,13,29,5,10,8,27,59
2004-03-01 00:00:00.000,Scottsdale AZ; U.S.A. ATP World Tour,HARD,2,Nicolas Kiefer,Brian Vahaly,Nicolas Kiefer,6-3; 6-3,R32,74,8,2,31,57,27,31,14,26,2,2,9,41,57,1,1,31,54,21,31,11,23,5,8,9,32,54
2004-03-01 00:00:00.000,Scottsdale AZ; U.S.A. ATP World Tour,HARD,2,Dmitry Tursunov,Ivo Karlovic,Dmitry Tursunov,6-3; 6-4,R32,59,1,4,20,48,19,20,19,28,1,1,9,38,48,8,7,32,60,25,32,11,28,3,6,10,36,60
2004-03-01 00:00:00.000,Scottsdale AZ; U.S.A. ATP World Tour,HARD,2,Wesley Moodie,Antony Dupuis,Wesley Moodie,6-7(6); 6-2; 6-2,R32,108,16,3,60,90,47,60,17,30,4,5,14,64,90,7,4,56,93,37,56,18,37,5,10,14,55,93
2004-03-01 00:00:00.000,Scottsdale AZ; U.S.A. ATP World Tour,HARD,2,Robby Ginepri,Tripp Phillips,Robby Ginepri,6-2; 6-0,R32,67,2,3,25,46,20,25,11,21,3,4,7,31,46,1,0,33,53,16,33,5,20,4,10,7,21,53
2004-03-01 00:00:00.000,Scottsdale AZ; U.S.A. ATP World Tour,HARD,2,Victor Hanescu,Wayne Ferreira,Victor Hanescu,6-1; 6-2,R32,48,8,1,31,49,24,31,13,18,2,2,8,37,49,1,1,17,37,8,17,10,20,2,6,7,18,37
2004-03-01 00:00:00.000,Scottsdale AZ; U.S.A. ATP World Tour,HARD,2,Robin Soderling,Xavier Malisse,Robin Soderling,6-3; 7-6(3),R32,87,5,2,44,80,32,44,22,36,5,6,11,54,80,6,2,40,61,29,40,9,21,0,2,10,38,61
2004-03-01 00:00:00.000,Scottsdale AZ; U.S.A. ATP World Tour,HARD,2,Cecil Mamiit,Jean-Rene Lisnard,Cecil Mamiit,6-0; 4-6; 6-3,R32,114,3,0,35,78,29,35,23,43,3,5,13,52,78,3,6,43,81,27,43,16,38,8,13,12,43,81
2004-03-01 00:00:00.000,Scottsdale AZ; U.S.A. ATP World Tour,HARD,2,Martin Verkerk,Yves Allegro,Martin Verkerk,6-3; 6-2,R32,58,14,3,34,51,28,34,10,17,0,0,9,38,51,4,6,32,60,19,32,13,28,6,9,8,32,60
2004-03-01 00:00:00.000,Scottsdale AZ; U.S.A. ATP World Tour,HARD,2,Andy Roddick,Alex Bogomolov Jr.,Andy Roddick,6-4; 6-3,R16,67,11,2,41,57,34,41,5,16,2,3,10,39,57,1,1,37,54,19,37,12,17,1,4,9,31,54
2004-03-01 00:00:00.000,Scottsdale AZ; U.S.A. ATP World Tour,HARD,2,Jan-Michael Gambill,Lars Burgsmuller,Jan-Michael Gambill,7-5; 7-5,R16,101,16,4,60,101,46,60,14,41,13,15,12,60,101,2,3,45,65,28,45,12,20,4,8,12,40,65
2004-03-01 00:00:00.000,Scottsdale AZ; U.S.A. ATP World Tour,HARD,2,Vincent Spadea,Wayne Arthurs,Vincent Spadea,6-3; 6-2,R16,58,1,2,32,49,24,32,10,17,2,3,9,34,49,7,4,27,52,15,27,12,25,5,9,8,27,52
2004-03-01 00:00:00.000,Scottsdale AZ; U.S.A. ATP World Tour,HARD,2,James Blake,Igor Andreev,James Blake,6-3; 6-2,R16,65,4,0,29,51,21,29,15,22,0,1,9,36,51,1,2,46,62,25,46,8,16,7,11,8,33,62
2004-03-01 00:00:00.000,Scottsdale AZ; U.S.A. ATP World Tour,HARD,2,Nicolas Kiefer,Dmitry Tursunov,Nicolas Kiefer,6-4; 6-4,R16,90,3,0,33,63,27,33,16,30,7,8,10,43,63,2,2,42,72,23,42,17,30,5,8,10,40,72
2004-03-01 00:00:00.000,Scottsdale AZ; U.S.A. ATP World Tour,HARD,2,Robby Ginepri,Wesley Moodie,Robby Ginepri,2-6; 7-6(2); 6-4,R16,98,6,1,53,93,37,53,21,40,3,7,15,58,93,11,3,61,80,45,61,9,19,0,3,15,54,80
2004-03-01 00:00:00.000,Scottsdale AZ; U.S.A. ATP World Tour,HARD,2,Victor Hanescu,Robin Soderling,Victor Hanescu,6-3; 6-7(5); 6-3,R16,114,12,2,62,106,42,62,22,44,7,9,14,64,106,5,5,60,96,41,60,13,36,3,9,16,54,96
2004-03-01 00:00:00.000,Scottsdale AZ; U.S.A. ATP World Tour,HARD,2,Martin Verkerk,Cecil Mamiit,Martin Verkerk,6-2; 4-6; 6-3,R16,117,4,5,56,90,41,56,19,34,3,4,14,60,90,8,2,42,85,33,42,21,43,5,8,13,54,85
2004-03-01 00:00:00.000,Scottsdale AZ; U.S.A. ATP World Tour,HARD,2,Andy Roddick,Jan-Michael Gambill,Andy Roddick,6-7(4); 6-4; 6-3,Q,109,13,1,60,81,53,60,13,21,2,2,15,66,81,21,5,66,108,53,66,18,42,9,12,16,71,108
2004-03-01 00:00:00.000,Scottsdale AZ; U.S.A. ATP World Tour,HARD,2,Vincent Spadea,James Blake,Vincent Spadea,6-4; 2-6; 7-5,Q,119,1,1,60,101,38,60,21,41,3,7,15,59,101,2,4,51,93,37,51,20,42,3,7,15,57,93
2004-03-01 00:00:00.000,Scottsdale AZ; U.S.A. ATP World Tour,HARD,2,Nicolas Kiefer,Robby Ginepri,Nicolas Kiefer,6-3; 7-6(6),Q,89,7,4,39,71,30,39,12,32,0,3,11,42,71,2,5,37,61,23,37,9,24,1,5,10,32,61
2004-03-01 00:00:00.000,Scottsdale AZ; U.S.A. ATP World Tour,HARD,2,Victor Hanescu,Martin Verkerk,Victor Hanescu,7-5; 6-4,Q,69,9,2,42,59,35,42,12,17,0,0,11,47,59,4,1,45,70,33,45,11,25,2,4,11,44,70
2004-03-01 00:00:00.000,Scottsdale AZ; U.S.A. ATP World Tour,HARD,2,Vincent Spadea,Andy Roddick,Vincent Spadea,6-7(5); 6-3; 6-4,S,123,4,3,64,105,43,64,26,41,2,4,16,69,105,6,5,59,95,41,59,15,36,3,7,15,56,95
2004-03-01 00:00:00.000,Scottsdale AZ; U.S.A. ATP World Tour,HARD,2,Nicolas Kiefer,Victor Hanescu,Nicolas Kiefer,4-6; 7-5; 6-4,S,153,8,5,59,113,43,59,24,54,5,9,16,67,113,13,4,62,104,42,62,17,42,5,10,16,59,104
2004-03-01 00:00:00.000,Scottsdale AZ; U.S.A. ATP World Tour,HARD,2,Vincent Spadea,Nicolas Kiefer,Vincent Spadea,7-5; 6-7(5); 6-3,F,164,3,2,74,116,49,74,26,42,7,9,17,75,116,9,8,49,105,36,49,26,56,3,7,16,62,105
2004-03-08 00:00:00.000,ATP Masters Series Indian Wells California; USA ATP World Tour,HARD,2,Roger Federer,N/A Bye,Roger Federer,,R128,0,0,0,0,0,0,0,0,0,0,0,0,0,0,0,0,0,0,0,0,0,0,0,0,0,0,0
2004-03-08 00:00:00.000,ATP Masters Series Indian Wells California; USA ATP World Tour,HARD,2,Andrei Pavel,Ivo Karlovic,Andrei Pavel,7-6(10); 6-7(4); 7-6(4),R128,179,9,3,84,128,64,84,26,44,6,7,18,90,128,24,11,93,163,77,93,26,70,17,18,18,103,163
2004-03-08 00:00:00.000,ATP Masters Series Indian Wells California; USA ATP World Tour,HARD,2,Victor Hanescu,Jurgen Melzer,Victor Hanescu,6-1; 6-7(5); 6-3,R128,98,8,3,61,86,45,61,13,25,1,4,15,58,86,8,2,46,84,31,46,16,38,4,10,13,47,84
2004-03-08 00:00:00.000,ATP Masters Series Indian Wells California; USA ATP World Tour,HARD,2,Fernando Gonzalez,N/A Bye,Fernando Gonzalez,,R128,0,0,0,0,0,0,0,0,0,0,0,0,0,0,0,0,0,0,0,0,0,0,0,0,0,0,0
2004-03-08 00:00:00.000,ATP Masters Series Indian Wells California; USA ATP World Tour,HARD,2,Mardy Fish,N/A Bye,Mardy Fish,,R128,0,0,0,0,0,0,0,0,0,0,0,0,0,0,0,0,0,0,0,0,0,0,0,0,0,0,0
2004-03-08 00:00:00.000,ATP Masters Series Indian Wells California; USA ATP World Tour,HARD,2,Glenn Weiner,Bohdan Ulihrach,Glenn Weiner,6-4; 4-6; 6-4,R128,104,7,5,53,90,42,53,19,37,1,3,15,61,90,3,4,53,96,37,53,23,43,3,6,15,60,96
2004-03-08 00:00:00.000,ATP Masters Series Indian Wells California; USA ATP World Tour,HARD,2,Antony Dupuis,Todd Martin,Antony Dupuis,6-4; 7-5,R128,91,9,4,36,70,27,36,21,34,3,3,11,48,70,10,6,45,75,32,45,15,30,6,8,11,47,75
2004-03-08 00:00:00.000,ATP Masters Series Indian Wells California; USA ATP World Tour,HARD,2,Jiri Novak,N/A Bye,Jiri Novak,,R128,0,0,0,0,0,0,0,0,0,0,0,0,0,0,0,0,0,0,0,0,0,0,0,0,0,0,0
2004-03-08 00:00:00.000,ATP Masters Series Indian Wells California; USA ATP World Tour,HARD,2,Paradorn Srichaphan,N/A Bye,Paradorn Srichaphan,,R128,0,0,0,0,0,0,0,0,0,0,0,0,0,0,0,0,0,0,0,0,0,0,0,0,0,0,0
2004-03-08 00:00:00.000,ATP Masters Series Indian Wells California; USA ATP World Tour,HARD,2,Tommy Haas,Thomas Enqvist,Tommy Haas,6-4; 3-6; 6-3,R128,109,9,5,46,84,38,46,14,38,2,5,14,52,84,5,4,38,77,29,38,18,39,2,6,14,47,77
2004-03-08 00:00:00.000,ATP Masters Series Indian Wells California; USA ATP World Tour,HARD,2,Guillermo Canas,Filippo Volandri,Guillermo Canas,6-4; 4-0 RET,R128,71,2,4,30,50,22,30,11,20,4,5,7,33,50,1,2,27,46,13,27,8,19,2,6,7,21,46
2004-03-08 00:00:00.000,ATP Masters Series Indian Wells California; USA ATP World Tour,HARD,2,Albert Costa,N/A Bye,Albert Costa,,R128,0,0,0,0,0,0,0,0,0,0,0,0,0,0,0,0,0,0,0,0,0,0,0,0,0,0,0
2004-03-08 00:00:00.000,ATP Masters Series Indian Wells California; USA ATP World Tour,HARD,2,Juan Ignacio Chela,N/A Bye,Juan Ignacio Chela,,R128,0,0,0,0,0,0,0,0,0,0,0,0,0,0,0,0,0,0,0,0,0,0,0,0,0,0,0
2004-03-08 00:00:00.000,ATP Masters Series Indian Wells California; USA ATP World Tour,HARD,2,Alberto Martin,Frederic Niemeyer,Alberto Martin,7-5; 6-4,R128,79,2,2,36,66,29,36,18,30,1,2,11,47,66,8,5,39,60,26,39,12,21,5,8,11,38,60
2004-03-08 00:00:00.000,ATP Masters Series Indian Wells California; USA ATP World Tour,HARD,2,Thomas Johansson,Dmitry Tursunov,Thomas Johansson,6-4; 5-7; 6-2,R128,148,8,2,54,95,40,54,20,41,3,6,15,60,95,6,6,56,117,35,56,31,61,7,12,15,66,117
2004-03-08 00:00:00.000,ATP Masters Series Indian Wells California; USA ATP World Tour,HARD,2,Lleyton Hewitt,N/A Bye,Lleyton Hewitt,,R128,0,0,0,0,0,0,0,0,0,0,0,0,0,0,0,0,0,0,0,0,0,0,0,0,0,0,0
2004-03-08 00:00:00.000,ATP Masters Series Indian Wells California; USA ATP World Tour,HARD,2,Guillermo Coria,N/A Bye,Guillermo Coria,,R128,0,0,0,0,0,0,0,0,0,0,0,0,0,0,0,0,0,0,0,0,0,0,0,0,0,0,0
2004-03-08 00:00:00.000,ATP Masters Series Indian Wells California; USA ATP World Tour,HARD,2,Sargis Sargsian,Mario Ancic,Sargis Sargsian,7-6(2); 2-6; 6-1,R128,130,4,3,69,96,53,69,9,27,4,6,14,62,96,11,4,62,100,37,62,21,38,7,9,13,58,100
2004-03-08 00:00:00.000,ATP Masters Series Indian Wells California; USA ATP World Tour,HARD,2,Alex Bogomolov Jr.,Jeff Salzenstein,Alex Bogomolov Jr.,6-2; 6-4,R128,81,1,4,46,68,31,46,12,22,5,6,9,43,68,9,4,48,71,31,48,6,23,7,11,9,37,71
2004-03-08 00:00:00.000,ATP Masters Series Indian Wells California; USA ATP World Tour,HARD,2,Max Mirnyi,N/A Bye,Max Mirnyi,,R128,0,0,0,0,0,0,0,0,0,0,0,0,0,0,0,0,0,0,0,0,0,0,0,0,0,0,0
2004-03-08 00:00:00.000,ATP Masters Series Indian Wells California; USA ATP World Tour,HARD,2,Arnaud Clement,N/A Bye,Arnaud Clement,,R128,0,0,0,0,0,0,0,0,0,0,0,0,0,0,0,0,0,0,0,0,0,0,0,0,0,0,0
2004-03-08 00:00:00.000,ATP Masters Series Indian Wells California; USA ATP World Tour,HARD,2,Raemon Sluiter,Mariano Zabaleta,Raemon Sluiter,7-6(3); 7-6(6),R128,107,8,2,44,84,34,44,23,40,6,8,12,57,84,7,6,39,79,31,39,22,40,2,4,12,53,79
2004-03-08 00:00:00.000,ATP Masters Series Indian Wells California; USA ATP World Tour,HARD,2,Davide Sanguinetti,Fabrice Santoro,Davide Sanguinetti,1-6; 7-6(4); 6-4,R128,127,5,5,44,97,29,44,29,53,9,12,14,58,97,5,1,56,102,39,56,28,46,7,9,15,67,102
2004-03-08 00:00:00.000,ATP Masters Series Indian Wells California; USA ATP World Tour,HARD,2,Sebastien Grosjean,N/A Bye,Sebastien Grosjean,,R128,0,0,0,0,0,0,0,0,0,0,0,0,0,0,0,0,0,0,0,0,0,0,0,0,0,0,0
2004-03-08 00:00:00.000,ATP Masters Series Indian Wells California; USA ATP World Tour,HARD,2,Mark Philippoussis,N/A Bye,Mark Philippoussis,,R128,0,0,0,0,0,0,0,0,0,0,0,0,0,0,0,0,0,0,0,0,0,0,0,0,0,0,0
2004-03-08 00:00:00.000,ATP Masters Series Indian Wells California; USA ATP World Tour,HARD,2,Mikhail Youzhny,Hyung-Taik Lee,Mikhail Youzhny,3-6; 6-3; 6-1,R128,98,6,1,34,67,24,34,24,33,0,1,12,48,67,8,4,61,86,41,61,9,25,6,10,13,50,86
2004-03-08 00:00:00.000,ATP Masters Series Indian Wells California; USA ATP World Tour,HARD,2,Luis Horna,Wesley Moodie,Luis Horna,6-2; 7-6(4),R128,71,4,1,49,60,40,49,7,11,1,1,10,47,60,2,1,41,58,30,41,10,17,1,3,10,40,58
2004-03-08 00:00:00.000,ATP Masters Series Indian Wells California; USA ATP World Tour,HARD,2,Feliciano Lopez,N/A Bye,Feliciano Lopez,,R128,0,0,0,0,0,0,0,0,0,0,0,0,0,0,0,0,0,0,0,0,0,0,0,0,0,0,0
2004-03-08 00:00:00.000,ATP Masters Series Indian Wells California; USA ATP World Tour,HARD,2,Dominik Hrbaty,N/A Bye,Dominik Hrbaty,,R128,0,0,0,0,0,0,0,0,0,0,0,0,0,0,0,0,0,0,0,0,0,0,0,0,0,0,0
2004-03-08 00:00:00.000,ATP Masters Series Indian Wells California; USA ATP World Tour,HARD,2,Xavier Malisse,Karol Beck,Xavier Malisse,6-3; 6-3,R128,65,4,0,28,46,20,28,13,18,3,4,9,33,46,3,6,24,58,19,24,13,34,1,5,9,32,58
2004-03-08 00:00:00.000,ATP Masters Series Indian Wells California; USA ATP World Tour,HARD,2,David Sanchez,Cyril Saulnier,David Sanchez,4-6; 6-4; 6-2,R128,108,9,1,59,91,41,59,17,32,4,6,14,58,91,5,2,52,87,34,52,18,35,2,6,14,52,87
2004-03-08 00:00:00.000,ATP Masters Series Indian Wells California; USA ATP World Tour,HARD,2,Andre Agassi,N/A Bye,Andre Agassi,,R128,0,0,0,0,0,0,0,0,0,0,0,0,0,0,0,0,0,0,0,0,0,0,0,0,0,0,0
2004-03-08 00:00:00.000,ATP Masters Series Indian Wells California; USA ATP World Tour,HARD,2,Rainer Schuettler,N/A Bye,Rainer Schuettler,,R128,0,0,0,0,0,0,0,0,0,0,0,0,0,0,0,0,0,0,0,0,0,0,0,0,0,0,0
2004-03-08 00:00:00.000,ATP Masters Series Indian Wells California; USA ATP World Tour,HARD,2,Wayne Arthurs,Federico Browne,Wayne Arthurs,6-3; 6-2,R128,60,12,0,28,44,22,28,14,16,0,0,9,36,44,2,2,25,46,17,25,8,21,0,3,8,25,46
2004-03-08 00:00:00.000,ATP Masters Series Indian Wells California; USA ATP World Tour,HARD,2,Harel Levy,Brian Vahaly,Harel Levy,6-2; 5-7; 6-3,R128,107,12,2,69,104,52,69,14,35,4,7,15,66,104,1,0,55,84,35,55,12,29,6,11,14,47,84
2004-03-08 00:00:00.000,ATP Masters Series Indian Wells California; USA ATP World Tour,HARD,2,Jonas Bjorkman,N/A Bye,Jonas Bjorkman,,R128,0,0,0,0,0,0,0,0,0,0,0,0,0,0,0,0,0,0,0,0,0,0,0,0,0,0,0
2004-03-08 00:00:00.000,ATP Masters Series Indian Wells California; USA ATP World Tour,HARD,2,Tommy Robredo,N/A Bye,Tommy Robredo,,R128,0,0,0,0,0,0,0,0,0,0,0,0,0,0,0,0,0,0,0,0,0,0,0,0,0,0,0
2004-03-08 00:00:00.000,ATP Masters Series Indian Wells California; USA ATP World Tour,HARD,2,Alex Corretja,David Ferrer,Alex Corretja,7-6(6); 3-6; 7-5,R128,172,4,5,59,112,41,59,27,53,9,13,16,68,112,2,3,79,125,54,79,21,46,8,12,17,75,125
2004-03-08 00:00:00.000,ATP Masters Series Indian Wells California; USA ATP World Tour,HARD,2,Simon Larose,Felix Mantilla,Simon Larose,6-0; 4-6; 7-5,R128,99,4,4,53,95,37,53,24,42,9,11,14,61,95,3,4,52,86,34,52,14,34,6,11,14,48,86
2004-03-08 00:00:00.000,ATP Masters Series Indian Wells California; USA ATP World Tour,HARD,2,Tim Henman,N/A Bye,Tim Henman,,R128,0,0,0,0,0,0,0,0,0,0,0,0,0,0,0,0,0,0,0,0,0,0,0,0,0,0,0
2004-03-08 00:00:00.000,ATP Masters Series Indian Wells California; USA ATP World Tour,HARD,2,Sjeng Schalken,N/A Bye,Sjeng Schalken,,R128,0,0,0,0,0,0,0,0,0,0,0,0,0,0,0,0,0,0,0,0,0,0,0,0,0,0,0
2004-03-08 00:00:00.000,ATP Masters Series Indian Wells California; USA ATP World Tour,HARD,2,Nicolas Escude,Fernando Verdasco,Nicolas Escude,7-6(2); 5-7; 7-6(5),R128,171,7,6,72,124,58,72,25,52,5,8,18,83,124,9,5,98,143,66,98,25,45,11,13,18,91,143
2004-03-08 00:00:00.000,ATP Masters Series Indian Wells California; USA ATP World Tour,HARD,2,Flavio Saretta,Nicolas Kiefer,Flavio Saretta,6-2; 7-5,R128,95,4,4,27,58,20,27,18,31,1,3,10,38,58,4,4,38,67,26,38,9,29,5,10,10,35,67
2004-03-08 00:00:00.000,ATP Masters Series Indian Wells California; USA ATP World Tour,HARD,2,Vincent Spadea,N/A Bye,Vincent Spadea,,R128,0,0,0,0,0,0,0,0,0,0,0,0,0,0,0,0,0,0,0,0,0,0,0,0,0,0,0
2004-03-08 00:00:00.000,ATP Masters Series Indian Wells California; USA ATP World Tour,HARD,2,Marat Safin,N/A Bye,Marat Safin,,R128,0,0,0,0,0,0,0,0,0,0,0,0,0,0,0,0,0,0,0,0,0,0,0,0,0,0,0
2004-03-08 00:00:00.000,ATP Masters Series Indian Wells California; USA ATP World Tour,HARD,2,Jan Hernych,Nikolay Davydenko,Jan Hernych,2-6; 6-4; 6-1,R128,105,3,1,57,85,33,57,15,28,6,11,13,48,85,3,3,48,79,26,48,11,31,0,6,12,37,79
2004-03-08 00:00:00.000,ATP Masters Series Indian Wells California; USA ATP World Tour,HARD,2,Jan-Michael Gambill,John van Lottum,Jan-Michael Gambill,6-3; 3-6; 6-2,R128,106,21,0,52,68,40,52,12,16,2,3,13,52,68,1,3,52,101,37,52,22,49,6,9,13,59,101
2004-03-08 00:00:00.000,ATP Masters Series Indian Wells California; USA ATP World Tour,HARD,2,Andy Roddick,N/A Bye,Andy Roddick,,R128,0,0,0,0,0,0,0,0,0,0,0,0,0,0,0,0,0,0,0,0,0,0,0,0,0,0,0
2004-03-08 00:00:00.000,ATP Masters Series Indian Wells California; USA ATP World Tour,HARD,2,Carlos Moya,N/A Bye,Carlos Moya,,R128,0,0,0,0,0,0,0,0,0,0,0,0,0,0,0,0,0,0,0,0,0,0,0,0,0,0,0
2004-03-08 00:00:00.000,ATP Masters Series Indian Wells California; USA ATP World Tour,HARD,2,Irakli Labadze,Thierry Ascione,Irakli Labadze,7-6(3); 6-4,R128,81,4,5,43,71,33,43,17,28,2,3,11,50,71,4,1,40,59,30,40,10,19,0,2,11,40,59
2004-03-08 00:00:00.000,ATP Masters Series Indian Wells California; USA ATP World Tour,HARD,2,Hicham Arazi,Olivier Rochus,Hicham Arazi,6-4; 6-2,R128,70,3,0,39,58,25,39,14,19,5,6,9,39,58,1,2,19,50,9,19,18,31,1,5,9,27,50
2004-03-08 00:00:00.000,ATP Masters Series Indian Wells California; USA ATP World Tour,HARD,2,Jarkko Nieminen,N/A Bye,Jarkko Nieminen,,R128,0,0,0,0,0,0,0,0,0,0,0,0,0,0,0,0,0,0,0,0,0,0,0,0,0,0,0
2004-03-08 00:00:00.000,ATP Masters Series Indian Wells California; USA ATP World Tour,HARD,2,Agustin Calleri,N/A Bye,Agustin Calleri,,R128,0,0,0,0,0,0,0,0,0,0,0,0,0,0,0,0,0,0,0,0,0,0,0,0,0,0,0
2004-03-08 00:00:00.000,ATP Masters Series Indian Wells California; USA ATP World Tour,HARD,2,Robin Soderling,Ivan Ljubicic,Robin Soderling,6-3; 7-6(5),R128,74,5,1,39,60,32,39,16,21,0,0,11,48,60,8,2,46,64,34,46,10,18,1,2,10,44,64
2004-03-08 00:00:00.000,ATP Masters Series Indian Wells California; USA ATP World Tour,HARD,2,Rafael Nadal,Lars Burgsmuller,Rafael Nadal,6-2; 6-3,R128,71,0,1,42,68,30,42,14,26,8,9,9,44,68,2,1,27,46,18,27,5,19,3,7,8,23,46
2004-03-08 00:00:00.000,ATP Masters Series Indian Wells California; USA ATP World Tour,HARD,2,Nicolas Massu,N/A Bye,Nicolas Massu,,R128,0,0,0,0,0,0,0,0,0,0,0,0,0,0,0,0,0,0,0,0,0,0,0,0,0,0,0
2004-03-08 00:00:00.000,ATP Masters Series Indian Wells California; USA ATP World Tour,HARD,2,Gustavo Kuerten,N/A Bye,Gustavo Kuerten,,R128,0,0,0,0,0,0,0,0,0,0,0,0,0,0,0,0,0,0,0,0,0,0,0,0,0,0,0
2004-03-08 00:00:00.000,ATP Masters Series Indian Wells California; USA ATP World Tour,HARD,2,Taylor Dent,Giovanni Lapentti,Taylor Dent,1-6; 6-4; 6-4,R128,113,8,16,35,81,28,35,21,46,10,14,14,49,81,2,5,41,77,29,41,19,36,2,5,13,48,77
2004-03-08 00:00:00.000,ATP Masters Series Indian Wells California; USA ATP World Tour,HARD,2,Nicolas Lapentti,Ruben Ramirez Hidalgo,Nicolas Lapentti,6-2; 6-3,R128,86,5,1,27,48,20,27,14,21,1,1,8,34,48,1,8,40,76,24,40,16,36,7,11,9,40,76
2004-03-08 00:00:00.000,ATP Masters Series Indian Wells California; USA ATP World Tour,HARD,2,Martin Verkerk,N/A Bye,Martin Verkerk,,R128,0,0,0,0,0,0,0,0,0,0,0,0,0,0,0,0,0,0,0,0,0,0,0,0,0,0,0
2004-03-08 00:00:00.000,ATP Masters Series Indian Wells California; USA ATP World Tour,HARD,2,Robby Ginepri,N/A Bye,Robby Ginepri,,R128,0,0,0,0,0,0,0,0,0,0,0,0,0,0,0,0,0,0,0,0,0,0,0,0,0,0,0
2004-03-08 00:00:00.000,ATP Masters Series Indian Wells California; USA ATP World Tour,HARD,2,James Blake,Radek Stepanek,James Blake,6-2; 6-2,R128,58,3,2,20,43,17,20,15,23,0,0,8,32,43,3,3,33,53,18,33,9,20,2,6,8,27,53
2004-03-08 00:00:00.000,ATP Masters Series Indian Wells California; USA ATP World Tour,HARD,2,Wayne Ferreira,Igor Andreev,Wayne Ferreira,6-4; 6-2,R128,64,6,2,33,55,28,33,13,22,4,4,9,41,55,0,3,40,60,25,40,8,20,4,7,9,33,60
2004-03-08 00:00:00.000,ATP Masters Series Indian Wells California; USA ATP World Tour,HARD,2,Gaston Gaudio,N/A Bye,Gaston Gaudio,,R128,0,0,0,0,0,0,0,0,0,0,0,0,0,0,0,0,0,0,0,0,0,0,0,0,0,0,0
2004-03-08 00:00:00.000,ATP Masters Series Indian Wells California; USA ATP World Tour,HARD,2,Roger Federer,Andrei Pavel,Roger Federer,6-1; 6-1,R64,64,5,2,29,44,22,29,9,15,3,3,7,31,44,1,3,35,59,19,35,8,24,2,7,7,27,59
2004-03-08 00:00:00.000,ATP Masters Series Indian Wells California; USA ATP World Tour,HARD,2,Fernando Gonzalez,Victor Hanescu,Fernando Gonzalez,3-6; 6-3; 6-4,R64,105,13,8,38,72,30,38,21,34,1,3,14,51,72,9,1,57,95,39,57,21,38,7,10,14,60,95
2004-03-08 00:00:00.000,ATP Masters Series Indian Wells California; USA ATP World Tour,HARD,2,Mardy Fish,Glenn Weiner,Mardy Fish,6-4; 6-4,R64,82,8,4,35,63,29,35,13,28,4,5,10,42,63,7,2,44,73,32,44,9,29,10,13,10,41,73
2004-03-08 00:00:00.000,ATP Masters Series Indian Wells California; USA ATP World Tour,HARD,2,Jiri Novak,Antony Dupuis,Jiri Novak,6-2; 6-0,R64,51,6,0,26,33,21,26,7,7,0,0,7,28,33,1,0,32,46,14,32,6,14,4,9,7,20,46
2004-03-08 00:00:00.000,ATP Masters Series Indian Wells California; USA ATP World Tour,HARD,2,Tommy Haas,Paradorn Srichaphan,Tommy Haas,6-1; 6-2,R64,68,6,2,29,53,21,29,15,24,1,1,8,36,53,0,1,28,45,11,28,9,17,2,6,7,20,45
2004-03-08 00:00:00.000,ATP Masters Series Indian Wells California; USA ATP World Tour,HARD,2,Albert Costa,Guillermo Canas,Albert Costa,7-5; 6-7(3); 6-4,R64,174,16,2,57,104,43,57,28,47,4,6,17,71,104,16,4,72,126,51,72,24,54,7,11,17,75,126
2004-03-08 00:00:00.000,ATP Masters Series Indian Wells California; USA ATP World Tour,HARD,2,Juan Ignacio Chela,Alberto Martin,Juan Ignacio Chela,5-7; 6-2; 6-0,R64,118,4,1,53,78,37,53,13,25,3,6,13,50,78,6,6,49,87,29,49,13,38,9,16,13,42,87
2004-03-08 00:00:00.000,ATP Masters Series Indian Wells California; USA ATP World Tour,HARD,2,Lleyton Hewitt,Thomas Johansson,Lleyton Hewitt,6-2; 6-3,R64,79,4,1,26,49,18,26,12,23,2,4,8,30,49,2,2,31,64,19,31,12,33,7,13,9,31,64
2004-03-08 00:00:00.000,ATP Masters Series Indian Wells California; USA ATP World Tour,HARD,2,Guillermo Coria,Sargis Sargsian,Guillermo Coria,6-3; 6-4,R64,82,4,2,37,55,27,37,9,18,3,5,10,36,55,2,1,39,61,20,39,11,22,5,9,9,31,61
2004-03-08 00:00:00.000,ATP Masters Series Indian Wells California; USA ATP World Tour,HARD,2,Max Mirnyi,Alex Bogomolov Jr.,Max Mirnyi,7-6(4); 6-4,R64,89,14,6,53,87,41,53,19,34,6,6,11,60,87,0,1,53,68,41,53,7,15,1,2,11,48,68
2004-03-08 00:00:00.000,ATP Masters Series Indian Wells California; USA ATP World Tour,HARD,2,Raemon Sluiter,Arnaud Clement,Raemon Sluiter,6-2; 6-4,R64,79,6,5,28,51,25,28,12,23,0,0,9,37,51,6,2,25,61,15,25,19,36,2,5,9,34,61
2004-03-08 00:00:00.000,ATP Masters Series Indian Wells California; USA ATP World Tour,HARD,2,Sebastien Grosjean,Davide Sanguinetti,Sebastien Grosjean,6-2; 6-2,R64,68,5,2,22,52,18,22,16,30,2,3,8,34,52,3,6,28,54,18,28,7,26,1,6,8,25,54
2004-03-08 00:00:00.000,ATP Masters Series Indian Wells California; USA ATP World Tour,HARD,2,Mikhail Youzhny,Mark Philippoussis,Mikhail Youzhny,7-6(5); 7-5,R64,112,10,2,44,82,33,44,20,38,5,7,12,53,82,5,3,50,87,39,50,13,37,7,10,12,52,87
2004-03-08 00:00:00.000,ATP Masters Series Indian Wells California; USA ATP World Tour,HARD,2,Luis Horna,Feliciano Lopez,Luis Horna,6-3; 7-6(3),R64,77,3,2,43,59,35,43,12,16,2,3,11,47,59,7,3,31,65,25,31,16,34,3,5,10,41,65
2004-03-08 00:00:00.000,ATP Masters Series Indian Wells California; USA ATP World Tour,HARD,2,Dominik Hrbaty,Xavier Malisse,Dominik Hrbaty,6-4; 6-3,R64,75,0,0,50,62,34,50,9,12,7,8,10,43,62,8,2,33,56,22,33,10,23,5,8,9,32,56
2004-03-08 00:00:00.000,ATP Masters Series Indian Wells California; USA ATP World Tour,HARD,2,Andre Agassi,David Sanchez,Andre Agassi,6-2; 6-2,R64,63,3,0,30,46,23,30,12,16,1,1,8,35,46,1,1,25,51,14,25,10,26,2,6,8,24,51
2004-03-08 00:00:00.000,ATP Masters Series Indian Wells California; USA ATP World Tour,HARD,2,Wayne Arthurs,Rainer Schuettler,Wayne Arthurs,6-1; 7-6(3),R64,77,12,1,40,68,30,40,17,28,3,3,10,47,68,1,3,40,58,27,40,9,18,3,5,9,36,58
2004-03-08 00:00:00.000,ATP Masters Series Indian Wells California; USA ATP World Tour,HARD,2,Jonas Bjorkman,Harel Levy,Jonas Bjorkman,6-1; 6-3,R64,63,1,2,19,41,18,19,15,22,0,0,8,33,41,2,2,37,66,22,37,12,29,8,12,8,34,66
2004-03-08 00:00:00.000,ATP Masters Series Indian Wells California; USA ATP World Tour,HARD,2,Alex Corretja,Tommy Robredo,Alex Corretja,6-1; 6-4,R64,82,0,6,42,70,31,42,14,28,4,4,9,45,70,5,5,23,44,15,23,9,21,2,5,8,24,44
2004-03-08 00:00:00.000,ATP Masters Series Indian Wells California; USA ATP World Tour,HARD,2,Tim Henman,Simon Larose,Tim Henman,6-3; 6-2,R64,62,6,2,23,47,16,23,19,24,1,2,9,35,47,1,2,26,50,12,26,13,24,6,10,8,25,50
2004-03-08 00:00:00.000,ATP Masters Series Indian Wells California; USA ATP World Tour,HARD,2,Nicolas Escude,Sjeng Schalken,Nicolas Escude,6-3; 6-2,R64,77,3,3,32,66,22,32,18,34,4,6,9,40,66,0,3,26,47,15,26,8,21,1,6,8,23,47
2004-03-08 00:00:00.000,ATP Masters Series Indian Wells California; USA ATP World Tour,HARD,2,Vincent Spadea,Flavio Saretta,Vincent Spadea,6-3; 6-2,R64,81,4,2,37,56,25,37,9,19,2,4,9,34,56,2,4,30,62,17,30,11,32,7,12,8,28,62
2004-03-08 00:00:00.000,ATP Masters Series Indian Wells California; USA ATP World Tour,HARD,2,Marat Safin,Jan Hernych,Marat Safin,6-4; 7-6(3),R64,91,8,2,39,65,33,39,13,26,1,2,11,46,65,4,2,47,80,33,47,15,33,7,9,11,48,80
2004-03-08 00:00:00.000,ATP Masters Series Indian Wells California; USA ATP World Tour,HARD,2,Andy Roddick,Jan-Michael Gambill,Andy Roddick,7-6(3); 6-2,R64,94,21,2,42,70,37,42,16,28,3,3,10,53,70,7,7,47,84,34,47,14,37,8,10,10,48,84
2004-03-08 00:00:00.000,ATP Masters Series Indian Wells California; USA ATP World Tour,HARD,2,Irakli Labadze,Carlos Moya,Irakli Labadze,2-6; 6-1; 6-3,R64,95,5,3,37,74,26,37,23,37,4,6,12,49,74,4,3,33,68,19,33,23,35,1,5,12,42,68
2004-03-08 00:00:00.000,ATP Masters Series Indian Wells California; USA ATP World Tour,HARD,2,Hicham Arazi,Jarkko Nieminen,Hicham Arazi,6-3; 6-3,R64,74,3,2,40,70,30,40,17,30,5,5,9,47,70,3,2,30,49,20,30,10,19,2,5,9,30,49
2004-03-08 00:00:00.000,ATP Masters Series Indian Wells California; USA ATP World Tour,HARD,2,Agustin Calleri,Robin Soderling,Agustin Calleri,6-4; 3-6; 6-3,R64,104,19,5,56,95,42,56,20,39,10,12,14,62,95,8,4,53,86,42,53,14,33,8,11,14,56,86
2004-03-08 00:00:00.000,ATP Masters Series Indian Wells California; USA ATP World Tour,HARD,2,Rafael Nadal,Nicolas Massu,Rafael Nadal,6-3; 1-0 RET,R64,47,3,1,21,30,15,21,6,9,0,0,5,21,30,5,2,28,42,18,28,5,14,6,8,5,23,42
2004-03-08 00:00:00.000,ATP Masters Series Indian Wells California; USA ATP World Tour,HARD,2,Taylor Dent,Gustavo Kuerten,Taylor Dent,7-5; 6-4,R64,82,11,8,33,71,25,33,20,38,4,6,11,45,71,4,3,34,69,23,34,15,35,7,11,11,38,69
2004-03-08 00:00:00.000,ATP Masters Series Indian Wells California; USA ATP World Tour,HARD,2,Nicolas Lapentti,Martin Verkerk,Nicolas Lapentti,7-5; 6-4,R64,90,8,1,48,74,36,48,13,26,3,4,11,49,74,13,2,54,69,37,54,5,15,1,4,11,42,69
2004-03-08 00:00:00.000,ATP Masters Series Indian Wells California; USA ATP World Tour,HARD,2,James Blake,Robby Ginepri,James Blake,6-4; 7-5,R64,78,10,5,42,77,33,42,17,35,4,5,11,50,77,3,2,42,74,26,42,18,32,4,7,11,44,74
2004-03-08 00:00:00.000,ATP Masters Series Indian Wells California; USA ATP World Tour,HARD,2,Gaston Gaudio,Wayne Ferreira,Gaston Gaudio,6-2; 7-5,R64,81,2,1,41,66,28,41,14,25,5,7,10,42,66,7,6,34,73,21,34,17,39,7,12,10,38,73
2004-03-08 00:00:00.000,ATP Masters Series Indian Wells California; USA ATP World Tour,HARD,2,Roger Federer,Fernando Gonzalez,Roger Federer,6-3; 6-2,R32,63,6,3,31,58,25,31,15,27,1,1,9,40,58,1,3,26,50,18,26,11,24,4,7,8,29,50
2004-03-08 00:00:00.000,ATP Masters Series Indian Wells California; USA ATP World Tour,HARD,2,Mardy Fish,Jiri Novak,Mardy Fish,6-3; 6-4,R32,73,9,8,38,77,29,38,16,39,8,10,10,45,77,1,4,36,54,23,36,7,18,0,4,9,30,54
2004-03-08 00:00:00.000,ATP Masters Series Indian Wells California; USA ATP World Tour,HARD,2,Tommy Haas,Albert Costa,Tommy Haas,7-6(4); 3-6; 6-3,R32,144,8,5,45,91,29,45,26,46,5,9,15,55,91,7,3,49,88,35,49,19,39,4,8,15,54,88
2004-03-08 00:00:00.000,ATP Masters Series Indian Wells California; USA ATP World Tour,HARD,2,Juan Ignacio Chela,Lleyton Hewitt,Juan Ignacio Chela,6-3; 4-6; 6-1,R32,132,2,0,71,98,46,71,15,27,11,13,13,61,98,4,8,36,92,24,36,26,56,7,12,13,50,92
2004-03-08 00:00:00.000,ATP Masters Series Indian Wells California; USA ATP World Tour,HARD,2,Guillermo Coria,Max Mirnyi,Guillermo Coria,6-4; 7-5,R32,84,4,2,48,61,41,48,7,13,2,2,11,48,61,2,3,35,63,25,35,17,28,3,5,11,42,63
2004-03-08 00:00:00.000,ATP Masters Series Indian Wells California; USA ATP World Tour,HARD,2,Sebastien Grosjean,Raemon Sluiter,Sebastien Grosjean,6-7(4); 6-4; 6-4,R32,134,10,2,41,89,35,41,29,48,2,4,16,64,89,15,4,72,110,56,72,12,38,8,12,16,68,110
2004-03-08 00:00:00.000,ATP Masters Series Indian Wells California; USA ATP World Tour,HARD,2,Mikhail Youzhny,Luis Horna,Mikhail Youzhny,7-6(12); 6-2,R32,114,8,0,30,63,25,30,21,33,0,1,10,46,63,4,5,63,93,39,63,12,30,4,7,10,51,93
2004-03-08 00:00:00.000,ATP Masters Series Indian Wells California; USA ATP World Tour,HARD,2,Andre Agassi,Dominik Hrbaty,Andre Agassi,6-2; 6-4,R32,65,9,2,27,51,22,27,17,24,0,0,9,39,51,5,5,45,64,27,45,8,19,4,7,9,35,64
2004-03-08 00:00:00.000,ATP Masters Series Indian Wells California; USA ATP World Tour,HARD,2,Wayne Arthurs,Jonas Bjorkman,Wayne Arthurs,4-6; 6-2; 6-3,R32,118,19,9,53,100,42,53,20,47,7,9,14,62,100,3,10,41,79,31,41,18,38,0,4,13,49,79
2004-03-08 00:00:00.000,ATP Masters Series Indian Wells California; USA ATP World Tour,HARD,2,Tim Henman,Alex Corretja,Tim Henman,6-4; 6-4,R32,102,3,3,29,58,22,29,16,29,1,3,10,38,58,0,2,44,68,27,44,8,24,4,8,10,35,68
2004-03-08 00:00:00.000,ATP Masters Series Indian Wells California; USA ATP World Tour,HARD,2,Nicolas Escude,Vincent Spadea,Nicolas Escude,3-6; 6-4; 7-6(5),R32,126,8,1,61,94,47,61,20,33,0,3,16,67,94,4,1,52,91,37,52,23,39,3,5,15,60,91
2004-03-08 00:00:00.000,ATP Masters Series Indian Wells California; USA ATP World Tour,HARD,2,Andy Roddick,Marat Safin,Andy Roddick,7-6(6); 6-2,R32,85,9,1,40,61,32,40,12,21,0,1,10,44,61,8,3,40,72,30,40,14,32,5,8,10,44,72
2004-03-08 00:00:00.000,ATP Masters Series Indian Wells California; USA ATP World Tour,HARD,2,Irakli Labadze,Hicham Arazi,Irakli Labadze,6-3; 6-4,R32,81,4,6,23,57,19,23,21,34,1,2,10,40,57,4,2,35,62,23,35,13,27,4,7,9,36,62
2004-03-08 00:00:00.000,ATP Masters Series Indian Wells California; USA ATP World Tour,HARD,2,Agustin Calleri,Rafael Nadal,Agustin Calleri,6-4; 3-6; 7-6(10),R32,158,8,3,52,98,39,52,23,46,2,6,15,62,98,0,0,85,118,50,85,21,33,12,16,16,71,118
2004-03-08 00:00:00.000,ATP Masters Series Indian Wells California; USA ATP World Tour,HARD,2,Taylor Dent,Nicolas Lapentti,Taylor Dent,6-3; 6-2,R32,70,8,6,33,61,27,33,16,28,4,4,9,43,61,2,1,29,47,19,29,8,18,3,6,8,27,47
2004-03-08 00:00:00.000,ATP Masters Series Indian Wells California; USA ATP World Tour,HARD,2,James Blake,Gaston Gaudio,James Blake,3-6; 6-2; 6-3,R32,111,9,4,48,79,34,48,16,31,4,7,13,50,79,2,4,72,107,39,72,19,35,7,12,13,58,107
2004-03-08 00:00:00.000,ATP Masters Series Indian Wells California; USA ATP World Tour,HARD,2,Roger Federer,Mardy Fish,Roger Federer,6-4; 6-1,R16,71,7,1,33,51,26,33,11,18,1,1,9,37,51,8,5,31,61,22,31,11,30,7,10,8,33,61
2004-03-08 00:00:00.000,ATP Masters Series Indian Wells California; USA ATP World Tour,HARD,2,Juan Ignacio Chela,Tommy Haas,Juan Ignacio Chela,6-4; 6-2,R16,74,3,1,34,52,23,34,15,18,0,0,9,38,52,0,1,30,52,22,30,8,22,1,4,9,30,52
2004-03-08 00:00:00.000,ATP Masters Series Indian Wells California; USA ATP World Tour,HARD,2,Guillermo Coria,Sebastien Grosjean,Guillermo Coria,3-6; 7-6(2); 6-2,R16,135,2,3,57,82,45,57,15,25,1,3,14,60,82,5,1,48,101,37,48,28,53,10,13,15,65,101
2004-03-08 00:00:00.000,ATP Masters Series Indian Wells California; USA ATP World Tour,HARD,2,Andre Agassi,Mikhail Youzhny,Andre Agassi,7-5; 6-2,R16,92,4,1,23,54,17,23,19,31,4,6,10,36,54,6,7,36,81,22,36,19,45,9,14,10,41,81
2004-03-08 00:00:00.000,ATP Masters Series Indian Wells California; USA ATP World Tour,HARD,2,Tim Henman,Wayne Arthurs,Tim Henman,6-1; 6-3,R16,61,5,3,24,40,20,24,10,16,1,2,8,30,40,3,5,27,52,18,27,6,25,0,5,8,24,52
2004-03-08 00:00:00.000,ATP Masters Series Indian Wells California; USA ATP World Tour,HARD,2,Andy Roddick,Nicolas Escude,Andy Roddick,6-3; 6-2,R16,70,16,1,29,57,27,29,13,28,4,4,9,40,57,1,3,30,59,20,30,11,29,6,9,8,31,59
2004-03-08 00:00:00.000,ATP Masters Series Indian Wells California; USA ATP World Tour,HARD,2,Irakli Labadze,Agustin Calleri,Irakli Labadze,1-6; 6-3; 6-4,R16,104,5,9,43,81,32,43,21,38,5,8,13,53,81,8,3,49,75,35,49,13,26,0,3,13,48,75
2004-03-08 00:00:00.000,ATP Masters Series Indian Wells California; USA ATP World Tour,HARD,2,James Blake,Taylor Dent,James Blake,7-6(4); 4-6; 6-1,R16,123,6,6,73,112,51,73,17,39,7,11,15,68,112,1,9,60,107,39,60,19,47,8,13,14,58,107
2004-03-08 00:00:00.000,ATP Masters Series Indian Wells California; USA ATP World Tour,HARD,2,Roger Federer,Juan Ignacio Chela,Roger Federer,6-2; 6-1,Q,63,4,2,31,53,23,31,12,22,1,2,8,35,53,1,1,33,49,15,33,6,16,4,9,7,21,49
2004-03-08 00:00:00.000,ATP Masters Series Indian Wells California; USA ATP World Tour,HARD,2,Andre Agassi,Guillermo Coria,Andre Agassi,6-4; 7-5,Q,81,5,2,32,60,21,32,17,28,0,2,11,38,60,2,1,44,63,27,44,10,19,5,9,11,37,63
2004-03-08 00:00:00.000,ATP Masters Series Indian Wells California; USA ATP World Tour,HARD,2,Tim Henman,Andy Roddick,Tim Henman,6-7(6); 7-6(1); 6-3,Q,152,6,3,74,120,56,74,25,46,5,7,17,81,120,12,4,60,102,41,60,26,42,4,7,16,67,102
2004-03-08 00:00:00.000,ATP Masters Series Indian Wells California; USA ATP World Tour,HARD,2,Irakli Labadze,James Blake,Irakli Labadze,6-7(1); 6-4; 6-1,Q,116,5,6,49,92,36,49,28,43,2,2,15,64,92,4,4,51,92,36,51,20,41,5,8,14,56,92
2004-03-08 00:00:00.000,ATP Masters Series Indian Wells California; USA ATP World Tour,HARD,2,Roger Federer,Andre Agassi,Roger Federer,4-6; 6-3; 6-4,S,113,12,5,50,85,41,50,22,35,5,6,15,63,85,2,4,59,93,45,59,16,34,4,6,14,61,93
2004-03-08 00:00:00.000,ATP Masters Series Indian Wells California; USA ATP World Tour,HARD,2,Tim Henman,Irakli Labadze,Tim Henman,6-3; 6-2,S,63,5,2,24,42,21,24,12,18,0,1,9,33,42,0,6,25,45,16,25,7,20,3,7,8,23,45
2004-03-08 00:00:00.000,ATP Masters Series Indian Wells California; USA ATP World Tour,HARD,2,Roger Federer,Tim Henman,Roger Federer,6-3; 6-3,F,67,3,0,27,45,23,27,13,18,0,0,9,36,45,0,3,31,52,20,31,10,21,3,6,9,30,52
2004-03-22 00:00:00.000,ATP Masters Series Miami FL; U.S.A. ATP World Tour,HARD,2,Roger Federer,N/A Bye,Roger Federer,,R128,0,0,0,0,0,0,0,0,0,0,0,0,0,0,0,0,0,0,0,0,0,0,0,0,0,0,0
2004-03-22 00:00:00.000,ATP Masters Series Miami FL; U.S.A. ATP World Tour,HARD,2,Nikolay Davydenko,Thomas Johansson,Nikolay Davydenko,6-2; 2-6; 6-3,R128,107,3,5,45,82,31,45,17,37,2,5,12,48,82,6,3,44,79,27,44,15,35,5,10,13,42,79
2004-03-22 00:00:00.000,ATP Masters Series Miami FL; U.S.A. ATP World Tour,HARD,2,Goran Ivanisevic,Nicolas Escude,Goran Ivanisevic,6-4; 5-7; 7-6(7),R128,122,12,11,51,110,38,51,32,59,1,6,17,70,110,7,3,64,104,44,64,22,40,3,8,17,66,104
2004-03-22 00:00:00.000,ATP Masters Series Miami FL; U.S.A. ATP World Tour,HARD,2,Rafael Nadal,N/A Bye,Rafael Nadal,,R128,0,0,0,0,0,0,0,0,0,0,0,0,0,0,0,0,0,0,0,0,0,0,0,0,0,0,0
2004-03-22 00:00:00.000,ATP Masters Series Miami FL; U.S.A. ATP World Tour,HARD,2,Fernando Gonzalez,N/A Bye,Fernando Gonzalez,,R128,0,0,0,0,0,0,0,0,0,0,0,0,0,0,0,0,0,0,0,0,0,0,0,0,0,0,0
2004-03-22 00:00:00.000,ATP Masters Series Miami FL; U.S.A. ATP World Tour,HARD,2,Karol Kucera,Alex Bogomolov Jr.,Karol Kucera,0-6; 7-6(3); 6-4,R128,120,3,6,53,88,34,53,15,35,7,12,14,49,88,0,1,70,96,44,70,13,26,7,10,14,57,96
2004-03-22 00:00:00.000,ATP Masters Series Miami FL; U.S.A. ATP World Tour,HARD,2,Stefan Koubek,Alberto Martin,Stefan Koubek,2-6; 7-6(3); 6-0,R128,105,0,3,62,86,43,62,11,24,4,6,13,54,86,3,5,46,80,36,46,16,34,2,5,13,52,80
2004-03-22 00:00:00.000,ATP Masters Series Miami FL; U.S.A. ATP World Tour,HARD,2,Jiri Novak,N/A Bye,Jiri Novak,,R128,0,0,0,0,0,0,0,0,0,0,0,0,0,0,0,0,0,0,0,0,0,0,0,0,0,0,0
2004-03-22 00:00:00.000,ATP Masters Series Miami FL; U.S.A. ATP World Tour,HARD,2,Nicolas Massu,N/A Bye,Nicolas Massu,,R128,0,0,0,0,0,0,0,0,0,0,0,0,0,0,0,0,0,0,0,0,0,0,0,0,0,0,0
2004-03-22 00:00:00.000,ATP Masters Series Miami FL; U.S.A. ATP World Tour,HARD,2,Andrei Pavel,Dmitry Tursunov,Andrei Pavel,6-2; 7-6(4),R128,89,4,2,43,66,29,43,13,23,2,4,10,42,66,3,4,37,77,22,37,19,40,5,9,10,41,77
2004-03-22 00:00:00.000,ATP Masters Series Miami FL; U.S.A. ATP World Tour,HARD,2,Robin Soderling,David Ferrer,Robin Soderling,7-6(5); 6-4,R128,80,3,2,38,68,31,38,17,30,4,5,11,48,68,5,1,42,65,31,42,11,23,4,6,11,42,65
2004-03-22 00:00:00.000,ATP Masters Series Miami FL; U.S.A. ATP World Tour,HARD,2,Lleyton Hewitt,N/A Bye,Lleyton Hewitt,,R128,0,0,0,0,0,0,0,0,0,0,0,0,0,0,0,0,0,0,0,0,0,0,0,0,0,0,0
2004-03-22 00:00:00.000,ATP Masters Series Miami FL; U.S.A. ATP World Tour,HARD,2,Jarkko Nieminen,N/A Bye,Jarkko Nieminen,,R128,0,0,0,0,0,0,0,0,0,0,0,0,0,0,0,0,0,0,0,0,0,0,0,0,0,0,0
2004-03-22 00:00:00.000,ATP Masters Series Miami FL; U.S.A. ATP World Tour,HARD,2,Todd Martin,Ivo Heuberger,Todd Martin,3-6; 6-4; 6-2,R128,109,2,3,45,71,26,45,15,26,5,10,13,41,71,5,2,52,89,29,52,17,37,7,14,14,46,89
2004-03-22 00:00:00.000,ATP Masters Series Miami FL; U.S.A. ATP World Tour,HARD,2,Jurgen Melzer,Ivo Karlovic,Jurgen Melzer,6-4; 6-4,R128,61,2,2,41,61,30,41,13,20,1,1,10,43,61,10,2,39,54,28,39,9,15,1,3,10,37,54
2004-03-22 00:00:00.000,ATP Masters Series Miami FL; U.S.A. ATP World Tour,HARD,2,Tim Henman,N/A Bye,Tim Henman,,R128,0,0,0,0,0,0,0,0,0,0,0,0,0,0,0,0,0,0,0,0,0,0,0,0,0,0,0
2004-03-22 00:00:00.000,ATP Masters Series Miami FL; U.S.A. ATP World Tour,HARD,2,Guillermo Coria,N/A Bye,Guillermo Coria,,R128,0,0,0,0,0,0,0,0,0,0,0,0,0,0,0,0,0,0,0,0,0,0,0,0,0,0,0
2004-03-22 00:00:00.000,ATP Masters Series Miami FL; U.S.A. ATP World Tour,HARD,2,Wayne Ferreira,Raemon Sluiter,Wayne Ferreira,6-3; 6-1,R128,52,4,2,26,49,21,26,14,23,4,4,8,35,49,0,4,23,47,13,23,11,24,1,5,8,24,47
2004-03-22 00:00:00.000,ATP Masters Series Miami FL; U.S.A. ATP World Tour,HARD,2,Cyril Saulnier,Brian Baker,Cyril Saulnier,6-4; 6-3,R128,65,10,1,36,55,28,36,11,19,1,2,10,39,55,2,6,34,60,24,34,11,26,4,7,9,35,60
2004-03-22 00:00:00.000,ATP Masters Series Miami FL; U.S.A. ATP World Tour,HARD,2,Juan Ignacio Chela,N/A Bye,Juan Ignacio Chela,,R128,0,0,0,0,0,0,0,0,0,0,0,0,0,0,0,0,0,0,0,0,0,0,0,0,0,0,0
2004-03-22 00:00:00.000,ATP Masters Series Miami FL; U.S.A. ATP World Tour,HARD,2,Arnaud Clement,N/A Bye,Arnaud Clement,,R128,0,0,0,0,0,0,0,0,0,0,0,0,0,0,0,0,0,0,0,0,0,0,0,0,0,0,0
2004-03-22 00:00:00.000,ATP Masters Series Miami FL; U.S.A. ATP World Tour,HARD,2,Ivan Ljubicic,Davide Sanguinetti,Ivan Ljubicic,6-1; 6-3,R128,57,6,5,29,51,23,29,12,22,3,4,8,35,51,0,3,26,46,13,26,9,20,1,6,8,22,46
2004-03-22 00:00:00.000,ATP Masters Series Miami FL; U.S.A. ATP World Tour,HARD,2,Julien Benneteau,Jeff Morrison,Julien Benneteau,6-3; 2-6; 7-5,R128,99,3,3,52,83,33,52,16,31,4,9,15,49,83,8,8,42,92,31,42,21,50,6,11,14,52,92
2004-03-22 00:00:00.000,ATP Masters Series Miami FL; U.S.A. ATP World Tour,HARD,2,Mardy Fish,N/A Bye,Mardy Fish,,R128,0,0,0,0,0,0,0,0,0,0,0,0,0,0,0,0,0,0,0,0,0,0,0,0,0,0,0
2004-03-22 00:00:00.000,ATP Masters Series Miami FL; U.S.A. ATP World Tour,HARD,2,Sebastien Grosjean,N/A Bye,Sebastien Grosjean,,R128,0,0,0,0,0,0,0,0,0,0,0,0,0,0,0,0,0,0,0,0,0,0,0,0,0,0,0
2004-03-22 00:00:00.000,ATP Masters Series Miami FL; U.S.A. ATP World Tour,HARD,2,Nicolas Lapentti,Thomas Enqvist,Nicolas Lapentti,7-5; 2-6; 6-4,R128,113,6,2,46,76,33,46,20,30,3,6,15,53,76,1,3,70,104,46,70,17,34,9,12,15,63,104
2004-03-22 00:00:00.000,ATP Masters Series Miami FL; U.S.A. ATP World Tour,HARD,2,Thierry Ascione,Hicham Arazi,Thierry Ascione,7-5; 6-4,R128,81,6,2,44,67,31,44,14,23,6,7,11,45,67,3,1,38,64,24,38,15,26,2,5,11,39,64
2004-03-22 00:00:00.000,ATP Masters Series Miami FL; U.S.A. ATP World Tour,HARD,2,Feliciano Lopez,N/A Bye,Feliciano Lopez,,R128,0,0,0,0,0,0,0,0,0,0,0,0,0,0,0,0,0,0,0,0,0,0,0,0,0,0,0
2004-03-22 00:00:00.000,ATP Masters Series Miami FL; U.S.A. ATP World Tour,HARD,2,Gaston Gaudio,N/A Bye,Gaston Gaudio,,R128,0,0,0,0,0,0,0,0,0,0,0,0,0,0,0,0,0,0,0,0,0,0,0,0,0,0,0
2004-03-22 00:00:00.000,ATP Masters Series Miami FL; U.S.A. ATP World Tour,HARD,2,Robby Ginepri,Ruben Ramirez Hidalgo,Robby Ginepri,6-2; 6-2,R128,67,2,3,26,50,19,26,15,24,4,5,8,34,50,0,7,27,56,16,27,10,29,9,14,8,26,56
2004-03-22 00:00:00.000,ATP Masters Series Miami FL; U.S.A. ATP World Tour,HARD,2,Nicolas Kiefer,Igor Andreev,Nicolas Kiefer,6-3; 6-4,R128,78,8,3,38,69,28,38,16,31,7,8,10,44,69,2,1,32,51,18,32,13,19,4,7,9,31,51
2004-03-22 00:00:00.000,ATP Masters Series Miami FL; U.S.A. ATP World Tour,HARD,2,Rainer Schuettler,N/A Bye,Rainer Schuettler,,R128,0,0,0,0,0,0,0,0,0,0,0,0,0,0,0,0,0,0,0,0,0,0,0,0,0,0,0
2004-03-22 00:00:00.000,ATP Masters Series Miami FL; U.S.A. ATP World Tour,HARD,2,Fernando Verdasco,N/A Bye,Fernando Verdasco,,R128,0,0,0,0,0,0,0,0,0,0,0,0,0,0,0,0,0,0,0,0,0,0,0,0,0,0,0
2004-03-22 00:00:00.000,ATP Masters Series Miami FL; U.S.A. ATP World Tour,HARD,2,Radek Stepanek,Sargis Sargsian,Radek Stepanek,6-3; 6-4,R128,72,5,0,34,57,24,34,14,23,3,4,10,38,57,1,1,41,50,23,41,6,9,2,5,9,29,50
2004-03-22 00:00:00.000,ATP Masters Series Miami FL; U.S.A. ATP World Tour,HARD,2,Vincent Spadea,James Blake,Vincent Spadea,6-7(12); 7-6(4); 6-1,R128,145,4,3,56,119,36,56,39,63,6,9,16,75,119,3,4,75,130,48,75,25,55,10,15,15,73,130
2004-03-22 00:00:00.000,ATP Masters Series Miami FL; U.S.A. ATP World Tour,HARD,2,Marat Safin,N/A Bye,Marat Safin,,R128,0,0,0,0,0,0,0,0,0,0,0,0,0,0,0,0,0,0,0,0,0,0,0,0,0,0,0
2004-03-22 00:00:00.000,ATP Masters Series Miami FL; U.S.A. ATP World Tour,HARD,2,Gustavo Kuerten,N/A Bye,Gustavo Kuerten,,R128,0,0,0,0,0,0,0,0,0,0,0,0,0,0,0,0,0,0,0,0,0,0,0,0,0,0,0
2004-03-22 00:00:00.000,ATP Masters Series Miami FL; U.S.A. ATP World Tour,HARD,2,Juan Monaco,Joachim Johansson,Juan Monaco,7-6(6); 6-2,R128,70,1,1,46,62,35,46,10,16,1,2,10,45,62,11,8,47,75,34,47,10,28,3,6,10,44,75
2004-03-22 00:00:00.000,ATP Masters Series Miami FL; U.S.A. ATP World Tour,HARD,2,Ricardo Mello,Jeff Salzenstein,Ricardo Mello,7-6(3); 7-6(6),R128,108,2,5,63,90,40,63,15,27,3,6,12,55,90,7,4,54,82,38,54,11,28,2,5,12,49,82
2004-03-22 00:00:00.000,ATP Masters Series Miami FL; U.S.A. ATP World Tour,HARD,2,Paradorn Srichaphan,N/A Bye,Paradorn Srichaphan,,R128,0,0,0,0,0,0,0,0,0,0,0,0,0,0,0,0,0,0,0,0,0,0,0,0,0,0,0
2004-03-22 00:00:00.000,ATP Masters Series Miami FL; U.S.A. ATP World Tour,HARD,2,Martin Verkerk,N/A Bye,Martin Verkerk,,R128,0,0,0,0,0,0,0,0,0,0,0,0,0,0,0,0,0,0,0,0,0,0,0,0,0,0,0
2004-03-22 00:00:00.000,ATP Masters Series Miami FL; U.S.A. ATP World Tour,HARD,2,Todd Reid,Flavio Saretta,Todd Reid,6-4; 6-4,R128,74,0,2,48,71,26,48,14,23,3,6,10,40,71,3,1,27,51,16,27,9,24,1,6,10,25,51
2004-03-22 00:00:00.000,ATP Masters Series Miami FL; U.S.A. ATP World Tour,HARD,2,Lars Burgsmuller,Jan-Michael Gambill,Lars Burgsmuller,7-5; 6-4,R128,95,4,4,31,63,23,31,17,32,3,5,11,40,63,10,3,49,85,35,49,11,36,9,13,11,46,85
2004-03-22 00:00:00.000,ATP Masters Series Miami FL; U.S.A. ATP World Tour,HARD,2,Agustin Calleri,N/A Bye,Agustin Calleri,,R128,0,0,0,0,0,0,0,0,0,0,0,0,0,0,0,0,0,0,0,0,0,0,0,0,0,0,0
2004-03-22 00:00:00.000,ATP Masters Series Miami FL; U.S.A. ATP World Tour,HARD,2,Max Mirnyi,N/A Bye,Max Mirnyi,,R128,0,0,0,0,0,0,0,0,0,0,0,0,0,0,0,0,0,0,0,0,0,0,0,0,0,0,0
2004-03-22 00:00:00.000,ATP Masters Series Miami FL; U.S.A. ATP World Tour,HARD,2,Franco Squillari,Hyung-Taik Lee,Franco Squillari,2-6; 6-2; 6-3,R128,106,6,6,36,70,28,36,17,34,5,8,12,45,70,2,1,63,97,34,63,20,34,6,11,13,54,97
2004-03-22 00:00:00.000,ATP Masters Series Miami FL; U.S.A. ATP World Tour,HARD,2,Mariano Zabaleta,Gregory Carraz,Mariano Zabaleta,6-4; 7-5,R128,96,6,1,35,64,25,35,19,29,0,1,11,44,64,4,4,53,82,35,53,12,29,7,10,11,47,82
2004-03-22 00:00:00.000,ATP Masters Series Miami FL; U.S.A. ATP World Tour,HARD,2,Andre Agassi,N/A Bye,Andre Agassi,,R128,0,0,0,0,0,0,0,0,0,0,0,0,0,0,0,0,0,0,0,0,0,0,0,0,0,0,0
2004-03-22 00:00:00.000,ATP Masters Series Miami FL; U.S.A. ATP World Tour,HARD,2,Carlos Moya,N/A Bye,Carlos Moya,,R128,0,0,0,0,0,0,0,0,0,0,0,0,0,0,0,0,0,0,0,0,0,0,0,0,0,0,0
2004-03-22 00:00:00.000,ATP Masters Series Miami FL; U.S.A. ATP World Tour,HARD,2,David Sanchez,Luis Horna,David Sanchez,6-4; 6-4,R128,77,3,1,38,50,29,38,8,12,2,3,10,37,50,2,4,44,73,29,44,11,29,7,10,10,40,73
2004-03-22 00:00:00.000,ATP Masters Series Miami FL; U.S.A. ATP World Tour,HARD,2,Bohdan Ulihrach,Gilles Muller,Bohdan Ulihrach,6-4; 7-5,R128,78,1,1,35,63,21,35,21,28,3,5,11,42,63,5,2,40,67,27,40,9,27,3,7,11,36,67
2004-03-22 00:00:00.000,ATP Masters Series Miami FL; U.S.A. ATP World Tour,HARD,2,Dominik Hrbaty,N/A Bye,Dominik Hrbaty,,R128,0,0,0,0,0,0,0,0,0,0,0,0,0,0,0,0,0,0,0,0,0,0,0,0,0,0,0
2004-03-22 00:00:00.000,ATP Masters Series Miami FL; U.S.A. ATP World Tour,HARD,2,Tommy Robredo,N/A Bye,Tommy Robredo,,R128,0,0,0,0,0,0,0,0,0,0,0,0,0,0,0,0,0,0,0,0,0,0,0,0,0,0,0
2004-03-22 00:00:00.000,ATP Masters Series Miami FL; U.S.A. ATP World Tour,HARD,2,Olivier Rochus,Kenneth Carlsen,Olivier Rochus,7-5; 6-1,R128,71,0,1,36,49,31,36,7,13,0,1,10,38,49,3,2,30,55,20,30,11,25,1,5,9,31,55
2004-03-22 00:00:00.000,ATP Masters Series Miami FL; U.S.A. ATP World Tour,HARD,2,Jan Hernych,Fabrice Santoro,Jan Hernych,7-5; 7-5,R128,103,2,0,45,74,26,45,17,29,4,7,12,43,74,1,1,50,94,29,50,22,44,11,16,12,51,94
2004-03-22 00:00:00.000,ATP Masters Series Miami FL; U.S.A. ATP World Tour,HARD,2,Mark Philippoussis,N/A Bye,Mark Philippoussis,,R128,0,0,0,0,0,0,0,0,0,0,0,0,0,0,0,0,0,0,0,0,0,0,0,0,0,0,0
2004-03-22 00:00:00.000,ATP Masters Series Miami FL; U.S.A. ATP World Tour,HARD,2,Sjeng Schalken,N/A Bye,Sjeng Schalken,,R128,0,0,0,0,0,0,0,0,0,0,0,0,0,0,0,0,0,0,0,0,0,0,0,0,0,0,0
2004-03-22 00:00:00.000,ATP Masters Series Miami FL; U.S.A. ATP World Tour,HARD,2,Guillermo Canas,Tommy Haas,Guillermo Canas,6-1; 7-6(6),R128,84,2,2,41,65,28,41,15,24,2,3,10,43,65,1,5,43,65,27,43,7,22,4,7,9,34,65
2004-03-22 00:00:00.000,ATP Masters Series Miami FL; U.S.A. ATP World Tour,HARD,2,Xavier Malisse,Irakli Labadze,Xavier Malisse,6-2; 6-0,R128,50,6,0,25,39,21,25,8,14,1,1,7,29,39,0,7,25,47,14,25,6,22,4,9,7,20,47
2004-03-22 00:00:00.000,ATP Masters Series Miami FL; U.S.A. ATP World Tour,HARD,2,Albert Costa,N/A Bye,Albert Costa,,R128,0,0,0,0,0,0,0,0,0,0,0,0,0,0,0,0,0,0,0,0,0,0,0,0,0,0,0
2004-03-22 00:00:00.000,ATP Masters Series Miami FL; U.S.A. ATP World Tour,HARD,2,Jonas Bjorkman,N/A Bye,Jonas Bjorkman,,R128,0,0,0,0,0,0,0,0,0,0,0,0,0,0,0,0,0,0,0,0,0,0,0,0,0,0,0
2004-03-22 00:00:00.000,ATP Masters Series Miami FL; U.S.A. ATP World Tour,HARD,2,Taylor Dent,Mikhail Youzhny,Taylor Dent,6-3; 6-3,R128,61,0,5,37,55,30,37,9,18,2,3,9,39,55,2,3,33,59,18,33,13,26,5,9,9,31,59
2004-03-22 00:00:00.000,ATP Masters Series Miami FL; U.S.A. ATP World Tour,HARD,2,Karol Beck,Victor Hanescu,Karol Beck,6-1; 6-3,R128,52,5,3,25,45,23,25,9,20,0,0,8,32,45,2,5,31,51,19,31,7,20,5,9,8,26,51
2004-03-22 00:00:00.000,ATP Masters Series Miami FL; U.S.A. ATP World Tour,HARD,2,Andy Roddick,N/A Bye,Andy Roddick,,R128,0,0,0,0,0,0,0,0,0,0,0,0,0,0,0,0,0,0,0,0,0,0,0,0,0,0,0
2004-03-22 00:00:00.000,ATP Masters Series Miami FL; U.S.A. ATP World Tour,HARD,2,Roger Federer,Nikolay Davydenko,Roger Federer,6-2; 3-6; 7-5,R64,117,7,3,63,96,46,63,13,33,4,7,15,59,96,0,2,49,79,31,49,18,30,5,9,14,49,79
2004-03-22 00:00:00.000,ATP Masters Series Miami FL; U.S.A. ATP World Tour,HARD,2,Rafael Nadal,Goran Ivanisevic,Rafael Nadal,6-4 RET,R64,36,2,0,20,26,17,20,3,6,0,0,5,20,26,5,2,18,38,12,18,10,20,4,5,5,22,38
2004-03-22 00:00:00.000,ATP Masters Series Miami FL; U.S.A. ATP World Tour,HARD,2,Fernando Gonzalez,Karol Kucera,Fernando Gonzalez,7-5; 7-6(7),R64,103,4,3,44,74,28,44,21,30,0,3,12,49,74,3,5,56,79,41,56,7,23,6,10,12,48,79
2004-03-22 00:00:00.000,ATP Masters Series Miami FL; U.S.A. ATP World Tour,HARD,2,Jiri Novak,Stefan Koubek,Jiri Novak,6-4; 6-0,R64,56,2,2,29,49,25,29,10,20,1,1,8,35,49,3,6,24,54,14,24,14,30,6,10,8,28,54
2004-03-22 00:00:00.000,ATP Masters Series Miami FL; U.S.A. ATP World Tour,HARD,2,Andrei Pavel,Nicolas Massu,Andrei Pavel,7-6(3); 6-1,R64,105,8,2,43,62,31,43,10,19,4,6,9,41,62,7,4,58,86,29,58,13,28,4,9,10,42,86
2004-03-22 00:00:00.000,ATP Masters Series Miami FL; U.S.A. ATP World Tour,HARD,2,Lleyton Hewitt,Robin Soderling,Lleyton Hewitt,6-4; 6-2,R64,72,10,3,35,52,28,35,8,17,0,1,9,36,52,3,3,32,63,17,32,16,31,3,7,9,33,63
2004-03-22 00:00:00.000,ATP Masters Series Miami FL; U.S.A. ATP World Tour,HARD,2,Todd Martin,Jarkko Nieminen,Todd Martin,6-3; 5-7; 7-5,R64,129,11,2,77,111,51,77,22,34,7,9,17,73,111,0,3,77,109,52,77,16,32,6,9,16,68,109
2004-03-22 00:00:00.000,ATP Masters Series Miami FL; U.S.A. ATP World Tour,HARD,2,Jurgen Melzer,Tim Henman,Jurgen Melzer,7-6(3); 2-6; 7-6(4),R64,135,8,5,61,107,41,61,25,46,2,7,16,66,107,2,8,67,108,49,67,18,41,4,7,16,67,108
2004-03-22 00:00:00.000,ATP Masters Series Miami FL; U.S.A. ATP World Tour,HARD,2,Guillermo Coria,Wayne Ferreira,Guillermo Coria,7-6(2); 6-0,R64,68,1,1,39,49,30,39,7,10,0,1,9,37,49,2,2,34,62,24,34,8,28,2,6,9,32,62
2004-03-22 00:00:00.000,ATP Masters Series Miami FL; U.S.A. ATP World Tour,HARD,2,Juan Ignacio Chela,Cyril Saulnier,Juan Ignacio Chela,2-6; 6-4; 7-5,R64,127,7,3,63,96,41,63,19,33,4,7,15,60,96,1,4,46,93,34,46,23,47,8,11,15,57,93
2004-03-22 00:00:00.000,ATP Masters Series Miami FL; U.S.A. ATP World Tour,HARD,2,Ivan Ljubicic,Arnaud Clement,Ivan Ljubicic,3-6; 6-3; 6-2,R64,131,18,4,52,85,39,52,15,33,8,10,13,54,85,2,8,48,86,33,48,17,38,5,9,13,50,86
2004-03-22 00:00:00.000,ATP Masters Series Miami FL; U.S.A. ATP World Tour,HARD,2,Julien Benneteau,Mardy Fish,Julien Benneteau,6-4; 6-4,R64,78,3,2,35,55,28,35,13,20,2,2,10,41,55,7,0,38,68,27,38,14,30,5,7,10,41,68
2004-03-22 00:00:00.000,ATP Masters Series Miami FL; U.S.A. ATP World Tour,HARD,2,Sebastien Grosjean,Nicolas Lapentti,Sebastien Grosjean,6-3; 6-4,R64,82,8,0,33,59,25,33,18,26,2,2,10,43,59,1,3,35,58,23,35,14,23,5,7,9,37,58
2004-03-22 00:00:00.000,ATP Masters Series Miami FL; U.S.A. ATP World Tour,HARD,2,Thierry Ascione,Feliciano Lopez,Thierry Ascione,7-6(4); 6-4,R64,113,4,2,43,71,26,43,18,28,4,7,11,44,71,10,6,39,70,29,39,11,31,4,8,11,40,70
2004-03-22 00:00:00.000,ATP Masters Series Miami FL; U.S.A. ATP World Tour,HARD,2,Robby Ginepri,Gaston Gaudio,Robby Ginepri,7-6(5); 6-2,R64,87,3,0,39,65,28,39,18,26,4,5,10,46,65,0,2,49,79,32,49,14,30,5,8,10,46,79
2004-03-22 00:00:00.000,ATP Masters Series Miami FL; U.S.A. ATP World Tour,HARD,2,Nicolas Kiefer,Rainer Schuettler,Nicolas Kiefer,6-4; 4-6; 7-6(3),R64,176,6,6,70,120,55,70,22,50,8,11,16,77,120,4,7,60,108,43,60,25,48,3,6,16,68,108
2004-03-22 00:00:00.000,ATP Masters Series Miami FL; U.S.A. ATP World Tour,HARD,2,Radek Stepanek,Fernando Verdasco,Radek Stepanek,7-6(6); 7-6(3),R64,109,6,2,46,81,39,46,18,35,5,7,12,57,81,6,3,54,79,36,54,13,25,3,5,12,49,79
2004-03-22 00:00:00.000,ATP Masters Series Miami FL; U.S.A. ATP World Tour,HARD,2,Vincent Spadea,Marat Safin,Vincent Spadea,7-6(7); 6-7(4); 6-4,R64,158,7,2,79,128,56,79,28,49,5,6,17,84,128,15,2,76,122,55,76,23,46,8,10,17,78,122
2004-03-22 00:00:00.000,ATP Masters Series Miami FL; U.S.A. ATP World Tour,HARD,2,Juan Monaco,Gustavo Kuerten,Juan Monaco,6-1; 3-6; 7-5,R64,114,2,3,70,96,47,70,15,26,3,5,14,62,96,7,4,48,85,36,48,15,37,4,8,14,51,85
2004-03-22 00:00:00.000,ATP Masters Series Miami FL; U.S.A. ATP World Tour,HARD,2,Paradorn Srichaphan,Ricardo Mello,Paradorn Srichaphan,6-1; 1-6; 6-3,R64,91,7,4,46,76,32,46,13,30,3,6,12,45,76,4,4,39,68,23,39,14,29,6,10,11,37,68
2004-03-22 00:00:00.000,ATP Masters Series Miami FL; U.S.A. ATP World Tour,HARD,2,Todd Reid,Martin Verkerk,Todd Reid,4-6; 6-4; 7-5,R64,101,3,2,66,86,51,66,12,20,0,1,16,63,86,17,3,63,100,46,63,22,37,2,4,16,68,100
2004-03-22 00:00:00.000,ATP Masters Series Miami FL; U.S.A. ATP World Tour,HARD,2,Agustin Calleri,Lars Burgsmuller,Agustin Calleri,6-3; 7-5,R64,75,5,4,39,60,33,39,12,21,0,0,11,45,60,5,1,34,60,23,34,15,26,1,3,10,38,60
2004-03-22 00:00:00.000,ATP Masters Series Miami FL; U.S.A. ATP World Tour,HARD,2,Max Mirnyi,Franco Squillari,Max Mirnyi,6-4; 7-6(3),R64,81,5,1,51,66,38,51,10,15,3,4,11,48,66,4,1,43,67,32,43,12,24,6,8,11,44,67
2004-03-22 00:00:00.000,ATP Masters Series Miami FL; U.S.A. ATP World Tour,HARD,2,Andre Agassi,Mariano Zabaleta,Andre Agassi,6-0; 7-6(1),R64,85,5,1,40,62,30,40,12,22,7,8,9,42,62,6,6,38,69,21,38,14,31,7,11,9,35,69
2004-03-22 00:00:00.000,ATP Masters Series Miami FL; U.S.A. ATP World Tour,HARD,2,Carlos Moya,David Sanchez,Carlos Moya,4-6; 6-4; 6-4,R64,124,5,1,44,98,32,44,33,54,5,7,15,65,98,7,1,62,98,48,62,16,36,8,11,15,64,98
2004-03-22 00:00:00.000,ATP Masters Series Miami FL; U.S.A. ATP World Tour,HARD,2,Dominik Hrbaty,Bohdan Ulihrach,Dominik Hrbaty,6-3; 3-6; 6-3,R64,90,5,2,59,89,34,59,19,30,3,7,14,53,89,2,4,59,82,39,59,6,23,3,8,13,45,82
2004-03-22 00:00:00.000,ATP Masters Series Miami FL; U.S.A. ATP World Tour,HARD,2,Tommy Robredo,Olivier Rochus,Tommy Robredo,4-6; 6-1; 7-6(3),R64,135,12,7,44,85,32,44,23,41,0,3,14,55,85,1,3,69,107,43,69,16,38,7,12,15,59,107
2004-03-22 00:00:00.000,ATP Masters Series Miami FL; U.S.A. ATP World Tour,HARD,2,Jan Hernych,Mark Philippoussis,Jan Hernych,6-4; 6-2,R64,61,3,0,30,44,24,30,8,14,0,2,9,32,44,7,2,29,55,20,29,9,26,1,6,9,29,55
2004-03-22 00:00:00.000,ATP Masters Series Miami FL; U.S.A. ATP World Tour,HARD,2,Guillermo Canas,Sjeng Schalken,Guillermo Canas,6-1; 3-0 DEF,R64,51,3,3,20,35,18,20,7,15,2,2,5,25,35,1,2,25,30,11,25,2,5,3,7,5,13,30
2004-03-22 00:00:00.000,ATP Masters Series Miami FL; U.S.A. ATP World Tour,HARD,2,Xavier Malisse,Albert Costa,Xavier Malisse,6-4; 6-2,R64,82,9,1,38,62,30,38,10,24,4,5,9,40,62,3,3,31,62,14,31,18,31,2,6,9,32,62
2004-03-22 00:00:00.000,ATP Masters Series Miami FL; U.S.A. ATP World Tour,HARD,2,Jonas Bjorkman,Taylor Dent,Jonas Bjorkman,7-6(4); 6-2,R64,83,2,2,40,67,30,40,15,27,2,3,10,45,67,4,6,41,70,29,41,10,29,5,8,10,39,70
2004-03-22 00:00:00.000,ATP Masters Series Miami FL; U.S.A. ATP World Tour,HARD,2,Andy Roddick,Karol Beck,Andy Roddick,6-2; 6-4,R64,63,14,1,32,45,29,32,9,13,0,0,9,38,45,9,2,30,61,22,30,12,31,4,7,9,34,61
2004-03-22 00:00:00.000,ATP Masters Series Miami FL; U.S.A. ATP World Tour,HARD,2,Rafael Nadal,Roger Federer,Rafael Nadal,6-3; 6-3,R32,70,1,2,39,48,31,39,5,9,0,0,9,36,48,8,2,34,56,21,34,13,22,4,7,9,34,56
2004-03-22 00:00:00.000,ATP Masters Series Miami FL; U.S.A. ATP World Tour,HARD,2,Fernando Gonzalez,Jiri Novak,Fernando Gonzalez,6-4; 6-2,R32,69,6,2,28,47,26,28,13,19,2,2,9,39,47,2,3,42,69,27,42,11,27,8,11,9,38,69
2004-03-22 00:00:00.000,ATP Masters Series Miami FL; U.S.A. ATP World Tour,HARD,2,Andrei Pavel,Lleyton Hewitt,Andrei Pavel,6-4; 7-5,R32,100,4,3,49,75,34,49,14,26,5,6,11,48,75,9,10,44,79,35,44,10,35,7,10,11,45,79
2004-03-22 00:00:00.000,ATP Masters Series Miami FL; U.S.A. ATP World Tour,HARD,2,Todd Martin,Jurgen Melzer,Todd Martin,7-6(4); 6-3,R32,82,6,1,35,61,27,35,17,26,0,1,11,44,61,2,3,35,64,26,35,16,29,3,5,10,42,64
2004-03-22 00:00:00.000,ATP Masters Series Miami FL; U.S.A. ATP World Tour,HARD,2,Guillermo Coria,Juan Ignacio Chela,Guillermo Coria,6-2; 3-6; 6-3,R32,106,2,3,39,68,27,39,16,29,3,7,13,43,68,1,1,47,75,24,47,14,28,2,8,13,38,75
2004-03-22 00:00:00.000,ATP Masters Series Miami FL; U.S.A. ATP World Tour,HARD,2,Julien Benneteau,Ivan Ljubicic,Julien Benneteau,7-6(3); 6-1,R32,79,5,0,37,61,32,37,14,24,0,0,10,46,61,9,3,34,53,29,34,6,19,1,3,9,35,53
2004-03-22 00:00:00.000,ATP Masters Series Miami FL; U.S.A. ATP World Tour,HARD,2,Sebastien Grosjean,Thierry Ascione,Sebastien Grosjean,6-3; 4-6; 7-6(1),R32,122,10,1,45,90,40,45,19,45,1,4,16,59,90,4,3,60,98,38,60,20,38,2,5,15,58,98
2004-03-22 00:00:00.000,ATP Masters Series Miami FL; U.S.A. ATP World Tour,HARD,2,Nicolas Kiefer,Robby Ginepri,Nicolas Kiefer,7-6(3); 3-6; 6-4,R32,123,8,3,56,89,43,56,17,33,5,8,15,60,89,5,1,61,89,43,61,14,28,2,5,16,57,89
2004-03-22 00:00:00.000,ATP Masters Series Miami FL; U.S.A. ATP World Tour,HARD,2,Vincent Spadea,Radek Stepanek,Vincent Spadea,6-3; 2-6; 7-6(3),R32,125,3,4,60,93,42,60,21,33,4,7,15,63,93,4,3,54,84,40,54,15,30,0,2,14,55,84
2004-03-22 00:00:00.000,ATP Masters Series Miami FL; U.S.A. ATP World Tour,HARD,2,Paradorn Srichaphan,Juan Monaco,Paradorn Srichaphan,1-6; 6-4; 6-4,R32,113,3,1,53,83,36,53,15,30,4,8,14,51,83,1,4,57,83,38,57,12,26,1,4,13,50,83
2004-03-22 00:00:00.000,ATP Masters Series Miami FL; U.S.A. ATP World Tour,HARD,2,Agustin Calleri,Todd Reid,Agustin Calleri,6-4; 7-6(3),R32,105,5,4,32,73,30,32,24,41,1,1,11,54,73,4,1,52,78,37,52,13,26,6,7,11,50,78
2004-03-22 00:00:00.000,ATP Masters Series Miami FL; U.S.A. ATP World Tour,HARD,2,Andre Agassi,Max Mirnyi,Andre Agassi,6-2; 6-2,R32,53,4,3,30,45,24,30,9,15,0,0,8,33,45,10,2,27,46,17,27,6,19,1,5,8,23,46
2004-03-22 00:00:00.000,ATP Masters Series Miami FL; U.S.A. ATP World Tour,HARD,2,Carlos Moya,Dominik Hrbaty,Carlos Moya,7-5; 1-6; 6-3,R32,99,13,0,47,82,34,47,20,35,5,8,14,54,82,0,7,51,84,33,51,20,33,3,6,14,53,84
2004-03-22 00:00:00.000,ATP Masters Series Miami FL; U.S.A. ATP World Tour,HARD,2,Tommy Robredo,Jan Hernych,Tommy Robredo,3-6; 6-3; 7-6(4),R32,141,7,3,56,90,46,56,18,34,1,3,15,64,90,4,1,71,101,48,71,16,30,4,6,15,64,101
2004-03-22 00:00:00.000,ATP Masters Series Miami FL; U.S.A. ATP World Tour,HARD,2,Guillermo Canas,Xavier Malisse,Guillermo Canas,6-4; 2-6; 6-3,R32,139,3,8,52,115,28,52,35,63,11,16,14,63,115,9,1,50,83,32,50,16,33,2,7,13,48,83
2004-03-22 00:00:00.000,ATP Masters Series Miami FL; U.S.A. ATP World Tour,HARD,2,Andy Roddick,Jonas Bjorkman,Andy Roddick,6-4; 3-6; 6-3,R32,105,9,1,58,81,45,58,9,23,2,4,14,54,81,2,0,53,84,34,53,20,31,4,7,14,54,84
2004-03-22 00:00:00.000,ATP Masters Series Miami FL; U.S.A. ATP World Tour,HARD,2,Fernando Gonzalez,Rafael Nadal,Fernando Gonzalez,7-6(1); 4-6; 6-2,R16,130,8,5,61,95,48,61,15,34,5,8,15,63,95,1,3,70,98,44,70,14,28,7,11,15,58,98
2004-03-22 00:00:00.000,ATP Masters Series Miami FL; U.S.A. ATP World Tour,HARD,2,Andrei Pavel,Todd Martin,Andrei Pavel,7-6(5); 7-6(1),R16,116,8,2,43,87,34,43,23,44,1,3,12,57,87,4,5,41,78,30,41,21,37,3,5,12,51,78
2004-03-22 00:00:00.000,ATP Masters Series Miami FL; U.S.A. ATP World Tour,HARD,2,Guillermo Coria,Julien Benneteau,Guillermo Coria,7-6(3); 2-6; 7-5,R16,151,2,1,64,93,42,64,20,29,1,5,16,62,93,5,7,57,112,41,57,28,55,9,12,16,69,112
2004-03-22 00:00:00.000,ATP Masters Series Miami FL; U.S.A. ATP World Tour,HARD,2,Nicolas Kiefer,Sebastien Grosjean,Nicolas Kiefer,6-4; 6-2,R16,90,5,0,34,66,28,34,17,32,2,2,9,45,66,3,2,20,53,13,20,18,33,2,5,9,31,53
2004-03-22 00:00:00.000,ATP Masters Series Miami FL; U.S.A. ATP World Tour,HARD,2,Vincent Spadea,Paradorn Srichaphan,Vincent Spadea,5-7; 6-3; 6-2,R16,124,5,1,46,88,37,46,27,42,2,3,15,64,88,8,3,62,95,45,62,14,33,4,7,14,59,95
2004-03-22 00:00:00.000,ATP Masters Series Miami FL; U.S.A. ATP World Tour,HARD,2,Agustin Calleri,Andre Agassi,Agustin Calleri,6-2; 7-6(2),R16,103,6,2,29,71,22,29,23,42,8,10,10,45,71,9,1,53,83,35,53,8,30,10,14,10,43,83
2004-03-22 00:00:00.000,ATP Masters Series Miami FL; U.S.A. ATP World Tour,HARD,2,Carlos Moya,Tommy Robredo,Carlos Moya,6-3; 6-3,R16,67,10,1,26,49,24,26,14,23,2,2,9,38,49,3,2,35,52,21,35,7,17,1,4,9,28,52
2004-03-22 00:00:00.000,ATP Masters Series Miami FL; U.S.A. ATP World Tour,HARD,2,Andy Roddick,Guillermo Canas,Andy Roddick,6-3; 6-3,R16,62,12,2,35,47,31,35,6,12,2,2,9,37,47,2,6,30,52,21,30,9,22,1,4,9,30,52
2004-03-22 00:00:00.000,ATP Masters Series Miami FL; U.S.A. ATP World Tour,HARD,2,Fernando Gonzalez,Andrei Pavel,Fernando Gonzalez,6-7(5); 6-3; 6-4,Q,141,7,5,46,94,41,46,28,48,3,4,16,69,94,7,2,68,107,47,68,21,39,2,5,15,68,107
2004-03-22 00:00:00.000,ATP Masters Series Miami FL; U.S.A. ATP World Tour,HARD,2,Guillermo Coria,Nicolas Kiefer,Guillermo Coria,6-3; 6-3,Q,71,2,2,23,46,19,23,14,23,0,1,9,33,46,4,2,26,46,17,26,7,20,0,4,9,24,46
2004-03-22 00:00:00.000,ATP Masters Series Miami FL; U.S.A. ATP World Tour,HARD,2,Vincent Spadea,Agustin Calleri,Vincent Spadea,7-5; 6-1,Q,83,5,4,41,73,32,41,12,32,7,9,10,44,73,1,3,33,53,20,33,8,20,4,9,9,28,53
2004-03-22 00:00:00.000,ATP Masters Series Miami FL; U.S.A. ATP World Tour,HARD,2,Andy Roddick,Carlos Moya,Andy Roddick,5-7; 6-2; 7-5,Q,112,12,5,53,89,39,53,21,36,4,7,16,60,89,7,4,47,85,35,47,18,38,1,6,16,53,85
2004-03-22 00:00:00.000,ATP Masters Series Miami FL; U.S.A. ATP World Tour,HARD,2,Guillermo Coria,Fernando Gonzalez,Guillermo Coria,4-6; 7-6(6); 6-1,S,127,4,3,68,98,47,68,14,30,5,8,14,61,98,4,6,51,98,33,51,22,47,8,13,15,55,98
2004-03-22 00:00:00.000,ATP Masters Series Miami FL; U.S.A. ATP World Tour,HARD,2,Andy Roddick,Vincent Spadea,Andy Roddick,6-1; 6-3,S,65,4,0,28,41,22,28,11,13,2,2,8,33,41,1,2,38,64,22,38,11,26,7,11,8,33,64
2004-03-22 00:00:00.000,ATP Masters Series Miami FL; U.S.A. ATP World Tour,HARD,2,Andy Roddick,Guillermo Coria,Andy Roddick,6-7(2); 6-3; 6-1 RET,F,122,12,2,45,74,39,45,17,29,1,2,14,56,74,4,1,81,107,43,81,15,26,7,12,14,58,107
2004-04-12 00:00:00.000,Estoril Portugal ATP World Tour,CLAY,2,Victor Hanescu,Rainer Schuettler,Victor Hanescu,7-6(4); 6-7(4); 6-3,R32,163,5,3,75,127,51,75,23,52,7,11,17,74,127,2,1,62,110,37,62,27,48,4,9,16,64,110
2004-04-12 00:00:00.000,Estoril Portugal ATP World Tour,CLAY,2,Olivier Rochus,Gregory Carraz,Olivier Rochus,6-4; 7-5,R32,83,1,1,49,73,35,49,12,24,4,6,11,47,73,6,5,43,73,27,43,13,30,3,7,11,40,73
2004-04-12 00:00:00.000,Estoril Portugal ATP World Tour,CLAY,2,Radek Stepanek,Nikolay Davydenko,Radek Stepanek,7-6(4); 6-3,R32,98,4,2,46,76,31,46,13,30,6,9,10,44,76,0,7,50,77,31,50,8,27,4,9,11,39,77
2004-04-12 00:00:00.000,Estoril Portugal ATP World Tour,CLAY,2,Florian Mayer,Gaston Gaudio,Florian Mayer,6-3; 6-4,R32,65,4,1,32,55,26,32,10,23,1,3,10,36,55,1,9,26,52,16,26,12,26,2,6,9,28,52
2004-04-12 00:00:00.000,Estoril Portugal ATP World Tour,CLAY,2,Jiri Vanek,Agustin Calleri,Jiri Vanek,7-6(3); 3-6; 7-6(3),R32,158,7,4,58,109,42,58,28,51,7,11,16,70,109,7,6,59,125,46,59,30,66,4,7,17,76,125
2004-04-12 00:00:00.000,Estoril Portugal ATP World Tour,CLAY,2,Olivier Patience,Julien Boutter,Olivier Patience,3-6; 6-2; 6-4,R32,94,3,3,56,85,34,56,18,29,2,5,14,52,85,5,13,46,77,34,46,11,31,7,11,13,45,77
2004-04-12 00:00:00.000,Estoril Portugal ATP World Tour,CLAY,2,Diogo Rocha,Leonardo Tavares,Diogo Rocha,7-5; 2-6; 6-3,R32,145,1,5,60,91,40,60,11,31,2,7,15,51,91,3,5,47,95,29,47,23,48,7,12,14,52,95
2004-04-12 00:00:00.000,Estoril Portugal ATP World Tour,CLAY,2,Juan Ignacio Chela,Guillermo Canas,Juan Ignacio Chela,6-3; 6-4,R32,82,1,2,40,68,29,40,16,28,2,3,10,45,68,1,3,31,59,19,31,14,28,6,9,9,33,59
2004-04-12 00:00:00.000,Estoril Portugal ATP World Tour,CLAY,2,Marat Safin,Cyril Saulnier,Marat Safin,5-7; 6-2; 6-2,R32,123,14,6,43,88,32,43,26,45,5,7,14,58,88,5,5,48,98,32,48,22,50,8,13,14,54,98
2004-04-12 00:00:00.000,Estoril Portugal ATP World Tour,CLAY,2,Thierry Ascione,Antony Dupuis,Thierry Ascione,7-6(5); 6-0,R32,83,5,4,37,62,30,37,14,25,4,4,9,44,62,3,4,28,62,19,28,17,34,1,4,9,36,62
2004-04-12 00:00:00.000,Estoril Portugal ATP World Tour,CLAY,2,Mariano Zabaleta,Vasilis Mazarakis,Mariano Zabaleta,3-6; 6-1; 6-2,R32,88,2,5,44,74,35,44,12,30,4,6,12,47,74,0,1,49,65,27,49,9,16,4,9,12,36,65
2004-04-12 00:00:00.000,Estoril Portugal ATP World Tour,CLAY,2,Tommy Robredo,Xavier Malisse,Tommy Robredo,6-0 RET,R32,50,0,8,18,42,12,18,12,24,4,4,3,24,42,0,2,13,26,5,13,4,13,5,8,3,9,26
2004-04-12 00:00:00.000,Estoril Portugal ATP World Tour,CLAY,2,Max Mirnyi,Bohdan Ulihrach,Max Mirnyi,7-6(2); 6-3,R32,79,6,4,36,62,31,36,13,26,2,3,10,44,62,0,3,46,78,29,46,15,32,8,11,11,44,78
2004-04-12 00:00:00.000,Estoril Portugal ATP World Tour,CLAY,2,Irakli Labadze,Attila Savolt,Irakli Labadze,4-6; 6-4; 7-5,R32,169,5,8,78,119,54,78,20,41,17,20,16,74,119,5,7,54,109,35,54,30,55,12,16,16,65,109
2004-04-12 00:00:00.000,Estoril Portugal ATP World Tour,CLAY,2,Rafael Nadal,Goran Ivanisevic,Rafael Nadal,6-4; 6-1,R32,66,3,5,33,53,24,33,11,20,1,2,9,35,53,6,5,23,51,16,23,11,28,2,6,8,27,51
2004-04-12 00:00:00.000,Estoril Portugal ATP World Tour,CLAY,2,Richard Gasquet,Nicolas Massu,Richard Gasquet,0-6; 7-6(2); 7-6(5),R32,181,4,6,52,105,37,52,23,53,6,12,15,60,105,1,7,64,117,42,64,28,53,6,9,15,70,117
2004-04-12 00:00:00.000,Estoril Portugal ATP World Tour,CLAY,2,Victor Hanescu,Olivier Rochus,Victor Hanescu,6-3; 6-0,R16,63,1,0,39,61,31,39,11,22,7,7,8,42,61,1,5,25,43,12,25,8,18,0,4,7,20,43
2004-04-12 00:00:00.000,Estoril Portugal ATP World Tour,CLAY,2,Florian Mayer,Radek Stepanek,Florian Mayer,6-4; 6-2,R16,72,4,3,25,47,21,25,14,22,2,3,9,35,47,3,3,37,66,24,37,12,29,8,12,9,36,66
2004-04-12 00:00:00.000,Estoril Portugal ATP World Tour,CLAY,2,Olivier Patience,Jiri Vanek,Olivier Patience,6-3; 6-2,R16,64,4,1,37,51,27,37,10,14,5,6,9,37,51,7,2,29,63,18,29,12,34,6,10,8,30,63
2004-04-12 00:00:00.000,Estoril Portugal ATP World Tour,CLAY,2,Juan Ignacio Chela,Diogo Rocha,Juan Ignacio Chela,6-0; 2-0 RET,R16,30,2,0,13,23,11,13,5,10,0,0,4,16,23,1,0,13,19,1,13,1,6,2,6,4,2,19
2004-04-12 00:00:00.000,Estoril Portugal ATP World Tour,CLAY,2,Marat Safin,Thierry Ascione,Marat Safin,6-4; 6-4,R16,76,4,3,31,59,24,31,16,28,0,1,10,40,59,3,1,36,60,22,36,12,24,3,6,10,34,60
2004-04-12 00:00:00.000,Estoril Portugal ATP World Tour,CLAY,2,Tommy Robredo,Mariano Zabaleta,Tommy Robredo,6-1; 7-6(6),R16,88,3,1,36,67,25,36,17,31,4,6,9,42,67,1,3,28,60,18,28,15,32,4,9,10,33,60
2004-04-12 00:00:00.000,Estoril Portugal ATP World Tour,CLAY,2,Irakli Labadze,Max Mirnyi,Irakli Labadze,6-3; 6-3,R16,66,6,6,35,52,30,35,9,17,5,5,9,39,52,4,4,34,54,19,34,11,20,0,3,9,30,54
2004-04-12 00:00:00.000,Estoril Portugal ATP World Tour,CLAY,2,Rafael Nadal,Richard Gasquet,Rafael Nadal,6-4; 3-6; 6-2,R16,139,0,7,61,82,33,61,11,21,2,7,14,44,82,1,6,50,92,33,50,16,42,10,16,13,49,92
2004-04-12 00:00:00.000,Estoril Portugal ATP World Tour,CLAY,2,Florian Mayer,Victor Hanescu,Florian Mayer,6-4; 6-3,Q,78,2,0,28,63,19,28,21,35,2,3,9,40,63,2,0,46,73,26,46,13,27,5,9,10,39,73
2004-04-12 00:00:00.000,Estoril Portugal ATP World Tour,CLAY,2,Juan Ignacio Chela,Olivier Patience,Juan Ignacio Chela,6-3; 6-2,Q,80,1,1,20,46,16,20,15,26,2,3,8,31,46,1,5,45,72,24,45,11,27,6,11,9,35,72
2004-04-12 00:00:00.000,Estoril Portugal ATP World Tour,CLAY,2,Marat Safin,Tommy Robredo,Marat Safin,7-6(2); 2-6; 7-6(5),Q,147,3,5,53,119,39,53,31,66,11,17,16,70,119,0,4,59,93,40,59,18,34,1,5,16,58,93
2004-04-12 00:00:00.000,Estoril Portugal ATP World Tour,CLAY,2,Irakli Labadze,Rafael Nadal,Irakli Labadze,W/O,Q,0,0,0,0,0,0,0,0,0,0,0,0,0,0,0,0,0,0,0,0,0,0,0,0,0,0,0
2004-04-12 00:00:00.000,Estoril Portugal ATP World Tour,CLAY,2,Juan Ignacio Chela,Florian Mayer,Juan Ignacio Chela,6-3; 6-3,S,82,2,1,46,72,30,46,12,26,7,9,9,42,72,1,5,28,57,12,28,14,29,7,12,9,26,57
2004-04-12 00:00:00.000,Estoril Portugal ATP World Tour,CLAY,2,Marat Safin,Irakli Labadze,Marat Safin,2-3 RET,S,23,1,1,10,16,6,10,2,6,2,3,2,8,16,1,0,20,24,11,20,2,4,4,5,3,13,24
2004-04-12 00:00:00.000,Estoril Portugal ATP World Tour,CLAY,2,Juan Ignacio Chela,Marat Safin,Juan Ignacio Chela,6-7(2); 6-3; 6-3,F,144,0,7,70,110,52,70,12,40,5,8,15,64,110,5,0,40,84,24,40,22,44,2,8,15,46,84
2004-04-12 00:00:00.000,Houston TX; U.S.A. ATP World Tour,CLAY,2,Andy Roddick,Kenneth Carlsen,Andy Roddick,6-1; 7-5,R32,66,4,1,32,52,26,32,14,20,0,0,10,40,52,7,4,33,55,24,33,8,22,4,7,9,32,55
2004-04-12 00:00:00.000,Houston TX; U.S.A. ATP World Tour,CLAY,2,Robert Kendrick,Sebastien De Chaunac,Robert Kendrick,6-2; 3-6; 7-6(2),R32,119,11,5,51,83,44,51,18,32,2,3,14,62,83,3,7,60,105,41,60,25,45,4,6,15,66,105
2004-04-12 00:00:00.000,Houston TX; U.S.A. ATP World Tour,CLAY,2,Tomas Behrend,Alexander Popp,Tomas Behrend,6-1; 6-3,R32,62,0,3,32,49,27,32,9,17,3,3,8,36,49,0,4,28,50,18,28,7,22,0,4,8,25,50
2004-04-12 00:00:00.000,Houston TX; U.S.A. ATP World Tour,CLAY,2,Jurgen Melzer,Diego Veronelli,Jurgen Melzer,6-3; 6-1,R32,64,3,2,32,42,25,32,3,10,0,1,8,28,42,4,1,42,66,22,42,10,24,7,12,8,32,66
2004-04-12 00:00:00.000,Houston TX; U.S.A. ATP World Tour,CLAY,2,Franco Squillari,Taylor Dent,Franco Squillari,0-6; 7-5; 7-6(5),R32,127,1,7,71,118,39,71,25,47,7,12,15,64,118,3,3,67,102,42,67,18,35,5,8,15,60,102
2004-04-12 00:00:00.000,Houston TX; U.S.A. ATP World Tour,CLAY,2,Todd Martin,Martin Vassallo Arguello,Todd Martin,6-1; 6-2,R32,53,4,3,22,39,19,22,9,17,3,4,7,28,39,1,6,28,44,12,28,3,16,0,6,8,15,44
2004-04-12 00:00:00.000,Houston TX; U.S.A. ATP World Tour,CLAY,2,Stephane Robert,Jean-Christophe Faurel,Stephane Robert,6-0; 6-2,R32,59,1,2,32,57,23,32,13,25,6,6,7,36,57,0,0,24,39,7,24,8,15,4,9,7,15,39
2004-04-12 00:00:00.000,Houston TX; U.S.A. ATP World Tour,CLAY,2,Luis Horna,Brian Vahaly,Luis Horna,6-3; 6-1,R32,66,4,2,37,51,26,37,8,14,3,4,8,34,51,0,5,42,62,21,42,6,20,6,11,8,27,62
2004-04-12 00:00:00.000,Houston TX; U.S.A. ATP World Tour,CLAY,2,Andrei Pavel,Nicolas Lapentti,Andrei Pavel,6-4; 6-3,R32,86,1,1,43,59,33,43,8,16,2,3,10,41,59,2,5,26,55,20,26,14,29,4,7,9,34,55
2004-04-12 00:00:00.000,Houston TX; U.S.A. ATP World Tour,CLAY,2,Jose Acasuso,Lars Burgsmuller,Jose Acasuso,6-2; 6-2,R32,57,3,1,27,47,23,27,9,20,2,3,8,32,47,2,4,22,47,12,22,8,25,0,5,8,20,47
2004-04-12 00:00:00.000,Houston TX; U.S.A. ATP World Tour,CLAY,2,Davide Sanguinetti,Alexander Peya,Davide Sanguinetti,6-3; 5-7; 6-4,R32,126,0,6,64,115,41,64,20,51,8,14,15,61,115,2,6,85,108,45,85,10,23,8,16,16,55,108
2004-04-12 00:00:00.000,Houston TX; U.S.A. ATP World Tour,CLAY,2,James Blake,Wayne Odesnik,James Blake,6-4; 6-2,R32,66,2,0,34,54,24,34,8,20,1,3,9,32,54,2,2,36,53,21,36,5,17,5,10,9,26,53
2004-04-12 00:00:00.000,Houston TX; U.S.A. ATP World Tour,CLAY,2,Tommy Haas,Robby Ginepri,Tommy Haas,7-6(5); 6-4,R32,88,8,3,57,84,41,57,13,27,5,6,11,54,84,4,6,41,74,33,41,12,33,3,5,11,45,74
2004-04-12 00:00:00.000,Houston TX; U.S.A. ATP World Tour,CLAY,2,Paul Goldstein,Thomas Enqvist,Paul Goldstein,6-4; 6-4,R32,68,3,2,34,59,26,34,11,25,2,4,10,37,59,2,6,42,64,23,42,11,22,2,6,10,34,64
2004-04-12 00:00:00.000,Houston TX; U.S.A. ATP World Tour,CLAY,2,Dmitry Tursunov,Ivo Karlovic,Dmitry Tursunov,6-7(3); 6-4; 7-5,R32,131,8,3,60,110,47,60,28,50,2,3,17,75,110,16,8,61,104,51,61,18,43,3,6,17,69,104
2004-04-12 00:00:00.000,Houston TX; U.S.A. ATP World Tour,CLAY,2,Alex Bogomolov Jr.,Mardy Fish,Alex Bogomolov Jr.,6-3; 6-1,R32,74,1,2,37,49,23,37,9,12,3,4,8,32,49,4,9,35,73,23,35,11,38,11,16,8,34,73
2004-04-12 00:00:00.000,Houston TX; U.S.A. ATP World Tour,CLAY,2,Andy Roddick,Robert Kendrick,Andy Roddick,6-2; 6-3,R16,58,5,1,29,43,22,29,11,14,0,0,8,33,43,7,6,33,56,24,33,6,23,2,6,9,30,56
2004-04-12 00:00:00.000,Houston TX; U.S.A. ATP World Tour,CLAY,2,Jurgen Melzer,Tomas Behrend,Jurgen Melzer,6-2; 6-4,R16,55,7,2,29,54,22,29,16,25,1,1,9,38,54,8,4,29,49,25,29,6,20,1,4,9,31,49
2004-04-12 00:00:00.000,Houston TX; U.S.A. ATP World Tour,CLAY,2,Todd Martin,Franco Squillari,Todd Martin,7-6(3); 7-6(6),R16,108,9,2,58,87,46,58,15,29,1,1,12,61,87,2,8,55,86,45,55,12,31,2,2,12,57,86
2004-04-12 00:00:00.000,Houston TX; U.S.A. ATP World Tour,CLAY,2,Luis Horna,Stephane Robert,Luis Horna,0-6; 6-1; 6-3,R16,95,5,4,64,93,44,64,9,29,5,8,11,53,93,2,1,33,71,20,33,20,38,8,12,11,40,71
2004-04-12 00:00:00.000,Houston TX; U.S.A. ATP World Tour,CLAY,2,Andrei Pavel,Jose Acasuso,Andrei Pavel,4-6; 6-3; 6-2,R16,111,5,1,61,90,41,61,18,29,5,7,14,59,90,5,2,50,86,31,50,19,36,5,9,13,50,86
2004-04-12 00:00:00.000,Houston TX; U.S.A. ATP World Tour,CLAY,2,James Blake,Davide Sanguinetti,James Blake,7-5; 6-3,R16,75,6,2,51,74,40,51,10,23,3,4,11,50,74,1,1,39,62,23,39,14,23,6,9,10,37,62
2004-04-12 00:00:00.000,Houston TX; U.S.A. ATP World Tour,CLAY,2,Tommy Haas,Paul Goldstein,Tommy Haas,6-4; 6-2,R16,78,2,1,34,60,20,34,18,26,2,3,9,38,60,2,2,48,70,25,48,11,22,9,13,9,36,70
2004-04-12 00:00:00.000,Houston TX; U.S.A. ATP World Tour,CLAY,2,Dmitry Tursunov,Alex Bogomolov Jr.,Dmitry Tursunov,6-2; 3-6; 6-2,R16,105,8,4,45,75,30,45,16,30,2,5,12,46,75,0,3,58,82,31,58,13,24,3,9,13,44,82
2004-04-12 00:00:00.000,Houston TX; U.S.A. ATP World Tour,CLAY,2,Andy Roddick,Jurgen Melzer,Andy Roddick,7-5; 7-6(5),Q,92,10,0,50,70,36,50,15,20,0,1,12,51,70,1,3,53,85,39,53,15,32,6,8,12,54,85
2004-04-12 00:00:00.000,Houston TX; U.S.A. ATP World Tour,CLAY,2,Luis Horna,Todd Martin,Luis Horna,7-5; 6-3,Q,84,3,5,50,70,37,50,10,20,5,5,10,47,70,9,0,38,65,30,38,11,27,4,7,11,41,65
2004-04-12 00:00:00.000,Houston TX; U.S.A. ATP World Tour,CLAY,2,Andrei Pavel,James Blake,Andrei Pavel,6-4; 6-4,Q,77,6,2,39,59,30,39,10,20,2,3,10,40,59,2,1,47,76,28,47,15,29,8,11,10,43,76
2004-04-12 00:00:00.000,Houston TX; U.S.A. ATP World Tour,CLAY,2,Tommy Haas,Dmitry Tursunov,Tommy Haas,6-2; 6-0,Q,66,0,0,37,52,28,37,6,15,4,4,7,34,52,3,4,31,46,13,31,6,15,5,10,7,19,46
2004-04-12 00:00:00.000,Houston TX; U.S.A. ATP World Tour,CLAY,2,Andy Roddick,Luis Horna,Andy Roddick,6-3; 6-4,S,63,10,2,37,55,30,37,13,18,1,1,10,43,55,2,2,39,55,28,39,6,16,2,4,9,34,55
2004-04-12 00:00:00.000,Houston TX; U.S.A. ATP World Tour,CLAY,2,Tommy Haas,Andrei Pavel,Tommy Haas,6-4; 6-7(4); 6-4,S,141,4,3,61,101,49,61,20,40,2,3,16,69,101,7,3,75,115,53,75,21,40,7,10,16,74,115
2004-04-12 00:00:00.000,Houston TX; U.S.A. ATP World Tour,CLAY,2,Tommy Haas,Andy Roddick,Tommy Haas,6-3; 6-4,F,71,3,3,35,56,28,35,14,21,3,3,10,42,56,6,1,35,53,21,35,12,18,2,4,9,33,53
2004-04-12 00:00:00.000,Valencia Spain ATP World Tour,CLAY,2,Juan Carlos Ferrero,Israel Matos Gil,Juan Carlos Ferrero,6-2; 7-5,R32,85,3,3,33,55,28,33,12,22,0,1,10,40,55,3,6,36,75,23,36,16,39,4,8,10,39,75
2004-04-12 00:00:00.000,Valencia Spain ATP World Tour,CLAY,2,Jan Vacek,Guillem Burniol,Jan Vacek,6-3; 3-6; 6-4,R32,113,2,4,53,96,34,53,20,43,5,10,14,54,96,3,11,54,96,37,54,15,42,9,15,14,52,96
2004-04-12 00:00:00.000,Valencia Spain ATP World Tour,CLAY,2,Mario Ancic,Harel Levy,Mario Ancic,6-1; 6-1,R32,45,7,2,18,33,18,18,10,15,0,0,7,28,33,0,2,19,40,8,19,7,21,5,10,7,15,40
2004-04-12 00:00:00.000,Valencia Spain ATP World Tour,CLAY,2,Ruben Ramirez Hidalgo,Alex Calatrava,Ruben Ramirez Hidalgo,6-7(7); 7-6(1); 6-4,R32,0,3,7,62,122,43,62,29,60,7,12,17,72,122,3,5,63,135,37,63,35,72,10,16,17,72,135
2004-04-12 00:00:00.000,Valencia Spain ATP World Tour,CLAY,2,Ivan Ljubicic,Guillermo Garcia-Lopez,Ivan Ljubicic,6-3; 6-4,R32,73,9,2,34,59,27,34,15,25,3,4,10,42,59,5,3,27,49,18,27,12,22,2,5,9,30,49
2004-04-12 00:00:00.000,Valencia Spain ATP World Tour,CLAY,2,Fernando Verdasco,Albert Portas,Fernando Verdasco,6-1; 6-4,R32,55,6,0,30,45,25,30,11,15,0,0,9,36,45,2,2,25,46,16,25,9,21,2,5,8,25,46
2004-04-12 00:00:00.000,Valencia Spain ATP World Tour,CLAY,2,Raemon Sluiter,Dennis van Scheppingen,Raemon Sluiter,6-0; 6-4,R32,64,6,1,28,62,25,28,17,34,10,10,8,42,62,0,1,29,55,15,29,13,26,3,7,8,28,55
2004-04-12 00:00:00.000,Valencia Spain ATP World Tour,CLAY,2,David Ferrer,Giovanni Lapentti,David Ferrer,6-4; 6-3,R32,78,2,1,36,61,25,36,17,25,4,5,9,42,61,2,2,34,53,22,34,9,19,2,6,10,31,53
2004-04-12 00:00:00.000,Valencia Spain ATP World Tour,CLAY,2,Alberto Martin,Nicolas Almagro,Alberto Martin,6-2; 6-4,R32,85,2,3,46,77,29,46,17,31,6,7,9,46,77,5,5,34,62,25,34,9,28,2,6,9,34,62
2004-04-12 00:00:00.000,Valencia Spain ATP World Tour,CLAY,2,Fernando Vicente,Oscar Hernandez,Fernando Vicente,7-6(5); 2-6; 7-6(5),R32,177,4,2,80,129,54,80,28,49,10,12,16,82,129,0,2,92,117,66,92,14,25,11,11,16,80,117
2004-04-12 00:00:00.000,Valencia Spain ATP World Tour,CLAY,2,Christophe Rochus,Werner Eschauer,Christophe Rochus,6-4; 6-2,R32,95,2,4,34,61,20,34,15,27,7,10,9,35,61,3,5,34,71,20,34,13,37,8,14,9,33,71
2004-04-12 00:00:00.000,Valencia Spain ATP World Tour,CLAY,2,Albert Costa,Galo Blanco,Albert Costa,6-3; 6-4,R32,69,9,1,34,49,30,34,10,15,0,0,10,40,49,5,1,23,44,16,23,13,21,0,2,9,29,44
2004-04-12 00:00:00.000,Valencia Spain ATP World Tour,CLAY,2,Alex Corretja,David Sanchez,Alex Corretja,5-7; 6-2; 6-2,R32,125,2,5,40,78,32,40,18,38,5,8,14,50,78,0,2,49,76,26,49,16,27,4,10,14,42,76
2004-04-12 00:00:00.000,Valencia Spain ATP World Tour,CLAY,2,Marc Lopez,Stefan Koubek,Marc Lopez,7-5; 6-0,R32,81,0,1,32,56,23,32,11,24,5,7,9,34,56,0,3,35,53,17,35,5,18,4,10,9,22,53
2004-04-12 00:00:00.000,Valencia Spain ATP World Tour,CLAY,2,Albert Montanes,John van Lottum,Albert Montanes,6-3; 6-1,R32,65,3,0,30,48,22,30,12,18,4,4,8,34,48,3,2,26,55,15,26,14,29,5,9,8,29,55
2004-04-12 00:00:00.000,Valencia Spain ATP World Tour,CLAY,2,Feliciano Lopez,Igor Andreev,Feliciano Lopez,6-4; 6-2,R32,77,9,3,28,57,24,28,16,29,1,1,9,40,57,4,3,36,67,23,36,16,31,4,7,9,39,67
2004-04-12 00:00:00.000,Valencia Spain ATP World Tour,CLAY,2,Juan Carlos Ferrero,Jan Vacek,Juan Carlos Ferrero,6-3; 7-5,R16,91,2,4,45,74,35,45,13,29,7,9,11,48,74,2,4,47,81,27,47,17,34,9,13,10,44,81
2004-04-12 00:00:00.000,Valencia Spain ATP World Tour,CLAY,2,Mario Ancic,Ruben Ramirez Hidalgo,Mario Ancic,7-5; 6-2,R16,88,6,4,23,53,19,23,17,30,0,2,10,36,53,0,1,30,57,19,30,12,27,3,8,10,31,57
2004-04-12 00:00:00.000,Valencia Spain ATP World Tour,CLAY,2,Fernando Verdasco,Ivan Ljubicic,Fernando Verdasco,6-4; 6-4,R16,75,3,2,40,57,30,40,12,17,3,3,10,42,57,3,1,32,54,23,32,13,22,4,6,10,36,54
2004-04-12 00:00:00.000,Valencia Spain ATP World Tour,CLAY,2,David Ferrer,Raemon Sluiter,David Ferrer,6-2; 6-4,R16,70,3,1,43,59,29,43,10,16,5,6,9,39,59,3,2,39,58,25,39,6,19,5,9,9,31,58
2004-04-12 00:00:00.000,Valencia Spain ATP World Tour,CLAY,2,Alberto Martin,Fernando Vicente,Alberto Martin,6-3; 5-7; 6-4,R16,136,0,5,62,97,44,62,19,35,3,6,16,63,97,2,1,48,94,30,48,27,46,5,9,15,57,94
2004-04-12 00:00:00.000,Valencia Spain ATP World Tour,CLAY,2,Christophe Rochus,Albert Costa,Christophe Rochus,6-4; 6-3,R16,86,0,2,38,59,25,38,8,21,4,7,9,33,59,1,2,38,59,21,38,8,21,4,10,10,29,59
2004-04-12 00:00:00.000,Valencia Spain ATP World Tour,CLAY,2,Marc Lopez,Alex Corretja,Marc Lopez,6-4; 6-4,R16,113,0,2,48,63,34,48,8,15,2,3,10,42,63,0,1,43,71,26,43,16,28,5,8,10,42,71
2004-04-12 00:00:00.000,Valencia Spain ATP World Tour,CLAY,2,Albert Montanes,Feliciano Lopez,Albert Montanes,4-6; 6-2; 6-4,R16,105,7,2,48,81,32,48,24,33,4,6,14,56,81,9,5,43,91,32,43,21,48,4,8,14,53,91
2004-04-12 00:00:00.000,Valencia Spain ATP World Tour,CLAY,2,Juan Carlos Ferrero,Mario Ancic,Juan Carlos Ferrero,6-4; 6-4,Q,87,4,1,42,70,29,42,17,28,4,5,10,46,70,2,0,36,61,23,36,14,25,4,7,10,37,61
2004-04-12 00:00:00.000,Valencia Spain ATP World Tour,CLAY,2,Fernando Verdasco,David Ferrer,Fernando Verdasco,6-2; 6-3,Q,66,1,2,35,49,29,35,7,14,5,6,9,36,49,1,7,35,61,23,35,7,26,4,8,8,30,61
2004-04-12 00:00:00.000,Valencia Spain ATP World Tour,CLAY,2,Alberto Martin,Christophe Rochus,Alberto Martin,6-1; 6-2,Q,63,2,3,48,75,26,48,16,27,8,10,8,42,75,0,3,27,44,10,27,4,17,4,10,7,14,44
2004-04-12 00:00:00.000,Valencia Spain ATP World Tour,CLAY,2,Albert Montanes,Marc Lopez,Albert Montanes,2-6; 6-2; 6-0,Q,109,5,1,49,76,32,49,16,27,4,6,11,48,76,0,3,48,71,27,48,10,23,7,12,11,37,71
2004-04-12 00:00:00.000,Valencia Spain ATP World Tour,CLAY,2,Fernando Verdasco,Juan Carlos Ferrero,Fernando Verdasco,6-2; 6-1,S,61,0,3,39,48,30,39,4,9,3,3,8,34,48,1,3,31,53,18,31,7,22,7,11,7,25,53
2004-04-12 00:00:00.000,Valencia Spain ATP World Tour,CLAY,2,Albert Montanes,Alberto Martin,Albert Montanes,4-6; 6-2; 6-2,S,111,2,6,51,74,41,51,9,23,2,4,13,50,74,1,6,50,87,31,50,16,37,5,10,13,47,87
2004-04-12 00:00:00.000,Valencia Spain ATP World Tour,CLAY,2,Fernando Verdasco,Albert Montanes,Fernando Verdasco,7-6(5); 6-3,F,96,3,3,55,76,38,55,13,21,4,6,11,51,76,3,1,48,67,33,48,8,19,3,6,10,41,67
2004-04-19 00:00:00.000,ATP Masters Series Monte Carlo Monaco ATP World Tour,CLAY,2,Wayne Arthurs,Thierry Ascione,Wayne Arthurs,7-6(5); 6-4,R64,82,14,4,44,75,36,44,17,31,1,1,11,53,75,1,0,52,74,37,52,13,22,2,3,11,50,74
2004-04-19 00:00:00.000,ATP Masters Series Monte Carlo Monaco ATP World Tour,CLAY,2,Nicolas Devilder,Goran Ivanisevic,Nicolas Devilder,4-6; 6-2; 6-2,R64,96,3,2,41,74,30,41,24,33,2,3,13,54,74,7,11,43,82,32,43,16,39,4,8,13,48,82
2004-04-19 00:00:00.000,ATP Masters Series Monte Carlo Monaco ATP World Tour,CLAY,2,Marat Safin,Olivier Rochus,Marat Safin,4-6; 6-3; 6-3,R64,136,6,3,46,87,36,46,24,41,5,6,14,60,87,1,3,64,105,31,64,29,41,10,13,14,60,105
2004-04-19 00:00:00.000,ATP Masters Series Monte Carlo Monaco ATP World Tour,CLAY,2,Max Mirnyi,Fernando Gonzalez,Max Mirnyi,6-4; 6-3,R64,71,2,2,40,64,28,40,15,24,3,4,10,43,64,1,5,39,55,27,39,6,16,2,5,9,33,55
2004-04-19 00:00:00.000,ATP Masters Series Monte Carlo Monaco ATP World Tour,CLAY,2,Agustin Calleri,Sjeng Schalken,Agustin Calleri,6-1; 6-3,R64,64,3,2,27,51,22,27,14,24,2,2,8,36,51,0,1,32,50,19,32,8,18,6,10,8,27,50
2004-04-19 00:00:00.000,ATP Masters Series Monte Carlo Monaco ATP World Tour,CLAY,2,Nicolas Escude,Gregory Carraz,Nicolas Escude,6-4; 6-2,R64,94,6,0,21,50,18,21,20,29,4,4,9,38,50,5,2,34,64,26,34,9,30,2,5,9,35,64
2004-04-19 00:00:00.000,ATP Masters Series Monte Carlo Monaco ATP World Tour,CLAY,2,Alberto Martin,Guillermo Canas,Alberto Martin,6-3; 4-6; 6-3,R64,118,0,3,38,75,21,38,24,37,3,8,14,45,75,3,4,40,80,27,40,15,40,5,12,14,42,80
2004-04-19 00:00:00.000,ATP Masters Series Monte Carlo Monaco ATP World Tour,CLAY,2,Sebastien Grosjean,Arnaud Clement,Sebastien Grosjean,6-4; 6-2,R64,86,4,3,22,61,20,22,17,39,7,9,9,37,61,0,7,27,60,18,27,12,33,6,11,9,30,60
2004-04-19 00:00:00.000,ATP Masters Series Monte Carlo Monaco ATP World Tour,CLAY,2,Guillermo Coria,Thomas Enqvist,Guillermo Coria,6-0; 6-1,R64,49,3,0,20,30,17,20,7,10,0,0,6,24,30,0,2,21,47,11,21,6,26,3,9,7,17,47
2004-04-19 00:00:00.000,ATP Masters Series Monte Carlo Monaco ATP World Tour,CLAY,2,Nicolas Kiefer,Hicham Arazi,Nicolas Kiefer,6-3; 6-3,R64,95,3,4,29,64,20,29,17,35,7,9,9,37,64,1,4,35,74,16,35,19,39,11,16,9,35,74
2004-04-19 00:00:00.000,ATP Masters Series Monte Carlo Monaco ATP World Tour,CLAY,2,Andrei Pavel,Radek Stepanek,Andrei Pavel,6-3; 6-3,R64,82,3,0,37,70,28,37,16,33,4,5,9,44,70,5,7,34,70,23,34,13,36,3,7,9,36,70
2004-04-19 00:00:00.000,ATP Masters Series Monte Carlo Monaco ATP World Tour,CLAY,2,Jonas Bjorkman,Nicolas Mahut,Jonas Bjorkman,6-1; 3-6; 7-5,R64,119,2,2,44,90,29,44,25,46,7,11,14,54,90,2,3,55,84,34,55,11,29,7,13,14,45,84
2004-04-19 00:00:00.000,ATP Masters Series Monte Carlo Monaco ATP World Tour,CLAY,2,Taylor Dent,Jiri Novak,Taylor Dent,6-4; 7-5,R64,76,1,4,35,63,26,35,12,28,0,3,11,38,63,1,3,38,68,23,38,15,30,4,9,11,38,68
2004-04-19 00:00:00.000,ATP Masters Series Monte Carlo Monaco ATP World Tour,CLAY,2,Fabrice Santoro,Igor Andreev,Fabrice Santoro,6-3; 7-6(3),R64,109,2,4,51,82,38,51,16,31,4,5,11,54,82,6,6,51,92,36,51,17,41,8,10,10,53,92
2004-04-19 00:00:00.000,ATP Masters Series Monte Carlo Monaco ATP World Tour,CLAY,2,Felix Mantilla,Albert Costa,Felix Mantilla,6-4; 7-5,R64,93,0,5,37,58,26,37,7,21,1,5,11,33,58,4,2,41,75,24,41,13,34,2,8,11,37,75
2004-04-19 00:00:00.000,ATP Masters Series Monte Carlo Monaco ATP World Tour,CLAY,2,David Nalbandian,Dominik Hrbaty,David Nalbandian,6-3; 6-0,R64,50,1,1,22,43,18,22,14,21,0,0,8,32,43,0,3,26,40,14,26,5,14,4,8,7,19,40
2004-04-19 00:00:00.000,ATP Masters Series Monte Carlo Monaco ATP World Tour,CLAY,2,Tim Henman,Vincent Spadea,Tim Henman,6-7(5); 6-4; 7-6(5),R64,171,4,8,65,121,47,65,29,56,5,9,17,76,121,0,3,80,131,49,80,25,51,7,12,17,74,131
2004-04-19 00:00:00.000,ATP Masters Series Monte Carlo Monaco ATP World Tour,CLAY,2,David Sanchez,Bohdan Ulihrach,David Sanchez,6-1; 6-4,R64,66,2,3,36,56,28,36,12,20,2,2,9,40,56,3,1,35,55,24,35,6,20,3,6,8,30,55
2004-04-19 00:00:00.000,ATP Masters Series Monte Carlo Monaco ATP World Tour,CLAY,2,Feliciano Lopez,Robin Soderling,Feliciano Lopez,7-5; 6-4,R64,75,4,3,29,62,18,29,23,33,2,4,11,41,62,4,3,35,71,23,35,17,36,5,9,11,40,71
2004-04-19 00:00:00.000,ATP Masters Series Monte Carlo Monaco ATP World Tour,CLAY,2,Nicolas Massu,Flavio Saretta,Nicolas Massu,6-3; 6-0,R64,68,3,2,29,45,23,29,7,16,1,2,7,30,45,2,1,23,46,10,23,6,23,3,9,8,16,46
2004-04-19 00:00:00.000,ATP Masters Series Monte Carlo Monaco ATP World Tour,CLAY,2,Lleyton Hewitt,Julien Benneteau,Lleyton Hewitt,3-6; 6-3; 6-4,R64,108,1,5,40,84,30,40,22,44,0,3,14,52,84,2,2,48,79,31,48,17,31,1,5,14,48,79
2004-04-19 00:00:00.000,ATP Masters Series Monte Carlo Monaco ATP World Tour,CLAY,2,Gaston Gaudio,Filippo Volandri,Gaston Gaudio,4-6; 7-5; 6-4,R64,126,4,7,50,96,34,50,18,46,4,10,16,52,96,2,1,64,97,36,64,14,33,6,13,16,50,97
2004-04-19 00:00:00.000,ATP Masters Series Monte Carlo Monaco ATP World Tour,CLAY,2,Jean-Rene Lisnard,Tomas Berdych,Jean-Rene Lisnard,7-5; 6-3,R64,92,2,2,22,58,13,22,23,36,1,3,10,36,58,6,3,39,75,26,39,14,36,6,11,11,40,75
2004-04-19 00:00:00.000,ATP Masters Series Monte Carlo Monaco ATP World Tour,CLAY,2,Rainer Schuettler,Gustavo Kuerten,Rainer Schuettler,7-6(3); 6-3,R64,91,3,3,39,75,27,39,18,36,5,8,10,45,75,2,3,33,69,22,33,14,36,5,10,11,36,69
2004-04-19 00:00:00.000,ATP Masters Series Monte Carlo Monaco ATP World Tour,CLAY,2,Carlos Moya,Sargis Sargsian,Carlos Moya,7-6(5); 1-6; 6-3,R64,110,2,3,46,90,30,46,22,44,6,11,14,52,90,1,2,60,85,40,60,12,25,3,7,14,52,85
2004-04-19 00:00:00.000,ATP Masters Series Monte Carlo Monaco ATP World Tour,CLAY,2,Jarkko Nieminen,Uros Vico,Jarkko Nieminen,6-4; 3-6; 6-4,R64,132,2,2,75,98,44,75,15,23,13,17,14,59,98,8,6,52,103,37,52,22,51,9,14,15,59,103
2004-04-19 00:00:00.000,ATP Masters Series Monte Carlo Monaco ATP World Tour,CLAY,2,Tommy Haas,Xavier Malisse,Tommy Haas,6-3; 6-4,R64,71,2,1,39,54,30,39,9,15,0,1,10,39,54,1,0,26,57,19,26,13,31,5,8,9,32,57
2004-04-19 00:00:00.000,ATP Masters Series Monte Carlo Monaco ATP World Tour,CLAY,2,Juan Ignacio Chela,Paradorn Srichaphan,Juan Ignacio Chela,6-4; 6-3,R64,94,1,1,43,63,26,43,13,20,3,5,9,39,63,1,4,37,70,22,37,11,33,3,8,10,33,70
2004-04-19 00:00:00.000,ATP Masters Series Monte Carlo Monaco ATP World Tour,CLAY,2,Martin Verkerk,Albert Portas,Martin Verkerk,4-6; 6-4; 6-3,R64,107,8,2,49,86,37,49,20,37,3,6,15,57,86,2,4,61,95,39,61,15,34,6,10,14,54,95
2004-04-19 00:00:00.000,ATP Masters Series Monte Carlo Monaco ATP World Tour,CLAY,2,Ivan Ljubicic,Tommy Robredo,Ivan Ljubicic,6-4; 7-6(2),R64,91,5,3,34,67,28,34,16,33,1,4,11,44,67,2,4,47,72,29,47,10,25,5,9,11,39,72
2004-04-19 00:00:00.000,ATP Masters Series Monte Carlo Monaco ATP World Tour,CLAY,2,Nikolay Davydenko,Mariano Zabaleta,Nikolay Davydenko,6-2; 6-4,R64,77,3,2,46,61,34,46,4,15,6,8,9,38,61,0,2,24,53,14,24,11,29,1,6,9,25,53
2004-04-19 00:00:00.000,ATP Masters Series Monte Carlo Monaco ATP World Tour,CLAY,2,Alex Corretja,Juan Carlos Ferrero,Alex Corretja,6-2; 6-3,R64,69,2,5,30,53,24,30,12,23,4,5,9,36,53,2,2,33,49,19,33,6,16,6,10,8,25,49
2004-04-19 00:00:00.000,ATP Masters Series Monte Carlo Monaco ATP World Tour,CLAY,2,Wayne Arthurs,Nicolas Devilder,Wayne Arthurs,4-6; 6-3; 6-4,R32,98,7,3,50,86,39,50,23,36,5,6,15,62,86,1,4,67,83,51,67,4,16,2,4,14,55,83
2004-04-19 00:00:00.000,ATP Masters Series Monte Carlo Monaco ATP World Tour,CLAY,2,Marat Safin,Max Mirnyi,Marat Safin,6-4; 6-3,R32,70,2,1,28,49,24,28,13,21,1,1,9,37,49,8,5,38,61,28,38,10,23,2,5,10,38,61
2004-04-19 00:00:00.000,ATP Masters Series Monte Carlo Monaco ATP World Tour,CLAY,2,Agustin Calleri,Nicolas Escude,Agustin Calleri,6-2; 6-3,R32,68,1,1,24,41,20,24,11,17,2,3,8,31,41,3,4,33,63,22,33,10,30,8,13,9,32,63
2004-04-19 00:00:00.000,ATP Masters Series Monte Carlo Monaco ATP World Tour,CLAY,2,Alberto Martin,Sebastien Grosjean,Alberto Martin,6-4; 6-2,R32,93,1,3,51,77,34,51,15,26,10,11,9,49,77,3,0,19,53,14,19,16,34,6,10,9,30,53
2004-04-19 00:00:00.000,ATP Masters Series Monte Carlo Monaco ATP World Tour,CLAY,2,Guillermo Coria,Nicolas Kiefer,Guillermo Coria,6-0; 6-3,R32,75,2,2,26,39,24,26,6,13,1,1,7,30,39,0,4,28,68,20,28,12,40,8,13,8,32,68
2004-04-19 00:00:00.000,ATP Masters Series Monte Carlo Monaco ATP World Tour,CLAY,2,Andrei Pavel,Jonas Bjorkman,Andrei Pavel,6-2; 6-0,R32,68,1,1,24,46,18,24,15,22,3,3,7,33,46,0,4,27,60,12,27,14,33,7,12,7,26,60
2004-04-19 00:00:00.000,ATP Masters Series Monte Carlo Monaco ATP World Tour,CLAY,2,Fabrice Santoro,Taylor Dent,Fabrice Santoro,6-3; 6-2,R32,78,1,1,41,55,25,41,8,14,2,4,8,33,55,2,7,38,68,21,38,9,30,6,12,9,30,68
2004-04-19 00:00:00.000,ATP Masters Series Monte Carlo Monaco ATP World Tour,CLAY,2,David Nalbandian,Felix Mantilla,David Nalbandian,6-0; 5-7; 7-6(4),R32,146,3,3,62,116,40,62,27,54,8,12,15,67,116,0,3,55,99,33,55,22,44,8,14,15,55,99
2004-04-19 00:00:00.000,ATP Masters Series Monte Carlo Monaco ATP World Tour,CLAY,2,Tim Henman,David Sanchez,Tim Henman,6-3; 6-7(8); 6-3,R32,122,4,3,61,100,48,61,21,39,3,5,16,69,100,1,3,46,83,31,46,21,37,2,6,14,52,83
2004-04-19 00:00:00.000,ATP Masters Series Monte Carlo Monaco ATP World Tour,CLAY,2,Nicolas Massu,Feliciano Lopez,Nicolas Massu,6-2; 6-4,R32,101,3,6,34,60,24,34,16,26,2,3,9,40,60,6,3,42,72,28,42,12,30,6,10,9,40,72
2004-04-19 00:00:00.000,ATP Masters Series Monte Carlo Monaco ATP World Tour,CLAY,2,Lleyton Hewitt,Gaston Gaudio,Lleyton Hewitt,1-6; 7-6(5); 6-1,R32,140,5,8,49,98,30,49,22,49,5,10,12,52,98,1,11,56,100,32,56,20,44,5,11,14,52,100
2004-04-19 00:00:00.000,ATP Masters Series Monte Carlo Monaco ATP World Tour,CLAY,2,Rainer Schuettler,Jean-Rene Lisnard,Rainer Schuettler,6-1; 6-2,R32,66,3,0,33,49,24,33,11,16,2,2,8,35,49,1,2,20,42,9,20,10,22,4,8,7,19,42
2004-04-19 00:00:00.000,ATP Masters Series Monte Carlo Monaco ATP World Tour,CLAY,2,Carlos Moya,Jarkko Nieminen,Carlos Moya,W/O,R32,0,0,0,0,0,0,0,0,0,0,0,0,0,0,0,0,0,0,0,0,0,0,0,0,0,0,0
2004-04-19 00:00:00.000,ATP Masters Series Monte Carlo Monaco ATP World Tour,CLAY,2,Juan Ignacio Chela,Tommy Haas,Juan Ignacio Chela,6-4; 1-6; 6-3,R32,117,3,6,54,90,34,54,19,36,8,12,13,53,90,1,3,52,83,36,52,13,31,5,9,13,49,83
2004-04-19 00:00:00.000,ATP Masters Series Monte Carlo Monaco ATP World Tour,CLAY,2,Ivan Ljubicic,Martin Verkerk,Ivan Ljubicic,6-3; 6-2,R32,67,10,1,28,45,26,28,11,17,1,1,9,37,45,4,2,36,64,21,36,14,28,6,9,8,35,64
2004-04-19 00:00:00.000,ATP Masters Series Monte Carlo Monaco ATP World Tour,CLAY,2,Nikolay Davydenko,Alex Corretja,Nikolay Davydenko,6-2; 6-1,R32,79,2,3,29,41,24,29,6,12,0,0,7,30,41,0,5,38,65,21,38,10,27,5,10,8,31,65
2004-04-19 00:00:00.000,ATP Masters Series Monte Carlo Monaco ATP World Tour,CLAY,2,Marat Safin,Wayne Arthurs,Marat Safin,6-4; 6-2,R16,68,1,1,32,48,25,32,12,16,2,2,9,37,48,8,7,37,61,25,37,10,24,5,8,9,35,61
2004-04-19 00:00:00.000,ATP Masters Series Monte Carlo Monaco ATP World Tour,CLAY,2,Alberto Martin,Agustin Calleri,Alberto Martin,6-3; 3-6; 7-6(1),R16,146,0,2,57,106,42,57,29,49,12,14,15,71,106,7,2,50,95,36,50,23,45,4,6,15,59,95
2004-04-19 00:00:00.000,ATP Masters Series Monte Carlo Monaco ATP World Tour,CLAY,2,Guillermo Coria,Andrei Pavel,Guillermo Coria,4-6; 6-1; 6-4,R16,120,1,4,56,79,43,56,9,23,2,5,14,52,79,0,1,43,77,31,43,12,34,3,8,13,43,77
2004-04-19 00:00:00.000,ATP Masters Series Monte Carlo Monaco ATP World Tour,CLAY,2,David Nalbandian,Fabrice Santoro,David Nalbandian,6-3; 6-2,R16,80,1,4,31,54,24,31,10,23,2,4,9,34,54,0,1,34,64,21,34,8,30,9,14,8,29,64
2004-04-19 00:00:00.000,ATP Masters Series Monte Carlo Monaco ATP World Tour,CLAY,2,Tim Henman,Nicolas Massu,Tim Henman,3-6; 6-4; 6-3,R16,126,5,5,50,88,34,50,18,38,4,9,14,52,88,1,3,45,82,26,45,16,37,5,11,14,42,82
2004-04-19 00:00:00.000,ATP Masters Series Monte Carlo Monaco ATP World Tour,CLAY,2,Rainer Schuettler,Lleyton Hewitt,Rainer Schuettler,6-4; 3-6; 6-4,R16,144,6,4,55,105,35,55,25,50,17,22,15,60,105,1,8,46,92,28,46,21,46,10,15,14,49,92
2004-04-19 00:00:00.000,ATP Masters Series Monte Carlo Monaco ATP World Tour,CLAY,2,Carlos Moya,Juan Ignacio Chela,Carlos Moya,6-4; 7-6(4),R16,109,1,3,37,80,27,37,25,43,4,6,11,52,80,1,5,49,83,35,49,13,34,1,4,11,48,83
2004-04-19 00:00:00.000,ATP Masters Series Monte Carlo Monaco ATP World Tour,CLAY,2,Nikolay Davydenko,Ivan Ljubicic,Nikolay Davydenko,6-2; 6-2,R16,87,1,1,36,49,27,36,8,13,4,5,8,35,49,2,0,36,63,21,36,9,27,5,10,8,30,63
2004-04-19 00:00:00.000,ATP Masters Series Monte Carlo Monaco ATP World Tour,CLAY,2,Marat Safin,Alberto Martin,Marat Safin,6-3; 3-6; 6-1,Q,107,3,1,44,82,31,44,23,38,1,3,13,54,82,0,5,52,78,32,52,12,26,5,9,12,44,78
2004-04-19 00:00:00.000,ATP Masters Series Monte Carlo Monaco ATP World Tour,CLAY,2,Guillermo Coria,David Nalbandian,Guillermo Coria,6-4; 6-3,Q,84,0,2,45,57,30,45,6,12,1,3,10,36,57,1,0,38,61,24,38,9,23,3,7,9,33,61
2004-04-19 00:00:00.000,ATP Masters Series Monte Carlo Monaco ATP World Tour,CLAY,2,Rainer Schuettler,Tim Henman,Rainer Schuettler,6-3; 6-1,Q,63,2,0,20,40,17,20,15,20,0,0,8,32,40,1,3,26,54,16,26,12,28,5,9,8,28,54
2004-04-19 00:00:00.000,ATP Masters Series Monte Carlo Monaco ATP World Tour,CLAY,2,Carlos Moya,Nikolay Davydenko,Carlos Moya,6-4; 7-6(4),Q,104,2,0,54,76,40,54,13,22,2,3,11,53,76,0,2,56,82,38,56,13,26,4,6,11,51,82
2004-04-19 00:00:00.000,ATP Masters Series Monte Carlo Monaco ATP World Tour,CLAY,2,Guillermo Coria,Marat Safin,Guillermo Coria,6-4; 1-6; 6-3,S,111,0,6,56,82,39,56,13,26,3,5,13,52,82,6,3,37,69,31,37,16,32,2,4,13,47,69
2004-04-19 00:00:00.000,ATP Masters Series Monte Carlo Monaco ATP World Tour,CLAY,2,Rainer Schuettler,Carlos Moya,Rainer Schuettler,7-6(5); 6-4,S,103,0,3,48,82,35,48,21,34,3,3,11,56,82,2,4,44,77,33,44,19,33,4,5,11,52,77
2004-04-19 00:00:00.000,ATP Masters Series Monte Carlo Monaco ATP World Tour,CLAY,2,Guillermo Coria,Rainer Schuettler,Guillermo Coria,6-2; 6-1; 6-3,F,121,2,3,45,69,33,45,17,24,6,7,12,50,69,0,1,45,84,20,45,19,39,3,10,12,39,84
2004-04-26 00:00:00.000,Barcelona Spain ATP World Tour,CLAY,2,Fernando Gonzalez,N/A Bye,Fernando Gonzalez,,R64,0,0,0,0,0,0,0,0,0,0,0,0,0,0,0,0,0,0,0,0,0,0,0,0,0,0,0
2004-04-26 00:00:00.000,Barcelona Spain ATP World Tour,CLAY,2,Nicolas Lapentti,Jurgen Melzer,Nicolas Lapentti,7-5; 6-1,R64,92,3,1,34,65,26,34,16,31,6,8,10,42,65,4,0,24,46,12,24,9,22,3,8,9,21,46
2004-04-26 00:00:00.000,Barcelona Spain ATP World Tour,CLAY,2,Fernando Vicente,Ivo Karlovic,Fernando Vicente,6-4; 6-4,R64,74,3,1,38,63,32,38,13,25,2,2,10,45,63,9,2,41,63,29,41,10,22,2,4,10,39,63
2004-04-26 00:00:00.000,Barcelona Spain ATP World Tour,CLAY,2,Mariano Zabaleta,Massimo Dell'Acqua,Mariano Zabaleta,6-1; 6-4,R64,74,4,1,40,67,28,40,16,27,4,4,9,44,67,10,2,26,52,19,26,9,26,3,6,8,28,52
2004-04-26 00:00:00.000,Barcelona Spain ATP World Tour,CLAY,2,Peter Luczak,Oscar Hernandez,Peter Luczak,7-5; 6-3,R64,84,7,2,46,64,36,46,9,18,1,2,11,45,64,4,3,35,54,22,35,9,19,1,4,10,31,54
2004-04-26 00:00:00.000,Barcelona Spain ATP World Tour,CLAY,2,Fernando Verdasco,Nicolas Mahut,Fernando Verdasco,6-2; 6-3,R64,60,5,2,35,49,26,35,9,14,3,4,9,35,49,3,4,37,56,21,37,5,19,8,12,8,26,56
2004-04-26 00:00:00.000,Barcelona Spain ATP World Tour,CLAY,2,Karol Beck,John van Lottum,Karol Beck,7-6(2) RET,R64,54,6,1,29,47,22,29,12,18,5,5,6,34,47,1,1,25,36,20,25,6,11,0,0,6,26,36
2004-04-26 00:00:00.000,Barcelona Spain ATP World Tour,CLAY,2,Tommy Robredo,N/A Bye,Tommy Robredo,,R64,0,0,0,0,0,0,0,0,0,0,0,0,0,0,0,0,0,0,0,0,0,0,0,0,0,0,0
2004-04-26 00:00:00.000,Barcelona Spain ATP World Tour,CLAY,2,David Nalbandian,N/A Bye,David Nalbandian,,R64,0,0,0,0,0,0,0,0,0,0,0,0,0,0,0,0,0,0,0,0,0,0,0,0,0,0,0
2004-04-26 00:00:00.000,Barcelona Spain ATP World Tour,CLAY,2,Todd Martin,David Ferrer,Todd Martin,6-4; 6-7(8); 6-4,R64,140,7,3,69,102,48,69,18,33,3,6,16,66,102,1,3,83,121,52,83,17,38,7,12,16,69,121
2004-04-26 00:00:00.000,Barcelona Spain ATP World Tour,CLAY,2,Marc Lopez,Igor Andreev,Marc Lopez,7-6(5); 3-6; 7-6(3),R64,167,0,0,79,114,53,79,15,35,2,7,17,68,114,6,2,76,108,54,76,14,32,2,5,16,68,108
2004-04-26 00:00:00.000,Barcelona Spain ATP World Tour,CLAY,2,Felix Mantilla,Stanislas Wawrinka,Felix Mantilla,7-6(2); 6-0,R64,85,1,2,32,67,24,32,22,35,2,3,9,46,67,3,2,41,72,23,41,14,31,8,12,9,37,72
2004-04-26 00:00:00.000,Barcelona Spain ATP World Tour,CLAY,2,Flavio Saretta,Salvador Navarro,Flavio Saretta,4-6; 7-5; 6-4,R64,138,6,2,57,95,40,57,24,38,11,14,16,64,95,1,1,62,95,40,62,19,33,3,7,16,59,95
2004-04-26 00:00:00.000,Barcelona Spain ATP World Tour,CLAY,2,Kristof Vliegen,Stefan Koubek,Kristof Vliegen,6-4; 6-2,R64,62,1,1,33,51,22,33,10,18,1,3,9,32,51,1,1,30,50,17,30,7,20,4,9,9,24,50
2004-04-26 00:00:00.000,Barcelona Spain ATP World Tour,CLAY,2,Olivier Patience,Davide Sanguinetti,Olivier Patience,6-7(1); 6-4; 6-3,R64,125,6,4,61,102,38,61,25,41,4,7,15,63,102,2,2,63,108,38,63,24,45,9,15,16,62,108
2004-04-26 00:00:00.000,Barcelona Spain ATP World Tour,CLAY,2,Juan Ignacio Chela,N/A Bye,Juan Ignacio Chela,,R64,0,0,0,0,0,0,0,0,0,0,0,0,0,0,0,0,0,0,0,0,0,0,0,0,0,0,0
2004-04-26 00:00:00.000,Barcelona Spain ATP World Tour,CLAY,2,Agustin Calleri,N/A Bye,Agustin Calleri,,R64,0,0,0,0,0,0,0,0,0,0,0,0,0,0,0,0,0,0,0,0,0,0,0,0,0,0,0
2004-04-26 00:00:00.000,Barcelona Spain ATP World Tour,CLAY,2,Tomas Berdych,Galo Blanco,Tomas Berdych,6-3; 6-1,R64,55,10,0,27,41,23,27,7,14,1,2,8,30,41,2,2,33,55,18,33,8,22,6,11,8,26,55
2004-04-26 00:00:00.000,Barcelona Spain ATP World Tour,CLAY,2,David Sanchez,Dmitry Tursunov,David Sanchez,6-2; 6-4,R64,92,2,0,40,58,30,40,9,18,6,7,9,39,58,5,1,55,83,29,55,12,28,8,12,9,41,83
2004-04-26 00:00:00.000,Barcelona Spain ATP World Tour,CLAY,2,Feliciano Lopez,Jan-Michael Gambill,Feliciano Lopez,7-5; 7-5,R64,87,11,2,38,71,27,38,19,33,2,4,12,46,71,9,2,48,73,32,48,11,25,5,9,12,43,73
2004-04-26 00:00:00.000,Barcelona Spain ATP World Tour,CLAY,2,Albert Montanes,Albert Costa,Albert Montanes,6-4; 7-6(3),R64,111,6,2,46,77,34,46,16,31,5,8,11,50,77,9,3,44,87,29,44,19,43,10,14,11,48,87
2004-04-26 00:00:00.000,Barcelona Spain ATP World Tour,CLAY,2,Nicolas Almagro,Alex Corretja,Nicolas Almagro,3-6; 6-3; 6-4,R64,139,13,6,48,85,37,48,14,37,7,12,14,51,85,6,5,65,122,41,65,23,57,10,16,14,64,122
2004-04-26 00:00:00.000,Barcelona Spain ATP World Tour,CLAY,2,Alberto Martin,Jose Acasuso,Alberto Martin,6-1; 1-2 RET,R64,47,2,1,16,28,9,16,9,12,2,3,5,18,28,0,4,26,39,15,26,2,13,4,7,5,17,39
2004-04-26 00:00:00.000,Barcelona Spain ATP World Tour,CLAY,2,Nicolas Massu,N/A Bye,Nicolas Massu,,R64,0,0,0,0,0,0,0,0,0,0,0,0,0,0,0,0,0,0,0,0,0,0,0,0,0,0,0
2004-04-26 00:00:00.000,Barcelona Spain ATP World Tour,CLAY,2,Gustavo Kuerten,N/A Bye,Gustavo Kuerten,,R64,0,0,0,0,0,0,0,0,0,0,0,0,0,0,0,0,0,0,0,0,0,0,0,0,0,0,0
2004-04-26 00:00:00.000,Barcelona Spain ATP World Tour,CLAY,2,Thomas Johansson,Didac Perez,Thomas Johansson,7-5; 6-3,R64,68,7,0,28,55,24,28,19,27,0,1,11,43,55,3,1,41,55,27,41,7,14,3,6,10,34,55
2004-04-26 00:00:00.000,Barcelona Spain ATP World Tour,CLAY,2,Guillermo Canas,Juan Antonio Marin,Guillermo Canas,6-4; 6-2,R64,82,8,0,27,46,22,27,15,19,0,0,9,37,46,2,0,30,63,22,30,13,33,4,7,9,35,63
2004-04-26 00:00:00.000,Barcelona Spain ATP World Tour,CLAY,2,Mario Ancic,Dominik Hrbaty,Mario Ancic,6-7(3); 7-6(5); 7-5,R64,144,17,2,73,107,59,73,18,34,0,2,18,77,107,1,5,68,110,52,68,24,42,1,4,18,76,110
2004-04-26 00:00:00.000,Barcelona Spain ATP World Tour,CLAY,2,Gaston Gaudio,Raemon Sluiter,Gaston Gaudio,6-3; 6-3,R64,67,1,0,36,46,30,36,7,10,0,0,9,37,46,5,3,28,57,19,28,15,29,5,8,9,34,57
2004-04-26 00:00:00.000,Barcelona Spain ATP World Tour,CLAY,2,Alexander Popp,Albert Portas,Alexander Popp,6-4; 6-2,R64,69,3,2,32,52,26,32,13,20,3,3,9,39,52,2,2,38,61,24,38,10,23,6,9,9,34,61
2004-04-26 00:00:00.000,Barcelona Spain ATP World Tour,CLAY,2,Daniel Elsner,Ruben Ramirez Hidalgo,Daniel Elsner,6-4; 1-6; 7-6(5),R64,135,3,2,59,97,34,59,22,38,4,9,14,56,97,2,1,64,100,45,64,17,36,9,13,15,62,100
2004-04-26 00:00:00.000,Barcelona Spain ATP World Tour,CLAY,2,Carlos Moya,N/A Bye,Carlos Moya,,R64,0,0,0,0,0,0,0,0,0,0,0,0,0,0,0,0,0,0,0,0,0,0,0,0,0,0,0
2004-04-26 00:00:00.000,Barcelona Spain ATP World Tour,CLAY,2,Fernando Gonzalez,Nicolas Lapentti,Fernando Gonzalez,7-6(1); 6-0,R32,74,4,3,39,54,33,39,9,15,1,1,9,42,54,2,1,35,58,17,35,15,23,4,7,9,32,58
2004-04-26 00:00:00.000,Barcelona Spain ATP World Tour,CLAY,2,Mariano Zabaleta,Fernando Vicente,Mariano Zabaleta,6-0; 6-3,R32,65,4,1,38,61,28,38,11,23,5,5,8,39,61,1,0,25,41,13,25,7,16,5,9,7,20,41
2004-04-26 00:00:00.000,Barcelona Spain ATP World Tour,CLAY,2,Fernando Verdasco,Peter Luczak,Fernando Verdasco,5-1 RET,R32,22,3,0,15,18,11,15,2,3,2,2,3,13,18,1,1,11,20,6,11,3,9,1,3,3,9,20
2004-04-26 00:00:00.000,Barcelona Spain ATP World Tour,CLAY,2,Tommy Robredo,Karol Beck,Tommy Robredo,6-4; 6-4,R32,88,4,1,34,64,24,34,16,30,4,6,10,40,64,3,3,39,71,26,39,14,32,5,9,10,40,71
2004-04-26 00:00:00.000,Barcelona Spain ATP World Tour,CLAY,2,David Nalbandian,Todd Martin,David Nalbandian,6-2; 6-4,R32,87,3,1,32,51,24,32,12,19,4,5,9,36,51,7,1,33,72,25,33,14,39,9,13,9,39,72
2004-04-26 00:00:00.000,Barcelona Spain ATP World Tour,CLAY,2,Marc Lopez,Felix Mantilla,Marc Lopez,6-4; 7-6(4),R32,123,0,0,59,85,37,59,17,26,9,10,11,54,85,1,1,50,69,32,50,11,19,0,2,11,43,69
2004-04-26 00:00:00.000,Barcelona Spain ATP World Tour,CLAY,2,Kristof Vliegen,Flavio Saretta,Kristof Vliegen,6-2; 1-6; 6-3,R32,98,2,1,45,68,28,45,15,23,0,3,12,43,68,5,2,43,78,30,43,15,35,7,11,12,45,78
2004-04-26 00:00:00.000,Barcelona Spain ATP World Tour,CLAY,2,Olivier Patience,Juan Ignacio Chela,Olivier Patience,1-6; 6-4; 6-4,R32,117,3,0,58,96,37,58,18,38,8,12,14,55,96,3,3,61,82,42,61,8,21,3,6,13,50,82
2004-04-26 00:00:00.000,Barcelona Spain ATP World Tour,CLAY,2,Agustin Calleri,Tomas Berdych,Agustin Calleri,6-1; 7-6(7),R32,98,3,2,29,61,25,29,19,32,1,1,9,44,61,5,4,49,87,28,49,21,38,8,11,10,49,87
2004-04-26 00:00:00.000,Barcelona Spain ATP World Tour,CLAY,2,Feliciano Lopez,David Sanchez,Feliciano Lopez,6-3; 2-6; 6-4,R32,101,8,4,49,82,34,49,16,33,5,9,14,50,82,6,2,46,80,31,46,15,34,3,7,13,46,80
2004-04-26 00:00:00.000,Barcelona Spain ATP World Tour,CLAY,2,Albert Montanes,Nicolas Almagro,Albert Montanes,3-6; 6-2; 6-2,R32,99,6,0,51,75,35,51,13,24,4,6,12,48,75,10,5,54,97,36,54,18,43,11,16,13,54,97
2004-04-26 00:00:00.000,Barcelona Spain ATP World Tour,CLAY,2,Alberto Martin,Nicolas Massu,Alberto Martin,6-3; 5-7; 6-2,R32,156,2,3,65,100,46,65,17,35,8,10,14,63,100,2,2,64,104,42,64,16,40,2,7,15,58,104
2004-04-26 00:00:00.000,Barcelona Spain ATP World Tour,CLAY,2,Gustavo Kuerten,Thomas Johansson,Gustavo Kuerten,7-6(5); 4-6; 7-6(5),R32,153,22,4,70,130,50,70,29,60,9,12,17,79,130,13,3,61,117,47,61,29,56,8,10,17,76,117
2004-04-26 00:00:00.000,Barcelona Spain ATP World Tour,CLAY,2,Guillermo Canas,Mario Ancic,Guillermo Canas,6-4; 6-4,R32,86,0,1,42,53,35,42,7,11,2,2,10,42,53,8,1,44,62,30,44,9,18,4,6,10,39,62
2004-04-26 00:00:00.000,Barcelona Spain ATP World Tour,CLAY,2,Gaston Gaudio,Alexander Popp,Gaston Gaudio,6-0; 7-6(4),R32,79,0,3,30,54,22,30,12,24,0,2,9,34,54,2,2,42,71,23,42,9,29,8,13,9,32,71
2004-04-26 00:00:00.000,Barcelona Spain ATP World Tour,CLAY,2,Carlos Moya,Daniel Elsner,Carlos Moya,6-4; 6-2,R32,64,4,2,27,57,24,27,17,30,2,2,9,41,57,3,5,32,57,22,32,10,25,6,9,9,32,57
2004-04-26 00:00:00.000,Barcelona Spain ATP World Tour,CLAY,2,Fernando Gonzalez,Mariano Zabaleta,Fernando Gonzalez,7-6(2); 3-6; 6-2,R16,122,5,2,63,88,46,63,13,25,2,4,14,59,88,2,3,77,97,50,77,10,20,7,10,15,60,97
2004-04-26 00:00:00.000,Barcelona Spain ATP World Tour,CLAY,2,Tommy Robredo,Fernando Verdasco,Tommy Robredo,6-4; 5-7; 6-4,R16,145,3,3,62,101,43,62,21,39,5,8,16,64,101,2,0,90,111,57,90,11,21,11,15,16,68,111
2004-04-26 00:00:00.000,Barcelona Spain ATP World Tour,CLAY,2,David Nalbandian,Marc Lopez,David Nalbandian,6-4; 6-4,R16,97,3,3,46,67,27,46,14,21,4,6,10,41,67,0,0,45,67,25,45,11,22,4,8,10,36,67
2004-04-26 00:00:00.000,Barcelona Spain ATP World Tour,CLAY,2,Kristof Vliegen,Olivier Patience,Kristof Vliegen,6-3; 6-4,R16,80,4,0,29,44,22,29,9,15,2,4,9,31,44,2,0,54,85,30,54,13,31,11,16,10,43,85
2004-04-26 00:00:00.000,Barcelona Spain ATP World Tour,CLAY,2,Agustin Calleri,Feliciano Lopez,Agustin Calleri,6-3; 7-5,R16,69,8,1,35,52,32,35,10,17,1,2,11,42,52,5,2,45,64,32,45,5,19,7,10,10,37,64
2004-04-26 00:00:00.000,Barcelona Spain ATP World Tour,CLAY,2,Albert Montanes,Alberto Martin,Albert Montanes,6-3; 6-2,R16,68,1,1,29,44,16,29,10,15,0,2,8,26,44,0,0,33,58,15,33,10,25,5,11,9,25,58
2004-04-26 00:00:00.000,Barcelona Spain ATP World Tour,CLAY,2,Gustavo Kuerten,Guillermo Canas,Gustavo Kuerten,6-3; 6-7(1); 6-3,R16,110,6,1,55,88,43,55,23,33,0,1,16,66,88,8,2,47,79,37,47,17,32,1,4,14,54,79
2004-04-26 00:00:00.000,Barcelona Spain ATP World Tour,CLAY,2,Gaston Gaudio,Carlos Moya,Gaston Gaudio,6-4; 6-4,R16,76,2,2,36,56,30,36,12,20,0,0,10,42,56,8,0,33,57,28,33,9,24,3,5,10,37,57
2004-04-26 00:00:00.000,Barcelona Spain ATP World Tour,CLAY,2,Tommy Robredo,Fernando Gonzalez,Tommy Robredo,4-6; 7-5; 7-6(2),Q,156,3,1,80,106,61,80,11,26,6,9,17,72,106,2,1,64,108,45,64,22,44,5,8,17,67,108
2004-04-26 00:00:00.000,Barcelona Spain ATP World Tour,CLAY,2,Kristof Vliegen,David Nalbandian,Kristof Vliegen,7-6(1); 6-4,Q,119,3,6,58,102,33,58,23,44,12,16,11,56,102,2,1,46,66,25,46,8,20,0,5,11,33,66
2004-04-26 00:00:00.000,Barcelona Spain ATP World Tour,CLAY,2,Albert Montanes,Agustin Calleri,Albert Montanes,4-6; 7-6(3); 6-3,Q,136,5,1,75,100,53,75,16,25,5,7,16,69,100,8,2,74,120,48,74,26,46,10,12,15,74,120
2004-04-26 00:00:00.000,Barcelona Spain ATP World Tour,CLAY,2,Gaston Gaudio,Gustavo Kuerten,Gaston Gaudio,3-6; 7-6(5); 2-1 RET,Q,104,1,7,51,73,39,51,8,22,0,2,11,47,73,6,2,51,85,35,51,17,34,3,5,13,52,85
2004-04-26 00:00:00.000,Barcelona Spain ATP World Tour,CLAY,2,Tommy Robredo,Kristof Vliegen,Tommy Robredo,6-4; 6-3,S,86,2,2,49,71,32,49,10,22,8,11,10,42,71,1,4,43,59,21,43,6,16,6,11,9,27,59
2004-04-26 00:00:00.000,Barcelona Spain ATP World Tour,CLAY,2,Gaston Gaudio,Albert Montanes,Gaston Gaudio,6-3; 6-4,S,83,2,2,38,57,25,38,11,19,5,7,9,36,57,1,3,36,57,19,36,8,21,1,6,10,27,57
2004-04-26 00:00:00.000,Barcelona Spain ATP World Tour,CLAY,2,Tommy Robredo,Gaston Gaudio,Tommy Robredo,6-3; 4-6; 6-2; 3-6; 6-3,F,226,9,4,84,139,59,84,33,55,10,13,23,92,139,1,5,107,160,69,107,26,53,8,13,22,95,160
2004-04-26 00:00:00.000,Munich Germany ATP World Tour,CLAY,2,Rainer Schuettler,Robin Soderling,Rainer Schuettler,6-4; 7-6(5),R32,100,4,4,51,83,38,51,15,32,5,7,11,53,83,4,2,44,72,32,44,12,28,0,3,11,44,72
2004-04-26 00:00:00.000,Munich Germany ATP World Tour,CLAY,2,Tommy Haas,Bohdan Ulihrach,Tommy Haas,6-3; 6-2,R32,60,6,2,30,48,25,30,12,18,1,1,9,37,48,3,2,25,51,15,25,12,26,2,5,8,27,51
2004-04-26 00:00:00.000,Munich Germany ATP World Tour,CLAY,2,Victor Hanescu,Lars Burgsmuller,Victor Hanescu,6-2; 7-6(5),R32,82,2,0,45,63,34,45,11,18,2,3,10,45,63,2,1,45,72,28,45,14,27,6,9,10,42,72
2004-04-26 00:00:00.000,Munich Germany ATP World Tour,CLAY,2,Nikolay Davydenko,Andrei Pavel,Nikolay Davydenko,7-6(3); 6-4,R32,87,5,1,41,60,34,41,13,19,4,5,11,47,60,0,0,45,65,30,45,12,20,2,4,11,42,65
2004-04-26 00:00:00.000,Munich Germany ATP World Tour,CLAY,2,Jiri Novak,Mikhail Youzhny,Jiri Novak,6-4; 6-2,R32,85,0,1,34,56,23,34,12,22,3,4,9,35,56,5,1,44,82,29,44,14,38,9,13,9,43,82
2004-04-26 00:00:00.000,Munich Germany ATP World Tour,CLAY,2,Radek Stepanek,Karol Kucera,Radek Stepanek,6-4; 7-5,R32,94,2,0,35,58,25,35,14,23,0,2,11,39,58,5,1,45,69,25,45,13,24,2,6,11,38,69
2004-04-26 00:00:00.000,Munich Germany ATP World Tour,CLAY,2,Luis Horna,Olivier Mutis,Luis Horna,6-4; 6-1,R32,60,6,0,35,56,27,35,11,21,5,6,9,38,56,3,1,29,48,19,29,7,19,4,8,8,26,48
2004-04-26 00:00:00.000,Munich Germany ATP World Tour,CLAY,2,Taylor Dent,Antony Dupuis,Taylor Dent,7-6(5); 7-6(2),R32,114,8,8,45,80,34,45,16,35,1,4,12,50,80,8,1,66,96,36,66,15,30,7,10,12,51,96
2004-04-26 00:00:00.000,Munich Germany ATP World Tour,CLAY,2,Sargis Sargsian,James Blake,Sargis Sargsian,6-4; 7-6(6),R32,84,5,3,56,76,42,56,8,20,3,5,11,50,76,4,0,51,77,36,51,12,26,3,6,11,48,77
2004-04-26 00:00:00.000,Munich Germany ATP World Tour,CLAY,2,Michel Kratochvil,Xavier Malisse,Michel Kratochvil,6-4; 4-6; 6-3,R32,127,7,5,56,101,43,56,22,45,5,7,15,65,101,11,3,70,103,43,70,21,33,14,17,14,64,103
2004-04-26 00:00:00.000,Munich Germany ATP World Tour,CLAY,2,Boris Pashanski,Wesley Moodie,Boris Pashanski,6-4; 6-3,R32,60,2,2,32,44,28,32,8,12,0,0,9,36,44,10,2,39,56,26,39,9,17,5,8,10,35,56
2004-04-26 00:00:00.000,Munich Germany ATP World Tour,CLAY,2,Martin Verkerk,Joachim Johansson,Martin Verkerk,6-4; 6-2,R32,8,9,3,30,48,28,30,10,18,0,0,9,38,48,6,1,28,50,18,28,12,22,0,3,9,30,50
2004-04-26 00:00:00.000,Munich Germany ATP World Tour,CLAY,2,Vincent Spadea,Dieter Kindlmann,Vincent Spadea,6-4; 6-2,R32,71,9,1,29,55,23,29,12,26,6,8,9,35,55,3,6,30,60,14,30,15,30,4,9,9,29,60
2004-04-26 00:00:00.000,Munich Germany ATP World Tour,CLAY,2,Alexander Waske,Goran Ivanisevic,Alexander Waske,6-4; 7-6(0),R32,77,8,1,35,58,30,35,18,23,0,0,11,48,58,13,3,38,67,30,38,16,29,2,3,11,46,67
2004-04-26 00:00:00.000,Munich Germany ATP World Tour,CLAY,2,Philipp Kohlschreiber,Kenneth Carlsen,Philipp Kohlschreiber,7-6(7); 6-4,R32,96,5,2,48,75,35,48,18,27,3,4,11,53,75,9,4,46,73,34,46,13,27,1,3,11,47,73
2004-04-26 00:00:00.000,Munich Germany ATP World Tour,CLAY,2,Olivier Rochus,Paradorn Srichaphan,Olivier Rochus,6-3; 6-2,R32,79,1,2,32,49,22,32,9,17,4,6,8,31,49,3,2,46,69,24,46,7,23,7,13,9,31,69
2004-04-26 00:00:00.000,Munich Germany ATP World Tour,CLAY,2,Rainer Schuettler,Tommy Haas,Rainer Schuettler,6-4; 2-6; 6-4,R16,111,6,2,44,77,31,44,19,33,1,4,14,50,77,3,2,44,73,33,44,17,29,3,6,14,50,73
2004-04-26 00:00:00.000,Munich Germany ATP World Tour,CLAY,2,Nikolay Davydenko,Victor Hanescu,Nikolay Davydenko,6-7(6); 6-2; 6-4,R16,131,11,5,60,88,48,60,17,28,3,3,15,65,88,2,0,80,108,55,80,14,28,5,8,15,69,108
2004-04-26 00:00:00.000,Munich Germany ATP World Tour,CLAY,2,Radek Stepanek,Jiri Novak,Radek Stepanek,6-3; 7-5,R16,78,4,4,34,57,25,34,13,23,0,2,11,38,57,1,2,48,69,28,48,10,21,4,8,10,38,69
2004-04-26 00:00:00.000,Munich Germany ATP World Tour,CLAY,2,Luis Horna,Taylor Dent,Luis Horna,4-6; 1-3 RET,R16,48,1,0,28,37,23,28,7,9,2,2,7,30,37,6,2,30,47,20,30,7,17,2,4,7,27,47
2004-04-26 00:00:00.000,Munich Germany ATP World Tour,CLAY,2,Michel Kratochvil,Sargis Sargsian,Michel Kratochvil,6-2; 6-4,R16,72,1,1,26,53,20,26,17,27,1,1,9,37,53,2,1,46,62,24,46,9,16,2,5,9,33,62
2004-04-26 00:00:00.000,Munich Germany ATP World Tour,CLAY,2,Martin Verkerk,Boris Pashanski,Martin Verkerk,7-6(3); 7-6(4),R16,98,21,0,48,70,37,48,17,22,0,1,12,54,70,0,2,52,83,40,52,17,31,2,3,12,57,83
2004-04-26 00:00:00.000,Munich Germany ATP World Tour,CLAY,2,Alexander Waske,Vincent Spadea,Alexander Waske,3-6; 7-5; 7-6(4),R16,139,11,1,70,98,50,70,17,28,2,5,16,67,98,5,1,72,113,46,72,25,41,6,9,17,71,113
2004-04-26 00:00:00.000,Munich Germany ATP World Tour,CLAY,2,Olivier Rochus,Philipp Kohlschreiber,Olivier Rochus,7-6(4); 6-2,R16,93,1,0,49,65,32,49,11,16,5,6,10,43,65,3,5,37,78,26,37,16,41,3,6,10,42,78
2004-04-26 00:00:00.000,Munich Germany ATP World Tour,CLAY,2,Nikolay Davydenko,Rainer Schuettler,Nikolay Davydenko,6-1; 7-6(4),Q,106,3,5,36,67,26,36,19,31,3,4,10,45,67,2,2,43,72,25,43,15,29,6,9,9,40,72
2004-04-26 00:00:00.000,Munich Germany ATP World Tour,CLAY,2,Luis Horna,Radek Stepanek,Luis Horna,7-6(6); 7-6(2),Q,113,6,4,49,82,44,49,19,33,1,1,12,63,82,14,1,65,94,51,65,14,29,5,5,12,65,94
2004-04-26 00:00:00.000,Munich Germany ATP World Tour,CLAY,2,Martin Verkerk,Michel Kratochvil,Martin Verkerk,6-3; 7-6(0),Q,82,12,1,32,57,26,32,19,25,2,2,10,45,57,2,4,30,62,21,30,19,32,2,4,11,40,62
2004-04-26 00:00:00.000,Munich Germany ATP World Tour,CLAY,2,Olivier Rochus,Alexander Waske,Olivier Rochus,3-6; 6-3; 6-4,Q,110,5,0,73,95,50,73,13,22,3,4,14,63,95,15,2,60,84,47,60,11,24,5,7,14,58,84
2004-04-26 00:00:00.000,Munich Germany ATP World Tour,CLAY,2,Nikolay Davydenko,Luis Horna,Nikolay Davydenko,6-4; 6-1,S,84,2,0,24,41,18,24,11,17,0,1,8,29,41,1,1,42,75,26,42,11,33,4,9,9,37,75
2004-04-26 00:00:00.000,Munich Germany ATP World Tour,CLAY,2,Martin Verkerk,Olivier Rochus,Martin Verkerk,7-6(2); 6-3,S,92,12,1,32,68,26,32,21,36,2,3,11,47,68,0,2,44,61,30,44,7,17,3,5,10,37,61
2004-04-26 00:00:00.000,Munich Germany ATP World Tour,CLAY,2,Nikolay Davydenko,Martin Verkerk,Nikolay Davydenko,6-4; 7-5,F,98,1,2,47,63,35,47,11,16,3,3,11,46,63,2,0,46,68,31,46,12,22,4,6,11,43,68
2004-05-03 00:00:00.000,ATP Masters Series Rome Italy ATP World Tour,CLAY,2,Roger Federer,Jonas Bjorkman,Roger Federer,7-6(4); 6-3,R64,84,4,3,39,69,33,39,19,30,1,1,11,52,69,1,0,31,63,23,31,23,32,4,5,10,46,63
2004-05-03 00:00:00.000,ATP Masters Series Rome Italy ATP World Tour,CLAY,2,Albert Costa,Alex Corretja,Albert Costa,7-6(5); 6-1,R64,105,3,4,36,62,29,36,15,26,2,3,10,44,62,0,4,38,66,22,38,13,28,3,6,9,35,66
2004-05-03 00:00:00.000,ATP Masters Series Rome Italy ATP World Tour,CLAY,2,Luis Horna,Mikhail Youzhny,Luis Horna,6-0; 4-6; 7-6(6),R64,127,5,4,68,100,43,68,22,32,7,9,14,65,100,3,6,76,108,49,76,13,32,11,15,14,62,108
2004-05-03 00:00:00.000,ATP Masters Series Rome Italy ATP World Tour,CLAY,2,Martin Verkerk,Todd Martin,Martin Verkerk,7-5; 3-6; 6-3,R64,102,18,8,60,92,49,60,14,32,5,7,15,63,92,9,7,51,80,41,51,14,29,2,5,15,55,80
2004-05-03 00:00:00.000,ATP Masters Series Rome Italy ATP World Tour,CLAY,2,Jiri Novak,James Blake,Jiri Novak,2-6; 6-3; 6-1,R64,80,1,1,58,68,36,58,8,10,2,5,12,44,68,3,2,65,83,42,65,6,18,13,18,12,48,83
2004-05-03 00:00:00.000,ATP Masters Series Rome Italy ATP World Tour,CLAY,2,Max Mirnyi,Stefan Koubek,Max Mirnyi,6-2; 6-4,R64,58,2,0,46,51,35,46,3,5,1,1,9,38,51,0,0,38,50,25,38,4,12,4,7,9,29,50
2004-05-03 00:00:00.000,ATP Masters Series Rome Italy ATP World Tour,CLAY,2,David Ferrer,Davide Sanguinetti,David Ferrer,6-3; 2-6; 6-3,R64,103,4,1,52,71,33,52,11,19,6,10,13,44,71,4,2,59,94,37,59,16,35,11,16,13,53,94
2004-05-03 00:00:00.000,ATP Masters Series Rome Italy ATP World Tour,CLAY,2,Sebastien Grosjean,Feliciano Lopez,Sebastien Grosjean,7-5; 6-2,R64,76,8,3,29,55,25,29,19,26,3,3,10,44,55,2,5,40,62,26,40,12,22,3,6,10,38,62
2004-05-03 00:00:00.000,ATP Masters Series Rome Italy ATP World Tour,CLAY,2,Vincent Spadea,Rainer Schuettler,Vincent Spadea,6-2; 2-6; 7-5,R64,118,4,5,40,84,27,40,23,44,4,8,14,50,84,6,4,61,104,39,61,19,43,5,10,14,58,104
2004-05-03 00:00:00.000,ATP Masters Series Rome Italy ATP World Tour,CLAY,2,Hicham Arazi,Ruben Ramirez Hidalgo,Hicham Arazi,6-1; 6-4,R64,69,2,0,34,46,27,34,9,12,0,0,9,36,46,1,1,28,57,22,28,10,29,3,6,8,32,57
2004-05-03 00:00:00.000,ATP Masters Series Rome Italy ATP World Tour,CLAY,2,Nikolay Davydenko,Sargis Sargsian,Nikolay Davydenko,6-2; 6-2,R64,74,2,2,41,54,29,41,4,13,4,6,8,33,54,1,0,33,55,15,33,7,22,4,10,8,22,55
2004-05-03 00:00:00.000,ATP Masters Series Rome Italy ATP World Tour,CLAY,2,Fernando Gonzalez,Dominik Hrbaty,Fernando Gonzalez,6-4; 6-4,R64,82,10,5,29,53,26,29,8,24,1,3,10,34,53,1,5,38,67,25,38,11,29,3,7,10,36,67
2004-05-03 00:00:00.000,ATP Masters Series Rome Italy ATP World Tour,CLAY,2,Sjeng Schalken,Wayne Arthurs,Sjeng Schalken,6-3; 4-6; 6-1,R64,112,4,3,59,84,40,59,16,25,8,9,13,56,84,7,9,40,88,30,40,21,48,8,12,13,51,88
2004-05-03 00:00:00.000,ATP Masters Series Rome Italy ATP World Tour,CLAY,2,Filippo Volandri,Nicolas Kiefer,Filippo Volandri,6-4; 0-6; 6-0,R64,99,0,4,56,78,36,56,9,22,6,9,11,45,78,0,3,30,61,25,30,11,31,2,6,11,36,61
2004-05-03 00:00:00.000,ATP Masters Series Rome Italy ATP World Tour,CLAY,2,Flavio Saretta,Mario Ancic,Flavio Saretta,6-4; 3-6; 7-6(6),R64,146,1,6,63,106,44,63,20,43,11,16,15,64,106,8,4,52,93,31,52,26,41,3,8,16,57,93
2004-05-03 00:00:00.000,ATP Masters Series Rome Italy ATP World Tour,CLAY,2,David Nalbandian,Robin Soderling,David Nalbandian,6-4; 6-4,R64,76,4,0,32,52,26,32,12,20,2,3,10,38,52,3,2,27,56,22,27,12,29,1,4,10,34,56
2004-05-03 00:00:00.000,ATP Masters Series Rome Italy ATP World Tour,CLAY,2,Nicolas Massu,Massimo Dell'Acqua,Nicolas Massu,6-7(9); 7-5; 6-3,R64,203,7,2,77,102,57,77,12,25,3,5,16,69,102,13,12,71,136,53,71,25,65,9,14,17,78,136
2004-05-03 00:00:00.000,ATP Masters Series Rome Italy ATP World Tour,CLAY,2,Irakli Labadze,Gaston Gaudio,Irakli Labadze,6-3; 6-2,R64,66,1,5,36,50,26,36,6,14,2,3,8,32,50,1,0,28,47,18,28,8,19,4,9,9,26,47
2004-05-03 00:00:00.000,ATP Masters Series Rome Italy ATP World Tour,CLAY,2,Marat Safin,Stefano Pescosolido,Marat Safin,6-4; 6-3,R64,72,10,0,33,52,24,33,11,19,0,1,9,35,52,2,7,27,61,18,27,14,34,2,6,10,32,61
2004-05-03 00:00:00.000,ATP Masters Series Rome Italy ATP World Tour,CLAY,2,Paradorn Srichaphan,Alessio Di Mauro,Paradorn Srichaphan,7-6(3); 3-6; 6-3,R64,133,5,6,59,99,45,59,21,40,9,11,15,66,99,6,3,48,98,35,48,26,50,4,6,15,61,98
2004-05-03 00:00:00.000,ATP Masters Series Rome Italy ATP World Tour,CLAY,2,Mariano Zabaleta,Juan Ignacio Chela,Mariano Zabaleta,6-4; 6-2,R64,74,4,1,39,51,26,39,8,12,2,4,9,34,51,0,1,47,57,24,47,5,10,6,11,9,29,57
2004-05-03 00:00:00.000,ATP Masters Series Rome Italy ATP World Tour,CLAY,2,Felix Mantilla,Robby Ginepri,Felix Mantilla,5-7; 7-5; 6-0,R64,105,1,8,51,84,35,51,13,33,4,9,15,48,84,6,12,53,97,28,53,18,44,4,12,15,46,97
2004-05-03 00:00:00.000,ATP Masters Series Rome Italy ATP World Tour,CLAY,2,Radek Stepanek,Goran Ivanisevic,Radek Stepanek,6-2; 6-4,R64,54,5,2,22,48,18,22,19,26,1,1,9,37,48,9,7,27,55,21,27,10,28,3,6,9,31,55
2004-05-03 00:00:00.000,ATP Masters Series Rome Italy ATP World Tour,CLAY,2,Tim Henman,Florian Mayer,Tim Henman,7-5; 6-1,R64,71,4,5,26,55,22,26,17,29,1,2,10,39,55,1,1,36,57,21,36,10,21,3,7,9,31,57
2004-05-03 00:00:00.000,ATP Masters Series Rome Italy ATP World Tour,CLAY,2,Carlos Moya,Alberto Martin,Carlos Moya,6-4; 6-2,R64,73,8,0,36,57,29,36,12,21,5,5,9,41,57,3,4,32,57,21,32,11,25,2,5,9,32,57
2004-05-03 00:00:00.000,ATP Masters Series Rome Italy ATP World Tour,CLAY,2,Ivan Ljubicic,Arnaud Clement,Ivan Ljubicic,6-3; 2-6; 7-6(3),R64,134,10,5,45,87,32,45,27,42,6,9,15,59,87,3,2,48,86,36,48,20,38,1,3,14,56,86
2004-05-03 00:00:00.000,ATP Masters Series Rome Italy ATP World Tour,CLAY,2,Ivo Karlovic,Tommy Haas,Ivo Karlovic,7-5; 4-6; 7-6(5),R64,137,24,6,72,112,55,72,23,40,4,5,17,78,112,5,2,52,98,36,52,35,46,2,3,17,71,98
2004-05-03 00:00:00.000,ATP Masters Series Rome Italy ATP World Tour,CLAY,2,Tommy Robredo,Mark Philippoussis,Tommy Robredo,6-2; 4-6; 6-4,R64,107,4,4,58,85,41,58,14,27,3,5,14,55,85,4,3,45,78,30,45,18,33,1,5,14,48,78
2004-05-03 00:00:00.000,ATP Masters Series Rome Italy ATP World Tour,CLAY,2,Lleyton Hewitt,Andreas Seppi,Lleyton Hewitt,5-7; 7-5; 6-3,R64,160,1,10,61,114,44,61,20,53,8,14,17,64,114,1,4,59,112,33,59,26,53,5,12,16,59,112
2004-05-03 00:00:00.000,ATP Masters Series Rome Italy ATP World Tour,CLAY,2,Andrei Pavel,Nicolas Lapentti,Andrei Pavel,6-4; 6-3,R64,87,1,1,36,60,27,36,12,24,5,6,9,39,60,2,3,26,59,15,26,20,33,5,9,10,35,59
2004-05-03 00:00:00.000,ATP Masters Series Rome Italy ATP World Tour,CLAY,2,David Sanchez,Igor Andreev,David Sanchez,6-2; 6-3,R64,81,4,2,33,56,24,33,12,23,6,7,8,36,56,0,2,42,58,23,42,6,16,7,12,9,29,58
2004-05-03 00:00:00.000,ATP Masters Series Rome Italy ATP World Tour,CLAY,2,Guillermo Canas,Andy Roddick,Guillermo Canas,7-6(7); 6-1,R64,82,5,5,44,78,34,44,19,34,6,7,10,53,78,4,2,28,57,21,28,16,29,6,9,9,37,57
2004-05-03 00:00:00.000,ATP Masters Series Rome Italy ATP World Tour,CLAY,2,Albert Costa,Roger Federer,Albert Costa,3-6; 6-3; 6-2,R32,127,3,1,64,93,43,64,14,29,12,14,13,57,93,6,4,48,83,35,48,13,35,6,10,13,48,83
2004-05-03 00:00:00.000,ATP Masters Series Rome Italy ATP World Tour,CLAY,2,Luis Horna,Martin Verkerk,Luis Horna,6-4; 3-6; 6-3,R32,112,2,1,60,81,44,60,15,21,4,5,14,59,81,11,3,66,96,48,66,14,30,4,6,14,62,96
2004-05-03 00:00:00.000,ATP Masters Series Rome Italy ATP World Tour,CLAY,2,Jiri Novak,Max Mirnyi,Jiri Novak,6-1; 6-1,R32,53,0,0,22,35,18,22,7,13,0,1,7,25,35,2,4,23,47,16,23,2,24,3,9,7,18,47
2004-05-03 00:00:00.000,ATP Masters Series Rome Italy ATP World Tour,CLAY,2,David Ferrer,Sebastien Grosjean,David Ferrer,6-7(4); 6-3; 6-2,R32,147,2,1,68,97,46,68,17,29,7,9,15,63,97,5,1,42,107,30,42,31,65,13,18,14,61,107
2004-05-03 00:00:00.000,ATP Masters Series Rome Italy ATP World Tour,CLAY,2,Vincent Spadea,Hicham Arazi,Vincent Spadea,2-6; 6-2; 6-4,R32,119,3,3,40,77,29,40,17,37,3,7,13,46,77,2,3,44,82,24,44,17,38,5,10,13,41,82
2004-05-03 00:00:00.000,ATP Masters Series Rome Italy ATP World Tour,CLAY,2,Nikolay Davydenko,Fernando Gonzalez,Nikolay Davydenko,2-6; 6-2; 6-4,R32,124,3,2,75,86,54,75,3,11,3,5,14,57,86,1,1,63,84,39,63,10,21,5,10,14,49,84
2004-05-03 00:00:00.000,ATP Masters Series Rome Italy ATP World Tour,CLAY,2,Filippo Volandri,Sjeng Schalken,Filippo Volandri,6-2; 6-3,R32,75,1,1,39,52,23,39,5,13,7,10,9,28,52,0,2,43,60,21,43,6,17,2,8,8,27,60
2004-05-03 00:00:00.000,ATP Masters Series Rome Italy ATP World Tour,CLAY,2,David Nalbandian,Flavio Saretta,David Nalbandian,6-2; 6-4,R32,107,1,4,33,60,24,33,8,27,3,7,9,32,60,5,5,38,77,23,38,10,39,10,17,9,33,77
2004-05-03 00:00:00.000,ATP Masters Series Rome Italy ATP World Tour,CLAY,2,Nicolas Massu,Irakli Labadze,Nicolas Massu,6-2; 7-5,R32,84,3,0,38,58,25,38,8,20,3,7,10,33,58,1,9,40,57,21,40,3,17,5,12,10,24,57
2004-05-03 00:00:00.000,ATP Masters Series Rome Italy ATP World Tour,CLAY,2,Marat Safin,Paradorn Srichaphan,Marat Safin,6-2; 6-2,R32,61,2,2,19,40,14,19,15,21,0,1,8,29,40,2,2,25,53,11,25,14,28,3,8,8,25,53
2004-05-03 00:00:00.000,ATP Masters Series Rome Italy ATP World Tour,CLAY,2,Mariano Zabaleta,Felix Mantilla,Mariano Zabaleta,7-5; 6-3,R32,94,6,2,38,60,29,38,8,22,4,7,10,37,60,0,5,49,77,30,49,7,28,9,15,11,37,77
2004-05-03 00:00:00.000,ATP Masters Series Rome Italy ATP World Tour,CLAY,2,Tim Henman,Radek Stepanek,Tim Henman,6-1; 6-1,R32,72,9,2,31,56,22,31,14,25,3,3,7,36,56,2,4,29,54,15,29,9,25,8,13,7,24,54
2004-05-03 00:00:00.000,ATP Masters Series Rome Italy ATP World Tour,CLAY,2,Carlos Moya,Ivan Ljubicic,Carlos Moya,6-2; 6-4,R32,71,4,2,39,65,33,39,10,26,3,3,9,43,65,6,3,26,48,19,26,10,22,3,6,9,29,48
2004-05-03 00:00:00.000,ATP Masters Series Rome Italy ATP World Tour,CLAY,2,Ivo Karlovic,Tommy Robredo,Ivo Karlovic,7-6(5); 6-4,R32,93,13,1,44,69,36,44,17,25,0,0,11,53,69,3,0,58,70,45,58,5,12,2,3,11,50,70
2004-05-03 00:00:00.000,ATP Masters Series Rome Italy ATP World Tour,CLAY,2,Andrei Pavel,Lleyton Hewitt,Andrei Pavel,4-6; 6-3; 6-4,R32,116,5,2,61,85,43,61,13,24,3,6,15,56,85,5,8,58,104,36,58,24,46,10,14,14,60,104
2004-05-03 00:00:00.000,ATP Masters Series Rome Italy ATP World Tour,CLAY,2,David Sanchez,Guillermo Canas,David Sanchez,7-5; 6-2,R32,93,3,0,52,64,32,52,8,12,1,3,10,40,64,4,4,42,66,28,42,8,24,3,8,10,36,66
2004-05-03 00:00:00.000,ATP Masters Series Rome Italy ATP World Tour,CLAY,2,Albert Costa,Luis Horna,Albert Costa,6-2; 6-3,R16,75,1,1,41,53,34,41,7,12,2,2,9,41,53,2,2,34,52,23,34,6,18,3,6,8,29,52
2004-05-03 00:00:00.000,ATP Masters Series Rome Italy ATP World Tour,CLAY,2,Jiri Novak,David Ferrer,Jiri Novak,6-3; 7-5,R16,83,1,3,51,80,33,51,10,29,4,7,10,43,80,1,4,31,57,20,31,8,26,2,8,11,28,57
2004-05-03 00:00:00.000,ATP Masters Series Rome Italy ATP World Tour,CLAY,2,Vincent Spadea,Nikolay Davydenko,Vincent Spadea,4-6; 6-3; 6-4,R16,138,1,1,53,95,33,53,24,42,6,9,15,57,95,1,2,48,86,34,48,19,38,2,6,14,53,86
2004-05-03 00:00:00.000,ATP Masters Series Rome Italy ATP World Tour,CLAY,2,David Nalbandian,Filippo Volandri,David Nalbandian,7-6(4); 3-6; 6-4,R16,137,4,3,59,92,41,59,16,33,2,7,16,57,92,1,2,70,99,44,70,15,29,9,13,15,59,99
2004-05-03 00:00:00.000,ATP Masters Series Rome Italy ATP World Tour,CLAY,2,Nicolas Massu,Marat Safin,Nicolas Massu,7-5; 6-4,R16,139,2,0,42,70,32,42,14,28,6,8,11,46,70,3,4,35,85,21,35,24,50,7,11,11,45,85
2004-05-03 00:00:00.000,ATP Masters Series Rome Italy ATP World Tour,CLAY,2,Mariano Zabaleta,Tim Henman,Mariano Zabaleta,3-6; 6-3; 6-2,R16,101,2,3,39,67,33,39,17,28,0,1,13,50,67,4,4,44,77,31,44,18,33,4,7,13,49,77
2004-05-03 00:00:00.000,ATP Masters Series Rome Italy ATP World Tour,CLAY,2,Carlos Moya,Ivo Karlovic,Carlos Moya,6-4; 3-6; 6-4,R16,107,1,2,66,86,46,66,9,20,3,5,14,55,86,14,6,55,94,43,55,17,39,5,8,15,60,94
2004-05-03 00:00:00.000,ATP Masters Series Rome Italy ATP World Tour,CLAY,2,Andrei Pavel,David Sanchez,Andrei Pavel,7-6(3); 7-6(5),R16,126,4,2,66,91,49,66,12,25,6,8,12,61,91,1,1,54,79,38,54,11,25,2,4,12,49,79
2004-05-03 00:00:00.000,ATP Masters Series Rome Italy ATP World Tour,CLAY,2,Albert Costa,Jiri Novak,Albert Costa,6-4; 6-2,Q,73,4,1,37,58,28,37,13,21,4,4,9,41,58,2,3,21,44,18,21,10,23,1,4,9,28,44
2004-05-03 00:00:00.000,ATP Masters Series Rome Italy ATP World Tour,CLAY,2,David Nalbandian,Vincent Spadea,David Nalbandian,6-4; 6-3,Q,87,3,3,35,59,26,35,14,24,4,5,9,40,59,3,6,36,69,24,36,12,33,7,11,10,36,69
2004-05-03 00:00:00.000,ATP Masters Series Rome Italy ATP World Tour,CLAY,2,Mariano Zabaleta,Nicolas Massu,Mariano Zabaleta,6-1; 7-5,Q,90,4,3,45,64,34,45,12,19,4,4,10,46,64,2,3,32,56,25,32,7,24,5,8,9,32,56
2004-05-03 00:00:00.000,ATP Masters Series Rome Italy ATP World Tour,CLAY,2,Carlos Moya,Andrei Pavel,Carlos Moya,6-1; 6-2,Q,47,2,1,22,39,19,22,13,17,0,0,8,32,39,0,1,25,40,15,25,5,15,2,6,7,20,40
2004-05-03 00:00:00.000,ATP Masters Series Rome Italy ATP World Tour,CLAY,2,David Nalbandian,Albert Costa,David Nalbandian,6-7(4); 6-1; 6-4,S,158,5,7,54,89,44,54,17,35,1,2,15,61,89,4,2,71,108,47,71,17,37,12,16,14,64,108
2004-05-03 00:00:00.000,ATP Masters Series Rome Italy ATP World Tour,CLAY,2,Carlos Moya,Mariano Zabaleta,Carlos Moya,6-3; 6-4,S,78,1,1,35,53,26,35,13,18,1,2,10,39,53,3,2,38,64,26,38,12,26,2,5,9,38,64
2004-05-03 00:00:00.000,ATP Masters Series Rome Italy ATP World Tour,CLAY,2,Carlos Moya,David Nalbandian,Carlos Moya,6-3; 6-3; 6-1,F,103,4,2,47,74,34,47,18,27,2,3,13,52,74,1,3,42,68,17,42,17,26,2,8,12,34,68
2004-05-10 00:00:00.000,ATP Masters Series Hamburg Germany ATP World Tour,CLAY,2,Roger Federer,Gaston Gaudio,Roger Federer,6-1; 5-7; 6-4,R64,116,11,1,55,97,39,55,20,42,10,14,15,59,97,1,1,57,85,34,57,11,28,5,11,14,45,85
2004-05-10 00:00:00.000,ATP Masters Series Hamburg Germany ATP World Tour,CLAY,2,Nicolas Lapentti,Filippo Volandri,Nicolas Lapentti,6-4; 6-1,R64,76,2,2,23,43,19,23,12,20,0,1,8,31,43,0,3,47,67,24,47,9,20,8,13,9,33,67
2004-05-10 00:00:00.000,ATP Masters Series Hamburg Germany ATP World Tour,CLAY,2,Julian Knowle,Robby Ginepri,Julian Knowle,6-1; 6-3,R64,73,4,4,32,55,23,32,12,23,2,3,8,35,55,0,2,26,48,12,26,10,22,6,11,8,22,48
2004-05-10 00:00:00.000,ATP Masters Series Hamburg Germany ATP World Tour,CLAY,2,Fernando Gonzalez,Feliciano Lopez,Fernando Gonzalez,7-6(4); 6-4,R64,89,2,0,60,74,42,60,9,14,4,5,11,51,74,5,0,55,85,36,55,16,30,8,10,11,52,85
2004-05-10 00:00:00.000,ATP Masters Series Hamburg Germany ATP World Tour,CLAY,2,Joachim Johansson,Mark Philippoussis,Joachim Johansson,7-6(5); 6-1,R64,90,9,4,46,76,39,46,14,30,3,4,10,53,76,4,6,35,68,24,35,15,33,4,7,9,39,68
2004-05-10 00:00:00.000,ATP Masters Series Hamburg Germany ATP World Tour,CLAY,2,Fernando Verdasco,Guillermo Canas,Fernando Verdasco,7-6(3); 7-6(7),R64,115,3,4,66,87,49,66,12,21,7,8,12,61,87,7,5,50,90,35,50,24,40,6,7,12,59,90
2004-05-10 00:00:00.000,ATP Masters Series Hamburg Germany ATP World Tour,CLAY,2,Alberto Martin,Hicham Arazi,Alberto Martin,4-6; 6-2; 6-2,R64,116,4,2,46,88,30,46,25,42,7,9,13,55,88,2,4,48,83,27,48,16,35,2,7,13,43,83
2004-05-10 00:00:00.000,ATP Masters Series Hamburg Germany ATP World Tour,CLAY,2,Carlos Moya,David Sanchez,Carlos Moya,7-5; 6-4,R64,82,4,3,38,69,29,38,17,31,5,6,11,46,69,0,2,30,70,23,30,18,40,0,3,11,41,70
2004-05-10 00:00:00.000,ATP Masters Series Hamburg Germany ATP World Tour,CLAY,2,Lleyton Hewitt,Jonas Bjorkman,Lleyton Hewitt,6-0; 7-6(5),R64,89,6,2,31,56,27,31,16,25,1,1,9,43,56,7,4,29,69,20,29,18,40,5,8,9,38,69
2004-05-10 00:00:00.000,ATP Masters Series Hamburg Germany ATP World Tour,CLAY,2,Tommy Haas,Vincent Spadea,Tommy Haas,6-0 RET,R64,26,3,1,7,16,7,7,5,9,0,0,3,12,16,0,1,10,20,4,10,2,10,3,6,3,6,20
2004-05-10 00:00:00.000,ATP Masters Series Hamburg Germany ATP World Tour,CLAY,2,Flavio Saretta,Maximilian Abel,Flavio Saretta,7-6(4); 7-6(3),R64,122,4,7,40,91,27,40,27,51,8,13,12,54,91,1,4,44,77,27,44,14,33,2,7,12,41,77
2004-05-10 00:00:00.000,ATP Masters Series Hamburg Germany ATP World Tour,CLAY,2,Oscar Hernandez,Sjeng Schalken,Oscar Hernandez,5-1 RET,R64,28,0,1,12,20,9,12,5,8,3,3,3,14,20,0,0,13,16,5,13,2,3,1,3,3,7,16
2004-05-10 00:00:00.000,ATP Masters Series Hamburg Germany ATP World Tour,CLAY,2,Jurgen Melzer,Nicolas Massu,Jurgen Melzer,6-3; 6-0,R64,68,4,2,26,51,19,26,15,25,3,4,8,34,51,2,4,33,52,13,33,9,19,6,11,7,22,52
2004-05-10 00:00:00.000,ATP Masters Series Hamburg Germany ATP World Tour,CLAY,2,Irakli Labadze,Juan Ignacio Chela,Irakli Labadze,6-0; 3-6; 7-6(1),R64,148,3,4,54,86,38,54,18,32,5,8,13,56,86,2,2,62,93,33,62,16,31,8,13,14,49,93
2004-05-10 00:00:00.000,ATP Masters Series Hamburg Germany ATP World Tour,CLAY,2,Sargis Sargsian,Nikolay Davydenko,Sargis Sargsian,6-2; 6-4,R64,89,1,2,34,50,26,34,11,16,0,0,9,37,50,1,2,34,53,22,34,8,19,1,4,9,30,53
2004-05-10 00:00:00.000,ATP Masters Series Hamburg Germany ATP World Tour,CLAY,2,Marat Safin,Sebastien Grosjean,Marat Safin,7-6(6); 7-5,R64,118,9,4,44,91,36,44,23,47,6,7,12,59,91,2,1,29,83,26,29,26,54,5,7,12,52,83
2004-05-10 00:00:00.000,ATP Masters Series Hamburg Germany ATP World Tour,CLAY,2,Tim Henman,Andreas Seppi,Tim Henman,7-5; 1-6; 6-3,R64,125,3,6,45,83,33,45,18,38,5,9,14,51,83,4,6,60,108,42,60,21,48,14,18,14,63,108
2004-05-10 00:00:00.000,ATP Masters Series Hamburg Germany ATP World Tour,CLAY,2,Andrei Pavel,Cyril Saulnier,Andrei Pavel,6-2; 7-5,R64,82,2,1,46,64,34,46,12,18,2,2,10,46,64,5,3,33,62,22,33,14,29,8,11,10,36,62
2004-05-10 00:00:00.000,ATP Masters Series Hamburg Germany ATP World Tour,CLAY,2,Victor Hanescu,Max Mirnyi,Victor Hanescu,7-6(7); 3-6; 6-3,R64,134,7,1,68,108,49,68,24,40,8,9,15,73,108,9,5,82,109,62,82,12,27,10,11,15,74,109
2004-05-10 00:00:00.000,ATP Masters Series Hamburg Germany ATP World Tour,CLAY,2,Ivan Ljubicic,Martin Verkerk,Ivan Ljubicic,7-5; 7-6(4),R64,113,7,0,41,77,31,41,24,36,1,2,12,55,77,2,5,67,96,44,67,14,29,8,10,12,58,96
2004-05-10 00:00:00.000,ATP Masters Series Hamburg Germany ATP World Tour,CLAY,2,Florian Mayer,Jiri Novak,Florian Mayer,7-6(5); 3-6; 6-4,R64,118,4,4,56,99,34,56,23,43,7,13,15,57,99,4,3,71,118,46,71,20,47,11,17,16,66,118
2004-05-10 00:00:00.000,ATP Masters Series Hamburg Germany ATP World Tour,CLAY,2,Albert Portas,Alex Corretja,Albert Portas,7-5; 6-4,R64,99,2,3,47,74,33,47,13,27,6,8,11,46,74,4,2,41,67,25,41,14,26,4,8,11,39,67
2004-05-10 00:00:00.000,ATP Masters Series Hamburg Germany ATP World Tour,CLAY,2,Mikhail Youzhny,Nicolas Kiefer,Mikhail Youzhny,6-4; 6-7(2); 6-2,R64,140,7,3,63,107,41,63,23,44,5,8,15,64,107,8,5,56,105,38,56,22,49,10,16,15,60,105
2004-05-10 00:00:00.000,ATP Masters Series Hamburg Germany ATP World Tour,CLAY,2,Lars Burgsmuller,Rainer Schuettler,Lars Burgsmuller,6-4; 6-7(5); 6-4,R64,187,3,10,87,148,56,87,30,61,19,22,16,86,148,3,4,63,105,47,63,20,42,9,14,16,67,105
2004-05-10 00:00:00.000,ATP Masters Series Hamburg Germany ATP World Tour,CLAY,2,David Ferrer,David Nalbandian,David Ferrer,6-2; 6-3,R64,59,0,0,24,34,23,24,9,10,0,0,8,32,34,0,1,34,51,19,34,9,17,3,7,9,28,51
2004-05-10 00:00:00.000,ATP Masters Series Hamburg Germany ATP World Tour,CLAY,2,Dominik Hrbaty,Thierry Ascione,Dominik Hrbaty,2-6; 6-3; 6-4,R64,106,1,5,44,81,29,44,13,37,8,14,13,42,81,3,4,50,85,30,50,12,35,7,14,14,42,85
2004-05-10 00:00:00.000,ATP Masters Series Hamburg Germany ATP World Tour,CLAY,2,Albert Costa,Xavier Malisse,Albert Costa,6-3; 6-4,R64,94,1,2,31,57,19,31,15,26,0,2,10,34,57,3,2,25,52,14,25,14,27,3,7,9,28,52
2004-05-10 00:00:00.000,ATP Masters Series Hamburg Germany ATP World Tour,CLAY,2,Olivier Rochus,Paradorn Srichaphan,Olivier Rochus,6-3; 6-4,R64,84,0,1,35,63,25,35,21,28,2,2,10,46,63,3,5,39,65,28,39,12,26,4,6,9,40,65
2004-05-10 00:00:00.000,ATP Masters Series Hamburg Germany ATP World Tour,CLAY,2,Tommy Robredo,Antony Dupuis,Tommy Robredo,6-2; 6-0,R64,56,3,1,17,39,16,17,13,22,2,2,7,29,39,2,4,30,51,18,30,4,21,5,10,7,22,51
2004-05-10 00:00:00.000,ATP Masters Series Hamburg Germany ATP World Tour,CLAY,2,Mariano Zabaleta,Robin Soderling,Mariano Zabaleta,3-6; 6-1; 6-4,R64,102,6,3,43,77,31,43,16,34,1,5,13,47,77,2,3,41,79,27,41,15,38,6,12,13,42,79
2004-05-10 00:00:00.000,ATP Masters Series Hamburg Germany ATP World Tour,CLAY,2,Luis Horna,Arnaud Clement,Luis Horna,6-2; 6-3,R64,76,4,2,27,42,23,27,8,15,0,1,8,31,42,5,5,28,64,17,28,15,36,4,9,9,32,64
2004-05-10 00:00:00.000,ATP Masters Series Hamburg Germany ATP World Tour,CLAY,2,Guillermo Coria,Nicolas Almagro,Guillermo Coria,3-6; 6-4; 7-5,R64,130,1,2,65,88,38,65,13,23,1,5,15,51,88,6,5,53,93,34,53,23,40,6,11,16,57,93
2004-05-10 00:00:00.000,ATP Masters Series Hamburg Germany ATP World Tour,CLAY,2,Roger Federer,Nicolas Lapentti,Roger Federer,6-3; 6-3,R32,60,1,0,30,46,27,30,10,16,0,0,9,37,46,4,1,33,47,20,33,7,14,1,4,9,27,47
2004-05-10 00:00:00.000,ATP Masters Series Hamburg Germany ATP World Tour,CLAY,2,Fernando Gonzalez,Julian Knowle,Fernando Gonzalez,0-6; 6-4; 6-2,R32,102,6,3,52,80,36,52,12,28,2,5,12,48,80,2,6,56,85,38,56,14,29,8,11,12,52,85
2004-05-10 00:00:00.000,ATP Masters Series Hamburg Germany ATP World Tour,CLAY,2,Fernando Verdasco,Joachim Johansson,Fernando Verdasco,7-6(4); 6-1,R32,60,6,1,48,57,40,48,7,9,3,3,10,47,57,8,6,31,54,23,31,13,23,2,4,9,36,54
2004-05-10 00:00:00.000,ATP Masters Series Hamburg Germany ATP World Tour,CLAY,2,Carlos Moya,Alberto Martin,Carlos Moya,6-2; 6-3,R32,55,3,0,37,57,29,37,12,20,3,3,9,41,57,0,2,27,42,15,27,8,15,0,3,8,23,42
2004-05-10 00:00:00.000,ATP Masters Series Hamburg Germany ATP World Tour,CLAY,2,Lleyton Hewitt,Tommy Haas,Lleyton Hewitt,6-4; 7-5,R32,105,3,3,36,66,22,36,17,30,9,13,11,39,66,3,8,40,76,26,40,12,36,2,8,11,38,76
2004-05-10 00:00:00.000,ATP Masters Series Hamburg Germany ATP World Tour,CLAY,2,Flavio Saretta,Oscar Hernandez,Flavio Saretta,6-4; 6-3,R32,103,4,6,38,65,28,38,13,27,3,5,10,41,65,0,2,32,62,16,32,16,30,5,9,9,32,62
2004-05-10 00:00:00.000,ATP Masters Series Hamburg Germany ATP World Tour,CLAY,2,Jurgen Melzer,Irakli Labadze,Jurgen Melzer,6-1; 6-0,R32,48,2,0,28,41,21,28,9,13,0,0,7,30,41,0,2,27,45,12,27,5,18,2,7,6,17,45
2004-05-10 00:00:00.000,ATP Masters Series Hamburg Germany ATP World Tour,CLAY,2,Marat Safin,Sargis Sargsian,Marat Safin,4-6; 6-3; 6-3,R32,116,2,0,36,77,27,36,25,41,2,4,14,52,77,1,3,55,88,32,55,20,33,7,11,14,52,88
2004-05-10 00:00:00.000,ATP Masters Series Hamburg Germany ATP World Tour,CLAY,2,Andrei Pavel,Tim Henman,Andrei Pavel,6-2; 6-2,R32,47,5,0,27,36,23,27,9,9,0,0,8,32,36,5,5,27,49,17,27,9,22,4,8,8,26,49
2004-05-10 00:00:00.000,ATP Masters Series Hamburg Germany ATP World Tour,CLAY,2,Ivan Ljubicic,Victor Hanescu,Ivan Ljubicic,6-0; 3-6; 7-6(3),R32,125,6,2,38,82,29,38,28,44,4,5,13,57,82,2,1,63,87,43,63,10,24,5,8,14,53,87
2004-05-10 00:00:00.000,ATP Masters Series Hamburg Germany ATP World Tour,CLAY,2,Florian Mayer,Albert Portas,Florian Mayer,6-3; 6-4,R32,66,4,4,37,55,27,37,11,18,1,2,10,38,55,2,3,30,54,19,30,10,24,5,8,9,29,54
2004-05-10 00:00:00.000,ATP Masters Series Hamburg Germany ATP World Tour,CLAY,2,Mikhail Youzhny,Lars Burgsmuller,Mikhail Youzhny,7-5; 7-5,R32,91,8,1,40,74,32,40,15,34,1,4,12,47,74,3,4,40,71,27,40,10,31,2,7,12,37,71
2004-05-10 00:00:00.000,ATP Masters Series Hamburg Germany ATP World Tour,CLAY,2,David Ferrer,Dominik Hrbaty,David Ferrer,6-0; 6-3,R32,66,2,0,30,52,24,30,13,22,2,2,8,37,52,0,2,29,46,14,29,9,17,6,10,7,23,46
2004-05-10 00:00:00.000,ATP Masters Series Hamburg Germany ATP World Tour,CLAY,2,Albert Costa,Olivier Rochus,Albert Costa,7-5; 6-4,R32,116,1,0,64,75,45,64,3,11,5,7,11,48,75,1,2,53,81,30,53,16,28,6,10,11,46,81
2004-05-10 00:00:00.000,ATP Masters Series Hamburg Germany ATP World Tour,CLAY,2,Tommy Robredo,Mariano Zabaleta,Tommy Robredo,6-4; 6-2,R32,70,2,3,34,60,27,34,13,26,5,6,9,40,60,1,2,38,51,22,38,6,13,4,8,9,28,51
2004-05-10 00:00:00.000,ATP Masters Series Hamburg Germany ATP World Tour,CLAY,2,Guillermo Coria,Luis Horna,Guillermo Coria,6-2; 3-6; 6-2,R32,140,1,1,53,83,33,53,17,30,7,10,12,50,83,5,3,68,90,40,68,6,22,10,16,13,46,90
2004-05-10 00:00:00.000,ATP Masters Series Hamburg Germany ATP World Tour,CLAY,2,Roger Federer,Fernando Gonzalez,Roger Federer,7-5; 6-1,R16,74,1,2,40,54,31,40,8,14,1,2,10,39,54,2,3,35,68,25,35,12,33,8,12,9,37,68
2004-05-10 00:00:00.000,ATP Masters Series Hamburg Germany ATP World Tour,CLAY,2,Carlos Moya,Fernando Verdasco,Carlos Moya,6-4; 3-6; 6-4,R16,125,7,1,60,108,44,60,23,48,9,11,14,67,108,1,1,79,104,50,79,15,25,11,14,15,65,104
2004-05-10 00:00:00.000,ATP Masters Series Hamburg Germany ATP World Tour,CLAY,2,Lleyton Hewitt,Flavio Saretta,Lleyton Hewitt,6-4; 2-6; 6-4,R16,141,2,1,47,86,27,47,21,39,7,12,14,48,86,1,4,53,95,36,53,18,42,7,12,14,54,95
2004-05-10 00:00:00.000,ATP Masters Series Hamburg Germany ATP World Tour,CLAY,2,Jurgen Melzer,Marat Safin,Jurgen Melzer,6-4; 6-4,R16,94,1,1,34,65,28,34,13,31,1,3,10,41,65,3,0,42,77,29,42,13,35,2,6,10,42,77
2004-05-10 00:00:00.000,ATP Masters Series Hamburg Germany ATP World Tour,CLAY,2,Ivan Ljubicic,Andrei Pavel,Ivan Ljubicic,4-6; 6-4; 6-3,R16,133,5,1,61,88,45,61,16,27,4,6,15,61,88,3,1,72,98,45,72,15,26,6,9,14,60,98
2004-05-10 00:00:00.000,ATP Masters Series Hamburg Germany ATP World Tour,CLAY,2,Mikhail Youzhny,Florian Mayer,Mikhail Youzhny,6-0; 7-6(4),R16,74,3,3,36,67,27,36,17,31,3,4,9,44,67,0,0,28,49,18,28,9,21,1,5,9,27,49
2004-05-10 00:00:00.000,ATP Masters Series Hamburg Germany ATP World Tour,CLAY,2,David Ferrer,Albert Costa,David Ferrer,5-7; 6-4; 6-3,R16,156,1,4,66,108,43,66,15,42,8,14,15,58,108,2,3,65,102,33,65,16,37,5,13,16,49,102
2004-05-10 00:00:00.000,ATP Masters Series Hamburg Germany ATP World Tour,CLAY,2,Guillermo Coria,Tommy Robredo,Guillermo Coria,7-6(2); 6-4,R16,131,0,2,44,74,29,44,17,30,4,7,11,46,74,2,5,40,94,25,40,25,54,12,16,11,50,94
2004-05-10 00:00:00.000,ATP Masters Series Hamburg Germany ATP World Tour,CLAY,2,Roger Federer,Carlos Moya,Roger Federer,6-4; 6-3,Q,64,2,1,34,57,26,34,17,23,1,1,10,43,57,1,2,29,47,20,29,12,18,2,4,9,32,47
2004-05-10 00:00:00.000,ATP Masters Series Hamburg Germany ATP World Tour,CLAY,2,Lleyton Hewitt,Jurgen Melzer,Lleyton Hewitt,6-4; 6-3,Q,72,2,0,30,49,23,30,13,19,6,7,9,36,49,2,6,36,63,23,36,12,27,4,8,10,35,63
2004-05-10 00:00:00.000,ATP Masters Series Hamburg Germany ATP World Tour,CLAY,2,Ivan Ljubicic,Mikhail Youzhny,Ivan Ljubicic,4-6; 7-5; 6-1,Q,131,12,1,65,106,46,65,22,41,6,8,15,68,106,4,0,52,78,33,52,15,26,2,6,14,48,78
2004-05-10 00:00:00.000,ATP Masters Series Hamburg Germany ATP World Tour,CLAY,2,Guillermo Coria,David Ferrer,Guillermo Coria,6-2; 6-2,Q,72,0,1,21,40,12,21,14,19,0,2,8,26,40,0,1,35,55,16,35,6,20,8,14,8,22,55
2004-05-10 00:00:00.000,ATP Masters Series Hamburg Germany ATP World Tour,CLAY,2,Roger Federer,Lleyton Hewitt,Roger Federer,6-0; 6-4,S,61,5,0,28,41,22,28,9,13,0,1,8,31,41,1,2,36,52,17,36,6,16,4,9,8,23,52
2004-05-10 00:00:00.000,ATP Masters Series Hamburg Germany ATP World Tour,CLAY,2,Guillermo Coria,Ivan Ljubicic,Guillermo Coria,3-6; 6-1; 6-4,S,118,1,5,60,89,43,60,11,29,3,5,13,54,89,6,2,47,71,33,47,11,24,0,4,13,44,71
2004-05-10 00:00:00.000,ATP Masters Series Hamburg Germany ATP World Tour,CLAY,2,Roger Federer,Guillermo Coria,Roger Federer,4-6; 6-4; 6-2; 6-3,F,141,7,0,64,113,49,64,30,49,2,4,19,79,113,2,4,71,102,49,71,14,31,5,10,18,63,102
2004-05-17 00:00:00.000,Casablanca Morocco ATP World Tour,CLAY,2,Dominik Hrbaty,Philipp Kohlschreiber,Dominik Hrbaty,6-2; 6-2,R32,65,4,1,32,56,27,32,11,24,6,6,8,38,56,1,4,28,63,17,28,15,35,5,9,8,32,63
2004-05-17 00:00:00.000,Casablanca Morocco ATP World Tour,CLAY,2,Alex Calatrava,Gilles Elseneer,Alex Calatrava,6-3; 4-6; 6-4,R32,108,4,4,59,83,33,59,12,24,6,11,14,45,83,5,7,59,97,35,59,14,38,6,13,15,49,97
2004-05-17 00:00:00.000,Casablanca Morocco ATP World Tour,CLAY,2,Juan-Pablo Guzman,Eric Taino,Juan-Pablo Guzman,6-2; 6-1,R32,59,0,2,26,50,20,26,13,24,3,3,7,33,50,0,5,23,52,15,23,7,29,3,8,8,22,52
2004-05-17 00:00:00.000,Casablanca Morocco ATP World Tour,CLAY,2,Oscar Hernandez,Mounir El Aarej,Oscar Hernandez,6-4; 6-4,R32,94,0,4,39,60,27,39,13,21,3,4,10,40,60,4,6,36,87,25,36,23,51,17,20,10,48,87
2004-05-17 00:00:00.000,Casablanca Morocco ATP World Tour,CLAY,2,Julien Benneteau,Ruben Ramirez Hidalgo,Julien Benneteau,6-4; 6-2,R32,100,1,5,43,73,29,43,16,30,6,7,9,45,73,2,6,33,68,20,33,16,35,4,8,9,36,68
2004-05-17 00:00:00.000,Casablanca Morocco ATP World Tour,CLAY,2,Julien Boutter,Mehdi Ziadi,Julien Boutter,6-1; 3-6; 6-1,R32,86,2,8,33,67,25,33,22,34,2,3,12,47,67,5,4,38,74,21,38,20,36,6,10,11,41,74
2004-05-17 00:00:00.000,Casablanca Morocco ATP World Tour,CLAY,2,Federico Browne,Zeljko Krajan,Federico Browne,6-3; 7-5,R32,0,6,1,40,67,27,40,20,27,6,7,11,47,67,1,0,34,65,21,34,17,31,3,6,10,38,65
2004-05-17 00:00:00.000,Casablanca Morocco ATP World Tour,CLAY,2,Thierry Ascione,Mehdi Tahiri,Thierry Ascione,6-3; 6-4,R32,71,0,0,36,52,26,36,10,16,4,6,10,36,52,0,2,34,54,18,34,11,20,6,10,9,29,54
2004-05-17 00:00:00.000,Casablanca Morocco ATP World Tour,CLAY,2,Cyril Saulnier,Stefano Pescosolido,Cyril Saulnier,6-3; 6-2,R32,55,5,2,26,48,22,26,15,22,1,1,9,37,48,4,1,23,40,19,23,7,17,1,4,8,26,40
2004-05-17 00:00:00.000,Casablanca Morocco ATP World Tour,CLAY,2,Christophe Rochus,Fernando Vicente,Christophe Rochus,7-5; 6-1,R32,78,1,6,38,71,28,38,10,33,5,9,10,38,71,2,2,31,54,16,31,6,23,5,12,9,22,54
2004-05-17 00:00:00.000,Casablanca Morocco ATP World Tour,CLAY,2,Albert Portas,Olivier Mutis,Albert Portas,6-2; 7-5,R32,71,5,2,32,62,24,32,16,30,4,5,10,40,62,1,1,22,59,14,22,18,37,2,6,10,32,59
2004-05-17 00:00:00.000,Casablanca Morocco ATP World Tour,CLAY,2,Antony Dupuis,Arnaud Di Pasquale,Antony Dupuis,7-6(7); 6-4,R32,123,3,3,44,90,32,44,22,46,7,9,11,54,90,1,1,55,80,37,55,12,25,3,6,11,49,80
2004-05-17 00:00:00.000,Casablanca Morocco ATP World Tour,CLAY,2,Ivo Heuberger,Dennis van Scheppingen,Ivo Heuberger,6-4; 6-2,R32,77,2,7,20,57,16,20,17,37,5,7,9,33,57,0,6,37,64,25,37,6,27,6,11,9,31,64
2004-05-17 00:00:00.000,Casablanca Morocco ATP World Tour,CLAY,2,Simone Vagnozzi,Jean-Rene Lisnard,Simone Vagnozzi,7-6(7); 6-1,R32,0,0,6,55,69,36,55,5,14,4,8,10,41,69,1,7,40,62,22,40,6,22,5,11,9,28,62
2004-05-17 00:00:00.000,Casablanca Morocco ATP World Tour,CLAY,2,Santiago Ventura,Razvan Sabau,Santiago Ventura,6-2; 6-3,R32,0,3,2,23,42,16,23,13,19,2,4,8,29,42,1,6,29,69,13,29,17,40,7,13,9,30,69
2004-05-17 00:00:00.000,Casablanca Morocco ATP World Tour,CLAY,2,Nicolas Mahut,Bjorn Rehnquist,Nicolas Mahut,6-1; 6-2,R32,0,1,1,28,40,24,28,8,12,0,0,8,32,40,1,4,35,48,16,35,8,13,3,7,7,24,48
2004-05-17 00:00:00.000,Casablanca Morocco ATP World Tour,CLAY,2,Dominik Hrbaty,Alex Calatrava,Dominik Hrbaty,5-7; 6-4; 6-4,R16,147,6,3,55,97,40,55,19,42,7,11,16,59,97,9,2,50,102,33,50,28,52,7,12,16,61,102
2004-05-17 00:00:00.000,Casablanca Morocco ATP World Tour,CLAY,2,Oscar Hernandez,Juan-Pablo Guzman,Oscar Hernandez,6-4; 1-6; 7-6(3),R16,138,3,0,56,86,37,56,14,30,8,13,14,51,86,3,7,60,100,39,60,20,40,7,11,15,59,100
2004-05-17 00:00:00.000,Casablanca Morocco ATP World Tour,CLAY,2,Julien Benneteau,Julien Boutter,Julien Benneteau,2-6; 6-3; 6-4,R16,117,4,3,52,83,29,52,17,31,4,9,14,46,83,11,7,46,95,29,46,21,49,7,12,13,50,95
2004-05-17 00:00:00.000,Casablanca Morocco ATP World Tour,CLAY,2,Thierry Ascione,Federico Browne,Thierry Ascione,6-2; 3-1 RET,R16,45,1,2,23,39,18,23,9,16,2,2,6,27,39,1,4,17,33,10,17,7,16,1,4,6,17,33
2004-05-17 00:00:00.000,Casablanca Morocco ATP World Tour,CLAY,2,Christophe Rochus,Cyril Saulnier,Christophe Rochus,6-0; 6-3,R16,57,1,1,27,42,17,27,11,15,1,2,7,28,42,2,5,22,53,11,22,11,31,3,9,8,22,53
2004-05-17 00:00:00.000,Casablanca Morocco ATP World Tour,CLAY,2,Antony Dupuis,Albert Portas,Antony Dupuis,7-6(4); 7-6(2),R16,109,13,1,44,77,37,44,20,33,2,3,12,57,77,5,7,44,77,37,44,15,33,2,3,12,52,77
2004-05-17 00:00:00.000,Casablanca Morocco ATP World Tour,CLAY,2,Ivo Heuberger,Simone Vagnozzi,Ivo Heuberger,6-3; 6-4,R16,103,7,3,34,75,25,34,20,41,7,9,10,45,75,1,5,42,66,22,42,12,24,4,8,9,34,66
2004-05-17 00:00:00.000,Casablanca Morocco ATP World Tour,CLAY,2,Santiago Ventura,Nicolas Mahut,Santiago Ventura,7-6(5); 6-4,R16,94,4,3,40,72,27,40,19,32,2,4,11,46,72,0,6,42,73,29,42,15,31,2,5,11,44,73
2004-05-17 00:00:00.000,Casablanca Morocco ATP World Tour,CLAY,2,Dominik Hrbaty,Oscar Hernandez,Dominik Hrbaty,6-3; 6-0,Q,56,0,2,29,53,25,29,12,24,3,3,8,37,53,0,1,19,41,10,19,8,22,2,6,7,18,41
2004-05-17 00:00:00.000,Casablanca Morocco ATP World Tour,CLAY,2,Julien Benneteau,Thierry Ascione,Julien Benneteau,6-3; 6-4,Q,75,2,0,39,59,28,39,13,20,5,5,9,41,59,2,6,38,65,27,38,12,27,4,7,10,39,65
2004-05-17 00:00:00.000,Casablanca Morocco ATP World Tour,CLAY,2,Christophe Rochus,Antony Dupuis,Christophe Rochus,6-3; 6-1,Q,58,3,1,28,46,23,28,11,18,2,2,8,34,46,2,0,26,51,15,26,13,25,6,10,8,28,51
2004-05-17 00:00:00.000,Casablanca Morocco ATP World Tour,CLAY,2,Santiago Ventura,Ivo Heuberger,Santiago Ventura,6-2; 6-4,Q,86,2,3,25,62,17,25,23,37,4,5,9,40,62,4,3,20,58,17,20,12,38,4,8,9,29,58
2004-05-17 00:00:00.000,Casablanca Morocco ATP World Tour,CLAY,2,Dominik Hrbaty,Julien Benneteau,Dominik Hrbaty,6-2; 6-2,S,61,7,2,34,54,27,34,9,20,4,4,8,36,54,2,7,36,64,21,36,10,28,7,11,8,31,64
2004-05-17 00:00:00.000,Casablanca Morocco ATP World Tour,CLAY,2,Santiago Ventura,Christophe Rochus,Santiago Ventura,6-1; 1-6; 6-2,S,96,2,2,41,77,27,41,18,36,6,9,11,45,77,1,2,35,69,20,35,16,34,2,7,11,36,69
2004-05-17 00:00:00.000,Casablanca Morocco ATP World Tour,CLAY,2,Santiago Ventura,Dominik Hrbaty,Santiago Ventura,6-3; 1-6; 6-4,F,116,6,7,37,83,28,37,24,46,6,8,13,52,83,4,3,67,93,47,67,11,26,9,11,13,58,93
2004-05-17 00:00:00.000,St. Poelten Austria ATP World Tour,CLAY,2,Nenad Zimonjic,Andre Agassi,Nenad Zimonjic,6-2; 7-6(6),R32,87,6,9,45,79,31,45,17,34,2,4,10,48,79,6,1,42,75,27,42,14,33,2,6,10,41,75
2004-05-17 00:00:00.000,St. Poelten Austria ATP World Tour,CLAY,2,Victor Hanescu,Alexander Popp,Victor Hanescu,6-4; 6-2,R32,73,2,2,44,64,34,44,9,20,7,7,9,43,64,2,8,36,61,27,36,8,25,5,8,9,35,61
2004-05-17 00:00:00.000,St. Poelten Austria ATP World Tour,CLAY,2,Raemon Sluiter,Tomas Zib,Raemon Sluiter,6-4; 2-6; 6-3,R32,106,15,4,56,96,41,56,17,40,7,10,14,58,96,4,1,44,77,32,44,16,33,2,5,13,48,77
2004-05-17 00:00:00.000,St. Poelten Austria ATP World Tour,CLAY,2,Filippo Volandri,Tomas Berdych,Filippo Volandri,6-3; 6-1,R32,72,0,4,40,57,27,40,6,17,1,3,8,33,57,2,5,36,63,18,36,9,27,12,18,8,27,63
2004-05-17 00:00:00.000,St. Poelten Austria ATP World Tour,CLAY,2,Nikolay Davydenko,Dmitry Tursunov,Nikolay Davydenko,6-2; 6-0,R32,48,4,2,33,41,25,33,5,8,2,2,7,30,41,0,0,19,39,7,19,7,20,2,7,7,14,39
2004-05-17 00:00:00.000,St. Poelten Austria ATP World Tour,CLAY,2,Mario Ancic,Galo Blanco,Mario Ancic,6-2; 6-4,R32,64,7,3,23,43,20,23,12,20,0,1,9,32,43,0,2,35,53,22,35,6,18,7,11,9,28,53
2004-05-17 00:00:00.000,St. Poelten Austria ATP World Tour,CLAY,2,Stefan Koubek,Robin Soderling,Stefan Koubek,7-5; 7-6(3),R32,100,1,5,49,85,29,49,18,36,5,9,12,47,85,1,6,52,86,31,52,13,34,3,8,12,44,86
2004-05-17 00:00:00.000,St. Poelten Austria ATP World Tour,CLAY,2,David Sanchez,Jan-Michael Gambill,David Sanchez,6-3; 6-4,R32,87,2,0,42,67,30,42,9,25,4,6,9,39,67,5,1,27,57,21,27,9,30,3,8,10,30,57
2004-05-17 00:00:00.000,St. Poelten Austria ATP World Tour,CLAY,2,Igor Andreev,Joachim Johansson,Igor Andreev,6-2; 7-6(2),R32,83,5,2,42,56,33,42,8,14,0,1,10,41,56,3,7,52,93,31,52,19,41,11,14,10,50,93
2004-05-17 00:00:00.000,St. Poelten Austria ATP World Tour,CLAY,2,Jurgen Melzer,Greg Rusedski,Jurgen Melzer,6-2; 7-6(1),R32,89,4,2,38,61,31,38,15,23,1,1,10,46,61,7,4,37,77,26,37,19,40,5,7,10,45,77
2004-05-17 00:00:00.000,St. Poelten Austria ATP World Tour,CLAY,2,Olivier Rochus,Harel Levy,Olivier Rochus,6-1; 6-1,R32,50,1,0,25,41,17,25,13,16,2,2,7,30,41,1,2,24,40,11,24,5,16,2,7,7,16,40
2004-05-17 00:00:00.000,St. Poelten Austria ATP World Tour,CLAY,2,Julian Knowle,Irakli Labadze,Julian Knowle,7-5; 4-6; 6-2,R32,118,8,6,57,84,43,57,14,27,4,6,15,57,84,2,6,59,96,41,59,15,37,9,13,15,56,96
2004-05-17 00:00:00.000,St. Poelten Austria ATP World Tour,CLAY,2,Ivo Karlovic,Andrea Stoppini,Ivo Karlovic,6-7(3); 6-4; 6-3,R32,132,15,3,60,93,48,60,22,33,2,2,16,70,93,2,3,55,106,41,55,27,51,10,12,15,68,106
2004-05-17 00:00:00.000,St. Poelten Austria ATP World Tour,CLAY,2,Daniel Koellerer,Davide Sanguinetti,Daniel Koellerer,2-6; 6-2; 6-4,R32,120,1,2,59,91,37,59,18,32,5,8,13,55,91,2,2,45,88,27,45,22,43,5,9,13,49,88
2004-05-17 00:00:00.000,St. Poelten Austria ATP World Tour,CLAY,2,Xavier Malisse,Karol Beck,Xavier Malisse,7-5; 6-0,R32,64,4,2,21,52,17,21,17,31,3,5,9,34,52,5,9,23,53,13,23,10,30,4,10,9,23,53
2004-05-17 00:00:00.000,St. Poelten Austria ATP World Tour,CLAY,2,Hugo Armando,Tomas Behrend,Hugo Armando,6-4; 6-3,R32,58,3,4,31,52,25,31,11,21,0,2,10,36,52,0,2,32,49,21,32,5,17,3,7,9,26,49
2004-05-17 00:00:00.000,St. Poelten Austria ATP World Tour,CLAY,2,Victor Hanescu,Nenad Zimonjic,Victor Hanescu,6-2; 6-2,R16,61,5,0,41,54,30,41,6,13,5,5,8,36,54,2,2,31,48,16,31,10,17,0,4,8,26,48
2004-05-17 00:00:00.000,St. Poelten Austria ATP World Tour,CLAY,2,Filippo Volandri,Raemon Sluiter,Filippo Volandri,6-4; 6-2,R16,65,1,2,43,49,30,43,2,6,0,2,9,32,49,1,3,38,63,23,38,9,25,4,9,9,32,63
2004-05-17 00:00:00.000,St. Poelten Austria ATP World Tour,CLAY,2,Nikolay Davydenko,Mario Ancic,Nikolay Davydenko,6-4; 7-5,R16,95,1,3,37,63,28,37,17,26,3,4,11,45,63,1,1,33,64,23,33,16,31,0,3,11,39,64
2004-05-17 00:00:00.000,St. Poelten Austria ATP World Tour,CLAY,2,David Sanchez,Stefan Koubek,David Sanchez,W/O,R16,0,0,0,0,0,0,0,0,0,0,0,0,0,0,0,0,0,0,0,0,0,0,0,0,0,0,0
2004-05-17 00:00:00.000,St. Poelten Austria ATP World Tour,CLAY,2,Jurgen Melzer,Igor Andreev,Jurgen Melzer,6-3; 7-5,R16,84,4,2,39,65,30,39,15,26,2,3,11,45,65,2,2,42,64,32,42,8,22,5,8,10,40,64
2004-05-17 00:00:00.000,St. Poelten Austria ATP World Tour,CLAY,2,Olivier Rochus,Julian Knowle,Olivier Rochus,3-6; 6-3; 6-1,R16,134,1,5,41,85,29,41,21,44,9,13,12,50,85,2,4,59,87,31,59,13,28,9,16,13,44,87
2004-05-17 00:00:00.000,St. Poelten Austria ATP World Tour,CLAY,2,Daniel Koellerer,Ivo Karlovic,Daniel Koellerer,6-2; 4-6; 6-3,R16,130,0,1,55,77,40,55,14,22,2,4,14,54,77,14,12,43,96,30,43,23,53,9,13,13,53,96
2004-05-17 00:00:00.000,St. Poelten Austria ATP World Tour,CLAY,2,Xavier Malisse,Hugo Armando,Xavier Malisse,6-2; 6-2,R16,58,6,0,26,37,24,26,8,11,0,0,8,32,37,2,1,35,56,15,35,11,21,5,9,8,26,56
2004-05-17 00:00:00.000,St. Poelten Austria ATP World Tour,CLAY,2,Filippo Volandri,Victor Hanescu,Filippo Volandri,6-4; 6-3,Q,68,0,3,41,53,31,41,5,12,3,4,9,36,53,2,2,39,61,24,39,9,22,2,6,10,33,61
2004-05-17 00:00:00.000,St. Poelten Austria ATP World Tour,CLAY,2,David Sanchez,Nikolay Davydenko,David Sanchez,3-6; 6-1 RET,Q,78,4,3,29,60,21,29,16,31,3,4,8,37,60,1,3,32,46,24,32,5,14,0,2,8,29,46
2004-05-17 00:00:00.000,St. Poelten Austria ATP World Tour,CLAY,2,Jurgen Melzer,Olivier Rochus,Jurgen Melzer,4-6; 7-6(5); 6-2,Q,134,18,3,50,84,43,50,16,34,1,4,15,59,84,2,8,74,124,49,74,22,50,14,18,15,71,124
2004-05-17 00:00:00.000,St. Poelten Austria ATP World Tour,CLAY,2,Xavier Malisse,Daniel Koellerer,Xavier Malisse,6-4; 3-6; 6-1,Q,127,6,2,45,90,28,45,22,45,5,9,13,50,90,0,1,76,97,38,76,10,21,7,13,13,48,97
2004-05-17 00:00:00.000,St. Poelten Austria ATP World Tour,CLAY,2,Filippo Volandri,David Sanchez,Filippo Volandri,6-1; 4-6; 6-4,S,119,0,0,79,99,45,79,6,20,9,15,14,51,99,1,2,38,75,21,38,14,37,3,11,13,35,75
2004-05-17 00:00:00.000,St. Poelten Austria ATP World Tour,CLAY,2,Xavier Malisse,Jurgen Melzer,Xavier Malisse,3-6; 6-3; 6-3,S,114,2,6,52,82,38,52,13,30,5,8,13,51,82,3,3,56,95,36,56,15,39,2,7,14,51,95
2004-05-17 00:00:00.000,St. Poelten Austria ATP World Tour,CLAY,2,Filippo Volandri,Xavier Malisse,Filippo Volandri,6-1; 6-4,F,75,0,1,54,68,28,54,8,14,6,9,8,36,68,0,0,25,48,9,25,10,23,0,7,9,19,48
2004-05-24 00:00:00.000,Roland Garros France Grand Slams,CLAY,3,Roger Federer,Kristof Vliegen,Roger Federer,6-1; 6-2; 6-1,R128,76,4,1,33,54,29,33,15,21,0,0,11,44,54,0,5,46,74,24,46,11,28,7,14,11,35,74
2004-05-24 00:00:00.000,Roland Garros France Grand Slams,CLAY,3,Nicolas Kiefer,Thierry Ascione,Nicolas Kiefer,6-3; 6-2; 6-2,R128,104,7,6,48,92,34,48,24,44,4,6,13,58,92,0,5,41,66,20,41,12,25,0,7,12,32,66
2004-05-24 00:00:00.000,Roland Garros France Grand Slams,CLAY,3,Gilles Elseneer,Ruben Ramirez Hidalgo,Gilles Elseneer,3-6; 7-5; 4-6; 6-4; 6-3,R128,198,7,4,107,154,78,107,25,47,7,10,25,103,154,2,5,134,170,91,134,18,36,10,14,25,109,170
2004-05-24 00:00:00.000,Roland Garros France Grand Slams,CLAY,3,Gustavo Kuerten,Nicolas Almagro,Gustavo Kuerten,7-5; 7-6(2); 1-6; 3-6; 7-5,R128,187,18,5,92,169,61,92,41,77,12,20,26,102,169,14,9,92,161,69,92,33,69,9,15,26,102,161
2004-05-24 00:00:00.000,Roland Garros France Grand Slams,CLAY,3,Feliciano Lopez,Nicolas Lapentti,Feliciano Lopez,5-7; 6-4; 6-4; 6-4,R128,177,13,8,60,121,47,60,30,61,6,11,21,77,121,7,5,83,126,60,83,15,43,4,11,21,75,126
2004-05-24 00:00:00.000,Roland Garros France Grand Slams,CLAY,3,Karol Kucera,Ivo Karlovic,Karol Kucera,7-6(4); 6-4; 6-4,R128,111,1,5,63,86,56,63,14,23,3,3,16,70,86,14,5,48,91,38,48,22,43,2,4,16,60,91
2004-05-24 00:00:00.000,Roland Garros France Grand Slams,CLAY,3,Olivier Patience,Filippo Volandri,Olivier Patience,6-3; 7-6(5); 6-0,R128,105,5,2,50,91,37,50,22,41,7,10,14,59,91,0,2,67,90,36,67,10,23,6,13,13,46,90
2004-05-24 00:00:00.000,Roland Garros France Grand Slams,CLAY,3,Hyung-Taik Lee,Robin Soderling,Hyung-Taik Lee,0-6; 3-6; 6-3; 6-4; 7-5,R128,192,9,6,100,145,72,100,20,45,14,19,23,92,145,14,7,104,175,76,104,32,71,13,17,23,108,175
2004-05-24 00:00:00.000,Roland Garros France Grand Slams,CLAY,3,Sebastien Grosjean,Kevin Kim,Sebastien Grosjean,6-1; 6-1; 6-4,R128,106,3,0,48,78,34,48,16,30,4,6,12,50,78,0,1,46,73,23,46,8,27,2,10,12,31,73
2004-05-24 00:00:00.000,Roland Garros France Grand Slams,CLAY,3,Potito Starace,Dmitry Tursunov,Potito Starace,6-2; 6-3; 6-4,R128,102,2,1,54,75,38,54,14,21,4,6,13,52,75,4,8,48,83,31,48,11,35,2,9,14,42,83
2004-05-24 00:00:00.000,Roland Garros France Grand Slams,CLAY,3,Felix Mantilla,Jeff Salzenstein,Felix Mantilla,6-4; 6-1; 6-7(6); 6-2,R128,154,3,3,61,110,45,61,28,49,5,8,18,73,110,15,7,89,156,55,89,27,67,22,31,19,82,156
2004-05-24 00:00:00.000,Roland Garros France Grand Slams,CLAY,3,Marat Safin,Agustin Calleri,Marat Safin,5-7; 6-1; 4-1 RET,R128,102,9,1,41,79,34,41,17,38,5,7,12,51,79,3,7,36,77,23,36,17,41,8,13,12,40,77
2004-05-24 00:00:00.000,Roland Garros France Grand Slams,CLAY,3,Ivan Ljubicic,Hicham Arazi,Ivan Ljubicic,6-7(3); 6-4; 6-7(2); 6-3; 6-3,R128,222,22,7,106,172,84,106,28,66,7,10,26,112,172,8,1,113,170,76,113,30,57,6,13,26,106,170
2004-05-24 00:00:00.000,Roland Garros France Grand Slams,CLAY,3,Stefan Koubek,David Sanchez,Stefan Koubek,6-3; 7-5; 3-6; 6-7(0); 6-0,R128,188,5,7,95,146,58,95,25,51,6,13,24,83,146,2,3,102,160,65,102,20,58,5,16,24,85,160
2004-05-24 00:00:00.000,Roland Garros France Grand Slams,CLAY,3,Alejandro Falla,Kristian Pless,Alejandro Falla,6-2; 4-6; 6-1; 6-2,R128,109,5,3,72,110,47,72,20,38,9,13,17,67,110,3,15,50,98,26,50,18,48,5,14,16,44,98
2004-05-24 00:00:00.000,Roland Garros France Grand Slams,CLAY,3,David Nalbandian,Richard Gasquet,David Nalbandian,6-4; 7-5; 7-6(1),R128,151,7,1,51,102,34,51,31,51,2,6,17,65,102,7,11,51,121,38,51,24,70,6,12,17,62,121
2004-05-24 00:00:00.000,Roland Garros France Grand Slams,CLAY,3,Juan Carlos Ferrero,Tommy Haas,Juan Carlos Ferrero,3-6; 6-4; 6-4; 6-2,R128,166,3,6,75,115,54,75,21,40,8,11,18,75,115,4,10,59,126,39,59,33,67,7,13,19,72,126
2004-05-24 00:00:00.000,Roland Garros France Grand Slams,CLAY,3,Igor Andreev,Jan Vacek,Igor Andreev,6-3; 6-1; 6-4,R128,105,2,4,50,77,36,50,16,27,6,8,13,52,77,3,8,56,91,32,56,11,35,7,14,13,43,91
2004-05-24 00:00:00.000,Roland Garros France Grand Slams,CLAY,3,David Ferrer,Olivier Rochus,David Ferrer,6-1; 6-1; 6-3,R128,91,5,0,53,75,36,53,15,22,6,7,11,51,75,0,3,41,66,21,41,9,25,5,13,12,30,66
2004-05-24 00:00:00.000,Roland Garros France Grand Slams,CLAY,3,Julien Benneteau,Max Mirnyi,Julien Benneteau,7-5; 7-5; 1-6; 6-3,R128,166,9,3,86,123,59,86,20,37,6,10,20,79,123,7,11,79,123,59,79,17,44,6,11,20,76,123
2004-05-24 00:00:00.000,Roland Garros France Grand Slams,CLAY,3,Jonas Bjorkman,Taylor Dent,Jonas Bjorkman,6-3; 2-6; 6-3; 3-6; 6-2,R128,181,6,6,85,153,52,85,33,68,16,25,22,85,153,5,9,87,128,51,87,12,41,5,15,21,63,128
2004-05-24 00:00:00.000,Roland Garros France Grand Slams,CLAY,3,Thomas Enqvist,Kenneth Carlsen,Thomas Enqvist,6-2; 6-3; 6-4,R128,121,8,1,40,81,34,40,21,41,5,7,14,55,81,11,5,42,90,27,42,19,48,5,11,13,46,90
2004-05-24 00:00:00.000,Roland Garros France Grand Slams,CLAY,3,Gaston Gaudio,Guillermo Canas,Gaston Gaudio,6-2; 2-6; 4-6; 6-3; 6-2,R128,219,1,5,103,151,62,103,21,48,6,14,22,83,151,0,4,87,146,52,87,25,59,9,19,21,77,146
2004-05-24 00:00:00.000,Roland Garros France Grand Slams,CLAY,3,Jiri Novak,Antony Dupuis,Jiri Novak,6-4; 6-4; 6-7(4); 6-3,R128,192,18,2,86,139,62,86,25,53,8,12,21,87,139,6,5,65,129,42,65,33,64,2,9,20,75,129
2004-05-24 00:00:00.000,Roland Garros France Grand Slams,CLAY,3,Lleyton Hewitt,Arnaud Di Pasquale,Lleyton Hewitt,6-0; 7-6(5); 4-6; 6-1,R128,186,6,6,68,128,46,68,27,60,10,16,18,73,128,0,4,76,111,35,76,16,35,8,18,17,51,111
2004-05-24 00:00:00.000,Roland Garros France Grand Slams,CLAY,3,Jurgen Melzer,Wayne Ferreira,Jurgen Melzer,6-7(4); 6-2; 6-4; 6-3,R128,156,8,4,70,123,57,70,27,53,7,9,19,84,123,5,8,76,144,47,76,34,68,6,13,20,81,144
2004-05-24 00:00:00.000,Roland Garros France Grand Slams,CLAY,3,Victor Hanescu,Jean-Rene Lisnard,Victor Hanescu,7-5; 6-2; 6-4,R128,129,3,2,73,100,48,73,14,27,4,7,15,62,100,4,5,62,103,37,62,17,41,6,13,15,54,103
2004-05-24 00:00:00.000,Roland Garros France Grand Slams,CLAY,3,Martin Verkerk,Julien Boutter,Martin Verkerk,7-5; 6-3; 6-1,R128,112,11,3,51,79,38,51,22,28,3,3,14,60,79,4,6,47,92,34,47,17,45,5,10,14,51,92
2004-05-24 00:00:00.000,Roland Garros France Grand Slams,CLAY,3,Albert Costa,Flavio Saretta,Albert Costa,6-2; 6-2; 6-7(2); 6-4,R128,187,2,1,64,107,45,64,22,43,1,5,19,67,107,8,4,56,112,37,56,25,56,3,12,19,62,112
2004-05-24 00:00:00.000,Roland Garros France Grand Slams,CLAY,3,Christophe Rochus,Marc Lopez,Christophe Rochus,6-4; 6-1; 6-1,R128,102,2,1,50,66,37,50,7,16,1,3,12,44,66,0,1,48,79,20,48,15,31,5,13,12,35,79
2004-05-24 00:00:00.000,Roland Garros France Grand Slams,CLAY,3,Daniel Elsner,Alexander Peya,Daniel Elsner,6-1; 7-6(4); 6-2,R128,94,5,3,61,89,45,61,19,28,7,7,14,64,89,3,4,40,74,26,40,18,34,2,6,13,44,74
2004-05-24 00:00:00.000,Roland Garros France Grand Slams,CLAY,3,Xavier Malisse,Rainer Schuettler,Xavier Malisse,6-4; 7-5; 6-4,R128,146,2,0,58,106,39,58,28,48,5,8,16,67,106,0,2,80,112,49,80,14,32,11,17,16,63,112
2004-05-24 00:00:00.000,Roland Garros France Grand Slams,CLAY,3,Carlos Moya,John van Lottum,Carlos Moya,6-3; 6-4; 3-6; 6-2,R128,142,9,3,44,95,38,44,30,51,3,6,18,68,95,2,5,70,119,42,70,24,49,3,9,18,66,119
2004-05-24 00:00:00.000,Roland Garros France Grand Slams,CLAY,3,Fernando Vicente,Marc Gicquel,Fernando Vicente,3-6; 7-6(4); 6-4; 6-2,R128,144,3,3,73,115,53,73,19,42,4,9,19,72,115,1,2,70,120,42,70,26,50,2,9,20,68,120
2004-05-24 00:00:00.000,Roland Garros France Grand Slams,CLAY,3,Raemon Sluiter,Ricardo Mello,Raemon Sluiter,7-5; 6-1; 3-6; 6-1,R128,132,14,3,52,95,45,52,21,43,0,3,18,66,95,6,8,66,108,44,66,15,42,6,13,17,59,108
2004-05-24 00:00:00.000,Roland Garros France Grand Slams,CLAY,3,Dominik Hrbaty,Bohdan Ulihrach,Dominik Hrbaty,6-1; 3-1 RET,R128,44,3,4,24,39,19,24,9,15,1,1,6,28,39,0,6,13,36,6,13,11,23,1,4,5,17,36
2004-05-24 00:00:00.000,Roland Garros France Grand Slams,CLAY,3,Tommy Robredo,Alberto Martin,Tommy Robredo,6-3; 6-3; 6-2,R128,118,7,1,38,67,29,38,18,29,2,4,13,47,67,0,8,72,109,40,72,13,37,15,22,13,53,109
2004-05-24 00:00:00.000,Roland Garros France Grand Slams,CLAY,3,Guillermo Garcia-Lopez,Todd Reid,Guillermo Garcia-Lopez,4-6; 6-1; 6-2; 6-2,R128,127,3,3,72,105,55,72,17,33,4,5,17,72,105,1,2,72,101,43,72,12,29,7,13,16,55,101
2004-05-24 00:00:00.000,Roland Garros France Grand Slams,CLAY,3,Vladimir Voltchkov,Radek Stepanek,Vladimir Voltchkov,6-3; 2-6; 3-6; 6-3; 11-9,R128,243,9,7,126,201,84,126,32,75,15,23,28,116,201,13,9,90,159,64,90,35,69,5,13,27,99,159
2004-05-24 00:00:00.000,Roland Garros France Grand Slams,CLAY,3,Nicolas Massu,Janko Tipsarevic,Nicolas Massu,3-6; 6-1; 6-4; 7-6(3),R128,199,11,6,78,121,58,78,22,43,11,14,19,80,121,6,3,66,119,46,66,22,53,6,11,19,68,119
2004-05-24 00:00:00.000,Roland Garros France Grand Slams,CLAY,3,Florian Mayer,Fernando Gonzalez,Florian Mayer,6-7(6); 6-1; 6-0; 7-6(5),R128,145,3,5,82,143,60,82,38,61,9,10,19,98,143,5,8,76,120,51,76,20,44,3,9,18,71,120
2004-05-24 00:00:00.000,Roland Garros France Grand Slams,CLAY,3,Nicolas Escude,Wayne Arthurs,Nicolas Escude,7-6(7); 6-2; 6-2,R128,115,12,6,43,86,35,43,30,43,2,2,14,65,86,7,11,36,86,30,36,23,50,4,8,14,53,86
2004-05-24 00:00:00.000,Roland Garros France Grand Slams,CLAY,3,Mikhail Youzhny,Dennis van Scheppingen,Mikhail Youzhny,6-0; 6-4; 6-2,R128,104,11,4,49,83,39,49,18,34,7,7,12,57,83,0,5,44,84,27,44,15,40,10,16,12,42,84
2004-05-24 00:00:00.000,Roland Garros France Grand Slams,CLAY,3,Andrei Pavel,Oscar Hernandez,Andrei Pavel,6-2 RET,R128,33,1,1,15,24,10,15,4,9,2,4,4,14,24,0,1,19,26,4,19,4,7,5,9,4,8,26
2004-05-24 00:00:00.000,Roland Garros France Grand Slams,CLAY,3,Mariano Zabaleta,Stephane Robert,Mariano Zabaleta,7-6(4); 6-3; 6-2,R128,117,8,5,54,99,40,54,26,45,6,8,15,66,99,3,2,55,88,37,55,15,33,3,8,14,52,88
2004-05-24 00:00:00.000,Roland Garros France Grand Slams,CLAY,3,Mario Ancic,Sargis Sargsian,Mario Ancic,7-6(4); 4-6; 6-4; 6-4,R128,220,20,7,101,178,72,101,30,77,15,22,21,102,178,0,4,79,128,51,79,21,49,4,12,21,72,128
2004-05-24 00:00:00.000,Roland Garros France Grand Slams,CLAY,3,Juan Monaco,Alex Bogomolov Jr.,Juan Monaco,6-1; 6-1; 5-7; 6-4,R128,140,4,6,54,97,36,54,17,43,5,12,18,53,97,0,4,92,131,46,92,12,39,13,25,18,58,131
2004-05-24 00:00:00.000,Roland Garros France Grand Slams,CLAY,3,Guillermo Coria,Nikolay Davydenko,Guillermo Coria,6-4; 6-2; 6-0,R128,122,2,1,45,65,32,45,16,20,3,4,12,48,65,0,4,54,96,29,54,18,42,12,19,12,47,96
2004-05-24 00:00:00.000,Roland Garros France Grand Slams,CLAY,3,Jerome Haehnel,Andre Agassi,Jerome Haehnel,6-4; 7-6(4); 6-3,R128,122,3,5,62,112,49,62,24,50,2,3,16,73,112,4,2,56,97,41,56,21,41,7,10,15,62,97
2004-05-24 00:00:00.000,Roland Garros France Grand Slams,CLAY,3,Michael Llodra,Alexander Popp,Michael Llodra,4-6; 6-3; 6-4; 6-2,R128,131,6,2,77,111,63,77,16,34,4,5,19,79,111,5,15,78,118,56,78,13,40,6,10,18,69,118
2004-05-24 00:00:00.000,Roland Garros France Grand Slams,CLAY,3,Julien Jeanpierre,Karol Beck,Julien Jeanpierre,6-2; 6-4; 7-5,R128,127,2,2,74,107,49,74,15,33,7,11,15,64,107,3,7,44,97,26,44,21,53,11,19,15,47,97
2004-05-24 00:00:00.000,Roland Garros France Grand Slams,CLAY,3,Vincent Spadea,Florent Serra,Vincent Spadea,7-5; 1-6; 4-6; 7-6(7); 9-7,R128,272,5,5,129,217,81,129,45,88,19,28,29,126,217,2,4,123,181,84,123,27,58,6,13,28,111,181
2004-05-24 00:00:00.000,Roland Garros France Grand Slams,CLAY,3,Luis Horna,Mark Philippoussis,Luis Horna,6-1; 7-6(9); 6-3,R128,138,1,1,73,108,47,73,20,35,4,7,15,67,108,7,12,55,111,35,55,20,56,6,12,13,55,111
2004-05-24 00:00:00.000,Roland Garros France Grand Slams,CLAY,3,Galo Blanco,Albert Portas,Galo Blanco,7-5; 7-5; 3-6; 6-4,R128,188,7,6,83,150,54,83,32,67,10,17,22,86,150,3,6,84,136,51,84,24,52,4,12,21,75,136
2004-05-24 00:00:00.000,Roland Garros France Grand Slams,CLAY,3,Lars Burgsmuller,Nicolas Mahut,Lars Burgsmuller,7-5; 6-3; 3-6; 6-1,R128,163,2,4,69,126,42,69,34,57,6,10,19,76,126,3,9,69,114,38,69,23,45,5,12,18,61,114
2004-05-24 00:00:00.000,Roland Garros France Grand Slams,CLAY,3,Tim Henman,Cyril Saulnier,Tim Henman,4-6; 4-6; 7-6(2); 6-4; 6-3,R128,228,7,4,89,152,65,89,31,63,4,9,25,96,152,6,11,90,172,60,90,43,82,13,19,26,103,172
2004-05-24 00:00:00.000,Roland Garros France Grand Slams,CLAY,3,Paradorn Srichaphan,Tomas Berdych,Paradorn Srichaphan,6-3; 6-4; 3-6; 6-1,R128,135,4,4,76,123,51,76,28,47,9,12,18,79,123,4,6,54,102,39,54,21,48,1,7,17,60,102
2004-05-24 00:00:00.000,Roland Garros France Grand Slams,CLAY,3,Alex Corretja,Jan-Michael Gambill,Alex Corretja,6-1; 4-6; 6-3; 6-2,R128,158,7,6,56,104,37,56,31,48,8,11,17,68,104,9,3,65,126,43,65,22,61,9,17,17,65,126
2004-05-24 00:00:00.000,Roland Garros France Grand Slams,CLAY,3,Fernando Verdasco,Greg Rusedski,Fernando Verdasco,7-6(7); 6-0; 6-0,R128,86,3,2,52,72,38,52,15,20,1,2,12,53,72,0,3,43,70,21,43,12,27,3,10,12,33,70
2004-05-24 00:00:00.000,Roland Garros France Grand Slams,CLAY,3,Juan Ignacio Chela,Harel Levy,Juan Ignacio Chela,6-3; 6-1; 6-4,R128,97,0,2,49,72,37,49,13,23,0,2,13,50,72,4,1,45,85,28,45,11,40,6,13,13,39,85
2004-05-24 00:00:00.000,Roland Garros France Grand Slams,CLAY,3,Fabrice Santoro,Arnaud Clement,Fabrice Santoro,6-4; 6-3; 6-7(5); 3-6; 16-14,R128,393,22,2,108,229,77,108,60,121,13,22,36,137,229,10,9,121,234,84,121,52,113,17,27,34,136,234
2004-05-24 00:00:00.000,Roland Garros France Grand Slams,CLAY,3,Irakli Labadze,Joachim Johansson,Irakli Labadze,7-5; 7-6(5); 7-5,R128,178,5,5,86,117,63,86,16,31,3,5,18,79,117,7,10,85,137,57,85,22,52,9,13,18,79,137
2004-05-24 00:00:00.000,Roland Garros France Grand Slams,CLAY,3,Olivier Mutis,Robby Ginepri,Olivier Mutis,6-4; 6-4; 6-0,R128,108,4,3,56,105,36,56,26,49,10,13,13,62,105,4,4,47,84,25,47,14,37,3,11,13,39,84
2004-05-24 00:00:00.000,Roland Garros France Grand Slams,CLAY,3,Andy Roddick,Todd Martin,Andy Roddick,7-6(5); 6-4; 7-5,R128,120,14,1,70,111,51,70,27,41,5,6,17,78,111,13,3,63,104,47,63,24,41,3,6,17,71,104
2004-05-24 00:00:00.000,Roland Garros France Grand Slams,CLAY,3,Roger Federer,Nicolas Kiefer,Roger Federer,6-3; 6-4; 7-6(6),R64,151,5,12,67,126,53,67,23,59,12,15,15,76,126,2,6,56,109,39,56,21,53,7,13,16,60,109
2004-05-24 00:00:00.000,Roland Garros France Grand Slams,CLAY,3,Gustavo Kuerten,Gilles Elseneer,Gustavo Kuerten,6-2; 6-0; 6-3,R64,89,6,1,33,59,26,33,15,26,0,1,11,41,59,7,6,66,107,40,66,10,41,12,20,12,50,107
2004-05-24 00:00:00.000,Roland Garros France Grand Slams,CLAY,3,Feliciano Lopez,Karol Kucera,Feliciano Lopez,6-7(3); 6-3; 6-4; 6-4,R64,187,8,4,77,134,54,77,32,57,10,12,21,86,134,3,7,83,125,58,83,18,42,7,12,20,76,125
2004-05-24 00:00:00.000,Roland Garros France Grand Slams,CLAY,3,Hyung-Taik Lee,Olivier Patience,Hyung-Taik Lee,6-4; 6-4; 6-3,R64,108,6,4,54,82,46,54,13,28,5,6,14,59,82,9,7,55,97,32,55,23,42,5,10,15,55,97
2004-05-24 00:00:00.000,Roland Garros France Grand Slams,CLAY,3,Potito Starace,Sebastien Grosjean,Potito Starace,7-6(6); 6-3; 6-4,R64,159,1,5,89,111,59,89,9,22,7,11,16,68,111,5,3,67,127,41,67,28,60,9,15,15,69,127
2004-05-24 00:00:00.000,Roland Garros France Grand Slams,CLAY,3,Marat Safin,Felix Mantilla,Marat Safin,6-4; 2-6; 6-2; 6-7(4); 11-9,R64,277,18,8,93,184,64,93,38,91,13,24,29,102,184,1,7,151,224,83,151,37,73,21,34,29,120,224
2004-05-24 00:00:00.000,Roland Garros France Grand Slams,CLAY,3,Stefan Koubek,Ivan Ljubicic,Stefan Koubek,6-0; 1-6; 6-4; 6-2,R64,141,3,6,66,106,43,66,21,40,4,7,16,64,106,10,3,71,112,42,71,18,41,3,9,15,60,112
2004-05-24 00:00:00.000,Roland Garros France Grand Slams,CLAY,3,David Nalbandian,Alejandro Falla,David Nalbandian,5-7; 6-0; 6-2; 6-0,R64,143,3,5,53,97,39,53,23,44,6,9,16,62,97,1,5,79,136,40,79,23,57,15,25,16,63,136
2004-05-24 00:00:00.000,Roland Garros France Grand Slams,CLAY,3,Igor Andreev,Juan Carlos Ferrero,Igor Andreev,6-4; 6-2; 6-3,R64,122,2,4,60,94,40,60,16,34,8,11,14,56,94,0,3,61,91,30,61,14,30,6,13,13,44,91
2004-05-24 00:00:00.000,Roland Garros France Grand Slams,CLAY,3,Julien Benneteau,David Ferrer,Julien Benneteau,6-3; 1-6; 6-2; 7-5,R64,148,4,2,68,101,42,68,10,33,2,9,18,52,101,1,8,62,107,34,62,19,45,8,17,18,53,107
2004-05-24 00:00:00.000,Roland Garros France Grand Slams,CLAY,3,Thomas Enqvist,Jonas Bjorkman,Thomas Enqvist,6-3; 3-6; 7-6(8); 6-3,R64,181,4,4,78,139,61,78,29,61,11,14,19,90,139,8,9,61,139,42,61,38,78,8,13,20,80,139
2004-05-24 00:00:00.000,Roland Garros France Grand Slams,CLAY,3,Gaston Gaudio,Jiri Novak,Gaston Gaudio,2-6; 6-4; 6-4; 5-7; 6-3,R64,212,4,1,97,149,55,97,32,52,9,16,25,87,149,8,6,96,169,62,96,37,73,13,20,24,99,169
2004-05-24 00:00:00.000,Roland Garros France Grand Slams,CLAY,3,Lleyton Hewitt,Jurgen Melzer,Lleyton Hewitt,6-4; 6-4; 4-6; 6-2,R64,164,10,8,59,114,45,59,27,55,6,10,19,72,114,7,7,73,136,48,73,27,63,5,12,19,75,136
2004-05-24 00:00:00.000,Roland Garros France Grand Slams,CLAY,3,Martin Verkerk,Victor Hanescu,Martin Verkerk,4-6; 6-3; 3-6; 6-0; 3-0 RET,R64,160,17,14,71,120,56,71,24,49,2,5,19,80,120,10,5,76,121,50,76,19,45,6,12,18,69,121
2004-05-24 00:00:00.000,Roland Garros France Grand Slams,CLAY,3,Albert Costa,Christophe Rochus,Albert Costa,6-1; 6-2; 7-5,R64,136,6,0,55,95,37,55,22,40,7,9,14,59,95,0,3,49,92,29,49,15,43,12,19,13,44,92
2004-05-24 00:00:00.000,Roland Garros France Grand Slams,CLAY,3,Xavier Malisse,Daniel Elsner,Xavier Malisse,6-3; 4-0 RET,R64,54,7,1,27,48,20,27,10,21,2,3,7,30,48,2,4,19,36,10,19,4,17,1,5,6,14,36
2004-05-24 00:00:00.000,Roland Garros France Grand Slams,CLAY,3,Carlos Moya,Fernando Vicente,Carlos Moya,6-1; 6-2; 6-1,R64,78,9,1,42,69,34,42,15,27,4,4,11,49,69,1,6,41,71,23,41,10,30,6,13,11,33,71
2004-05-24 00:00:00.000,Roland Garros France Grand Slams,CLAY,3,Raemon Sluiter,Dominik Hrbaty,Raemon Sluiter,6-4; 6-4; 3-6; 7-6(5),R64,156,10,4,82,139,59,82,33,57,7,9,20,92,139,8,2,75,116,55,75,26,41,4,7,21,81,116
2004-05-24 00:00:00.000,Roland Garros France Grand Slams,CLAY,3,Tommy Robredo,Guillermo Garcia-Lopez,Tommy Robredo,6-4; 3-6; 7-5; 6-4,R64,188,9,9,65,117,49,65,28,52,7,11,20,77,117,2,6,104,154,67,104,22,50,13,19,21,89,154
2004-05-24 00:00:00.000,Roland Garros France Grand Slams,CLAY,3,Nicolas Massu,Vladimir Voltchkov,Nicolas Massu,6-3; 6-1; 6-0,R64,95,6,0,31,53,28,31,16,22,0,0,11,44,53,3,1,47,78,26,47,11,31,7,14,11,37,78
2004-05-24 00:00:00.000,Roland Garros France Grand Slams,CLAY,3,Nicolas Escude,Florian Mayer,Nicolas Escude,6-4; 6-3; 6-4,R64,104,10,1,46,78,36,46,20,32,3,5,14,56,78,4,7,54,100,30,54,24,46,4,10,15,54,100
2004-05-24 00:00:00.000,Roland Garros France Grand Slams,CLAY,3,Mikhail Youzhny,Andrei Pavel,Mikhail Youzhny,6-7(3); 7-6(4); 1-6; 7-6(8); 6-2,R64,227,5,4,109,183,68,109,36,74,12,20,25,104,183,0,3,140,189,90,140,20,49,11,19,26,110,189
2004-05-24 00:00:00.000,Roland Garros France Grand Slams,CLAY,3,Mario Ancic,Mariano Zabaleta,Mario Ancic,6-3; 6-4; 3-6; 6-4,R64,147,9,3,66,105,47,66,18,39,4,10,19,65,105,1,3,67,111,36,67,21,44,4,12,19,57,111
2004-05-24 00:00:00.000,Roland Garros France Grand Slams,CLAY,3,Guillermo Coria,Juan Monaco,Guillermo Coria,7-5; 6-1; 6-3,R64,144,3,3,64,95,42,64,15,31,4,8,14,57,95,1,10,58,103,31,58,17,45,11,20,14,48,103
2004-05-24 00:00:00.000,Roland Garros France Grand Slams,CLAY,3,Michael Llodra,Jerome Haehnel,Michael Llodra,6-3; 6-2; 3-6; 6-1,R64,110,6,2,68,97,52,68,18,29,3,4,17,70,97,3,6,54,98,37,54,20,44,2,7,16,57,98
2004-05-24 00:00:00.000,Roland Garros France Grand Slams,CLAY,3,Julien Jeanpierre,Vincent Spadea,Julien Jeanpierre,6-4; 6-2; 7-5,R64,148,2,6,67,102,46,67,16,35,13,15,15,62,102,2,2,61,101,37,61,19,40,4,10,15,56,101
2004-05-24 00:00:00.000,Roland Garros France Grand Slams,CLAY,3,Galo Blanco,Luis Horna,Galo Blanco,2-6; 6-4; 1-6; 6-2; 6-3,R64,175,4,2,71,126,47,71,33,55,6,11,21,80,126,3,6,93,132,61,93,19,39,11,16,21,80,132
2004-05-24 00:00:00.000,Roland Garros France Grand Slams,CLAY,3,Tim Henman,Lars Burgsmuller,Tim Henman,6-0; 6-3; 6-3,R64,93,2,2,41,65,34,41,17,24,2,2,12,51,65,1,4,52,85,29,52,13,33,4,10,12,42,85
2004-05-24 00:00:00.000,Roland Garros France Grand Slams,CLAY,3,Alex Corretja,Paradorn Srichaphan,Alex Corretja,6-4; 7-5; 6-3,R64,147,3,3,49,92,34,49,26,43,5,7,15,60,92,8,5,89,127,61,89,11,38,9,15,16,72,127
2004-05-24 00:00:00.000,Roland Garros France Grand Slams,CLAY,3,Juan Ignacio Chela,Fernando Verdasco,Juan Ignacio Chela,7-5; 6-2; 6-2,R64,99,5,2,49,78,35,49,20,29,3,4,14,55,78,1,6,53,79,28,53,13,26,3,9,14,41,79
2004-05-24 00:00:00.000,Roland Garros France Grand Slams,CLAY,3,Fabrice Santoro,Irakli Labadze,Fabrice Santoro,6-4; 3-6; 2-6; 6-1; 6-2,R64,202,1,1,86,139,53,86,33,53,8,13,21,86,139,3,16,78,126,55,78,20,48,8,15,21,75,126
2004-05-24 00:00:00.000,Roland Garros France Grand Slams,CLAY,3,Olivier Mutis,Andy Roddick,Olivier Mutis,3-6; 6-3; 6-7(5); 6-3; 6-2,R64,191,10,1,99,163,64,99,32,64,8,14,24,96,163,15,6,78,148,52,78,32,70,10,19,23,84,148
2004-05-24 00:00:00.000,Roland Garros France Grand Slams,CLAY,3,Gustavo Kuerten,Roger Federer,Gustavo Kuerten,6-4; 6-4; 6-4,R32,124,6,0,47,91,33,47,29,44,1,2,15,62,91,10,2,60,95,41,60,17,35,8,12,15,58,95
2004-05-24 00:00:00.000,Roland Garros France Grand Slams,CLAY,3,Feliciano Lopez,Hyung-Taik Lee,Feliciano Lopez,7-6(3); 4-6; 6-0; 6-3,R32,140,26,3,65,112,49,65,29,47,3,5,19,78,112,6,3,82,121,51,82,22,39,9,14,18,73,121
2004-05-24 00:00:00.000,Roland Garros France Grand Slams,CLAY,3,Marat Safin,Potito Starace,Marat Safin,6-7(4); 6-4; 3-6; 7-5; 7-5,R32,265,20,3,100,171,77,100,37,71,9,13,27,114,171,1,4,162,211,107,162,22,49,11,17,28,129,211
2004-05-24 00:00:00.000,Roland Garros France Grand Slams,CLAY,3,David Nalbandian,Stefan Koubek,David Nalbandian,6-7(1); 6-3; 7-6(1); 7-5,R32,189,6,8,84,146,59,84,31,62,9,15,23,90,146,1,8,88,141,60,88,19,53,10,18,22,79,141
2004-05-24 00:00:00.000,Roland Garros France Grand Slams,CLAY,3,Igor Andreev,Julien Benneteau,Igor Andreev,7-6(3); 7-6(3); 6-3,R32,136,3,2,69,103,46,69,20,34,1,5,17,66,103,3,7,54,98,38,54,18,44,2,7,16,56,98
2004-05-24 00:00:00.000,Roland Garros France Grand Slams,CLAY,3,Gaston Gaudio,Thomas Enqvist,Gaston Gaudio,6-0; 6-4; 6-7(5); 6-4,R32,157,10,1,75,110,55,75,20,35,4,8,19,75,110,10,4,57,119,39,57,25,62,5,14,19,64,119
2004-05-24 00:00:00.000,Roland Garros France Grand Slams,CLAY,3,Lleyton Hewitt,Martin Verkerk,Lleyton Hewitt,6-2; 3-6; 4-6; 6-2; 6-1,R32,180,7,4,67,117,51,67,28,50,9,12,21,79,117,18,9,97,146,69,97,14,49,11,18,21,83,146
2004-05-24 00:00:00.000,Roland Garros France Grand Slams,CLAY,3,Xavier Malisse,Albert Costa,Xavier Malisse,6-4; 2-6; 4-6; 7-6(4); 8-6,R32,261,12,2,86,161,54,86,33,75,8,19,27,87,161,2,8,100,172,64,100,33,72,7,17,27,97,172
2004-05-24 00:00:00.000,Roland Garros France Grand Slams,CLAY,3,Carlos Moya,Raemon Sluiter,Carlos Moya,6-0; 6-3; 6-4,R32,91,13,1,46,76,39,46,18,30,2,2,13,57,76,6,2,46,73,30,46,9,27,4,9,12,39,73
2004-05-24 00:00:00.000,Roland Garros France Grand Slams,CLAY,3,Tommy Robredo,Nicolas Massu,Tommy Robredo,6-2; 6-0; 6-2,R32,97,5,2,30,61,25,30,21,31,2,2,11,46,61,2,2,37,68,19,37,11,31,6,13,11,30,68
2004-05-24 00:00:00.000,Roland Garros France Grand Slams,CLAY,3,Nicolas Escude,Mikhail Youzhny,Nicolas Escude,6-2; 7-5; 6-7(3); 6-2,R32,177,6,4,70,132,53,70,26,62,7,12,20,79,132,3,7,69,118,42,69,22,49,11,21,20,64,118
2004-05-24 00:00:00.000,Roland Garros France Grand Slams,CLAY,3,Guillermo Coria,Mario Ancic,Guillermo Coria,6-3; 6-1; 6-2,R32,103,3,3,58,79,39,58,12,21,1,2,12,51,79,1,4,37,69,26,37,9,32,6,13,12,35,69
2004-05-24 00:00:00.000,Roland Garros France Grand Slams,CLAY,3,Michael Llodra,Julien Jeanpierre,Michael Llodra,6-2; 6-2; 6-3,R32,93,4,3,40,78,33,40,21,38,7,7,12,54,78,0,3,57,81,33,57,10,24,8,14,13,43,81
2004-05-24 00:00:00.000,Roland Garros France Grand Slams,CLAY,3,Tim Henman,Galo Blanco,Tim Henman,7-6(3); 6-1; 6-2,R32,114,19,6,46,80,37,46,20,34,2,4,13,57,80,1,6,64,95,35,64,13,31,3,10,14,48,95
2004-05-24 00:00:00.000,Roland Garros France Grand Slams,CLAY,3,Juan Ignacio Chela,Alex Corretja,Juan Ignacio Chela,6-4; 6-4; 4-6; 6-3,R32,203,2,2,86,143,52,86,28,57,11,18,20,80,143,2,4,55,113,35,55,24,58,5,14,19,59,113
2004-05-24 00:00:00.000,Roland Garros France Grand Slams,CLAY,3,Olivier Mutis,Fabrice Santoro,Olivier Mutis,6-0; 6-2; 6-3,R32,100,3,0,41,63,36,41,11,22,1,1,11,47,63,2,1,34,79,23,34,14,45,4,11,12,37,79
2004-05-24 00:00:00.000,Roland Garros France Grand Slams,CLAY,3,Gustavo Kuerten,Feliciano Lopez,Gustavo Kuerten,6-3; 7-5; 6-4,R16,113,7,2,45,84,36,45,27,39,0,1,16,63,84,3,3,40,90,30,40,26,50,7,11,15,56,90
2004-05-24 00:00:00.000,Roland Garros France Grand Slams,CLAY,3,David Nalbandian,Marat Safin,David Nalbandian,7-5; 6-4; 6-7(5); 6-3,R16,204,8,2,108,149,75,108,24,41,7,10,22,99,149,9,2,89,139,60,89,22,50,2,8,21,82,139
2004-05-24 00:00:00.000,Roland Garros France Grand Slams,CLAY,3,Gaston Gaudio,Igor Andreev,Gaston Gaudio,6-4; 7-5; 6-3,R16,128,0,1,59,93,34,59,19,34,4,9,15,53,93,0,3,58,88,29,58,13,30,2,11,16,42,88
2004-05-24 00:00:00.000,Roland Garros France Grand Slams,CLAY,3,Lleyton Hewitt,Xavier Malisse,Lleyton Hewitt,7-5; 6-2; 7-6(6),R16,165,1,5,64,115,41,64,26,51,8,12,16,67,115,4,2,52,104,30,52,26,52,3,10,16,56,104
2004-05-24 00:00:00.000,Roland Garros France Grand Slams,CLAY,3,Carlos Moya,Tommy Robredo,Carlos Moya,7-6(8); 6-4; 6-2,R16,138,5,7,49,93,39,49,24,44,2,4,15,63,93,0,5,60,113,37,60,26,53,8,13,15,63,113
2004-05-24 00:00:00.000,Roland Garros France Grand Slams,CLAY,3,Guillermo Coria,Nicolas Escude,Guillermo Coria,6-0 RET,R16,26,1,1,13,21,12,13,3,8,1,1,3,15,21,0,2,12,20,5,12,1,8,4,7,3,6,20
2004-05-24 00:00:00.000,Roland Garros France Grand Slams,CLAY,3,Tim Henman,Michael Llodra,Tim Henman,6-7(2); 4-6; 6-4; 6-3; 9-7,R16,251,6,8,113,189,84,113,38,76,11,16,29,122,189,12,4,105,188,70,105,45,83,8,15,28,115,188
2004-05-24 00:00:00.000,Roland Garros France Grand Slams,CLAY,3,Juan Ignacio Chela,Olivier Mutis,Juan Ignacio Chela,4-6; 6-2; 7-6(5); 6-2,R16,178,1,3,73,116,48,73,27,43,4,8,19,75,116,1,6,69,139,42,69,34,70,14,21,19,76,139
2004-05-24 00:00:00.000,Roland Garros France Grand Slams,CLAY,3,David Nalbandian,Gustavo Kuerten,David Nalbandian,6-2; 3-6; 6-4; 7-6(6),Q,188,5,7,72,121,47,72,26,49,7,13,19,73,121,9,3,71,133,48,71,26,62,7,15,20,74,133
2004-05-24 00:00:00.000,Roland Garros France Grand Slams,CLAY,3,Gaston Gaudio,Lleyton Hewitt,Gaston Gaudio,6-3; 6-2; 6-2,Q,116,1,1,39,73,23,39,24,34,1,3,13,47,73,2,5,45,85,23,45,16,40,7,14,12,39,85
2004-05-24 00:00:00.000,Roland Garros France Grand Slams,CLAY,3,Guillermo Coria,Carlos Moya,Guillermo Coria,7-5; 7-6(3); 6-3,Q,145,2,5,72,98,49,72,13,26,2,6,16,62,98,3,5,54,115,38,54,22,61,3,10,17,60,115
2004-05-24 00:00:00.000,Roland Garros France Grand Slams,CLAY,3,Tim Henman,Juan Ignacio Chela,Tim Henman,6-2; 6-4; 6-4,Q,110,3,2,52,87,38,52,21,35,4,5,14,59,87,3,2,50,78,33,50,14,28,4,9,14,47,78
2004-05-24 00:00:00.000,Roland Garros France Grand Slams,CLAY,3,Gaston Gaudio,David Nalbandian,Gaston Gaudio,6-3; 7-6(5); 6-0,S,146,1,1,42,82,27,42,22,40,5,9,13,49,82,2,5,74,114,37,74,15,40,7,16,14,52,114
2004-05-24 00:00:00.000,Roland Garros France Grand Slams,CLAY,3,Guillermo Coria,Tim Henman,Guillermo Coria,3-6; 6-4; 6-0; 7-5,S,167,0,4,79,114,49,79,17,35,6,11,18,66,114,2,5,59,116,38,59,21,57,4,13,19,59,116
2004-05-24 00:00:00.000,Roland Garros France Grand Slams,CLAY,3,Gaston Gaudio,Guillermo Coria,Gaston Gaudio,0-6; 3-6; 6-4; 6-1; 8-6,F,211,2,9,99,149,57,99,23,50,12,23,23,80,149,5,6,89,136,46,89,22,47,4,15,23,68,136
2004-06-07 00:00:00.000,Halle Germany ATP World Tour,GRASS,2,Roger Federer,Thomas Johansson,Roger Federer,6-3; 6-2,R32,69,10,4,34,56,28,34,11,22,6,7,9,39,56,3,2,38,62,23,38,7,24,5,9,8,30,62
2004-06-07 00:00:00.000,Halle Germany ATP World Tour,GRASS,2,Mikhail Youzhny,Florian Mayer,Mikhail Youzhny,6-7(4); 6-2; 7-6(2),R32,113,7,3,51,89,44,51,24,38,4,6,16,68,89,9,5,64,110,45,64,23,46,7,11,16,68,110
2004-06-07 00:00:00.000,Halle Germany ATP World Tour,GRASS,2,Arnaud Clement,Alexander Waske,Arnaud Clement,6-1; 6-4,R32,75,2,2,19,44,19,19,17,25,0,0,9,36,44,7,10,29,65,20,29,14,36,8,11,8,34,65
2004-06-07 00:00:00.000,Halle Germany ATP World Tour,GRASS,2,Alexander Popp,Andrei Pavel,Alexander Popp,1-6; 6-4; 6-4,R32,94,1,5,48,85,32,48,21,37,4,7,13,53,85,4,4,42,77,34,42,17,35,4,7,14,51,77
2004-06-07 00:00:00.000,Halle Germany ATP World Tour,GRASS,2,Jiri Novak,Ivan Ljubicic,Jiri Novak,6-2; 6-2,R32,51,3,0,28,42,25,28,8,14,3,3,8,33,42,5,1,32,49,17,32,8,17,4,8,8,25,49
2004-06-07 00:00:00.000,Halle Germany ATP World Tour,GRASS,2,Marco Chiudinelli,Michel Kratochvil,Marco Chiudinelli,6-2; 6-2,R32,59,2,2,29,42,24,29,9,13,0,0,8,33,42,3,5,23,49,15,23,9,26,3,7,8,24,49
2004-06-07 00:00:00.000,Halle Germany ATP World Tour,GRASS,2,Kenneth Carlsen,Michael Berrer,Kenneth Carlsen,3-6; 7-6(5); 7-5,R32,151,14,4,62,112,49,62,29,50,7,8,16,78,112,6,6,76,113,57,76,22,37,5,6,17,79,113
2004-06-07 00:00:00.000,Halle Germany ATP World Tour,GRASS,2,Tommy Haas,Feliciano Lopez,Tommy Haas,6-3; 6-4,R32,54,9,0,28,47,24,28,16,19,0,0,10,40,47,5,3,26,47,23,26,8,21,0,2,9,31,47
2004-06-07 00:00:00.000,Halle Germany ATP World Tour,GRASS,2,Mardy Fish,David Prinosil,Mardy Fish,6-4; 6-2,R32,71,8,4,25,54,21,25,18,29,0,0,9,39,54,1,7,34,63,23,34,12,29,5,8,9,35,63
2004-06-07 00:00:00.000,Halle Germany ATP World Tour,GRASS,2,Sargis Sargsian,Filippo Volandri,Sargis Sargsian,2-6; 6-2; 6-2,R32,84,3,2,44,73,34,44,10,29,4,8,12,44,73,2,3,49,68,29,49,6,19,2,8,12,35,68
2004-06-07 00:00:00.000,Halle Germany ATP World Tour,GRASS,2,Andreas Seppi,Nikolay Davydenko,Andreas Seppi,7-6(5); 2-6; 6-3,R32,120,2,5,66,99,45,66,14,33,7,11,14,59,99,11,6,72,117,52,72,15,45,9,13,15,67,117
2004-06-07 00:00:00.000,Halle Germany ATP World Tour,GRASS,2,Fernando Verdasco,Martin Verkerk,Fernando Verdasco,7-5; 7-5,R32,79,9,2,36,65,30,36,21,29,2,2,12,51,65,4,2,38,65,31,38,14,27,2,4,12,45,65
2004-06-07 00:00:00.000,Halle Germany ATP World Tour,GRASS,2,Jonas Bjorkman,Marat Safin,Jonas Bjorkman,6-2; 6-7(3); 7-6(4),R32,145,5,4,59,106,45,59,30,47,6,7,16,75,106,13,3,76,122,51,76,27,46,6,9,16,78,122
2004-06-07 00:00:00.000,Halle Germany ATP World Tour,GRASS,2,Nicolas Kiefer,Lars Burgsmuller,Nicolas Kiefer,6-3; 6-4,R32,67,7,4,28,53,26,28,14,25,0,0,10,40,53,6,4,34,53,24,34,11,19,2,4,9,35,53
2004-06-07 00:00:00.000,Halle Germany ATP World Tour,GRASS,2,Joachim Johansson,Robin Soderling,Joachim Johansson,7-6(3); 4-6; 6-3,R32,99,29,3,62,95,50,62,19,33,3,4,16,69,95,22,3,56,89,50,56,13,33,2,3,15,63,89
2004-06-07 00:00:00.000,Halle Germany ATP World Tour,GRASS,2,Rainer Schuettler,Jan Hernych,Rainer Schuettler,6-3; 6-2,R32,68,0,1,27,49,20,27,17,22,5,6,9,37,49,2,1,39,53,21,39,6,14,2,6,8,27,53
2004-06-07 00:00:00.000,Halle Germany ATP World Tour,GRASS,2,Roger Federer,Mikhail Youzhny,Roger Federer,6-2; 6-1,R16,69,3,0,26,42,19,26,10,16,0,1,8,29,42,4,0,44,80,23,44,13,36,9,14,7,36,80
2004-06-07 00:00:00.000,Halle Germany ATP World Tour,GRASS,2,Arnaud Clement,Alexander Popp,Arnaud Clement,7-6(4); 6-2,R16,96,4,4,36,66,28,36,13,30,2,4,10,41,66,4,8,47,77,30,47,9,30,5,9,10,39,77
2004-06-07 00:00:00.000,Halle Germany ATP World Tour,GRASS,2,Jiri Novak,Marco Chiudinelli,Jiri Novak,6-3; 6-1,R16,58,5,2,36,48,29,36,6,12,4,4,8,35,48,0,7,30,51,18,30,5,21,5,9,8,23,51
2004-06-07 00:00:00.000,Halle Germany ATP World Tour,GRASS,2,Tommy Haas,Kenneth Carlsen,Tommy Haas,6-7(3); 6-2; 6-4,R16,115,10,4,56,90,43,56,26,34,8,8,15,69,90,11,3,57,90,42,57,18,33,5,8,15,60,90
2004-06-07 00:00:00.000,Halle Germany ATP World Tour,GRASS,2,Mardy Fish,Sargis Sargsian,Mardy Fish,6-4; 6-3,R16,65,13,4,35,56,32,35,8,21,2,3,10,40,56,5,4,27,54,21,27,10,27,2,5,9,31,54
2004-06-07 00:00:00.000,Halle Germany ATP World Tour,GRASS,2,Fernando Verdasco,Andreas Seppi,Fernando Verdasco,6-3; 6-4,R16,69,7,6,43,64,36,43,9,21,2,2,10,45,64,3,4,31,53,24,31,10,22,2,4,9,34,53
2004-06-07 00:00:00.000,Halle Germany ATP World Tour,GRASS,2,Nicolas Kiefer,Jonas Bjorkman,Nicolas Kiefer,5-7; 6-4; 6-4,R16,150,4,2,60,98,46,60,19,38,4,7,16,65,98,6,3,74,116,48,74,21,42,8,12,16,69,116
2004-06-07 00:00:00.000,Halle Germany ATP World Tour,GRASS,2,Rainer Schuettler,Joachim Johansson,Rainer Schuettler,7-6(5); 6-4,R16,94,8,2,54,75,45,54,11,21,4,4,11,56,75,10,9,45,80,34,45,20,35,8,9,11,54,80
2004-06-07 00:00:00.000,Halle Germany ATP World Tour,GRASS,2,Roger Federer,Arnaud Clement,Roger Federer,6-3; 7-5,Q,72,5,4,39,56,34,39,10,17,0,0,11,44,56,1,0,41,62,26,41,12,21,2,4,10,38,62
2004-06-07 00:00:00.000,Halle Germany ATP World Tour,GRASS,2,Jiri Novak,Tommy Haas,Jiri Novak,6-4; 7-6(1),Q,96,4,1,58,85,40,58,17,27,3,3,11,57,85,6,5,48,80,37,48,12,32,3,4,11,49,80
2004-06-07 00:00:00.000,Halle Germany ATP World Tour,GRASS,2,Mardy Fish,Fernando Verdasco,Mardy Fish,6-2; 6-2,Q,52,10,1,23,39,22,23,10,16,0,0,8,32,39,2,5,22,46,15,22,9,24,3,7,8,24,46
2004-06-07 00:00:00.000,Halle Germany ATP World Tour,GRASS,2,Rainer Schuettler,Nicolas Kiefer,Rainer Schuettler,6-3; 7-6(2),Q,76,7,3,34,59,29,34,18,25,0,0,11,47,59,6,1,44,57,35,44,6,13,1,2,10,41,57
2004-06-07 00:00:00.000,Halle Germany ATP World Tour,GRASS,2,Roger Federer,Jiri Novak,Roger Federer,6-3; 6-4,S,53,4,2,31,50,25,31,15,19,0,0,10,40,50,1,0,32,49,23,32,9,17,4,6,9,32,49
2004-06-07 00:00:00.000,Halle Germany ATP World Tour,GRASS,2,Mardy Fish,Rainer Schuettler,Mardy Fish,6-4; 4-6; 7-6(4),S,125,14,1,55,104,40,55,31,49,3,5,16,71,104,4,3,58,90,46,58,17,32,0,2,16,63,90
2004-06-07 00:00:00.000,Halle Germany ATP World Tour,GRASS,2,Roger Federer,Mardy Fish,Roger Federer,6-0; 6-3,F,57,3,0,31,42,25,31,8,11,0,0,8,33,42,3,2,33,60,18,33,11,27,3,7,7,29,60
2004-06-07 00:00:00.000,London / Queen's Club England ATP World Tour,GRASS,2,Andy Roddick,N/A Bye,Andy Roddick,,R64,0,0,0,0,0,0,0,0,0,0,0,0,0,0,0,0,0,0,0,0,0,0,0,0,0,0,0
2004-06-07 00:00:00.000,London / Queen's Club England ATP World Tour,GRASS,2,Karol Kucera,John van Lottum,Karol Kucera,4-6; 6-1; 6-1,R64,84,6,1,36,63,30,36,18,27,0,1,12,48,63,1,3,55,76,30,55,9,21,5,10,12,39,76
2004-06-07 00:00:00.000,London / Queen's Club England ATP World Tour,GRASS,2,Mario Ancic,Jeff Morrison,Mario Ancic,6-3; 6-4,R64,64,7,3,37,59,30,37,13,22,2,2,10,43,59,4,4,41,63,27,41,10,22,5,7,9,37,63
2004-06-07 00:00:00.000,London / Queen's Club England ATP World Tour,GRASS,2,Todd Martin,Olivier Rochus,Todd Martin,6-4; 6-3,R64,62,11,4,27,47,23,27,13,20,0,0,9,36,47,0,5,37,62,23,37,12,25,3,6,10,35,62
2004-06-07 00:00:00.000,London / Queen's Club England ATP World Tour,GRASS,2,Nicolas Mahut,Max Mirnyi,Nicolas Mahut,6-4; 6-7(2); 6-4,R64,124,14,6,63,97,48,63,20,34,2,3,16,68,97,16,4,66,91,52,66,12,25,2,5,16,64,91
2004-06-07 00:00:00.000,London / Queen's Club England ATP World Tour,GRASS,2,Antony Dupuis,Julien Benneteau,Antony Dupuis,6-4; 7-5,R64,98,10,0,49,79,39,49,15,30,8,8,11,54,79,7,4,34,59,26,34,13,25,3,5,11,39,59
2004-06-07 00:00:00.000,London / Queen's Club England ATP World Tour,GRASS,2,Wesley Moodie,Alex Bogomolov Jr.,Wesley Moodie,7-6(7); 7-6(5),R64,100,22,1,47,70,46,47,15,23,1,1,12,61,70,2,1,65,95,50,65,17,30,4,4,12,67,95
2004-06-07 00:00:00.000,London / Queen's Club England ATP World Tour,GRASS,2,Paradorn Srichaphan,N/A Bye,Paradorn Srichaphan,,R64,0,0,0,0,0,0,0,0,0,0,0,0,0,0,0,0,0,0,0,0,0,0,0,0,0,0,0
2004-06-07 00:00:00.000,London / Queen's Club England ATP World Tour,GRASS,2,Andre Agassi,N/A Bye,Andre Agassi,,R64,0,0,0,0,0,0,0,0,0,0,0,0,0,0,0,0,0,0,0,0,0,0,0,0,0,0,0
2004-06-07 00:00:00.000,London / Queen's Club England ATP World Tour,GRASS,2,Igor Andreev,Richard Gasquet,Igor Andreev,7-6(4); 7-6(4),R64,90,10,1,45,79,36,45,23,34,1,1,12,59,79,5,5,47,78,36,47,21,31,1,1,12,57,78
2004-06-07 00:00:00.000,London / Queen's Club England ATP World Tour,GRASS,2,Frank Dancevic,Arvind Parmar,Frank Dancevic,7-5; 1-6; 7-6(5),R64,113,5,5,68,101,49,68,12,33,3,7,15,61,101,12,6,65,98,50,65,17,33,4,7,16,67,98
2004-06-07 00:00:00.000,London / Queen's Club England ATP World Tour,GRASS,2,Olivier Patience,David Ferrer,Olivier Patience,4-6; 7-6(2); 6-4,R64,122,7,4,72,101,58,72,13,29,5,7,16,71,101,2,2,71,112,48,71,25,41,10,12,16,73,112
2004-06-07 00:00:00.000,London / Queen's Club England ATP World Tour,GRASS,2,Jamie Delgado,Taylor Dent,Jamie Delgado,5-7; 7-5; 7-6(3),R64,125,6,8,59,109,49,59,30,50,3,5,18,79,109,8,7,84,117,63,84,13,33,7,9,18,76,117
2004-06-07 00:00:00.000,London / Queen's Club England ATP World Tour,GRASS,2,Jonathan Marray,Christophe Rochus,Jonathan Marray,6-3; 4-6; 7-5,R64,93,6,4,53,83,44,53,14,30,0,2,16,58,83,0,3,72,97,45,72,14,25,5,8,15,59,97
2004-06-07 00:00:00.000,London / Queen's Club England ATP World Tour,GRASS,2,Marc Lopez,Dmitry Tursunov,Marc Lopez,6-2; 1-6; 6-3,R64,93,1,2,41,71,27,41,15,30,2,6,12,42,71,4,6,33,73,23,33,16,40,4,9,12,39,73
2004-06-07 00:00:00.000,London / Queen's Club England ATP World Tour,GRASS,2,Lleyton Hewitt,N/A Bye,Lleyton Hewitt,,R64,0,0,0,0,0,0,0,0,0,0,0,0,0,0,0,0,0,0,0,0,0,0,0,0,0,0,0
2004-06-07 00:00:00.000,London / Queen's Club England ATP World Tour,GRASS,2,Sjeng Schalken,N/A Bye,Sjeng Schalken,,R64,0,0,0,0,0,0,0,0,0,0,0,0,0,0,0,0,0,0,0,0,0,0,0,0,0,0,0
2004-06-07 00:00:00.000,London / Queen's Club England ATP World Tour,GRASS,2,Wesley Whitehouse,Jan Vacek,Wesley Whitehouse,7-6(5); 6-3,R64,76,11,2,33,60,30,33,16,27,1,1,10,46,60,2,0,43,64,30,43,12,21,0,2,11,42,64
2004-06-07 00:00:00.000,London / Queen's Club England ATP World Tour,GRASS,2,Hyung-Taik Lee,Greg Rusedski,Hyung-Taik Lee,3-6; 6-3; 6-4,R64,98,4,3,60,84,47,60,10,24,1,3,14,57,84,8,9,52,90,36,52,21,38,5,8,14,57,90
2004-06-07 00:00:00.000,London / Queen's Club England ATP World Tour,GRASS,2,Robby Ginepri,Cyril Saulnier,Robby Ginepri,6-2; 6-1,R64,48,1,1,24,37,20,24,9,13,0,0,7,29,37,2,4,27,51,13,27,9,24,5,10,8,22,51
2004-06-07 00:00:00.000,London / Queen's Club England ATP World Tour,GRASS,2,Ivo Karlovic,Jan-Michael Gambill,Ivo Karlovic,6-4; 6-7(5); 7-6(5),R64,134,33,5,74,115,60,74,24,41,4,5,17,84,115,13,4,62,108,49,62,27,46,4,6,17,76,108
2004-06-07 00:00:00.000,London / Queen's Club England ATP World Tour,GRASS,2,Thomas Enqvist,Takao Suzuki,Thomas Enqvist,7-6(3); 6-4,R64,83,5,4,50,76,38,50,12,26,3,4,11,50,76,11,2,44,67,35,44,8,23,1,3,11,43,67
2004-06-07 00:00:00.000,London / Queen's Club England ATP World Tour,GRASS,2,Karol Beck,Gilles Elseneer,Karol Beck,6-3; 6-4,R64,66,8,2,31,60,24,31,19,29,3,3,10,43,60,1,2,39,56,29,39,6,17,1,3,9,35,56
2004-06-07 00:00:00.000,London / Queen's Club England ATP World Tour,GRASS,2,Tim Henman,N/A Bye,Tim Henman,,R64,0,0,0,0,0,0,0,0,0,0,0,0,0,0,0,0,0,0,0,0,0,0,0,0,0,0,0
2004-06-07 00:00:00.000,London / Queen's Club England ATP World Tour,GRASS,2,Sebastien Grosjean,N/A Bye,Sebastien Grosjean,,R64,0,0,0,0,0,0,0,0,0,0,0,0,0,0,0,0,0,0,0,0,0,0,0,0,0,0,0
2004-06-07 00:00:00.000,London / Queen's Club England ATP World Tour,GRASS,2,Todd Reid,Thierry Ascione,Todd Reid,7-5; 6-3,R64,75,2,2,38,56,26,38,8,18,2,5,10,34,56,3,5,49,74,30,49,9,25,6,12,11,39,74
2004-06-07 00:00:00.000,London / Queen's Club England ATP World Tour,GRASS,2,Victor Hanescu,Goran Ivanisevic,Victor Hanescu,6-7(5); 6-4; 6-4,R64,102,29,2,70,92,59,70,11,22,3,3,16,70,92,18,12,52,101,41,52,27,49,2,4,16,68,101
2004-06-07 00:00:00.000,London / Queen's Club England ATP World Tour,GRASS,2,Ian Flanagan,Mark Philippoussis,Ian Flanagan,7-6(2); 7-6(3),R64,87,16,2,52,81,45,52,13,29,3,4,12,58,81,12,5,48,77,40,48,12,29,1,2,12,52,77
2004-06-07 00:00:00.000,London / Queen's Club England ATP World Tour,GRASS,2,Radek Stepanek,Raemon Sluiter,Radek Stepanek,3-6; 6-1; 7-6(5),R64,101,11,0,61,78,48,61,12,17,1,2,14,60,78,7,4,47,84,36,47,21,37,0,2,14,57,84
2004-06-07 00:00:00.000,London / Queen's Club England ATP World Tour,GRASS,2,Davide Sanguinetti,Stefan Koubek,Davide Sanguinetti,6-4; 6-4,R64,56,0,0,29,51,26,29,14,22,0,0,10,40,51,5,2,34,56,24,34,12,22,2,4,10,36,56
2004-06-07 00:00:00.000,London / Queen's Club England ATP World Tour,GRASS,2,Yen-Hsun Lu,Wayne Arthurs,Yen-Hsun Lu,6-2; 6-4,R64,65,4,1,28,46,25,28,13,18,2,2,9,38,46,4,9,22,60,17,22,18,38,2,5,9,35,60
2004-06-07 00:00:00.000,London / Queen's Club England ATP World Tour,GRASS,2,Guillermo Coria,N/A Bye,Guillermo Coria,,R64,0,0,0,0,0,0,0,0,0,0,0,0,0,0,0,0,0,0,0,0,0,0,0,0,0,0,0
2004-06-07 00:00:00.000,London / Queen's Club England ATP World Tour,GRASS,2,Andy Roddick,Karol Kucera,Andy Roddick,7-6(4); 6-2,R32,78,13,5,37,65,29,37,15,28,3,4,10,44,65,3,6,52,70,33,52,7,18,5,8,10,40,70
2004-06-07 00:00:00.000,London / Queen's Club England ATP World Tour,GRASS,2,Mario Ancic,Todd Martin,Mario Ancic,7-6(5); 4-6; 6-2,R32,118,15,5,70,103,48,70,19,33,7,9,15,67,103,10,4,66,96,50,66,12,30,7,10,15,62,96
2004-06-07 00:00:00.000,London / Queen's Club England ATP World Tour,GRASS,2,Antony Dupuis,Nicolas Mahut,Antony Dupuis,7-6(7); 6-4,R32,88,12,0,48,67,37,48,10,19,0,1,11,47,67,16,3,39,63,31,39,11,24,0,2,11,42,63
2004-06-07 00:00:00.000,London / Queen's Club England ATP World Tour,GRASS,2,Paradorn Srichaphan,Wesley Moodie,Paradorn Srichaphan,6-3; 6-2,R32,46,4,1,29,48,22,29,16,19,1,1,9,38,48,3,1,34,46,20,34,5,12,1,4,8,25,46
2004-06-07 00:00:00.000,London / Queen's Club England ATP World Tour,GRASS,2,Igor Andreev,Andre Agassi,Igor Andreev,4-6; 7-6(2); 7-6(3),R32,116,18,5,60,110,49,60,26,50,3,4,17,75,110,5,1,56,95,46,56,25,39,0,0,17,71,95
2004-06-07 00:00:00.000,London / Queen's Club England ATP World Tour,GRASS,2,Olivier Patience,Frank Dancevic,Olivier Patience,6-3; 6-4,R32,56,7,2,35,61,28,35,16,26,4,4,10,44,61,1,3,30,45,24,30,7,15,0,2,9,31,45
2004-06-07 00:00:00.000,London / Queen's Club England ATP World Tour,GRASS,2,Jonathan Marray,Jamie Delgado,Jonathan Marray,6-4; 6-3,R32,65,7,4,43,60,34,43,6,17,2,3,10,40,60,4,8,37,63,26,37,9,26,8,11,9,35,63
2004-06-07 00:00:00.000,London / Queen's Club England ATP World Tour,GRASS,2,Lleyton Hewitt,Marc Lopez,Lleyton Hewitt,6-3; 6-2,R32,57,4,4,27,55,23,27,16,28,1,1,9,39,55,0,2,26,39,18,26,4,13,1,4,8,22,39
2004-06-07 00:00:00.000,London / Queen's Club England ATP World Tour,GRASS,2,Sjeng Schalken,Wesley Whitehouse,Sjeng Schalken,7-6(4); 6-3,R32,79,2,2,64,77,46,64,8,13,1,1,11,54,77,8,4,45,71,33,45,13,26,4,5,10,46,71
2004-06-07 00:00:00.000,London / Queen's Club England ATP World Tour,GRASS,2,Hyung-Taik Lee,Robby Ginepri,Hyung-Taik Lee,6-3; 6-2,R32,52,1,1,29,48,22,29,13,19,2,3,9,35,48,3,0,35,53,23,35,3,18,2,6,8,26,53
2004-06-07 00:00:00.000,London / Queen's Club England ATP World Tour,GRASS,2,Ivo Karlovic,Thomas Enqvist,Ivo Karlovic,7-6(5); 6-4,R32,69,26,0,38,61,35,38,16,23,0,0,11,51,61,7,6,36,63,34,36,12,27,1,2,11,46,63
2004-06-07 00:00:00.000,London / Queen's Club England ATP World Tour,GRASS,2,Karol Beck,Tim Henman,Karol Beck,6-2; 3-6; 7-6(6),R32,114,13,3,52,80,44,52,16,28,1,2,14,60,80,4,5,74,103,55,74,12,29,5,7,15,67,103
2004-06-07 00:00:00.000,London / Queen's Club England ATP World Tour,GRASS,2,Sebastien Grosjean,Todd Reid,Sebastien Grosjean,6-3; 6-1,R32,54,5,2,26,45,18,26,13,19,2,3,8,31,45,1,3,30,50,17,30,6,20,4,9,8,23,50
2004-06-07 00:00:00.000,London / Queen's Club England ATP World Tour,GRASS,2,Ian Flanagan,Victor Hanescu,Ian Flanagan,7-6(4); 6-3,R32,71,3,1,31,69,27,31,21,38,0,0,10,48,69,12,2,43,63,32,43,10,20,1,3,11,42,63
2004-06-07 00:00:00.000,London / Queen's Club England ATP World Tour,GRASS,2,Radek Stepanek,Davide Sanguinetti,Radek Stepanek,4-6; 6-4; 6-3,R32,106,8,5,63,101,42,63,22,38,7,10,15,64,101,4,3,59,88,39,59,13,29,5,9,14,52,88
2004-06-07 00:00:00.000,London / Queen's Club England ATP World Tour,GRASS,2,Yen-Hsun Lu,Guillermo Coria,Yen-Hsun Lu,6-2; 6-4,R32,68,2,3,30,48,23,30,13,18,0,0,9,36,48,1,3,42,67,28,42,9,25,4,7,9,37,67
2004-06-07 00:00:00.000,London / Queen's Club England ATP World Tour,GRASS,2,Andy Roddick,Mario Ancic,Andy Roddick,7-6(3); 4-6; 6-4,R16,102,8,1,56,90,44,56,22,34,2,3,16,66,90,15,6,62,94,51,62,15,32,2,3,16,66,94
2004-06-07 00:00:00.000,London / Queen's Club England ATP World Tour,GRASS,2,Paradorn Srichaphan,Antony Dupuis,Paradorn Srichaphan,6-3; 7-5,R16,80,3,2,33,59,29,33,16,26,0,0,11,45,59,4,2,43,70,32,43,11,27,4,6,10,43,70
2004-06-07 00:00:00.000,London / Queen's Club England ATP World Tour,GRASS,2,Igor Andreev,Olivier Patience,Igor Andreev,6-4; 7-5,R16,74,8,3,29,60,22,29,22,31,2,3,11,44,60,4,6,38,70,25,38,16,32,5,8,11,41,70
2004-06-07 00:00:00.000,London / Queen's Club England ATP World Tour,GRASS,2,Lleyton Hewitt,Jonathan Marray,Lleyton Hewitt,7-6(2); 7-6(8),R16,97,8,5,52,91,42,52,22,39,8,9,12,64,91,5,1,47,75,35,47,19,28,2,3,12,54,75
2004-06-07 00:00:00.000,London / Queen's Club England ATP World Tour,GRASS,2,Hyung-Taik Lee,Sjeng Schalken,Hyung-Taik Lee,7-6(3); 6-7(6); 6-3,R16,142,7,2,82,115,59,82,18,33,5,7,17,77,115,2,2,75,101,52,75,12,26,1,4,16,64,101
2004-06-07 00:00:00.000,London / Queen's Club England ATP World Tour,GRASS,2,Karol Beck,Ivo Karlovic,Karol Beck,6-7(4); 7-6(3); 6-3,R16,125,13,3,64,107,54,64,26,43,2,2,17,80,107,16,5,64,99,54,64,17,35,0,1,16,71,99
2004-06-07 00:00:00.000,London / Queen's Club England ATP World Tour,GRASS,2,Sebastien Grosjean,Ian Flanagan,Sebastien Grosjean,6-2; 6-0,R16,51,5,1,22,39,19,22,11,17,0,0,7,30,39,0,1,29,47,11,29,8,18,7,12,7,19,47
2004-06-07 00:00:00.000,London / Queen's Club England ATP World Tour,GRASS,2,Radek Stepanek,Yen-Hsun Lu,Radek Stepanek,6-2; 6-4,R16,81,4,5,38,58,30,38,11,20,4,4,9,41,58,2,7,38,65,24,38,13,27,5,8,9,37,65
2004-06-07 00:00:00.000,London / Queen's Club England ATP World Tour,GRASS,2,Andy Roddick,Paradorn Srichaphan,Andy Roddick,6-3; 6-3,Q,66,6,1,26,48,23,26,11,22,0,1,9,34,48,6,2,41,72,21,41,15,31,5,9,9,36,72
2004-06-07 00:00:00.000,London / Queen's Club England ATP World Tour,GRASS,2,Lleyton Hewitt,Igor Andreev,Lleyton Hewitt,6-3; 7-5,Q,79,9,5,41,70,34,41,11,29,8,9,10,45,70,2,0,39,70,23,39,15,31,4,8,11,38,70
2004-06-07 00:00:00.000,London / Queen's Club England ATP World Tour,GRASS,2,Hyung-Taik Lee,Karol Beck,Hyung-Taik Lee,6-3; 6-4,Q,57,2,1,35,52,27,35,8,17,0,2,10,35,52,3,3,36,54,25,36,2,18,1,5,9,27,54
2004-06-07 00:00:00.000,London / Queen's Club England ATP World Tour,GRASS,2,Sebastien Grosjean,Radek Stepanek,Sebastien Grosjean,6-3; 6-3,Q,79,2,0,35,56,22,35,15,21,3,4,9,37,56,1,6,44,67,28,44,6,23,4,8,9,34,67
2004-06-07 00:00:00.000,London / Queen's Club England ATP World Tour,GRASS,2,Andy Roddick,Lleyton Hewitt,Andy Roddick,7-6(7); 6-3,S,75,15,1,40,67,30,40,17,27,0,1,10,47,67,8,2,42,71,33,42,13,29,2,5,11,46,71
2004-06-07 00:00:00.000,London / Queen's Club England ATP World Tour,GRASS,2,Sebastien Grosjean,Hyung-Taik Lee,Sebastien Grosjean,6-7(4); 7-6(3); 6-2,S,138,10,0,71,118,50,71,25,47,7,10,16,75,118,2,3,67,107,42,67,20,40,4,9,16,62,107
2004-06-07 00:00:00.000,London / Queen's Club England ATP World Tour,GRASS,2,Andy Roddick,Sebastien Grosjean,Andy Roddick,7-6(4); 6-4,F,83,11,3,33,63,29,33,17,30,2,3,11,46,63,4,2,44,71,34,44,13,27,3,5,11,47,71
2004-06-14 00:00:00.000,Nottingham England ATP World Tour,GRASS,2,Paradorn Srichaphan,Gilles Elseneer,Paradorn Srichaphan,6-3; 7-5,R32,71,6,2,45,68,30,45,11,23,3,5,11,41,68,1,0,41,65,25,41,12,24,2,6,10,37,65
2004-06-14 00:00:00.000,Nottingham England ATP World Tour,GRASS,2,Wayne Ferreira,Alberto Martin,Wayne Ferreira,4-6; 6-4; 7-6(5),R32,113,11,6,49,85,41,49,18,36,0,3,16,59,85,2,3,66,105,47,66,19,39,7,10,16,66,105
2004-06-14 00:00:00.000,Nottingham England ATP World Tour,GRASS,2,Jan-Michael Gambill,Wesley Moodie,Jan-Michael Gambill,6-4; 6-2,R32,65,5,4,34,52,26,34,9,18,4,5,9,35,52,7,3,34,50,20,34,8,16,3,7,9,28,50
2004-06-14 00:00:00.000,Nottingham England ATP World Tour,GRASS,2,Hicham Arazi,Lee Childs,Hicham Arazi,6-3; 6-3,R32,68,7,1,32,50,25,32,10,18,1,2,9,35,50,4,3,42,67,27,42,8,25,8,12,9,35,67
2004-06-14 00:00:00.000,Nottingham England ATP World Tour,GRASS,2,Jonas Bjorkman,Aisam-Ul-Haq Qureshi,Jonas Bjorkman,7-6(5); 6-3,R32,91,6,0,39,55,33,39,11,16,0,0,10,44,55,8,5,61,87,40,61,13,26,4,6,11,53,87
2004-06-14 00:00:00.000,Nottingham England ATP World Tour,GRASS,2,Robin Soderling,David Ferrer,Robin Soderling,7-6(5); 3-6; 6-2,R32,133,6,3,53,99,34,53,24,46,4,7,14,58,99,2,3,71,103,44,71,16,32,3,7,15,60,103
2004-06-14 00:00:00.000,Nottingham England ATP World Tour,GRASS,2,Jonathan Marray,Wayne Arthurs,Jonathan Marray,7-6(4); 2-6; 6-3,R32,39,9,3,57,85,47,57,17,28,2,4,15,64,85,13,3,48,81,36,48,23,33,2,3,14,59,81
2004-06-14 00:00:00.000,Nottingham England ATP World Tour,GRASS,2,Flavio Saretta,Jurgen Melzer,Flavio Saretta,7-6(4); 7-6(3),R32,103,2,7,62,86,45,62,10,24,3,5,12,55,86,2,4,54,89,38,54,17,35,4,6,12,55,89
2004-06-14 00:00:00.000,Nottingham England ATP World Tour,GRASS,2,Vincent Spadea,Gregory Carraz,Vincent Spadea,6-3; 7-5,R32,84,7,3,34,62,27,34,18,28,2,2,11,45,62,4,4,56,77,39,56,7,21,7,9,10,46,77
2004-06-14 00:00:00.000,Nottingham England ATP World Tour,GRASS,2,Greg Rusedski,Karol Kucera,Greg Rusedski,2-6; 7-6(4); 6-3,R32,177,15,1,67,108,49,67,22,41,10,13,15,71,108,3,2,58,92,40,58,21,34,5,7,14,61,92
2004-06-14 00:00:00.000,Nottingham England ATP World Tour,GRASS,2,Olivier Rochus,Sargis Sargsian,Olivier Rochus,6-3; 6-3,R32,70,0,2,32,59,23,32,17,27,0,0,9,40,59,6,2,34,51,23,34,8,17,2,5,9,31,51
2004-06-14 00:00:00.000,Nottingham England ATP World Tour,GRASS,2,Thomas Johansson,Max Mirnyi,Thomas Johansson,2-6; 6-1; 6-4,R32,99,8,1,45,86,34,45,21,41,8,10,13,55,86,8,4,50,72,33,50,12,22,1,4,12,45,72
2004-06-14 00:00:00.000,Nottingham England ATP World Tour,GRASS,2,Taylor Dent,Irakli Labadze,Taylor Dent,6-2; 6-2,R32,42,4,2,25,39,22,25,10,14,0,0,8,32,39,2,6,27,42,16,27,5,15,1,5,8,21,42
2004-06-14 00:00:00.000,Nottingham England ATP World Tour,GRASS,2,Alex Bogdanovic,Joachim Johansson,Alex Bogdanovic,7-6(5); 6-4,R32,76,6,1,52,66,41,52,8,14,2,3,11,49,66,11,5,50,72,39,50,9,22,4,6,11,48,72
2004-06-14 00:00:00.000,Nottingham England ATP World Tour,GRASS,2,Arvind Parmar,Xavier Malisse,Arvind Parmar,1-6; 6-4; 7-5,R32,108,3,2,61,90,37,61,16,29,5,9,14,53,90,10,3,60,87,43,60,12,27,3,7,15,55,87
2004-06-14 00:00:00.000,Nottingham England ATP World Tour,GRASS,2,Victor Hanescu,Sebastian Fitz,Victor Hanescu,4-6; 6-1; 6-4,R32,113,9,4,70,96,49,70,14,26,6,7,14,63,96,6,2,61,90,43,61,12,29,6,9,13,55,90
2004-06-14 00:00:00.000,Nottingham England ATP World Tour,GRASS,2,Paradorn Srichaphan,Wayne Ferreira,Paradorn Srichaphan,4-6; 6-3; 7-5,R16,109,9,2,68,100,54,68,17,32,8,9,16,71,100,12,4,58,96,42,58,21,38,4,6,15,63,96
2004-06-14 00:00:00.000,Nottingham England ATP World Tour,GRASS,2,Hicham Arazi,Jan-Michael Gambill,Hicham Arazi,7-6(3); 6-3,R16,80,8,1,51,74,35,51,15,23,2,3,11,50,74,9,1,41,61,28,41,11,20,2,4,10,39,61
2004-06-14 00:00:00.000,Nottingham England ATP World Tour,GRASS,2,Robin Soderling,Jonas Bjorkman,Robin Soderling,6-3; 6-4,R16,70,8,4,41,62,34,41,9,21,4,4,10,43,62,3,1,34,52,24,34,11,18,3,5,9,35,52
2004-06-14 00:00:00.000,Nottingham England ATP World Tour,GRASS,2,Flavio Saretta,Jonathan Marray,Flavio Saretta,6-7(2); 7-6(1); 6-2,R16,121,5,4,58,88,49,58,21,30,3,4,16,70,88,8,10,60,96,44,60,20,36,4,7,16,64,96
2004-06-14 00:00:00.000,Nottingham England ATP World Tour,GRASS,2,Greg Rusedski,Vincent Spadea,Greg Rusedski,7-6(3); 4-6; 6-1,R16,109,7,4,59,89,48,59,16,30,1,2,15,64,89,2,3,56,92,45,56,18,36,7,9,14,63,92
2004-06-14 00:00:00.000,Nottingham England ATP World Tour,GRASS,2,Thomas Johansson,Olivier Rochus,Thomas Johansson,6-4; 7-6(5),R16,92,15,2,37,62,30,37,12,25,3,5,11,42,62,2,3,66,92,44,66,8,26,6,9,11,52,92
2004-06-14 00:00:00.000,Nottingham England ATP World Tour,GRASS,2,Taylor Dent,Alex Bogdanovic,Taylor Dent,6-2; 7-5,R16,76,4,2,34,59,26,34,12,25,0,2,10,38,59,4,4,49,71,27,49,8,22,7,12,10,35,71
2004-06-14 00:00:00.000,Nottingham England ATP World Tour,GRASS,2,Victor Hanescu,Arvind Parmar,Victor Hanescu,6-4; 7-5,R16,87,9,1,46,72,35,46,14,26,4,5,11,49,72,4,3,32,63,21,32,16,31,3,6,11,37,63
2004-06-14 00:00:00.000,Nottingham England ATP World Tour,GRASS,2,Paradorn Srichaphan,Hicham Arazi,Paradorn Srichaphan,6-3; 6-4,Q,69,4,2,43,63,34,43,12,20,1,1,10,46,63,2,1,36,56,25,36,9,20,6,8,9,34,56
2004-06-14 00:00:00.000,Nottingham England ATP World Tour,GRASS,2,Robin Soderling,Flavio Saretta,Robin Soderling,6-3; 6-4,Q,89,4,4,52,82,38,52,11,30,13,15,10,49,82,1,4,50,73,29,50,8,23,6,10,9,37,73
2004-06-14 00:00:00.000,Nottingham England ATP World Tour,GRASS,2,Thomas Johansson,Greg Rusedski,Thomas Johansson,4-6; 7-5; 7-6(5),Q,122,8,1,58,107,44,58,33,49,6,7,17,77,107,16,2,72,98,58,72,13,26,1,2,17,71,98
2004-06-14 00:00:00.000,Nottingham England ATP World Tour,GRASS,2,Taylor Dent,Victor Hanescu,Taylor Dent,5-7; 7-6(2); 7-6(7),Q,156,11,9,68,117,58,68,25,49,3,4,18,83,117,8,5,83,124,61,83,23,41,5,5,18,84,124
2004-06-14 00:00:00.000,Nottingham England ATP World Tour,GRASS,2,Paradorn Srichaphan,Robin Soderling,Paradorn Srichaphan,6-2; 6-2,S,51,4,0,31,43,24,31,5,12,0,1,8,29,43,0,3,23,42,11,23,7,19,1,6,8,18,42
2004-06-14 00:00:00.000,Nottingham England ATP World Tour,GRASS,2,Thomas Johansson,Taylor Dent,Thomas Johansson,7-6(4); 6-1,S,71,8,0,39,65,32,39,14,26,0,0,10,46,65,5,3,35,61,22,35,14,26,4,6,9,36,61
2004-06-14 00:00:00.000,Nottingham England ATP World Tour,GRASS,2,Paradorn Srichaphan,Thomas Johansson,Paradorn Srichaphan,1-6; 7-6(4); 6-3,F,113,7,8,50,98,35,50,24,48,4,8,15,59,98,6,0,41,78,35,41,21,37,7,9,13,56,78
2004-06-14 00:00:00.000,'s-Hertogenbosch The Netherlands ATP World Tour,GRASS,2,Guillermo Coria,Karol Beck,Guillermo Coria,6-3; 6-3,R32,63,5,2,27,47,25,27,12,20,0,0,9,37,47,1,4,29,61,21,29,13,32,4,7,9,34,61
2004-06-14 00:00:00.000,'s-Hertogenbosch The Netherlands ATP World Tour,GRASS,2,Michael Kohlmann,George Bastl,Michael Kohlmann,7-6(7); 6-4,R32,93,2,1,53,69,36,53,11,16,1,2,11,47,69,8,2,59,85,42,59,11,26,5,7,11,53,85
2004-06-14 00:00:00.000,'s-Hertogenbosch The Netherlands ATP World Tour,GRASS,2,Dennis van Scheppingen,Jose Acasuso,Dennis van Scheppingen,6-3; 6-2,R32,67,6,1,33,48,29,33,8,15,0,0,9,37,48,0,1,28,45,14,28,8,17,0,3,8,22,45
2004-06-14 00:00:00.000,'s-Hertogenbosch The Netherlands ATP World Tour,GRASS,2,Arnaud Clement,Ivo Karlovic,Arnaud Clement,7-6(8); 6-7(5); 6-3,R32,133,2,3,65,100,57,65,25,35,0,0,17,82,100,35,8,66,106,59,66,21,40,3,4,16,80,106
2004-06-14 00:00:00.000,'s-Hertogenbosch The Netherlands ATP World Tour,GRASS,2,Mario Ancic,Sjeng Schalken,Mario Ancic,4-6; 6-3; 6-2,R32,98,4,6,45,75,37,45,19,30,0,1,14,56,75,2,4,57,82,37,57,14,25,3,6,13,51,82
2004-06-14 00:00:00.000,'s-Hertogenbosch The Netherlands ATP World Tour,GRASS,2,Igor Andreev,Peter Wessels,Igor Andreev,6-1; 6-3,R32,51,6,3,32,50,26,32,10,18,3,3,8,36,50,2,3,35,52,20,35,6,17,3,7,8,26,52
2004-06-14 00:00:00.000,'s-Hertogenbosch The Netherlands ATP World Tour,GRASS,2,Martin Verkerk,Kristof Vliegen,Martin Verkerk,7-6(2); 6-4,R32,91,14,5,45,75,37,45,18,30,4,4,11,55,75,10,3,36,60,30,36,16,24,1,2,11,46,60
2004-06-14 00:00:00.000,'s-Hertogenbosch The Netherlands ATP World Tour,GRASS,2,Mikhail Youzhny,Antony Dupuis,Mikhail Youzhny,6-4; 6-0,R32,78,2,2,28,47,21,28,13,19,4,4,8,34,47,1,4,25,59,13,25,15,34,7,11,8,28,59
2004-06-14 00:00:00.000,'s-Hertogenbosch The Netherlands ATP World Tour,GRASS,2,Fernando Verdasco,Jean-Claude Scherrer,Fernando Verdasco,3-6; 7-6(7); 6-4,R32,130,13,8,62,106,45,62,26,44,7,9,15,71,106,10,3,79,123,61,79,19,44,12,14,16,80,123
2004-06-14 00:00:00.000,'s-Hertogenbosch The Netherlands ATP World Tour,GRASS,2,John van Lottum,Thierry Ascione,John van Lottum,6-2; 6-0,R32,58,1,0,25,37,19,25,9,12,0,0,7,28,37,0,3,32,55,17,32,8,23,5,10,7,25,55
2004-06-14 00:00:00.000,'s-Hertogenbosch The Netherlands ATP World Tour,GRASS,2,Guillermo Canas,Nikolay Davydenko,Guillermo Canas,6-4; 6-4,R32,70,3,3,29,52,24,29,15,23,0,1,10,39,52,2,3,35,57,22,35,11,22,2,5,10,33,57
2004-06-14 00:00:00.000,'s-Hertogenbosch The Netherlands ATP World Tour,GRASS,2,Tommy Robredo,Lars Burgsmuller,Tommy Robredo,3-6; 6-4; 6-4,R32,109,4,6,55,88,40,55,20,33,3,5,15,60,88,2,5,42,90,29,42,28,48,7,9,14,57,90
2004-06-14 00:00:00.000,'s-Hertogenbosch The Netherlands ATP World Tour,GRASS,2,Jan Vacek,Dominik Hrbaty,Jan Vacek,6-4; 6-4,R32,80,4,3,35,72,28,35,19,37,7,8,10,47,72,2,3,54,78,30,54,14,24,6,9,10,44,78
2004-06-14 00:00:00.000,'s-Hertogenbosch The Netherlands ATP World Tour,GRASS,2,Michael Llodra,Yen-Hsun Lu,Michael Llodra,6-3; 6-1,R32,52,8,0,26,35,25,26,7,9,0,0,8,32,35,0,3,34,53,18,34,8,19,4,8,8,26,53
2004-06-14 00:00:00.000,'s-Hertogenbosch The Netherlands ATP World Tour,GRASS,2,Philipp Petzschner,Alexander Popp,Philipp Petzschner,6-1; 5-7; 6-4,R32,93,9,3,57,90,40,57,18,33,2,5,15,58,90,2,5,60,86,37,60,13,26,1,6,14,50,86
2004-06-14 00:00:00.000,'s-Hertogenbosch The Netherlands ATP World Tour,GRASS,2,Raemon Sluiter,Rainer Schuettler,Raemon Sluiter,3-6; 7-6(2); 6-3,R32,129,6,7,58,109,44,58,25,51,11,13,14,69,109,4,3,61,96,43,61,19,35,3,6,16,62,96
2004-06-14 00:00:00.000,'s-Hertogenbosch The Netherlands ATP World Tour,GRASS,2,Guillermo Coria,Michael Kohlmann,Guillermo Coria,6-4; 6-2,R16,69,6,7,35,62,25,35,13,27,3,5,9,38,62,1,1,34,54,23,34,5,20,0,5,9,28,54
2004-06-14 00:00:00.000,'s-Hertogenbosch The Netherlands ATP World Tour,GRASS,2,Arnaud Clement,Dennis van Scheppingen,Arnaud Clement,7-5; 1-0 RET,R16,64,7,0,33,47,25,33,4,14,6,7,6,29,47,3,5,34,59,21,34,9,25,8,11,7,30,59
2004-06-14 00:00:00.000,'s-Hertogenbosch The Netherlands ATP World Tour,GRASS,2,Mario Ancic,Igor Andreev,Mario Ancic,6-3; 6-1,R16,59,10,3,28,48,22,28,14,20,3,3,8,36,48,2,3,34,53,21,34,7,19,2,6,8,28,53
2004-06-14 00:00:00.000,'s-Hertogenbosch The Netherlands ATP World Tour,GRASS,2,Martin Verkerk,Mikhail Youzhny,Martin Verkerk,6-2; 2-0 RET,R16,39,5,2,12,22,12,12,8,10,0,0,5,20,22,2,2,19,30,9,19,4,11,2,5,5,13,30
2004-06-14 00:00:00.000,'s-Hertogenbosch The Netherlands ATP World Tour,GRASS,2,Fernando Verdasco,John van Lottum,Fernando Verdasco,5-4 RET,R16,34,5,0,12,18,11,12,6,6,0,0,4,17,18,0,0,16,29,13,16,6,13,1,2,5,19,29
2004-06-14 00:00:00.000,'s-Hertogenbosch The Netherlands ATP World Tour,GRASS,2,Tommy Robredo,Guillermo Canas,Tommy Robredo,7-5; 1-6; 7-5,R16,142,0,3,60,101,41,60,23,41,11,13,15,64,101,3,3,74,113,53,74,19,39,5,7,16,72,113
2004-06-14 00:00:00.000,'s-Hertogenbosch The Netherlands ATP World Tour,GRASS,2,Michael Llodra,Jan Vacek,Michael Llodra,6-3; 6-4,R16,56,2,2,33,48,28,33,9,15,0,1,10,37,48,3,2,40,56,26,40,7,16,1,4,9,33,56
2004-06-14 00:00:00.000,'s-Hertogenbosch The Netherlands ATP World Tour,GRASS,2,Raemon Sluiter,Philipp Petzschner,Raemon Sluiter,6-3; 6-0,R16,57,5,2,24,45,19,24,15,21,4,4,8,34,45,5,2,27,51,13,27,13,24,3,7,7,26,51
2004-06-14 00:00:00.000,'s-Hertogenbosch The Netherlands ATP World Tour,GRASS,2,Guillermo Coria,Arnaud Clement,Guillermo Coria,6-2; 7-5,Q,93,5,2,39,61,32,39,13,22,2,2,10,45,61,0,3,34,67,23,34,16,33,3,6,10,39,67
2004-06-14 00:00:00.000,'s-Hertogenbosch The Netherlands ATP World Tour,GRASS,2,Mario Ancic,Martin Verkerk,Mario Ancic,6-3; 6-3,Q,69,12,3,35,51,31,35,9,16,2,2,9,40,51,9,9,39,65,27,39,9,26,4,7,9,36,65
2004-06-14 00:00:00.000,'s-Hertogenbosch The Netherlands ATP World Tour,GRASS,2,Tommy Robredo,Fernando Verdasco,Tommy Robredo,7-6(5); 6-2,Q,82,0,0,38,57,25,38,16,19,0,1,10,41,57,1,5,47,69,32,47,7,22,4,7,10,39,69
2004-06-14 00:00:00.000,'s-Hertogenbosch The Netherlands ATP World Tour,GRASS,2,Michael Llodra,Raemon Sluiter,Michael Llodra,6-7(2); 7-6(5); 6-3,Q,119,15,2,85,120,63,85,17,35,10,11,16,80,120,15,1,73,104,53,73,19,31,6,9,17,72,104
2004-06-14 00:00:00.000,'s-Hertogenbosch The Netherlands ATP World Tour,GRASS,2,Guillermo Coria,Mario Ancic,Guillermo Coria,7-6(4); 1-6; 6-3,S,117,3,4,63,95,44,63,13,32,7,11,14,57,95,12,5,48,87,34,48,23,39,2,5,14,57,87
2004-06-14 00:00:00.000,'s-Hertogenbosch The Netherlands ATP World Tour,GRASS,2,Michael Llodra,Tommy Robredo,Michael Llodra,6-3; 6-2,S,51,5,2,30,42,27,30,10,12,1,1,9,37,42,2,2,31,51,20,31,9,20,1,4,8,29,51
2004-06-14 00:00:00.000,'s-Hertogenbosch The Netherlands ATP World Tour,GRASS,2,Michael Llodra,Guillermo Coria,Michael Llodra,6-3; 6-4,F,62,2,0,34,55,25,34,13,21,2,4,10,38,55,3,2,34,51,20,34,8,17,3,7,9,28,51
2004-06-21 00:00:00.000,Wimbledon England Grand Slams,GRASS,3,Roger Federer,Alex Bogdanovic,Roger Federer,6-3; 6-3; 6-0,R128,80,6,4,43,64,37,43,14,21,2,2,12,51,64,3,2,64,86,37,64,8,22,6,12,12,45,86
2004-06-21 00:00:00.000,Wimbledon England Grand Slams,GRASS,3,Alejandro Falla,Julian Knowle,Alejandro Falla,2-6; 6-3; 6-1; 6-3,R128,117,6,3,67,110,46,67,25,43,4,6,17,71,110,2,6,53,88,36,53,15,35,0,5,16,51,88
2004-06-21 00:00:00.000,Wimbledon England Grand Slams,GRASS,3,Fabrice Santoro,Alberto Martin,Fabrice Santoro,7-5; 6-2; 3-6; 6-2,R128,162,4,4,61,110,49,61,25,49,5,8,19,74,110,4,4,71,104,44,71,16,33,3,9,18,60,104
2004-06-21 00:00:00.000,Wimbledon England Grand Slams,GRASS,3,Thomas Johansson,Nicolas Kiefer,Thomas Johansson,4-6; 4-6; 6-4; 6-3; 6-0,R128,162,22,4,75,136,58,75,30,61,4,8,23,88,136,20,11,77,129,54,77,22,52,6,13,22,76,129
2004-06-21 00:00:00.000,Wimbledon England Grand Slams,GRASS,3,Feliciano Lopez,Richard Bloomfield,Feliciano Lopez,6-4; 6-2; 7-5,R128,98,17,2,43,72,40,43,20,29,0,0,15,60,72,10,8,65,99,47,65,14,34,7,11,15,61,99
2004-06-21 00:00:00.000,Wimbledon England Grand Slams,GRASS,3,Cyril Saulnier,Michael Llodra,Cyril Saulnier,7-5; 4-6; 7-6(6); 7-6(3),R128,161,13,4,75,139,60,75,42,64,3,4,23,102,139,19,4,81,138,59,81,38,57,5,6,23,97,138
2004-06-21 00:00:00.000,Wimbledon England Grand Slams,GRASS,3,Gilles Elseneer,Arvind Parmar,Gilles Elseneer,7-6(5); 7-6(5); 7-6(3),R128,141,20,5,84,130,68,84,25,46,6,8,18,93,130,8,3,78,123,57,78,25,45,4,6,18,82,123
2004-06-21 00:00:00.000,Wimbledon England Grand Slams,GRASS,3,Ivo Karlovic,Paradorn Srichaphan,Ivo Karlovic,3-6; 6-4; 6-4; 6-4,R128,133,16,7,71,112,61,71,16,41,5,8,20,77,112,9,5,74,130,52,74,29,56,10,14,19,81,130
2004-06-21 00:00:00.000,Wimbledon England Grand Slams,GRASS,3,Carlos Moya,Olivier Patience,Carlos Moya,6-4; 3-6; 7-5; 6-7(6); 6-1,R128,186,29,9,80,146,67,80,39,66,10,11,24,106,146,7,12,102,179,74,102,37,77,10,15,26,111,179
2004-06-21 00:00:00.000,Wimbledon England Grand Slams,GRASS,3,Radek Stepanek,Alex Corretja,Radek Stepanek,4-6; 6-3; 6-2; 5-7; 6-4,R128,194,12,4,89,140,69,89,33,51,5,7,25,102,140,13,7,83,144,61,83,33,61,6,10,24,94,144
2004-06-21 00:00:00.000,Wimbledon England Grand Slams,GRASS,3,Sargis Sargsian,Marc Lopez,Sargis Sargsian,6-4; 6-3; 4-6; 6-2,R128,139,9,3,67,101,49,67,16,34,3,9,19,65,101,2,4,104,145,54,104,19,41,8,17,18,73,145
2004-06-21 00:00:00.000,Wimbledon England Grand Slams,GRASS,3,Dmitry Tursunov,Marat Safin,Dmitry Tursunov,4-6; 7-5; 6-3; 7-6(1),R128,152,18,7,86,142,65,86,29,56,8,11,22,94,142,8,6,80,124,55,80,22,44,7,11,21,77,124
2004-06-21 00:00:00.000,Wimbledon England Grand Slams,GRASS,3,Goran Ivanisevic,Mikhail Youzhny,Goran Ivanisevic,6-3; 7-6(4); 6-2,R128,87,14,3,66,86,56,66,10,20,2,2,15,66,86,11,1,68,100,44,68,17,32,5,8,14,61,100
2004-06-21 00:00:00.000,Wimbledon England Grand Slams,GRASS,3,Filippo Volandri,Jamie Delgado,Filippo Volandri,6-1; 6-3; 6-3,R128,76,4,3,48,76,35,48,21,28,5,5,13,56,76,1,4,52,80,35,52,10,28,10,15,12,45,80
2004-06-21 00:00:00.000,Wimbledon England Grand Slams,GRASS,3,Irakli Labadze,Kristof Vliegen,Irakli Labadze,6-2; 6-4; 3-6; 6-2,R128,134,5,7,72,104,58,72,10,32,6,9,17,68,104,8,12,67,115,42,67,22,48,5,12,18,64,115
2004-06-21 00:00:00.000,Wimbledon England Grand Slams,GRASS,3,Lleyton Hewitt,Jurgen Melzer,Lleyton Hewitt,6-2; 6-4; 6-2,R128,90,5,3,42,73,34,42,22,31,4,4,13,56,73,5,4,53,83,31,53,13,30,5,10,13,44,83
2004-06-21 00:00:00.000,Wimbledon England Grand Slams,GRASS,3,Guillermo Coria,Wesley Moodie,Guillermo Coria,6-4; 6-7(3); 6-3; 6-7(3); 6-3,R128,186,13,8,112,169,86,112,35,57,2,3,27,121,169,15,3,116,157,88,116,22,41,9,13,25,110,157
2004-06-21 00:00:00.000,Wimbledon England Grand Slams,GRASS,3,Florian Mayer,Wayne Arthurs,Florian Mayer,7-6(4); 7-6(5); 7-6(4),R128,119,15,4,90,126,71,90,22,36,1,1,18,93,126,30,7,76,116,65,76,23,40,6,6,18,88,116
2004-06-21 00:00:00.000,Wimbledon England Grand Slams,GRASS,3,Karol Kucera,Oscar Hernandez,Karol Kucera,6-1; 6-2; 6-2,R128,67,5,2,35,53,32,35,16,18,0,0,12,48,53,1,9,39,59,21,39,4,20,3,9,11,25,59
2004-06-21 00:00:00.000,Wimbledon England Grand Slams,GRASS,3,Wayne Ferreira,Ivan Ljubicic,Wayne Ferreira,5-7; 7-6(5); 7-5; 6-2,R128,192,13,2,76,124,63,76,32,48,0,1,22,95,124,16,3,93,157,70,93,31,64,7,10,22,101,157
2004-06-21 00:00:00.000,Wimbledon England Grand Slams,GRASS,3,Jonas Bjorkman,Raemon Sluiter,Jonas Bjorkman,5-7; 6-1; 7-5; 6-1,R128,150,9,7,88,136,61,88,26,48,11,13,19,87,136,8,3,67,107,44,67,19,40,6,13,19,63,107
2004-06-21 00:00:00.000,Wimbledon England Grand Slams,GRASS,3,Yen-Hsun Lu,Jan Vacek,Yen-Hsun Lu,6-3; 4-6; 6-3; 6-2,R128,147,8,3,84,120,60,84,18,36,6,9,18,78,120,9,9,69,124,48,69,21,55,7,14,18,69,124
2004-06-21 00:00:00.000,Wimbledon England Grand Slams,GRASS,3,Joachim Johansson,Arnaud Clement,Joachim Johansson,6-2; 7-6(3); 7-6(7),R128,129,34,2,73,107,60,73,22,34,5,5,16,82,107,12,3,69,107,57,69,16,38,4,6,16,73,107
2004-06-21 00:00:00.000,Wimbledon England Grand Slams,GRASS,3,Mardy Fish,Ivan Navarro,Mardy Fish,6-3; 6-2; 6-3,R128,93,13,3,44,78,35,44,22,34,3,3,13,57,78,8,14,36,78,28,36,16,42,4,9,13,44,78
2004-06-21 00:00:00.000,Wimbledon England Grand Slams,GRASS,3,Sebastien Grosjean,Thierry Ascione,Sebastien Grosjean,6-4; 6-2; 6-4,R128,113,11,0,39,73,35,39,25,34,5,5,14,60,73,2,9,66,116,45,66,21,50,12,16,14,66,116
2004-06-21 00:00:00.000,Wimbledon England Grand Slams,GRASS,3,Gregory Carraz,Olivier Rochus,Gregory Carraz,7-6(5); 6-4; 6-4,R128,119,17,9,73,104,60,73,13,31,4,5,16,73,104,4,4,60,105,44,60,25,45,6,9,16,69,105
2004-06-21 00:00:00.000,Wimbledon England Grand Slams,GRASS,3,Daniele Bracciali,Jan Hernych,Daniele Bracciali,3-6; 4-6; 6-2; 6-3; 6-3,R128,151,6,4,66,116,53,66,25,50,1,5,22,78,116,5,2,99,150,57,99,30,51,14,21,23,87,150
2004-06-21 00:00:00.000,Wimbledon England Grand Slams,GRASS,3,Jan-Michael Gambill,Max Mirnyi,Jan-Michael Gambill,6-3; 7-5; 6-4,R128,106,20,3,68,94,58,68,11,26,4,4,16,69,94,21,5,58,85,43,58,14,27,6,9,15,57,85
2004-06-21 00:00:00.000,Wimbledon England Grand Slams,GRASS,3,Robby Ginepri,Janko Tipsarevic,Robby Ginepri,4-6; 7-5; 6-3; 6-3,R128,202,9,2,86,126,65,86,15,40,8,11,20,80,126,11,3,92,157,62,92,27,65,12,18,20,89,157
2004-06-21 00:00:00.000,Wimbledon England Grand Slams,GRASS,3,Fernando Verdasco,Glenn Weiner,Fernando Verdasco,6-4; 6-4; 6-4,R128,166,15,11,49,86,39,49,22,37,0,1,15,61,86,7,6,41,74,33,41,15,33,0,4,15,48,74
2004-06-21 00:00:00.000,Wimbledon England Grand Slams,GRASS,3,Stefan Koubek,Jose Acasuso,Stefan Koubek,4-6; 6-4; 6-1; 6-1,R128,123,6,3,64,95,50,64,20,31,4,5,17,70,95,7,4,74,139,47,74,30,65,14,20,17,77,139
2004-06-21 00:00:00.000,Wimbledon England Grand Slams,GRASS,3,Juan Carlos Ferrero,Julien Boutter,Juan Carlos Ferrero,6-4; 7-6(4); 6-3,R128,122,6,4,66,97,53,66,19,31,0,0,16,72,97,15,6,70,114,54,70,17,44,9,11,15,71,114
2004-06-21 00:00:00.000,Wimbledon England Grand Slams,GRASS,3,Tim Henman,Ruben Ramirez Hidalgo,Tim Henman,4-6; 7-6(6); 6-4; 6-2,R128,182,12,10,70,124,53,70,29,54,2,5,20,82,124,3,3,93,143,61,93,23,50,8,13,20,84,143
2004-06-21 00:00:00.000,Wimbledon England Grand Slams,GRASS,3,Ivo Heuberger,Flavio Saretta,Ivo Heuberger,5-7; 6-0; 6-1; 7-6(9),R128,137,7,4,68,107,50,68,22,39,3,7,19,72,107,1,11,73,124,42,73,21,51,4,12,18,63,124
2004-06-21 00:00:00.000,Wimbledon England Grand Slams,GRASS,3,David Ferrer,Victor Hanescu,David Ferrer,7-6(5); 6-4; 6-7(4); 7-5,R128,201,16,3,110,152,74,110,22,42,8,12,23,96,152,5,7,106,154,69,106,21,48,8,14,23,90,154
2004-06-21 00:00:00.000,Wimbledon England Grand Slams,GRASS,3,Hicham Arazi,Andre Sa,Hicham Arazi,6-1; 6-4; 6-2,R128,87,3,2,37,63,30,37,19,26,0,1,13,49,63,5,0,48,80,29,48,12,32,5,11,12,41,80
2004-06-21 00:00:00.000,Wimbledon England Grand Slams,GRASS,3,Fernando Gonzalez,Martin Vassallo Arguello,Fernando Gonzalez,6-4; 6-2; 6-4,R128,91,5,1,47,78,40,47,20,31,2,2,14,60,78,3,2,62,84,43,62,9,22,5,9,14,52,84
2004-06-21 00:00:00.000,Wimbledon England Grand Slams,GRASS,3,Igor Andreev,John van Lottum,Igor Andreev,2-6; 6-2; 6-0; 6-3,R128,101,11,9,58,96,42,58,17,38,2,6,16,59,96,5,9,52,91,31,52,16,39,6,14,15,47,91
2004-06-21 00:00:00.000,Wimbledon England Grand Slams,GRASS,3,Martin Verkerk,Nikolay Davydenko,Martin Verkerk,4-6; 6-3; 6-4; 7-5,R128,151,21,12,80,128,63,80,25,48,5,7,21,88,128,8,8,91,131,67,91,18,40,12,16,20,85,131
2004-06-21 00:00:00.000,Wimbledon England Grand Slams,GRASS,3,Mark Philippoussis,Christophe Rochus,Mark Philippoussis,6-3; 6-4; 6-2,R128,92,22,11,50,84,43,50,16,34,4,4,14,59,84,3,0,67,81,40,67,5,14,5,9,13,45,81
2004-06-21 00:00:00.000,Wimbledon England Grand Slams,GRASS,3,Xavier Malisse,Jiri Novak,Xavier Malisse,6-3; 6-4; 6-4,R128,90,7,2,43,80,37,43,24,37,1,2,15,61,80,2,4,69,95,46,69,8,26,3,7,14,54,95
2004-06-21 00:00:00.000,Wimbledon England Grand Slams,GRASS,3,Tommy Haas,Antony Dupuis,Tommy Haas,2-6; 2-6; 7-6(8); 6-4; 8-6,R128,216,12,11,93,147,76,93,29,54,6,10,26,105,147,20,1,101,168,75,101,40,67,10,12,26,115,168
2004-06-21 00:00:00.000,Wimbledon England Grand Slams,GRASS,3,Karol Beck,Jonathan Marray,Karol Beck,6-4; 6-7(3); 4-6; 6-3; 10-8,R128,212,15,5,99,173,76,99,44,74,11,16,30,120,173,13,20,122,191,88,122,31,69,10,17,29,119,191
2004-06-21 00:00:00.000,Wimbledon England Grand Slams,GRASS,3,Tommy Robredo,Potito Starace,Tommy Robredo,6-4; 6-4; 6-4,R128,113,5,1,56,90,44,56,15,34,3,5,15,59,90,3,2,79,121,50,79,18,42,15,20,15,68,121
2004-06-21 00:00:00.000,Wimbledon England Grand Slams,GRASS,3,Dominik Hrbaty,David Sanchez,Dominik Hrbaty,6-2; 6-4; 6-2,R128,84,4,2,43,75,34,43,22,32,5,5,13,56,75,3,1,45,79,27,45,15,34,3,8,13,42,79
2004-06-21 00:00:00.000,Wimbledon England Grand Slams,GRASS,3,Mark Hilton,Albert Costa,Mark Hilton,6-1; 6-4; 6-3,R128,98,3,2,55,75,39,55,13,20,4,5,13,52,75,4,5,54,87,37,54,10,33,9,15,13,47,87
2004-06-21 00:00:00.000,Wimbledon England Grand Slams,GRASS,3,Julien Benneteau,Tomas Berdych,Julien Benneteau,6-3; 7-5; 6-4,R128,103,6,2,71,97,53,71,12,26,6,8,15,65,97,3,6,62,93,39,62,14,31,5,11,16,53,93
2004-06-21 00:00:00.000,Wimbledon England Grand Slams,GRASS,3,Mario Ancic,Luis Horna,Mario Ancic,6-7(5); 6-4; 6-3; 6-4,R128,148,17,5,79,115,69,79,19,36,3,4,21,88,115,1,5,100,135,67,100,19,35,9,13,20,86,135
2004-06-21 00:00:00.000,Wimbledon England Grand Slams,GRASS,3,Rainer Schuettler,Robin Soderling,Rainer Schuettler,4-6; 6-3; 7-6(5); 1-6; 6-2,R128,172,10,3,94,138,68,94,24,44,3,8,24,92,138,11,6,94,156,69,94,25,62,6,10,22,94,156
2004-06-21 00:00:00.000,Wimbledon England Grand Slams,GRASS,3,Greg Rusedski,Davide Sanguinetti,Greg Rusedski,7-5; 4-6; 6-2; 6-2,R128,118,20,5,59,103,50,59,30,44,6,7,19,80,103,6,7,77,118,54,77,17,41,5,10,19,71,118
2004-06-21 00:00:00.000,Wimbledon England Grand Slams,GRASS,3,Felix Mantilla,Kristian Pless,Felix Mantilla,7-6(5); 4-6; 7-5; 6-1,R128,157,4,8,77,137,56,77,29,60,9,12,21,85,137,19,13,75,150,55,75,31,75,13,18,20,86,150
2004-06-21 00:00:00.000,Wimbledon England Grand Slams,GRASS,3,Vincent Spadea,Todd Reid,Vincent Spadea,6-2; 6-4; 6-2,R128,96,8,6,48,90,37,48,23,42,4,5,13,60,90,2,1,71,97,39,71,11,26,7,13,13,50,97
2004-06-21 00:00:00.000,Wimbledon England Grand Slams,GRASS,3,Juan Ignacio Chela,Lars Burgsmuller,Juan Ignacio Chela,6-4; 4-6; 6-0; 6-2,R128,126,4,3,79,111,56,79,19,32,7,9,17,75,111,0,3,65,106,41,65,14,41,5,12,17,55,106
2004-06-21 00:00:00.000,Wimbledon England Grand Slams,GRASS,3,Thomas Enqvist,Galo Blanco,Thomas Enqvist,4-6; 7-6(2); 6-4; 7-6(1),R128,160,16,9,76,132,57,76,36,56,5,8,22,93,132,22,10,77,153,57,77,38,76,3,6,22,95,153
2004-06-21 00:00:00.000,Wimbledon England Grand Slams,GRASS,3,Todd Martin,Guillermo Canas,Todd Martin,4-6; 6-3; 7-6(1); 4-6; 9-7,R128,224,18,5,115,183,88,115,40,68,10,12,29,128,183,11,9,127,186,90,127,35,59,8,10,28,125,186
2004-06-21 00:00:00.000,Wimbledon England Grand Slams,GRASS,3,Sjeng Schalken,Lee Childs,Sjeng Schalken,6-2; 6-1; 6-3,R128,78,6,0,39,58,35,39,13,19,0,0,12,48,58,3,1,36,66,20,36,12,30,2,8,12,32,66
2004-06-21 00:00:00.000,Wimbledon England Grand Slams,GRASS,3,Alexander Popp,Nicolas Massu,Alexander Popp,6-2; 6-4; 6-4,R128,115,2,8,67,87,52,67,10,20,3,3,14,62,87,9,5,57,106,39,57,21,49,13,17,14,60,106
2004-06-21 00:00:00.000,Wimbledon England Grand Slams,GRASS,3,Albert Montanes,Bohdan Ulihrach,Albert Montanes,6-4; 6-2; 6-3,R128,67,5,1,41,63,38,41,15,22,0,0,13,53,63,5,11,37,81,29,37,19,44,2,7,14,48,81
2004-06-21 00:00:00.000,Wimbledon England Grand Slams,GRASS,3,Kenneth Carlsen,Richard Gasquet,Kenneth Carlsen,3-6; 7-6(5); 7-6(4); 6-7(0); 6-4,R128,234,16,9,117,184,84,117,38,67,12,15,27,122,184,7,13,119,210,86,119,49,91,11,14,28,135,210
2004-06-21 00:00:00.000,Wimbledon England Grand Slams,GRASS,3,Andrei Pavel,Andy Ram,Andrei Pavel,6-3; 7-5; 7-6(8),R128,124,3,0,72,102,54,72,20,30,3,4,17,74,102,17,0,64,104,48,64,20,40,2,5,16,68,104
2004-06-21 00:00:00.000,Wimbledon England Grand Slams,GRASS,3,Taylor Dent,Ramon Delgado,Taylor Dent,6-2; 6-3; 6-4,R128,98,11,4,67,94,51,67,14,27,4,4,14,65,94,3,2,57,78,39,57,6,21,2,6,13,45,78
2004-06-21 00:00:00.000,Wimbledon England Grand Slams,GRASS,3,Stefano Pescosolido,Dennis van Scheppingen,Stefano Pescosolido,4-6; 4-6; 6-4; 7-6(5); 10-8,R128,217,8,5,123,192,81,123,36,69,8,15,30,117,192,21,11,114,193,80,114,40,79,10,17,30,120,193
2004-06-21 00:00:00.000,Wimbledon England Grand Slams,GRASS,3,Alexander Peya,Jeff Salzenstein,Alexander Peya,6-2; 6-4; 6-2,R128,88,7,2,56,75,42,56,10,19,6,8,13,52,75,4,7,54,92,30,54,17,38,11,18,13,47,92
2004-06-21 00:00:00.000,Wimbledon England Grand Slams,GRASS,3,Andy Roddick,Jimmy Wang,Andy Roddick,6-3; 7-5; 6-4,R128,108,18,5,60,94,47,60,22,34,0,0,16,69,94,2,3,62,91,43,62,14,29,4,7,15,57,91
2004-06-21 00:00:00.000,Wimbledon England Grand Slams,GRASS,3,Roger Federer,Alejandro Falla,Roger Federer,6-1; 6-2; 6-0,R64,54,6,1,43,57,36,43,9,14,0,0,11,45,57,2,1,31,52,15,31,7,21,1,8,10,22,52
2004-06-21 00:00:00.000,Wimbledon England Grand Slams,GRASS,3,Thomas Johansson,Fabrice Santoro,Thomas Johansson,7-5; 6-2; 6-1,R64,94,6,0,49,79,39,49,14,30,1,3,14,53,79,5,1,45,78,26,45,11,33,4,11,13,37,78
2004-06-21 00:00:00.000,Wimbledon England Grand Slams,GRASS,3,Feliciano Lopez,Cyril Saulnier,Feliciano Lopez,3-6; 6-3; 6-4; 6-7(3); 8-6,R64,197,23,5,92,154,72,92,36,62,3,5,27,108,154,15,3,104,178,76,104,38,74,11,15,27,114,178
2004-06-21 00:00:00.000,Wimbledon England Grand Slams,GRASS,3,Ivo Karlovic,Gilles Elseneer,Ivo Karlovic,6-4; 6-4; 3-6; 7-6(14),R64,155,41,8,80,122,73,80,21,42,3,4,20,94,122,4,10,86,147,70,86,29,61,5,7,21,99,147
2004-06-21 00:00:00.000,Wimbledon England Grand Slams,GRASS,3,Carlos Moya,Radek Stepanek,Carlos Moya,6-4; 6-4; 6-7(5); 7-5,R64,156,14,5,74,119,65,74,29,45,1,2,22,94,119,7,6,90,126,69,90,17,36,3,7,22,86,126
2004-06-21 00:00:00.000,Wimbledon England Grand Slams,GRASS,3,Dmitry Tursunov,Sargis Sargsian,Dmitry Tursunov,6-3; 7-6(5); 3-6; 4-6; 15-13,R64,241,15,8,114,196,89,114,46,82,9,15,35,135,196,13,7,123,201,92,123,42,78,5,10,33,134,201
2004-06-21 00:00:00.000,Wimbledon England Grand Slams,GRASS,3,Goran Ivanisevic,Filippo Volandri,Goran Ivanisevic,4-6; 7-6(8); 1-6; 6-3; 6-4,R64,153,21,12,100,147,73,100,23,47,7,13,24,96,147,9,5,100,159,73,100,27,59,3,8,24,100,159
2004-06-21 00:00:00.000,Wimbledon England Grand Slams,GRASS,3,Lleyton Hewitt,Irakli Labadze,Lleyton Hewitt,6-4; 6-4; 6-1,R64,103,9,5,43,74,40,43,15,31,2,2,13,55,74,5,8,53,96,36,53,18,43,11,16,14,54,96
2004-06-21 00:00:00.000,Wimbledon England Grand Slams,GRASS,3,Florian Mayer,Guillermo Coria,Florian Mayer,4-6; 6-3; 6-3; 6-4,R64,145,7,2,76,112,49,76,22,36,4,8,19,71,112,7,8,93,147,63,93,19,54,11,18,19,82,147
2004-06-21 00:00:00.000,Wimbledon England Grand Slams,GRASS,3,Wayne Ferreira,Karol Kucera,Wayne Ferreira,7-6(3); 6-3; 6-1,R64,114,12,1,52,100,38,52,29,48,10,11,14,67,100,4,4,49,92,31,49,20,43,5,10,14,51,92
2004-06-21 00:00:00.000,Wimbledon England Grand Slams,GRASS,3,Jonas Bjorkman,Yen-Hsun Lu,Jonas Bjorkman,6-4; 6-3; 6-4,R64,115,8,2,46,87,32,46,27,41,4,6,15,59,87,6,4,61,93,40,61,13,32,6,11,14,53,93
2004-06-21 00:00:00.000,Wimbledon England Grand Slams,GRASS,3,Joachim Johansson,Mardy Fish,Joachim Johansson,6-7(8); 6-3; 6-4; 6-4,R64,151,27,4,83,123,69,83,20,40,4,5,21,89,123,25,4,86,138,62,86,24,52,7,11,20,86,138
2004-06-21 00:00:00.000,Wimbledon England Grand Slams,GRASS,3,Sebastien Grosjean,Gregory Carraz,Sebastien Grosjean,6-1; 6-2; 6-2,R64,83,12,0,41,61,35,41,13,20,0,0,12,48,61,6,4,49,77,25,49,11,28,7,13,11,36,77
2004-06-21 00:00:00.000,Wimbledon England Grand Slams,GRASS,3,Jan-Michael Gambill,Daniele Bracciali,Jan-Michael Gambill,6-7(4); 7-6(6); 6-3; 6-2,R64,170,20,1,74,119,55,74,25,45,1,5,21,80,119,9,7,76,144,51,76,30,68,9,16,20,81,144
2004-06-21 00:00:00.000,Wimbledon England Grand Slams,GRASS,3,Robby Ginepri,Fernando Verdasco,Robby Ginepri,6-7(3); 6-4; 6-4; 6-3,R64,139,11,1,83,131,60,83,30,48,9,10,20,90,131,8,9,76,131,56,76,25,55,4,9,21,81,131
2004-06-21 00:00:00.000,Wimbledon England Grand Slams,GRASS,3,Juan Carlos Ferrero,Stefan Koubek,Juan Carlos Ferrero,4-6; 7-5; 5-7; 7-6(6); 8-6,R64,220,2,5,138,202,93,138,39,64,12,16,30,132,202,10,0,118,179,87,118,36,61,6,10,30,123,179
2004-06-21 00:00:00.000,Wimbledon England Grand Slams,GRASS,3,Tim Henman,Ivo Heuberger,Tim Henman,7-5; 6-3; 6-2,R64,127,4,6,57,87,44,57,17,30,6,8,15,61,87,4,4,68,100,38,68,13,32,9,15,14,51,100
2004-06-21 00:00:00.000,Wimbledon England Grand Slams,GRASS,3,Hicham Arazi,David Ferrer,Hicham Arazi,6-7(5); 6-4; 6-3; 7-6(7),R64,195,6,0,94,142,62,94,30,48,8,13,22,92,142,10,5,112,163,73,112,22,51,12,19,21,95,163
2004-06-21 00:00:00.000,Wimbledon England Grand Slams,GRASS,3,Fernando Gonzalez,Igor Andreev,Fernando Gonzalez,7-5; 6-3; 5-7; 6-7(4); 6-3,R64,184,12,7,97,170,76,97,38,73,3,5,28,114,170,5,2,92,150,71,92,30,58,8,12,26,101,150
2004-06-21 00:00:00.000,Wimbledon England Grand Slams,GRASS,3,Mark Philippoussis,Martin Verkerk,Mark Philippoussis,4-6; 6-3; 7-6(5); 7-5,R64,136,25,8,72,114,63,72,25,42,1,3,22,88,114,23,7,75,112,63,75,18,37,1,4,21,81,112
2004-06-21 00:00:00.000,Wimbledon England Grand Slams,GRASS,3,Xavier Malisse,Tommy Haas,Xavier Malisse,3-6; 6-3; 6-2; 6-4,R64,128,16,2,51,97,46,51,25,46,4,6,18,71,97,3,7,68,117,48,68,20,49,3,8,18,68,117
2004-06-21 00:00:00.000,Wimbledon England Grand Slams,GRASS,3,Karol Beck,Tommy Robredo,Karol Beck,6-3; 6-2; 7-6(2),R64,112,6,4,57,97,43,57,25,40,11,13,15,68,97,4,0,76,106,40,76,17,30,7,12,14,57,106
2004-06-21 00:00:00.000,Wimbledon England Grand Slams,GRASS,3,Dominik Hrbaty,Mark Hilton,Dominik Hrbaty,7-5; 6-4; 6-2,R64,97,5,2,57,79,46,57,16,22,1,1,15,62,79,6,4,57,91,40,57,13,34,5,9,15,53,91
2004-06-21 00:00:00.000,Wimbledon England Grand Slams,GRASS,3,Mario Ancic,Julien Benneteau,Mario Ancic,4-6; 7-6(8); 6-2; 5-7; 6-4,R64,219,15,4,112,179,74,112,37,67,8,13,26,111,179,5,2,120,172,75,120,28,52,6,12,26,103,172
2004-06-21 00:00:00.000,Wimbledon England Grand Slams,GRASS,3,Rainer Schuettler,Greg Rusedski,Rainer Schuettler,6-7(5); 7-6(10); 6-7(5); 6-2; 6-2,R64,219,3,3,125,177,92,125,31,52,7,9,26,123,177,21,16,99,168,78,99,33,69,11,17,26,111,168
2004-06-21 00:00:00.000,Wimbledon England Grand Slams,GRASS,3,Vincent Spadea,Felix Mantilla,Vincent Spadea,6-1; 6-2; 6-2,R64,81,10,2,49,78,39,49,18,29,7,7,12,57,78,3,8,28,67,18,28,15,39,4,10,11,33,67
2004-06-21 00:00:00.000,Wimbledon England Grand Slams,GRASS,3,Thomas Enqvist,Juan Ignacio Chela,Thomas Enqvist,6-3; 6-7(4); 6-1; 3-6; 6-3,R64,159,9,5,75,139,56,75,43,64,3,5,24,99,139,8,2,110,152,72,110,25,42,10,15,22,97,152
2004-06-21 00:00:00.000,Wimbledon England Grand Slams,GRASS,3,Sjeng Schalken,Todd Martin,Sjeng Schalken,6-3; 6-2; 4-6; 6-3,R64,139,7,3,84,110,63,84,12,26,4,5,18,75,110,11,6,79,112,56,79,12,33,6,11,18,68,112
2004-06-21 00:00:00.000,Wimbledon England Grand Slams,GRASS,3,Alexander Popp,Albert Montanes,Alexander Popp,6-1; 6-0; 6-1,R64,62,5,2,38,52,30,38,8,14,0,1,10,38,52,0,3,39,63,14,39,8,24,4,13,10,22,63
2004-06-21 00:00:00.000,Wimbledon England Grand Slams,GRASS,3,Kenneth Carlsen,Andrei Pavel,Kenneth Carlsen,7-6(9); 6-4; 6-3,R64,120,18,3,65,96,58,65,13,31,0,1,16,71,96,6,1,92,115,57,92,12,23,5,8,15,69,115
2004-06-21 00:00:00.000,Wimbledon England Grand Slams,GRASS,3,Taylor Dent,Stefano Pescosolido,Taylor Dent,6-3; 6-3; 7-6(3),R64,109,9,10,56,92,41,56,21,36,3,6,15,62,92,1,8,69,103,43,69,13,34,9,15,15,56,103
2004-06-21 00:00:00.000,Wimbledon England Grand Slams,GRASS,3,Andy Roddick,Alexander Peya,Andy Roddick,6-3; 7-6(2); 6-4,R64,108,13,3,51,86,44,51,20,35,4,5,15,64,86,4,3,73,113,47,73,20,40,9,13,16,67,113
2004-06-21 00:00:00.000,Wimbledon England Grand Slams,GRASS,3,Roger Federer,Thomas Johansson,Roger Federer,6-3; 6-4; 6-3,R32,98,11,2,53,80,42,53,18,27,2,2,14,60,80,4,0,49,90,37,49,17,41,7,11,14,54,90
2004-06-21 00:00:00.000,Wimbledon England Grand Slams,GRASS,3,Ivo Karlovic,Feliciano Lopez,Ivo Karlovic,7-6(12); 7-6(3); 6-7(2); 7-5,R32,169,40,6,91,140,82,91,36,49,3,3,24,118,140,14,4,88,146,73,88,42,58,0,1,24,115,146
2004-06-21 00:00:00.000,Wimbledon England Grand Slams,GRASS,3,Carlos Moya,Dmitry Tursunov,Carlos Moya,6-1; 6-4; 7-5,R32,90,16,3,53,85,44,53,21,32,3,3,15,65,85,3,3,44,79,29,44,20,35,2,6,14,49,79
2004-06-21 00:00:00.000,Wimbledon England Grand Slams,GRASS,3,Lleyton Hewitt,Goran Ivanisevic,Lleyton Hewitt,6-2; 6-3; 6-4,R32,86,12,4,42,72,39,42,19,30,0,0,14,58,72,15,9,62,96,45,62,11,34,13,17,13,56,96
2004-06-21 00:00:00.000,Wimbledon England Grand Slams,GRASS,3,Florian Mayer,Wayne Ferreira,Florian Mayer,4-6; 6-4; 6-1; 6-4,R32,110,6,4,84,118,68,84,14,34,1,2,19,82,118,9,4,54,98,37,54,30,44,2,6,18,67,98
2004-06-21 00:00:00.000,Wimbledon England Grand Slams,GRASS,3,Joachim Johansson,Jonas Bjorkman,Joachim Johansson,6-7(5); 7-6(5); 7-6(6); 6-3,R32,182,39,4,98,148,83,98,27,50,3,3,23,110,148,20,9,97,146,79,97,23,49,5,6,22,102,146
2004-06-21 00:00:00.000,Wimbledon England Grand Slams,GRASS,3,Sebastien Grosjean,Jan-Michael Gambill,Sebastien Grosjean,7-6(5); 6-3; 6-2,R32,130,9,3,48,90,42,48,24,42,4,5,15,66,90,15,5,63,108,50,63,14,45,6,10,14,64,108
2004-06-21 00:00:00.000,Wimbledon England Grand Slams,GRASS,3,Robby Ginepri,Juan Carlos Ferrero,Robby Ginepri,6-3; 6-4; 6-1,R32,81,14,1,48,76,42,48,12,28,1,2,13,54,76,2,2,65,97,37,65,13,32,7,13,13,50,97
2004-06-21 00:00:00.000,Wimbledon England Grand Slams,GRASS,3,Tim Henman,Hicham Arazi,Tim Henman,7-6(6); 6-4; 3-6; 6-2,R32,165,7,5,72,118,56,72,20,46,7,11,19,76,118,6,3,84,125,55,84,18,41,6,12,20,73,125
2004-06-21 00:00:00.000,Wimbledon England Grand Slams,GRASS,3,Mark Philippoussis,Fernando Gonzalez,Mark Philippoussis,6-4; 6-1; 6-7(4); 7-5,R32,143,27,9,66,114,60,66,31,48,2,2,21,91,114,17,9,80,132,59,80,25,52,7,11,20,84,132
2004-06-21 00:00:00.000,Wimbledon England Grand Slams,GRASS,3,Xavier Malisse,Karol Beck,Xavier Malisse,6-3; 6-3; 6-4,R32,97,8,4,56,85,43,56,17,29,2,3,14,60,85,8,11,45,91,33,45,17,46,3,8,14,50,91
2004-06-21 00:00:00.000,Wimbledon England Grand Slams,GRASS,3,Mario Ancic,Dominik Hrbaty,Mario Ancic,7-5; 6-3; 7-5,R32,118,12,6,71,113,56,71,17,42,10,12,17,73,113,4,1,65,95,48,65,13,30,6,11,16,61,95
2004-06-21 00:00:00.000,Wimbledon England Grand Slams,GRASS,3,Vincent Spadea,Rainer Schuettler,Vincent Spadea,6-4; 6-2; 6-3,R32,107,3,3,49,90,34,49,24,41,7,10,14,58,90,0,5,45,73,25,45,9,28,2,9,13,34,73
2004-06-21 00:00:00.000,Wimbledon England Grand Slams,GRASS,3,Sjeng Schalken,Thomas Enqvist,Sjeng Schalken,5-7; 6-2; 3-6; 7-6(8); 6-2,R32,176,18,4,98,137,74,98,23,39,4,8,24,97,137,20,7,88,157,64,88,34,69,11,17,25,98,157
2004-06-21 00:00:00.000,Wimbledon England Grand Slams,GRASS,3,Alexander Popp,Kenneth Carlsen,Alexander Popp,7-5; 6-4; 6-4,R32,120,6,3,69,89,55,69,14,20,2,2,16,69,89,6,1,63,106,45,63,22,43,5,8,16,67,106
2004-06-21 00:00:00.000,Wimbledon England Grand Slams,GRASS,3,Andy Roddick,Taylor Dent,Andy Roddick,6-3; 7-6(6); 7-6(1),R32,110,16,1,67,99,57,67,23,32,1,1,17,80,99,6,3,77,111,56,77,18,34,5,6,16,74,111
2004-06-21 00:00:00.000,Wimbledon England Grand Slams,GRASS,3,Roger Federer,Ivo Karlovic,Roger Federer,6-3; 7-6(3); 7-6(5),R16,110,6,1,72,96,59,72,20,24,2,2,17,79,96,14,2,69,100,50,69,21,31,3,4,16,71,100
2004-06-21 00:00:00.000,Wimbledon England Grand Slams,GRASS,3,Lleyton Hewitt,Carlos Moya,Lleyton Hewitt,6-4; 6-2; 4-6; 7-6(3),R16,165,4,7,72,133,59,72,30,61,8,11,20,89,133,14,5,82,135,52,82,31,53,7,12,20,83,135
2004-06-21 00:00:00.000,Wimbledon England Grand Slams,GRASS,3,Florian Mayer,Joachim Johansson,Florian Mayer,6-3; 6-7(5); 7-6(5); 6-4,R16,138,24,2,86,123,75,86,22,37,0,0,22,97,123,23,10,89,130,74,89,21,41,5,7,21,95,130
2004-06-21 00:00:00.000,Wimbledon England Grand Slams,GRASS,3,Sebastien Grosjean,Robby Ginepri,Sebastien Grosjean,6-2; 6-2; 7-6(4),R16,122,14,1,63,98,43,63,21,35,6,8,14,64,98,4,2,74,112,45,74,16,38,6,12,14,61,112
2004-06-21 00:00:00.000,Wimbledon England Grand Slams,GRASS,3,Tim Henman,Mark Philippoussis,Tim Henman,6-2; 7-5; 6-7(3); 7-6(5),R16,187,22,5,89,137,68,89,29,48,3,4,22,97,137,22,7,95,142,66,95,23,47,2,6,22,89,142
2004-06-21 00:00:00.000,Wimbledon England Grand Slams,GRASS,3,Mario Ancic,Xavier Malisse,Mario Ancic,7-5; 3-1 RET,R16,60,7,2,38,54,28,38,7,16,0,2,8,35,54,1,1,27,42,16,27,6,15,7,11,8,22,42
2004-06-21 00:00:00.000,Wimbledon England Grand Slams,GRASS,3,Sjeng Schalken,Vincent Spadea,Sjeng Schalken,6-2; 7-5; 3-6; 6-2,R16,158,7,1,92,114,62,92,14,22,4,7,18,76,114,6,4,85,137,53,85,25,52,7,14,19,78,137
2004-06-21 00:00:00.000,Wimbledon England Grand Slams,GRASS,3,Andy Roddick,Alexander Popp,Andy Roddick,7-5; 6-4; 6-4,R16,116,11,0,63,90,49,63,13,27,1,3,16,62,90,3,2,80,114,50,80,17,34,9,14,16,67,114
2004-06-21 00:00:00.000,Wimbledon England Grand Slams,GRASS,3,Roger Federer,Lleyton Hewitt,Roger Federer,6-1; 6-7(1); 6-0; 6-4,Q,140,19,0,72,125,51,72,30,53,10,11,18,81,125,4,7,53,102,31,53,29,49,7,14,17,60,102
2004-06-21 00:00:00.000,Wimbledon England Grand Slams,GRASS,3,Sebastien Grosjean,Florian Mayer,Sebastien Grosjean,7-5; 6-4; 6-2,Q,110,6,3,53,103,39,53,27,50,8,10,15,66,103,1,1,58,89,37,58,13,31,7,13,15,50,89
2004-06-21 00:00:00.000,Wimbledon England Grand Slams,GRASS,3,Mario Ancic,Tim Henman,Mario Ancic,7-6(5); 6-4; 6-2,Q,133,12,5,60,98,44,60,24,38,1,2,15,68,98,5,6,63,91,44,63,13,28,4,8,15,57,91
2004-06-21 00:00:00.000,Wimbledon England Grand Slams,GRASS,3,Andy Roddick,Sjeng Schalken,Andy Roddick,7-6(4); 7-6(9); 6-3,Q,129,20,6,69,111,60,69,27,42,4,4,17,87,111,5,0,86,114,59,86,20,28,2,3,16,79,114
2004-06-21 00:00:00.000,Wimbledon England Grand Slams,GRASS,3,Roger Federer,Sebastien Grosjean,Roger Federer,6-2; 6-3; 7-6(6),S,120,6,3,54,91,41,54,20,37,1,2,14,61,91,2,2,62,106,39,62,17,44,6,11,15,56,106
2004-06-21 00:00:00.000,Wimbledon England Grand Slams,GRASS,3,Andy Roddick,Mario Ancic,Andy Roddick,6-4; 4-6; 7-5; 7-5,S,171,11,8,79,145,63,79,33,66,9,11,22,96,145,12,6,85,140,62,85,28,55,8,12,22,90,140
2004-06-21 00:00:00.000,Wimbledon England Grand Slams,GRASS,3,Roger Federer,Andy Roddick,Roger Federer,4-6; 7-5; 7-6(3); 6-4,F,151,12,3,95,154,64,95,34,59,10,14,22,98,154,11,5,81,133,60,81,21,52,5,10,22,81,133
2004-07-05 00:00:00.000,Bastad Sweden ATP World Tour,CLAY,2,Alberto Martin,Mikhail Youzhny,Alberto Martin,7-5; 6-3,R32,73,2,2,40,69,30,40,17,29,3,4,11,47,69,4,3,25,51,20,25,11,26,2,5,10,31,51
2004-07-05 00:00:00.000,Bastad Sweden ATP World Tour,CLAY,2,Filippo Volandri,Guillermo Canas,Filippo Volandri,4-6; 7-6(1); 6-4,R32,145,2,4,67,97,43,67,14,30,5,11,16,57,97,3,6,73,116,45,73,19,43,9,15,16,64,116
2004-07-05 00:00:00.000,Bastad Sweden ATP World Tour,CLAY,2,Irakli Labadze,Mathias Hellstrom,Irakli Labadze,4-6; 6-0; 6-0,R32,80,4,6,53,77,35,53,13,24,5,7,11,48,77,3,3,32,63,16,32,13,31,3,10,11,29,63
2004-07-05 00:00:00.000,Bastad Sweden ATP World Tour,CLAY,2,Mariano Zabaleta,Joachim Johansson,Mariano Zabaleta,6-4; 6-3,R32,78,1,3,32,52,24,32,12,20,1,2,9,36,52,4,3,36,65,21,36,17,29,4,8,10,38,65
2004-07-05 00:00:00.000,Bastad Sweden ATP World Tour,CLAY,2,Juan Monaco,Nicolas Massu,Juan Monaco,4-6; 6-3; 6-2,R32,123,0,2,52,79,37,52,13,27,4,7,14,50,79,2,4,55,93,36,55,16,38,7,12,13,52,93
2004-07-05 00:00:00.000,Bastad Sweden ATP World Tour,CLAY,2,Kristof Vliegen,Arnaud Di Pasquale,Kristof Vliegen,6-4; 6-2,R32,65,1,1,27,47,20,27,13,20,0,2,9,33,47,2,2,28,49,13,28,10,21,4,9,9,23,49
2004-07-05 00:00:00.000,Bastad Sweden ATP World Tour,CLAY,2,Jarkko Nieminen,Ervin Eleskovic,Jarkko Nieminen,6-0; 6-2,R32,55,1,2,26,43,20,26,10,17,1,1,7,30,43,0,3,24,45,14,24,6,21,6,11,7,20,45
2004-07-05 00:00:00.000,Bastad Sweden ATP World Tour,CLAY,2,Fernando Gonzalez,Luis Horna,Fernando Gonzalez,6-3; 6-2,R32,48,10,0,30,44,25,30,11,14,0,0,9,36,44,1,1,36,47,18,36,6,11,1,4,8,24,47
2004-07-05 00:00:00.000,Bastad Sweden ATP World Tour,CLAY,2,Tommy Robredo,Agustin Calleri,Tommy Robredo,4-6; 7-5; 6-4,R32,143,3,4,74,120,48,74,20,46,5,10,16,68,120,2,7,74,112,42,74,18,38,7,13,16,60,112
2004-07-05 00:00:00.000,Bastad Sweden ATP World Tour,CLAY,2,Robin Soderling,Boris Pashanski,Robin Soderling,7-6(4); 6-2,R32,85,6,0,42,56,28,42,10,14,2,4,10,38,56,2,6,44,81,25,44,16,37,5,9,10,41,81
2004-07-05 00:00:00.000,Bastad Sweden ATP World Tour,CLAY,2,Fernando Verdasco,Thomas Johansson,Fernando Verdasco,6-1; 6-4,R32,54,6,1,35,43,27,35,6,8,1,1,8,33,43,7,2,26,52,17,26,12,26,5,9,9,29,52
2004-07-05 00:00:00.000,Bastad Sweden ATP World Tour,CLAY,2,Juan Ignacio Chela,Marc Lopez,Juan Ignacio Chela,6-4; 6-0,R32,68,0,2,37,52,27,37,6,15,3,4,8,33,52,0,1,28,45,16,28,5,17,1,6,8,21,45
2004-07-05 00:00:00.000,Bastad Sweden ATP World Tour,CLAY,2,Santiago Ventura,Jonas Bjorkman,Santiago Ventura,6-2; 6-2,R32,53,4,1,30,44,23,30,11,14,2,2,8,34,44,0,5,25,44,15,25,8,19,1,5,8,23,44
2004-07-05 00:00:00.000,Bastad Sweden ATP World Tour,CLAY,2,Rafael Nadal,Jiri Vanek,Rafael Nadal,4-6; 6-4; 6-3,R32,118,0,2,69,86,42,69,10,17,6,11,15,52,86,0,4,50,88,31,50,15,38,3,9,14,46,88
2004-07-05 00:00:00.000,Bastad Sweden ATP World Tour,CLAY,2,Olivier Patience,Teymuraz Gabashvili,Olivier Patience,6-3; 4-6; 7-6(1),R32,145,9,4,66,110,45,66,17,44,6,12,16,62,110,7,6,64,113,45,64,13,49,7,13,15,58,113
2004-07-05 00:00:00.000,Bastad Sweden ATP World Tour,CLAY,2,Gaston Gaudio,Nikolay Davydenko,Gaston Gaudio,6-3; 6-1,R32,70,0,1,40,53,31,40,5,13,3,3,8,36,53,0,1,31,49,18,31,6,18,2,6,8,24,49
2004-07-05 00:00:00.000,Bastad Sweden ATP World Tour,CLAY,2,Alberto Martin,Filippo Volandri,Alberto Martin,5-7; 6-1; 6-4,R16,127,1,4,51,93,32,51,21,42,4,10,15,53,93,2,4,52,86,28,52,15,34,6,14,14,43,86
2004-07-05 00:00:00.000,Bastad Sweden ATP World Tour,CLAY,2,Mariano Zabaleta,Irakli Labadze,Mariano Zabaleta,6-4; 1-6; 6-3,R16,108,2,3,50,77,35,50,14,27,5,8,13,49,77,5,10,67,91,47,67,8,24,9,12,13,55,91
2004-07-05 00:00:00.000,Bastad Sweden ATP World Tour,CLAY,2,Juan Monaco,Kristof Vliegen,Juan Monaco,5-7; 6-4; 6-1,R16,105,2,1,56,76,37,56,15,20,2,5,15,52,76,3,5,45,81,31,45,15,36,3,8,14,46,81
2004-07-05 00:00:00.000,Bastad Sweden ATP World Tour,CLAY,2,Fernando Gonzalez,Jarkko Nieminen,Fernando Gonzalez,7-6(3); 6-1,R16,75,9,1,40,65,32,40,14,25,4,5,10,46,65,0,2,37,62,26,37,10,25,1,4,9,36,62
2004-07-05 00:00:00.000,Bastad Sweden ATP World Tour,CLAY,2,Robin Soderling,Tommy Robredo,Robin Soderling,6-0; 4-6; 6-3,R16,96,4,1,44,72,33,44,17,28,2,4,13,50,72,3,1,42,71,23,42,14,29,7,12,12,37,71
2004-07-05 00:00:00.000,Bastad Sweden ATP World Tour,CLAY,2,Juan Ignacio Chela,Fernando Verdasco,Juan Ignacio Chela,6-4; 7-5,R16,89,4,2,48,77,29,48,16,29,4,7,11,45,77,0,3,48,73,28,48,10,25,4,9,11,38,73
2004-07-05 00:00:00.000,Bastad Sweden ATP World Tour,CLAY,2,Rafael Nadal,Santiago Ventura,Rafael Nadal,6-1; 6-2,R16,59,0,2,31,40,25,31,7,9,0,0,8,32,40,5,4,27,58,19,27,9,31,6,10,7,28,58
2004-07-05 00:00:00.000,Bastad Sweden ATP World Tour,CLAY,2,Gaston Gaudio,Olivier Patience,Gaston Gaudio,4-6; 6-3; 6-2,R16,108,4,1,51,78,39,51,17,27,4,5,13,56,78,7,5,50,91,36,50,18,41,5,9,14,54,91
2004-07-05 00:00:00.000,Bastad Sweden ATP World Tour,CLAY,2,Mariano Zabaleta,Alberto Martin,Mariano Zabaleta,6-1; 6-2,Q,70,0,3,29,61,25,29,14,32,2,2,8,39,61,1,0,26,37,12,26,6,11,3,7,7,18,37
2004-07-05 00:00:00.000,Bastad Sweden ATP World Tour,CLAY,2,Fernando Gonzalez,Juan Monaco,Fernando Gonzalez,6-4; 6-4,Q,68,3,3,33,61,25,33,14,28,2,4,10,39,61,2,3,43,59,25,43,8,16,2,6,10,33,59
2004-07-05 00:00:00.000,Bastad Sweden ATP World Tour,CLAY,2,Robin Soderling,Juan Ignacio Chela,Robin Soderling,6-3; 6-7(5); 6-2,Q,133,5,0,67,107,45,67,26,40,9,10,15,71,107,3,3,59,91,41,59,13,32,3,7,14,54,91
2004-07-05 00:00:00.000,Bastad Sweden ATP World Tour,CLAY,2,Gaston Gaudio,Rafael Nadal,Gaston Gaudio,6-2; 6-3,Q,78,2,2,27,49,19,27,8,22,1,4,8,27,49,0,0,35,49,13,35,4,14,5,12,9,17,49
2004-07-05 00:00:00.000,Bastad Sweden ATP World Tour,CLAY,2,Mariano Zabaleta,Fernando Gonzalez,Mariano Zabaleta,6-1; 6-4,S,56,0,1,22,40,16,22,12,18,0,2,8,28,40,1,5,29,54,14,29,9,25,4,10,9,23,54
2004-07-05 00:00:00.000,Bastad Sweden ATP World Tour,CLAY,2,Gaston Gaudio,Robin Soderling,Gaston Gaudio,6-4; 6-2,S,59,4,0,37,49,30,37,6,12,0,0,9,36,49,5,2,36,50,26,36,5,14,3,6,9,31,50
2004-07-05 00:00:00.000,Bastad Sweden ATP World Tour,CLAY,2,Mariano Zabaleta,Gaston Gaudio,Mariano Zabaleta,6-1; 4-6; 7-6(4),F,138,5,2,51,86,36,51,14,35,2,7,14,50,86,2,5,66,109,41,66,16,43,10,17,15,57,109
2004-07-05 00:00:00.000,Gstaad Switzerland ATP World Tour,CLAY,2,Roger Federer,Tomas Behrend,Roger Federer,6-1; 6-1,R32,47,9,2,21,38,19,21,10,17,1,1,7,29,38,0,1,34,55,16,34,7,21,4,9,7,23,55
2004-07-05 00:00:00.000,Gstaad Switzerland ATP World Tour,CLAY,2,Ivo Karlovic,Oscar Hernandez,Ivo Karlovic,6-3; 6-7(6); 6-3,R32,128,24,2,54,91,50,54,22,37,0,0,16,72,91,2,2,74,121,51,74,24,47,7,9,14,75,121
2004-07-05 00:00:00.000,Gstaad Switzerland ATP World Tour,CLAY,2,Radek Stepanek,Ivo Heuberger,Radek Stepanek,6-4; 1-6; 6-3,R32,98,9,4,36,72,30,36,18,36,4,6,13,48,72,5,5,35,80,27,35,24,45,3,5,13,51,80
2004-07-05 00:00:00.000,Gstaad Switzerland ATP World Tour,CLAY,2,Marc Rosset,Andrei Pavel,Marc Rosset,7-6(5); 6-4,R32,94,18,10,56,86,47,56,9,30,6,7,11,56,86,3,1,58,72,41,58,6,14,2,4,11,47,72
2004-07-05 00:00:00.000,Gstaad Switzerland ATP World Tour,CLAY,2,Jiri Novak,Jose Acasuso,Jiri Novak,6-3; 6-3,R32,56,5,0,27,47,26,27,11,20,1,1,9,37,47,5,4,28,51,21,28,10,23,5,8,9,31,51
2004-07-05 00:00:00.000,Gstaad Switzerland ATP World Tour,CLAY,2,Albert Montanes,Marco Chiudinelli,Albert Montanes,6-7(5); 7-6(2); 6-4,R32,137,3,5,64,106,50,64,21,42,6,9,17,71,106,11,3,49,109,38,49,30,60,4,8,17,68,109
2004-07-05 00:00:00.000,Gstaad Switzerland ATP World Tour,CLAY,2,Victor Hanescu,Lars Burgsmuller,Victor Hanescu,7-6(4); 6-2,R32,81,9,2,38,55,31,38,11,17,1,2,10,42,55,5,3,52,80,32,52,13,28,6,9,10,45,80
2004-07-05 00:00:00.000,Gstaad Switzerland ATP World Tour,CLAY,2,Potito Starace,David Sanchez,Potito Starace,6-2; 3-6; 6-3,R32,115,0,1,74,88,47,74,5,14,5,8,13,52,88,3,2,56,94,35,56,17,38,4,9,13,52,94
2004-07-05 00:00:00.000,Gstaad Switzerland ATP World Tour,CLAY,2,David Ferrer,Tomas Berdych,David Ferrer,2-6; 6-3; 6-4,R32,107,0,2,44,73,28,44,18,29,2,5,13,46,73,5,6,49,91,36,49,19,42,3,7,14,55,91
2004-07-05 00:00:00.000,Gstaad Switzerland ATP World Tour,CLAY,2,Felix Mantilla,Christophe Rochus,Felix Mantilla,3-6; 6-2; 6-4,R32,112,7,4,33,78,25,33,23,45,4,7,13,48,78,1,0,56,91,33,56,18,35,5,10,14,51,91
2004-07-05 00:00:00.000,Gstaad Switzerland ATP World Tour,CLAY,2,Florian Mayer,Albert Portas,Florian Mayer,7-5; 6-3,R32,77,7,3,33,70,27,33,18,37,6,8,11,45,70,2,5,28,58,24,28,9,30,3,7,10,33,58
2004-07-05 00:00:00.000,Gstaad Switzerland ATP World Tour,CLAY,2,Rainer Schuettler,Michel Kratochvil,Rainer Schuettler,6-4; 1-6; 6-3,R32,111,4,4,43,90,31,43,24,47,7,10,13,55,90,1,9,35,85,25,35,25,50,6,9,13,50,85
2004-07-05 00:00:00.000,Gstaad Switzerland ATP World Tour,CLAY,2,Albert Costa,Bohdan Ulihrach,Albert Costa,6-4; 7-6(5),R32,93,4,1,38,68,25,38,23,30,0,1,11,48,68,10,5,33,71,27,33,19,38,5,7,11,46,71
2004-07-05 00:00:00.000,Gstaad Switzerland ATP World Tour,CLAY,2,Igor Andreev,Andreas Seppi,Igor Andreev,3-6; 6-4; 6-2,R32,109,6,1,47,90,32,47,28,43,8,9,13,60,90,1,1,51,93,36,51,22,42,7,10,14,58,93
2004-07-05 00:00:00.000,Gstaad Switzerland ATP World Tour,CLAY,2,Ruben Ramirez Hidalgo,Stanislas Wawrinka,Ruben Ramirez Hidalgo,7-6(5); 6-4,R32,95,3,3,38,69,32,38,18,31,3,3,11,50,69,5,5,33,75,27,33,23,42,2,3,11,50,75
2004-07-05 00:00:00.000,Gstaad Switzerland ATP World Tour,CLAY,2,Stefan Koubek,Juan Carlos Ferrero,Stefan Koubek,7-6(4); 6-4,R32,77,8,3,37,70,29,37,19,33,1,2,11,48,70,3,2,42,72,26,42,18,30,3,5,11,44,72
2004-07-05 00:00:00.000,Gstaad Switzerland ATP World Tour,CLAY,2,Roger Federer,Ivo Karlovic,Roger Federer,6-7(5); 6-3; 7-6(4),R16,114,8,0,63,98,52,63,26,35,0,0,17,78,98,15,6,64,105,54,64,23,41,3,4,16,77,105
2004-07-05 00:00:00.000,Gstaad Switzerland ATP World Tour,CLAY,2,Radek Stepanek,Marc Rosset,Radek Stepanek,4-6; 7-5; 6-3,R16,91,2,2,64,85,53,64,13,21,2,3,16,66,85,7,5,69,92,55,69,8,23,6,8,15,63,92
2004-07-05 00:00:00.000,Gstaad Switzerland ATP World Tour,CLAY,2,Jiri Novak,Albert Montanes,Jiri Novak,3-6; 6-3; 6-3,R16,82,10,2,42,68,34,42,10,26,3,7,13,44,68,4,4,45,77,30,45,13,32,8,14,14,43,77
2004-07-05 00:00:00.000,Gstaad Switzerland ATP World Tour,CLAY,2,Potito Starace,Victor Hanescu,Potito Starace,3-6; 7-6(3); 7-6(1),R16,132,6,0,85,103,59,85,12,18,5,8,16,71,103,9,3,81,121,55,81,20,40,3,5,17,75,121
2004-07-05 00:00:00.000,Gstaad Switzerland ATP World Tour,CLAY,2,Felix Mantilla,David Ferrer,Felix Mantilla,6-3; 7-6(2),R16,102,1,6,47,89,31,47,24,42,9,10,11,55,89,3,0,43,70,27,43,16,27,6,8,10,43,70
2004-07-05 00:00:00.000,Gstaad Switzerland ATP World Tour,CLAY,2,Rainer Schuettler,Florian Mayer,Rainer Schuettler,6-3; 6-2,R16,57,8,3,32,52,25,32,11,20,3,4,9,36,52,2,1,24,47,15,24,9,23,2,6,8,24,47
2004-07-05 00:00:00.000,Gstaad Switzerland ATP World Tour,CLAY,2,Igor Andreev,Albert Costa,Igor Andreev,6-2; 6-4,R16,83,3,5,34,54,28,34,10,20,5,6,9,38,54,5,2,41,70,26,41,11,29,8,12,9,37,70
2004-07-05 00:00:00.000,Gstaad Switzerland ATP World Tour,CLAY,2,Ruben Ramirez Hidalgo,Stefan Koubek,Ruben Ramirez Hidalgo,6-3; 6-4,R16,67,1,1,27,54,22,27,18,27,4,4,9,40,54,1,3,38,61,26,38,10,23,2,5,10,36,61
2004-07-05 00:00:00.000,Gstaad Switzerland ATP World Tour,CLAY,2,Roger Federer,Radek Stepanek,Roger Federer,6-1; 5-7; 6-4,Q,98,7,4,51,90,40,51,18,39,4,6,15,58,90,5,2,46,82,28,46,21,36,4,8,14,49,82
2004-07-05 00:00:00.000,Gstaad Switzerland ATP World Tour,CLAY,2,Potito Starace,Jiri Novak,Potito Starace,6-4; 6-3,Q,70,1,1,49,66,33,49,9,17,5,5,9,42,66,6,1,41,65,29,41,11,24,6,9,10,40,65
2004-07-05 00:00:00.000,Gstaad Switzerland ATP World Tour,CLAY,2,Rainer Schuettler,Felix Mantilla,Rainer Schuettler,6-1; 4-6; 6-2,Q,108,8,4,43,85,28,43,22,42,5,8,13,50,85,1,3,54,88,25,54,20,34,9,15,12,45,88
2004-07-05 00:00:00.000,Gstaad Switzerland ATP World Tour,CLAY,2,Igor Andreev,Ruben Ramirez Hidalgo,Igor Andreev,6-3; 6-4,Q,73,4,2,35,54,27,35,11,19,3,3,9,38,54,1,4,44,68,28,44,11,24,6,9,10,39,68
2004-07-05 00:00:00.000,Gstaad Switzerland ATP World Tour,CLAY,2,Roger Federer,Potito Starace,Roger Federer,6-3; 3-6; 6-3,S,91,7,1,49,77,38,49,19,28,3,4,14,57,77,2,1,68,88,44,68,11,20,7,9,13,55,88
2004-07-05 00:00:00.000,Gstaad Switzerland ATP World Tour,CLAY,2,Igor Andreev,Rainer Schuettler,Igor Andreev,6-2; 3-6; 7-6(6),S,111,1,1,65,88,43,65,15,23,0,2,14,58,88,5,5,46,92,35,46,23,46,2,5,15,58,92
2004-07-05 00:00:00.000,Gstaad Switzerland ATP World Tour,CLAY,2,Roger Federer,Igor Andreev,Roger Federer,6-2; 6-3; 5-7; 6-3,F,118,6,0,55,101,43,55,31,46,2,4,19,74,101,4,3,73,103,50,73,11,30,6,12,19,61,103
2004-07-05 00:00:00.000,Newport RI; U.S.A. ATP World Tour,GRASS,2,Vincent Spadea,Jeff Salzenstein,Vincent Spadea,6-3; 4-6; 6-3,R32,90,3,3,40,66,32,40,18,26,1,3,14,50,66,7,6,48,84,34,48,15,36,9,13,14,49,84
2004-07-05 00:00:00.000,Newport RI; U.S.A. ATP World Tour,GRASS,2,Brian Vahaly,Michal Mertinak,Brian Vahaly,6-2; 6-2,R32,63,0,3,30,53,18,30,14,23,2,3,8,32,53,2,4,25,52,14,25,8,27,4,9,8,22,52
2004-07-05 00:00:00.000,Newport RI; U.S.A. ATP World Tour,GRASS,2,Glenn Weiner,Alexander Peya,Glenn Weiner,7-6(4); 6-4,R32,84,8,4,38,65,31,38,12,27,1,3,11,43,65,3,4,49,83,33,49,16,34,6,9,11,49,83
2004-07-05 00:00:00.000,Newport RI; U.S.A. ATP World Tour,GRASS,2,Alexander Popp,Amer Delic,Alexander Popp,6-4; 6-3,R32,66,6,0,33,54,23,33,16,21,4,4,9,39,54,5,6,37,63,27,37,10,26,2,5,10,37,63
2004-07-05 00:00:00.000,Newport RI; U.S.A. ATP World Tour,GRASS,2,Jurgen Melzer,Jan Hernych,Jurgen Melzer,6-2; 6-4,R32,65,4,2,39,63,27,39,14,24,6,7,9,41,63,1,4,41,59,24,41,9,18,7,11,9,33,59
2004-07-05 00:00:00.000,Newport RI; U.S.A. ATP World Tour,GRASS,2,Nicolas Mahut,Jerome Golmard,Nicolas Mahut,6-2; 6-2,R32,53,10,1,25,45,22,25,12,20,1,1,8,34,45,8,5,27,53,15,27,11,26,6,10,8,26,53
2004-07-05 00:00:00.000,Newport RI; U.S.A. ATP World Tour,GRASS,2,Gilles Elseneer,Rajeev Ram,Gilles Elseneer,6-2; 6-3,R32,59,3,1,36,55,28,36,12,19,0,0,9,40,55,2,3,24,46,16,24,10,22,1,4,8,26,46
2004-07-05 00:00:00.000,Newport RI; U.S.A. ATP World Tour,GRASS,2,Cyril Saulnier,Justin Gimelstob,Cyril Saulnier,6-1; 3-6; 6-1,R32,100,8,6,43,81,33,43,19,38,7,8,12,52,81,11,6,45,77,29,45,14,32,8,12,11,43,77
2004-07-05 00:00:00.000,Newport RI; U.S.A. ATP World Tour,GRASS,2,Jeff Morrison,Jan-Michael Gambill,Jeff Morrison,6-2; 6-7(5); 6-3,R32,97,10,3,51,81,46,51,21,30,1,1,15,67,81,8,5,41,82,36,41,19,41,3,6,14,55,82
2004-07-05 00:00:00.000,Newport RI; U.S.A. ATP World Tour,GRASS,2,Brian Baker,Wesley Moodie,Brian Baker,6-2; 6-7(4); 7-6(2),R32,121,7,8,71,109,53,71,20,38,7,9,16,73,109,11,6,67,96,48,67,14,29,1,5,16,62,96
2004-07-05 00:00:00.000,Newport RI; U.S.A. ATP World Tour,GRASS,2,Kenneth Carlsen,Todd Reid,Kenneth Carlsen,6-1; 2-6; 7-6(4),R32,94,10,1,45,73,35,45,16,28,0,2,13,51,73,9,3,70,97,49,70,11,27,4,7,14,60,97
2004-07-05 00:00:00.000,Newport RI; U.S.A. ATP World Tour,GRASS,2,Greg Rusedski,Gregory Carraz,Greg Rusedski,6-1; 4-6; 6-3,R32,89,12,6,38,68,34,38,18,30,2,3,13,52,68,12,12,50,90,36,50,14,40,4,8,13,50,90
2004-07-05 00:00:00.000,Newport RI; U.S.A. ATP World Tour,GRASS,2,Antony Dupuis,Jan Vacek,Antony Dupuis,6-2; 6-3,R32,63,6,1,36,48,29,36,8,12,1,1,9,37,48,3,1,37,63,19,37,15,26,3,6,8,34,63
2004-07-05 00:00:00.000,Newport RI; U.S.A. ATP World Tour,GRASS,2,Davide Sanguinetti,Robert Kendrick,Davide Sanguinetti,3-6; 6-2; 6-3,R32,95,7,7,41,87,32,41,26,46,8,9,13,58,87,13,10,34,83,31,34,20,49,6,9,13,51,83
2004-07-05 00:00:00.000,Newport RI; U.S.A. ATP World Tour,GRASS,2,Alex Bogomolov Jr.,Harel Levy,Alex Bogomolov Jr.,6-3; 6-3,R32,68,0,1,46,62,32,46,7,16,4,5,9,39,62,1,1,51,78,31,51,10,27,8,12,9,41,78
2004-07-05 00:00:00.000,Newport RI; U.S.A. ATP World Tour,GRASS,2,James Blake,Dick Norman,James Blake,7-6(7); 6-3,R32,78,4,1,36,65,27,36,23,29,0,1,11,50,65,9,5,41,71,31,41,13,30,5,7,10,44,71
2004-07-05 00:00:00.000,Newport RI; U.S.A. ATP World Tour,GRASS,2,Vincent Spadea,Brian Vahaly,Vincent Spadea,6-1; 7-6(5),R16,89,5,4,49,89,34,49,18,40,5,7,10,52,89,0,7,32,57,19,32,10,25,1,5,9,29,57
2004-07-05 00:00:00.000,Newport RI; U.S.A. ATP World Tour,GRASS,2,Alexander Popp,Glenn Weiner,Alexander Popp,6-1; 6-3,R16,51,3,1,27,42,23,27,10,15,1,1,8,33,42,3,6,25,46,18,25,6,21,1,5,8,24,46
2004-07-05 00:00:00.000,Newport RI; U.S.A. ATP World Tour,GRASS,2,Jurgen Melzer,Nicolas Mahut,Jurgen Melzer,6-3; 6-1,R16,59,2,2,23,42,16,23,14,19,3,4,8,30,42,2,5,34,62,20,34,8,28,3,8,8,28,62
2004-07-05 00:00:00.000,Newport RI; U.S.A. ATP World Tour,GRASS,2,Cyril Saulnier,Gilles Elseneer,Cyril Saulnier,5-7; 6-3; 7-6(3),R16,163,9,4,68,121,49,68,24,53,7,11,17,73,121,11,9,92,140,62,92,18,48,21,25,16,80,140
2004-07-05 00:00:00.000,Newport RI; U.S.A. ATP World Tour,GRASS,2,Jeff Morrison,Brian Baker,Jeff Morrison,6-3; 6-3,R16,79,9,4,36,60,28,36,14,24,3,3,9,42,60,2,12,51,81,33,51,12,30,7,10,9,45,81
2004-07-05 00:00:00.000,Newport RI; U.S.A. ATP World Tour,GRASS,2,Greg Rusedski,Kenneth Carlsen,Greg Rusedski,4-6; 7-6(5); 7-6(6),R16,133,18,9,67,113,50,67,33,46,4,5,17,83,113,11,8,81,121,69,81,17,40,3,3,17,86,121
2004-07-05 00:00:00.000,Newport RI; U.S.A. ATP World Tour,GRASS,2,Antony Dupuis,Davide Sanguinetti,Antony Dupuis,6-3; 6-4,R16,81,5,3,31,52,26,31,13,21,0,1,10,39,52,7,2,47,74,30,47,12,27,6,9,9,42,74
2004-07-05 00:00:00.000,Newport RI; U.S.A. ATP World Tour,GRASS,2,Alex Bogomolov Jr.,James Blake,Alex Bogomolov Jr.,6-3; 6-1,R16,53,0,1,35,43,23,35,6,8,1,2,8,29,43,7,5,30,53,19,30,5,23,6,11,8,24,53
2004-07-05 00:00:00.000,Newport RI; U.S.A. ATP World Tour,GRASS,2,Alexander Popp,Vincent Spadea,Alexander Popp,6-2; 6-2,Q,57,1,2,35,50,26,35,11,15,2,2,8,37,50,0,4,29,52,19,29,8,23,1,5,8,27,52
2004-07-05 00:00:00.000,Newport RI; U.S.A. ATP World Tour,GRASS,2,Cyril Saulnier,Jurgen Melzer,Cyril Saulnier,6-1; 7-5,Q,59,14,1,40,54,33,40,4,14,0,2,10,37,54,4,4,24,54,17,24,9,30,4,9,9,26,54
2004-07-05 00:00:00.000,Newport RI; U.S.A. ATP World Tour,GRASS,2,Greg Rusedski,Jeff Morrison,Greg Rusedski,7-6(5); 7-5,Q,81,9,2,45,69,35,45,14,24,0,1,12,49,69,8,4,53,78,39,53,11,25,1,3,12,50,78
2004-07-05 00:00:00.000,Newport RI; U.S.A. ATP World Tour,GRASS,2,Antony Dupuis,Alex Bogomolov Jr.,Antony Dupuis,6-4; 2-6; 6-3,Q,110,7,1,43,71,30,43,16,28,0,3,13,46,71,3,2,77,102,48,77,10,25,8,12,14,58,102
2004-07-05 00:00:00.000,Newport RI; U.S.A. ATP World Tour,GRASS,2,Alexander Popp,Cyril Saulnier,Alexander Popp,6-4; 7-6(5),S,83,5,2,53,75,35,53,13,22,6,8,11,48,75,2,1,47,63,30,47,11,16,3,6,11,41,63
2004-07-05 00:00:00.000,Newport RI; U.S.A. ATP World Tour,GRASS,2,Greg Rusedski,Antony Dupuis,Greg Rusedski,7-5; 7-6(10),S,95,13,7,52,74,45,52,12,22,0,0,12,57,74,6,0,59,79,42,59,14,20,2,3,12,56,79
2004-07-05 00:00:00.000,Newport RI; U.S.A. ATP World Tour,GRASS,2,Greg Rusedski,Alexander Popp,Greg Rusedski,7-6(5); 7-6(2),F,108,11,9,48,87,42,48,21,39,4,4,12,63,87,4,1,56,87,40,56,22,31,3,3,12,62,87
2004-07-12 00:00:00.000,Amersfoort The Netherlands ATP World Tour,CLAY,2,Nicolas Massu,Kristof Vliegen,Nicolas Massu,6-3; 6-4,R32,76,2,0,29,58,24,29,15,29,2,4,10,39,58,4,4,34,58,24,34,8,24,7,11,9,32,58
2004-07-12 00:00:00.000,Amersfoort The Netherlands ATP World Tour,CLAY,2,Raemon Sluiter,Nicolas Thomann,Raemon Sluiter,6-1; 6-3,R32,48,9,0,27,39,23,27,10,12,0,0,8,33,39,6,3,25,53,17,25,9,28,5,9,8,26,53
2004-07-12 00:00:00.000,Amersfoort The Netherlands ATP World Tour,CLAY,2,Albert Portas,Olivier Rochus,Albert Portas,6-3; 7-6(2),R32,89,2,2,50,75,33,50,14,25,3,6,11,47,75,2,2,45,76,29,45,12,31,8,12,10,41,76
2004-07-12 00:00:00.000,Amersfoort The Netherlands ATP World Tour,CLAY,2,Tomas Behrend,Albert Montanes,Tomas Behrend,6-3; 6-0,R32,54,5,1,30,44,24,30,7,14,6,6,7,31,44,3,2,33,49,20,33,3,16,5,10,8,23,49
2004-07-12 00:00:00.000,Amersfoort The Netherlands ATP World Tour,CLAY,2,Martin Verkerk,Melle Van Gemerden,Martin Verkerk,6-4; 3-6; 6-1,R32,108,9,3,44,75,34,44,18,31,3,4,13,52,75,5,4,40,81,28,40,21,41,4,7,13,49,81
2004-07-12 00:00:00.000,Amersfoort The Netherlands ATP World Tour,CLAY,2,Adrian Garcia,Marc Rosset,Adrian Garcia,7-5; 6-1,R32,67,2,3,30,53,26,30,11,23,3,4,9,37,53,3,2,34,62,21,34,12,28,5,10,10,33,62
2004-07-12 00:00:00.000,Amersfoort The Netherlands ATP World Tour,CLAY,2,Jean-Rene Lisnard,Peter Wessels,Jean-Rene Lisnard,2-6; 6-3; 6-3,R32,98,2,6,47,79,34,47,12,32,4,8,13,46,79,6,3,58,87,40,58,6,29,4,9,13,46,87
2004-07-12 00:00:00.000,Amersfoort The Netherlands ATP World Tour,CLAY,2,David Sanchez,Michal Przysiezny,David Sanchez,6-4; 6-4,R32,105,5,0,44,63,33,44,6,19,7,10,10,39,63,1,0,47,77,30,47,8,30,12,17,10,38,77
2004-07-12 00:00:00.000,Amersfoort The Netherlands ATP World Tour,CLAY,2,Alberto Martin,Nick Van Der Meer,Alberto Martin,6-0; 6-4,R32,58,2,2,22,43,22,22,11,21,2,2,8,33,43,1,2,29,53,15,29,12,24,4,8,8,27,53
2004-07-12 00:00:00.000,Amersfoort The Netherlands ATP World Tour,CLAY,2,Peter Luczak,John van Lottum,Peter Luczak,6-4; 4-6; 6-2,R32,120,9,5,57,88,41,57,10,31,5,9,14,51,88,1,5,59,105,33,59,21,46,12,18,14,54,105
2004-07-12 00:00:00.000,Amersfoort The Netherlands ATP World Tour,CLAY,2,Dennis van Scheppingen,Jiri Vanek,Dennis van Scheppingen,6-3; 2-6; 6-4,R32,106,4,5,52,87,34,52,18,35,8,12,14,52,87,6,3,61,99,40,61,15,38,11,15,13,55,99
2004-07-12 00:00:00.000,Amersfoort The Netherlands ATP World Tour,CLAY,2,Alejandro Falla,Luis Horna,Alejandro Falla,6-2; 6-1,R32,46,4,1,28,38,22,28,7,10,1,1,7,29,38,1,3,30,53,16,30,9,23,2,7,8,25,53
2004-07-12 00:00:00.000,Amersfoort The Netherlands ATP World Tour,CLAY,2,Igor Andreev,Ruben Ramirez Hidalgo,Igor Andreev,6-2; 6-2,R32,50,11,1,30,43,23,30,10,13,0,0,8,33,43,2,0,32,46,18,32,6,14,2,6,8,24,46
2004-07-12 00:00:00.000,Amersfoort The Netherlands ATP World Tour,CLAY,2,Christophe Rochus,Flavio Saretta,Christophe Rochus,7-5; 6-3,R32,107,2,1,47,71,30,47,12,24,5,8,10,42,71,0,3,60,96,34,60,14,36,14,20,11,48,96
2004-07-12 00:00:00.000,Amersfoort The Netherlands ATP World Tour,CLAY,2,Oscar Hernandez,Olivier Mutis,Oscar Hernandez,6-1; 6-3,R32,53,3,0,23,40,21,23,13,17,0,0,8,34,40,3,0,34,49,19,34,7,15,3,7,8,26,49
2004-07-12 00:00:00.000,Amersfoort The Netherlands ATP World Tour,CLAY,2,Fernando Gonzalez,Jose Acasuso,Fernando Gonzalez,4-6; 6-4; 6-1,R32,89,9,2,56,83,43,56,12,27,8,10,14,55,83,2,5,33,71,24,33,20,38,5,9,13,44,71
2004-07-12 00:00:00.000,Amersfoort The Netherlands ATP World Tour,CLAY,2,Nicolas Massu,Raemon Sluiter,Nicolas Massu,6-4; 7-6(4),R16,100,2,0,49,78,33,49,15,29,5,7,11,48,78,3,1,34,53,23,34,12,19,0,3,11,35,53
2004-07-12 00:00:00.000,Amersfoort The Netherlands ATP World Tour,CLAY,2,Tomas Behrend,Albert Portas,Tomas Behrend,6-2; 5-7; 6-2,R16,107,14,3,65,90,44,65,14,25,0,2,14,58,90,7,4,54,82,33,54,13,28,2,7,14,46,82
2004-07-12 00:00:00.000,Amersfoort The Netherlands ATP World Tour,CLAY,2,Martin Verkerk,Adrian Garcia,Martin Verkerk,6-7(5); 7-6(4); 6-2,R16,143,12,10,56,101,40,56,21,45,4,9,16,61,101,4,1,74,109,41,74,19,35,7,14,16,60,109
2004-07-12 00:00:00.000,Amersfoort The Netherlands ATP World Tour,CLAY,2,David Sanchez,Jean-Rene Lisnard,David Sanchez,6-2; 3-6; 6-3,R16,144,6,2,77,101,50,77,12,24,9,11,13,62,101,2,5,44,94,31,44,24,50,6,10,13,55,94
2004-07-12 00:00:00.000,Amersfoort The Netherlands ATP World Tour,CLAY,2,Alberto Martin,Peter Luczak,Alberto Martin,6-4; 4-6; 7-6(6),R16,153,2,3,61,101,43,61,25,40,5,8,16,68,101,4,6,65,111,43,65,26,46,9,12,16,69,111
2004-07-12 00:00:00.000,Amersfoort The Netherlands ATP World Tour,CLAY,2,Dennis van Scheppingen,Alejandro Falla,Dennis van Scheppingen,6-2; 6-0,R16,46,4,5,32,52,26,32,8,20,2,2,7,34,52,2,3,31,49,19,31,4,18,3,8,7,23,49
2004-07-12 00:00:00.000,Amersfoort The Netherlands ATP World Tour,CLAY,2,Igor Andreev,Christophe Rochus,Igor Andreev,4-6; 6-2; 6-1,R16,80,6,5,48,71,33,48,12,23,4,7,12,45,71,2,2,53,76,24,53,14,23,1,8,13,38,76
2004-07-12 00:00:00.000,Amersfoort The Netherlands ATP World Tour,CLAY,2,Fernando Gonzalez,Oscar Hernandez,Fernando Gonzalez,7-5; 6-3,R16,72,7,4,41,67,32,41,15,26,3,4,11,47,67,4,2,47,59,31,47,4,12,1,4,10,35,59
2004-07-12 00:00:00.000,Amersfoort The Netherlands ATP World Tour,CLAY,2,Nicolas Massu,Tomas Behrend,Nicolas Massu,6-2; 6-3,Q,87,2,2,28,48,20,28,11,20,2,4,9,31,48,0,3,53,80,26,53,12,27,8,13,8,38,80
2004-07-12 00:00:00.000,Amersfoort The Netherlands ATP World Tour,CLAY,2,Martin Verkerk,David Sanchez,Martin Verkerk,1-6; 7-6(2); 6-4,Q,127,14,0,53,94,36,53,23,41,7,11,14,59,94,4,3,60,94,40,60,19,34,4,7,15,59,94
2004-07-12 00:00:00.000,Amersfoort The Netherlands ATP World Tour,CLAY,2,Dennis van Scheppingen,Alberto Martin,Dennis van Scheppingen,6-4; 6-2,Q,68,2,3,36,60,27,36,10,24,5,6,9,37,60,3,0,41,57,24,41,7,16,4,8,9,31,57
2004-07-12 00:00:00.000,Amersfoort The Netherlands ATP World Tour,CLAY,2,Fernando Gonzalez,Igor Andreev,Fernando Gonzalez,6-3; 7-5,Q,69,11,4,40,63,31,40,13,23,1,2,11,44,63,2,1,36,61,24,36,12,25,1,4,10,36,61
2004-07-12 00:00:00.000,Amersfoort The Netherlands ATP World Tour,CLAY,2,Martin Verkerk,Nicolas Massu,Martin Verkerk,6-3; 6-7(4); 6-3,S,140,18,5,67,99,55,67,17,32,2,2,16,72,99,8,1,51,87,40,51,19,36,3,5,14,59,87
2004-07-12 00:00:00.000,Amersfoort The Netherlands ATP World Tour,CLAY,2,Fernando Gonzalez,Dennis van Scheppingen,Fernando Gonzalez,7-6(5); 6-4,S,94,13,6,31,72,24,31,25,41,0,1,11,49,72,4,2,42,78,32,42,16,36,3,5,11,48,78
2004-07-12 00:00:00.000,Amersfoort The Netherlands ATP World Tour,CLAY,2,Martin Verkerk,Fernando Gonzalez,Martin Verkerk,7-6(5); 4-6; 6-4,F,138,12,2,72,109,57,72,22,37,7,8,16,79,109,6,4,73,107,58,73,17,34,5,6,16,75,107
2004-07-12 00:00:00.000,Los Angeles CA; U.S.A. ATP World Tour,HARD,2,Andre Agassi,Alex Bogomolov Jr.,Andre Agassi,6-3; 6-1,R32,54,6,4,37,61,29,37,12,24,4,4,8,41,61,3,3,31,43,15,31,6,12,1,5,8,21,43
2004-07-12 00:00:00.000,Los Angeles CA; U.S.A. ATP World Tour,HARD,2,Julien Benneteau,Mark Philippoussis,Julien Benneteau,6-1; 7-5,R32,82,4,3,41,61,31,41,9,20,2,3,9,40,61,10,7,34,69,22,34,11,35,4,9,10,33,69
2004-07-12 00:00:00.000,Los Angeles CA; U.S.A. ATP World Tour,HARD,2,Kenneth Carlsen,Wayne Arthurs,Kenneth Carlsen,7-6(3); 6-3,R32,90,13,2,38,67,29,38,20,29,0,0,11,49,67,17,5,42,80,33,42,17,38,7,8,10,50,80
2004-07-12 00:00:00.000,Los Angeles CA; U.S.A. ATP World Tour,HARD,2,Tommy Haas,Robby Ginepri,Tommy Haas,6-4; 6-3,R32,67,8,4,27,53,23,27,9,26,3,5,9,32,53,5,5,36,63,22,36,11,27,2,7,10,33,63
2004-07-12 00:00:00.000,Los Angeles CA; U.S.A. ATP World Tour,HARD,2,Mardy Fish,Jan Vacek,Mardy Fish,7-6(5); 6-2,R32,86,9,3,30,66,22,30,20,36,2,4,10,42,66,0,3,38,66,23,38,14,28,3,7,10,37,66
2004-07-12 00:00:00.000,Los Angeles CA; U.S.A. ATP World Tour,HARD,2,Gilles Elseneer,Brian Vahaly,Gilles Elseneer,2-6; 6-4; 7-5,R32,104,8,8,43,78,34,43,15,35,4,9,15,49,78,0,7,59,104,37,59,25,45,7,12,15,62,104
2004-07-12 00:00:00.000,Los Angeles CA; U.S.A. ATP World Tour,HARD,2,Jan Hernych,Antony Dupuis,Jan Hernych,6-4; 6-7(0); 6-4,R32,134,7,9,51,89,36,51,19,38,4,7,16,55,89,6,7,57,106,41,57,23,49,3,8,16,64,106
2004-07-12 00:00:00.000,Los Angeles CA; U.S.A. ATP World Tour,HARD,2,Cyril Saulnier,Vincent Spadea,Cyril Saulnier,6-4 RET,R32,37,0,1,12,27,10,12,10,15,0,0,5,20,27,3,1,19,30,12,19,6,11,1,2,5,18,30
2004-07-12 00:00:00.000,Los Angeles CA; U.S.A. ATP World Tour,HARD,2,Greg Rusedski,Taylor Dent,Greg Rusedski,7-6(7); 3-6; 6-2,R32,115,9,4,52,98,37,52,26,46,5,8,15,63,98,9,5,72,96,50,72,10,24,6,9,14,60,96
2004-07-12 00:00:00.000,Los Angeles CA; U.S.A. ATP World Tour,HARD,2,Karol Beck,Andy Ram,Karol Beck,4-6; 7-6(1); 6-4,R32,145,1,10,54,113,43,54,27,59,6,10,16,70,113,8,6,54,107,38,54,25,53,3,7,16,63,107
2004-07-12 00:00:00.000,Los Angeles CA; U.S.A. ATP World Tour,HARD,2,Glenn Weiner,Hyung-Taik Lee,Glenn Weiner,3-6; 7-5; 6-3,R32,110,8,5,47,88,38,47,24,41,3,4,15,62,88,3,1,46,83,33,46,23,37,0,2,15,56,83
2004-07-12 00:00:00.000,Los Angeles CA; U.S.A. ATP World Tour,HARD,2,Nicolas Kiefer,Dominik Hrbaty,Nicolas Kiefer,7-6(0); 4-6; 6-2,R32,133,5,4,56,114,41,56,28,58,7,11,15,69,114,2,1,55,85,32,55,17,30,3,8,15,49,85
2004-07-12 00:00:00.000,Los Angeles CA; U.S.A. ATP World Tour,HARD,2,Sjeng Schalken,Gregory Carraz,Sjeng Schalken,6-4; 6-4,R32,75,3,2,31,54,25,31,16,23,0,0,10,41,54,6,12,30,64,26,30,14,34,6,8,10,40,64
2004-07-12 00:00:00.000,Los Angeles CA; U.S.A. ATP World Tour,HARD,2,Wesley Moodie,Zack Fleishman,Wesley Moodie,6-4; 6-2,R32,51,10,1,34,43,28,34,8,9,0,0,9,36,43,5,4,31,54,25,31,7,23,4,7,9,32,54
2004-07-12 00:00:00.000,Los Angeles CA; U.S.A. ATP World Tour,HARD,2,Jeff Morrison,Lester Cook,Jeff Morrison,6-2; 6-2,R32,51,9,2,25,41,22,25,10,16,0,0,8,32,41,0,4,26,49,13,26,11,23,4,8,8,24,49
2004-07-12 00:00:00.000,Los Angeles CA; U.S.A. ATP World Tour,HARD,2,Paradorn Srichaphan,Wayne Ferreira,Paradorn Srichaphan,6-3; 7-6(4),R32,83,2,2,46,79,38,46,19,33,4,4,11,57,79,2,3,42,64,31,42,12,22,2,3,10,43,64
2004-07-12 00:00:00.000,Los Angeles CA; U.S.A. ATP World Tour,HARD,2,Andre Agassi,Julien Benneteau,Andre Agassi,7-6(4); 6-2,R16,75,5,1,39,59,32,39,10,20,1,2,10,42,59,6,5,36,61,22,36,14,25,0,3,10,36,61
2004-07-12 00:00:00.000,Los Angeles CA; U.S.A. ATP World Tour,HARD,2,Tommy Haas,Kenneth Carlsen,Tommy Haas,6-2; 6-0,R16,65,1,3,20,44,19,20,12,24,3,3,7,31,44,5,1,24,51,15,24,8,27,4,9,7,23,51
2004-07-12 00:00:00.000,Los Angeles CA; U.S.A. ATP World Tour,HARD,2,Mardy Fish,Gilles Elseneer,Mardy Fish,6-2; 3-6; 6-3,R16,86,9,4,42,72,33,42,17,30,3,4,13,50,72,9,1,52,68,37,52,8,16,1,4,13,45,68
2004-07-12 00:00:00.000,Los Angeles CA; U.S.A. ATP World Tour,HARD,2,Cyril Saulnier,Jan Hernych,Cyril Saulnier,6-3; 6-7(5); 6-3,R16,133,15,1,51,99,43,51,26,48,3,4,16,69,99,2,3,74,103,48,74,15,29,5,8,14,63,103
2004-07-12 00:00:00.000,Los Angeles CA; U.S.A. ATP World Tour,HARD,2,Greg Rusedski,Karol Beck,Greg Rusedski,3-6; 6-3; 7-6(2),R16,107,16,10,65,102,51,65,18,37,10,12,15,69,102,6,7,48,86,41,48,19,38,0,2,15,60,86
2004-07-12 00:00:00.000,Los Angeles CA; U.S.A. ATP World Tour,HARD,2,Nicolas Kiefer,Glenn Weiner,Nicolas Kiefer,6-4; 7-5,R16,93,7,1,32,60,23,32,15,28,0,2,11,38,60,7,5,41,80,29,41,16,39,4,8,11,45,80
2004-07-12 00:00:00.000,Los Angeles CA; U.S.A. ATP World Tour,HARD,2,Wesley Moodie,Sjeng Schalken,Wesley Moodie,7-6(5); 2-6; 7-5,R16,124,9,6,60,90,44,60,16,30,2,6,16,60,90,5,4,69,96,51,69,14,27,3,6,16,65,96
2004-07-12 00:00:00.000,Los Angeles CA; U.S.A. ATP World Tour,HARD,2,Jeff Morrison,Paradorn Srichaphan,Jeff Morrison,7-5; 6-4,R16,81,18,4,47,71,39,47,12,24,1,1,11,51,71,6,4,40,66,27,40,14,26,1,3,11,41,66
2004-07-12 00:00:00.000,Los Angeles CA; U.S.A. ATP World Tour,HARD,2,Tommy Haas,Andre Agassi,Tommy Haas,7-6(5); 6-7(6); 6-3,Q,143,20,5,61,109,50,61,20,48,6,10,17,70,109,10,2,58,109,38,58,29,51,7,12,16,67,109
2004-07-12 00:00:00.000,Los Angeles CA; U.S.A. ATP World Tour,HARD,2,Cyril Saulnier,Mardy Fish,Cyril Saulnier,7-6(6); 7-6(7),Q,114,11,3,47,83,35,47,21,36,6,8,12,56,83,10,6,45,86,37,45,16,41,2,4,12,53,86
2004-07-12 00:00:00.000,Los Angeles CA; U.S.A. ATP World Tour,HARD,2,Nicolas Kiefer,Greg Rusedski,Nicolas Kiefer,6-1; 6-4,Q,60,6,2,32,51,27,32,10,19,0,0,9,37,51,4,3,32,51,19,32,9,19,3,6,8,28,51
2004-07-12 00:00:00.000,Los Angeles CA; U.S.A. ATP World Tour,HARD,2,Jeff Morrison,Wesley Moodie,Jeff Morrison,6-3; 6-4,Q,67,4,2,31,56,26,31,12,25,2,3,10,38,56,8,3,37,57,25,37,7,20,3,6,9,32,57
2004-07-12 00:00:00.000,Los Angeles CA; U.S.A. ATP World Tour,HARD,2,Tommy Haas,Cyril Saulnier,Tommy Haas,7-5; 7-5,S,122,6,3,50,88,40,50,21,38,8,8,12,61,88,6,2,44,83,33,44,20,39,3,5,12,53,83
2004-07-12 00:00:00.000,Los Angeles CA; U.S.A. ATP World Tour,HARD,2,Nicolas Kiefer,Jeff Morrison,Nicolas Kiefer,3-6; 6-2; 6-4,S,109,5,1,41,77,26,41,23,36,4,7,14,49,77,12,6,52,86,35,52,17,34,5,9,13,52,86
2004-07-12 00:00:00.000,Los Angeles CA; U.S.A. ATP World Tour,HARD,2,Tommy Haas,Nicolas Kiefer,Tommy Haas,7-6(6); 6-4,F,106,6,1,51,79,36,51,16,28,5,6,11,52,79,9,5,39,72,32,39,14,33,4,6,11,46,72
2004-07-12 00:00:00.000,Stuttgart Germany ATP World Tour,CLAY,2,Rainer Schuettler,N/A Bye,Rainer Schuettler,,R64,0,0,0,0,0,0,0,0,0,0,0,0,0,0,0,0,0,0,0,0,0,0,0,0,0,0,0
2004-07-12 00:00:00.000,Stuttgart Germany ATP World Tour,CLAY,2,Radek Stepanek,Juan-Pablo Guzman,Radek Stepanek,7-6(4); 6-3,R64,83,4,3,41,71,34,41,18,30,3,3,11,52,71,1,0,43,63,30,43,13,20,5,6,10,43,63
2004-07-12 00:00:00.000,Stuttgart Germany ATP World Tour,CLAY,2,Franco Squillari,Nicolas Almagro,Franco Squillari,6-3; 7-6(1),R64,92,2,3,48,83,31,48,26,35,4,4,11,57,83,5,1,41,64,31,41,11,23,1,2,10,42,64
2004-07-12 00:00:00.000,Stuttgart Germany ATP World Tour,CLAY,2,Ivo Karlovic,N/A Bye,Ivo Karlovic,,R64,0,0,0,0,0,0,0,0,0,0,0,0,0,0,0,0,0,0,0,0,0,0,0,0,0,0,0
2004-07-12 00:00:00.000,Stuttgart Germany ATP World Tour,CLAY,2,Florian Mayer,N/A Bye,Florian Mayer,,R64,0,0,0,0,0,0,0,0,0,0,0,0,0,0,0,0,0,0,0,0,0,0,0,0,0,0,0
2004-07-12 00:00:00.000,Stuttgart Germany ATP World Tour,CLAY,2,Guillermo Canas,Dick Norman,Guillermo Canas,6-0; 7-5,R64,57,6,4,27,45,24,27,12,18,0,0,9,36,45,3,5,34,61,18,34,14,27,4,8,9,32,61
2004-07-12 00:00:00.000,Stuttgart Germany ATP World Tour,CLAY,2,Stefan Koubek,Olivier Patience,Stefan Koubek,6-2; 7-6(5),R64,70,5,3,38,57,32,38,12,19,0,1,10,44,57,3,3,35,64,24,35,14,29,0,3,10,38,64
2004-07-12 00:00:00.000,Stuttgart Germany ATP World Tour,CLAY,2,Feliciano Lopez,N/A Bye,Feliciano Lopez,,R64,0,0,0,0,0,0,0,0,0,0,0,0,0,0,0,0,0,0,0,0,0,0,0,0,0,0,0
2004-07-12 00:00:00.000,Stuttgart Germany ATP World Tour,CLAY,2,Andrei Pavel,N/A Bye,Andrei Pavel,,R64,0,0,0,0,0,0,0,0,0,0,0,0,0,0,0,0,0,0,0,0,0,0,0,0,0,0,0
2004-07-12 00:00:00.000,Stuttgart Germany ATP World Tour,CLAY,2,Bohdan Ulihrach,Victor Hanescu,Bohdan Ulihrach,7-6(3); 4-1 RET,R64,69,2,2,32,56,23,32,12,24,3,5,9,35,56,7,3,38,61,23,38,9,23,3,6,8,32,61
2004-07-12 00:00:00.000,Stuttgart Germany ATP World Tour,CLAY,2,Andreas Beck,Alexander Peya,Andreas Beck,7-6(2); 6-1,R64,81,1,3,35,59,24,35,12,24,0,2,10,36,59,2,5,39,71,22,39,12,32,7,11,9,34,71
2004-07-12 00:00:00.000,Stuttgart Germany ATP World Tour,CLAY,2,Nikolay Davydenko,N/A Bye,Nikolay Davydenko,,R64,0,0,0,0,0,0,0,0,0,0,0,0,0,0,0,0,0,0,0,0,0,0,0,0,0,0,0
2004-07-12 00:00:00.000,Stuttgart Germany ATP World Tour,CLAY,2,Albert Costa,N/A Bye,Albert Costa,,R64,0,0,0,0,0,0,0,0,0,0,0,0,0,0,0,0,0,0,0,0,0,0,0,0,0,0,0
2004-07-12 00:00:00.000,Stuttgart Germany ATP World Tour,CLAY,2,Felix Mantilla,Jerome Haehnel,Felix Mantilla,6-7(1); 6-2; 6-2,R64,116,5,3,47,79,33,47,19,32,2,5,14,52,79,5,2,74,113,42,74,17,39,15,22,14,59,113
2004-07-12 00:00:00.000,Stuttgart Germany ATP World Tour,CLAY,2,Marc Lopez,Daniel Elsner,Marc Lopez,6-1; 6-7(5); 6-3,R64,114,1,1,57,97,37,57,19,40,5,9,15,56,97,0,4,44,70,21,44,11,26,2,9,13,32,70
2004-07-12 00:00:00.000,Stuttgart Germany ATP World Tour,CLAY,2,Mariano Zabaleta,N/A Bye,Mariano Zabaleta,,R64,0,0,0,0,0,0,0,0,0,0,0,0,0,0,0,0,0,0,0,0,0,0,0,0,0,0,0
2004-07-12 00:00:00.000,Stuttgart Germany ATP World Tour,CLAY,2,Tommy Robredo,N/A Bye,Tommy Robredo,,R64,0,0,0,0,0,0,0,0,0,0,0,0,0,0,0,0,0,0,0,0,0,0,0,0,0,0,0
2004-07-12 00:00:00.000,Stuttgart Germany ATP World Tour,CLAY,2,Richard Gasquet,Edouard Roger-Vasselin,Richard Gasquet,6-2; 6-4,R64,72,5,2,22,51,17,22,19,29,2,3,9,36,51,1,4,46,62,25,46,6,16,4,8,9,31,62
2004-07-12 00:00:00.000,Stuttgart Germany ATP World Tour,CLAY,2,Arnaud Di Pasquale,Galo Blanco,Arnaud Di Pasquale,6-3; 6-1,R64,61,2,4,27,46,22,27,8,19,3,4,8,30,46,3,5,27,49,17,27,5,22,3,8,8,22,49
2004-07-12 00:00:00.000,Stuttgart Germany ATP World Tour,CLAY,2,David Ferrer,N/A Bye,David Ferrer,,R64,0,0,0,0,0,0,0,0,0,0,0,0,0,0,0,0,0,0,0,0,0,0,0,0,0,0,0
2004-07-12 00:00:00.000,Stuttgart Germany ATP World Tour,CLAY,2,Rafael Nadal,N/A Bye,Rafael Nadal,,R64,0,0,0,0,0,0,0,0,0,0,0,0,0,0,0,0,0,0,0,0,0,0,0,0,0,0,0
2004-07-12 00:00:00.000,Stuttgart Germany ATP World Tour,CLAY,2,Martin Vassallo Arguello,Philipp Kohlschreiber,Martin Vassallo Arguello,6-3; 3-6; 6-2,R64,115,1,9,65,101,46,65,15,36,11,13,13,61,101,1,4,34,69,19,34,22,35,4,8,13,41,69
2004-07-12 00:00:00.000,Stuttgart Germany ATP World Tour,CLAY,2,Jan Frode Andersen,Lars Burgsmuller,Jan Frode Andersen,6-4; 6-2,R64,99,3,2,44,66,31,44,12,22,5,5,9,43,66,4,1,35,58,24,35,9,23,5,8,9,33,58
2004-07-12 00:00:00.000,Stuttgart Germany ATP World Tour,CLAY,2,Juan Ignacio Chela,N/A Bye,Juan Ignacio Chela,,R64,0,0,0,0,0,0,0,0,0,0,0,0,0,0,0,0,0,0,0,0,0,0,0,0,0,0,0
2004-07-12 00:00:00.000,Stuttgart Germany ATP World Tour,CLAY,2,Jiri Novak,N/A Bye,Jiri Novak,,R64,0,0,0,0,0,0,0,0,0,0,0,0,0,0,0,0,0,0,0,0,0,0,0,0,0,0,0
2004-07-12 00:00:00.000,Stuttgart Germany ATP World Tour,CLAY,2,Thierry Ascione,Tomas Zib,Thierry Ascione,6-3; 7-6(8),R64,81,7,3,54,74,44,54,12,20,3,3,11,56,74,6,0,34,61,24,34,21,27,0,1,10,45,61
2004-07-12 00:00:00.000,Stuttgart Germany ATP World Tour,CLAY,2,Alexander Popp,Alexander Waske,Alexander Popp,6-2; 1-6; 6-1,R64,84,0,2,48,63,36,48,6,15,4,6,11,42,63,5,3,37,69,26,37,16,32,4,8,11,42,69
2004-07-12 00:00:00.000,Stuttgart Germany ATP World Tour,CLAY,2,Mikhail Youzhny,N/A Bye,Mikhail Youzhny,,R64,0,0,0,0,0,0,0,0,0,0,0,0,0,0,0,0,0,0,0,0,0,0,0,0,0,0,0
2004-07-12 00:00:00.000,Stuttgart Germany ATP World Tour,CLAY,2,Tomas Berdych,N/A Bye,Tomas Berdych,,R64,0,0,0,0,0,0,0,0,0,0,0,0,0,0,0,0,0,0,0,0,0,0,0,0,0,0,0
2004-07-12 00:00:00.000,Stuttgart Germany ATP World Tour,CLAY,2,Bjorn Phau,Ivo Heuberger,Bjorn Phau,6-3; 6-2,R64,63,1,2,23,47,19,23,15,24,3,3,8,34,47,4,3,31,57,19,31,11,26,4,8,9,30,57
2004-07-12 00:00:00.000,Stuttgart Germany ATP World Tour,CLAY,2,Hugo Armando,Sebastian Rieschick,Hugo Armando,6-1; 6-4,R64,59,2,2,28,56,23,28,13,28,0,1,9,36,56,1,5,27,50,19,27,6,23,3,7,8,25,50
2004-07-12 00:00:00.000,Stuttgart Germany ATP World Tour,CLAY,2,Gaston Gaudio,N/A Bye,Gaston Gaudio,,R64,0,0,0,0,0,0,0,0,0,0,0,0,0,0,0,0,0,0,0,0,0,0,0,0,0,0,0
2004-07-12 00:00:00.000,Stuttgart Germany ATP World Tour,CLAY,2,Radek Stepanek,Rainer Schuettler,Radek Stepanek,6-7(6); 6-3; 6-2,R32,119,8,2,60,100,47,60,20,40,4,4,15,67,100,4,2,45,85,33,45,23,40,0,3,14,56,85
2004-07-12 00:00:00.000,Stuttgart Germany ATP World Tour,CLAY,2,Ivo Karlovic,Franco Squillari,Ivo Karlovic,6-3; 7-6(0),R32,78,13,2,50,72,41,50,12,22,4,4,11,53,72,2,4,35,53,28,35,9,18,1,2,10,37,53
2004-07-12 00:00:00.000,Stuttgart Germany ATP World Tour,CLAY,2,Guillermo Canas,Florian Mayer,Guillermo Canas,6-7(3); 7-6(5); 6-4,R32,178,5,3,57,113,38,57,29,56,8,13,17,67,113,2,7,77,138,46,77,30,61,12,18,17,76,138
2004-07-12 00:00:00.000,Stuttgart Germany ATP World Tour,CLAY,2,Stefan Koubek,Feliciano Lopez,Stefan Koubek,6-3; 6-4,R32,63,2,1,39,51,32,39,9,12,0,0,10,41,51,1,1,32,63,24,32,14,31,6,8,9,38,63
2004-07-12 00:00:00.000,Stuttgart Germany ATP World Tour,CLAY,2,Andrei Pavel,Bohdan Ulihrach,Andrei Pavel,6-1; 6-1,R32,43,3,0,27,40,20,27,9,13,3,3,7,29,40,1,2,28,45,12,28,7,17,4,9,7,19,45
2004-07-12 00:00:00.000,Stuttgart Germany ATP World Tour,CLAY,2,Nikolay Davydenko,Andreas Beck,Nikolay Davydenko,6-3; 6-3,R32,75,4,3,33,57,23,33,15,24,5,6,9,38,57,0,1,32,51,18,32,10,19,0,4,9,28,51
2004-07-12 00:00:00.000,Stuttgart Germany ATP World Tour,CLAY,2,Albert Costa,Felix Mantilla,Albert Costa,7-5; 6-4,R32,92,5,0,43,68,32,43,16,25,0,0,11,48,68,7,2,33,67,24,33,21,34,6,8,11,45,67
2004-07-12 00:00:00.000,Stuttgart Germany ATP World Tour,CLAY,2,Mariano Zabaleta,Marc Lopez,Mariano Zabaleta,7-6(2); 6-2,R32,89,5,2,37,63,27,37,17,26,1,2,10,44,63,1,0,42,65,28,42,11,23,1,4,10,39,65
2004-07-12 00:00:00.000,Stuttgart Germany ATP World Tour,CLAY,2,Richard Gasquet,Tommy Robredo,Richard Gasquet,6-1; 6-4,R32,62,4,3,28,52,22,28,14,24,1,2,9,36,52,2,2,35,54,21,35,7,19,4,8,8,28,54
2004-07-12 00:00:00.000,Stuttgart Germany ATP World Tour,CLAY,2,David Ferrer,Arnaud Di Pasquale,David Ferrer,6-4; 1-6; 6-1,R32,93,2,1,47,72,29,47,14,25,1,5,12,43,72,3,5,42,65,24,42,11,23,2,7,12,35,65
2004-07-12 00:00:00.000,Stuttgart Germany ATP World Tour,CLAY,2,Rafael Nadal,Martin Vassallo Arguello,Rafael Nadal,7-6(4); 6-4,R32,128,1,3,50,85,32,50,15,35,7,12,11,47,85,4,9,51,85,33,51,10,34,8,14,11,43,85
2004-07-12 00:00:00.000,Stuttgart Germany ATP World Tour,CLAY,2,Juan Ignacio Chela,Jan Frode Andersen,Juan Ignacio Chela,6-3; 6-1,R32,62,4,2,29,50,19,29,14,21,3,4,8,33,50,0,3,33,46,15,33,5,13,0,5,8,20,46
2004-07-12 00:00:00.000,Stuttgart Germany ATP World Tour,CLAY,2,Jiri Novak,Thierry Ascione,Jiri Novak,6-2; 6-4,R32,54,3,1,29,47,23,29,10,18,3,5,9,33,47,1,2,34,52,19,34,6,18,0,5,9,25,52
2004-07-12 00:00:00.000,Stuttgart Germany ATP World Tour,CLAY,2,Mikhail Youzhny,Alexander Popp,Mikhail Youzhny,6-3; 7-6(7),R32,88,6,2,42,85,31,42,25,43,8,9,11,56,85,3,6,42,63,31,42,10,21,1,3,10,41,63
2004-07-12 00:00:00.000,Stuttgart Germany ATP World Tour,CLAY,2,Tomas Berdych,Bjorn Phau,Tomas Berdych,6-2; 6-3,R32,51,7,1,29,48,24,29,13,19,0,0,9,37,48,0,1,26,43,17,26,6,17,2,5,8,23,43
2004-07-12 00:00:00.000,Stuttgart Germany ATP World Tour,CLAY,2,Gaston Gaudio,Hugo Armando,Gaston Gaudio,3-6; 6-2; 7-6(5),R32,140,7,2,53,95,40,53,22,42,4,6,14,62,95,3,3,75,122,49,75,23,47,8,11,15,72,122
2004-07-12 00:00:00.000,Stuttgart Germany ATP World Tour,CLAY,2,Radek Stepanek,Ivo Karlovic,Radek Stepanek,6-2; 7-5,R16,71,3,2,42,64,29,42,13,22,3,4,10,42,64,8,2,38,59,24,38,7,21,1,5,10,31,59
2004-07-12 00:00:00.000,Stuttgart Germany ATP World Tour,CLAY,2,Guillermo Canas,Stefan Koubek,Guillermo Canas,6-4; 6-2,R16,81,1,5,30,60,23,30,16,30,3,4,9,39,60,0,2,34,49,17,34,8,15,4,8,9,25,49
2004-07-12 00:00:00.000,Stuttgart Germany ATP World Tour,CLAY,2,Nikolay Davydenko,Andrei Pavel,Nikolay Davydenko,7-5; 1-6; 6-4,R16,111,2,0,39,71,27,39,17,32,5,10,14,44,71,2,0,70,100,43,70,12,30,12,17,15,55,100
2004-07-12 00:00:00.000,Stuttgart Germany ATP World Tour,CLAY,2,Albert Costa,Mariano Zabaleta,Albert Costa,7-5; 7-6(4),R16,123,1,1,61,86,43,61,13,25,3,5,12,56,86,3,2,54,89,34,54,19,35,6,9,12,53,89
2004-07-12 00:00:00.000,Stuttgart Germany ATP World Tour,CLAY,2,David Ferrer,Richard Gasquet,David Ferrer,6-4; 6-2,R16,78,0,0,36,56,25,36,14,20,1,1,9,39,56,1,1,25,59,19,25,14,34,3,6,9,33,59
2004-07-12 00:00:00.000,Stuttgart Germany ATP World Tour,CLAY,2,Rafael Nadal,Juan Ignacio Chela,Rafael Nadal,6-2; 6-3,R16,76,3,1,25,52,20,25,19,27,0,0,9,39,52,2,4,29,50,20,29,8,21,1,4,8,28,50
2004-07-12 00:00:00.000,Stuttgart Germany ATP World Tour,CLAY,2,Jiri Novak,Mikhail Youzhny,Jiri Novak,7-6(4); 4-6; 6-1,R16,110,6,2,59,98,46,59,19,39,5,8,15,65,98,5,5,53,106,35,53,28,53,6,10,14,63,106
2004-07-12 00:00:00.000,Stuttgart Germany ATP World Tour,CLAY,2,Gaston Gaudio,Tomas Berdych,Gaston Gaudio,6-2; 6-4,R16,66,2,1,31,48,26,31,12,17,0,0,9,38,48,3,4,30,62,20,30,14,32,7,10,9,34,62
2004-07-12 00:00:00.000,Stuttgart Germany ATP World Tour,CLAY,2,Guillermo Canas,Radek Stepanek,Guillermo Canas,6-4; 6-4,Q,74,4,1,33,53,28,33,14,20,0,0,10,42,53,3,3,36,63,21,36,16,27,2,4,10,37,63
2004-07-12 00:00:00.000,Stuttgart Germany ATP World Tour,CLAY,2,Nikolay Davydenko,Albert Costa,Nikolay Davydenko,6-3; 6-4,Q,90,4,1,43,67,26,43,13,24,7,10,10,39,67,0,0,42,57,20,42,7,15,3,8,9,27,57
2004-07-12 00:00:00.000,Stuttgart Germany ATP World Tour,CLAY,2,David Ferrer,Rafael Nadal,David Ferrer,6-3; 6-7(3); 7-5,Q,146,3,3,70,112,47,70,19,42,2,6,17,66,112,2,1,76,104,44,76,15,28,7,13,16,59,104
2004-07-12 00:00:00.000,Stuttgart Germany ATP World Tour,CLAY,2,Gaston Gaudio,Jiri Novak,Gaston Gaudio,6-4; 6-3,Q,71,2,3,39,56,27,39,10,17,1,2,9,37,56,6,1,33,54,21,33,10,21,1,5,10,31,54
2004-07-12 00:00:00.000,Stuttgart Germany ATP World Tour,CLAY,2,Guillermo Canas,Nikolay Davydenko,Guillermo Canas,3-6; 6-1; 6-2,S,118,1,0,41,63,28,41,15,22,4,7,12,43,63,3,0,59,87,33,59,11,28,10,16,12,44,87
2004-07-12 00:00:00.000,Stuttgart Germany ATP World Tour,CLAY,2,Gaston Gaudio,David Ferrer,Gaston Gaudio,6-3; 5-7; 6-4,S,143,1,2,61,96,36,61,19,35,7,12,15,55,96,5,3,59,102,35,59,21,43,7,14,16,56,102
2004-07-12 00:00:00.000,Stuttgart Germany ATP World Tour,CLAY,2,Guillermo Canas,Gaston Gaudio,Guillermo Canas,5-7; 6-2; 6-0; 1-6; 6-3,F,220,14,6,85,141,57,85,24,56,12,19,21,81,141,1,1,93,142,53,93,19,49,10,20,21,72,142
2004-07-19 00:00:00.000,Indianapolis IN; U.S.A. ATP World Tour,HARD,2,Andy Roddick,N/A Bye,Andy Roddick,,R64,0,0,0,0,0,0,0,0,0,0,0,0,0,0,0,0,0,0,0,0,0,0,0,0,0,0,0
2004-07-19 00:00:00.000,Indianapolis IN; U.S.A. ATP World Tour,HARD,2,Michel Kratochvil,Jan Vacek,Michel Kratochvil,6-2; 5-7; 6-3,R64,113,13,4,42,82,36,42,23,40,5,7,15,59,82,8,3,40,87,32,40,22,47,5,9,14,54,87
2004-07-19 00:00:00.000,Indianapolis IN; U.S.A. ATP World Tour,HARD,2,Sebastien De Chaunac,Antony Dupuis,Sebastien De Chaunac,2-6; 7-5; 6-4,R64,131,12,11,43,94,31,43,26,51,3,7,15,57,94,4,8,44,93,36,44,18,49,7,11,15,54,93
2004-07-19 00:00:00.000,Indianapolis IN; U.S.A. ATP World Tour,HARD,2,Robby Ginepri,N/A Bye,Robby Ginepri,,R64,0,0,0,0,0,0,0,0,0,0,0,0,0,0,0,0,0,0,0,0,0,0,0,0,0,0,0
2004-07-19 00:00:00.000,Indianapolis IN; U.S.A. ATP World Tour,HARD,2,Joachim Johansson,N/A Bye,Joachim Johansson,,R64,0,0,0,0,0,0,0,0,0,0,0,0,0,0,0,0,0,0,0,0,0,0,0,0,0,0,0
2004-07-19 00:00:00.000,Indianapolis IN; U.S.A. ATP World Tour,HARD,2,Greg Rusedski,Thomas Johansson,Greg Rusedski,7-6(5); 6-7(3); 6-4,R64,136,19,12,66,116,57,66,24,50,5,6,17,81,116,14,3,70,113,57,70,21,43,3,5,17,78,113
2004-07-19 00:00:00.000,Indianapolis IN; U.S.A. ATP World Tour,HARD,2,Fabrice Santoro,Hyung-Taik Lee,Fabrice Santoro,6-3; 4-6; 6-4,R64,113,5,0,43,80,33,43,23,37,1,3,14,56,80,4,4,49,88,34,49,21,39,1,5,15,55,88
2004-07-19 00:00:00.000,Indianapolis IN; U.S.A. ATP World Tour,HARD,2,Dominik Hrbaty,N/A Bye,Dominik Hrbaty,,R64,0,0,0,0,0,0,0,0,0,0,0,0,0,0,0,0,0,0,0,0,0,0,0,0,0,0,0
2004-07-19 00:00:00.000,Indianapolis IN; U.S.A. ATP World Tour,HARD,2,Sebastien Grosjean,N/A Bye,Sebastien Grosjean,,R64,0,0,0,0,0,0,0,0,0,0,0,0,0,0,0,0,0,0,0,0,0,0,0,0,0,0,0
2004-07-19 00:00:00.000,Indianapolis IN; U.S.A. ATP World Tour,HARD,2,Julien Jeanpierre,Gilles Elseneer,Julien Jeanpierre,6-3; 3-6; 6-3,R64,90,7,2,53,77,41,53,14,24,0,1,14,55,77,6,3,51,80,37,51,16,29,10,12,13,53,80
2004-07-19 00:00:00.000,Indianapolis IN; U.S.A. ATP World Tour,HARD,2,Jeff Morrison,Julien Benneteau,Jeff Morrison,6-4; 7-6(6),R64,80,12,3,41,69,33,41,18,28,1,2,11,51,69,2,5,45,65,36,45,8,20,2,4,11,44,65
2004-07-19 00:00:00.000,Indianapolis IN; U.S.A. ATP World Tour,HARD,2,Xavier Malisse,N/A Bye,Xavier Malisse,,R64,0,0,0,0,0,0,0,0,0,0,0,0,0,0,0,0,0,0,0,0,0,0,0,0,0,0,0
2004-07-19 00:00:00.000,Indianapolis IN; U.S.A. ATP World Tour,HARD,2,Ivan Ljubicic,N/A Bye,Ivan Ljubicic,,R64,0,0,0,0,0,0,0,0,0,0,0,0,0,0,0,0,0,0,0,0,0,0,0,0,0,0,0
2004-07-19 00:00:00.000,Indianapolis IN; U.S.A. ATP World Tour,HARD,2,Rajeev Ram,Wesley Moodie,Rajeev Ram,6-7(3); 6-3; 7-6(5),R64,140,9,5,57,108,49,57,31,51,5,5,17,80,108,19,4,72,109,54,72,22,37,6,7,16,76,109
2004-07-19 00:00:00.000,Indianapolis IN; U.S.A. ATP World Tour,HARD,2,Jan Hernych,Jan-Michael Gambill,Jan Hernych,6-4; 3-0 RET,R64,56,4,0,30,43,22,30,7,13,1,2,7,29,43,6,0,24,40,12,24,10,16,7,10,6,22,40
2004-07-19 00:00:00.000,Indianapolis IN; U.S.A. ATP World Tour,HARD,2,Sjeng Schalken,N/A Bye,Sjeng Schalken,,R64,0,0,0,0,0,0,0,0,0,0,0,0,0,0,0,0,0,0,0,0,0,0,0,0,0,0,0
2004-07-19 00:00:00.000,Indianapolis IN; U.S.A. ATP World Tour,HARD,2,Marco Chiudinelli,N/A Bye,Marco Chiudinelli,,R64,0,0,0,0,0,0,0,0,0,0,0,0,0,0,0,0,0,0,0,0,0,0,0,0,0,0,0
2004-07-19 00:00:00.000,Indianapolis IN; U.S.A. ATP World Tour,HARD,2,Rik De Voest,Wayne Arthurs,Rik De Voest,7-6(6); 6-1,R64,63,6,0,33,49,27,33,13,16,0,0,9,40,49,7,7,34,67,28,34,11,33,3,6,10,39,67
2004-07-19 00:00:00.000,Indianapolis IN; U.S.A. ATP World Tour,HARD,2,Ivo Karlovic,Brian Vahaly,Ivo Karlovic,5-7; 6-3; 6-4,R64,117,27,9,55,103,44,55,26,48,5,6,16,70,103,2,2,69,88,49,69,11,19,3,5,15,60,88
2004-07-19 00:00:00.000,Indianapolis IN; U.S.A. ATP World Tour,HARD,2,Nicolas Kiefer,N/A Bye,Nicolas Kiefer,,R64,0,0,0,0,0,0,0,0,0,0,0,0,0,0,0,0,0,0,0,0,0,0,0,0,0,0,0
2004-07-19 00:00:00.000,Indianapolis IN; U.S.A. ATP World Tour,HARD,2,Robin Soderling,N/A Bye,Robin Soderling,,R64,0,0,0,0,0,0,0,0,0,0,0,0,0,0,0,0,0,0,0,0,0,0,0,0,0,0,0
2004-07-19 00:00:00.000,Indianapolis IN; U.S.A. ATP World Tour,HARD,2,Alex Bogomolov Jr.,Kenneth Carlsen,Alex Bogomolov Jr.,6-4; 6-4,R64,78,2,3,43,52,34,43,4,9,0,1,10,38,52,9,2,39,71,23,39,17,32,6,9,10,40,71
2004-07-19 00:00:00.000,Indianapolis IN; U.S.A. ATP World Tour,HARD,2,Thierry Ascione,Jeff Salzenstein,Thierry Ascione,7-5; 7-6(3),R64,90,4,5,46,70,40,46,14,24,2,2,12,54,70,9,4,50,77,39,50,14,27,3,4,12,53,77
2004-07-19 00:00:00.000,Indianapolis IN; U.S.A. ATP World Tour,HARD,2,Paradorn Srichaphan,N/A Bye,Paradorn Srichaphan,,R64,0,0,0,0,0,0,0,0,0,0,0,0,0,0,0,0,0,0,0,0,0,0,0,0,0,0,0
2004-07-19 00:00:00.000,Indianapolis IN; U.S.A. ATP World Tour,HARD,2,Mardy Fish,N/A Bye,Mardy Fish,,R64,0,0,0,0,0,0,0,0,0,0,0,0,0,0,0,0,0,0,0,0,0,0,0,0,0,0,0
2004-07-19 00:00:00.000,Indianapolis IN; U.S.A. ATP World Tour,HARD,2,Gregory Carraz,Sargis Sargsian,Gregory Carraz,6-3; 6-3,R64,63,5,0,29,49,23,29,14,20,3,3,9,37,49,3,5,37,62,23,37,11,25,2,5,9,34,62
2004-07-19 00:00:00.000,Indianapolis IN; U.S.A. ATP World Tour,HARD,2,Todd Reid,Michael Llodra,Todd Reid,4-6; 6-3; 3-0 RET,R64,77,4,1,46,60,33,46,11,14,2,3,11,44,60,5,6,42,78,29,42,17,36,4,7,11,46,78
2004-07-19 00:00:00.000,Indianapolis IN; U.S.A. ATP World Tour,HARD,2,Alex Kuznetsov,N/A Bye,Alex Kuznetsov,,R64,0,0,0,0,0,0,0,0,0,0,0,0,0,0,0,0,0,0,0,0,0,0,0,0,0,0,0
2004-07-19 00:00:00.000,Indianapolis IN; U.S.A. ATP World Tour,HARD,2,Max Mirnyi,N/A Bye,Max Mirnyi,,R64,0,0,0,0,0,0,0,0,0,0,0,0,0,0,0,0,0,0,0,0,0,0,0,0,0,0,0
2004-07-19 00:00:00.000,Indianapolis IN; U.S.A. ATP World Tour,HARD,2,Karol Beck,Amer Delic,Karol Beck,6-1; 3-6; 6-1,R64,78,7,3,39,67,28,39,17,28,0,2,12,45,67,6,9,39,76,25,39,14,37,5,10,11,39,76
2004-07-19 00:00:00.000,Indianapolis IN; U.S.A. ATP World Tour,HARD,2,Noam Okun,Yen-Hsun Lu,Noam Okun,6-3; 6-1,R64,62,5,1,23,40,19,23,10,17,1,2,8,29,40,3,5,34,59,20,34,9,25,6,11,8,29,59
2004-07-19 00:00:00.000,Indianapolis IN; U.S.A. ATP World Tour,HARD,2,Thomas Enqvist,N/A Bye,Thomas Enqvist,,R64,0,0,0,0,0,0,0,0,0,0,0,0,0,0,0,0,0,0,0,0,0,0,0,0,0,0,0
2004-07-19 00:00:00.000,Indianapolis IN; U.S.A. ATP World Tour,HARD,2,Andy Roddick,Michel Kratochvil,Andy Roddick,6-4; 2-6; 6-4,R32,123,23,5,44,87,36,44,20,43,4,7,14,56,87,5,6,47,101,32,47,28,54,8,11,14,60,101
2004-07-19 00:00:00.000,Indianapolis IN; U.S.A. ATP World Tour,HARD,2,Robby Ginepri,Sebastien De Chaunac,Robby Ginepri,6-3; 3-6; 6-2,R32,97,2,6,38,75,28,38,21,37,4,7,13,49,75,7,6,45,80,32,45,11,35,6,11,13,43,80
2004-07-19 00:00:00.000,Indianapolis IN; U.S.A. ATP World Tour,HARD,2,Joachim Johansson,Greg Rusedski,Joachim Johansson,6-7(5); 6-3; 6-4,R32,128,22,9,63,113,50,63,27,50,9,10,16,77,113,23,14,51,96,41,51,22,45,3,6,15,63,96
2004-07-19 00:00:00.000,Indianapolis IN; U.S.A. ATP World Tour,HARD,2,Dominik Hrbaty,Fabrice Santoro,Dominik Hrbaty,6-3; 6-2,R32,55,4,2,34,52,28,34,9,18,4,5,9,37,52,0,2,28,47,15,28,9,19,2,6,8,24,47
2004-07-19 00:00:00.000,Indianapolis IN; U.S.A. ATP World Tour,HARD,2,Sebastien Grosjean,Julien Jeanpierre,Sebastien Grosjean,6-7(6); 6-2; 6-2,R32,127,8,2,35,84,29,35,30,49,3,4,14,59,84,6,8,55,100,37,55,19,45,10,15,14,56,100
2004-07-19 00:00:00.000,Indianapolis IN; U.S.A. ATP World Tour,HARD,2,Xavier Malisse,Jeff Morrison,Xavier Malisse,6-1; 6-2,R32,47,3,2,26,48,20,26,14,22,2,2,8,34,48,3,4,23,37,14,23,4,14,2,6,7,18,37
2004-07-19 00:00:00.000,Indianapolis IN; U.S.A. ATP World Tour,HARD,2,Ivan Ljubicic,Rajeev Ram,Ivan Ljubicic,6-2; 6-3,R32,59,18,4,27,51,23,27,15,24,0,0,9,38,51,1,6,28,49,23,28,5,21,5,8,8,28,49
2004-07-19 00:00:00.000,Indianapolis IN; U.S.A. ATP World Tour,HARD,2,Jan Hernych,Sjeng Schalken,Jan Hernych,7-5; 1-0 RET,R32,50,2,1,24,40,18,24,10,16,3,4,7,28,40,0,0,31,37,19,31,1,6,1,3,6,20,37
2004-07-19 00:00:00.000,Indianapolis IN; U.S.A. ATP World Tour,HARD,2,Rik De Voest,Marco Chiudinelli,Rik De Voest,1-6; 6-1; 6-3,R32,111,11,4,48,84,33,48,16,36,8,11,11,49,84,6,8,29,77,24,29,15,48,4,9,12,39,77
2004-07-19 00:00:00.000,Indianapolis IN; U.S.A. ATP World Tour,HARD,2,Nicolas Kiefer,Ivo Karlovic,Nicolas Kiefer,6-0; 7-6(0),R32,83,5,0,25,52,21,25,15,27,3,5,9,36,52,8,8,29,65,24,29,7,36,5,10,9,31,65
2004-07-19 00:00:00.000,Indianapolis IN; U.S.A. ATP World Tour,HARD,2,Alex Bogomolov Jr.,Robin Soderling,Alex Bogomolov Jr.,6-2; 6-2,R32,66,2,4,28,53,21,28,11,25,5,7,8,32,53,3,2,33,54,16,33,7,21,5,11,8,23,54
2004-07-19 00:00:00.000,Indianapolis IN; U.S.A. ATP World Tour,HARD,2,Paradorn Srichaphan,Thierry Ascione,Paradorn Srichaphan,7-6(4); 6-1,R32,75,8,5,32,67,28,32,18,35,2,3,10,46,67,3,2,26,55,16,26,16,29,3,6,9,32,55
2004-07-19 00:00:00.000,Indianapolis IN; U.S.A. ATP World Tour,HARD,2,Gregory Carraz,Mardy Fish,Gregory Carraz,7-6(4); 7-6(4),R32,123,12,4,70,105,51,70,17,35,4,6,12,68,105,14,9,42,84,35,42,17,42,4,6,12,52,84
2004-07-19 00:00:00.000,Indianapolis IN; U.S.A. ATP World Tour,HARD,2,Todd Reid,Alex Kuznetsov,Todd Reid,6-1; 7-5,R32,76,7,1,37,53,32,37,10,16,2,2,10,42,53,9,3,35,70,24,35,15,35,7,10,9,39,70
2004-07-19 00:00:00.000,Indianapolis IN; U.S.A. ATP World Tour,HARD,2,Karol Beck,Max Mirnyi,Karol Beck,6-4; 7-6(5),R32,93,6,4,39,76,34,39,21,37,3,3,11,55,76,7,5,47,71,38,47,11,24,4,5,11,49,71
2004-07-19 00:00:00.000,Indianapolis IN; U.S.A. ATP World Tour,HARD,2,Noam Okun,Thomas Enqvist,Noam Okun,7-6(7); 2-6; 7-6(5),R32,145,9,7,68,105,53,68,16,37,3,6,16,69,105,13,12,63,120,49,63,29,57,6,7,16,78,120
2004-07-19 00:00:00.000,Indianapolis IN; U.S.A. ATP World Tour,HARD,2,Andy Roddick,Robby Ginepri,Andy Roddick,7-6(5); 6-4,R16,72,7,1,49,71,37,49,10,22,3,5,11,47,71,6,4,40,60,28,40,12,20,2,5,11,40,60
2004-07-19 00:00:00.000,Indianapolis IN; U.S.A. ATP World Tour,HARD,2,Dominik Hrbaty,Joachim Johansson,Dominik Hrbaty,7-6(9); 4-6; 7-6(1),R16,133,13,9,86,122,69,86,17,36,5,6,17,86,122,29,5,70,109,60,70,21,39,2,2,17,81,109
2004-07-19 00:00:00.000,Indianapolis IN; U.S.A. ATP World Tour,HARD,2,Sebastien Grosjean,Xavier Malisse,Sebastien Grosjean,7-6(4); 6-2,R16,112,6,2,46,79,33,46,17,33,4,5,10,50,79,5,4,24,61,18,24,18,37,1,4,10,36,61
2004-07-19 00:00:00.000,Indianapolis IN; U.S.A. ATP World Tour,HARD,2,Ivan Ljubicic,Jan Hernych,Ivan Ljubicic,6-3; 6-4,R16,67,8,4,26,49,20,26,12,23,0,2,10,32,49,3,3,32,58,20,32,9,26,3,7,9,29,58
2004-07-19 00:00:00.000,Indianapolis IN; U.S.A. ATP World Tour,HARD,2,Nicolas Kiefer,Rik De Voest,Nicolas Kiefer,6-1; 7-5,R16,81,6,1,40,62,30,40,12,22,2,3,10,42,62,1,5,21,56,13,21,17,35,2,6,9,30,56
2004-07-19 00:00:00.000,Indianapolis IN; U.S.A. ATP World Tour,HARD,2,Paradorn Srichaphan,Alex Bogomolov Jr.,Paradorn Srichaphan,6-3; 6-0,R16,59,10,1,31,49,25,31,7,18,4,5,8,32,49,2,5,29,50,14,29,7,21,8,13,7,21,50
2004-07-19 00:00:00.000,Indianapolis IN; U.S.A. ATP World Tour,HARD,2,Gregory Carraz,Todd Reid,Gregory Carraz,7-5; 6-3,R16,71,10,2,33,53,27,33,14,20,2,2,10,41,53,5,3,47,61,31,47,6,14,1,4,11,37,61
2004-07-19 00:00:00.000,Indianapolis IN; U.S.A. ATP World Tour,HARD,2,Noam Okun,Karol Beck,Noam Okun,7-6(2); 6-2,R16,85,3,1,43,58,30,43,8,15,1,3,10,38,58,4,4,31,61,16,31,16,30,3,7,10,32,61
2004-07-19 00:00:00.000,Indianapolis IN; U.S.A. ATP World Tour,HARD,2,Andy Roddick,Dominik Hrbaty,Andy Roddick,6-2; 6-3,Q,52,14,5,26,46,25,26,11,20,0,0,9,36,46,3,2,28,47,16,28,9,19,4,7,8,25,47
2004-07-19 00:00:00.000,Indianapolis IN; U.S.A. ATP World Tour,HARD,2,Ivan Ljubicic,Sebastien Grosjean,Ivan Ljubicic,5-7; 7-5; 6-2,Q,152,11,6,53,103,41,53,25,50,4,6,16,66,103,7,5,63,103,46,63,19,40,6,10,16,65,103
2004-07-19 00:00:00.000,Indianapolis IN; U.S.A. ATP World Tour,HARD,2,Nicolas Kiefer,Paradorn Srichaphan,Nicolas Kiefer,7-6(7); 7-6(5),Q,154,5,6,61,117,41,61,28,56,8,11,12,69,117,10,3,70,114,46,70,20,44,15,18,12,66,114
2004-07-19 00:00:00.000,Indianapolis IN; U.S.A. ATP World Tour,HARD,2,Gregory Carraz,Noam Okun,Gregory Carraz,4-6; 6-3; 6-2,Q,110,5,5,49,87,39,49,18,38,2,5,14,57,87,6,2,44,73,26,44,17,29,4,9,13,43,73
2004-07-19 00:00:00.000,Indianapolis IN; U.S.A. ATP World Tour,HARD,2,Andy Roddick,Ivan Ljubicic,Andy Roddick,1-6; 7-6(10); 7-6(3),S,141,11,0,57,95,50,57,23,38,4,6,15,73,95,24,3,65,120,56,65,28,55,3,3,16,84,120
2004-07-19 00:00:00.000,Indianapolis IN; U.S.A. ATP World Tour,HARD,2,Nicolas Kiefer,Gregory Carraz,Nicolas Kiefer,6-2; 6-2,S,68,7,2,28,52,23,28,13,24,2,2,8,36,52,3,3,29,48,17,29,7,19,4,8,8,24,48
2004-07-19 00:00:00.000,Indianapolis IN; U.S.A. ATP World Tour,HARD,2,Andy Roddick,Nicolas Kiefer,Andy Roddick,6-2; 6-3,F,59,10,2,25,48,23,25,14,23,0,0,9,37,48,2,3,24,49,17,24,13,25,4,7,8,30,49
2004-07-19 00:00:00.000,Kitzbuhel Austria ATP World Tour,CLAY,2,Rainer Schuettler,N/A Bye,Rainer Schuettler,,R64,0,0,0,0,0,0,0,0,0,0,0,0,0,0,0,0,0,0,0,0,0,0,0,0,0,0,0
2004-07-19 00:00:00.000,Kitzbuhel Austria ATP World Tour,CLAY,2,Andreas Seppi,Michal Tabara,Andreas Seppi,7-6(4); 6-3,R64,76,5,6,32,68,26,32,17,36,3,6,11,43,68,0,6,21,63,18,21,18,42,1,5,10,36,63
2004-07-19 00:00:00.000,Kitzbuhel Austria ATP World Tour,CLAY,2,Frantisek Cermak,Ivo Heuberger,Frantisek Cermak,7-6(0); 6-4,R64,97,8,3,40,63,34,40,13,23,0,1,11,47,63,8,3,36,73,26,36,18,37,4,6,11,44,73
2004-07-19 00:00:00.000,Kitzbuhel Austria ATP World Tour,CLAY,2,David Sanchez,N/A Bye,David Sanchez,,R64,0,0,0,0,0,0,0,0,0,0,0,0,0,0,0,0,0,0,0,0,0,0,0,0,0,0,0
2004-07-19 00:00:00.000,Kitzbuhel Austria ATP World Tour,CLAY,2,David Ferrer,N/A Bye,David Ferrer,,R64,0,0,0,0,0,0,0,0,0,0,0,0,0,0,0,0,0,0,0,0,0,0,0,0,0,0,0
2004-07-19 00:00:00.000,Kitzbuhel Austria ATP World Tour,CLAY,2,Juan Monaco,Juan-Pablo Guzman,Juan Monaco,7-5; 6-4,R64,91,4,5,46,78,33,46,15,32,4,6,11,48,78,3,3,38,64,26,38,11,26,1,5,11,37,64
2004-07-19 00:00:00.000,Kitzbuhel Austria ATP World Tour,CLAY,2,Peter Luczak,Alexander Peya,Peter Luczak,6-2; 7-6(4),R64,107,2,4,52,86,33,52,21,34,7,7,10,54,86,3,7,44,78,31,44,14,34,7,9,10,45,78
2004-07-19 00:00:00.000,Kitzbuhel Austria ATP World Tour,CLAY,2,Florian Mayer,N/A Bye,Florian Mayer,,R64,0,0,0,0,0,0,0,0,0,0,0,0,0,0,0,0,0,0,0,0,0,0,0,0,0,0,0
2004-07-19 00:00:00.000,Kitzbuhel Austria ATP World Tour,CLAY,2,Nicolas Massu,N/A Bye,Nicolas Massu,,R64,0,0,0,0,0,0,0,0,0,0,0,0,0,0,0,0,0,0,0,0,0,0,0,0,0,0,0
2004-07-19 00:00:00.000,Kitzbuhel Austria ATP World Tour,CLAY,2,Yuri Schukin,Johannes Ager,Yuri Schukin,6-1; 3-6; 6-3,R64,93,3,0,49,69,29,49,10,20,4,9,13,39,69,2,5,27,64,12,27,16,37,1,8,12,28,64
2004-07-19 00:00:00.000,Kitzbuhel Austria ATP World Tour,CLAY,2,Potito Starace,Marc Lopez,Potito Starace,7-6(1); 6-2,R64,82,2,2,47,60,35,47,6,13,0,2,10,41,60,0,0,36,63,23,36,9,27,2,6,10,32,63
2004-07-19 00:00:00.000,Kitzbuhel Austria ATP World Tour,CLAY,2,Tomas Berdych,N/A Bye,Tomas Berdych,,R64,0,0,0,0,0,0,0,0,0,0,0,0,0,0,0,0,0,0,0,0,0,0,0,0,0,0,0
2004-07-19 00:00:00.000,Kitzbuhel Austria ATP World Tour,CLAY,2,Irakli Labadze,N/A Bye,Irakli Labadze,,R64,0,0,0,0,0,0,0,0,0,0,0,0,0,0,0,0,0,0,0,0,0,0,0,0,0,0,0
2004-07-19 00:00:00.000,Kitzbuhel Austria ATP World Tour,CLAY,2,Radek Stepanek,Daniel Gimeno-Traver,Radek Stepanek,6-7(2); 7-5; 7-6(3),R64,141,6,4,68,107,56,68,22,39,0,1,18,78,107,8,9,80,136,55,80,35,56,14,16,18,90,136
2004-07-19 00:00:00.000,Kitzbuhel Austria ATP World Tour,CLAY,2,Oscar Hernandez,Albert Portas,Oscar Hernandez,6-1; 6-4,R64,49,3,1,26,42,25,26,11,16,0,0,9,36,42,1,1,32,47,18,32,9,15,1,4,8,27,47
2004-07-19 00:00:00.000,Kitzbuhel Austria ATP World Tour,CLAY,2,Mariano Zabaleta,N/A Bye,Mariano Zabaleta,,R64,0,0,0,0,0,0,0,0,0,0,0,0,0,0,0,0,0,0,0,0,0,0,0,0,0,0,0
2004-07-19 00:00:00.000,Kitzbuhel Austria ATP World Tour,CLAY,2,Fernando Verdasco,N/A Bye,Fernando Verdasco,,R64,0,0,0,0,0,0,0,0,0,0,0,0,0,0,0,0,0,0,0,0,0,0,0,0,0,0,0
2004-07-19 00:00:00.000,Kitzbuhel Austria ATP World Tour,CLAY,2,Franco Squillari,Paul-Henri Mathieu,Franco Squillari,6-4; 6-2,R64,90,4,1,30,51,23,30,14,21,0,0,9,37,51,1,2,43,68,27,43,10,25,8,11,9,37,68
2004-07-19 00:00:00.000,Kitzbuhel Austria ATP World Tour,CLAY,2,Martin Vassallo Arguello,Nicolas Thomann,Martin Vassallo Arguello,6-4; 6-7(3); 6-1,R64,113,15,8,54,89,42,54,22,35,6,7,15,64,89,3,5,58,100,40,58,20,42,8,12,14,60,100
2004-07-19 00:00:00.000,Kitzbuhel Austria ATP World Tour,CLAY,2,Jurgen Melzer,N/A Bye,Jurgen Melzer,,R64,0,0,0,0,0,0,0,0,0,0,0,0,0,0,0,0,0,0,0,0,0,0,0,0,0,0,0
2004-07-19 00:00:00.000,Kitzbuhel Austria ATP World Tour,CLAY,2,Albert Montanes,N/A Bye,Albert Montanes,,R64,0,0,0,0,0,0,0,0,0,0,0,0,0,0,0,0,0,0,0,0,0,0,0,0,0,0,0
2004-07-19 00:00:00.000,Kitzbuhel Austria ATP World Tour,CLAY,2,Santiago Ventura,Stefano Pescosolido,Santiago Ventura,7-6(4); 6-4,R64,107,7,5,43,91,32,43,19,48,10,14,11,51,91,0,8,41,83,26,41,16,42,8,13,11,42,83
2004-07-19 00:00:00.000,Kitzbuhel Austria ATP World Tour,CLAY,2,Stefan Koubek,Marc Rosset,Stefan Koubek,6-3; 6-0,R64,52,4,1,17,44,14,17,19,27,3,3,8,33,44,6,5,19,42,15,19,6,23,3,7,7,21,42
2004-07-19 00:00:00.000,Kitzbuhel Austria ATP World Tour,CLAY,2,Feliciano Lopez,N/A Bye,Feliciano Lopez,,R64,0,0,0,0,0,0,0,0,0,0,0,0,0,0,0,0,0,0,0,0,0,0,0,0,0,0,0
2004-07-19 00:00:00.000,Kitzbuhel Austria ATP World Tour,CLAY,2,Luis Horna,N/A Bye,Luis Horna,,R64,0,0,0,0,0,0,0,0,0,0,0,0,0,0,0,0,0,0,0,0,0,0,0,0,0,0,0
2004-07-19 00:00:00.000,Kitzbuhel Austria ATP World Tour,CLAY,2,Alejandro Falla,Adrian Garcia,Alejandro Falla,6-0; 6-3,R64,40,2,0,21,36,18,21,11,15,0,0,7,29,36,1,3,25,41,12,25,3,16,2,7,8,15,41
2004-07-19 00:00:00.000,Kitzbuhel Austria ATP World Tour,CLAY,2,Werner Eschauer,Thomas Schiessling,Werner Eschauer,6-3; 6-2,R64,78,2,1,34,70,26,34,18,36,6,7,9,44,70,1,4,18,40,10,18,10,22,0,4,8,20,40
2004-07-19 00:00:00.000,Kitzbuhel Austria ATP World Tour,CLAY,2,Albert Costa,N/A Bye,Albert Costa,,R64,0,0,0,0,0,0,0,0,0,0,0,0,0,0,0,0,0,0,0,0,0,0,0,0,0,0,0
2004-07-19 00:00:00.000,Kitzbuhel Austria ATP World Tour,CLAY,2,Nikolay Davydenko,N/A Bye,Nikolay Davydenko,,R64,0,0,0,0,0,0,0,0,0,0,0,0,0,0,0,0,0,0,0,0,0,0,0,0,0,0,0
2004-07-19 00:00:00.000,Kitzbuhel Austria ATP World Tour,CLAY,2,Dick Norman,Alessio Di Mauro,Dick Norman,3-6; 6-2; 6-4,R64,117,8,5,60,96,40,60,15,36,5,10,14,55,96,3,5,48,88,31,48,13,40,12,18,13,44,88
2004-07-19 00:00:00.000,Kitzbuhel Austria ATP World Tour,CLAY,2,Ivo Minar,Galo Blanco,Ivo Minar,7-6(2); 7-6(11),R64,117,8,3,44,88,33,44,26,44,3,6,12,59,88,2,2,61,101,39,61,19,40,7,10,12,58,101
2004-07-19 00:00:00.000,Kitzbuhel Austria ATP World Tour,CLAY,2,Gaston Gaudio,N/A Bye,Gaston Gaudio,,R64,0,0,0,0,0,0,0,0,0,0,0,0,0,0,0,0,0,0,0,0,0,0,0,0,0,0,0
2004-07-19 00:00:00.000,Kitzbuhel Austria ATP World Tour,CLAY,2,Rainer Schuettler,Andreas Seppi,Rainer Schuettler,3-6; 7-6(13); 6-0,R32,135,3,2,50,104,28,50,37,54,6,9,14,65,104,5,5,54,99,42,54,17,45,6,10,13,59,99
2004-07-19 00:00:00.000,Kitzbuhel Austria ATP World Tour,CLAY,2,David Sanchez,Frantisek Cermak,David Sanchez,6-4; 5-7; 6-4,R32,129,2,2,63,97,49,63,14,34,10,13,16,63,97,5,5,61,97,43,61,17,36,6,10,16,60,97
2004-07-19 00:00:00.000,Kitzbuhel Austria ATP World Tour,CLAY,2,Juan Monaco,David Ferrer,Juan Monaco,6-3; 6-4,R32,77,1,2,46,68,29,46,9,22,5,8,10,38,68,1,1,32,57,12,32,16,25,2,7,9,28,57
2004-07-19 00:00:00.000,Kitzbuhel Austria ATP World Tour,CLAY,2,Florian Mayer,Peter Luczak,Florian Mayer,6-2; 6-4,R32,78,3,4,31,62,24,31,16,31,4,5,9,40,62,2,2,36,60,22,36,10,24,3,7,9,32,60
2004-07-19 00:00:00.000,Kitzbuhel Austria ATP World Tour,CLAY,2,Nicolas Massu,Yuri Schukin,Nicolas Massu,6-2; 6-3,R32,78,8,4,22,47,19,22,15,25,0,0,8,34,47,1,4,29,60,17,29,16,31,3,7,9,33,60
2004-07-19 00:00:00.000,Kitzbuhel Austria ATP World Tour,CLAY,2,Tomas Berdych,Potito Starace,Tomas Berdych,6-2; 7-5,R32,81,3,3,31,69,23,31,24,38,2,2,10,47,69,3,3,45,65,29,45,10,20,3,6,10,39,65
2004-07-19 00:00:00.000,Kitzbuhel Austria ATP World Tour,CLAY,2,Radek Stepanek,Irakli Labadze,Radek Stepanek,6-2; 7-6(1),R32,79,6,5,39,67,29,39,15,28,1,3,10,44,67,1,10,48,78,29,48,12,30,4,8,10,41,78
2004-07-19 00:00:00.000,Kitzbuhel Austria ATP World Tour,CLAY,2,Mariano Zabaleta,Oscar Hernandez,Mariano Zabaleta,7-6(5); 6-2,R32,87,4,0,40,58,30,40,12,18,1,2,10,42,58,0,1,46,68,25,46,14,22,1,4,10,39,68
2004-07-19 00:00:00.000,Kitzbuhel Austria ATP World Tour,CLAY,2,Fernando Verdasco,Franco Squillari,Fernando Verdasco,7-6(3); 6-2,R32,88,2,0,39,57,30,39,14,18,2,2,10,44,57,3,6,33,79,23,33,23,46,5,7,10,46,79
2004-07-19 00:00:00.000,Kitzbuhel Austria ATP World Tour,CLAY,2,Martin Vassallo Arguello,Jurgen Melzer,Martin Vassallo Arguello,6-4; 6-2,R32,74,3,4,33,57,26,33,14,24,3,3,9,40,57,1,1,33,56,21,33,11,23,6,9,9,32,56
2004-07-19 00:00:00.000,Kitzbuhel Austria ATP World Tour,CLAY,2,Santiago Ventura,Albert Montanes,Santiago Ventura,6-2; 6-1,R32,47,7,2,31,43,26,31,7,12,2,2,8,33,43,0,1,27,40,13,27,6,13,4,8,7,19,40
2004-07-19 00:00:00.000,Kitzbuhel Austria ATP World Tour,CLAY,2,Feliciano Lopez,Stefan Koubek,Feliciano Lopez,3-6; 6-3; 6-4,R32,103,5,7,41,86,36,41,21,45,5,7,14,57,86,5,3,55,91,40,55,18,36,4,7,14,58,91
2004-07-19 00:00:00.000,Kitzbuhel Austria ATP World Tour,CLAY,2,Luis Horna,Alejandro Falla,Luis Horna,7-6(3); 7-6(2),R32,96,1,0,51,75,38,51,19,24,3,3,12,57,75,1,4,46,74,33,46,19,28,0,0,12,52,74
2004-07-19 00:00:00.000,Kitzbuhel Austria ATP World Tour,CLAY,2,Albert Costa,Werner Eschauer,Albert Costa,6-3; 6-7(2); 6-3,R32,161,5,1,63,109,43,63,25,46,10,13,16,68,109,8,7,59,109,40,59,20,50,10,15,14,60,109
2004-07-19 00:00:00.000,Kitzbuhel Austria ATP World Tour,CLAY,2,Nikolay Davydenko,Dick Norman,Nikolay Davydenko,6-2; 6-2,R32,64,0,1,32,40,27,32,6,8,1,1,8,33,40,0,4,35,63,23,35,8,28,4,8,8,31,63
2004-07-19 00:00:00.000,Kitzbuhel Austria ATP World Tour,CLAY,2,Gaston Gaudio,Ivo Minar,Gaston Gaudio,6-4; 6-1,R32,74,2,1,37,64,28,37,13,27,4,5,9,41,64,1,6,25,55,14,25,13,30,2,6,8,27,55
2004-07-19 00:00:00.000,Kitzbuhel Austria ATP World Tour,CLAY,2,Rainer Schuettler,David Sanchez,Rainer Schuettler,6-0 RET,R16,28,0,0,11,18,9,11,5,7,0,0,3,14,18,0,1,6,17,2,6,3,11,0,3,3,5,17
2004-07-19 00:00:00.000,Kitzbuhel Austria ATP World Tour,CLAY,2,Florian Mayer,Juan Monaco,Florian Mayer,6-4; 6-4,R16,74,5,2,41,65,31,41,8,24,2,5,10,39,65,1,8,35,66,23,35,12,31,3,8,10,35,66
2004-07-19 00:00:00.000,Kitzbuhel Austria ATP World Tour,CLAY,2,Nicolas Massu,Tomas Berdych,Nicolas Massu,7-6(3); 3-6; 6-4,R16,150,4,8,52,109,39,52,34,57,7,10,16,73,109,16,3,60,96,46,60,17,36,4,6,15,63,96
2004-07-19 00:00:00.000,Kitzbuhel Austria ATP World Tour,CLAY,2,Mariano Zabaleta,Radek Stepanek,Mariano Zabaleta,6-3; 7-5,R16,87,4,3,36,59,28,36,13,23,1,2,10,41,59,6,3,40,71,27,40,12,31,2,6,11,39,71
2004-07-19 00:00:00.000,Kitzbuhel Austria ATP World Tour,CLAY,2,Fernando Verdasco,Martin Vassallo Arguello,Fernando Verdasco,7-6(7); 6-3,R16,97,3,3,49,76,36,49,18,27,0,0,11,54,76,1,9,43,80,31,43,18,37,5,6,10,49,80
2004-07-19 00:00:00.000,Kitzbuhel Austria ATP World Tour,CLAY,2,Feliciano Lopez,Santiago Ventura,Feliciano Lopez,6-3; 6-0,R16,52,3,6,24,56,17,24,21,32,5,5,8,38,56,0,2,15,43,10,15,9,28,0,4,7,19,43
2004-07-19 00:00:00.000,Kitzbuhel Austria ATP World Tour,CLAY,2,Luis Horna,Albert Costa,Luis Horna,4-6; 7-6(4); 6-4,R16,141,9,3,62,90,48,62,18,28,0,1,16,66,90,9,1,72,104,48,72,22,32,5,6,16,70,104
2004-07-19 00:00:00.000,Kitzbuhel Austria ATP World Tour,CLAY,2,Gaston Gaudio,Nikolay Davydenko,Gaston Gaudio,6-3; 6-3,R16,68,0,3,29,52,22,29,11,23,2,4,9,33,52,0,0,36,54,21,36,6,18,5,10,9,27,54
2004-07-19 00:00:00.000,Kitzbuhel Austria ATP World Tour,CLAY,2,Rainer Schuettler,Florian Mayer,Rainer Schuettler,7-6(6); 6-2,Q,87,5,4,38,66,24,38,14,28,2,5,10,38,66,6,3,51,82,30,51,11,31,9,14,10,41,82
2004-07-19 00:00:00.000,Kitzbuhel Austria ATP World Tour,CLAY,2,Nicolas Massu,Mariano Zabaleta,Nicolas Massu,7-6(4); 7-6(6),Q,172,1,1,58,100,40,58,26,42,9,11,12,66,100,5,4,57,91,38,57,20,34,8,10,12,58,91
2004-07-19 00:00:00.000,Kitzbuhel Austria ATP World Tour,CLAY,2,Fernando Verdasco,Feliciano Lopez,Fernando Verdasco,6-2; 6-3,Q,61,3,1,41,52,26,41,7,11,0,1,8,33,52,3,4,32,56,18,32,9,24,4,9,9,27,56
2004-07-19 00:00:00.000,Kitzbuhel Austria ATP World Tour,CLAY,2,Gaston Gaudio,Luis Horna,Gaston Gaudio,7-6(5); 7-6(1),Q,126,3,3,62,85,50,62,8,23,4,6,12,58,85,10,3,73,105,52,73,10,32,13,15,12,62,105
2004-07-19 00:00:00.000,Kitzbuhel Austria ATP World Tour,CLAY,2,Nicolas Massu,Rainer Schuettler,Nicolas Massu,6-3; 6-3,S,87,3,3,38,59,28,38,11,21,4,5,9,39,59,1,1,41,61,23,41,10,20,7,11,9,33,61
2004-07-19 00:00:00.000,Kitzbuhel Austria ATP World Tour,CLAY,2,Gaston Gaudio,Fernando Verdasco,Gaston Gaudio,6-0; 6-2,S,64,3,1,26,45,20,26,13,19,2,2,7,33,45,3,2,39,53,20,39,3,14,3,8,7,23,53
2004-07-19 00:00:00.000,Kitzbuhel Austria ATP World Tour,CLAY,2,Nicolas Massu,Gaston Gaudio,Nicolas Massu,7-6(3); 6-4,F,132,3,3,46,85,34,46,21,39,9,11,11,55,85,2,1,47,81,26,47,18,34,5,8,11,44,81
2004-07-19 00:00:00.000,Umag Croatia ATP World Tour,CLAY,2,Carlos Moya,Roko Karanusic,Carlos Moya,6-4; 6-4,R32,75,1,2,35,62,29,35,16,27,5,5,10,45,62,2,5,38,69,28,38,14,31,6,8,10,42,69
2004-07-19 00:00:00.000,Umag Croatia ATP World Tour,CLAY,2,Zeljko Krajan,Jiri Vanek,Zeljko Krajan,6-0; 3-6; 6-3,R32,119,1,3,47,89,33,47,16,42,9,13,12,49,89,5,5,37,71,23,37,10,34,5,12,12,33,71
2004-07-19 00:00:00.000,Umag Croatia ATP World Tour,CLAY,2,Nicolas Almagro,Tomas Behrend,Nicolas Almagro,7-6(4); 6-4,R32,87,2,1,42,62,36,42,11,20,1,2,11,47,62,3,2,54,76,38,54,9,22,5,7,11,47,76
2004-07-19 00:00:00.000,Umag Croatia ATP World Tour,CLAY,2,Alberto Martin,Jerome Golmard,Alberto Martin,6-2; 4-6; 6-2,R32,111,3,6,43,69,35,43,13,26,1,3,13,48,69,7,6,51,90,33,51,17,39,4,9,13,50,90
2004-07-19 00:00:00.000,Umag Croatia ATP World Tour,CLAY,2,Filippo Volandri,Novak Djokovic,Filippo Volandri,7-6(5); 6-1,R32,90,0,7,39,74,22,39,18,35,6,10,10,40,74,4,6,40,65,20,40,6,25,2,8,9,26,65
2004-07-19 00:00:00.000,Umag Croatia ATP World Tour,CLAY,2,Florent Serra,Bohdan Ulihrach,Florent Serra,6-3; 6-1,R32,59,0,0,36,47,27,36,5,11,1,2,8,32,47,2,6,30,58,18,30,7,28,7,12,8,25,58
2004-07-19 00:00:00.000,Umag Croatia ATP World Tour,CLAY,2,Kristof Vliegen,Olivier Mutis,Kristof Vliegen,6-0; 6-2,R32,42,4,2,18,32,17,18,11,14,0,0,7,28,32,1,3,35,43,16,35,1,8,1,6,7,17,43
2004-07-19 00:00:00.000,Umag Croatia ATP World Tour,CLAY,2,Olivier Rochus,Karol Kucera,Olivier Rochus,6-2; 6-2,R32,63,0,2,32,50,21,32,11,18,4,6,8,32,50,0,1,23,47,10,23,8,24,0,6,8,18,47
2004-07-19 00:00:00.000,Umag Croatia ATP World Tour,CLAY,2,Guillermo Canas,Olivier Patience,Guillermo Canas,6-3; 6-2,R32,76,3,1,20,39,15,20,14,19,0,1,8,29,39,2,5,31,66,20,31,10,35,5,10,9,30,66
2004-07-19 00:00:00.000,Umag Croatia ATP World Tour,CLAY,2,Fernando Vicente,Sasa Tuksar,Fernando Vicente,6-7(5); 6-4; 6-3,R32,130,6,1,61,97,45,61,19,36,2,5,16,64,97,4,3,54,95,37,54,22,41,3,8,15,59,95
2004-07-19 00:00:00.000,Umag Croatia ATP World Tour,CLAY,2,Alex Calatrava,Arnaud Di Pasquale,Alex Calatrava,6-4; 6-3,R32,90,3,3,45,67,27,45,12,22,5,7,9,39,67,2,5,32,51,18,32,8,19,4,9,10,26,51
2004-07-19 00:00:00.000,Umag Croatia ATP World Tour,CLAY,2,Tomas Zib,Igor Andreev,Tomas Zib,6-3; 6-4,R32,65,2,1,24,48,23,24,15,24,1,2,10,38,48,3,1,32,52,20,32,13,20,6,9,9,33,52
2004-07-19 00:00:00.000,Umag Croatia ATP World Tour,CLAY,2,Flavio Saretta,Stanislas Wawrinka,Flavio Saretta,6-3; 6-1,R32,63,2,0,30,43,23,30,9,13,0,0,8,32,43,2,3,27,41,14,27,6,14,1,5,8,20,41
2004-07-19 00:00:00.000,Umag Croatia ATP World Tour,CLAY,2,Guillermo Garcia-Lopez,Victor Hanescu,Guillermo Garcia-Lopez,5-7; 6-4; 6-4,R32,140,1,2,61,98,46,61,18,37,2,5,16,64,98,4,4,54,99,40,54,20,45,5,9,16,60,99
2004-07-19 00:00:00.000,Umag Croatia ATP World Tour,CLAY,2,Christophe Rochus,Jose Acasuso,Christophe Rochus,6-3; 7-5,R32,92,2,1,56,76,36,56,13,20,8,10,11,49,76,2,2,28,63,14,28,20,35,5,9,10,34,63
2004-07-19 00:00:00.000,Umag Croatia ATP World Tour,CLAY,2,Jiri Novak,Ruben Ramirez Hidalgo,Jiri Novak,6-4; 6-2,R32,79,11,2,31,48,27,31,10,17,0,0,9,37,48,1,4,43,68,24,43,12,25,4,7,9,36,68
2004-07-19 00:00:00.000,Umag Croatia ATP World Tour,CLAY,2,Carlos Moya,Zeljko Krajan,Carlos Moya,3-3 RET,R16,26,0,1,10,16,5,10,4,6,0,1,3,9,16,0,0,14,19,8,14,3,5,2,3,3,11,19
2004-07-19 00:00:00.000,Umag Croatia ATP World Tour,CLAY,2,Alberto Martin,Nicolas Almagro,Alberto Martin,6-3; 6-1,R16,76,1,5,29,55,25,29,13,26,3,3,8,38,55,4,5,28,60,17,28,13,32,6,10,8,30,60
2004-07-19 00:00:00.000,Umag Croatia ATP World Tour,CLAY,2,Filippo Volandri,Florent Serra,Filippo Volandri,7-5; 6-0,R16,77,1,1,32,54,23,32,13,22,2,3,9,36,54,2,0,32,54,18,32,7,22,2,7,9,25,54
2004-07-19 00:00:00.000,Umag Croatia ATP World Tour,CLAY,2,Kristof Vliegen,Olivier Rochus,Kristof Vliegen,7-6(3); 3-6; 6-4,R16,165,12,3,54,100,36,54,22,46,5,10,16,58,100,1,5,64,112,41,64,24,48,11,15,15,65,112
2004-07-19 00:00:00.000,Umag Croatia ATP World Tour,CLAY,2,Guillermo Canas,Fernando Vicente,Guillermo Canas,6-2; 6-1,R16,59,1,1,21,33,15,21,10,12,0,1,7,25,33,3,0,27,51,14,27,7,24,3,9,8,21,51
2004-07-19 00:00:00.000,Umag Croatia ATP World Tour,CLAY,2,Alex Calatrava,Tomas Zib,Alex Calatrava,7-5; 6-3,R16,110,5,2,39,66,26,39,15,27,6,9,11,41,66,3,1,36,63,19,36,12,27,5,10,10,31,63
2004-07-19 00:00:00.000,Umag Croatia ATP World Tour,CLAY,2,Guillermo Garcia-Lopez,Flavio Saretta,Guillermo Garcia-Lopez,7-5; 6-0,R16,92,0,2,23,46,14,23,11,23,3,7,9,25,46,0,5,31,65,10,31,13,34,3,11,9,23,65
2004-07-19 00:00:00.000,Umag Croatia ATP World Tour,CLAY,2,Jiri Novak,Christophe Rochus,Jiri Novak,4-6; 6-3; 6-1,R16,115,7,1,48,79,30,48,19,31,3,6,13,49,79,2,1,58,91,27,58,18,33,8,14,13,45,91
2004-07-19 00:00:00.000,Umag Croatia ATP World Tour,CLAY,2,Carlos Moya,Alberto Martin,Carlos Moya,6-1; 7-6(2),Q,87,3,4,37,72,31,37,16,35,6,7,9,47,72,0,2,43,61,25,43,6,18,3,7,10,31,61
2004-07-19 00:00:00.000,Umag Croatia ATP World Tour,CLAY,2,Filippo Volandri,Kristof Vliegen,Filippo Volandri,6-2; 6-2,Q,67,0,3,36,54,23,36,9,18,6,8,8,32,54,0,2,30,49,14,30,6,19,2,8,8,20,49
2004-07-19 00:00:00.000,Umag Croatia ATP World Tour,CLAY,2,Guillermo Canas,Alex Calatrava,Guillermo Canas,6-2; 7-6(4),Q,105,8,0,36,57,25,36,15,21,1,3,10,40,57,1,2,36,59,19,36,13,23,0,4,10,32,59
2004-07-19 00:00:00.000,Umag Croatia ATP World Tour,CLAY,2,Guillermo Garcia-Lopez,Jiri Novak,Guillermo Garcia-Lopez,6-3; 6-3,Q,66,1,2,36,59,23,36,17,23,0,0,9,40,59,5,3,28,47,22,28,5,19,0,3,9,27,47
2004-07-19 00:00:00.000,Umag Croatia ATP World Tour,CLAY,2,Filippo Volandri,Carlos Moya,Filippo Volandri,6-3; 6-2,S,69,0,1,34,53,28,34,11,19,1,1,9,39,53,3,2,31,53,20,31,9,22,4,7,8,29,53
2004-07-19 00:00:00.000,Umag Croatia ATP World Tour,CLAY,2,Guillermo Canas,Guillermo Garcia-Lopez,Guillermo Canas,6-2; 6-2,S,76,3,0,29,46,21,29,11,17,1,2,8,32,46,0,1,32,53,17,32,5,21,4,9,8,22,53
2004-07-19 00:00:00.000,Umag Croatia ATP World Tour,CLAY,2,Guillermo Canas,Filippo Volandri,Guillermo Canas,7-5; 6-3,F,98,1,5,35,62,25,35,12,27,4,7,10,37,62,0,0,43,67,22,43,8,24,6,12,11,30,67
2004-07-26 00:00:00.000,ATP Masters Series Canada Toronto; Canada ATP World Tour,HARD,2,Roger Federer,Hicham Arazi,Roger Federer,6-3; 7-5,R64,88,12,5,40,68,31,40,17,28,1,1,11,48,68,4,2,40,70,27,40,16,30,4,6,10,43,70
2004-07-26 00:00:00.000,ATP Masters Series Canada Toronto; Canada ATP World Tour,HARD,2,Robin Soderling,Thomas Enqvist,Robin Soderling,7-6(2); 6-3,R64,81,14,0,48,72,40,48,11,24,1,1,11,51,72,5,5,33,68,23,33,21,35,1,2,10,44,68
2004-07-26 00:00:00.000,ATP Masters Series Canada Toronto; Canada ATP World Tour,HARD,2,Max Mirnyi,Michel Kratochvil,Max Mirnyi,7-6(6); 7-6(9),R64,107,12,2,50,78,39,50,14,28,1,4,12,53,78,2,4,58,83,39,58,14,25,3,6,12,53,83
2004-07-26 00:00:00.000,ATP Masters Series Canada Toronto; Canada ATP World Tour,HARD,2,Paradorn Srichaphan,Andrei Pavel,Paradorn Srichaphan,7-5; 6-2,R64,80,4,0,36,56,31,36,8,20,0,1,10,39,56,2,0,53,70,34,53,5,17,6,10,10,39,70
2004-07-26 00:00:00.000,ATP Masters Series Canada Toronto; Canada ATP World Tour,HARD,2,Lleyton Hewitt,Rafael Nadal,Lleyton Hewitt,1-6; 6-4; 6-2,R64,104,7,3,29,67,23,29,18,38,3,7,12,41,67,1,0,63,86,36,63,12,23,7,12,13,48,86
2004-07-26 00:00:00.000,ATP Masters Series Canada Toronto; Canada ATP World Tour,HARD,2,Jiri Novak,Jonas Bjorkman,Jiri Novak,5-7; 7-6(10); 6-0,R64,137,12,1,76,97,60,76,12,21,3,4,15,72,97,11,2,77,125,54,77,24,48,14,17,15,78,125
2004-07-26 00:00:00.000,ATP Masters Series Canada Toronto; Canada ATP World Tour,HARD,2,Ivan Ljubicic,Karol Beck,Ivan Ljubicic,6-2; 5-7; 6-3,R64,129,13,2,53,99,43,53,25,46,4,5,15,68,99,4,2,45,77,30,45,21,32,3,6,14,51,77
2004-07-26 00:00:00.000,ATP Masters Series Canada Toronto; Canada ATP World Tour,HARD,2,Fabrice Santoro,Juan Carlos Ferrero,Fabrice Santoro,3-2 RET,R64,37,0,0,12,31,9,12,10,19,3,3,3,19,31,1,1,9,16,6,9,5,7,3,3,2,11,16
2004-07-26 00:00:00.000,ATP Masters Series Canada Toronto; Canada ATP World Tour,HARD,2,Luis Horna,Guillermo Coria,Luis Horna,5-1 RET,R64,31,3,0,12,19,9,12,5,7,0,0,3,14,19,0,3,7,14,3,7,2,7,1,3,3,5,14
2004-07-26 00:00:00.000,ATP Masters Series Canada Toronto; Canada ATP World Tour,HARD,2,Frederic Niemeyer,David Sanchez,Frederic Niemeyer,6-1; 6-4,R64,55,9,1,30,45,28,30,9,15,1,1,9,37,45,0,3,28,49,19,28,9,21,0,3,8,28,49
2004-07-26 00:00:00.000,ATP Masters Series Canada Toronto; Canada ATP World Tour,HARD,2,Igor Andreev,Sargis Sargsian,Igor Andreev,7-5; 6-7(1); 6-2,R64,149,9,10,61,119,43,61,30,58,7,9,16,73,119,2,4,78,113,53,78,16,35,7,12,16,69,113
2004-07-26 00:00:00.000,ATP Masters Series Canada Toronto; Canada ATP World Tour,HARD,2,Thomas Johansson,Nicolas Massu,Thomas Johansson,6-4; 6-4,R64,87,12,2,40,60,31,40,9,20,1,2,10,40,60,2,1,35,62,24,35,14,27,3,6,10,38,62
2004-07-26 00:00:00.000,ATP Masters Series Canada Toronto; Canada ATP World Tour,HARD,2,Gregory Carraz,Sebastien Grosjean,Gregory Carraz,6-2; 7-6(3),R64,91,8,6,48,77,36,48,15,29,6,7,10,51,77,7,3,32,64,24,32,13,32,3,6,10,37,64
2004-07-26 00:00:00.000,ATP Masters Series Canada Toronto; Canada ATP World Tour,HARD,2,Joachim Johansson,Michael Llodra,Joachim Johansson,1-6; 7-6(4); 6-1,R64,101,6,5,52,79,41,52,12,27,6,8,12,53,79,13,2,52,88,41,52,18,36,3,6,14,59,88
2004-07-26 00:00:00.000,ATP Masters Series Canada Toronto; Canada ATP World Tour,HARD,2,Cyril Saulnier,Daniel Nestor,Cyril Saulnier,6-3; 6-4,R64,70,9,1,42,66,29,42,16,24,7,8,10,45,66,5,2,34,53,24,34,8,19,2,5,9,32,53
2004-07-26 00:00:00.000,ATP Masters Series Canada Toronto; Canada ATP World Tour,HARD,2,Mikhail Youzhny,David Nalbandian,Mikhail Youzhny,3-6; 6-3; 6-4,R64,106,10,2,39,69,34,39,16,30,0,2,14,50,69,5,4,55,92,36,55,22,37,4,7,14,58,92
2004-07-26 00:00:00.000,ATP Masters Series Canada Toronto; Canada ATP World Tour,HARD,2,Fernando Gonzalez,Rainer Schuettler,Fernando Gonzalez,3-6; 6-4; 6-3,R64,114,11,2,49,82,37,49,20,33,3,5,14,57,82,0,0,70,102,45,70,17,32,6,9,14,62,102
2004-07-26 00:00:00.000,ATP Masters Series Canada Toronto; Canada ATP World Tour,HARD,2,Vincent Spadea,Frank Dancevic,Vincent Spadea,6-1; 6-4,R64,81,3,5,28,53,23,28,15,25,3,3,9,38,53,3,1,37,67,28,37,9,30,10,13,8,37,67
2004-07-26 00:00:00.000,ATP Masters Series Canada Toronto; Canada ATP World Tour,HARD,2,Jurgen Melzer,Dominik Hrbaty,Jurgen Melzer,4-6; 7-5; 7-6(3),R64,118,6,1,51,96,41,51,15,45,4,10,17,56,96,10,3,62,95,44,62,13,33,2,8,17,57,95
2004-07-26 00:00:00.000,ATP Masters Series Canada Toronto; Canada ATP World Tour,HARD,2,Andre Agassi,Tommy Haas,Andre Agassi,4-6; 6-4; 6-4,R64,124,10,2,46,86,35,46,21,40,1,4,15,56,86,8,4,52,91,39,52,17,39,5,9,15,56,91
2004-07-26 00:00:00.000,ATP Masters Series Canada Toronto; Canada ATP World Tour,HARD,2,Nicolas Kiefer,Marat Safin,Nicolas Kiefer,6-7(3); 6-4; 7-6(2),R64,163,14,4,57,94,48,57,21,37,1,3,17,69,94,20,2,56,116,42,56,33,60,6,9,17,75,116
2004-07-26 00:00:00.000,ATP Masters Series Canada Toronto; Canada ATP World Tour,HARD,2,David Ferrer,Simon Larose,David Ferrer,7-5; 6-2,R64,82,1,1,38,54,26,38,7,16,0,3,10,33,54,2,3,42,74,26,42,10,32,7,13,10,36,74
2004-07-26 00:00:00.000,ATP Masters Series Canada Toronto; Canada ATP World Tour,HARD,2,Alex Bogomolov Jr.,Ivo Karlovic,Alex Bogomolov Jr.,6-4; 7-6(6),R64,67,1,0,53,61,42,53,7,8,0,0,11,49,61,17,3,37,58,31,37,15,21,0,1,11,46,58
2004-07-26 00:00:00.000,ATP Masters Series Canada Toronto; Canada ATP World Tour,HARD,2,Carlos Moya,Fernando Verdasco,Carlos Moya,6-7(9); 6-3; 6-4,R64,151,5,2,72,122,48,72,27,50,7,10,16,75,122,3,6,69,104,43,69,18,35,7,12,15,61,104
2004-07-26 00:00:00.000,ATP Masters Series Canada Toronto; Canada ATP World Tour,HARD,2,Tim Henman,Mariano Zabaleta,Tim Henman,6-4; 6-1,R64,75,2,3,32,59,21,32,15,27,3,5,9,36,59,1,4,30,48,17,30,6,18,6,11,8,23,48
2004-07-26 00:00:00.000,ATP Masters Series Canada Toronto; Canada ATP World Tour,HARD,2,Gustavo Kuerten,Robby Ginepri,Gustavo Kuerten,6-1; 6-4,R64,60,12,2,27,48,23,27,12,21,1,1,8,35,48,3,2,31,61,21,31,13,30,3,7,9,34,61
2004-07-26 00:00:00.000,ATP Masters Series Canada Toronto; Canada ATP World Tour,HARD,2,Jan Hernych,Irakli Labadze,Jan Hernych,6-1; 6-4,R64,58,0,2,42,60,29,42,10,18,7,8,9,39,60,2,4,35,49,22,35,2,14,0,4,8,24,49
2004-07-26 00:00:00.000,ATP Masters Series Canada Toronto; Canada ATP World Tour,HARD,2,Todd Reid,Gaston Gaudio,Todd Reid,7-6(2); 5-7; 6-3,R64,112,6,2,82,110,59,82,14,28,9,12,16,73,110,7,4,76,102,53,76,11,26,1,5,17,64,102
2004-07-26 00:00:00.000,ATP Masters Series Canada Toronto; Canada ATP World Tour,HARD,2,Juan Ignacio Chela,Xavier Malisse,Juan Ignacio Chela,6-3; 5-7; 6-3,R64,117,1,0,61,90,39,61,16,29,6,10,15,55,90,4,6,47,96,34,47,19,49,3,9,15,53,96
2004-07-26 00:00:00.000,ATP Masters Series Canada Toronto; Canada ATP World Tour,HARD,2,Tommy Robredo,Hyung-Taik Lee,Tommy Robredo,7-6(3); 6-1,R64,89,3,2,43,69,35,43,12,26,2,2,9,47,69,0,2,39,64,23,39,16,25,4,7,10,39,64
2004-07-26 00:00:00.000,ATP Masters Series Canada Toronto; Canada ATP World Tour,HARD,2,Feliciano Lopez,Nicolas Escude,Feliciano Lopez,7-6(1); 6-2,R64,71,11,0,45,63,33,45,15,18,4,4,10,48,63,5,3,28,56,22,28,16,28,3,5,10,38,56
2004-07-26 00:00:00.000,ATP Masters Series Canada Toronto; Canada ATP World Tour,HARD,2,Andy Roddick,Julien Benneteau,Andy Roddick,6-4; 6-2,R64,76,4,3,32,53,28,32,10,21,3,4,9,38,53,4,5,29,55,19,29,9,26,0,4,9,28,55
2004-07-26 00:00:00.000,ATP Masters Series Canada Toronto; Canada ATP World Tour,HARD,2,Roger Federer,Robin Soderling,Roger Federer,7-5; 6-1,R32,64,13,0,47,67,35,47,11,20,6,7,10,46,67,2,2,25,47,16,25,11,22,3,7,9,27,47
2004-07-26 00:00:00.000,ATP Masters Series Canada Toronto; Canada ATP World Tour,HARD,2,Max Mirnyi,Paradorn Srichaphan,Max Mirnyi,3-6; 6-1; 6-4,R32,112,7,4,46,70,38,46,13,24,0,1,13,51,70,5,7,57,99,41,57,18,42,11,14,13,59,99
2004-07-26 00:00:00.000,ATP Masters Series Canada Toronto; Canada ATP World Tour,HARD,2,Lleyton Hewitt,Jiri Novak,Lleyton Hewitt,6-2; 6-1,R32,52,8,3,31,43,27,31,5,12,0,0,8,32,43,3,2,34,56,20,34,7,22,6,10,7,27,56
2004-07-26 00:00:00.000,ATP Masters Series Canada Toronto; Canada ATP World Tour,HARD,2,Fabrice Santoro,Ivan Ljubicic,Fabrice Santoro,6-4; 7-6(4),R32,104,6,0,37,69,33,37,19,32,4,4,11,52,69,8,1,48,73,37,48,12,25,5,6,11,49,73
2004-07-26 00:00:00.000,ATP Masters Series Canada Toronto; Canada ATP World Tour,HARD,2,Luis Horna,Frederic Niemeyer,Luis Horna,6-7(5); 7-5; 6-3,R32,127,5,5,76,106,57,76,16,30,1,2,17,73,106,17,8,49,99,38,49,27,50,4,7,16,65,99
2004-07-26 00:00:00.000,ATP Masters Series Canada Toronto; Canada ATP World Tour,HARD,2,Thomas Johansson,Igor Andreev,Thomas Johansson,7-6(4); 6-1,R32,70,8,2,32,61,26,32,22,29,2,2,10,48,61,8,3,32,53,24,32,11,21,0,2,9,35,53
2004-07-26 00:00:00.000,ATP Masters Series Canada Toronto; Canada ATP World Tour,HARD,2,Joachim Johansson,Gregory Carraz,Joachim Johansson,7-6(4); 6-7(3); 7-6(4),R32,146,30,6,65,116,54,65,31,51,1,2,18,85,116,23,13,86,124,73,86,14,38,6,7,18,87,124
2004-07-26 00:00:00.000,ATP Masters Series Canada Toronto; Canada ATP World Tour,HARD,2,Cyril Saulnier,Mikhail Youzhny,Cyril Saulnier,4-6; 6-3; 7-6(0),R32,125,9,3,48,94,41,48,26,46,0,1,16,67,94,11,6,52,99,37,52,27,47,4,5,15,64,99
2004-07-26 00:00:00.000,ATP Masters Series Canada Toronto; Canada ATP World Tour,HARD,2,Fernando Gonzalez,Vincent Spadea,Fernando Gonzalez,7-5; 6-4,R32,89,2,3,39,69,29,39,21,30,3,3,11,50,69,4,2,53,83,34,53,15,30,8,10,11,49,83
2004-07-26 00:00:00.000,ATP Masters Series Canada Toronto; Canada ATP World Tour,HARD,2,Jurgen Melzer,Andre Agassi,Jurgen Melzer,6-3; 6-3,R32,61,10,2,36,57,28,36,10,21,4,5,9,38,57,3,1,33,55,17,33,13,22,4,8,9,30,55
2004-07-26 00:00:00.000,ATP Masters Series Canada Toronto; Canada ATP World Tour,HARD,2,Nicolas Kiefer,David Ferrer,Nicolas Kiefer,6-3; 6-1,R32,63,6,0,29,47,25,29,10,18,2,2,8,35,47,2,2,31,50,18,31,7,19,5,9,8,25,50
2004-07-26 00:00:00.000,ATP Masters Series Canada Toronto; Canada ATP World Tour,HARD,2,Carlos Moya,Alex Bogomolov Jr.,Carlos Moya,6-4; 6-3,R32,70,6,2,34,61,25,34,17,27,4,6,10,42,61,0,1,35,52,19,35,9,17,0,4,9,28,52
2004-07-26 00:00:00.000,ATP Masters Series Canada Toronto; Canada ATP World Tour,HARD,2,Gustavo Kuerten,Tim Henman,Gustavo Kuerten,7-5; 6-4,R32,103,12,4,44,76,36,44,17,32,6,6,11,53,76,6,6,34,68,25,34,17,34,4,6,11,42,68
2004-07-26 00:00:00.000,ATP Masters Series Canada Toronto; Canada ATP World Tour,HARD,2,Jan Hernych,Todd Reid,Jan Hernych,6-3; 6-3,R32,59,7,1,36,50,30,36,7,14,2,3,9,37,50,4,2,50,69,26,50,10,19,9,13,9,36,69
2004-07-26 00:00:00.000,ATP Masters Series Canada Toronto; Canada ATP World Tour,HARD,2,Juan Ignacio Chela,Tommy Robredo,Juan Ignacio Chela,6-4; 6-0,R32,72,0,2,28,42,22,28,10,14,0,0,8,32,42,2,3,49,75,29,49,8,26,12,16,8,37,75
2004-07-26 00:00:00.000,ATP Masters Series Canada Toronto; Canada ATP World Tour,HARD,2,Andy Roddick,Feliciano Lopez,Andy Roddick,6-3; 7-6(5),R32,67,13,0,47,60,41,47,9,13,1,1,11,50,60,9,1,38,67,30,38,14,29,1,2,10,44,67
2004-07-26 00:00:00.000,ATP Masters Series Canada Toronto; Canada ATP World Tour,HARD,2,Roger Federer,Max Mirnyi,Roger Federer,7-6(3); 7-6(4),R16,93,3,1,50,68,44,50,12,18,0,0,12,56,68,7,0,56,79,44,56,11,23,2,2,12,55,79
2004-07-26 00:00:00.000,ATP Masters Series Canada Toronto; Canada ATP World Tour,HARD,2,Fabrice Santoro,Lleyton Hewitt,Fabrice Santoro,2-6; 6-3; 6-4,R16,113,6,1,42,85,30,42,26,43,7,9,14,56,85,7,3,45,84,33,45,20,39,4,6,13,53,84
2004-07-26 00:00:00.000,ATP Masters Series Canada Toronto; Canada ATP World Tour,HARD,2,Thomas Johansson,Luis Horna,Thomas Johansson,3-6; 7-5; 6-1,R16,109,15,0,43,79,40,43,17,36,3,4,14,57,79,5,2,66,94,44,66,14,28,8,11,14,58,94
2004-07-26 00:00:00.000,ATP Masters Series Canada Toronto; Canada ATP World Tour,HARD,2,Joachim Johansson,Cyril Saulnier,Joachim Johansson,7-6(2); 4-6; 7-6(4),R16,115,23,5,58,97,54,58,22,39,3,4,17,76,97,21,2,60,93,53,60,22,33,1,1,17,75,93
2004-07-26 00:00:00.000,ATP Masters Series Canada Toronto; Canada ATP World Tour,HARD,2,Jurgen Melzer,Fernando Gonzalez,Jurgen Melzer,6-3; 6-3,R16,59,3,1,40,61,28,40,9,21,5,7,9,37,61,5,3,24,46,12,24,10,22,1,6,9,22,46
2004-07-26 00:00:00.000,ATP Masters Series Canada Toronto; Canada ATP World Tour,HARD,2,Nicolas Kiefer,Carlos Moya,Nicolas Kiefer,6-4; 2-6; 6-4,R16,146,5,6,45,86,36,45,23,41,2,4,14,59,86,13,4,53,104,37,53,28,51,7,9,14,65,104
2004-07-26 00:00:00.000,ATP Masters Series Canada Toronto; Canada ATP World Tour,HARD,2,Jan Hernych,Gustavo Kuerten,Jan Hernych,5-7; 7-6(6); 6-4,R16,144,3,1,70,105,51,70,19,35,3,5,17,70,105,11,0,69,120,49,69,29,51,9,11,17,78,120
2004-07-26 00:00:00.000,ATP Masters Series Canada Toronto; Canada ATP World Tour,HARD,2,Andy Roddick,Juan Ignacio Chela,Andy Roddick,6-1; 6-4,R16,62,8,1,31,53,27,31,13,22,2,2,9,40,53,1,2,36,51,21,36,8,15,6,9,8,29,51
2004-07-26 00:00:00.000,ATP Masters Series Canada Toronto; Canada ATP World Tour,HARD,2,Roger Federer,Fabrice Santoro,Roger Federer,7-5; 6-4,Q,97,4,1,46,65,35,46,10,19,1,2,11,45,65,3,1,52,94,30,52,23,42,11,14,11,53,94
2004-07-26 00:00:00.000,ATP Masters Series Canada Toronto; Canada ATP World Tour,HARD,2,Thomas Johansson,Joachim Johansson,Thomas Johansson,6-3; 7-6(5),Q,89,11,1,33,68,26,33,20,35,1,3,11,46,68,10,4,42,74,27,42,16,32,2,5,10,43,74
2004-07-26 00:00:00.000,ATP Masters Series Canada Toronto; Canada ATP World Tour,HARD,2,Nicolas Kiefer,Jurgen Melzer,Nicolas Kiefer,3-6; 6-1; 6-1,Q,95,6,2,47,78,33,47,16,31,5,7,12,49,78,3,1,34,63,22,34,10,29,3,8,11,32,63
2004-07-26 00:00:00.000,ATP Masters Series Canada Toronto; Canada ATP World Tour,HARD,2,Andy Roddick,Jan Hernych,Andy Roddick,6-4; 6-2,Q,61,6,2,37,53,30,37,8,16,0,0,9,38,53,4,0,40,58,27,40,7,18,4,7,9,34,58
2004-07-26 00:00:00.000,ATP Masters Series Canada Toronto; Canada ATP World Tour,HARD,2,Roger Federer,Thomas Johansson,Roger Federer,4-6; 6-3; 6-2,S,104,8,0,46,77,38,46,19,31,3,4,14,57,77,6,1,51,87,31,51,21,36,5,8,13,52,87
2004-07-26 00:00:00.000,ATP Masters Series Canada Toronto; Canada ATP World Tour,HARD,2,Andy Roddick,Nicolas Kiefer,Andy Roddick,7-5; 6-3,S,82,8,4,42,70,33,42,15,28,3,3,11,48,70,5,4,33,59,27,33,11,26,3,5,10,38,59
2004-07-26 00:00:00.000,ATP Masters Series Canada Toronto; Canada ATP World Tour,HARD,2,Roger Federer,Andy Roddick,Roger Federer,7-5; 6-3,F,85,13,1,38,65,28,38,19,27,4,4,11,47,65,4,2,49,72,33,49,11,23,7,9,10,44,72
2004-08-02 00:00:00.000,ATP Masters Series Cincinnati Ohio; USA ATP World Tour,HARD,2,Dominik Hrbaty,Roger Federer,Dominik Hrbaty,1-6; 7-6(7); 6-4,R64,110,4,7,59,101,39,59,26,42,8,10,14,65,101,11,2,55,86,47,55,16,31,2,3,15,63,86
2004-08-02 00:00:00.000,ATP Masters Series Cincinnati Ohio; USA ATP World Tour,HARD,2,Jonas Bjorkman,Irakli Labadze,Jonas Bjorkman,2-6; 6-2; 6-1,R64,95,7,6,44,82,31,44,16,38,2,6,12,47,82,6,8,37,71,23,37,12,34,8,14,11,35,71
2004-08-02 00:00:00.000,ATP Masters Series Cincinnati Ohio; USA ATP World Tour,HARD,2,Fabrice Santoro,Robby Ginepri,Fabrice Santoro,6-3; 7-6(6),R64,85,5,1,32,64,28,32,18,32,0,1,11,46,64,6,1,45,75,27,45,17,30,9,11,10,44,75
2004-08-02 00:00:00.000,ATP Masters Series Cincinnati Ohio; USA ATP World Tour,HARD,2,Mikhail Youzhny,Nicolas Massu,Mikhail Youzhny,6-3; 3-6; 6-3,R64,141,9,4,39,90,33,39,25,51,4,6,14,58,90,8,3,60,110,44,60,20,50,9,12,13,64,110
2004-08-02 00:00:00.000,ATP Masters Series Cincinnati Ohio; USA ATP World Tour,HARD,2,Gaston Gaudio,Jan-Michael Gambill,Gaston Gaudio,6-4; 6-2,R64,70,4,3,29,49,25,29,13,20,2,2,9,38,49,8,5,32,52,26,32,4,20,1,4,9,30,52
2004-08-02 00:00:00.000,ATP Masters Series Cincinnati Ohio; USA ATP World Tour,HARD,2,Greg Rusedski,Thomas Enqvist,Greg Rusedski,3-6; 6-3; 6-2,R64,93,18,4,49,75,41,49,14,26,2,3,13,55,75,6,5,48,80,34,48,17,32,4,7,13,51,80
2004-08-02 00:00:00.000,ATP Masters Series Cincinnati Ohio; USA ATP World Tour,HARD,2,Tommy Robredo,Taylor Dent,Tommy Robredo,7-6(4); 6-3,R64,82,2,2,45,68,38,45,10,23,0,1,11,48,68,7,5,36,59,30,36,9,23,1,3,10,39,59
2004-08-02 00:00:00.000,ATP Masters Series Cincinnati Ohio; USA ATP World Tour,HARD,2,Juan Carlos Ferrero,Arnaud Clement,Juan Carlos Ferrero,6-4; 6-4,R64,85,10,0,40,58,31,40,12,18,4,4,10,43,58,5,2,29,59,24,29,16,30,2,4,10,40,59
2004-08-02 00:00:00.000,ATP Masters Series Cincinnati Ohio; USA ATP World Tour,HARD,2,Feliciano Lopez,Todd Reid,Feliciano Lopez,6-4; 6-4,R64,65,9,7,33,57,29,33,10,24,0,1,10,39,57,4,3,42,65,24,42,13,23,6,9,10,37,65
2004-08-02 00:00:00.000,ATP Masters Series Cincinnati Ohio; USA ATP World Tour,HARD,2,Ivo Karlovic,Wesley Moodie,Ivo Karlovic,6-7(2); 7-6(7); 7-6(9),R64,155,35,4,80,121,68,80,25,41,4,5,18,93,121,12,4,89,113,78,89,13,24,3,4,18,91,113
2004-08-02 00:00:00.000,ATP Masters Series Cincinnati Ohio; USA ATP World Tour,HARD,2,Jeff Morrison,Jurgen Melzer,Jeff Morrison,7-6(3); 6-2,R64,78,13,3,41,62,36,41,14,21,3,3,10,50,62,1,0,40,72,26,40,19,32,6,8,10,45,72
2004-08-02 00:00:00.000,ATP Masters Series Cincinnati Ohio; USA ATP World Tour,HARD,2,Marat Safin,Jiri Novak,Marat Safin,6-3; 6-0,R64,51,11,2,20,44,18,20,15,24,1,1,8,33,44,2,3,21,42,12,21,8,21,4,8,7,20,42
2004-08-02 00:00:00.000,ATP Masters Series Cincinnati Ohio; USA ATP World Tour,HARD,2,Lleyton Hewitt,Alex Bogomolov Jr.,Lleyton Hewitt,6-2; 6-4,R64,75,14,5,26,51,25,26,13,25,0,0,9,38,51,1,3,37,68,28,37,10,31,5,8,9,38,68
2004-08-02 00:00:00.000,ATP Masters Series Cincinnati Ohio; USA ATP World Tour,HARD,2,Gustavo Kuerten,Yen-Hsun Lu,Gustavo Kuerten,6-4; 3-6; 6-3,R64,113,13,5,45,80,36,45,18,35,3,5,14,54,80,7,9,49,96,37,49,21,47,7,10,14,58,96
2004-08-02 00:00:00.000,ATP Masters Series Cincinnati Ohio; USA ATP World Tour,HARD,2,Hicham Arazi,Vincent Spadea,Hicham Arazi,6-7(3); 7-5; 5-3 RET,R64,155,8,1,73,117,52,73,22,44,6,7,16,74,117,7,2,70,114,48,70,24,44,6,9,16,72,114
2004-08-02 00:00:00.000,ATP Masters Series Cincinnati Ohio; USA ATP World Tour,HARD,2,Tim Henman,Younes El Aynaoui,Tim Henman,6-1; 6-0,R64,51,6,2,24,35,20,24,8,11,0,0,7,28,35,0,6,29,46,13,29,5,17,3,8,6,18,46
2004-08-02 00:00:00.000,ATP Masters Series Cincinnati Ohio; USA ATP World Tour,HARD,2,Juan Ignacio Chela,Rafael Nadal,Juan Ignacio Chela,6-4; 4-6; 7-6(3),R64,137,11,1,68,95,54,68,15,27,4,6,16,69,95,2,3,68,98,49,68,16,30,7,9,16,65,98
2004-08-02 00:00:00.000,ATP Masters Series Cincinnati Ohio; USA ATP World Tour,HARD,2,Fernando Gonzalez,Dmitry Tursunov,Fernando Gonzalez,6-4; 6-4,R64,71,7,1,29,54,26,29,17,25,1,1,10,43,54,8,1,33,61,25,33,15,28,5,7,10,40,61
2004-08-02 00:00:00.000,ATP Masters Series Cincinnati Ohio; USA ATP World Tour,HARD,2,Thomas Johansson,Gregory Carraz,Thomas Johansson,7-6(3); 7-6(3),R64,89,17,0,41,65,38,41,19,24,1,1,12,57,65,17,5,59,84,45,59,13,25,6,6,12,58,84
2004-08-02 00:00:00.000,ATP Masters Series Cincinnati Ohio; USA ATP World Tour,HARD,2,Andre Agassi,Mardy Fish,Andre Agassi,4-6; 7-6(3); 4-1,R64,102,5,2,50,75,40,50,17,25,1,2,13,57,75,15,4,56,89,43,56,15,33,5,7,14,58,89
2004-08-02 00:00:00.000,ATP Masters Series Cincinnati Ohio; USA ATP World Tour,HARD,2,Wayne Arthurs,Andrei Pavel,Wayne Arthurs,7-6(5); 6-3,R64,72,18,1,45,60,36,45,11,15,0,0,11,47,60,4,1,52,69,36,52,9,17,4,5,10,45,69
2004-08-02 00:00:00.000,ATP Masters Series Cincinnati Ohio; USA ATP World Tour,HARD,2,Mariano Zabaleta,Michael Llodra,Mariano Zabaleta,6-4; 7-6(1),R64,87,6,3,49,73,39,49,13,24,3,3,11,52,73,6,2,52,70,39,52,7,18,5,6,11,46,70
2004-08-02 00:00:00.000,ATP Masters Series Cincinnati Ohio; USA ATP World Tour,HARD,2,Ivan Ljubicic,Xavier Malisse,Ivan Ljubicic,4-6; 7-6(5); 7-6(5),R64,145,18,2,50,114,39,50,40,64,5,7,17,79,114,21,2,59,98,51,59,26,39,2,3,17,77,98
2004-08-02 00:00:00.000,ATP Masters Series Cincinnati Ohio; USA ATP World Tour,HARD,2,Carlos Moya,Arvind Parmar,Carlos Moya,3-6; 7-5; 6-2,R64,111,7,4,45,74,33,45,19,29,1,3,14,52,74,10,3,69,105,46,69,14,36,13,17,15,60,105
2004-08-02 00:00:00.000,ATP Masters Series Cincinnati Ohio; USA ATP World Tour,HARD,2,Tommy Haas,Rainer Schuettler,Tommy Haas,6-3; 1-6; 6-4,R64,94,8,2,38,72,30,38,18,34,2,4,13,48,72,6,2,42,72,33,42,17,30,3,5,13,50,72
2004-08-02 00:00:00.000,ATP Masters Series Cincinnati Ohio; USA ATP World Tour,HARD,2,Sargis Sargsian,Michel Kratochvil,Sargis Sargsian,2-6; 6-2; 7-5,R64,119,7,3,50,81,38,50,17,31,1,3,14,55,81,9,6,51,98,35,51,25,47,8,11,14,60,98
2004-08-02 00:00:00.000,ATP Masters Series Cincinnati Ohio; USA ATP World Tour,HARD,2,Luis Horna,Fernando Verdasco,Luis Horna,7-6(4); 7-6(3),R64,91,13,1,49,74,40,49,17,25,0,0,12,57,74,8,5,50,82,34,50,23,32,2,2,12,57,82
2004-08-02 00:00:00.000,ATP Masters Series Cincinnati Ohio; USA ATP World Tour,HARD,2,Robin Soderling,Sebastien Grosjean,Robin Soderling,3-6; 6-3; 6-4,R64,93,6,1,46,71,36,46,19,25,4,5,14,55,71,18,4,47,79,39,47,17,32,2,4,14,56,79
2004-08-02 00:00:00.000,ATP Masters Series Cincinnati Ohio; USA ATP World Tour,HARD,2,Paradorn Srichaphan,David Ferrer,Paradorn Srichaphan,6-3; 5-7; 6-3,R64,123,11,7,62,99,47,62,17,37,5,8,15,64,99,0,1,51,87,32,51,19,36,1,6,15,51,87
2004-08-02 00:00:00.000,ATP Masters Series Cincinnati Ohio; USA ATP World Tour,HARD,2,Sjeng Schalken,Dick Norman,Sjeng Schalken,6-4; 6-3,R64,62,3,0,38,48,34,38,7,10,0,0,10,41,48,4,7,26,53,20,26,12,27,2,4,9,32,53
2004-08-02 00:00:00.000,ATP Masters Series Cincinnati Ohio; USA ATP World Tour,HARD,2,Nicolas Kiefer,Joachim Johansson,Nicolas Kiefer,6-3; 7-6(2),R64,84,13,0,40,61,36,40,13,21,2,2,11,49,61,11,6,38,59,30,38,11,21,1,2,10,41,59
2004-08-02 00:00:00.000,ATP Masters Series Cincinnati Ohio; USA ATP World Tour,HARD,2,Andy Roddick,Max Mirnyi,Andy Roddick,6-7(5); 7-6(5); 6-3,R64,138,22,1,66,101,57,66,18,35,2,2,16,75,101,21,7,72,117,57,72,21,45,7,9,17,78,117
2004-08-02 00:00:00.000,ATP Masters Series Cincinnati Ohio; USA ATP World Tour,HARD,2,Jonas Bjorkman,Dominik Hrbaty,Jonas Bjorkman,6-7(6); 6-3; 6-3,R32,136,7,2,60,103,41,60,22,43,8,12,15,63,103,5,5,67,119,43,67,21,52,12,19,15,64,119
2004-08-02 00:00:00.000,ATP Masters Series Cincinnati Ohio; USA ATP World Tour,HARD,2,Fabrice Santoro,Mikhail Youzhny,Fabrice Santoro,7-5; 6-3,R32,87,2,2,35,69,25,35,20,34,4,5,10,45,69,2,3,31,64,21,31,14,33,2,6,11,35,64
2004-08-02 00:00:00.000,ATP Masters Series Cincinnati Ohio; USA ATP World Tour,HARD,2,Greg Rusedski,Gaston Gaudio,Greg Rusedski,4-6; 7-6(3); 6-4,R32,127,16,10,46,90,40,46,27,44,1,2,16,67,90,6,3,66,101,47,66,22,35,4,5,16,69,101
2004-08-02 00:00:00.000,ATP Masters Series Cincinnati Ohio; USA ATP World Tour,HARD,2,Tommy Robredo,Juan Carlos Ferrero,Tommy Robredo,7-6(5); 4-6; 6-4,R32,168,8,5,78,118,56,78,18,40,3,6,16,74,118,4,1,76,113,48,76,21,37,9,12,16,69,113
2004-08-02 00:00:00.000,ATP Masters Series Cincinnati Ohio; USA ATP World Tour,HARD,2,Ivo Karlovic,Feliciano Lopez,Ivo Karlovic,7-6(9); 6-4,R32,84,19,2,42,66,37,42,17,24,0,0,11,54,66,12,4,48,84,40,48,16,36,5,6,11,56,84
2004-08-02 00:00:00.000,ATP Masters Series Cincinnati Ohio; USA ATP World Tour,HARD,2,Marat Safin,Jeff Morrison,Marat Safin,6-4; 6-4,R32,72,6,2,23,50,23,23,17,27,0,0,10,40,50,8,1,36,58,26,36,14,22,5,7,10,40,58
2004-08-02 00:00:00.000,ATP Masters Series Cincinnati Ohio; USA ATP World Tour,HARD,2,Lleyton Hewitt,Gustavo Kuerten,Lleyton Hewitt,6-3; 6-4,R32,67,10,2,34,57,30,34,11,23,0,1,10,41,57,3,3,27,52,18,27,13,25,2,5,9,31,52
2004-08-02 00:00:00.000,ATP Masters Series Cincinnati Ohio; USA ATP World Tour,HARD,2,Tim Henman,Hicham Arazi,Tim Henman,4-6; 6-3; 7-5,R32,131,3,2,68,108,51,68,21,40,7,8,16,72,108,1,1,64,99,46,64,16,35,1,3,15,62,99
2004-08-02 00:00:00.000,ATP Masters Series Cincinnati Ohio; USA ATP World Tour,HARD,2,Juan Ignacio Chela,Fernando Gonzalez,Juan Ignacio Chela,2-6; 6-3; 6-2,R32,102,5,5,50,82,36,50,16,32,1,4,13,52,82,8,5,29,65,23,29,15,36,2,6,12,38,65
2004-08-02 00:00:00.000,ATP Masters Series Cincinnati Ohio; USA ATP World Tour,HARD,2,Andre Agassi,Thomas Johansson,Andre Agassi,6-1; 3-6; 6-1,R32,92,7,5,38,76,27,38,24,38,4,5,12,51,76,7,5,39,83,30,39,16,44,3,7,11,46,83
2004-08-02 00:00:00.000,ATP Masters Series Cincinnati Ohio; USA ATP World Tour,HARD,2,Wayne Arthurs,Mariano Zabaleta,Wayne Arthurs,6-2; 7-6(6),R32,80,17,4,46,78,35,46,20,32,9,9,10,55,78,2,2,45,62,32,45,10,17,0,2,10,42,62
2004-08-02 00:00:00.000,ATP Masters Series Cincinnati Ohio; USA ATP World Tour,HARD,2,Carlos Moya,Ivan Ljubicic,Carlos Moya,6-4; 4-6; 6-4,R32,118,8,1,57,93,44,57,20,36,5,7,15,64,93,23,2,51,86,45,51,14,35,4,7,15,59,86
2004-08-02 00:00:00.000,ATP Masters Series Cincinnati Ohio; USA ATP World Tour,HARD,2,Tommy Haas,Sargis Sargsian,Tommy Haas,6-3; 6-3,R32,75,3,4,36,65,27,36,16,29,3,3,9,43,65,3,1,36,54,23,36,8,18,4,7,9,31,54
2004-08-02 00:00:00.000,ATP Masters Series Cincinnati Ohio; USA ATP World Tour,HARD,2,Robin Soderling,Luis Horna,Robin Soderling,6-2; 6-3,R32,59,7,2,29,52,26,29,13,23,1,1,9,39,52,7,6,39,53,26,39,3,14,3,6,8,29,53
2004-08-02 00:00:00.000,ATP Masters Series Cincinnati Ohio; USA ATP World Tour,HARD,2,Paradorn Srichaphan,Sjeng Schalken,Paradorn Srichaphan,6-3; 6-4,R32,76,16,2,37,62,33,37,11,25,6,7,10,44,62,1,0,46,64,27,46,8,18,3,6,9,35,64
2004-08-02 00:00:00.000,ATP Masters Series Cincinnati Ohio; USA ATP World Tour,HARD,2,Andy Roddick,Nicolas Kiefer,Andy Roddick,6-4; 6-4,R32,80,11,2,42,69,33,42,14,27,5,5,10,47,69,8,3,28,53,23,28,13,25,0,2,10,36,53
2004-08-02 00:00:00.000,ATP Masters Series Cincinnati Ohio; USA ATP World Tour,HARD,2,Fabrice Santoro,Jonas Bjorkman,Fabrice Santoro,6-0; 6-3,R16,64,3,1,21,32,19,21,9,11,0,0,7,28,32,3,3,30,57,18,30,10,27,5,10,8,28,57
2004-08-02 00:00:00.000,ATP Masters Series Cincinnati Ohio; USA ATP World Tour,HARD,2,Tommy Robredo,Greg Rusedski,Tommy Robredo,7-6(4); 7-6(2),R16,98,2,2,65,79,48,65,7,14,2,4,12,55,79,5,4,51,80,38,51,14,29,2,4,12,52,80
2004-08-02 00:00:00.000,ATP Masters Series Cincinnati Ohio; USA ATP World Tour,HARD,2,Marat Safin,Ivo Karlovic,Marat Safin,7-6(4); 6-7(3); 6-4,R16,146,14,8,59,105,52,59,31,46,3,3,17,83,105,27,5,72,122,57,72,28,50,8,9,17,85,122
2004-08-02 00:00:00.000,ATP Masters Series Cincinnati Ohio; USA ATP World Tour,HARD,2,Lleyton Hewitt,Tim Henman,Lleyton Hewitt,6-1; 6-4,R16,64,8,0,24,43,21,24,15,19,0,0,9,36,43,3,2,24,49,13,24,14,25,7,10,8,27,49
2004-08-02 00:00:00.000,ATP Masters Series Cincinnati Ohio; USA ATP World Tour,HARD,2,Andre Agassi,Juan Ignacio Chela,Andre Agassi,6-3; 6-3,R16,62,7,3,40,53,30,40,10,13,2,2,9,40,53,5,3,36,57,22,36,10,21,5,8,9,32,57
2004-08-02 00:00:00.000,ATP Masters Series Cincinnati Ohio; USA ATP World Tour,HARD,2,Carlos Moya,Wayne Arthurs,Carlos Moya,7-6(5); 4-6; 7-6(5),R16,130,6,2,79,114,58,79,22,35,6,8,17,80,114,23,5,58,113,46,58,34,55,6,7,17,80,113
2004-08-02 00:00:00.000,ATP Masters Series Cincinnati Ohio; USA ATP World Tour,HARD,2,Tommy Haas,Robin Soderling,Tommy Haas,6-3; 5-7; 6-4,R16,107,9,4,52,92,39,52,24,40,1,3,16,63,92,3,3,54,78,40,54,11,24,0,3,15,51,78
2004-08-02 00:00:00.000,ATP Masters Series Cincinnati Ohio; USA ATP World Tour,HARD,2,Andy Roddick,Paradorn Srichaphan,Andy Roddick,6-2; 6-3,R16,54,12,1,27,41,24,27,12,14,0,0,9,36,41,3,0,32,53,20,32,10,21,7,10,8,30,53
2004-08-02 00:00:00.000,ATP Masters Series Cincinnati Ohio; USA ATP World Tour,HARD,2,Tommy Robredo,Fabrice Santoro,Tommy Robredo,6-2; 6-3,Q,80,0,1,53,72,33,53,9,19,9,11,9,42,72,2,3,24,49,12,24,8,25,5,10,8,20,49
2004-08-02 00:00:00.000,ATP Masters Series Cincinnati Ohio; USA ATP World Tour,HARD,2,Lleyton Hewitt,Marat Safin,Lleyton Hewitt,6-4; 6-4,Q,83,2,1,25,57,20,25,22,32,2,2,10,42,57,10,3,29,56,20,29,17,27,1,3,10,37,56
2004-08-02 00:00:00.000,ATP Masters Series Cincinnati Ohio; USA ATP World Tour,HARD,2,Andre Agassi,Carlos Moya,Andre Agassi,7-6(12); 6-3,Q,91,8,2,52,81,41,52,16,29,4,5,11,57,81,10,4,44,77,34,44,16,33,2,4,10,50,77
2004-08-02 00:00:00.000,ATP Masters Series Cincinnati Ohio; USA ATP World Tour,HARD,2,Andy Roddick,Tommy Haas,Andy Roddick,6-3; 6-3,Q,67,11,3,32,52,24,32,10,20,2,3,9,34,52,2,2,39,57,24,39,6,18,3,7,9,30,57
2004-08-02 00:00:00.000,ATP Masters Series Cincinnati Ohio; USA ATP World Tour,HARD,2,Lleyton Hewitt,Tommy Robredo,Lleyton Hewitt,6-3; 6-2,S,54,7,0,25,42,22,25,14,17,0,0,9,36,42,5,2,28,41,21,28,3,13,2,5,8,24,41
2004-08-02 00:00:00.000,ATP Masters Series Cincinnati Ohio; USA ATP World Tour,HARD,2,Andre Agassi,Andy Roddick,Andre Agassi,7-5; 6-7(2); 7-6(2),S,126,16,3,65,99,53,65,27,34,0,0,18,80,99,30,3,67,107,58,67,21,40,3,4,18,79,107
2004-08-02 00:00:00.000,ATP Masters Series Cincinnati Ohio; USA ATP World Tour,HARD,2,Andre Agassi,Lleyton Hewitt,Andre Agassi,6-3; 3-6; 6-2,F,107,7,1,47,77,36,47,17,30,4,5,13,53,77,13,5,33,79,29,33,22,46,2,5,13,51,79
2004-08-09 00:00:00.000,Sopot Poland ATP World Tour,CLAY,2,Marat Safin,Galo Blanco,Marat Safin,7-5; 6-2,R32,91,6,0,31,60,22,31,18,29,4,5,10,40,60,2,4,31,68,19,31,16,37,4,8,10,35,68
2004-08-09 00:00:00.000,Sopot Poland ATP World Tour,CLAY,2,Marc Lopez,Oscar Hernandez,Marc Lopez,7-5; 6-2,R32,96,0,1,41,59,30,41,5,18,3,6,10,35,59,0,1,52,72,27,52,7,20,6,12,10,34,72
2004-08-09 00:00:00.000,Sopot Poland ATP World Tour,CLAY,2,Marc Rosset,Filip Urban,Marc Rosset,6-4; 7-6(6),R32,121,7,10,39,77,31,39,20,38,1,3,11,51,77,3,5,44,87,35,44,17,43,2,5,11,52,87
2004-08-09 00:00:00.000,Sopot Poland ATP World Tour,CLAY,2,Juan Monaco,Alberto Martin,Juan Monaco,6-7(13); 7-5; 6-3,R32,165,1,3,88,127,55,88,20,39,7,12,16,75,127,6,2,81,121,47,81,20,40,7,15,17,67,121
2004-08-09 00:00:00.000,Sopot Poland ATP World Tour,CLAY,2,David Ferrer,Guillermo Garcia-Lopez,David Ferrer,6-4; 6-3,R32,108,1,1,49,78,29,49,15,29,6,9,9,44,78,2,4,48,72,25,48,8,24,9,15,10,33,72
2004-08-09 00:00:00.000,Sopot Poland ATP World Tour,CLAY,2,Jose Acasuso,Michal Przysiezny,Jose Acasuso,7-5; 6-4,R32,79,4,2,39,65,30,39,16,26,0,1,11,46,65,3,3,29,53,21,29,13,24,1,4,11,34,53
2004-08-09 00:00:00.000,Sopot Poland ATP World Tour,CLAY,2,Jiri Vanek,Bohdan Ulihrach,Jiri Vanek,2-6; 6-2; 7-6(5),R32,136,8,4,77,104,51,77,10,27,8,12,14,61,104,3,4,85,119,48,85,17,34,4,8,14,65,119
2004-08-09 00:00:00.000,Sopot Poland ATP World Tour,CLAY,2,Stefan Koubek,Paul-Henri Mathieu,Stefan Koubek,3-6; 6-1; 6-3,R32,104,5,0,48,65,33,48,14,17,2,4,12,47,65,4,2,55,90,32,55,17,35,9,14,13,49,90
2004-08-09 00:00:00.000,Sopot Poland ATP World Tour,CLAY,2,Rafael Nadal,Victor Hanescu,Rafael Nadal,6-4; 6-4,R32,81,3,1,38,47,34,38,4,9,1,2,10,38,47,4,1,48,66,33,48,7,18,3,6,10,40,66
2004-08-09 00:00:00.000,Sopot Poland ATP World Tour,CLAY,2,Arnaud Di Pasquale,Alex Calatrava,Arnaud Di Pasquale,6-4; 3-6; 6-4,R32,133,3,4,72,90,46,72,9,18,5,10,15,55,90,4,2,60,81,34,60,11,21,6,11,14,45,81
2004-08-09 00:00:00.000,Sopot Poland ATP World Tour,CLAY,2,Franco Squillari,Tomas Zib,Franco Squillari,6-4; 6-2,R32,78,4,5,35,60,27,35,15,25,5,5,9,42,60,1,1,33,63,26,33,9,30,0,3,9,35,63
2004-08-09 00:00:00.000,Sopot Poland ATP World Tour,CLAY,2,Lukasz Kubot,Igor Andreev,Lukasz Kubot,6-4; 6-2,R32,81,2,3,30,50,23,30,12,20,1,2,9,35,50,3,2,38,68,21,38,13,30,8,12,9,34,68
2004-08-09 00:00:00.000,Sopot Poland ATP World Tour,CLAY,2,Felix Mantilla,Albert Montanes,Felix Mantilla,6-0; 6-2,R32,44,4,1,19,37,16,19,11,18,0,1,7,27,37,2,3,23,34,9,23,1,11,2,8,7,10,34
2004-08-09 00:00:00.000,Sopot Poland ATP World Tour,CLAY,2,Albert Portas,Martin Vassallo Arguello,Albert Portas,6-1; 6-2,R32,72,1,1,35,52,26,35,10,17,1,1,8,36,52,1,0,36,57,19,36,8,21,8,12,7,27,57
2004-08-09 00:00:00.000,Sopot Poland ATP World Tour,CLAY,2,Olivier Mutis,Ruben Ramirez Hidalgo,Olivier Mutis,6-4; 6-3,R32,68,2,2,22,54,15,22,19,32,2,4,9,34,54,1,0,39,53,24,39,5,14,3,8,10,29,53
2004-08-09 00:00:00.000,Sopot Poland ATP World Tour,CLAY,2,Adrian Garcia,Nikolay Davydenko,Adrian Garcia,3-6; 7-6(5); 6-4,R32,140,1,1,60,102,38,60,26,42,7,10,15,64,102,9,2,57,96,42,57,22,39,2,5,16,64,96
2004-08-09 00:00:00.000,Sopot Poland ATP World Tour,CLAY,2,Marc Lopez,Marat Safin,Marc Lopez,6-3; 6-2,R16,75,0,0,23,48,18,23,17,25,1,1,8,35,48,5,1,40,59,27,40,4,19,5,9,9,31,59
2004-08-09 00:00:00.000,Sopot Poland ATP World Tour,CLAY,2,Juan Monaco,Marc Rosset,Juan Monaco,6-4; 6-3,R16,82,2,2,57,69,35,57,6,12,7,9,10,41,69,2,1,37,52,22,37,5,15,3,7,9,27,52
2004-08-09 00:00:00.000,Sopot Poland ATP World Tour,CLAY,2,Jose Acasuso,David Ferrer,Jose Acasuso,6-4; 7-6(4),R16,102,3,3,46,76,32,46,18,30,0,1,11,50,76,8,3,52,75,35,52,13,23,3,5,11,48,75
2004-08-09 00:00:00.000,Sopot Poland ATP World Tour,CLAY,2,Jiri Vanek,Stefan Koubek,Jiri Vanek,6-4; 6-4,R16,81,1,0,40,61,30,40,16,21,2,2,10,46,61,2,2,50,73,36,50,9,23,4,6,10,45,73
2004-08-09 00:00:00.000,Sopot Poland ATP World Tour,CLAY,2,Rafael Nadal,Arnaud Di Pasquale,Rafael Nadal,6-2; 6-4,R16,79,1,0,31,51,24,31,10,20,0,1,9,34,51,2,5,37,51,22,37,4,14,0,4,9,26,51
2004-08-09 00:00:00.000,Sopot Poland ATP World Tour,CLAY,2,Franco Squillari,Lukasz Kubot,Franco Squillari,6-2; 6-3,R16,75,3,0,32,50,24,32,11,18,2,2,8,35,50,1,3,34,52,24,34,4,18,5,9,9,28,52
2004-08-09 00:00:00.000,Sopot Poland ATP World Tour,CLAY,2,Felix Mantilla,Albert Portas,Felix Mantilla,5-7; 7-5; 7-5,R16,156,8,2,64,134,44,64,31,70,16,22,18,75,134,5,3,75,100,51,75,6,25,4,11,18,57,100
2004-08-09 00:00:00.000,Sopot Poland ATP World Tour,CLAY,2,Adrian Garcia,Olivier Mutis,Adrian Garcia,6-2; 7-6(9),R16,78,7,2,46,68,31,46,9,22,6,10,10,40,68,3,3,54,79,28,54,8,25,8,14,10,36,79
2004-08-09 00:00:00.000,Sopot Poland ATP World Tour,CLAY,2,Juan Monaco,Marc Lopez,Juan Monaco,6-3; 2-6; 7-6(6),Q,142,2,1,83,97,50,83,6,14,2,7,15,56,97,0,2,61,85,42,61,7,24,3,7,14,49,85
2004-08-09 00:00:00.000,Sopot Poland ATP World Tour,CLAY,2,Jose Acasuso,Jiri Vanek,Jose Acasuso,3-6; 6-3; 6-2,Q,99,1,1,34,71,29,34,23,37,0,1,13,52,71,5,5,53,86,40,53,15,33,11,14,13,55,86
2004-08-09 00:00:00.000,Sopot Poland ATP World Tour,CLAY,2,Rafael Nadal,Franco Squillari,Rafael Nadal,6-3; 6-4,Q,158,1,0,51,59,33,51,5,8,4,6,10,38,59,1,3,39,60,22,39,8,21,0,4,9,30,60
2004-08-09 00:00:00.000,Sopot Poland ATP World Tour,CLAY,2,Felix Mantilla,Adrian Garcia,Felix Mantilla,6-3; 6-3,Q,81,0,2,41,61,29,41,12,20,6,7,9,41,61,0,2,44,64,28,44,8,20,7,11,9,36,64
2004-08-09 00:00:00.000,Sopot Poland ATP World Tour,CLAY,2,Jose Acasuso,Juan Monaco,Jose Acasuso,6-4; 6-2,S,78,2,2,30,59,20,30,17,29,1,2,9,37,59,0,1,37,52,21,37,8,15,3,7,9,29,52
2004-08-09 00:00:00.000,Sopot Poland ATP World Tour,CLAY,2,Rafael Nadal,Felix Mantilla,Rafael Nadal,7-5; 6-1,S,94,2,2,45,62,31,45,8,17,3,5,10,39,62,2,4,31,59,18,31,8,28,9,14,9,26,59
2004-08-09 00:00:00.000,Sopot Poland ATP World Tour,CLAY,2,Rafael Nadal,Jose Acasuso,Rafael Nadal,6-3; 6-4,F,96,4,1,60,76,43,60,6,16,11,12,10,49,76,9,3,40,65,29,40,9,25,10,13,9,38,65
2004-08-16 00:00:00.000,Athens Olympics Greece ATP World Tour,HARD,2,Roger Federer,Nikolay Davydenko,Roger Federer,6-3; 5-7; 6-1,R64,0,0,0,0,0,0,0,0,0,0,0,0,0,0,0,0,0,0,0,0,0,0,0,0,0,0,0
2004-08-16 00:00:00.000,Athens Olympics Greece ATP World Tour,HARD,2,Tomas Berdych,Florian Mayer,Tomas Berdych,6-3; 7-5,R64,0,0,0,0,0,0,0,0,0,0,0,0,0,0,0,0,0,0,0,0,0,0,0,0,0,0,0
2004-08-16 00:00:00.000,Athens Olympics Greece ATP World Tour,HARD,2,Fabrice Santoro,Filippo Volandri,Fabrice Santoro,6-2; 6-1,R64,0,0,0,0,0,0,0,0,0,0,0,0,0,0,0,0,0,0,0,0,0,0,0,0,0,0,0
2004-08-16 00:00:00.000,Athens Olympics Greece ATP World Tour,HARD,2,Tommy Robredo,Lamine Ouahab,Tommy Robredo,6-3; 6-4,R64,0,0,0,0,0,0,0,0,0,0,0,0,0,0,0,0,0,0,0,0,0,0,0,0,0,0,0
2004-08-16 00:00:00.000,Athens Olympics Greece ATP World Tour,HARD,2,Joachim Johansson,Paradorn Srichaphan,Joachim Johansson,6-2; 6-3,R64,0,0,0,0,0,0,0,0,0,0,0,0,0,0,0,0,0,0,0,0,0,0,0,0,0,0,0
2004-08-16 00:00:00.000,Athens Olympics Greece ATP World Tour,HARD,2,Ivan Ljubicic,Sargis Sargsian,Ivan Ljubicic,6-3; 6-4,R64,0,0,0,0,0,0,0,0,0,0,0,0,0,0,0,0,0,0,0,0,0,0,0,0,0,0,0
2004-08-16 00:00:00.000,Athens Olympics Greece ATP World Tour,HARD,2,Dominik Hrbaty,Younes El Aynaoui,Dominik Hrbaty,6-3; 6-4,R64,0,0,0,0,0,0,0,0,0,0,0,0,0,0,0,0,0,0,0,0,0,0,0,0,0,0,0
2004-08-16 00:00:00.000,Athens Olympics Greece ATP World Tour,HARD,2,Taylor Dent,Frederic Niemeyer,Taylor Dent,6-2; 3-6; 6-4,R64,0,0,0,0,0,0,0,0,0,0,0,0,0,0,0,0,0,0,0,0,0,0,0,0,0,0,0
2004-08-16 00:00:00.000,Athens Olympics Greece ATP World Tour,HARD,2,Carlos Moya,Thomas Enqvist,Carlos Moya,7-6(7); 6-7(8); 9-7,R64,0,0,0,0,0,0,0,0,0,0,0,0,0,0,0,0,0,0,0,0,0,0,0,0,0,0,0
2004-08-16 00:00:00.000,Athens Olympics Greece ATP World Tour,HARD,2,Olivier Rochus,Mark Philippoussis,Olivier Rochus,3-6; 6-0; 6-1,R64,0,0,0,0,0,0,0,0,0,0,0,0,0,0,0,0,0,0,0,0,0,0,0,0,0,0,0
2004-08-16 00:00:00.000,Athens Olympics Greece ATP World Tour,HARD,2,Arnaud Clement,Nicolas Lapentti,Arnaud Clement,7-6(5); 6-2,R64,0,0,0,0,0,0,0,0,0,0,0,0,0,0,0,0,0,0,0,0,0,0,0,0,0,0,0
2004-08-16 00:00:00.000,Athens Olympics Greece ATP World Tour,HARD,2,Ivo Karlovic,Andrei Pavel,Ivo Karlovic,6-4; 6-7(10); 6-2,R64,0,0,0,0,0,0,0,0,0,0,0,0,0,0,0,0,0,0,0,0,0,0,0,0,0,0,0
2004-08-16 00:00:00.000,Athens Olympics Greece ATP World Tour,HARD,2,Nicolas Massu,Gustavo Kuerten,Nicolas Massu,6-3; 5-7; 6-4,R64,0,0,0,0,0,0,0,0,0,0,0,0,0,0,0,0,0,0,0,0,0,0,0,0,0,0,0
2004-08-16 00:00:00.000,Athens Olympics Greece ATP World Tour,HARD,2,Vincent Spadea,Jurgen Melzer,Vincent Spadea,6-0; 6-1,R64,0,0,0,0,0,0,0,0,0,0,0,0,0,0,0,0,0,0,0,0,0,0,0,0,0,0,0
2004-08-16 00:00:00.000,Athens Olympics Greece ATP World Tour,HARD,2,Agustin Calleri,Karol Beck,Agustin Calleri,2-6; 6-3; 8-6,R64,0,0,0,0,0,0,0,0,0,0,0,0,0,0,0,0,0,0,0,0,0,0,0,0,0,0,0
2004-08-16 00:00:00.000,Athens Olympics Greece ATP World Tour,HARD,2,Igor Andreev,Rainer Schuettler,Igor Andreev,6-7(5); 7-6(2); 6-2,R64,0,0,0,0,0,0,0,0,0,0,0,0,0,0,0,0,0,0,0,0,0,0,0,0,0,0,0
2004-08-16 00:00:00.000,Athens Olympics Greece ATP World Tour,HARD,2,Juan Carlos Ferrero,Hicham Arazi,Juan Carlos Ferrero,6-3; 6-1,R64,0,0,0,0,0,0,0,0,0,0,0,0,0,0,0,0,0,0,0,0,0,0,0,0,0,0,0
2004-08-16 00:00:00.000,Athens Olympics Greece ATP World Tour,HARD,2,Mardy Fish,Jonas Bjorkman,Mardy Fish,7-6(7); 1-0 RET,R64,0,0,0,0,0,0,0,0,0,0,0,0,0,0,0,0,0,0,0,0,0,0,0,0,0,0,0
2004-08-16 00:00:00.000,Athens Olympics Greece ATP World Tour,HARD,2,Jarkko Nieminen,Yen-Hsun Lu,Jarkko Nieminen,6-3; 6-3,R64,0,0,0,0,0,0,0,0,0,0,0,0,0,0,0,0,0,0,0,0,0,0,0,0,0,0,0
2004-08-16 00:00:00.000,Athens Olympics Greece ATP World Tour,HARD,2,Max Mirnyi,Juan Ignacio Chela,Max Mirnyi,3-6; 7-6(0); 6-4,R64,0,0,0,0,0,0,0,0,0,0,0,0,0,0,0,0,0,0,0,0,0,0,0,0,0,0,0
2004-08-16 00:00:00.000,Athens Olympics Greece ATP World Tour,HARD,2,Nicolas Kiefer,Vladimir Voltchkov,Nicolas Kiefer,6-2; 6-4,R64,0,0,0,0,0,0,0,0,0,0,0,0,0,0,0,0,0,0,0,0,0,0,0,0,0,0,0
2004-08-16 00:00:00.000,Athens Olympics Greece ATP World Tour,HARD,2,Marcos Baghdatis,Gregory Carraz,Marcos Baghdatis,5-7; 7-6(5); 7-5,R64,0,0,0,0,0,0,0,0,0,0,0,0,0,0,0,0,0,0,0,0,0,0,0,0,0,0,0
2004-08-16 00:00:00.000,Athens Olympics Greece ATP World Tour,HARD,2,Mikhail Youzhny,Xavier Malisse,Mikhail Youzhny,6-2; 6-2,R64,0,0,0,0,0,0,0,0,0,0,0,0,0,0,0,0,0,0,0,0,0,0,0,0,0,0,0
2004-08-16 00:00:00.000,Athens Olympics Greece ATP World Tour,HARD,2,Jiri Novak,Tim Henman,Jiri Novak,6-3; 6-3,R64,0,0,0,0,0,0,0,0,0,0,0,0,0,0,0,0,0,0,0,0,0,0,0,0,0,0,0
2004-08-16 00:00:00.000,Athens Olympics Greece ATP World Tour,HARD,2,Sebastien Grosjean,Luis Horna,Sebastien Grosjean,6-2; 7-5,R64,0,0,0,0,0,0,0,0,0,0,0,0,0,0,0,0,0,0,0,0,0,0,0,0,0,0,0
2004-08-16 00:00:00.000,Athens Olympics Greece ATP World Tour,HARD,2,Wayne Arthurs,Victor Hanescu,Wayne Arthurs,6-4; 7-6(4),R64,0,0,0,0,0,0,0,0,0,0,0,0,0,0,0,0,0,0,0,0,0,0,0,0,0,0,0
2004-08-16 00:00:00.000,Athens Olympics Greece ATP World Tour,HARD,2,Feliciano Lopez,Robin Soderling,Feliciano Lopez,6-3; 3-6; 6-4,R64,0,0,0,0,0,0,0,0,0,0,0,0,0,0,0,0,0,0,0,0,0,0,0,0,0,0,0
2004-08-16 00:00:00.000,Athens Olympics Greece ATP World Tour,HARD,2,Marat Safin,Karol Kucera,Marat Safin,6-0; 6-4,R64,0,0,0,0,0,0,0,0,0,0,0,0,0,0,0,0,0,0,0,0,0,0,0,0,0,0,0
2004-08-16 00:00:00.000,Athens Olympics Greece ATP World Tour,HARD,2,Fernando Gonzalez,Konstantinos Economidis,Fernando Gonzalez,7-6(6); 6-2,R64,0,0,0,0,0,0,0,0,0,0,0,0,0,0,0,0,0,0,0,0,0,0,0,0,0,0,0
2004-08-16 00:00:00.000,Athens Olympics Greece ATP World Tour,HARD,2,Hyung-Taik Lee,Mariano Zabaleta,Hyung-Taik Lee,4-6; 6-3; 6-2,R64,0,0,0,0,0,0,0,0,0,0,0,0,0,0,0,0,0,0,0,0,0,0,0,0,0,0,0
2004-08-16 00:00:00.000,Athens Olympics Greece ATP World Tour,HARD,2,Tommy Haas,Mario Ancic,Tommy Haas,6-1; 7-5,R64,0,0,0,0,0,0,0,0,0,0,0,0,0,0,0,0,0,0,0,0,0,0,0,0,0,0,0
2004-08-16 00:00:00.000,Athens Olympics Greece ATP World Tour,HARD,2,Andy Roddick,Flavio Saretta,Andy Roddick,6-3; 7-6(4),R64,0,0,0,0,0,0,0,0,0,0,0,0,0,0,0,0,0,0,0,0,0,0,0,0,0,0,0
2004-08-16 00:00:00.000,Athens Olympics Greece ATP World Tour,HARD,2,Tomas Berdych,Roger Federer,Tomas Berdych,4-6; 7-5; 7-5,R32,0,0,0,0,0,0,0,0,0,0,0,0,0,0,0,0,0,0,0,0,0,0,0,0,0,0,0
2004-08-16 00:00:00.000,Athens Olympics Greece ATP World Tour,HARD,2,Tommy Robredo,Fabrice Santoro,Tommy Robredo,1-6; 6-3; 6-4,R32,0,0,0,0,0,0,0,0,0,0,0,0,0,0,0,0,0,0,0,0,0,0,0,0,0,0,0
2004-08-16 00:00:00.000,Athens Olympics Greece ATP World Tour,HARD,2,Ivan Ljubicic,Joachim Johansson,Ivan Ljubicic,7-6(3); 6-4,R32,0,0,0,0,0,0,0,0,0,0,0,0,0,0,0,0,0,0,0,0,0,0,0,0,0,0,0
2004-08-16 00:00:00.000,Athens Olympics Greece ATP World Tour,HARD,2,Taylor Dent,Dominik Hrbaty,Taylor Dent,7-6(4); 6-3,R32,0,0,0,0,0,0,0,0,0,0,0,0,0,0,0,0,0,0,0,0,0,0,0,0,0,0,0
2004-08-16 00:00:00.000,Athens Olympics Greece ATP World Tour,HARD,2,Carlos Moya,Olivier Rochus,Carlos Moya,6-0; 7-6(3),R32,0,0,0,0,0,0,0,0,0,0,0,0,0,0,0,0,0,0,0,0,0,0,0,0,0,0,0
2004-08-16 00:00:00.000,Athens Olympics Greece ATP World Tour,HARD,2,Ivo Karlovic,Arnaud Clement,Ivo Karlovic,7-6(4); 4-6; 6-4,R32,0,0,0,0,0,0,0,0,0,0,0,0,0,0,0,0,0,0,0,0,0,0,0,0,0,0,0
2004-08-16 00:00:00.000,Athens Olympics Greece ATP World Tour,HARD,2,Nicolas Massu,Vincent Spadea,Nicolas Massu,7-6(3); 6-2,R32,0,0,0,0,0,0,0,0,0,0,0,0,0,0,0,0,0,0,0,0,0,0,0,0,0,0,0
2004-08-16 00:00:00.000,Athens Olympics Greece ATP World Tour,HARD,2,Igor Andreev,Agustin Calleri,Igor Andreev,W/O,R32,0,0,0,0,0,0,0,0,0,0,0,0,0,0,0,0,0,0,0,0,0,0,0,0,0,0,0
2004-08-16 00:00:00.000,Athens Olympics Greece ATP World Tour,HARD,2,Mardy Fish,Juan Carlos Ferrero,Mardy Fish,4-6; 7-6(5); 6-4,R32,0,0,0,0,0,0,0,0,0,0,0,0,0,0,0,0,0,0,0,0,0,0,0,0,0,0,0
2004-08-16 00:00:00.000,Athens Olympics Greece ATP World Tour,HARD,2,Max Mirnyi,Jarkko Nieminen,Max Mirnyi,6-3; 6-4,R32,0,0,0,0,0,0,0,0,0,0,0,0,0,0,0,0,0,0,0,0,0,0,0,0,0,0,0
2004-08-16 00:00:00.000,Athens Olympics Greece ATP World Tour,HARD,2,Nicolas Kiefer,Marcos Baghdatis,Nicolas Kiefer,6-2; 3-6; 6-3,R32,0,0,0,0,0,0,0,0,0,0,0,0,0,0,0,0,0,0,0,0,0,0,0,0,0,0,0
2004-08-16 00:00:00.000,Athens Olympics Greece ATP World Tour,HARD,2,Mikhail Youzhny,Jiri Novak,Mikhail Youzhny,6-4; 6-3,R32,0,0,0,0,0,0,0,0,0,0,0,0,0,0,0,0,0,0,0,0,0,0,0,0,0,0,0
2004-08-16 00:00:00.000,Athens Olympics Greece ATP World Tour,HARD,2,Sebastien Grosjean,Wayne Arthurs,Sebastien Grosjean,7-6(2); 6-3,R32,0,0,0,0,0,0,0,0,0,0,0,0,0,0,0,0,0,0,0,0,0,0,0,0,0,0,0
2004-08-16 00:00:00.000,Athens Olympics Greece ATP World Tour,HARD,2,Feliciano Lopez,Marat Safin,Feliciano Lopez,7-6(4); 6-3,R32,0,0,0,0,0,0,0,0,0,0,0,0,0,0,0,0,0,0,0,0,0,0,0,0,0,0,0
2004-08-16 00:00:00.000,Athens Olympics Greece ATP World Tour,HARD,2,Fernando Gonzalez,Hyung-Taik Lee,Fernando Gonzalez,7-5; 6-2,R32,0,0,0,0,0,0,0,0,0,0,0,0,0,0,0,0,0,0,0,0,0,0,0,0,0,0,0
2004-08-16 00:00:00.000,Athens Olympics Greece ATP World Tour,HARD,2,Andy Roddick,Tommy Haas,Andy Roddick,4-6; 6-3; 9-7,R32,0,0,0,0,0,0,0,0,0,0,0,0,0,0,0,0,0,0,0,0,0,0,0,0,0,0,0
2004-08-16 00:00:00.000,Athens Olympics Greece ATP World Tour,HARD,2,Tomas Berdych,Tommy Robredo,Tomas Berdych,7-6(2); 4-6; 8-6,R16,0,0,0,0,0,0,0,0,0,0,0,0,0,0,0,0,0,0,0,0,0,0,0,0,0,0,0
2004-08-16 00:00:00.000,Athens Olympics Greece ATP World Tour,HARD,2,Taylor Dent,Ivan Ljubicic,Taylor Dent,6-4; 6-4,R16,0,0,0,0,0,0,0,0,0,0,0,0,0,0,0,0,0,0,0,0,0,0,0,0,0,0,0
2004-08-16 00:00:00.000,Athens Olympics Greece ATP World Tour,HARD,2,Carlos Moya,Ivo Karlovic,Carlos Moya,4-6; 7-6(3); 6-4,R16,0,0,0,0,0,0,0,0,0,0,0,0,0,0,0,0,0,0,0,0,0,0,0,0,0,0,0
2004-08-16 00:00:00.000,Athens Olympics Greece ATP World Tour,HARD,2,Nicolas Massu,Igor Andreev,Nicolas Massu,6-3; 6-7(4); 6-4,R16,0,0,0,0,0,0,0,0,0,0,0,0,0,0,0,0,0,0,0,0,0,0,0,0,0,0,0
2004-08-16 00:00:00.000,Athens Olympics Greece ATP World Tour,HARD,2,Mardy Fish,Max Mirnyi,Mardy Fish,6-3; 4-6; 6-1,R16,0,0,0,0,0,0,0,0,0,0,0,0,0,0,0,0,0,0,0,0,0,0,0,0,0,0,0
2004-08-16 00:00:00.000,Athens Olympics Greece ATP World Tour,HARD,2,Mikhail Youzhny,Nicolas Kiefer,Mikhail Youzhny,6-2; 3-6; 6-2,R16,0,0,0,0,0,0,0,0,0,0,0,0,0,0,0,0,0,0,0,0,0,0,0,0,0,0,0
2004-08-16 00:00:00.000,Athens Olympics Greece ATP World Tour,HARD,2,Sebastien Grosjean,Feliciano Lopez,Sebastien Grosjean,6-7(4); 6-4; 6-0,R16,0,0,0,0,0,0,0,0,0,0,0,0,0,0,0,0,0,0,0,0,0,0,0,0,0,0,0
2004-08-16 00:00:00.000,Athens Olympics Greece ATP World Tour,HARD,2,Fernando Gonzalez,Andy Roddick,Fernando Gonzalez,6-4; 6-4,R16,0,0,0,0,0,0,0,0,0,0,0,0,0,0,0,0,0,0,0,0,0,0,0,0,0,0,0
2004-08-16 00:00:00.000,Athens Olympics Greece ATP World Tour,HARD,2,Taylor Dent,Tomas Berdych,Taylor Dent,6-4; 6-1,Q,0,0,0,0,0,0,0,0,0,0,0,0,0,0,0,0,0,0,0,0,0,0,0,0,0,0,0
2004-08-16 00:00:00.000,Athens Olympics Greece ATP World Tour,HARD,2,Nicolas Massu,Carlos Moya,Nicolas Massu,6-2; 7-5,Q,0,0,0,0,0,0,0,0,0,0,0,0,0,0,0,0,0,0,0,0,0,0,0,0,0,0,0
2004-08-16 00:00:00.000,Athens Olympics Greece ATP World Tour,HARD,2,Mardy Fish,Mikhail Youzhny,Mardy Fish,6-3; 6-4,Q,0,0,0,0,0,0,0,0,0,0,0,0,0,0,0,0,0,0,0,0,0,0,0,0,0,0,0
2004-08-16 00:00:00.000,Athens Olympics Greece ATP World Tour,HARD,2,Fernando Gonzalez,Sebastien Grosjean,Fernando Gonzalez,6-2; 2-6; 6-4,Q,0,0,0,0,0,0,0,0,0,0,0,0,0,0,0,0,0,0,0,0,0,0,0,0,0,0,0
2004-08-16 00:00:00.000,Athens Olympics Greece ATP World Tour,HARD,2,Nicolas Massu,Taylor Dent,Nicolas Massu,7-6(5); 6-1,S,0,0,0,0,0,0,0,0,0,0,0,0,0,0,0,0,0,0,0,0,0,0,0,0,0,0,0
2004-08-16 00:00:00.000,Athens Olympics Greece ATP World Tour,HARD,2,Mardy Fish,Fernando Gonzalez,Mardy Fish,3-6; 6-3; 6-4,S,0,0,0,0,0,0,0,0,0,0,0,0,0,0,0,0,0,0,0,0,0,0,0,0,0,0,0
2004-08-16 00:00:00.000,Athens Olympics Greece ATP World Tour,HARD,2,Nicolas Massu,Mardy Fish,Nicolas Massu,6-3; 3-6; 2-6; 6-3; 6-4,F,0,0,0,0,0,0,0,0,0,0,0,0,0,0,0,0,0,0,0,0,0,0,0,0,0,0,0
2004-08-16 00:00:00.000,Washington DC; U.S.A. ATP World Tour,HARD,2,Andre Agassi,Paul Goldstein,Andre Agassi,6-4; 6-2,R32,67,8,2,32,53,24,32,11,21,3,4,9,35,53,8,4,36,70,24,36,12,34,7,11,9,36,70
2004-08-16 00:00:00.000,Washington DC; U.S.A. ATP World Tour,HARD,2,Kristian Pless,Brian Baker,Kristian Pless,6-3; 3-6; 7-6(2),R32,129,8,5,78,120,52,78,18,42,15,18,15,70,120,6,4,57,94,41,57,19,37,5,8,15,60,94
2004-08-16 00:00:00.000,Washington DC; U.S.A. ATP World Tour,HARD,2,Paul-Henri Mathieu,Daniel Yoo,Paul-Henri Mathieu,6-2; 6-2,R32,66,10,0,20,44,16,20,17,24,2,2,8,33,44,3,5,36,55,25,36,3,19,5,9,8,28,55
2004-08-16 00:00:00.000,Washington DC; U.S.A. ATP World Tour,HARD,2,Adrian Garcia,James Blake,Adrian Garcia,6-1; 6-4,R32,58,4,3,39,63,33,39,11,24,4,4,9,44,63,2,4,21,47,14,21,11,26,1,4,8,25,47
2004-08-16 00:00:00.000,Washington DC; U.S.A. ATP World Tour,HARD,2,Gilles Muller,Sjeng Schalken,Gilles Muller,6-1; 0-1 RET,R32,28,0,0,13,20,9,13,7,7,0,0,4,16,20,0,1,16,27,7,16,6,11,2,4,4,13,27
2004-08-16 00:00:00.000,Washington DC; U.S.A. ATP World Tour,HARD,2,Jan-Michael Gambill,Stefan Koubek,Jan-Michael Gambill,7-5; 6-4,R32,84,5,4,39,65,28,39,12,26,2,5,11,40,65,5,2,48,68,28,48,10,20,5,10,11,38,68
2004-08-16 00:00:00.000,Washington DC; U.S.A. ATP World Tour,HARD,2,Michel Kratochvil,Jeff Salzenstein,Michel Kratochvil,6-4; 7-6(1),R32,84,3,1,32,59,29,32,20,27,1,1,11,49,59,16,4,41,83,31,41,23,42,10,11,11,54,83
2004-08-16 00:00:00.000,Washington DC; U.S.A. ATP World Tour,HARD,2,Dmitry Tursunov,Olivier Patience,Dmitry Tursunov,5-7; 6-4; 6-4,R32,144,15,8,64,122,45,64,31,58,13,15,16,76,122,6,8,62,109,43,62,23,47,6,9,16,66,109
2004-08-16 00:00:00.000,Washington DC; U.S.A. ATP World Tour,HARD,2,Alberto Martin,Wayne Ferreira,Alberto Martin,4-6; 6-4; 7-6(2),R32,113,4,3,59,95,45,59,20,36,4,6,16,65,95,8,5,45,90,31,45,28,45,1,3,16,59,90
2004-08-16 00:00:00.000,Washington DC; U.S.A. ATP World Tour,HARD,2,Raemon Sluiter,Todd Martin,Raemon Sluiter,6-7(5); 7-6(3); 7-6(5),R32,161,19,10,78,126,66,78,18,48,8,10,18,84,126,17,6,85,132,61,85,26,47,10,12,18,87,132
2004-08-16 00:00:00.000,Washington DC; U.S.A. ATP World Tour,HARD,2,Harel Levy,Nenad Zimonjic,Harel Levy,6-7(7); 7-5; 6-3,R32,110,6,2,70,100,54,70,20,30,5,6,17,74,100,14,5,64,94,50,64,13,30,1,4,16,63,94
2004-08-16 00:00:00.000,Washington DC; U.S.A. ATP World Tour,HARD,2,Robby Ginepri,Alex Corretja,Robby Ginepri,7-6(4); 4-6; 6-3,R32,136,12,2,61,105,42,61,27,44,3,5,16,69,105,6,1,70,107,48,70,19,37,5,7,15,67,107
2004-08-16 00:00:00.000,Washington DC; U.S.A. ATP World Tour,HARD,2,Cyril Saulnier,Antony Dupuis,Cyril Saulnier,6-3; 6-4,R32,67,8,1,28,55,24,28,18,27,2,2,10,42,55,4,3,27,47,23,27,8,20,1,3,9,31,47
2004-08-16 00:00:00.000,Washington DC; U.S.A. ATP World Tour,HARD,2,Gilles Elseneer,Jimmy Wang,Gilles Elseneer,2-6; 7-6(1); 6-4,R32,115,7,6,54,90,35,54,25,36,4,7,15,60,90,4,0,72,92,46,72,13,20,4,6,15,59,92
2004-08-16 00:00:00.000,Washington DC; U.S.A. ATP World Tour,HARD,2,Alejandro Falla,Justin Gimelstob,Alejandro Falla,3-6; 6-4; 6-3,R32,120,2,4,48,91,36,48,22,43,4,6,14,58,91,2,8,40,87,30,40,23,47,3,6,14,53,87
2004-08-16 00:00:00.000,Washington DC; U.S.A. ATP World Tour,HARD,2,Lleyton Hewitt,Kenneth Carlsen,Lleyton Hewitt,6-1; 6-2,R32,66,5,1,29,55,23,29,15,26,3,3,8,38,55,3,6,20,41,15,20,5,21,1,5,7,20,41
2004-08-16 00:00:00.000,Washington DC; U.S.A. ATP World Tour,HARD,2,Andre Agassi,Kristian Pless,Andre Agassi,6-4; 6-2,R16,64,12,1,31,48,26,31,12,17,2,2,9,38,48,7,2,41,65,27,41,11,24,2,5,9,38,65
2004-08-16 00:00:00.000,Washington DC; U.S.A. ATP World Tour,HARD,2,Paul-Henri Mathieu,Adrian Garcia,Paul-Henri Mathieu,7-6(4); 6-4,R16,98,10,3,32,67,30,32,21,35,2,2,11,51,67,3,2,43,80,27,43,23,37,5,6,11,50,80
2004-08-16 00:00:00.000,Washington DC; U.S.A. ATP World Tour,HARD,2,Gilles Muller,Jan-Michael Gambill,Gilles Muller,7-5; 5-7; 6-2,R16,119,25,5,72,103,50,72,17,31,6,8,16,67,103,14,5,49,89,34,49,21,40,1,5,16,55,89
2004-08-16 00:00:00.000,Washington DC; U.S.A. ATP World Tour,HARD,2,Michel Kratochvil,Dmitry Tursunov,Michel Kratochvil,7-6(5); 7-6(4),R16,112,7,1,36,78,28,36,26,42,3,4,12,54,78,17,8,53,100,38,53,22,47,7,8,12,60,100
2004-08-16 00:00:00.000,Washington DC; U.S.A. ATP World Tour,HARD,2,Raemon Sluiter,Alberto Martin,Raemon Sluiter,7-6(4); 5-7; 7-6(2),R16,160,12,5,78,121,61,78,25,43,9,11,18,86,121,3,6,62,110,50,62,26,48,2,3,18,76,110
2004-08-16 00:00:00.000,Washington DC; U.S.A. ATP World Tour,HARD,2,Robby Ginepri,Harel Levy,Robby Ginepri,4-6; 6-2; 6-1,R16,88,6,3,42,75,35,42,19,33,2,3,13,54,75,5,0,40,79,26,40,19,39,5,9,12,45,79
2004-08-16 00:00:00.000,Washington DC; U.S.A. ATP World Tour,HARD,2,Cyril Saulnier,Gilles Elseneer,Cyril Saulnier,6-3; 7-6(2),R16,98,8,0,34,72,28,34,25,38,2,2,11,53,72,4,5,42,76,33,42,15,34,1,2,10,48,76
2004-08-16 00:00:00.000,Washington DC; U.S.A. ATP World Tour,HARD,2,Lleyton Hewitt,Alejandro Falla,Lleyton Hewitt,6-3; 6-2,R16,69,8,6,31,63,22,31,15,32,8,11,9,37,63,0,2,27,46,12,27,6,19,4,10,8,18,46
2004-08-16 00:00:00.000,Washington DC; U.S.A. ATP World Tour,HARD,2,Andre Agassi,Paul-Henri Mathieu,Andre Agassi,6-4; 6-4,Q,82,5,2,25,51,20,25,21,26,0,0,10,41,51,6,6,27,68,21,27,21,41,3,5,10,42,68
2004-08-16 00:00:00.000,Washington DC; U.S.A. ATP World Tour,HARD,2,Gilles Muller,Michel Kratochvil,Gilles Muller,7-5; 6-7(7); 6-2,Q,132,14,5,60,110,48,60,29,50,8,9,16,77,110,6,6,57,116,44,57,28,59,11,15,16,72,116
2004-08-16 00:00:00.000,Washington DC; U.S.A. ATP World Tour,HARD,2,Robby Ginepri,Raemon Sluiter,Robby Ginepri,6-3; 7-6(3),Q,73,8,1,37,62,28,37,16,25,0,1,11,44,62,7,0,41,64,31,41,11,23,3,5,10,42,64
2004-08-16 00:00:00.000,Washington DC; U.S.A. ATP World Tour,HARD,2,Lleyton Hewitt,Cyril Saulnier,Lleyton Hewitt,6-3; 3-6; 7-6(5),Q,140,17,4,58,109,50,58,24,51,9,10,15,74,109,16,4,57,105,40,57,32,48,8,9,15,72,105
2004-08-16 00:00:00.000,Washington DC; U.S.A. ATP World Tour,HARD,2,Gilles Muller,Andre Agassi,Gilles Muller,6-4; 7-5,S,86,11,3,55,81,39,55,11,26,8,10,11,50,81,5,5,35,61,22,35,13,26,0,4,11,35,61
2004-08-16 00:00:00.000,Washington DC; U.S.A. ATP World Tour,HARD,2,Lleyton Hewitt,Robby Ginepri,Lleyton Hewitt,6-3; 6-4,S,70,6,2,30,55,27,30,14,25,0,0,10,41,55,6,2,38,68,27,38,14,30,5,7,9,41,68
2004-08-16 00:00:00.000,Washington DC; U.S.A. ATP World Tour,HARD,2,Lleyton Hewitt,Gilles Muller,Lleyton Hewitt,6-3; 6-4,F,77,8,4,26,46,23,26,8,20,0,2,9,31,46,4,2,48,82,27,48,14,34,11,16,10,41,82
2004-08-23 00:00:00.000,Long Island New York; USA ATP World Tour,HARD,2,Luis Horna,Alexander Popp,Luis Horna,6-1; 6-3,R32,67,6,1,40,57,29,40,9,17,6,6,8,38,57,5,1,32,55,20,32,8,23,4,8,8,28,55
2004-08-23 00:00:00.000,Long Island New York; USA ATP World Tour,HARD,2,Jarkko Nieminen,Robby Ginepri,Jarkko Nieminen,6-4; 6-4,R32,66,1,0,41,57,26,41,13,16,0,1,10,39,57,1,1,44,66,27,44,13,22,4,7,10,40,66
2004-08-23 00:00:00.000,Long Island New York; USA ATP World Tour,HARD,2,Nikolay Davydenko,KJ Hippensteel,Nikolay Davydenko,6-2; 6-3,R32,70,6,4,32,51,25,32,9,19,0,1,8,34,51,4,6,38,64,24,38,7,26,4,9,9,31,64
2004-08-23 00:00:00.000,Long Island New York; USA ATP World Tour,HARD,2,Fernando Verdasco,Alberto Martin,Fernando Verdasco,6-4; 3-6; 6-1,R32,95,10,0,59,82,40,59,18,23,5,6,13,58,82,2,4,46,74,36,46,12,28,3,6,13,48,74
2004-08-23 00:00:00.000,Long Island New York; USA ATP World Tour,HARD,2,Paradorn Srichaphan,Kevin Kim,Paradorn Srichaphan,6-3; 6-2,R32,63,10,0,40,64,30,40,11,24,5,6,9,41,64,1,2,26,45,17,26,6,19,5,9,8,23,45
2004-08-23 00:00:00.000,Long Island New York; USA ATP World Tour,HARD,2,Wayne Ferreira,David Sanchez,Wayne Ferreira,6-2; 6-3,R32,52,7,0,35,51,28,35,10,16,0,0,9,38,51,2,3,27,43,18,27,6,16,1,4,8,24,43
2004-08-23 00:00:00.000,Long Island New York; USA ATP World Tour,HARD,2,Stefan Koubek,David Ferrer,Stefan Koubek,6-1; 6-3,R32,58,2,3,27,55,19,27,17,28,4,5,8,36,55,0,1,30,49,16,30,7,19,2,7,8,23,49
2004-08-23 00:00:00.000,Long Island New York; USA ATP World Tour,HARD,2,Joachim Johansson,Daniel Elsner,Joachim Johansson,6-4; 6-3,R32,60,8,3,26,49,26,26,14,23,2,2,9,40,49,3,7,30,53,24,30,9,23,2,5,10,33,53
2004-08-23 00:00:00.000,Long Island New York; USA ATP World Tour,HARD,2,Dmitry Tursunov,Mario Ancic,Dmitry Tursunov,6-1; 6-4,R32,52,7,4,27,49,24,27,14,22,3,3,9,38,49,2,5,31,46,19,31,7,15,1,4,8,26,46
2004-08-23 00:00:00.000,Long Island New York; USA ATP World Tour,HARD,2,Jan-Michael Gambill,Richard Gasquet,Jan-Michael Gambill,7-6(3); 7-6(3),R32,97,8,5,35,79,28,35,28,44,5,6,12,56,79,3,2,48,74,33,48,14,26,0,1,12,47,74
2004-08-23 00:00:00.000,Long Island New York; USA ATP World Tour,HARD,2,Igor Andreev,Albert Costa,Igor Andreev,6-2; 5-7; 6-4,R32,128,11,5,54,86,40,54,18,32,6,8,15,58,86,6,3,40,93,28,40,29,53,5,9,15,57,93
2004-08-23 00:00:00.000,Long Island New York; USA ATP World Tour,HARD,2,Jurgen Melzer,Todd Martin,Jurgen Melzer,1-6; 6-3; 6-3,R32,92,3,4,44,72,34,44,11,28,4,7,12,45,72,9,4,44,73,35,44,12,29,0,4,13,47,73
2004-08-23 00:00:00.000,Long Island New York; USA ATP World Tour,HARD,2,Juan Ignacio Chela,Karol Beck,Juan Ignacio Chela,6-4; 6-2,R32,70,2,2,34,47,25,34,5,13,0,2,9,30,47,0,2,33,63,19,33,10,30,3,8,9,29,63
2004-08-23 00:00:00.000,Long Island New York; USA ATP World Tour,HARD,2,Thomas Enqvist,Julien Benneteau,Thomas Enqvist,6-3; 7-6(4),R32,88,6,3,38,72,33,38,18,34,5,6,11,51,72,4,3,31,65,25,31,15,34,5,7,10,40,65
2004-08-23 00:00:00.000,Long Island New York; USA ATP World Tour,HARD,2,Michael Llodra,Sargis Sargsian,Michael Llodra,6-4; 6-1,R32,60,6,0,34,54,28,34,11,20,1,1,9,39,54,0,4,33,49,21,33,7,16,3,6,8,28,49
2004-08-23 00:00:00.000,Long Island New York; USA ATP World Tour,HARD,2,Lleyton Hewitt,Olivier Mutis,Lleyton Hewitt,7-6(3); 6-1,R32,86,8,7,43,78,34,43,17,35,11,12,9,51,78,4,8,36,75,24,36,14,39,3,7,10,38,75
2004-08-23 00:00:00.000,Long Island New York; USA ATP World Tour,HARD,2,Luis Horna,Jarkko Nieminen,Luis Horna,6-3; 6-4,R16,72,5,2,38,58,28,38,12,20,0,1,10,40,58,6,5,32,64,22,32,13,32,7,10,9,35,64
2004-08-23 00:00:00.000,Long Island New York; USA ATP World Tour,HARD,2,Nikolay Davydenko,Fernando Verdasco,Nikolay Davydenko,7-6(4); 6-3,R16,86,6,2,42,68,37,42,11,26,1,2,11,48,68,0,3,35,66,25,35,17,31,4,6,10,42,66
2004-08-23 00:00:00.000,Long Island New York; USA ATP World Tour,HARD,2,Paradorn Srichaphan,Wayne Ferreira,Paradorn Srichaphan,7-6(3); 7-5,R16,104,2,1,41,76,32,41,20,35,4,5,12,52,76,4,3,54,96,39,54,19,42,8,10,12,58,96
2004-08-23 00:00:00.000,Long Island New York; USA ATP World Tour,HARD,2,Joachim Johansson,Stefan Koubek,Joachim Johansson,6-2; 6-4,R16,61,8,1,34,56,28,34,13,22,3,3,9,41,56,2,2,35,54,19,35,11,19,2,5,9,30,54
2004-08-23 00:00:00.000,Long Island New York; USA ATP World Tour,HARD,2,Dmitry Tursunov,Jan-Michael Gambill,Dmitry Tursunov,6-7(3); 7-6(3); 7-6(5),R16,175,6,5,61,137,42,61,44,76,6,9,18,86,137,22,7,83,132,63,83,19,49,4,7,18,82,132
2004-08-23 00:00:00.000,Long Island New York; USA ATP World Tour,HARD,2,Jurgen Melzer,Igor Andreev,Jurgen Melzer,6-3; 6-4,R16,70,3,2,33,58,32,33,10,25,2,2,10,42,58,4,2,43,62,29,43,10,19,4,6,9,39,62
2004-08-23 00:00:00.000,Long Island New York; USA ATP World Tour,HARD,2,Juan Ignacio Chela,Thomas Enqvist,Juan Ignacio Chela,6-4; 5-7; 6-1,R16,123,5,3,52,78,39,52,14,26,3,5,14,53,78,4,5,55,110,38,55,25,55,8,13,15,63,110
2004-08-23 00:00:00.000,Long Island New York; USA ATP World Tour,HARD,2,Lleyton Hewitt,Michael Llodra,Lleyton Hewitt,6-1; 6-4,R16,72,4,0,24,43,18,24,15,19,1,1,8,33,43,3,1,35,60,23,35,9,25,1,5,9,32,60
2004-08-23 00:00:00.000,Long Island New York; USA ATP World Tour,HARD,2,Luis Horna,Nikolay Davydenko,Luis Horna,6-4; 6-7(2); 6-4,Q,139,10,4,58,93,45,58,17,35,3,5,16,62,93,8,5,59,94,43,59,18,35,2,6,16,61,94
2004-08-23 00:00:00.000,Long Island New York; USA ATP World Tour,HARD,2,Paradorn Srichaphan,Joachim Johansson,Paradorn Srichaphan,3-6; 7-6(3); 6-3,Q,110,13,5,46,82,43,46,20,36,0,2,16,63,82,15,9,55,92,44,55,19,37,6,7,14,63,92
2004-08-23 00:00:00.000,Long Island New York; USA ATP World Tour,HARD,2,Dmitry Tursunov,Jurgen Melzer,Dmitry Tursunov,4-6; 7-6(5); 6-4,Q,150,3,4,58,109,39,58,32,51,5,7,16,71,109,6,6,61,113,48,61,23,52,10,12,16,71,113
2004-08-23 00:00:00.000,Long Island New York; USA ATP World Tour,HARD,2,Lleyton Hewitt,Juan Ignacio Chela,Lleyton Hewitt,6-7(6); 6-1; 6-1,Q,128,8,6,42,77,30,42,20,35,4,7,13,50,77,3,8,69,120,37,69,21,51,19,27,13,58,120
2004-08-23 00:00:00.000,Long Island New York; USA ATP World Tour,HARD,2,Luis Horna,Paradorn Srichaphan,Luis Horna,1-6; 6-4; 7-6(5),S,140,4,3,63,96,41,63,15,33,5,10,14,56,96,11,7,53,96,42,53,17,43,2,6,15,59,96
2004-08-23 00:00:00.000,Long Island New York; USA ATP World Tour,HARD,2,Lleyton Hewitt,Dmitry Tursunov,Lleyton Hewitt,6-3; 1-0 RET,S,43,6,1,12,30,11,12,11,18,2,2,5,22,30,3,2,16,31,11,16,4,15,1,3,5,15,31
2004-08-23 00:00:00.000,Long Island New York; USA ATP World Tour,HARD,2,Lleyton Hewitt,Luis Horna,Lleyton Hewitt,6-3; 6-1,F,79,12,1,24,48,21,24,16,24,1,1,8,37,48,5,5,51,80,31,51,9,29,11,15,8,40,80
2004-08-30 00:00:00.000,US Open NY; U.S.A. Grand Slams,HARD,3,Roger Federer,Albert Costa,Roger Federer,7-5; 6-2; 6-4,R128,120,11,5,49,73,39,49,11,24,0,3,15,50,73,1,3,64,109,36,64,19,45,12,19,15,55,109
2004-08-30 00:00:00.000,US Open NY; U.S.A. Grand Slams,HARD,3,Marcos Baghdatis,Olivier Mutis,Marcos Baghdatis,2-6; 6-2; 6-1; 7-5,R128,136,18,7,50,104,39,50,23,54,1,6,18,62,104,2,5,63,114,39,63,20,51,3,11,17,59,114
2004-08-30 00:00:00.000,US Open NY; U.S.A. Grand Slams,HARD,3,Dmitry Tursunov,Mariano Zabaleta,Dmitry Tursunov,4-6; 6-3; 6-7(5); 6-3; 6-2,R128,198,18,14,99,168,73,99,38,69,6,8,25,111,168,9,8,92,152,63,92,32,60,13,18,23,95,152
2004-08-30 00:00:00.000,US Open NY; U.S.A. Grand Slams,HARD,3,Fabrice Santoro,Todd Martin,Fabrice Santoro,4-6; 6-4; 6-4; 7-5,R128,180,7,4,62,125,45,62,37,63,1,4,21,82,125,16,6,88,128,62,88,17,40,4,9,21,79,128
2004-08-30 00:00:00.000,US Open NY; U.S.A. Grand Slams,HARD,3,Hyung-Taik Lee,Ivan Ljubicic,Hyung-Taik Lee,3-6; 6-3; 1-1 RET,R128,95,1,2,48,73,33,48,14,25,2,3,10,47,73,10,1,45,76,35,45,13,31,5,6,10,48,76
2004-08-30 00:00:00.000,US Open NY; U.S.A. Grand Slams,HARD,3,Alberto Martin,Antony Dupuis,Alberto Martin,3-6; 6-2; 6-4; 6-4,R128,149,11,10,67,122,49,67,26,55,3,7,19,75,122,6,5,46,101,32,46,29,55,2,8,18,61,101
2004-08-30 00:00:00.000,US Open NY; U.S.A. Grand Slams,HARD,3,Fernando Verdasco,Igor Andreev,Fernando Verdasco,6-3; 6-4; 4-6; 2-6; 7-5,R128,193,12,5,109,169,73,109,33,60,16,21,25,106,169,10,13,69,136,54,69,32,67,2,7,24,86,136
2004-08-30 00:00:00.000,US Open NY; U.S.A. Grand Slams,HARD,3,Andrei Pavel,Jarkko Nieminen,Andrei Pavel,6-3; 7-5; 6-7(5); 6-3,R128,171,13,9,72,137,51,72,31,65,12,18,20,82,137,6,8,85,157,51,85,33,72,10,21,22,84,157
2004-08-30 00:00:00.000,US Open NY; U.S.A. Grand Slams,HARD,3,Nicolas Massu,Jose Acasuso,Nicolas Massu,6-4; 6-0; 6-2,R128,115,7,4,41,73,36,41,13,32,1,2,12,49,73,8,5,40,81,25,40,14,41,7,14,12,39,81
2004-08-30 00:00:00.000,US Open NY; U.S.A. Grand Slams,HARD,3,Sargis Sargsian,Alex Corretja,Sargis Sargsian,2-6; 6-4; 6-0; 6-1,R128,132,12,5,41,84,33,41,23,43,5,8,15,56,84,3,7,46,95,27,46,19,49,5,13,16,46,95
2004-08-30 00:00:00.000,US Open NY; U.S.A. Grand Slams,HARD,3,Paul-Henri Mathieu,Raemon Sluiter,Paul-Henri Mathieu,6-2; 7-6(3); 7-6(12),R128,168,10,4,58,122,44,58,39,64,8,10,16,83,122,17,10,65,112,51,65,17,47,6,10,16,68,112
2004-08-30 00:00:00.000,US Open NY; U.S.A. Grand Slams,HARD,3,Taylor Dent,Younes El Aynaoui,Taylor Dent,6-1; 2-1 RET,R128,43,3,0,13,23,10,13,10,10,0,0,5,20,23,0,0,24,32,10,24,3,8,2,5,5,13,32
2004-08-30 00:00:00.000,US Open NY; U.S.A. Grand Slams,HARD,3,Jiri Novak,Radek Stepanek,Jiri Novak,7-5; 6-1; 6-3,R128,118,3,2,54,77,41,54,9,23,2,5,14,50,77,9,6,57,103,35,57,14,46,8,16,14,49,103
2004-08-30 00:00:00.000,US Open NY; U.S.A. Grand Slams,HARD,3,Alex Calatrava,Alex Bogdanovic,Alex Calatrava,6-3; 3-6; 4-6; 6-1; 6-4,R128,167,17,4,75,123,58,75,26,48,3,7,23,84,123,13,7,83,136,62,83,20,53,9,15,22,82,136
2004-08-30 00:00:00.000,US Open NY; U.S.A. Grand Slams,HARD,3,Florian Mayer,Flavio Saretta,Florian Mayer,6-4; 6-2; 6-1,R128,106,7,2,49,86,35,49,20,37,3,5,13,55,86,5,5,33,74,21,33,14,41,7,14,12,35,74
2004-08-30 00:00:00.000,US Open NY; U.S.A. Grand Slams,HARD,3,Andre Agassi,Robby Ginepri,Andre Agassi,7-6(5); 6-4; 6-2,R128,115,9,2,52,97,38,52,24,45,5,9,15,62,97,10,3,80,113,48,80,10,33,7,14,15,58,113
2004-08-30 00:00:00.000,US Open NY; U.S.A. Grand Slams,HARD,3,Carlos Moya,Brian Baker,Carlos Moya,6-7(6); 6-4; 6-4; 6-2,R128,183,25,9,59,133,50,59,38,74,7,10,20,88,133,4,9,92,143,56,92,24,51,9,16,20,80,143
2004-08-30 00:00:00.000,US Open NY; U.S.A. Grand Slams,HARD,3,Amer Delic,Janko Tipsarevic,Amer Delic,6-1; 6-3; 6-4,R128,93,5,4,48,84,33,48,22,36,8,10,13,55,84,4,2,50,79,27,50,14,29,8,15,13,41,79
2004-08-30 00:00:00.000,US Open NY; U.S.A. Grand Slams,HARD,3,Potito Starace,Alexander Popp,Potito Starace,1-6; 6-3; 6-4; 6-3,R128,140,10,2,70,111,50,70,21,41,6,9,17,71,111,7,7,74,114,45,74,22,40,7,12,18,67,114
2004-08-30 00:00:00.000,US Open NY; U.S.A. Grand Slams,HARD,3,Olivier Rochus,Mario Ancic,Olivier Rochus,7-5; 6-2; 7-6(6),R128,139,0,5,64,103,47,64,22,39,3,5,16,69,103,19,3,49,90,35,49,17,41,0,5,16,52,90
2004-08-30 00:00:00.000,US Open NY; U.S.A. Grand Slams,HARD,3,Dominik Hrbaty,Oscar Hernandez,Dominik Hrbaty,6-1; 6-2; 6-1,R128,66,12,3,33,59,30,33,17,26,0,0,11,47,59,0,3,36,60,16,36,10,24,2,9,11,26,60
2004-08-30 00:00:00.000,US Open NY; U.S.A. Grand Slams,HARD,3,Karol Kucera,Xavier Malisse,Karol Kucera,6-1; 1-6; 1-6; 6-4; 6-1,R128,161,5,6,59,121,44,59,26,62,9,16,19,70,121,12,1,66,111,43,66,19,45,9,17,19,62,111
2004-08-30 00:00:00.000,US Open NY; U.S.A. Grand Slams,HARD,3,Paul Goldstein,Takao Suzuki,Paul Goldstein,7-6(5); 2-6; 6-2; 6-1,R128,145,3,5,81,125,55,81,24,44,10,13,17,79,125,13,6,64,111,44,64,22,47,6,12,18,66,111
2004-08-30 00:00:00.000,US Open NY; U.S.A. Grand Slams,HARD,3,Paradorn Srichaphan,Victor Hanescu,Paradorn Srichaphan,4-6; 6-4; 6-1; 6-1,R128,122,9,7,57,101,45,57,23,44,7,9,17,68,101,6,7,61,105,36,61,24,44,5,12,17,60,105
2004-08-30 00:00:00.000,US Open NY; U.S.A. Grand Slams,HARD,3,Gaston Gaudio,Juan Monaco,Gaston Gaudio,7-6(6); 4-6; 6-3; 6-2,R128,197,5,7,63,133,47,63,40,70,7,10,20,87,133,8,3,84,131,54,84,24,47,11,16,19,78,131
2004-08-30 00:00:00.000,US Open NY; U.S.A. Grand Slams,HARD,3,Thomas Johansson,Daniel Elsner,Thomas Johansson,7-6(3); 6-4; 6-3,R128,136,16,3,54,110,39,54,25,56,8,14,16,64,110,5,12,45,98,29,45,18,53,7,15,15,47,98
2004-08-30 00:00:00.000,US Open NY; U.S.A. Grand Slams,HARD,3,Cyril Saulnier,Greg Rusedski,Cyril Saulnier,6-4; 3-6; 6-1; 3-6; 7-6(7),R128,173,18,4,70,127,57,70,40,57,1,3,23,97,127,18,9,86,146,70,86,29,60,9,12,24,99,146
2004-08-30 00:00:00.000,US Open NY; U.S.A. Grand Slams,HARD,3,Nicolas Kiefer,Nicolas Mahut,Nicolas Kiefer,6-3; 7-5; 6-2,R128,125,9,3,43,83,37,43,19,40,2,5,15,56,83,10,2,54,90,34,54,13,36,4,11,14,47,90
2004-08-30 00:00:00.000,US Open NY; U.S.A. Grand Slams,HARD,3,Mardy Fish,David Ferrer,Mardy Fish,7-5; 6-3; 6-2,R128,122,9,7,45,94,36,45,25,49,3,5,15,61,94,1,8,75,117,43,75,17,42,11,17,14,60,117
2004-08-30 00:00:00.000,US Open NY; U.S.A. Grand Slams,HARD,3,Michal Tabara,Max Mirnyi,Michal Tabara,6-4; 3-6; 6-4; 6-4,R128,153,3,11,52,116,40,52,36,64,2,5,19,76,116,33,8,72,125,55,72,25,53,10,15,20,80,125
2004-08-30 00:00:00.000,US Open NY; U.S.A. Grand Slams,HARD,3,Jerome Golmard,Irakli Labadze,Jerome Golmard,7-6(2) RET,R128,40,7,3,22,39,17,22,11,17,2,3,6,28,39,5,3,22,30,17,22,4,8,0,1,6,21,30
2004-08-30 00:00:00.000,US Open NY; U.S.A. Grand Slams,HARD,3,Tim Henman,Ivo Karlovic,Tim Henman,7-6(3); 6-7(7); 4-6; 6-4; 6-4,R128,217,10,9,91,166,76,91,41,75,0,2,27,117,166,37,13,114,177,97,114,27,63,8,11,27,124,177
2004-08-30 00:00:00.000,US Open NY; U.S.A. Grand Slams,HARD,3,David Nalbandian,Dennis van Scheppingen,David Nalbandian,6-4; 7-6(5); 6-3,R128,138,8,6,58,115,38,58,26,57,8,13,16,64,115,6,12,59,112,38,59,17,53,8,15,15,55,112
2004-08-30 00:00:00.000,US Open NY; U.S.A. Grand Slams,HARD,3,Mikhail Youzhny,Albert Montanes,Mikhail Youzhny,6-1; 6-3; 6-2,R128,76,5,0,38,58,33,38,16,20,0,0,12,49,58,0,5,44,82,23,44,17,38,6,12,12,40,82
2004-08-30 00:00:00.000,US Open NY; U.S.A. Grand Slams,HARD,3,Tuomas Ketola,Jeff Morrison,Tuomas Ketola,6-1; 3-6; 6-3; 7-6(8),R128,147,8,7,77,134,54,77,35,57,8,10,19,89,134,15,8,67,119,54,67,19,52,5,9,18,73,119
2004-08-30 00:00:00.000,US Open NY; U.S.A. Grand Slams,HARD,3,Tomas Berdych,Jonas Bjorkman,Tomas Berdych,6-3; 2-6; 6-2; 1-6; 6-3,R128,162,15,4,85,137,60,85,21,52,8,14,21,81,137,8,11,61,132,42,61,35,71,7,13,20,77,132
2004-08-30 00:00:00.000,US Open NY; U.S.A. Grand Slams,HARD,3,Ricardo Mello,Juan Ignacio Chela,Ricardo Mello,6-2; 7-6(1); 2-6; 2-6; 6-2,R128,196,7,5,108,143,73,108,16,35,9,14,22,89,143,5,6,116,153,72,116,21,37,13,18,22,93,153
2004-08-30 00:00:00.000,US Open NY; U.S.A. Grand Slams,HARD,3,David Sanchez,Wayne Odesnik,David Sanchez,4-6; 7-6(7); 6-2; 6-3,R128,141,7,3,79,120,66,79,15,41,8,10,19,81,120,11,2,76,140,55,76,29,64,9,14,20,84,140
2004-08-30 00:00:00.000,US Open NY; U.S.A. Grand Slams,HARD,3,Tommy Haas,Davide Sanguinetti,Tommy Haas,6-1; 5-7; 6-2; 3-6; 6-2,R128,149,16,7,56,114,44,56,35,58,3,7,22,79,114,9,5,83,144,53,83,27,61,8,16,22,80,144
2004-08-30 00:00:00.000,US Open NY; U.S.A. Grand Slams,HARD,3,Sebastien Grosjean,Olivier Patience,Sebastien Grosjean,7-5; 6-7(6); 6-2; 6-1,R128,164,14,6,58,134,46,58,42,76,8,10,20,88,134,9,8,80,127,56,80,18,47,10,17,19,74,127
2004-08-30 00:00:00.000,US Open NY; U.S.A. Grand Slams,HARD,3,Robin Soderling,Fernando Gonzalez,Robin Soderling,6-4; 7-6(3); 6-7(4); 6-1,R128,167,11,6,72,130,56,72,35,58,5,7,21,91,130,14,7,76,134,53,76,28,58,7,12,20,81,134
2004-08-30 00:00:00.000,US Open NY; U.S.A. Grand Slams,HARD,3,Nikolay Davydenko,Mark Philippoussis,Nikolay Davydenko,1-6; 6-3; 3-6; 7-6(5); 4-1 RET,R128,203,6,5,93,135,63,93,23,42,10,14,20,86,135,17,6,71,145,56,71,34,74,4,8,22,90,145
2004-08-30 00:00:00.000,US Open NY; U.S.A. Grand Slams,HARD,3,Karol Beck,Thierry Ascione,Karol Beck,6-3; 7-6(4); 6-4,R128,113,14,3,45,77,40,45,18,32,1,4,16,58,77,5,7,70,106,45,70,13,36,6,11,15,58,106
2004-08-30 00:00:00.000,US Open NY; U.S.A. Grand Slams,HARD,3,Kristian Pless,Gustavo Kuerten,Kristian Pless,6-4; 3-6; 6-1; 7-6(4),R128,110,9,5,80,107,61,80,16,27,1,3,19,77,107,15,6,58,107,42,58,26,49,1,5,19,68,107
2004-08-30 00:00:00.000,US Open NY; U.S.A. Grand Slams,HARD,3,Feliciano Lopez,Arnaud Di Pasquale,Feliciano Lopez,7-6(4); 6-3; 6-2,R128,96,19,0,47,87,43,47,24,40,2,2,15,67,87,3,9,36,80,30,36,23,44,1,4,14,53,80
2004-08-30 00:00:00.000,US Open NY; U.S.A. Grand Slams,HARD,3,Philipp Kohlschreiber,Julien Benneteau,Philipp Kohlschreiber,6-1; 6-1; 6-4,R128,92,6,1,38,69,32,38,19,31,2,2,12,51,69,0,5,53,77,31,53,8,24,8,14,12,39,77
2004-08-30 00:00:00.000,US Open NY; U.S.A. Grand Slams,HARD,3,Hicham Arazi,Kenneth Carlsen,Hicham Arazi,6-4; 7-6(5); 6-7(0); 3-6; 6-3,R128,209,4,6,111,173,81,111,36,62,6,8,26,117,173,16,10,97,174,73,97,44,77,5,8,26,117,174
2004-08-30 00:00:00.000,US Open NY; U.S.A. Grand Slams,HARD,3,Lleyton Hewitt,Wayne Ferreira,Lleyton Hewitt,6-1; 7-5; 6-4,R128,102,8,1,45,80,34,45,26,35,0,0,15,60,80,8,2,44,84,32,44,20,40,6,10,14,52,84
2004-08-30 00:00:00.000,US Open NY; U.S.A. Grand Slams,HARD,3,Juan Carlos Ferrero,Tomas Zib,Juan Carlos Ferrero,4-6; 7-5; 7-6(6); 6-7(4); 6-3,R128,266,19,4,115,178,81,115,34,63,10,15,27,115,178,10,9,107,199,68,107,51,92,7,14,28,119,199
2004-08-30 00:00:00.000,US Open NY; U.S.A. Grand Slams,HARD,3,Stefan Koubek,Alex Bogomolov Jr.,Stefan Koubek,6-3; 6-4; 1-6; 2-6; 6-3,R128,168,9,8,80,137,53,80,28,57,8,15,22,81,137,7,10,87,141,55,87,30,54,8,14,21,85,141
2004-08-30 00:00:00.000,US Open NY; U.S.A. Grand Slams,HARD,3,Jan-Michael Gambill,Rajeev Ram,Jan-Michael Gambill,6-3; 6-2; 3-6; 6-4,R128,137,17,3,51,98,44,51,25,47,1,4,18,69,98,7,6,58,105,38,58,23,47,4,10,18,61,105
2004-08-30 00:00:00.000,US Open NY; U.S.A. Grand Slams,HARD,3,Joachim Johansson,Yen-Hsun Lu,Joachim Johansson,6-3; 6-1; 6-3,R128,88,23,8,45,74,42,45,14,29,3,3,13,56,74,4,5,40,71,28,40,9,31,2,7,12,37,71
2004-08-30 00:00:00.000,US Open NY; U.S.A. Grand Slams,HARD,3,Vincent Spadea,Luis Horna,Vincent Spadea,6-7(3); 6-2; 6-4; 6-4,R128,177,18,8,75,150,63,75,36,75,11,12,20,99,150,3,4,85,125,62,85,17,40,3,8,20,79,125
2004-08-30 00:00:00.000,US Open NY; U.S.A. Grand Slams,HARD,3,Jurgen Melzer,Gregory Carraz,Jurgen Melzer,7-5; 6-0; 4-6; 6-3,R128,143,12,1,70,119,50,70,32,49,10,12,19,82,119,12,9,55,115,39,55,27,60,11,17,18,66,115
2004-08-30 00:00:00.000,US Open NY; U.S.A. Grand Slams,HARD,3,Michael Llodra,Gilles Elseneer,Michael Llodra,2-6; 7-6(2); 7-6(5); 6-2,R128,161,7,7,86,135,63,86,28,49,7,10,20,91,135,6,1,69,125,55,69,27,56,3,6,20,82,125
2004-08-30 00:00:00.000,US Open NY; U.S.A. Grand Slams,HARD,3,Andreas Seppi,Rainer Schuettler,Andreas Seppi,3-6; 4-6; 7-6(5); 7-6(1); 6-1,R128,214,4,7,85,164,63,85,43,79,7,13,25,106,164,8,15,97,165,71,97,30,68,4,10,25,101,165
2004-08-30 00:00:00.000,US Open NY; U.S.A. Grand Slams,HARD,3,Thomas Enqvist,Marat Safin,Thomas Enqvist,7-6(5); 6-4; 3-6; 6-3,R128,155,10,12,83,146,58,83,31,63,9,13,20,89,146,17,2,65,118,44,65,29,53,6,11,20,73,118
2004-08-30 00:00:00.000,US Open NY; U.S.A. Grand Slams,HARD,3,Alexander Peya,Bobby Reynolds,Alexander Peya,2-6; 6-3; 6-3; 6-7(3); 6-4,R128,204,15,10,106,162,75,106,30,56,7,10,24,105,162,14,6,80,160,54,80,47,80,10,15,24,101,160
2004-08-30 00:00:00.000,US Open NY; U.S.A. Grand Slams,HARD,3,Arnaud Clement,Wayne Arthurs,Arnaud Clement,6-4; 6-7(5); 6-3; 6-3,R128,180,4,3,75,129,59,75,35,54,4,4,20,94,129,25,6,74,140,59,74,27,66,11,15,20,86,140
2004-08-30 00:00:00.000,US Open NY; U.S.A. Grand Slams,HARD,3,Tommy Robredo,Danai Udomchoke,Tommy Robredo,6-4; 7-5; 6-4,R128,130,4,4,63,99,43,63,18,36,5,9,16,61,99,0,5,65,109,39,65,18,44,4,11,16,57,109
2004-08-30 00:00:00.000,US Open NY; U.S.A. Grand Slams,HARD,3,Guillermo Canas,Kristof Vliegen,Guillermo Canas,6-3; 4-6; 7-5; 6-1,R128,152,7,8,52,114,39,52,39,62,5,7,19,78,114,5,8,66,112,47,66,21,46,5,11,19,68,112
2004-08-30 00:00:00.000,US Open NY; U.S.A. Grand Slams,HARD,3,Filippo Volandri,KJ Hippensteel,Filippo Volandri,6-3; 6-4; 6-2,R128,93,1,8,50,87,36,50,23,37,3,5,14,59,87,2,6,57,87,32,57,13,30,4,10,13,45,87
2004-08-30 00:00:00.000,US Open NY; U.S.A. Grand Slams,HARD,3,Rafael Nadal,Ivo Heuberger,Rafael Nadal,6-0; 6-3; 4-6; 2-6; 6-3,R128,174,6,3,69,105,58,69,22,36,1,4,21,80,105,17,8,85,156,58,85,30,71,9,15,21,88,156
2004-08-30 00:00:00.000,US Open NY; U.S.A. Grand Slams,HARD,3,Andy Roddick,Scoville Jenkins,Andy Roddick,6-0; 6-2; 6-2,R128,70,11,0,39,50,38,39,6,11,0,0,11,44,50,1,4,34,69,19,34,11,35,4,11,11,30,69
2004-08-30 00:00:00.000,US Open NY; U.S.A. Grand Slams,HARD,3,Roger Federer,Marcos Baghdatis,Roger Federer,6-2; 6-7(4); 6-3; 6-1,R64,124,8,5,61,104,50,61,25,43,2,4,18,75,104,5,8,64,117,41,64,21,53,2,10,18,62,117
2004-08-30 00:00:00.000,US Open NY; U.S.A. Grand Slams,HARD,3,Fabrice Santoro,Dmitry Tursunov,Fabrice Santoro,6-1; 6-3; 6-4,R64,99,2,2,43,72,37,43,17,29,0,0,13,54,72,4,10,44,83,29,44,13,39,3,8,13,42,83
2004-08-30 00:00:00.000,US Open NY; U.S.A. Grand Slams,HARD,3,Hyung-Taik Lee,Alberto Martin,Hyung-Taik Lee,6-4; 7-6(3); 6-1,R64,136,3,4,68,101,46,68,21,33,4,5,15,67,101,2,6,47,95,32,47,21,48,6,10,14,53,95
2004-08-30 00:00:00.000,US Open NY; U.S.A. Grand Slams,HARD,3,Andrei Pavel,Fernando Verdasco,Andrei Pavel,7-5; 6-3; 7-6(2),R64,124,8,2,69,103,57,69,21,34,3,3,17,78,103,8,6,61,106,41,61,27,45,6,8,16,68,106
2004-08-30 00:00:00.000,US Open NY; U.S.A. Grand Slams,HARD,3,Sargis Sargsian,Nicolas Massu,Sargis Sargsian,6-7(6); 6-4; 3-6; 7-6(6); 6-4,R64,309,20,9,91,182,64,91,49,91,9,15,27,113,182,14,2,117,188,75,117,43,71,9,15,26,118,188
2004-08-30 00:00:00.000,US Open NY; U.S.A. Grand Slams,HARD,3,Paul-Henri Mathieu,Taylor Dent,Paul-Henri Mathieu,6-7(6); 6-4; 6-3; 7-6(6),R64,196,6,3,79,132,56,79,33,53,6,9,21,89,132,15,14,80,159,53,80,41,79,11,17,22,94,159
2004-08-30 00:00:00.000,US Open NY; U.S.A. Grand Slams,HARD,3,Jiri Novak,Alex Calatrava,Jiri Novak,7-5; 6-1; 6-3,R64,92,8,2,57,81,41,57,15,24,3,4,14,56,81,5,2,60,88,34,60,12,28,0,6,14,46,88
2004-08-30 00:00:00.000,US Open NY; U.S.A. Grand Slams,HARD,3,Andre Agassi,Florian Mayer,Andre Agassi,7-5; 2-6; 6-2; 1-0 RET,R64,96,7,3,52,91,38,52,19,39,5,9,15,57,91,2,6,49,85,29,49,19,36,2,7,14,48,85
2004-08-30 00:00:00.000,US Open NY; U.S.A. Grand Slams,HARD,3,Carlos Moya,Amer Delic,Carlos Moya,6-2; 3-6; 6-3; 6-2,R64,120,7,3,57,104,47,57,28,47,1,2,17,75,104,23,6,73,115,49,73,18,42,9,14,17,67,115
2004-08-30 00:00:00.000,US Open NY; U.S.A. Grand Slams,HARD,3,Olivier Rochus,Potito Starace,Olivier Rochus,6-1; 4-6; 4-6; 6-0; 6-3,R64,144,3,4,65,118,49,65,33,53,3,5,21,82,118,9,1,72,111,50,72,16,39,4,11,21,66,111
2004-08-30 00:00:00.000,US Open NY; U.S.A. Grand Slams,HARD,3,Dominik Hrbaty,Karol Kucera,Dominik Hrbaty,6-4; 6-3; 1-6; 5-7; 6-4,R64,190,4,9,90,146,57,90,29,56,8,16,24,86,146,13,8,90,148,60,90,23,58,7,15,24,83,148
2004-08-30 00:00:00.000,US Open NY; U.S.A. Grand Slams,HARD,3,Paradorn Srichaphan,Paul Goldstein,Paradorn Srichaphan,6-4; 7-6(4); 6-0,R64,109,12,8,53,92,40,53,23,39,2,3,14,63,92,1,4,63,100,43,63,15,37,7,12,14,58,100
2004-08-30 00:00:00.000,US Open NY; U.S.A. Grand Slams,HARD,3,Thomas Johansson,Gaston Gaudio,Thomas Johansson,6-3; 2-6; 6-4; 6-4,R64,150,10,7,65,124,48,65,29,59,5,9,19,77,124,4,1,71,112,47,71,20,41,8,13,18,67,112
2004-08-30 00:00:00.000,US Open NY; U.S.A. Grand Slams,HARD,3,Nicolas Kiefer,Cyril Saulnier,Nicolas Kiefer,7-6(0); 6-3; 7-6(4),R64,167,10,8,49,114,43,49,33,65,5,7,17,76,114,7,3,52,107,36,52,26,55,8,11,16,62,107
2004-08-30 00:00:00.000,US Open NY; U.S.A. Grand Slams,HARD,3,Michal Tabara,Mardy Fish,Michal Tabara,6-3; 3-6; 1-6; 6-3; 6-3,R64,162,6,9,63,126,47,63,34,63,7,11,21,81,126,21,9,58,127,42,58,37,69,3,8,22,79,127
2004-08-30 00:00:00.000,US Open NY; U.S.A. Grand Slams,HARD,3,Tim Henman,Jerome Golmard,Tim Henman,6-2; 6-4; 4-6; 7-6(1),R64,165,22,6,77,125,56,77,27,48,2,6,20,83,125,10,7,70,127,46,70,26,57,8,14,20,72,127
2004-08-30 00:00:00.000,US Open NY; U.S.A. Grand Slams,HARD,3,Mikhail Youzhny,David Nalbandian,Mikhail Youzhny,6-7(4); 6-4; 7-5; 2-6; 6-4,R64,238,13,6,121,169,78,121,17,48,9,18,26,95,169,2,7,107,167,72,107,22,60,4,14,26,94,167
2004-08-30 00:00:00.000,US Open NY; U.S.A. Grand Slams,HARD,3,Tomas Berdych,Tuomas Ketola,Tomas Berdych,6-3; 7-6(1); 6-3,R64,121,12,7,70,117,56,70,21,47,13,15,16,77,117,8,7,48,93,31,48,21,45,6,10,14,52,93
2004-08-30 00:00:00.000,US Open NY; U.S.A. Grand Slams,HARD,3,Ricardo Mello,David Sanchez,Ricardo Mello,6-1; 6-1; 6-3,R64,93,2,1,37,76,25,37,28,39,6,6,12,53,76,3,1,47,71,29,47,8,24,5,11,11,37,71
2004-08-30 00:00:00.000,US Open NY; U.S.A. Grand Slams,HARD,3,Tommy Haas,Sebastien Grosjean,Tommy Haas,6-4; 6-4; 1-6; 6-1,R64,149,8,8,61,113,40,61,29,52,8,12,17,69,113,8,7,56,120,42,56,24,64,14,20,17,66,120
2004-08-30 00:00:00.000,US Open NY; U.S.A. Grand Slams,HARD,3,Nikolay Davydenko,Robin Soderling,Nikolay Davydenko,6-1; 2-6; 7-5; 6-4,R64,130,12,2,64,96,46,64,15,32,3,8,18,61,96,7,4,72,120,46,72,18,48,7,15,19,64,120
2004-08-30 00:00:00.000,US Open NY; U.S.A. Grand Slams,HARD,3,Karol Beck,Kristian Pless,Karol Beck,6-1; 7-6(3); 7-5,R64,125,10,2,52,106,38,52,32,54,3,6,16,70,106,8,3,63,103,37,63,16,40,2,8,15,53,103
2004-08-30 00:00:00.000,US Open NY; U.S.A. Grand Slams,HARD,3,Feliciano Lopez,Philipp Kohlschreiber,Feliciano Lopez,7-5; 7-5; 6-7(5); 1-6; 6-2,R64,204,27,7,82,170,62,82,46,88,9,14,26,108,170,12,13,79,173,59,79,45,94,11,17,25,104,173
2004-08-30 00:00:00.000,US Open NY; U.S.A. Grand Slams,HARD,3,Lleyton Hewitt,Hicham Arazi,Lleyton Hewitt,7-6(7); 6-1; 6-2,R64,113,9,4,49,89,39,49,19,40,7,9,13,58,89,1,3,62,92,33,62,11,30,6,13,14,44,92
2004-08-30 00:00:00.000,US Open NY; U.S.A. Grand Slams,HARD,3,Stefan Koubek,Juan Carlos Ferrero,Stefan Koubek,7-6(2); 4-6; 6-7(6); 6-2; 6-3,R64,240,12,8,107,182,73,107,36,75,17,24,26,109,182,8,11,110,192,77,110,32,82,9,18,25,109,192
2004-08-30 00:00:00.000,US Open NY; U.S.A. Grand Slams,HARD,3,Joachim Johansson,Jan-Michael Gambill,Joachim Johansson,6-4; 7-5; 7-5,R64,124,27,5,58,97,47,58,23,39,0,1,17,70,97,24,4,56,112,46,56,24,56,8,12,17,70,112
2004-08-30 00:00:00.000,US Open NY; U.S.A. Grand Slams,HARD,3,Jurgen Melzer,Vincent Spadea,Jurgen Melzer,6-3; 4-6; 3-6; 6-3; 6-4,R64,194,5,11,111,172,80,111,21,61,10,16,24,101,172,11,7,77,140,51,77,30,63,7,14,23,81,140
2004-08-30 00:00:00.000,US Open NY; U.S.A. Grand Slams,HARD,3,Michael Llodra,Andreas Seppi,Michael Llodra,6-0; 6-3; 3-6; 6-3,R64,125,5,4,72,102,55,72,17,30,5,6,17,72,102,6,3,55,105,34,55,28,50,8,13,16,62,105
2004-08-30 00:00:00.000,US Open NY; U.S.A. Grand Slams,HARD,3,Alexander Peya,Thomas Enqvist,Alexander Peya,1-6; 6-3; 6-3; 6-2,R64,133,18,4,71,107,52,71,15,36,5,9,17,67,107,5,8,62,121,42,62,25,59,9,15,16,67,121
2004-08-30 00:00:00.000,US Open NY; U.S.A. Grand Slams,HARD,3,Tommy Robredo,Arnaud Clement,Tommy Robredo,6-3; 6-3; 3-6; 6-4,R64,160,14,8,72,123,51,72,22,51,9,14,18,73,123,1,7,77,123,50,77,16,46,6,14,19,66,123
2004-08-30 00:00:00.000,US Open NY; U.S.A. Grand Slams,HARD,3,Guillermo Canas,Filippo Volandri,Guillermo Canas,6-4; 7-5; 6-1,R64,130,7,2,48,82,38,48,19,34,4,5,14,57,82,0,8,52,105,36,52,22,53,8,14,15,58,105
2004-08-30 00:00:00.000,US Open NY; U.S.A. Grand Slams,HARD,3,Andy Roddick,Rafael Nadal,Andy Roddick,6-0; 6-3; 6-4,R64,96,10,3,45,74,31,45,19,29,3,4,12,50,74,0,4,61,74,30,61,3,13,4,11,13,33,74
2004-08-30 00:00:00.000,US Open NY; U.S.A. Grand Slams,HARD,3,Roger Federer,Fabrice Santoro,Roger Federer,6-0; 6-4; 7-6(7),R32,123,10,2,59,96,46,59,21,37,1,1,14,67,96,2,2,56,95,36,56,20,39,4,8,14,56,95
2004-08-30 00:00:00.000,US Open NY; U.S.A. Grand Slams,HARD,3,Andrei Pavel,Hyung-Taik Lee,Andrei Pavel,6-4; 6-2; 1-6; 1-6; 6-4,R32,158,20,5,75,128,52,75,21,53,11,18,21,73,128,9,4,70,122,52,70,25,52,8,14,21,77,122
2004-08-30 00:00:00.000,US Open NY; U.S.A. Grand Slams,HARD,3,Sargis Sargsian,Paul-Henri Mathieu,Sargis Sargsian,4-6; 4-6; 6-4; 6-2; 7-6(4),R32,284,19,6,82,161,65,82,40,79,7,11,25,105,161,16,10,82,180,59,82,49,98,13,18,25,108,180
2004-08-30 00:00:00.000,US Open NY; U.S.A. Grand Slams,HARD,3,Andre Agassi,Jiri Novak,Andre Agassi,6-4; 6-2; 6-3,R32,91,11,2,56,72,46,56,7,16,2,3,13,53,72,8,4,61,96,41,61,12,35,12,18,14,53,96
2004-08-30 00:00:00.000,US Open NY; U.S.A. Grand Slams,HARD,3,Olivier Rochus,Carlos Moya,Olivier Rochus,4-6; 6-4; 6-3; 6-7(5); 7-5,R32,216,4,10,93,159,69,93,39,66,12,18,27,108,159,17,7,80,149,54,80,37,69,7,15,26,91,149
2004-08-30 00:00:00.000,US Open NY; U.S.A. Grand Slams,HARD,3,Dominik Hrbaty,Paradorn Srichaphan,Dominik Hrbaty,7-6(8); 6-3; 6-3,R32,114,3,5,57,97,42,57,23,40,5,8,15,65,97,7,2,52,97,33,52,22,45,7,13,15,55,97
2004-08-30 00:00:00.000,US Open NY; U.S.A. Grand Slams,HARD,3,Nicolas Kiefer,Thomas Johansson,Nicolas Kiefer,6-4; 6-0; 6-1,R32,97,16,4,35,73,28,35,22,38,5,6,12,50,73,12,4,32,73,21,32,14,41,6,13,11,35,73
2004-08-30 00:00:00.000,US Open NY; U.S.A. Grand Slams,HARD,3,Tim Henman,Michal Tabara,Tim Henman,4-6; 6-3; 5-7; 6-4; 6-3,R32,206,12,9,87,157,54,87,43,70,10,15,25,97,157,14,15,55,150,43,55,49,95,9,16,25,92,150
2004-08-30 00:00:00.000,US Open NY; U.S.A. Grand Slams,HARD,3,Tomas Berdych,Mikhail Youzhny,Tomas Berdych,2-6; 6-1; 6-3; 4-6; 6-1,R32,142,10,5,86,134,60,86,23,48,8,13,21,83,134,9,8,68,127,43,68,24,59,9,17,20,67,127
2004-08-30 00:00:00.000,US Open NY; U.S.A. Grand Slams,HARD,3,Tommy Haas,Ricardo Mello,Tommy Haas,6-2; 6-3; 7-5,R32,116,11,4,49,83,41,49,19,34,2,3,15,60,83,6,3,64,103,42,64,17,39,6,11,14,59,103
2004-08-30 00:00:00.000,US Open NY; U.S.A. Grand Slams,HARD,3,Karol Beck,Nikolay Davydenko,Karol Beck,6-3; 4-6; 3-6; 6-1; 6-4,R32,193,12,7,92,160,74,92,34,68,11,13,23,108,160,5,5,107,151,73,107,19,44,8,12,22,92,151
2004-08-30 00:00:00.000,US Open NY; U.S.A. Grand Slams,HARD,3,Lleyton Hewitt,Feliciano Lopez,Lleyton Hewitt,6-1; 6-4; 6-2,R32,90,11,5,52,80,43,52,16,28,7,7,13,59,80,5,4,51,78,32,51,10,27,3,8,12,42,78
2004-08-30 00:00:00.000,US Open NY; U.S.A. Grand Slams,HARD,3,Joachim Johansson,Stefan Koubek,Joachim Johansson,6-7(2); 7-6(1); 6-1; 6-3,R32,158,19,7,79,135,62,79,34,56,5,5,20,96,135,5,2,90,140,63,90,26,50,14,18,20,89,140
2004-08-30 00:00:00.000,US Open NY; U.S.A. Grand Slams,HARD,3,Michael Llodra,Jurgen Melzer,Michael Llodra,6-3; 6-2; 7-5,R32,102,8,0,68,92,50,68,16,24,2,2,15,66,92,5,3,64,99,37,64,19,35,11,15,14,56,99
2004-08-30 00:00:00.000,US Open NY; U.S.A. Grand Slams,HARD,3,Tommy Robredo,Alexander Peya,Tommy Robredo,6-3; 6-3; 6-2,R32,91,2,3,49,76,37,49,18,27,3,4,13,55,76,2,5,39,73,25,39,13,34,3,9,13,38,73
2004-08-30 00:00:00.000,US Open NY; U.S.A. Grand Slams,HARD,3,Andy Roddick,Guillermo Canas,Andy Roddick,6-1; 6-3; 6-3,R32,96,21,0,51,72,43,51,12,21,5,5,13,55,72,3,7,57,91,38,57,12,34,9,14,12,50,91
2004-08-30 00:00:00.000,US Open NY; U.S.A. Grand Slams,HARD,3,Roger Federer,Andrei Pavel,Roger Federer,W/O,R16,0,0,0,0,0,0,0,0,0,0,0,0,0,0,0,0,0,0,0,0,0,0,0,0,0,0,0
2004-08-30 00:00:00.000,US Open NY; U.S.A. Grand Slams,HARD,3,Andre Agassi,Sargis Sargsian,Andre Agassi,6-3; 6-2; 6-2,R16,89,7,4,48,73,41,48,15,25,1,1,13,56,73,10,4,40,79,29,40,13,39,4,9,12,42,79
2004-08-30 00:00:00.000,US Open NY; U.S.A. Grand Slams,HARD,3,Dominik Hrbaty,Olivier Rochus,Dominik Hrbaty,2-6; 3-6; 6-3; 6-4; 6-0,R16,179,13,5,93,131,58,93,15,38,8,16,21,73,131,2,3,96,128,45,96,19,32,12,22,21,64,128
2004-08-30 00:00:00.000,US Open NY; U.S.A. Grand Slams,HARD,3,Tim Henman,Nicolas Kiefer,Tim Henman,6-7(5); 6-3; 6-1; 6-7(4); 3-0 RET,R16,225,13,6,88,136,68,88,23,48,7,10,22,91,136,14,7,86,158,62,86,28,72,17,25,21,90,158
2004-08-30 00:00:00.000,US Open NY; U.S.A. Grand Slams,HARD,3,Tommy Haas,Tomas Berdych,Tommy Haas,7-6(6); 6-1; 7-5,R16,120,18,1,55,91,45,55,21,36,1,3,16,66,91,6,4,58,102,39,58,18,44,5,10,15,57,102
2004-08-30 00:00:00.000,US Open NY; U.S.A. Grand Slams,HARD,3,Lleyton Hewitt,Karol Beck,Lleyton Hewitt,6-4; 6-2; 6-2,R16,100,7,3,45,83,31,45,27,38,5,5,13,58,83,4,7,34,73,23,34,16,39,5,10,13,39,73
2004-08-30 00:00:00.000,US Open NY; U.S.A. Grand Slams,HARD,3,Joachim Johansson,Michael Llodra,Joachim Johansson,6-2; 6-3; 6-2,R16,79,10,5,33,65,29,33,17,32,1,2,12,46,65,9,7,44,72,27,44,7,28,2,9,13,34,72
2004-08-30 00:00:00.000,US Open NY; U.S.A. Grand Slams,HARD,3,Andy Roddick,Tommy Robredo,Andy Roddick,6-3; 6-2; 6-4,R16,92,11,3,49,74,43,49,15,25,2,2,14,58,74,5,5,51,84,34,51,17,33,4,8,13,51,84
2004-08-30 00:00:00.000,US Open NY; U.S.A. Grand Slams,HARD,3,Roger Federer,Andre Agassi,Roger Federer,6-3; 2-6; 7-5; 3-6; 6-3,Q,180,16,9,101,158,75,101,27,57,6,9,24,102,158,4,4,97,142,69,97,27,45,7,10,23,96,142
2004-08-30 00:00:00.000,US Open NY; U.S.A. Grand Slams,HARD,3,Tim Henman,Dominik Hrbaty,Tim Henman,6-1; 7-5; 5-7; 6-2,Q,158,11,10,65,121,51,65,28,56,3,5,20,79,121,7,11,70,118,49,70,21,48,5,11,19,70,118
2004-08-30 00:00:00.000,US Open NY; U.S.A. Grand Slams,HARD,3,Lleyton Hewitt,Tommy Haas,Lleyton Hewitt,6-2; 6-2; 6-2,Q,98,3,2,41,66,30,41,16,25,3,5,12,46,66,2,3,56,77,29,56,5,21,6,14,12,34,77
2004-08-30 00:00:00.000,US Open NY; U.S.A. Grand Slams,HARD,3,Joachim Johansson,Andy Roddick,Joachim Johansson,6-4; 6-4; 3-6; 2-6; 6-4,Q,173,30,6,99,162,74,99,27,63,12,15,23,101,162,34,5,75,118,64,75,27,43,2,5,24,91,118
2004-08-30 00:00:00.000,US Open NY; U.S.A. Grand Slams,HARD,3,Roger Federer,Tim Henman,Roger Federer,6-3; 6-4; 6-4,S,104,7,2,53,84,40,53,20,31,2,4,15,60,84,4,1,45,74,28,45,18,29,2,7,14,46,74
2004-08-30 00:00:00.000,US Open NY; U.S.A. Grand Slams,HARD,3,Lleyton Hewitt,Joachim Johansson,Lleyton Hewitt,6-4; 7-5; 6-3,S,119,9,2,59,88,49,59,19,29,1,1,16,68,88,17,4,60,99,43,60,15,39,2,5,15,58,99
2004-08-30 00:00:00.000,US Open NY; U.S.A. Grand Slams,HARD,3,Roger Federer,Lleyton Hewitt,Roger Federer,6-0; 7-6(3); 6-0,F,109,11,1,49,89,38,49,22,40,5,6,12,60,89,1,4,41,75,23,41,12,34,6,13,12,35,75
2004-09-13 00:00:00.000,Beijing China ATP World Tour,HARD,2,Jo-Wilfried Tsonga,Carlos Moya,Jo-Wilfried Tsonga,6-3; 6-3,R32,55,5,3,31,49,26,31,9,18,1,2,9,35,49,2,8,29,54,18,29,8,25,3,7,9,26,54
2004-09-13 00:00:00.000,Beijing China ATP World Tour,HARD,2,Hyung-Taik Lee,Glenn Weiner,Hyung-Taik Lee,6-2; 6-4,R32,57,6,1,32,47,23,32,9,15,2,4,9,32,47,2,3,30,48,18,30,6,18,3,8,9,24,48
2004-09-13 00:00:00.000,Beijing China ATP World Tour,HARD,2,Noam Okun,Arvind Parmar,Noam Okun,6-3; 6-2,R32,72,6,1,32,55,26,32,13,23,1,1,9,39,55,4,2,27,44,18,27,7,17,0,3,8,25,44
2004-09-13 00:00:00.000,Beijing China ATP World Tour,HARD,2,Paradorn Srichaphan,Jean-Rene Lisnard,Paradorn Srichaphan,6-4; 7-5,R32,91,3,1,49,65,31,49,9,16,5,8,11,40,65,2,3,33,67,22,33,13,34,4,9,11,35,67
2004-09-13 00:00:00.000,Beijing China ATP World Tour,HARD,2,Rainer Schuettler,Paul Baccanello,Rainer Schuettler,6-4; 6-3,R32,101,4,4,44,69,34,44,14,25,4,4,10,48,69,5,7,45,74,32,45,11,29,9,11,9,43,74
2004-09-13 00:00:00.000,Beijing China ATP World Tour,HARD,2,Mikhail Youzhny,Ivo Heuberger,Mikhail Youzhny,7-5; 7-6(4),R32,119,6,5,44,81,34,44,20,37,3,5,12,54,81,4,5,42,85,27,42,23,43,5,8,12,50,85
2004-09-13 00:00:00.000,Beijing China ATP World Tour,HARD,2,Davide Sanguinetti,Nathan Healey,Davide Sanguinetti,5-7; 7-5; 6-2,R32,131,2,0,57,90,39,57,20,33,5,8,16,59,90,12,6,52,105,35,52,28,53,4,9,16,63,105
2004-09-13 00:00:00.000,Beijing China ATP World Tour,HARD,2,Dominik Hrbaty,Yu Jr. Wang,Dominik Hrbaty,6-2; 6-2,R32,68,4,4,28,54,24,28,14,26,7,7,8,38,54,1,2,25,52,16,25,12,27,2,6,8,28,52
2004-09-13 00:00:00.000,Beijing China ATP World Tour,HARD,2,Taylor Dent,Peter Luczak,Taylor Dent,6-3; 6-2,R32,64,16,6,24,49,23,24,14,25,0,0,9,37,49,0,0,37,56,22,37,10,19,7,10,8,32,56
2004-09-13 00:00:00.000,Beijing China ATP World Tour,HARD,2,Jarkko Nieminen,Guillermo Garcia-Lopez,Jarkko Nieminen,7-5; 6-4,R32,102,5,4,45,78,34,45,16,33,7,8,11,50,78,0,1,40,74,29,40,14,34,6,9,11,43,74
2004-09-13 00:00:00.000,Beijing China ATP World Tour,HARD,2,Yen-Hsun Lu,Ben-Qiang Zhu,Yen-Hsun Lu,7-5; 6-2,R32,80,6,1,32,51,27,32,14,19,0,0,10,41,51,6,3,47,69,28,47,11,22,6,9,10,39,69
2004-09-13 00:00:00.000,Beijing China ATP World Tour,HARD,2,David Nalbandian,Kristian Pless,David Nalbandian,7-6(5); 3-6; 6-3,R32,132,7,1,55,98,40,55,28,43,5,7,15,68,98,5,2,59,100,43,59,23,41,9,11,15,66,100
2004-09-13 00:00:00.000,Beijing China ATP World Tour,HARD,2,Marat Safin,Alex Bogomolov Jr.,Marat Safin,6-4; 7-5,R32,72,10,1,39,55,34,39,11,16,0,0,11,45,55,3,2,41,63,30,41,13,22,3,5,11,43,63
2004-09-13 00:00:00.000,Beijing China ATP World Tour,HARD,2,Hao Lu,Prakash Amritraj,Hao Lu,4-6; 6-4; 6-2,R32,124,1,3,61,87,41,61,13,26,2,5,14,54,87,0,4,50,87,35,50,17,37,9,14,14,52,87
2004-09-13 00:00:00.000,Beijing China ATP World Tour,HARD,2,Kevin Kim,Lars Burgsmuller,Kevin Kim,6-2; 6-2,R32,67,6,0,28,39,24,28,8,11,0,0,8,32,39,4,0,29,53,15,29,10,24,2,6,8,25,53
2004-09-13 00:00:00.000,Beijing China ATP World Tour,HARD,2,Juan Carlos Ferrero,Justin Gimelstob,Juan Carlos Ferrero,6-4; 6-1,R32,74,3,4,36,64,28,36,18,28,5,5,9,46,64,4,6,19,49,15,19,12,30,2,5,8,27,49
2004-09-13 00:00:00.000,Beijing China ATP World Tour,HARD,2,Hyung-Taik Lee,Jo-Wilfried Tsonga,Hyung-Taik Lee,7-6(7); 6-3,R16,86,2,2,41,68,30,41,21,27,2,3,11,51,68,5,2,45,77,34,45,12,32,8,10,10,46,77
2004-09-13 00:00:00.000,Beijing China ATP World Tour,HARD,2,Paradorn Srichaphan,Noam Okun,Paradorn Srichaphan,6-3; 3-6; 7-6(6),R16,122,9,3,56,95,40,56,25,39,4,7,15,65,95,8,2,52,88,35,52,24,36,7,10,15,59,88
2004-09-13 00:00:00.000,Beijing China ATP World Tour,HARD,2,Mikhail Youzhny,Rainer Schuettler,Mikhail Youzhny,7-6(4); 6-1,R16,85,6,3,38,72,31,38,15,34,5,6,10,46,72,1,4,47,71,27,47,12,24,8,11,9,39,71
2004-09-13 00:00:00.000,Beijing China ATP World Tour,HARD,2,Dominik Hrbaty,Davide Sanguinetti,Dominik Hrbaty,6-2; 6-2,R16,51,3,3,29,53,23,29,14,24,3,3,8,37,53,0,1,26,41,12,26,7,15,0,4,8,19,41
2004-09-13 00:00:00.000,Beijing China ATP World Tour,HARD,2,Jarkko Nieminen,Taylor Dent,Jarkko Nieminen,6-3; 7-5,R16,79,4,4,51,77,34,51,9,26,6,10,11,43,77,2,8,32,58,18,32,9,26,4,10,10,27,58
2004-09-13 00:00:00.000,Beijing China ATP World Tour,HARD,2,David Nalbandian,Yen-Hsun Lu,David Nalbandian,6-7(6); 6-4; 6-4,R16,150,3,4,62,110,47,62,26,48,4,5,16,73,110,7,6,56,98,45,56,22,42,4,7,16,67,98
2004-09-13 00:00:00.000,Beijing China ATP World Tour,HARD,2,Marat Safin,Hao Lu,Marat Safin,6-2; 6-2,R16,52,9,2,21,40,21,21,11,19,0,0,8,32,40,1,5,32,58,17,32,12,26,7,11,8,29,58
2004-09-13 00:00:00.000,Beijing China ATP World Tour,HARD,2,Kevin Kim,Juan Carlos Ferrero,Kevin Kim,6-4; 6-4,R16,85,5,2,37,70,26,37,22,33,8,8,10,48,70,4,2,38,70,24,38,20,32,9,11,10,44,70
2004-09-13 00:00:00.000,Beijing China ATP World Tour,HARD,2,Paradorn Srichaphan,Hyung-Taik Lee,Paradorn Srichaphan,6-4; 6-3,Q,76,11,0,37,55,29,37,11,18,3,5,10,40,55,4,1,33,62,21,33,12,29,6,10,9,33,62
2004-09-13 00:00:00.000,Beijing China ATP World Tour,HARD,2,Mikhail Youzhny,Dominik Hrbaty,Mikhail Youzhny,6-4; 6-2,Q,68,5,4,35,63,27,35,13,28,7,8,9,40,63,1,1,34,53,19,34,9,19,2,6,9,28,53
2004-09-13 00:00:00.000,Beijing China ATP World Tour,HARD,2,Jarkko Nieminen,David Nalbandian,Jarkko Nieminen,6-2; 2-6; 6-2,Q,114,5,1,48,69,35,48,11,21,0,2,12,46,69,2,2,53,96,34,53,20,43,12,16,12,54,96
2004-09-13 00:00:00.000,Beijing China ATP World Tour,HARD,2,Marat Safin,Kevin Kim,Marat Safin,6-2; 6-4,Q,62,9,1,29,46,24,29,11,17,0,1,9,35,46,6,2,42,68,25,42,10,26,7,11,9,35,68
2004-09-13 00:00:00.000,Beijing China ATP World Tour,HARD,2,Mikhail Youzhny,Paradorn Srichaphan,Mikhail Youzhny,6-4; 6-4,S,81,3,0,42,77,27,42,24,35,6,6,10,51,77,9,4,37,60,30,37,9,23,2,4,10,39,60
2004-09-13 00:00:00.000,Beijing China ATP World Tour,HARD,2,Marat Safin,Jarkko Nieminen,Marat Safin,6-2; 6-4,S,65,13,0,33,53,27,33,12,20,1,1,9,39,53,1,2,38,65,22,38,13,27,6,9,9,35,65
2004-09-13 00:00:00.000,Beijing China ATP World Tour,HARD,2,Marat Safin,Mikhail Youzhny,Marat Safin,7-6(4); 7-5,F,97,8,1,53,80,42,53,14,27,2,3,12,56,80,3,3,47,76,32,47,17,29,1,3,12,49,76
2004-09-13 00:00:00.000,Bucharest Romania ATP World Tour,CLAY,2,Victor Hanescu,Fernando Verdasco,Victor Hanescu,7-6(4); 7-6(3),R32,119,1,0,59,80,37,59,12,21,3,7,12,49,80,2,1,79,108,48,79,12,29,5,9,12,60,108
2004-09-13 00:00:00.000,Bucharest Romania ATP World Tour,CLAY,2,Stefan Koubek,Victor Ionita,Stefan Koubek,6-3; 7-6(3),R32,123,3,1,55,82,32,55,12,27,5,10,11,44,82,2,2,45,82,20,45,20,37,6,12,10,40,82
2004-09-13 00:00:00.000,Bucharest Romania ATP World Tour,CLAY,2,Richard Gasquet,Potito Starace,Richard Gasquet,6-3; 6-4,R32,91,4,3,41,69,31,41,12,28,7,9,10,43,69,0,2,54,74,30,54,6,20,4,8,9,36,74
2004-09-13 00:00:00.000,Bucharest Romania ATP World Tour,CLAY,2,Filippo Volandri,Albert Montanes,Filippo Volandri,6-3; 6-1,R32,54,3,1,24,41,20,24,10,17,1,2,8,30,41,1,3,27,51,14,27,9,24,3,8,8,23,51
2004-09-13 00:00:00.000,Bucharest Romania ATP World Tour,CLAY,2,Paul-Henri Mathieu,Albert Costa,Paul-Henri Mathieu,6-1; 6-2,R32,84,1,1,30,58,21,30,18,28,1,1,8,39,58,3,0,26,40,12,26,7,14,1,5,7,19,40
2004-09-13 00:00:00.000,Bucharest Romania ATP World Tour,CLAY,2,Alex Corretja,Oscar Hernandez,Alex Corretja,7-5; 2-6; 7-5,R32,183,5,2,62,99,38,62,18,37,6,12,16,56,99,5,0,67,103,41,67,18,36,7,13,16,59,103
2004-09-13 00:00:00.000,Bucharest Romania ATP World Tour,CLAY,2,Jose Acasuso,Franco Squillari,Jose Acasuso,3-6; 6-4; 6-2,R32,120,3,2,42,78,34,42,16,36,2,4,13,50,78,6,10,59,103,40,59,18,44,10,14,14,58,103
2004-09-13 00:00:00.000,Bucharest Romania ATP World Tour,CLAY,2,David Sanchez,Raemon Sluiter,David Sanchez,6-2; 7-6(3),R32,83,4,0,40,58,32,40,11,18,2,3,10,43,58,4,2,46,72,31,46,11,26,6,9,10,42,72
2004-09-13 00:00:00.000,Bucharest Romania ATP World Tour,CLAY,2,Felix Mantilla,Nikolay Davydenko,Felix Mantilla,7-6(3); 6-0,R32,90,1,3,26,50,20,26,16,24,0,1,9,36,50,4,1,37,64,21,37,12,27,5,9,9,33,64
2004-09-13 00:00:00.000,Bucharest Romania ATP World Tour,CLAY,2,Alex Calatrava,Juan Monaco,Alex Calatrava,7-6(7); 6-2,R32,104,5,0,43,65,30,43,16,22,4,5,10,46,65,1,1,43,64,30,43,10,21,1,4,10,40,64
2004-09-13 00:00:00.000,Bucharest Romania ATP World Tour,CLAY,2,Philipp Kohlschreiber,Razvan Sabau,Philipp Kohlschreiber,6-1; 6-1,R32,50,7,2,29,41,21,29,5,12,0,1,7,26,41,0,0,27,42,11,27,3,15,3,9,7,14,42
2004-09-13 00:00:00.000,Bucharest Romania ATP World Tour,CLAY,2,Igor Andreev,Kristof Vliegen,Igor Andreev,6-2; 6-3,R32,70,0,5,30,60,19,30,18,30,6,7,8,37,60,0,3,35,56,18,35,9,21,2,7,9,27,56
2004-09-13 00:00:00.000,Bucharest Romania ATP World Tour,CLAY,2,David Ferrer,Stanislas Wawrinka,David Ferrer,6-4; 7-6(4),R32,122,2,3,52,84,31,52,15,32,4,8,11,46,84,5,5,51,89,29,51,16,38,7,12,11,45,89
2004-09-13 00:00:00.000,Bucharest Romania ATP World Tour,CLAY,2,Novak Djokovic,Arnaud Clement,Novak Djokovic,2-6; 6-4; 6-4,R32,146,4,2,60,91,39,60,19,31,2,5,14,58,91,0,2,62,93,40,62,16,31,7,10,14,56,93
2004-09-13 00:00:00.000,Bucharest Romania ATP World Tour,CLAY,2,Arnaud Di Pasquale,Daniel Elsner,Arnaud Di Pasquale,4-0 RET,R32,17,1,1,6,9,6,6,2,3,0,0,2,8,9,0,0,10,17,4,10,2,7,3,5,2,6,17
2004-09-13 00:00:00.000,Bucharest Romania ATP World Tour,CLAY,2,Florian Mayer,Dennis van Scheppingen,Florian Mayer,6-1; 6-1,R32,46,3,0,26,38,21,26,8,12,1,1,7,29,38,0,4,16,40,7,16,9,24,3,8,7,16,40
2004-09-13 00:00:00.000,Bucharest Romania ATP World Tour,CLAY,2,Victor Hanescu,Stefan Koubek,Victor Hanescu,6-2; 6-3,R16,59,2,0,41,50,32,41,5,9,1,1,9,37,50,2,1,28,44,13,28,11,16,2,5,8,24,44
2004-09-13 00:00:00.000,Bucharest Romania ATP World Tour,CLAY,2,Filippo Volandri,Richard Gasquet,Filippo Volandri,6-2; 1-6; 6-3,R16,84,1,4,63,83,39,63,12,20,7,10,12,51,83,1,3,29,58,21,29,15,29,1,5,12,36,58
2004-09-13 00:00:00.000,Bucharest Romania ATP World Tour,CLAY,2,Paul-Henri Mathieu,Alex Corretja,Paul-Henri Mathieu,3-6; 6-3; 6-1,R16,139,2,3,49,86,33,49,18,37,7,11,13,51,86,3,0,39,67,22,39,14,28,4,10,12,36,67
2004-09-13 00:00:00.000,Bucharest Romania ATP World Tour,CLAY,2,Jose Acasuso,David Sanchez,Jose Acasuso,6-3; 6-0,R16,61,6,1,20,36,19,20,5,16,0,1,7,24,36,1,3,33,50,17,33,4,17,3,9,8,21,50
2004-09-13 00:00:00.000,Bucharest Romania ATP World Tour,CLAY,2,Felix Mantilla,Alex Calatrava,Felix Mantilla,6-3; 6-1,R16,58,8,3,18,42,17,18,15,24,0,0,8,32,42,2,1,34,45,20,34,3,11,1,5,8,23,45
2004-09-13 00:00:00.000,Bucharest Romania ATP World Tour,CLAY,2,Igor Andreev,Philipp Kohlschreiber,Igor Andreev,7-6(6); 6-2,R16,97,2,1,36,73,26,36,22,37,1,2,10,48,73,4,1,44,74,28,44,16,30,2,5,10,44,74
2004-09-13 00:00:00.000,Bucharest Romania ATP World Tour,CLAY,2,David Ferrer,Novak Djokovic,David Ferrer,4-6; 6-4; 6-4,R16,155,1,2,61,107,34,61,25,46,14,19,15,59,107,3,1,62,98,37,62,14,36,5,11,15,51,98
2004-09-13 00:00:00.000,Bucharest Romania ATP World Tour,CLAY,2,Florian Mayer,Arnaud Di Pasquale,Florian Mayer,7-6(6); 4-6; 6-3,R16,140,8,1,70,100,47,70,18,30,1,3,16,65,100,3,2,64,104,42,64,23,40,4,6,15,65,104
2004-09-13 00:00:00.000,Bucharest Romania ATP World Tour,CLAY,2,Filippo Volandri,Victor Hanescu,Filippo Volandri,6-3; 6-1,Q,60,3,0,38,50,27,38,6,12,5,6,8,33,50,0,0,39,49,18,39,5,10,2,7,8,23,49
2004-09-13 00:00:00.000,Bucharest Romania ATP World Tour,CLAY,2,Jose Acasuso,Paul-Henri Mathieu,Jose Acasuso,6-2; 7-6(2),Q,100,5,3,34,62,27,34,16,28,3,4,10,43,62,1,5,36,75,24,36,15,39,6,9,10,39,75
2004-09-13 00:00:00.000,Bucharest Romania ATP World Tour,CLAY,2,Igor Andreev,Felix Mantilla,Igor Andreev,6-4; 6-2,Q,85,2,3,37,55,26,37,13,18,3,3,9,39,55,0,5,30,67,20,30,17,37,10,13,9,37,67
2004-09-13 00:00:00.000,Bucharest Romania ATP World Tour,CLAY,2,Florian Mayer,David Ferrer,Florian Mayer,6-4; 6-2,Q,63,1,0,40,54,26,40,10,14,2,3,9,36,54,0,1,39,52,17,39,9,13,2,6,9,26,52
2004-09-13 00:00:00.000,Bucharest Romania ATP World Tour,CLAY,2,Jose Acasuso,Filippo Volandri,Jose Acasuso,7-6(5); 6-2,S,85,6,2,36,60,30,36,15,24,1,2,10,45,60,0,0,40,69,28,40,10,29,4,7,10,38,69
2004-09-13 00:00:00.000,Bucharest Romania ATP World Tour,CLAY,2,Igor Andreev,Florian Mayer,Igor Andreev,2-6; 6-1; 6-4,S,95,1,0,53,83,37,53,19,30,5,7,13,56,83,1,1,47,74,32,47,12,27,7,10,12,44,74
2004-09-13 00:00:00.000,Bucharest Romania ATP World Tour,CLAY,2,Jose Acasuso,Igor Andreev,Jose Acasuso,6-3; 6-0,F,65,5,1,21,38,18,21,9,17,0,1,7,27,38,0,3,21,43,10,21,5,22,3,9,8,15,43
2004-09-13 00:00:00.000,Delray Beach FL; U.S.A. ATP World Tour,HARD,2,Vincent Spadea,Alejandro Falla,Vincent Spadea,4-6; 7-5; 6-1,R32,143,6,2,51,99,33,51,30,48,2,5,15,63,99,1,0,71,108,45,71,15,37,13,18,14,60,108
2004-09-13 00:00:00.000,Delray Beach FL; U.S.A. ATP World Tour,HARD,2,James Blake,Adrian Bohane,James Blake,4-6; 6-3; 6-2,R32,87,6,5,54,76,42,54,13,22,1,2,14,55,76,1,3,38,71,28,38,15,33,4,7,13,43,71
2004-09-13 00:00:00.000,Delray Beach FL; U.S.A. ATP World Tour,HARD,2,Jeff Morrison,Todd Widom,Jeff Morrison,6-4; 6-3,R32,84,5,4,25,49,24,25,13,24,0,0,9,37,49,4,3,44,71,32,44,10,27,4,7,10,42,71
2004-09-13 00:00:00.000,Delray Beach FL; U.S.A. ATP World Tour,HARD,2,Hugo Armando,Max Mirnyi,Hugo Armando,3-6; 7-6(5); 7-6(4),R32,159,3,4,68,102,49,68,23,34,1,2,16,72,102,17,6,69,113,56,69,23,44,7,7,17,79,113
2004-09-13 00:00:00.000,Delray Beach FL; U.S.A. ATP World Tour,HARD,2,Greg Rusedski,Xavier Malisse,Greg Rusedski,7-5; 4-6; 6-1,R32,127,2,7,62,107,44,62,26,45,9,10,15,70,107,9,3,44,79,36,44,13,35,1,4,14,49,79
2004-09-13 00:00:00.000,Delray Beach FL; U.S.A. ATP World Tour,HARD,2,Matias Boeker,Robert Kendrick,Matias Boeker,6-3; 6-2,R32,61,6,3,32,52,27,32,11,20,2,2,9,38,52,2,3,29,47,19,29,7,18,1,4,8,26,47
2004-09-13 00:00:00.000,Delray Beach FL; U.S.A. ATP World Tour,HARD,2,Jeff Salzenstein,Marco Chiudinelli,Jeff Salzenstein,7-5; 6-7(4); 6-2,R32,125,21,7,50,86,44,50,20,36,1,2,16,64,86,6,4,70,111,47,70,21,41,8,12,16,68,111
2004-09-13 00:00:00.000,Delray Beach FL; U.S.A. ATP World Tour,HARD,2,Paul Goldstein,Ivo Karlovic,Paul Goldstein,4-6; 6-3; 7-6(4),R32,120,1,0,72,90,51,72,11,18,1,3,15,62,90,19,6,55,100,45,55,22,45,7,10,16,67,100
2004-09-13 00:00:00.000,Delray Beach FL; U.S.A. ATP World Tour,HARD,2,Kenneth Carlsen,Cyril Saulnier,Kenneth Carlsen,2-6; 6-4; 7-5,R32,124,8,3,62,90,48,62,12,28,3,5,15,60,90,9,4,47,85,36,47,21,38,2,4,15,57,85
2004-09-13 00:00:00.000,Delray Beach FL; U.S.A. ATP World Tour,HARD,2,Bjorn Phau,Wayne Odesnik,Bjorn Phau,4-6; 6-3; 6-0,R32,90,6,2,40,70,36,40,15,30,1,2,13,51,70,8,2,40,75,25,40,17,35,3,7,12,42,75
2004-09-13 00:00:00.000,Delray Beach FL; U.S.A. ATP World Tour,HARD,2,Amer Delic,Adrian Garcia,Amer Delic,2-6; 6-2; 6-3,R32,85,15,4,46,74,36,46,13,28,6,8,12,49,74,2,2,39,69,22,39,20,30,0,4,13,42,69
2004-09-13 00:00:00.000,Delray Beach FL; U.S.A. ATP World Tour,HARD,2,Mario Ancic,Jan-Michael Gambill,Mario Ancic,6-3; 6-4,R32,71,9,2,40,54,31,40,11,14,1,1,10,42,54,6,1,28,55,20,28,15,27,1,3,9,35,55
2004-09-13 00:00:00.000,Delray Beach FL; U.S.A. ATP World Tour,HARD,2,Sebastien De Chaunac,Radek Stepanek,Sebastien De Chaunac,6-7(7); 7-6(1); 6-1,R32,172,1,12,75,131,47,75,22,56,15,21,16,69,131,3,9,73,115,41,73,15,42,9,17,15,56,115
2004-09-13 00:00:00.000,Delray Beach FL; U.S.A. ATP World Tour,HARD,2,Jerome Golmard,Dick Norman,Jerome Golmard,7-5; 3-6; 6-4,R32,121,7,2,49,79,35,49,17,30,1,4,15,52,79,13,6,54,93,41,54,18,39,5,9,16,59,93
2004-09-13 00:00:00.000,Delray Beach FL; U.S.A. ATP World Tour,HARD,2,Ricardo Mello,Gilles Elseneer,Ricardo Mello,6-1; 6-4,R32,68,3,1,40,60,27,40,12,20,8,9,9,39,60,2,3,36,52,22,36,3,16,3,7,8,25,52
2004-09-13 00:00:00.000,Delray Beach FL; U.S.A. ATP World Tour,HARD,2,Mardy Fish,Andres Pedroso,Mardy Fish,6-1; 6-2,R32,61,6,4,30,49,23,30,9,19,1,2,8,32,49,2,0,26,41,8,26,8,15,3,8,7,16,41
2004-09-13 00:00:00.000,Delray Beach FL; U.S.A. ATP World Tour,HARD,2,Vincent Spadea,James Blake,Vincent Spadea,6-3; 6-1,R16,61,3,0,30,51,24,30,11,21,2,2,8,35,51,2,1,30,54,16,30,10,24,3,7,8,26,54
2004-09-13 00:00:00.000,Delray Beach FL; U.S.A. ATP World Tour,HARD,2,Hugo Armando,Jeff Morrison,Hugo Armando,7-6(4); 6-3,R16,79,9,0,40,63,34,40,17,23,0,0,11,51,63,7,6,37,67,32,37,14,30,3,4,10,46,67
2004-09-13 00:00:00.000,Delray Beach FL; U.S.A. ATP World Tour,HARD,2,Greg Rusedski,Matias Boeker,Greg Rusedski,6-3; 6-4,R16,68,12,2,27,53,25,27,16,26,1,1,10,41,53,3,4,31,44,21,31,8,13,3,5,9,29,44
2004-09-13 00:00:00.000,Delray Beach FL; U.S.A. ATP World Tour,HARD,2,Jeff Salzenstein,Paul Goldstein,Jeff Salzenstein,6-2; 2-6; 6-1,R16,87,20,7,45,75,36,45,12,30,6,8,11,48,75,1,2,53,75,33,53,9,22,2,7,12,42,75
2004-09-13 00:00:00.000,Delray Beach FL; U.S.A. ATP World Tour,HARD,2,Kenneth Carlsen,Bjorn Phau,Kenneth Carlsen,5-7; 6-4; 6-2,R16,131,3,4,57,89,43,57,13,32,0,3,15,56,89,4,7,47,95,33,47,23,48,3,8,15,56,95
2004-09-13 00:00:00.000,Delray Beach FL; U.S.A. ATP World Tour,HARD,2,Mario Ancic,Amer Delic,Mario Ancic,6-1; 6-3,R16,58,3,1,20,39,20,20,12,19,0,0,8,32,39,4,5,32,53,18,32,9,21,2,6,8,27,53
2004-09-13 00:00:00.000,Delray Beach FL; U.S.A. ATP World Tour,HARD,2,Jerome Golmard,Sebastien De Chaunac,Jerome Golmard,6-3; 6-2,R16,72,7,4,30,51,26,30,12,21,0,0,9,38,51,5,1,24,44,16,24,9,20,2,5,8,25,44
2004-09-13 00:00:00.000,Delray Beach FL; U.S.A. ATP World Tour,HARD,2,Ricardo Mello,Mardy Fish,Ricardo Mello,5-7; 6-4; 6-4,R16,132,6,1,67,100,44,67,23,33,8,10,16,67,100,11,9,47,99,35,47,27,52,4,7,16,62,99
2004-09-13 00:00:00.000,Delray Beach FL; U.S.A. ATP World Tour,HARD,2,Vincent Spadea,Hugo Armando,Vincent Spadea,6-3; 1-6; 6-4,Q,96,9,4,44,72,33,44,15,28,3,5,13,48,72,6,3,49,79,39,49,14,30,2,4,13,53,79
2004-09-13 00:00:00.000,Delray Beach FL; U.S.A. ATP World Tour,HARD,2,Jeff Salzenstein,Greg Rusedski,Jeff Salzenstein,6-4; 7-6(7),Q,85,14,4,41,62,36,41,14,21,1,1,11,50,62,8,4,52,82,39,52,14,30,4,5,11,53,82
2004-09-13 00:00:00.000,Delray Beach FL; U.S.A. ATP World Tour,HARD,2,Mario Ancic,Kenneth Carlsen,Mario Ancic,6-2; 7-5,Q,92,8,0,37,52,32,37,10,15,0,0,10,42,52,1,3,39,69,26,39,14,30,4,7,10,40,69
2004-09-13 00:00:00.000,Delray Beach FL; U.S.A. ATP World Tour,HARD,2,Ricardo Mello,Jerome Golmard,Ricardo Mello,6-7(2); 6-3; 6-3,Q,136,10,5,65,105,47,65,21,40,4,5,15,68,105,15,4,59,91,43,59,16,32,4,8,15,59,91
2004-09-13 00:00:00.000,Delray Beach FL; U.S.A. ATP World Tour,HARD,2,Vincent Spadea,Jeff Salzenstein,Vincent Spadea,6-1; 6-3,S,67,2,0,29,50,21,29,14,21,1,1,8,35,50,4,3,37,62,24,37,9,25,8,12,8,33,62
2004-09-13 00:00:00.000,Delray Beach FL; U.S.A. ATP World Tour,HARD,2,Ricardo Mello,Mario Ancic,Ricardo Mello,7-6(2); 6-3,S,114,4,2,46,76,33,46,17,30,5,7,11,50,76,8,5,47,74,31,47,11,27,4,7,10,42,74
2004-09-13 00:00:00.000,Delray Beach FL; U.S.A. ATP World Tour,HARD,2,Ricardo Mello,Vincent Spadea,Ricardo Mello,7-6(2); 6-3,F,104,1,3,41,74,28,41,21,33,3,4,11,49,74,3,4,36,67,26,36,13,31,4,6,10,39,67
2004-09-27 00:00:00.000,Bangkok Thailand ATP World Tour,HARD,2,Roger Federer,Nicolas Thomann,Roger Federer,6-4; 7-6(4),R32,96,13,2,45,69,38,45,13,24,2,2,11,51,69,6,3,44,85,33,44,21,41,9,10,11,54,85
2004-09-27 00:00:00.000,Bangkok Thailand ATP World Tour,HARD,2,Ivo Heuberger,Attila Savolt,Ivo Heuberger,6-4; 6-1,R32,73,16,5,33,56,32,33,9,23,3,3,9,41,56,3,7,34,58,25,34,5,24,3,6,8,30,58
2004-09-27 00:00:00.000,Bangkok Thailand ATP World Tour,HARD,2,Paul Baccanello,Marc Rosset,Paul Baccanello,7-6(2); 1-6; 7-6(4),R32,126,8,3,50,86,42,50,24,36,1,3,15,66,86,19,9,59,109,50,59,26,50,3,3,16,76,109
2004-09-27 00:00:00.000,Bangkok Thailand ATP World Tour,HARD,2,Robin Soderling,Harel Levy,Robin Soderling,6-3; 6-4,R32,72,7,3,35,56,29,35,13,21,1,1,10,42,56,7,2,46,82,31,46,17,36,6,8,9,48,82
2004-09-27 00:00:00.000,Bangkok Thailand ATP World Tour,HARD,2,Paradorn Srichaphan,Marco Chiudinelli,Paradorn Srichaphan,6-4; 7-6(3),R32,88,6,0,38,63,32,38,14,25,1,2,11,46,63,5,3,46,74,31,46,15,28,2,4,11,46,74
2004-09-27 00:00:00.000,Bangkok Thailand ATP World Tour,HARD,2,Alex Bogomolov Jr.,Jaymon Crabb,Alex Bogomolov Jr.,6-3; 6-2,R32,65,5,5,32,65,26,32,15,33,4,5,9,41,65,4,3,31,50,19,31,6,19,2,6,8,25,50
2004-09-27 00:00:00.000,Bangkok Thailand ATP World Tour,HARD,2,Dennis van Scheppingen,Novak Djokovic,Dennis van Scheppingen,4-6; 7-5; 6-4,R32,112,7,7,57,88,39,57,18,31,3,7,16,57,88,15,12,70,118,45,70,22,48,10,15,16,67,118
2004-09-27 00:00:00.000,Bangkok Thailand ATP World Tour,HARD,2,Taylor Dent,Justin Gimelstob,Taylor Dent,4-6; 6-4; 6-4,R32,125,2,8,74,101,51,74,9,27,10,14,15,60,101,3,5,53,95,37,53,19,42,3,8,15,56,95
2004-09-27 00:00:00.000,Bangkok Thailand ATP World Tour,HARD,2,Rogier Wassen,Igor Andreev,Rogier Wassen,6-1; 6-2,R32,48,6,4,24,41,21,24,9,17,1,2,8,30,41,3,3,26,44,12,26,7,18,1,6,7,19,44
2004-09-27 00:00:00.000,Bangkok Thailand ATP World Tour,HARD,2,Flavio Saretta,Prakash Amritraj,Flavio Saretta,6-3; 6-3,R32,71,3,3,33,58,23,33,14,25,2,4,9,37,58,1,2,33,55,18,33,10,22,4,9,9,28,55
2004-09-27 00:00:00.000,Bangkok Thailand ATP World Tour,HARD,2,Jiri Vanek,Danai Udomchoke,Jiri Vanek,3-6; 7-5; 6-2,R32,129,14,2,57,109,44,57,21,52,11,14,14,65,109,1,2,69,104,39,69,22,35,12,17,15,61,104
2004-09-27 00:00:00.000,Bangkok Thailand ATP World Tour,HARD,2,Marat Safin,Noam Okun,Marat Safin,6-2; 6-3,R32,63,4,2,33,45,28,33,6,12,0,0,8,34,45,1,4,28,59,17,28,13,31,4,8,9,30,59
2004-09-27 00:00:00.000,Bangkok Thailand ATP World Tour,HARD,2,Thomas Johansson,Feliciano Lopez,Thomas Johansson,6-1; 2-6; 7-6(5),R32,109,13,4,46,91,36,46,24,45,4,6,14,60,91,7,7,43,84,36,43,18,41,3,5,13,54,84
2004-09-27 00:00:00.000,Bangkok Thailand ATP World Tour,HARD,2,Adrian Garcia,Satoshi Iwabuchi,Adrian Garcia,7-6(5); 6-3,R32,65,5,2,43,65,36,43,14,22,1,1,11,50,65,1,1,47,61,32,47,11,14,2,3,10,43,61
2004-09-27 00:00:00.000,Bangkok Thailand ATP World Tour,HARD,2,Jeff Morrison,Michael Kohlmann,Jeff Morrison,6-3; 6-4,R32,64,9,4,29,53,25,29,16,24,0,0,10,41,53,3,1,35,64,25,35,14,29,2,4,9,39,64
2004-09-27 00:00:00.000,Bangkok Thailand ATP World Tour,HARD,2,Andy Roddick,Arvind Parmar,Andy Roddick,6-1; 6-4,R32,65,11,3,43,62,30,43,12,19,4,7,9,42,62,5,1,27,51,17,27,10,24,0,4,8,27,51
2004-09-27 00:00:00.000,Bangkok Thailand ATP World Tour,HARD,2,Roger Federer,Ivo Heuberger,Roger Federer,6-1; 6-3,R16,51,6,1,26,46,21,26,13,20,2,3,8,34,46,3,1,25,47,15,25,6,22,2,7,8,21,47
2004-09-27 00:00:00.000,Bangkok Thailand ATP World Tour,HARD,2,Robin Soderling,Paul Baccanello,Robin Soderling,6-1; 6-3,R16,64,7,1,32,58,21,32,15,26,0,1,8,36,58,5,4,30,52,19,30,5,22,3,8,8,24,52
2004-09-27 00:00:00.000,Bangkok Thailand ATP World Tour,HARD,2,Paradorn Srichaphan,Alex Bogomolov Jr.,Paradorn Srichaphan,6-0; 7-6(4),R16,77,1,1,29,55,22,29,17,26,0,1,9,39,55,2,2,38,60,22,38,7,22,1,5,9,29,60
2004-09-27 00:00:00.000,Bangkok Thailand ATP World Tour,HARD,2,Dennis van Scheppingen,Taylor Dent,Dennis van Scheppingen,6-0; 6-4,R16,47,0,2,25,40,20,25,12,15,0,4,8,32,40,8,2,20,40,15,20,7,20,0,0,8,22,40
2004-09-27 00:00:00.000,Bangkok Thailand ATP World Tour,HARD,2,Flavio Saretta,Rogier Wassen,Flavio Saretta,3-6; 6-1; 6-2,R16,92,8,3,39,75,32,39,18,36,3,4,12,50,75,3,4,40,74,29,40,14,34,1,5,12,43,74
2004-09-27 00:00:00.000,Bangkok Thailand ATP World Tour,HARD,2,Marat Safin,Jiri Vanek,Marat Safin,6-3; 6-4,R16,72,6,1,46,72,37,46,11,26,2,2,9,48,72,7,1,35,62,29,35,9,27,8,10,10,38,62
2004-09-27 00:00:00.000,Bangkok Thailand ATP World Tour,HARD,2,Thomas Johansson,Adrian Garcia,Thomas Johansson,6-3; 6-3,R16,69,4,1,32,56,28,32,11,24,1,1,9,39,56,1,2,28,48,16,28,12,20,1,4,9,28,48
2004-09-27 00:00:00.000,Bangkok Thailand ATP World Tour,HARD,2,Andy Roddick,Jeff Morrison,Andy Roddick,6-2; 6-7(4); 6-4,R16,112,12,3,59,92,47,59,21,33,1,1,15,68,92,13,5,64,106,49,64,20,42,6,9,15,69,106
2004-09-27 00:00:00.000,Bangkok Thailand ATP World Tour,HARD,2,Roger Federer,Robin Soderling,Roger Federer,7-6(3); 6-4,Q,82,14,3,39,71,33,39,12,32,2,4,11,45,71,3,5,46,74,29,46,12,28,1,4,11,41,74
2004-09-27 00:00:00.000,Bangkok Thailand ATP World Tour,HARD,2,Paradorn Srichaphan,Dennis van Scheppingen,Paradorn Srichaphan,6-2; 7-5,Q,69,12,4,32,57,24,32,16,25,3,4,10,40,57,1,6,34,59,24,34,9,25,3,7,10,33,59
2004-09-27 00:00:00.000,Bangkok Thailand ATP World Tour,HARD,2,Marat Safin,Flavio Saretta,Marat Safin,6-2; 6-1,Q,52,6,1,24,41,18,24,14,17,0,0,7,32,41,1,5,21,44,14,21,6,23,1,5,8,20,44
2004-09-27 00:00:00.000,Bangkok Thailand ATP World Tour,HARD,2,Andy Roddick,Thomas Johansson,Andy Roddick,6-3; 6-4,Q,51,21,4,35,55,31,35,11,20,0,0,10,42,55,10,1,27,43,23,27,8,16,2,4,9,31,43
2004-09-27 00:00:00.000,Bangkok Thailand ATP World Tour,HARD,2,Roger Federer,Paradorn Srichaphan,Roger Federer,7-5; 2-6; 6-3,S,115,7,4,47,80,38,47,16,33,4,7,15,54,80,5,2,61,101,41,61,20,40,8,11,14,61,101
2004-09-27 00:00:00.000,Bangkok Thailand ATP World Tour,HARD,2,Andy Roddick,Marat Safin,Andy Roddick,7-6(1); 6-7(0); 7-6(2),S,126,18,5,68,118,54,68,31,50,1,1,18,85,118,18,1,62,105,53,62,26,43,1,1,18,79,105
2004-09-27 00:00:00.000,Bangkok Thailand ATP World Tour,HARD,2,Roger Federer,Andy Roddick,Roger Federer,6-4; 6-0,F,57,11,2,32,52,23,32,13,20,2,2,8,36,52,8,2,40,57,23,40,6,17,4,8,8,29,57
2004-09-27 00:00:00.000,Palermo Italy ATP World Tour,CLAY,2,Nicolas Massu,David Sanchez,Nicolas Massu,6-3; 6-2,R32,86,1,1,27,48,24,27,5,21,0,2,8,29,48,0,0,39,62,18,39,10,23,4,10,9,28,62
2004-09-27 00:00:00.000,Palermo Italy ATP World Tour,CLAY,2,Potito Starace,Richard Gasquet,Potito Starace,7-6(6); 4-6; 6-1,R32,113,2,1,75,96,56,75,11,21,4,6,15,67,96,0,3,54,87,34,54,19,33,2,5,14,53,87
2004-09-27 00:00:00.000,Palermo Italy ATP World Tour,CLAY,2,Galo Blanco,Alessio Di Mauro,Galo Blanco,2-6; 6-2; 6-2,R32,118,2,1,41,68,27,41,16,27,2,5,12,43,68,4,0,49,89,29,49,16,40,8,13,12,45,89
2004-09-27 00:00:00.000,Palermo Italy ATP World Tour,CLAY,2,Filippo Volandri,Albert Montanes,Filippo Volandri,6-2; 6-3,R32,57,2,0,28,46,23,28,14,18,0,0,9,37,46,0,3,34,48,23,34,5,14,3,6,8,28,48
2004-09-27 00:00:00.000,Palermo Italy ATP World Tour,CLAY,2,Fernando Verdasco,Francesco Aldi,Fernando Verdasco,6-2; 4-6; 6-2,R32,114,4,6,49,79,33,49,19,30,1,3,13,52,79,1,0,44,82,27,44,20,38,10,15,13,47,82
2004-09-27 00:00:00.000,Palermo Italy ATP World Tour,CLAY,2,Juan Monaco,Philipp Kohlschreiber,Juan Monaco,3-6; 6-4 RET,R32,85,1,3,37,63,17,37,15,26,2,7,10,32,63,3,5,27,61,16,27,16,34,4,8,9,32,61
2004-09-27 00:00:00.000,Palermo Italy ATP World Tour,CLAY,2,Olivier Mutis,Olivier Patience,Olivier Mutis,6-4; 6-3,R32,95,3,1,39,57,25,39,9,18,5,8,9,34,57,2,1,31,62,18,31,11,31,7,13,10,29,62
2004-09-27 00:00:00.000,Palermo Italy ATP World Tour,CLAY,2,Rafael Nadal,Nicolas Almagro,Rafael Nadal,6-1; 7-5,R32,69,0,1,33,52,25,33,9,19,0,2,10,34,52,1,1,22,45,11,22,11,23,2,7,9,22,45
2004-09-27 00:00:00.000,Palermo Italy ATP World Tour,CLAY,2,David Ferrer,Alberto Martin,David Ferrer,2-6; 6-1; 6-4,R32,117,4,4,56,87,36,56,16,31,10,13,13,52,87,1,7,58,84,39,58,12,26,6,10,12,51,84
2004-09-27 00:00:00.000,Palermo Italy ATP World Tour,CLAY,2,Alex Calatrava,Daniel Elsner,Alex Calatrava,6-1; 6-0,R32,48,1,0,23,30,19,23,5,7,0,0,6,24,30,2,2,28,43,12,28,4,15,4,10,7,16,43
2004-09-27 00:00:00.000,Palermo Italy ATP World Tour,CLAY,2,Marc Lopez,Daniel Gimeno-Traver,Marc Lopez,6-2; 6-2,R32,67,0,0,30,39,26,30,7,9,0,0,8,33,39,3,3,25,50,14,25,11,25,4,8,8,25,50
2004-09-27 00:00:00.000,Palermo Italy ATP World Tour,CLAY,2,Nikolay Davydenko,Victor Hanescu,Nikolay Davydenko,6-2; 7-5,R32,79,2,2,29,51,23,29,14,22,1,2,10,37,51,1,0,37,54,21,37,10,17,2,6,10,31,54
2004-09-27 00:00:00.000,Palermo Italy ATP World Tour,CLAY,2,Tomas Berdych,Oscar Hernandez,Tomas Berdych,6-7(5); 6-3; 6-3,R32,168,7,2,65,111,46,65,20,46,6,9,15,66,111,2,6,83,142,51,83,24,59,16,22,15,75,142
2004-09-27 00:00:00.000,Palermo Italy ATP World Tour,CLAY,2,Jose Acasuso,Alejandro Falla,Jose Acasuso,6-3; 6-1,R32,56,4,2,23,39,21,23,11,16,0,0,8,32,39,1,0,34,51,19,34,6,17,1,5,8,25,51
2004-09-27 00:00:00.000,Palermo Italy ATP World Tour,CLAY,2,Andreas Seppi,Arnaud Di Pasquale,Andreas Seppi,6-7(2); 6-2; 6-4,R32,141,1,2,63,99,42,63,16,36,6,10,15,58,99,1,3,58,87,33,58,13,29,4,11,15,46,87
2004-09-27 00:00:00.000,Palermo Italy ATP World Tour,CLAY,2,Kristof Vliegen,Mariano Puerta,Kristof Vliegen,6-1; 6-2,R32,37,7,0,22,36,19,22,13,14,0,0,8,32,36,1,4,21,35,13,21,4,14,0,4,7,17,35
2004-09-27 00:00:00.000,Palermo Italy ATP World Tour,CLAY,2,Nicolas Massu,Potito Starace,Nicolas Massu,4-1 RET,R16,18,1,0,5,9,5,5,3,4,0,0,2,8,9,0,2,13,20,6,13,2,7,1,3,3,8,20
2004-09-27 00:00:00.000,Palermo Italy ATP World Tour,CLAY,2,Filippo Volandri,Galo Blanco,Filippo Volandri,6-2; 6-1,R16,57,1,1,31,41,24,31,4,10,2,3,7,28,41,0,1,27,49,15,27,4,22,3,9,8,19,49
2004-09-27 00:00:00.000,Palermo Italy ATP World Tour,CLAY,2,Juan Monaco,Fernando Verdasco,Juan Monaco,6-4; 5-7; 6-3,R16,140,3,0,64,88,44,64,17,24,1,3,16,61,88,5,5,52,98,37,52,21,46,8,11,15,58,98
2004-09-27 00:00:00.000,Palermo Italy ATP World Tour,CLAY,2,Olivier Mutis,Rafael Nadal,Olivier Mutis,6-3; 6-3,R16,86,1,1,35,63,26,35,17,28,7,7,9,43,63,0,0,51,61,29,51,5,10,2,5,9,34,61
2004-09-27 00:00:00.000,Palermo Italy ATP World Tour,CLAY,2,David Ferrer,Alex Calatrava,David Ferrer,3-6; 7-6(2); 6-2,R16,148,2,5,58,103,45,58,22,45,9,11,14,67,103,1,0,52,92,36,52,22,40,2,5,15,58,92
2004-09-27 00:00:00.000,Palermo Italy ATP World Tour,CLAY,2,Nikolay Davydenko,Marc Lopez,Nikolay Davydenko,6-1; 6-4,R16,90,3,3,37,59,24,37,12,22,5,7,9,36,59,0,1,36,55,20,36,6,19,4,9,8,26,55
2004-09-27 00:00:00.000,Palermo Italy ATP World Tour,CLAY,2,Tomas Berdych,Jose Acasuso,Tomas Berdych,4-6; 7-5; 6-4,R16,137,4,4,61,94,50,61,12,33,4,6,16,62,94,11,3,68,114,45,68,26,46,13,16,16,71,114
2004-09-27 00:00:00.000,Palermo Italy ATP World Tour,CLAY,2,Andreas Seppi,Kristof Vliegen,Andreas Seppi,6-4; 3-6; 4-1 RET,R16,110,4,4,46,75,33,46,12,29,4,8,12,45,75,6,2,56,84,34,56,11,28,6,11,12,45,84
2004-09-27 00:00:00.000,Palermo Italy ATP World Tour,CLAY,2,Filippo Volandri,Nicolas Massu,Filippo Volandri,6-3; 3-6; 6-4,Q,143,0,1,78,103,50,78,9,25,6,11,14,59,103,2,3,40,83,26,40,19,43,4,10,14,45,83
2004-09-27 00:00:00.000,Palermo Italy ATP World Tour,CLAY,2,Juan Monaco,Olivier Mutis,Juan Monaco,6-3; 6-2,Q,71,3,1,38,56,27,38,12,18,5,6,9,39,56,0,1,33,62,15,33,17,29,6,10,8,32,62
2004-09-27 00:00:00.000,Palermo Italy ATP World Tour,CLAY,2,David Ferrer,Nikolay Davydenko,David Ferrer,6-2; 2-6; 6-4,Q,119,1,5,50,89,26,50,20,39,9,15,13,46,89,2,0,57,81,32,57,8,24,9,16,13,40,81
2004-09-27 00:00:00.000,Palermo Italy ATP World Tour,CLAY,2,Tomas Berdych,Andreas Seppi,Tomas Berdych,6-2; 6-4,Q,63,4,1,22,43,20,22,12,21,0,1,9,32,43,1,3,31,54,20,31,9,23,2,6,9,29,54
2004-09-27 00:00:00.000,Palermo Italy ATP World Tour,CLAY,2,Filippo Volandri,Juan Monaco,Filippo Volandri,6-1; 6-4,S,64,0,2,34,53,24,34,12,19,2,3,9,36,53,2,0,26,41,15,26,6,15,1,5,8,21,41
2004-09-27 00:00:00.000,Palermo Italy ATP World Tour,CLAY,2,Tomas Berdych,David Ferrer,Tomas Berdych,7-5; 6-4,S,101,3,1,52,75,35,52,10,23,4,6,11,45,75,1,2,49,80,26,49,16,31,8,12,11,42,80
2004-09-27 00:00:00.000,Palermo Italy ATP World Tour,CLAY,2,Tomas Berdych,Filippo Volandri,Tomas Berdych,6-3; 6-3,F,56,6,2,31,45,27,31,9,14,0,0,9,36,45,0,2,25,44,17,25,10,19,0,3,9,27,44
2004-09-27 00:00:00.000,Shanghai China ATP World Tour,HARD,2,Edouard Roger-Vasselin,Nathan Healey,Edouard Roger-Vasselin,4-6; 7-6(7); 6-4,R32,124,6,1,57,86,43,57,22,29,0,1,16,65,86,13,10,45,106,41,45,32,61,1,2,16,73,106
2004-09-27 00:00:00.000,Shanghai China ATP World Tour,HARD,2,Lars Burgsmuller,Shao-Xuan Zeng,Lars Burgsmuller,6-3; 6-4,R32,60,6,4,35,58,28,35,12,23,0,1,10,40,58,2,2,28,52,20,28,12,24,1,4,9,32,52
2004-09-27 00:00:00.000,Shanghai China ATP World Tour,HARD,2,Davide Sanguinetti,Bohdan Ulihrach,Davide Sanguinetti,6-3; 6-3,R32,52,6,1,29,50,23,29,14,21,0,0,9,37,50,5,10,24,53,19,24,11,29,2,5,9,30,53
2004-09-27 00:00:00.000,Shanghai China ATP World Tour,HARD,2,Jarkko Nieminen,Bjorn Phau,Jarkko Nieminen,3-6; 6-3; 6-4,R32,96,4,5,56,98,40,56,18,42,7,10,14,58,98,7,2,36,75,29,36,17,39,1,5,14,46,75
2004-09-27 00:00:00.000,Shanghai China ATP World Tour,HARD,2,Glenn Weiner,Mark Philippoussis,Glenn Weiner,3-6; 6-4; 6-4,R32,111,17,3,58,86,46,58,12,28,5,8,15,58,86,10,2,40,88,32,40,23,48,6,9,14,55,88
2004-09-27 00:00:00.000,Shanghai China ATP World Tour,HARD,2,Gilles Muller,Jean-Rene Lisnard,Gilles Muller,3-6; 6-4; 6-4,R32,121,11,1,66,105,47,66,18,39,8,10,15,65,105,7,5,37,81,27,37,28,44,3,5,14,55,81
2004-09-27 00:00:00.000,Shanghai China ATP World Tour,HARD,2,Kenneth Carlsen,Jan Hernych,Kenneth Carlsen,7-5; 6-1,R32,76,4,3,36,57,26,36,11,21,8,9,9,37,57,3,1,44,66,25,44,9,22,4,9,10,34,66
2004-09-27 00:00:00.000,Shanghai China ATP World Tour,HARD,2,Wayne Arthurs,Hyung-Taik Lee,Wayne Arthurs,W/O,R32,0,0,0,0,0,0,0,0,0,0,0,0,0,0,0,0,0,0,0,0,0,0,0,0,0,0,0
2004-09-27 00:00:00.000,Shanghai China ATP World Tour,HARD,2,Ricardo Mello,Alexander Peya,Ricardo Mello,6-4; 6-3,R32,69,2,1,30,51,23,30,12,21,3,5,9,35,51,3,6,50,78,32,50,9,28,4,9,10,41,78
2004-09-27 00:00:00.000,Shanghai China ATP World Tour,HARD,2,Janko Tipsarevic,John van Lottum,Janko Tipsarevic,6-1; 6-4,R32,60,9,2,34,46,29,34,5,12,2,2,8,34,46,7,4,39,66,23,39,12,27,7,11,9,35,66
2004-09-27 00:00:00.000,Shanghai China ATP World Tour,HARD,2,Kristian Pless,Christophe Rochus,Kristian Pless,4-6; 7-5; 6-0,R32,94,17,7,61,93,48,61,12,32,8,10,14,60,93,1,4,53,84,35,53,13,31,8,13,14,48,84
2004-09-27 00:00:00.000,Shanghai China ATP World Tour,HARD,2,Guillermo Canas,Guillermo Garcia-Lopez,Guillermo Canas,7-6(1); 6-3,R32,88,8,3,34,68,27,34,22,34,0,1,11,49,68,5,3,37,64,26,37,13,27,0,2,10,39,64
2004-09-27 00:00:00.000,Shanghai China ATP World Tour,HARD,2,Jan-Michael Gambill,Ivo Klec,Jan-Michael Gambill,6-4; 6-3,R32,77,11,1,35,53,26,35,12,18,1,2,10,38,53,1,7,41,74,26,41,15,33,6,9,9,41,74
2004-09-27 00:00:00.000,Shanghai China ATP World Tour,HARD,2,Ben-Qiang Zhu,Tomas Zib,Ben-Qiang Zhu,1-6; 6-4; 6-4,R32,106,7,3,53,86,34,53,20,33,5,8,14,54,86,5,3,48,79,37,48,14,31,2,4,13,51,79
2004-09-27 00:00:00.000,Shanghai China ATP World Tour,HARD,2,Melle Van Gemerden,Jan Vacek,Melle Van Gemerden,6-4; 6-2,R32,60,5,4,23,43,21,23,15,20,0,0,9,36,43,7,4,29,58,22,29,12,29,2,5,9,34,58
2004-09-27 00:00:00.000,Shanghai China ATP World Tour,HARD,2,Jiri Novak,Yen-Hsun Lu,Jiri Novak,6-2; 6-2,R32,52,6,1,32,55,24,32,13,23,5,5,8,37,55,0,1,25,45,13,25,10,20,1,5,8,23,45
2004-09-27 00:00:00.000,Shanghai China ATP World Tour,HARD,2,Lars Burgsmuller,Edouard Roger-Vasselin,Lars Burgsmuller,6-3; 6-2,R16,55,5,4,26,43,24,26,6,17,0,2,9,30,43,2,1,39,49,21,39,2,10,3,8,8,23,49
2004-09-27 00:00:00.000,Shanghai China ATP World Tour,HARD,2,Davide Sanguinetti,Jarkko Nieminen,Davide Sanguinetti,6-4; 7-5,R16,96,5,2,41,83,25,41,24,42,5,8,11,49,83,2,4,39,84,23,39,20,45,12,17,11,43,84
2004-09-27 00:00:00.000,Shanghai China ATP World Tour,HARD,2,Gilles Muller,Glenn Weiner,Gilles Muller,5-7; 6-3; 7-5,R16,118,13,4,52,91,42,52,24,39,2,4,17,66,91,17,8,53,93,42,53,19,40,3,6,16,61,93
2004-09-27 00:00:00.000,Shanghai China ATP World Tour,HARD,2,Kenneth Carlsen,Wayne Arthurs,Kenneth Carlsen,1-6; 6-3; 7-6(4),R16,98,5,2,53,77,42,53,16,24,1,3,14,58,77,15,5,48,89,41,48,23,41,3,4,14,64,89
2004-09-27 00:00:00.000,Shanghai China ATP World Tour,HARD,2,Ricardo Mello,Janko Tipsarevic,Ricardo Mello,1-6; 7-6(3); 6-4,R16,123,8,2,56,95,39,56,20,39,5,8,14,59,95,6,10,51,98,36,51,26,47,1,3,15,62,98
2004-09-27 00:00:00.000,Shanghai China ATP World Tour,HARD,2,Guillermo Canas,Kristian Pless,Guillermo Canas,6-2; 4-6; 6-4,R16,101,17,1,41,78,36,41,21,37,0,1,14,57,78,7,6,64,105,37,64,23,41,4,7,14,60,105
2004-09-27 00:00:00.000,Shanghai China ATP World Tour,HARD,2,Jan-Michael Gambill,Ben-Qiang Zhu,Jan-Michael Gambill,6-0; 7-6(5),R16,71,14,5,36,51,34,36,7,15,0,0,9,41,51,4,3,39,72,29,39,13,33,5,8,9,42,72
2004-09-27 00:00:00.000,Shanghai China ATP World Tour,HARD,2,Jiri Novak,Melle Van Gemerden,Jiri Novak,6-4; 6-7(5); 6-1,R16,112,6,2,61,91,46,61,21,30,3,3,15,67,91,3,1,59,93,44,59,16,34,3,6,14,60,93
2004-09-27 00:00:00.000,Shanghai China ATP World Tour,HARD,2,Lars Burgsmuller,Davide Sanguinetti,Lars Burgsmuller,6-3; 6-7(5); 7-6(6),Q,128,6,1,75,109,63,75,18,34,1,1,17,81,109,7,0,75,110,58,75,18,35,0,1,16,76,110
2004-09-27 00:00:00.000,Shanghai China ATP World Tour,HARD,2,Kenneth Carlsen,Gilles Muller,Kenneth Carlsen,7-6(5); 6-1,Q,79,8,1,50,73,38,50,12,23,4,5,10,50,73,3,3,36,52,26,36,7,16,1,4,9,33,52
2004-09-27 00:00:00.000,Shanghai China ATP World Tour,HARD,2,Guillermo Canas,Ricardo Mello,Guillermo Canas,6-3; 6-4,Q,100,2,3,39,57,34,39,8,18,1,1,10,42,57,1,3,38,72,24,38,19,34,10,12,9,43,72
2004-09-27 00:00:00.000,Shanghai China ATP World Tour,HARD,2,Jiri Novak,Jan-Michael Gambill,Jiri Novak,6-3; 6-3,Q,77,3,4,33,53,26,33,10,20,1,2,9,36,53,7,3,32,73,20,32,19,41,6,10,9,39,73
2004-09-27 00:00:00.000,Shanghai China ATP World Tour,HARD,2,Lars Burgsmuller,Kenneth Carlsen,Lars Burgsmuller,7-5; 6-3,S,95,3,3,45,72,35,45,14,27,2,2,11,49,72,5,5,44,75,28,44,16,31,8,10,10,44,75
2004-09-27 00:00:00.000,Shanghai China ATP World Tour,HARD,2,Guillermo Canas,Jiri Novak,Guillermo Canas,6-1; 6-2,S,54,9,1,21,39,19,21,13,18,0,0,8,32,39,2,1,29,49,21,29,4,20,6,10,7,25,49
2004-09-27 00:00:00.000,Shanghai China ATP World Tour,HARD,2,Guillermo Canas,Lars Burgsmuller,Guillermo Canas,6-1; 6-0,F,57,6,3,22,40,18,22,11,18,1,1,6,29,40,0,4,24,43,10,24,5,19,2,8,7,15,43
2004-10-04 00:00:00.000,Lyon France ATP World Tour,HARD,2,Agustin Calleri,Nicolas Massu,Agustin Calleri,6-3; 6-4,R32,70,8,1,34,51,27,34,9,17,2,3,9,36,51,8,6,32,75,23,32,18,43,11,15,10,41,75
2004-10-04 00:00:00.000,Lyon France ATP World Tour,HARD,2,Mikhail Youzhny,Luis Horna,Mikhail Youzhny,6-4; 7-6(1),R32,94,8,2,42,77,34,42,21,35,4,4,11,55,77,7,1,40,62,28,40,15,22,1,2,11,43,62
2004-10-04 00:00:00.000,Lyon France ATP World Tour,HARD,2,Radek Stepanek,Paul-Henri Mathieu,Radek Stepanek,4-6; 7-5; 6-2,R32,121,9,2,53,81,40,53,19,28,1,2,15,59,81,7,1,55,86,38,55,17,31,3,6,15,55,86
2004-10-04 00:00:00.000,Lyon France ATP World Tour,HARD,2,Xavier Malisse,Dominik Hrbaty,Xavier Malisse,6-4; 7-6(4),R32,83,11,1,39,61,32,39,13,22,1,2,11,45,61,3,3,42,70,32,42,13,28,3,5,11,45,70
2004-10-04 00:00:00.000,Lyon France ATP World Tour,HARD,2,Juan Carlos Ferrero,Sargis Sargsian,Juan Carlos Ferrero,6-3; 7-6(4),R32,85,3,0,49,70,35,49,15,21,1,1,11,50,70,13,2,38,61,26,38,16,23,1,2,10,42,61
2004-10-04 00:00:00.000,Lyon France ATP World Tour,HARD,2,David Ferrer,Raemon Sluiter,David Ferrer,6-3; 6-4,R32,79,3,5,39,66,30,39,12,27,3,4,10,42,66,6,2,43,66,28,43,10,23,7,10,9,38,66
2004-10-04 00:00:00.000,Lyon France ATP World Tour,HARD,2,Jonas Bjorkman,Albert Costa,Jonas Bjorkman,6-7(5); 7-6(6); 6-4,R32,162,12,3,67,114,51,67,24,47,2,6,17,75,114,14,6,64,115,45,64,26,51,6,11,17,71,115
2004-10-04 00:00:00.000,Lyon France ATP World Tour,HARD,2,Max Mirnyi,Mario Ancic,Max Mirnyi,6-3; 3-1 RET,R32,57,6,1,22,37,19,22,9,15,3,3,6,28,37,2,3,24,44,17,24,7,20,1,4,7,24,44
2004-10-04 00:00:00.000,Lyon France ATP World Tour,HARD,2,Robin Soderling,Tommy Robredo,Robin Soderling,6-1; 6-4,R32,55,4,1,33,50,25,33,12,17,3,3,9,37,50,1,3,28,43,19,28,6,15,4,7,8,25,43
2004-10-04 00:00:00.000,Lyon France ATP World Tour,HARD,2,Feliciano Lopez,Nikolay Davydenko,Feliciano Lopez,6-3; 6-7(2); 6-3,R32,117,9,5,58,118,49,58,28,60,9,10,16,77,118,6,3,60,86,47,60,13,26,1,4,14,60,86
2004-10-04 00:00:00.000,Lyon France ATP World Tour,HARD,2,Julien Benneteau,Rafael Nadal,Julien Benneteau,6-3; 6-0,R32,65,1,1,21,38,15,21,14,17,0,0,7,29,38,1,3,40,55,22,40,3,15,7,12,8,25,55
2004-10-04 00:00:00.000,Lyon France ATP World Tour,HARD,2,Joachim Johansson,Juan Monaco,Joachim Johansson,6-4; 6-3,R32,73,9,5,41,60,34,41,9,19,3,3,10,43,60,2,2,40,63,25,40,13,23,5,7,9,38,63
2004-10-04 00:00:00.000,Lyon France ATP World Tour,HARD,2,Vincent Spadea,Robby Ginepri,Vincent Spadea,6-4; 6-3,R32,61,6,0,39,49,30,39,6,10,2,3,9,36,49,3,1,36,57,22,36,9,21,3,7,10,31,57
2004-10-04 00:00:00.000,Lyon France ATP World Tour,HARD,2,Ivan Ljubicic,Arnaud Clement,Ivan Ljubicic,6-4; 7-6(1),R32,101,21,1,49,62,40,49,9,13,3,3,11,49,62,1,0,44,78,27,44,21,34,3,4,11,48,78
2004-10-04 00:00:00.000,Lyon France ATP World Tour,HARD,2,Jurgen Melzer,Michael Llodra,Jurgen Melzer,7-6(2); 6-4,R32,96,7,2,45,75,34,45,18,30,4,5,11,52,75,4,1,57,75,38,57,8,18,4,6,11,46,75
2004-10-04 00:00:00.000,Lyon France ATP World Tour,HARD,2,Hicham Arazi,Rainer Schuettler,Hicham Arazi,6-4; 1-6; 6-3,R32,120,5,0,47,80,33,47,15,33,6,10,13,48,80,4,4,56,97,32,56,23,41,3,7,13,55,97
2004-10-04 00:00:00.000,Lyon France ATP World Tour,HARD,2,Mikhail Youzhny,Agustin Calleri,Mikhail Youzhny,6-3; 6-7(2); 7-6(4),R16,150,6,3,66,118,51,66,25,52,6,9,17,76,118,6,3,66,115,48,66,21,49,1,5,16,69,115
2004-10-04 00:00:00.000,Lyon France ATP World Tour,HARD,2,Xavier Malisse,Radek Stepanek,Xavier Malisse,4-6; 7-6(4); 6-0,R16,131,12,2,75,107,54,75,14,32,9,11,14,68,107,8,8,61,90,43,61,9,29,5,9,14,52,90
2004-10-04 00:00:00.000,Lyon France ATP World Tour,HARD,2,David Ferrer,Juan Carlos Ferrero,David Ferrer,3-6; 7-5; 6-3,R16,126,6,2,67,95,49,67,9,28,7,11,15,58,95,2,1,73,110,44,73,18,37,5,10,15,62,110
2004-10-04 00:00:00.000,Lyon France ATP World Tour,HARD,2,Jonas Bjorkman,Max Mirnyi,Jonas Bjorkman,6-7(3); 7-6(5); 6-4,R16,164,4,1,61,108,46,61,31,47,3,4,17,77,108,21,6,83,123,60,83,24,40,8,10,17,84,123
2004-10-04 00:00:00.000,Lyon France ATP World Tour,HARD,2,Robin Soderling,Feliciano Lopez,Robin Soderling,4-6; 6-3; 6-3,R16,90,11,1,50,79,39,50,15,29,1,3,14,54,79,9,3,47,82,36,47,12,35,1,5,14,48,82
2004-10-04 00:00:00.000,Lyon France ATP World Tour,HARD,2,Joachim Johansson,Julien Benneteau,Joachim Johansson,6-3; 6-4,R16,82,15,2,44,60,37,44,7,16,2,2,10,44,60,5,4,50,71,31,50,9,21,9,11,9,40,71
2004-10-04 00:00:00.000,Lyon France ATP World Tour,HARD,2,Vincent Spadea,Ivan Ljubicic,Vincent Spadea,6-4; 7-6(4),R16,89,1,0,48,66,34,48,12,18,0,1,11,46,66,6,1,38,61,28,38,13,23,1,3,11,41,61
2004-10-04 00:00:00.000,Lyon France ATP World Tour,HARD,2,Jurgen Melzer,Hicham Arazi,Jurgen Melzer,4-6; 7-6(4); 6-1,R16,125,16,9,62,88,49,62,8,26,2,5,14,57,88,4,3,67,112,42,67,22,45,13,18,15,64,112
2004-10-04 00:00:00.000,Lyon France ATP World Tour,HARD,2,Xavier Malisse,Mikhail Youzhny,Xavier Malisse,6-3; 6-4,Q,75,13,1,37,60,31,37,12,23,3,3,10,43,60,1,2,35,59,21,35,15,24,5,7,9,36,59
2004-10-04 00:00:00.000,Lyon France ATP World Tour,HARD,2,David Ferrer,Jonas Bjorkman,David Ferrer,6-2; 6-4,Q,75,7,1,30,51,26,30,11,21,1,1,9,37,51,3,1,33,56,18,33,13,23,0,3,9,31,56
2004-10-04 00:00:00.000,Lyon France ATP World Tour,HARD,2,Robin Soderling,Joachim Johansson,Robin Soderling,6-3; 6-4,Q,58,9,0,37,51,31,37,10,14,1,1,10,41,51,10,1,32,46,23,32,8,14,0,2,9,31,46
2004-10-04 00:00:00.000,Lyon France ATP World Tour,HARD,2,Vincent Spadea,Jurgen Melzer,Vincent Spadea,1-6; 6-1; 7-6(2),Q,95,6,0,52,79,38,52,13,27,0,3,13,51,79,6,4,43,73,33,43,14,30,0,3,13,47,73
2004-10-04 00:00:00.000,Lyon France ATP World Tour,HARD,2,Xavier Malisse,David Ferrer,Xavier Malisse,6-4; 6-2,S,79,7,1,30,49,23,30,13,19,3,4,9,36,49,4,2,39,69,25,39,12,30,10,14,9,37,69
2004-10-04 00:00:00.000,Lyon France ATP World Tour,HARD,2,Robin Soderling,Vincent Spadea,Robin Soderling,6-2; 6-4,S,78,8,5,30,60,26,30,14,30,4,5,9,40,60,3,0,42,64,23,42,10,22,9,13,9,33,64
2004-10-04 00:00:00.000,Lyon France ATP World Tour,HARD,2,Robin Soderling,Xavier Malisse,Robin Soderling,6-2; 3-6; 6-4,F,88,5,2,49,69,36,49,11,20,1,4,14,47,69,6,1,44,69,33,44,10,25,2,6,13,43,69
2004-10-04 00:00:00.000,Tokyo Japan ATP World Tour,HARD,2,Lleyton Hewitt,N/A Bye,Lleyton Hewitt,,R64,0,0,0,0,0,0,0,0,0,0,0,0,0,0,0,0,0,0,0,0,0,0,0,0,0,0,0
2004-10-04 00:00:00.000,Tokyo Japan ATP World Tour,HARD,2,Gouichi Motomura,Glenn Weiner,Gouichi Motomura,6-4; 6-3,R64,77,2,4,30,62,22,30,17,32,2,4,9,39,62,4,3,31,55,16,31,10,24,1,6,10,26,55
2004-10-04 00:00:00.000,Tokyo Japan ATP World Tour,HARD,2,Takao Suzuki,Adrian Garcia,Takao Suzuki,7-6(6); 7-6(4),R64,102,18,3,51,75,44,51,15,24,3,4,12,59,75,5,3,46,77,35,46,19,31,0,1,12,54,77
2004-10-04 00:00:00.000,Tokyo Japan ATP World Tour,HARD,2,Jan Hernych,N/A Bye,Jan Hernych,,R64,0,0,0,0,0,0,0,0,0,0,0,0,0,0,0,0,0,0,0,0,0,0,0,0,0,0,0
2004-10-04 00:00:00.000,Tokyo Japan ATP World Tour,HARD,2,Cyril Saulnier,N/A Bye,Cyril Saulnier,,R64,0,0,0,0,0,0,0,0,0,0,0,0,0,0,0,0,0,0,0,0,0,0,0,0,0,0,0
2004-10-04 00:00:00.000,Tokyo Japan ATP World Tour,HARD,2,Nicolas Thomann,Kristian Pless,Nicolas Thomann,7-6(2); 7-6(0),R64,87,12,0,45,72,39,45,19,27,1,1,12,58,72,5,1,40,78,28,40,27,38,5,5,12,55,78
2004-10-04 00:00:00.000,Tokyo Japan ATP World Tour,HARD,2,Justin Gimelstob,Christophe Rochus,Justin Gimelstob,6-6(2) RET,R64,55,3,3,16,34,13,16,10,18,0,1,6,23,34,0,2,24,42,15,24,10,18,1,2,6,25,42
2004-10-04 00:00:00.000,Tokyo Japan ATP World Tour,HARD,2,Thomas Johansson,N/A Bye,Thomas Johansson,,R64,0,0,0,0,0,0,0,0,0,0,0,0,0,0,0,0,0,0,0,0,0,0,0,0,0,0,0
2004-10-04 00:00:00.000,Tokyo Japan ATP World Tour,HARD,2,Paradorn Srichaphan,N/A Bye,Paradorn Srichaphan,,R64,0,0,0,0,0,0,0,0,0,0,0,0,0,0,0,0,0,0,0,0,0,0,0,0,0,0,0
2004-10-04 00:00:00.000,Tokyo Japan ATP World Tour,HARD,2,Harel Levy,Yen-Hsun Lu,Harel Levy,7-6(1); 7-6(1),R64,91,6,0,53,79,40,53,15,26,6,8,12,55,79,5,2,49,77,37,49,12,28,3,5,12,49,77
2004-10-04 00:00:00.000,Tokyo Japan ATP World Tour,HARD,2,Marco Chiudinelli,Alexander Peya,Marco Chiudinelli,4-6; 6-3; 6-4,R64,144,1,5,52,85,36,52,18,33,0,3,14,54,85,5,6,50,89,37,50,16,39,2,7,15,53,89
2004-10-04 00:00:00.000,Tokyo Japan ATP World Tour,HARD,2,Dennis van Scheppingen,N/A Bye,Dennis van Scheppingen,,R64,0,0,0,0,0,0,0,0,0,0,0,0,0,0,0,0,0,0,0,0,0,0,0,0,0,0,0
2004-10-04 00:00:00.000,Tokyo Japan ATP World Tour,HARD,2,Ricardo Mello,N/A Bye,Ricardo Mello,,R64,0,0,0,0,0,0,0,0,0,0,0,0,0,0,0,0,0,0,0,0,0,0,0,0,0,0,0
2004-10-04 00:00:00.000,Tokyo Japan ATP World Tour,HARD,2,Flavio Saretta,Jan Vacek,Flavio Saretta,6-3; 6-4,R64,62,8,3,34,51,27,34,11,17,0,1,10,38,51,4,4,30,58,23,30,11,28,1,4,9,34,58
2004-10-04 00:00:00.000,Tokyo Japan ATP World Tour,HARD,2,Guillermo Garcia-Lopez,Lars Burgsmuller,Guillermo Garcia-Lopez,6-4; 2-6; 6-3,R64,106,6,4,46,75,34,46,16,29,0,3,14,50,75,7,1,42,77,32,42,15,35,3,6,13,47,77
2004-10-04 00:00:00.000,Tokyo Japan ATP World Tour,HARD,2,Jiri Novak,N/A Bye,Jiri Novak,,R64,0,0,0,0,0,0,0,0,0,0,0,0,0,0,0,0,0,0,0,0,0,0,0,0,0,0,0
2004-10-04 00:00:00.000,Tokyo Japan ATP World Tour,HARD,2,Guillermo Canas,N/A Bye,Guillermo Canas,,R64,0,0,0,0,0,0,0,0,0,0,0,0,0,0,0,0,0,0,0,0,0,0,0,0,0,0,0
2004-10-04 00:00:00.000,Tokyo Japan ATP World Tour,HARD,2,Michael Kohlmann,Kenneth Carlsen,Michael Kohlmann,7-5; 6-2,R64,71,2,2,34,51,30,34,8,17,0,1,10,38,51,7,3,34,58,26,34,8,24,1,5,10,34,58
2004-10-04 00:00:00.000,Tokyo Japan ATP World Tour,HARD,2,Bohdan Ulihrach,Noam Okun,Bohdan Ulihrach,6-4; 6-1,R64,75,2,1,37,55,28,37,12,18,3,3,9,40,55,6,4,46,70,27,46,10,24,11,14,8,37,70
2004-10-04 00:00:00.000,Tokyo Japan ATP World Tour,HARD,2,Jarkko Nieminen,N/A Bye,Jarkko Nieminen,,R64,0,0,0,0,0,0,0,0,0,0,0,0,0,0,0,0,0,0,0,0,0,0,0,0,0,0,0
2004-10-04 00:00:00.000,Tokyo Japan ATP World Tour,HARD,2,Jan-Michael Gambill,N/A Bye,Jan-Michael Gambill,,R64,0,0,0,0,0,0,0,0,0,0,0,0,0,0,0,0,0,0,0,0,0,0,0,0,0,0,0
2004-10-04 00:00:00.000,Tokyo Japan ATP World Tour,HARD,2,Takahiro Terachi,Satoshi Iwabuchi,Takahiro Terachi,6-1; 6-3,R64,57,1,1,30,50,23,30,10,20,3,4,8,33,50,1,1,40,50,19,40,3,10,4,9,8,22,50
2004-10-04 00:00:00.000,Tokyo Japan ATP World Tour,HARD,2,Bjorn Phau,Tasuku Iwami,Bjorn Phau,6-4; 6-1,R64,61,5,3,24,54,18,24,17,30,2,4,9,35,54,2,1,29,42,12,29,5,13,1,6,8,17,42
2004-10-04 00:00:00.000,Tokyo Japan ATP World Tour,HARD,2,Andrei Pavel,N/A Bye,Andrei Pavel,,R64,0,0,0,0,0,0,0,0,0,0,0,0,0,0,0,0,0,0,0,0,0,0,0,0,0,0,0
2004-10-04 00:00:00.000,Tokyo Japan ATP World Tour,HARD,2,Taylor Dent,N/A Bye,Taylor Dent,,R64,0,0,0,0,0,0,0,0,0,0,0,0,0,0,0,0,0,0,0,0,0,0,0,0,0,0,0
2004-10-04 00:00:00.000,Tokyo Japan ATP World Tour,HARD,2,Tomas Zib,Mark Philippoussis,Tomas Zib,6-3; 6-4,R64,80,6,1,30,48,27,30,13,18,0,0,10,40,48,11,7,38,74,28,38,15,36,7,9,9,43,74
2004-10-04 00:00:00.000,Tokyo Japan ATP World Tour,HARD,2,Wayne Arthurs,Jean-Rene Lisnard,Wayne Arthurs,6-4; 7-5,R64,77,15,4,42,59,37,42,8,17,3,4,11,45,59,5,2,30,64,22,30,19,34,1,4,11,41,64
2004-10-04 00:00:00.000,Tokyo Japan ATP World Tour,HARD,2,Hyung-Taik Lee,N/A Bye,Hyung-Taik Lee,,R64,0,0,0,0,0,0,0,0,0,0,0,0,0,0,0,0,0,0,0,0,0,0,0,0,0,0,0
2004-10-04 00:00:00.000,Tokyo Japan ATP World Tour,HARD,2,Gilles Muller,N/A Bye,Gilles Muller,,R64,0,0,0,0,0,0,0,0,0,0,0,0,0,0,0,0,0,0,0,0,0,0,0,0,0,0,0
2004-10-04 00:00:00.000,Tokyo Japan ATP World Tour,HARD,2,Alex Bogomolov Jr.,Janko Tipsarevic,Alex Bogomolov Jr.,6-3; 3-6; 7-6(2),R64,131,6,3,62,95,49,62,17,33,5,7,15,66,95,8,4,57,100,43,57,19,43,4,6,15,62,100
2004-10-04 00:00:00.000,Tokyo Japan ATP World Tour,HARD,2,Jimmy Wang,Jeff Morrison,Jimmy Wang,6-3; 7-6(1),R64,88,4,1,46,69,32,46,16,23,5,7,11,48,69,4,3,37,75,23,37,18,38,3,6,10,41,75
2004-10-04 00:00:00.000,Tokyo Japan ATP World Tour,HARD,2,David Nalbandian,N/A Bye,David Nalbandian,,R64,0,0,0,0,0,0,0,0,0,0,0,0,0,0,0,0,0,0,0,0,0,0,0,0,0,0,0
2004-10-04 00:00:00.000,Tokyo Japan ATP World Tour,HARD,2,Lleyton Hewitt,Gouichi Motomura,Lleyton Hewitt,6-0; 3-6; 6-1,R32,95,10,5,28,64,20,28,21,36,0,2,11,41,64,1,4,32,73,18,32,17,41,5,11,11,35,73
2004-10-04 00:00:00.000,Tokyo Japan ATP World Tour,HARD,2,Takao Suzuki,Jan Hernych,Takao Suzuki,7-6(4); 3-6; 7-5,R32,145,5,6,67,116,47,67,20,49,4,10,17,67,116,2,4,59,90,41,59,13,31,3,8,16,54,90
2004-10-04 00:00:00.000,Tokyo Japan ATP World Tour,HARD,2,Cyril Saulnier,Nicolas Thomann,Cyril Saulnier,2-6; 6-1; 6-4,R32,89,21,2,42,72,35,42,13,30,0,3,13,48,72,2,5,33,63,24,33,14,30,3,7,12,38,63
2004-10-04 00:00:00.000,Tokyo Japan ATP World Tour,HARD,2,Thomas Johansson,Justin Gimelstob,Thomas Johansson,6-4; 6-4,R32,80,5,5,33,65,26,33,17,32,2,3,10,43,65,4,5,23,50,16,23,17,27,3,6,10,33,50
2004-10-04 00:00:00.000,Tokyo Japan ATP World Tour,HARD,2,Paradorn Srichaphan,Harel Levy,Paradorn Srichaphan,2-6; 7-6(3); 6-4,R32,121,7,3,64,107,43,64,24,43,5,8,15,67,107,10,2,53,102,36,53,28,49,6,8,15,64,102
2004-10-04 00:00:00.000,Tokyo Japan ATP World Tour,HARD,2,Marco Chiudinelli,Dennis van Scheppingen,Marco Chiudinelli,6-4; 7-6(3),R32,88,6,6,49,87,38,49,19,38,5,6,11,57,87,7,3,36,63,28,36,14,27,2,4,11,42,63
2004-10-04 00:00:00.000,Tokyo Japan ATP World Tour,HARD,2,Ricardo Mello,Flavio Saretta,Ricardo Mello,5-7; 6-2; 7-6(5),R32,150,4,2,74,101,50,74,10,27,6,12,16,60,101,7,5,69,119,46,69,16,50,11,18,16,62,119
2004-10-04 00:00:00.000,Tokyo Japan ATP World Tour,HARD,2,Jiri Novak,Guillermo Garcia-Lopez,Jiri Novak,7-5; 6-2,R32,79,11,0,37,52,31,37,7,15,1,2,10,38,52,3,1,38,65,23,38,14,27,5,9,10,37,65
2004-10-04 00:00:00.000,Tokyo Japan ATP World Tour,HARD,2,Michael Kohlmann,Guillermo Canas,Michael Kohlmann,4-6; 7-6(2); 6-3,R32,122,2,2,68,87,51,68,13,19,1,3,15,64,87,6,2,55,87,44,55,15,32,0,3,16,59,87
2004-10-04 00:00:00.000,Tokyo Japan ATP World Tour,HARD,2,Bohdan Ulihrach,Jarkko Nieminen,Bohdan Ulihrach,6-3; 7-6(5),R32,78,5,0,34,58,23,34,13,24,0,3,10,36,58,3,2,53,83,28,53,17,30,5,10,11,45,83
2004-10-04 00:00:00.000,Tokyo Japan ATP World Tour,HARD,2,Jan-Michael Gambill,Takahiro Terachi,Jan-Michael Gambill,7-6(5); 6-1,R32,86,12,2,36,61,28,36,15,25,3,4,9,43,61,3,1,39,67,21,39,16,28,4,8,10,37,67
2004-10-04 00:00:00.000,Tokyo Japan ATP World Tour,HARD,2,Bjorn Phau,Andrei Pavel,Bjorn Phau,6-2; 6-1,R32,49,9,0,29,45,21,29,13,16,1,1,8,34,45,1,1,24,40,13,24,6,16,2,6,7,19,40
2004-10-04 00:00:00.000,Tokyo Japan ATP World Tour,HARD,2,Taylor Dent,Tomas Zib,Taylor Dent,6-3; 6-4,R32,63,9,4,32,53,28,32,15,21,1,1,10,43,53,2,2,26,50,20,26,13,24,1,3,9,33,50
2004-10-04 00:00:00.000,Tokyo Japan ATP World Tour,HARD,2,Hyung-Taik Lee,Wayne Arthurs,Hyung-Taik Lee,6-2; 7-6(2),R32,75,2,1,44,59,37,44,9,15,1,1,10,46,59,11,5,42,73,31,42,13,31,2,4,10,44,73
2004-10-04 00:00:00.000,Tokyo Japan ATP World Tour,HARD,2,Gilles Muller,Alex Bogomolov Jr.,Gilles Muller,6-3; 6-1,R32,57,5,2,24,42,16,24,12,18,0,1,8,28,42,3,4,24,48,16,24,6,24,2,7,8,22,48
2004-10-04 00:00:00.000,Tokyo Japan ATP World Tour,HARD,2,David Nalbandian,Jimmy Wang,David Nalbandian,3-6; 7-6(4); 6-2,R32,153,10,4,66,108,47,66,19,42,7,10,14,66,108,7,6,73,116,48,73,19,43,9,13,15,67,116
2004-10-04 00:00:00.000,Tokyo Japan ATP World Tour,HARD,2,Lleyton Hewitt,Takao Suzuki,Lleyton Hewitt,6-7(3); 6-2; 6-4,R16,113,14,2,48,81,42,48,22,33,0,0,15,64,81,12,2,58,91,43,58,19,33,3,6,15,62,91
2004-10-04 00:00:00.000,Tokyo Japan ATP World Tour,HARD,2,Cyril Saulnier,Thomas Johansson,Cyril Saulnier,6-7(6); 7-6(3); 7-6(5),R16,176,17,7,88,145,64,88,29,57,13,16,18,93,145,18,0,72,138,51,72,38,66,13,16,18,89,138
2004-10-04 00:00:00.000,Tokyo Japan ATP World Tour,HARD,2,Paradorn Srichaphan,Marco Chiudinelli,Paradorn Srichaphan,6-3; 4-1 RET,R16,63,6,0,23,39,19,23,9,16,0,0,7,28,39,0,6,40,66,23,40,11,26,7,10,7,34,66
2004-10-04 00:00:00.000,Tokyo Japan ATP World Tour,HARD,2,Jiri Novak,Ricardo Mello,Jiri Novak,6-1; 6-2,R16,55,7,1,37,52,28,37,7,15,4,4,8,35,52,0,2,33,53,17,33,9,20,4,8,7,26,53
2004-10-04 00:00:00.000,Tokyo Japan ATP World Tour,HARD,2,Bohdan Ulihrach,Michael Kohlmann,Bohdan Ulihrach,6-4; 6-2,R16,69,1,2,35,59,27,35,12,24,2,3,9,39,59,2,2,28,57,17,28,12,29,2,6,9,29,57
2004-10-04 00:00:00.000,Tokyo Japan ATP World Tour,HARD,2,Bjorn Phau,Jan-Michael Gambill,Bjorn Phau,7-6(1); 2-6; 6-2,R16,109,5,6,43,83,35,43,15,40,4,9,14,50,83,7,1,39,74,24,39,17,35,1,6,14,41,74
2004-10-04 00:00:00.000,Tokyo Japan ATP World Tour,HARD,2,Taylor Dent,Hyung-Taik Lee,Taylor Dent,7-6(4); 5-7; 6-3,R16,121,15,4,62,108,48,62,25,46,5,8,17,73,108,1,5,73,95,54,73,7,22,3,6,16,61,95
2004-10-04 00:00:00.000,Tokyo Japan ATP World Tour,HARD,2,Gilles Muller,David Nalbandian,Gilles Muller,7-6(4); 3-6; 6-4,R16,138,16,2,56,87,43,56,15,31,5,8,15,58,87,8,1,78,120,50,78,25,42,6,9,16,75,120
2004-10-04 00:00:00.000,Tokyo Japan ATP World Tour,HARD,2,Lleyton Hewitt,Cyril Saulnier,Lleyton Hewitt,7-5; 6-1,Q,80,9,4,36,68,29,36,18,32,5,5,10,47,68,5,8,31,58,23,31,9,27,0,3,9,32,58
2004-10-04 00:00:00.000,Tokyo Japan ATP World Tour,HARD,2,Jiri Novak,Paradorn Srichaphan,Jiri Novak,6-4; 6-4,Q,64,3,1,46,57,35,46,8,11,2,2,10,43,57,2,1,42,60,32,42,6,18,3,5,10,38,60
2004-10-04 00:00:00.000,Tokyo Japan ATP World Tour,HARD,2,Bohdan Ulihrach,Bjorn Phau,Bohdan Ulihrach,7-5; 6-4,Q,90,1,6,53,88,36,53,17,35,5,7,11,53,88,7,3,37,70,27,37,16,33,6,10,11,43,70
2004-10-04 00:00:00.000,Tokyo Japan ATP World Tour,HARD,2,Taylor Dent,Gilles Muller,Taylor Dent,6-4; 4-6; 6-2,Q,95,10,3,57,84,47,57,13,27,5,6,14,60,84,6,5,51,82,35,51,19,31,6,9,14,54,82
2004-10-04 00:00:00.000,Tokyo Japan ATP World Tour,HARD,2,Jiri Novak,Lleyton Hewitt,Jiri Novak,6-4; 4-6; 6-2,S,96,3,1,52,80,39,52,15,28,2,4,14,54,80,10,2,42,82,35,42,15,40,3,7,14,50,82
2004-10-04 00:00:00.000,Tokyo Japan ATP World Tour,HARD,2,Taylor Dent,Bohdan Ulihrach,Taylor Dent,4-6; 6-4; 6-1,S,85,12,3,54,78,43,54,13,24,2,3,14,56,78,6,5,45,78,35,45,15,33,3,6,13,50,78
2004-10-04 00:00:00.000,Tokyo Japan ATP World Tour,HARD,2,Jiri Novak,Taylor Dent,Jiri Novak,5-7; 6-1; 6-3,F,105,1,0,51,76,31,51,18,25,1,4,14,49,76,4,7,63,107,39,63,17,44,7,13,14,56,107
2004-10-11 00:00:00.000,Metz France ATP World Tour,HARD,2,Ivan Ljubicic,Victor Hanescu,Ivan Ljubicic,6-4; 6-4,R32,63,13,2,37,51,32,37,9,14,0,0,10,41,51,5,1,38,53,26,38,10,15,2,4,10,36,53
2004-10-11 00:00:00.000,Metz France ATP World Tour,HARD,2,Raemon Sluiter,Adrian Garcia,Raemon Sluiter,6-4; 2-0 RET,R32,58,8,1,20,30,19,20,5,10,0,0,6,24,30,1,4,30,57,21,30,10,27,7,9,6,31,57
2004-10-11 00:00:00.000,Metz France ATP World Tour,HARD,2,Paul-Henri Mathieu,Kristof Vliegen,Paul-Henri Mathieu,6-4; 6-3,R32,78,2,0,27,55,19,27,19,28,0,1,10,38,55,3,0,37,59,22,37,11,22,1,4,9,33,59
2004-10-11 00:00:00.000,Metz France ATP World Tour,HARD,2,Florent Serra,Juan Monaco,Florent Serra,6-4; 4-6; 6-0,R32,102,1,10,56,78,38,56,6,22,5,10,13,44,78,3,1,46,76,20,46,12,30,4,12,13,32,76
2004-10-11 00:00:00.000,Metz France ATP World Tour,HARD,2,Jerome Haehnel,Jose Acasuso,Jerome Haehnel,6-3; 7-6(2),R32,82,4,0,37,72,32,37,20,35,6,6,11,52,72,9,6,34,73,29,34,17,39,3,4,10,46,73
2004-10-11 00:00:00.000,Metz France ATP World Tour,HARD,2,Marc Gicquel,Gilles Simon,Marc Gicquel,6-2; 2-6; 7-6(5),R32,119,1,0,49,79,31,49,18,30,0,4,14,49,79,5,1,62,89,40,62,15,27,4,8,14,55,89
2004-10-11 00:00:00.000,Metz France ATP World Tour,HARD,2,Olivier Mutis,Nicolas Mahut,Olivier Mutis,6-2; 2-6; 7-6(1),R32,119,6,1,47,90,37,47,22,43,8,11,14,59,90,11,3,58,95,43,58,13,37,0,3,14,56,95
2004-10-11 00:00:00.000,Metz France ATP World Tour,HARD,2,Arnaud Clement,Gilles Muller,Arnaud Clement,6-4; 7-6(3),R32,98,6,1,37,67,31,37,15,30,0,1,11,46,67,12,1,43,65,31,43,12,22,2,4,11,43,65
2004-10-11 00:00:00.000,Metz France ATP World Tour,HARD,2,Julien Benneteau,Jan-Michael Gambill,Julien Benneteau,6-3; 6-1,R32,69,2,1,37,60,28,37,13,23,8,8,8,41,60,3,2,36,53,22,36,4,17,5,9,8,26,53
2004-10-11 00:00:00.000,Metz France ATP World Tour,HARD,2,Jeff Morrison,Christophe Rochus,Jeff Morrison,6-4; 6-3,R32,59,13,2,32,55,28,32,14,23,3,3,10,42,55,1,3,38,55,27,38,7,17,2,4,9,34,55
2004-10-11 00:00:00.000,Metz France ATP World Tour,HARD,2,Gregory Carraz,Wayne Arthurs,Gregory Carraz,7-6(6); 6-7(5); 7-6(6),R32,149,22,10,71,126,62,71,35,55,5,5,18,97,126,30,4,72,115,59,72,29,43,1,1,18,88,115
2004-10-11 00:00:00.000,Metz France ATP World Tour,HARD,2,Alex Corretja,Olivier Rochus,Alex Corretja,6-3; 2-6; 7-5,R32,138,8,2,47,92,33,47,24,45,8,12,15,57,92,4,3,57,91,37,57,15,34,5,9,14,52,91
2004-10-11 00:00:00.000,Metz France ATP World Tour,HARD,2,Richard Gasquet,Dennis van Scheppingen,Richard Gasquet,6-3; 7-6(5),R32,70,15,2,31,57,26,31,18,26,2,3,10,44,57,1,4,41,71,31,41,13,30,5,8,11,44,71
2004-10-11 00:00:00.000,Metz France ATP World Tour,HARD,2,Antony Dupuis,Thierry Ascione,Antony Dupuis,4-6; 6-4; 7-6(3),R32,138,7,3,62,109,43,62,24,47,3,7,16,67,109,7,1,66,109,44,66,23,43,3,7,16,67,109
2004-10-11 00:00:00.000,Metz France ATP World Tour,HARD,2,Olivier Patience,Philipp Kohlschreiber,Olivier Patience,7-6(5); 0-6; 6-4,R32,100,9,1,67,88,43,67,5,21,2,8,14,48,88,14,3,55,93,39,55,16,38,2,6,14,55,93
2004-10-11 00:00:00.000,Metz France ATP World Tour,HARD,2,Gael Monfils,Xavier Malisse,Gael Monfils,3-6; 7-6(4) RET,R32,106,7,7,40,79,27,40,16,39,3,7,11,43,79,2,3,34,62,24,34,14,28,2,4,10,38,62
2004-10-11 00:00:00.000,Metz France ATP World Tour,HARD,2,Ivan Ljubicic,Raemon Sluiter,Ivan Ljubicic,4-6; 6-3; 7-6(4),R16,129,20,4,69,103,58,69,16,34,5,6,16,74,103,13,2,55,93,45,55,23,38,3,4,15,68,93
2004-10-11 00:00:00.000,Metz France ATP World Tour,HARD,2,Paul-Henri Mathieu,Florent Serra,Paul-Henri Mathieu,7-6(5); 6-1,R16,89,7,2,45,71,35,45,14,26,5,5,9,49,71,6,4,43,64,32,43,7,21,1,4,10,39,64
2004-10-11 00:00:00.000,Metz France ATP World Tour,HARD,2,Jerome Haehnel,Marc Gicquel,Jerome Haehnel,6-4; 6-2,R16,66,5,1,28,60,22,28,18,32,3,3,9,40,60,4,3,33,55,21,33,11,22,1,4,9,32,55
2004-10-11 00:00:00.000,Metz France ATP World Tour,HARD,2,Arnaud Clement,Olivier Mutis,Arnaud Clement,7-6(4); 6-1,R16,90,5,0,32,52,23,32,13,20,0,1,9,36,52,5,0,35,68,26,35,9,33,5,9,10,35,68
2004-10-11 00:00:00.000,Metz France ATP World Tour,HARD,2,Jeff Morrison,Julien Benneteau,Jeff Morrison,6-4; 4-6; 6-1,R16,96,13,5,55,88,44,55,17,33,3,4,14,61,88,4,3,48,72,36,48,10,24,2,5,13,46,72
2004-10-11 00:00:00.000,Metz France ATP World Tour,HARD,2,Alex Corretja,Gregory Carraz,Alex Corretja,4-6; 7-6(5); 6-4,R16,158,5,3,77,109,59,77,13,32,10,13,16,72,109,10,8,58,108,46,58,23,50,5,8,16,69,108
2004-10-11 00:00:00.000,Metz France ATP World Tour,HARD,2,Richard Gasquet,Antony Dupuis,Richard Gasquet,6-3; 4-6; 7-5,R16,122,21,5,64,105,47,64,21,41,8,10,16,68,105,6,1,59,83,48,59,8,24,0,3,15,56,83
2004-10-11 00:00:00.000,Metz France ATP World Tour,HARD,2,Gael Monfils,Olivier Patience,Gael Monfils,6-4; 6-4,R16,85,13,3,40,77,32,40,17,37,3,4,10,49,77,1,0,41,59,26,41,9,18,1,4,10,35,59
2004-10-11 00:00:00.000,Metz France ATP World Tour,HARD,2,Paul-Henri Mathieu,Ivan Ljubicic,Paul-Henri Mathieu,7-6(4); 6-4,Q,97,2,1,32,63,23,32,23,31,1,2,11,46,63,10,3,45,65,35,45,8,20,1,3,11,43,65
2004-10-11 00:00:00.000,Metz France ATP World Tour,HARD,2,Jerome Haehnel,Arnaud Clement,Jerome Haehnel,5-7; 6-2; 7-5,Q,131,8,4,60,95,45,60,17,35,3,5,16,62,95,14,3,48,94,40,48,19,46,6,10,16,59,94
2004-10-11 00:00:00.000,Metz France ATP World Tour,HARD,2,Jeff Morrison,Alex Corretja,Jeff Morrison,7-5; 6-4,Q,92,10,3,41,61,35,41,13,20,4,4,11,48,61,2,1,42,74,27,42,17,32,4,6,11,44,74
2004-10-11 00:00:00.000,Metz France ATP World Tour,HARD,2,Richard Gasquet,Gael Monfils,Richard Gasquet,7-5; 6-1,Q,93,3,6,46,74,36,46,12,28,6,7,10,48,74,3,3,34,70,22,34,17,36,8,12,9,39,70
2004-10-11 00:00:00.000,Metz France ATP World Tour,HARD,2,Jerome Haehnel,Paul-Henri Mathieu,Jerome Haehnel,6-7(5); 7-6(4); 7-6(1),S,190,6,3,73,117,58,73,28,44,2,3,18,86,117,19,3,71,137,59,71,31,66,8,9,18,90,137
2004-10-11 00:00:00.000,Metz France ATP World Tour,HARD,2,Richard Gasquet,Jeff Morrison,Richard Gasquet,6-1; 6-4,S,57,1,0,28,43,24,28,12,15,0,0,9,36,43,4,3,33,59,18,33,14,26,8,11,8,32,59
2004-10-11 00:00:00.000,Metz France ATP World Tour,HARD,2,Jerome Haehnel,Richard Gasquet,Jerome Haehnel,7-6(9); 6-4,F,95,5,1,50,82,37,50,20,32,9,10,11,57,82,7,1,45,70,35,45,14,25,3,5,11,49,70
2004-10-11 00:00:00.000,Moscow Russia ATP World Tour,HARD,2,Marat Safin,Max Mirnyi,Marat Safin,6-7(8); 7-6(2); 7-6(1),R32,155,14,5,72,125,57,72,32,53,5,7,18,89,125,18,7,76,119,63,76,18,43,2,4,18,81,119
2004-10-11 00:00:00.000,Moscow Russia ATP World Tour,HARD,2,Radek Stepanek,Irakli Labadze,Radek Stepanek,6-2; 6-1,R32,48,4,4,33,51,26,33,9,18,3,3,8,35,51,1,5,19,37,12,19,6,18,2,6,7,18,37
2004-10-11 00:00:00.000,Moscow Russia ATP World Tour,HARD,2,Sargis Sargsian,Teymuraz Gabashvili,Sargis Sargsian,6-2; 6-1,R32,80,3,4,24,42,23,24,10,18,0,0,8,33,42,3,1,34,61,21,34,8,27,3,7,7,29,61
2004-10-11 00:00:00.000,Moscow Russia ATP World Tour,HARD,2,Nikolay Davydenko,Sergiy Stakhovsky,Nikolay Davydenko,6-0; 6-3,R32,51,1,2,28,42,23,28,8,14,3,3,7,31,42,3,0,36,48,19,36,4,12,3,8,8,23,48
2004-10-11 00:00:00.000,Moscow Russia ATP World Tour,HARD,2,Igor Andreev,Vincent Spadea,Igor Andreev,6-4; 4-6; 6-4,R32,155,2,4,64,107,45,64,20,43,6,9,15,65,107,4,1,76,114,44,76,24,38,9,13,15,68,114
2004-10-11 00:00:00.000,Moscow Russia ATP World Tour,HARD,2,Kenneth Carlsen,Kristian Pless,Kenneth Carlsen,6-0; 6-4,R32,64,5,0,33,53,24,33,10,20,3,4,8,34,53,1,3,33,53,19,33,5,20,6,11,8,24,53
2004-10-11 00:00:00.000,Moscow Russia ATP World Tour,HARD,2,Jonas Bjorkman,David Sanchez,Jonas Bjorkman,4-6; 6-1; 6-2,R32,110,1,1,42,82,31,42,20,40,10,13,13,51,82,2,3,45,82,24,45,17,37,5,11,12,41,82
2004-10-11 00:00:00.000,Moscow Russia ATP World Tour,HARD,2,Mikhail Youzhny,Marc Rosset,Mikhail Youzhny,4-6; 6-3; 6-2,R32,93,7,3,38,71,34,38,21,33,3,4,14,55,71,5,3,38,73,28,38,20,35,2,5,13,48,73
2004-10-11 00:00:00.000,Moscow Russia ATP World Tour,HARD,2,Igor Kunitsyn,Tomas Berdych,Igor Kunitsyn,6-3; 6-4,R32,68,6,3,38,65,28,38,17,27,7,7,10,45,65,7,4,29,52,20,29,12,23,1,3,9,32,52
2004-10-11 00:00:00.000,Moscow Russia ATP World Tour,HARD,2,Karol Beck,Ivo Heuberger,Karol Beck,6-4; 6-4,R32,85,3,2,38,62,29,38,13,24,1,2,10,42,62,5,3,38,69,24,38,15,31,3,6,10,39,69
2004-10-11 00:00:00.000,Moscow Russia ATP World Tour,HARD,2,Vladimir Voltchkov,Gilles Elseneer,Vladimir Voltchkov,6-2; 7-6(1),R32,83,6,1,34,59,26,34,16,25,0,1,10,42,59,1,0,45,69,28,45,10,24,6,9,10,38,69
2004-10-11 00:00:00.000,Moscow Russia ATP World Tour,HARD,2,Dominik Hrbaty,Thomas Johansson,Dominik Hrbaty,6-4; 4-6; 6-3,R32,92,7,1,39,73,34,39,21,34,0,2,15,55,73,17,4,46,83,38,46,17,37,4,7,14,55,83
2004-10-11 00:00:00.000,Moscow Russia ATP World Tour,HARD,2,Filippo Volandri,Robin Soderling,Filippo Volandri,3-6; 6-1; 7-6(6),R32,115,2,6,60,94,37,60,18,34,3,8,14,55,94,1,4,62,95,40,62,9,33,6,12,14,49,95
2004-10-11 00:00:00.000,Moscow Russia ATP World Tour,HARD,2,Greg Rusedski,Ivo Karlovic,Greg Rusedski,7-6(14); 6-2,R32,89,5,4,37,65,35,37,18,28,0,0,10,53,65,15,5,56,82,42,56,13,26,2,4,10,55,82
2004-10-11 00:00:00.000,Moscow Russia ATP World Tour,HARD,2,Cyril Saulnier,Andrei Stoliarov,Cyril Saulnier,6-4; 5-7; 7-6(6),R32,155,11,3,56,98,34,56,27,42,2,7,17,61,98,7,6,48,121,36,48,33,73,7,12,17,69,121
2004-10-11 00:00:00.000,Moscow Russia ATP World Tour,HARD,2,Joachim Johansson,Jan Hernych,Joachim Johansson,6-4; 6-2,R32,63,6,2,31,54,26,31,14,23,3,3,9,40,54,3,1,32,51,22,32,8,19,3,6,9,30,51
2004-10-11 00:00:00.000,Moscow Russia ATP World Tour,HARD,2,Radek Stepanek,Marat Safin,Radek Stepanek,7-6(8); 4-6; 6-3,R16,151,7,3,63,101,42,63,21,38,5,9,16,63,101,12,4,55,108,37,55,28,53,7,11,15,65,108
2004-10-11 00:00:00.000,Moscow Russia ATP World Tour,HARD,2,Nikolay Davydenko,Sargis Sargsian,Nikolay Davydenko,6-2; 6-4,R16,96,3,0,39,57,28,39,10,18,3,4,9,38,57,1,0,39,64,27,39,6,25,6,10,9,33,64
2004-10-11 00:00:00.000,Moscow Russia ATP World Tour,HARD,2,Kenneth Carlsen,Igor Andreev,Kenneth Carlsen,7-6(4); 4-6; 6-1,R16,138,4,0,68,98,43,68,23,30,3,5,15,66,98,6,2,66,104,43,66,18,38,7,10,14,61,104
2004-10-11 00:00:00.000,Moscow Russia ATP World Tour,HARD,2,Mikhail Youzhny,Jonas Bjorkman,Mikhail Youzhny,6-4; 6-2,R16,79,5,2,29,49,23,29,10,20,0,2,9,33,49,1,3,30,67,19,30,12,37,5,10,9,31,67
2004-10-11 00:00:00.000,Moscow Russia ATP World Tour,HARD,2,Igor Kunitsyn,Karol Beck,Igor Kunitsyn,7-6(5); 7-5,R16,113,2,4,51,84,33,51,11,33,3,8,12,44,84,8,6,47,93,28,47,18,46,7,13,12,46,93
2004-10-11 00:00:00.000,Moscow Russia ATP World Tour,HARD,2,Dominik Hrbaty,Vladimir Voltchkov,Dominik Hrbaty,4-6; 7-5; 7-6(1),R16,131,6,0,73,107,47,73,18,34,4,9,17,65,107,6,4,62,99,40,62,19,37,2,7,17,59,99
2004-10-11 00:00:00.000,Moscow Russia ATP World Tour,HARD,2,Greg Rusedski,Filippo Volandri,Greg Rusedski,6-2; 6-4,R16,63,3,5,27,53,22,27,14,26,0,1,9,36,53,0,4,27,48,15,27,10,21,1,5,9,25,48
2004-10-11 00:00:00.000,Moscow Russia ATP World Tour,HARD,2,Joachim Johansson,Cyril Saulnier,Joachim Johansson,6-2; 6-4,R16,64,11,4,35,52,30,35,9,17,1,1,9,39,52,3,1,36,57,25,36,9,21,1,4,9,34,57
2004-10-11 00:00:00.000,Moscow Russia ATP World Tour,HARD,2,Nikolay Davydenko,Radek Stepanek,Nikolay Davydenko,7-6(2); 5-7; 6-1,Q,150,2,3,66,102,48,66,20,36,5,8,16,68,102,7,8,72,111,50,72,15,39,10,14,15,65,111
2004-10-11 00:00:00.000,Moscow Russia ATP World Tour,HARD,2,Mikhail Youzhny,Kenneth Carlsen,Mikhail Youzhny,6-2; 7-6(5),Q,93,5,0,36,61,28,36,15,25,1,2,10,43,61,3,1,42,72,26,42,16,30,3,6,10,42,72
2004-10-11 00:00:00.000,Moscow Russia ATP World Tour,HARD,2,Dominik Hrbaty,Igor Kunitsyn,Dominik Hrbaty,7-6(2); 6-4,Q,92,8,4,56,81,42,56,14,25,4,5,11,56,81,3,0,35,74,24,35,22,39,5,7,11,46,74
2004-10-11 00:00:00.000,Moscow Russia ATP World Tour,HARD,2,Greg Rusedski,Joachim Johansson,Greg Rusedski,7-6(5); 6-7(1); 7-6(7),Q,152,25,3,79,126,67,79,24,47,4,4,18,91,126,26,5,88,125,71,88,21,37,5,5,18,92,125
2004-10-11 00:00:00.000,Moscow Russia ATP World Tour,HARD,2,Nikolay Davydenko,Mikhail Youzhny,Nikolay Davydenko,7-5; 6-7(5); 7-5,S,176,1,4,87,125,57,87,21,38,11,14,18,78,125,2,4,77,134,50,77,30,57,11,16,18,80,134
2004-10-11 00:00:00.000,Moscow Russia ATP World Tour,HARD,2,Greg Rusedski,Dominik Hrbaty,Greg Rusedski,6-4; 6-3,S,64,8,3,36,63,28,36,17,27,4,4,10,45,63,2,2,37,55,26,37,10,18,3,5,9,36,55
2004-10-11 00:00:00.000,Moscow Russia ATP World Tour,HARD,2,Nikolay Davydenko,Greg Rusedski,Nikolay Davydenko,3-6; 6-3; 7-5,F,109,1,3,68,84,48,68,10,16,3,5,15,58,84,11,4,55,94,42,55,18,39,8,11,15,60,94
2004-10-11 00:00:00.000,Vienna Austria ATP World Tour,HARD,2,David Nalbandian,Andreas Seppi,David Nalbandian,6-4; 6-3,R32,84,2,2,35,62,27,35,15,27,6,7,10,42,62,4,3,35,64,22,35,14,29,4,7,9,36,64
2004-10-11 00:00:00.000,Vienna Austria ATP World Tour,HARD,2,Stefan Koubek,Alberto Martin,Stefan Koubek,7-5; 6-1,R32,81,2,3,38,69,28,38,17,31,7,8,10,45,69,2,5,31,59,22,31,9,28,3,7,9,31,59
2004-10-11 00:00:00.000,Vienna Austria ATP World Tour,HARD,2,Taylor Dent,Konstantin Don Gruber,Taylor Dent,6-1; 6-3,R32,54,4,3,35,50,27,35,7,15,2,2,8,34,50,5,1,38,51,21,38,5,13,6,10,8,26,51
2004-10-11 00:00:00.000,Vienna Austria ATP World Tour,HARD,2,Guillermo Canas,Julian Knowle,Guillermo Canas,6-2; 6-4,R32,80,8,6,28,51,26,28,12,23,3,3,9,38,51,0,9,36,61,24,36,9,25,5,8,9,33,61
2004-10-11 00:00:00.000,Vienna Austria ATP World Tour,HARD,2,Florian Mayer,Juan Ignacio Chela,Florian Mayer,6-4; 6-4,R32,62,4,1,33,56,27,33,13,23,4,5,10,40,56,4,3,44,59,30,44,4,15,2,5,10,34,59
2004-10-11 00:00:00.000,Vienna Austria ATP World Tour,HARD,2,Tommy Haas,Wesley Moodie,Tommy Haas,6-3; 6-0,R32,62,3,0,26,45,21,26,13,19,0,0,8,34,45,2,2,22,49,14,22,10,27,1,5,7,24,49
2004-10-11 00:00:00.000,Vienna Austria ATP World Tour,HARD,2,Robby Ginepri,Potito Starace,Robby Ginepri,4-6; 7-6(4); 6-4,R32,104,5,1,64,94,51,64,14,30,3,5,16,65,94,8,3,64,97,52,64,16,33,4,6,16,68,97
2004-10-11 00:00:00.000,Vienna Austria ATP World Tour,HARD,2,Paradorn Srichaphan,Albert Costa,Paradorn Srichaphan,6-4; 6-4,R32,87,7,2,32,67,27,32,20,35,3,3,10,47,67,5,1,30,60,21,30,16,30,2,4,10,37,60
2004-10-11 00:00:00.000,Vienna Austria ATP World Tour,HARD,2,Feliciano Lopez,Agustin Calleri,Feliciano Lopez,1-6; 7-5; 6-3,R32,100,10,1,43,76,34,43,21,33,5,7,14,55,76,9,8,41,89,34,41,24,48,6,8,14,58,89
2004-10-11 00:00:00.000,Vienna Austria ATP World Tour,HARD,2,Bohdan Ulihrach,Thomas Enqvist,Bohdan Ulihrach,3-6; 6-4; 6-4,R32,99,6,6,49,87,32,49,21,38,3,6,14,53,87,11,4,46,81,39,46,15,35,3,7,15,54,81
2004-10-11 00:00:00.000,Vienna Austria ATP World Tour,HARD,2,Luis Horna,David Ferrer,Luis Horna,6-3; 6-2,R32,56,2,1,34,47,26,34,10,13,0,0,9,36,47,3,2,31,43,20,31,4,12,1,4,8,24,43
2004-10-11 00:00:00.000,Vienna Austria ATP World Tour,HARD,2,Rainer Schuettler,Jurgen Melzer,Rainer Schuettler,6-4; 1-6; 6-3,R32,118,4,2,51,79,37,51,14,28,3,6,13,51,79,5,6,53,95,40,53,18,42,9,12,13,58,95
2004-10-11 00:00:00.000,Vienna Austria ATP World Tour,HARD,2,Alexander Peya,Glenn Weiner,Alexander Peya,6-3; 3-6; 6-2,R32,92,3,3,55,87,38,55,20,32,7,8,13,58,87,2,3,48,73,32,48,13,25,5,8,13,45,73
2004-10-11 00:00:00.000,Vienna Austria ATP World Tour,HARD,2,Davide Sanguinetti,Mariano Zabaleta,Davide Sanguinetti,7-6(7); 7-5,R32,105,2,2,50,77,32,50,16,27,3,6,12,48,77,4,4,53,80,34,53,13,27,3,7,12,47,80
2004-10-11 00:00:00.000,Vienna Austria ATP World Tour,HARD,2,Rik De Voest,Janko Tipsarevic,Rik De Voest,6-3; 6-4,R32,77,8,3,41,65,30,41,11,24,6,8,10,41,65,0,3,34,56,20,34,11,22,6,10,9,31,56
2004-10-11 00:00:00.000,Vienna Austria ATP World Tour,HARD,2,Nicolas Massu,Karol Kucera,Nicolas Massu,6-4; 6-7(5); 6-4,R32,173,2,0,61,95,43,61,25,34,5,6,16,68,95,12,6,69,114,51,69,20,45,11,14,16,71,114
2004-10-11 00:00:00.000,Vienna Austria ATP World Tour,HARD,2,David Nalbandian,Stefan Koubek,David Nalbandian,6-2; 7-6(6),R16,90,7,3,37,66,30,37,14,29,2,4,10,44,66,4,5,41,71,25,41,14,30,3,7,10,39,71
2004-10-11 00:00:00.000,Vienna Austria ATP World Tour,HARD,2,Guillermo Canas,Taylor Dent,Guillermo Canas,6-4; 6-4,R16,75,2,3,38,58,32,38,12,20,3,3,10,44,58,2,2,37,62,25,37,13,25,2,4,10,38,62
2004-10-11 00:00:00.000,Vienna Austria ATP World Tour,HARD,2,Tommy Haas,Florian Mayer,Tommy Haas,6-3; 6-4,R16,71,4,1,32,56,28,32,12,24,1,2,10,40,56,4,4,38,67,24,38,14,29,5,8,9,38,67
2004-10-11 00:00:00.000,Vienna Austria ATP World Tour,HARD,2,Robby Ginepri,Paradorn Srichaphan,Robby Ginepri,6-2; 6-1,R16,60,5,1,33,52,24,33,11,19,6,6,7,35,52,5,9,26,58,15,26,12,32,4,9,8,27,58
2004-10-11 00:00:00.000,Vienna Austria ATP World Tour,HARD,2,Feliciano Lopez,Bohdan Ulihrach,Feliciano Lopez,6-1; 6-4,R16,71,14,1,32,46,26,32,10,14,0,0,9,36,46,3,6,40,72,25,40,15,32,11,14,8,40,72
2004-10-11 00:00:00.000,Vienna Austria ATP World Tour,HARD,2,Rainer Schuettler,Luis Horna,Rainer Schuettler,7-5; 4-6; 6-3,R16,116,8,2,54,86,38,54,20,32,1,4,15,58,86,4,1,55,90,36,55,19,35,6,11,16,55,90
2004-10-11 00:00:00.000,Vienna Austria ATP World Tour,HARD,2,Davide Sanguinetti,Alexander Peya,Davide Sanguinetti,7-5; 6-4,R16,83,2,0,46,66,30,46,14,20,4,5,11,44,66,2,4,39,64,28,39,13,25,3,6,11,41,64
2004-10-11 00:00:00.000,Vienna Austria ATP World Tour,HARD,2,Nicolas Massu,Rik De Voest,Nicolas Massu,6-4; 6-2,R16,84,4,0,30,40,28,30,8,10,0,0,9,36,40,3,3,36,66,20,36,17,30,8,11,9,37,66
2004-10-11 00:00:00.000,Vienna Austria ATP World Tour,HARD,2,Guillermo Canas,David Nalbandian,Guillermo Canas,6-4; 2-6; 6-3,Q,138,4,0,48,83,37,48,14,35,2,6,14,51,83,6,2,50,88,35,50,17,38,8,12,13,52,88
2004-10-11 00:00:00.000,Vienna Austria ATP World Tour,HARD,2,Tommy Haas,Robby Ginepri,Tommy Haas,4-6; 6-3; 6-4,Q,94,6,2,51,79,41,51,16,28,0,1,15,57,79,7,1,57,82,39,57,17,25,1,3,14,56,82
2004-10-11 00:00:00.000,Vienna Austria ATP World Tour,HARD,2,Feliciano Lopez,Rainer Schuettler,Feliciano Lopez,6-4; 6-4,Q,68,9,1,41,62,32,41,13,21,2,2,10,45,62,3,2,26,60,15,26,23,34,2,4,10,38,60
2004-10-11 00:00:00.000,Vienna Austria ATP World Tour,HARD,2,Davide Sanguinetti,Nicolas Massu,Davide Sanguinetti,6-4; 6-3,Q,82,2,0,32,52,27,32,8,20,2,4,9,35,52,3,1,40,71,21,40,15,31,8,13,10,36,71
2004-10-11 00:00:00.000,Vienna Austria ATP World Tour,HARD,2,Guillermo Canas,Tommy Haas,Guillermo Canas,6-4; 6-3,S,89,6,2,34,53,30,34,9,19,3,3,9,39,53,4,1,42,69,30,42,9,27,1,4,10,39,69
2004-10-11 00:00:00.000,Vienna Austria ATP World Tour,HARD,2,Feliciano Lopez,Davide Sanguinetti,Feliciano Lopez,6-3; 6-3,S,56,10,0,34,45,30,34,5,11,3,4,9,35,45,4,0,37,53,22,37,8,16,3,7,9,30,53
2004-10-11 00:00:00.000,Vienna Austria ATP World Tour,HARD,2,Feliciano Lopez,Guillermo Canas,Feliciano Lopez,6-4; 1-6; 7-5; 3-6; 7-5,F,215,7,4,88,151,64,88,29,63,4,10,25,93,151,8,8,84,145,62,84,35,61,11,16,25,97,145
2004-10-18 00:00:00.000,ATP Masters Series Madrid Spain ATP World Tour,HARD,2,Tim Henman,N/A Bye,Tim Henman,,R64,0,0,0,0,0,0,0,0,0,0,0,0,0,0,0,0,0,0,0,0,0,0,0,0,0,0,0
2004-10-18 00:00:00.000,ATP Masters Series Madrid Spain ATP World Tour,HARD,2,Albert Costa,Irakli Labadze,Albert Costa,6-2; 5-7; 7-5,R64,161,8,1,58,99,45,58,21,41,8,10,16,66,99,5,13,64,118,40,64,28,54,13,17,16,68,118
2004-10-18 00:00:00.000,ATP Masters Series Madrid Spain ATP World Tour,HARD,2,Ivan Ljubicic,Tomas Berdych,Ivan Ljubicic,6-4; 6-4,R64,76,10,3,29,55,26,29,15,26,1,1,10,41,55,6,4,29,58,21,29,16,29,4,6,10,37,58
2004-10-18 00:00:00.000,ATP Masters Series Madrid Spain ATP World Tour,HARD,2,Rainer Schuettler,N/A Bye,Rainer Schuettler,,R64,0,0,0,0,0,0,0,0,0,0,0,0,0,0,0,0,0,0,0,0,0,0,0,0,0,0,0
2004-10-18 00:00:00.000,ATP Masters Series Madrid Spain ATP World Tour,HARD,2,Juan Ignacio Chela,N/A Bye,Juan Ignacio Chela,,R64,0,0,0,0,0,0,0,0,0,0,0,0,0,0,0,0,0,0,0,0,0,0,0,0,0,0,0
2004-10-18 00:00:00.000,ATP Masters Series Madrid Spain ATP World Tour,HARD,2,Antony Dupuis,Agustin Calleri,Antony Dupuis,6-4; 6-4,R64,72,9,0,32,49,27,32,14,17,0,0,10,41,49,5,5,28,65,23,28,19,37,2,4,10,42,65
2004-10-18 00:00:00.000,ATP Masters Series Madrid Spain ATP World Tour,HARD,2,Guillermo Canas,Kristof Vliegen,Guillermo Canas,5-7; 7-5; 6-1,R64,147,6,7,44,88,32,44,24,44,2,6,16,56,88,9,3,53,107,35,53,23,54,4,10,15,58,107
2004-10-18 00:00:00.000,ATP Masters Series Madrid Spain ATP World Tour,HARD,2,Joachim Johansson,N/A Bye,Joachim Johansson,,R64,0,0,0,0,0,0,0,0,0,0,0,0,0,0,0,0,0,0,0,0,0,0,0,0,0,0,0
2004-10-18 00:00:00.000,ATP Masters Series Madrid Spain ATP World Tour,HARD,2,David Nalbandian,N/A Bye,David Nalbandian,,R64,0,0,0,0,0,0,0,0,0,0,0,0,0,0,0,0,0,0,0,0,0,0,0,0,0,0,0
2004-10-18 00:00:00.000,ATP Masters Series Madrid Spain ATP World Tour,HARD,2,Robin Soderling,Florian Mayer,Robin Soderling,6-3; 7-6(2),R64,79,8,1,57,96,45,57,19,39,5,5,11,64,96,4,1,37,57,27,37,13,20,2,3,10,40,57
2004-10-18 00:00:00.000,ATP Masters Series Madrid Spain ATP World Tour,HARD,2,Alex Corretja,David Ferrer,Alex Corretja,7-5; 6-1,R64,72,5,2,25,51,25,25,16,26,1,1,10,41,51,4,6,34,62,26,34,8,28,2,5,9,34,62
2004-10-18 00:00:00.000,ATP Masters Series Madrid Spain ATP World Tour,HARD,2,Paradorn Srichaphan,N/A Bye,Paradorn Srichaphan,,R64,0,0,0,0,0,0,0,0,0,0,0,0,0,0,0,0,0,0,0,0,0,0,0,0,0,0,0
2004-10-18 00:00:00.000,ATP Masters Series Madrid Spain ATP World Tour,HARD,2,Jiri Novak,N/A Bye,Jiri Novak,,R64,0,0,0,0,0,0,0,0,0,0,0,0,0,0,0,0,0,0,0,0,0,0,0,0,0,0,0
2004-10-18 00:00:00.000,ATP Masters Series Madrid Spain ATP World Tour,HARD,2,Tommy Haas,Xavier Malisse,Tommy Haas,6-4; 6-1,R64,58,4,3,30,49,26,30,12,19,4,4,9,38,49,5,2,25,43,18,25,7,18,1,4,8,25,43
2004-10-18 00:00:00.000,ATP Masters Series Madrid Spain ATP World Tour,HARD,2,Taylor Dent,Mikhail Youzhny,Taylor Dent,6-3; 6-2,R64,55,5,0,32,44,28,32,8,12,0,0,9,36,44,3,7,30,54,18,30,10,24,3,6,8,28,54
2004-10-18 00:00:00.000,ATP Masters Series Madrid Spain ATP World Tour,HARD,2,Nicolas Massu,N/A Bye,Nicolas Massu,,R64,0,0,0,0,0,0,0,0,0,0,0,0,0,0,0,0,0,0,0,0,0,0,0,0,0,0,0
2004-10-18 00:00:00.000,ATP Masters Series Madrid Spain ATP World Tour,HARD,2,Juan Carlos Ferrero,N/A Bye,Juan Carlos Ferrero,,R64,0,0,0,0,0,0,0,0,0,0,0,0,0,0,0,0,0,0,0,0,0,0,0,0,0,0,0
2004-10-18 00:00:00.000,ATP Masters Series Madrid Spain ATP World Tour,HARD,2,Luis Horna,Hicham Arazi,Luis Horna,6-4; 7-5,R64,96,6,2,39,73,29,39,19,34,3,4,11,48,73,4,1,49,75,30,49,15,26,7,10,11,45,75
2004-10-18 00:00:00.000,ATP Masters Series Madrid Spain ATP World Tour,HARD,2,Mardy Fish,Mario Ancic,Mardy Fish,0-6; 6-4; 6-4,R64,101,4,5,28,64,22,28,20,36,0,3,13,42,64,9,6,48,87,35,48,21,39,6,8,13,56,87
2004-10-18 00:00:00.000,ATP Masters Series Madrid Spain ATP World Tour,HARD,2,Andrei Pavel,N/A Bye,Andrei Pavel,,R64,0,0,0,0,0,0,0,0,0,0,0,0,0,0,0,0,0,0,0,0,0,0,0,0,0,0,0
2004-10-18 00:00:00.000,ATP Masters Series Madrid Spain ATP World Tour,HARD,2,Fernando Gonzalez,N/A Bye,Fernando Gonzalez,,R64,0,0,0,0,0,0,0,0,0,0,0,0,0,0,0,0,0,0,0,0,0,0,0,0,0,0,0
2004-10-18 00:00:00.000,ATP Masters Series Madrid Spain ATP World Tour,HARD,2,Stefan Koubek,Sjeng Schalken,Stefan Koubek,6-4; 6-4,R64,76,5,2,36,53,29,36,8,17,1,3,10,37,53,0,3,40,66,23,40,13,26,5,9,10,36,66
2004-10-18 00:00:00.000,ATP Masters Series Madrid Spain ATP World Tour,HARD,2,Feliciano Lopez,Ivo Karlovic,Feliciano Lopez,6-4; 6-7(10); 7-6(5),R64,132,8,3,74,110,63,74,23,36,4,4,17,86,110,35,6,74,107,64,74,20,33,1,2,17,84,107
2004-10-18 00:00:00.000,ATP Masters Series Madrid Spain ATP World Tour,HARD,2,Marat Safin,N/A Bye,Marat Safin,,R64,0,0,0,0,0,0,0,0,0,0,0,0,0,0,0,0,0,0,0,0,0,0,0,0,0,0,0
2004-10-18 00:00:00.000,ATP Masters Series Madrid Spain ATP World Tour,HARD,2,Tommy Robredo,N/A Bye,Tommy Robredo,,R64,0,0,0,0,0,0,0,0,0,0,0,0,0,0,0,0,0,0,0,0,0,0,0,0,0,0,0
2004-10-18 00:00:00.000,ATP Masters Series Madrid Spain ATP World Tour,HARD,2,Robby Ginepri,Juan-Luis Rascon-Lope,Robby Ginepri,6-1; 6-4,R64,72,6,0,35,51,29,35,9,16,1,1,9,38,51,3,5,35,60,22,35,9,25,7,10,8,31,60
2004-10-18 00:00:00.000,ATP Masters Series Madrid Spain ATP World Tour,HARD,2,Fernando Verdasco,Jonas Bjorkman,Fernando Verdasco,6-1; 6-2,R64,66,5,2,21,37,18,21,11,16,0,0,7,29,37,3,0,28,59,11,28,17,31,3,8,8,28,59
2004-10-18 00:00:00.000,ATP Masters Series Madrid Spain ATP World Tour,HARD,2,Dominik Hrbaty,N/A Bye,Dominik Hrbaty,,R64,0,0,0,0,0,0,0,0,0,0,0,0,0,0,0,0,0,0,0,0,0,0,0,0,0,0,0
2004-10-18 00:00:00.000,ATP Masters Series Madrid Spain ATP World Tour,HARD,2,Vincent Spadea,N/A Bye,Vincent Spadea,,R64,0,0,0,0,0,0,0,0,0,0,0,0,0,0,0,0,0,0,0,0,0,0,0,0,0,0,0
2004-10-18 00:00:00.000,ATP Masters Series Madrid Spain ATP World Tour,HARD,2,Rafael Nadal,Davide Sanguinetti,Rafael Nadal,6-2; 6-1,R64,62,2,4,27,47,23,27,9,20,5,6,8,32,47,1,2,21,41,11,21,6,20,3,8,7,17,41
2004-10-18 00:00:00.000,ATP Masters Series Madrid Spain ATP World Tour,HARD,2,Max Mirnyi,David Sanchez,Max Mirnyi,6-3; 7-6(3),R64,93,14,2,46,69,38,46,12,23,1,2,11,50,69,2,4,46,81,33,46,15,35,7,9,10,48,81
2004-10-18 00:00:00.000,ATP Masters Series Madrid Spain ATP World Tour,HARD,2,Andre Agassi,N/A Bye,Andre Agassi,,R64,0,0,0,0,0,0,0,0,0,0,0,0,0,0,0,0,0,0,0,0,0,0,0,0,0,0,0
2004-10-18 00:00:00.000,ATP Masters Series Madrid Spain ATP World Tour,HARD,2,Tim Henman,Albert Costa,Tim Henman,6-4; 6-2,R32,85,12,4,38,62,31,38,8,24,7,9,9,39,62,4,2,34,57,19,34,10,23,5,10,9,29,57
2004-10-18 00:00:00.000,ATP Masters Series Madrid Spain ATP World Tour,HARD,2,Ivan Ljubicic,Rainer Schuettler,Ivan Ljubicic,6-3; 6-0,R32,55,7,1,38,51,28,38,7,13,1,1,8,35,51,2,1,20,45,15,20,9,25,2,6,7,24,45
2004-10-18 00:00:00.000,ATP Masters Series Madrid Spain ATP World Tour,HARD,2,Antony Dupuis,Juan Ignacio Chela,Antony Dupuis,7-6(4); 6-3,R32,100,6,1,47,75,36,47,12,28,1,3,11,48,75,4,5,49,76,31,49,10,27,3,6,10,41,76
2004-10-18 00:00:00.000,ATP Masters Series Madrid Spain ATP World Tour,HARD,2,Joachim Johansson,Guillermo Canas,Joachim Johansson,7-6(3); 7-5,R32,112,23,5,36,62,35,36,17,26,0,0,12,52,62,3,3,48,83,37,48,17,35,6,7,12,54,83
2004-10-18 00:00:00.000,ATP Masters Series Madrid Spain ATP World Tour,HARD,2,David Nalbandian,Robin Soderling,David Nalbandian,7-6(5); 6-3,R32,89,5,4,41,72,33,41,17,31,4,5,11,50,72,7,4,36,62,23,36,16,26,1,3,10,39,62
2004-10-18 00:00:00.000,ATP Masters Series Madrid Spain ATP World Tour,HARD,2,Paradorn Srichaphan,Alex Corretja,Paradorn Srichaphan,7-6(5); 6-3,R32,102,10,2,36,72,30,36,19,36,1,2,11,49,72,8,1,48,77,35,48,11,29,7,9,10,46,77
2004-10-18 00:00:00.000,ATP Masters Series Madrid Spain ATP World Tour,HARD,2,Tommy Haas,Jiri Novak,Tommy Haas,6-1; 6-4,R32,54,13,1,26,48,23,26,15,22,2,2,9,38,48,1,0,33,55,18,33,11,22,3,6,8,29,55
2004-10-18 00:00:00.000,ATP Masters Series Madrid Spain ATP World Tour,HARD,2,Taylor Dent,Nicolas Massu,Taylor Dent,6-3; 3-6; 6-3,R32,128,5,7,56,86,43,56,16,30,3,5,14,59,86,5,1,62,96,37,62,20,34,9,12,13,57,96
2004-10-18 00:00:00.000,ATP Masters Series Madrid Spain ATP World Tour,HARD,2,Luis Horna,Juan Carlos Ferrero,Luis Horna,6-3; 6-1,R32,79,2,2,33,53,26,33,11,20,3,3,8,37,53,2,6,27,63,18,27,15,36,6,10,8,33,63
2004-10-18 00:00:00.000,ATP Masters Series Madrid Spain ATP World Tour,HARD,2,Andrei Pavel,Mardy Fish,Andrei Pavel,6-1; 3-6; 7-6(2),R32,110,9,3,54,94,40,54,20,40,6,8,14,60,94,11,5,48,88,37,48,15,40,3,6,14,52,88
2004-10-18 00:00:00.000,ATP Masters Series Madrid Spain ATP World Tour,HARD,2,Stefan Koubek,Fernando Gonzalez,Stefan Koubek,6-1; 3-6; 7-6(5),R32,140,6,8,63,122,44,63,30,59,14,16,14,74,122,9,10,65,102,50,65,11,37,4,7,14,61,102
2004-10-18 00:00:00.000,ATP Masters Series Madrid Spain ATP World Tour,HARD,2,Marat Safin,Feliciano Lopez,Marat Safin,7-5; 6-7(5); 6-3,R32,136,17,3,51,97,42,51,30,46,3,6,17,72,97,16,4,58,104,42,58,25,46,0,1,16,67,104
2004-10-18 00:00:00.000,ATP Masters Series Madrid Spain ATP World Tour,HARD,2,Tommy Robredo,Robby Ginepri,Tommy Robredo,6-4; 3-6; 6-3,R32,100,8,6,42,80,36,42,21,38,1,2,14,57,80,1,2,55,85,36,55,20,30,3,5,14,56,85
2004-10-18 00:00:00.000,ATP Masters Series Madrid Spain ATP World Tour,HARD,2,Fernando Verdasco,Dominik Hrbaty,Fernando Verdasco,6-4; 7-6(4),R32,100,9,4,42,84,36,42,19,42,6,7,11,55,84,3,5,39,72,28,39,16,33,2,4,11,44,72
2004-10-18 00:00:00.000,ATP Masters Series Madrid Spain ATP World Tour,HARD,2,Vincent Spadea,Rafael Nadal,Vincent Spadea,6-4; 4-6; 6-3,R32,151,1,4,44,88,30,44,24,44,3,7,15,54,88,0,4,74,102,46,74,11,28,11,16,14,57,102
2004-10-18 00:00:00.000,ATP Masters Series Madrid Spain ATP World Tour,HARD,2,Andre Agassi,Max Mirnyi,Andre Agassi,7-6(5); 6-3,R32,88,10,1,40,77,29,40,23,37,5,5,10,52,77,11,6,37,60,32,37,11,23,2,4,11,43,60
2004-10-18 00:00:00.000,ATP Masters Series Madrid Spain ATP World Tour,HARD,2,Ivan Ljubicic,Tim Henman,Ivan Ljubicic,6-4; 4-6; 6-2,R16,118,10,1,38,70,30,38,24,32,0,1,14,54,70,5,7,45,89,34,45,22,44,4,7,14,56,89
2004-10-18 00:00:00.000,ATP Masters Series Madrid Spain ATP World Tour,HARD,2,Joachim Johansson,Antony Dupuis,Joachim Johansson,6-1; 7-6(6),R16,80,21,3,34,56,28,34,18,22,0,0,10,46,56,11,2,35,60,29,35,11,25,2,4,9,40,60
2004-10-18 00:00:00.000,ATP Masters Series Madrid Spain ATP World Tour,HARD,2,David Nalbandian,Paradorn Srichaphan,David Nalbandian,6-3; 6-1,R16,55,5,1,28,40,22,28,10,12,0,0,8,32,40,5,2,27,48,16,27,8,21,2,6,8,24,48
2004-10-18 00:00:00.000,ATP Masters Series Madrid Spain ATP World Tour,HARD,2,Taylor Dent,Tommy Haas,Taylor Dent,7-6(3); 6-2,R16,86,5,5,45,70,32,45,12,25,4,6,10,44,70,3,7,34,71,23,34,16,37,5,9,10,39,71
2004-10-18 00:00:00.000,ATP Masters Series Madrid Spain ATP World Tour,HARD,2,Luis Horna,Andrei Pavel,Luis Horna,7-5; 6-4,R16,71,13,3,54,65,44,54,6,11,2,2,11,50,65,12,1,35,61,29,35,10,26,0,2,11,39,61
2004-10-18 00:00:00.000,ATP Masters Series Madrid Spain ATP World Tour,HARD,2,Marat Safin,Stefan Koubek,Marat Safin,6-3; 6-3,R16,59,13,2,28,48,25,28,12,20,3,3,9,37,48,2,4,36,58,24,36,9,22,3,6,9,33,58
2004-10-18 00:00:00.000,ATP Masters Series Madrid Spain ATP World Tour,HARD,2,Tommy Robredo,Fernando Verdasco,Tommy Robredo,2-6; 6-4; 6-3,R16,117,5,3,52,81,41,52,13,29,6,8,13,54,81,7,3,58,90,36,58,21,32,11,14,14,57,90
2004-10-18 00:00:00.000,ATP Masters Series Madrid Spain ATP World Tour,HARD,2,Andre Agassi,Vincent Spadea,Andre Agassi,6-1; 6-3,R16,59,7,4,28,50,22,28,14,22,6,6,8,36,50,7,2,23,50,15,23,12,27,5,9,8,27,50
2004-10-18 00:00:00.000,ATP Masters Series Madrid Spain ATP World Tour,HARD,2,Ivan Ljubicic,Joachim Johansson,Ivan Ljubicic,7-6(2); 6-7(1); 7-6(3),Q,162,27,1,77,112,62,77,22,35,1,1,18,84,112,15,4,69,122,54,69,33,53,2,2,18,87,122
2004-10-18 00:00:00.000,ATP Masters Series Madrid Spain ATP World Tour,HARD,2,David Nalbandian,Taylor Dent,David Nalbandian,7-6(4); 6-3,Q,83,4,0,43,71,35,43,15,28,2,3,11,50,71,3,3,43,58,31,43,6,15,2,4,10,37,58
2004-10-18 00:00:00.000,ATP Masters Series Madrid Spain ATP World Tour,HARD,2,Marat Safin,Luis Horna,Marat Safin,6-4; 6-4,Q,79,9,4,29,60,25,29,19,31,3,3,10,44,60,5,1,44,68,33,44,10,24,2,4,10,43,68
2004-10-18 00:00:00.000,ATP Masters Series Madrid Spain ATP World Tour,HARD,2,Andre Agassi,Tommy Robredo,Andre Agassi,6-7(3); 6-3; 6-2,Q,147,6,2,59,112,46,59,28,53,10,11,15,74,112,17,6,52,108,36,52,27,56,7,11,14,63,108
2004-10-18 00:00:00.000,ATP Masters Series Madrid Spain ATP World Tour,HARD,2,David Nalbandian,Ivan Ljubicic,David Nalbandian,6-4; 6-4,S,85,3,0,33,60,24,33,21,27,5,5,10,45,60,13,3,37,53,31,37,5,16,2,4,10,36,53
2004-10-18 00:00:00.000,ATP Masters Series Madrid Spain ATP World Tour,HARD,2,Marat Safin,Andre Agassi,Marat Safin,6-3; 7-6(4),S,94,12,2,38,72,33,38,20,34,4,4,11,53,72,5,2,39,78,31,39,17,39,6,7,10,48,78
2004-10-18 00:00:00.000,ATP Masters Series Madrid Spain ATP World Tour,HARD,2,Marat Safin,David Nalbandian,Marat Safin,6-2; 6-4; 6-3,F,112,15,2,42,73,34,42,20,31,1,3,14,54,73,1,3,41,82,25,41,16,41,7,13,13,41,82
2004-10-25 00:00:00.000,Basel Switzerland ATP World Tour,HARD,2,Bohdan Ulihrach,Luis Horna,Bohdan Ulihrach,6-1 RET,R32,23,2,1,13,21,12,13,4,8,0,0,4,16,21,0,1,10,16,6,10,2,6,1,3,3,8,16
2004-10-25 00:00:00.000,Basel Switzerland ATP World Tour,HARD,2,Ivo Heuberger,Taylor Dent,Ivo Heuberger,6-2; 6-3,R32,62,3,0,26,43,21,26,12,17,1,1,8,33,43,2,4,42,59,23,42,9,17,6,10,9,32,59
2004-10-25 00:00:00.000,Basel Switzerland ATP World Tour,HARD,2,Mariano Zabaleta,Victor Hanescu,Mariano Zabaleta,7-6(7); 5-7; 7-6(4),R32,147,11,1,88,118,71,88,18,30,4,5,18,89,118,21,3,84,117,64,84,22,33,0,0,18,86,117
2004-10-25 00:00:00.000,Basel Switzerland ATP World Tour,HARD,2,Nicolas Massu,Michel Kratochvil,Nicolas Massu,6-3; 6-2,R32,85,6,2,18,45,18,18,14,27,1,2,8,32,45,4,7,37,76,21,37,16,39,6,11,9,37,76
2004-10-25 00:00:00.000,Basel Switzerland ATP World Tour,HARD,2,David Nalbandian,Mario Ancic,David Nalbandian,6-4; 6-3,R32,79,4,3,31,50,24,31,11,19,2,3,9,35,50,9,1,45,65,29,45,7,20,4,8,10,36,65
2004-10-25 00:00:00.000,Basel Switzerland ATP World Tour,HARD,2,Vincent Spadea,Filippo Volandri,Vincent Spadea,6-3; 4-0 RET,R32,71,1,0,29,55,20,29,16,26,5,5,7,36,55,0,0,31,54,18,31,9,23,5,8,6,27,54
2004-10-25 00:00:00.000,Basel Switzerland ATP World Tour,HARD,2,Marco Chiudinelli,Albert Montanes,Marco Chiudinelli,6-3; 6-3,R32,71,9,1,38,58,32,38,11,20,2,2,9,43,58,3,5,49,68,30,49,10,19,3,6,9,40,68
2004-10-25 00:00:00.000,Basel Switzerland ATP World Tour,HARD,2,Rainer Schuettler,Rafael Nadal,Rainer Schuettler,6-3; 6-4,R32,98,4,2,30,64,23,30,19,34,5,7,10,42,64,1,3,43,66,26,43,9,23,4,8,9,35,66
2004-10-25 00:00:00.000,Basel Switzerland ATP World Tour,HARD,2,Jerome Haehnel,Fernando Gonzalez,Jerome Haehnel,6-3; 6-4,R32,53,6,0,35,48,31,35,9,13,0,0,10,40,48,4,1,33,50,22,33,10,17,0,2,9,32,50
2004-10-25 00:00:00.000,Basel Switzerland ATP World Tour,HARD,2,Ivan Ljubicic,Juan Ignacio Chela,Ivan Ljubicic,6-3; 6-4,R32,78,10,0,31,54,26,31,15,23,2,2,10,41,54,1,1,45,64,30,45,8,19,8,10,9,38,64
2004-10-25 00:00:00.000,Basel Switzerland ATP World Tour,HARD,2,Stefan Koubek,Paradorn Srichaphan,Stefan Koubek,6-7(7); 6-4; 6-3,R32,122,4,3,59,97,43,59,25,38,3,4,15,68,97,9,4,55,106,40,55,26,51,2,6,16,66,106
2004-10-25 00:00:00.000,Basel Switzerland ATP World Tour,HARD,2,Gaston Gaudio,Dick Norman,Gaston Gaudio,7-6(4); 6-4,R32,88,3,1,45,67,32,45,17,22,0,0,11,49,67,13,1,40,72,31,40,18,32,3,4,11,49,72
2004-10-25 00:00:00.000,Basel Switzerland ATP World Tour,HARD,2,Tommy Robredo,Stanislas Wawrinka,Tommy Robredo,7-6(6); 5-7; 6-4,R32,167,12,4,85,142,63,85,24,57,10,13,17,87,142,7,3,65,119,47,65,31,54,10,13,17,78,119
2004-10-25 00:00:00.000,Basel Switzerland ATP World Tour,HARD,2,Jiri Novak,Florian Mayer,Jiri Novak,6-2; 6-3,R32,52,5,1,40,61,31,40,11,21,2,2,9,42,61,3,3,25,48,18,25,8,23,1,4,8,26,48
2004-10-25 00:00:00.000,Basel Switzerland ATP World Tour,HARD,2,Wesley Moodie,Potito Starace,Wesley Moodie,6-4; 6-4,R32,74,13,2,36,57,30,36,11,21,1,1,10,41,57,2,3,47,68,28,47,12,21,4,6,10,40,68
2004-10-25 00:00:00.000,Basel Switzerland ATP World Tour,HARD,2,Tim Henman,Antony Dupuis,Tim Henman,6-3; 6-4,R32,75,9,3,29,55,24,29,17,26,0,0,10,41,55,2,2,39,56,25,39,9,17,0,2,9,34,56
2004-10-25 00:00:00.000,Basel Switzerland ATP World Tour,HARD,2,Bohdan Ulihrach,Ivo Heuberger,Bohdan Ulihrach,6-1; 6-4,R16,67,4,1,32,49,26,32,11,17,0,0,9,37,49,4,0,35,62,25,35,10,27,7,10,8,35,62
2004-10-25 00:00:00.000,Basel Switzerland ATP World Tour,HARD,2,Nicolas Massu,Mariano Zabaleta,Nicolas Massu,6-2; 6-4,R16,67,4,0,27,46,24,27,12,19,0,0,9,36,46,4,0,39,48,26,39,4,9,3,6,9,30,48
2004-10-25 00:00:00.000,Basel Switzerland ATP World Tour,HARD,2,David Nalbandian,Vincent Spadea,David Nalbandian,6-4; 6-4,R16,76,4,0,34,57,27,34,15,23,0,0,10,42,57,5,4,41,69,31,41,12,28,8,10,10,43,69
2004-10-25 00:00:00.000,Basel Switzerland ATP World Tour,HARD,2,Rainer Schuettler,Marco Chiudinelli,Rainer Schuettler,7-6(4); 6-2,R16,91,5,3,35,63,26,35,14,28,0,2,10,40,63,2,4,38,65,19,38,15,27,4,8,10,34,65
2004-10-25 00:00:00.000,Basel Switzerland ATP World Tour,HARD,2,Ivan Ljubicic,Jerome Haehnel,Ivan Ljubicic,6-3; 3-6; 6-3,R16,100,14,2,45,77,34,45,21,32,0,1,14,55,77,5,4,49,77,37,49,16,28,2,4,13,53,77
2004-10-25 00:00:00.000,Basel Switzerland ATP World Tour,HARD,2,Stefan Koubek,Gaston Gaudio,Stefan Koubek,6-1; 1-6; 6-3,R16,102,2,2,46,95,29,46,28,49,12,14,12,57,95,1,3,48,72,32,48,10,24,3,6,11,42,72
2004-10-25 00:00:00.000,Basel Switzerland ATP World Tour,HARD,2,Jiri Novak,Tommy Robredo,Jiri Novak,W/O,R16,0,0,0,0,0,0,0,0,0,0,0,0,0,0,0,0,0,0,0,0,0,0,0,0,0,0,0
2004-10-25 00:00:00.000,Basel Switzerland ATP World Tour,HARD,2,Tim Henman,Wesley Moodie,Tim Henman,7-6(2); 6-7(0); 6-4,R16,170,11,3,69,106,55,69,22,37,1,1,17,77,106,24,4,90,135,68,90,21,45,11,12,17,89,135
2004-10-25 00:00:00.000,Basel Switzerland ATP World Tour,HARD,2,Nicolas Massu,Bohdan Ulihrach,Nicolas Massu,6-2; 7-6(4),Q,87,6,2,35,56,28,35,15,21,2,3,10,43,56,3,5,34,72,25,34,15,38,5,8,10,40,72
2004-10-25 00:00:00.000,Basel Switzerland ATP World Tour,HARD,2,David Nalbandian,Rainer Schuettler,David Nalbandian,4-6; 7-6(5); 6-3,Q,134,2,5,58,110,38,58,25,52,6,12,16,63,110,6,5,51,86,33,51,15,35,1,7,15,48,86
2004-10-25 00:00:00.000,Basel Switzerland ATP World Tour,HARD,2,Stefan Koubek,Ivan Ljubicic,Stefan Koubek,2-6; 7-5; 7-5,Q,123,10,1,65,92,49,65,17,27,8,10,16,66,92,24,1,59,92,48,59,17,33,6,8,16,65,92
2004-10-25 00:00:00.000,Basel Switzerland ATP World Tour,HARD,2,Jiri Novak,Tim Henman,Jiri Novak,7-6(5); 7-5,Q,99,1,2,54,86,37,54,16,32,4,6,12,53,86,7,1,47,74,33,47,13,27,1,4,12,46,74
2004-10-25 00:00:00.000,Basel Switzerland ATP World Tour,HARD,2,David Nalbandian,Nicolas Massu,David Nalbandian,6-3; 6-4,S,78,4,3,46,68,32,46,9,22,2,4,10,41,68,4,4,21,50,15,21,12,29,2,6,9,27,50
2004-10-25 00:00:00.000,Basel Switzerland ATP World Tour,HARD,2,Jiri Novak,Stefan Koubek,Jiri Novak,6-4; 6-0,S,51,3,2,27,46,18,27,13,19,2,3,8,31,46,1,1,26,42,15,26,3,16,0,5,8,18,42
2004-10-25 00:00:00.000,Basel Switzerland ATP World Tour,HARD,2,Jiri Novak,David Nalbandian,Jiri Novak,5-7; 6-3; 6-4; 1-6; 6-2,F,182,7,1,97,147,67,97,21,50,5,10,23,88,147,7,0,99,141,66,99,17,42,7,13,23,83,141
2004-10-25 00:00:00.000,St. Petersburg Russia ATP World Tour,HARD,2,Marat Safin,Alexander Peya,Marat Safin,7-6(5); 3-1 RET,R32,65,3,1,35,51,30,35,9,16,0,0,8,39,51,3,3,35,58,27,35,10,23,4,5,8,37,58
2004-10-25 00:00:00.000,St. Petersburg Russia ATP World Tour,HARD,2,Sargis Sargsian,Irakli Labadze,Sargis Sargsian,4-6; 6-1; 6-2,R32,99,7,3,51,82,36,51,17,31,3,5,13,53,82,4,6,44,70,28,44,9,26,3,8,12,37,70
2004-10-25 00:00:00.000,St. Petersburg Russia ATP World Tour,HARD,2,Michael Kohlmann,Gregory Carraz,Michael Kohlmann,4-6; 6-3; 6-4,R32,102,11,1,49,77,37,49,22,28,1,2,15,59,77,12,10,59,86,44,59,12,27,4,6,14,56,86
2004-10-25 00:00:00.000,St. Petersburg Russia ATP World Tour,HARD,2,Michael Llodra,Mikhail Elgin,Michael Llodra,6-2; 6-2,R32,46,5,5,26,45,22,26,11,19,3,3,8,33,45,3,3,25,46,17,25,6,21,3,7,8,23,46
2004-10-25 00:00:00.000,St. Petersburg Russia ATP World Tour,HARD,2,Mardy Fish,Jan Hernych,Mardy Fish,6-2; 6-4,R32,64,6,8,27,48,21,27,11,21,3,5,9,32,48,2,4,39,70,20,39,12,31,9,14,9,32,70
2004-10-25 00:00:00.000,St. Petersburg Russia ATP World Tour,HARD,2,Cyril Saulnier,Alberto Martin,Cyril Saulnier,6-0; 6-1,R32,47,8,0,20,39,19,20,11,19,0,0,7,30,39,0,9,14,40,8,14,6,26,1,6,6,14,40
2004-10-25 00:00:00.000,St. Petersburg Russia ATP World Tour,HARD,2,Karol Beck,Jiri Vanek,Karol Beck,6-3; 6-2,R32,54,5,2,33,49,28,33,10,16,1,1,9,38,49,1,3,25,50,17,25,12,25,2,5,8,29,50
2004-10-25 00:00:00.000,St. Petersburg Russia ATP World Tour,HARD,2,Nikolay Davydenko,Igor Kunitsyn,Nikolay Davydenko,6-4; 6-7(5); 6-4,R32,156,3,10,81,125,52,81,18,44,14,19,16,70,125,2,3,60,118,35,60,28,58,11,18,16,63,118
2004-10-25 00:00:00.000,St. Petersburg Russia ATP World Tour,HARD,2,Gilles Muller,Igor Andreev,Gilles Muller,4-6; 6-1; 7-5,R32,102,6,3,54,80,36,54,17,26,0,2,15,53,80,9,5,49,87,35,49,18,38,4,8,14,53,87
2004-10-25 00:00:00.000,St. Petersburg Russia ATP World Tour,HARD,2,Julien Benneteau,Arnaud Clement,Julien Benneteau,6-4; 1-6; 6-4,R32,117,13,3,58,89,34,58,17,31,7,12,13,51,89,3,4,41,80,31,41,17,39,2,7,14,48,80
2004-10-25 00:00:00.000,St. Petersburg Russia ATP World Tour,HARD,2,Max Mirnyi,Ricardo Mello,Max Mirnyi,7-6(7); 7-6(2),R32,106,14,4,57,89,42,57,20,32,0,0,12,62,89,2,1,59,77,42,59,13,18,2,2,12,55,77
2004-10-25 00:00:00.000,St. Petersburg Russia ATP World Tour,HARD,2,Mikhail Youzhny,Andy Ram,Mikhail Youzhny,2-6; 7-6(3); 7-6(4),R32,158,4,4,78,109,52,78,14,31,0,4,16,66,109,5,4,66,132,46,66,33,66,14,16,16,79,132
2004-10-25 00:00:00.000,St. Petersburg Russia ATP World Tour,HARD,2,Radek Stepanek,David Ferrer,Radek Stepanek,6-3; 6-2,R32,63,7,6,32,52,26,32,8,20,2,3,8,34,52,2,10,22,46,17,22,5,24,2,7,9,22,46
2004-10-25 00:00:00.000,St. Petersburg Russia ATP World Tour,HARD,2,Greg Rusedski,Marc Rosset,Greg Rusedski,6-4; 6-3,R32,70,12,6,33,62,28,33,17,29,5,5,10,45,62,5,4,28,54,18,28,15,26,0,2,9,33,54
2004-10-25 00:00:00.000,St. Petersburg Russia ATP World Tour,HARD,2,Alex Corretja,Paul-Henri Mathieu,Alex Corretja,6-4; 6-2,R32,73,9,2,24,44,21,24,15,20,0,0,9,36,44,6,5,26,57,21,26,14,31,0,3,9,35,57
2004-10-25 00:00:00.000,St. Petersburg Russia ATP World Tour,HARD,2,Ivo Karlovic,Dominik Hrbaty,Ivo Karlovic,7-6(5); 5-7; 6-4,R32,123,21,6,58,103,52,58,26,45,2,3,17,78,103,9,3,58,93,53,58,20,35,4,5,17,73,93
2004-10-25 00:00:00.000,St. Petersburg Russia ATP World Tour,HARD,2,Marat Safin,Sargis Sargsian,Marat Safin,6-4; 6-2,R16,77,5,1,31,55,21,31,18,24,0,0,9,39,55,6,5,41,69,26,41,14,28,4,7,9,40,69
2004-10-25 00:00:00.000,St. Petersburg Russia ATP World Tour,HARD,2,Michael Llodra,Michael Kohlmann,Michael Llodra,7-6(3); 6-3,R16,80,9,0,43,69,34,43,15,26,7,8,11,49,69,3,1,43,68,27,43,13,25,4,6,10,40,68
2004-10-25 00:00:00.000,St. Petersburg Russia ATP World Tour,HARD,2,Cyril Saulnier,Mardy Fish,Cyril Saulnier,6-7(6); 6-4; 6-3,R16,125,14,5,54,92,49,54,21,38,0,0,16,70,92,25,7,65,115,51,65,22,50,13,15,15,73,115
2004-10-25 00:00:00.000,St. Petersburg Russia ATP World Tour,HARD,2,Karol Beck,Nikolay Davydenko,Karol Beck,6-1; 6-7(4); 6-4,R16,120,6,4,55,98,42,55,21,43,5,8,15,63,98,2,5,68,90,40,68,12,22,4,10,14,52,90
2004-10-25 00:00:00.000,St. Petersburg Russia ATP World Tour,HARD,2,Julien Benneteau,Gilles Muller,Julien Benneteau,6-4; 7-5,R16,77,4,2,37,56,31,37,11,19,1,2,11,42,56,4,2,38,69,26,38,15,31,4,7,11,41,69
2004-10-25 00:00:00.000,St. Petersburg Russia ATP World Tour,HARD,2,Mikhail Youzhny,Max Mirnyi,Mikhail Youzhny,7-5; 3-6; 6-2,R16,111,7,2,59,84,46,59,12,25,6,8,14,58,84,11,9,51,92,39,51,16,41,2,6,15,55,92
2004-10-25 00:00:00.000,St. Petersburg Russia ATP World Tour,HARD,2,Greg Rusedski,Radek Stepanek,Greg Rusedski,7-6(1); 4-6; 6-4,R16,116,18,4,61,92,46,61,19,31,4,6,16,65,92,8,2,60,91,45,60,14,31,0,2,16,59,91
2004-10-25 00:00:00.000,St. Petersburg Russia ATP World Tour,HARD,2,Ivo Karlovic,Alex Corretja,Ivo Karlovic,7-6(3); 6-7(5); 7-6(8),R16,184,27,5,77,120,64,77,25,43,1,2,18,89,120,5,4,97,131,73,97,19,34,7,8,18,92,131
2004-10-25 00:00:00.000,St. Petersburg Russia ATP World Tour,HARD,2,Michael Llodra,Marat Safin,Michael Llodra,6-4; 6-1,Q,60,4,2,41,57,32,41,8,16,4,4,9,40,57,2,0,30,44,16,30,9,14,3,6,8,25,44
2004-10-25 00:00:00.000,St. Petersburg Russia ATP World Tour,HARD,2,Karol Beck,Cyril Saulnier,Karol Beck,6-3; 7-6(3),Q,92,10,3,43,71,33,43,15,28,4,6,11,48,71,5,2,29,64,21,29,19,35,3,6,10,40,64
2004-10-25 00:00:00.000,St. Petersburg Russia ATP World Tour,HARD,2,Mikhail Youzhny,Julien Benneteau,Mikhail Youzhny,6-0; 6-1,Q,50,2,1,21,33,15,21,11,12,3,3,6,26,33,1,2,26,44,9,26,5,18,3,9,7,14,44
2004-10-25 00:00:00.000,St. Petersburg Russia ATP World Tour,HARD,2,Greg Rusedski,Ivo Karlovic,Greg Rusedski,6-4; 7-6(7),Q,79,8,5,38,64,36,38,16,26,0,0,11,52,64,10,5,40,66,33,40,15,26,0,1,11,48,66
2004-10-25 00:00:00.000,St. Petersburg Russia ATP World Tour,HARD,2,Karol Beck,Michael Llodra,Karol Beck,6-4; 2-6; 6-1,S,103,6,7,48,95,36,48,19,47,4,7,13,55,95,8,4,54,78,34,54,12,24,8,12,12,46,78
2004-10-25 00:00:00.000,St. Petersburg Russia ATP World Tour,HARD,2,Mikhail Youzhny,Greg Rusedski,Mikhail Youzhny,3-6; 6-3; 6-4,S,91,2,1,46,73,38,46,16,27,0,1,14,54,73,5,3,43,78,36,43,19,35,8,10,14,55,78
2004-10-25 00:00:00.000,St. Petersburg Russia ATP World Tour,HARD,2,Mikhail Youzhny,Karol Beck,Mikhail Youzhny,6-2; 6-2,F,62,4,0,28,38,23,28,9,10,0,0,8,32,38,1,3,32,61,16,32,14,29,3,7,8,30,61
2004-10-25 00:00:00.000,Stockholm Sweden ATP World Tour,HARD,2,Andre Agassi,Kristof Vliegen,Andre Agassi,6-2; 6-4,R32,64,3,2,44,61,31,44,8,17,2,3,9,39,61,3,2,39,59,21,39,9,20,3,7,9,30,59
2004-10-25 00:00:00.000,Stockholm Sweden ATP World Tour,HARD,2,Jonas Bjorkman,Wayne Arthurs,Jonas Bjorkman,4-6; 6-4; 6-4,R32,124,7,1,55,91,39,55,27,36,5,6,15,66,91,17,6,58,95,45,58,18,37,4,6,15,63,95
2004-10-25 00:00:00.000,Stockholm Sweden ATP World Tour,HARD,2,Raemon Sluiter,Jan Frode Andersen,Raemon Sluiter,6-3; 6-4,R32,70,9,1,29,47,27,29,14,18,0,0,10,41,47,5,3,30,55,19,30,17,25,4,6,9,36,55
2004-10-25 00:00:00.000,Stockholm Sweden ATP World Tour,HARD,2,Fernando Verdasco,Robby Ginepri,Fernando Verdasco,6-2; 2-1 RET,R32,36,6,0,14,25,12,14,8,11,0,0,5,20,25,0,0,17,34,6,17,11,17,2,5,6,17,34
2004-10-25 00:00:00.000,Stockholm Sweden ATP World Tour,HARD,2,Tommy Haas,Davide Sanguinetti,Tommy Haas,7-6(5); 6-4,R32,88,3,3,43,77,34,43,15,34,7,8,11,49,77,11,3,50,78,37,50,11,28,4,6,11,48,78
2004-10-25 00:00:00.000,Stockholm Sweden ATP World Tour,HARD,2,Kenneth Carlsen,Ervin Eleskovic,Kenneth Carlsen,6-0; 6-1,R32,50,3,1,21,35,17,21,7,14,0,0,6,24,35,1,7,32,53,17,32,4,21,4,10,7,21,53
2004-10-25 00:00:00.000,Stockholm Sweden ATP World Tour,HARD,2,Olivier Rochus,Johan Settergren,Olivier Rochus,6-3; 6-2,R32,63,1,0,32,44,28,32,6,12,1,1,8,34,44,3,4,26,51,14,26,11,25,4,8,9,25,51
2004-10-25 00:00:00.000,Stockholm Sweden ATP World Tour,HARD,2,Janko Tipsarevic,Tomas Berdych,Janko Tipsarevic,3-6; 7-5; 6-1,R32,92,11,2,36,74,29,36,23,38,0,2,14,52,74,13,3,43,79,32,43,17,36,3,7,14,49,79
2004-10-25 00:00:00.000,Stockholm Sweden ATP World Tour,HARD,2,Robin Soderling,Thomas Enqvist,Robin Soderling,7-6(4); 6-3,R32,85,6,1,35,59,29,35,13,24,1,2,10,42,59,12,3,36,73,29,36,17,37,5,8,11,46,73
2004-10-25 00:00:00.000,Stockholm Sweden ATP World Tour,HARD,2,Thomas Johansson,Xavier Malisse,Thomas Johansson,7-6(4); 7-6(1),R32,116,6,0,47,87,40,47,20,40,7,8,12,60,87,7,1,45,80,34,45,18,35,1,2,12,52,80
2004-10-25 00:00:00.000,Stockholm Sweden ATP World Tour,HARD,2,Michal Tabara,Philipp Kohlschreiber,Michal Tabara,6-0; 6-4,R32,63,3,4,30,64,23,30,16,34,6,7,8,39,64,4,5,26,54,14,26,9,28,5,10,8,23,54
2004-10-25 00:00:00.000,Stockholm Sweden ATP World Tour,HARD,2,Andrei Pavel,Agustin Calleri,Andrei Pavel,6-4; 7-6(4),R32,92,7,0,44,74,36,44,15,30,3,5,11,51,74,10,2,52,76,38,52,9,24,5,8,11,47,76
2004-10-25 00:00:00.000,Stockholm Sweden ATP World Tour,HARD,2,Feliciano Lopez,Jeff Morrison,Feliciano Lopez,7-6(5); 7-5,R32,90,8,3,40,77,33,40,24,37,1,1,12,57,77,7,7,43,80,34,43,18,37,6,7,12,52,80
2004-10-25 00:00:00.000,Stockholm Sweden ATP World Tour,HARD,2,Michael Ryderstedt,Oscar Hernandez,Michael Ryderstedt,6-4; 6-4,R32,78,5,1,30,55,24,30,15,25,1,2,10,39,55,7,2,40,72,29,40,11,32,6,9,10,40,72
2004-10-25 00:00:00.000,Stockholm Sweden ATP World Tour,HARD,2,Jan-Michael Gambill,Jarkko Nieminen,Jan-Michael Gambill,7-6(5); 3-6; 6-2,R32,132,19,1,74,99,50,74,11,25,3,5,14,61,99,5,6,63,112,42,63,21,49,8,11,15,63,112
2004-10-25 00:00:00.000,Stockholm Sweden ATP World Tour,HARD,2,Joachim Johansson,Adrian Garcia,Joachim Johansson,6-4; 6-2,R32,61,12,0,32,42,28,32,8,10,0,0,9,36,42,3,3,32,59,22,32,13,27,4,7,9,35,59
2004-10-25 00:00:00.000,Stockholm Sweden ATP World Tour,HARD,2,Andre Agassi,Jonas Bjorkman,Andre Agassi,6-3; 6-4,R16,71,10,2,31,58,22,31,17,27,3,5,10,39,58,13,2,35,58,26,35,5,23,5,9,9,31,58
2004-10-25 00:00:00.000,Stockholm Sweden ATP World Tour,HARD,2,Fernando Verdasco,Raemon Sluiter,Fernando Verdasco,6-4; 6-2,R16,71,6,2,38,59,31,38,9,21,3,3,9,40,59,2,4,29,57,17,29,14,28,2,5,9,31,57
2004-10-25 00:00:00.000,Stockholm Sweden ATP World Tour,HARD,2,Tommy Haas,Kenneth Carlsen,Tommy Haas,7-5; 7-5,R16,84,9,1,37,63,31,37,15,26,0,1,12,46,63,6,1,48,69,35,48,9,21,1,4,12,44,69
2004-10-25 00:00:00.000,Stockholm Sweden ATP World Tour,HARD,2,Olivier Rochus,Janko Tipsarevic,Olivier Rochus,6-4; 7-5,R16,95,3,4,38,71,32,38,16,33,4,5,11,48,71,14,1,40,72,31,40,10,32,3,6,11,41,72
2004-10-25 00:00:00.000,Stockholm Sweden ATP World Tour,HARD,2,Thomas Johansson,Robin Soderling,Thomas Johansson,1-6; 7-6(2); 6-4,R16,112,9,1,51,91,37,51,25,40,2,4,14,62,91,10,3,59,89,42,59,21,30,5,6,15,63,89
2004-10-25 00:00:00.000,Stockholm Sweden ATP World Tour,HARD,2,Andrei Pavel,Michal Tabara,Andrei Pavel,6-3; 3-6; 6-3,R16,105,15,1,62,92,46,62,17,30,9,10,14,63,92,6,6,36,84,28,36,25,48,5,7,13,53,84
2004-10-25 00:00:00.000,Stockholm Sweden ATP World Tour,HARD,2,Michael Ryderstedt,Feliciano Lopez,Michael Ryderstedt,6-4; 6-7(4); 6-3,R16,126,13,0,67,105,49,67,20,38,8,10,16,69,105,15,3,70,111,48,70,19,41,11,15,15,67,111
2004-10-25 00:00:00.000,Stockholm Sweden ATP World Tour,HARD,2,Joachim Johansson,Jan-Michael Gambill,Joachim Johansson,6-4; 6-4,R16,75,16,2,36,49,34,36,6,13,0,0,10,40,49,12,3,40,70,29,40,14,30,7,9,10,43,70
2004-10-25 00:00:00.000,Stockholm Sweden ATP World Tour,HARD,2,Andre Agassi,Fernando Verdasco,Andre Agassi,7-6(4); 6-2,Q,65,6,2,44,59,37,44,8,15,0,0,10,45,59,12,2,36,61,27,36,14,25,2,4,10,41,61
2004-10-25 00:00:00.000,Stockholm Sweden ATP World Tour,HARD,2,Tommy Haas,Olivier Rochus,Tommy Haas,6-3; 7-6(4),Q,89,12,1,33,62,27,33,17,29,0,2,11,44,62,0,0,42,70,21,42,19,28,0,3,10,40,70
2004-10-25 00:00:00.000,Stockholm Sweden ATP World Tour,HARD,2,Thomas Johansson,Andrei Pavel,Thomas Johansson,7-6(4); 7-5,Q,105,11,1,53,80,44,53,14,27,2,2,12,58,80,7,2,40,69,32,40,19,29,0,1,12,51,69
2004-10-25 00:00:00.000,Stockholm Sweden ATP World Tour,HARD,2,Michael Ryderstedt,Joachim Johansson,Michael Ryderstedt,3-6; 5-3 RET,Q,55,4,3,31,46,27,31,5,15,1,2,8,32,46,11,1,31,43,26,31,8,12,0,1,9,34,43
2004-10-25 00:00:00.000,Stockholm Sweden ATP World Tour,HARD,2,Andre Agassi,Tommy Haas,Andre Agassi,7-6(5); 7-6(4),S,114,8,1,55,83,40,55,16,28,5,6,12,56,83,8,3,57,92,41,57,16,35,5,6,12,57,92
2004-10-25 00:00:00.000,Stockholm Sweden ATP World Tour,HARD,2,Thomas Johansson,Michael Ryderstedt,Thomas Johansson,6-3; 6-2,S,51,7,1,28,43,25,28,11,15,0,0,9,36,43,5,4,25,44,19,25,7,19,2,5,8,26,44
2004-10-25 00:00:00.000,Stockholm Sweden ATP World Tour,HARD,2,Thomas Johansson,Andre Agassi,Thomas Johansson,3-6; 6-3; 7-6(4),F,114,17,3,55,93,38,55,19,38,4,8,15,57,93,8,2,56,91,38,56,16,35,5,9,15,54,91
2004-11-01 00:00:00.000,ATP Masters Series Paris France ATP World Tour,HARD,2,Andy Roddick,N/A Bye,Andy Roddick,,R64,0,0,0,0,0,0,0,0,0,0,0,0,0,0,0,0,0,0,0,0,0,0,0,0,0,0,0
2004-11-01 00:00:00.000,ATP Masters Series Paris France ATP World Tour,HARD,2,Sargis Sargsian,Thomas Johansson,Sargis Sargsian,7-5; 6-2,R64,77,5,1,39,59,30,39,11,20,4,5,10,41,59,5,2,36,71,24,36,16,35,5,9,10,40,71
2004-11-01 00:00:00.000,ATP Masters Series Paris France ATP World Tour,HARD,2,Max Mirnyi,Hicham Arazi,Max Mirnyi,6-3; 6-0,R64,56,5,2,30,44,25,30,8,14,1,1,8,33,44,1,2,29,50,16,29,8,21,4,8,7,24,50
2004-11-01 00:00:00.000,ATP Masters Series Paris France ATP World Tour,HARD,2,Fernando Gonzalez,N/A Bye,Fernando Gonzalez,,R64,0,0,0,0,0,0,0,0,0,0,0,0,0,0,0,0,0,0,0,0,0,0,0,0,0,0,0
2004-11-01 00:00:00.000,ATP Masters Series Paris France ATP World Tour,HARD,2,Dominik Hrbaty,N/A Bye,Dominik Hrbaty,,R64,0,0,0,0,0,0,0,0,0,0,0,0,0,0,0,0,0,0,0,0,0,0,0,0,0,0,0
2004-11-01 00:00:00.000,ATP Masters Series Paris France ATP World Tour,HARD,2,Cyril Saulnier,Luis Horna,Cyril Saulnier,7-6(6); 7-6(0),R64,116,16,3,53,84,44,53,19,31,0,0,12,63,84,13,3,55,93,44,55,19,38,5,5,12,63,93
2004-11-01 00:00:00.000,ATP Masters Series Paris France ATP World Tour,HARD,2,Robin Soderling,Taylor Dent,Robin Soderling,6-2; 6-4,R64,59,4,3,30,47,23,30,10,17,0,1,9,33,47,2,2,34,52,19,34,9,18,5,9,9,28,52
2004-11-01 00:00:00.000,ATP Masters Series Paris France ATP World Tour,HARD,2,Davide Sanguinetti,N/A Bye,Davide Sanguinetti,,R64,0,0,0,0,0,0,0,0,0,0,0,0,0,0,0,0,0,0,0,0,0,0,0,0,0,0,0
2004-11-01 00:00:00.000,ATP Masters Series Paris France ATP World Tour,HARD,2,Tim Henman,N/A Bye,Tim Henman,,R64,0,0,0,0,0,0,0,0,0,0,0,0,0,0,0,0,0,0,0,0,0,0,0,0,0,0,0
2004-11-01 00:00:00.000,ATP Masters Series Paris France ATP World Tour,HARD,2,Paradorn Srichaphan,Mariano Zabaleta,Paradorn Srichaphan,7-6(3); 6-4,R64,81,7,5,32,67,26,32,25,35,0,0,11,51,67,3,1,41,66,30,41,16,25,2,3,11,46,66
2004-11-01 00:00:00.000,ATP Masters Series Paris France ATP World Tour,HARD,2,Mikhail Youzhny,Jonas Bjorkman,Mikhail Youzhny,6-2; 7-6(2),R64,85,5,3,44,66,36,44,12,22,3,4,10,48,66,0,5,26,70,20,26,20,44,4,7,10,40,70
2004-11-01 00:00:00.000,ATP Masters Series Paris France ATP World Tour,HARD,2,Jiri Novak,N/A Bye,Jiri Novak,,R64,0,0,0,0,0,0,0,0,0,0,0,0,0,0,0,0,0,0,0,0,0,0,0,0,0,0,0
2004-11-01 00:00:00.000,ATP Masters Series Paris France ATP World Tour,HARD,2,Vincent Spadea,N/A Bye,Vincent Spadea,,R64,0,0,0,0,0,0,0,0,0,0,0,0,0,0,0,0,0,0,0,0,0,0,0,0,0,0,0
2004-11-01 00:00:00.000,ATP Masters Series Paris France ATP World Tour,HARD,2,Nikolay Davydenko,Fernando Verdasco,Nikolay Davydenko,6-2; 6-3,R64,55,2,0,22,39,21,22,11,17,0,0,8,32,39,5,3,30,59,19,30,12,29,1,5,9,31,59
2004-11-01 00:00:00.000,ATP Masters Series Paris France ATP World Tour,HARD,2,Radek Stepanek,Michael Llodra,Radek Stepanek,7-6(2); 6-1,R64,79,5,1,46,68,35,46,10,22,1,2,10,45,68,3,1,35,58,20,35,13,23,1,4,9,33,58
2004-11-01 00:00:00.000,ATP Masters Series Paris France ATP World Tour,HARD,2,Victor Hanescu,N/A Bye,Victor Hanescu,,R64,0,0,0,0,0,0,0,0,0,0,0,0,0,0,0,0,0,0,0,0,0,0,0,0,0,0,0
2004-11-01 00:00:00.000,ATP Masters Series Paris France ATP World Tour,HARD,2,Gaston Gaudio,N/A Bye,Gaston Gaudio,,R64,0,0,0,0,0,0,0,0,0,0,0,0,0,0,0,0,0,0,0,0,0,0,0,0,0,0,0
2004-11-01 00:00:00.000,ATP Masters Series Paris France ATP World Tour,HARD,2,Feliciano Lopez,Rainer Schuettler,Feliciano Lopez,7-6(3); 6-4,R64,75,10,1,51,77,40,51,14,26,2,2,11,54,77,4,1,36,68,28,36,20,32,3,4,11,48,68
2004-11-01 00:00:00.000,ATP Masters Series Paris France ATP World Tour,HARD,2,Mardy Fish,David Ferrer,Mardy Fish,6-3; 3-6; 6-2,R64,102,5,5,40,81,32,40,24,41,6,7,13,56,81,4,8,38,80,30,38,19,42,6,9,13,49,80
2004-11-01 00:00:00.000,ATP Masters Series Paris France ATP World Tour,HARD,2,Andrei Pavel,N/A Bye,Andrei Pavel,,R64,0,0,0,0,0,0,0,0,0,0,0,0,0,0,0,0,0,0,0,0,0,0,0,0,0,0,0
2004-11-01 00:00:00.000,ATP Masters Series Paris France ATP World Tour,HARD,2,Guillermo Canas,N/A Bye,Guillermo Canas,,R64,0,0,0,0,0,0,0,0,0,0,0,0,0,0,0,0,0,0,0,0,0,0,0,0,0,0,0
2004-11-01 00:00:00.000,ATP Masters Series Paris France ATP World Tour,HARD,2,Jo-Wilfried Tsonga,Mario Ancic,Jo-Wilfried Tsonga,4-6; 7-6(5); 6-3,R64,122,11,3,70,103,55,70,16,33,5,6,15,71,103,7,3,57,89,46,57,19,32,0,2,16,65,89
2004-11-01 00:00:00.000,ATP Masters Series Paris France ATP World Tour,HARD,2,Xavier Malisse,Paul-Henri Mathieu,Xavier Malisse,7-5; 6-4,R64,87,9,1,37,56,32,37,11,19,2,3,11,43,56,0,1,23,67,17,23,23,44,3,6,11,40,67
2004-11-01 00:00:00.000,ATP Masters Series Paris France ATP World Tour,HARD,2,Tommy Haas,N/A Bye,Tommy Haas,,R64,0,0,0,0,0,0,0,0,0,0,0,0,0,0,0,0,0,0,0,0,0,0,0,0,0,0,0
2004-11-01 00:00:00.000,ATP Masters Series Paris France ATP World Tour,HARD,2,Marat Safin,N/A Bye,Marat Safin,,R64,0,0,0,0,0,0,0,0,0,0,0,0,0,0,0,0,0,0,0,0,0,0,0,0,0,0,0
2004-11-01 00:00:00.000,ATP Masters Series Paris France ATP World Tour,HARD,2,Ivan Ljubicic,Arnaud Clement,Ivan Ljubicic,6-3; 7-6(4),R64,105,13,2,35,69,31,35,18,34,3,4,11,49,69,3,3,37,71,28,37,15,34,3,5,10,43,71
2004-11-01 00:00:00.000,ATP Masters Series Paris France ATP World Tour,HARD,2,Jurgen Melzer,Juan Ignacio Chela,Jurgen Melzer,6-1; 6-4,R64,54,1,1,22,51,20,22,17,29,1,1,9,37,51,4,1,34,41,23,34,2,7,1,4,8,25,41
2004-11-01 00:00:00.000,ATP Masters Series Paris France ATP World Tour,HARD,2,Tommy Robredo,N/A Bye,Tommy Robredo,,R64,0,0,0,0,0,0,0,0,0,0,0,0,0,0,0,0,0,0,0,0,0,0,0,0,0,0,0
2004-11-01 00:00:00.000,ATP Masters Series Paris France ATP World Tour,HARD,2,Nicolas Massu,N/A Bye,Nicolas Massu,,R64,0,0,0,0,0,0,0,0,0,0,0,0,0,0,0,0,0,0,0,0,0,0,0,0,0,0,0
2004-11-01 00:00:00.000,ATP Masters Series Paris France ATP World Tour,HARD,2,Christophe Rochus,Filippo Volandri,Christophe Rochus,2-6; 6-4; 4-1 RET,R64,97,3,4,63,104,40,63,16,41,14,18,12,56,104,0,4,35,63,21,35,16,28,3,7,11,37,63
2004-11-01 00:00:00.000,ATP Masters Series Paris France ATP World Tour,HARD,2,Gael Monfils,Thomas Enqvist,Gael Monfils,1-6; 6-4; 6-3,R64,113,9,3,36,71,29,36,17,35,4,7,13,46,71,6,5,62,102,41,62,21,40,3,6,13,62,102
2004-11-01 00:00:00.000,ATP Masters Series Paris France ATP World Tour,HARD,2,Lleyton Hewitt,N/A Bye,Lleyton Hewitt,,R64,0,0,0,0,0,0,0,0,0,0,0,0,0,0,0,0,0,0,0,0,0,0,0,0,0,0,0
2004-11-01 00:00:00.000,ATP Masters Series Paris France ATP World Tour,HARD,2,Andy Roddick,Sargis Sargsian,Andy Roddick,6-2; 6-2,R32,52,7,0,28,39,24,28,8,11,0,0,8,32,39,4,3,32,51,19,32,7,19,3,7,8,26,51
2004-11-01 00:00:00.000,ATP Masters Series Paris France ATP World Tour,HARD,2,Max Mirnyi,Fernando Gonzalez,Max Mirnyi,7-6(8); 6-3,R32,77,8,0,46,67,34,46,12,21,4,5,10,46,67,5,8,37,65,31,37,12,28,1,4,11,43,65
2004-11-01 00:00:00.000,ATP Masters Series Paris France ATP World Tour,HARD,2,Cyril Saulnier,Dominik Hrbaty,Cyril Saulnier,7-6(4); 6-2,R32,82,8,0,36,73,27,36,21,37,6,7,10,48,73,0,3,38,61,24,38,12,23,1,4,10,36,61
2004-11-01 00:00:00.000,ATP Masters Series Paris France ATP World Tour,HARD,2,Robin Soderling,Davide Sanguinetti,Robin Soderling,4-6; 7-6(6); 6-0,R32,112,6,1,62,92,43,62,18,30,7,9,14,61,92,14,2,58,102,37,58,26,44,7,11,14,63,102
2004-11-01 00:00:00.000,ATP Masters Series Paris France ATP World Tour,HARD,2,Tim Henman,Paradorn Srichaphan,Tim Henman,6-3; 6-4,R32,64,5,1,28,47,24,28,16,19,0,0,10,40,47,3,3,36,61,26,36,11,25,2,4,9,37,61
2004-11-01 00:00:00.000,ATP Masters Series Paris France ATP World Tour,HARD,2,Mikhail Youzhny,Jiri Novak,Mikhail Youzhny,6-3; 7-5,R32,75,3,0,36,63,27,36,18,27,7,7,10,45,63,1,1,41,69,28,41,11,28,2,5,11,39,69
2004-11-01 00:00:00.000,ATP Masters Series Paris France ATP World Tour,HARD,2,Vincent Spadea,Nikolay Davydenko,Vincent Spadea,7-6(4); 6-0,R32,79,3,0,37,64,26,37,16,27,3,4,9,42,64,1,1,39,65,20,39,12,26,5,9,9,32,65
2004-11-01 00:00:00.000,ATP Masters Series Paris France ATP World Tour,HARD,2,Radek Stepanek,Victor Hanescu,Radek Stepanek,6-4; 6-1,R32,54,6,1,29,39,24,29,8,10,0,0,8,32,39,5,4,36,58,25,36,5,22,1,5,9,30,58
2004-11-01 00:00:00.000,ATP Masters Series Paris France ATP World Tour,HARD,2,Feliciano Lopez,Gaston Gaudio,Feliciano Lopez,7-5; 3-6; 6-1,R32,101,14,4,43,77,33,43,21,34,0,1,14,54,77,7,4,51,85,35,51,19,34,5,8,14,54,85
2004-11-01 00:00:00.000,ATP Masters Series Paris France ATP World Tour,HARD,2,Andrei Pavel,Mardy Fish,Andrei Pavel,7-6(3); 6-4,R32,82,11,1,35,63,29,35,19,28,0,0,11,48,63,12,0,31,61,25,31,19,30,1,2,11,44,61
2004-11-01 00:00:00.000,ATP Masters Series Paris France ATP World Tour,HARD,2,Guillermo Canas,Jo-Wilfried Tsonga,Guillermo Canas,6-1; 6-3,R32,70,5,0,27,47,19,27,14,20,2,3,8,33,47,2,3,34,61,23,34,6,27,7,12,8,29,61
2004-11-01 00:00:00.000,ATP Masters Series Paris France ATP World Tour,HARD,2,Tommy Haas,Xavier Malisse,Tommy Haas,6-1; 7-6(1),R32,53,5,2,34,59,30,34,16,25,0,0,10,46,59,3,0,43,58,25,43,11,15,3,5,9,36,58
2004-11-01 00:00:00.000,ATP Masters Series Paris France ATP World Tour,HARD,2,Marat Safin,Ivan Ljubicic,Marat Safin,6-7(1); 6-3; 7-5,R32,145,13,3,53,104,38,53,34,51,4,5,17,72,104,17,4,53,98,44,53,21,45,3,6,16,65,98
2004-11-01 00:00:00.000,ATP Masters Series Paris France ATP World Tour,HARD,2,Jurgen Melzer,Tommy Robredo,Jurgen Melzer,6-3; 3-6; 6-1,R32,105,1,7,45,89,33,45,23,44,4,6,13,56,89,1,4,38,73,24,38,17,35,2,6,12,41,73
2004-11-01 00:00:00.000,ATP Masters Series Paris France ATP World Tour,HARD,2,Nicolas Massu,Christophe Rochus,Nicolas Massu,6-2; 7-6(4),R32,118,12,1,49,78,34,49,16,29,3,4,10,50,78,1,0,39,77,24,39,19,38,1,4,10,43,77
2004-11-01 00:00:00.000,ATP Masters Series Paris France ATP World Tour,HARD,2,Lleyton Hewitt,Gael Monfils,Lleyton Hewitt,6-3; 7-6(3),R32,116,5,8,43,85,31,43,19,42,1,4,11,50,85,11,7,41,84,30,41,12,43,5,9,10,42,84
2004-11-01 00:00:00.000,ATP Masters Series Paris France ATP World Tour,HARD,2,Max Mirnyi,Andy Roddick,Max Mirnyi,7-6(2); 6-2,R16,65,14,1,34,52,30,34,14,18,0,0,10,44,52,13,1,35,61,25,35,12,26,1,3,10,37,61
2004-11-01 00:00:00.000,ATP Masters Series Paris France ATP World Tour,HARD,2,Robin Soderling,Cyril Saulnier,Robin Soderling,7-6(4); 6-2,R16,83,5,3,40,67,31,40,14,27,3,4,10,45,67,7,3,39,69,26,39,13,30,4,7,10,39,69
2004-11-01 00:00:00.000,ATP Masters Series Paris France ATP World Tour,HARD,2,Mikhail Youzhny,Tim Henman,Mikhail Youzhny,7-5; 6-1,R16,73,1,1,34,55,23,34,11,21,2,3,9,34,55,1,2,27,51,16,27,12,24,2,7,10,28,51
2004-11-01 00:00:00.000,ATP Masters Series Paris France ATP World Tour,HARD,2,Radek Stepanek,Vincent Spadea,Radek Stepanek,6-2; 6-3,R16,60,3,0,28,44,24,28,10,16,1,1,8,34,44,2,4,32,57,17,32,13,25,3,7,9,30,57
2004-11-01 00:00:00.000,ATP Masters Series Paris France ATP World Tour,HARD,2,Feliciano Lopez,Andrei Pavel,Feliciano Lopez,5-7; 6-4; 6-4,R16,114,18,1,54,83,43,54,20,29,1,2,16,63,83,7,3,55,102,42,55,25,47,5,7,16,67,102
2004-11-01 00:00:00.000,ATP Masters Series Paris France ATP World Tour,HARD,2,Guillermo Canas,Tommy Haas,Guillermo Canas,7-6(4); 6-2,R16,96,6,1,35,67,28,35,18,32,2,3,10,46,67,5,5,29,60,21,29,15,31,0,3,10,36,60
2004-11-01 00:00:00.000,ATP Masters Series Paris France ATP World Tour,HARD,2,Marat Safin,Jurgen Melzer,Marat Safin,6-2; 7-5,R16,80,8,0,30,51,27,30,15,21,3,3,10,42,51,2,2,44,76,28,44,14,32,9,12,10,42,76
2004-11-01 00:00:00.000,ATP Masters Series Paris France ATP World Tour,HARD,2,Lleyton Hewitt,Nicolas Massu,Lleyton Hewitt,4-3 RET,R16,31,1,0,7,22,5,7,12,15,1,1,4,17,22,1,1,14,20,11,14,2,6,2,2,3,13,20
2004-11-01 00:00:00.000,ATP Masters Series Paris France ATP World Tour,HARD,2,Max Mirnyi,Robin Soderling,Max Mirnyi,6-7(5); 6-4; 7-6(5),Q,152,11,4,72,111,55,72,20,39,4,6,17,75,111,7,4,74,125,53,74,26,51,5,8,17,79,125
2004-11-01 00:00:00.000,ATP Masters Series Paris France ATP World Tour,HARD,2,Radek Stepanek,Mikhail Youzhny,Radek Stepanek,7-6(1); 6-3,Q,87,7,6,49,71,41,49,10,22,2,2,11,51,71,2,0,34,61,28,34,13,27,5,6,10,41,61
2004-11-01 00:00:00.000,ATP Masters Series Paris France ATP World Tour,HARD,2,Guillermo Canas,Feliciano Lopez,Guillermo Canas,6-3; 6-3,Q,75,6,0,26,50,21,26,18,24,2,2,9,39,50,6,3,37,55,29,37,5,18,2,5,9,34,55
2004-11-01 00:00:00.000,ATP Masters Series Paris France ATP World Tour,HARD,2,Marat Safin,Lleyton Hewitt,Marat Safin,6-4; 7-6(2),Q,100,10,1,46,79,37,46,17,33,5,6,11,54,79,2,4,30,66,23,30,18,36,0,2,11,41,66
2004-11-01 00:00:00.000,ATP Masters Series Paris France ATP World Tour,HARD,2,Radek Stepanek,Max Mirnyi,Radek Stepanek,3-6; 7-6(1); 6-4,S,132,13,5,61,90,50,61,15,29,1,2,15,65,90,16,4,60,101,45,60,22,41,0,1,16,67,101
2004-11-01 00:00:00.000,ATP Masters Series Paris France ATP World Tour,HARD,2,Marat Safin,Guillermo Canas,Marat Safin,6-2; 7-6(5),S,100,7,3,30,64,26,30,19,34,1,2,10,45,64,4,0,32,62,21,32,16,30,4,7,10,37,62
2004-11-01 00:00:00.000,ATP Masters Series Paris France ATP World Tour,HARD,2,Marat Safin,Radek Stepanek,Marat Safin,6-3; 7-6(5); 6-3,F,139,16,3,62,101,48,62,23,39,5,6,16,71,101,11,4,56,103,43,56,21,47,4,7,14,64,103
