event_time,event_name,surface,num_of_sets,playerA,playerB,winner,score,round,duration_minutes,a_aces,a_double_faults,a_first_serve_hits,a_first_serve_total,a_first_serve_won,a_first_serve_played,a_second_serve_won,a_second_serve_played,a_break_points_saved,a_break_points_total,a_service_games,a_service_points_won,a_service_points_total,b_aces,b_double_faults,b_first_serve_hits,b_first_serve_total,b_first_serve_won,b_first_serve_played,b_second_serve_won,b_second_serve_played,b_break_points_saved,b_break_points_total,b_service_games,b_service_points_won,b_service_points_total
2005-01-03 00:00:00.000,Adelaide Adelaide; Australia ATP World Tour,HARD,2,Lleyton Hewitt,Arnaud Clement,Lleyton Hewitt,2-6; 6-1; 6-1,R32,93,8,1,33,56,26,33,13,23,0,2,11,39,56,5,3,54,90,29,54,17,36,9,14,11,46,90
2005-01-03 00:00:00.000,Adelaide Adelaide; Australia ATP World Tour,HARD,2,Agustin Calleri,Jarkko Nieminen,Agustin Calleri,6-4; 3-6; 7-6(2),R32,118,5,6,53,97,36,53,23,44,5,9,15,59,97,2,3,64,101,41,64,19,37,2,6,16,60,101
2005-01-03 00:00:00.000,Adelaide Adelaide; Australia ATP World Tour,HARD,2,Julien Benneteau,Potito Starace,Julien Benneteau,6-3; 6-4,R32,72,1,0,48,64,32,48,7,16,2,5,10,39,64,3,4,40,49,20,40,3,9,4,9,9,23,49
2005-01-03 00:00:00.000,Adelaide Adelaide; Australia ATP World Tour,HARD,2,Taylor Dent,Robby Ginepri,Taylor Dent,6-1; 2-6; 6-2,R32,96,3,9,42,80,32,42,18,38,8,10,11,50,80,0,6,51,81,29,51,11,30,9,14,12,40,81
2005-01-03 00:00:00.000,Adelaide Adelaide; Australia ATP World Tour,HARD,2,Juan Ignacio Chela,Sargis Sargsian,Juan Ignacio Chela,6-1; 6-1,R32,57,4,1,27,36,23,27,6,9,0,0,7,29,36,3,3,40,59,19,40,7,19,9,14,7,26,59
2005-01-03 00:00:00.000,Adelaide Adelaide; Australia ATP World Tour,HARD,2,Jean-Rene Lisnard,Sebastien De Chaunac,Jean-Rene Lisnard,6-4; 7-6(4),R32,110,2,6,39,77,31,39,20,38,1,2,11,51,77,1,4,48,78,32,48,15,30,5,7,11,47,78
2005-01-03 00:00:00.000,Adelaide Adelaide; Australia ATP World Tour,HARD,2,Amer Delic,Todd Reid,Amer Delic,3-6; 7-5; 6-2,R32,94,9,4,40,78,31,40,23,38,6,8,14,54,78,2,1,78,104,45,78,16,26,11,15,15,61,104
2005-01-03 00:00:00.000,Adelaide Adelaide; Australia ATP World Tour,HARD,2,Jurgen Melzer,Tomas Berdych,Jurgen Melzer,6-4; 4-6; 6-3,R32,122,6,3,63,111,44,63,24,48,5,8,15,68,111,11,8,60,99,40,60,17,39,12,16,14,57,99
2005-01-03 00:00:00.000,Adelaide Adelaide; Australia ATP World Tour,HARD,2,Radek Stepanek,Philipp Kohlschreiber,Radek Stepanek,6-3; 6-4,R32,84,2,3,25,49,21,25,12,24,0,2,10,33,49,0,4,51,70,32,51,5,19,4,8,9,37,70
2005-01-03 00:00:00.000,Adelaide Adelaide; Australia ATP World Tour,HARD,2,Olivier Rochus,Antony Dupuis,Olivier Rochus,3-6; 6-3; 6-1,R32,95,3,3,37,64,29,37,16,27,3,5,12,45,64,10,3,62,95,41,62,10,33,7,12,13,51,95
2005-01-03 00:00:00.000,Adelaide Adelaide; Australia ATP World Tour,HARD,2,Cyril Saulnier,Paul Baccanello,Cyril Saulnier,6-2; 7-6(3),R32,84,9,1,35,55,30,35,14,20,0,0,10,44,55,7,1,42,67,26,42,15,25,3,5,10,41,67
2005-01-03 00:00:00.000,Adelaide Adelaide; Australia ATP World Tour,HARD,2,Nicolas Kiefer,Sjeng Schalken,Nicolas Kiefer,6-2; 4-6; 6-3,R32,131,5,3,47,80,29,47,14,33,4,10,14,43,80,0,2,65,91,28,65,14,26,10,18,13,42,91
2005-01-03 00:00:00.000,Adelaide Adelaide; Australia ATP World Tour,HARD,2,Florian Mayer,Wayne Arthurs,Florian Mayer,6-4; 3-6; 7-5,R32,112,6,4,55,96,42,55,20,41,7,9,15,62,96,17,2,48,93,40,48,22,45,3,6,16,62,93
2005-01-03 00:00:00.000,Adelaide Adelaide; Australia ATP World Tour,HARD,2,Thomas Enqvist,Raemon Sluiter,Thomas Enqvist,6-3; 6-1,R32,67,8,0,27,43,22,27,12,16,0,0,8,34,43,12,11,40,78,30,40,9,38,9,13,8,39,78
2005-01-03 00:00:00.000,Adelaide Adelaide; Australia ATP World Tour,HARD,2,Xavier Malisse,Alberto Martin,Xavier Malisse,6-2; 7-6(1),R32,92,11,4,40,69,31,40,16,29,2,3,10,47,69,2,5,35,62,27,35,10,27,1,4,10,37,62
2005-01-03 00:00:00.000,Adelaide Adelaide; Australia ATP World Tour,HARD,2,Joachim Johansson,Marc Kimmich,Joachim Johansson,6-2; 6-4,R32,74,7,6,34,58,30,34,11,24,1,1,9,41,58,1,6,33,59,24,33,8,26,2,5,9,32,59
2005-01-03 00:00:00.000,Adelaide Adelaide; Australia ATP World Tour,HARD,2,Lleyton Hewitt,Agustin Calleri,Lleyton Hewitt,6-1; 6-4,R16,61,7,2,33,54,27,33,11,21,2,3,9,38,54,1,1,21,47,10,21,12,26,2,6,8,22,47
2005-01-03 00:00:00.000,Adelaide Adelaide; Australia ATP World Tour,HARD,2,Taylor Dent,Julien Benneteau,Taylor Dent,4-6; 6-1; 6-2,R16,98,9,5,43,79,32,43,17,36,1,4,13,49,79,5,3,55,84,30,55,11,29,7,13,12,41,84
2005-01-03 00:00:00.000,Adelaide Adelaide; Australia ATP World Tour,HARD,2,Juan Ignacio Chela,Jean-Rene Lisnard,Juan Ignacio Chela,7-5; 7-5,R16,109,6,0,54,80,41,54,11,26,7,9,12,52,80,0,8,36,80,26,36,19,44,3,7,12,45,80
2005-01-03 00:00:00.000,Adelaide Adelaide; Australia ATP World Tour,HARD,2,Jurgen Melzer,Amer Delic,Jurgen Melzer,6-3; 6-3,R16,61,3,1,39,64,29,39,12,25,2,3,9,41,64,3,3,29,48,18,29,8,19,4,8,9,26,48
2005-01-03 00:00:00.000,Adelaide Adelaide; Australia ATP World Tour,HARD,2,Olivier Rochus,Radek Stepanek,Olivier Rochus,6-0; 6-3,R16,67,1,0,28,50,15,28,17,22,3,4,7,32,50,1,5,28,44,14,28,3,16,2,8,8,17,44
2005-01-03 00:00:00.000,Adelaide Adelaide; Australia ATP World Tour,HARD,2,Nicolas Kiefer,Cyril Saulnier,Nicolas Kiefer,6-4; 6-3,R16,78,1,2,24,46,21,24,16,22,0,0,9,37,46,1,2,28,57,18,28,14,29,1,4,10,32,57
2005-01-03 00:00:00.000,Adelaide Adelaide; Australia ATP World Tour,HARD,2,Thomas Enqvist,Florian Mayer,Thomas Enqvist,6-3; 6-3,R16,65,2,5,31,65,21,31,19,34,5,6,9,40,65,3,1,33,55,22,33,7,22,0,4,9,29,55
2005-01-03 00:00:00.000,Adelaide Adelaide; Australia ATP World Tour,HARD,2,Joachim Johansson,Xavier Malisse,Joachim Johansson,6-7(4); 6-3; 7-6(2),R16,148,14,6,64,100,51,64,20,36,2,3,16,71,100,12,3,64,115,48,64,25,51,7,10,17,73,115
2005-01-03 00:00:00.000,Adelaide Adelaide; Australia ATP World Tour,HARD,2,Taylor Dent,Lleyton Hewitt,Taylor Dent,7-6(4); 6-3,Q,86,5,4,41,81,36,41,19,40,4,5,11,55,81,3,2,38,63,28,38,15,25,1,3,10,43,63
2005-01-03 00:00:00.000,Adelaide Adelaide; Australia ATP World Tour,HARD,2,Juan Ignacio Chela,Jurgen Melzer,Juan Ignacio Chela,7-6(3); 5-7; 6-2,Q,123,0,1,73,97,52,73,13,24,4,8,16,65,97,8,3,61,106,41,61,19,45,5,10,16,60,106
2005-01-03 00:00:00.000,Adelaide Adelaide; Australia ATP World Tour,HARD,2,Olivier Rochus,Nicolas Kiefer,Olivier Rochus,6-7(4); 7-6(6); 7-5,Q,187,3,7,71,130,42,71,34,59,5,10,18,76,130,12,8,60,120,42,60,29,60,7,13,18,71,120
2005-01-03 00:00:00.000,Adelaide Adelaide; Australia ATP World Tour,HARD,2,Joachim Johansson,Thomas Enqvist,Joachim Johansson,6-3; 4-6; 6-1,Q,99,14,7,38,72,33,38,19,34,4,5,13,52,72,10,9,41,88,30,41,22,47,7,11,13,52,88
2005-01-03 00:00:00.000,Adelaide Adelaide; Australia ATP World Tour,HARD,2,Taylor Dent,Juan Ignacio Chela,Taylor Dent,6-1; 6-1,S,51,10,3,25,44,22,25,11,19,6,6,7,33,44,1,2,34,49,20,34,2,15,8,13,7,22,49
2005-01-03 00:00:00.000,Adelaide Adelaide; Australia ATP World Tour,HARD,2,Joachim Johansson,Olivier Rochus,Joachim Johansson,6-1; 7-6(5),S,72,16,3,25,48,22,25,17,23,1,2,9,39,48,1,2,31,63,15,31,22,32,2,6,10,37,63
2005-01-03 00:00:00.000,Adelaide Adelaide; Australia ATP World Tour,HARD,2,Joachim Johansson,Taylor Dent,Joachim Johansson,7-5; 6-3,F,80,5,4,28,53,26,28,15,25,0,0,10,41,53,10,11,40,83,31,40,18,43,6,9,11,49,83
2005-01-03 00:00:00.000,Chennai India ATP World Tour,HARD,2,Carlos Moya,Julian Knowle,Carlos Moya,6-4; 7-6(4),R32,90,13,2,35,60,28,35,19,25,0,1,11,47,60,4,3,43,70,31,43,14,27,2,4,11,45,70
2005-01-03 00:00:00.000,Chennai India ATP World Tour,HARD,2,Ivo Heuberger,Prakash Amritraj,Ivo Heuberger,6-4; 6-4,R32,78,11,0,37,53,32,37,12,16,4,4,10,44,53,3,3,38,65,22,38,17,27,4,6,10,39,65
2005-01-03 00:00:00.000,Chennai India ATP World Tour,HARD,2,Paul-Henri Mathieu,Janko Tipsarevic,Paul-Henri Mathieu,6-3; 6-4,R32,62,9,4,28,57,25,28,19,29,2,2,10,44,57,7,2,24,45,18,24,11,21,0,2,9,29,45
2005-01-03 00:00:00.000,Chennai India ATP World Tour,HARD,2,Kenneth Carlsen,Noam Okun,Kenneth Carlsen,7-6(0); 6-4,R32,88,2,1,44,61,34,44,13,17,0,0,11,47,61,5,4,50,71,37,50,9,21,1,2,11,46,71
2005-01-03 00:00:00.000,Chennai India ATP World Tour,HARD,2,Olivier Patience,Rainer Schuettler,Olivier Patience,6-2; 6-2,R32,72,2,6,18,45,13,18,15,27,0,2,8,28,45,1,6,41,77,23,41,11,36,10,16,8,34,77
2005-01-03 00:00:00.000,Chennai India ATP World Tour,HARD,2,Michal Tabara,Jiri Vanek,Michal Tabara,6-2; 4-6; 7-6(5),R32,125,4,9,55,103,40,55,23,48,8,11,15,63,103,12,6,50,89,37,50,17,39,1,5,15,54,89
2005-01-03 00:00:00.000,Chennai India ATP World Tour,HARD,2,Guillermo Garcia-Lopez,Dennis van Scheppingen,Guillermo Garcia-Lopez,3-6; 6-3; 6-2,R32,104,5,7,51,92,37,51,18,41,5,8,13,55,92,1,7,47,89,28,47,21,42,6,11,13,49,89
2005-01-03 00:00:00.000,Chennai India ATP World Tour,HARD,2,Adrian Garcia,Gregory Carraz,Adrian Garcia,6-4; 6-3,R32,68,3,2,31,56,24,31,13,25,1,3,10,37,56,7,7,31,62,24,31,8,31,1,5,9,32,62
2005-01-03 00:00:00.000,Chennai India ATP World Tour,HARD,2,Kevin Kim,Harsh Mankad,Kevin Kim,6-4; 4-6; 6-4,R32,124,5,7,48,91,30,48,18,43,4,10,15,48,91,0,5,64,104,38,64,16,40,7,14,15,54,104
2005-01-03 00:00:00.000,Chennai India ATP World Tour,HARD,2,Tomas Zib,Lars Burgsmuller,Tomas Zib,6-1; 6-4,R32,62,4,0,28,50,20,28,15,22,1,2,9,35,50,6,3,35,58,23,35,7,23,3,7,8,30,58
2005-01-03 00:00:00.000,Chennai India ATP World Tour,HARD,2,Justin Gimelstob,Jan-Michael Gambill,Justin Gimelstob,6-3; 6-3,R32,82,6,2,38,63,26,38,15,25,5,6,9,41,63,8,4,38,61,24,38,7,23,3,7,9,31,61
2005-01-03 00:00:00.000,Chennai India ATP World Tour,HARD,2,Jonas Bjorkman,Karan Rastogi,Jonas Bjorkman,6-4; 6-0,R32,65,3,2,23,48,17,23,16,25,1,2,8,33,48,0,3,33,49,17,33,4,16,1,6,8,21,49
2005-01-03 00:00:00.000,Chennai India ATP World Tour,HARD,2,Yen-Hsun Lu,Leander Paes,Yen-Hsun Lu,6-2; 7-6(5),R32,79,4,0,33,58,24,33,18,25,1,3,10,42,58,2,0,36,60,24,36,10,24,3,7,10,34,60
2005-01-03 00:00:00.000,Chennai India ATP World Tour,HARD,2,Kristof Vliegen,Santiago Ventura,Kristof Vliegen,7-6(6); 5-7; 6-4,R32,157,8,5,60,115,39,60,26,55,8,15,17,65,115,4,5,55,113,36,55,25,58,6,13,17,61,113
2005-01-03 00:00:00.000,Chennai India ATP World Tour,HARD,2,Nicolas Devilder,Marcos Baghdatis,Nicolas Devilder,6-4; 6-7(10); 7-6(5),R32,169,4,8,72,123,51,72,26,51,3,7,17,77,123,9,9,53,121,40,53,34,68,2,7,17,74,121
2005-01-03 00:00:00.000,Chennai India ATP World Tour,HARD,2,Paradorn Srichaphan,Christophe Rochus,Paradorn Srichaphan,4-6; 7-6(4); 6-1,R32,116,13,3,59,92,45,59,19,33,2,4,15,64,92,3,3,56,107,39,56,25,51,6,9,14,64,107
2005-01-03 00:00:00.000,Chennai India ATP World Tour,HARD,2,Carlos Moya,Ivo Heuberger,Carlos Moya,W/O,R16,0,0,0,0,0,0,0,0,0,0,0,0,0,0,0,0,0,0,0,0,0,0,0,0,0,0,0
2005-01-03 00:00:00.000,Chennai India ATP World Tour,HARD,2,Paul-Henri Mathieu,Kenneth Carlsen,Paul-Henri Mathieu,6-3; 7-5,R16,100,4,5,37,75,28,37,23,38,8,9,11,51,75,10,3,43,66,31,43,7,23,3,6,10,38,66
2005-01-03 00:00:00.000,Chennai India ATP World Tour,HARD,2,Michal Tabara,Olivier Patience,Michal Tabara,7-6(4); 6-4,R16,91,7,7,27,66,23,27,24,39,3,5,11,47,66,8,1,49,87,34,49,16,38,9,12,11,50,87
2005-01-03 00:00:00.000,Chennai India ATP World Tour,HARD,2,Guillermo Garcia-Lopez,Adrian Garcia,Guillermo Garcia-Lopez,6-3; 6-3,R16,75,4,3,37,60,31,37,10,23,2,2,9,41,60,2,5,40,63,26,40,9,23,5,8,9,35,63
2005-01-03 00:00:00.000,Chennai India ATP World Tour,HARD,2,Tomas Zib,Kevin Kim,Tomas Zib,6-3; 7-5,R16,74,7,1,30,51,30,30,14,21,0,0,11,44,51,3,1,40,64,29,40,10,24,4,6,10,39,64
2005-01-03 00:00:00.000,Chennai India ATP World Tour,HARD,2,Justin Gimelstob,Jonas Bjorkman,Justin Gimelstob,6-0; 4-6; 6-3,R16,116,7,3,42,86,32,42,22,44,8,10,12,54,86,6,4,39,80,18,39,22,41,3,9,13,40,80
2005-01-03 00:00:00.000,Chennai India ATP World Tour,HARD,2,Kristof Vliegen,Yen-Hsun Lu,Kristof Vliegen,1-6; 7-5; 7-6(6),R16,134,6,6,53,106,34,53,28,53,9,15,16,62,106,7,5,55,92,41,55,17,37,3,7,15,58,92
2005-01-03 00:00:00.000,Chennai India ATP World Tour,HARD,2,Paradorn Srichaphan,Nicolas Devilder,Paradorn Srichaphan,6-3; 6-2,R16,61,7,0,35,48,27,35,10,13,0,0,9,37,48,2,2,35,55,19,35,11,20,4,7,8,30,55
2005-01-03 00:00:00.000,Chennai India ATP World Tour,HARD,2,Carlos Moya,Paul-Henri Mathieu,Carlos Moya,6-4; 6-4,Q,89,11,6,33,67,27,33,16,34,3,4,10,43,67,1,1,23,59,14,23,21,36,0,3,10,35,59
2005-01-03 00:00:00.000,Chennai India ATP World Tour,HARD,2,Guillermo Garcia-Lopez,Michal Tabara,Guillermo Garcia-Lopez,6-4; 6-4,Q,84,3,6,49,68,35,49,11,19,7,8,10,46,68,0,5,28,57,21,28,13,29,2,5,10,34,57
2005-01-03 00:00:00.000,Chennai India ATP World Tour,HARD,2,Tomas Zib,Justin Gimelstob,Tomas Zib,6-3; 7-6(4),Q,86,5,3,44,72,33,44,15,28,4,5,11,48,72,6,2,30,55,24,30,11,25,1,3,10,35,55
2005-01-03 00:00:00.000,Chennai India ATP World Tour,HARD,2,Paradorn Srichaphan,Kristof Vliegen,Paradorn Srichaphan,6-3; 6-4,Q,77,9,4,37,60,31,37,9,23,3,4,10,40,60,2,1,43,67,24,43,13,24,6,9,9,37,67
2005-01-03 00:00:00.000,Chennai India ATP World Tour,HARD,2,Carlos Moya,Guillermo Garcia-Lopez,Carlos Moya,6-4; 2-6; 7-6(2),S,122,13,3,39,91,30,39,28,52,1,5,15,58,91,8,3,44,82,31,44,23,38,3,6,15,54,82
2005-01-03 00:00:00.000,Chennai India ATP World Tour,HARD,2,Paradorn Srichaphan,Tomas Zib,Paradorn Srichaphan,7-6(5); 6-3,S,114,13,1,47,82,37,47,15,35,7,8,10,52,82,4,3,46,76,28,46,17,30,4,7,11,45,76
2005-01-03 00:00:00.000,Chennai India ATP World Tour,HARD,2,Carlos Moya,Paradorn Srichaphan,Carlos Moya,3-6; 6-4; 7-6(5),F,152,4,6,63,100,47,63,10,37,5,10,15,57,100,7,7,61,107,45,61,19,46,5,10,16,64,107
2005-01-03 00:00:00.000,Doha Qatar ATP World Tour,HARD,2,Roger Federer,David Ferrer,Roger Federer,6-1; 6-1,R32,58,1,1,39,52,27,39,7,13,0,0,7,34,52,1,2,25,46,11,25,9,21,2,7,7,20,46
2005-01-03 00:00:00.000,Doha Qatar ATP World Tour,HARD,2,Greg Rusedski,Jan Hernych,Greg Rusedski,6-3; 7-5,R32,87,7,2,39,76,32,39,19,37,9,10,11,51,76,0,1,48,69,27,48,13,21,4,7,10,40,69
2005-01-03 00:00:00.000,Doha Qatar ATP World Tour,HARD,2,Uros Vico,Nicolas Mahut,Uros Vico,4-6; 6-3; 6-4,R32,113,16,1,54,93,39,54,21,39,3,5,15,60,93,8,3,46,76,37,46,15,30,0,3,14,52,76
2005-01-03 00:00:00.000,Doha Qatar ATP World Tour,HARD,2,Feliciano Lopez,Filippo Volandri,Feliciano Lopez,7-5; 6-3,R32,70,2,2,35,57,32,35,12,22,0,0,11,44,57,0,2,28,56,20,28,18,28,5,7,10,38,56
2005-01-03 00:00:00.000,Doha Qatar ATP World Tour,HARD,2,Sebastien Grosjean,Gilles Muller,Sebastien Grosjean,7-6(3); 6-2,R32,97,3,0,40,68,30,40,19,28,4,5,10,49,68,2,4,44,65,25,44,12,21,0,3,10,37,65
2005-01-03 00:00:00.000,Doha Qatar ATP World Tour,HARD,2,Hyung-Taik Lee,Sergiy Stakhovsky,Hyung-Taik Lee,6-0; 6-1,R32,8,3,1,30,32,27,30,1,2,0,0,7,28,32,2,3,25,30,7,25,2,5,1,6,6,9,30
2005-01-03 00:00:00.000,Doha Qatar ATP World Tour,HARD,2,Karol Beck,Igor Andreev,Karol Beck,6-3; 6-4,R32,85,3,2,47,65,38,47,7,18,5,5,10,45,65,3,5,39,62,26,39,10,23,5,7,9,36,62
2005-01-03 00:00:00.000,Doha Qatar ATP World Tour,HARD,2,Nikolay Davydenko,Ivo Karlovic,Nikolay Davydenko,7-6(7); 6-3,R32,101,1,1,49,69,39,49,14,20,2,2,11,53,69,13,7,53,90,37,53,17,37,8,9,10,54,90
2005-01-03 00:00:00.000,Doha Qatar ATP World Tour,HARD,2,Ivan Ljubicic,Stanislas Wawrinka,Ivan Ljubicic,6-3; 6-4,R32,0,0,0,0,0,0,0,0,0,0,0,0,0,0,0,0,0,0,0,0,0,0,0,0,0,0,0
2005-01-03 00:00:00.000,Doha Qatar ATP World Tour,HARD,2,Marc Lopez,Bohdan Ulihrach,Marc Lopez,7-5; 7-6(2),R32,117,2,0,38,72,30,38,15,34,4,7,12,45,72,1,6,67,105,38,67,18,38,13,17,12,56,105
2005-01-03 00:00:00.000,Doha Qatar ATP World Tour,HARD,2,Fernando Verdasco,Mohammed Abdulla,Fernando Verdasco,6-2; 6-2,R32,54,5,3,26,45,22,26,11,19,1,1,8,33,45,0,6,22,49,14,22,10,27,1,5,8,24,49
2005-01-03 00:00:00.000,Doha Qatar ATP World Tour,HARD,2,Rafael Nadal,Mikhail Youzhny,Rafael Nadal,6-3; 7-6(3),R32,94,3,5,45,70,36,45,9,25,2,4,11,45,70,2,1,46,61,25,46,7,15,0,3,10,32,61
2005-01-03 00:00:00.000,Doha Qatar ATP World Tour,HARD,2,Marco Chiudinelli,Andrei Pavel,Marco Chiudinelli,7-5; 6-7(8); 6-4,R32,141,4,3,81,106,56,81,14,25,6,9,17,70,106,9,3,83,110,55,83,12,27,3,8,17,67,110
2005-01-03 00:00:00.000,Doha Qatar ATP World Tour,HARD,2,Albert Costa,David Sanchez,Albert Costa,6-3; 6-4,R32,100,7,1,42,58,31,42,7,16,2,4,10,38,58,1,1,52,78,27,52,14,26,10,14,9,41,78
2005-01-03 00:00:00.000,Doha Qatar ATP World Tour,HARD,2,Fabrice Santoro,Thomas Johansson,Fabrice Santoro,6-4; 6-2,R32,79,9,2,37,61,27,37,17,24,5,5,9,44,61,5,1,39,64,28,39,7,25,5,8,9,35,64
2005-01-03 00:00:00.000,Doha Qatar ATP World Tour,HARD,2,Gael Monfils,Gaston Gaudio,Gael Monfils,6-4; 7-6(4),R32,97,3,2,33,67,27,33,19,34,4,5,11,46,67,0,0,50,67,29,50,16,17,3,5,11,45,67
2005-01-03 00:00:00.000,Doha Qatar ATP World Tour,HARD,2,Roger Federer,Greg Rusedski,Roger Federer,6-3; 6-4,R16,61,2,0,34,56,23,34,19,22,2,2,10,42,56,4,1,34,52,22,34,9,18,3,5,9,31,52
2005-01-03 00:00:00.000,Doha Qatar ATP World Tour,HARD,2,Feliciano Lopez,Uros Vico,Feliciano Lopez,6-2; 7-6(6),R16,97,7,3,36,66,30,36,16,30,2,3,10,46,66,5,3,44,75,28,44,16,31,6,9,10,44,75
2005-01-03 00:00:00.000,Doha Qatar ATP World Tour,HARD,2,Sebastien Grosjean,Hyung-Taik Lee,Sebastien Grosjean,6-3; 6-0,R16,75,3,0,28,46,19,28,13,18,0,1,8,32,46,0,2,33,55,15,33,9,22,4,9,7,24,55
2005-01-03 00:00:00.000,Doha Qatar ATP World Tour,HARD,2,Nikolay Davydenko,Karol Beck,Nikolay Davydenko,7-6(2); 6-2,R16,108,1,1,40,67,26,40,16,27,3,5,10,42,67,1,2,42,76,25,42,15,34,13,17,10,40,76
2005-01-03 00:00:00.000,Doha Qatar ATP World Tour,HARD,2,Ivan Ljubicic,Marc Lopez,Ivan Ljubicic,6-1; 6-4,R16,76,7,2,33,54,26,33,13,21,2,2,9,39,54,1,1,32,55,20,32,11,23,4,7,8,31,55
2005-01-03 00:00:00.000,Doha Qatar ATP World Tour,HARD,2,Rafael Nadal,Fernando Verdasco,Rafael Nadal,6-2; 6-4,R16,72,2,1,28,48,21,28,10,20,2,4,9,31,48,1,3,39,61,21,39,6,22,8,13,9,27,61
2005-01-03 00:00:00.000,Doha Qatar ATP World Tour,HARD,2,Albert Costa,Marco Chiudinelli,Albert Costa,6-3; 6-2,R16,77,9,2,27,44,24,27,8,17,3,4,8,32,44,5,0,48,67,28,48,5,19,5,10,9,33,67
2005-01-03 00:00:00.000,Doha Qatar ATP World Tour,HARD,2,Fabrice Santoro,Gael Monfils,Fabrice Santoro,6-2; 4-6; 7-5,R16,158,2,4,72,117,48,72,23,45,8,10,15,71,117,2,3,55,88,37,55,16,33,3,7,15,53,88
2005-01-03 00:00:00.000,Doha Qatar ATP World Tour,HARD,2,Roger Federer,Feliciano Lopez,Roger Federer,6-1; 6-2,Q,51,6,1,27,41,23,27,10,14,1,1,8,33,41,0,4,29,47,17,29,5,18,2,6,7,22,47
2005-01-03 00:00:00.000,Doha Qatar ATP World Tour,HARD,2,Nikolay Davydenko,Sebastien Grosjean,Nikolay Davydenko,2-6; 6-3; 6-2,Q,120,2,2,55,76,29,55,11,21,5,10,12,40,76,2,3,55,94,34,55,12,39,8,15,13,46,94
2005-01-03 00:00:00.000,Doha Qatar ATP World Tour,HARD,2,Ivan Ljubicic,Rafael Nadal,Ivan Ljubicic,6-2; 6-7(3); 6-3,Q,152,9,3,63,98,48,63,18,35,7,8,15,66,98,2,3,50,80,35,50,20,30,2,6,14,55,80
2005-01-03 00:00:00.000,Doha Qatar ATP World Tour,HARD,2,Albert Costa,Fabrice Santoro,Albert Costa,6-2; 3-0 RET,Q,52,5,0,20,34,18,20,6,14,4,4,5,24,34,1,1,22,34,11,22,3,12,1,5,6,14,34
2005-01-03 00:00:00.000,Doha Qatar ATP World Tour,HARD,2,Roger Federer,Nikolay Davydenko,Roger Federer,6-3; 6-4,S,65,7,0,37,58,27,37,16,21,1,1,10,43,58,0,3,44,52,32,44,2,8,4,6,9,34,52
2005-01-03 00:00:00.000,Doha Qatar ATP World Tour,HARD,2,Ivan Ljubicic,Albert Costa,Ivan Ljubicic,6-3; 7-6(4),S,112,6,0,43,67,32,43,17,24,1,2,11,49,67,1,1,51,71,36,51,8,20,7,9,10,44,71
2005-01-03 00:00:00.000,Doha Qatar ATP World Tour,HARD,2,Roger Federer,Ivan Ljubicic,Roger Federer,6-3; 6-1,F,63,3,0,31,44,24,31,9,13,3,3,8,33,44,0,1,31,51,14,31,11,20,5,9,8,25,51
2005-01-10 00:00:00.000,Auckland New Zealand ATP World Tour,HARD,2,Guillermo Coria,Sjeng Schalken,Guillermo Coria,6-0; 6-3,R32,72,1,6,31,55,24,31,11,24,4,5,8,35,55,0,1,34,43,15,34,3,9,2,7,7,18,43
2005-01-10 00:00:00.000,Auckland New Zealand ATP World Tour,HARD,2,Cyril Saulnier,Gilles Muller,Cyril Saulnier,6-4; 6-4,R32,68,7,2,39,61,31,39,13,22,4,4,10,44,61,4,2,41,63,27,41,12,22,2,4,10,39,63
2005-01-10 00:00:00.000,Auckland New Zealand ATP World Tour,HARD,2,Federico Luzzi,Juan Monaco,Federico Luzzi,6-4; 6-4,R32,73,6,4,31,60,25,31,13,29,4,6,10,38,60,1,3,40,58,22,40,9,18,3,7,10,31,58
2005-01-10 00:00:00.000,Auckland New Zealand ATP World Tour,HARD,2,Olivier Rochus,Luis Horna,Olivier Rochus,6-3; 6-1,R32,64,1,1,25,46,22,25,12,21,2,2,8,34,46,5,0,33,47,20,33,5,14,2,6,8,25,47
2005-01-10 00:00:00.000,Auckland New Zealand ATP World Tour,HARD,2,Dominik Hrbaty,Rafael Nadal,Dominik Hrbaty,6-3 RET,R32,60,1,3,17,34,10,17,9,17,8,10,5,19,34,1,1,38,54,18,38,7,16,9,12,4,25,54
2005-01-10 00:00:00.000,Auckland New Zealand ATP World Tour,HARD,2,Jose Acasuso,Julien Benneteau,Jose Acasuso,6-1; 3-6; 6-4,R32,127,5,3,28,75,21,28,28,47,4,7,13,49,75,2,3,56,88,39,56,11,32,3,8,13,50,88
2005-01-10 00:00:00.000,Auckland New Zealand ATP World Tour,HARD,2,Alberto Martin,Philipp Kohlschreiber,Alberto Martin,6-4; 7-5,R32,111,0,3,53,91,37,53,20,38,9,10,11,57,91,2,5,38,74,26,38,18,36,11,14,11,44,74
2005-01-10 00:00:00.000,Auckland New Zealand ATP World Tour,HARD,2,Jan Hernych,Juan Carlos Ferrero,Jan Hernych,6-7(1); 6-1; 6-3,R32,113,4,3,54,86,40,54,15,32,4,7,14,55,86,5,5,52,95,35,52,17,43,4,11,14,52,95
2005-01-10 00:00:00.000,Auckland New Zealand ATP World Tour,HARD,2,Fernando Gonzalez,James Blake,Fernando Gonzalez,7-6(4); 6-1,R32,76,5,3,38,71,29,38,20,33,5,6,10,49,71,1,2,30,54,20,30,12,24,1,4,9,32,54
2005-01-10 00:00:00.000,Auckland New Zealand ATP World Tour,HARD,2,Mariano Zabaleta,G.D. Jones,Mariano Zabaleta,6-0; 6-2,R32,48,3,3,20,36,18,20,7,16,0,1,7,25,36,0,5,24,39,7,24,7,15,3,9,7,14,39
2005-01-10 00:00:00.000,Auckland New Zealand ATP World Tour,HARD,2,Robby Ginepri,Agustin Calleri,Robby Ginepri,2-6; 6-4; 6-3,R32,91,3,2,55,82,41,55,9,27,3,6,14,50,82,6,4,35,79,28,35,19,44,1,4,13,47,79
2005-01-10 00:00:00.000,Auckland New Zealand ATP World Tour,HARD,2,Vincent Spadea,David Sanchez,Vincent Spadea,6-0; 6-0,R32,45,1,1,16,33,13,16,12,17,0,0,6,25,33,0,2,22,34,9,22,0,12,4,10,6,9,34
2005-01-10 00:00:00.000,Auckland New Zealand ATP World Tour,HARD,2,Juan Ignacio Chela,Guillermo Garcia-Lopez,Juan Ignacio Chela,6-2; 6-2,R32,73,0,0,32,46,24,32,9,14,0,0,8,33,46,2,2,39,64,20,39,12,25,9,13,8,32,64
2005-01-10 00:00:00.000,Auckland New Zealand ATP World Tour,HARD,2,Ricardo Mello,Jonas Bjorkman,Ricardo Mello,6-4; 6-1,R32,63,5,2,36,51,24,36,8,15,2,4,9,32,51,2,2,21,50,11,21,12,29,1,6,8,23,50
2005-01-10 00:00:00.000,Auckland New Zealand ATP World Tour,HARD,2,Potito Starace,Mark Nielsen,Potito Starace,6-4; 6-4,R32,77,5,1,50,59,34,50,7,9,3,4,10,41,59,4,5,42,61,30,42,6,19,4,7,10,36,61
2005-01-10 00:00:00.000,Auckland New Zealand ATP World Tour,HARD,2,Raemon Sluiter,Tommy Robredo,Raemon Sluiter,4-6; 6-4; 6-4,R32,111,12,6,48,94,35,48,24,46,8,11,15,59,94,4,2,48,87,35,48,17,39,2,6,15,52,87
2005-01-10 00:00:00.000,Auckland New Zealand ATP World Tour,HARD,2,Guillermo Coria,Cyril Saulnier,Guillermo Coria,6-3; 4-6; 7-6(3),R16,147,6,5,68,113,44,68,20,45,10,14,15,64,113,8,1,54,107,38,54,21,53,8,13,16,59,107
2005-01-10 00:00:00.000,Auckland New Zealand ATP World Tour,HARD,2,Olivier Rochus,Federico Luzzi,Olivier Rochus,6-2; 6-3,R16,65,0,2,28,53,26,28,13,25,1,1,9,39,53,3,4,24,46,15,24,8,22,1,4,8,23,46
2005-01-10 00:00:00.000,Auckland New Zealand ATP World Tour,HARD,2,Jose Acasuso,Dominik Hrbaty,Jose Acasuso,7-6(5); 6-3,R16,82,10,3,33,70,24,33,24,37,0,0,11,48,70,5,5,36,61,29,36,14,25,1,2,10,43,61
2005-01-10 00:00:00.000,Auckland New Zealand ATP World Tour,HARD,2,Jan Hernych,Alberto Martin,Jan Hernych,6-4; 6-2,R16,74,3,2,28,45,22,28,11,17,0,1,9,33,45,3,2,41,68,23,41,14,27,6,10,9,37,68
2005-01-10 00:00:00.000,Auckland New Zealand ATP World Tour,HARD,2,Fernando Gonzalez,Mariano Zabaleta,Fernando Gonzalez,6-3; 6-4,R16,73,8,2,41,68,32,41,14,27,5,5,10,46,68,4,0,31,51,23,31,9,20,1,3,9,32,51
2005-01-10 00:00:00.000,Auckland New Zealand ATP World Tour,HARD,2,Robby Ginepri,Vincent Spadea,Robby Ginepri,7-5; 6-3,R16,85,4,1,35,55,26,35,9,20,2,5,10,35,55,2,3,42,94,27,42,20,52,12,18,11,47,94
2005-01-10 00:00:00.000,Auckland New Zealand ATP World Tour,HARD,2,Juan Ignacio Chela,Ricardo Mello,Juan Ignacio Chela,6-2; 6-1,R16,55,2,3,31,43,25,31,7,12,3,3,7,32,43,2,3,28,48,14,28,7,20,7,12,8,21,48
2005-01-10 00:00:00.000,Auckland New Zealand ATP World Tour,HARD,2,Potito Starace,Raemon Sluiter,Potito Starace,6-4; 6-2,R16,61,1,0,47,56,33,47,5,9,3,4,9,38,56,2,5,24,49,15,24,12,25,2,6,9,27,49
2005-01-10 00:00:00.000,Auckland New Zealand ATP World Tour,HARD,2,Olivier Rochus,Guillermo Coria,Olivier Rochus,6-4; 6-4,Q,91,1,1,38,61,27,38,15,23,1,2,10,42,61,2,4,44,71,26,44,15,27,8,11,10,41,71
2005-01-10 00:00:00.000,Auckland New Zealand ATP World Tour,HARD,2,Jan Hernych,Jose Acasuso,Jan Hernych,6-4; 7-5,Q,71,5,1,46,64,37,46,10,18,5,5,11,47,64,4,5,35,63,26,35,15,28,2,4,11,41,63
2005-01-10 00:00:00.000,Auckland New Zealand ATP World Tour,HARD,2,Fernando Gonzalez,Robby Ginepri,Fernando Gonzalez,6-3; 6-4,Q,65,7,3,43,68,35,43,12,25,6,6,10,47,68,4,1,38,54,26,38,8,16,5,7,9,34,54
2005-01-10 00:00:00.000,Auckland New Zealand ATP World Tour,HARD,2,Juan Ignacio Chela,Potito Starace,Juan Ignacio Chela,6-1; 7-6(5),Q,75,7,2,37,56,29,37,12,19,0,0,9,41,56,3,5,48,72,28,48,12,24,4,7,10,40,72
2005-01-10 00:00:00.000,Auckland New Zealand ATP World Tour,HARD,2,Olivier Rochus,Jan Hernych,Olivier Rochus,6-3; 6-1,S,57,1,1,26,41,20,26,11,15,2,3,8,31,41,0,1,27,48,16,27,6,21,4,9,8,22,48
2005-01-10 00:00:00.000,Auckland New Zealand ATP World Tour,HARD,2,Fernando Gonzalez,Juan Ignacio Chela,Fernando Gonzalez,6-4; 6-2,S,68,2,2,34,49,26,34,6,15,0,2,9,32,49,0,0,38,61,17,38,12,23,3,8,9,29,61
2005-01-10 00:00:00.000,Auckland New Zealand ATP World Tour,HARD,2,Fernando Gonzalez,Olivier Rochus,Fernando Gonzalez,6-4; 6-2,F,70,6,0,34,48,27,34,10,14,2,2,9,37,48,0,1,43,64,28,43,7,21,9,12,9,35,64
2005-01-10 00:00:00.000,Sydney Australia ATP World Tour,HARD,2,Lleyton Hewitt,Karol Beck,Lleyton Hewitt,6-1; 6-2,R32,68,5,3,28,50,24,28,13,22,5,5,8,37,50,2,3,25,54,15,25,11,29,9,13,7,26,54
2005-01-10 00:00:00.000,Sydney Australia ATP World Tour,HARD,2,Arnaud Clement,Tomas Zib,Arnaud Clement,6-1; 6-3,R32,0,12,2,29,50,24,29,10,21,5,6,8,34,50,3,1,27,53,15,27,10,26,2,7,8,25,53
2005-01-10 00:00:00.000,Sydney Australia ATP World Tour,HARD,2,Wayne Arthurs,Filippo Volandri,Wayne Arthurs,7-6(1); 6-7(4); 6-3,R32,143,16,3,61,115,50,61,29,54,6,7,17,79,115,1,2,68,115,47,68,27,47,4,6,16,74,115
2005-01-10 00:00:00.000,Sydney Australia ATP World Tour,HARD,2,Thomas Johansson,Florian Mayer,Thomas Johansson,6-2; 7-6(5),R32,74,13,2,33,60,29,33,10,27,0,2,10,39,60,3,6,43,70,30,43,6,27,5,9,10,36,70
2005-01-10 00:00:00.000,Sydney Australia ATP World Tour,HARD,2,Joachim Johansson,Greg Rusedski,Joachim Johansson,6-4; 6-3,R32,74,5,1,38,54,28,38,11,16,4,4,9,39,54,11,5,41,72,29,41,13,31,5,8,10,42,72
2005-01-10 00:00:00.000,Sydney Australia ATP World Tour,HARD,2,Max Mirnyi,David Ferrer,Max Mirnyi,6-1; 7-5,R32,72,9,1,37,58,29,37,10,21,0,1,10,39,58,0,0,43,62,23,43,10,19,7,11,9,33,62
2005-01-10 00:00:00.000,Sydney Australia ATP World Tour,HARD,2,Mardy Fish,Robin Soderling,Mardy Fish,6-4; 6-4,R32,81,13,5,34,65,28,34,13,31,1,3,10,41,65,5,2,38,65,29,38,7,27,6,10,10,36,65
2005-01-10 00:00:00.000,Sydney Australia ATP World Tour,HARD,2,Taylor Dent,Santiago Ventura,Taylor Dent,7-5; 7-6(7),R32,112,3,5,63,90,41,63,15,27,3,5,12,56,90,4,2,51,92,36,51,19,41,4,7,12,55,92
2005-01-10 00:00:00.000,Sydney Australia ATP World Tour,HARD,2,Ivo Minar,Nikolay Davydenko,Ivo Minar,6-2; 3-6; 6-2,R32,98,3,2,46,89,30,46,23,43,5,7,12,53,89,0,6,62,85,37,62,11,23,8,13,13,48,85
2005-01-10 00:00:00.000,Sydney Australia ATP World Tour,HARD,2,Fernando Verdasco,Tomas Berdych,Fernando Verdasco,3-6; 6-4; 7-5,R32,119,6,3,44,87,31,44,27,43,1,3,15,58,87,4,5,48,100,38,48,26,52,6,9,16,64,100
2005-01-10 00:00:00.000,Sydney Australia ATP World Tour,HARD,2,Jarkko Nieminen,Jurgen Melzer,Jarkko Nieminen,6-3; 7-5,R32,70,3,1,42,57,28,42,11,15,0,1,10,39,57,3,1,38,64,24,38,13,26,3,7,11,37,64
2005-01-10 00:00:00.000,Sydney Australia ATP World Tour,HARD,2,Andrei Pavel,Luke Bourgeois,Andrei Pavel,7-6(3); 7-5,R32,91,2,1,53,72,45,53,10,19,4,4,12,55,72,11,5,42,76,35,42,17,34,2,3,12,52,76
2005-01-10 00:00:00.000,Sydney Australia ATP World Tour,HARD,2,Feliciano Lopez,Todd Reid,Feliciano Lopez,6-4; 6-4,R32,67,11,0,35,60,26,35,18,25,0,0,10,44,60,3,0,45,64,30,45,9,19,3,5,10,39,64
2005-01-10 00:00:00.000,Sydney Australia ATP World Tour,HARD,2,Michael Llodra,Xavier Malisse,Michael Llodra,4-6; 6-0; 6-3,R32,99,6,0,58,75,43,58,11,17,4,5,13,54,75,3,0,51,85,30,51,17,34,5,9,12,47,85
2005-01-10 00:00:00.000,Sydney Australia ATP World Tour,HARD,2,Igor Andreev,Albert Costa,Igor Andreev,6-1; 6-4,R32,61,2,3,19,45,17,19,19,26,0,0,9,36,45,1,3,26,51,19,26,10,25,3,6,8,29,51
2005-01-10 00:00:00.000,Sydney Australia ATP World Tour,HARD,2,Radek Stepanek,Carlos Moya,Radek Stepanek,2-6; 6-4; 6-2,R32,118,5,8,48,96,29,48,29,48,10,13,13,58,96,8,2,49,71,35,49,9,22,3,7,13,44,71
2005-01-10 00:00:00.000,Sydney Australia ATP World Tour,HARD,2,Lleyton Hewitt,Arnaud Clement,Lleyton Hewitt,6-2; 6-4,R16,78,12,10,33,60,27,33,12,27,4,5,9,39,60,4,7,24,59,15,24,15,35,6,10,9,30,59
2005-01-10 00:00:00.000,Sydney Australia ATP World Tour,HARD,2,Thomas Johansson,Wayne Arthurs,Thomas Johansson,7-6(4); 7-6(3),R16,91,14,1,39,72,34,39,24,33,1,1,12,58,72,18,2,42,74,37,42,19,32,1,1,12,56,74
2005-01-10 00:00:00.000,Sydney Australia ATP World Tour,HARD,2,Max Mirnyi,Joachim Johansson,Max Mirnyi,4-1 RET,R16,25,2,1,8,16,8,8,4,8,0,0,3,12,16,3,1,15,22,8,15,3,7,3,4,2,11,22
2005-01-10 00:00:00.000,Sydney Australia ATP World Tour,HARD,2,Taylor Dent,Mardy Fish,Taylor Dent,7-6(4); 6-1,R16,80,4,3,36,65,32,36,15,29,2,2,10,47,65,8,0,37,60,26,37,11,23,3,5,9,37,60
2005-01-10 00:00:00.000,Sydney Australia ATP World Tour,HARD,2,Ivo Minar,Fernando Verdasco,Ivo Minar,6-1; 6-2,R16,48,6,4,22,54,17,22,20,32,3,3,8,37,54,3,4,26,42,15,26,5,16,2,6,7,20,42
2005-01-10 00:00:00.000,Sydney Australia ATP World Tour,HARD,2,Andrei Pavel,Jarkko Nieminen,Andrei Pavel,6-4; 7-6(3),R16,112,1,0,53,75,37,53,11,22,3,6,11,48,75,2,5,67,103,43,67,12,36,12,16,11,55,103
2005-01-10 00:00:00.000,Sydney Australia ATP World Tour,HARD,2,Feliciano Lopez,Michael Llodra,Feliciano Lopez,6-4; 3-6; 7-6(4),R16,102,4,0,53,94,38,53,27,41,5,8,15,65,94,2,0,64,93,43,64,18,29,1,4,16,61,93
2005-01-10 00:00:00.000,Sydney Australia ATP World Tour,HARD,2,Radek Stepanek,Igor Andreev,Radek Stepanek,6-3; 6-7(5); 6-2,R16,147,3,4,55,91,40,55,21,36,6,9,15,61,91,8,4,54,101,37,54,20,47,9,15,14,57,101
2005-01-10 00:00:00.000,Sydney Australia ATP World Tour,HARD,2,Lleyton Hewitt,Thomas Johansson,Lleyton Hewitt,6-1; 7-6(4),Q,86,10,2,35,59,28,35,18,24,0,0,10,46,59,6,3,33,78,24,33,22,45,8,10,9,46,78
2005-01-10 00:00:00.000,Sydney Australia ATP World Tour,HARD,2,Max Mirnyi,Taylor Dent,Max Mirnyi,3-4 RET,Q,22,3,1,14,18,10,14,2,4,0,1,4,12,18,0,1,6,14,5,6,7,8,0,0,3,12,14
2005-01-10 00:00:00.000,Sydney Australia ATP World Tour,HARD,2,Ivo Minar,Andrei Pavel,Ivo Minar,2-6; 7-6(5); 6-4,Q,107,7,3,50,89,39,50,23,39,2,4,15,62,89,15,2,63,92,47,63,18,29,3,4,15,65,92
2005-01-10 00:00:00.000,Sydney Australia ATP World Tour,HARD,2,Radek Stepanek,Feliciano Lopez,Radek Stepanek,6-3; 6-2,Q,58,4,2,31,52,26,31,13,21,4,4,9,39,52,2,1,28,40,21,28,3,12,1,4,8,24,40
2005-01-10 00:00:00.000,Sydney Australia ATP World Tour,HARD,2,Lleyton Hewitt,Max Mirnyi,Lleyton Hewitt,6-7(4); 6-3; 6-2,S,128,13,3,50,81,43,50,17,31,3,4,14,60,81,14,6,62,97,49,62,13,35,8,13,15,62,97
2005-01-10 00:00:00.000,Sydney Australia ATP World Tour,HARD,2,Ivo Minar,Radek Stepanek,Ivo Minar,6-1; 6-2,S,54,9,2,21,47,16,21,19,26,2,2,8,35,47,7,4,27,45,15,27,8,18,6,10,7,23,45
2005-01-10 00:00:00.000,Sydney Australia ATP World Tour,HARD,2,Lleyton Hewitt,Ivo Minar,Lleyton Hewitt,7-5; 6-0,F,62,13,4,29,49,25,29,7,20,0,2,9,32,49,0,6,20,57,12,20,13,37,5,11,9,25,57
2005-01-17 00:00:00.000,Australian Open Australia Grand Slams,HARD,3,Roger Federer,Fabrice Santoro,Roger Federer,6-1; 6-1; 6-2,R128,94,4,1,41,68,33,41,15,27,6,6,11,48,68,1,2,68,98,33,68,13,30,11,18,11,46,98
2005-01-17 00:00:00.000,Australian Open Australia Grand Slams,HARD,3,Takao Suzuki,Jan-Michael Gambill,Takao Suzuki,6-4; 6-3; 6-3,R128,107,10,1,51,81,41,51,20,30,2,2,14,61,81,10,2,49,86,37,49,17,37,2,6,14,54,86
2005-01-17 00:00:00.000,Australian Open Australia Grand Slams,HARD,3,Jarkko Nieminen,Davide Sanguinetti,Jarkko Nieminen,3-6; 6-4; 6-3; 6-2,R128,112,3,3,59,95,42,59,22,36,3,7,18,64,95,5,2,65,98,41,65,14,33,3,10,18,55,98
2005-01-17 00:00:00.000,Australian Open Australia Grand Slams,HARD,3,Paradorn Srichaphan,Potito Starace,Paradorn Srichaphan,1-6; 6-2; 7-5; 6-4,R128,144,9,2,69,113,48,69,22,44,3,7,18,70,113,7,2,97,130,60,97,19,33,13,19,19,79,130
2005-01-17 00:00:00.000,Australian Open Australia Grand Slams,HARD,3,Ivan Ljubicic,Luis Horna,Ivan Ljubicic,6-4; 6-3; 6-3,R128,96,14,2,45,70,38,45,20,25,1,1,14,58,70,6,4,64,83,40,64,8,19,3,7,14,48,83
2005-01-17 00:00:00.000,Australian Open Australia Grand Slams,HARD,3,Marcos Baghdatis,Federico Luzzi,Marcos Baghdatis,6-1; 3-6; 6-1; 3-6; 6-3,R128,167,12,3,76,131,54,76,33,55,9,12,21,87,131,6,10,76,137,52,76,25,61,9,15,20,77,137
2005-01-17 00:00:00.000,Australian Open Australia Grand Slams,HARD,3,Tomas Zib,Jimmy Wang,Tomas Zib,7-6(5); 6-2; 6-4,R128,146,4,1,64,101,38,64,19,37,1,6,15,57,101,5,5,67,107,43,67,9,40,9,17,15,52,107
2005-01-17 00:00:00.000,Australian Open Australia Grand Slams,HARD,3,Tommy Robredo,Scott Draper,Tommy Robredo,5-7; 6-2; 6-4; 6-2,R128,137,5,3,62,104,46,62,23,42,6,10,19,69,104,5,3,72,117,46,72,18,45,8,16,19,64,117
2005-01-17 00:00:00.000,Australian Open Australia Grand Slams,HARD,3,Joachim Johansson,Sjeng Schalken,Joachim Johansson,7-6(6); 6-2; 6-3,R128,111,17,3,45,77,38,45,23,32,1,1,14,61,77,7,3,67,94,47,67,11,27,2,6,15,58,94
2005-01-17 00:00:00.000,Australian Open Australia Grand Slams,HARD,3,Peter Wessels,Yen-Hsun Lu,Peter Wessels,6-3; 6-4; 6-4,R128,84,9,1,45,71,39,45,19,26,0,1,15,58,71,5,6,51,81,36,51,13,30,1,5,14,49,81
2005-01-17 00:00:00.000,Australian Open Australia Grand Slams,HARD,3,Sargis Sargsian,David Sanchez,Sargis Sargsian,7-6(5); 4-6; 1-6; 6-4; 6-2,R128,198,9,7,86,144,65,86,24,58,4,11,24,89,144,7,3,96,149,62,96,28,53,2,8,23,90,149
2005-01-17 00:00:00.000,Australian Open Australia Grand Slams,HARD,3,Feliciano Lopez,Paul Baccanello,Feliciano Lopez,7-5; 7-5; 6-2,R128,115,11,5,49,91,40,49,28,42,2,2,16,68,91,14,9,46,100,35,46,29,54,2,6,16,64,100
2005-01-17 00:00:00.000,Australian Open Australia Grand Slams,HARD,3,Taylor Dent,Florent Serra,Taylor Dent,7-5; 6-2; 6-4,R128,103,8,9,60,93,47,60,12,33,2,5,15,59,93,3,5,62,92,34,62,15,30,4,11,15,49,92
2005-01-17 00:00:00.000,Australian Open Australia Grand Slams,HARD,3,Michal Tabara,Thomas Enqvist,Michal Tabara,3-6; 6-2; 6-3; 6-3,R128,133,14,9,49,116,36,49,34,67,9,13,17,70,116,7,7,55,108,37,55,20,53,7,15,18,57,108
2005-01-17 00:00:00.000,Australian Open Australia Grand Slams,HARD,3,Rainer Schuettler,Olivier Patience,Rainer Schuettler,7-6(3); 6-3; 6-2,R128,123,6,2,56,92,45,56,23,36,7,7,14,68,92,2,3,70,109,42,70,21,39,6,10,15,63,109
2005-01-17 00:00:00.000,Australian Open Australia Grand Slams,HARD,3,Andre Agassi,Dieter Kindlmann,Andre Agassi,6-4; 6-3; 6-0,R128,98,8,5,40,68,34,40,15,28,1,2,12,49,68,6,5,55,108,29,55,20,53,13,20,13,49,108
2005-01-17 00:00:00.000,Australian Open Australia Grand Slams,HARD,3,Marat Safin,Novak Djokovic,Marat Safin,6-0; 6-2; 6-1,R128,74,1,1,27,51,25,27,13,24,0,1,10,38,51,1,5,39,66,16,39,5,27,4,13,11,21,66
2005-01-17 00:00:00.000,Australian Open Australia Grand Slams,HARD,3,Bohdan Ulihrach,Ivo Karlovic,Bohdan Ulihrach,6-3; 6-7(5); 7-5; 6-2,R128,148,4,3,82,118,69,82,23,36,2,2,21,92,118,26,7,78,133,59,78,28,55,12,16,20,87,133
2005-01-17 00:00:00.000,Australian Open Australia Grand Slams,HARD,3,Bjorn Phau,Albert Costa,Bjorn Phau,6-3; 7-6(4); 6-3,R128,164,7,3,45,86,30,45,25,41,4,8,14,55,86,2,3,84,138,45,84,24,54,10,18,16,69,138
2005-01-17 00:00:00.000,Australian Open Australia Grand Slams,HARD,3,Mario Ancic,Oscar Hernandez,Mario Ancic,6-3; 6-2; 6-1,R128,111,10,1,45,66,36,45,15,21,0,0,12,51,66,0,6,46,87,26,46,17,41,11,17,12,43,87
2005-01-17 00:00:00.000,Australian Open Australia Grand Slams,HARD,3,Olivier Rochus,Nicolas Kiefer,Olivier Rochus,7-5; 2-6; 3-6; 6-2; 6-3,R128,213,1,5,83,146,56,83,33,63,11,17,23,89,146,16,8,82,141,51,82,30,59,10,17,23,81,141
2005-01-17 00:00:00.000,Australian Open Australia Grand Slams,HARD,3,Gael Monfils,Robby Ginepri,Gael Monfils,1-6; 6-3; 6-4; 7-6(6),R128,135,15,8,68,126,54,68,24,58,1,5,19,78,126,3,3,82,130,54,82,29,48,4,8,19,83,130
2005-01-17 00:00:00.000,Australian Open Australia Grand Slams,HARD,3,Karol Beck,Todd Reid,Karol Beck,6-2; 6-2; 6-1,R128,106,9,8,36,89,29,36,30,53,16,16,11,59,89,3,3,59,90,32,59,12,31,10,17,12,44,90
2005-01-17 00:00:00.000,Australian Open Australia Grand Slams,HARD,3,Tommy Haas,Xavier Malisse,Tommy Haas,6-3; 6-2; 6-3,R128,107,10,0,39,66,34,39,19,27,1,1,13,53,66,10,1,50,103,31,50,25,53,9,14,13,56,103
2005-01-17 00:00:00.000,Australian Open Australia Grand Slams,HARD,3,Gaston Gaudio,Justin Gimelstob,Gaston Gaudio,7-6(3); 6-4; 6-3,R128,135,2,6,61,96,47,61,19,35,3,5,15,66,96,10,10,44,100,32,44,26,56,1,6,16,58,100
2005-01-17 00:00:00.000,Australian Open Australia Grand Slams,HARD,3,Mardy Fish,Juan Monaco,Mardy Fish,2-6; 6-0; 6-4; 4-6; 9-7,R128,203,19,8,86,160,67,86,34,74,6,11,25,101,160,6,2,112,163,67,112,29,51,9,16,25,96,163
2005-01-17 00:00:00.000,Australian Open Australia Grand Slams,HARD,3,Janko Tipsarevic,Daniele Bracciali,Janko Tipsarevic,7-6(4); 7-6(6); 3-6; 6-1,R128,175,10,6,76,141,53,76,37,65,5,9,20,90,141,12,6,58,137,42,58,42,79,2,7,20,84,137
2005-01-17 00:00:00.000,Australian Open Australia Grand Slams,HARD,3,Dominik Hrbaty,Robin Soderling,Dominik Hrbaty,6-4; 6-2; 1-0 RET,R128,56,7,6,34,59,25,34,12,25,4,6,10,37,59,3,2,20,44,11,20,9,24,1,6,9,20,44
2005-01-17 00:00:00.000,Australian Open Australia Grand Slams,HARD,3,Thomas Johansson,Peter Luczak,Thomas Johansson,7-6(5); 4-6; 6-3; 4-6; 6-0,R128,198,24,7,76,152,62,76,40,76,3,6,24,102,152,8,8,89,154,60,89,37,65,8,13,23,97,154
2005-01-17 00:00:00.000,Australian Open Australia Grand Slams,HARD,3,Agustin Calleri,Max Mirnyi,Agustin Calleri,6-4; 5-7; 6-4; 4-6; 6-4,R128,199,15,10,97,162,72,97,34,65,4,8,26,106,162,16,4,103,149,79,103,22,46,2,7,26,101,149
2005-01-17 00:00:00.000,Australian Open Australia Grand Slams,HARD,3,Kevin Kim,Hyung-Taik Lee,Kevin Kim,3-6; 6-4; 6-3; 3-6; 6-1,R128,173,13,3,82,127,60,82,21,45,4,8,22,81,127,8,3,105,160,68,105,26,55,15,21,22,94,160
2005-01-17 00:00:00.000,Australian Open Australia Grand Slams,HARD,3,Guillermo Garcia-Lopez,Carlos Moya,Guillermo Garcia-Lopez,7-5; 6-3; 3-6; 6-3,R128,163,13,6,63,122,44,63,36,59,13,16,20,80,122,6,4,75,117,52,75,19,42,5,10,19,71,117
2005-01-17 00:00:00.000,Australian Open Australia Grand Slams,HARD,3,Guillermo Coria,Tomas Berdych,Guillermo Coria,6-2; 6-4; 6-0,R128,96,2,5,42,68,34,42,14,26,1,2,12,48,68,4,3,32,68,18,32,13,36,3,10,12,31,68
2005-01-17 00:00:00.000,Australian Open Australia Grand Slams,HARD,3,Ricardo Mello,Alberto Martin,Ricardo Mello,6-3; 6-3; 7-6(5),R128,148,5,4,61,89,49,61,10,28,2,5,15,59,89,2,7,80,134,52,80,18,54,10,16,15,70,134
2005-01-17 00:00:00.000,Australian Open Australia Grand Slams,HARD,3,Mariano Zabaleta,Marc Kimmich,Mariano Zabaleta,6-4; 6-2; 6-7(5); 6-3,R128,159,8,7,74,112,61,74,23,38,5,7,20,84,112,9,3,81,138,56,81,28,57,11,17,19,84,138
2005-01-17 00:00:00.000,Australian Open Australia Grand Slams,HARD,3,Juan Carlos Ferrero,Melle Van Gemerden,Juan Carlos Ferrero,2-6; 6-3; 6-4; 6-4,R128,125,1,1,85,118,58,85,14,33,4,8,19,72,118,4,2,61,114,44,61,26,53,7,12,18,70,114
2005-01-17 00:00:00.000,Australian Open Australia Grand Slams,HARD,3,Fernando Gonzalez,Jose Acasuso,Fernando Gonzalez,3-6; 3-6; 6-3; 6-3; 7-5,R128,198,9,10,91,156,66,91,34,65,10,14,24,100,156,13,4,86,150,60,86,36,64,11,16,24,96,150
2005-01-17 00:00:00.000,Australian Open Australia Grand Slams,HARD,3,Igor Andreev,Lars Burgsmuller,Igor Andreev,7-6(2); 6-1; 6-2,R128,102,7,5,55,92,44,55,21,37,6,6,14,65,92,4,1,46,80,26,46,20,34,1,5,13,46,80
2005-01-17 00:00:00.000,Australian Open Australia Grand Slams,HARD,3,Santiago Ventura,Alex Calatrava,Santiago Ventura,3-6; 6-3; 6-4; 4-6; 6-4,R128,224,8,7,90,167,65,90,43,77,10,13,24,108,167,6,5,82,141,62,82,33,59,5,9,24,95,141
2005-01-17 00:00:00.000,Australian Open Australia Grand Slams,HARD,3,David Nalbandian,David Ferrer,David Nalbandian,7-6(1); 4-6; 4-6; 6-3; 6-4,R128,225,3,5,110,173,72,110,27,63,13,22,26,99,173,4,4,100,163,60,100,31,63,17,26,25,91,163
2005-01-17 00:00:00.000,Australian Open Australia Grand Slams,HARD,3,Mikhail Youzhny,Jerome Haehnel,Mikhail Youzhny,6-2; 6-2; 7-5,R128,87,1,0,40,68,34,40,23,28,1,1,14,57,68,4,4,51,90,27,51,24,39,2,7,14,51,90
2005-01-17 00:00:00.000,Australian Open Australia Grand Slams,HARD,3,Rafael Nadal,Julien Benneteau,Rafael Nadal,6-0; 6-4; 6-2,R128,88,1,1,47,61,36,47,7,14,1,3,12,43,61,2,6,35,66,18,35,9,31,2,10,12,27,66
2005-01-17 00:00:00.000,Australian Open Australia Grand Slams,HARD,3,Bobby Reynolds,Nicolas Almagro,Bobby Reynolds,5-7; 6-4; 7-6(7); 7-6(5),R128,190,21,6,98,157,75,98,30,59,5,8,23,105,157,16,3,91,164,68,91,39,73,16,19,23,107,164
2005-01-17 00:00:00.000,Australian Open Australia Grand Slams,HARD,3,Andrei Pavel,Olivier Mutis,Andrei Pavel,6-4; 6-4; 6-0,R128,90,9,1,58,81,44,58,12,23,2,3,13,56,81,6,1,42,83,24,42,19,41,5,11,13,43,83
2005-01-17 00:00:00.000,Australian Open Australia Grand Slams,HARD,3,Juan Ignacio Chela,Wayne Arthurs,Juan Ignacio Chela,6-4; 7-6(4); 7-6(1),R128,133,3,0,73,98,62,73,16,25,2,2,17,78,98,15,7,57,120,43,57,36,63,1,2,17,79,120
2005-01-17 00:00:00.000,Australian Open Australia Grand Slams,HARD,3,Gregory Carraz,Paul-Henri Mathieu,Gregory Carraz,6-4; 5-7; 7-5; 7-6(5),R128,206,30,12,83,145,65,83,25,62,6,11,23,90,145,9,9,100,166,66,100,30,66,10,16,23,96,166
2005-01-17 00:00:00.000,Australian Open Australia Grand Slams,HARD,3,James Blake,Florian Mayer,James Blake,6-1; 6-2; 6-0,R128,70,5,4,40,76,33,40,22,36,3,3,11,55,76,2,4,28,64,15,28,14,36,5,12,10,29,64
2005-01-17 00:00:00.000,Australian Open Australia Grand Slams,HARD,3,Lleyton Hewitt,Arnaud Clement,Lleyton Hewitt,6-3; 6-4; 6-1,R128,108,12,2,52,79,45,52,12,27,1,1,13,57,79,2,1,38,72,26,38,15,34,3,8,13,41,72
2005-01-17 00:00:00.000,Australian Open Australia Grand Slams,HARD,3,Tim Henman,Cyril Saulnier,Tim Henman,6-1; 6-2; 4-6; 6-3,R128,154,4,4,74,117,50,74,24,43,10,13,17,74,117,2,4,70,115,41,70,20,45,6,14,17,61,115
2005-01-17 00:00:00.000,Australian Open Australia Grand Slams,HARD,3,Victor Hanescu,Filippo Volandri,Victor Hanescu,6-3; 6-4; 7-6(1),R128,122,6,0,79,117,52,79,27,38,13,14,16,79,117,1,7,49,95,34,49,24,46,5,8,15,58,95
2005-01-17 00:00:00.000,Australian Open Australia Grand Slams,HARD,3,Christophe Rochus,Albert Montanes,Christophe Rochus,6-2; 6-3; 6-3,R128,81,7,2,46,68,37,46,12,22,1,2,13,49,68,8,3,61,96,39,61,9,35,8,14,13,48,96
2005-01-17 00:00:00.000,Australian Open Australia Grand Slams,HARD,3,Nikolay Davydenko,Roko Karanusic,Nikolay Davydenko,6-2; 7-5; 6-2,R128,106,3,3,53,77,35,53,14,24,1,4,14,49,77,3,1,55,94,26,55,18,39,11,19,14,44,94
2005-01-17 00:00:00.000,Australian Open Australia Grand Slams,HARD,3,Radek Stepanek,Vincent Spadea,Radek Stepanek,6-3; 5-7; 4-6; 7-5; 6-3,R128,213,10,8,97,164,75,97,35,67,9,11,26,110,164,3,5,103,159,70,103,36,56,9,13,26,106,159
2005-01-17 00:00:00.000,Australian Open Australia Grand Slams,HARD,3,Jan Hernych,Felix Mantilla,Jan Hernych,6-4; 6-7(5); 6-1; 6-0,R128,134,5,2,73,103,60,73,17,30,1,2,18,77,103,2,9,66,122,40,66,25,56,10,17,17,65,122
2005-01-17 00:00:00.000,Australian Open Australia Grand Slams,HARD,3,Fernando Verdasco,Gilles Muller,Fernando Verdasco,6-3; 6-0; 6-4,R128,89,5,2,44,69,36,44,15,25,1,2,13,51,69,6,4,50,85,30,50,14,35,12,18,12,44,85
2005-01-17 00:00:00.000,Australian Open Australia Grand Slams,HARD,3,Guillermo Canas,Chris Guccione,Guillermo Canas,6-4; 6-2; 7-6(4),R128,122,7,3,71,103,57,71,15,32,6,7,15,72,103,16,8,63,115,43,63,23,52,12,16,15,66,115
2005-01-17 00:00:00.000,Australian Open Australia Grand Slams,HARD,3,Sebastien Grosjean,Michael Llodra,Sebastien Grosjean,6-3; 6-4; 6-3,R128,114,3,2,64,98,47,64,16,34,6,8,14,63,98,4,5,56,88,36,56,10,32,6,12,14,46,88
2005-01-17 00:00:00.000,Australian Open Australia Grand Slams,HARD,3,Jean-Rene Lisnard,Oliver Marach,Jean-Rene Lisnard,5-7; 5-7; 6-1; 6-4; 7-5,R128,285,8,15,108,212,76,108,51,104,22,27,27,127,212,8,7,94,174,66,94,39,80,11,18,26,105,174
2005-01-17 00:00:00.000,Australian Open Australia Grand Slams,HARD,3,Philipp Kohlschreiber,Kenneth Carlsen,Philipp Kohlschreiber,7-6(2); 6-2; 6-1,R128,132,1,3,55,94,44,55,21,39,5,6,14,65,94,4,9,56,105,38,56,17,49,13,18,13,55,105
2005-01-17 00:00:00.000,Australian Open Australia Grand Slams,HARD,3,Nicolas Massu,Antony Dupuis,Nicolas Massu,6-7(7); 7-6(2); 6-3; 6-2,R128,230,9,6,81,141,66,81,36,60,9,10,21,102,141,11,8,84,152,60,84,34,68,12,16,20,94,152
2005-01-17 00:00:00.000,Australian Open Australia Grand Slams,HARD,3,Jurgen Melzer,Raemon Sluiter,Jurgen Melzer,3-3 RET,R128,25,0,1,7,17,5,7,5,10,0,1,3,10,17,2,1,8,20,4,8,6,12,1,2,3,10,20
2005-01-17 00:00:00.000,Australian Open Australia Grand Slams,HARD,3,Nathan Healey,Flavio Saretta,Nathan Healey,4-6; 4-6; 6-1; 5-0 RET,R128,130,13,8,64,112,46,64,21,48,10,14,16,67,112,4,4,69,104,43,69,15,35,5,12,16,58,104
2005-01-17 00:00:00.000,Australian Open Australia Grand Slams,HARD,3,Greg Rusedski,Jonas Bjorkman,Greg Rusedski,2-6; 6-4; 6-0; 7-6(7),R128,163,14,9,69,120,51,69,25,51,7,10,18,76,120,1,8,73,130,49,73,28,57,8,13,18,77,130
2005-01-17 00:00:00.000,Australian Open Australia Grand Slams,HARD,3,Andy Roddick,Irakli Labadze,Andy Roddick,7-5; 6-2; 6-1,R128,92,11,0,47,71,40,47,18,24,4,4,14,58,71,5,7,54,81,29,54,14,27,4,9,13,43,81
2005-01-17 00:00:00.000,Australian Open Australia Grand Slams,HARD,3,Roger Federer,Takao Suzuki,Roger Federer,6-3; 6-4; 6-4,R64,113,7,0,59,84,45,59,17,25,3,4,15,62,84,7,3,71,105,39,71,21,34,7,11,14,60,105
2005-01-17 00:00:00.000,Australian Open Australia Grand Slams,HARD,3,Jarkko Nieminen,Paradorn Srichaphan,Jarkko Nieminen,6-3; 6-4; 6-2,R64,106,5,0,65,89,49,65,14,24,3,3,14,63,89,5,4,47,76,30,47,15,29,1,5,13,45,76
2005-01-17 00:00:00.000,Australian Open Australia Grand Slams,HARD,3,Marcos Baghdatis,Ivan Ljubicic,Marcos Baghdatis,7-6(1); 6-4; 6-7(2); 6-2,R64,166,13,3,67,117,54,67,36,50,7,8,21,90,117,20,1,86,141,64,86,25,55,10,14,21,89,141
2005-01-17 00:00:00.000,Australian Open Australia Grand Slams,HARD,3,Tommy Robredo,Tomas Zib,Tommy Robredo,6-4; 2-6; 6-2; 6-4,R64,160,16,8,64,112,46,64,24,48,3,7,18,70,112,3,3,71,128,45,71,28,57,10,16,18,73,128
2005-01-17 00:00:00.000,Australian Open Australia Grand Slams,HARD,3,Joachim Johansson,Peter Wessels,Joachim Johansson,6-3; 7-5; 6-4,R64,110,21,4,65,105,50,65,23,40,3,3,16,73,105,5,2,55,88,41,55,19,33,3,6,15,60,88
2005-01-17 00:00:00.000,Australian Open Australia Grand Slams,HARD,3,Feliciano Lopez,Sargis Sargsian,Feliciano Lopez,4-6; 6-3; 6-4; 7-6(3),R64,161,17,3,81,134,66,81,21,53,8,12,21,87,134,5,6,97,129,64,97,16,32,7,12,20,80,129
2005-01-17 00:00:00.000,Australian Open Australia Grand Slams,HARD,3,Taylor Dent,Michal Tabara,Taylor Dent,6-4; 6-1; 6-4,R64,97,6,15,58,92,42,58,9,34,9,14,14,51,92,2,11,28,75,15,28,15,47,5,14,13,30,75
2005-01-17 00:00:00.000,Australian Open Australia Grand Slams,HARD,3,Andre Agassi,Rainer Schuettler,Andre Agassi,6-3; 6-1; 6-0,R64,87,7,3,48,74,34,48,18,26,5,5,11,52,74,6,8,44,80,28,44,10,36,5,12,11,38,80
2005-01-17 00:00:00.000,Australian Open Australia Grand Slams,HARD,3,Marat Safin,Bohdan Ulihrach,Marat Safin,6-4; 6-1; 6-3,R64,81,10,0,40,67,34,40,16,27,0,1,13,50,67,4,5,47,83,26,47,17,36,3,9,13,43,83
2005-01-17 00:00:00.000,Australian Open Australia Grand Slams,HARD,3,Mario Ancic,Bjorn Phau,Mario Ancic,7-5; 6-2; 6-1,R64,108,12,2,50,76,42,50,15,26,3,4,14,57,76,1,6,53,90,31,53,16,37,5,11,13,47,90
2005-01-17 00:00:00.000,Australian Open Australia Grand Slams,HARD,3,Olivier Rochus,Gael Monfils,Olivier Rochus,6-1; 6-3; 6-3,R64,111,0,1,47,75,36,47,13,28,3,5,12,49,75,3,4,49,101,29,49,17,52,7,15,13,46,101
2005-01-17 00:00:00.000,Australian Open Australia Grand Slams,HARD,3,Karol Beck,Tommy Haas,Karol Beck,5-7; 2-6; 6-2; 7-6(5); 6-3,R64,212,14,11,77,145,61,77,31,68,8,14,25,92,145,13,9,85,161,56,85,42,76,10,16,24,98,161
2005-01-17 00:00:00.000,Australian Open Australia Grand Slams,HARD,3,Gaston Gaudio,Mardy Fish,Gaston Gaudio,2-6; 6-4; 7-5; 7-6(4),R64,180,8,11,63,128,48,63,32,65,5,11,21,80,128,17,6,67,138,46,67,35,71,6,12,21,81,138
2005-01-17 00:00:00.000,Australian Open Australia Grand Slams,HARD,3,Dominik Hrbaty,Janko Tipsarevic,Dominik Hrbaty,6-2; 7-6(1); 3-6; 7-5,R64,165,12,6,78,120,56,78,26,42,5,9,20,82,120,13,4,65,141,42,65,37,76,8,14,21,79,141
2005-01-17 00:00:00.000,Australian Open Australia Grand Slams,HARD,3,Thomas Johansson,Agustin Calleri,Thomas Johansson,6-4; 5-7; 6-3; 2-6; 7-5,R64,195,17,4,72,133,60,72,31,61,3,8,25,91,133,15,6,89,158,63,89,38,69,6,12,26,101,158
2005-01-17 00:00:00.000,Australian Open Australia Grand Slams,HARD,3,Kevin Kim,Guillermo Garcia-Lopez,Kevin Kim,6-2; 6-4; 6-2,R64,100,5,1,51,72,41,51,14,21,2,2,13,55,72,3,3,53,87,36,53,11,34,6,11,13,47,87
2005-01-17 00:00:00.000,Australian Open Australia Grand Slams,HARD,3,Guillermo Coria,Ricardo Mello,Guillermo Coria,6-4; 6-7(3); 6-3; 7-6(3),R64,237,4,2,91,153,58,91,28,62,6,13,21,86,153,8,5,102,167,61,102,30,65,14,24,22,91,167
2005-01-17 00:00:00.000,Australian Open Australia Grand Slams,HARD,3,Juan Carlos Ferrero,Mariano Zabaleta,Juan Carlos Ferrero,6-1; 6-2; 6-0,R64,83,2,1,52,73,37,52,13,21,3,3,11,50,73,2,5,29,58,17,29,10,29,4,11,10,27,58
2005-01-17 00:00:00.000,Australian Open Australia Grand Slams,HARD,3,Fernando Gonzalez,Igor Andreev,Fernando Gonzalez,7-5; 6-2; 6-3,R64,115,4,2,55,82,44,55,19,27,1,1,15,63,82,3,4,68,110,44,68,18,42,14,18,14,62,110
2005-01-17 00:00:00.000,Australian Open Australia Grand Slams,HARD,3,David Nalbandian,Santiago Ventura,David Nalbandian,6-0; 6-3; 2-6; 6-2,R64,143,3,1,57,99,38,57,28,42,4,6,15,66,99,10,5,45,109,30,45,28,64,8,15,16,58,109
2005-01-17 00:00:00.000,Australian Open Australia Grand Slams,HARD,3,Rafael Nadal,Mikhail Youzhny,Rafael Nadal,6-1; 4-6; 4-6; 7-5; 6-3,R64,217,0,2,108,153,71,108,21,45,8,14,24,92,153,9,5,73,140,47,73,32,67,5,14,24,79,140
2005-01-17 00:00:00.000,Australian Open Australia Grand Slams,HARD,3,Bobby Reynolds,Andrei Pavel,Bobby Reynolds,7-6(6); 6-2; 6-2,R64,107,10,1,48,83,35,48,22,35,5,7,14,57,83,5,6,62,92,41,62,10,30,4,10,14,51,92
2005-01-17 00:00:00.000,Australian Open Australia Grand Slams,HARD,3,Juan Ignacio Chela,Gregory Carraz,Juan Ignacio Chela,7-6(7); 6-2; 7-6(3),R64,127,5,2,71,102,56,71,22,31,6,7,16,78,102,8,3,68,109,49,68,22,41,5,8,16,71,109
2005-01-17 00:00:00.000,Australian Open Australia Grand Slams,HARD,3,Lleyton Hewitt,James Blake,Lleyton Hewitt,4-6; 7-6(8); 6-0; 6-3,R64,155,7,7,65,110,53,65,21,45,2,5,18,74,110,9,8,76,141,47,76,32,65,9,16,19,79,141
2005-01-17 00:00:00.000,Australian Open Australia Grand Slams,HARD,3,Tim Henman,Victor Hanescu,Tim Henman,7-5; 6-1; 6-4,R64,113,10,2,54,83,42,54,18,29,4,5,15,60,83,8,1,65,91,37,65,16,26,7,12,14,53,91
2005-01-17 00:00:00.000,Australian Open Australia Grand Slams,HARD,3,Nikolay Davydenko,Christophe Rochus,Nikolay Davydenko,6-4; 6-4; 6-2,R64,110,14,4,49,87,39,49,17,38,3,5,14,56,87,0,0,62,96,35,62,16,34,4,10,14,51,96
2005-01-17 00:00:00.000,Australian Open Australia Grand Slams,HARD,3,Radek Stepanek,Jan Hernych,Radek Stepanek,7-6(5); 6-1; 1-6; 6-7(2); 6-0,R64,209,11,6,91,156,68,91,26,65,7,12,22,94,156,0,3,93,146,55,93,30,53,8,16,22,85,146
2005-01-17 00:00:00.000,Australian Open Australia Grand Slams,HARD,3,Guillermo Canas,Fernando Verdasco,Guillermo Canas,3-6; 7-5; 6-3; 6-0,R64,166,9,5,68,112,45,68,22,44,6,11,18,67,112,2,6,72,119,35,72,24,47,9,18,18,59,119
2005-01-17 00:00:00.000,Australian Open Australia Grand Slams,HARD,3,Jean-Rene Lisnard,Sebastien Grosjean,Jean-Rene Lisnard,1-6; 4-6; 6-3; 6-4; 6-3,R64,208,1,8,66,126,44,66,25,60,2,10,22,69,126,11,6,96,166,60,96,29,70,12,21,23,89,166
2005-01-17 00:00:00.000,Australian Open Australia Grand Slams,HARD,3,Philipp Kohlschreiber,Nicolas Massu,Philipp Kohlschreiber,6-0; 2-0 RET,R64,41,5,0,19,29,15,19,6,10,2,2,4,21,29,0,2,9,21,3,9,1,12,1,5,4,4,21
2005-01-17 00:00:00.000,Australian Open Australia Grand Slams,HARD,3,Jurgen Melzer,Nathan Healey,Jurgen Melzer,6-3; 6-2; 7-6(3),R64,105,3,3,63,87,52,63,12,24,0,1,15,64,87,6,5,39,78,26,39,21,39,3,7,14,47,78
2005-01-17 00:00:00.000,Australian Open Australia Grand Slams,HARD,3,Andy Roddick,Greg Rusedski,Andy Roddick,6-0; 3-6; 6-2; 6-3,R64,93,11,2,55,76,49,55,14,21,1,2,16,63,76,12,4,63,101,44,63,14,38,10,16,16,58,101
2005-01-17 00:00:00.000,Australian Open Australia Grand Slams,HARD,3,Roger Federer,Jarkko Nieminen,Roger Federer,6-3; 5-2 RET,R32,57,2,1,35,49,23,35,8,14,3,5,8,31,49,1,3,36,56,16,36,9,20,2,7,8,25,56
2005-01-17 00:00:00.000,Australian Open Australia Grand Slams,HARD,3,Marcos Baghdatis,Tommy Robredo,Marcos Baghdatis,7-6(2); 6-4; 6-1,R32,122,4,2,50,97,41,50,23,47,3,5,14,64,97,3,5,73,112,52,73,9,39,9,15,15,61,112
2005-01-17 00:00:00.000,Australian Open Australia Grand Slams,HARD,3,Joachim Johansson,Feliciano Lopez,Joachim Johansson,6-3; 3-6; 5-7; 7-6(2); 13-11,R32,238,38,5,124,197,93,124,46,73,10,13,33,139,197,34,8,122,202,95,122,46,80,11,14,33,141,202
2005-01-17 00:00:00.000,Australian Open Australia Grand Slams,HARD,3,Andre Agassi,Taylor Dent,Andre Agassi,7-5; 7-6(3); 6-1,R32,112,3,0,57,90,41,57,20,33,7,11,15,61,90,2,9,74,112,43,74,13,38,12,20,16,56,112
2005-01-17 00:00:00.000,Australian Open Australia Grand Slams,HARD,3,Marat Safin,Mario Ancic,Marat Safin,6-4; 3-6; 6-3; 6-4,R32,165,11,1,64,115,46,64,32,51,3,5,19,78,115,6,7,74,118,56,74,20,44,4,8,19,76,118
2005-01-17 00:00:00.000,Australian Open Australia Grand Slams,HARD,3,Olivier Rochus,Karol Beck,Olivier Rochus,6-7(6); 6-1; 6-4; 6-2,R32,188,4,3,81,131,59,81,29,50,8,9,19,88,131,12,8,76,139,56,76,24,63,11,17,18,80,139
2005-01-17 00:00:00.000,Australian Open Australia Grand Slams,HARD,3,Dominik Hrbaty,Gaston Gaudio,Dominik Hrbaty,7-6(5); 6-7(8); 6-7(3); 6-1; 6-3,R32,261,15,8,111,201,80,111,38,90,16,22,26,118,201,8,7,117,191,79,117,30,74,12,22,26,109,191
2005-01-17 00:00:00.000,Australian Open Australia Grand Slams,HARD,3,Thomas Johansson,Kevin Kim,Thomas Johansson,3-6; 6-2; 6-7(4); 6-2; 6-2,R32,193,17,3,74,131,61,74,34,57,3,5,22,95,131,14,7,89,162,61,89,31,73,9,16,23,92,162
2005-01-17 00:00:00.000,Australian Open Australia Grand Slams,HARD,3,Guillermo Coria,Juan Carlos Ferrero,Guillermo Coria,6-3; 6-2; 6-1,R32,123,5,2,51,78,33,51,14,27,5,8,12,47,78,2,3,52,89,25,52,14,37,5,14,12,39,89
2005-01-17 00:00:00.000,Australian Open Australia Grand Slams,HARD,3,David Nalbandian,Fernando Gonzalez,David Nalbandian,6-7(3); 7-5; 6-2; 6-3,R32,191,10,5,82,128,63,82,22,46,9,12,20,85,128,7,8,106,167,69,106,24,61,16,24,21,93,167
2005-01-17 00:00:00.000,Australian Open Australia Grand Slams,HARD,3,Rafael Nadal,Bobby Reynolds,Rafael Nadal,6-1; 6-1; 6-3,R32,89,2,3,43,69,35,43,14,26,1,2,12,49,69,3,9,37,69,20,37,12,32,7,14,11,32,69
2005-01-17 00:00:00.000,Australian Open Australia Grand Slams,HARD,3,Lleyton Hewitt,Juan Ignacio Chela,Lleyton Hewitt,6-2; 4-6; 6-1; 6-4,R32,137,9,3,65,105,48,65,20,40,2,5,18,68,105,1,3,70,103,39,70,17,33,9,16,17,56,103
2005-01-17 00:00:00.000,Australian Open Australia Grand Slams,HARD,3,Nikolay Davydenko,Tim Henman,Nikolay Davydenko,6-4; 6-2; 6-2,R32,126,1,0,67,92,46,67,17,25,5,5,13,63,92,2,5,57,97,38,57,16,40,10,15,13,54,97
2005-01-17 00:00:00.000,Australian Open Australia Grand Slams,HARD,3,Guillermo Canas,Radek Stepanek,Guillermo Canas,6-1; 6-2; 6-2,R32,94,3,1,42,67,32,42,16,25,3,4,12,48,67,1,1,40,66,21,40,7,26,7,14,11,28,66
2005-01-17 00:00:00.000,Australian Open Australia Grand Slams,HARD,3,Philipp Kohlschreiber,Jean-Rene Lisnard,Philipp Kohlschreiber,7-5; 6-3; 6-2,R32,123,1,2,53,89,39,53,23,36,4,5,14,62,89,2,5,50,100,29,50,25,50,3,9,15,54,100
2005-01-17 00:00:00.000,Australian Open Australia Grand Slams,HARD,3,Andy Roddick,Jurgen Melzer,Andy Roddick,6-2; 6-2; 7-5,R32,95,22,0,52,76,43,52,17,24,3,3,14,60,76,2,3,63,94,36,63,15,31,5,10,14,51,94
2005-01-17 00:00:00.000,Australian Open Australia Grand Slams,HARD,3,Roger Federer,Marcos Baghdatis,Roger Federer,6-2; 6-2; 7-6(4),R16,103,9,0,47,78,40,47,20,31,0,1,14,60,78,4,1,51,96,30,51,25,45,3,8,14,55,96
2005-01-17 00:00:00.000,Australian Open Australia Grand Slams,HARD,3,Andre Agassi,Joachim Johansson,Andre Agassi,6-7(4); 7-6(5); 7-6(3); 6-4,R16,158,16,4,91,139,74,91,29,48,2,4,23,103,139,51,9,96,149,78,96,27,53,7,10,23,105,149
2005-01-17 00:00:00.000,Australian Open Australia Grand Slams,HARD,3,Marat Safin,Olivier Rochus,Marat Safin,4-6; 7-6(1); 7-6(5); 7-6(2),R16,222,29,1,87,140,72,87,32,53,3,5,23,104,140,1,3,113,180,81,113,30,67,17,18,23,111,180
2005-01-17 00:00:00.000,Australian Open Australia Grand Slams,HARD,3,Dominik Hrbaty,Thomas Johansson,Dominik Hrbaty,7-5; 6-3; 6-1,R16,101,6,2,45,78,39,45,19,33,1,1,14,58,78,12,5,65,108,39,65,19,43,5,10,14,58,108
2005-01-17 00:00:00.000,Australian Open Australia Grand Slams,HARD,3,David Nalbandian,Guillermo Coria,David Nalbandian,5-7; 7-5; 6-3; 6-0,R16,204,1,5,84,135,58,84,18,51,14,20,20,76,135,4,3,92,139,55,92,14,47,6,16,19,69,139
2005-01-17 00:00:00.000,Australian Open Australia Grand Slams,HARD,3,Lleyton Hewitt,Rafael Nadal,Lleyton Hewitt,7-5; 3-6; 1-6; 7-6(3); 6-2,R16,233,18,6,75,146,57,75,37,71,12,18,24,94,146,5,3,111,160,72,111,28,49,12,17,24,100,160
2005-01-17 00:00:00.000,Australian Open Australia Grand Slams,HARD,3,Nikolay Davydenko,Guillermo Canas,Nikolay Davydenko,6-3; 6-4; 6-3,R16,132,6,5,59,99,42,59,24,40,3,4,14,66,99,1,4,37,72,22,37,23,35,3,8,14,45,72
2005-01-17 00:00:00.000,Australian Open Australia Grand Slams,HARD,3,Andy Roddick,Philipp Kohlschreiber,Andy Roddick,6-3; 7-6(6); 6-1,R16,87,15,2,59,86,50,59,17,27,1,1,15,67,86,5,2,43,77,32,43,18,34,1,4,13,50,77
2005-01-17 00:00:00.000,Australian Open Australia Grand Slams,HARD,3,Roger Federer,Andre Agassi,Roger Federer,6-3; 6-4; 6-4,Q,99,22,4,65,99,50,65,21,34,4,4,15,71,99,1,2,44,79,33,44,18,35,3,6,14,51,79
2005-01-17 00:00:00.000,Australian Open Australia Grand Slams,HARD,3,Marat Safin,Dominik Hrbaty,Marat Safin,6-2; 6-4; 6-2,Q,90,14,2,34,69,30,34,20,35,3,4,13,50,69,2,0,32,72,20,32,17,40,2,8,13,37,72
2005-01-17 00:00:00.000,Australian Open Australia Grand Slams,HARD,3,Lleyton Hewitt,David Nalbandian,Lleyton Hewitt,6-3; 6-2; 1-6; 3-6; 10-8,Q,245,16,6,79,157,58,79,40,78,6,12,26,98,157,4,4,96,154,68,96,26,58,10,16,25,94,154
2005-01-17 00:00:00.000,Australian Open Australia Grand Slams,HARD,3,Andy Roddick,Nikolay Davydenko,Andy Roddick,6-3; 7-5; 4-1 RET,Q,95,17,2,52,79,41,52,14,27,4,5,13,55,79,5,3,43,74,28,43,13,31,4,9,13,41,74
2005-01-17 00:00:00.000,Australian Open Australia Grand Slams,HARD,3,Marat Safin,Roger Federer,Marat Safin,5-7; 6-4; 5-7; 7-6(6); 9-7,S,268,16,1,123,207,91,123,44,84,10,14,31,135,207,22,8,107,188,88,107,41,81,9,13,31,129,188
2005-01-17 00:00:00.000,Australian Open Australia Grand Slams,HARD,3,Lleyton Hewitt,Andy Roddick,Lleyton Hewitt,3-6; 7-6(3); 7-6(4); 6-1,S,174,14,7,84,135,70,84,24,51,6,8,20,94,135,31,9,75,134,61,75,25,59,9,12,20,86,134
2005-01-17 00:00:00.000,Australian Open Australia Grand Slams,HARD,3,Marat Safin,Lleyton Hewitt,Marat Safin,1-6; 6-3; 6-4; 6-4,F,165,18,1,66,110,48,66,25,44,5,8,18,73,110,7,3,61,125,43,61,33,64,7,11,18,76,125
2005-01-31 00:00:00.000,Delray Beach FL; U.S.A. ATP World Tour,HARD,2,Vincent Spadea,Hugo Armando,Vincent Spadea,6-2; 6-3,R32,60,3,1,29,52,22,29,17,23,2,2,9,39,52,2,0,32,50,22,32,5,18,2,5,8,27,50
2005-01-31 00:00:00.000,Delray Beach FL; U.S.A. ATP World Tour,HARD,2,Teymuraz Gabashvili,James Blake,Teymuraz Gabashvili,4-6; 6-2; 6-2,R32,100,3,4,42,85,32,42,20,43,5,8,13,52,85,3,1,44,76,24,44,15,32,1,7,13,39,76
2005-01-31 00:00:00.000,Delray Beach FL; U.S.A. ATP World Tour,HARD,2,Todd Widom,Olivier Mutis,Todd Widom,7-6(6); 6-7(4); 6-3,R32,160,5,6,79,130,53,79,24,51,4,7,17,77,130,8,3,64,118,50,64,22,54,6,10,16,72,118
2005-01-31 00:00:00.000,Delray Beach FL; U.S.A. ATP World Tour,HARD,2,Kevin Kim,Frank Dancevic,Kevin Kim,6-4; 6-1,R32,63,10,0,33,56,24,33,14,23,1,1,8,38,56,2,3,29,53,17,29,10,24,3,7,9,27,53
2005-01-31 00:00:00.000,Delray Beach FL; U.S.A. ATP World Tour,HARD,2,Xavier Malisse,Jeff Morrison,Xavier Malisse,6-2; 4-6; 7-5,R32,110,6,3,54,84,44,54,17,30,3,5,15,61,84,12,4,63,99,43,63,17,36,4,8,15,60,99
2005-01-31 00:00:00.000,Delray Beach FL; U.S.A. ATP World Tour,HARD,2,Juan-Pablo Guzman,Roko Karanusic,Juan-Pablo Guzman,6-2; 3-6; 6-3,R32,88,1,4,40,78,29,40,26,38,2,3,13,55,78,3,3,44,77,33,44,15,33,5,8,13,48,77
2005-01-31 00:00:00.000,Delray Beach FL; U.S.A. ATP World Tour,HARD,2,Peng Sun,Matias Boeker,Peng Sun,6-3; 6-4,R32,91,2,2,40,67,28,40,12,27,3,5,10,40,67,3,2,44,69,25,44,11,25,6,10,9,36,69
2005-01-31 00:00:00.000,Delray Beach FL; U.S.A. ATP World Tour,HARD,2,Ramon Delgado,Glenn Weiner,Ramon Delgado,6-2; 6-1,R32,56,6,1,35,56,24,35,14,21,2,2,8,38,56,3,4,18,40,11,18,6,22,1,5,7,17,40
2005-01-31 00:00:00.000,Delray Beach FL; U.S.A. ATP World Tour,HARD,2,Ricardo Mello,Tomas Zib,Ricardo Mello,7-6(4); 6-3,R32,81,5,1,39,63,32,39,18,24,0,0,11,50,63,3,1,45,69,33,45,12,24,5,6,10,45,69
2005-01-31 00:00:00.000,Delray Beach FL; U.S.A. ATP World Tour,HARD,2,Wesley Moodie,Jeff Salzenstein,Wesley Moodie,7-5; 6-2,R32,72,7,1,41,62,31,41,12,21,1,1,10,43,62,3,5,32,57,21,32,13,25,2,5,10,34,57
2005-01-31 00:00:00.000,Delray Beach FL; U.S.A. ATP World Tour,HARD,2,Peter Wessels,Dennis van Scheppingen,Peter Wessels,6-2; 6-4,R32,60,8,0,50,65,34,50,9,15,1,1,9,43,65,1,6,36,60,25,36,8,24,5,8,9,33,60
2005-01-31 00:00:00.000,Delray Beach FL; U.S.A. ATP World Tour,HARD,2,Jan-Michael Gambill,Cyril Saulnier,Jan-Michael Gambill,7-5; 3-6; 6-4,R32,121,21,7,60,109,50,60,24,49,8,9,15,74,109,10,1,50,93,37,50,25,43,1,3,16,62,93
2005-01-31 00:00:00.000,Delray Beach FL; U.S.A. ATP World Tour,HARD,2,Kenneth Carlsen,Eric Nunez,Kenneth Carlsen,7-5; 6-4,R32,129,8,1,46,77,34,46,17,31,5,6,11,51,77,3,2,51,94,26,51,28,43,10,13,11,54,94
2005-01-31 00:00:00.000,Delray Beach FL; U.S.A. ATP World Tour,HARD,2,Brian Vahaly,Robert Kendrick,Brian Vahaly,7-5; 6-4,R32,79,3,2,41,64,30,41,10,23,1,3,11,40,64,6,3,42,78,25,42,18,36,3,7,11,43,78
2005-01-31 00:00:00.000,Delray Beach FL; U.S.A. ATP World Tour,HARD,2,Philipp Kohlschreiber,Wayne Odesnik,Philipp Kohlschreiber,6-3; 6-4,R32,66,5,0,41,68,31,41,14,27,2,2,10,45,68,3,3,35,51,23,35,10,16,2,4,9,33,51
2005-01-31 00:00:00.000,Delray Beach FL; U.S.A. ATP World Tour,HARD,2,Jiri Novak,Amer Delic,Jiri Novak,6-4; 6-3,R32,78,4,1,35,56,23,35,12,21,4,6,9,35,56,3,3,38,77,20,38,18,39,11,16,10,38,77
2005-01-31 00:00:00.000,Delray Beach FL; U.S.A. ATP World Tour,HARD,2,Vincent Spadea,Teymuraz Gabashvili,Vincent Spadea,4-6; 7-5; 6-3,R16,149,8,4,67,119,48,67,24,52,5,8,16,72,119,10,5,50,93,36,50,19,43,6,10,15,55,93
2005-01-31 00:00:00.000,Delray Beach FL; U.S.A. ATP World Tour,HARD,2,Kevin Kim,Todd Widom,Kevin Kim,6-2; 6-3,R16,75,3,3,30,49,26,30,9,19,1,1,8,35,49,2,0,46,63,26,46,7,17,5,9,9,33,63
2005-01-31 00:00:00.000,Delray Beach FL; U.S.A. ATP World Tour,HARD,2,Xavier Malisse,Juan-Pablo Guzman,Xavier Malisse,6-4; 3-6; 6-1,R16,101,11,3,52,83,37,52,17,31,7,9,13,54,83,1,5,50,80,32,50,13,30,4,8,13,45,80
2005-01-31 00:00:00.000,Delray Beach FL; U.S.A. ATP World Tour,HARD,2,Ramon Delgado,Peng Sun,Ramon Delgado,6-7(6); 6-1; 6-1,R16,119,4,1,53,83,42,53,15,30,7,8,13,57,83,4,3,57,97,35,57,16,40,6,12,13,51,97
2005-01-31 00:00:00.000,Delray Beach FL; U.S.A. ATP World Tour,HARD,2,Wesley Moodie,Ricardo Mello,Wesley Moodie,6-4; 6-4,R16,72,13,1,42,61,31,42,13,19,2,2,10,44,61,5,1,35,55,23,35,14,20,2,4,10,37,55
2005-01-31 00:00:00.000,Delray Beach FL; U.S.A. ATP World Tour,HARD,2,Peter Wessels,Jan-Michael Gambill,Peter Wessels,6-4; 6-7(3); 6-3,R16,129,8,3,53,102,37,53,30,49,6,7,16,67,102,7,8,50,109,38,50,28,59,2,5,15,66,109
2005-01-31 00:00:00.000,Delray Beach FL; U.S.A. ATP World Tour,HARD,2,Kenneth Carlsen,Brian Vahaly,Kenneth Carlsen,2-6; 7-6(5); 6-3,R16,139,9,1,60,98,47,60,17,38,5,7,14,64,98,3,2,67,100,45,67,21,33,6,8,15,66,100
2005-01-31 00:00:00.000,Delray Beach FL; U.S.A. ATP World Tour,HARD,2,Jiri Novak,Philipp Kohlschreiber,Jiri Novak,6-2; 6-1,R16,52,5,2,28,39,21,28,8,11,1,1,7,29,39,4,0,34,59,18,34,10,25,2,7,8,28,59
2005-01-31 00:00:00.000,Delray Beach FL; U.S.A. ATP World Tour,HARD,2,Vincent Spadea,Kevin Kim,Vincent Spadea,7-5; 6-7(0); 6-4,Q,149,4,2,73,117,45,73,25,44,11,15,17,70,117,4,4,67,122,47,67,22,55,8,14,17,69,122
2005-01-31 00:00:00.000,Delray Beach FL; U.S.A. ATP World Tour,HARD,2,Xavier Malisse,Ramon Delgado,Xavier Malisse,6-2; 6-2,Q,56,7,4,26,48,23,26,11,22,1,1,8,34,48,0,5,25,40,17,25,5,15,0,4,8,22,40
2005-01-31 00:00:00.000,Delray Beach FL; U.S.A. ATP World Tour,HARD,2,Wesley Moodie,Peter Wessels,Wesley Moodie,5-0 RET,Q,12,5,0,7,8,7,7,1,1,0,0,2,8,8,1,1,13,19,4,13,2,6,0,3,3,6,19
2005-01-31 00:00:00.000,Delray Beach FL; U.S.A. ATP World Tour,HARD,2,Jiri Novak,Kenneth Carlsen,Jiri Novak,6-3; 7-5,Q,75,5,3,38,65,30,38,18,27,0,0,11,48,65,7,2,38,62,28,38,11,24,4,6,10,39,62
2005-01-31 00:00:00.000,Delray Beach FL; U.S.A. ATP World Tour,HARD,2,Xavier Malisse,Vincent Spadea,Xavier Malisse,7-5; 6-4,S,94,1,1,43,67,28,43,8,24,4,8,11,36,67,0,1,43,68,25,43,8,25,6,12,11,33,68
2005-01-31 00:00:00.000,Delray Beach FL; U.S.A. ATP World Tour,HARD,2,Jiri Novak,Wesley Moodie,Jiri Novak,6-3; 6-3,S,71,4,1,37,47,31,37,6,10,0,0,9,37,47,6,1,54,80,32,54,11,26,9,12,9,43,80
2005-01-31 00:00:00.000,Delray Beach FL; U.S.A. ATP World Tour,HARD,2,Xavier Malisse,Jiri Novak,Xavier Malisse,7-6(6); 6-2,F,85,10,2,44,67,36,44,8,23,5,6,10,44,67,2,3,46,80,29,46,16,34,6,9,10,45,80
2005-01-31 00:00:00.000,Milan Italy ATP World Tour,HARD,2,Andrei Pavel,Gregory Carraz,Andrei Pavel,7-6(0); 6-7(5); 7-6(3),R32,131,28,2,89,122,74,89,17,33,4,4,18,91,122,33,12,75,109,63,75,17,34,1,1,18,80,109
2005-01-31 00:00:00.000,Milan Italy ATP World Tour,HARD,2,Tomas Behrend,Igor Andreev,Tomas Behrend,6-4; 5-7; 6-2,R32,125,5,6,58,92,44,58,17,34,4,6,15,61,92,13,6,62,114,47,62,20,52,11,15,15,67,114
2005-01-31 00:00:00.000,Milan Italy ATP World Tour,HARD,2,Gilles Muller,Michael Llodra,Gilles Muller,7-6(5); 7-5,R32,78,15,2,52,68,44,52,7,16,0,1,12,51,68,15,1,51,80,37,51,16,29,6,8,12,53,80
2005-01-31 00:00:00.000,Milan Italy ATP World Tour,HARD,2,Max Mirnyi,Francesco Aldi,Max Mirnyi,6-3; 7-6(5),R32,87,21,3,51,71,44,51,10,20,4,4,11,54,71,2,1,50,68,37,50,10,18,7,8,10,47,68
2005-01-31 00:00:00.000,Milan Italy ATP World Tour,HARD,2,Mario Ancic,Bohdan Ulihrach,Mario Ancic,6-4; 7-5,R32,63,17,0,42,48,39,42,5,6,0,0,11,44,48,0,4,50,69,36,50,7,19,4,6,11,43,69
2005-01-31 00:00:00.000,Milan Italy ATP World Tour,HARD,2,Sergiy Stakhovsky,Christophe Rochus,Sergiy Stakhovsky,6-2; 6-3,R32,48,11,2,29,44,24,29,10,15,3,3,8,34,44,1,1,33,55,18,33,12,22,7,11,9,30,55
2005-01-31 00:00:00.000,Milan Italy ATP World Tour,HARD,2,Gael Monfils,Julien Benneteau,Gael Monfils,6-3; 6-3,R32,69,13,5,30,56,27,30,11,26,3,4,9,38,56,4,5,44,64,26,44,8,20,8,12,9,34,64
2005-01-31 00:00:00.000,Milan Italy ATP World Tour,HARD,2,Robin Soderling,Arnaud Clement,Robin Soderling,6-1; 6-7(3); 6-4,R32,122,18,1,60,88,45,60,17,28,3,4,15,62,88,13,4,54,102,40,54,21,48,3,7,14,61,102
2005-01-31 00:00:00.000,Milan Italy ATP World Tour,HARD,2,Rainer Schuettler,Davide Sanguinetti,Rainer Schuettler,7-5; 4-6; 6-3,R32,117,5,1,50,98,33,50,31,48,3,5,16,64,98,5,0,47,83,37,47,15,36,3,6,15,52,83
2005-01-31 00:00:00.000,Milan Italy ATP World Tour,HARD,2,Sjeng Schalken,Jonas Bjorkman,Sjeng Schalken,6-2; 6-2,R32,72,4,0,34,49,27,34,9,15,2,2,8,36,49,1,4,20,56,11,20,17,36,3,7,8,28,56
2005-01-31 00:00:00.000,Milan Italy ATP World Tour,HARD,2,Ivo Karlovic,Alan Mackin,Ivo Karlovic,6-7(5); 6-3; 7-6(3),R32,123,31,1,66,104,59,66,23,38,2,2,17,82,104,7,2,75,105,58,75,14,30,4,5,16,72,105
2005-01-31 00:00:00.000,Milan Italy ATP World Tour,HARD,2,Radek Stepanek,Daniele Bracciali,Radek Stepanek,7-6(3); 6-4,R32,83,11,2,44,61,36,44,12,17,1,1,11,48,61,7,1,29,74,24,29,23,45,1,2,11,47,74
2005-01-31 00:00:00.000,Milan Italy ATP World Tour,HARD,2,Karol Beck,Victor Hanescu,Karol Beck,6-4; 6-4,R32,72,5,1,38,55,30,38,12,17,2,2,10,42,55,6,1,48,64,38,48,4,16,5,7,10,42,64
2005-01-31 00:00:00.000,Milan Italy ATP World Tour,HARD,2,Andreas Seppi,Uros Vico,Andreas Seppi,6-2; 7-6(3),R32,77,3,4,35,57,30,35,16,22,0,0,10,46,57,7,6,39,69,28,39,15,30,3,5,10,43,69
2005-01-31 00:00:00.000,Milan Italy ATP World Tour,HARD,2,Ivo Heuberger,Giorgio Galimberti,Ivo Heuberger,4-6; 6-3; 7-6(4),R32,144,15,1,61,102,49,61,20,41,6,9,16,69,102,3,4,74,116,48,74,19,42,9,12,15,67,116
2005-01-31 00:00:00.000,Milan Italy ATP World Tour,HARD,2,Ivan Ljubicic,Thomas Enqvist,Ivan Ljubicic,7-5; 6-3,R32,79,15,3,51,63,40,51,7,12,3,3,11,47,63,13,4,40,67,32,40,11,27,6,8,10,43,67
2005-01-31 00:00:00.000,Milan Italy ATP World Tour,HARD,2,Tomas Behrend,Andrei Pavel,Tomas Behrend,7-5; 7-6(3),R16,86,4,4,44,82,40,44,20,38,5,5,12,60,82,11,1,42,62,36,42,12,20,0,1,12,48,62
2005-01-31 00:00:00.000,Milan Italy ATP World Tour,HARD,2,Max Mirnyi,Gilles Muller,Max Mirnyi,7-6(1); 7-6(4),R16,95,15,3,49,73,42,49,13,24,1,2,12,55,73,14,5,59,94,43,59,15,35,7,8,12,58,94
2005-01-31 00:00:00.000,Milan Italy ATP World Tour,HARD,2,Sergiy Stakhovsky,Mario Ancic,Sergiy Stakhovsky,6-4; 4-6; 7-6(3),R16,102,13,2,61,92,50,61,20,31,2,3,16,70,92,13,0,53,75,45,53,18,22,0,1,16,63,75
2005-01-31 00:00:00.000,Milan Italy ATP World Tour,HARD,2,Robin Soderling,Gael Monfils,Robin Soderling,6-3; 6-4,R16,65,6,3,33,60,26,33,20,27,3,3,10,46,60,13,0,32,55,28,32,7,23,4,6,9,35,55
2005-01-31 00:00:00.000,Milan Italy ATP World Tour,HARD,2,Rainer Schuettler,Sjeng Schalken,Rainer Schuettler,6-3; 6-4,R16,75,6,1,43,62,32,43,10,19,1,2,10,42,62,1,2,33,48,21,33,9,15,0,3,9,30,48
2005-01-31 00:00:00.000,Milan Italy ATP World Tour,HARD,2,Radek Stepanek,Ivo Karlovic,Radek Stepanek,7-6(7); 4-6; 7-6(5),R16,119,8,4,76,98,63,76,17,22,0,1,17,80,98,25,1,66,102,55,66,26,36,0,0,17,81,102
2005-01-31 00:00:00.000,Milan Italy ATP World Tour,HARD,2,Karol Beck,Andreas Seppi,Karol Beck,7-5; 4-6; 6-3,R16,122,9,4,79,119,54,79,21,40,8,10,16,75,119,2,1,61,89,41,61,15,28,3,6,15,56,89
2005-01-31 00:00:00.000,Milan Italy ATP World Tour,HARD,2,Ivan Ljubicic,Ivo Heuberger,Ivan Ljubicic,6-1; 6-2,R16,67,9,1,33,59,26,33,13,26,4,4,8,39,59,2,2,21,43,15,21,7,22,4,8,7,22,43
2005-01-31 00:00:00.000,Milan Italy ATP World Tour,HARD,2,Max Mirnyi,Tomas Behrend,Max Mirnyi,6-3; 6-2,Q,62,10,3,31,45,28,31,9,14,2,2,9,37,45,6,2,35,55,24,35,7,20,3,6,8,31,55
2005-01-31 00:00:00.000,Milan Italy ATP World Tour,HARD,2,Robin Soderling,Sergiy Stakhovsky,Robin Soderling,6-3; 6-2,Q,57,9,1,33,55,26,33,13,22,0,0,9,39,55,5,2,38,60,26,38,7,22,6,9,8,33,60
2005-01-31 00:00:00.000,Milan Italy ATP World Tour,HARD,2,Radek Stepanek,Rainer Schuettler,Radek Stepanek,7-6(4); 4-6; 6-3,Q,138,11,6,82,112,61,82,13,30,8,10,16,74,112,6,7,53,91,44,53,16,38,6,8,15,60,91
2005-01-31 00:00:00.000,Milan Italy ATP World Tour,HARD,2,Ivan Ljubicic,Karol Beck,Ivan Ljubicic,6-7(4); 6-0; 6-2,Q,118,21,6,54,90,40,54,18,36,7,8,13,58,90,7,3,51,87,34,51,13,36,8,14,13,47,87
2005-01-31 00:00:00.000,Milan Italy ATP World Tour,HARD,2,Robin Soderling,Max Mirnyi,Robin Soderling,6-7(5); 6-3; 6-4,S,115,12,5,67,100,55,67,16,33,4,4,16,71,100,14,3,61,89,48,61,16,28,4,6,15,64,89
2005-01-31 00:00:00.000,Milan Italy ATP World Tour,HARD,2,Radek Stepanek,Ivan Ljubicic,Radek Stepanek,6-4; 6-2,S,65,5,2,36,49,29,36,8,13,0,0,9,37,49,2,4,33,57,22,33,12,24,8,11,9,34,57
2005-01-31 00:00:00.000,Milan Italy ATP World Tour,HARD,2,Robin Soderling,Radek Stepanek,Robin Soderling,6-3; 6-7(2); 7-6(5),F,117,18,1,60,96,53,60,25,36,0,0,17,78,96,15,8,72,104,59,72,18,32,3,4,16,77,104
2005-01-31 00:00:00.000,Vi±a del Mar Chile ATP World Tour,CLAY,2,Gaston Gaudio,Jiri Vanek,Gaston Gaudio,7-6(6); 6-2,R32,83,3,6,42,75,34,42,17,33,6,7,10,51,75,9,5,46,79,30,46,15,33,6,9,10,45,79
2005-01-31 00:00:00.000,Vi±a del Mar Chile ATP World Tour,CLAY,2,David Sanchez,Albert Montanes,David Sanchez,5-7; 6-4; 6-4,R32,148,3,2,69,101,49,69,12,32,2,6,16,61,101,3,1,66,104,41,66,19,38,5,10,16,60,104
2005-01-31 00:00:00.000,Vi±a del Mar Chile ATP World Tour,CLAY,2,Flavio Saretta,Felipe Parada,Flavio Saretta,6-4; 4-6; 6-3,R32,149,11,2,55,98,40,55,18,43,8,12,15,58,98,2,2,57,100,35,57,21,43,8,13,14,56,100
2005-01-31 00:00:00.000,Vi±a del Mar Chile ATP World Tour,CLAY,2,Jose Acasuso,Olivier Patience,Jose Acasuso,6-1; 3-6; 7-6(6),R32,115,6,6,59,95,42,59,20,36,7,9,14,62,95,4,2,58,101,41,58,20,43,8,11,14,61,101
2005-01-31 00:00:00.000,Vi±a del Mar Chile ATP World Tour,CLAY,2,David Ferrer,Albert Portas,David Ferrer,6-4; 6-4,R32,92,3,2,45,62,33,45,8,17,3,4,10,41,62,3,5,41,78,28,41,15,37,4,7,10,43,78
2005-01-31 00:00:00.000,Vi±a del Mar Chile ATP World Tour,CLAY,2,Mariano Puerta,Juan Monaco,Mariano Puerta,6-3; 6-7(6); 7-5,R32,149,4,0,67,102,51,67,19,35,3,5,17,70,102,6,4,77,116,55,77,16,39,5,9,16,71,116
2005-01-31 00:00:00.000,Vi±a del Mar Chile ATP World Tour,CLAY,2,Federico Luzzi,Janko Tipsarevic,Federico Luzzi,7-6(6); 6-0,R32,92,6,4,29,61,24,29,17,32,4,5,9,41,61,4,6,39,69,25,39,10,30,4,8,9,35,69
2005-01-31 00:00:00.000,Vi±a del Mar Chile ATP World Tour,CLAY,2,Agustin Calleri,Alex Calatrava,Agustin Calleri,6-3; 6-2,R32,59,4,2,24,47,20,24,15,23,1,2,9,35,47,3,1,29,46,18,29,5,17,2,6,8,23,46
2005-01-31 00:00:00.000,Vi±a del Mar Chile ATP World Tour,CLAY,2,Ruben Ramirez Hidalgo,Potito Starace,Ruben Ramirez Hidalgo,6-1; 6-2,R32,60,4,3,27,47,21,27,13,20,2,2,8,34,47,0,1,26,44,12,26,9,18,3,7,7,21,44
2005-01-31 00:00:00.000,Vi±a del Mar Chile ATP World Tour,CLAY,2,Felix Mantilla,Adrian Garcia,Felix Mantilla,6-4; 3-2 RET,R32,64,2,2,29,51,20,29,13,22,1,3,8,33,51,0,3,20,40,13,20,9,20,0,3,7,22,40
2005-01-31 00:00:00.000,Vi±a del Mar Chile ATP World Tour,CLAY,2,Paul-Henri Mathieu,Oscar Hernandez,Paul-Henri Mathieu,6-2; 7-6(3),R32,91,4,3,40,64,31,40,18,24,0,0,10,49,64,2,0,43,64,30,43,10,21,2,4,10,40,64
2005-01-31 00:00:00.000,Vi±a del Mar Chile ATP World Tour,CLAY,2,Filippo Volandri,Guillermo Garcia-Lopez,Filippo Volandri,6-1; 6-3,R32,75,1,6,37,64,24,37,12,27,4,6,8,36,64,4,5,37,61,18,37,8,24,8,14,8,26,61
2005-01-31 00:00:00.000,Vi±a del Mar Chile ATP World Tour,CLAY,2,Mariano Zabaleta,Nicolas Lapentti,Mariano Zabaleta,6-1; 6-2,R32,58,5,1,25,45,20,25,14,20,1,1,8,34,45,2,2,24,43,15,24,7,19,4,8,7,22,43
2005-01-31 00:00:00.000,Vi±a del Mar Chile ATP World Tour,CLAY,2,Santiago Ventura,Phillip Harboe,Santiago Ventura,6-3; 4-6; 6-2,R32,126,7,4,46,82,35,46,21,36,4,6,14,56,82,3,2,56,90,36,56,17,34,6,10,13,53,90
2005-01-31 00:00:00.000,Vi±a del Mar Chile ATP World Tour,CLAY,2,Nicolas Almagro,Alex Corretja,Nicolas Almagro,7-5; 6-2,R32,93,2,1,35,57,30,35,13,22,2,2,10,43,57,2,2,40,76,24,40,18,36,6,9,10,42,76
2005-01-31 00:00:00.000,Vi±a del Mar Chile ATP World Tour,CLAY,2,Fernando Gonzalez,Peter Luczak,Fernando Gonzalez,6-3; 5-7; 6-4,R32,110,16,7,55,86,42,55,14,31,2,5,16,56,86,7,3,53,92,40,53,17,39,5,9,15,57,92
2005-01-31 00:00:00.000,Vi±a del Mar Chile ATP World Tour,CLAY,2,Gaston Gaudio,David Sanchez,Gaston Gaudio,6-4; 6-2,R16,77,3,0,29,50,21,29,14,21,4,5,9,35,50,0,3,33,57,20,33,11,24,3,7,9,31,57
2005-01-31 00:00:00.000,Vi±a del Mar Chile ATP World Tour,CLAY,2,Jose Acasuso,Flavio Saretta,Jose Acasuso,6-2; 7-6(2),R16,101,7,2,39,67,30,39,15,28,1,2,10,45,67,1,1,48,74,29,48,11,26,6,9,10,40,74
2005-01-31 00:00:00.000,Vi±a del Mar Chile ATP World Tour,CLAY,2,David Ferrer,Mariano Puerta,David Ferrer,6-2; 6-0,R16,72,4,1,42,63,29,42,8,21,1,2,7,37,63,0,1,36,51,14,36,6,15,4,10,7,20,51
2005-01-31 00:00:00.000,Vi±a del Mar Chile ATP World Tour,CLAY,2,Agustin Calleri,Federico Luzzi,Agustin Calleri,6-3; 3-6; 6-3,R16,122,7,1,52,90,37,52,20,38,4,6,14,57,90,4,0,47,93,30,47,27,46,5,8,13,57,93
2005-01-31 00:00:00.000,Vi±a del Mar Chile ATP World Tour,CLAY,2,Ruben Ramirez Hidalgo,Felix Mantilla,Ruben Ramirez Hidalgo,6-4; 6-3,R16,88,4,2,22,51,16,22,17,29,0,2,9,33,51,3,1,31,64,18,31,14,33,4,9,10,32,64
2005-01-31 00:00:00.000,Vi±a del Mar Chile ATP World Tour,CLAY,2,Filippo Volandri,Paul-Henri Mathieu,Filippo Volandri,6-4; 6-4,R16,81,0,1,40,59,27,40,9,19,2,4,10,36,59,4,3,35,61,24,35,11,26,6,10,10,35,61
2005-01-31 00:00:00.000,Vi±a del Mar Chile ATP World Tour,CLAY,2,Mariano Zabaleta,Santiago Ventura,Mariano Zabaleta,6-4; 6-3,R16,75,4,2,36,66,24,36,19,30,5,7,10,43,66,1,2,30,53,18,30,12,23,2,6,9,30,53
2005-01-31 00:00:00.000,Vi±a del Mar Chile ATP World Tour,CLAY,2,Fernando Gonzalez,Nicolas Almagro,Fernando Gonzalez,7-6(4); 7-5,R16,96,8,0,34,73,28,34,26,39,1,2,12,54,73,4,5,56,76,42,56,7,20,6,8,12,49,76
2005-01-31 00:00:00.000,Vi±a del Mar Chile ATP World Tour,CLAY,2,Gaston Gaudio,Jose Acasuso,Gaston Gaudio,6-2; 3-6; 6-1,Q,92,4,2,44,74,31,44,19,30,1,2,12,50,74,4,4,32,73,23,32,19,41,2,6,12,42,73
2005-01-31 00:00:00.000,Vi±a del Mar Chile ATP World Tour,CLAY,2,David Ferrer,Agustin Calleri,David Ferrer,6-1; 6-3,Q,60,1,0,32,48,25,32,9,16,0,0,8,34,48,1,3,21,41,14,21,9,20,2,6,8,23,41
2005-01-31 00:00:00.000,Vi±a del Mar Chile ATP World Tour,CLAY,2,Filippo Volandri,Ruben Ramirez Hidalgo,Filippo Volandri,6-4; 6-2,Q,81,0,0,49,67,36,49,11,18,4,4,9,47,67,0,1,31,54,17,31,14,23,2,5,9,31,54
2005-01-31 00:00:00.000,Vi±a del Mar Chile ATP World Tour,CLAY,2,Fernando Gonzalez,Mariano Zabaleta,Fernando Gonzalez,4-6; 7-6(4); 7-6(2),Q,176,9,6,65,122,46,65,35,57,6,9,17,81,122,6,7,82,126,57,82,20,44,10,12,17,77,126
2005-01-31 00:00:00.000,Vi±a del Mar Chile ATP World Tour,CLAY,2,Gaston Gaudio,David Ferrer,Gaston Gaudio,6-3; 4-6; 6-2,S,135,2,2,51,81,30,51,18,30,8,12,13,48,81,4,7,71,105,43,71,10,34,10,17,14,53,105
2005-01-31 00:00:00.000,Vi±a del Mar Chile ATP World Tour,CLAY,2,Fernando Gonzalez,Filippo Volandri,Fernando Gonzalez,6-4; 5-7; 6-2,S,109,4,1,51,80,40,51,18,29,3,5,15,58,80,2,3,55,78,39,55,11,23,1,5,15,50,78
2005-01-31 00:00:00.000,Vi±a del Mar Chile ATP World Tour,CLAY,2,Gaston Gaudio,Fernando Gonzalez,Gaston Gaudio,6-3; 6-4,F,98,3,6,58,80,40,58,8,22,5,6,10,48,80,6,3,30,60,24,30,10,30,3,6,9,34,60
2005-02-07 00:00:00.000,Buenos Aires Argentina ATP World Tour,CLAY,2,Carlos Moya,Peter Luczak,Carlos Moya,6-3; 7-6(5),R32,90,7,2,38,63,34,38,16,25,4,4,10,50,63,3,1,61,83,40,61,11,22,6,8,11,51,83
2005-02-07 00:00:00.000,Buenos Aires Argentina ATP World Tour,CLAY,2,Juan Monaco,Albert Costa,Juan Monaco,7-5; 6-4,R32,102,1,1,33,56,26,33,16,23,1,2,11,42,56,6,0,45,75,28,45,16,30,5,8,11,44,75
2005-02-07 00:00:00.000,Buenos Aires Argentina ATP World Tour,CLAY,2,Mariano Puerta,Juan-Pablo Guzman,Mariano Puerta,6-2; 7-6(2),R32,86,3,2,43,62,33,43,9,19,1,2,10,42,62,4,0,40,68,27,40,11,28,4,7,10,38,68
2005-02-07 00:00:00.000,Buenos Aires Argentina ATP World Tour,CLAY,2,Lars Burgsmuller,Filippo Volandri,Lars Burgsmuller,6-4; 6-2,R32,84,7,0,31,58,21,31,12,27,6,9,9,33,58,0,8,49,80,27,49,10,31,12,18,9,37,80
2005-02-07 00:00:00.000,Buenos Aires Argentina ATP World Tour,CLAY,2,Guillermo Garcia-Lopez,David Sanchez,Guillermo Garcia-Lopez,6-4; 6-3,R32,85,0,4,40,57,27,40,6,17,3,6,10,33,57,0,2,35,58,16,35,12,23,6,11,9,28,58
2005-02-07 00:00:00.000,Buenos Aires Argentina ATP World Tour,CLAY,2,Jose Acasuso,Paul-Henri Mathieu,Jose Acasuso,6-3; 6-2,R32,59,8,1,26,48,20,26,12,22,1,2,8,32,48,0,4,30,43,15,30,3,13,0,5,9,18,43
2005-02-07 00:00:00.000,Buenos Aires Argentina ATP World Tour,CLAY,2,Nicolas Almagro,Santiago Ventura,Nicolas Almagro,6-3; 6-3,R32,74,5,3,31,54,23,31,12,23,3,4,9,35,54,0,1,37,70,21,37,14,33,6,10,9,35,70
2005-02-07 00:00:00.000,Buenos Aires Argentina ATP World Tour,CLAY,2,Mariano Zabaleta,Alex Calatrava,Mariano Zabaleta,6-3; 6-2,R32,68,6,2,40,57,29,40,9,17,5,6,9,38,57,3,3,30,46,20,30,4,16,5,9,8,24,46
2005-02-07 00:00:00.000,Buenos Aires Argentina ATP World Tour,CLAY,2,Marc Lopez,Juan Ignacio Chela,Marc Lopez,7-5; 6-1,R32,95,0,0,36,51,23,36,8,15,1,3,9,31,51,2,4,38,74,21,38,12,36,6,12,10,33,74
2005-02-07 00:00:00.000,Buenos Aires Argentina ATP World Tour,CLAY,2,Felix Mantilla,Oscar Hernandez,Felix Mantilla,6-4; 7-6(0),R32,118,1,1,53,83,39,53,17,30,7,7,11,56,83,1,2,51,74,33,51,13,23,5,6,11,46,74
2005-02-07 00:00:00.000,Buenos Aires Argentina ATP World Tour,CLAY,2,Alberto Martin,David Ferrer,Alberto Martin,5-0 RET,R32,22,0,2,4,16,3,4,9,12,0,0,3,12,16,1,3,7,15,3,7,2,8,0,2,2,5,15
2005-02-07 00:00:00.000,Buenos Aires Argentina ATP World Tour,CLAY,2,Guillermo Canas,Alex Corretja,Guillermo Canas,6-3; 6-1,R32,72,3,6,27,50,21,27,12,23,4,5,8,33,50,0,4,33,51,18,33,6,18,4,9,8,24,51
2005-02-07 00:00:00.000,Buenos Aires Argentina ATP World Tour,CLAY,2,Rafael Nadal,Agustin Calleri,Rafael Nadal,7-6(2); 6-3,R32,99,0,0,46,62,34,46,13,16,0,0,11,47,62,8,2,35,64,26,35,16,29,0,1,10,42,64
2005-02-07 00:00:00.000,Buenos Aires Argentina ATP World Tour,CLAY,2,Potito Starace,Edgardo Massa,Potito Starace,7-6(5); 6-0,R32,92,3,0,60,78,36,60,13,18,4,5,9,49,78,3,0,47,67,28,47,8,20,5,9,9,36,67
2005-02-07 00:00:00.000,Buenos Aires Argentina ATP World Tour,CLAY,2,Flavio Saretta,Albert Montanes,Flavio Saretta,6-3; 0-6; 6-2,R32,117,3,2,42,76,27,42,18,34,3,6,12,45,76,1,2,54,88,35,54,17,34,7,10,11,52,88
2005-02-07 00:00:00.000,Buenos Aires Argentina ATP World Tour,CLAY,2,Gaston Gaudio,Federico Luzzi,Gaston Gaudio,2-6; 6-1; 6-3,R32,114,4,1,55,77,35,55,10,22,3,6,12,45,77,5,4,63,97,42,63,11,34,10,15,12,53,97
2005-02-07 00:00:00.000,Buenos Aires Argentina ATP World Tour,CLAY,2,Carlos Moya,Juan Monaco,Carlos Moya,6-1; 6-2,R16,68,5,2,25,59,21,25,19,34,7,7,8,40,59,0,2,31,45,20,31,3,14,3,7,7,23,45
2005-02-07 00:00:00.000,Buenos Aires Argentina ATP World Tour,CLAY,2,Mariano Puerta,Lars Burgsmuller,Mariano Puerta,6-2; 6-0,R16,56,1,1,28,43,21,28,10,15,4,4,7,31,43,3,2,21,45,13,21,6,24,3,8,7,19,45
2005-02-07 00:00:00.000,Buenos Aires Argentina ATP World Tour,CLAY,2,Jose Acasuso,Guillermo Garcia-Lopez,Jose Acasuso,6-4; 6-3,R16,78,2,0,26,47,23,26,14,21,1,1,9,37,47,2,0,44,67,27,44,10,23,2,5,10,37,67
2005-02-07 00:00:00.000,Buenos Aires Argentina ATP World Tour,CLAY,2,Nicolas Almagro,Mariano Zabaleta,Nicolas Almagro,6-7(4); 6-4; 6-4,R16,140,11,0,75,113,55,75,18,38,5,7,16,73,113,1,8,56,95,39,56,20,39,1,5,16,59,95
2005-02-07 00:00:00.000,Buenos Aires Argentina ATP World Tour,CLAY,2,Felix Mantilla,Marc Lopez,Felix Mantilla,4-6; 7-6(5); 7-6(4),R16,206,2,2,68,102,51,68,18,34,5,9,17,69,102,4,5,93,138,63,93,21,45,10,13,17,84,138
2005-02-07 00:00:00.000,Buenos Aires Argentina ATP World Tour,CLAY,2,Alberto Martin,Guillermo Canas,Alberto Martin,6-4; 6-3,R16,98,1,2,49,73,33,49,14,24,8,9,10,47,73,0,1,41,63,26,41,10,22,4,7,9,36,63
2005-02-07 00:00:00.000,Buenos Aires Argentina ATP World Tour,CLAY,2,Rafael Nadal,Potito Starace,Rafael Nadal,6-1; 6-3,R16,76,1,1,30,43,26,30,5,13,2,3,8,31,43,2,1,44,71,24,44,9,27,13,18,8,33,71
2005-02-07 00:00:00.000,Buenos Aires Argentina ATP World Tour,CLAY,2,Gaston Gaudio,Flavio Saretta,Gaston Gaudio,6-3; 6-2,R16,82,2,1,37,60,26,37,13,23,2,3,9,39,60,0,1,26,52,12,26,14,26,2,6,8,26,52
2005-02-07 00:00:00.000,Buenos Aires Argentina ATP World Tour,CLAY,2,Mariano Puerta,Carlos Moya,Mariano Puerta,7-6(0); 6-3,Q,87,4,0,48,60,38,48,9,12,2,2,10,47,60,3,1,62,80,37,62,10,18,4,6,11,47,80
2005-02-07 00:00:00.000,Buenos Aires Argentina ATP World Tour,CLAY,2,Jose Acasuso,Nicolas Almagro,Jose Acasuso,6-3; 6-4,Q,77,3,1,26,50,22,26,18,24,0,0,10,40,50,3,7,44,70,29,44,11,26,10,12,9,40,70
2005-02-07 00:00:00.000,Buenos Aires Argentina ATP World Tour,CLAY,2,Alberto Martin,Felix Mantilla,Alberto Martin,5-7; 6-4; 7-6(3),Q,152,8,1,49,104,38,49,33,55,5,8,17,71,104,7,5,74,106,50,74,19,32,6,9,17,69,106
2005-02-07 00:00:00.000,Buenos Aires Argentina ATP World Tour,CLAY,2,Gaston Gaudio,Rafael Nadal,Gaston Gaudio,0-6; 6-0; 6-1,Q,103,6,1,37,65,22,37,17,28,6,9,10,39,65,3,2,52,74,28,52,8,22,12,17,9,36,74
2005-02-07 00:00:00.000,Buenos Aires Argentina ATP World Tour,CLAY,2,Mariano Puerta,Jose Acasuso,Mariano Puerta,6-4; 7-6(5),S,100,6,1,50,70,38,50,12,20,1,2,11,50,70,13,5,43,80,34,43,17,37,5,7,11,51,80
2005-02-07 00:00:00.000,Buenos Aires Argentina ATP World Tour,CLAY,2,Gaston Gaudio,Alberto Martin,Gaston Gaudio,6-3; 6-4,S,94,1,5,34,62,28,34,13,28,0,1,10,41,62,1,1,25,60,18,25,16,35,6,9,9,34,60
2005-02-07 00:00:00.000,Buenos Aires Argentina ATP World Tour,CLAY,2,Gaston Gaudio,Mariano Puerta,Gaston Gaudio,6-4; 6-4,F,92,4,1,40,62,30,40,14,22,0,0,10,44,62,1,0,30,58,20,30,17,28,3,5,10,37,58
2005-02-07 00:00:00.000,Marseille France ATP World Tour,HARD,2,Sebastien De Chaunac,Guillermo Coria,Sebastien De Chaunac,6-4; 7-5,R32,102,8,3,39,70,31,39,16,31,3,5,11,47,70,1,3,27,62,18,27,18,35,1,5,11,36,62
2005-02-07 00:00:00.000,Marseille France ATP World Tour,HARD,2,Greg Rusedski,Michael Llodra,Greg Rusedski,7-6(2); 4-6; 6-3,R32,115,20,7,60,98,46,60,23,38,4,5,16,69,98,8,2,41,86,31,41,30,45,3,4,15,61,86
2005-02-07 00:00:00.000,Marseille France ATP World Tour,HARD,2,Tomas Berdych,Paradorn Srichaphan,Tomas Berdych,6-7(5); 6-2; 7-6(4),R32,126,13,3,63,96,53,63,16,33,0,1,16,69,96,11,5,65,110,45,65,27,45,8,11,16,72,110
2005-02-07 00:00:00.000,Marseille France ATP World Tour,HARD,2,Mario Ancic,Dominik Hrbaty,Mario Ancic,6-3; 7-5,R32,73,14,4,36,60,33,36,10,24,3,4,11,43,60,2,2,36,63,25,36,12,27,4,7,10,37,63
2005-02-07 00:00:00.000,Marseille France ATP World Tour,HARD,2,Sjeng Schalken,Nikolay Davydenko,Sjeng Schalken,3-6; 6-4; 6-1,R32,99,1,3,56,80,34,56,12,24,4,8,13,46,80,4,6,41,73,26,41,13,32,3,9,13,39,73
2005-02-07 00:00:00.000,Marseille France ATP World Tour,HARD,2,Jerome Haehnel,Jean-Rene Lisnard,Jerome Haehnel,6-2; 6-7(5); 6-4,R32,144,10,2,52,93,34,52,23,41,1,5,15,57,93,2,9,52,103,35,52,22,51,6,13,15,57,103
2005-02-07 00:00:00.000,Marseille France ATP World Tour,HARD,2,Igor Andreev,Gael Monfils,Igor Andreev,6-3; 6-2,R32,87,0,5,37,71,29,37,13,34,3,4,9,42,71,4,2,16,49,11,16,15,33,1,5,8,26,49
2005-02-07 00:00:00.000,Marseille France ATP World Tour,HARD,2,Ivan Ljubicic,Victor Hanescu,Ivan Ljubicic,7-6(6); 5-7; 6-4,R32,157,12,3,70,109,53,70,21,39,1,3,17,74,109,5,0,81,112,56,81,17,31,10,12,17,73,112
2005-02-07 00:00:00.000,Marseille France ATP World Tour,HARD,2,Karol Beck,Nicolas Kiefer,Karol Beck,6-3; 6-2,R32,88,1,2,43,76,34,43,13,33,11,12,9,47,76,1,3,29,50,15,29,9,21,2,6,8,24,50
2005-02-07 00:00:00.000,Marseille France ATP World Tour,HARD,2,Arnaud Clement,Radek Stepanek,Arnaud Clement,4-6; 6-2; 6-1,R32,103,5,2,49,73,36,49,17,24,4,5,13,53,73,9,3,47,76,31,47,14,29,10,14,12,45,76
2005-02-07 00:00:00.000,Marseille France ATP World Tour,HARD,2,Gilles Simon,Thomas Johansson,Gilles Simon,6-4; 4-6; 6-2,R32,111,3,0,39,82,27,39,26,43,1,4,14,53,82,12,4,34,80,27,34,21,46,8,13,14,48,80
2005-02-07 00:00:00.000,Marseille France ATP World Tour,HARD,2,Joachim Johansson,Juan Carlos Ferrero,Joachim Johansson,7-6(4); 6-3,R32,97,17,7,40,74,36,40,19,34,4,4,11,55,74,6,4,34,69,28,34,19,35,2,3,10,47,69
2005-02-07 00:00:00.000,Marseille France ATP World Tour,HARD,2,Feliciano Lopez,Fernando Verdasco,Feliciano Lopez,7-5; 6-3,R32,65,10,1,31,50,28,31,13,19,3,3,10,41,50,3,0,31,56,20,31,15,25,0,3,11,35,56
2005-02-07 00:00:00.000,Marseille France ATP World Tour,HARD,2,Ivo Karlovic,Jimmy Wang,Ivo Karlovic,6-4; 7-6(4),R32,74,20,2,40,61,35,40,14,21,0,0,11,49,61,2,0,41,65,35,41,12,24,2,3,11,47,65
2005-02-07 00:00:00.000,Marseille France ATP World Tour,HARD,2,Taylor Dent,Julien Benneteau,Taylor Dent,6-2; 6-2,R32,52,6,3,23,39,21,23,9,16,0,1,8,30,39,0,2,27,45,15,27,6,18,3,8,8,21,45
2005-02-07 00:00:00.000,Marseille France ATP World Tour,HARD,2,David Nalbandian,Rainer Schuettler,David Nalbandian,6-7(2); 6-4; 7-5,R32,162,4,5,57,103,33,57,29,46,5,10,17,62,103,4,7,58,109,37,58,23,51,3,10,17,60,109
2005-02-07 00:00:00.000,Marseille France ATP World Tour,HARD,2,Sebastien De Chaunac,Greg Rusedski,Sebastien De Chaunac,W/O,R16,0,0,0,0,0,0,0,0,0,0,0,0,0,0,0,0,0,0,0,0,0,0,0,0,0,0,0
2005-02-07 00:00:00.000,Marseille France ATP World Tour,HARD,2,Mario Ancic,Tomas Berdych,Mario Ancic,7-5; 7-6(4),R16,95,20,4,49,73,40,49,11,24,1,2,12,51,73,6,4,39,67,28,39,18,28,0,2,12,46,67
2005-02-07 00:00:00.000,Marseille France ATP World Tour,HARD,2,Sjeng Schalken,Jerome Haehnel,Sjeng Schalken,6-4; 6-2,R16,75,0,2,34,50,25,34,11,16,3,4,9,36,50,5,5,36,69,21,36,15,33,7,11,9,36,69
2005-02-07 00:00:00.000,Marseille France ATP World Tour,HARD,2,Ivan Ljubicic,Igor Andreev,Ivan Ljubicic,6-3; 6-4,R16,85,6,0,38,58,29,38,13,20,0,0,10,42,58,3,0,30,62,20,30,17,32,3,5,9,37,62
2005-02-07 00:00:00.000,Marseille France ATP World Tour,HARD,2,Karol Beck,Arnaud Clement,Karol Beck,6-4; 6-4,R16,101,5,3,34,62,27,34,14,28,3,4,10,41,62,1,2,39,72,24,39,17,33,2,5,10,41,72
2005-02-07 00:00:00.000,Marseille France ATP World Tour,HARD,2,Joachim Johansson,Gilles Simon,Joachim Johansson,7-6(3); 6-3,R16,83,22,3,45,71,40,45,14,26,3,3,11,54,71,3,1,25,61,18,25,23,36,1,2,10,41,61
2005-02-07 00:00:00.000,Marseille France ATP World Tour,HARD,2,Feliciano Lopez,Ivo Karlovic,Feliciano Lopez,7-6(6); 6-4,R16,86,6,3,40,69,33,40,20,29,0,0,11,53,69,12,3,53,78,42,53,11,25,2,3,11,53,78
2005-02-07 00:00:00.000,Marseille France ATP World Tour,HARD,2,Taylor Dent,David Nalbandian,Taylor Dent,7-6(3); 6-2,R16,94,6,2,42,63,37,42,10,21,3,4,10,47,63,1,1,50,75,27,50,16,25,6,9,10,43,75
2005-02-07 00:00:00.000,Marseille France ATP World Tour,HARD,2,Mario Ancic,Sebastien De Chaunac,Mario Ancic,7-6(11); 6-3,Q,116,19,5,51,80,42,51,15,29,5,5,11,57,80,2,5,43,79,28,43,20,36,4,5,10,48,79
2005-02-07 00:00:00.000,Marseille France ATP World Tour,HARD,2,Ivan Ljubicic,Sjeng Schalken,Ivan Ljubicic,6-3; 6-4,Q,105,8,0,40,63,27,40,13,23,1,3,10,40,63,0,1,48,69,31,48,7,21,3,7,9,38,69
2005-02-07 00:00:00.000,Marseille France ATP World Tour,HARD,2,Joachim Johansson,Karol Beck,Joachim Johansson,6-4; 6-4,Q,74,16,0,33,55,25,33,16,22,0,0,10,41,55,2,2,37,56,27,37,10,19,1,3,10,37,56
2005-02-07 00:00:00.000,Marseille France ATP World Tour,HARD,2,Feliciano Lopez,Taylor Dent,Feliciano Lopez,7-5; 1-6; 7-6(8),Q,113,10,3,50,93,39,50,23,43,4,8,15,62,93,11,5,60,99,46,60,21,39,4,7,16,67,99
2005-02-07 00:00:00.000,Marseille France ATP World Tour,HARD,2,Ivan Ljubicic,Mario Ancic,Ivan Ljubicic,7-5; 2-6; 6-4,S,161,5,3,73,117,46,73,26,44,18,20,15,72,117,16,6,49,82,43,49,15,33,2,4,15,58,82
2005-02-07 00:00:00.000,Marseille France ATP World Tour,HARD,2,Joachim Johansson,Feliciano Lopez,Joachim Johansson,6-7(1); 7-6(6); 6-4,S,124,19,4,51,94,43,51,31,43,1,1,17,74,94,10,2,53,91,47,53,25,38,1,2,17,72,91
2005-02-07 00:00:00.000,Marseille France ATP World Tour,HARD,2,Joachim Johansson,Ivan Ljubicic,Joachim Johansson,7-5; 6-4,F,80,19,3,34,58,29,34,16,24,0,0,11,45,58,13,1,41,62,33,41,9,21,2,4,11,42,62
2005-02-07 00:00:00.000,San Jose CA; U.S.A. ATP World Tour,HARD,2,Andy Roddick,Paul Goldstein,Andy Roddick,6-3; 6-4,R32,71,8,2,33,63,31,33,14,30,2,2,10,45,63,3,1,28,52,23,28,12,24,2,4,9,35,52
2005-02-07 00:00:00.000,San Jose CA; U.S.A. ATP World Tour,HARD,2,Hyung-Taik Lee,Jan-Michael Gambill,Hyung-Taik Lee,6-3; 7-6(4),R32,98,3,4,38,78,31,38,25,40,3,3,11,56,78,10,3,41,73,32,41,17,32,2,3,10,49,73
2005-02-07 00:00:00.000,San Jose CA; U.S.A. ATP World Tour,HARD,2,Robby Ginepri,Donald Young,Robby Ginepri,6-2; 6-2,R32,50,7,2,33,49,28,33,8,16,3,3,8,36,49,1,2,31,52,19,31,8,21,2,6,8,27,52
2005-02-07 00:00:00.000,San Jose CA; U.S.A. ATP World Tour,HARD,2,Thomas Enqvist,Mardy Fish,Thomas Enqvist,7-6(6); 6-1,R32,78,13,8,38,71,32,38,19,33,4,4,10,51,71,10,4,31,63,24,31,17,32,3,5,9,41,63
2005-02-07 00:00:00.000,San Jose CA; U.S.A. ATP World Tour,HARD,2,Tommy Haas,Gregory Carraz,Tommy Haas,6-3; 7-6(3),R32,84,6,3,30,75,22,30,25,45,3,5,11,47,75,4,3,34,62,24,34,12,28,2,5,10,36,62
2005-02-07 00:00:00.000,San Jose CA; U.S.A. ATP World Tour,HARD,2,Frank Dancevic,Jeff Morrison,Frank Dancevic,4-6; 7-6(3); 6-0,R32,119,7,1,60,92,42,60,19,32,4,6,14,61,92,6,6,45,108,33,45,27,63,11,15,14,60,108
2005-02-07 00:00:00.000,San Jose CA; U.S.A. ATP World Tour,HARD,2,Kevin Kim,Jan Hernych,Kevin Kim,7-5; 6-3,R32,90,3,3,42,71,30,42,15,29,5,7,11,45,71,1,4,46,70,27,46,10,24,4,8,10,37,70
2005-02-07 00:00:00.000,San Jose CA; U.S.A. ATP World Tour,HARD,2,Max Mirnyi,Peter Wessels,Max Mirnyi,6-7(6); 7-6(4); 6-3,R32,121,29,6,74,110,63,74,17,36,2,2,17,80,110,7,3,66,103,53,66,22,37,3,4,16,75,103
2005-02-07 00:00:00.000,San Jose CA; U.S.A. ATP World Tour,HARD,2,Cyril Saulnier,Jiri Novak,Cyril Saulnier,6-2; 6-2,R32,58,4,2,25,44,21,25,10,19,0,1,8,31,44,1,4,28,58,14,28,12,30,7,12,8,26,58
2005-02-07 00:00:00.000,San Jose CA; U.S.A. ATP World Tour,HARD,2,Tomas Zib,Philipp Kohlschreiber,Tomas Zib,6-4; 6-3,R32,69,2,1,25,51,18,25,18,26,2,4,10,36,51,4,1,37,64,22,37,11,27,7,11,9,33,64
2005-02-07 00:00:00.000,San Jose CA; U.S.A. ATP World Tour,HARD,2,James Blake,Wesley Moodie,James Blake,6-3; 6-4,R32,64,2,2,37,57,27,37,13,20,2,3,10,40,57,2,3,35,58,24,35,9,23,4,7,9,33,58
2005-02-07 00:00:00.000,San Jose CA; U.S.A. ATP World Tour,HARD,2,Vincent Spadea,Antony Dupuis,Vincent Spadea,5-7; 6-3; 6-2,R32,131,4,4,50,97,31,50,31,47,10,13,15,62,97,8,5,55,100,38,55,17,45,8,13,14,55,100
2005-02-07 00:00:00.000,San Jose CA; U.S.A. ATP World Tour,HARD,2,Jurgen Melzer,Glenn Weiner,Jurgen Melzer,6-2; 7-5,R32,73,5,2,23,58,19,23,22,35,1,2,10,41,58,4,4,24,60,16,24,17,36,5,9,10,33,60
2005-02-07 00:00:00.000,San Jose CA; U.S.A. ATP World Tour,HARD,2,Xavier Malisse,Yen-Hsun Lu,Xavier Malisse,6-2; 6-3,R32,73,3,0,38,57,28,38,10,19,3,4,9,38,57,1,3,35,58,23,35,5,23,2,6,8,28,58
2005-02-07 00:00:00.000,San Jose CA; U.S.A. ATP World Tour,HARD,2,Kenneth Carlsen,Irakli Labadze,Kenneth Carlsen,6-7(4); 6-2; 6-3,R32,153,12,0,47,91,32,47,30,44,4,6,15,62,91,3,11,78,126,47,78,19,48,10,15,14,66,126
2005-02-07 00:00:00.000,San Jose CA; U.S.A. ATP World Tour,HARD,2,Andre Agassi,Bobby Reynolds,Andre Agassi,6-4; 6-4,R32,72,5,2,35,65,24,35,22,30,5,5,10,46,65,7,2,26,62,20,26,19,36,3,5,10,39,62
2005-02-07 00:00:00.000,San Jose CA; U.S.A. ATP World Tour,HARD,2,Andy Roddick,Hyung-Taik Lee,Andy Roddick,6-3; 3-6; 6-2,R16,96,17,5,39,70,33,39,18,31,1,2,13,51,70,0,2,39,82,27,39,25,43,5,8,13,52,82
2005-02-07 00:00:00.000,San Jose CA; U.S.A. ATP World Tour,HARD,2,Thomas Enqvist,Robby Ginepri,Thomas Enqvist,6-3; 7-6(1),R16,89,9,5,36,86,27,36,29,50,4,5,11,56,86,10,1,36,58,25,36,11,22,1,3,10,36,58
2005-02-07 00:00:00.000,San Jose CA; U.S.A. ATP World Tour,HARD,2,Tommy Haas,Frank Dancevic,Tommy Haas,6-1; 6-3,R16,58,2,2,31,54,20,31,13,23,5,6,8,33,54,5,3,31,56,17,31,10,25,7,12,8,27,56
2005-02-07 00:00:00.000,San Jose CA; U.S.A. ATP World Tour,HARD,2,Max Mirnyi,Kevin Kim,Max Mirnyi,6-1; 7-5,R16,65,7,2,35,58,30,35,14,23,6,6,10,44,58,2,1,33,49,22,33,8,16,5,8,9,30,49
2005-02-07 00:00:00.000,San Jose CA; U.S.A. ATP World Tour,HARD,2,Cyril Saulnier,Tomas Zib,Cyril Saulnier,6-1; 7-6(3),R16,73,19,0,37,60,32,37,12,23,1,2,10,44,60,1,1,36,59,20,36,12,23,4,7,9,32,59
2005-02-07 00:00:00.000,San Jose CA; U.S.A. ATP World Tour,HARD,2,Vincent Spadea,James Blake,Vincent Spadea,6-3; 6-0,R16,54,1,3,31,52,25,31,12,21,3,3,8,37,52,1,4,16,42,8,16,13,26,3,7,7,21,42
2005-02-07 00:00:00.000,San Jose CA; U.S.A. ATP World Tour,HARD,2,Jurgen Melzer,Xavier Malisse,Jurgen Melzer,6-3; 6-3,R16,58,2,2,31,48,25,31,10,17,3,4,9,35,48,2,2,25,51,15,25,12,26,2,6,9,27,51
2005-02-07 00:00:00.000,San Jose CA; U.S.A. ATP World Tour,HARD,2,Andre Agassi,Kenneth Carlsen,Andre Agassi,7-5; 6-1,R16,73,1,2,39,63,34,39,11,24,4,4,10,45,63,4,5,29,59,20,29,13,30,5,8,9,33,59
2005-02-07 00:00:00.000,San Jose CA; U.S.A. ATP World Tour,HARD,2,Andy Roddick,Thomas Enqvist,Andy Roddick,3-6; 7-6(6); 7-5,Q,142,22,7,53,102,43,53,23,49,5,9,17,66,102,13,10,67,125,52,67,22,58,14,17,16,74,125
2005-02-07 00:00:00.000,San Jose CA; U.S.A. ATP World Tour,HARD,2,Tommy Haas,Max Mirnyi,Tommy Haas,6-7(2); 7-6(3); 6-2,Q,130,3,8,79,112,52,79,19,33,3,5,16,71,112,18,4,66,107,50,66,16,41,6,10,16,66,107
2005-02-07 00:00:00.000,San Jose CA; U.S.A. ATP World Tour,HARD,2,Cyril Saulnier,Vincent Spadea,Cyril Saulnier,6-2; 6-4,Q,80,7,3,39,73,32,39,13,34,9,10,9,45,73,5,4,35,57,24,35,7,22,0,4,9,31,57
2005-02-07 00:00:00.000,San Jose CA; U.S.A. ATP World Tour,HARD,2,Jurgen Melzer,Andre Agassi,Jurgen Melzer,6-3; 6-1,Q,59,9,2,27,54,20,27,19,27,6,6,8,39,54,1,4,19,47,12,19,13,28,3,7,8,25,47
2005-02-07 00:00:00.000,San Jose CA; U.S.A. ATP World Tour,HARD,2,Andy Roddick,Tommy Haas,Andy Roddick,7-6(3); 6-3,S,81,14,0,48,68,38,48,10,20,5,6,11,48,68,2,3,39,74,29,39,16,35,1,3,10,45,74
2005-02-07 00:00:00.000,San Jose CA; U.S.A. ATP World Tour,HARD,2,Cyril Saulnier,Jurgen Melzer,Cyril Saulnier,6-7(3); 6-3; 6-3,S,128,12,3,43,81,35,43,28,38,1,1,15,63,81,6,3,65,109,45,65,24,44,5,8,15,69,109
2005-02-07 00:00:00.000,San Jose CA; U.S.A. ATP World Tour,HARD,2,Andy Roddick,Cyril Saulnier,Andy Roddick,6-0; 6-4,F,50,9,1,33,46,25,33,9,13,0,0,8,34,46,6,2,25,43,18,25,6,18,3,7,8,24,43
2005-02-14 00:00:00.000,Costa Do Sauipe Brazil ATP World Tour,CLAY,2,Ricardo Mello,Albert Montanes,Ricardo Mello,3-6; 6-4; 6-4,R32,122,4,3,59,105,44,59,21,46,8,10,15,65,105,3,2,39,70,31,39,21,31,3,5,14,52,70
2005-02-14 00:00:00.000,Costa Do Sauipe Brazil ATP World Tour,CLAY,2,Martin Vassallo Arguello,Felix Mantilla,Martin Vassallo Arguello,7-6(1); 4-6; 6-3,R32,177,3,1,66,103,43,66,25,37,4,8,16,68,103,3,6,47,94,33,47,25,47,5,9,15,58,94
2005-02-14 00:00:00.000,Costa Do Sauipe Brazil ATP World Tour,CLAY,2,Santiago Ventura,Nicolas Almagro,Santiago Ventura,4-6; 6-4; 6-1,R32,98,4,3,44,76,29,44,17,32,4,8,13,46,76,8,2,41,74,25,41,14,33,2,9,14,39,74
2005-02-14 00:00:00.000,Costa Do Sauipe Brazil ATP World Tour,CLAY,2,Alex Corretja,David Ferrer,Alex Corretja,0-6; 7-5 RET,R32,92,1,2,33,55,19,33,10,22,5,10,9,29,55,1,1,42,67,26,42,12,25,14,17,9,38,67
2005-02-14 00:00:00.000,Costa Do Sauipe Brazil ATP World Tour,CLAY,2,Juan Ignacio Chela,Lars Burgsmuller,Juan Ignacio Chela,6-4; 6-0,R32,73,1,1,28,49,23,28,8,21,5,7,8,31,49,0,3,24,54,15,24,6,30,1,7,8,21,54
2005-02-14 00:00:00.000,Costa Do Sauipe Brazil ATP World Tour,CLAY,2,Agustin Calleri,Potito Starace,Agustin Calleri,6-1; 6-1,R32,52,10,1,23,41,21,23,9,18,1,1,7,30,41,1,1,28,45,9,28,9,17,3,8,7,18,45
2005-02-14 00:00:00.000,Costa Do Sauipe Brazil ATP World Tour,CLAY,2,Alex Calatrava,Juan Antonio Marin,Alex Calatrava,6-3; 6-4,R32,84,3,2,49,62,34,49,7,13,4,5,10,41,62,1,2,21,47,11,21,15,26,1,4,9,26,47
2005-02-14 00:00:00.000,Costa Do Sauipe Brazil ATP World Tour,CLAY,2,Rafael Nadal,Jose Acasuso,Rafael Nadal,7-6(1); 6-3,R32,114,5,1,56,71,40,56,10,15,6,7,11,50,71,4,2,36,74,25,36,18,38,9,11,10,43,74
2005-02-14 00:00:00.000,Costa Do Sauipe Brazil ATP World Tour,CLAY,2,Mariano Zabaleta,Mariano Puerta,Mariano Zabaleta,6-4; 6-2,R32,52,12,0,20,41,17,20,19,21,0,0,9,36,41,2,5,24,50,15,24,14,26,3,6,9,29,50
2005-02-14 00:00:00.000,Costa Do Sauipe Brazil ATP World Tour,CLAY,2,Guillermo Garcia-Lopez,Juan Monaco,Guillermo Garcia-Lopez,6-1; 6-3,R32,79,2,2,27,49,22,27,13,22,0,0,8,35,49,0,4,30,57,17,30,10,27,4,8,8,27,57
2005-02-14 00:00:00.000,Costa Do Sauipe Brazil ATP World Tour,CLAY,2,Paul-Henri Mathieu,David Sanchez,Paul-Henri Mathieu,6-4; 6-0,R32,82,1,3,30,48,20,30,11,18,2,3,8,31,48,3,1,33,55,17,33,7,22,2,7,8,24,55
2005-02-14 00:00:00.000,Costa Do Sauipe Brazil ATP World Tour,CLAY,2,Alberto Martin,Filippo Volandri,Alberto Martin,7-5; 1-0 RET,R32,49,1,3,15,29,13,15,9,14,1,2,6,22,29,1,5,24,47,14,24,10,23,1,4,7,24,47
2005-02-14 00:00:00.000,Costa Do Sauipe Brazil ATP World Tour,CLAY,2,Albert Costa,Oscar Hernandez,Albert Costa,7-6(2); 4-6; 4-4 RET,R32,173,4,3,65,104,38,65,24,39,8,13,15,62,104,4,3,51,100,35,51,25,49,5,9,15,60,100
2005-02-14 00:00:00.000,Costa Do Sauipe Brazil ATP World Tour,CLAY,2,Edgardo Massa,Flavio Saretta,Edgardo Massa,6-3; 6-1,R32,73,2,1,29,53,20,29,12,24,8,10,8,32,53,1,3,28,50,14,28,5,22,5,11,8,19,50
2005-02-14 00:00:00.000,Costa Do Sauipe Brazil ATP World Tour,CLAY,2,Andre Sa,Julio Silva,Andre Sa,6-2; 6-4,R32,82,0,1,42,57,26,42,7,15,2,5,9,33,57,3,1,27,53,13,27,8,26,2,8,9,21,53
2005-02-14 00:00:00.000,Costa Do Sauipe Brazil ATP World Tour,CLAY,2,Peter Luczak,Fernando Gonzalez,Peter Luczak,3-6; 6-3; 7-5,R32,116,6,2,72,99,51,72,14,27,9,11,15,65,99,10,8,44,87,35,44,21,43,3,6,15,56,87
2005-02-14 00:00:00.000,Costa Do Sauipe Brazil ATP World Tour,CLAY,2,Ricardo Mello,Martin Vassallo Arguello,Ricardo Mello,6-3; 1-0 RET,R16,67,5,0,19,30,15,19,7,11,1,1,5,22,30,1,1,30,45,17,30,6,15,5,7,5,23,45
2005-02-14 00:00:00.000,Costa Do Sauipe Brazil ATP World Tour,CLAY,2,Santiago Ventura,Alex Corretja,Santiago Ventura,6-4; 6-4,R16,106,5,3,37,62,29,37,12,25,4,6,10,41,62,1,1,27,55,15,27,14,28,4,8,10,29,55
2005-02-14 00:00:00.000,Costa Do Sauipe Brazil ATP World Tour,CLAY,2,Agustin Calleri,Juan Ignacio Chela,Agustin Calleri,7-6(2); 6-1,R16,90,8,3,33,58,26,33,15,25,0,1,10,41,58,1,3,36,67,24,36,13,31,4,7,9,37,67
2005-02-14 00:00:00.000,Costa Do Sauipe Brazil ATP World Tour,CLAY,2,Rafael Nadal,Alex Calatrava,Rafael Nadal,6-3; 6-3,R16,163,2,0,31,50,25,31,14,19,1,1,9,39,50,2,3,45,67,27,45,8,22,5,8,9,35,67
2005-02-14 00:00:00.000,Costa Do Sauipe Brazil ATP World Tour,CLAY,2,Mariano Zabaleta,Guillermo Garcia-Lopez,Mariano Zabaleta,6-2; 6-2,R16,63,2,2,27,47,21,27,10,20,0,1,8,31,47,1,2,34,45,15,34,4,11,1,6,8,19,45
2005-02-14 00:00:00.000,Costa Do Sauipe Brazil ATP World Tour,CLAY,2,Alberto Martin,Paul-Henri Mathieu,Alberto Martin,6-2; 7-5,R16,96,3,6,27,63,19,27,19,36,2,5,10,38,63,5,2,42,69,22,42,12,27,7,13,10,34,69
2005-02-14 00:00:00.000,Costa Do Sauipe Brazil ATP World Tour,CLAY,2,Edgardo Massa,Albert Costa,Edgardo Massa,6-7(3); 6-1; 7-6(7),R16,156,5,3,69,114,49,69,29,45,5,6,16,78,114,3,2,58,96,41,58,22,38,1,4,15,63,96
2005-02-14 00:00:00.000,Costa Do Sauipe Brazil ATP World Tour,CLAY,2,Peter Luczak,Andre Sa,Peter Luczak,3-6; 6-3; 6-0,R16,112,6,0,60,79,34,60,11,19,4,9,12,45,79,2,2,60,83,26,60,9,23,14,22,12,35,83
2005-02-14 00:00:00.000,Costa Do Sauipe Brazil ATP World Tour,CLAY,2,Ricardo Mello,Santiago Ventura,Ricardo Mello,7-5; 6-1,Q,80,6,4,29,55,21,29,14,26,1,3,9,35,55,3,5,26,56,17,26,8,30,2,8,10,25,56
2005-02-14 00:00:00.000,Costa Do Sauipe Brazil ATP World Tour,CLAY,2,Rafael Nadal,Agustin Calleri,Rafael Nadal,6-2; 6-7(5); 6-4,Q,151,0,0,80,100,54,80,14,20,6,8,15,68,100,9,3,68,110,44,68,17,42,5,10,15,61,110
2005-02-14 00:00:00.000,Costa Do Sauipe Brazil ATP World Tour,CLAY,2,Alberto Martin,Mariano Zabaleta,Alberto Martin,7-6(6); 6-4,Q,136,4,6,48,92,38,48,19,44,5,7,11,57,92,6,4,54,90,36,54,15,36,4,7,11,51,90
2005-02-14 00:00:00.000,Costa Do Sauipe Brazil ATP World Tour,CLAY,2,Peter Luczak,Edgardo Massa,Peter Luczak,1-6; 7-5; 6-1,Q,109,2,0,61,82,40,61,14,21,4,6,13,54,82,4,1,45,89,28,45,26,44,6,9,13,54,89
2005-02-14 00:00:00.000,Costa Do Sauipe Brazil ATP World Tour,CLAY,2,Rafael Nadal,Ricardo Mello,Rafael Nadal,2-6; 6-2; 6-4,S,151,0,2,59,79,35,59,11,20,2,6,13,46,79,3,1,64,95,38,64,15,31,6,11,13,53,95
2005-02-14 00:00:00.000,Costa Do Sauipe Brazil ATP World Tour,CLAY,2,Alberto Martin,Peter Luczak,Alberto Martin,6-2; 6-3,S,71,4,2,35,59,25,35,12,24,6,8,9,37,59,0,0,27,39,9,27,7,12,1,6,8,16,39
2005-02-14 00:00:00.000,Costa Do Sauipe Brazil ATP World Tour,CLAY,2,Rafael Nadal,Alberto Martin,Rafael Nadal,6-0; 6-7(2); 6-1,F,126,0,2,50,74,31,50,12,24,5,8,12,43,74,1,2,45,84,25,45,13,39,6,15,13,38,84
2005-02-14 00:00:00.000,Memphis TN; U.S.A. ATP World Tour,HARD,2,Andy Roddick,Hyung-Taik Lee,Andy Roddick,6-3; 6-4,R32,58,11,0,28,45,25,28,15,17,0,0,10,40,45,4,1,31,52,23,31,11,21,2,4,9,34,52
2005-02-14 00:00:00.000,Memphis TN; U.S.A. ATP World Tour,HARD,2,Arnaud Clement,Davide Sanguinetti,Arnaud Clement,7-6(6); 1-6; 6-1,R32,100,3,5,46,73,31,46,15,27,1,5,13,46,73,9,2,47,83,31,47,18,36,2,6,13,49,83
2005-02-14 00:00:00.000,Memphis TN; U.S.A. ATP World Tour,HARD,2,Robby Ginepri,Zach Dailey,Robby Ginepri,6-2; 6-0,R32,63,5,1,18,33,17,18,11,15,0,0,7,28,33,5,1,35,67,19,35,11,32,11,16,7,30,67
2005-02-14 00:00:00.000,Memphis TN; U.S.A. ATP World Tour,HARD,2,Mardy Fish,James Blake,Mardy Fish,6-3; 2-6; 7-6(7),R32,121,12,4,63,116,42,63,25,53,9,13,15,67,116,6,3,47,85,31,47,21,38,2,5,14,52,85
2005-02-14 00:00:00.000,Memphis TN; U.S.A. ATP World Tour,HARD,2,Jan-Michael Gambill,Jiri Novak,Jan-Michael Gambill,6-0; 6-4,R32,60,13,3,36,59,31,36,7,23,6,7,8,38,59,3,0,24,46,11,24,9,22,2,7,8,20,46
2005-02-14 00:00:00.000,Memphis TN; U.S.A. ATP World Tour,HARD,2,Irakli Labadze,Jonas Bjorkman,Irakli Labadze,6-4; 7-6(1),R32,98,9,3,53,81,34,53,17,28,5,7,11,51,81,2,5,31,69,21,31,18,38,2,5,11,39,69
2005-02-14 00:00:00.000,Memphis TN; U.S.A. ATP World Tour,HARD,2,Kenneth Carlsen,Gregory Carraz,Kenneth Carlsen,6-4; 3-6; 7-6(0),R32,105,11,2,63,88,45,63,13,25,2,5,15,58,88,11,6,52,87,38,52,18,35,2,5,16,56,87
2005-02-14 00:00:00.000,Memphis TN; U.S.A. ATP World Tour,HARD,2,Wayne Arthurs,Jurgen Melzer,Wayne Arthurs,7-6(5); 7-6(4),R32,95,23,7,48,83,44,48,20,35,3,3,12,64,83,8,5,64,97,48,64,18,33,7,7,12,66,97
2005-02-14 00:00:00.000,Memphis TN; U.S.A. ATP World Tour,HARD,2,Max Mirnyi,Brian Baker,Max Mirnyi,7-6(1); 6-7(1); 7-6(9),R32,158,25,5,83,123,70,83,18,40,5,6,18,88,123,4,5,87,127,67,87,21,40,2,3,18,88,127
2005-02-14 00:00:00.000,Memphis TN; U.S.A. ATP World Tour,HARD,2,Cyril Saulnier,Robert Kendrick,Cyril Saulnier,5-7; 6-3; 6-4,R32,117,8,2,68,107,50,68,21,39,5,6,16,71,107,15,10,54,92,41,54,21,38,5,7,15,62,92
2005-02-14 00:00:00.000,Memphis TN; U.S.A. ATP World Tour,HARD,2,Antony Dupuis,Jeff Morrison,Antony Dupuis,7-6(7); 7-6(5),R32,108,9,4,53,95,41,53,22,42,6,8,12,63,95,4,3,48,80,37,48,19,32,1,3,12,56,80
2005-02-14 00:00:00.000,Memphis TN; U.S.A. ATP World Tour,HARD,2,Vincent Spadea,Thomas Enqvist,Vincent Spadea,7-5; 6-2,R32,71,5,6,34,59,27,34,13,25,1,2,10,40,59,6,4,29,68,20,29,17,39,1,5,10,37,68
2005-02-14 00:00:00.000,Memphis TN; U.S.A. ATP World Tour,HARD,2,Xavier Malisse,Philipp Kohlschreiber,Xavier Malisse,6-3; 6-3,R32,69,10,1,38,66,30,38,15,28,6,6,9,45,66,5,1,24,53,16,24,16,29,4,7,9,32,53
2005-02-14 00:00:00.000,Memphis TN; U.S.A. ATP World Tour,HARD,2,Frank Dancevic,Yen-Hsun Lu,Frank Dancevic,6-2; 6-4,R32,54,7,0,39,56,27,39,12,17,2,3,9,39,56,1,7,30,55,20,30,8,25,3,7,9,28,55
2005-02-14 00:00:00.000,Memphis TN; U.S.A. ATP World Tour,HARD,2,Kevin Kim,Scoville Jenkins,Kevin Kim,6-4; 6-7(5); 7-6(4),R32,118,9,1,72,106,53,72,23,34,4,6,17,76,106,12,1,71,104,52,71,22,33,3,6,17,74,104
2005-02-14 00:00:00.000,Memphis TN; U.S.A. ATP World Tour,HARD,2,Tommy Haas,Jeff Salzenstein,Tommy Haas,6-4; 6-4,R32,73,4,2,36,59,26,36,14,23,2,3,10,40,59,7,5,51,80,36,51,10,29,5,8,10,46,80
2005-02-14 00:00:00.000,Memphis TN; U.S.A. ATP World Tour,HARD,2,Andy Roddick,Arnaud Clement,Andy Roddick,6-3; 6-3,R16,75,13,1,30,47,27,30,10,17,1,1,9,37,47,5,3,44,74,30,44,11,30,6,9,9,41,74
2005-02-14 00:00:00.000,Memphis TN; U.S.A. ATP World Tour,HARD,2,Robby Ginepri,Mardy Fish,Robby Ginepri,6-1; 7-5,R16,60,7,2,41,50,35,41,5,9,0,0,10,40,50,14,2,35,60,26,35,9,25,5,8,9,35,60
2005-02-14 00:00:00.000,Memphis TN; U.S.A. ATP World Tour,HARD,2,Jan-Michael Gambill,Irakli Labadze,Jan-Michael Gambill,7-6(2); 7-6(3),R16,112,23,3,54,81,45,54,14,27,3,4,12,59,81,6,5,66,107,47,66,20,41,10,11,12,67,107
2005-02-14 00:00:00.000,Memphis TN; U.S.A. ATP World Tour,HARD,2,Kenneth Carlsen,Wayne Arthurs,Kenneth Carlsen,6-4; 7-6(5),R16,84,6,0,38,60,32,38,16,22,0,0,11,48,60,20,4,46,81,36,46,16,35,5,6,11,52,81
2005-02-14 00:00:00.000,Memphis TN; U.S.A. ATP World Tour,HARD,2,Max Mirnyi,Cyril Saulnier,Max Mirnyi,7-5; 6-4,R16,87,20,8,45,73,40,45,6,28,9,11,11,46,73,1,1,42,64,29,42,8,22,5,9,11,37,64
2005-02-14 00:00:00.000,Memphis TN; U.S.A. ATP World Tour,HARD,2,Antony Dupuis,Vincent Spadea,Antony Dupuis,7-5; 2-0 RET,R16,61,8,2,25,44,21,25,10,19,0,0,7,31,44,3,6,31,52,24,31,6,21,4,6,7,30,52
2005-02-14 00:00:00.000,Memphis TN; U.S.A. ATP World Tour,HARD,2,Xavier Malisse,Frank Dancevic,Xavier Malisse,6-2; 6-2,R16,54,7,1,31,47,28,31,8,16,1,1,8,36,47,1,1,29,53,15,29,13,24,4,8,8,28,53
2005-02-14 00:00:00.000,Memphis TN; U.S.A. ATP World Tour,HARD,2,Tommy Haas,Kevin Kim,Tommy Haas,7-6(4); 6-3,R16,74,12,0,32,59,30,32,19,27,0,0,11,49,59,6,0,33,64,27,33,18,31,1,2,10,45,64
2005-02-14 00:00:00.000,Memphis TN; U.S.A. ATP World Tour,HARD,2,Andy Roddick,Robby Ginepri,Andy Roddick,7-6(7); 7-6(2),Q,99,22,1,55,78,44,55,16,23,4,4,12,60,78,7,4,61,99,46,61,19,38,8,8,12,65,99
2005-02-14 00:00:00.000,Memphis TN; U.S.A. ATP World Tour,HARD,2,Kenneth Carlsen,Jan-Michael Gambill,Kenneth Carlsen,7-6(7); 7-5,Q,95,8,3,49,78,41,49,15,29,3,3,12,56,78,14,2,45,70,35,45,16,25,0,1,12,51,70
2005-02-14 00:00:00.000,Memphis TN; U.S.A. ATP World Tour,HARD,2,Max Mirnyi,Antony Dupuis,Max Mirnyi,7-6(1); 7-6(1),Q,102,18,3,52,81,47,52,17,29,4,4,12,64,81,8,2,52,77,38,52,15,25,1,1,12,53,77
2005-02-14 00:00:00.000,Memphis TN; U.S.A. ATP World Tour,HARD,2,Tommy Haas,Xavier Malisse,Tommy Haas,6-4; 6-3,Q,64,4,2,28,48,24,28,16,20,0,0,10,40,48,5,0,26,54,20,26,14,28,3,5,9,34,54
2005-02-14 00:00:00.000,Memphis TN; U.S.A. ATP World Tour,HARD,2,Kenneth Carlsen,Andy Roddick,Kenneth Carlsen,W/O,S,0,0,0,0,0,0,0,0,0,0,0,0,0,0,0,0,0,0,0,0,0,0,0,0,0,0,0
2005-02-14 00:00:00.000,Memphis TN; U.S.A. ATP World Tour,HARD,2,Max Mirnyi,Tommy Haas,Max Mirnyi,7-5; 6-3,S,85,11,4,40,63,35,40,10,23,2,3,11,45,63,5,6,50,71,31,50,9,21,8,11,10,40,71
2005-02-14 00:00:00.000,Memphis TN; U.S.A. ATP World Tour,HARD,2,Kenneth Carlsen,Max Mirnyi,Kenneth Carlsen,7-5; 7-5,F,98,9,1,51,70,38,51,14,19,4,4,12,52,70,15,5,50,80,41,50,10,30,8,10,12,51,80
2005-02-14 00:00:00.000,Rotterdam The Netherlands ATP World Tour,HARD,2,Roger Federer,Bohdan Ulihrach,Roger Federer,6-3; 6-4,R32,73,7,1,45,72,34,45,16,27,5,5,10,50,72,1,2,41,67,24,41,15,26,1,3,9,39,67
2005-02-14 00:00:00.000,Rotterdam The Netherlands ATP World Tour,HARD,2,Stanislas Wawrinka,Sebastien Grosjean,Stanislas Wawrinka,7-6(5); 6-2,R32,92,9,3,37,68,29,37,15,31,2,3,10,44,68,4,2,43,76,31,43,12,33,3,6,10,43,76
2005-02-14 00:00:00.000,Rotterdam The Netherlands ATP World Tour,HARD,2,Tomas Berdych,Robin Soderling,Tomas Berdych,7-5; 6-2,R32,69,11,0,28,56,24,28,15,28,1,2,10,39,56,8,5,37,63,24,37,11,26,2,6,10,35,63
2005-02-14 00:00:00.000,Rotterdam The Netherlands ATP World Tour,HARD,2,Nikolay Davydenko,Fernando Verdasco,Nikolay Davydenko,7-5; 2-6; 6-4,R32,124,6,4,60,102,43,60,20,42,7,10,15,63,102,11,3,49,89,34,49,24,40,4,7,15,58,89
2005-02-14 00:00:00.000,Rotterdam The Netherlands ATP World Tour,HARD,2,Tim Henman,Nicolas Kiefer,Tim Henman,7-5; 6-4,R32,85,6,3,34,59,28,34,16,25,0,0,11,44,59,8,4,32,59,25,32,14,27,1,3,11,39,59
2005-02-14 00:00:00.000,Rotterdam The Netherlands ATP World Tour,HARD,2,Michael Llodra,Peter Wessels,Michael Llodra,6-7(4); 6-4; 6-2,R32,110,13,3,64,97,52,64,15,33,2,3,15,67,97,7,3,72,96,50,72,7,24,5,9,15,57,96
2005-02-14 00:00:00.000,Rotterdam The Netherlands ATP World Tour,HARD,2,Mario Ancic,Taylor Dent,Mario Ancic,7-6(5); 7-5,R32,102,11,1,52,84,44,52,12,32,4,5,12,56,84,11,6,51,83,42,51,12,32,8,10,12,54,83
2005-02-14 00:00:00.000,Rotterdam The Netherlands ATP World Tour,HARD,2,Olivier Rochus,Feliciano Lopez,Olivier Rochus,6-4; 7-6(4),R32,96,1,1,46,67,34,46,14,21,1,2,11,48,67,12,5,50,78,34,50,12,28,5,7,11,46,78
2005-02-14 00:00:00.000,Rotterdam The Netherlands ATP World Tour,HARD,2,Joachim Johansson,Jimmy Wang,Joachim Johansson,6-2; 6-7(2); 6-3,R32,116,14,9,55,92,45,55,18,37,3,4,15,63,92,5,0,53,94,36,53,22,41,13,17,14,58,94
2005-02-14 00:00:00.000,Rotterdam The Netherlands ATP World Tour,HARD,2,Thomas Johansson,Karol Beck,Thomas Johansson,6-2; 3-6; 6-1,R32,93,5,4,28,71,23,28,25,43,2,3,12,48,71,5,1,42,68,30,42,12,26,0,4,12,42,68
2005-02-14 00:00:00.000,Rotterdam The Netherlands ATP World Tour,HARD,2,Juan Carlos Ferrero,Rainer Schuettler,Juan Carlos Ferrero,6-4; 6-2,R32,76,2,3,32,57,21,32,18,25,2,3,9,39,57,2,5,22,50,16,22,10,28,2,6,9,26,50
2005-02-14 00:00:00.000,Rotterdam The Netherlands ATP World Tour,HARD,2,Radek Stepanek,David Nalbandian,Radek Stepanek,6-2; 4-6; 6-1,R32,100,21,6,45,75,42,45,12,30,3,4,13,54,75,0,1,37,71,20,37,22,34,5,9,12,42,71
2005-02-14 00:00:00.000,Rotterdam The Netherlands ATP World Tour,HARD,2,Ivan Ljubicic,Dominik Hrbaty,Ivan Ljubicic,6-4; 1-6; 6-2,R32,104,14,0,50,79,38,50,14,29,6,8,12,52,79,8,3,39,78,28,39,22,39,4,7,13,50,78
2005-02-14 00:00:00.000,Rotterdam The Netherlands ATP World Tour,HARD,2,Sjeng Schalken,Andrei Pavel,Sjeng Schalken,4-6; 7-5; 6-4,R32,157,1,3,71,100,49,71,17,29,6,9,16,66,100,12,3,67,115,52,67,17,48,11,15,16,69,115
2005-02-14 00:00:00.000,Rotterdam The Netherlands ATP World Tour,HARD,2,Paradorn Srichaphan,Igor Andreev,Paradorn Srichaphan,7-6(4); 1-6; 7-5,R32,139,5,4,60,99,44,60,21,39,3,5,15,65,99,7,2,69,116,51,69,26,47,9,10,16,77,116
2005-02-14 00:00:00.000,Rotterdam The Netherlands ATP World Tour,HARD,2,Guillermo Coria,Raemon Sluiter,Guillermo Coria,6-2; 6-4,R32,87,5,5,33,61,25,33,13,28,6,8,9,38,61,10,3,34,64,23,34,10,30,4,9,9,33,64
2005-02-14 00:00:00.000,Rotterdam The Netherlands ATP World Tour,HARD,2,Roger Federer,Stanislas Wawrinka,Roger Federer,6-1; 6-4,R16,64,0,1,37,58,27,37,13,21,1,1,9,40,58,2,3,24,53,18,24,12,29,4,7,8,30,53
2005-02-14 00:00:00.000,Rotterdam The Netherlands ATP World Tour,HARD,2,Nikolay Davydenko,Tomas Berdych,Nikolay Davydenko,7-6(8); 6-0,R16,82,4,1,50,61,39,50,3,11,4,5,9,42,61,3,1,39,67,20,39,14,28,3,7,9,34,67
2005-02-14 00:00:00.000,Rotterdam The Netherlands ATP World Tour,HARD,2,Tim Henman,Michael Llodra,Tim Henman,6-4; 6-1,R16,58,6,2,33,50,31,33,8,17,1,1,9,39,50,3,1,25,44,17,25,8,19,1,4,8,25,44
2005-02-14 00:00:00.000,Rotterdam The Netherlands ATP World Tour,HARD,2,Mario Ancic,Olivier Rochus,Mario Ancic,6-4; 6-3,R16,74,24,2,43,65,37,43,9,22,3,3,10,46,65,5,1,33,46,24,33,6,13,1,3,9,30,46
2005-02-14 00:00:00.000,Rotterdam The Netherlands ATP World Tour,HARD,2,Thomas Johansson,Joachim Johansson,Thomas Johansson,6-4; 6-4,R16,72,15,2,31,59,27,31,17,28,1,1,10,44,59,13,2,37,56,29,37,9,19,2,4,10,38,56
2005-02-14 00:00:00.000,Rotterdam The Netherlands ATP World Tour,HARD,2,Radek Stepanek,Juan Carlos Ferrero,Radek Stepanek,6-4; 6-7(6); 6-3,R16,147,15,11,67,103,59,67,12,36,6,7,16,71,103,1,1,64,95,45,64,16,31,4,7,15,61,95
2005-02-14 00:00:00.000,Rotterdam The Netherlands ATP World Tour,HARD,2,Ivan Ljubicic,Sjeng Schalken,Ivan Ljubicic,6-4; 5-7; 6-3,R16,157,12,1,55,98,39,55,24,43,6,9,16,63,98,4,3,72,95,45,72,13,23,3,7,15,58,95
2005-02-14 00:00:00.000,Rotterdam The Netherlands ATP World Tour,HARD,2,Paradorn Srichaphan,Guillermo Coria,Paradorn Srichaphan,2-6; 7-6(2); 6-3,R16,142,10,2,60,91,48,60,14,31,3,5,14,62,91,3,4,57,102,40,57,25,45,4,6,15,65,102
2005-02-14 00:00:00.000,Rotterdam The Netherlands ATP World Tour,HARD,2,Roger Federer,Nikolay Davydenko,Roger Federer,7-5; 7-5,Q,101,6,1,54,88,38,54,20,34,6,6,12,58,88,2,1,52,67,34,52,10,15,1,3,12,44,67
2005-02-14 00:00:00.000,Rotterdam The Netherlands ATP World Tour,HARD,2,Mario Ancic,Tim Henman,Mario Ancic,7-6(5); 7-6(4),Q,119,13,2,54,86,44,54,14,32,3,6,12,58,86,4,4,47,77,35,47,12,30,2,5,12,47,77
2005-02-14 00:00:00.000,Rotterdam The Netherlands ATP World Tour,HARD,2,Thomas Johansson,Radek Stepanek,Thomas Johansson,6-2; 7-6(5),Q,100,6,3,29,62,23,29,19,33,0,2,10,42,62,11,5,42,78,27,42,15,36,8,12,10,42,78
2005-02-14 00:00:00.000,Rotterdam The Netherlands ATP World Tour,HARD,2,Ivan Ljubicic,Paradorn Srichaphan,Ivan Ljubicic,3-6; 6-4; 6-2,Q,123,11,1,53,89,40,53,18,36,8,10,14,58,89,9,1,46,76,32,46,16,30,6,9,13,48,76
2005-02-14 00:00:00.000,Rotterdam The Netherlands ATP World Tour,HARD,2,Roger Federer,Mario Ancic,Roger Federer,7-5; 6-3,S,88,5,2,32,49,27,32,13,17,0,0,10,40,49,8,0,41,68,30,41,13,27,3,6,11,43,68
2005-02-14 00:00:00.000,Rotterdam The Netherlands ATP World Tour,HARD,2,Ivan Ljubicic,Thomas Johansson,Ivan Ljubicic,7-6(4); 7-5,S,104,12,0,47,72,39,47,17,25,3,3,12,56,72,9,2,35,69,29,35,23,34,2,3,12,52,69
2005-02-14 00:00:00.000,Rotterdam The Netherlands ATP World Tour,HARD,2,Roger Federer,Ivan Ljubicic,Roger Federer,5-7; 7-5; 7-6(5),F,164,12,2,67,97,58,67,17,30,2,3,18,75,97,16,3,87,131,65,87,22,44,5,6,18,87,131
2005-02-21 00:00:00.000,Acapulco Mexico ATP World Tour,CLAY,2,Carlos Moya,Nicolas Lapentti,Carlos Moya,6-4; 7-6(4),R32,98,5,3,51,65,42,51,7,14,1,2,11,49,65,2,0,42,66,26,42,17,24,1,3,11,43,66
2005-02-21 00:00:00.000,Acapulco Mexico ATP World Tour,CLAY,2,Mariano Puerta,Guillermo Garcia-Lopez,Mariano Puerta,6-3; 7-6(3),R32,98,10,1,49,61,35,49,8,12,2,3,10,43,61,6,7,50,85,33,50,16,35,6,9,11,49,85
2005-02-21 00:00:00.000,Acapulco Mexico ATP World Tour,CLAY,2,Felix Mantilla,Miguel Gallardo-Valles,Felix Mantilla,6-1; 6-1,R32,56,2,0,28,39,21,28,9,11,0,0,7,30,39,1,2,29,45,13,29,6,16,3,8,7,19,45
2005-02-21 00:00:00.000,Acapulco Mexico ATP World Tour,CLAY,2,David Ferrer,Ricardo Mello,David Ferrer,4-6; 6-3; 6-2,R32,102,2,2,45,73,37,45,15,28,1,3,14,52,73,3,2,68,91,44,68,8,23,5,9,13,52,91
2005-02-21 00:00:00.000,Acapulco Mexico ATP World Tour,CLAY,2,Guillermo Canas,Edgardo Massa,Guillermo Canas,6-4; 2-2 RET,R32,59,4,0,20,37,15,20,13,17,0,0,7,28,37,0,1,33,44,22,33,5,11,1,2,7,27,44
2005-02-21 00:00:00.000,Acapulco Mexico ATP World Tour,CLAY,2,Nicolas Devilder,Jose Acasuso,Nicolas Devilder,6-4; 6-4,R32,0,4,2,36,58,31,36,12,22,3,3,10,43,58,2,0,26,53,20,26,15,27,1,3,10,35,53
2005-02-21 00:00:00.000,Acapulco Mexico ATP World Tour,CLAY,2,Santiago Ventura,Nicolas Almagro,Santiago Ventura,2-6; 6-4; 6-2,R32,96,4,1,40,78,31,40,22,38,2,4,13,53,78,13,1,45,66,35,45,11,21,1,4,13,46,66
2005-02-21 00:00:00.000,Acapulco Mexico ATP World Tour,CLAY,2,Rafael Nadal,Alex Calatrava,Rafael Nadal,6-4; 6-4,R32,83,5,1,36,56,28,36,11,20,1,2,10,39,56,7,1,33,58,26,33,10,25,4,7,10,36,58
2005-02-21 00:00:00.000,Acapulco Mexico ATP World Tour,CLAY,2,Jiri Novak,Juan Antonio Marin,Jiri Novak,6-3; 7-5,R32,84,6,1,50,61,40,50,4,11,2,2,10,44,61,5,3,33,71,24,33,19,38,3,6,11,43,71
2005-02-21 00:00:00.000,Acapulco Mexico ATP World Tour,CLAY,2,Oscar Hernandez,David Sanchez,Oscar Hernandez,6-4; 6-2,R32,76,1,4,32,50,26,32,10,18,2,3,9,36,50,5,0,38,55,19,38,10,17,5,9,9,29,55
2005-02-21 00:00:00.000,Acapulco Mexico ATP World Tour,CLAY,2,Agustin Calleri,Olivier Patience,Agustin Calleri,7-5; 7-6(5),R32,101,12,3,42,74,32,42,19,32,2,4,12,51,74,3,4,50,76,34,50,12,26,1,4,12,46,76
2005-02-21 00:00:00.000,Acapulco Mexico ATP World Tour,CLAY,2,Juan Monaco,Juan Ignacio Chela,Juan Monaco,6-2; 6-3,R32,68,3,3,28,44,24,28,8,16,4,5,8,32,44,0,2,37,59,21,37,9,22,1,6,9,30,59
2005-02-21 00:00:00.000,Acapulco Mexico ATP World Tour,CLAY,2,Filippo Volandri,Mariano Zabaleta,Filippo Volandri,6-2; 7-6(6),R32,82,2,1,36,63,26,36,16,27,2,4,10,42,63,4,4,37,64,26,37,11,27,3,7,10,37,64
2005-02-21 00:00:00.000,Acapulco Mexico ATP World Tour,CLAY,2,Alberto Martin,Jiri Vanek,Alberto Martin,6-0; 2-6; 7-6(1),R32,114,4,2,49,84,34,49,20,35,2,4,13,54,84,12,3,52,82,36,52,13,30,4,7,13,49,82
2005-02-21 00:00:00.000,Acapulco Mexico ATP World Tour,CLAY,2,Albert Montanes,Alejandro Hernandez,Albert Montanes,6-2; 6-3,R32,72,2,1,29,40,22,29,10,11,0,0,8,32,40,3,3,38,66,24,38,10,28,2,6,9,34,66
2005-02-21 00:00:00.000,Acapulco Mexico ATP World Tour,CLAY,2,Tomas Zib,Gaston Gaudio,Tomas Zib,2-6; 7-5 RET,R32,99,7,3,31,59,22,31,14,28,2,4,10,36,59,3,4,39,81,30,39,20,42,3,4,10,50,81
2005-02-21 00:00:00.000,Acapulco Mexico ATP World Tour,CLAY,2,Mariano Puerta,Carlos Moya,Mariano Puerta,4-6; 6-3; 6-4,R16,131,3,0,71,101,51,71,15,30,5,6,15,66,101,13,1,49,81,37,49,17,32,3,5,14,54,81
2005-02-21 00:00:00.000,Acapulco Mexico ATP World Tour,CLAY,2,Felix Mantilla,David Ferrer,Felix Mantilla,7-5; 6-2,R16,80,0,2,41,55,29,41,7,14,0,2,10,36,55,2,4,42,69,21,42,12,27,6,11,10,33,69
2005-02-21 00:00:00.000,Acapulco Mexico ATP World Tour,CLAY,2,Guillermo Canas,Nicolas Devilder,Guillermo Canas,6-0; 7-5,R16,92,3,2,31,54,23,31,14,23,2,3,9,37,54,2,3,31,55,18,31,10,24,2,7,9,28,55
2005-02-21 00:00:00.000,Acapulco Mexico ATP World Tour,CLAY,2,Rafael Nadal,Santiago Ventura,Rafael Nadal,7-6(0); 6-2,R16,104,3,1,43,63,33,43,13,20,4,5,10,46,63,4,2,29,76,16,29,25,47,5,8,10,41,76
2005-02-21 00:00:00.000,Acapulco Mexico ATP World Tour,CLAY,2,Jiri Novak,Oscar Hernandez,Jiri Novak,6-3; 6-1,R16,56,4,1,28,42,23,28,10,14,1,1,8,33,42,4,3,28,50,20,28,6,22,2,6,8,26,50
2005-02-21 00:00:00.000,Acapulco Mexico ATP World Tour,CLAY,2,Agustin Calleri,Juan Monaco,Agustin Calleri,7-6(4); 6-3,R16,107,8,1,39,70,30,39,21,31,1,1,11,51,70,0,3,57,87,35,57,17,30,5,6,10,52,87
2005-02-21 00:00:00.000,Acapulco Mexico ATP World Tour,CLAY,2,Filippo Volandri,Alberto Martin,Filippo Volandri,7-6(5); 7-5,R16,124,0,2,56,82,38,56,12,26,3,6,12,50,82,4,3,53,103,33,53,23,50,8,12,12,56,103
2005-02-21 00:00:00.000,Acapulco Mexico ATP World Tour,CLAY,2,Albert Montanes,Tomas Zib,Albert Montanes,6-4; 7-6(15),R16,116,17,6,55,91,44,55,19,36,4,5,11,63,91,5,0,37,83,32,37,23,46,4,6,11,55,83
2005-02-21 00:00:00.000,Acapulco Mexico ATP World Tour,CLAY,2,Mariano Puerta,Felix Mantilla,Mariano Puerta,6-4; 3-6; 7-6(5),Q,157,9,1,70,107,52,70,17,37,3,6,15,69,107,13,3,70,108,52,70,19,38,7,10,16,71,108
2005-02-21 00:00:00.000,Acapulco Mexico ATP World Tour,CLAY,2,Rafael Nadal,Guillermo Canas,Rafael Nadal,7-5; 6-3,Q,105,0,1,42,63,31,42,17,21,3,3,11,48,63,4,6,38,56,29,38,6,18,1,3,10,35,56
2005-02-21 00:00:00.000,Acapulco Mexico ATP World Tour,CLAY,2,Agustin Calleri,Jiri Novak,Agustin Calleri,7-5; 6-1,Q,72,9,0,36,55,28,36,14,19,2,2,10,42,55,2,0,33,57,19,33,11,24,3,6,9,30,57
2005-02-21 00:00:00.000,Acapulco Mexico ATP World Tour,CLAY,2,Albert Montanes,Filippo Volandri,Albert Montanes,4-6; 6-3; 6-4,Q,102,7,2,55,78,44,55,13,23,2,4,15,57,78,1,5,64,93,47,64,12,29,7,10,14,59,93
2005-02-21 00:00:00.000,Acapulco Mexico ATP World Tour,CLAY,2,Rafael Nadal,Mariano Puerta,Rafael Nadal,6-4; 6-1,S,76,4,1,37,47,30,37,4,10,0,1,9,34,47,4,0,39,52,20,39,6,13,8,12,8,26,52
2005-02-21 00:00:00.000,Acapulco Mexico ATP World Tour,CLAY,2,Albert Montanes,Agustin Calleri,Albert Montanes,7-6(3); 1-6; 7-6(4),S,149,6,0,72,112,47,72,19,40,5,10,16,66,112,9,2,54,98,39,54,24,44,4,6,15,63,98
2005-02-21 00:00:00.000,Acapulco Mexico ATP World Tour,CLAY,2,Rafael Nadal,Albert Montanes,Rafael Nadal,6-1; 6-0,F,52,5,2,28,36,24,28,4,8,0,0,7,28,36,0,1,25,36,12,25,2,11,4,9,6,14,36
2005-02-21 00:00:00.000,Dubai U.A.E. ATP World Tour,HARD,2,Roger Federer,Ivo Minar,Roger Federer,6-7(5); 6-3; 7-6(5),R32,124,11,4,62,99,47,62,21,37,2,4,16,68,99,6,1,60,110,44,60,27,50,5,9,17,71,110
2005-02-21 00:00:00.000,Dubai U.A.E. ATP World Tour,HARD,2,Juan Carlos Ferrero,Florian Mayer,Juan Carlos Ferrero,6-3; 6-4,R32,77,5,1,39,56,29,39,12,17,3,4,10,41,56,6,2,35,59,24,35,7,24,3,6,9,31,59
2005-02-21 00:00:00.000,Dubai U.A.E. ATP World Tour,HARD,2,Rainer Schuettler,Younes El Aynaoui,Rainer Schuettler,6-0; 6-1,R32,44,4,0,20,35,17,20,9,15,1,2,7,26,35,0,3,22,37,7,22,3,15,4,10,6,10,37
2005-02-21 00:00:00.000,Dubai U.A.E. ATP World Tour,HARD,2,Mikhail Youzhny,Thomas Johansson,Mikhail Youzhny,7-6(3); 6-1,R32,92,9,1,30,72,25,30,27,42,6,6,10,52,72,7,3,31,62,22,31,15,31,0,2,9,37,62
2005-02-21 00:00:00.000,Dubai U.A.E. ATP World Tour,HARD,2,Andre Agassi,Radek Stepanek,Andre Agassi,6-4; 7-5,R32,120,5,1,31,54,26,31,16,23,1,2,11,42,54,12,5,38,64,27,38,12,26,5,8,11,39,64
2005-02-21 00:00:00.000,Dubai U.A.E. ATP World Tour,HARD,2,Feliciano Lopez,Paradorn Srichaphan,Feliciano Lopez,6-2; 3-6; 6-3,R32,103,6,2,46,73,34,46,18,27,1,2,13,52,73,5,8,56,98,38,56,20,42,6,9,13,58,98
2005-02-21 00:00:00.000,Dubai U.A.E. ATP World Tour,HARD,2,Dominik Hrbaty,Omar Awadhy,Dominik Hrbaty,6-0; 6-4,R32,53,8,4,31,59,22,31,17,28,3,3,8,39,59,0,2,30,51,14,30,11,21,1,5,8,25,51
2005-02-21 00:00:00.000,Dubai U.A.E. ATP World Tour,HARD,2,Nikolay Davydenko,Fabrice Santoro,Nikolay Davydenko,6-3; 6-0,R32,66,3,0,28,47,17,28,11,19,4,5,7,28,47,1,3,18,45,9,18,9,27,3,9,8,18,45
2005-02-21 00:00:00.000,Dubai U.A.E. ATP World Tour,HARD,2,Ivan Ljubicic,Jean-Rene Lisnard,Ivan Ljubicic,6-1; 6-1,R32,59,6,1,26,45,18,26,12,19,6,7,7,30,45,0,4,15,48,8,15,9,33,6,12,7,17,48
2005-02-21 00:00:00.000,Dubai U.A.E. ATP World Tour,HARD,2,Fernando Verdasco,Vladimir Voltchkov,Fernando Verdasco,6-2; 6-2,R32,52,5,0,30,39,24,30,8,9,0,0,8,32,39,1,1,27,46,18,27,6,19,1,5,8,24,46
2005-02-21 00:00:00.000,Dubai U.A.E. ATP World Tour,HARD,2,Igor Andreev,Marco Chiudinelli,Igor Andreev,6-3; 7-5,R32,72,2,1,24,53,23,24,20,29,0,1,11,43,53,2,3,34,60,24,34,11,26,1,4,10,35,60
2005-02-21 00:00:00.000,Dubai U.A.E. ATP World Tour,HARD,2,Tim Henman,Greg Rusedski,Tim Henman,4-6; 7-6(7); 6-4,R32,158,2,3,77,111,58,77,17,34,5,7,16,75,111,4,5,69,123,52,69,28,54,7,9,16,80,123
2005-02-21 00:00:00.000,Dubai U.A.E. ATP World Tour,HARD,2,Tommy Robredo,Olivier Rochus,Tommy Robredo,7-6(5); 7-6(6),R32,134,10,7,61,109,47,61,14,48,10,13,12,61,109,4,9,57,91,39,57,14,34,8,11,12,53,91
2005-02-21 00:00:00.000,Dubai U.A.E. ATP World Tour,HARD,2,Tomas Berdych,Karol Beck,Tomas Berdych,6-4; 7-6(4),R32,96,1,4,27,63,19,27,20,36,0,3,11,39,63,4,7,37,73,23,37,17,36,1,5,11,40,73
2005-02-21 00:00:00.000,Dubai U.A.E. ATP World Tour,HARD,2,Hyung-Taik Lee,Robin Soderling,Hyung-Taik Lee,7-5; 6-4,R32,77,5,1,35,60,25,35,15,25,2,4,11,40,60,6,2,42,68,23,42,16,26,4,8,11,39,68
2005-02-21 00:00:00.000,Dubai U.A.E. ATP World Tour,HARD,2,Nicolas Kiefer,Marat Safin,Nicolas Kiefer,7-6(2); 6-4,R32,89,8,4,35,70,27,35,22,35,2,3,11,49,70,6,2,38,64,28,38,13,26,0,2,11,41,64
2005-02-21 00:00:00.000,Dubai U.A.E. ATP World Tour,HARD,2,Roger Federer,Juan Carlos Ferrero,Roger Federer,4-6; 6-3; 7-6(6),R16,136,7,1,66,100,46,66,22,34,6,9,16,68,100,1,3,74,102,51,74,14,28,8,11,15,65,102
2005-02-21 00:00:00.000,Dubai U.A.E. ATP World Tour,HARD,2,Mikhail Youzhny,Rainer Schuettler,Mikhail Youzhny,7-5; 6-4,R16,138,9,2,39,68,29,39,12,29,4,7,11,41,68,1,6,35,70,25,35,11,35,11,16,11,36,70
2005-02-21 00:00:00.000,Dubai U.A.E. ATP World Tour,HARD,2,Andre Agassi,Feliciano Lopez,Andre Agassi,6-1; 6-3,R16,57,1,0,30,51,27,30,10,21,2,2,8,37,51,4,2,24,40,15,24,5,16,1,5,8,20,40
2005-02-21 00:00:00.000,Dubai U.A.E. ATP World Tour,HARD,2,Nikolay Davydenko,Dominik Hrbaty,Nikolay Davydenko,7-5; 6-3,R16,88,4,4,45,69,32,45,10,24,8,11,10,42,69,4,5,48,73,28,48,9,25,6,12,11,37,73
2005-02-21 00:00:00.000,Dubai U.A.E. ATP World Tour,HARD,2,Ivan Ljubicic,Fernando Verdasco,Ivan Ljubicic,6-7(4); 6-4; 7-6(8),R16,175,8,1,85,126,59,85,21,41,5,8,17,80,126,7,1,83,119,58,83,17,36,10,14,17,75,119
2005-02-21 00:00:00.000,Dubai U.A.E. ATP World Tour,HARD,2,Tim Henman,Igor Andreev,Tim Henman,7-6(5); 6-1,R16,86,1,3,34,60,31,34,14,26,3,3,10,45,60,2,2,44,71,28,44,14,27,3,5,9,42,71
2005-02-21 00:00:00.000,Dubai U.A.E. ATP World Tour,HARD,2,Tommy Robredo,Tomas Berdych,Tommy Robredo,6-2; 6-4,R16,61,3,0,32,50,26,32,12,18,2,2,9,38,50,3,1,28,49,20,28,10,21,5,8,9,30,49
2005-02-21 00:00:00.000,Dubai U.A.E. ATP World Tour,HARD,2,Nicolas Kiefer,Hyung-Taik Lee,Nicolas Kiefer,2-6; 6-1; 6-3,R16,102,8,3,34,71,25,34,20,37,0,3,12,45,71,3,4,51,74,34,51,8,23,5,10,12,42,74
2005-02-21 00:00:00.000,Dubai U.A.E. ATP World Tour,HARD,2,Roger Federer,Mikhail Youzhny,Roger Federer,6-3; 7-5,Q,73,3,1,42,72,34,42,14,30,0,1,11,48,72,0,4,33,52,24,33,8,19,2,5,10,32,52
2005-02-21 00:00:00.000,Dubai U.A.E. ATP World Tour,HARD,2,Andre Agassi,Nikolay Davydenko,Andre Agassi,6-4; 7-6(4),Q,95,9,1,48,71,38,48,10,23,4,6,11,48,71,3,2,46,79,30,46,17,33,4,7,11,47,79
2005-02-21 00:00:00.000,Dubai U.A.E. ATP World Tour,HARD,2,Ivan Ljubicic,Tim Henman,Ivan Ljubicic,7-5; 6-4,Q,137,8,2,47,79,31,47,21,32,5,6,11,52,79,5,4,38,64,26,38,14,26,3,6,11,40,64
2005-02-21 00:00:00.000,Dubai U.A.E. ATP World Tour,HARD,2,Tommy Robredo,Nicolas Kiefer,Tommy Robredo,6-4; 6-4,Q,90,1,1,38,62,25,38,17,24,3,4,10,42,62,5,3,33,62,28,33,9,29,2,5,10,37,62
2005-02-21 00:00:00.000,Dubai U.A.E. ATP World Tour,HARD,2,Roger Federer,Andre Agassi,Roger Federer,6-3; 6-1,S,52,8,3,33,51,25,33,11,18,3,3,8,36,51,2,1,24,41,11,24,9,17,2,6,8,20,41
2005-02-21 00:00:00.000,Dubai U.A.E. ATP World Tour,HARD,2,Ivan Ljubicic,Tommy Robredo,Ivan Ljubicic,6-4; 6-3,S,80,13,0,36,60,30,36,15,24,2,2,10,45,60,2,1,34,56,23,34,11,22,3,5,9,34,56
2005-02-21 00:00:00.000,Dubai U.A.E. ATP World Tour,HARD,2,Roger Federer,Ivan Ljubicic,Roger Federer,6-1; 6-7(6); 6-3,F,136,6,2,63,102,43,63,25,39,5,7,15,68,102,5,0,48,89,37,48,15,41,2,7,13,52,89
2005-02-21 00:00:00.000,Scottsdale AZ; U.S.A. ATP World Tour,HARD,2,Paul Goldstein,Donald Young,Paul Goldstein,6-3; 6-1,R32,60,0,1,24,43,17,24,9,19,0,3,8,26,43,1,2,45,69,18,45,9,24,9,16,8,27,69
2005-02-21 00:00:00.000,Scottsdale AZ; U.S.A. ATP World Tour,HARD,2,Davide Sanguinetti,Michael Kohlmann,Davide Sanguinetti,6-4; 6-7(2); 6-3,R32,148,8,2,70,114,53,70,20,44,9,10,16,73,114,8,5,60,112,41,60,27,52,9,12,15,68,112
2005-02-21 00:00:00.000,Scottsdale AZ; U.S.A. ATP World Tour,HARD,2,Christophe Rochus,Jeff Morrison,Christophe Rochus,6-4; 2-6; 6-4,R32,93,4,1,59,82,37,59,13,23,5,10,14,50,82,14,4,43,81,33,43,15,38,4,9,14,48,81
2005-02-21 00:00:00.000,Scottsdale AZ; U.S.A. ATP World Tour,HARD,2,Kevin Kim,Horia Tecau,Kevin Kim,6-3; 6-2,R32,60,2,0,23,47,19,23,15,24,2,2,8,34,47,8,10,21,53,18,21,11,32,5,9,9,29,53
2005-02-21 00:00:00.000,Scottsdale AZ; U.S.A. ATP World Tour,HARD,2,Wayne Arthurs,Taylor Dent,Wayne Arthurs,3-6; 6-3; 7-6(4),R32,100,13,3,48,87,40,48,26,39,5,6,15,66,87,11,5,46,84,36,46,28,38,1,2,15,64,84
2005-02-21 00:00:00.000,Scottsdale AZ; U.S.A. ATP World Tour,HARD,2,Justin Gimelstob,Kristof Vliegen,Justin Gimelstob,6-3; 7-6(3),R32,73,12,7,46,68,41,46,10,22,0,0,11,51,68,5,2,35,56,26,35,15,21,1,2,10,41,56
2005-02-21 00:00:00.000,Scottsdale AZ; U.S.A. ATP World Tour,HARD,2,Glenn Weiner,Frank Dancevic,Glenn Weiner,6-4; 7-6(4),R32,78,6,3,42,65,34,42,14,23,1,2,11,48,65,10,4,46,76,36,46,13,30,2,4,11,49,76
2005-02-21 00:00:00.000,Scottsdale AZ; U.S.A. ATP World Tour,HARD,2,Lars Burgsmuller,Yen-Hsun Lu,Lars Burgsmuller,4-6; 6-4; 7-6(3),R32,146,5,4,67,122,46,67,26,55,11,16,16,72,122,1,5,49,95,33,49,22,46,6,11,16,55,95
2005-02-21 00:00:00.000,Scottsdale AZ; U.S.A. ATP World Tour,HARD,2,Irakli Labadze,Alex Kuznetsov,Irakli Labadze,3-6; 7-5; 6-1,R32,110,4,2,51,74,39,51,12,23,1,3,14,51,74,6,3,51,95,32,51,25,44,5,9,14,57,95
2005-02-21 00:00:00.000,Scottsdale AZ; U.S.A. ATP World Tour,HARD,2,Giovanni Lapentti,Wesley Moodie,Giovanni Lapentti,6-4; 6-1,R32,68,1,2,24,48,20,24,14,24,1,1,8,34,48,4,3,36,57,23,36,7,21,1,5,9,30,57
2005-02-21 00:00:00.000,Scottsdale AZ; U.S.A. ATP World Tour,HARD,2,Mark Philippoussis,Tomas Behrend,Mark Philippoussis,7-5; 1-6; 6-4,R32,129,12,4,54,89,39,54,18,35,4,7,14,57,89,6,6,57,99,39,57,22,42,7,10,15,61,99
2005-02-21 00:00:00.000,Scottsdale AZ; U.S.A. ATP World Tour,HARD,2,Mario Ancic,Brendan Evans,Mario Ancic,3-6; 6-2; 6-3,R32,96,8,3,46,74,36,46,16,28,1,3,13,52,74,2,3,45,78,30,45,15,33,2,6,13,45,78
2005-02-21 00:00:00.000,Scottsdale AZ; U.S.A. ATP World Tour,HARD,2,James Blake,Kenneth Carlsen,James Blake,7-6(9); 7-5,R32,106,1,2,51,84,38,51,16,33,4,7,12,54,84,7,2,54,87,40,54,16,33,7,11,12,56,87
2005-02-21 00:00:00.000,Scottsdale AZ; U.S.A. ATP World Tour,HARD,2,Jeff Salzenstein,Alex Bogomolov Jr.,Jeff Salzenstein,6-3; 7-6(4),R32,86,14,5,50,80,37,50,13,30,1,3,11,50,80,1,2,46,66,26,46,14,20,3,6,10,40,66
2005-02-21 00:00:00.000,Scottsdale AZ; U.S.A. ATP World Tour,HARD,2,Janko Tipsarevic,Jan-Michael Gambill,Janko Tipsarevic,6-4; 6-2,R32,78,4,2,30,66,23,30,20,36,0,0,9,43,66,11,2,35,64,24,35,12,29,4,7,9,36,64
2005-02-21 00:00:00.000,Scottsdale AZ; U.S.A. ATP World Tour,HARD,2,Vincent Spadea,Bobby Reynolds,Vincent Spadea,1-6; 7-6(4); 7-6(2),R32,132,8,5,56,104,39,56,24,48,8,14,16,63,104,14,6,55,106,42,55,25,51,7,10,15,67,106
2005-02-21 00:00:00.000,Scottsdale AZ; U.S.A. ATP World Tour,HARD,2,Davide Sanguinetti,Paul Goldstein,Davide Sanguinetti,3-6; 6-1; 6-4,R16,100,8,1,55,86,41,55,19,31,7,8,13,60,86,3,3,47,81,34,47,15,34,5,8,13,49,81
2005-02-21 00:00:00.000,Scottsdale AZ; U.S.A. ATP World Tour,HARD,2,Christophe Rochus,Kevin Kim,Christophe Rochus,6-3; 6-1,R16,59,0,1,29,51,21,29,15,22,4,4,8,36,51,4,4,28,52,16,28,11,24,3,7,8,27,52
2005-02-21 00:00:00.000,Scottsdale AZ; U.S.A. ATP World Tour,HARD,2,Wayne Arthurs,Justin Gimelstob,Wayne Arthurs,6-2; 6-7(5); 7-6(6),R16,141,18,7,44,98,38,44,34,54,0,0,16,72,98,12,5,75,123,54,75,21,48,7,9,16,75,123
2005-02-21 00:00:00.000,Scottsdale AZ; U.S.A. ATP World Tour,HARD,2,Glenn Weiner,Lars Burgsmuller,Glenn Weiner,6-4; 6-4,R16,82,8,1,35,59,30,35,10,24,4,6,10,40,59,2,2,41,63,24,41,10,22,5,9,10,34,63
2005-02-21 00:00:00.000,Scottsdale AZ; U.S.A. ATP World Tour,HARD,2,Giovanni Lapentti,Irakli Labadze,Giovanni Lapentti,6-2; 6-2,R16,63,4,2,30,46,26,30,9,16,2,2,8,35,46,2,5,36,60,18,36,11,24,8,12,8,29,60
2005-02-21 00:00:00.000,Scottsdale AZ; U.S.A. ATP World Tour,HARD,2,Mario Ancic,Mark Philippoussis,Mario Ancic,6-1; 7-6(3),R16,74,10,2,36,59,29,36,13,23,2,4,10,42,59,1,5,37,56,21,37,7,19,1,5,9,28,56
2005-02-21 00:00:00.000,Scottsdale AZ; U.S.A. ATP World Tour,HARD,2,James Blake,Jeff Salzenstein,James Blake,6-2; 6-4,R16,67,5,0,42,74,30,42,16,32,8,8,9,46,74,4,2,27,46,19,27,10,19,2,5,9,29,46
2005-02-21 00:00:00.000,Scottsdale AZ; U.S.A. ATP World Tour,HARD,2,Vincent Spadea,Janko Tipsarevic,Vincent Spadea,6-4; 4-6; 6-4,R16,126,4,1,45,98,35,45,27,53,8,11,15,62,98,5,3,44,94,31,44,27,50,3,7,15,58,94
2005-02-21 00:00:00.000,Scottsdale AZ; U.S.A. ATP World Tour,HARD,2,Christophe Rochus,Davide Sanguinetti,Christophe Rochus,6-4; 6-3,Q,78,2,1,39,65,28,39,17,26,5,5,9,45,65,2,4,34,65,26,34,12,31,3,6,10,38,65
2005-02-21 00:00:00.000,Scottsdale AZ; U.S.A. ATP World Tour,HARD,2,Wayne Arthurs,Glenn Weiner,Wayne Arthurs,6-3; 7-6(3),Q,81,15,5,32,68,29,32,22,36,2,2,11,51,68,7,7,36,69,30,36,16,33,4,5,10,46,69
2005-02-21 00:00:00.000,Scottsdale AZ; U.S.A. ATP World Tour,HARD,2,Mario Ancic,Giovanni Lapentti,Mario Ancic,6-1; 6-4,Q,66,9,2,35,57,27,35,15,22,3,3,9,42,57,0,1,24,45,16,24,11,21,3,6,8,27,45
2005-02-21 00:00:00.000,Scottsdale AZ; U.S.A. ATP World Tour,HARD,2,Vincent Spadea,James Blake,Vincent Spadea,7-6(6); 6-1,Q,88,3,2,33,76,24,33,22,43,6,8,9,46,76,3,7,32,64,22,32,11,32,1,6,10,33,64
2005-02-21 00:00:00.000,Scottsdale AZ; U.S.A. ATP World Tour,HARD,2,Wayne Arthurs,Christophe Rochus,Wayne Arthurs,7-5; 7-6(2),S,79,19,2,32,63,29,32,25,31,0,0,12,54,63,5,2,49,67,39,49,10,18,1,2,12,49,67
2005-02-21 00:00:00.000,Scottsdale AZ; U.S.A. ATP World Tour,HARD,2,Mario Ancic,Vincent Spadea,Mario Ancic,6-1; 6-4,S,79,5,3,40,64,30,40,11,24,2,3,9,41,64,1,2,24,48,13,24,12,24,1,5,8,25,48
2005-02-21 00:00:00.000,Scottsdale AZ; U.S.A. ATP World Tour,HARD,2,Wayne Arthurs,Mario Ancic,Wayne Arthurs,7-5; 6-3,F,81,9,0,31,53,28,31,17,22,0,0,11,45,53,10,2,40,65,28,40,11,25,5,7,10,39,65
2005-03-07 00:00:00.000,ATP Masters Series Indian Wells California; USA ATP World Tour,HARD,2,Roger Federer,N/A Bye,Roger Federer,,R128,0,0,0,0,0,0,0,0,0,0,0,0,0,0,0,0,0,0,0,0,0,0,0,0,0,0,0
2005-03-07 00:00:00.000,ATP Masters Series Indian Wells California; USA ATP World Tour,HARD,2,Mardy Fish,Jan-Michael Gambill,Mardy Fish,6-2; 6-2,R128,62,8,0,27,46,23,27,12,19,3,3,8,35,46,7,3,25,50,16,25,9,25,3,7,8,25,50
2005-03-07 00:00:00.000,ATP Masters Series Indian Wells California; USA ATP World Tour,HARD,2,Gilles Muller,Jean-Rene Lisnard,Gilles Muller,6-4; 7-5,R128,87,14,4,38,71,30,38,17,33,3,4,11,47,71,5,8,23,60,19,23,18,37,0,3,11,37,60
2005-03-07 00:00:00.000,ATP Masters Series Indian Wells California; USA ATP World Tour,HARD,2,Radek Stepanek,N/A Bye,Radek Stepanek,,R128,0,0,0,0,0,0,0,0,0,0,0,0,0,0,0,0,0,0,0,0,0,0,0,0,0,0,0
2005-03-07 00:00:00.000,ATP Masters Series Indian Wells California; USA ATP World Tour,HARD,2,Mario Ancic,N/A Bye,Mario Ancic,,R128,0,0,0,0,0,0,0,0,0,0,0,0,0,0,0,0,0,0,0,0,0,0,0,0,0,0,0
2005-03-07 00:00:00.000,ATP Masters Series Indian Wells California; USA ATP World Tour,HARD,2,Tomas Berdych,Hicham Arazi,Tomas Berdych,6-1; 6-1,R128,46,6,0,26,37,22,26,7,11,0,0,7,29,37,1,2,25,49,14,25,8,24,2,7,7,22,49
2005-03-07 00:00:00.000,ATP Masters Series Indian Wells California; USA ATP World Tour,HARD,2,Tomas Zib,Filippo Volandri,Tomas Zib,6-1; 6-4,R128,66,4,0,33,58,26,33,15,25,2,2,9,41,58,4,5,28,51,20,28,8,23,2,5,8,28,51
2005-03-07 00:00:00.000,ATP Masters Series Indian Wells California; USA ATP World Tour,HARD,2,Ivan Ljubicic,N/A Bye,Ivan Ljubicic,,R128,0,0,0,0,0,0,0,0,0,0,0,0,0,0,0,0,0,0,0,0,0,0,0,0,0,0,0
2005-03-07 00:00:00.000,ATP Masters Series Indian Wells California; USA ATP World Tour,HARD,2,David Nalbandian,N/A Bye,David Nalbandian,,R128,0,0,0,0,0,0,0,0,0,0,0,0,0,0,0,0,0,0,0,0,0,0,0,0,0,0,0
2005-03-07 00:00:00.000,ATP Masters Series Indian Wells California; USA ATP World Tour,HARD,2,Juan Monaco,Antony Dupuis,Juan Monaco,6-2; 6-2,R128,67,3,3,27,52,22,27,14,25,2,2,8,36,52,2,2,20,49,13,20,12,29,6,10,8,25,49
2005-03-07 00:00:00.000,ATP Masters Series Indian Wells California; USA ATP World Tour,HARD,2,Jonas Bjorkman,Irakli Labadze,Jonas Bjorkman,6-1; 7-6(4),R128,84,2,6,31,61,23,31,20,30,1,3,10,43,61,6,6,35,64,23,35,10,29,3,7,9,33,64
2005-03-07 00:00:00.000,ATP Masters Series Indian Wells California; USA ATP World Tour,HARD,2,Thomas Johansson,N/A Bye,Thomas Johansson,,R128,0,0,0,0,0,0,0,0,0,0,0,0,0,0,0,0,0,0,0,0,0,0,0,0,0,0,0
2005-03-07 00:00:00.000,ATP Masters Series Indian Wells California; USA ATP World Tour,HARD,2,Nicolas Kiefer,N/A Bye,Nicolas Kiefer,,R128,0,0,0,0,0,0,0,0,0,0,0,0,0,0,0,0,0,0,0,0,0,0,0,0,0,0,0
2005-03-07 00:00:00.000,ATP Masters Series Indian Wells California; USA ATP World Tour,HARD,2,Sargis Sargsian,Bobby Reynolds,Sargis Sargsian,6-3; 6-2,R128,73,0,5,45,66,32,45,9,21,3,4,9,41,66,5,5,32,53,21,32,8,21,2,6,8,29,53
2005-03-07 00:00:00.000,ATP Masters Series Indian Wells California; USA ATP World Tour,HARD,2,Max Mirnyi,Xavier Malisse,Max Mirnyi,6-3; 4-6; 7-6(4),R128,118,10,5,47,80,45,47,17,33,0,2,16,62,80,7,4,58,98,40,58,23,40,6,8,15,63,98
2005-03-07 00:00:00.000,ATP Masters Series Indian Wells California; USA ATP World Tour,HARD,2,Gaston Gaudio,N/A Bye,Gaston Gaudio,,R128,0,0,0,0,0,0,0,0,0,0,0,0,0,0,0,0,0,0,0,0,0,0,0,0,0,0,0
2005-03-07 00:00:00.000,ATP Masters Series Indian Wells California; USA ATP World Tour,HARD,2,Marat Safin,N/A Bye,Marat Safin,,R128,0,0,0,0,0,0,0,0,0,0,0,0,0,0,0,0,0,0,0,0,0,0,0,0,0,0,0
2005-03-07 00:00:00.000,ATP Masters Series Indian Wells California; USA ATP World Tour,HARD,2,Jarkko Nieminen,Luis Horna,Jarkko Nieminen,6-0; 7-6(1),R128,75,4,1,38,53,28,38,9,15,2,4,9,37,53,3,4,39,67,21,39,9,28,3,8,9,30,67
2005-03-07 00:00:00.000,ATP Masters Series Indian Wells California; USA ATP World Tour,HARD,2,Cyril Saulnier,Victor Hanescu,Cyril Saulnier,6-2; 6-2,R128,62,8,1,27,47,24,27,9,20,3,4,8,33,47,5,2,36,56,21,36,5,20,2,7,8,26,56
2005-03-07 00:00:00.000,ATP Masters Series Indian Wells California; USA ATP World Tour,HARD,2,Taylor Dent,N/A Bye,Taylor Dent,,R128,0,0,0,0,0,0,0,0,0,0,0,0,0,0,0,0,0,0,0,0,0,0,0,0,0,0,0
2005-03-07 00:00:00.000,ATP Masters Series Indian Wells California; USA ATP World Tour,HARD,2,Juan Ignacio Chela,N/A Bye,Juan Ignacio Chela,,R128,0,0,0,0,0,0,0,0,0,0,0,0,0,0,0,0,0,0,0,0,0,0,0,0,0,0,0
2005-03-07 00:00:00.000,ATP Masters Series Indian Wells California; USA ATP World Tour,HARD,2,Rainer Schuettler,Alex Kuznetsov,Rainer Schuettler,6-4; 6-3,R128,74,5,2,35,64,25,35,15,29,8,10,10,40,64,5,3,29,51,21,29,8,22,2,6,9,29,51
2005-03-07 00:00:00.000,ATP Masters Series Indian Wells California; USA ATP World Tour,HARD,2,Kenneth Carlsen,Florian Mayer,Kenneth Carlsen,7-5; 6-3,R128,91,5,2,41,76,31,41,15,35,7,10,11,46,76,3,3,40,63,23,40,8,23,3,8,10,31,63
2005-03-07 00:00:00.000,ATP Masters Series Indian Wells California; USA ATP World Tour,HARD,2,Guillermo Canas,N/A Bye,Guillermo Canas,,R128,0,0,0,0,0,0,0,0,0,0,0,0,0,0,0,0,0,0,0,0,0,0,0,0,0,0,0
2005-03-07 00:00:00.000,ATP Masters Series Indian Wells California; USA ATP World Tour,HARD,2,Tommy Robredo,N/A Bye,Tommy Robredo,,R128,0,0,0,0,0,0,0,0,0,0,0,0,0,0,0,0,0,0,0,0,0,0,0,0,0,0,0
2005-03-07 00:00:00.000,ATP Masters Series Indian Wells California; USA ATP World Tour,HARD,2,Gael Monfils,Jeff Morrison,Gael Monfils,7-5; 6-4,R128,96,3,7,38,82,25,38,21,44,6,9,11,46,82,2,3,42,73,24,42,15,31,7,12,11,39,73
2005-03-07 00:00:00.000,ATP Masters Series Indian Wells California; USA ATP World Tour,HARD,2,Thomas Enqvist,Karol Beck,Thomas Enqvist,6-0; 7-5,R128,75,9,2,33,61,22,33,19,28,7,8,9,41,61,5,4,32,59,20,32,9,27,4,9,9,29,59
2005-03-07 00:00:00.000,ATP Masters Series Indian Wells California; USA ATP World Tour,HARD,2,Mikhail Youzhny,N/A Bye,Mikhail Youzhny,,R128,0,0,0,0,0,0,0,0,0,0,0,0,0,0,0,0,0,0,0,0,0,0,0,0,0,0,0
2005-03-07 00:00:00.000,ATP Masters Series Indian Wells California; USA ATP World Tour,HARD,2,Jurgen Melzer,N/A Bye,Jurgen Melzer,,R128,0,0,0,0,0,0,0,0,0,0,0,0,0,0,0,0,0,0,0,0,0,0,0,0,0,0,0
2005-03-07 00:00:00.000,ATP Masters Series Indian Wells California; USA ATP World Tour,HARD,2,Paul Goldstein,Hyung-Taik Lee,Paul Goldstein,6-1; 7-6(1),R128,88,5,4,46,71,32,46,11,25,6,9,10,43,71,2,3,42,68,22,42,11,26,2,7,9,33,68
2005-03-07 00:00:00.000,ATP Masters Series Indian Wells California; USA ATP World Tour,HARD,2,Arnaud Clement,Donald Young,Arnaud Clement,6-3; 6-2,R128,62,3,0,38,52,32,38,6,14,2,2,9,38,52,3,1,33,46,20,33,6,13,3,6,8,26,46
2005-03-07 00:00:00.000,ATP Masters Series Indian Wells California; USA ATP World Tour,HARD,2,Tim Henman,N/A Bye,Tim Henman,,R128,0,0,0,0,0,0,0,0,0,0,0,0,0,0,0,0,0,0,0,0,0,0,0,0,0,0,0
2005-03-07 00:00:00.000,ATP Masters Series Indian Wells California; USA ATP World Tour,HARD,2,Carlos Moya,N/A Bye,Carlos Moya,,R128,0,0,0,0,0,0,0,0,0,0,0,0,0,0,0,0,0,0,0,0,0,0,0,0,0,0,0
2005-03-07 00:00:00.000,ATP Masters Series Indian Wells California; USA ATP World Tour,HARD,2,Juan Carlos Ferrero,Igor Andreev,Juan Carlos Ferrero,6-3; 6-3,R128,71,2,3,32,51,28,32,10,19,0,0,9,38,51,3,3,34,52,22,34,10,18,2,5,9,32,52
2005-03-07 00:00:00.000,ATP Masters Series Indian Wells California; USA ATP World Tour,HARD,2,David Ferrer,Brian Vahaly,David Ferrer,6-4; 6-3,R128,72,3,0,27,46,20,27,12,19,0,2,9,32,46,1,2,54,68,30,54,5,14,5,10,10,35,68
2005-03-07 00:00:00.000,ATP Masters Series Indian Wells California; USA ATP World Tour,HARD,2,Sebastien Grosjean,N/A Bye,Sebastien Grosjean,,R128,0,0,0,0,0,0,0,0,0,0,0,0,0,0,0,0,0,0,0,0,0,0,0,0,0,0,0
2005-03-07 00:00:00.000,ATP Masters Series Indian Wells California; USA ATP World Tour,HARD,2,Feliciano Lopez,N/A Bye,Feliciano Lopez,,R128,0,0,0,0,0,0,0,0,0,0,0,0,0,0,0,0,0,0,0,0,0,0,0,0,0,0,0
2005-03-07 00:00:00.000,ATP Masters Series Indian Wells California; USA ATP World Tour,HARD,2,Ivo Karlovic,Julien Benneteau,Ivo Karlovic,7-6(2); 6-4,R128,84,12,1,37,60,34,37,15,23,0,0,11,49,60,3,1,44,69,32,44,14,25,4,5,11,46,69
2005-03-07 00:00:00.000,ATP Masters Series Indian Wells California; USA ATP World Tour,HARD,2,Fabrice Santoro,Ricardo Mello,Fabrice Santoro,6-2; 6-3,R128,75,3,0,31,61,23,31,15,30,4,6,9,38,61,0,4,34,54,19,34,7,20,6,11,8,26,54
2005-03-07 00:00:00.000,ATP Masters Series Indian Wells California; USA ATP World Tour,HARD,2,Joachim Johansson,N/A Bye,Joachim Johansson,,R128,0,0,0,0,0,0,0,0,0,0,0,0,0,0,0,0,0,0,0,0,0,0,0,0,0,0,0
2005-03-07 00:00:00.000,ATP Masters Series Indian Wells California; USA ATP World Tour,HARD,2,Nikolay Davydenko,N/A Bye,Nikolay Davydenko,,R128,0,0,0,0,0,0,0,0,0,0,0,0,0,0,0,0,0,0,0,0,0,0,0,0,0,0,0
2005-03-07 00:00:00.000,ATP Masters Series Indian Wells California; USA ATP World Tour,HARD,2,James Blake,Alberto Martin,James Blake,6-2; 6-3,R128,60,2,0,32,45,26,32,10,13,0,0,9,36,45,1,3,30,60,19,30,13,30,6,9,8,32,60
2005-03-07 00:00:00.000,ATP Masters Series Indian Wells California; USA ATP World Tour,HARD,2,Greg Rusedski,Jeff Salzenstein,Greg Rusedski,3-6; 7-5; 6-3,R128,128,10,4,56,97,43,56,20,41,6,8,15,63,97,12,6,58,104,44,58,21,46,10,13,15,65,104
2005-03-07 00:00:00.000,ATP Masters Series Indian Wells California; USA ATP World Tour,HARD,2,Fernando Gonzalez,N/A Bye,Fernando Gonzalez,,R128,0,0,0,0,0,0,0,0,0,0,0,0,0,0,0,0,0,0,0,0,0,0,0,0,0,0,0
2005-03-07 00:00:00.000,ATP Masters Series Indian Wells California; USA ATP World Tour,HARD,2,Jiri Novak,N/A Bye,Jiri Novak,,R128,0,0,0,0,0,0,0,0,0,0,0,0,0,0,0,0,0,0,0,0,0,0,0,0,0,0,0
2005-03-07 00:00:00.000,ATP Masters Series Indian Wells California; USA ATP World Tour,HARD,2,Olivier Rochus,Mariano Zabaleta,Olivier Rochus,7-5; 6-4,R128,103,1,5,42,82,31,42,23,40,9,9,11,54,82,4,6,30,64,23,30,20,34,3,5,11,43,64
2005-03-07 00:00:00.000,ATP Masters Series Indian Wells California; USA ATP World Tour,HARD,2,Fernando Verdasco,Wayne Odesnik,Fernando Verdasco,7-6(0); 6-4,R128,77,5,5,41,69,32,41,17,28,5,6,11,49,69,5,3,41,66,26,41,16,25,3,5,11,42,66
2005-03-07 00:00:00.000,ATP Masters Series Indian Wells California; USA ATP World Tour,HARD,2,Andy Roddick,N/A Bye,Andy Roddick,,R128,0,0,0,0,0,0,0,0,0,0,0,0,0,0,0,0,0,0,0,0,0,0,0,0,0,0,0
2005-03-07 00:00:00.000,ATP Masters Series Indian Wells California; USA ATP World Tour,HARD,2,Guillermo Coria,N/A Bye,Guillermo Coria,,R128,0,0,0,0,0,0,0,0,0,0,0,0,0,0,0,0,0,0,0,0,0,0,0,0,0,0,0
2005-03-07 00:00:00.000,ATP Masters Series Indian Wells California; USA ATP World Tour,HARD,2,Kevin Kim,Giovanni Lapentti,Kevin Kim,7-5; 6-1,R128,77,7,8,33,60,28,33,13,27,2,3,9,41,60,0,3,45,61,22,45,10,16,1,6,10,32,61
2005-03-07 00:00:00.000,ATP Masters Series Indian Wells California; USA ATP World Tour,HARD,2,Agustin Calleri,Dmitry Tursunov,Agustin Calleri,6-2; 3-6; 6-3,R128,114,8,3,48,77,32,48,19,29,1,3,13,51,77,2,10,45,98,35,45,21,53,8,12,13,56,98
2005-03-07 00:00:00.000,ATP Masters Series Indian Wells California; USA ATP World Tour,HARD,2,Paradorn Srichaphan,N/A Bye,Paradorn Srichaphan,,R128,0,0,0,0,0,0,0,0,0,0,0,0,0,0,0,0,0,0,0,0,0,0,0,0,0,0,0
2005-03-07 00:00:00.000,ATP Masters Series Indian Wells California; USA ATP World Tour,HARD,2,Andrei Pavel,N/A Bye,Andrei Pavel,,R128,0,0,0,0,0,0,0,0,0,0,0,0,0,0,0,0,0,0,0,0,0,0,0,0,0,0,0
2005-03-07 00:00:00.000,ATP Masters Series Indian Wells California; USA ATP World Tour,HARD,2,Gregory Carraz,Mark Philippoussis,Gregory Carraz,7-6(7); 6-1,R128,89,12,1,33,62,29,33,20,29,2,2,10,49,62,14,4,41,73,32,41,11,32,6,8,9,43,73
2005-03-07 00:00:00.000,ATP Masters Series Indian Wells California; USA ATP World Tour,HARD,2,Wayne Arthurs,Potito Starace,Wayne Arthurs,6-4; 6-3,R128,67,18,4,33,50,30,33,10,17,0,0,10,40,50,6,4,48,70,33,48,9,22,3,5,9,42,70
2005-03-07 00:00:00.000,ATP Masters Series Indian Wells California; USA ATP World Tour,HARD,2,Andre Agassi,N/A Bye,Andre Agassi,,R128,0,0,0,0,0,0,0,0,0,0,0,0,0,0,0,0,0,0,0,0,0,0,0,0,0,0,0
2005-03-07 00:00:00.000,ATP Masters Series Indian Wells California; USA ATP World Tour,HARD,2,Tommy Haas,N/A Bye,Tommy Haas,,R128,0,0,0,0,0,0,0,0,0,0,0,0,0,0,0,0,0,0,0,0,0,0,0,0,0,0,0
2005-03-07 00:00:00.000,ATP Masters Series Indian Wells California; USA ATP World Tour,HARD,2,Paul-Henri Mathieu,Alex Calatrava,Paul-Henri Mathieu,6-3; 3-6; 6-1,R128,101,6,0,36,70,28,36,24,34,2,3,13,52,70,10,1,45,66,33,45,10,21,3,6,12,43,66
2005-03-07 00:00:00.000,ATP Masters Series Indian Wells California; USA ATP World Tour,HARD,2,Jan Hernych,Ramon Delgado,Jan Hernych,6-2; 6-4,R128,84,3,2,45,79,27,45,18,34,11,13,9,45,79,2,1,33,55,18,33,10,22,2,7,9,28,55
2005-03-07 00:00:00.000,ATP Masters Series Indian Wells California; USA ATP World Tour,HARD,2,Vincent Spadea,N/A Bye,Vincent Spadea,,R128,0,0,0,0,0,0,0,0,0,0,0,0,0,0,0,0,0,0,0,0,0,0,0,0,0,0,0
2005-03-07 00:00:00.000,ATP Masters Series Indian Wells California; USA ATP World Tour,HARD,2,Dominik Hrbaty,N/A Bye,Dominik Hrbaty,,R128,0,0,0,0,0,0,0,0,0,0,0,0,0,0,0,0,0,0,0,0,0,0,0,0,0,0,0
2005-03-07 00:00:00.000,ATP Masters Series Indian Wells California; USA ATP World Tour,HARD,2,Michael Llodra,Davide Sanguinetti,Michael Llodra,6-3; 6-2,R128,49,1,2,35,46,30,35,7,11,0,0,9,37,46,2,0,19,42,14,19,10,23,1,4,8,24,42
2005-03-07 00:00:00.000,ATP Masters Series Indian Wells California; USA ATP World Tour,HARD,2,Robby Ginepri,Jose Acasuso,Robby Ginepri,7-5; 7-6(5),R128,89,8,1,46,79,35,46,20,33,2,2,12,55,79,4,6,37,70,27,37,23,33,4,5,12,50,70
2005-03-07 00:00:00.000,ATP Masters Series Indian Wells California; USA ATP World Tour,HARD,2,Lleyton Hewitt,N/A Bye,Lleyton Hewitt,,R128,0,0,0,0,0,0,0,0,0,0,0,0,0,0,0,0,0,0,0,0,0,0,0,0,0,0,0
2005-03-07 00:00:00.000,ATP Masters Series Indian Wells California; USA ATP World Tour,HARD,2,Roger Federer,Mardy Fish,Roger Federer,6-3; 6-3,R64,74,1,0,31,50,20,31,15,19,1,2,9,35,50,1,5,23,56,16,23,13,33,1,5,9,29,56
2005-03-07 00:00:00.000,ATP Masters Series Indian Wells California; USA ATP World Tour,HARD,2,Gilles Muller,Radek Stepanek,Gilles Muller,6-3; 3-6; 6-0,R64,107,7,1,45,62,37,45,9,17,2,3,12,46,62,6,6,46,79,30,46,16,33,5,9,12,46,79
2005-03-07 00:00:00.000,ATP Masters Series Indian Wells California; USA ATP World Tour,HARD,2,Tomas Berdych,Mario Ancic,Tomas Berdych,7-5; 3-6; 6-2,R64,120,5,6,53,96,42,53,18,43,5,8,15,60,96,9,2,47,76,36,47,12,29,2,6,14,48,76
2005-03-07 00:00:00.000,ATP Masters Series Indian Wells California; USA ATP World Tour,HARD,2,Ivan Ljubicic,Tomas Zib,Ivan Ljubicic,6-3; 6-2,R64,67,15,0,30,44,26,30,11,14,2,2,9,37,44,2,1,34,54,21,34,7,20,2,5,8,28,54
2005-03-07 00:00:00.000,ATP Masters Series Indian Wells California; USA ATP World Tour,HARD,2,David Nalbandian,Juan Monaco,David Nalbandian,6-2; 6-1,R64,49,4,1,23,38,19,23,13,15,0,0,8,32,38,0,3,16,36,8,16,8,20,0,4,7,16,36
2005-03-07 00:00:00.000,ATP Masters Series Indian Wells California; USA ATP World Tour,HARD,2,Jonas Bjorkman,Thomas Johansson,Jonas Bjorkman,4-6; 6-3; 7-6(0),R64,145,1,7,67,113,42,67,28,46,5,8,16,70,113,7,2,47,96,35,47,23,49,6,9,15,58,96
2005-03-07 00:00:00.000,ATP Masters Series Indian Wells California; USA ATP World Tour,HARD,2,Nicolas Kiefer,Sargis Sargsian,Nicolas Kiefer,6-0; 6-0,R64,48,2,1,16,31,12,16,12,15,0,0,6,24,31,1,8,20,42,9,20,5,22,3,9,6,14,42
2005-03-07 00:00:00.000,ATP Masters Series Indian Wells California; USA ATP World Tour,HARD,2,Gaston Gaudio,Max Mirnyi,Gaston Gaudio,6-7(5); 6-3; 7-6(4),R64,152,4,4,69,125,54,69,31,56,7,8,17,85,125,14,4,71,110,49,71,23,39,3,5,16,72,110
2005-03-07 00:00:00.000,ATP Masters Series Indian Wells California; USA ATP World Tour,HARD,2,Marat Safin,Jarkko Nieminen,Marat Safin,4-6; 6-1; 7-5,R64,124,8,2,52,98,41,52,25,46,4,5,15,66,98,0,5,51,85,39,51,13,34,5,8,14,52,85
2005-03-07 00:00:00.000,ATP Masters Series Indian Wells California; USA ATP World Tour,HARD,2,Taylor Dent,Cyril Saulnier,Taylor Dent,1-6; 7-6(1); 6-2,R64,115,15,4,44,80,36,44,21,36,3,5,13,57,80,2,2,50,100,34,50,27,50,0,2,14,61,100
2005-03-07 00:00:00.000,ATP Masters Series Indian Wells California; USA ATP World Tour,HARD,2,Juan Ignacio Chela,Rainer Schuettler,Juan Ignacio Chela,6-7(4); 6-4; 6-1,R64,132,2,7,64,109,36,64,23,45,10,15,15,59,109,3,4,40,82,18,40,20,42,3,11,14,38,82
2005-03-07 00:00:00.000,ATP Masters Series Indian Wells California; USA ATP World Tour,HARD,2,Guillermo Canas,Kenneth Carlsen,Guillermo Canas,6-4; 6-3,R64,69,2,4,35,52,28,35,7,17,1,2,9,35,52,3,5,31,54,21,31,9,23,1,5,10,30,54
2005-03-07 00:00:00.000,ATP Masters Series Indian Wells California; USA ATP World Tour,HARD,2,Tommy Robredo,Gael Monfils,Tommy Robredo,6-3; 6-1,R64,72,4,4,37,52,28,37,8,15,4,4,8,36,52,5,3,31,67,19,31,16,36,5,9,8,35,67
2005-03-07 00:00:00.000,ATP Masters Series Indian Wells California; USA ATP World Tour,HARD,2,Thomas Enqvist,Mikhail Youzhny,Thomas Enqvist,6-4; 6-1,R64,80,4,5,36,72,28,36,19,36,8,8,9,47,72,1,1,28,52,20,28,9,24,4,7,8,29,52
2005-03-07 00:00:00.000,ATP Masters Series Indian Wells California; USA ATP World Tour,HARD,2,Jurgen Melzer,Paul Goldstein,Jurgen Melzer,7-6(3); 3-6; 6-3,R64,115,13,3,64,99,47,64,19,35,7,10,15,66,99,8,7,50,101,34,50,27,51,6,9,15,61,101
2005-03-07 00:00:00.000,ATP Masters Series Indian Wells California; USA ATP World Tour,HARD,2,Tim Henman,Arnaud Clement,Tim Henman,4-6; 6-4; 6-3,R64,133,6,3,54,90,43,54,17,36,4,7,15,60,90,3,5,38,84,25,38,27,46,5,9,14,52,84
2005-03-07 00:00:00.000,ATP Masters Series Indian Wells California; USA ATP World Tour,HARD,2,Carlos Moya,Juan Carlos Ferrero,Carlos Moya,6-3; 6-4,R64,93,4,3,42,64,32,42,10,22,5,6,10,42,64,2,0,42,72,26,42,13,30,7,10,9,39,72
2005-03-07 00:00:00.000,ATP Masters Series Indian Wells California; USA ATP World Tour,HARD,2,David Ferrer,Sebastien Grosjean,David Ferrer,6-2; 3-6; 6-1,R64,115,0,4,60,87,39,60,14,27,3,5,12,53,87,1,0,38,77,25,38,16,39,4,9,12,41,77
2005-03-07 00:00:00.000,ATP Masters Series Indian Wells California; USA ATP World Tour,HARD,2,Feliciano Lopez,Ivo Karlovic,Feliciano Lopez,6-7(4); 6-4; 6-4,R64,122,11,5,52,93,41,52,28,41,5,6,16,69,93,18,5,62,104,47,62,22,42,4,7,16,69,104
2005-03-07 00:00:00.000,ATP Masters Series Indian Wells California; USA ATP World Tour,HARD,2,Fabrice Santoro,Joachim Johansson,Fabrice Santoro,4-6; 6-2; 7-6(6),R64,135,3,2,69,98,46,69,17,29,4,7,15,63,98,9,6,64,116,44,64,26,52,8,12,15,70,116
2005-03-07 00:00:00.000,ATP Masters Series Indian Wells California; USA ATP World Tour,HARD,2,James Blake,Nikolay Davydenko,James Blake,6-3; 7-6(6),R64,82,8,1,44,71,31,44,15,27,2,3,11,46,71,2,5,45,66,29,45,11,21,4,6,10,40,66
2005-03-07 00:00:00.000,ATP Masters Series Indian Wells California; USA ATP World Tour,HARD,2,Fernando Gonzalez,Greg Rusedski,Fernando Gonzalez,7-6(4); 7-6(5),R64,93,3,2,49,76,38,49,20,27,0,0,12,58,76,7,4,53,84,44,53,17,31,5,5,12,61,84
2005-03-07 00:00:00.000,ATP Masters Series Indian Wells California; USA ATP World Tour,HARD,2,Jiri Novak,Olivier Rochus,Jiri Novak,6-3; 6-4,R64,74,6,1,29,48,22,29,15,19,0,1,10,37,48,1,2,36,69,25,36,13,33,10,13,9,38,69
2005-03-07 00:00:00.000,ATP Masters Series Indian Wells California; USA ATP World Tour,HARD,2,Andy Roddick,Fernando Verdasco,Andy Roddick,6-3; 3-6; 7-6(2),R64,121,16,3,61,108,49,61,23,47,7,9,15,72,108,6,3,49,87,36,49,22,38,3,5,15,58,87
2005-03-07 00:00:00.000,ATP Masters Series Indian Wells California; USA ATP World Tour,HARD,2,Guillermo Coria,Kevin Kim,Guillermo Coria,7-6(2); 7-6(3),R64,112,5,3,46,70,35,46,12,24,2,6,12,47,70,3,3,51,97,35,51,17,46,7,11,12,52,97
2005-03-07 00:00:00.000,ATP Masters Series Indian Wells California; USA ATP World Tour,HARD,2,Paradorn Srichaphan,Agustin Calleri,Paradorn Srichaphan,7-5; 6-4,R64,83,6,4,40,66,31,40,14,26,1,2,11,45,66,9,6,45,77,30,45,14,32,6,9,11,44,77
2005-03-07 00:00:00.000,ATP Masters Series Indian Wells California; USA ATP World Tour,HARD,2,Andrei Pavel,Gregory Carraz,Andrei Pavel,6-7(5); 7-6(6); 6-2,R64,164,13,1,70,109,47,70,24,39,3,5,16,71,109,12,5,84,138,58,84,21,54,15,19,16,79,138
2005-03-07 00:00:00.000,ATP Masters Series Indian Wells California; USA ATP World Tour,HARD,2,Andre Agassi,Wayne Arthurs,Andre Agassi,6-4; 6-1,R64,61,4,0,25,39,20,25,13,14,3,3,8,33,39,9,9,22,61,14,22,16,39,2,6,9,30,61
2005-03-07 00:00:00.000,ATP Masters Series Indian Wells California; USA ATP World Tour,HARD,2,Paul-Henri Mathieu,Tommy Haas,Paul-Henri Mathieu,7-6(3); 6-3,R64,102,4,2,27,57,21,27,19,30,1,2,10,40,57,8,4,49,92,33,49,17,43,8,11,11,50,92
2005-03-07 00:00:00.000,ATP Masters Series Indian Wells California; USA ATP World Tour,HARD,2,Jan Hernych,Vincent Spadea,Jan Hernych,6-2; 1-6; 7-6(6),R64,110,2,3,53,84,33,53,18,31,7,12,13,51,84,4,12,47,92,34,47,16,45,7,12,14,50,92
2005-03-07 00:00:00.000,ATP Masters Series Indian Wells California; USA ATP World Tour,HARD,2,Michael Llodra,Dominik Hrbaty,Michael Llodra,4-6; 6-1; 6-2,R64,91,3,1,58,88,39,58,18,30,5,6,13,57,88,4,6,59,86,35,59,13,27,5,9,12,48,86
2005-03-07 00:00:00.000,ATP Masters Series Indian Wells California; USA ATP World Tour,HARD,2,Lleyton Hewitt,Robby Ginepri,Lleyton Hewitt,6-2; 7-6(2),R64,87,7,3,40,79,30,40,21,39,7,9,10,51,79,2,0,49,70,29,49,7,21,2,6,10,36,70
2005-03-07 00:00:00.000,ATP Masters Series Indian Wells California; USA ATP World Tour,HARD,2,Roger Federer,Gilles Muller,Roger Federer,6-3; 6-2,R32,83,7,1,35,61,27,35,13,26,2,3,9,40,61,3,6,53,80,36,53,4,27,12,16,8,40,80
2005-03-07 00:00:00.000,ATP Masters Series Indian Wells California; USA ATP World Tour,HARD,2,Ivan Ljubicic,Tomas Berdych,Ivan Ljubicic,6-4; 6-1,R32,63,9,0,28,43,25,28,9,15,0,1,9,34,43,2,3,20,47,11,20,12,27,3,7,8,23,47
2005-03-07 00:00:00.000,ATP Masters Series Indian Wells California; USA ATP World Tour,HARD,2,David Nalbandian,Jonas Bjorkman,David Nalbandian,6-1; 3-6; 6-1,R32,101,0,2,41,65,23,41,10,24,4,9,11,33,65,0,2,42,69,18,42,9,27,3,12,12,27,69
2005-03-07 00:00:00.000,ATP Masters Series Indian Wells California; USA ATP World Tour,HARD,2,Nicolas Kiefer,Gaston Gaudio,Nicolas Kiefer,6-3; 6-1,R32,69,0,4,34,54,27,34,10,20,5,5,8,37,54,2,2,32,51,17,32,8,19,2,6,8,25,51
2005-03-07 00:00:00.000,ATP Masters Series Indian Wells California; USA ATP World Tour,HARD,2,Taylor Dent,Marat Safin,Taylor Dent,7-5; 6-4,R32,88,5,6,25,58,24,25,19,33,4,5,11,43,58,3,4,35,70,20,35,19,35,8,11,11,39,70
2005-03-07 00:00:00.000,ATP Masters Series Indian Wells California; USA ATP World Tour,HARD,2,Guillermo Canas,Juan Ignacio Chela,Guillermo Canas,7-5; 2-6; 6-4,R32,162,3,2,58,109,38,58,24,51,12,17,15,62,109,3,1,52,81,36,52,12,29,2,7,15,48,81
2005-03-07 00:00:00.000,ATP Masters Series Indian Wells California; USA ATP World Tour,HARD,2,Tommy Robredo,Thomas Enqvist,Tommy Robredo,4-6; 6-2; 7-6(4),R32,131,10,3,59,90,45,59,16,31,3,6,15,61,90,3,5,47,104,31,47,28,57,10,14,15,59,104
2005-03-07 00:00:00.000,ATP Masters Series Indian Wells California; USA ATP World Tour,HARD,2,Tim Henman,Jurgen Melzer,Tim Henman,7-5; 6-4,R32,83,1,3,49,58,33,49,5,9,3,6,11,38,58,3,1,49,71,30,49,8,22,4,9,11,38,71
2005-03-07 00:00:00.000,ATP Masters Series Indian Wells California; USA ATP World Tour,HARD,2,Carlos Moya,David Ferrer,Carlos Moya,6-3; 6-4,R32,63,5,0,31,49,28,31,12,18,0,0,10,40,49,1,0,32,47,22,32,9,15,0,2,9,31,47
2005-03-07 00:00:00.000,ATP Masters Series Indian Wells California; USA ATP World Tour,HARD,2,Fabrice Santoro,Feliciano Lopez,Fabrice Santoro,6-4; 6-2,R32,73,0,2,23,47,17,23,12,24,1,4,9,29,47,2,5,34,64,17,34,12,30,5,11,9,29,64
2005-03-07 00:00:00.000,ATP Masters Series Indian Wells California; USA ATP World Tour,HARD,2,Fernando Gonzalez,James Blake,Fernando Gonzalez,6-4; 0-6; 6-3,R32,124,6,14,51,111,30,51,28,60,12,17,13,58,111,1,4,45,80,29,45,16,35,6,10,12,45,80
2005-03-07 00:00:00.000,ATP Masters Series Indian Wells California; USA ATP World Tour,HARD,2,Andy Roddick,Jiri Novak,Andy Roddick,6-1; 6-2,R32,46,9,3,24,44,21,24,12,20,0,0,8,33,44,1,3,26,43,16,26,5,17,2,6,7,21,43
2005-03-07 00:00:00.000,ATP Masters Series Indian Wells California; USA ATP World Tour,HARD,2,Guillermo Coria,Paradorn Srichaphan,Guillermo Coria,6-4; 6-2,R32,86,4,2,35,60,24,35,12,25,3,5,9,36,60,5,2,41,64,25,41,7,23,2,7,9,32,64
2005-03-07 00:00:00.000,ATP Masters Series Indian Wells California; USA ATP World Tour,HARD,2,Andre Agassi,Andrei Pavel,Andre Agassi,6-3; 6-4,R32,72,7,3,35,61,30,35,16,26,5,5,10,46,61,3,3,33,55,24,33,11,22,3,5,9,35,55
2005-03-07 00:00:00.000,ATP Masters Series Indian Wells California; USA ATP World Tour,HARD,2,Paul-Henri Mathieu,Jan Hernych,Paul-Henri Mathieu,6-4; 4-6; 7-6(6),R32,163,5,4,47,109,39,47,25,62,1,6,16,64,109,6,2,68,105,44,68,20,37,6,11,16,64,105
2005-03-07 00:00:00.000,ATP Masters Series Indian Wells California; USA ATP World Tour,HARD,2,Lleyton Hewitt,Michael Llodra,Lleyton Hewitt,6-2; 7-6(3),R32,89,7,5,30,64,24,30,24,34,1,1,10,48,64,7,3,43,77,30,43,15,34,5,7,10,45,77
2005-03-07 00:00:00.000,ATP Masters Series Indian Wells California; USA ATP World Tour,HARD,2,Roger Federer,Ivan Ljubicic,Roger Federer,7-6(3); 7-6(4),R16,107,7,1,47,67,42,47,14,20,0,0,12,56,67,9,1,48,82,34,48,21,34,1,1,12,55,82
2005-03-07 00:00:00.000,ATP Masters Series Indian Wells California; USA ATP World Tour,HARD,2,Nicolas Kiefer,David Nalbandian,Nicolas Kiefer,6-1; 6-3,R16,78,3,2,24,47,20,24,14,23,3,4,8,34,47,2,2,38,59,21,38,7,21,6,11,8,28,59
2005-03-07 00:00:00.000,ATP Masters Series Indian Wells California; USA ATP World Tour,HARD,2,Guillermo Canas,Taylor Dent,Guillermo Canas,6-3 RET,R16,29,0,0,19,22,15,19,2,3,2,2,4,17,22,1,2,21,30,13,21,3,9,1,3,5,16,30
2005-03-07 00:00:00.000,ATP Masters Series Indian Wells California; USA ATP World Tour,HARD,2,Tim Henman,Tommy Robredo,Tim Henman,6-4; 2-6; 6-2,R16,110,3,5,43,73,34,43,14,30,4,7,13,48,73,2,2,57,81,37,57,11,24,2,6,13,48,81
2005-03-07 00:00:00.000,ATP Masters Series Indian Wells California; USA ATP World Tour,HARD,2,Carlos Moya,Fabrice Santoro,Carlos Moya,7-5; 6-2,R16,89,2,2,48,76,31,48,14,28,10,12,10,45,76,1,0,35,55,18,35,11,20,6,11,10,29,55
2005-03-07 00:00:00.000,ATP Masters Series Indian Wells California; USA ATP World Tour,HARD,2,Andy Roddick,Fernando Gonzalez,Andy Roddick,6-4; 6-3,R16,66,10,0,40,53,36,40,6,13,2,2,10,42,53,4,2,39,64,29,39,9,25,8,10,9,38,64
2005-03-07 00:00:00.000,ATP Masters Series Indian Wells California; USA ATP World Tour,HARD,2,Andre Agassi,Guillermo Coria,Andre Agassi,6-4; 6-1,R16,85,4,0,34,63,22,34,21,29,4,4,9,43,63,0,1,33,63,20,33,13,30,5,8,8,33,63
2005-03-07 00:00:00.000,ATP Masters Series Indian Wells California; USA ATP World Tour,HARD,2,Lleyton Hewitt,Paul-Henri Mathieu,Lleyton Hewitt,6-1; 6-0,R16,60,7,1,13,38,12,13,17,25,1,1,7,29,38,1,4,19,44,10,19,7,25,4,9,6,17,44
2005-03-07 00:00:00.000,ATP Masters Series Indian Wells California; USA ATP World Tour,HARD,2,Roger Federer,Nicolas Kiefer,Roger Federer,6-4; 6-1,Q,67,4,1,26,42,20,26,8,16,0,2,9,28,42,1,2,32,52,16,32,7,20,2,7,8,23,52
2005-03-07 00:00:00.000,ATP Masters Series Indian Wells California; USA ATP World Tour,HARD,2,Guillermo Canas,Tim Henman,Guillermo Canas,7-6(1); 7-5,Q,139,0,3,51,77,39,51,16,26,1,2,12,55,77,4,4,56,104,36,56,24,48,10,12,12,60,104
2005-03-07 00:00:00.000,ATP Masters Series Indian Wells California; USA ATP World Tour,HARD,2,Andy Roddick,Carlos Moya,Andy Roddick,6-7(4); 6-4; 6-1,Q,113,13,0,46,71,40,46,17,25,0,1,14,57,71,5,1,63,112,42,63,23,49,10,15,15,65,112
2005-03-07 00:00:00.000,ATP Masters Series Indian Wells California; USA ATP World Tour,HARD,2,Lleyton Hewitt,Andre Agassi,Lleyton Hewitt,W/O,Q,0,0,0,0,0,0,0,0,0,0,0,0,0,0,0,0,0,0,0,0,0,0,0,0,0,0,0
2005-03-07 00:00:00.000,ATP Masters Series Indian Wells California; USA ATP World Tour,HARD,2,Roger Federer,Guillermo Canas,Roger Federer,6-3; 6-1,S,73,7,2,34,56,22,34,13,22,1,2,8,35,56,2,2,29,52,14,29,11,23,5,10,8,25,52
2005-03-07 00:00:00.000,ATP Masters Series Indian Wells California; USA ATP World Tour,HARD,2,Lleyton Hewitt,Andy Roddick,Lleyton Hewitt,7-6(2); 6-7(3); 7-6(4),S,153,10,0,64,116,51,64,33,52,6,7,18,84,116,25,1,74,123,61,74,23,49,8,9,18,84,123
2005-03-07 00:00:00.000,ATP Masters Series Indian Wells California; USA ATP World Tour,HARD,2,Roger Federer,Lleyton Hewitt,Roger Federer,6-2; 6-4; 6-4,F,114,14,3,48,84,39,48,21,36,6,7,14,60,84,5,7,46,94,30,46,23,48,10,15,14,53,94
2005-03-21 00:00:00.000,ATP Masters Series Miami FL; U.S.A. ATP World Tour,HARD,2,Roger Federer,N/A Bye,Roger Federer,,R128,0,0,0,0,0,0,0,0,0,0,0,0,0,0,0,0,0,0,0,0,0,0,0,0,0,0,0
2005-03-21 00:00:00.000,ATP Masters Series Miami FL; U.S.A. ATP World Tour,HARD,2,Olivier Rochus,Ivo Karlovic,Olivier Rochus,5-7; 7-6(5); 7-6(3),R128,157,7,6,68,108,55,68,25,40,3,5,18,80,108,30,7,76,115,62,76,18,39,3,4,18,80,115
2005-03-21 00:00:00.000,ATP Masters Series Miami FL; U.S.A. ATP World Tour,HARD,2,Mariano Zabaleta,Gilles Muller,Mariano Zabaleta,6-4; 6-2,R128,65,5,6,25,48,21,25,16,23,0,0,9,37,48,8,3,33,60,22,33,13,27,5,8,9,35,60
2005-03-21 00:00:00.000,ATP Masters Series Miami FL; U.S.A. ATP World Tour,HARD,2,Paradorn Srichaphan,N/A Bye,Paradorn Srichaphan,,R128,0,0,0,0,0,0,0,0,0,0,0,0,0,0,0,0,0,0,0,0,0,0,0,0,0,0,0
2005-03-21 00:00:00.000,ATP Masters Series Miami FL; U.S.A. ATP World Tour,HARD,2,Mario Ancic,N/A Bye,Mario Ancic,,R128,0,0,0,0,0,0,0,0,0,0,0,0,0,0,0,0,0,0,0,0,0,0,0,0,0,0,0
2005-03-21 00:00:00.000,ATP Masters Series Miami FL; U.S.A. ATP World Tour,HARD,2,Ricardo Mello,Santiago Ventura,Ricardo Mello,6-0; 1-0 RET,R128,26,3,0,12,20,11,12,5,8,0,0,4,16,20,0,0,10,24,5,10,2,14,3,6,3,7,24
2005-03-21 00:00:00.000,ATP Masters Series Miami FL; U.S.A. ATP World Tour,HARD,2,Mardy Fish,Tomas Zib,Mardy Fish,7-6(2); 6-7(3); 6-3,R128,151,34,1,59,120,44,59,32,61,8,12,17,76,120,5,8,63,113,43,63,25,50,2,7,16,68,113
2005-03-21 00:00:00.000,ATP Masters Series Miami FL; U.S.A. ATP World Tour,HARD,2,Tommy Haas,N/A Bye,Tommy Haas,,R128,0,0,0,0,0,0,0,0,0,0,0,0,0,0,0,0,0,0,0,0,0,0,0,0,0,0,0
2005-03-21 00:00:00.000,ATP Masters Series Miami FL; U.S.A. ATP World Tour,HARD,2,Joachim Johansson,N/A Bye,Joachim Johansson,,R128,0,0,0,0,0,0,0,0,0,0,0,0,0,0,0,0,0,0,0,0,0,0,0,0,0,0,0
2005-03-21 00:00:00.000,ATP Masters Series Miami FL; U.S.A. ATP World Tour,HARD,2,Jeff Morrison,Stefan Koubek,Jeff Morrison,6-2; 6-4,R128,57,8,3,25,47,19,25,15,22,0,1,9,34,47,0,9,29,62,17,29,14,33,5,9,9,31,62
2005-03-21 00:00:00.000,ATP Masters Series Miami FL; U.S.A. ATP World Tour,HARD,2,Julien Benneteau,Sargis Sargsian,Julien Benneteau,6-0; 6-3,R128,57,1,1,40,54,30,40,7,14,1,1,8,37,54,0,4,18,39,12,18,4,21,2,6,7,16,39
2005-03-21 00:00:00.000,ATP Masters Series Miami FL; U.S.A. ATP World Tour,HARD,2,Radek Stepanek,N/A Bye,Radek Stepanek,,R128,0,0,0,0,0,0,0,0,0,0,0,0,0,0,0,0,0,0,0,0,0,0,0,0,0,0,0
2005-03-21 00:00:00.000,ATP Masters Series Miami FL; U.S.A. ATP World Tour,HARD,2,Juan Ignacio Chela,N/A Bye,Juan Ignacio Chela,,R128,0,0,0,0,0,0,0,0,0,0,0,0,0,0,0,0,0,0,0,0,0,0,0,0,0,0,0
2005-03-21 00:00:00.000,ATP Masters Series Miami FL; U.S.A. ATP World Tour,HARD,2,Jean-Rene Lisnard,Donald Young,Jean-Rene Lisnard,6-4; 7-5,R128,84,2,8,34,71,23,34,20,37,0,3,11,43,71,2,0,41,66,22,41,10,25,8,13,11,32,66
2005-03-21 00:00:00.000,ATP Masters Series Miami FL; U.S.A. ATP World Tour,HARD,2,Ivo Minar,Juan Monaco,Ivo Minar,4-6; 6-3; 6-3,R128,133,7,4,41,87,26,41,26,46,6,9,14,52,87,3,4,79,113,43,79,18,34,11,16,14,61,113
2005-03-21 00:00:00.000,ATP Masters Series Miami FL; U.S.A. ATP World Tour,HARD,2,Tim Henman,N/A Bye,Tim Henman,,R128,0,0,0,0,0,0,0,0,0,0,0,0,0,0,0,0,0,0,0,0,0,0,0,0,0,0,0
2005-03-21 00:00:00.000,ATP Masters Series Miami FL; U.S.A. ATP World Tour,HARD,2,Guillermo Coria,N/A Bye,Guillermo Coria,,R128,0,0,0,0,0,0,0,0,0,0,0,0,0,0,0,0,0,0,0,0,0,0,0,0,0,0,0
2005-03-21 00:00:00.000,ATP Masters Series Miami FL; U.S.A. ATP World Tour,HARD,2,Davide Sanguinetti,Jan Hernych,Davide Sanguinetti,7-6(6); 6-1,R128,83,6,2,37,66,29,37,15,29,6,7,9,44,66,1,3,45,73,27,45,12,28,6,10,10,39,73
2005-03-21 00:00:00.000,ATP Masters Series Miami FL; U.S.A. ATP World Tour,HARD,2,Victor Hanescu,Antony Dupuis,Victor Hanescu,6-4; 6-1,R128,66,11,1,39,59,29,39,13,20,6,6,9,42,59,2,4,34,55,20,34,9,21,6,9,8,29,55
2005-03-21 00:00:00.000,ATP Masters Series Miami FL; U.S.A. ATP World Tour,HARD,2,Taylor Dent,N/A Bye,Taylor Dent,,R128,0,0,0,0,0,0,0,0,0,0,0,0,0,0,0,0,0,0,0,0,0,0,0,0,0,0,0
2005-03-21 00:00:00.000,ATP Masters Series Miami FL; U.S.A. ATP World Tour,HARD,2,Nicolas Kiefer,N/A Bye,Nicolas Kiefer,,R128,0,0,0,0,0,0,0,0,0,0,0,0,0,0,0,0,0,0,0,0,0,0,0,0,0,0,0
2005-03-21 00:00:00.000,ATP Masters Series Miami FL; U.S.A. ATP World Tour,HARD,2,Florian Mayer,Lars Burgsmuller,Florian Mayer,6-2; 6-3,R128,66,3,0,28,45,22,28,11,17,0,0,8,33,45,1,1,32,58,18,32,13,26,1,5,9,31,58
2005-03-21 00:00:00.000,ATP Masters Series Miami FL; U.S.A. ATP World Tour,HARD,2,Mark Philippoussis,Christophe Rochus,Mark Philippoussis,6-4; 6-2,R128,75,9,4,24,55,19,24,16,31,2,4,9,35,55,1,0,38,57,23,38,5,19,6,11,9,28,57
2005-03-21 00:00:00.000,ATP Masters Series Miami FL; U.S.A. ATP World Tour,HARD,2,Fernando Gonzalez,N/A Bye,Fernando Gonzalez,,R128,0,0,0,0,0,0,0,0,0,0,0,0,0,0,0,0,0,0,0,0,0,0,0,0,0,0,0
2005-03-21 00:00:00.000,ATP Masters Series Miami FL; U.S.A. ATP World Tour,HARD,2,Andre Agassi,N/A Bye,Andre Agassi,,R128,0,0,0,0,0,0,0,0,0,0,0,0,0,0,0,0,0,0,0,0,0,0,0,0,0,0,0
2005-03-21 00:00:00.000,ATP Masters Series Miami FL; U.S.A. ATP World Tour,HARD,2,Paul-Henri Mathieu,Michal Tabara,Paul-Henri Mathieu,4-6; 7-6(2); 6-4,R128,144,9,8,47,104,35,47,25,57,6,12,16,60,104,6,13,39,103,30,39,27,64,6,12,16,57,103
2005-03-21 00:00:00.000,ATP Masters Series Miami FL; U.S.A. ATP World Tour,HARD,2,Arnaud Clement,Tomas Berdych,Arnaud Clement,6-3; 3-0 RET,R128,43,2,2,17,32,13,17,7,15,0,1,6,20,32,0,5,16,30,5,16,5,14,1,5,6,10,30
2005-03-21 00:00:00.000,ATP Masters Series Miami FL; U.S.A. ATP World Tour,HARD,2,Feliciano Lopez,N/A Bye,Feliciano Lopez,,R128,0,0,0,0,0,0,0,0,0,0,0,0,0,0,0,0,0,0,0,0,0,0,0,0,0,0,0
2005-03-21 00:00:00.000,ATP Masters Series Miami FL; U.S.A. ATP World Tour,HARD,2,Sebastien Grosjean,N/A Bye,Sebastien Grosjean,,R128,0,0,0,0,0,0,0,0,0,0,0,0,0,0,0,0,0,0,0,0,0,0,0,0,0,0,0
2005-03-21 00:00:00.000,ATP Masters Series Miami FL; U.S.A. ATP World Tour,HARD,2,Nicolas Lapentti,Karol Beck,Nicolas Lapentti,6-1; 7-6(8),R128,116,2,0,50,83,33,50,17,33,2,4,10,50,83,2,3,27,63,19,27,17,36,2,6,9,36,63
2005-03-21 00:00:00.000,ATP Masters Series Miami FL; U.S.A. ATP World Tour,HARD,2,Bjorn Phau,Alex Calatrava,Bjorn Phau,7-6(7); 6-0,R128,93,6,2,31,64,26,31,15,33,2,3,9,41,64,2,2,43,70,24,43,14,27,7,11,9,38,70
2005-03-21 00:00:00.000,ATP Masters Series Miami FL; U.S.A. ATP World Tour,HARD,2,Gaston Gaudio,N/A Bye,Gaston Gaudio,,R128,0,0,0,0,0,0,0,0,0,0,0,0,0,0,0,0,0,0,0,0,0,0,0,0,0,0,0
2005-03-21 00:00:00.000,ATP Masters Series Miami FL; U.S.A. ATP World Tour,HARD,2,David Nalbandian,N/A Bye,David Nalbandian,,R128,0,0,0,0,0,0,0,0,0,0,0,0,0,0,0,0,0,0,0,0,0,0,0,0,0,0,0
2005-03-21 00:00:00.000,ATP Masters Series Miami FL; U.S.A. ATP World Tour,HARD,2,Jose Acasuso,Jurgen Melzer,Jose Acasuso,6-4; 6-3,R128,77,5,1,28,46,23,28,11,18,1,2,9,34,46,2,4,35,68,23,35,12,33,5,9,10,35,68
2005-03-21 00:00:00.000,ATP Masters Series Miami FL; U.S.A. ATP World Tour,HARD,2,David Ferrer,Philipp Kohlschreiber,David Ferrer,6-2; 7-6(6),R128,95,5,4,38,59,30,38,11,21,3,4,10,41,59,2,2,49,84,27,49,20,35,3,6,10,47,84
2005-03-21 00:00:00.000,ATP Masters Series Miami FL; U.S.A. ATP World Tour,HARD,2,Xavier Malisse,N/A Bye,Xavier Malisse,,R128,0,0,0,0,0,0,0,0,0,0,0,0,0,0,0,0,0,0,0,0,0,0,0,0,0,0,0
2005-03-21 00:00:00.000,ATP Masters Series Miami FL; U.S.A. ATP World Tour,HARD,2,Andrei Pavel,N/A Bye,Andrei Pavel,,R128,0,0,0,0,0,0,0,0,0,0,0,0,0,0,0,0,0,0,0,0,0,0,0,0,0,0,0
2005-03-21 00:00:00.000,ATP Masters Series Miami FL; U.S.A. ATP World Tour,HARD,2,Igor Andreev,Nicolas Almagro,Igor Andreev,7-6(4); 2-6; 7-6(12),R128,141,10,6,76,123,52,76,22,47,10,14,16,74,123,10,4,74,116,52,74,22,42,5,7,16,74,116
2005-03-21 00:00:00.000,ATP Masters Series Miami FL; U.S.A. ATP World Tour,HARD,2,Juan Carlos Ferrero,Brendan Evans,Juan Carlos Ferrero,6-2; 6-4,R128,70,2,3,33,51,24,33,11,18,5,6,9,35,51,7,4,35,66,22,35,12,31,7,11,9,34,66
2005-03-21 00:00:00.000,ATP Masters Series Miami FL; U.S.A. ATP World Tour,HARD,2,Guillermo Canas,N/A Bye,Guillermo Canas,,R128,0,0,0,0,0,0,0,0,0,0,0,0,0,0,0,0,0,0,0,0,0,0,0,0,0,0,0
2005-03-21 00:00:00.000,ATP Masters Series Miami FL; U.S.A. ATP World Tour,HARD,2,Nikolay Davydenko,N/A Bye,Nikolay Davydenko,,R128,0,0,0,0,0,0,0,0,0,0,0,0,0,0,0,0,0,0,0,0,0,0,0,0,0,0,0
2005-03-21 00:00:00.000,ATP Masters Series Miami FL; U.S.A. ATP World Tour,HARD,2,Gael Monfils,Michael Llodra,Gael Monfils,3-6; 6-4; 6-3,R128,98,12,2,37,72,31,37,22,35,5,7,14,53,72,3,4,61,92,44,61,15,31,5,8,14,59,92
2005-03-21 00:00:00.000,ATP Masters Series Miami FL; U.S.A. ATP World Tour,HARD,2,Hyung-Taik Lee,Thomas Enqvist,Hyung-Taik Lee,3-6; 6-4; 6-3,R128,127,11,3,56,90,35,56,17,34,5,9,14,52,90,9,4,45,88,31,45,19,43,5,10,14,50,88
2005-03-21 00:00:00.000,ATP Masters Series Miami FL; U.S.A. ATP World Tour,HARD,2,Mikhail Youzhny,N/A Bye,Mikhail Youzhny,,R128,0,0,0,0,0,0,0,0,0,0,0,0,0,0,0,0,0,0,0,0,0,0,0,0,0,0,0
2005-03-21 00:00:00.000,ATP Masters Series Miami FL; U.S.A. ATP World Tour,HARD,2,Dominik Hrbaty,N/A Bye,Dominik Hrbaty,,R128,0,0,0,0,0,0,0,0,0,0,0,0,0,0,0,0,0,0,0,0,0,0,0,0,0,0,0
2005-03-21 00:00:00.000,ATP Masters Series Miami FL; U.S.A. ATP World Tour,HARD,2,Jarkko Nieminen,Cyril Saulnier,Jarkko Nieminen,6-2; 7-6(4),R128,81,0,1,41,67,27,41,14,26,2,5,10,41,67,5,5,33,63,26,33,7,30,2,7,10,33,63
2005-03-21 00:00:00.000,ATP Masters Series Miami FL; U.S.A. ATP World Tour,HARD,2,Irakli Labadze,Younes El Aynaoui,Irakli Labadze,6-4; 1-6; 6-1,R128,91,3,11,45,71,31,45,10,26,4,8,12,41,71,1,3,49,70,28,49,10,21,1,6,12,38,70
2005-03-21 00:00:00.000,ATP Masters Series Miami FL; U.S.A. ATP World Tour,HARD,2,Marat Safin,N/A Bye,Marat Safin,,R128,0,0,0,0,0,0,0,0,0,0,0,0,0,0,0,0,0,0,0,0,0,0,0,0,0,0,0
2005-03-21 00:00:00.000,ATP Masters Series Miami FL; U.S.A. ATP World Tour,HARD,2,Carlos Moya,N/A Bye,Carlos Moya,,R128,0,0,0,0,0,0,0,0,0,0,0,0,0,0,0,0,0,0,0,0,0,0,0,0,0,0,0
2005-03-21 00:00:00.000,ATP Masters Series Miami FL; U.S.A. ATP World Tour,HARD,2,James Blake,Kenneth Carlsen,James Blake,6-3; 6-2,R128,82,3,1,35,59,27,35,16,24,4,4,9,43,59,3,3,43,72,27,43,12,29,10,13,8,39,72
2005-03-21 00:00:00.000,ATP Masters Series Miami FL; U.S.A. ATP World Tour,HARD,2,Greg Rusedski,Andreas Seppi,Greg Rusedski,4-6; 6-4; 6-4,R128,128,20,7,49,81,41,49,19,32,4,5,15,60,81,8,5,74,115,50,74,21,41,13,15,15,71,115
2005-03-21 00:00:00.000,ATP Masters Series Miami FL; U.S.A. ATP World Tour,HARD,2,Thomas Johansson,N/A Bye,Thomas Johansson,,R128,0,0,0,0,0,0,0,0,0,0,0,0,0,0,0,0,0,0,0,0,0,0,0,0,0,0,0
2005-03-21 00:00:00.000,ATP Masters Series Miami FL; U.S.A. ATP World Tour,HARD,2,Jiri Novak,N/A Bye,Jiri Novak,,R128,0,0,0,0,0,0,0,0,0,0,0,0,0,0,0,0,0,0,0,0,0,0,0,0,0,0,0
2005-03-21 00:00:00.000,ATP Masters Series Miami FL; U.S.A. ATP World Tour,HARD,2,Kevin Kim,Luis Horna,Kevin Kim,6-4; 4-6; 7-6(0),R128,140,19,3,56,87,45,56,13,31,5,9,16,58,87,7,6,68,117,49,68,18,49,12,16,16,67,117
2005-03-21 00:00:00.000,ATP Masters Series Miami FL; U.S.A. ATP World Tour,HARD,2,Jonas Bjorkman,Max Mirnyi,Jonas Bjorkman,2-6; 6-4; 6-1,R128,101,4,2,33,71,24,33,24,38,4,6,13,48,71,6,1,56,81,40,56,10,25,7,10,12,50,81
2005-03-21 00:00:00.000,ATP Masters Series Miami FL; U.S.A. ATP World Tour,HARD,2,Tommy Robredo,N/A Bye,Tommy Robredo,,R128,0,0,0,0,0,0,0,0,0,0,0,0,0,0,0,0,0,0,0,0,0,0,0,0,0,0,0
2005-03-21 00:00:00.000,ATP Masters Series Miami FL; U.S.A. ATP World Tour,HARD,2,Ivan Ljubicic,N/A Bye,Ivan Ljubicic,,R128,0,0,0,0,0,0,0,0,0,0,0,0,0,0,0,0,0,0,0,0,0,0,0,0,0,0,0
2005-03-21 00:00:00.000,ATP Masters Series Miami FL; U.S.A. ATP World Tour,HARD,2,Alberto Martin,Agustin Calleri,Alberto Martin,3-6; 6-3; 7-6(3),R128,117,5,4,59,103,41,59,27,44,7,9,15,68,103,5,8,45,81,38,45,19,36,1,3,15,57,81
2005-03-21 00:00:00.000,ATP Masters Series Miami FL; U.S.A. ATP World Tour,HARD,2,Robby Ginepri,Filippo Volandri,Robby Ginepri,7-6(4); 6-1,R128,76,3,1,38,62,25,38,18,24,2,3,9,43,62,0,3,34,65,20,34,15,31,3,7,10,35,65
2005-03-21 00:00:00.000,ATP Masters Series Miami FL; U.S.A. ATP World Tour,HARD,2,Vincent Spadea,N/A Bye,Vincent Spadea,,R128,0,0,0,0,0,0,0,0,0,0,0,0,0,0,0,0,0,0,0,0,0,0,0,0,0,0,0
2005-03-21 00:00:00.000,ATP Masters Series Miami FL; U.S.A. ATP World Tour,HARD,2,Rafael Nadal,N/A Bye,Rafael Nadal,,R128,0,0,0,0,0,0,0,0,0,0,0,0,0,0,0,0,0,0,0,0,0,0,0,0,0,0,0
2005-03-21 00:00:00.000,ATP Masters Series Miami FL; U.S.A. ATP World Tour,HARD,2,Rainer Schuettler,Potito Starace,Rainer Schuettler,7-6(4); 5-7; 7-6(5),R128,157,8,6,57,115,48,57,35,58,6,8,18,83,115,3,1,85,125,60,85,24,40,6,7,18,84,125
2005-03-21 00:00:00.000,ATP Masters Series Miami FL; U.S.A. ATP World Tour,HARD,2,Fernando Verdasco,Peter Wessels,Fernando Verdasco,6-4; 7-5,R128,71,9,2,42,67,35,42,14,25,5,5,11,49,67,9,0,42,59,34,42,8,17,2,4,11,42,59
2005-03-21 00:00:00.000,ATP Masters Series Miami FL; U.S.A. ATP World Tour,HARD,2,Andy Roddick,N/A Bye,Andy Roddick,,R128,0,0,0,0,0,0,0,0,0,0,0,0,0,0,0,0,0,0,0,0,0,0,0,0,0,0,0
2005-03-21 00:00:00.000,ATP Masters Series Miami FL; U.S.A. ATP World Tour,HARD,2,Roger Federer,Olivier Rochus,Roger Federer,6-3; 6-1,R64,72,12,1,24,39,21,24,11,15,0,0,8,32,39,1,4,39,75,17,39,20,36,8,12,8,37,75
2005-03-21 00:00:00.000,ATP Masters Series Miami FL; U.S.A. ATP World Tour,HARD,2,Mariano Zabaleta,Paradorn Srichaphan,Mariano Zabaleta,7-6(5); 6-3,R64,97,7,7,34,68,30,34,19,34,2,2,11,49,68,7,1,44,72,32,44,14,28,3,4,10,46,72
2005-03-21 00:00:00.000,ATP Masters Series Miami FL; U.S.A. ATP World Tour,HARD,2,Mario Ancic,Ricardo Mello,Mario Ancic,6-1; 6-4,R64,74,4,2,30,52,26,30,10,22,1,2,9,36,52,1,2,34,56,21,34,7,22,5,9,8,28,56
2005-03-21 00:00:00.000,ATP Masters Series Miami FL; U.S.A. ATP World Tour,HARD,2,Tommy Haas,Mardy Fish,Tommy Haas,7-6(6); 7-5,R64,127,10,8,46,93,37,46,26,47,3,4,12,63,93,9,2,38,84,29,38,23,46,7,9,12,52,84
2005-03-21 00:00:00.000,ATP Masters Series Miami FL; U.S.A. ATP World Tour,HARD,2,Jeff Morrison,Joachim Johansson,Jeff Morrison,7-6(3); 6-4,R64,93,15,1,31,60,30,31,18,29,0,0,11,48,60,9,5,51,82,35,51,16,31,5,6,11,51,82
2005-03-21 00:00:00.000,ATP Masters Series Miami FL; U.S.A. ATP World Tour,HARD,2,Radek Stepanek,Julien Benneteau,Radek Stepanek,7-5; 6-0,R64,82,5,1,36,58,27,36,11,22,4,5,9,38,58,2,2,43,63,20,43,9,20,3,8,9,29,63
2005-03-21 00:00:00.000,ATP Masters Series Miami FL; U.S.A. ATP World Tour,HARD,2,Juan Ignacio Chela,Jean-Rene Lisnard,Juan Ignacio Chela,1-6; 6-2; 6-2,R64,99,2,1,52,77,31,52,16,25,2,5,12,47,77,3,7,22,62,18,22,17,40,1,5,11,35,62
2005-03-21 00:00:00.000,ATP Masters Series Miami FL; U.S.A. ATP World Tour,HARD,2,Tim Henman,Ivo Minar,Tim Henman,6-3; 7-5,R64,80,5,4,35,57,31,35,15,22,2,2,11,46,57,4,4,33,72,21,33,23,39,3,5,10,44,72
2005-03-21 00:00:00.000,ATP Masters Series Miami FL; U.S.A. ATP World Tour,HARD,2,Guillermo Coria,Davide Sanguinetti,Guillermo Coria,6-1; 6-4,R64,81,4,2,32,55,23,32,14,23,3,4,9,37,55,3,1,26,56,14,26,14,30,4,8,8,28,56
2005-03-21 00:00:00.000,ATP Masters Series Miami FL; U.S.A. ATP World Tour,HARD,2,Taylor Dent,Victor Hanescu,Taylor Dent,2-6; 6-1; 4-0 RET,R64,80,7,3,28,49,22,28,12,21,0,2,10,34,49,6,1,46,75,29,46,11,29,9,13,9,40,75
2005-03-21 00:00:00.000,ATP Masters Series Miami FL; U.S.A. ATP World Tour,HARD,2,Florian Mayer,Nicolas Kiefer,Florian Mayer,6-4; 6-2,R64,82,6,5,32,56,26,32,15,24,1,1,9,41,56,3,0,30,63,20,30,16,33,7,10,9,36,63
2005-03-21 00:00:00.000,ATP Masters Series Miami FL; U.S.A. ATP World Tour,HARD,2,Fernando Gonzalez,Mark Philippoussis,Fernando Gonzalez,W/O,R64,0,0,0,0,0,0,0,0,0,0,0,0,0,0,0,0,0,0,0,0,0,0,0,0,0,0,0
2005-03-21 00:00:00.000,ATP Masters Series Miami FL; U.S.A. ATP World Tour,HARD,2,Andre Agassi,Paul-Henri Mathieu,Andre Agassi,7-5; 6-4,R64,93,8,0,37,61,31,37,14,24,2,3,11,45,61,2,1,37,71,25,37,18,34,2,5,11,43,71
2005-03-21 00:00:00.000,ATP Masters Series Miami FL; U.S.A. ATP World Tour,HARD,2,Arnaud Clement,Feliciano Lopez,Arnaud Clement,6-1; 7-5,R64,78,7,3,35,60,29,35,13,25,0,0,10,42,60,8,3,33,58,25,33,7,25,2,5,9,32,58
2005-03-21 00:00:00.000,ATP Masters Series Miami FL; U.S.A. ATP World Tour,HARD,2,Sebastien Grosjean,Nicolas Lapentti,Sebastien Grosjean,6-1; 6-3,R64,65,4,0,25,39,22,25,8,14,1,2,8,30,39,0,0,31,48,13,31,7,17,3,8,8,20,48
2005-03-21 00:00:00.000,ATP Masters Series Miami FL; U.S.A. ATP World Tour,HARD,2,Gaston Gaudio,Bjorn Phau,Gaston Gaudio,6-2; 6-2,R64,64,3,0,23,38,20,23,12,15,0,0,8,32,38,0,1,31,57,16,31,13,26,2,6,8,29,57
2005-03-21 00:00:00.000,ATP Masters Series Miami FL; U.S.A. ATP World Tour,HARD,2,David Nalbandian,Jose Acasuso,David Nalbandian,6-3; 6-3,R64,65,4,3,26,46,20,26,12,20,0,2,9,32,46,2,3,22,51,11,22,14,29,1,6,9,25,51
2005-03-21 00:00:00.000,ATP Masters Series Miami FL; U.S.A. ATP World Tour,HARD,2,David Ferrer,Xavier Malisse,David Ferrer,3-6; 5-5 DEF,R64,100,1,3,35,58,29,35,9,23,2,4,10,38,58,3,0,38,65,28,38,16,27,2,2,9,44,65
2005-03-21 00:00:00.000,ATP Masters Series Miami FL; U.S.A. ATP World Tour,HARD,2,Igor Andreev,Andrei Pavel,Igor Andreev,6-2; 6-1,R64,67,4,2,25,50,17,25,15,25,2,3,7,32,50,3,5,32,60,14,32,11,28,7,13,8,25,60
2005-03-21 00:00:00.000,ATP Masters Series Miami FL; U.S.A. ATP World Tour,HARD,2,Juan Carlos Ferrero,Guillermo Canas,Juan Carlos Ferrero,6-4; 2-6; 6-4,R64,154,3,2,49,86,32,49,21,37,2,5,14,53,86,12,5,46,93,37,46,20,47,4,7,14,57,93
2005-03-21 00:00:00.000,ATP Masters Series Miami FL; U.S.A. ATP World Tour,HARD,2,Gael Monfils,Nikolay Davydenko,Gael Monfils,4-6; 6-1; 6-4,R64,126,9,8,47,86,35,47,19,39,6,9,14,54,86,1,2,66,85,37,66,10,19,4,9,13,47,85
2005-03-21 00:00:00.000,ATP Masters Series Miami FL; U.S.A. ATP World Tour,HARD,2,Hyung-Taik Lee,Mikhail Youzhny,Hyung-Taik Lee,6-1; 6-4,R64,60,2,0,31,44,26,31,7,13,0,1,9,33,44,1,3,31,52,17,31,9,21,6,10,8,26,52
2005-03-21 00:00:00.000,ATP Masters Series Miami FL; U.S.A. ATP World Tour,HARD,2,Dominik Hrbaty,Jarkko Nieminen,Dominik Hrbaty,6-3; 6-4,R64,77,2,6,33,57,24,33,10,24,1,3,10,34,57,1,1,53,82,33,53,9,29,11,15,9,42,82
2005-03-21 00:00:00.000,ATP Masters Series Miami FL; U.S.A. ATP World Tour,HARD,2,Marat Safin,Irakli Labadze,Marat Safin,6-4; 2-6; 7-6(5),R64,150,9,2,54,93,42,54,19,39,5,8,15,61,93,4,11,76,126,55,76,22,50,12,14,15,77,126
2005-03-21 00:00:00.000,ATP Masters Series Miami FL; U.S.A. ATP World Tour,HARD,2,Carlos Moya,James Blake,Carlos Moya,4-6; 7-5; 7-6(6),R64,149,3,6,76,122,59,76,22,46,12,14,17,81,122,4,3,71,114,55,71,21,43,3,5,17,76,114
2005-03-21 00:00:00.000,ATP Masters Series Miami FL; U.S.A. ATP World Tour,HARD,2,Thomas Johansson,Greg Rusedski,Thomas Johansson,6-3; 6-4,R64,70,5,1,30,56,24,30,15,26,3,4,10,39,56,4,3,25,50,17,25,12,25,1,4,9,29,50
2005-03-21 00:00:00.000,ATP Masters Series Miami FL; U.S.A. ATP World Tour,HARD,2,Jiri Novak,Kevin Kim,Jiri Novak,6-1; 6-2,R64,49,3,0,33,46,24,33,8,13,3,4,8,32,46,1,2,21,42,12,21,5,21,3,8,7,17,42
2005-03-21 00:00:00.000,ATP Masters Series Miami FL; U.S.A. ATP World Tour,HARD,2,Tommy Robredo,Jonas Bjorkman,Tommy Robredo,6-4; 6-0,R64,65,0,3,29,42,22,29,5,13,1,3,8,27,42,1,6,36,58,23,36,2,22,7,13,8,25,58
2005-03-21 00:00:00.000,ATP Masters Series Miami FL; U.S.A. ATP World Tour,HARD,2,Ivan Ljubicic,Alberto Martin,Ivan Ljubicic,6-3; 6-3,R64,85,11,2,44,69,33,44,13,25,8,8,9,46,69,2,6,29,57,21,29,13,28,4,7,9,34,57
2005-03-21 00:00:00.000,ATP Masters Series Miami FL; U.S.A. ATP World Tour,HARD,2,Vincent Spadea,Robby Ginepri,Vincent Spadea,6-3; 6-4,R64,60,7,3,26,48,23,26,14,22,1,2,10,37,48,3,2,38,65,24,38,12,27,2,5,9,36,65
2005-03-21 00:00:00.000,ATP Masters Series Miami FL; U.S.A. ATP World Tour,HARD,2,Rafael Nadal,Rainer Schuettler,Rafael Nadal,6-4; 7-6(5),R64,128,2,1,46,71,30,46,17,25,2,3,11,47,71,2,4,52,85,34,52,18,33,6,8,11,52,85
2005-03-21 00:00:00.000,ATP Masters Series Miami FL; U.S.A. ATP World Tour,HARD,2,Fernando Verdasco,Andy Roddick,Fernando Verdasco,7-6(9); 4-3 RET,R64,76,8,2,44,60,34,44,10,16,1,2,10,44,60,10,5,40,59,33,40,7,19,1,2,9,40,59
2005-03-21 00:00:00.000,ATP Masters Series Miami FL; U.S.A. ATP World Tour,HARD,2,Roger Federer,Mariano Zabaleta,Roger Federer,6-2; 5-7; 6-3,R32,137,11,2,52,92,36,52,24,40,3,5,15,60,92,4,4,59,103,37,59,21,44,3,7,14,58,103
2005-03-21 00:00:00.000,ATP Masters Series Miami FL; U.S.A. ATP World Tour,HARD,2,Mario Ancic,Tommy Haas,Mario Ancic,6-4; 6-4,R32,100,11,4,42,80,35,42,18,38,6,6,10,53,80,0,2,36,58,26,36,11,22,1,3,10,37,58
2005-03-21 00:00:00.000,ATP Masters Series Miami FL; U.S.A. ATP World Tour,HARD,2,Radek Stepanek,Jeff Morrison,Radek Stepanek,6-3; 6-0,R32,61,4,2,24,45,20,24,10,21,2,3,7,30,45,3,1,26,49,13,26,7,23,6,12,8,20,49
2005-03-21 00:00:00.000,ATP Masters Series Miami FL; U.S.A. ATP World Tour,HARD,2,Tim Henman,Juan Ignacio Chela,Tim Henman,6-3; 6-1,R32,72,3,2,35,52,26,35,10,17,1,1,8,36,52,1,1,31,43,15,31,4,12,1,5,8,19,43
2005-03-21 00:00:00.000,ATP Masters Series Miami FL; U.S.A. ATP World Tour,HARD,2,Taylor Dent,Guillermo Coria,Taylor Dent,6-3; 6-4,R32,79,7,2,28,51,24,28,16,23,0,0,10,40,51,2,8,41,74,27,41,17,33,8,10,9,44,74
2005-03-21 00:00:00.000,ATP Masters Series Miami FL; U.S.A. ATP World Tour,HARD,2,Florian Mayer,Fernando Gonzalez,Florian Mayer,7-6(3); 2-6; 6-3,R32,135,5,5,59,94,39,59,21,35,5,8,15,60,94,6,5,48,81,40,48,16,33,2,4,14,56,81
2005-03-21 00:00:00.000,ATP Masters Series Miami FL; U.S.A. ATP World Tour,HARD,2,Andre Agassi,Arnaud Clement,Andre Agassi,6-2; 6-4,R32,70,12,3,28,55,23,28,15,27,1,2,9,38,55,3,0,26,45,15,26,8,19,0,4,9,23,45
2005-03-21 00:00:00.000,ATP Masters Series Miami FL; U.S.A. ATP World Tour,HARD,2,Gaston Gaudio,Sebastien Grosjean,Gaston Gaudio,6-2; 6-3,R32,89,0,2,37,64,28,37,15,27,1,1,9,43,64,4,1,38,61,21,38,12,23,3,6,8,33,61
2005-03-21 00:00:00.000,ATP Masters Series Miami FL; U.S.A. ATP World Tour,HARD,2,David Ferrer,David Nalbandian,David Ferrer,7-6(0); 6-1,R32,89,2,3,37,63,22,37,17,26,4,7,10,39,63,3,6,42,64,24,42,6,22,8,13,9,30,64
2005-03-21 00:00:00.000,ATP Masters Series Miami FL; U.S.A. ATP World Tour,HARD,2,Juan Carlos Ferrero,Igor Andreev,Juan Carlos Ferrero,6-4; 6-3,R32,86,1,1,32,52,23,32,16,20,1,2,10,39,52,5,2,37,67,23,37,15,30,5,8,9,38,67
2005-03-21 00:00:00.000,ATP Masters Series Miami FL; U.S.A. ATP World Tour,HARD,2,Gael Monfils,Hyung-Taik Lee,Gael Monfils,7-6(5); 3-6; 7-6(1),R32,148,25,3,58,110,47,58,27,52,4,6,16,74,110,4,1,63,106,45,63,28,43,3,4,17,73,106
2005-03-21 00:00:00.000,ATP Masters Series Miami FL; U.S.A. ATP World Tour,HARD,2,Dominik Hrbaty,Marat Safin,Dominik Hrbaty,7-6(6); 6-1,R32,76,5,6,40,76,29,40,20,36,5,7,10,49,76,0,2,36,54,21,36,8,18,3,7,9,29,54
2005-03-21 00:00:00.000,ATP Masters Series Miami FL; U.S.A. ATP World Tour,HARD,2,Thomas Johansson,Carlos Moya,Thomas Johansson,7-6(6); 3-6; 6-2,R32,132,8,2,52,102,35,52,32,50,4,7,15,67,102,8,9,53,97,40,53,22,44,7,10,14,62,97
2005-03-21 00:00:00.000,ATP Masters Series Miami FL; U.S.A. ATP World Tour,HARD,2,Jiri Novak,Tommy Robredo,Jiri Novak,W/O,R32,0,0,0,0,0,0,0,0,0,0,0,0,0,0,0,0,0,0,0,0,0,0,0,0,0,0,0
2005-03-21 00:00:00.000,ATP Masters Series Miami FL; U.S.A. ATP World Tour,HARD,2,Ivan Ljubicic,Vincent Spadea,Ivan Ljubicic,6-3; 4-6; 7-6(3),R32,129,6,0,45,85,37,45,23,40,1,3,15,60,85,3,4,48,88,35,48,23,40,3,6,16,58,88
2005-03-21 00:00:00.000,ATP Masters Series Miami FL; U.S.A. ATP World Tour,HARD,2,Rafael Nadal,Fernando Verdasco,Rafael Nadal,6-2; 6-2,R32,75,1,3,39,59,23,39,13,20,2,3,8,36,59,2,5,21,42,14,21,5,21,0,5,8,19,42
2005-03-21 00:00:00.000,ATP Masters Series Miami FL; U.S.A. ATP World Tour,HARD,2,Roger Federer,Mario Ancic,Roger Federer,6-3; 4-6; 6-4,R16,106,5,2,50,76,39,50,14,26,2,5,15,53,76,6,3,49,82,35,49,14,33,1,5,14,49,82
2005-03-21 00:00:00.000,ATP Masters Series Miami FL; U.S.A. ATP World Tour,HARD,2,Tim Henman,Radek Stepanek,Tim Henman,7-5; 6-3,R16,83,0,1,45,60,35,45,8,15,1,2,11,43,60,4,2,43,59,29,43,8,16,3,6,10,37,59
2005-03-21 00:00:00.000,ATP Masters Series Miami FL; U.S.A. ATP World Tour,HARD,2,Taylor Dent,Florian Mayer,Taylor Dent,6-3; 6-4,R16,65,5,4,36,59,33,36,7,23,2,3,10,40,59,1,1,40,67,27,40,11,27,3,6,9,38,67
2005-03-21 00:00:00.000,ATP Masters Series Miami FL; U.S.A. ATP World Tour,HARD,2,Andre Agassi,Gaston Gaudio,Andre Agassi,7-6(7); 6-2,R16,127,7,2,58,100,40,58,22,42,13,14,10,62,100,5,1,46,81,31,46,17,35,8,11,10,48,81
2005-03-21 00:00:00.000,ATP Masters Series Miami FL; U.S.A. ATP World Tour,HARD,2,David Ferrer,Juan Carlos Ferrero,David Ferrer,6-7(7); 6-3; 7-5,R16,172,4,1,73,114,41,73,24,41,5,10,17,65,114,0,1,67,103,39,67,18,36,8,15,16,57,103
2005-03-21 00:00:00.000,ATP Masters Series Miami FL; U.S.A. ATP World Tour,HARD,2,Dominik Hrbaty,Gael Monfils,Dominik Hrbaty,6-3; 6-3,R16,80,5,3,35,64,24,35,20,29,6,6,9,44,64,6,3,31,64,20,31,15,33,6,9,9,35,64
2005-03-21 00:00:00.000,ATP Masters Series Miami FL; U.S.A. ATP World Tour,HARD,2,Thomas Johansson,Jiri Novak,Thomas Johansson,7-6(2); 6-2,R16,82,10,3,35,66,26,35,22,31,4,5,10,48,66,5,4,38,64,25,38,12,26,4,7,10,37,64
2005-03-21 00:00:00.000,ATP Masters Series Miami FL; U.S.A. ATP World Tour,HARD,2,Rafael Nadal,Ivan Ljubicic,Rafael Nadal,6-4; 6-7(5); 6-3,R16,164,5,1,66,95,49,66,20,29,2,3,16,69,95,11,4,73,115,53,73,16,42,9,12,15,69,115
2005-03-21 00:00:00.000,ATP Masters Series Miami FL; U.S.A. ATP World Tour,HARD,2,Roger Federer,Tim Henman,Roger Federer,6-4; 6-2,Q,72,2,0,32,49,24,32,13,17,1,1,9,37,49,5,1,29,49,18,29,11,20,3,6,9,29,49
2005-03-21 00:00:00.000,ATP Masters Series Miami FL; U.S.A. ATP World Tour,HARD,2,Andre Agassi,Taylor Dent,Andre Agassi,7-5; 6-0,Q,70,3,2,26,51,21,26,13,25,1,3,9,34,51,3,7,28,55,16,28,9,27,3,9,9,25,55
2005-03-21 00:00:00.000,ATP Masters Series Miami FL; U.S.A. ATP World Tour,HARD,2,David Ferrer,Dominik Hrbaty,David Ferrer,6-2; 6-3,Q,66,4,2,41,54,33,41,4,13,2,3,9,37,54,3,7,21,39,15,21,3,18,0,4,8,18,39
2005-03-21 00:00:00.000,ATP Masters Series Miami FL; U.S.A. ATP World Tour,HARD,2,Rafael Nadal,Thomas Johansson,Rafael Nadal,6-2; 6-4,Q,84,1,2,33,48,25,33,9,15,0,1,9,34,48,2,3,34,61,22,34,10,27,5,9,9,32,61
2005-03-21 00:00:00.000,ATP Masters Series Miami FL; U.S.A. ATP World Tour,HARD,2,Roger Federer,Andre Agassi,Roger Federer,6-4; 6-3,S,85,8,2,41,66,30,41,17,25,5,5,10,47,66,1,1,30,60,22,30,15,30,6,8,9,37,60
2005-03-21 00:00:00.000,ATP Masters Series Miami FL; U.S.A. ATP World Tour,HARD,2,Rafael Nadal,David Ferrer,Rafael Nadal,6-4; 6-3,S,91,0,0,36,52,24,36,11,16,1,2,9,35,52,3,3,44,68,23,44,12,24,2,6,10,35,68
2005-03-21 00:00:00.000,ATP Masters Series Miami FL; U.S.A. ATP World Tour,HARD,2,Roger Federer,Rafael Nadal,Roger Federer,2-6; 6-7(4); 7-6(5); 6-3; 6-1,F,223,9,9,90,151,67,90,30,61,4,9,24,97,151,4,4,100,156,64,100,32,56,6,13,24,96,156
2005-04-04 00:00:00.000,Casablanca Morocco ATP World Tour,CLAY,2,Tomas Zib,Rainer Schuettler,Tomas Zib,6-2; 6-2,R32,77,0,0,34,54,24,34,10,20,3,4,8,34,54,3,2,38,64,21,38,9,26,3,8,8,30,64
2005-04-04 00:00:00.000,Casablanca Morocco ATP World Tour,CLAY,2,Santiago Ventura,Hicham Arazi,Santiago Ventura,7-5; 6-3,R32,85,4,1,39,71,30,39,20,32,4,5,11,50,71,3,0,42,69,26,42,14,27,8,11,10,40,69
2005-04-04 00:00:00.000,Casablanca Morocco ATP World Tour,CLAY,2,David Sanchez,Thierry Ascione,David Sanchez,7-5; 6-4,R32,89,2,2,36,64,22,36,17,28,1,4,11,39,64,1,0,55,70,33,55,5,15,8,13,11,38,70
2005-04-04 00:00:00.000,Casablanca Morocco ATP World Tour,CLAY,2,Christophe Rochus,Mehdi Tahiri,Christophe Rochus,6-3; 6-2,R32,78,3,0,37,49,24,37,5,12,4,7,8,29,49,0,0,30,53,14,30,8,23,1,8,9,22,53
2005-04-04 00:00:00.000,Casablanca Morocco ATP World Tour,CLAY,2,Jiri Vanek,Fabrice Santoro,Jiri Vanek,6-4; 3-6; 6-3,R32,113,5,1,64,87,45,64,10,23,3,7,14,55,87,0,2,41,81,22,41,22,40,4,9,14,44,81
2005-04-04 00:00:00.000,Casablanca Morocco ATP World Tour,CLAY,2,Gilles Simon,Jose Acasuso,Gilles Simon,6-3; 3-6; 6-3,R32,110,2,2,48,79,32,48,19,31,5,8,14,51,79,6,3,51,94,33,51,20,43,8,12,13,53,94
2005-04-04 00:00:00.000,Casablanca Morocco ATP World Tour,CLAY,2,Juan Monaco,Davide Sanguinetti,Juan Monaco,7-6(5); 6-4,R32,92,1,2,41,72,28,41,18,31,6,8,11,46,72,2,0,30,73,22,30,22,43,4,7,11,44,73
2005-04-04 00:00:00.000,Casablanca Morocco ATP World Tour,CLAY,2,Florian Mayer,Bohdan Ulihrach,Florian Mayer,6-2; 6-1,R32,43,2,0,33,41,28,33,5,8,0,0,8,33,41,2,1,38,50,20,38,3,12,4,8,7,23,50
2005-04-04 00:00:00.000,Casablanca Morocco ATP World Tour,CLAY,2,Mariano Puerta,Tomas Behrend,Mariano Puerta,6-4; 6-1,R32,61,5,0,29,45,23,29,14,16,0,0,9,37,45,3,2,31,50,22,31,6,19,2,5,8,28,50
2005-04-04 00:00:00.000,Casablanca Morocco ATP World Tour,CLAY,2,Nicolas Almagro,Lars Burgsmuller,Nicolas Almagro,6-2; 6-2,R32,52,7,1,32,56,25,32,10,24,4,5,8,35,56,0,2,22,42,11,22,7,20,2,7,8,18,42
2005-04-04 00:00:00.000,Casablanca Morocco ATP World Tour,CLAY,2,Marc Gicquel,Michal Mertinak,Marc Gicquel,1-6; 7-5; 6-4,R32,122,2,1,61,89,43,61,11,28,3,7,14,54,89,4,4,61,93,41,61,15,32,6,10,15,56,93
2005-04-04 00:00:00.000,Casablanca Morocco ATP World Tour,CLAY,2,Arnaud Clement,Luis Horna,Arnaud Clement,7-5; 6-2,R32,80,4,5,36,63,25,36,14,27,2,4,10,39,63,1,3,35,55,18,35,9,20,5,10,10,27,55
2005-04-04 00:00:00.000,Casablanca Morocco ATP World Tour,CLAY,2,Gilles Muller,Jean-Rene Lisnard,Gilles Muller,7-5; 6-2,R32,72,4,3,32,57,25,32,15,25,1,2,10,40,57,0,13,31,68,23,31,15,37,8,12,10,38,68
2005-04-04 00:00:00.000,Casablanca Morocco ATP World Tour,CLAY,2,Janko Tipsarevic,Olivier Mutis,Janko Tipsarevic,7-5; 6-3,R32,75,2,0,28,60,21,28,19,32,2,4,11,40,60,3,2,47,80,29,47,15,33,7,11,10,44,80
2005-04-04 00:00:00.000,Casablanca Morocco ATP World Tour,CLAY,2,Jarkko Nieminen,Victor Hanescu,Jarkko Nieminen,6-3; 7-6(2),R32,87,2,1,45,64,32,45,10,19,4,6,10,42,64,1,2,58,83,34,58,11,25,11,15,11,45,83
2005-04-04 00:00:00.000,Casablanca Morocco ATP World Tour,CLAY,2,Filippo Volandri,Younes El Aynaoui,Filippo Volandri,6-3; 7-6(5),R32,130,0,2,49,67,32,49,11,18,3,5,10,43,67,1,2,70,110,40,70,18,40,9,13,11,58,110
2005-04-04 00:00:00.000,Casablanca Morocco ATP World Tour,CLAY,2,Tomas Zib,Santiago Ventura,Tomas Zib,6-4; 6-1,R16,67,3,2,27,51,20,27,13,24,1,3,9,33,51,4,4,28,47,15,28,6,19,0,5,8,21,47
2005-04-04 00:00:00.000,Casablanca Morocco ATP World Tour,CLAY,2,Christophe Rochus,David Sanchez,Christophe Rochus,7-5; 4-6; 6-3,R16,132,3,0,55,94,37,55,18,39,8,14,16,55,94,2,7,56,113,36,56,22,57,5,12,15,58,113
2005-04-04 00:00:00.000,Casablanca Morocco ATP World Tour,CLAY,2,Gilles Simon,Jiri Vanek,Gilles Simon,6-4; 3-6; 6-3,R16,135,4,2,63,98,38,63,18,35,4,8,14,56,98,8,4,61,108,38,61,21,47,8,13,14,59,108
2005-04-04 00:00:00.000,Casablanca Morocco ATP World Tour,CLAY,2,Juan Monaco,Florian Mayer,Juan Monaco,7-6(4); 6-0,R16,78,2,0,38,54,26,38,11,16,0,1,9,37,54,1,3,37,72,22,37,16,35,4,8,9,38,72
2005-04-04 00:00:00.000,Casablanca Morocco ATP World Tour,CLAY,2,Mariano Puerta,Nicolas Almagro,Mariano Puerta,6-3; 7-6(2),R16,83,2,0,49,70,39,49,12,21,2,2,11,51,70,7,3,36,61,28,36,12,25,3,4,10,40,61
2005-04-04 00:00:00.000,Casablanca Morocco ATP World Tour,CLAY,2,Arnaud Clement,Marc Gicquel,Arnaud Clement,6-4; 6-4,R16,103,7,1,37,73,31,37,12,36,4,7,10,43,73,2,1,37,67,21,37,13,30,7,12,10,34,67
2005-04-04 00:00:00.000,Casablanca Morocco ATP World Tour,CLAY,2,Gilles Muller,Janko Tipsarevic,Gilles Muller,6-3; 6-4,R16,68,8,3,39,61,31,39,13,22,4,4,10,44,61,1,1,22,48,17,22,14,26,0,2,9,31,48
2005-04-04 00:00:00.000,Casablanca Morocco ATP World Tour,CLAY,2,Filippo Volandri,Jarkko Nieminen,Filippo Volandri,3-6; 6-1; 6-4,R16,119,0,1,53,80,32,53,14,27,3,7,13,46,80,1,2,59,89,38,59,9,30,7,13,13,47,89
2005-04-04 00:00:00.000,Casablanca Morocco ATP World Tour,CLAY,2,Tomas Zib,Christophe Rochus,Tomas Zib,6-1; 7-6(7),Q,102,5,1,44,75,33,44,17,31,10,12,10,50,75,3,1,43,71,28,43,8,28,1,5,9,36,71
2005-04-04 00:00:00.000,Casablanca Morocco ATP World Tour,CLAY,2,Juan Monaco,Gilles Simon,Juan Monaco,4-6; 6-2; 7-5,Q,131,2,1,73,101,47,73,16,28,8,11,15,63,101,1,0,49,82,33,49,17,33,2,7,15,50,82
2005-04-04 00:00:00.000,Casablanca Morocco ATP World Tour,CLAY,2,Mariano Puerta,Arnaud Clement,Mariano Puerta,4-6; 6-1; 6-2,Q,112,9,1,42,66,35,42,16,24,1,2,13,51,66,13,4,49,88,29,49,22,39,9,13,12,51,88
2005-04-04 00:00:00.000,Casablanca Morocco ATP World Tour,CLAY,2,Filippo Volandri,Gilles Muller,Filippo Volandri,7-6(0); 6-1,Q,93,2,2,47,63,37,47,10,16,4,4,10,47,63,2,4,56,89,36,56,13,33,14,16,9,49,89
2005-04-04 00:00:00.000,Casablanca Morocco ATP World Tour,CLAY,2,Juan Monaco,Tomas Zib,Juan Monaco,6-2; 6-4,S,93,1,1,27,46,22,27,10,19,0,1,9,32,46,0,0,46,74,26,46,13,28,9,13,9,39,74
2005-04-04 00:00:00.000,Casablanca Morocco ATP World Tour,CLAY,2,Mariano Puerta,Filippo Volandri,Mariano Puerta,6-3; 7-6(6),S,131,7,2,42,68,26,42,18,26,3,6,11,44,68,1,2,49,80,27,49,16,31,6,10,10,43,80
2005-04-04 00:00:00.000,Casablanca Morocco ATP World Tour,CLAY,2,Mariano Puerta,Juan Monaco,Mariano Puerta,6-4; 6-1,F,78,0,2,42,59,28,42,11,17,6,7,9,39,59,1,1,31,44,17,31,6,13,2,6,8,23,44
2005-04-04 00:00:00.000,Valencia Spain ATP World Tour,CLAY,2,Albert Costa,Nikolay Davydenko,Albert Costa,7-6(2); 1-6; 6-3,R32,128,1,0,64,84,40,64,15,20,2,6,14,55,84,2,3,59,80,37,59,14,21,2,5,14,51,80
2005-04-04 00:00:00.000,Valencia Spain ATP World Tour,CLAY,2,Stefan Koubek,Israel Matos Gil,Stefan Koubek,6-1; 6-3,R32,71,3,1,37,60,23,37,18,23,5,5,8,41,60,1,1,41,59,25,41,6,18,4,8,8,31,59
2005-04-04 00:00:00.000,Valencia Spain ATP World Tour,CLAY,2,Federico Luzzi,Alex Corretja,Federico Luzzi,7-6(5); 7-6(8),R32,142,6,1,57,97,42,57,14,40,8,12,12,56,97,0,2,72,85,46,72,3,13,5,9,12,49,85
2005-04-04 00:00:00.000,Valencia Spain ATP World Tour,CLAY,2,Fernando Verdasco,Michael Berrer,Fernando Verdasco,6-1; 6-1,R32,70,4,1,32,43,24,32,8,11,2,2,7,32,43,0,2,29,43,14,29,5,14,1,6,7,19,43
2005-04-04 00:00:00.000,Valencia Spain ATP World Tour,CLAY,2,Gustavo Kuerten,Olivier Rochus,Gustavo Kuerten,6-2; 6-4,R32,66,6,0,28,50,22,28,13,22,4,5,9,35,50,2,2,33,57,22,33,8,24,4,8,9,30,57
2005-04-04 00:00:00.000,Valencia Spain ATP World Tour,CLAY,2,Alberto Martin,Albert Montanes,Alberto Martin,6-7(5); 6-4; 6-2,R32,147,3,3,66,113,45,66,26,47,13,15,15,71,113,2,1,65,101,42,65,17,36,4,9,15,59,101
2005-04-04 00:00:00.000,Valencia Spain ATP World Tour,CLAY,2,Irakli Labadze,Ivo Karlovic,Irakli Labadze,7-6(3); 6-2,R32,86,4,3,58,79,38,58,15,21,3,3,10,53,79,10,8,32,67,25,32,14,35,3,5,10,39,67
2005-04-04 00:00:00.000,Valencia Spain ATP World Tour,CLAY,2,David Ferrer,Julien Benneteau,David Ferrer,6-4; 6-1,R32,86,2,1,34,53,24,34,8,19,2,5,9,32,53,1,3,33,65,16,33,13,32,5,11,8,29,65
2005-04-04 00:00:00.000,Valencia Spain ATP World Tour,CLAY,2,Igor Andreev,Fernando Vicente,Igor Andreev,6-4; 7-5,R32,95,2,3,47,69,34,47,8,22,4,7,11,42,69,1,2,45,75,25,45,14,30,4,9,11,39,75
2005-04-04 00:00:00.000,Valencia Spain ATP World Tour,CLAY,2,Potito Starace,Alex Calatrava,Potito Starace,7-5; 7-5,R32,97,2,1,53,66,38,53,4,13,3,6,12,42,66,3,1,50,76,35,50,7,26,4,9,12,42,76
2005-04-04 00:00:00.000,Valencia Spain ATP World Tour,CLAY,2,Guillermo Garcia-Lopez,Philipp Kohlschreiber,Guillermo Garcia-Lopez,6-4; 6-2,R32,74,1,2,35,58,24,35,16,23,4,4,9,40,58,1,2,27,54,18,27,14,27,2,5,9,32,54
2005-04-04 00:00:00.000,Valencia Spain ATP World Tour,CLAY,2,Rafael Nadal,Juan Carlos Ferrero,Rafael Nadal,6-2; 6-1,R32,58,3,0,23,36,21,23,8,13,0,0,7,29,36,0,1,30,48,16,30,6,18,3,8,8,22,48
2005-04-04 00:00:00.000,Valencia Spain ATP World Tour,CLAY,2,Ivan Navarro,Kenneth Carlsen,Ivan Navarro,6-4; 6-3,R32,110,5,3,33,55,27,33,14,22,4,4,9,41,55,1,1,45,80,31,45,14,35,4,7,10,45,80
2005-04-04 00:00:00.000,Valencia Spain ATP World Tour,CLAY,2,Antony Dupuis,Novak Djokovic,Antony Dupuis,6-4; 7-5,R32,96,2,1,34,68,23,34,18,34,5,8,11,41,68,2,4,41,69,29,41,7,28,5,10,11,36,69
2005-04-04 00:00:00.000,Valencia Spain ATP World Tour,CLAY,2,Felix Mantilla,Oscar Hernandez,Felix Mantilla,6-0; 6-2,R32,66,1,2,22,43,19,22,9,21,4,5,7,28,43,1,1,35,52,17,35,3,17,3,9,7,20,52
2005-04-04 00:00:00.000,Valencia Spain ATP World Tour,CLAY,2,Fernando Gonzalez,Bjorn Phau,Fernando Gonzalez,6-3; 7-6(3),R32,89,2,1,40,68,29,40,18,28,3,5,11,47,68,2,3,40,66,27,40,11,26,2,5,10,38,66
2005-04-04 00:00:00.000,Valencia Spain ATP World Tour,CLAY,2,Albert Costa,Stefan Koubek,Albert Costa,6-4; 6-2,R16,86,0,2,48,66,36,48,9,18,5,5,9,45,66,0,0,38,56,22,38,9,18,2,5,9,31,56
2005-04-04 00:00:00.000,Valencia Spain ATP World Tour,CLAY,2,Fernando Verdasco,Federico Luzzi,Fernando Verdasco,6-2; 6-0,R16,42,4,2,26,34,24,26,4,8,0,0,7,28,34,1,3,23,39,13,23,2,16,1,6,7,15,39
2005-04-04 00:00:00.000,Valencia Spain ATP World Tour,CLAY,2,Alberto Martin,Gustavo Kuerten,Alberto Martin,6-2; 6-0,R16,51,3,1,18,38,14,18,15,20,0,0,7,29,38,1,4,17,34,11,17,2,17,0,5,7,13,34
2005-04-04 00:00:00.000,Valencia Spain ATP World Tour,CLAY,2,David Ferrer,Irakli Labadze,David Ferrer,6-3; 6-4,R16,87,3,0,41,54,29,41,9,13,4,5,9,38,54,0,3,45,74,29,45,12,29,4,8,10,41,74
2005-04-04 00:00:00.000,Valencia Spain ATP World Tour,CLAY,2,Igor Andreev,Potito Starace,Igor Andreev,7-5; 6-1,R16,80,2,0,31,54,23,31,15,23,3,4,9,38,54,2,0,49,72,23,49,13,23,6,11,10,36,72
2005-04-04 00:00:00.000,Valencia Spain ATP World Tour,CLAY,2,Rafael Nadal,Guillermo Garcia-Lopez,Rafael Nadal,6-1; 6-4,R16,84,5,0,54,75,37,54,10,21,6,7,9,47,75,0,1,32,48,18,32,5,16,0,4,8,23,48
2005-04-04 00:00:00.000,Valencia Spain ATP World Tour,CLAY,2,Ivan Navarro,Antony Dupuis,Ivan Navarro,1-6; 6-4; 6-3,R16,113,5,5,63,85,38,63,8,22,6,11,13,46,85,8,2,43,78,26,43,18,35,3,8,13,44,78
2005-04-04 00:00:00.000,Valencia Spain ATP World Tour,CLAY,2,Fernando Gonzalez,Felix Mantilla,Fernando Gonzalez,6-4; 6-1,R16,67,2,1,18,40,15,18,18,22,0,0,8,33,40,1,2,29,58,17,29,14,29,4,8,9,31,58
2005-04-04 00:00:00.000,Valencia Spain ATP World Tour,CLAY,2,Albert Costa,Fernando Verdasco,Albert Costa,6-7(4); 7-5; 6-1,Q,153,3,3,56,85,44,56,20,29,0,1,16,64,85,2,3,81,113,53,81,15,32,7,11,15,68,113
2005-04-04 00:00:00.000,Valencia Spain ATP World Tour,CLAY,2,David Ferrer,Alberto Martin,David Ferrer,6-1; 6-4,Q,71,0,0,39,59,23,39,16,20,2,3,9,39,59,0,5,25,45,14,25,9,20,2,6,8,23,45
2005-04-04 00:00:00.000,Valencia Spain ATP World Tour,CLAY,2,Igor Andreev,Rafael Nadal,Igor Andreev,7-5; 6-2,Q,100,0,0,34,63,23,34,13,29,6,9,10,36,63,1,3,48,70,26,48,8,22,7,13,10,34,70
2005-04-04 00:00:00.000,Valencia Spain ATP World Tour,CLAY,2,Ivan Navarro,Fernando Gonzalez,Ivan Navarro,6-7(5); 6-4; 6-4,Q,143,7,3,49,98,36,49,34,49,3,3,16,70,98,2,4,76,109,52,76,20,33,6,8,16,72,109
2005-04-04 00:00:00.000,Valencia Spain ATP World Tour,CLAY,2,David Ferrer,Albert Costa,David Ferrer,6-3; 6-3,S,92,2,0,35,51,24,35,12,16,2,3,9,36,51,0,2,57,75,32,57,6,18,11,15,9,38,75
2005-04-04 00:00:00.000,Valencia Spain ATP World Tour,CLAY,2,Igor Andreev,Ivan Navarro,Igor Andreev,7-6(3); 6-2,S,108,0,1,54,68,36,54,8,14,2,4,10,44,68,5,4,45,83,26,45,19,38,11,15,10,45,83
2005-04-04 00:00:00.000,Valencia Spain ATP World Tour,CLAY,2,Igor Andreev,David Ferrer,Igor Andreev,6-3; 5-7; 6-3,F,129,1,1,56,89,34,56,16,33,5,11,15,50,89,1,5,64,99,35,64,15,35,5,13,15,50,99
2005-04-11 00:00:00.000,ATP Masters Series Monte Carlo Monaco ATP World Tour,CLAY,2,Roger Federer,Greg Rusedski,Roger Federer,6-3; 6-1,R64,63,0,1,28,46,20,28,11,18,0,1,8,31,46,2,4,30,58,14,30,12,28,6,11,8,26,58
2005-04-11 00:00:00.000,ATP Masters Series Monte Carlo Monaco ATP World Tour,CLAY,2,Albert Montanes,Younes El Aynaoui,Albert Montanes,6-1; 6-3,R64,56,1,0,38,52,26,38,8,14,3,4,8,34,52,1,3,28,49,15,28,6,21,4,9,8,21,49
2005-04-11 00:00:00.000,ATP Masters Series Monte Carlo Monaco ATP World Tour,CLAY,2,Fernando Gonzalez,Fernando Verdasco,Fernando Gonzalez,6-4; 7-5,R64,76,6,3,35,63,29,35,18,28,1,1,11,47,63,2,4,48,67,34,48,9,19,2,4,11,43,67
2005-04-11 00:00:00.000,ATP Masters Series Monte Carlo Monaco ATP World Tour,CLAY,2,Mario Ancic,Gustavo Kuerten,Mario Ancic,7-5; 6-2,R64,93,6,1,30,60,22,30,21,30,0,0,10,43,60,4,4,33,67,20,33,19,34,5,8,10,39,67
2005-04-11 00:00:00.000,ATP Masters Series Monte Carlo Monaco ATP World Tour,CLAY,2,Nikolay Davydenko,Jurgen Melzer,Nikolay Davydenko,5-7; 6-1; 6-3,R64,116,6,2,52,78,34,52,17,26,0,2,14,51,78,5,2,57,102,35,57,19,45,3,8,14,54,102
2005-04-11 00:00:00.000,ATP Masters Series Monte Carlo Monaco ATP World Tour,CLAY,2,Albert Costa,Michael Llodra,Albert Costa,7-6(5); 6-2,R64,91,1,0,49,61,30,49,7,12,1,4,10,37,61,2,1,55,79,29,55,12,24,5,10,10,41,79
2005-04-11 00:00:00.000,ATP Masters Series Monte Carlo Monaco ATP World Tour,CLAY,2,Richard Gasquet,Guillermo Garcia-Lopez,Richard Gasquet,6-2; 6-0,R64,51,4,3,18,36,13,18,12,18,0,1,7,25,36,0,5,24,43,11,24,4,19,2,8,7,15,43
2005-04-11 00:00:00.000,ATP Masters Series Monte Carlo Monaco ATP World Tour,CLAY,2,Felix Mantilla,Joachim Johansson,Felix Mantilla,2-6; 6-3; 6-2,R64,81,3,4,59,77,42,59,6,18,1,4,13,48,77,8,5,47,75,30,47,11,28,3,7,12,41,75
2005-04-11 00:00:00.000,ATP Masters Series Monte Carlo Monaco ATP World Tour,CLAY,2,Gaston Gaudio,Christophe Rochus,Gaston Gaudio,7-6(3); 6-2,R64,89,4,4,36,63,24,36,13,27,1,4,10,37,63,0,1,42,73,26,42,10,31,5,10,10,36,73
2005-04-11 00:00:00.000,ATP Masters Series Monte Carlo Monaco ATP World Tour,CLAY,2,Nicolas Kiefer,Rainer Schuettler,Nicolas Kiefer,6-2; 2-6; 6-1,R64,109,2,1,35,70,25,35,17,35,3,6,11,42,70,1,6,45,74,24,45,13,29,3,9,12,37,74
2005-04-11 00:00:00.000,ATP Masters Series Monte Carlo Monaco ATP World Tour,CLAY,2,Victor Hanescu,Agustin Calleri,Victor Hanescu,6-2; 6-3,R64,69,2,1,40,54,31,40,8,14,2,2,9,39,54,3,1,30,59,19,30,13,29,3,6,8,32,59
2005-04-11 00:00:00.000,ATP Masters Series Monte Carlo Monaco ATP World Tour,CLAY,2,Radek Stepanek,Vincent Spadea,Radek Stepanek,6-0; 7-5,R64,80,3,0,33,60,22,33,15,27,4,6,9,37,60,0,5,30,58,14,30,11,28,5,11,9,25,58
2005-04-11 00:00:00.000,ATP Masters Series Monte Carlo Monaco ATP World Tour,CLAY,2,Rafael Nadal,Gael Monfils,Rafael Nadal,6-3; 6-2,R64,84,0,0,38,55,24,38,9,17,4,6,9,33,55,1,0,27,52,15,27,8,25,3,8,8,23,52
2005-04-11 00:00:00.000,ATP Masters Series Monte Carlo Monaco ATP World Tour,CLAY,2,Xavier Malisse,Juan Ignacio Chela,Xavier Malisse,6-2; 7-5,R64,89,4,0,32,65,23,32,16,33,3,5,10,39,65,0,1,38,56,23,38,6,18,3,8,10,29,56
2005-04-11 00:00:00.000,ATP Masters Series Monte Carlo Monaco ATP World Tour,CLAY,2,Tomas Berdych,Luis Horna,Tomas Berdych,4-6; 7-6(3); 7-6(1),R64,154,15,8,64,110,53,64,17,46,3,7,17,70,110,4,3,85,115,52,85,20,30,6,9,17,72,115
2005-04-11 00:00:00.000,ATP Masters Series Monte Carlo Monaco ATP World Tour,CLAY,2,Olivier Rochus,Ivan Ljubicic,Olivier Rochus,6-2; 6-2,R64,82,3,0,29,54,19,29,19,25,1,1,8,38,54,9,2,32,63,21,32,10,31,1,5,8,31,63
2005-04-11 00:00:00.000,ATP Masters Series Monte Carlo Monaco ATP World Tour,CLAY,2,Guillermo Coria,Paul-Henri Mathieu,Guillermo Coria,6-2; 7-5,R64,95,0,7,49,65,32,49,5,16,1,4,10,37,65,1,3,32,62,16,32,13,30,1,7,10,29,62
2005-04-11 00:00:00.000,ATP Masters Series Monte Carlo Monaco ATP World Tour,CLAY,2,Thierry Ascione,Karol Beck,Thierry Ascione,6-3; 7-5,R64,102,0,3,45,78,32,45,19,33,5,6,11,51,78,5,7,30,63,19,30,17,33,4,7,10,36,63
2005-04-11 00:00:00.000,ATP Masters Series Monte Carlo Monaco ATP World Tour,CLAY,2,Alberto Martin,Potito Starace,Alberto Martin,6-3; 7-5,R64,89,0,3,27,63,17,27,22,36,2,4,10,39,63,0,2,58,76,32,58,8,18,7,12,11,40,76
2005-04-11 00:00:00.000,ATP Masters Series Monte Carlo Monaco ATP World Tour,CLAY,2,Jean-Rene Lisnard,Thomas Johansson,Jean-Rene Lisnard,4-6; 6-4; 6-2,R64,123,3,1,39,83,25,39,25,44,6,10,14,50,83,4,4,46,92,30,46,18,46,9,15,14,48,92
2005-04-11 00:00:00.000,ATP Masters Series Monte Carlo Monaco ATP World Tour,CLAY,2,David Ferrer,Dominik Hrbaty,David Ferrer,6-4; 6-3,R64,83,0,2,48,68,27,48,14,20,6,8,10,41,68,1,1,26,51,12,26,18,25,0,4,9,30,51
2005-04-11 00:00:00.000,ATP Masters Series Monte Carlo Monaco ATP World Tour,CLAY,2,Andreas Seppi,Feliciano Lopez,Andreas Seppi,6-3; 6-4,R64,78,1,0,30,47,21,30,11,17,2,2,7,32,47,2,3,31,51,21,31,8,20,5,7,7,29,51
2005-04-11 00:00:00.000,ATP Masters Series Monte Carlo Monaco ATP World Tour,CLAY,2,Fabrice Santoro,Robin Soderling,Fabrice Santoro,7-6(3); 7-5,R64,112,1,2,42,88,28,42,25,46,2,5,12,53,88,5,5,60,91,37,60,13,31,9,13,12,50,91
2005-04-11 00:00:00.000,ATP Masters Series Monte Carlo Monaco ATP World Tour,CLAY,2,Mariano Zabaleta,Tim Henman,Mariano Zabaleta,6-4; 4-6; 6-2,R64,178,0,8,49,97,33,49,29,48,11,13,14,62,97,7,7,59,109,39,59,23,50,10,14,14,62,109
2005-04-11 00:00:00.000,ATP Masters Series Monte Carlo Monaco ATP World Tour,CLAY,2,Mariano Puerta,Carlos Moya,Mariano Puerta,7-6(10); 1-6; 6-3,R64,0,0,3,60,109,37,60,27,49,3,6,14,64,109,12,2,65,105,46,65,22,40,4,6,14,68,105
2005-04-11 00:00:00.000,ATP Masters Series Monte Carlo Monaco ATP World Tour,CLAY,2,Florian Mayer,Julien Benneteau,Florian Mayer,6-3; 6-3,R64,76,2,1,34,52,22,34,10,18,4,6,9,32,52,3,3,40,68,22,40,10,28,8,13,9,32,68
2005-04-11 00:00:00.000,ATP Masters Series Monte Carlo Monaco ATP World Tour,CLAY,2,Filippo Volandri,Wayne Arthurs,Filippo Volandri,7-5; 6-2,R64,66,1,1,45,59,32,45,10,14,4,5,10,42,59,4,5,27,56,18,27,13,29,1,5,10,31,56
2005-04-11 00:00:00.000,ATP Masters Series Monte Carlo Monaco ATP World Tour,CLAY,2,Guillermo Canas,Igor Andreev,Guillermo Canas,7-6(10); 6-1,R64,114,1,4,44,74,32,44,16,30,6,7,9,48,74,0,1,44,70,22,44,15,26,2,6,10,37,70
2005-04-11 00:00:00.000,ATP Masters Series Monte Carlo Monaco ATP World Tour,CLAY,2,Jiri Novak,Max Mirnyi,Jiri Novak,3-6; 6-4; 6-3,R64,138,3,3,81,112,51,81,17,31,10,12,14,68,112,2,4,66,113,47,66,19,47,14,17,14,66,113
2005-04-11 00:00:00.000,ATP Masters Series Monte Carlo Monaco ATP World Tour,CLAY,2,Juan Carlos Ferrero,Ivo Karlovic,Juan Carlos Ferrero,6-4; 6-1,R64,54,3,0,30,39,26,30,7,9,0,0,8,33,39,7,5,33,57,23,33,7,24,3,7,9,30,57
2005-04-11 00:00:00.000,ATP Masters Series Monte Carlo Monaco ATP World Tour,CLAY,2,Cyril Saulnier,Paradorn Srichaphan,Cyril Saulnier,6-2; 6-4,R64,88,9,2,36,62,29,36,11,26,0,1,9,40,62,4,3,38,66,24,38,10,28,10,14,9,34,66
2005-04-11 00:00:00.000,ATP Masters Series Monte Carlo Monaco ATP World Tour,CLAY,2,Marat Safin,Hyung-Taik Lee,Marat Safin,6-0; 7-5,R64,64,8,1,31,49,26,31,12,18,4,4,9,38,49,0,3,39,59,22,39,10,20,6,10,9,32,59
2005-04-11 00:00:00.000,ATP Masters Series Monte Carlo Monaco ATP World Tour,CLAY,2,Roger Federer,Albert Montanes,Roger Federer,6-3; 6-4,R32,60,4,3,39,62,26,39,15,23,5,6,10,41,62,5,2,33,48,20,33,9,15,1,4,9,29,48
2005-04-11 00:00:00.000,ATP Masters Series Monte Carlo Monaco ATP World Tour,CLAY,2,Fernando Gonzalez,Mario Ancic,Fernando Gonzalez,6-2; 7-6(4),R32,99,0,6,36,65,29,36,11,29,4,7,10,40,65,5,0,48,76,27,48,9,28,6,11,10,36,76
2005-04-11 00:00:00.000,ATP Masters Series Monte Carlo Monaco ATP World Tour,CLAY,2,Nikolay Davydenko,Albert Costa,Nikolay Davydenko,7-6(2); 6-3,R32,110,1,1,51,62,32,51,9,11,3,5,10,41,62,2,5,53,83,27,53,17,30,6,10,11,44,83
2005-04-11 00:00:00.000,ATP Masters Series Monte Carlo Monaco ATP World Tour,CLAY,2,Richard Gasquet,Felix Mantilla,Richard Gasquet,7-5; 6-1,R32,82,4,3,29,60,22,29,18,31,4,5,9,40,60,0,0,35,58,21,35,9,23,0,5,10,30,58
2005-04-11 00:00:00.000,ATP Masters Series Monte Carlo Monaco ATP World Tour,CLAY,2,Gaston Gaudio,Nicolas Kiefer,Gaston Gaudio,7-5; 5-2 RET,R32,102,1,7,45,67,29,45,7,22,5,8,9,36,67,6,2,31,65,20,31,10,34,7,13,10,30,65
2005-04-11 00:00:00.000,ATP Masters Series Monte Carlo Monaco ATP World Tour,CLAY,2,Victor Hanescu,Radek Stepanek,Victor Hanescu,6-3; 2-6; 6-0,R32,110,0,1,50,79,32,50,17,29,7,10,12,49,79,4,1,44,78,27,44,15,34,8,13,11,42,78
2005-04-11 00:00:00.000,ATP Masters Series Monte Carlo Monaco ATP World Tour,CLAY,2,Rafael Nadal,Xavier Malisse,Rafael Nadal,6-0; 6-3,R32,62,0,0,28,43,22,28,12,15,1,1,8,34,43,1,2,20,36,11,20,6,16,0,4,7,17,36
2005-04-11 00:00:00.000,ATP Masters Series Monte Carlo Monaco ATP World Tour,CLAY,2,Olivier Rochus,Tomas Berdych,Olivier Rochus,7-6(4); 3-6; 6-2,R32,130,1,7,43,86,30,43,26,43,5,8,14,56,86,6,4,57,103,38,57,22,46,5,9,15,60,103
2005-04-11 00:00:00.000,ATP Masters Series Monte Carlo Monaco ATP World Tour,CLAY,2,Guillermo Coria,Thierry Ascione,Guillermo Coria,6-2; 6-1,R32,64,2,2,26,40,20,26,7,14,0,1,7,27,40,1,0,37,56,17,37,6,19,2,8,8,23,56
2005-04-11 00:00:00.000,ATP Masters Series Monte Carlo Monaco ATP World Tour,CLAY,2,Alberto Martin,Jean-Rene Lisnard,Alberto Martin,6-1; 6-2,R32,82,2,6,27,63,25,27,15,36,2,2,8,40,63,0,5,23,62,12,23,18,39,9,13,7,30,62
2005-04-11 00:00:00.000,ATP Masters Series Monte Carlo Monaco ATP World Tour,CLAY,2,David Ferrer,Andreas Seppi,David Ferrer,6-3; 6-3,R32,80,1,1,34,49,23,34,9,15,4,6,9,32,49,1,5,37,73,22,37,13,36,5,10,9,35,73
2005-04-11 00:00:00.000,ATP Masters Series Monte Carlo Monaco ATP World Tour,CLAY,2,Mariano Zabaleta,Fabrice Santoro,Mariano Zabaleta,6-7(1); 6-3; 6-4,R32,161,1,9,56,109,34,56,25,53,13,19,16,59,109,2,0,62,102,33,62,19,40,8,16,15,52,102
2005-04-11 00:00:00.000,ATP Masters Series Monte Carlo Monaco ATP World Tour,CLAY,2,Mariano Puerta,Florian Mayer,Mariano Puerta,6-2; 6-1,R32,55,4,3,25,48,20,25,14,23,0,0,8,34,48,4,2,34,48,21,34,3,14,5,9,7,24,48
2005-04-11 00:00:00.000,ATP Masters Series Monte Carlo Monaco ATP World Tour,CLAY,2,Filippo Volandri,Guillermo Canas,Filippo Volandri,6-4; 2-6; 6-3,R32,129,0,1,59,87,39,59,11,28,2,6,13,50,87,4,6,55,95,35,55,18,40,9,14,14,53,95
2005-04-11 00:00:00.000,ATP Masters Series Monte Carlo Monaco ATP World Tour,CLAY,2,Juan Carlos Ferrero,Jiri Novak,Juan Carlos Ferrero,3-6; 6-3; 6-2,R32,104,1,0,53,81,37,53,17,28,2,3,13,54,81,5,1,58,82,39,58,10,24,3,6,13,49,82
2005-04-11 00:00:00.000,ATP Masters Series Monte Carlo Monaco ATP World Tour,CLAY,2,Marat Safin,Cyril Saulnier,Marat Safin,6-3; 6-1,R32,63,5,0,27,48,23,27,13,21,5,5,8,36,48,1,3,24,48,12,24,14,24,3,7,8,26,48
2005-04-11 00:00:00.000,ATP Masters Series Monte Carlo Monaco ATP World Tour,CLAY,2,Roger Federer,Fernando Gonzalez,Roger Federer,6-2; 6-7(3); 6-4,R16,141,9,0,52,93,42,52,24,41,7,8,15,66,93,6,6,76,124,53,76,19,48,7,11,15,72,124
2005-04-11 00:00:00.000,ATP Masters Series Monte Carlo Monaco ATP World Tour,CLAY,2,Richard Gasquet,Nikolay Davydenko,Richard Gasquet,4-6; 7-5; 6-2,R16,144,2,7,43,86,31,43,23,43,3,7,15,54,86,1,5,64,101,34,64,20,37,6,12,15,54,101
2005-04-11 00:00:00.000,ATP Masters Series Monte Carlo Monaco ATP World Tour,CLAY,2,Gaston Gaudio,Victor Hanescu,Gaston Gaudio,6-2; 6-0,R16,56,2,1,23,39,19,23,11,16,1,1,7,30,39,1,0,34,39,14,34,1,5,5,10,7,15,39
2005-04-11 00:00:00.000,ATP Masters Series Monte Carlo Monaco ATP World Tour,CLAY,2,Rafael Nadal,Olivier Rochus,Rafael Nadal,6-1; 6-2,R16,64,0,1,28,38,22,28,6,10,2,3,7,28,38,0,2,25,49,10,25,10,24,3,9,8,20,49
2005-04-11 00:00:00.000,ATP Masters Series Monte Carlo Monaco ATP World Tour,CLAY,2,Guillermo Coria,Alberto Martin,Guillermo Coria,7-6(0); 6-1,R16,103,0,1,35,53,26,35,7,18,1,3,9,33,53,0,2,35,76,20,35,17,41,6,11,10,37,76
2005-04-11 00:00:00.000,ATP Masters Series Monte Carlo Monaco ATP World Tour,CLAY,2,David Ferrer,Mariano Zabaleta,David Ferrer,3-6; 1-0 RET,R16,45,1,0,19,26,14,19,4,7,0,1,5,18,26,0,2,22,37,14,22,11,15,1,1,5,25,37
2005-04-11 00:00:00.000,ATP Masters Series Monte Carlo Monaco ATP World Tour,CLAY,2,Filippo Volandri,Mariano Puerta,Filippo Volandri,6-7(6); 7-6(3); 6-4,R16,169,1,2,71,105,44,71,25,34,1,5,17,69,105,2,1,70,119,45,70,27,49,6,11,17,72,119
2005-04-11 00:00:00.000,ATP Masters Series Monte Carlo Monaco ATP World Tour,CLAY,2,Juan Carlos Ferrero,Marat Safin,Juan Carlos Ferrero,6-2; 6-4,R16,98,0,1,46,66,29,46,11,20,6,8,9,40,66,6,3,44,70,26,44,7,26,4,9,9,33,70
2005-04-11 00:00:00.000,ATP Masters Series Monte Carlo Monaco ATP World Tour,CLAY,2,Richard Gasquet,Roger Federer,Richard Gasquet,6-7(1); 6-2; 7-6(8),Q,140,1,3,64,113,37,64,27,49,4,8,16,64,113,4,1,69,112,45,69,19,43,2,8,16,64,112
2005-04-11 00:00:00.000,ATP Masters Series Monte Carlo Monaco ATP World Tour,CLAY,2,Rafael Nadal,Gaston Gaudio,Rafael Nadal,6-3; 6-0,Q,62,2,1,34,40,28,34,4,6,0,0,8,32,40,1,4,26,42,13,26,6,16,1,5,7,19,42
2005-04-11 00:00:00.000,ATP Masters Series Monte Carlo Monaco ATP World Tour,CLAY,2,Guillermo Coria,David Ferrer,Guillermo Coria,3-6; 6-4; 6-3,Q,120,2,2,53,81,35,53,15,28,3,7,14,50,81,1,2,61,84,39,61,7,23,2,7,14,46,84
2005-04-11 00:00:00.000,ATP Masters Series Monte Carlo Monaco ATP World Tour,CLAY,2,Juan Carlos Ferrero,Filippo Volandri,Juan Carlos Ferrero,6-2; 6-3,Q,74,0,0,40,54,23,40,8,14,6,9,8,31,54,0,2,33,52,15,33,2,19,3,10,9,17,52
2005-04-11 00:00:00.000,ATP Masters Series Monte Carlo Monaco ATP World Tour,CLAY,2,Rafael Nadal,Richard Gasquet,Rafael Nadal,6-7(6); 6-4; 6-3,S,165,2,3,79,112,44,79,16,33,9,14,16,60,112,2,1,57,115,31,57,27,58,5,12,15,58,115
2005-04-11 00:00:00.000,ATP Masters Series Monte Carlo Monaco ATP World Tour,CLAY,2,Guillermo Coria,Juan Carlos Ferrero,Guillermo Coria,6-2; 7-5,S,94,3,2,42,58,29,42,7,16,2,4,10,36,58,0,0,45,60,20,45,8,15,5,10,10,28,60
2005-04-11 00:00:00.000,ATP Masters Series Monte Carlo Monaco ATP World Tour,CLAY,2,Rafael Nadal,Guillermo Coria,Rafael Nadal,6-3; 6-1; 0-6; 7-5,F,189,3,0,89,120,52,89,17,31,11,16,17,69,120,1,3,65,110,40,65,17,45,13,20,17,57,110
2005-04-18 00:00:00.000,Barcelona Spain ATP World Tour,CLAY,2,Marat Safin,N/A Bye,Marat Safin,,R64,0,0,0,0,0,0,0,0,0,0,0,0,0,0,0,0,0,0,0,0,0,0,0,0,0,0,0
2005-04-18 00:00:00.000,Barcelona Spain ATP World Tour,CLAY,2,Jose Acasuso,Fernando Vicente,Jose Acasuso,7-5; 6-4,R64,95,5,1,47,74,33,47,16,27,4,5,11,49,74,3,1,39,80,23,39,23,41,8,11,11,46,80
2005-04-18 00:00:00.000,Barcelona Spain ATP World Tour,CLAY,2,Stanislas Wawrinka,Guillermo Garcia-Lopez,Stanislas Wawrinka,6-3; 6-1,R64,59,5,2,22,42,20,22,13,20,0,0,8,33,42,1,2,38,54,19,38,8,16,7,11,8,27,54
2005-04-18 00:00:00.000,Barcelona Spain ATP World Tour,CLAY,2,Paradorn Srichaphan,Kenneth Carlsen,Paradorn Srichaphan,6-2; 6-1,R64,68,0,1,27,45,20,27,11,18,1,2,8,31,45,4,2,30,60,18,30,9,30,7,12,7,27,60
2005-04-18 00:00:00.000,Barcelona Spain ATP World Tour,CLAY,2,Radek Stepanek,Irakli Labadze,Radek Stepanek,4-6; 6-2; 7-5,R64,137,9,5,55,93,40,55,18,38,2,5,15,58,93,6,7,71,104,45,71,14,33,7,12,15,59,104
2005-04-18 00:00:00.000,Barcelona Spain ATP World Tour,CLAY,2,Santiago Ventura,Galo Blanco,Santiago Ventura,6-3; 6-3,R64,72,3,1,40,67,32,40,11,27,7,8,9,43,67,3,1,34,48,23,34,3,14,3,7,9,26,48
2005-04-18 00:00:00.000,Barcelona Spain ATP World Tour,CLAY,2,Wayne Arthurs,Ruben Ramirez Hidalgo,Wayne Arthurs,6-4; 6-3,R64,71,11,4,28,51,23,28,14,23,0,0,9,37,51,0,1,43,60,28,43,7,17,0,3,10,35,60
2005-04-18 00:00:00.000,Barcelona Spain ATP World Tour,CLAY,2,Guillermo Canas,N/A Bye,Guillermo Canas,,R64,0,0,0,0,0,0,0,0,0,0,0,0,0,0,0,0,0,0,0,0,0,0,0,0,0,0,0
2005-04-18 00:00:00.000,Barcelona Spain ATP World Tour,CLAY,2,Guillermo Coria,N/A Bye,Guillermo Coria,,R64,0,0,0,0,0,0,0,0,0,0,0,0,0,0,0,0,0,0,0,0,0,0,0,0,0,0,0
2005-04-18 00:00:00.000,Barcelona Spain ATP World Tour,CLAY,2,Peter Wessels,Cyril Saulnier,Peter Wessels,6-3; 6-3,R64,58,6,1,32,43,28,32,8,11,0,0,9,36,43,7,1,39,58,26,39,8,19,4,7,9,34,58
2005-04-18 00:00:00.000,Barcelona Spain ATP World Tour,CLAY,2,Agustin Calleri,Gael Monfils,Agustin Calleri,7-6(2); 7-6(2),R64,127,0,5,47,82,33,47,19,35,2,5,12,52,82,4,7,54,101,34,54,21,47,7,10,12,55,101
2005-04-18 00:00:00.000,Barcelona Spain ATP World Tour,CLAY,2,Juan Ignacio Chela,Albert Portas,Juan Ignacio Chela,6-4; 7-6(2),R64,102,3,3,46,67,34,46,13,21,3,4,11,47,67,3,1,40,63,26,40,15,23,2,4,11,41,63
2005-04-18 00:00:00.000,Barcelona Spain ATP World Tour,CLAY,2,Dominik Hrbaty,Jerome Haehnel,Dominik Hrbaty,6-1; 6-1,R64,52,10,2,35,56,25,35,11,21,7,7,7,36,56,1,4,28,50,16,28,5,22,5,10,7,21,50
2005-04-18 00:00:00.000,Barcelona Spain ATP World Tour,CLAY,2,Potito Starace,Teymuraz Gabashvili,Potito Starace,6-1; 6-1,R64,57,3,0,31,41,22,31,8,10,1,1,7,30,41,1,0,16,39,8,16,9,23,0,5,7,17,39
2005-04-18 00:00:00.000,Barcelona Spain ATP World Tour,CLAY,2,Gilles Muller,Marc Lopez,Gilles Muller,6-4; 7-6(2),R64,100,7,6,50,86,41,50,17,36,7,8,11,58,86,2,0,38,64,24,38,18,26,0,2,11,42,64
2005-04-18 00:00:00.000,Barcelona Spain ATP World Tour,CLAY,2,Rafael Nadal,N/A Bye,Rafael Nadal,,R64,0,0,0,0,0,0,0,0,0,0,0,0,0,0,0,0,0,0,0,0,0,0,0,0,0,0,0
2005-04-18 00:00:00.000,Barcelona Spain ATP World Tour,CLAY,2,Nikolay Davydenko,N/A Bye,Nikolay Davydenko,,R64,0,0,0,0,0,0,0,0,0,0,0,0,0,0,0,0,0,0,0,0,0,0,0,0,0,0,0
2005-04-18 00:00:00.000,Barcelona Spain ATP World Tour,CLAY,2,Francisco Fogues,Christophe Rochus,Francisco Fogues,7-6(10); 1-6; 6-3,R64,122,4,2,66,92,45,66,11,26,3,8,14,56,92,4,1,61,103,37,61,23,42,8,12,14,60,103
2005-04-18 00:00:00.000,Barcelona Spain ATP World Tour,CLAY,2,Xavier Malisse,Philipp Kohlschreiber,Xavier Malisse,6-1; 6-2,R64,63,7,0,29,58,22,29,18,29,1,1,8,40,58,0,6,19,42,12,19,8,23,2,6,7,20,42
2005-04-18 00:00:00.000,Barcelona Spain ATP World Tour,CLAY,2,Thomas Johansson,Stefan Koubek,Thomas Johansson,6-2; 6-1,R64,63,1,2,23,39,19,23,10,16,1,1,7,29,39,6,3,29,67,18,29,14,38,5,10,8,32,67
2005-04-18 00:00:00.000,Barcelona Spain ATP World Tour,CLAY,2,Juan Monaco,Igor Andreev,Juan Monaco,6-3; 2-6; 6-3,R64,106,1,4,63,81,47,63,8,18,4,6,13,55,81,3,2,45,76,32,45,18,31,2,5,13,50,76
2005-04-18 00:00:00.000,Barcelona Spain ATP World Tour,CLAY,2,Max Mirnyi,Albert Costa,Max Mirnyi,7-6(4); 3-6; 7-6(2),R64,144,12,6,59,101,48,59,17,42,4,8,16,65,101,1,1,89,115,62,89,12,26,4,7,17,74,115
2005-04-18 00:00:00.000,Barcelona Spain ATP World Tour,CLAY,2,Jarkko Nieminen,Hyung-Taik Lee,Jarkko Nieminen,6-4; 7-6(4),R64,104,1,2,50,77,33,50,15,27,2,3,11,48,77,4,0,41,70,30,41,15,29,5,7,11,45,70
2005-04-18 00:00:00.000,Barcelona Spain ATP World Tour,CLAY,2,Carlos Moya,N/A Bye,Carlos Moya,,R64,0,0,0,0,0,0,0,0,0,0,0,0,0,0,0,0,0,0,0,0,0,0,0,0,0,0,0
2005-04-18 00:00:00.000,Barcelona Spain ATP World Tour,CLAY,2,Tommy Robredo,N/A Bye,Tommy Robredo,,R64,0,0,0,0,0,0,0,0,0,0,0,0,0,0,0,0,0,0,0,0,0,0,0,0,0,0,0
2005-04-18 00:00:00.000,Barcelona Spain ATP World Tour,CLAY,2,Alberto Martin,Younes El Aynaoui,Alberto Martin,6-4; 6-3,R64,82,3,1,47,64,30,47,13,17,7,7,9,43,64,4,5,48,74,32,48,8,26,4,7,10,40,74
2005-04-18 00:00:00.000,Barcelona Spain ATP World Tour,CLAY,2,Juan Carlos Ferrero,Albert Montanes,Juan Carlos Ferrero,6-3; 3-6; 7-5,R64,162,2,8,69,110,54,69,15,41,8,11,15,69,110,4,2,59,99,40,59,19,40,9,13,15,59,99
2005-04-18 00:00:00.000,Barcelona Spain ATP World Tour,CLAY,2,Feliciano Lopez,Nicolas Almagro,Feliciano Lopez,6-4; 6-2,R64,70,6,4,36,55,30,36,9,19,2,2,9,39,55,5,1,38,60,25,38,10,22,8,11,9,35,60
2005-04-18 00:00:00.000,Barcelona Spain ATP World Tour,CLAY,2,David Ferrer,Fernando Verdasco,David Ferrer,6-3; 6-4,R64,76,4,3,48,70,29,48,11,22,1,4,10,40,70,4,3,50,68,29,50,4,18,8,13,9,33,68
2005-04-18 00:00:00.000,Barcelona Spain ATP World Tour,CLAY,2,Jan Hernych,Andy Murray,Jan Hernych,3-6; 6-4; 6-4,R64,123,1,2,67,101,43,67,16,34,10,14,15,59,101,4,3,64,94,43,64,13,30,5,9,14,56,94
2005-04-18 00:00:00.000,Barcelona Spain ATP World Tour,CLAY,2,Felix Mantilla,Michael Llodra,Felix Mantilla,6-2; 6-1,R64,47,1,4,27,41,24,27,6,14,2,3,8,30,41,1,0,40,50,17,40,5,10,3,8,7,22,50
2005-04-18 00:00:00.000,Barcelona Spain ATP World Tour,CLAY,2,Gaston Gaudio,N/A Bye,Gaston Gaudio,,R64,0,0,0,0,0,0,0,0,0,0,0,0,0,0,0,0,0,0,0,0,0,0,0,0,0,0,0
2005-04-18 00:00:00.000,Barcelona Spain ATP World Tour,CLAY,2,Jose Acasuso,Marat Safin,Jose Acasuso,6-4; 6-4,R32,94,2,1,41,68,34,41,13,27,4,4,10,47,68,5,0,41,63,27,41,13,22,5,7,10,40,63
2005-04-18 00:00:00.000,Barcelona Spain ATP World Tour,CLAY,2,Stanislas Wawrinka,Paradorn Srichaphan,Stanislas Wawrinka,1-6; 6-3; 7-6(3),R32,112,2,1,43,75,27,43,22,32,0,4,14,49,75,4,2,64,99,39,64,22,35,7,10,14,61,99
2005-04-18 00:00:00.000,Barcelona Spain ATP World Tour,CLAY,2,Radek Stepanek,Santiago Ventura,Radek Stepanek,6-3; 6-2,R32,66,6,1,39,53,32,39,8,14,1,1,9,40,53,0,1,36,59,22,36,9,23,4,7,8,31,59
2005-04-18 00:00:00.000,Barcelona Spain ATP World Tour,CLAY,2,Guillermo Canas,Wayne Arthurs,Guillermo Canas,7-5; 7-6(3),R32,114,5,2,42,85,29,42,27,43,3,4,12,56,85,6,11,26,80,22,26,27,54,4,6,12,49,80
2005-04-18 00:00:00.000,Barcelona Spain ATP World Tour,CLAY,2,Guillermo Coria,Peter Wessels,Guillermo Coria,6-2; 6-7(4); 6-4,R32,127,6,5,62,97,43,62,22,35,7,9,15,65,97,3,6,68,106,46,68,16,38,7,12,15,62,106
2005-04-18 00:00:00.000,Barcelona Spain ATP World Tour,CLAY,2,Agustin Calleri,Juan Ignacio Chela,Agustin Calleri,6-3; 6-7(9); 7-6(1),R32,149,5,3,66,110,55,66,22,44,3,5,17,77,110,0,0,77,104,50,77,17,27,4,7,16,67,104
2005-04-18 00:00:00.000,Barcelona Spain ATP World Tour,CLAY,2,Dominik Hrbaty,Potito Starace,Dominik Hrbaty,6-3; 6-2,R32,59,7,3,30,49,28,30,10,19,1,1,9,38,49,3,1,40,58,23,40,9,18,8,11,8,32,58
2005-04-18 00:00:00.000,Barcelona Spain ATP World Tour,CLAY,2,Rafael Nadal,Gilles Muller,Rafael Nadal,6-0; 6-2,R32,54,2,2,29,45,24,29,9,16,4,4,7,33,45,2,1,22,41,12,22,5,19,3,8,7,17,41
2005-04-18 00:00:00.000,Barcelona Spain ATP World Tour,CLAY,2,Nikolay Davydenko,Francisco Fogues,Nikolay Davydenko,6-3; 6-2,R32,95,1,2,37,51,24,37,6,14,2,4,8,30,51,0,4,43,66,21,43,9,23,7,13,9,30,66
2005-04-18 00:00:00.000,Barcelona Spain ATP World Tour,CLAY,2,Thomas Johansson,Xavier Malisse,Thomas Johansson,7-5; 7-5,R32,108,5,1,37,71,31,37,20,34,1,2,12,51,71,8,3,39,78,29,39,17,39,0,3,12,46,78
2005-04-18 00:00:00.000,Barcelona Spain ATP World Tour,CLAY,2,Max Mirnyi,Juan Monaco,Max Mirnyi,7-6(3); 6-2,R32,82,4,4,39,60,31,39,12,21,0,0,10,43,60,1,1,58,76,36,58,10,18,9,11,10,46,76
2005-04-18 00:00:00.000,Barcelona Spain ATP World Tour,CLAY,2,Carlos Moya,Jarkko Nieminen,Carlos Moya,7-5; 5-7; 6-2,R32,142,7,2,58,96,43,58,19,38,3,6,16,62,96,0,1,86,129,53,86,18,43,15,20,16,71,129
2005-04-18 00:00:00.000,Barcelona Spain ATP World Tour,CLAY,2,Alberto Martin,Tommy Robredo,Alberto Martin,6-1; 6-4,R32,75,2,2,31,62,21,31,17,31,4,5,9,38,62,0,1,38,52,20,38,5,14,5,9,8,25,52
2005-04-18 00:00:00.000,Barcelona Spain ATP World Tour,CLAY,2,Juan Carlos Ferrero,Feliciano Lopez,Juan Carlos Ferrero,6-4; 6-4,R32,81,2,2,50,65,36,50,10,15,5,5,10,46,65,5,0,41,57,31,41,6,16,2,4,10,37,57
2005-04-18 00:00:00.000,Barcelona Spain ATP World Tour,CLAY,2,David Ferrer,Jan Hernych,David Ferrer,6-2; 6-3,R32,0,0,1,31,50,18,31,15,19,2,3,8,33,50,0,0,49,64,23,49,6,15,8,13,9,29,64
2005-04-18 00:00:00.000,Barcelona Spain ATP World Tour,CLAY,2,Gaston Gaudio,Felix Mantilla,Gaston Gaudio,6-4; 6-2,R32,99,1,1,28,58,21,28,21,30,8,9,9,42,58,3,3,24,57,16,24,14,33,6,10,9,30,57
2005-04-18 00:00:00.000,Barcelona Spain ATP World Tour,CLAY,2,Stanislas Wawrinka,Jose Acasuso,Stanislas Wawrinka,6-3; 6-4,R16,69,6,0,32,55,25,32,17,23,0,0,10,42,55,3,1,33,65,23,33,14,32,5,7,9,37,65
2005-04-18 00:00:00.000,Barcelona Spain ATP World Tour,CLAY,2,Radek Stepanek,Guillermo Canas,Radek Stepanek,6-7(6); 7-6(2); 7-6(5),R16,190,11,4,85,133,61,85,23,48,6,9,18,84,133,5,4,94,136,63,94,23,42,11,14,18,86,136
2005-04-18 00:00:00.000,Barcelona Spain ATP World Tour,CLAY,2,Agustin Calleri,Guillermo Coria,Agustin Calleri,6-4; 6-7(5); 7-6(2),R16,166,4,3,65,120,48,65,20,55,10,16,17,68,120,6,7,67,104,40,67,18,37,2,9,17,58,104
2005-04-18 00:00:00.000,Barcelona Spain ATP World Tour,CLAY,2,Rafael Nadal,Dominik Hrbaty,Rafael Nadal,6-1; 6-2,R16,79,2,0,40,53,28,40,7,13,5,6,8,35,53,0,1,28,52,11,28,11,24,5,10,7,22,52
2005-04-18 00:00:00.000,Barcelona Spain ATP World Tour,CLAY,2,Nikolay Davydenko,Thomas Johansson,Nikolay Davydenko,6-3; 6-7(3); 7-6(2),R16,162,1,1,78,104,52,78,16,26,4,6,16,68,104,4,1,63,123,38,63,35,60,10,14,17,73,123
2005-04-18 00:00:00.000,Barcelona Spain ATP World Tour,CLAY,2,Max Mirnyi,Carlos Moya,Max Mirnyi,6-4; 6-4,R16,85,7,2,42,65,32,42,8,23,2,4,10,40,65,1,1,49,68,29,49,8,19,8,12,10,37,68
2005-04-18 00:00:00.000,Barcelona Spain ATP World Tour,CLAY,2,Juan Carlos Ferrero,Alberto Martin,Juan Carlos Ferrero,6-1; 6-2,R16,71,1,0,40,57,27,40,8,17,6,7,8,35,57,2,1,29,45,14,29,5,16,3,8,7,19,45
2005-04-18 00:00:00.000,Barcelona Spain ATP World Tour,CLAY,2,Gaston Gaudio,David Ferrer,Gaston Gaudio,6-3; 6-4,R16,98,1,3,39,70,24,39,14,31,6,9,10,38,70,0,1,29,55,11,29,14,26,2,7,9,25,55
2005-04-18 00:00:00.000,Barcelona Spain ATP World Tour,CLAY,2,Radek Stepanek,Stanislas Wawrinka,Radek Stepanek,3-6; 6-3; 6-2,Q,123,5,4,53,79,40,53,12,26,4,6,13,52,79,6,3,53,99,34,53,23,46,7,11,13,57,99
2005-04-18 00:00:00.000,Barcelona Spain ATP World Tour,CLAY,2,Rafael Nadal,Agustin Calleri,Rafael Nadal,6-2; 3-0 RET,Q,53,1,0,22,31,17,22,6,9,0,0,5,23,31,2,0,24,40,12,24,4,16,2,6,6,16,40
2005-04-18 00:00:00.000,Barcelona Spain ATP World Tour,CLAY,2,Nikolay Davydenko,Max Mirnyi,Nikolay Davydenko,6-4; 6-4,Q,81,0,1,47,60,34,47,10,13,2,2,10,44,60,5,4,41,63,31,41,9,22,3,5,10,40,63
2005-04-18 00:00:00.000,Barcelona Spain ATP World Tour,CLAY,2,Juan Carlos Ferrero,Gaston Gaudio,Juan Carlos Ferrero,6-4; 4-6; 6-3,Q,178,3,2,80,120,49,80,23,40,15,18,15,72,120,3,6,63,103,43,63,17,40,9,13,14,60,103
2005-04-18 00:00:00.000,Barcelona Spain ATP World Tour,CLAY,2,Rafael Nadal,Radek Stepanek,Rafael Nadal,7-5; 6-2,S,80,1,0,34,47,31,34,9,13,0,0,10,40,47,7,3,41,63,28,41,8,22,2,5,10,36,63
2005-04-18 00:00:00.000,Barcelona Spain ATP World Tour,CLAY,2,Juan Carlos Ferrero,Nikolay Davydenko,Juan Carlos Ferrero,7-6(1); 6-1,S,95,1,6,40,69,31,40,16,29,3,4,10,47,69,0,0,51,61,28,51,5,10,4,7,9,33,61
2005-04-18 00:00:00.000,Barcelona Spain ATP World Tour,CLAY,2,Rafael Nadal,Juan Carlos Ferrero,Rafael Nadal,6-1; 7-6(4); 6-3,F,176,6,1,86,113,60,86,15,27,8,9,15,75,113,1,6,66,99,44,66,13,33,7,11,13,57,99
2005-04-18 00:00:00.000,Houston TX; U.S.A. ATP World Tour,CLAY,2,Andy Roddick,Matias Boeker,Andy Roddick,6-2; 6-3,R32,58,11,0,28,46,23,28,11,18,0,1,9,34,46,2,3,28,45,18,28,5,17,1,5,8,23,45
2005-04-18 00:00:00.000,Houston TX; U.S.A. ATP World Tour,CLAY,2,Robby Ginepri,Mardy Fish,Robby Ginepri,6-1; 6-4,R32,73,7,0,36,61,28,36,12,25,1,1,9,40,61,4,0,29,49,16,29,11,20,4,7,8,27,49
2005-04-18 00:00:00.000,Houston TX; U.S.A. ATP World Tour,CLAY,2,Paul Goldstein,Jiri Vanek,Paul Goldstein,6-1; 7-6(4),R32,103,5,4,41,79,32,41,16,38,3,4,9,48,79,5,4,59,87,36,59,9,28,8,12,10,45,87
2005-04-18 00:00:00.000,Houston TX; U.S.A. ATP World Tour,CLAY,2,Luis Horna,Thomas Enqvist,Luis Horna,6-4; 6-3,R32,78,7,6,42,63,31,42,7,21,3,6,10,38,63,5,5,24,52,19,24,6,28,2,7,9,25,52
2005-04-18 00:00:00.000,Houston TX; U.S.A. ATP World Tour,CLAY,2,Tommy Haas,Kristof Vliegen,Tommy Haas,6-3; 7-5,R32,70,5,2,36,55,31,36,10,19,1,2,11,41,55,1,1,38,65,24,38,15,27,3,6,10,39,65
2005-04-18 00:00:00.000,Houston TX; U.S.A. ATP World Tour,CLAY,2,Jeff Morrison,Alexander Popp,Jeff Morrison,6-3; 7-6(4),R32,71,6,2,41,65,32,41,14,24,1,2,11,46,65,4,9,31,61,25,31,12,30,2,4,10,37,61
2005-04-18 00:00:00.000,Houston TX; U.S.A. ATP World Tour,CLAY,2,Noam Okun,Ricardo Mello,Noam Okun,6-4; 7-5,R32,116,2,3,45,69,30,45,13,24,5,7,11,43,69,2,1,49,82,26,49,17,33,11,15,11,43,82
2005-04-18 00:00:00.000,Houston TX; U.S.A. ATP World Tour,CLAY,2,Jurgen Melzer,Mariano Puerta,Jurgen Melzer,6-3; 6-3,R32,63,5,2,38,58,28,38,12,20,5,5,9,40,58,0,3,32,50,20,32,8,18,2,5,9,28,50
2005-04-18 00:00:00.000,Houston TX; U.S.A. ATP World Tour,CLAY,2,Kevin Kim,Adrian Garcia,Kevin Kim,6-4; 6-4,R32,101,3,3,36,71,27,36,19,35,3,4,10,46,71,1,5,37,57,27,37,9,20,3,6,10,36,57
2005-04-18 00:00:00.000,Houston TX; U.S.A. ATP World Tour,CLAY,2,Nicolas Lapentti,Tomas Zib,Nicolas Lapentti,6-3; 6-2,R32,73,1,1,31,52,24,31,14,21,0,0,9,38,52,0,0,17,38,11,17,11,21,2,5,8,22,38
2005-04-18 00:00:00.000,Houston TX; U.S.A. ATP World Tour,CLAY,2,James Blake,Ivo Minar,James Blake,6-2; 7-5,R32,59,13,2,36,59,31,36,12,23,7,8,10,43,59,11,1,29,57,18,29,14,28,1,5,10,32,57
2005-04-18 00:00:00.000,Houston TX; U.S.A. ATP World Tour,CLAY,2,Antony Dupuis,Nicolas Massu,Antony Dupuis,6-4; 6-0,R32,74,6,1,21,42,19,21,14,21,1,1,8,33,42,5,3,28,58,19,28,11,30,4,8,8,30,58
2005-04-18 00:00:00.000,Houston TX; U.S.A. ATP World Tour,CLAY,2,Sebastien Grosjean,Bjorn Phau,Sebastien Grosjean,4-6; 6-3; 7-5,R32,140,3,1,64,101,39,64,22,37,5,10,16,61,101,5,4,58,92,39,58,12,34,2,8,15,51,92
2005-04-18 00:00:00.000,Houston TX; U.S.A. ATP World Tour,CLAY,2,Oscar Hernandez,Alex Bogomolov Jr.,Oscar Hernandez,6-1; 7-5,R32,91,3,5,35,56,26,35,5,21,1,4,9,31,56,1,2,47,63,23,47,5,16,5,12,10,28,63
2005-04-18 00:00:00.000,Houston TX; U.S.A. ATP World Tour,CLAY,2,Alex Calatrava,Donald Young,Alex Calatrava,6-1; 6-4,R32,54,9,0,37,45,28,37,4,8,3,4,8,32,45,1,2,26,48,15,26,9,22,0,5,9,24,48
2005-04-18 00:00:00.000,Houston TX; U.S.A. ATP World Tour,CLAY,2,Andre Agassi,Michal Tabara,Andre Agassi,6-2; 7-6(5),R32,69,13,8,42,83,37,42,18,41,6,6,10,55,83,7,6,22,59,18,22,18,37,0,2,10,36,59
2005-04-18 00:00:00.000,Houston TX; U.S.A. ATP World Tour,CLAY,2,Andy Roddick,Robby Ginepri,Andy Roddick,7-6(6); 6-4,R16,79,9,0,39,63,33,39,13,24,1,2,11,46,63,8,7,52,75,34,52,11,23,4,6,11,45,75
2005-04-18 00:00:00.000,Houston TX; U.S.A. ATP World Tour,CLAY,2,Luis Horna,Paul Goldstein,Luis Horna,6-1; 6-7(7); 7-5,R16,158,3,6,71,105,46,71,18,34,1,4,16,64,105,7,9,69,125,46,69,22,56,9,15,15,68,125
2005-04-18 00:00:00.000,Houston TX; U.S.A. ATP World Tour,CLAY,2,Tommy Haas,Jeff Morrison,Tommy Haas,7-6(4); 6-2,R16,86,6,6,31,63,22,31,20,32,3,5,10,42,63,3,2,43,82,22,43,20,39,6,10,10,42,82
2005-04-18 00:00:00.000,Houston TX; U.S.A. ATP World Tour,CLAY,2,Jurgen Melzer,Noam Okun,Jurgen Melzer,2-6; 6-2; 7-5,R16,137,8,2,66,104,43,66,18,38,13,17,14,61,104,5,1,75,108,46,75,14,33,11,16,14,60,108
2005-04-18 00:00:00.000,Houston TX; U.S.A. ATP World Tour,CLAY,2,Nicolas Lapentti,Kevin Kim,Nicolas Lapentti,7-6(1); 6-2,R16,86,2,1,38,57,31,38,12,19,1,2,10,43,57,4,5,26,63,16,26,19,37,4,7,10,35,63
2005-04-18 00:00:00.000,Houston TX; U.S.A. ATP World Tour,CLAY,2,James Blake,Antony Dupuis,James Blake,6-4; 6-1,R16,67,10,1,25,50,18,25,17,25,1,2,9,35,50,2,2,28,55,19,28,9,27,4,8,8,28,55
2005-04-18 00:00:00.000,Houston TX; U.S.A. ATP World Tour,CLAY,2,Sebastien Grosjean,Oscar Hernandez,Sebastien Grosjean,6-4; 5-7; 6-2,R16,155,7,1,49,97,32,49,29,48,9,12,15,61,97,2,8,57,99,37,57,20,42,3,8,15,57,99
2005-04-18 00:00:00.000,Houston TX; U.S.A. ATP World Tour,CLAY,2,Andre Agassi,Alex Calatrava,Andre Agassi,3-6; 6-4; 7-5,R16,129,6,8,50,80,39,50,14,30,5,8,15,53,80,7,2,65,109,45,65,20,44,4,8,16,65,109
2005-04-18 00:00:00.000,Houston TX; U.S.A. ATP World Tour,CLAY,2,Andy Roddick,Luis Horna,Andy Roddick,6-4; 6-1,Q,57,14,1,35,50,30,35,10,15,2,2,9,40,50,5,2,37,47,24,37,4,10,3,6,8,28,47
2005-04-18 00:00:00.000,Houston TX; U.S.A. ATP World Tour,CLAY,2,Jurgen Melzer,Tommy Haas,Jurgen Melzer,2-6; 6-2; 6-4,Q,108,6,0,47,69,35,47,11,22,1,4,13,46,69,6,2,53,85,35,53,14,32,7,11,13,49,85
2005-04-18 00:00:00.000,Houston TX; U.S.A. ATP World Tour,CLAY,2,Nicolas Lapentti,James Blake,Nicolas Lapentti,6-4; 1-6; 7-6(3),Q,135,2,4,77,109,50,77,16,32,5,8,14,66,109,4,1,46,90,32,46,26,44,2,4,15,58,90
2005-04-18 00:00:00.000,Houston TX; U.S.A. ATP World Tour,CLAY,2,Sebastien Grosjean,Andre Agassi,Sebastien Grosjean,4-6; 6-1; 6-2,Q,109,10,1,46,93,39,46,24,47,5,6,13,63,93,8,2,34,70,29,34,12,36,7,11,12,41,70
2005-04-18 00:00:00.000,Houston TX; U.S.A. ATP World Tour,CLAY,2,Andy Roddick,Jurgen Melzer,Andy Roddick,6-4; 6-2,S,65,7,3,37,53,28,37,7,16,0,2,9,35,53,2,2,30,52,17,30,7,22,3,8,9,24,52
2005-04-18 00:00:00.000,Houston TX; U.S.A. ATP World Tour,CLAY,2,Sebastien Grosjean,Nicolas Lapentti,Sebastien Grosjean,6-1; 7-6(5),S,103,1,0,36,62,29,36,13,26,1,2,10,42,62,1,1,47,61,30,47,4,14,2,5,9,34,61
2005-04-18 00:00:00.000,Houston TX; U.S.A. ATP World Tour,CLAY,2,Andy Roddick,Sebastien Grosjean,Andy Roddick,6-2; 6-2,F,71,4,0,28,44,20,28,13,16,0,0,8,33,44,3,3,33,62,19,33,12,29,6,10,8,31,62
2005-04-25 00:00:00.000,Estoril Portugal ATP World Tour,CLAY,2,Carlos Moya,Felix Mantilla,Carlos Moya,6-0; 7-6(5),R32,100,3,1,35,61,25,35,14,26,3,4,9,39,61,2,5,37,77,20,37,18,40,10,14,9,38,77
2005-04-25 00:00:00.000,Estoril Portugal ATP World Tour,CLAY,2,Juan Carlos Ferrero,Marcos Baghdatis,Juan Carlos Ferrero,6-3; 2-6; 7-6(6),R32,123,0,3,51,82,38,51,17,31,2,4,14,55,82,5,5,52,103,38,52,29,51,3,5,15,67,103
2005-04-25 00:00:00.000,Estoril Portugal ATP World Tour,CLAY,2,Tomas Cakl,Kenneth Carlsen,Tomas Cakl,6-3; 6-0,R32,70,0,4,31,57,21,31,16,26,4,4,8,37,57,0,5,25,48,17,25,5,23,3,7,7,22,48
2005-04-25 00:00:00.000,Estoril Portugal ATP World Tour,CLAY,2,Paul-Henri Mathieu,Jiri Novak,Paul-Henri Mathieu,7-6(5); 6-1,R32,92,2,2,32,69,19,32,19,37,4,7,9,38,69,6,3,38,66,23,38,9,28,6,12,10,32,66
2005-04-25 00:00:00.000,Estoril Portugal ATP World Tour,CLAY,2,Tommy Robredo,Frantisek Cermak,Tommy Robredo,6-2; 2-6; 6-4,R32,123,0,3,46,82,35,46,13,36,3,7,13,48,82,1,4,67,111,40,67,20,44,16,21,13,60,111
2005-04-25 00:00:00.000,Estoril Portugal ATP World Tour,CLAY,2,Santiago Ventura,Gilles Muller,Santiago Ventura,3-6; 6-1; 6-2,R32,82,7,2,35,65,30,35,17,30,3,4,12,47,65,3,3,34,64,26,34,11,30,2,6,12,37,64
2005-04-25 00:00:00.000,Estoril Portugal ATP World Tour,CLAY,2,Davide Sanguinetti,Frank Condor,Davide Sanguinetti,6-0; 6-2,R32,47,3,0,21,38,16,21,12,17,0,0,7,28,38,0,2,29,45,14,29,3,16,2,7,7,17,45
2005-04-25 00:00:00.000,Estoril Portugal ATP World Tour,CLAY,2,Albert Costa,Nicolas Massu,Albert Costa,3-6; 6-3; 6-3,R32,169,2,3,68,105,50,68,15,37,15,16,13,65,105,3,3,57,96,38,57,19,39,3,6,14,57,96
2005-04-25 00:00:00.000,Estoril Portugal ATP World Tour,CLAY,2,Juan Antonio Marin,Juan Ignacio Chela,Juan Antonio Marin,6-1; 6-2,R32,95,0,2,26,62,18,26,17,36,2,4,8,35,62,0,3,31,58,16,31,8,27,8,14,7,24,58
2005-04-25 00:00:00.000,Estoril Portugal ATP World Tour,CLAY,2,Agustin Calleri,Rui Machado,Agustin Calleri,4-6; 6-3; 6-1,R32,108,1,4,35,80,28,35,19,45,4,8,13,47,80,0,5,49,79,26,49,12,30,5,12,13,38,79
2005-04-25 00:00:00.000,Estoril Portugal ATP World Tour,CLAY,2,Guillermo Garcia-Lopez,Ivo Karlovic,Guillermo Garcia-Lopez,6-3; 6-3,R32,62,0,0,25,39,24,25,12,14,0,0,9,36,39,6,7,33,64,26,33,11,31,3,6,9,37,64
2005-04-25 00:00:00.000,Estoril Portugal ATP World Tour,CLAY,2,Joachim Johansson,Alex Calatrava,Joachim Johansson,7-6(1); 6-4,R32,105,9,6,38,78,30,38,25,40,5,5,11,55,78,4,0,54,74,40,54,8,20,3,4,11,48,74
2005-04-25 00:00:00.000,Estoril Portugal ATP World Tour,CLAY,2,Feliciano Lopez,Alex Corretja,Feliciano Lopez,6-7(1); 7-6(4); 6-4,R32,166,15,3,70,121,49,70,25,51,4,7,17,74,121,4,5,58,119,33,58,40,61,7,11,17,73,119
2005-04-25 00:00:00.000,Estoril Portugal ATP World Tour,CLAY,2,Albert Montanes,Galo Blanco,Albert Montanes,7-6(5); 6-4,R32,110,4,1,49,77,35,49,14,28,9,11,11,49,77,4,1,42,73,31,42,13,31,4,7,11,44,73
2005-04-25 00:00:00.000,Estoril Portugal ATP World Tour,CLAY,2,Michal Tabara,Tomas Berdych,Michal Tabara,1-6; 6-4; 6-1,R32,101,2,7,36,70,23,36,13,34,4,9,12,36,70,4,5,51,90,29,51,14,39,3,9,12,43,90
2005-04-25 00:00:00.000,Estoril Portugal ATP World Tour,CLAY,2,Gaston Gaudio,Jan Hernych,Gaston Gaudio,6-7(5); 7-5; 6-0,R32,144,2,3,53,111,29,53,36,58,5,9,15,65,111,1,4,71,104,37,71,10,33,14,22,15,47,104
2005-04-25 00:00:00.000,Estoril Portugal ATP World Tour,CLAY,2,Carlos Moya,Juan Carlos Ferrero,Carlos Moya,7-5; 6-7(4); 6-4,R16,168,3,7,70,113,51,70,18,43,6,9,17,69,113,1,2,78,115,49,78,18,37,6,11,17,67,115
2005-04-25 00:00:00.000,Estoril Portugal ATP World Tour,CLAY,2,Paul-Henri Mathieu,Tomas Cakl,Paul-Henri Mathieu,6-1; 6-1,R16,61,4,1,19,36,14,19,12,17,0,1,7,26,36,2,0,32,52,15,32,4,20,5,11,7,19,52
2005-04-25 00:00:00.000,Estoril Portugal ATP World Tour,CLAY,2,Tommy Robredo,Santiago Ventura,Tommy Robredo,7-5; 6-0,R16,74,2,0,40,66,26,40,12,26,4,6,9,38,66,1,2,27,49,12,27,9,22,5,11,9,21,49
2005-04-25 00:00:00.000,Estoril Portugal ATP World Tour,CLAY,2,Davide Sanguinetti,Albert Costa,Davide Sanguinetti,5-7; 6-3; 6-4,R16,141,5,3,48,93,38,48,21,45,6,10,16,59,93,2,2,66,101,41,66,16,35,6,11,15,57,101
2005-04-25 00:00:00.000,Estoril Portugal ATP World Tour,CLAY,2,Juan Antonio Marin,Agustin Calleri,Juan Antonio Marin,6-4; 3-1 RET,R16,75,1,1,25,42,16,25,9,17,4,6,7,25,42,0,0,42,57,19,42,7,15,7,11,7,26,57
2005-04-25 00:00:00.000,Estoril Portugal ATP World Tour,CLAY,2,Guillermo Garcia-Lopez,Joachim Johansson,Guillermo Garcia-Lopez,6-2; 6-4,R16,75,0,1,46,61,35,46,8,15,3,3,9,43,61,3,6,25,53,20,25,11,28,2,5,9,31,53
2005-04-25 00:00:00.000,Estoril Portugal ATP World Tour,CLAY,2,Feliciano Lopez,Albert Montanes,Feliciano Lopez,7-6(5); 4-6; 6-4,R16,116,7,5,59,94,46,59,16,35,5,8,16,62,94,1,7,69,105,47,69,19,36,5,8,16,66,105
2005-04-25 00:00:00.000,Estoril Portugal ATP World Tour,CLAY,2,Gaston Gaudio,Michal Tabara,Gaston Gaudio,6-2; 6-1,R16,78,1,1,36,56,21,36,12,20,8,9,7,33,56,2,10,27,66,16,27,13,39,8,14,8,29,66
2005-04-25 00:00:00.000,Estoril Portugal ATP World Tour,CLAY,2,Carlos Moya,Paul-Henri Mathieu,Carlos Moya,6-4; 6-2,Q,76,2,1,29,55,24,29,15,26,1,1,9,39,55,2,4,27,48,17,27,12,21,3,6,9,29,48
2005-04-25 00:00:00.000,Estoril Portugal ATP World Tour,CLAY,2,Tommy Robredo,Davide Sanguinetti,Tommy Robredo,6-2; 6-2,Q,53,1,1,26,45,21,26,12,19,0,0,8,33,45,1,4,26,48,16,26,8,22,2,6,8,24,48
2005-04-25 00:00:00.000,Estoril Portugal ATP World Tour,CLAY,2,Guillermo Garcia-Lopez,Juan Antonio Marin,Guillermo Garcia-Lopez,6-1; 2-6; 6-3,Q,130,0,2,72,89,47,72,8,17,8,10,12,55,89,2,1,42,74,23,42,19,32,3,7,12,42,74
2005-04-25 00:00:00.000,Estoril Portugal ATP World Tour,CLAY,2,Gaston Gaudio,Feliciano Lopez,Gaston Gaudio,6-2; 6-2,Q,62,1,3,28,45,23,28,11,17,1,1,8,34,45,2,0,21,44,13,21,11,23,0,4,8,24,44
2005-04-25 00:00:00.000,Estoril Portugal ATP World Tour,CLAY,2,Tommy Robredo,Carlos Moya,Tommy Robredo,6-3; 3-0 RET,S,51,0,4,28,40,20,28,4,12,4,6,6,24,40,0,1,19,30,6,19,2,11,0,5,6,8,30
2005-04-25 00:00:00.000,Estoril Portugal ATP World Tour,CLAY,2,Gaston Gaudio,Guillermo Garcia-Lopez,Gaston Gaudio,6-4; 2-6; 6-2,S,108,5,4,44,74,29,44,15,30,6,10,13,44,74,4,4,60,78,39,60,5,18,1,6,13,44,78
2005-04-25 00:00:00.000,Estoril Portugal ATP World Tour,CLAY,2,Gaston Gaudio,Tommy Robredo,Gaston Gaudio,6-1; 2-6; 6-1,F,109,0,3,39,69,28,39,18,30,2,4,11,46,69,1,1,47,80,30,47,11,33,7,12,11,41,80
2005-04-25 00:00:00.000,Munich Germany ATP World Tour,CLAY,2,David Nalbandian,Nicolas Lapentti,David Nalbandian,7-5; 1-6; 6-4,R32,145,3,4,46,79,28,46,14,33,5,11,14,42,79,2,0,72,109,43,72,16,37,10,16,15,59,109
2005-04-25 00:00:00.000,Munich Germany ATP World Tour,CLAY,2,Peter Luczak,Florian Mayer,Peter Luczak,2-6; 6-3; 6-2,R32,99,4,4,54,90,38,54,18,36,7,10,13,56,90,3,2,66,89,41,66,9,23,4,8,12,50,89
2005-04-25 00:00:00.000,Munich Germany ATP World Tour,CLAY,2,Juan Monaco,Lars Burgsmuller,Juan Monaco,7-5; 6-3,R32,88,1,2,49,68,33,49,11,19,8,9,10,44,68,3,2,40,65,26,40,10,25,2,6,11,36,65
2005-04-25 00:00:00.000,Munich Germany ATP World Tour,CLAY,2,Paradorn Srichaphan,Peter Wessels,Paradorn Srichaphan,6-3; 6-4,R32,62,8,2,36,61,28,36,16,25,4,4,10,44,61,5,2,45,53,31,45,3,8,3,5,9,34,53
2005-04-25 00:00:00.000,Munich Germany ATP World Tour,CLAY,2,Mario Ancic,Jose Acasuso,Mario Ancic,6-2; 6-4,R32,61,7,2,23,42,22,23,11,19,0,1,9,33,42,3,3,26,58,18,26,12,32,2,6,9,30,58
2005-04-25 00:00:00.000,Munich Germany ATP World Tour,CLAY,2,Jarkko Nieminen,Bohdan Ulihrach,Jarkko Nieminen,7-5; 6-1,R32,66,2,1,48,65,30,48,8,17,6,8,9,38,65,2,1,38,62,18,38,11,24,7,13,10,29,62
2005-04-25 00:00:00.000,Munich Germany ATP World Tour,CLAY,2,Michal Mertinak,Julien Benneteau,Michal Mertinak,6-4; 6-1,R32,125,3,2,41,63,30,41,13,22,5,5,9,43,63,5,2,37,54,22,37,8,17,3,6,8,30,54
2005-04-25 00:00:00.000,Munich Germany ATP World Tour,CLAY,2,Ricardo Mello,Rainer Schuettler,Ricardo Mello,6-4; 6-2,R32,78,1,0,41,52,28,41,9,11,3,4,9,37,52,3,3,41,67,26,41,10,26,8,12,9,36,67
2005-04-25 00:00:00.000,Munich Germany ATP World Tour,CLAY,2,Igor Andreev,Jiri Vanek,Igor Andreev,6-1; 6-2,R32,47,5,0,26,37,24,26,8,11,0,0,8,32,37,2,1,33,49,17,33,7,16,3,7,7,24,49
2005-04-25 00:00:00.000,Munich Germany ATP World Tour,CLAY,2,Wayne Arthurs,Irakli Labadze,Wayne Arthurs,6-3; 6-3,R32,63,15,7,31,65,27,31,15,34,4,5,9,42,65,3,4,30,57,15,30,16,27,7,11,9,31,57
2005-04-25 00:00:00.000,Munich Germany ATP World Tour,CLAY,2,Hyung-Taik Lee,Jean-Rene Lisnard,Hyung-Taik Lee,6-4; 3-6; 6-3,R32,112,2,4,55,94,36,55,21,39,4,6,14,57,94,2,0,50,99,33,50,30,49,9,12,14,63,99
2005-04-25 00:00:00.000,Munich Germany ATP World Tour,CLAY,2,Tommy Haas,Nicolas Almagro,Tommy Haas,7-5; 6-3,R32,79,12,0,44,58,32,44,10,14,0,1,11,42,58,2,0,54,79,28,54,17,25,4,7,10,45,79
2005-04-25 00:00:00.000,Munich Germany ATP World Tour,CLAY,2,Andrei Pavel,Alexander Waske,Andrei Pavel,6-4; 6-4,R32,69,7,1,40,61,31,40,11,21,1,1,10,42,61,7,0,39,54,30,39,8,15,4,6,10,38,54
2005-04-25 00:00:00.000,Munich Germany ATP World Tour,CLAY,2,Sjeng Schalken,Tobias Summerer,Sjeng Schalken,6-2; 7-5,R32,94,1,0,55,78,35,55,13,23,5,6,10,48,78,2,1,30,54,21,30,12,24,5,9,10,33,54
2005-04-25 00:00:00.000,Munich Germany ATP World Tour,CLAY,2,Raemon Sluiter,Tomas Zib,Raemon Sluiter,6-4; 6-2,R32,75,17,5,35,59,30,35,11,24,3,3,9,41,59,5,1,41,65,26,41,13,24,6,9,9,39,65
2005-04-25 00:00:00.000,Munich Germany ATP World Tour,CLAY,2,Nikolay Davydenko,Jerome Haehnel,Nikolay Davydenko,7-6(2); 6-2,R32,75,4,1,48,59,30,48,6,11,1,4,10,36,59,2,1,36,62,18,36,11,26,4,9,10,29,62
2005-04-25 00:00:00.000,Munich Germany ATP World Tour,CLAY,2,David Nalbandian,Peter Luczak,David Nalbandian,6-2; 6-2,R16,72,4,2,26,53,22,26,16,27,2,2,8,38,53,0,1,32,51,18,32,7,19,6,10,8,25,51
2005-04-25 00:00:00.000,Munich Germany ATP World Tour,CLAY,2,Juan Monaco,Paradorn Srichaphan,Juan Monaco,7-6(12); 2-6; 6-3,R16,131,0,0,77,105,50,77,15,28,1,4,15,65,105,4,0,56,86,42,56,17,30,1,3,14,59,86
2005-04-25 00:00:00.000,Munich Germany ATP World Tour,CLAY,2,Jarkko Nieminen,Mario Ancic,Jarkko Nieminen,7-6(5); 6-4,R16,89,2,0,48,73,32,48,19,25,5,6,11,51,73,5,2,38,61,29,38,13,23,0,2,11,42,61
2005-04-25 00:00:00.000,Munich Germany ATP World Tour,CLAY,2,Michal Mertinak,Ricardo Mello,Michal Mertinak,6-3; 6-0,R16,61,2,3,44,61,33,44,7,17,6,6,8,40,61,0,3,25,44,12,25,9,19,2,6,7,21,44
2005-04-25 00:00:00.000,Munich Germany ATP World Tour,CLAY,2,Wayne Arthurs,Igor Andreev,Wayne Arthurs,6-4; 6-7(5); 7-6(3),R16,132,16,3,51,99,44,51,33,48,0,0,17,77,99,12,1,72,110,56,72,20,38,3,4,17,76,110
2005-04-25 00:00:00.000,Munich Germany ATP World Tour,CLAY,2,Tommy Haas,Hyung-Taik Lee,Tommy Haas,6-3; 6-4,R16,68,7,0,32,58,27,32,16,26,4,4,10,43,58,5,0,30,50,25,30,9,20,1,3,9,34,50
2005-04-25 00:00:00.000,Munich Germany ATP World Tour,CLAY,2,Andrei Pavel,Sjeng Schalken,Andrei Pavel,6-1; 1-6; 6-1,R16,90,6,0,41,64,26,41,12,23,1,5,11,38,64,1,0,54,69,24,54,8,15,6,12,10,32,69
2005-04-25 00:00:00.000,Munich Germany ATP World Tour,CLAY,2,Raemon Sluiter,Nikolay Davydenko,Raemon Sluiter,6-1; 1-6; 6-3,R16,96,4,1,48,75,32,48,16,27,2,4,12,48,75,4,1,45,65,32,45,9,20,2,5,11,41,65
2005-04-25 00:00:00.000,Munich Germany ATP World Tour,CLAY,2,David Nalbandian,Juan Monaco,David Nalbandian,6-0; 6-4,Q,66,1,1,27,41,20,27,7,14,2,4,8,27,41,0,1,26,46,13,26,5,20,1,7,8,18,46
2005-04-25 00:00:00.000,Munich Germany ATP World Tour,CLAY,2,Jarkko Nieminen,Michal Mertinak,Jarkko Nieminen,3-6; 6-1; 6-4,Q,113,4,2,71,99,50,71,11,28,6,8,13,61,99,3,1,57,90,35,57,17,33,4,8,13,52,90
2005-04-25 00:00:00.000,Munich Germany ATP World Tour,CLAY,2,Tommy Haas,Wayne Arthurs,Tommy Haas,7-6(6); 7-6(5),Q,102,3,2,50,77,42,50,21,27,2,2,12,63,77,19,3,51,81,41,51,20,30,2,2,12,61,81
2005-04-25 00:00:00.000,Munich Germany ATP World Tour,CLAY,2,Andrei Pavel,Raemon Sluiter,Andrei Pavel,6-1; 3-6; 6-3,Q,93,2,2,48,77,36,48,15,29,5,7,13,51,77,7,3,43,69,27,43,15,26,2,6,12,42,69
2005-04-25 00:00:00.000,Munich Germany ATP World Tour,CLAY,2,David Nalbandian,Jarkko Nieminen,David Nalbandian,6-3; 6-0,S,59,3,3,36,52,25,36,8,16,3,5,8,33,52,0,0,23,36,8,23,2,13,1,7,7,10,36
2005-04-25 00:00:00.000,Munich Germany ATP World Tour,CLAY,2,Andrei Pavel,Tommy Haas,Andrei Pavel,6-4; 6-7(2); 6-4,S,167,6,1,81,122,50,81,19,41,11,16,16,69,122,4,5,62,108,41,62,18,46,4,11,16,59,108
2005-04-25 00:00:00.000,Munich Germany ATP World Tour,CLAY,2,David Nalbandian,Andrei Pavel,David Nalbandian,6-4; 6-1,F,69,0,1,27,45,18,27,13,18,0,1,8,31,45,2,0,34,52,16,34,6,18,2,7,9,22,52
2005-05-02 00:00:00.000,ATP Masters Series Rome Italy ATP World Tour,CLAY,2,Andy Roddick,Greg Rusedski,Andy Roddick,6-4; 6-2,R64,81,4,0,22,45,18,22,19,23,1,1,9,37,45,6,7,41,74,29,41,13,33,8,11,9,42,74
2005-05-02 00:00:00.000,ATP Masters Series Rome Italy ATP World Tour,CLAY,2,Albert Costa,Albert Montanes,Albert Costa,6-4; 6-4,R64,108,1,0,55,75,36,55,12,20,6,7,10,48,75,0,3,41,66,26,41,10,25,6,9,10,36,66
2005-05-02 00:00:00.000,ATP Masters Series Rome Italy ATP World Tour,CLAY,2,Stanislas Wawrinka,Tomas Berdych,Stanislas Wawrinka,6-1; 6-4,R64,66,3,2,39,61,26,39,13,22,3,4,9,39,61,2,2,24,44,16,24,5,20,0,4,8,21,44
2005-05-02 00:00:00.000,ATP Masters Series Rome Italy ATP World Tour,CLAY,2,Fernando Verdasco,Nikolay Davydenko,Fernando Verdasco,6-3; 7-5,R64,88,2,2,38,55,29,38,11,17,4,5,10,40,55,0,3,45,71,30,45,12,26,7,11,11,42,71
2005-05-02 00:00:00.000,ATP Masters Series Rome Italy ATP World Tour,CLAY,2,Guillermo Coria,Fernando Gonzalez,Guillermo Coria,7-6(5); 5-7; 6-4,R64,170,4,2,67,103,53,67,20,36,3,4,17,73,103,13,7,70,129,56,70,29,59,10,11,17,85,129
2005-05-02 00:00:00.000,ATP Masters Series Rome Italy ATP World Tour,CLAY,2,Nicolas Kiefer,Tommy Haas,Nicolas Kiefer,6-3; 6-1,R64,85,3,7,29,64,20,29,20,35,8,9,8,40,64,2,3,24,51,10,24,12,27,2,7,8,22,51
2005-05-02 00:00:00.000,ATP Masters Series Rome Italy ATP World Tour,CLAY,2,Davide Sanguinetti,Max Mirnyi,Davide Sanguinetti,5-7; 6-4; 7-6(6),R64,139,7,2,60,110,47,60,26,50,5,7,17,73,110,13,6,60,100,47,60,26,40,3,5,17,73,100
2005-05-02 00:00:00.000,ATP Masters Series Rome Italy ATP World Tour,CLAY,2,Fabrice Santoro,David Nalbandian,Fabrice Santoro,6-4; 1-6; 6-4,R64,148,3,1,44,88,29,44,23,44,2,6,13,52,88,8,3,54,96,32,54,23,42,4,8,14,55,96
2005-05-02 00:00:00.000,ATP Masters Series Rome Italy ATP World Tour,CLAY,2,Tim Henman,Gustavo Kuerten,Tim Henman,6-3; 6-3,R64,74,4,2,36,51,27,36,8,15,1,2,9,35,51,3,1,32,58,20,32,10,26,4,8,9,30,58
2005-05-02 00:00:00.000,ATP Masters Series Rome Italy ATP World Tour,CLAY,2,Nicolas Massu,Paul-Henri Mathieu,Nicolas Massu,6-0; 6-4,R64,75,6,3,20,41,17,20,13,21,1,2,8,30,41,0,2,28,50,15,28,8,22,4,9,8,23,50
2005-05-02 00:00:00.000,ATP Masters Series Rome Italy ATP World Tour,CLAY,2,Dominik Hrbaty,Ricardo Mello,Dominik Hrbaty,6-4; 6-3,R64,76,3,4,30,61,23,30,17,31,2,3,10,40,61,4,1,36,62,23,36,11,26,3,6,9,34,62
2005-05-02 00:00:00.000,ATP Masters Series Rome Italy ATP World Tour,CLAY,2,Julien Benneteau,Tommy Robredo,Julien Benneteau,6-1; 6-0,R64,59,0,2,27,51,19,27,16,24,6,6,7,35,51,1,0,20,35,10,20,3,15,1,6,6,13,35
2005-05-02 00:00:00.000,ATP Masters Series Rome Italy ATP World Tour,CLAY,2,Ivan Ljubicic,Olivier Rochus,Ivan Ljubicic,6-3; 6-3,R64,70,10,2,38,48,29,38,6,10,1,2,9,35,48,1,0,30,46,16,30,8,16,2,6,9,24,46
2005-05-02 00:00:00.000,ATP Masters Series Rome Italy ATP World Tour,CLAY,2,Sebastien Grosjean,Kenneth Carlsen,Sebastien Grosjean,6-3; 6-2,R64,108,6,0,30,57,21,30,18,27,2,3,9,39,57,4,8,41,84,25,41,16,43,8,12,8,41,84
2005-05-02 00:00:00.000,ATP Masters Series Rome Italy ATP World Tour,CLAY,2,Richard Gasquet,Paradorn Srichaphan,Richard Gasquet,6-0; 6-2,R64,48,3,2,24,38,21,24,8,14,2,2,7,29,38,1,4,14,38,9,14,5,24,1,6,7,14,38
2005-05-02 00:00:00.000,ATP Masters Series Rome Italy ATP World Tour,CLAY,2,Andre Agassi,Alessio Di Mauro,Andre Agassi,7-5; 6-2,R64,99,4,2,33,68,27,33,19,35,5,6,10,46,68,2,2,38,70,21,38,16,32,3,7,10,37,70
2005-05-02 00:00:00.000,ATP Masters Series Rome Italy ATP World Tour,CLAY,2,Potito Starace,Carlos Moya,Potito Starace,6-4; 7-6(7),R64,96,0,1,55,71,40,55,11,16,6,7,11,51,71,1,0,54,71,33,54,11,17,0,2,11,44,71
2005-05-02 00:00:00.000,ATP Masters Series Rome Italy ATP World Tour,CLAY,2,Alberto Martin,Rainer Schuettler,Alberto Martin,6-0; 1-0 RET,R64,28,1,0,8,18,7,8,6,10,2,2,3,13,18,0,0,16,20,4,16,0,4,2,6,4,4,20
2005-05-02 00:00:00.000,ATP Masters Series Rome Italy ATP World Tour,CLAY,2,Luis Horna,Florian Mayer,Luis Horna,4-6; 6-3; 7-5,R64,119,4,4,82,107,49,82,10,25,11,16,16,59,107,2,1,46,75,31,46,11,29,1,7,15,42,75
2005-05-02 00:00:00.000,ATP Masters Series Rome Italy ATP World Tour,CLAY,2,Andreas Seppi,Joachim Johansson,Andreas Seppi,6-1; 6-2,R64,50,9,3,22,46,20,22,15,24,3,3,8,35,46,5,5,15,35,11,15,6,20,0,4,7,17,35
2005-05-02 00:00:00.000,ATP Masters Series Rome Italy ATP World Tour,CLAY,2,Thomas Johansson,Feliciano Lopez,Thomas Johansson,6-3; 6-2,R64,88,7,1,35,57,26,35,11,22,6,7,9,37,57,4,4,46,76,27,46,12,30,7,11,8,39,76
2005-05-02 00:00:00.000,ATP Masters Series Rome Italy ATP World Tour,CLAY,2,David Ferrer,Cyril Saulnier,David Ferrer,6-1; 6-3,R64,71,1,2,24,50,14,24,17,26,2,3,8,31,50,1,4,24,50,11,24,9,26,8,13,8,20,50
2005-05-02 00:00:00.000,ATP Masters Series Rome Italy ATP World Tour,CLAY,2,Filippo Volandri,Younes El Aynaoui,Filippo Volandri,6-0; 6-2,R64,53,0,2,31,43,24,31,8,12,2,2,7,32,43,0,2,19,37,9,19,6,18,2,7,7,15,37
2005-05-02 00:00:00.000,ATP Masters Series Rome Italy ATP World Tour,CLAY,2,Gaston Gaudio,Karol Beck,Gaston Gaudio,6-4; 6-3,R64,78,0,1,41,57,31,41,10,16,7,7,9,41,57,2,3,36,57,26,36,9,21,5,8,10,35,57
2005-05-02 00:00:00.000,ATP Masters Series Rome Italy ATP World Tour,CLAY,2,Rafael Nadal,Mikhail Youzhny,Rafael Nadal,6-0; 6-2,R64,60,1,2,24,41,19,24,10,17,1,2,7,29,41,1,1,28,40,12,28,3,12,3,9,7,15,40
2005-05-02 00:00:00.000,ATP Masters Series Rome Italy ATP World Tour,CLAY,2,Victor Hanescu,Jurgen Melzer,Victor Hanescu,6-4; 3-6; 6-3,R64,124,4,1,60,80,44,60,12,20,1,2,14,56,80,3,3,79,109,54,79,12,30,6,8,14,66,109
2005-05-02 00:00:00.000,ATP Masters Series Rome Italy ATP World Tour,CLAY,2,Juan Monaco,Robin Soderling,Juan Monaco,6-3; 6-2,R64,64,2,0,38,54,26,38,12,16,4,5,9,38,54,2,4,24,45,16,24,7,21,1,5,8,23,45
2005-05-02 00:00:00.000,ATP Masters Series Rome Italy ATP World Tour,CLAY,2,Guillermo Canas,Andrei Pavel,Guillermo Canas,7-5; 6-2,R64,106,4,1,34,59,26,34,13,25,1,2,10,39,59,2,1,55,85,35,55,9,30,9,13,10,44,85
2005-05-02 00:00:00.000,ATP Masters Series Rome Italy ATP World Tour,CLAY,2,Radek Stepanek,Mario Ancic,Radek Stepanek,6-1; 6-7(5); 6-3,R64,157,2,4,54,95,36,54,26,41,5,6,13,62,95,9,4,66,111,39,66,18,45,12,18,15,57,111
2005-05-02 00:00:00.000,ATP Masters Series Rome Italy ATP World Tour,CLAY,2,Juan Ignacio Chela,Michael Llodra,Juan Ignacio Chela,6-4; 6-4,R64,85,1,2,34,53,23,34,9,19,0,3,10,32,53,0,2,43,75,21,43,16,32,9,14,10,37,75
2005-05-02 00:00:00.000,ATP Masters Series Rome Italy ATP World Tour,CLAY,2,Nicolas Almagro,Igor Andreev,Nicolas Almagro,3-6; 6-4; 6-1,R64,112,2,2,58,97,38,58,22,39,8,11,13,60,97,2,3,45,72,28,45,14,27,3,8,13,42,72
2005-05-02 00:00:00.000,ATP Masters Series Rome Italy ATP World Tour,CLAY,2,Marat Safin,Jiri Novak,Marat Safin,6-7(3); 6-1; 6-1,R64,112,6,2,38,78,33,38,19,40,5,7,13,52,78,2,2,58,90,32,58,14,32,3,10,13,46,90
2005-05-02 00:00:00.000,ATP Masters Series Rome Italy ATP World Tour,CLAY,2,Andy Roddick,Albert Costa,Andy Roddick,6-4; 7-5,R32,95,8,0,32,53,30,32,15,21,1,1,11,45,53,0,1,57,69,36,57,8,12,3,5,11,44,69
2005-05-02 00:00:00.000,ATP Masters Series Rome Italy ATP World Tour,CLAY,2,Fernando Verdasco,Stanislas Wawrinka,Fernando Verdasco,7-6(8); 6-2,R32,99,7,2,66,78,45,66,6,12,6,7,10,51,78,1,4,40,65,25,40,15,25,2,5,10,40,65
2005-05-02 00:00:00.000,ATP Masters Series Rome Italy ATP World Tour,CLAY,2,Guillermo Coria,Nicolas Kiefer,Guillermo Coria,6-1; 6-1,R32,75,1,3,27,42,23,27,7,15,3,3,7,30,42,2,1,25,50,11,25,10,25,4,9,7,21,50
2005-05-02 00:00:00.000,ATP Masters Series Rome Italy ATP World Tour,CLAY,2,Davide Sanguinetti,Fabrice Santoro,Davide Sanguinetti,6-3; 7-5,R32,84,2,2,33,55,27,33,9,22,1,3,10,36,55,4,0,35,59,22,35,9,24,7,12,11,31,59
2005-05-02 00:00:00.000,ATP Masters Series Rome Italy ATP World Tour,CLAY,2,Tim Henman,Nicolas Massu,Tim Henman,6-3; 6-2,R32,85,3,2,32,53,25,32,11,21,0,1,9,36,53,3,5,34,56,17,34,11,22,3,7,8,28,56
2005-05-02 00:00:00.000,ATP Masters Series Rome Italy ATP World Tour,CLAY,2,Dominik Hrbaty,Julien Benneteau,Dominik Hrbaty,7-6(4); 6-0,R32,83,3,0,40,61,32,40,13,21,6,7,9,45,61,0,2,37,55,22,37,7,18,2,6,9,29,55
2005-05-02 00:00:00.000,ATP Masters Series Rome Italy ATP World Tour,CLAY,2,Ivan Ljubicic,Sebastien Grosjean,Ivan Ljubicic,6-4; 3-6; 6-3,R32,154,3,2,58,105,40,58,23,47,5,8,14,63,105,3,0,38,82,25,38,25,44,5,9,14,50,82
2005-05-02 00:00:00.000,ATP Masters Series Rome Italy ATP World Tour,CLAY,2,Andre Agassi,Richard Gasquet,Andre Agassi,6-2; 6-3,R32,64,2,1,26,51,19,26,16,25,4,4,8,35,51,1,6,28,56,18,28,12,28,2,6,9,30,56
2005-05-02 00:00:00.000,ATP Masters Series Rome Italy ATP World Tour,CLAY,2,Alberto Martin,Potito Starace,Alberto Martin,6-3; 3-6; 6-3,R32,116,5,4,54,89,38,54,17,35,7,10,14,55,89,3,1,69,87,44,69,6,18,8,12,13,50,87
2005-05-02 00:00:00.000,ATP Masters Series Rome Italy ATP World Tour,CLAY,2,Luis Horna,Andreas Seppi,Luis Horna,2-6; 6-3; 6-4,R32,107,4,0,56,78,41,56,10,22,1,4,14,51,78,5,3,46,75,30,46,17,29,6,9,13,47,75
2005-05-02 00:00:00.000,ATP Masters Series Rome Italy ATP World Tour,CLAY,2,David Ferrer,Thomas Johansson,David Ferrer,6-3; 6-4,R32,91,3,4,36,60,23,36,15,24,3,5,10,38,60,3,2,33,67,19,33,16,34,1,5,9,35,67
2005-05-02 00:00:00.000,ATP Masters Series Rome Italy ATP World Tour,CLAY,2,Gaston Gaudio,Filippo Volandri,Gaston Gaudio,6-4; 6-2,R32,96,0,1,52,82,39,52,12,30,13,14,9,51,82,0,1,39,59,23,39,8,20,4,8,9,31,59
2005-05-02 00:00:00.000,ATP Masters Series Rome Italy ATP World Tour,CLAY,2,Rafael Nadal,Victor Hanescu,Rafael Nadal,6-1; 6-1,R32,63,0,2,25,42,19,25,10,17,1,1,7,29,42,0,2,29,44,14,29,4,15,2,7,7,18,44
2005-05-02 00:00:00.000,ATP Masters Series Rome Italy ATP World Tour,CLAY,2,Guillermo Canas,Juan Monaco,Guillermo Canas,6-0; 6-0,R32,65,3,1,27,31,23,27,2,4,1,1,6,25,31,0,0,41,48,13,41,3,7,2,8,6,16,48
2005-05-02 00:00:00.000,ATP Masters Series Rome Italy ATP World Tour,CLAY,2,Radek Stepanek,Juan Ignacio Chela,Radek Stepanek,6-4; 4-6; 6-1,R32,149,3,4,51,96,36,51,24,45,7,10,14,60,96,3,4,50,86,33,50,15,36,8,13,13,48,86
2005-05-02 00:00:00.000,ATP Masters Series Rome Italy ATP World Tour,CLAY,2,Nicolas Almagro,Marat Safin,Nicolas Almagro,6-4; 6-3,R32,95,2,0,51,74,30,51,15,23,9,11,10,45,74,9,1,35,62,21,35,12,27,6,10,9,33,62
2005-05-02 00:00:00.000,ATP Masters Series Rome Italy ATP World Tour,CLAY,2,Fernando Verdasco,Andy Roddick,Fernando Verdasco,6-7(1); 7-6(3); 6-4,R16,154,13,2,88,118,67,88,11,30,11,14,17,78,118,12,0,87,121,61,87,13,34,9,13,17,74,121
2005-05-02 00:00:00.000,ATP Masters Series Rome Italy ATP World Tour,CLAY,2,Guillermo Coria,Davide Sanguinetti,Guillermo Coria,6-0; 6-4,R16,77,0,0,34,50,24,34,11,16,2,2,8,35,50,0,0,32,58,21,32,9,26,5,9,8,30,58
2005-05-02 00:00:00.000,ATP Masters Series Rome Italy ATP World Tour,CLAY,2,Dominik Hrbaty,Tim Henman,Dominik Hrbaty,6-3; 3-6; 6-3,R16,121,2,8,45,88,35,45,17,43,2,6,13,52,88,5,3,45,88,30,45,18,43,8,14,14,48,88
2005-05-02 00:00:00.000,ATP Masters Series Rome Italy ATP World Tour,CLAY,2,Andre Agassi,Ivan Ljubicic,Andre Agassi,7-6(4); 6-3,R16,103,6,0,49,76,37,49,14,27,3,4,11,51,76,8,2,37,65,25,37,15,28,1,3,10,40,65
2005-05-02 00:00:00.000,ATP Masters Series Rome Italy ATP World Tour,CLAY,2,Alberto Martin,Luis Horna,Alberto Martin,6-1; 6-3,R16,89,0,2,36,62,28,36,13,26,6,6,8,41,62,2,2,40,64,22,40,11,24,9,13,8,33,64
2005-05-02 00:00:00.000,ATP Masters Series Rome Italy ATP World Tour,CLAY,2,David Ferrer,Gaston Gaudio,David Ferrer,6-0; 6-1,R16,59,0,1,27,43,19,27,9,16,1,2,7,28,43,0,1,33,44,12,33,2,11,6,12,6,14,44
2005-05-02 00:00:00.000,ATP Masters Series Rome Italy ATP World Tour,CLAY,2,Rafael Nadal,Guillermo Canas,Rafael Nadal,6-3; 6-1,R16,84,1,1,36,45,28,36,5,9,0,0,8,33,45,1,0,31,51,14,31,11,20,5,9,8,25,51
2005-05-02 00:00:00.000,ATP Masters Series Rome Italy ATP World Tour,CLAY,2,Radek Stepanek,Nicolas Almagro,Radek Stepanek,4-6; 6-4; 6-2,R16,119,5,4,45,75,33,45,20,30,3,5,14,53,75,5,3,60,98,41,60,16,38,9,13,14,57,98
2005-05-02 00:00:00.000,ATP Masters Series Rome Italy ATP World Tour,CLAY,2,Guillermo Coria,Fernando Verdasco,Guillermo Coria,3-6; 6-3; 6-3,Q,125,1,1,48,84,33,48,20,36,3,5,13,53,84,5,1,58,87,38,58,12,29,3,7,14,50,87
2005-05-02 00:00:00.000,ATP Masters Series Rome Italy ATP World Tour,CLAY,2,Andre Agassi,Dominik Hrbaty,Andre Agassi,6-3; 6-3,Q,72,3,2,29,53,22,29,10,24,3,6,9,32,53,2,1,37,58,20,37,3,21,5,11,9,23,58
2005-05-02 00:00:00.000,ATP Masters Series Rome Italy ATP World Tour,CLAY,2,David Ferrer,Alberto Martin,David Ferrer,6-2; 3-6; 7-5,Q,139,2,3,76,106,47,76,9,30,10,16,15,56,106,1,6,52,90,29,52,17,38,6,13,14,46,90
2005-05-02 00:00:00.000,ATP Masters Series Rome Italy ATP World Tour,CLAY,2,Rafael Nadal,Radek Stepanek,Rafael Nadal,5-7; 6-1; 6-1,Q,129,0,0,58,78,42,58,10,20,2,4,13,52,78,2,3,51,82,30,51,13,31,5,11,13,43,82
2005-05-02 00:00:00.000,ATP Masters Series Rome Italy ATP World Tour,CLAY,2,Guillermo Coria,Andre Agassi,Guillermo Coria,7-5; 7-6(0),S,106,4,3,52,68,38,52,5,16,2,6,12,43,68,3,3,41,76,25,41,12,35,5,10,12,37,76
2005-05-02 00:00:00.000,ATP Masters Series Rome Italy ATP World Tour,CLAY,2,Rafael Nadal,David Ferrer,Rafael Nadal,4-6; 6-4; 7-5,S,149,0,0,71,102,43,71,16,31,1,7,16,59,102,2,4,51,82,31,51,14,31,2,9,16,45,82
2005-05-02 00:00:00.000,ATP Masters Series Rome Italy ATP World Tour,CLAY,2,Rafael Nadal,Guillermo Coria,Rafael Nadal,6-4; 3-6; 6-3; 4-6; 7-6(6),F,314,1,3,119,176,70,119,26,57,8,17,25,96,176,3,7,148,202,85,148,23,54,11,20,25,108,202
2005-05-09 00:00:00.000,ATP Masters Series Hamburg Germany ATP World Tour,CLAY,2,Roger Federer,Fernando Verdasco,Roger Federer,6-4; 6-3,R64,73,6,0,31,49,26,31,14,18,0,0,10,40,49,0,1,42,57,29,42,7,15,5,7,9,36,57
2005-05-09 00:00:00.000,ATP Masters Series Hamburg Germany ATP World Tour,CLAY,2,Tomas Berdych,David Ferrer,Tomas Berdych,6-2; 2-6; 6-3,R64,113,2,2,57,104,41,57,24,47,14,16,13,65,104,1,4,32,57,24,32,14,25,1,4,12,38,57
2005-05-09 00:00:00.000,ATP Masters Series Hamburg Germany ATP World Tour,CLAY,2,Gustavo Kuerten,Andrei Pavel,Gustavo Kuerten,6-2; 6-1,R64,56,5,1,29,55,22,29,16,26,4,4,8,38,55,1,0,32,40,19,32,1,8,4,8,7,20,40
2005-05-09 00:00:00.000,ATP Masters Series Hamburg Germany ATP World Tour,CLAY,2,Tommy Robredo,Alexander Waske,Tommy Robredo,4-6; 7-5; 6-3,R64,124,4,4,52,87,37,52,19,35,1,5,16,56,87,3,4,65,106,40,65,18,41,9,14,15,58,106
2005-05-09 00:00:00.000,ATP Masters Series Hamburg Germany ATP World Tour,CLAY,2,Guillermo Coria,Vincent Spadea,Guillermo Coria,6-0; 6-2,R64,60,1,0,39,48,29,39,6,9,4,4,7,35,48,1,4,24,41,13,24,3,17,2,7,7,16,41
2005-05-09 00:00:00.000,ATP Masters Series Hamburg Germany ATP World Tour,CLAY,2,Mikhail Youzhny,Karol Beck,Mikhail Youzhny,6-3; 6-2,R64,66,2,0,24,40,16,24,13,16,0,1,8,29,40,2,2,31,59,15,31,13,28,6,11,9,28,59
2005-05-09 00:00:00.000,ATP Masters Series Hamburg Germany ATP World Tour,CLAY,2,Mario Ancic,Florian Mayer,Mario Ancic,6-1; 6-2,R64,61,8,0,34,48,27,34,8,14,2,2,8,35,48,0,1,34,51,16,34,8,17,6,10,7,24,51
2005-05-09 00:00:00.000,ATP Masters Series Hamburg Germany ATP World Tour,CLAY,2,Fernando Gonzalez,Paul-Henri Mathieu,Fernando Gonzalez,6-4; 6-4,R64,109,3,1,34,62,28,34,15,28,2,2,10,43,62,2,1,40,65,32,40,10,25,2,4,10,42,65
2005-05-09 00:00:00.000,ATP Masters Series Hamburg Germany ATP World Tour,CLAY,2,Marat Safin,Alberto Martin,Marat Safin,6-1; 6-0,R64,50,3,1,23,38,21,23,8,15,1,1,7,29,38,0,2,24,40,9,24,6,16,2,7,6,15,40
2005-05-09 00:00:00.000,ATP Masters Series Hamburg Germany ATP World Tour,CLAY,2,Juan Carlos Ferrero,Jurgen Melzer,Juan Carlos Ferrero,6-3; 7-5,R64,90,0,1,39,55,28,39,10,16,4,6,10,38,55,2,3,53,92,29,53,19,39,9,14,11,48,92
2005-05-09 00:00:00.000,ATP Masters Series Hamburg Germany ATP World Tour,CLAY,2,Mariano Puerta,Olivier Rochus,Mariano Puerta,4-6; 6-1; 6-3,R64,116,2,2,54,83,40,54,14,29,6,8,13,54,83,6,4,56,86,35,56,10,30,5,10,13,45,86
2005-05-09 00:00:00.000,ATP Masters Series Hamburg Germany ATP World Tour,CLAY,2,Nikolay Davydenko,Michael Llodra,Nikolay Davydenko,6-1; 6-1,R64,46,0,0,28,38,23,28,7,10,1,1,7,30,38,1,0,29,43,15,29,3,14,0,5,7,18,43
2005-05-09 00:00:00.000,ATP Masters Series Hamburg Germany ATP World Tour,CLAY,2,Sebastien Grosjean,Joachim Johansson,Sebastien Grosjean,6-1; 6-4,R64,64,7,0,38,51,28,38,11,13,1,1,9,39,51,2,6,26,50,18,26,9,24,1,4,8,27,50
2005-05-09 00:00:00.000,ATP Masters Series Hamburg Germany ATP World Tour,CLAY,2,Nicolas Kiefer,Philipp Kohlschreiber,Nicolas Kiefer,6-4; 6-3,R64,98,3,0,35,60,22,35,14,25,3,6,10,36,60,4,3,42,76,25,42,14,34,2,7,9,39,76
2005-05-09 00:00:00.000,ATP Masters Series Hamburg Germany ATP World Tour,CLAY,2,Filippo Volandri,Nicolas Almagro,Filippo Volandri,6-3; 6-2,R64,81,0,0,46,67,28,46,14,21,8,9,8,42,67,3,2,42,73,25,42,12,31,6,11,9,37,73
2005-05-09 00:00:00.000,ATP Masters Series Hamburg Germany ATP World Tour,CLAY,2,Feliciano Lopez,Andre Agassi,Feliciano Lopez,6-2; 7-6(5),R64,92,6,2,56,77,40,56,10,21,4,5,10,50,77,6,2,54,83,33,54,14,29,9,12,10,47,83
2005-05-09 00:00:00.000,ATP Masters Series Hamburg Germany ATP World Tour,CLAY,2,Tim Henman,Lars Burgsmuller,Tim Henman,6-3; 6-4,R64,85,5,1,33,55,27,33,14,22,0,0,10,41,55,1,4,37,67,23,37,19,30,8,10,9,42,67
2005-05-09 00:00:00.000,ATP Masters Series Hamburg Germany ATP World Tour,CLAY,2,Greg Rusedski,Philipp Petzschner,Greg Rusedski,7-6(3); 3-6; 6-3,R64,126,7,4,66,103,49,66,21,37,6,7,15,70,103,3,1,50,90,33,50,29,40,2,3,15,62,90
2005-05-09 00:00:00.000,ATP Masters Series Hamburg Germany ATP World Tour,CLAY,2,Juan Ignacio Chela,Thomas Johansson,Juan Ignacio Chela,4-6; 6-3; 6-4,R64,193,2,4,78,117,52,78,12,39,9,14,15,64,117,1,0,32,98,20,32,33,66,11,17,14,53,98
2005-05-09 00:00:00.000,ATP Masters Series Hamburg Germany ATP World Tour,CLAY,2,Robin Soderling,David Nalbandian,Robin Soderling,7-6(8); 7-5,R64,126,8,2,63,107,44,63,21,44,4,6,12,65,107,1,3,44,78,33,44,16,34,4,7,12,49,78
2005-05-09 00:00:00.000,ATP Masters Series Hamburg Germany ATP World Tour,CLAY,2,Ivan Ljubicic,Luis Horna,Ivan Ljubicic,6-3; 6-3,R64,64,11,1,36,46,30,36,7,10,2,2,9,37,46,3,2,34,54,22,34,9,20,2,5,9,31,54
2005-05-09 00:00:00.000,ATP Masters Series Hamburg Germany ATP World Tour,CLAY,2,Christophe Rochus,Santiago Ventura,Christophe Rochus,6-3; 6-2,R64,92,0,0,41,68,26,41,13,27,5,7,8,39,68,1,1,39,66,18,39,12,27,7,13,9,30,66
2005-05-09 00:00:00.000,ATP Masters Series Hamburg Germany ATP World Tour,CLAY,2,Albert Costa,Max Mirnyi,Albert Costa,7-6(3); 7-5,R64,115,3,2,70,99,48,70,15,29,11,12,12,63,99,8,1,45,73,33,45,15,28,1,3,12,48,73
2005-05-09 00:00:00.000,ATP Masters Series Hamburg Germany ATP World Tour,CLAY,2,Gaston Gaudio,David Sanchez,Gaston Gaudio,6-2; 6-2,R64,77,0,0,29,52,21,29,15,23,1,1,8,36,52,1,1,37,59,23,37,8,22,4,8,8,31,59
2005-05-09 00:00:00.000,ATP Masters Series Hamburg Germany ATP World Tour,CLAY,2,Juan Monaco,Igor Andreev,Juan Monaco,6-2; 6-7(5); 6-1,R64,118,1,2,62,86,33,62,15,24,4,8,13,48,86,1,4,54,82,28,54,10,28,5,14,14,38,82
2005-05-09 00:00:00.000,ATP Masters Series Hamburg Germany ATP World Tour,CLAY,2,Jiri Novak,Paradorn Srichaphan,Jiri Novak,6-2; 6-3,R64,60,0,0,35,55,26,35,10,20,4,5,9,36,55,2,2,30,52,17,30,9,22,3,7,8,26,52
2005-05-09 00:00:00.000,ATP Masters Series Hamburg Germany ATP World Tour,CLAY,2,Andreas Seppi,Rainer Schuettler,Andreas Seppi,7-5; 6-7(5); 6-4,R64,170,2,1,69,112,46,69,22,43,8,13,17,68,112,1,4,68,117,43,68,24,49,9,16,17,67,117
2005-05-09 00:00:00.000,ATP Masters Series Hamburg Germany ATP World Tour,CLAY,2,Guillermo Canas,Fabrice Santoro,Guillermo Canas,6-2; 6-1,R64,65,2,0,35,53,27,35,7,18,5,6,8,34,53,0,1,23,39,12,23,5,16,1,6,7,17,39
2005-05-09 00:00:00.000,ATP Masters Series Hamburg Germany ATP World Tour,CLAY,2,Radek Stepanek,Cyril Saulnier,Radek Stepanek,7-6(5); 6-2,R64,88,5,2,48,65,37,48,6,17,2,4,10,43,65,0,2,41,64,28,41,8,23,3,7,10,36,64
2005-05-09 00:00:00.000,ATP Masters Series Hamburg Germany ATP World Tour,CLAY,2,Dominik Hrbaty,Tommy Haas,Dominik Hrbaty,6-4; 7-5,R64,88,4,2,37,69,27,37,20,32,1,2,11,47,69,6,0,31,53,26,31,10,22,0,3,11,36,53
2005-05-09 00:00:00.000,ATP Masters Series Hamburg Germany ATP World Tour,CLAY,2,Richard Gasquet,Ivo Karlovic,Richard Gasquet,6-1; 1-0 RET,R64,35,0,0,13,18,13,13,3,5,0,0,4,16,18,2,0,11,21,4,11,4,10,0,3,4,8,21
2005-05-09 00:00:00.000,ATP Masters Series Hamburg Germany ATP World Tour,CLAY,2,Nicolas Massu,Andy Roddick,Nicolas Massu,7-6(4); 4-6; 7-5,R64,178,8,1,73,113,46,73,24,40,5,9,17,70,113,19,3,75,115,53,75,18,40,7,11,17,71,115
2005-05-09 00:00:00.000,ATP Masters Series Hamburg Germany ATP World Tour,CLAY,2,Roger Federer,Tomas Berdych,Roger Federer,6-2; 6-1,R32,54,4,0,25,41,21,25,9,16,1,1,7,30,41,2,2,23,40,12,23,5,17,2,7,8,17,40
2005-05-09 00:00:00.000,ATP Masters Series Hamburg Germany ATP World Tour,CLAY,2,Tommy Robredo,Gustavo Kuerten,Tommy Robredo,6-3; 6-0,R32,62,2,1,30,45,21,30,11,15,2,3,8,32,45,0,4,28,53,16,28,7,25,7,12,7,23,53
2005-05-09 00:00:00.000,ATP Masters Series Hamburg Germany ATP World Tour,CLAY,2,Guillermo Coria,Mikhail Youzhny,Guillermo Coria,6-2; 6-3,R32,83,0,1,47,57,31,47,6,10,4,5,8,37,57,1,0,39,59,20,39,8,20,6,11,9,28,59
2005-05-09 00:00:00.000,ATP Masters Series Hamburg Germany ATP World Tour,CLAY,2,Mario Ancic,Fernando Gonzalez,Mario Ancic,6-3; 7-6(1),R32,95,4,1,47,76,36,47,13,29,4,6,11,49,76,2,8,39,66,29,39,11,27,2,5,10,40,66
2005-05-09 00:00:00.000,ATP Masters Series Hamburg Germany ATP World Tour,CLAY,2,Juan Carlos Ferrero,Marat Safin,Juan Carlos Ferrero,4-6; 6-4; 6-2,R32,132,1,2,62,86,46,62,12,24,3,4,14,58,86,9,4,60,97,47,60,12,37,8,11,14,59,97
2005-05-09 00:00:00.000,ATP Masters Series Hamburg Germany ATP World Tour,CLAY,2,Nikolay Davydenko,Mariano Puerta,Nikolay Davydenko,7-5; 6-3,R32,110,6,1,46,75,31,46,13,29,9,11,10,44,75,1,2,46,76,24,46,14,30,5,10,11,38,76
2005-05-09 00:00:00.000,ATP Masters Series Hamburg Germany ATP World Tour,CLAY,2,Sebastien Grosjean,Nicolas Kiefer,Sebastien Grosjean,2-6; 6-3; 6-4,R32,139,3,0,40,72,27,40,20,32,1,5,14,47,72,6,3,49,103,37,49,21,54,12,16,13,58,103
2005-05-09 00:00:00.000,ATP Masters Series Hamburg Germany ATP World Tour,CLAY,2,Filippo Volandri,Feliciano Lopez,Filippo Volandri,6-4; 2-6; 6-2,R32,99,1,1,54,72,38,54,8,18,0,4,13,46,72,3,1,54,82,35,54,10,28,9,14,13,45,82
2005-05-09 00:00:00.000,ATP Masters Series Hamburg Germany ATP World Tour,CLAY,2,Tim Henman,Greg Rusedski,Tim Henman,7-6(3); 6-4,R32,110,4,1,51,74,37,51,12,23,1,3,11,49,74,3,4,56,85,34,56,17,29,8,11,11,51,85
2005-05-09 00:00:00.000,ATP Masters Series Hamburg Germany ATP World Tour,CLAY,2,Juan Ignacio Chela,Robin Soderling,Juan Ignacio Chela,6-1; 6-4,R32,87,0,1,29,43,23,29,7,14,0,1,8,30,43,2,4,28,54,15,28,11,26,4,9,9,26,54
2005-05-09 00:00:00.000,ATP Masters Series Hamburg Germany ATP World Tour,CLAY,2,Christophe Rochus,Ivan Ljubicic,Christophe Rochus,6-4; 6-2,R32,73,1,2,28,50,19,28,15,22,0,1,9,34,50,4,2,29,56,17,29,12,27,1,5,9,29,56
2005-05-09 00:00:00.000,ATP Masters Series Hamburg Germany ATP World Tour,CLAY,2,Gaston Gaudio,Albert Costa,Gaston Gaudio,7-5; 6-0,R32,85,5,3,29,57,21,29,15,28,2,4,9,36,57,2,0,41,56,18,41,6,15,1,7,9,24,56
2005-05-09 00:00:00.000,ATP Masters Series Hamburg Germany ATP World Tour,CLAY,2,Jiri Novak,Juan Monaco,Jiri Novak,6-3; 4-6; 7-6(6),R32,152,1,2,82,125,47,82,19,43,9,16,16,66,125,1,0,68,103,32,68,19,35,3,10,15,51,103
2005-05-09 00:00:00.000,ATP Masters Series Hamburg Germany ATP World Tour,CLAY,2,Andreas Seppi,Guillermo Canas,Andreas Seppi,7-6(9); 6-2,R32,129,1,2,54,94,36,54,17,40,9,11,10,53,94,4,2,40,66,22,40,14,26,0,4,10,36,66
2005-05-09 00:00:00.000,ATP Masters Series Hamburg Germany ATP World Tour,CLAY,2,Dominik Hrbaty,Radek Stepanek,Dominik Hrbaty,7-5; 7-6(2),R32,113,1,2,51,77,41,51,10,26,7,9,12,51,77,4,6,56,100,38,56,20,44,9,12,12,58,100
2005-05-09 00:00:00.000,ATP Masters Series Hamburg Germany ATP World Tour,CLAY,2,Richard Gasquet,Nicolas Massu,Richard Gasquet,2-6; 6-2; 6-2,R32,111,3,1,47,66,30,47,9,19,2,6,12,39,66,1,3,42,78,28,42,12,36,6,12,12,40,78
2005-05-09 00:00:00.000,ATP Masters Series Hamburg Germany ATP World Tour,CLAY,2,Roger Federer,Tommy Robredo,Roger Federer,6-2; 6-3,R16,67,2,3,29,55,23,29,12,26,3,4,9,35,55,1,0,29,49,15,29,10,20,1,5,8,25,49
2005-05-09 00:00:00.000,ATP Masters Series Hamburg Germany ATP World Tour,CLAY,2,Guillermo Coria,Mario Ancic,Guillermo Coria,6-4; 6-3,R16,82,0,0,32,46,22,32,11,14,2,3,9,33,46,2,0,36,58,23,36,8,22,4,8,10,31,58
2005-05-09 00:00:00.000,ATP Masters Series Hamburg Germany ATP World Tour,CLAY,2,Nikolay Davydenko,Juan Carlos Ferrero,Nikolay Davydenko,3-6; 6-2; 6-1,R16,103,2,3,34,60,24,34,15,26,0,3,12,39,60,3,0,65,82,33,65,8,17,6,12,12,41,82
2005-05-09 00:00:00.000,ATP Masters Series Hamburg Germany ATP World Tour,CLAY,2,Filippo Volandri,Sebastien Grosjean,Filippo Volandri,6-3; 6-4,R16,81,0,1,35,54,24,35,13,19,3,4,9,37,54,0,2,28,58,16,28,14,30,1,5,10,30,58
2005-05-09 00:00:00.000,ATP Masters Series Hamburg Germany ATP World Tour,CLAY,2,Juan Ignacio Chela,Tim Henman,Juan Ignacio Chela,3-6; 6-4; 6-2,R16,127,0,4,60,92,36,60,16,32,10,14,13,52,92,1,3,54,85,36,54,10,31,11,17,14,46,85
2005-05-09 00:00:00.000,ATP Masters Series Hamburg Germany ATP World Tour,CLAY,2,Christophe Rochus,Gaston Gaudio,Christophe Rochus,2-6; 7-5; 6-3,R16,140,1,1,46,102,30,46,25,56,8,14,15,55,102,3,1,67,106,42,67,14,39,12,18,14,56,106
2005-05-09 00:00:00.000,ATP Masters Series Hamburg Germany ATP World Tour,CLAY,2,Andreas Seppi,Jiri Novak,Andreas Seppi,6-3; 6-4,R16,70,2,1,27,56,17,27,19,29,4,6,10,36,56,4,1,36,53,19,36,8,17,4,8,9,27,53
2005-05-09 00:00:00.000,ATP Masters Series Hamburg Germany ATP World Tour,CLAY,2,Richard Gasquet,Dominik Hrbaty,Richard Gasquet,6-1; 6-2,R16,53,4,0,27,42,23,27,10,15,1,1,8,33,42,2,2,26,44,13,26,6,18,3,7,7,19,44
2005-05-09 00:00:00.000,ATP Masters Series Hamburg Germany ATP World Tour,CLAY,2,Roger Federer,Guillermo Coria,Roger Federer,6-4; 7-6(3),Q,95,5,2,39,66,26,39,18,27,1,3,11,44,66,2,4,50,72,31,50,10,22,3,6,11,41,72
2005-05-09 00:00:00.000,ATP Masters Series Hamburg Germany ATP World Tour,CLAY,2,Nikolay Davydenko,Filippo Volandri,Nikolay Davydenko,7-6(5); 6-4,Q,110,1,1,37,63,26,37,15,26,2,5,11,41,63,1,3,56,77,29,56,12,21,7,11,11,41,77
2005-05-09 00:00:00.000,ATP Masters Series Hamburg Germany ATP World Tour,CLAY,2,Christophe Rochus,Juan Ignacio Chela,Christophe Rochus,3-6; 6-0; 6-3,Q,114,0,2,56,89,37,56,18,33,7,10,12,55,89,3,1,48,78,28,48,11,30,6,12,12,39,78
2005-05-09 00:00:00.000,ATP Masters Series Hamburg Germany ATP World Tour,CLAY,2,Richard Gasquet,Andreas Seppi,Richard Gasquet,6-1; 6-2,Q,53,0,0,20,37,18,20,14,17,0,0,8,32,37,1,0,26,39,15,26,4,13,1,5,7,19,39
2005-05-09 00:00:00.000,ATP Masters Series Hamburg Germany ATP World Tour,CLAY,2,Roger Federer,Nikolay Davydenko,Roger Federer,6-3; 6-4,S,72,0,0,38,62,26,38,16,24,5,6,10,42,62,0,2,30,47,17,30,10,17,0,3,9,27,47
2005-05-09 00:00:00.000,ATP Masters Series Hamburg Germany ATP World Tour,CLAY,2,Richard Gasquet,Christophe Rochus,Richard Gasquet,6-1; 6-1,S,56,3,1,37,57,26,37,9,20,6,7,7,35,57,0,3,21,41,8,21,6,20,5,11,7,14,41
2005-05-09 00:00:00.000,ATP Masters Series Hamburg Germany ATP World Tour,CLAY,2,Roger Federer,Richard Gasquet,Roger Federer,6-3; 7-5; 7-6(4),F,133,4,4,70,112,53,70,29,42,5,5,17,82,112,1,3,49,88,39,49,23,39,1,3,16,62,88
2005-05-16 00:00:00.000,St. Poelten Austria ATP World Tour,CLAY,2,Nikolay Davydenko,Michal Mertinak,Nikolay Davydenko,6-3; 6-2,R32,73,3,2,33,46,22,33,9,13,1,2,8,31,46,2,2,37,55,18,37,6,18,3,8,9,24,55
2005-05-16 00:00:00.000,St. Poelten Austria ATP World Tour,CLAY,2,Sjeng Schalken,Kevin Kim,Sjeng Schalken,6-3; 2-6; 6-3,R32,113,1,3,62,97,35,62,21,35,9,13,13,56,97,5,2,66,91,43,66,9,25,8,13,13,52,91
2005-05-16 00:00:00.000,St. Poelten Austria ATP World Tour,CLAY,2,Felix Mantilla,Francisco Fogues,Felix Mantilla,7-6(10); 7-5,R32,113,1,3,39,76,32,39,19,37,2,4,12,51,76,4,0,55,82,34,55,17,27,5,8,12,51,82
2005-05-16 00:00:00.000,St. Poelten Austria ATP World Tour,CLAY,2,Mariano Puerta,Alex Calatrava,Mariano Puerta,7-5; 6-2,R32,77,3,2,35,55,28,35,10,20,3,5,10,38,55,7,3,35,54,25,35,3,19,3,8,10,28,54
2005-05-16 00:00:00.000,St. Poelten Austria ATP World Tour,CLAY,2,Jose Acasuso,Igor Andreev,Jose Acasuso,3-6; 6-3; 6-2,R32,105,4,2,40,74,31,40,15,34,4,7,13,46,74,4,2,39,69,26,39,13,30,2,7,13,39,69
2005-05-16 00:00:00.000,St. Poelten Austria ATP World Tour,CLAY,2,Nicolas Almagro,Ivo Karlovic,Nicolas Almagro,7-6(2); 7-6(3),R32,80,2,2,58,80,45,58,15,22,6,7,12,60,80,17,1,44,67,37,44,14,23,0,1,12,51,67
2005-05-16 00:00:00.000,St. Poelten Austria ATP World Tour,CLAY,2,Victor Hanescu,Jan Hernych,Victor Hanescu,4-6; 6-1; 6-3,R32,114,3,2,51,77,34,51,17,26,3,5,13,51,77,1,1,55,96,32,55,22,41,10,15,13,54,96
2005-05-16 00:00:00.000,St. Poelten Austria ATP World Tour,CLAY,2,Michael Kohlmann,Tomas Zib,Michael Kohlmann,2-6; 7-6(7); 6-4,R32,126,6,7,83,123,53,83,16,40,11,17,15,69,123,5,0,66,103,40,66,19,37,8,13,15,59,103
2005-05-16 00:00:00.000,St. Poelten Austria ATP World Tour,CLAY,2,Potito Starace,Philipp Kohlschreiber,Potito Starace,6-3; 7-6(2),R32,91,3,6,61,82,41,61,8,21,3,6,11,49,82,2,8,27,73,17,27,20,46,4,8,10,37,73
2005-05-16 00:00:00.000,St. Poelten Austria ATP World Tour,CLAY,2,David Sanchez,Robby Ginepri,David Sanchez,3-6; 7-6(5); 6-4,R32,134,4,5,78,117,48,78,18,39,7,13,15,66,117,0,2,60,93,41,60,13,33,4,10,16,54,93
2005-05-16 00:00:00.000,St. Poelten Austria ATP World Tour,CLAY,2,Gilles Muller,Albert Montanes,Gilles Muller,6-2 RET,R32,35,3,1,10,17,10,10,6,7,0,0,4,16,17,0,3,13,24,5,13,5,11,0,2,4,10,24
2005-05-16 00:00:00.000,St. Poelten Austria ATP World Tour,CLAY,2,Jurgen Melzer,Marco Mirnegg,Jurgen Melzer,6-3; 6-1,R32,66,4,0,23,49,18,23,15,26,4,5,8,33,49,0,4,28,57,17,28,9,29,10,15,8,26,57
2005-05-16 00:00:00.000,St. Poelten Austria ATP World Tour,CLAY,2,Luis Horna,Daniel Koellerer,Luis Horna,4-6; 6-2; 6-4,R32,159,8,3,63,101,44,63,20,38,7,8,14,64,101,0,1,76,96,47,76,13,20,5,8,14,60,96
2005-05-16 00:00:00.000,St. Poelten Austria ATP World Tour,CLAY,2,Guillermo Garcia-Lopez,Jean-Rene Lisnard,Guillermo Garcia-Lopez,6-3; 7-5,R32,100,1,2,46,66,34,46,8,20,2,4,11,42,66,3,4,47,86,31,47,16,39,9,13,10,47,86
2005-05-16 00:00:00.000,St. Poelten Austria ATP World Tour,CLAY,2,Davide Sanguinetti,Jiri Vanek,Davide Sanguinetti,6-4; 6-2,R32,58,9,5,26,44,22,26,10,18,0,1,9,32,44,1,3,36,61,23,36,8,25,8,12,9,31,61
2005-05-16 00:00:00.000,St. Poelten Austria ATP World Tour,CLAY,2,Christophe Rochus,Paradorn Srichaphan,Christophe Rochus,6-1; 6-3,R32,56,2,0,27,48,19,27,11,21,1,3,8,30,48,4,3,27,46,11,27,4,19,6,12,8,15,46
2005-05-16 00:00:00.000,St. Poelten Austria ATP World Tour,CLAY,2,Nikolay Davydenko,Sjeng Schalken,Nikolay Davydenko,6-3; 6-1,R16,74,5,4,28,53,23,28,15,25,7,7,8,38,53,0,1,34,51,19,34,7,17,4,8,8,26,51
2005-05-16 00:00:00.000,St. Poelten Austria ATP World Tour,CLAY,2,Felix Mantilla,Mariano Puerta,Felix Mantilla,7-6(2); 4-6; 7-5,R16,157,11,8,69,131,55,69,32,62,8,9,17,87,131,13,3,68,110,53,68,23,42,4,5,17,76,110
2005-05-16 00:00:00.000,St. Poelten Austria ATP World Tour,CLAY,2,Jose Acasuso,Nicolas Almagro,Jose Acasuso,6-4; 6-4,R16,86,2,2,36,61,30,36,14,25,4,4,10,44,61,0,2,52,70,34,52,8,18,5,7,10,42,70
2005-05-16 00:00:00.000,St. Poelten Austria ATP World Tour,CLAY,2,Michael Kohlmann,Victor Hanescu,Michael Kohlmann,6-3; 2-6; 7-6(2),R16,107,7,2,58,87,40,58,15,29,1,5,14,55,87,7,0,60,96,45,60,14,36,5,9,15,59,96
2005-05-16 00:00:00.000,St. Poelten Austria ATP World Tour,CLAY,2,David Sanchez,Potito Starace,David Sanchez,6-4; 6-4,R16,77,3,1,39,66,27,39,17,27,4,5,10,44,66,3,1,38,56,27,38,7,18,2,5,10,34,56
2005-05-16 00:00:00.000,St. Poelten Austria ATP World Tour,CLAY,2,Jurgen Melzer,Gilles Muller,Jurgen Melzer,6-2; 6-7(5); 7-5,R16,147,4,4,62,99,47,62,18,37,5,7,16,65,99,10,10,68,117,50,68,15,49,7,12,16,65,117
2005-05-16 00:00:00.000,St. Poelten Austria ATP World Tour,CLAY,2,Guillermo Garcia-Lopez,Luis Horna,Guillermo Garcia-Lopez,6-1; 6-4,R16,82,0,3,48,71,30,48,13,23,8,10,9,43,71,3,3,35,55,18,35,6,20,7,12,8,24,55
2005-05-16 00:00:00.000,St. Poelten Austria ATP World Tour,CLAY,2,Christophe Rochus,Davide Sanguinetti,Christophe Rochus,6-3; 6-3,R16,61,0,3,26,48,17,26,15,22,2,4,9,32,48,3,0,37,58,21,37,6,21,3,8,9,27,58
2005-05-16 00:00:00.000,St. Poelten Austria ATP World Tour,CLAY,2,Nikolay Davydenko,Felix Mantilla,Nikolay Davydenko,6-3; 7-5,Q,93,6,5,30,60,25,30,10,30,1,4,10,35,60,0,4,54,74,30,54,6,20,5,11,11,36,74
2005-05-16 00:00:00.000,St. Poelten Austria ATP World Tour,CLAY,2,Jose Acasuso,Michael Kohlmann,Jose Acasuso,6-2; 7-6(5),Q,82,5,2,38,67,31,38,17,29,2,2,10,48,67,1,2,33,67,23,33,18,34,1,3,10,41,67
2005-05-16 00:00:00.000,St. Poelten Austria ATP World Tour,CLAY,2,Jurgen Melzer,David Sanchez,Jurgen Melzer,5-7; 6-4; 6-4,Q,127,3,5,63,111,38,63,24,48,9,14,16,62,111,3,3,49,85,27,49,22,36,3,9,16,49,85
2005-05-16 00:00:00.000,St. Poelten Austria ATP World Tour,CLAY,2,Christophe Rochus,Guillermo Garcia-Lopez,Christophe Rochus,6-3; 6-4,Q,75,0,2,39,63,29,39,13,24,1,2,10,42,63,1,5,51,62,31,51,4,11,3,6,9,35,62
2005-05-16 00:00:00.000,St. Poelten Austria ATP World Tour,CLAY,2,Nikolay Davydenko,Jose Acasuso,Nikolay Davydenko,6-4; 6-2,S,80,6,2,29,51,21,29,15,22,1,2,9,36,51,4,3,35,68,23,35,13,33,8,12,9,36,68
2005-05-16 00:00:00.000,St. Poelten Austria ATP World Tour,CLAY,2,Jurgen Melzer,Christophe Rochus,Jurgen Melzer,6-4; 6-3,S,71,3,1,32,53,21,32,12,21,1,4,10,33,53,0,0,33,57,17,33,12,24,4,9,9,29,57
2005-05-16 00:00:00.000,St. Poelten Austria ATP World Tour,CLAY,2,Nikolay Davydenko,Jurgen Melzer,Nikolay Davydenko,6-3; 2-6; 6-4,F,135,2,4,58,80,38,58,8,22,8,12,13,46,80,0,5,61,110,39,61,20,49,10,15,14,59,110
2005-05-23 00:00:00.000,Roland Garros France Grand Slams,CLAY,3,Roger Federer,Dudi Sela,Roger Federer,6-1; 6-4; 6-0,R128,89,2,5,47,75,33,47,14,28,4,6,12,47,75,0,5,49,79,20,49,12,30,8,16,11,32,79
2005-05-23 00:00:00.000,Roland Garros France Grand Slams,CLAY,3,Nicolas Almagro,Philipp Kohlschreiber,Nicolas Almagro,7-6(4); 6-4; 6-3,R128,125,7,5,67,102,45,67,15,35,4,8,15,60,102,5,4,55,105,36,55,20,50,2,9,16,56,105
2005-05-23 00:00:00.000,Roland Garros France Grand Slams,CLAY,3,Tomas Behrend,Christophe Rochus,Tomas Behrend,4-6; 6-2; 7-5; 6-2,R128,156,9,5,62,105,44,62,27,43,3,6,19,71,105,0,7,80,145,51,80,28,65,14,21,19,79,145
2005-05-23 00:00:00.000,Roland Garros France Grand Slams,CLAY,3,Fernando Gonzalez,Michael Llodra,Fernando Gonzalez,7-6(3); 6-3; 6-2,R128,90,4,1,60,80,49,60,14,20,0,1,15,63,80,6,4,60,92,43,60,14,32,6,10,14,57,92
2005-05-23 00:00:00.000,Roland Garros France Grand Slams,CLAY,3,Janko Tipsarevic,Dominik Hrbaty,Janko Tipsarevic,6-7(5); 6-3; 3-6; 6-3; 8-6,R128,260,9,4,87,173,62,87,40,86,11,21,27,102,173,9,6,117,181,69,117,30,64,15,27,26,99,181
2005-05-23 00:00:00.000,Roland Garros France Grand Slams,CLAY,3,Fernando Vicente,Hugo Armando,Fernando Vicente,7-6(2); 6-4; 2-6; 4-6; 6-3,R128,236,8,8,106,183,69,106,41,77,17,23,25,110,183,6,7,101,179,64,101,40,78,22,27,24,104,179
2005-05-23 00:00:00.000,Roland Garros France Grand Slams,CLAY,3,Robin Vik,Kevin Kim,Robin Vik,6-4; 7-6(6); 7-5,R128,126,3,3,77,115,50,77,18,38,7,12,17,68,115,5,4,73,123,44,73,20,50,9,16,17,64,123
2005-05-23 00:00:00.000,Roland Garros France Grand Slams,CLAY,3,Carlos Moya,Alberto Martin,Carlos Moya,5-7; 6-1; 6-4; 6-2,R128,144,3,1,78,119,60,78,21,41,7,9,19,81,119,2,1,73,116,46,73,22,43,9,15,18,68,116
2005-05-23 00:00:00.000,Roland Garros France Grand Slams,CLAY,3,David Nalbandian,Marcos Baghdatis,David Nalbandian,0-6; 6-4; 6-4; 6-4,R128,156,4,3,68,104,44,68,17,36,5,11,18,61,104,6,5,75,135,47,75,28,60,8,14,18,75,135
2005-05-23 00:00:00.000,Roland Garros France Grand Slams,CLAY,3,Tomas Berdych,Jeff Morrison,Tomas Berdych,6-3; 6-2; 6-4,R128,105,3,1,50,88,34,50,24,38,6,8,14,58,88,3,5,53,94,37,53,12,41,4,10,13,49,94
2005-05-23 00:00:00.000,Roland Garros France Grand Slams,CLAY,3,Oscar Hernandez,Daniel Gimeno-Traver,Oscar Hernandez,6-7(4); 6-0; 6-3; 6-4,R128,166,1,6,79,125,46,79,30,46,5,9,19,76,125,3,5,82,122,46,82,17,40,10,19,18,63,122
2005-05-23 00:00:00.000,Roland Garros France Grand Slams,CLAY,3,Mario Ancic,Marcos Daniel,Mario Ancic,6-2; 6-1; 7-6(4),R128,146,8,3,56,95,43,56,23,39,7,8,14,66,95,0,4,53,94,30,53,20,41,8,13,13,50,94
2005-05-23 00:00:00.000,Roland Garros France Grand Slams,CLAY,3,Juan Ignacio Chela,Rainer Schuettler,Juan Ignacio Chela,3-6; 6-1; 6-4; 6-3,R128,164,6,5,54,106,37,54,29,52,6,10,17,66,106,1,5,73,133,45,73,23,60,11,19,18,68,133
2005-05-23 00:00:00.000,Roland Garros France Grand Slams,CLAY,3,Victor Hanescu,Michal Tabara,Victor Hanescu,6-2; 4-6; 6-2; 6-1,R128,118,8,0,68,94,48,68,13,26,1,5,17,61,94,5,15,36,103,23,36,24,67,6,15,16,47,103
2005-05-23 00:00:00.000,Roland Garros France Grand Slams,CLAY,3,Luis Horna,Jerome Haehnel,Luis Horna,7-6(2); 7-5; 6-3,R128,119,5,3,55,102,38,55,29,47,5,8,17,67,102,3,3,55,99,33,55,23,44,6,11,16,56,99
2005-05-23 00:00:00.000,Roland Garros France Grand Slams,CLAY,3,Tim Henman,Juan Pablo Brzezicki,Tim Henman,6-2; 6-1; 6-4,R128,98,4,2,54,75,37,54,10,21,1,4,13,47,75,1,6,52,85,28,52,10,33,9,17,12,38,85
2005-05-23 00:00:00.000,Roland Garros France Grand Slams,CLAY,3,Rafael Nadal,Lars Burgsmuller,Rafael Nadal,6-1; 7-6(4); 6-1,R128,105,5,3,48,77,42,48,19,29,0,0,14,61,77,3,4,50,89,33,50,19,39,4,8,12,52,89
2005-05-23 00:00:00.000,Roland Garros France Grand Slams,CLAY,3,Xavier Malisse,Mardy Fish,Xavier Malisse,6-2; 6-1; 6-1,R128,73,6,1,32,54,29,32,17,22,2,2,11,46,54,0,5,30,59,14,30,9,29,2,9,11,23,59
2005-05-23 00:00:00.000,Roland Garros France Grand Slams,CLAY,3,Peter Wessels,Ricardo Mello,Peter Wessels,6-4; 6-1; 6-3,R128,91,6,4,43,76,35,43,16,33,0,2,13,51,76,2,5,54,79,34,54,7,25,6,13,13,41,79
2005-05-23 00:00:00.000,Roland Garros France Grand Slams,CLAY,3,Richard Gasquet,Daniele Bracciali,Richard Gasquet,3-6; 6-3; 6-2; 6-4,R128,143,4,4,52,101,38,52,37,49,6,7,18,75,101,7,5,46,109,38,46,30,63,4,8,18,68,109
2005-05-23 00:00:00.000,Roland Garros France Grand Slams,CLAY,3,Sebastien Grosjean,Juan Monaco,Sebastien Grosjean,7-5; 6-3; 6-1,R128,162,1,1,54,107,34,54,31,53,9,11,14,65,107,0,4,62,101,33,62,17,39,10,17,14,50,101
2005-05-23 00:00:00.000,Roland Garros France Grand Slams,CLAY,3,Davide Sanguinetti,Thierry Ascione,Davide Sanguinetti,3-6; 5-7; 6-0; 6-3; 6-4,R128,198,10,3,75,155,52,75,37,80,18,25,23,89,155,2,5,110,160,63,110,21,50,11,21,23,84,160
2005-05-23 00:00:00.000,Roland Garros France Grand Slams,CLAY,3,Florent Serra,Andrei Pavel,Florent Serra,6-2; 6-2; 6-3,R128,95,3,0,43,77,32,43,17,34,3,5,12,49,77,5,6,54,84,28,54,9,30,5,13,13,37,84
2005-05-23 00:00:00.000,Roland Garros France Grand Slams,CLAY,3,Radek Stepanek,Paradorn Srichaphan,Radek Stepanek,3-6; 6-3; 6-1; 6-1,R128,128,4,1,66,93,44,66,17,27,2,5,16,61,93,4,5,57,107,33,57,21,50,7,15,16,54,107
2005-05-23 00:00:00.000,Roland Garros France Grand Slams,CLAY,3,Robin Soderling,Fernando Verdasco,Robin Soderling,1-6; 3-6; 6-3; 6-3; 6-3,R128,172,2,7,87,138,62,87,21,51,7,13,22,83,138,9,3,75,121,45,75,28,46,7,13,21,73,121
2005-05-23 00:00:00.000,Roland Garros France Grand Slams,CLAY,3,Hyung-Taik Lee,Alex Calatrava,Hyung-Taik Lee,6-4; 2-6; 5-7; 7-6(4); 6-4,R128,275,3,5,92,174,58,92,42,82,8,17,26,100,174,13,5,124,196,83,124,32,72,16,24,26,115,196
2005-05-23 00:00:00.000,Roland Garros France Grand Slams,CLAY,3,Olivier Patience,Gilles Simon,Olivier Patience,6-2; 6-2; 4-6; 6-3,R128,131,3,2,66,108,44,66,23,42,3,7,17,67,108,4,3,70,129,41,70,24,59,6,15,18,65,129
2005-05-23 00:00:00.000,Roland Garros France Grand Slams,CLAY,3,David Ferrer,Jiri Vanek,David Ferrer,2-6; 7-6(8); 6-4; 6-0,R128,157,5,1,88,126,54,88,18,38,6,11,18,72,126,3,6,66,127,42,66,26,61,3,10,18,68,127
2005-05-23 00:00:00.000,Roland Garros France Grand Slams,CLAY,3,Jiri Novak,Bjorn Phau,Jiri Novak,4-6; 6-2; 6-3; 6-1,R128,141,1,5,60,114,41,60,26,54,11,16,17,67,114,1,5,52,118,31,52,25,66,17,27,17,56,118
2005-05-23 00:00:00.000,Roland Garros France Grand Slams,CLAY,3,Felix Mantilla,Tomas Zib,Felix Mantilla,6-2; 6-1; 6-3,R128,100,1,1,62,85,39,62,12,23,6,9,12,51,85,2,2,45,72,23,45,6,27,9,18,12,29,72
2005-05-23 00:00:00.000,Roland Garros France Grand Slams,CLAY,3,Dmitry Tursunov,Stefan Koubek,Dmitry Tursunov,4-6; 6-1; 6-4; 6-1,R128,120,3,3,41,96,28,41,33,55,2,6,17,61,96,0,6,63,95,35,63,13,32,4,13,17,48,95
2005-05-23 00:00:00.000,Roland Garros France Grand Slams,CLAY,3,Gaston Gaudio,Julien Benneteau,Gaston Gaudio,7-5; 6-0; 6-1,R128,127,2,1,55,78,42,55,12,23,4,5,13,54,78,1,3,55,94,35,55,11,39,13,20,12,46,94
2005-05-23 00:00:00.000,Roland Garros France Grand Slams,CLAY,3,Guillermo Coria,Kenneth Carlsen,Guillermo Coria,6-4; 6-2; 6-4,R128,109,9,2,52,74,43,52,14,22,2,3,14,57,74,5,3,53,89,34,53,16,36,6,11,14,50,89
2005-05-23 00:00:00.000,Roland Garros France Grand Slams,CLAY,3,Novak Djokovic,Robby Ginepri,Novak Djokovic,6-0; 6-0; 6-3,R128,78,6,2,39,58,29,39,12,19,1,2,10,41,58,4,4,45,80,22,45,11,35,7,16,11,33,80
2005-05-23 00:00:00.000,Roland Garros France Grand Slams,CLAY,3,Jurgen Melzer,Wayne Arthurs,Jurgen Melzer,6-4; 6-2; 7-6(4),R128,107,0,2,56,87,42,56,18,31,2,5,15,60,87,14,10,47,99,35,47,21,52,4,10,15,56,99
2005-05-23 00:00:00.000,Roland Garros France Grand Slams,CLAY,3,Mikhail Youzhny,Gilles Muller,Mikhail Youzhny,6-4; 6-1; 6-0,R128,94,3,0,37,60,27,37,16,23,0,1,11,43,60,4,11,54,101,30,54,17,47,17,25,12,47,101
2005-05-23 00:00:00.000,Roland Garros France Grand Slams,CLAY,3,Tommy Haas,Florian Mayer,Tommy Haas,6-1; 6-2; 6-4,R128,100,6,8,54,92,37,54,18,38,13,16,13,55,92,2,1,47,87,23,47,16,40,5,13,12,39,87
2005-05-23 00:00:00.000,Roland Garros France Grand Slams,CLAY,3,Vincent Spadea,Albert Costa,Vincent Spadea,6-4; 7-6(6); 6-2,R128,130,4,4,56,99,43,56,21,43,7,10,15,64,99,4,6,70,100,40,70,12,30,8,14,15,52,100
2005-05-23 00:00:00.000,Roland Garros France Grand Slams,CLAY,3,Olivier Rochus,Guillermo Garcia-Lopez,Olivier Rochus,7-6(4); 7-5; 4-6; 6-3,R128,225,4,4,87,154,54,87,37,67,15,21,22,91,154,2,5,109,153,66,109,18,44,12,19,21,84,153
2005-05-23 00:00:00.000,Roland Garros France Grand Slams,CLAY,3,Nikolay Davydenko,Sasa Tuksar,Nikolay Davydenko,6-2; 6-4; 6-3,R128,108,7,3,57,86,41,57,13,29,6,9,14,54,86,3,2,39,77,18,39,19,38,4,11,13,37,77
2005-05-23 00:00:00.000,Roland Garros France Grand Slams,CLAY,3,Tommy Robredo,Peter Luczak,Tommy Robredo,4-6; 6-3; 6-3; 6-3,R128,163,6,4,67,116,49,67,30,49,5,7,19,79,116,1,3,96,144,57,96,25,48,18,23,18,82,144
2005-05-23 00:00:00.000,Roland Garros France Grand Slams,CLAY,3,Dick Norman,Jean-Rene Lisnard,Dick Norman,6-1; 6-1; 6-4,R128,96,8,3,45,74,36,45,13,29,2,3,12,49,74,2,5,34,74,21,34,14,40,3,10,12,35,74
2005-05-23 00:00:00.000,Roland Garros France Grand Slams,CLAY,3,David Sanchez,Gustavo Kuerten,David Sanchez,6-3; 6-0; 4-6; 6-1,R128,124,1,0,49,94,38,49,30,45,7,8,16,68,94,7,7,52,100,35,52,18,48,5,12,16,53,100
2005-05-23 00:00:00.000,Roland Garros France Grand Slams,CLAY,3,Thomas Johansson,Scott Draper,Thomas Johansson,6-7(5); 6-1; 3-6; 6-0; 6-1,R128,152,12,5,76,126,57,76,30,50,2,4,21,87,126,12,5,66,134,41,66,34,68,6,14,20,75,134
2005-05-23 00:00:00.000,Roland Garros France Grand Slams,CLAY,3,Juan Carlos Ferrero,Karol Beck,Juan Carlos Ferrero,6-4; 6-3; 6-3,R128,113,0,1,60,90,38,60,18,30,5,8,14,56,90,6,9,47,96,30,47,16,49,9,16,14,46,96
2005-05-23 00:00:00.000,Roland Garros France Grand Slams,CLAY,3,Jan Hernych,Fabrice Santoro,Jan Hernych,7-6(4); 3-6; 6-1; 4-6; 6-4,R128,221,3,4,100,160,70,100,31,60,6,11,24,101,160,8,2,94,167,55,94,45,73,13,19,24,100,167
2005-05-23 00:00:00.000,Roland Garros France Grand Slams,CLAY,3,Lukas Dlouhy,Thomas Enqvist,Lukas Dlouhy,6-2; 7-6(3); 6-1,R128,82,8,3,50,89,42,50,21,39,5,7,14,63,89,3,2,48,72,31,48,9,24,5,11,13,40,72
2005-05-23 00:00:00.000,Roland Garros France Grand Slams,CLAY,3,Marat Safin,Raemon Sluiter,Marat Safin,6-1; 4-6; 6-4; 6-2,R128,153,9,6,72,137,53,72,33,65,10,13,18,86,137,6,5,52,103,35,52,20,51,9,16,17,55,103
2005-05-23 00:00:00.000,Roland Garros France Grand Slams,CLAY,3,Jarkko Nieminen,Andre Agassi,Jarkko Nieminen,7-5; 4-6; 6-7(6); 6-1; 6-0,R128,179,6,5,95,164,65,95,37,69,15,20,24,102,164,5,15,100,179,66,100,30,79,17,27,23,96,179
2005-05-23 00:00:00.000,Roland Garros France Grand Slams,CLAY,3,Igor Andreev,Jonas Bjorkman,Igor Andreev,2-6; 6-2; 6-2; 7-5,R128,157,3,4,78,121,52,78,24,43,6,9,18,76,121,5,6,60,119,36,60,29,59,8,14,18,65,119
2005-05-23 00:00:00.000,Roland Garros France Grand Slams,CLAY,3,Arnaud Clement,Alexander Popp,Arnaud Clement,6-2; 6-4; 6-7(1); 6-2,R128,175,10,7,68,131,53,68,33,63,7,9,19,86,131,8,9,78,128,51,78,20,50,6,13,19,71,128
2005-05-23 00:00:00.000,Roland Garros France Grand Slams,CLAY,3,Nicolas Kiefer,Ivo Karlovic,Nicolas Kiefer,6-3; 6-3; 6-4,R128,99,5,3,42,81,39,42,22,39,2,2,14,61,81,6,4,33,67,24,33,18,34,1,5,14,42,67
2005-05-23 00:00:00.000,Roland Garros France Grand Slams,CLAY,3,Paul-Henri Mathieu,Feliciano Lopez,Paul-Henri Mathieu,6-2; 6-0; 6-7(5); 6-4,R128,186,3,3,86,128,58,86,24,42,10,12,18,82,128,6,6,78,146,49,78,28,68,16,24,18,77,146
2005-05-23 00:00:00.000,Roland Garros France Grand Slams,CLAY,3,Chris Guccione,Santiago Ventura,Chris Guccione,6-3; 2-6; 6-1; 3-6; 6-2,R128,153,5,8,61,121,42,61,33,60,4,9,21,75,121,6,5,75,134,55,75,21,59,10,17,20,76,134
2005-05-23 00:00:00.000,Roland Garros France Grand Slams,CLAY,3,Albert Montanes,Sargis Sargsian,Albert Montanes,6-1; 6-4; 6-0,R128,85,2,0,42,72,31,42,18,30,2,4,12,49,72,4,4,42,75,23,42,8,33,5,13,11,31,75
2005-05-23 00:00:00.000,Roland Garros France Grand Slams,CLAY,3,Guillermo Canas,Gael Monfils,Guillermo Canas,6-3; 6-1; 6-0,R128,101,2,1,25,58,18,25,21,33,1,3,11,39,58,2,4,34,76,16,34,13,42,4,13,11,29,76
2005-05-23 00:00:00.000,Roland Garros France Grand Slams,CLAY,3,Mariano Puerta,Ivan Ljubicic,Mariano Puerta,7-5; 7-5; 6-2,R128,135,5,3,50,85,37,50,25,35,1,2,16,62,85,14,5,57,97,39,57,18,40,2,7,16,57,97
2005-05-23 00:00:00.000,Roland Garros France Grand Slams,CLAY,3,Kristof Vliegen,Antony Dupuis,Kristof Vliegen,6-4; 6-1; 6-2,R128,93,7,2,40,75,33,40,23,35,2,2,13,56,75,5,2,42,69,27,42,12,27,4,9,12,39,69
2005-05-23 00:00:00.000,Roland Garros France Grand Slams,CLAY,3,James Blake,Tomas Tenconi,James Blake,6-2; 6-4; 7-6(8),R128,134,9,2,63,116,45,63,23,53,12,16,15,68,116,2,8,79,119,48,79,14,40,4,11,15,62,119
2005-05-23 00:00:00.000,Roland Garros France Grand Slams,CLAY,3,Stanislas Wawrinka,Nicolas Massu,Stanislas Wawrinka,6-7(4); 6-2; 6-2; 6-4,R128,187,17,8,61,121,47,61,36,60,7,8,19,83,121,6,5,81,141,58,81,24,60,13,19,19,82,141
2005-05-23 00:00:00.000,Roland Garros France Grand Slams,CLAY,3,Filippo Volandri,Cyril Saulnier,Filippo Volandri,6-0; 6-2; 6-1,R128,77,1,2,38,62,29,38,14,24,2,2,10,43,62,2,7,41,78,21,41,13,37,5,13,11,34,78
2005-05-23 00:00:00.000,Roland Garros France Grand Slams,CLAY,3,Flavio Saretta,Greg Rusedski,Flavio Saretta,6-2; 7-6(7); 6-3,R128,141,1,1,74,114,51,74,18,40,5,7,15,69,114,6,9,45,95,29,45,19,50,3,8,14,48,95
2005-05-23 00:00:00.000,Roland Garros France Grand Slams,CLAY,3,Jose Acasuso,Max Mirnyi,Jose Acasuso,6-4; 7-6(9); 6-2,R128,146,2,1,60,95,46,60,24,35,5,6,15,70,95,9,3,74,115,50,74,19,41,8,12,15,69,115
2005-05-23 00:00:00.000,Roland Garros France Grand Slams,CLAY,3,Andy Roddick,Jo-Wilfried Tsonga,Andy Roddick,6-3; 6-2; 6-4,R128,103,3,2,57,82,42,57,16,25,7,8,14,58,82,9,5,45,85,23,45,24,40,7,12,13,47,85
2005-05-23 00:00:00.000,Roland Garros France Grand Slams,CLAY,3,Roger Federer,Nicolas Almagro,Roger Federer,6-3; 7-6(0); 6-2,R64,107,6,3,53,88,43,53,22,35,1,2,15,65,88,7,6,54,91,38,54,14,37,6,10,14,52,91
2005-05-23 00:00:00.000,Roland Garros France Grand Slams,CLAY,3,Fernando Gonzalez,Tomas Behrend,Fernando Gonzalez,6-3; 6-4; 6-4,R64,106,11,2,61,95,48,61,21,34,3,3,15,69,95,6,3,58,91,37,58,20,33,10,13,14,57,91
2005-05-23 00:00:00.000,Roland Garros France Grand Slams,CLAY,3,Fernando Vicente,Janko Tipsarevic,Fernando Vicente,6-3; 1-6; 7-6(2); 6-3,R64,175,7,2,75,114,51,75,22,39,4,8,18,73,114,5,2,105,144,64,105,19,39,12,17,19,83,144
2005-05-23 00:00:00.000,Roland Garros France Grand Slams,CLAY,3,Carlos Moya,Robin Vik,Carlos Moya,7-6(6); 6-7(4); 6-3; 6-1,R64,184,8,2,89,154,62,89,35,65,8,12,20,97,154,8,11,68,134,48,68,24,66,2,10,20,72,134
2005-05-23 00:00:00.000,Roland Garros France Grand Slams,CLAY,3,David Nalbandian,Tomas Berdych,David Nalbandian,6-3; 6-2; 6-1,R64,98,5,1,37,69,29,37,22,32,2,2,12,51,69,2,1,32,70,18,32,18,38,4,10,12,36,70
2005-05-23 00:00:00.000,Roland Garros France Grand Slams,CLAY,3,Mario Ancic,Oscar Hernandez,Mario Ancic,4-6; 6-1; 6-2; 6-3,R64,153,11,3,54,98,45,54,21,44,0,2,17,66,98,2,2,61,95,36,61,14,34,6,13,17,50,95
2005-05-23 00:00:00.000,Roland Garros France Grand Slams,CLAY,3,Victor Hanescu,Juan Ignacio Chela,Victor Hanescu,7-5; 6-1; 3-6; 7-5,R64,172,3,3,92,133,63,92,21,41,7,10,20,84,133,8,7,67,122,46,67,28,55,6,12,20,74,122
2005-05-23 00:00:00.000,Roland Garros France Grand Slams,CLAY,3,Luis Horna,Tim Henman,Luis Horna,7-5; 6-7(2); 6-3; 6-4,R64,190,10,3,84,125,60,84,24,41,3,6,22,84,125,15,1,79,139,55,79,30,60,4,10,21,85,139
2005-05-23 00:00:00.000,Roland Garros France Grand Slams,CLAY,3,Rafael Nadal,Xavier Malisse,Rafael Nadal,6-2; 6-2; 6-4,R64,111,0,2,33,65,26,33,21,32,0,2,13,47,65,2,3,46,82,28,46,12,36,7,14,13,40,82
2005-05-23 00:00:00.000,Roland Garros France Grand Slams,CLAY,3,Richard Gasquet,Peter Wessels,Richard Gasquet,6-3; 7-6(1); 6-1,R64,109,8,6,54,91,41,54,23,37,7,8,15,64,91,8,3,55,91,37,55,13,36,11,15,13,50,91
2005-05-23 00:00:00.000,Roland Garros France Grand Slams,CLAY,3,Sebastien Grosjean,Davide Sanguinetti,Sebastien Grosjean,6-0; 6-3; 6-2,R64,99,9,4,39,67,30,39,18,28,0,1,12,48,67,1,3,30,62,15,30,11,32,4,11,11,26,62
2005-05-23 00:00:00.000,Roland Garros France Grand Slams,CLAY,3,Radek Stepanek,Florent Serra,Radek Stepanek,6-3; 6-4; 6-1,R64,104,5,2,45,76,34,45,16,31,1,3,13,50,76,2,2,40,78,20,40,17,38,2,9,13,37,78
2005-05-23 00:00:00.000,Roland Garros France Grand Slams,CLAY,3,Hyung-Taik Lee,Robin Soderling,Hyung-Taik Lee,6-2; 6-3; 6-4,R64,108,2,1,50,76,33,50,19,26,3,5,14,52,76,2,3,53,92,31,53,16,39,7,13,13,47,92
2005-05-23 00:00:00.000,Roland Garros France Grand Slams,CLAY,3,David Ferrer,Olivier Patience,David Ferrer,6-3; 7-6(5); 7-5,R64,146,4,7,70,117,47,70,25,47,7,11,17,72,117,3,8,63,122,37,63,27,59,10,16,16,64,122
2005-05-23 00:00:00.000,Roland Garros France Grand Slams,CLAY,3,Felix Mantilla,Jiri Novak,Felix Mantilla,6-2; 0-6; 3-6; 7-5; 6-3,R64,164,5,6,78,134,50,78,30,56,12,19,22,80,134,18,5,65,126,48,65,32,61,5,12,22,80,126
2005-05-23 00:00:00.000,Roland Garros France Grand Slams,CLAY,3,Gaston Gaudio,Dmitry Tursunov,Gaston Gaudio,W/O,R64,0,0,0,0,0,0,0,0,0,0,0,0,0,0,0,0,0,0,0,0,0,0,0,0,0,0,0
2005-05-23 00:00:00.000,Roland Garros France Grand Slams,CLAY,3,Guillermo Coria,Novak Djokovic,Guillermo Coria,4-6; 6-2; 3-2 RET,R64,114,0,7,59,84,37,59,10,25,8,12,11,47,84,3,3,42,80,23,42,17,38,5,11,12,40,80
2005-05-23 00:00:00.000,Roland Garros France Grand Slams,CLAY,3,Jurgen Melzer,Mikhail Youzhny,Jurgen Melzer,6-3; 6-4; 7-6(5),R64,134,2,1,62,101,41,62,27,39,2,4,16,68,101,4,2,59,110,36,59,28,51,11,15,15,64,110
2005-05-23 00:00:00.000,Roland Garros France Grand Slams,CLAY,3,Tommy Haas,Vincent Spadea,Tommy Haas,6-4; 6-3 RET,R64,76,8,4,32,59,23,32,15,27,0,2,10,38,59,0,6,35,67,20,35,14,32,0,4,9,34,67
2005-05-23 00:00:00.000,Roland Garros France Grand Slams,CLAY,3,Nikolay Davydenko,Olivier Rochus,Nikolay Davydenko,3-6; 7-5; 6-2; 6-3,R64,186,5,6,76,123,48,76,21,47,9,16,19,69,123,1,12,67,127,40,67,23,60,7,17,19,63,127
2005-05-23 00:00:00.000,Roland Garros France Grand Slams,CLAY,3,Tommy Robredo,Dick Norman,Tommy Robredo,6-4; 6-2; 6-4,R64,108,6,1,49,79,39,49,19,30,5,6,14,58,79,8,3,63,96,39,63,17,33,9,14,14,56,96
2005-05-23 00:00:00.000,Roland Garros France Grand Slams,CLAY,3,David Sanchez,Thomas Johansson,David Sanchez,6-3; 3-6; 4-6; 7-6(4); 6-4,R64,223,10,5,86,163,62,86,43,77,6,10,25,105,163,14,5,81,167,56,81,48,86,11,15,25,104,167
2005-05-23 00:00:00.000,Roland Garros France Grand Slams,CLAY,3,Juan Carlos Ferrero,Jan Hernych,Juan Carlos Ferrero,6-4; 6-4; 6-2,R64,109,5,1,57,78,41,57,14,21,3,5,14,55,78,3,2,60,90,36,60,12,30,8,14,14,48,90
2005-05-23 00:00:00.000,Roland Garros France Grand Slams,CLAY,3,Marat Safin,Lukas Dlouhy,Marat Safin,6-7(6); 6-3; 7-5; 6-1,R64,146,8,2,68,115,55,68,31,47,2,4,20,86,115,5,17,60,122,43,60,32,62,5,12,20,75,122
2005-05-23 00:00:00.000,Roland Garros France Grand Slams,CLAY,3,Igor Andreev,Jarkko Nieminen,Igor Andreev,6-2; 6-4; 6-7(3); 6-2,R64,157,7,8,73,114,53,73,20,41,2,5,19,73,114,1,8,73,128,43,73,26,55,10,18,19,69,128
2005-05-23 00:00:00.000,Roland Garros France Grand Slams,CLAY,3,Nicolas Kiefer,Arnaud Clement,Nicolas Kiefer,4-6; 6-2; 6-2; 4-6; 6-4,R64,235,23,7,80,151,55,80,33,71,10,17,23,88,151,8,6,83,151,53,83,26,68,13,23,23,79,151
2005-05-23 00:00:00.000,Roland Garros France Grand Slams,CLAY,3,Paul-Henri Mathieu,Chris Guccione,Paul-Henri Mathieu,6-3; 6-4; 6-4,R64,117,3,3,62,96,48,62,18,34,12,13,15,66,96,11,4,44,86,31,44,20,42,4,8,14,51,86
2005-05-23 00:00:00.000,Roland Garros France Grand Slams,CLAY,3,Guillermo Canas,Albert Montanes,Guillermo Canas,6-1; 6-3; 6-4,R64,114,3,1,45,80,36,45,22,35,4,4,13,58,80,2,7,45,77,28,45,16,32,9,14,13,44,77
2005-05-23 00:00:00.000,Roland Garros France Grand Slams,CLAY,3,Mariano Puerta,Kristof Vliegen,Mariano Puerta,6-3; 7-5; 6-2,R64,115,4,4,53,84,42,53,16,31,2,4,15,58,84,6,4,49,88,31,49,16,39,5,11,14,47,88
2005-05-23 00:00:00.000,Roland Garros France Grand Slams,CLAY,3,Stanislas Wawrinka,James Blake,Stanislas Wawrinka,6-7(9); 5-7; 6-1; 6-3; 6-4,R64,222,17,11,95,165,65,95,36,70,10,15,25,101,165,11,6,101,189,68,101,35,88,13,22,25,103,189
2005-05-23 00:00:00.000,Roland Garros France Grand Slams,CLAY,3,Filippo Volandri,Flavio Saretta,Filippo Volandri,6-4; 6-1; 6-2,R64,107,0,0,55,73,35,55,13,18,5,7,12,48,73,4,3,60,89,31,60,10,29,6,14,13,41,89
2005-05-23 00:00:00.000,Roland Garros France Grand Slams,CLAY,3,Jose Acasuso,Andy Roddick,Jose Acasuso,3-6; 4-6; 6-4; 6-3; 8-6,R64,201,20,9,77,149,63,77,39,72,7,10,26,102,149,13,5,97,150,77,97,22,53,3,7,26,99,150
2005-05-23 00:00:00.000,Roland Garros France Grand Slams,CLAY,3,Roger Federer,Fernando Gonzalez,Roger Federer,7-6(9); 7-5; 6-2,R32,130,11,1,63,96,49,63,22,33,1,3,16,71,96,1,6,60,112,41,60,26,52,3,8,16,67,112
2005-05-23 00:00:00.000,Roland Garros France Grand Slams,CLAY,3,Carlos Moya,Fernando Vicente,Carlos Moya,6-4; 7-6(4); 6-7(3); 0-6; 6-4,R32,231,3,3,117,160,80,117,21,43,7,13,25,101,160,11,3,97,173,76,97,35,76,17,22,25,111,173
2005-05-23 00:00:00.000,Roland Garros France Grand Slams,CLAY,3,David Nalbandian,Mario Ancic,David Nalbandian,6-4; 7-6(4); 6-3,R32,144,1,3,51,102,32,51,31,51,3,7,16,63,102,11,2,52,94,34,52,18,42,8,14,15,52,94
2005-05-23 00:00:00.000,Roland Garros France Grand Slams,CLAY,3,Victor Hanescu,Luis Horna,Victor Hanescu,6-3; 6-4; 6-4,R32,109,4,1,60,96,42,60,24,36,5,6,15,66,96,17,4,50,82,37,50,15,32,6,10,14,52,82
2005-05-23 00:00:00.000,Roland Garros France Grand Slams,CLAY,3,Rafael Nadal,Richard Gasquet,Rafael Nadal,6-4; 6-3; 6-2,R32,109,3,0,47,71,32,47,16,24,1,3,13,48,71,2,4,46,73,24,46,12,27,3,10,14,36,73
2005-05-23 00:00:00.000,Roland Garros France Grand Slams,CLAY,3,Sebastien Grosjean,Radek Stepanek,Sebastien Grosjean,6-1; 4-6; 3-6; 6-3; 6-4,R32,241,12,2,73,166,54,73,51,93,10,13,23,105,166,4,4,87,147,64,87,28,60,13,18,22,92,147
2005-05-23 00:00:00.000,Roland Garros France Grand Slams,CLAY,3,David Ferrer,Hyung-Taik Lee,David Ferrer,6-3; 6-1; 7-5,R32,117,4,2,57,89,39,57,19,32,6,8,14,58,89,1,7,45,86,30,45,12,41,3,10,14,42,86
2005-05-23 00:00:00.000,Roland Garros France Grand Slams,CLAY,3,Gaston Gaudio,Felix Mantilla,Gaston Gaudio,6-4; 6-4; 6-3,R32,150,2,8,49,98,27,49,26,49,10,16,15,53,98,2,4,50,102,27,50,19,52,6,15,14,46,102
2005-05-23 00:00:00.000,Roland Garros France Grand Slams,CLAY,3,Guillermo Coria,Jurgen Melzer,Guillermo Coria,6-1; 6-1; 7-6(2),R32,114,3,2,50,83,35,50,18,33,4,7,13,53,83,2,6,57,94,29,57,10,37,13,21,13,39,94
2005-05-23 00:00:00.000,Roland Garros France Grand Slams,CLAY,3,Nikolay Davydenko,Tommy Haas,Nikolay Davydenko,7-5; 6-0; 6-0,R32,111,2,1,60,86,40,60,15,26,3,4,12,55,86,2,3,36,71,19,36,11,35,3,11,12,30,71
2005-05-23 00:00:00.000,Roland Garros France Grand Slams,CLAY,3,Tommy Robredo,David Sanchez,Tommy Robredo,6-4; 6-3; 6-1,R32,118,3,3,46,78,35,46,20,32,0,1,13,55,78,2,1,45,83,28,45,15,38,6,12,13,43,83
2005-05-23 00:00:00.000,Roland Garros France Grand Slams,CLAY,3,Marat Safin,Juan Carlos Ferrero,Marat Safin,7-6(5); 7-5; 1-6; 7-6(2),R32,226,13,2,66,132,50,66,33,66,4,9,21,83,132,1,2,104,155,66,104,30,51,8,12,22,96,155
2005-05-23 00:00:00.000,Roland Garros France Grand Slams,CLAY,3,Nicolas Kiefer,Igor Andreev,Nicolas Kiefer,6-4; 7-6(7); 3-6; 6-4,R32,234,7,12,71,150,58,71,37,79,14,18,20,95,150,1,3,93,154,62,93,29,61,16,21,21,91,154
2005-05-23 00:00:00.000,Roland Garros France Grand Slams,CLAY,3,Guillermo Canas,Paul-Henri Mathieu,Guillermo Canas,6-3; 7-6(4); 2-6; 6-7(5); 8-6,R32,304,3,3,108,173,68,108,24,65,3,14,27,92,173,7,4,113,188,65,113,38,75,9,21,28,103,188
2005-05-23 00:00:00.000,Roland Garros France Grand Slams,CLAY,3,Mariano Puerta,Stanislas Wawrinka,Mariano Puerta,1-6; 6-3; 6-1; 6-4,R32,132,4,3,54,84,36,54,15,30,1,6,16,51,84,9,11,49,105,31,49,24,56,6,14,17,55,105
2005-05-23 00:00:00.000,Roland Garros France Grand Slams,CLAY,3,Jose Acasuso,Filippo Volandri,Jose Acasuso,3-0 RET,R32,12,2,0,2,5,2,2,2,3,0,0,1,4,5,0,0,11,16,5,11,1,5,1,3,2,6,16
2005-05-23 00:00:00.000,Roland Garros France Grand Slams,CLAY,3,Roger Federer,Carlos Moya,Roger Federer,6-1; 6-4; 6-3,R16,102,2,2,44,77,30,44,22,33,1,2,13,52,77,0,3,63,95,35,63,15,32,12,18,13,50,95
2005-05-23 00:00:00.000,Roland Garros France Grand Slams,CLAY,3,Victor Hanescu,David Nalbandian,Victor Hanescu,6-3; 4-6; 5-7; 6-1; 6-2,R16,207,9,2,107,156,70,107,22,49,11,18,23,92,156,4,6,97,156,59,97,22,59,11,22,23,81,156
2005-05-23 00:00:00.000,Roland Garros France Grand Slams,CLAY,3,Rafael Nadal,Sebastien Grosjean,Rafael Nadal,6-4; 3-6; 6-0; 6-3,R16,191,0,2,73,106,50,73,18,33,5,8,17,68,106,2,2,70,114,42,70,20,44,5,12,17,62,114
2005-05-23 00:00:00.000,Roland Garros France Grand Slams,CLAY,3,David Ferrer,Gaston Gaudio,David Ferrer,2-6; 6-4; 7-6(5); 5-7; 6-4,R16,245,5,6,92,160,49,92,36,68,7,18,26,85,160,2,4,107,189,61,107,41,82,16,26,26,102,189
2005-05-23 00:00:00.000,Roland Garros France Grand Slams,CLAY,3,Nikolay Davydenko,Guillermo Coria,Nikolay Davydenko,2-6; 6-3; 7-6(1); 6-2,R16,186,0,5,102,143,63,102,22,41,9,14,19,85,143,1,5,77,113,46,77,18,36,7,13,18,64,113
2005-05-23 00:00:00.000,Roland Garros France Grand Slams,CLAY,3,Tommy Robredo,Marat Safin,Tommy Robredo,7-5; 1-6; 6-1; 4-6; 8-6,R16,230,5,4,104,155,64,104,27,51,7,15,25,91,155,6,5,106,177,67,106,33,71,11,20,25,100,177
2005-05-23 00:00:00.000,Roland Garros France Grand Slams,CLAY,3,Guillermo Canas,Nicolas Kiefer,Guillermo Canas,W/O,R16,0,0,0,0,0,0,0,0,0,0,0,0,0,0,0,0,0,0,0,0,0,0,0,0,0,0,0
2005-05-23 00:00:00.000,Roland Garros France Grand Slams,CLAY,3,Mariano Puerta,Jose Acasuso,Mariano Puerta,6-4; 6-1; 6-1,R16,107,3,3,54,81,40,54,16,27,4,4,12,56,81,7,1,46,82,30,46,9,36,4,10,12,39,82
2005-05-23 00:00:00.000,Roland Garros France Grand Slams,CLAY,3,Roger Federer,Victor Hanescu,Roger Federer,6-2; 7-6(3); 6-3,Q,124,7,7,43,92,35,43,28,49,1,3,15,63,92,2,3,78,110,46,78,14,32,11,16,14,60,110
2005-05-23 00:00:00.000,Roland Garros France Grand Slams,CLAY,3,Rafael Nadal,David Ferrer,Rafael Nadal,7-5; 6-2; 6-0,Q,128,3,0,66,92,43,66,16,26,10,12,13,59,92,1,2,52,80,28,52,9,28,2,10,13,37,80
2005-05-23 00:00:00.000,Roland Garros France Grand Slams,CLAY,3,Nikolay Davydenko,Tommy Robredo,Nikolay Davydenko,3-6; 6-1; 6-2; 4-6; 6-4,Q,198,4,6,109,141,66,109,15,32,6,13,22,81,141,1,1,101,157,61,101,21,56,19,29,22,82,157
2005-05-23 00:00:00.000,Roland Garros France Grand Slams,CLAY,3,Mariano Puerta,Guillermo Canas,Mariano Puerta,6-2; 3-6; 1-6; 6-3; 6-4,Q,215,2,3,85,131,57,85,25,46,4,9,22,82,131,7,1,68,132,49,68,35,64,9,14,21,84,132
2005-05-23 00:00:00.000,Roland Garros France Grand Slams,CLAY,3,Rafael Nadal,Roger Federer,Rafael Nadal,6-3; 4-6; 6-4; 6-3,S,167,2,4,88,120,54,88,16,32,6,12,19,70,120,3,5,74,119,47,74,17,45,4,13,19,64,119
2005-05-23 00:00:00.000,Roland Garros France Grand Slams,CLAY,3,Mariano Puerta,Nikolay Davydenko,Mariano Puerta,6-3; 5-7; 2-6; 6-4; 6-4,S,209,1,9,79,150,55,79,35,71,5,12,25,90,150,11,3,81,137,53,81,29,56,5,12,24,82,137
2005-05-23 00:00:00.000,Roland Garros France Grand Slams,CLAY,3,Rafael Nadal,Mariano Puerta,Rafael Nadal,6-7(6); 6-3; 6-1; 7-5,F,204,7,3,108,137,73,108,12,29,11,14,20,85,137,4,2,83,137,53,83,23,54,10,18,20,76,137
2005-06-06 00:00:00.000,Halle Germany ATP World Tour,GRASS,2,Roger Federer,Robin Soderling,Roger Federer,6-7(5); 7-6(6); 6-4,R32,141,9,2,80,112,61,80,18,32,3,5,17,79,112,15,7,76,125,61,76,22,49,11,14,17,83,125
2005-06-06 00:00:00.000,Halle Germany ATP World Tour,GRASS,2,Florian Mayer,Mikhail Youzhny,Florian Mayer,6-4; 7-6(4),R32,93,6,2,49,74,40,49,13,25,4,5,11,53,74,3,3,45,79,34,45,17,34,3,5,11,51,79
2005-06-06 00:00:00.000,Halle Germany ATP World Tour,GRASS,2,Jimmy Wang,Michael Llodra,Jimmy Wang,7-6(2); 6-7(6); 6-2,R32,148,3,2,86,135,60,86,29,49,11,12,16,89,135,6,3,81,116,55,81,18,35,5,8,16,73,116
2005-06-06 00:00:00.000,Halle Germany ATP World Tour,GRASS,2,Philipp Kohlschreiber,Joachim Johansson,Philipp Kohlschreiber,7-6(4); 6-1,R32,76,10,1,45,71,35,45,14,26,5,6,10,49,71,7,2,33,56,22,33,10,23,2,5,9,32,56
2005-06-06 00:00:00.000,Halle Germany ATP World Tour,GRASS,2,Alexander Waske,Rafael Nadal,Alexander Waske,4-6; 7-5; 6-3,R32,111,12,8,57,96,48,57,20,39,7,8,16,68,96,2,3,56,78,45,56,11,22,1,3,15,56,78
2005-06-06 00:00:00.000,Halle Germany ATP World Tour,GRASS,2,Juan Carlos Ferrero,Vladimir Voltchkov,Juan Carlos Ferrero,6-7(5); 6-4; 6-4,R32,142,8,3,81,116,57,81,18,35,9,10,16,75,116,3,3,47,93,34,47,27,46,3,6,16,61,93
2005-06-06 00:00:00.000,Halle Germany ATP World Tour,GRASS,2,Jurgen Melzer,Alberto Martin,Jurgen Melzer,7-5; 6-7(3); 7-6(3),R32,143,7,6,78,123,56,78,23,45,5,7,18,79,123,7,13,72,129,58,72,26,57,9,12,18,84,129
2005-06-06 00:00:00.000,Halle Germany ATP World Tour,GRASS,2,Tommy Haas,Jiri Novak,Tommy Haas,6-4; 6-1,R32,55,3,1,31,49,24,31,9,18,3,5,9,33,49,1,0,31,47,15,31,7,16,4,9,8,22,47
2005-06-06 00:00:00.000,Halle Germany ATP World Tour,GRASS,2,Rainer Schuettler,David Nalbandian,Rainer Schuettler,6-3; 6-3,R32,79,3,3,43,64,33,43,9,21,5,6,9,42,64,3,2,41,68,23,41,12,27,5,9,9,35,68
2005-06-06 00:00:00.000,Halle Germany ATP World Tour,GRASS,2,Dick Norman,Christophe Rochus,Dick Norman,6-4; 3-6; 6-1,R32,79,16,5,40,67,34,40,16,27,1,2,13,50,67,4,4,59,81,39,59,10,22,2,5,13,49,81
2005-06-06 00:00:00.000,Halle Germany ATP World Tour,GRASS,2,Nenad Zimonjic,Nicolas Kiefer,Nenad Zimonjic,6-7(1); 6-3; 6-4,R32,118,19,5,61,89,53,61,14,28,0,0,16,67,89,20,7,60,92,50,60,15,32,4,6,15,65,92
2005-06-06 00:00:00.000,Halle Germany ATP World Tour,GRASS,2,Guillermo Canas,Fernando Verdasco,Guillermo Canas,6-4; 6-4,R32,82,3,2,44,66,32,44,6,22,4,6,10,38,66,3,2,35,62,21,35,14,27,3,7,10,35,62
2005-06-06 00:00:00.000,Halle Germany ATP World Tour,GRASS,2,Feliciano Lopez,Kenneth Carlsen,Feliciano Lopez,7-6(3); 7-6(5),R32,112,10,4,49,80,39,49,20,31,6,7,12,59,80,5,6,55,90,45,55,15,35,3,4,12,60,90
2005-06-06 00:00:00.000,Halle Germany ATP World Tour,GRASS,2,Olivier Rochus,Cyril Saulnier,Olivier Rochus,6-4; 6-4,R32,70,2,0,39,52,30,39,10,13,0,0,10,40,52,8,2,48,64,33,48,7,16,4,6,10,40,64
2005-06-06 00:00:00.000,Halle Germany ATP World Tour,GRASS,2,Fabrice Santoro,Andrei Pavel,Fabrice Santoro,7-5; 6-2,R32,85,1,1,46,76,31,46,18,30,8,9,10,49,76,7,2,37,64,23,37,11,27,0,4,10,34,64
2005-06-06 00:00:00.000,Halle Germany ATP World Tour,GRASS,2,Marat Safin,Alexander Popp,Marat Safin,6-3; 6-2,R32,58,6,2,29,54,21,29,15,25,2,3,9,36,54,4,1,26,44,16,26,7,18,1,5,8,23,44
2005-06-06 00:00:00.000,Halle Germany ATP World Tour,GRASS,2,Roger Federer,Florian Mayer,Roger Federer,6-2; 6-4,R16,58,5,1,33,43,27,33,4,10,0,2,9,31,43,3,2,37,62,23,37,6,25,4,9,9,29,62
2005-06-06 00:00:00.000,Halle Germany ATP World Tour,GRASS,2,Philipp Kohlschreiber,Jimmy Wang,Philipp Kohlschreiber,6-2; 5-7; 7-6(6),R16,139,6,3,68,105,52,68,19,37,4,5,16,71,105,0,2,72,102,48,72,20,30,8,10,16,68,102
2005-06-06 00:00:00.000,Halle Germany ATP World Tour,GRASS,2,Juan Carlos Ferrero,Alexander Waske,Juan Carlos Ferrero,7-6(5); 6-7(7); 6-3,R16,155,11,1,89,124,66,89,25,35,7,7,17,91,124,21,7,73,114,60,73,22,41,8,9,16,82,114
2005-06-06 00:00:00.000,Halle Germany ATP World Tour,GRASS,2,Tommy Haas,Jurgen Melzer,Tommy Haas,6-2; 3-6; 6-4,R16,97,10,3,46,69,37,46,13,23,2,4,13,50,69,6,0,55,93,38,55,18,38,9,13,14,56,93
2005-06-06 00:00:00.000,Halle Germany ATP World Tour,GRASS,2,Rainer Schuettler,Dick Norman,Rainer Schuettler,6-3; 6-3,R16,60,5,0,37,51,31,37,6,14,0,0,9,37,51,4,1,27,53,19,27,13,26,1,4,9,32,53
2005-06-06 00:00:00.000,Halle Germany ATP World Tour,GRASS,2,Guillermo Canas,Nenad Zimonjic,Guillermo Canas,6-3; 7-6(3),R16,93,5,1,36,63,27,36,17,27,3,4,10,44,63,7,4,51,78,30,51,16,27,6,9,11,46,78
2005-06-06 00:00:00.000,Halle Germany ATP World Tour,GRASS,2,Olivier Rochus,Feliciano Lopez,Olivier Rochus,7-6(2); 6-3,R16,90,1,0,46,60,31,46,11,14,1,3,11,42,60,15,3,38,63,27,38,6,25,1,4,10,33,63
2005-06-06 00:00:00.000,Halle Germany ATP World Tour,GRASS,2,Marat Safin,Fabrice Santoro,Marat Safin,3-6; 7-6(7); 3-2 RET,R16,141,6,3,60,94,42,60,17,34,6,7,12,59,94,3,3,77,117,57,77,18,40,10,11,14,75,117
2005-06-06 00:00:00.000,Halle Germany ATP World Tour,GRASS,2,Roger Federer,Philipp Kohlschreiber,Roger Federer,6-3; 6-4,Q,62,10,2,38,56,30,38,12,18,3,3,10,42,56,3,0,29,49,22,29,11,20,1,3,9,33,49
2005-06-06 00:00:00.000,Halle Germany ATP World Tour,GRASS,2,Tommy Haas,Juan Carlos Ferrero,Tommy Haas,6-2; 7-5,Q,72,4,4,32,55,26,32,14,23,2,3,10,40,55,4,1,41,61,26,41,9,20,2,6,10,35,61
2005-06-06 00:00:00.000,Halle Germany ATP World Tour,GRASS,2,Guillermo Canas,Rainer Schuettler,Guillermo Canas,6-4; 6-4,Q,89,4,0,31,56,22,31,20,25,2,2,10,42,56,0,3,39,67,28,39,15,28,4,6,10,43,67
2005-06-06 00:00:00.000,Halle Germany ATP World Tour,GRASS,2,Marat Safin,Olivier Rochus,Marat Safin,6-4; 7-6(4),Q,106,13,0,44,80,30,44,18,36,4,7,11,48,80,2,5,44,79,26,44,18,35,5,9,11,44,79
2005-06-06 00:00:00.000,Halle Germany ATP World Tour,GRASS,2,Roger Federer,Tommy Haas,Roger Federer,6-4; 7-6(9),S,99,8,0,44,63,40,44,12,19,0,0,11,52,63,7,2,55,85,39,55,19,30,8,9,11,58,85
2005-06-06 00:00:00.000,Halle Germany ATP World Tour,GRASS,2,Marat Safin,Guillermo Canas,Marat Safin,6-3; 4-6; 6-2,S,114,14,3,56,91,36,56,22,35,6,8,14,58,91,3,3,46,81,29,46,18,35,3,7,13,47,81
2005-06-06 00:00:00.000,Halle Germany ATP World Tour,GRASS,2,Roger Federer,Marat Safin,Roger Federer,6-4; 6-7(6); 6-4,F,125,9,1,59,97,44,59,28,38,5,6,16,72,97,12,0,66,97,53,66,15,31,1,4,16,68,97
2005-06-06 00:00:00.000,London / Queen's Club England ATP World Tour,GRASS,2,Lleyton Hewitt,N/A Bye,Lleyton Hewitt,,R64,0,0,0,0,0,0,0,0,0,0,0,0,0,0,0,0,0,0,0,0,0,0,0,0,0,0,0
2005-06-06 00:00:00.000,London / Queen's Club England ATP World Tour,GRASS,2,Xavier Malisse,Hyung-Taik Lee,Xavier Malisse,6-2; 6-0,R64,56,3,2,23,40,18,23,11,17,1,1,7,29,40,1,0,28,54,9,28,15,26,2,7,7,24,54
2005-06-06 00:00:00.000,London / Queen's Club England ATP World Tour,GRASS,2,Davide Sanguinetti,Bjorn Phau,Davide Sanguinetti,6-2; 7-6(6),R64,73,3,1,49,71,34,49,13,22,1,2,10,47,71,5,1,42,69,25,42,14,27,1,4,10,39,69
2005-06-06 00:00:00.000,London / Queen's Club England ATP World Tour,GRASS,2,Max Mirnyi,Tomas Berdych,Max Mirnyi,7-6(5); 3-6; 6-2,R64,112,6,4,44,78,33,44,21,34,1,4,14,54,78,4,1,58,98,37,58,20,40,2,6,15,57,98
2005-06-06 00:00:00.000,London / Queen's Club England ATP World Tour,GRASS,2,Kevin Kim,Paradorn Srichaphan,Kevin Kim,6-3; 6-4,R64,66,7,3,39,65,29,39,16,26,6,7,10,45,65,4,4,29,56,22,29,9,27,1,4,9,31,56
2005-06-06 00:00:00.000,London / Queen's Club England ATP World Tour,GRASS,2,Tomas Zib,Jerome Haehnel,Tomas Zib,6-3; 6-4,R64,72,1,4,46,79,35,46,14,33,8,9,10,49,79,4,2,27,49,18,27,10,22,0,3,9,28,49
2005-06-06 00:00:00.000,London / Queen's Club England ATP World Tour,GRASS,2,Ivo Karlovic,Michal Mertinak,Ivo Karlovic,7-6(6); 7-6(3),R64,95,20,4,54,74,49,54,11,20,1,1,12,60,74,2,0,52,84,36,52,24,32,5,5,12,60,84
2005-06-06 00:00:00.000,London / Queen's Club England ATP World Tour,GRASS,2,Fernando Gonzalez,N/A Bye,Fernando Gonzalez,,R64,0,0,0,0,0,0,0,0,0,0,0,0,0,0,0,0,0,0,0,0,0,0,0,0,0,0,0
2005-06-06 00:00:00.000,London / Queen's Club England ATP World Tour,GRASS,2,Tim Henman,N/A Bye,Tim Henman,,R64,0,0,0,0,0,0,0,0,0,0,0,0,0,0,0,0,0,0,0,0,0,0,0,0,0,0,0
2005-06-06 00:00:00.000,London / Queen's Club England ATP World Tour,GRASS,2,Robby Ginepri,Lars Burgsmuller,Robby Ginepri,6-2; 6-2,R64,49,5,1,31,50,23,31,9,19,4,5,8,32,50,0,7,24,49,17,24,4,25,4,9,8,21,49
2005-06-06 00:00:00.000,London / Queen's Club England ATP World Tour,GRASS,2,Chris Guccione,Kristof Vliegen,Chris Guccione,7-6(2); 3-6; 6-4,R64,109,20,3,52,80,46,52,14,28,0,1,15,60,80,6,7,75,110,55,75,18,35,11,12,16,73,110
2005-06-06 00:00:00.000,London / Queen's Club England ATP World Tour,GRASS,2,Igor Andreev,Alan Mackin,Igor Andreev,7-5; 4-6; 6-3,R64,123,9,3,76,120,54,76,18,44,5,8,16,72,120,2,1,71,92,49,71,8,21,8,12,15,57,92
2005-06-06 00:00:00.000,London / Queen's Club England ATP World Tour,GRASS,2,Taylor Dent,Tomas Behrend,Taylor Dent,6-4; 6-3,R64,65,6,2,32,56,25,32,15,24,2,2,9,40,56,1,1,45,65,30,45,9,20,4,7,10,39,65
2005-06-06 00:00:00.000,London / Queen's Club England ATP World Tour,GRASS,2,Andy Murray,Santiago Ventura,Andy Murray,6-1; 6-2,R64,44,5,1,26,43,22,26,11,17,0,0,8,33,43,3,2,26,40,17,26,3,14,1,5,7,20,40
2005-06-06 00:00:00.000,London / Queen's Club England ATP World Tour,GRASS,2,Gilles Muller,Julien Benneteau,Gilles Muller,6-2; 6-3,R64,70,12,4,32,53,25,32,14,21,1,1,9,39,53,2,2,36,58,22,36,10,22,3,6,8,32,58
2005-06-06 00:00:00.000,London / Queen's Club England ATP World Tour,GRASS,2,Thomas Johansson,N/A Bye,Thomas Johansson,,R64,0,0,0,0,0,0,0,0,0,0,0,0,0,0,0,0,0,0,0,0,0,0,0,0,0,0,0
2005-06-06 00:00:00.000,London / Queen's Club England ATP World Tour,GRASS,2,Mario Ancic,N/A Bye,Mario Ancic,,R64,0,0,0,0,0,0,0,0,0,0,0,0,0,0,0,0,0,0,0,0,0,0,0,0,0,0,0
2005-06-06 00:00:00.000,London / Queen's Club England ATP World Tour,GRASS,2,Jan Hernych,Arnaud Clement,Jan Hernych,6-4; 2-6; 6-2,R64,102,7,2,56,79,38,56,12,23,8,10,13,50,79,6,1,58,85,38,58,14,27,4,7,13,52,85
2005-06-06 00:00:00.000,London / Queen's Club England ATP World Tour,GRASS,2,Jamie Delgado,Gael Monfils,Jamie Delgado,6-2; 6-4,R64,66,0,0,35,56,26,35,11,21,3,4,9,37,56,5,3,36,55,25,36,4,19,4,8,9,29,55
2005-06-06 00:00:00.000,London / Queen's Club England ATP World Tour,GRASS,2,Richard Gasquet,Janko Tipsarevic,Richard Gasquet,6-1; 7-6(3),R64,69,9,3,42,64,40,42,8,22,3,4,10,48,64,5,4,30,60,23,30,12,30,3,6,9,35,60
2005-06-06 00:00:00.000,London / Queen's Club England ATP World Tour,GRASS,2,Greg Rusedski,Josh Goodall,Greg Rusedski,6-3; 6-4,R64,53,21,7,36,59,32,36,13,23,3,3,10,45,59,2,2,22,44,17,22,14,22,2,4,9,31,44
2005-06-06 00:00:00.000,London / Queen's Club England ATP World Tour,GRASS,2,Dmitry Tursunov,Jonas Bjorkman,Dmitry Tursunov,7-5; 6-3,R64,87,5,6,46,87,36,46,16,41,8,10,11,52,87,3,6,29,56,21,29,10,27,6,10,10,31,56
2005-06-06 00:00:00.000,London / Queen's Club England ATP World Tour,GRASS,2,Gregory Carraz,Sargis Sargsian,Gregory Carraz,3-0 RET,R64,10,4,1,9,12,7,9,1,3,0,0,2,8,12,0,0,6,10,2,6,2,4,0,1,1,4,10
2005-06-06 00:00:00.000,London / Queen's Club England ATP World Tour,GRASS,2,Radek Stepanek,N/A Bye,Radek Stepanek,,R64,0,0,0,0,0,0,0,0,0,0,0,0,0,0,0,0,0,0,0,0,0,0,0,0,0,0,0
2005-06-06 00:00:00.000,London / Queen's Club England ATP World Tour,GRASS,2,Sebastien Grosjean,N/A Bye,Sebastien Grosjean,,R64,0,0,0,0,0,0,0,0,0,0,0,0,0,0,0,0,0,0,0,0,0,0,0,0,0,0,0
2005-06-06 00:00:00.000,London / Queen's Club England ATP World Tour,GRASS,2,Guillermo Garcia-Lopez,Jean-Rene Lisnard,Guillermo Garcia-Lopez,7-6(2); 6-1,R64,84,1,0,50,69,30,50,9,19,4,7,10,39,69,2,8,26,64,16,26,12,38,2,7,9,28,64
2005-06-06 00:00:00.000,London / Queen's Club England ATP World Tour,GRASS,2,Victor Hanescu,Scott Draper,Victor Hanescu,6-7(3); 7-6(4); 6-2,R64,106,6,1,69,102,53,69,22,33,2,2,16,75,102,13,4,68,102,55,68,15,34,6,8,16,70,102
2005-06-06 00:00:00.000,London / Queen's Club England ATP World Tour,GRASS,2,James Blake,Jeff Morrison,James Blake,6-4; 3-6; 6-3,R64,100,8,6,58,90,45,58,15,32,5,6,14,60,90,6,2,52,89,36,52,20,37,4,6,14,56,89
2005-06-06 00:00:00.000,London / Queen's Club England ATP World Tour,GRASS,2,Karol Beck,Wayne Arthurs,Karol Beck,7-5; 6-4,R64,72,5,1,35,61,28,35,16,26,4,5,11,44,61,11,4,44,61,32,44,6,17,2,5,11,38,61
2005-06-06 00:00:00.000,London / Queen's Club England ATP World Tour,GRASS,2,Paul-Henri Mathieu,Marcos Baghdatis,Paul-Henri Mathieu,4-6; 7-6(3); 6-4,R64,127,4,6,47,92,39,47,24,45,1,3,16,63,92,3,2,49,105,35,49,34,56,7,9,16,69,105
2005-06-06 00:00:00.000,London / Queen's Club England ATP World Tour,GRASS,2,Mark Philippoussis,Raemon Sluiter,Mark Philippoussis,6-4; 6-0,R64,63,8,5,34,57,27,34,11,23,2,2,8,38,57,3,7,28,48,17,28,8,20,3,7,8,25,48
2005-06-06 00:00:00.000,London / Queen's Club England ATP World Tour,GRASS,2,Andy Roddick,N/A Bye,Andy Roddick,,R64,0,0,0,0,0,0,0,0,0,0,0,0,0,0,0,0,0,0,0,0,0,0,0,0,0,0,0
2005-06-06 00:00:00.000,London / Queen's Club England ATP World Tour,GRASS,2,Lleyton Hewitt,Xavier Malisse,Lleyton Hewitt,6-7(3); 7-5; 7-5,R32,158,9,4,63,105,51,63,23,42,2,3,18,74,105,8,1,70,121,47,70,30,51,9,12,18,77,121
2005-06-06 00:00:00.000,London / Queen's Club England ATP World Tour,GRASS,2,Max Mirnyi,Davide Sanguinetti,Max Mirnyi,6-4; 6-3,R32,64,6,1,33,53,27,33,14,20,0,0,10,41,53,2,2,33,57,21,33,16,24,4,6,9,37,57
2005-06-06 00:00:00.000,London / Queen's Club England ATP World Tour,GRASS,2,Tomas Zib,Kevin Kim,Tomas Zib,4-6; 6-1; 6-4,R32,95,8,4,60,101,50,60,17,41,7,8,14,67,101,19,3,43,71,38,43,11,28,1,4,13,49,71
2005-06-06 00:00:00.000,London / Queen's Club England ATP World Tour,GRASS,2,Ivo Karlovic,Fernando Gonzalez,Ivo Karlovic,6-3; 7-6(4),R32,71,7,5,41,62,36,41,12,21,3,4,11,48,62,5,3,37,59,30,37,9,22,2,4,10,39,59
2005-06-06 00:00:00.000,London / Queen's Club England ATP World Tour,GRASS,2,Tim Henman,Robby Ginepri,Tim Henman,7-6(5); 4-6; 6-1,R32,111,6,3,58,89,44,58,18,31,2,4,15,62,89,3,0,48,81,33,48,20,33,2,5,14,53,81
2005-06-06 00:00:00.000,London / Queen's Club England ATP World Tour,GRASS,2,Chris Guccione,Igor Andreev,Chris Guccione,6-4; 6-4,R32,56,11,2,30,46,26,30,14,16,0,0,10,40,46,6,2,36,62,25,36,16,26,4,6,10,41,62
2005-06-06 00:00:00.000,London / Queen's Club England ATP World Tour,GRASS,2,Andy Murray,Taylor Dent,Andy Murray,6-3; 6-3,R32,62,7,4,27,52,24,27,14,25,2,2,9,38,52,2,3,25,56,17,25,17,31,1,4,9,34,56
2005-06-06 00:00:00.000,London / Queen's Club England ATP World Tour,GRASS,2,Thomas Johansson,Gilles Muller,Thomas Johansson,6-7(4); 6-4; 7-5,R32,121,14,4,57,97,47,57,22,40,0,1,17,69,97,15,6,63,100,49,63,18,37,3,6,17,67,100
2005-06-06 00:00:00.000,London / Queen's Club England ATP World Tour,GRASS,2,Mario Ancic,Jan Hernych,Mario Ancic,6-4; 6-4,R32,66,5,2,31,55,28,31,16,24,4,4,10,44,55,3,2,38,61,25,38,13,23,2,4,10,38,61
2005-06-06 00:00:00.000,London / Queen's Club England ATP World Tour,GRASS,2,Richard Gasquet,Jamie Delgado,Richard Gasquet,6-4; 6-1,R32,53,5,1,27,43,23,27,14,16,2,2,9,37,43,1,1,25,45,14,25,12,20,3,6,8,26,45
2005-06-06 00:00:00.000,London / Queen's Club England ATP World Tour,GRASS,2,Greg Rusedski,Dmitry Tursunov,Greg Rusedski,6-1; 6-7(3); 6-4,R32,110,7,7,39,90,30,39,33,51,2,2,14,63,90,7,5,52,102,37,52,28,50,6,10,15,65,102
2005-06-06 00:00:00.000,London / Queen's Club England ATP World Tour,GRASS,2,Radek Stepanek,Gregory Carraz,Radek Stepanek,6-2; 4-6; 7-5,R32,104,11,2,59,78,44,59,16,19,3,4,15,60,78,6,3,67,98,51,67,12,31,6,9,15,63,98
2005-06-06 00:00:00.000,London / Queen's Club England ATP World Tour,GRASS,2,Sebastien Grosjean,Guillermo Garcia-Lopez,Sebastien Grosjean,7-5; 6-3,R32,85,5,5,41,65,34,41,10,24,2,4,11,44,65,1,4,48,74,28,48,12,26,4,8,10,40,74
2005-06-06 00:00:00.000,London / Queen's Club England ATP World Tour,GRASS,2,James Blake,Victor Hanescu,James Blake,6-2; 6-4,R32,62,5,1,38,61,25,38,16,23,3,4,9,41,61,2,0,37,49,23,37,6,12,4,8,9,29,49
2005-06-06 00:00:00.000,London / Queen's Club England ATP World Tour,GRASS,2,Karol Beck,Paul-Henri Mathieu,Karol Beck,6-2; 4-6; 7-6(5),R32,120,9,5,56,87,48,56,12,31,0,3,15,60,87,7,1,52,95,39,52,20,43,7,11,15,59,95
2005-06-06 00:00:00.000,London / Queen's Club England ATP World Tour,GRASS,2,Andy Roddick,Mark Philippoussis,Andy Roddick,6-2; 6-4,R32,58,10,2,27,46,26,27,13,19,0,0,9,39,46,5,4,33,52,25,33,4,19,1,4,9,29,52
2005-06-06 00:00:00.000,London / Queen's Club England ATP World Tour,GRASS,2,Lleyton Hewitt,Max Mirnyi,Lleyton Hewitt,6-3; 1-6; 6-1,R16,83,6,3,43,65,34,43,9,22,2,5,12,43,65,5,1,49,66,28,49,10,17,2,6,11,38,66
2005-06-06 00:00:00.000,London / Queen's Club England ATP World Tour,GRASS,2,Ivo Karlovic,Tomas Zib,Ivo Karlovic,6-2; 6-4,R16,61,22,3,33,49,31,33,6,16,0,0,9,37,49,0,2,23,48,14,23,13,25,2,5,9,27,48
2005-06-06 00:00:00.000,London / Queen's Club England ATP World Tour,GRASS,2,Tim Henman,Chris Guccione,Tim Henman,6-7(4); 6-2; 6-2,R16,99,5,3,55,80,46,55,17,25,3,3,14,63,80,14,2,57,92,43,57,15,35,0,4,14,58,92
2005-06-06 00:00:00.000,London / Queen's Club England ATP World Tour,GRASS,2,Thomas Johansson,Andy Murray,Thomas Johansson,7-6(1); 6-7(5); 7-5,R16,179,17,2,77,116,58,77,21,39,4,6,18,79,116,17,4,60,136,48,60,36,76,9,12,18,84,136
2005-06-06 00:00:00.000,London / Queen's Club England ATP World Tour,GRASS,2,Richard Gasquet,Mario Ancic,Richard Gasquet,7-5; 1-6; 6-3,R16,106,7,3,61,91,41,61,14,30,1,4,14,55,91,17,7,53,91,43,53,14,38,6,9,14,57,91
2005-06-06 00:00:00.000,London / Queen's Club England ATP World Tour,GRASS,2,Radek Stepanek,Greg Rusedski,Radek Stepanek,6-3; 7-6(4),R16,79,7,1,51,65,40,51,7,14,0,1,11,47,65,10,9,52,78,40,52,9,26,5,7,10,49,78
2005-06-06 00:00:00.000,London / Queen's Club England ATP World Tour,GRASS,2,Sebastien Grosjean,James Blake,Sebastien Grosjean,2-6; 6-3; 7-6(10),R16,130,6,2,68,111,51,68,21,43,6,8,15,72,111,5,1,66,102,47,66,22,36,2,3,14,69,102
2005-06-06 00:00:00.000,London / Queen's Club England ATP World Tour,GRASS,2,Andy Roddick,Karol Beck,Andy Roddick,6-2; 3-6; 6-4,R16,105,13,2,50,72,42,50,11,22,3,4,13,53,72,4,9,48,103,38,48,25,55,4,7,14,63,103
2005-06-06 00:00:00.000,London / Queen's Club England ATP World Tour,GRASS,2,Ivo Karlovic,Lleyton Hewitt,Ivo Karlovic,7-6(4); 6-3,Q,69,12,0,44,65,36,44,15,21,0,0,11,51,65,12,1,40,54,33,40,7,14,0,1,10,40,54
2005-06-06 00:00:00.000,London / Queen's Club England ATP World Tour,GRASS,2,Thomas Johansson,Tim Henman,Thomas Johansson,6-4; 6-4,Q,77,4,0,33,54,25,33,12,21,0,1,10,37,54,1,5,32,58,20,32,15,26,3,6,10,35,58
2005-06-06 00:00:00.000,London / Queen's Club England ATP World Tour,GRASS,2,Radek Stepanek,Richard Gasquet,Radek Stepanek,3-6; 6-1; 6-2,Q,86,2,0,48,71,35,48,12,23,1,3,12,47,71,2,1,46,71,24,46,12,25,2,7,12,36,71
2005-06-06 00:00:00.000,London / Queen's Club England ATP World Tour,GRASS,2,Andy Roddick,Sebastien Grosjean,Andy Roddick,6-4; 7-6(5),Q,85,6,3,48,69,38,48,12,21,2,3,11,50,69,6,2,39,72,30,39,18,33,2,4,11,48,72
2005-06-06 00:00:00.000,London / Queen's Club England ATP World Tour,GRASS,2,Ivo Karlovic,Thomas Johansson,Ivo Karlovic,6-4; 7-6(7),S,84,19,3,41,65,37,41,15,24,1,1,11,52,65,4,2,51,74,38,51,13,23,2,3,11,51,74
2005-06-06 00:00:00.000,London / Queen's Club England ATP World Tour,GRASS,2,Andy Roddick,Radek Stepanek,Andy Roddick,6-3; 2-6; 6-2,S,89,11,1,54,74,40,54,11,20,4,6,13,51,74,8,5,55,79,41,55,10,24,3,6,12,51,79
2005-06-06 00:00:00.000,London / Queen's Club England ATP World Tour,GRASS,2,Andy Roddick,Ivo Karlovic,Andy Roddick,7-6(7); 7-6(4),F,81,10,1,58,74,50,58,10,16,0,0,12,60,74,16,3,52,81,41,52,17,29,3,3,12,58,81
2005-06-13 00:00:00.000,Nottingham England ATP World Tour,GRASS,2,Ivan Ljubicic,Victor Hanescu,Ivan Ljubicic,6-7(5); 6-3; 7-6(8),R32,133,19,3,66,109,46,66,26,43,6,8,16,72,109,10,2,81,116,57,81,19,35,8,12,17,76,116
2005-06-13 00:00:00.000,Nottingham England ATP World Tour,GRASS,2,Ivo Karlovic,Igor Andreev,Ivo Karlovic,6-4; 6-4,R32,60,11,3,30,50,26,30,15,20,1,1,10,41,50,2,2,31,51,23,31,11,20,1,3,10,34,51
2005-06-13 00:00:00.000,Nottingham England ATP World Tour,GRASS,2,Karol Beck,Gael Monfils,Karol Beck,6-2; 2-6; 6-3,R32,92,4,2,42,84,31,42,19,42,2,5,13,50,84,4,2,45,74,32,45,12,29,2,6,12,44,74
2005-06-13 00:00:00.000,Nottingham England ATP World Tour,GRASS,2,Olivier Rochus,Kevin Kim,Olivier Rochus,6-7(7); 7-6(3); 7-6(6),R32,157,3,0,81,126,63,81,25,45,5,6,18,88,126,26,4,88,135,69,88,22,47,8,9,18,91,135
2005-06-13 00:00:00.000,Nottingham England ATP World Tour,GRASS,2,Dominik Hrbaty,Robby Ginepri,Dominik Hrbaty,6-2; 6-3,R32,51,4,2,30,56,25,30,14,26,4,5,9,39,56,2,0,30,45,16,30,5,15,1,5,8,21,45
2005-06-13 00:00:00.000,Nottingham England ATP World Tour,GRASS,2,Kenneth Carlsen,Harsh Mankad,Kenneth Carlsen,7-6(5); 4-6; 7-6(5),R32,161,4,5,68,110,52,68,22,42,7,10,17,74,110,5,5,73,116,55,73,23,43,3,5,17,78,116
2005-06-13 00:00:00.000,Nottingham England ATP World Tour,GRASS,2,Hyung-Taik Lee,Alberto Martin,Hyung-Taik Lee,7-5; 7-6(1),R32,106,2,1,50,70,40,50,13,20,3,4,12,53,70,5,0,45,96,28,45,28,51,5,7,12,56,96
2005-06-13 00:00:00.000,Nottingham England ATP World Tour,GRASS,2,Max Mirnyi,Sargis Sargsian,Max Mirnyi,6-2; 6-0,R32,51,4,3,24,41,18,24,10,17,0,1,7,28,41,1,0,36,50,16,36,3,14,4,10,7,19,50
2005-06-13 00:00:00.000,Nottingham England ATP World Tour,GRASS,2,Paradorn Srichaphan,Mark Hilton,Paradorn Srichaphan,6-3; 6-2,R32,66,6,1,35,51,28,35,9,16,2,2,9,37,51,0,3,34,57,22,34,10,23,5,8,8,32,57
2005-06-13 00:00:00.000,Nottingham England ATP World Tour,GRASS,2,Jan Vacek,Ricardo Mello,Jan Vacek,6-2; 6-1,R32,51,4,1,39,49,29,39,5,10,1,1,7,34,49,0,5,29,53,14,29,9,24,3,8,8,23,53
2005-06-13 00:00:00.000,Nottingham England ATP World Tour,GRASS,2,Jonathan Marray,Alan Mackin,Jonathan Marray,6-2; 6-3,R32,72,3,3,31,45,21,31,6,14,0,2,8,27,45,0,1,54,83,27,54,12,29,12,18,9,39,83
2005-06-13 00:00:00.000,Nottingham England ATP World Tour,GRASS,2,Richard Gasquet,Tomas Zib,Richard Gasquet,7-6(0); 6-2,R32,68,11,1,41,61,34,41,12,20,1,1,10,46,61,2,1,37,56,24,37,13,19,1,3,10,37,56
2005-06-13 00:00:00.000,Nottingham England ATP World Tour,GRASS,2,Taylor Dent,Alexander Popp,Taylor Dent,6-3; 6-3,R32,64,5,5,24,49,20,24,14,25,1,2,9,34,49,1,3,42,62,25,42,7,20,4,8,9,32,62
2005-06-13 00:00:00.000,Nottingham England ATP World Tour,GRASS,2,Travis Rettenmaier,Janko Tipsarevic,Travis Rettenmaier,4-6; 6-4; 7-6(4),R32,116,14,5,70,105,54,70,18,35,6,9,16,72,105,4,4,60,90,46,60,17,30,5,8,16,63,90
2005-06-13 00:00:00.000,Nottingham England ATP World Tour,GRASS,2,Tomas Berdych,Santiago Ventura,Tomas Berdych,6-3; 6-2,R32,49,6,0,34,47,27,34,9,13,0,0,9,36,47,0,3,25,48,17,25,9,23,1,4,8,26,48
2005-06-13 00:00:00.000,Nottingham England ATP World Tour,GRASS,2,Thomas Johansson,Dmitry Tursunov,Thomas Johansson,7-6(0); 6-3,R32,68,6,1,40,60,33,40,10,20,1,3,11,43,60,8,7,34,57,25,34,8,23,2,5,10,33,57
2005-06-13 00:00:00.000,Nottingham England ATP World Tour,GRASS,2,Ivo Karlovic,Ivan Ljubicic,Ivo Karlovic,6-1; 3-6; 7-6(1),R16,104,27,4,56,82,48,56,13,26,4,5,14,61,82,0,5,70,94,45,70,15,24,5,7,14,60,94
2005-06-13 00:00:00.000,Nottingham England ATP World Tour,GRASS,2,Olivier Rochus,Karol Beck,Olivier Rochus,6-4; 6-3,R16,74,1,0,26,46,22,26,12,20,2,3,9,34,46,11,4,41,74,28,41,12,33,5,9,10,40,74
2005-06-13 00:00:00.000,Nottingham England ATP World Tour,GRASS,2,Kenneth Carlsen,Dominik Hrbaty,Kenneth Carlsen,6-4; 6-4,R16,65,5,0,35,52,28,35,12,17,0,0,10,40,52,3,0,29,57,22,29,16,28,1,3,10,38,57
2005-06-13 00:00:00.000,Nottingham England ATP World Tour,GRASS,2,Max Mirnyi,Hyung-Taik Lee,Max Mirnyi,6-1; 6-4,R16,0,0,0,0,0,0,0,0,0,0,0,0,0,0,0,0,0,0,0,0,0,0,0,0,0,0,0
2005-06-13 00:00:00.000,Nottingham England ATP World Tour,GRASS,2,Paradorn Srichaphan,Jan Vacek,Paradorn Srichaphan,7-6(3); 7-6(4),R16,111,7,3,44,88,33,44,19,44,6,10,12,52,88,5,4,48,84,28,48,18,36,4,8,12,46,84
2005-06-13 00:00:00.000,Nottingham England ATP World Tour,GRASS,2,Richard Gasquet,Jonathan Marray,Richard Gasquet,6-4; 6-1,R16,63,0,2,25,48,20,25,15,23,1,2,9,35,48,1,5,36,57,22,36,7,21,11,15,8,29,57
2005-06-13 00:00:00.000,Nottingham England ATP World Tour,GRASS,2,Taylor Dent,Travis Rettenmaier,Taylor Dent,6-3; 1-6; 6-3,R16,82,10,5,51,76,40,51,13,25,1,3,13,53,76,7,4,41,69,29,41,16,28,4,6,12,45,69
2005-06-13 00:00:00.000,Nottingham England ATP World Tour,GRASS,2,Thomas Johansson,Tomas Berdych,Thomas Johansson,7-6(5); 7-6(8),R16,98,15,1,56,86,46,56,19,30,2,2,12,65,86,13,3,48,75,41,48,18,27,0,0,12,59,75
2005-06-13 00:00:00.000,Nottingham England ATP World Tour,GRASS,2,Olivier Rochus,Ivo Karlovic,Olivier Rochus,7-6(0); 6-7(3); 6-4,Q,131,2,3,62,94,54,62,20,32,1,1,17,74,94,26,9,68,108,57,68,18,40,4,5,17,75,108
2005-06-13 00:00:00.000,Nottingham England ATP World Tour,GRASS,2,Max Mirnyi,Kenneth Carlsen,Max Mirnyi,7-6(2); 6-4,Q,99,7,4,58,79,46,58,11,21,4,4,11,57,79,6,2,43,69,29,43,17,26,3,4,11,46,69
2005-06-13 00:00:00.000,Nottingham England ATP World Tour,GRASS,2,Richard Gasquet,Paradorn Srichaphan,Richard Gasquet,6-3; 4-6; 6-0,Q,94,5,4,47,75,35,47,17,28,2,3,12,52,75,3,3,54,79,33,54,10,25,5,10,13,43,79
2005-06-13 00:00:00.000,Nottingham England ATP World Tour,GRASS,2,Taylor Dent,Thomas Johansson,Taylor Dent,6-3; 1-0 RET,Q,46,4,8,14,32,10,14,7,18,3,5,5,17,32,4,1,22,40,11,22,6,18,2,6,5,17,40
2005-06-13 00:00:00.000,Nottingham England ATP World Tour,GRASS,2,Max Mirnyi,Olivier Rochus,Max Mirnyi,6-4; 7-5,S,83,17,0,46,59,39,46,7,13,0,0,11,46,59,0,2,46,66,33,46,11,20,1,3,11,44,66
2005-06-13 00:00:00.000,Nottingham England ATP World Tour,GRASS,2,Richard Gasquet,Taylor Dent,Richard Gasquet,6-4; 6-2,S,70,3,1,37,53,31,37,8,16,1,1,9,39,53,5,5,32,70,26,32,14,38,6,9,9,40,70
2005-06-13 00:00:00.000,Nottingham England ATP World Tour,GRASS,2,Richard Gasquet,Max Mirnyi,Richard Gasquet,6-2; 6-3,F,63,4,0,30,41,27,30,9,11,0,0,9,36,41,5,6,29,51,20,29,8,22,2,5,8,28,51
2005-06-13 00:00:00.000,'s-Hertogenbosch The Netherlands ATP World Tour,GRASS,2,Tommy Robredo,Gilles Muller,Tommy Robredo,6-4; 6-4,R32,143,6,1,38,57,30,38,15,19,4,4,10,45,57,7,1,47,67,32,47,9,20,10,12,10,41,67
2005-06-13 00:00:00.000,'s-Hertogenbosch The Netherlands ATP World Tour,GRASS,2,Lars Burgsmuller,Stanislas Wawrinka,Lars Burgsmuller,2-6; 7-5; 6-3,R32,103,5,10,46,89,38,46,20,43,5,8,15,58,89,12,4,52,93,39,52,19,41,5,8,14,58,93
2005-06-13 00:00:00.000,'s-Hertogenbosch The Netherlands ATP World Tour,GRASS,2,Michael Llodra,Denis Gremelmayr,Michael Llodra,6-3; 3-6; 7-6(2),R32,104,12,5,58,97,40,58,21,39,3,6,15,61,97,3,2,56,93,38,56,18,37,2,5,15,56,93
2005-06-13 00:00:00.000,'s-Hertogenbosch The Netherlands ATP World Tour,GRASS,2,Paul-Henri Mathieu,Jiri Vanek,Paul-Henri Mathieu,6-4; 6-3,R32,100,5,3,32,52,29,32,13,20,1,1,10,42,52,9,3,34,60,25,34,13,26,7,9,9,38,60
2005-06-13 00:00:00.000,'s-Hertogenbosch The Netherlands ATP World Tour,GRASS,2,Davide Sanguinetti,Karol Kucera,Davide Sanguinetti,7-6(1); 6-4,R32,98,2,3,45,87,33,45,18,42,2,5,11,51,87,3,5,51,83,31,51,13,32,8,12,11,44,83
2005-06-13 00:00:00.000,'s-Hertogenbosch The Netherlands ATP World Tour,GRASS,2,Sjeng Schalken,Bjorn Phau,Sjeng Schalken,7-6(5); 6-1,R32,93,1,1,58,73,41,58,9,15,2,2,10,50,73,8,2,41,74,28,41,15,33,8,10,9,43,74
2005-06-13 00:00:00.000,'s-Hertogenbosch The Netherlands ATP World Tour,GRASS,2,Guillermo Garcia-Lopez,Tobias Klein,Guillermo Garcia-Lopez,6-0; 6-2,R32,78,1,1,24,40,18,24,12,16,3,3,7,30,40,0,4,51,76,28,51,7,25,12,17,7,35,76
2005-06-13 00:00:00.000,'s-Hertogenbosch The Netherlands ATP World Tour,GRASS,2,Mark Philippoussis,Christophe Rochus,Mark Philippoussis,6-3; 7-6(8),R32,94,23,7,42,76,38,42,18,34,2,2,11,56,76,2,3,47,74,35,47,15,27,1,2,10,50,74
2005-06-13 00:00:00.000,'s-Hertogenbosch The Netherlands ATP World Tour,GRASS,2,Jonas Bjorkman,Andrei Pavel,Jonas Bjorkman,6-2; 7-6(1),R32,77,9,4,38,57,32,38,12,19,0,1,10,44,57,9,3,46,73,33,46,7,27,6,9,10,40,73
2005-06-13 00:00:00.000,'s-Hertogenbosch The Netherlands ATP World Tour,GRASS,2,Julien Benneteau,Philipp Petzschner,Julien Benneteau,6-4; 6-3,R32,89,4,5,41,73,30,41,16,32,5,6,10,46,73,4,3,33,63,21,33,15,30,5,8,9,36,63
2005-06-13 00:00:00.000,'s-Hertogenbosch The Netherlands ATP World Tour,GRASS,2,Wayne Arthurs,Raemon Sluiter,Wayne Arthurs,7-5; 6-4,R32,73,10,1,30,54,28,30,16,24,0,0,11,44,54,12,3,35,61,27,35,15,26,2,4,11,42,61
2005-06-13 00:00:00.000,'s-Hertogenbosch The Netherlands ATP World Tour,GRASS,2,Mario Ancic,Paul Logtens,Mario Ancic,6-4; 6-2,R32,64,9,2,31,52,24,31,15,21,2,2,9,39,52,3,4,33,57,25,33,8,24,2,5,9,33,57
2005-06-13 00:00:00.000,'s-Hertogenbosch The Netherlands ATP World Tour,GRASS,2,Robin Soderling,Jerome Haehnel,Robin Soderling,7-5; 6-3,R32,62,14,3,41,59,36,41,10,18,0,0,11,46,59,2,1,40,69,26,40,16,29,2,4,10,42,69
2005-06-13 00:00:00.000,'s-Hertogenbosch The Netherlands ATP World Tour,GRASS,2,Philipp Kohlschreiber,Jean-Rene Lisnard,Philipp Kohlschreiber,6-1; 7-6(4),R32,86,6,4,36,81,25,36,29,45,10,11,10,54,81,0,2,21,53,14,21,18,32,0,3,9,32,53
2005-06-13 00:00:00.000,'s-Hertogenbosch The Netherlands ATP World Tour,GRASS,2,Jan Hernych,Dennis van Scheppingen,Jan Hernych,7-6(7); 6-4,R32,138,1,2,51,73,33,51,14,22,4,6,11,47,73,1,3,53,73,36,53,8,20,2,5,11,44,73
2005-06-13 00:00:00.000,'s-Hertogenbosch The Netherlands ATP World Tour,GRASS,2,Guillermo Coria,Lars Uebel,Guillermo Coria,6-3; 6-1,R32,60,2,2,26,44,24,26,10,18,1,1,8,34,44,3,2,28,54,18,28,10,26,5,9,8,28,54
2005-06-13 00:00:00.000,'s-Hertogenbosch The Netherlands ATP World Tour,GRASS,2,Lars Burgsmuller,Tommy Robredo,Lars Burgsmuller,6-2; 7-6(5),R16,95,6,12,46,94,34,46,23,48,9,10,10,57,94,7,4,42,62,28,42,8,20,1,4,10,36,62
2005-06-13 00:00:00.000,'s-Hertogenbosch The Netherlands ATP World Tour,GRASS,2,Michael Llodra,Paul-Henri Mathieu,Michael Llodra,6-4; 4-6; 6-3,R16,173,10,3,58,92,48,58,18,34,5,6,15,66,92,4,5,42,85,28,42,28,43,2,4,14,56,85
2005-06-13 00:00:00.000,'s-Hertogenbosch The Netherlands ATP World Tour,GRASS,2,Davide Sanguinetti,Sjeng Schalken,Davide Sanguinetti,7-6(6); 6-3,R16,80,6,4,42,64,32,42,10,22,1,2,10,42,64,0,0,49,71,33,49,8,22,3,6,11,41,71
2005-06-13 00:00:00.000,'s-Hertogenbosch The Netherlands ATP World Tour,GRASS,2,Mark Philippoussis,Guillermo Garcia-Lopez,Mark Philippoussis,7-6(7); 7-6(2),R16,117,15,6,54,84,44,54,18,30,4,4,12,62,84,8,6,56,90,41,56,19,34,1,1,12,60,90
2005-06-13 00:00:00.000,'s-Hertogenbosch The Netherlands ATP World Tour,GRASS,2,Jonas Bjorkman,Julien Benneteau,Jonas Bjorkman,6-4; 6-2,R16,79,5,1,27,47,23,27,14,20,1,1,9,37,47,2,2,61,79,37,61,7,18,5,8,9,44,79
2005-06-13 00:00:00.000,'s-Hertogenbosch The Netherlands ATP World Tour,GRASS,2,Mario Ancic,Wayne Arthurs,Mario Ancic,6-4; 7-6(1),R16,91,19,5,48,81,40,48,17,33,4,4,11,57,81,6,4,30,61,25,30,17,31,2,3,11,42,61
2005-06-13 00:00:00.000,'s-Hertogenbosch The Netherlands ATP World Tour,GRASS,2,Philipp Kohlschreiber,Robin Soderling,Philipp Kohlschreiber,6-4; 4-6; 7-6(9),R16,120,8,4,56,94,43,56,21,38,3,7,16,64,94,9,4,65,103,48,65,20,38,5,9,16,68,103
2005-06-13 00:00:00.000,'s-Hertogenbosch The Netherlands ATP World Tour,GRASS,2,Jan Hernych,Guillermo Coria,Jan Hernych,6-3; 6-4,R16,58,1,1,37,53,31,37,10,16,1,1,10,41,53,7,4,30,53,25,30,8,23,3,5,9,33,53
2005-06-13 00:00:00.000,'s-Hertogenbosch The Netherlands ATP World Tour,GRASS,2,Michael Llodra,Lars Burgsmuller,Michael Llodra,6-2; 6-7(4); 6-3,Q,114,6,3,44,69,38,44,18,25,0,1,14,56,69,4,6,66,97,44,66,15,31,2,7,15,59,97
2005-06-13 00:00:00.000,'s-Hertogenbosch The Netherlands ATP World Tour,GRASS,2,Mark Philippoussis,Davide Sanguinetti,Mark Philippoussis,7-6(2); 7-6(0),Q,114,11,6,49,81,40,49,16,32,6,8,12,56,81,10,2,43,70,33,43,13,27,0,2,12,46,70
2005-06-13 00:00:00.000,'s-Hertogenbosch The Netherlands ATP World Tour,GRASS,2,Mario Ancic,Jonas Bjorkman,Mario Ancic,6-1; 3-6; 6-3,Q,107,19,6,58,87,45,58,13,29,6,7,13,58,87,3,2,47,80,31,47,17,33,4,7,12,48,80
2005-06-13 00:00:00.000,'s-Hertogenbosch The Netherlands ATP World Tour,GRASS,2,Jan Hernych,Philipp Kohlschreiber,Jan Hernych,7-6(1); 6-2,Q,99,4,2,56,73,33,56,11,17,7,10,10,44,73,5,5,51,99,35,51,12,48,13,18,10,47,99
2005-06-13 00:00:00.000,'s-Hertogenbosch The Netherlands ATP World Tour,GRASS,2,Michael Llodra,Mark Philippoussis,Michael Llodra,7-6(2); 6-7(5); 6-3,S,131,15,5,72,112,60,72,23,40,4,4,17,83,112,12,3,64,92,55,64,16,28,0,1,16,71,92
2005-06-13 00:00:00.000,'s-Hertogenbosch The Netherlands ATP World Tour,GRASS,2,Mario Ancic,Jan Hernych,Mario Ancic,6-4; 6-4,S,70,14,3,32,57,28,32,14,25,1,1,10,42,57,1,0,42,58,31,42,8,16,0,2,10,39,58
2005-06-13 00:00:00.000,'s-Hertogenbosch The Netherlands ATP World Tour,GRASS,2,Mario Ancic,Michael Llodra,Mario Ancic,7-5; 6-4,F,69,13,3,39,54,35,39,9,15,0,0,11,44,54,1,2,32,62,26,32,18,30,7,9,11,44,62
2005-06-20 00:00:00.000,Wimbledon England Grand Slams,GRASS,3,Roger Federer,Paul-Henri Mathieu,Roger Federer,6-4; 6-2; 6-4,R128,110,18,1,51,72,43,51,12,21,1,2,14,55,72,2,2,59,95,37,59,17,36,10,15,14,54,95
2005-06-20 00:00:00.000,Wimbledon England Grand Slams,GRASS,3,Ivo Minar,Michal Tabara,Ivo Minar,6-4; 6-4; 6-4,R128,94,11,1,65,100,50,65,16,35,3,4,15,66,100,9,5,53,91,34,53,22,38,2,6,15,56,91
2005-06-20 00:00:00.000,Wimbledon England Grand Slams,GRASS,3,Alessio Di Mauro,Josh Goodall,Alessio Di Mauro,6-3; 7-6(4); 6-3,R128,138,15,5,56,105,46,56,27,49,3,4,16,73,105,14,6,63,119,51,63,19,56,5,8,14,70,119
2005-06-20 00:00:00.000,Wimbledon England Grand Slams,GRASS,3,Nicolas Kiefer,Julien Benneteau,Nicolas Kiefer,6-3; 7-6(5); 5-7; 3-6; 6-4,R128,250,19,9,87,161,66,87,34,74,7,12,25,100,161,19,8,115,173,84,115,26,58,4,10,27,110,173
2005-06-20 00:00:00.000,Wimbledon England Grand Slams,GRASS,3,Juan Carlos Ferrero,Jamie Delgado,Juan Carlos Ferrero,7-6(2); 6-1; 6-4,R128,124,13,3,68,99,50,68,20,31,8,9,15,70,99,6,5,60,104,34,60,22,44,6,10,14,56,104
2005-06-20 00:00:00.000,Wimbledon England Grand Slams,GRASS,3,Hyung-Taik Lee,Thomas Enqvist,Hyung-Taik Lee,6-3; 6-7(4); 7-5; 6-4,R128,158,11,2,85,124,67,85,21,39,1,2,21,88,124,15,10,93,149,66,93,26,56,7,12,22,92,149
2005-06-20 00:00:00.000,Wimbledon England Grand Slams,GRASS,3,Florian Mayer,Santiago Ventura,Florian Mayer,6-4; 7-5; 6-2,R128,103,2,3,62,94,45,62,16,32,7,9,15,61,94,5,5,50,86,33,50,15,36,2,8,15,48,86
2005-06-20 00:00:00.000,Wimbledon England Grand Slams,GRASS,3,Fernando Verdasco,Tommy Robredo,Fernando Verdasco,6-1; 6-2; 7-5,R128,113,12,4,51,96,39,51,26,45,11,12,14,65,96,0,5,61,88,36,61,9,27,6,12,13,45,88
2005-06-20 00:00:00.000,Wimbledon England Grand Slams,GRASS,3,Joachim Johansson,Albert Montanes,Joachim Johansson,7-6(5); 6-4; 7-5,R128,99,13,6,60,90,54,60,19,30,0,0,17,73,90,11,1,68,104,50,68,22,36,5,7,17,72,104
2005-06-20 00:00:00.000,Wimbledon England Grand Slams,GRASS,3,Greg Rusedski,Alberto Martin,Greg Rusedski,6-3; 4-6; 6-2; 6-1,R128,110,20,12,68,105,58,68,16,37,7,8,17,74,105,2,3,57,91,38,57,19,34,4,10,17,57,91
2005-06-20 00:00:00.000,Wimbledon England Grand Slams,GRASS,3,Tomas Zib,Jose Acasuso,Tomas Zib,7-5; 6-3; 6-3,R128,111,13,2,49,80,42,49,19,31,3,4,15,61,80,15,7,65,101,44,65,13,36,1,6,15,57,101
2005-06-20 00:00:00.000,Wimbledon England Grand Slams,GRASS,3,Fernando Gonzalez,Alan Mackin,Fernando Gonzalez,6-3; 6-4; 6-4,R128,87,11,5,50,76,41,50,14,26,1,3,15,55,76,0,2,65,85,39,65,10,20,4,9,14,49,85
2005-06-20 00:00:00.000,Wimbledon England Grand Slams,GRASS,3,Mikhail Youzhny,Marcos Baghdatis,Mikhail Youzhny,6-2; 3-6; 6-1; 6-4,R128,113,5,4,56,96,40,56,24,40,3,6,17,64,96,6,8,56,100,36,56,19,44,3,10,17,55,100
2005-06-20 00:00:00.000,Wimbledon England Grand Slams,GRASS,3,Jean-Rene Lisnard,Oscar Hernandez,Jean-Rene Lisnard,6-4; 2-1 RET,R128,54,5,3,27,45,24,27,9,18,4,4,7,33,45,0,3,20,32,16,20,5,12,1,2,6,21,32
2005-06-20 00:00:00.000,Wimbledon England Grand Slams,GRASS,3,Jonas Bjorkman,Jeff Morrison,Jonas Bjorkman,6-3; 6-3; 4-6; 2-6; 6-2,R128,161,8,8,80,129,61,80,22,49,8,12,22,83,129,10,5,96,148,67,96,18,52,8,14,22,85,148
2005-06-20 00:00:00.000,Wimbledon England Grand Slams,GRASS,3,Nikolay Davydenko,Scott Draper,Nikolay Davydenko,7-6(4); 6-4; 6-3,R128,103,13,5,62,96,47,62,19,34,2,4,16,66,96,6,4,64,100,43,64,15,36,3,7,15,58,100
2005-06-20 00:00:00.000,Wimbledon England Grand Slams,GRASS,3,Lleyton Hewitt,Christophe Rochus,Lleyton Hewitt,6-3; 6-3; 6-1,R128,93,18,5,42,73,33,42,20,31,4,5,13,53,73,2,2,52,87,28,52,16,35,5,11,12,44,87
2005-06-20 00:00:00.000,Wimbledon England Grand Slams,GRASS,3,Jan Hernych,James Blake,Jan Hernych,1-6; 6-4; 7-6(6); 7-6(4),R128,164,9,5,99,141,72,99,18,42,7,12,20,90,141,7,4,96,147,68,96,24,51,10,14,21,92,147
2005-06-20 00:00:00.000,Wimbledon England Grand Slams,GRASS,3,Justin Gimelstob,Adrian Garcia,Justin Gimelstob,6-3; 6-4; 7-6(5),R128,119,17,6,61,104,49,61,24,43,9,10,16,73,104,2,7,62,95,43,62,17,33,6,9,15,60,95
2005-06-20 00:00:00.000,Wimbledon England Grand Slams,GRASS,3,Nicolas Massu,Sargis Sargsian,Nicolas Massu,7-6(7); 6-3; 6-4,R128,152,12,8,66,118,51,66,30,52,6,6,16,81,118,9,4,66,101,45,66,22,35,4,6,15,67,101
2005-06-20 00:00:00.000,Wimbledon England Grand Slams,GRASS,3,Taylor Dent,Dick Norman,Taylor Dent,7-6(4); 7-6(4); 4-6; 6-7(7); 6-1,R128,202,23,8,105,166,86,105,37,61,5,6,26,123,166,23,4,116,166,89,116,28,50,5,8,27,117,166
2005-06-20 00:00:00.000,Wimbledon England Grand Slams,GRASS,3,Kevin Kim,Alex Bogdanovic,Kevin Kim,6-7(4); 6-1; 6-4; 6-2,R128,128,20,2,79,117,57,79,16,38,6,10,19,73,117,7,5,82,128,53,82,15,46,9,18,18,68,128
2005-06-20 00:00:00.000,Wimbledon England Grand Slams,GRASS,3,Tomas Berdych,Antony Dupuis,Tomas Berdych,7-6(5); 7-5; 3-6; 7-6(4),R128,195,19,4,80,139,66,80,33,59,4,6,22,99,139,21,6,109,162,77,109,29,53,9,11,23,106,162
2005-06-20 00:00:00.000,Wimbledon England Grand Slams,GRASS,3,Lars Burgsmuller,Mariano Puerta,Lars Burgsmuller,6-1; 6-1; 6-4,R128,91,10,4,39,67,33,39,15,28,1,2,12,48,67,2,1,60,82,29,60,10,22,10,17,12,39,82
2005-06-20 00:00:00.000,Wimbledon England Grand Slams,GRASS,3,Mario Ancic,Tobias Summerer,Mario Ancic,6-3; 7-5; 6-1,R128,98,19,3,46,76,39,46,19,30,1,1,14,58,76,10,5,49,86,31,49,19,37,5,10,14,50,86
2005-06-20 00:00:00.000,Wimbledon England Grand Slams,GRASS,3,Danai Udomchoke,Stefan Koubek,Danai Udomchoke,5-7; 6-4; 4-6; 6-3; 8-6,R128,229,4,9,121,193,82,121,33,72,15,22,27,115,193,16,9,102,179,66,102,34,77,8,17,28,100,179
2005-06-20 00:00:00.000,Wimbledon England Grand Slams,GRASS,3,Gael Monfils,Noam Okun,Gael Monfils,3-6; 6-4; 6-4; 7-6(14),R128,171,14,7,58,130,49,58,43,72,5,8,21,92,130,8,3,91,141,68,91,24,50,6,9,20,92,141
2005-06-20 00:00:00.000,Wimbledon England Grand Slams,GRASS,3,Dominik Hrbaty,Cyril Saulnier,Dominik Hrbaty,7-6(0); 6-0; 6-2,R128,94,7,2,46,77,36,46,17,31,3,5,13,53,77,5,4,50,96,28,50,18,46,6,13,13,46,96
2005-06-20 00:00:00.000,Wimbledon England Grand Slams,GRASS,3,Feliciano Lopez,Bjorn Phau,Feliciano Lopez,5-7; 7-6(8); 6-7(5); 6-2; 6-4,R128,213,28,4,97,163,80,97,39,66,4,6,27,119,163,17,9,97,191,72,97,53,94,11,15,27,125,191
2005-06-20 00:00:00.000,Wimbledon England Grand Slams,GRASS,3,David Sherwood,Ricardo Mello,David Sherwood,6-3; 6-4; 6-4,R128,102,7,4,45,92,36,45,29,47,3,4,15,65,92,3,2,60,83,37,60,13,23,1,5,14,50,83
2005-06-20 00:00:00.000,Wimbledon England Grand Slams,GRASS,3,Mark Philippoussis,Karol Beck,Mark Philippoussis,7-5; 6-4; 6-2,R128,105,16,5,51,83,41,51,20,32,4,6,15,61,83,9,3,56,85,36,56,13,29,4,10,15,49,85
2005-06-20 00:00:00.000,Wimbledon England Grand Slams,GRASS,3,Marat Safin,Paradorn Srichaphan,Marat Safin,6-2; 6-4; 6-4,R128,105,10,0,55,79,44,55,15,24,6,7,14,59,79,4,3,57,97,32,57,20,40,7,12,14,52,97
2005-06-20 00:00:00.000,Wimbledon England Grand Slams,GRASS,3,Olivier Rochus,Paul Goldstein,Olivier Rochus,6-4; 6-2; 6-2,R128,119,0,0,57,75,44,57,12,18,3,3,13,56,75,2,3,54,119,36,54,27,65,9,14,13,63,119
2005-06-20 00:00:00.000,Wimbledon England Grand Slams,GRASS,3,Max Mirnyi,Rainer Schuettler,Max Mirnyi,6-3; 6-3; 6-4,R128,90,18,1,48,68,44,48,13,20,2,2,14,57,68,0,1,58,84,38,58,14,26,2,6,14,52,84
2005-06-20 00:00:00.000,Wimbledon England Grand Slams,GRASS,3,Fabrice Santoro,Stanislas Wawrinka,Fabrice Santoro,6-2; 6-7(7); 7-5; 6-1,R128,198,5,0,83,134,62,83,32,51,9,10,20,94,134,13,10,107,176,74,107,25,69,19,25,19,99,176
2005-06-20 00:00:00.000,Wimbledon England Grand Slams,GRASS,3,Jiri Novak,Peter Wessels,Jiri Novak,7-6(4); 6-3; 6-4,R128,98,10,1,92,119,55,92,18,27,7,10,16,73,119,13,3,62,91,43,62,12,29,8,13,15,55,91
2005-06-20 00:00:00.000,Wimbledon England Grand Slams,GRASS,3,Janko Tipsarevic,Tommy Haas,Janko Tipsarevic,6-2; 2-1 RET,R128,37,3,0,14,29,11,14,11,15,0,0,5,22,29,3,5,26,47,19,26,5,21,3,6,6,24,47
2005-06-20 00:00:00.000,Wimbledon England Grand Slams,GRASS,3,Yen-Hsun Lu,Arnaud Clement,Yen-Hsun Lu,7-6(4); 0-6; 6-1; 3-6; 6-3,R128,192,9,5,76,120,58,76,24,44,7,12,22,82,120,20,3,81,145,60,81,30,64,7,11,21,90,145
2005-06-20 00:00:00.000,Wimbledon England Grand Slams,GRASS,3,Andrei Pavel,Roko Karanusic,Andrei Pavel,6-2; 4-6; 6-2; 6-4,R128,113,6,3,69,99,56,69,17,30,5,6,18,73,99,10,3,70,115,46,70,24,45,10,15,18,70,115
2005-06-20 00:00:00.000,Wimbledon England Grand Slams,GRASS,3,Thomas Johansson,Bohdan Ulihrach,Thomas Johansson,6-3; 6-2; 6-2,R128,86,8,2,51,80,42,51,18,29,4,4,13,60,80,2,5,49,70,28,49,9,21,2,7,12,37,70
2005-06-20 00:00:00.000,Wimbledon England Grand Slams,GRASS,3,Radek Stepanek,Robby Ginepri,Radek Stepanek,6-7(5); 6-3; 6-4; 6-2,R128,170,18,3,99,144,74,99,19,45,12,15,20,93,144,9,4,94,148,57,94,27,54,14,21,19,84,148
2005-06-20 00:00:00.000,Wimbledon England Grand Slams,GRASS,3,Andy Murray,George Bastl,Andy Murray,6-4; 6-2; 6-2,R128,100,7,0,38,69,31,38,22,31,0,0,13,53,69,3,3,52,79,36,52,8,27,7,12,13,44,79
2005-06-20 00:00:00.000,Wimbledon England Grand Slams,GRASS,3,Karol Kucera,Luis Horna,Karol Kucera,4-6; 6-3; 6-3; 6-4,R128,159,16,5,66,108,53,66,25,42,2,3,19,78,108,11,7,93,141,66,93,18,48,9,13,19,84,141
2005-06-20 00:00:00.000,Wimbledon England Grand Slams,GRASS,3,David Nalbandian,Raemon Sluiter,David Nalbandian,6-2; 6-2; 7-5,R128,103,8,1,50,75,40,50,16,25,1,2,14,56,75,10,2,57,94,33,57,18,37,7,13,14,51,94
2005-06-20 00:00:00.000,Wimbledon England Grand Slams,GRASS,3,Richard Gasquet,Philipp Kohlschreiber,Richard Gasquet,6-3; 3-6; 6-3; 6-2,R128,126,12,3,76,110,54,76,18,34,3,6,18,72,110,8,5,69,110,46,69,16,41,7,13,17,62,110
2005-06-20 00:00:00.000,Wimbledon England Grand Slams,GRASS,3,Gilles Elseneer,Potito Starace,Gilles Elseneer,6-3; 7-6(9); 6-3,R128,104,14,7,64,108,53,64,23,44,2,3,16,76,108,10,2,64,91,46,64,11,27,5,8,14,57,91
2005-06-20 00:00:00.000,Wimbledon England Grand Slams,GRASS,3,Gilles Muller,Felix Mantilla,Gilles Muller,5-4 RET,R128,47,3,2,18,28,13,18,5,10,2,3,5,18,28,2,1,15,31,12,15,6,16,1,2,4,18,31
2005-06-20 00:00:00.000,Wimbledon England Grand Slams,GRASS,3,Rafael Nadal,Vincent Spadea,Rafael Nadal,6-4; 6-3; 6-0,R128,91,7,0,45,66,38,45,12,21,1,1,12,50,66,3,4,58,89,35,58,11,31,6,12,13,46,89
2005-06-20 00:00:00.000,Wimbledon England Grand Slams,GRASS,3,Tim Henman,Jarkko Nieminen,Tim Henman,3-6; 6-7(5); 6-4; 7-5; 6-2,R128,211,9,9,102,160,73,102,32,58,3,6,26,105,160,9,3,117,174,77,117,35,57,12,17,25,112,174
2005-06-20 00:00:00.000,Wimbledon England Grand Slams,GRASS,3,Dmitry Tursunov,Nicolas Almagro,Dmitry Tursunov,7-6(2); 7-6(4); 6-1,R128,126,13,10,65,115,51,65,24,50,3,5,16,75,115,9,12,67,117,46,67,21,50,8,12,15,67,117
2005-06-20 00:00:00.000,Wimbledon England Grand Slams,GRASS,3,Alexander Popp,Jerome Haehnel,Alexander Popp,6-2; 6-3; 2-6; 6-4,R128,103,7,3,74,103,51,74,20,29,8,10,17,71,103,2,2,63,97,40,63,19,34,1,6,18,59,97
2005-06-20 00:00:00.000,Wimbledon England Grand Slams,GRASS,3,Wayne Arthurs,Filippo Volandri,Wayne Arthurs,6-3; 6-4; 6-4,R128,86,16,4,45,73,37,45,18,28,3,5,15,55,73,4,7,47,85,32,47,18,38,3,8,14,50,85
2005-06-20 00:00:00.000,Wimbledon England Grand Slams,GRASS,3,Guillermo Garcia-Lopez,David Ferrer,Guillermo Garcia-Lopez,6-3; 6-2; 7-6(7),R128,125,2,5,57,95,42,57,21,38,5,7,15,63,95,6,5,65,103,42,65,16,38,5,10,14,58,103
2005-06-20 00:00:00.000,Wimbledon England Grand Slams,GRASS,3,Novak Djokovic,Juan Monaco,Novak Djokovic,6-3; 7-6(5); 6-3,R128,113,2,5,65,94,53,65,16,29,2,3,16,69,94,4,5,63,97,44,63,18,34,7,10,14,62,97
2005-06-20 00:00:00.000,Wimbledon England Grand Slams,GRASS,3,Victor Hanescu,Kenneth Carlsen,Victor Hanescu,6-7(2); 7-6(4); 6-3; 5-7; 6-4,R128,224,12,5,135,172,99,135,21,37,5,7,28,120,172,16,5,120,184,94,120,31,64,7,10,27,125,184
2005-06-20 00:00:00.000,Wimbledon England Grand Slams,GRASS,3,Sebastien Grosjean,Michael Llodra,Sebastien Grosjean,3-6; 7-5; 4-6; 7-6(5); 6-4,R128,219,13,6,118,183,83,118,35,65,7,12,26,118,183,10,6,110,167,76,110,34,57,9,14,27,110,167
2005-06-20 00:00:00.000,Wimbledon England Grand Slams,GRASS,3,Guillermo Coria,Tomas Behrend,Guillermo Coria,6-1; 6-2; 6-2,R128,79,9,2,42,63,36,42,13,21,0,0,12,49,63,0,3,69,88,37,69,6,19,8,14,11,43,88
2005-06-20 00:00:00.000,Wimbledon England Grand Slams,GRASS,3,Xavier Malisse,Jonathan Marray,Xavier Malisse,6-3; 3-6; 2-6; 6-1; 6-4,R128,170,10,6,71,120,54,71,26,49,1,5,22,80,120,5,8,102,163,61,102,33,61,18,23,21,94,163
2005-06-20 00:00:00.000,Wimbledon England Grand Slams,GRASS,3,Alex Calatrava,Tuomas Ketola,Alex Calatrava,6-4; 7-6(4); 6-4,R128,109,6,2,56,91,47,56,24,35,0,0,16,71,91,21,5,57,93,48,57,17,36,2,4,16,65,93
2005-06-20 00:00:00.000,Wimbledon England Grand Slams,GRASS,3,Jurgen Melzer,Ivan Ljubicic,Jurgen Melzer,6-4; 6-4; 6-4,R128,108,10,3,63,96,49,63,18,33,5,5,15,67,96,12,3,49,83,35,49,20,34,0,3,15,55,83
2005-06-20 00:00:00.000,Wimbledon England Grand Slams,GRASS,3,Igor Andreev,Robin Soderling,Igor Andreev,6-7(3); 7-5; 6-1; 7-5,R128,181,13,2,84,134,64,84,27,50,5,8,22,91,134,4,5,81,155,51,81,34,74,16,23,21,85,155
2005-06-20 00:00:00.000,Wimbledon England Grand Slams,GRASS,3,Davide Sanguinetti,Andreas Seppi,Davide Sanguinetti,6-3; 6-2; 6-1,R128,97,7,1,41,67,33,41,16,26,0,0,12,49,67,3,0,48,91,29,48,16,43,12,18,12,45,91
2005-06-20 00:00:00.000,Wimbledon England Grand Slams,GRASS,3,Daniele Bracciali,Ivo Karlovic,Daniele Bracciali,6-7(4); 7-6(8); 3-6; 7-6(5); 12-10,R128,257,33,5,117,193,102,117,51,76,3,4,33,153,193,51,8,143,198,122,143,32,55,4,5,34,154,198
2005-06-20 00:00:00.000,Wimbledon England Grand Slams,GRASS,3,Andy Roddick,Jiri Vanek,Andy Roddick,6-1; 7-6(4); 6-2,R128,83,13,6,39,68,35,39,19,29,0,1,13,54,68,6,8,49,85,34,49,12,36,5,11,14,46,85
2005-06-20 00:00:00.000,Wimbledon England Grand Slams,GRASS,3,Roger Federer,Ivo Minar,Roger Federer,6-4; 6-4; 6-1,R64,82,10,1,54,72,46,54,12,18,2,2,14,58,72,3,6,51,93,35,51,17,42,3,7,13,52,93
2005-06-20 00:00:00.000,Wimbledon England Grand Slams,GRASS,3,Nicolas Kiefer,Alessio Di Mauro,Nicolas Kiefer,6-3; 7-5; 6-3,R64,126,15,1,58,82,46,58,10,24,1,4,15,56,82,4,4,80,111,44,80,12,31,11,18,15,56,111
2005-06-20 00:00:00.000,Wimbledon England Grand Slams,GRASS,3,Juan Carlos Ferrero,Hyung-Taik Lee,Juan Carlos Ferrero,6-4; 3-6; 4-6; 6-3; 6-3,R64,216,10,1,86,131,60,86,31,45,6,9,23,91,131,5,5,102,165,78,102,22,63,13,18,24,100,165
2005-06-20 00:00:00.000,Wimbledon England Grand Slams,GRASS,3,Florian Mayer,Fernando Verdasco,Florian Mayer,7-6(6); 7-5; 6-3,R64,125,5,0,68,108,51,68,24,40,7,8,17,75,108,13,8,68,109,47,68,20,41,3,6,16,67,109
2005-06-20 00:00:00.000,Wimbledon England Grand Slams,GRASS,3,Joachim Johansson,Greg Rusedski,Joachim Johansson,7-6(10); 3-6; 6-4; 7-6(5),R64,172,23,8,97,147,77,97,27,50,2,4,22,104,147,20,7,78,136,66,78,34,58,3,4,21,100,136
2005-06-20 00:00:00.000,Wimbledon England Grand Slams,GRASS,3,Fernando Gonzalez,Tomas Zib,Fernando Gonzalez,6-4; 7-6(6); 6-3,R64,112,28,8,60,98,49,60,25,38,2,2,16,74,98,6,2,63,96,46,63,17,33,1,3,15,63,96
2005-06-20 00:00:00.000,Wimbledon England Grand Slams,GRASS,3,Mikhail Youzhny,Jean-Rene Lisnard,Mikhail Youzhny,1-6; 7-5; 6-3; 6-4,R64,149,10,4,69,122,53,69,28,53,8,11,19,81,122,4,5,69,130,51,69,31,61,9,13,19,82,130
2005-06-20 00:00:00.000,Wimbledon England Grand Slams,GRASS,3,Jonas Bjorkman,Nikolay Davydenko,Jonas Bjorkman,6-7(4); 1-2 RET,R64,73,4,1,32,48,27,32,7,16,1,1,7,34,48,1,3,43,67,30,43,15,24,5,5,8,45,67
2005-06-20 00:00:00.000,Wimbledon England Grand Slams,GRASS,3,Lleyton Hewitt,Jan Hernych,Lleyton Hewitt,6-2; 7-5; 3-6; 6-3,R64,144,15,5,68,112,55,68,24,44,2,4,19,79,112,2,2,85,119,53,85,21,34,7,12,19,74,119
2005-06-20 00:00:00.000,Wimbledon England Grand Slams,GRASS,3,Justin Gimelstob,Nicolas Massu,Justin Gimelstob,6-3; 4-6; 7-6(5); 7-6(0),R64,208,18,8,82,148,68,82,28,66,9,12,22,96,148,10,5,73,127,57,73,26,54,2,5,21,83,127
2005-06-20 00:00:00.000,Wimbledon England Grand Slams,GRASS,3,Taylor Dent,Kevin Kim,Taylor Dent,6-3; 6-4; 6-4,R64,105,8,13,58,100,50,58,16,42,10,11,15,66,100,5,4,62,94,41,62,16,32,6,10,14,57,94
2005-06-20 00:00:00.000,Wimbledon England Grand Slams,GRASS,3,Tomas Berdych,Lars Burgsmuller,Tomas Berdych,6-3; 6-3; 6-1,R64,77,7,0,47,68,40,47,12,21,0,0,13,52,68,8,2,47,66,30,47,8,19,3,8,12,38,66
2005-06-20 00:00:00.000,Wimbledon England Grand Slams,GRASS,3,Mario Ancic,Danai Udomchoke,Mario Ancic,7-6(6); 3-6; 6-3; 6-3,R64,158,21,8,71,120,62,71,24,49,6,8,19,86,120,1,5,78,120,59,78,23,42,3,7,20,82,120
2005-06-20 00:00:00.000,Wimbledon England Grand Slams,GRASS,3,Gael Monfils,Dominik Hrbaty,Gael Monfils,6-3; 6-3; 2-6; 7-5,R64,137,15,9,59,120,48,59,26,61,6,10,19,74,120,6,6,72,124,49,72,23,52,5,11,19,72,124
2005-06-20 00:00:00.000,Wimbledon England Grand Slams,GRASS,3,Feliciano Lopez,David Sherwood,Feliciano Lopez,6-2; 6-4; 6-2,R64,79,9,2,43,73,36,43,18,30,1,1,13,54,73,5,6,41,77,26,41,17,36,4,9,13,43,77
2005-06-20 00:00:00.000,Wimbledon England Grand Slams,GRASS,3,Marat Safin,Mark Philippoussis,Marat Safin,7-6(4); 7-6(4); 6-4,R64,143,20,2,69,102,60,69,19,33,5,5,17,79,102,21,6,70,105,58,70,15,35,0,1,17,73,105
2005-06-20 00:00:00.000,Wimbledon England Grand Slams,GRASS,3,Max Mirnyi,Olivier Rochus,Max Mirnyi,7-6(4); 6-2; 7-6(3),R64,134,33,1,61,91,56,61,20,30,3,3,16,76,91,1,2,75,116,53,75,22,41,6,8,16,75,116
2005-06-20 00:00:00.000,Wimbledon England Grand Slams,GRASS,3,Jiri Novak,Fabrice Santoro,Jiri Novak,6-1; 4-6; 7-6(4); 6-3,R64,163,9,3,108,156,73,108,26,48,20,23,20,99,156,5,3,57,110,39,57,27,53,4,9,18,66,110
2005-06-20 00:00:00.000,Wimbledon England Grand Slams,GRASS,3,Janko Tipsarevic,Yen-Hsun Lu,Janko Tipsarevic,2-6; 6-3; 6-2; 4-6; 7-5,R64,197,11,5,80,145,57,80,34,65,9,14,24,91,145,21,4,94,143,69,94,20,49,5,11,23,89,143
2005-06-20 00:00:00.000,Wimbledon England Grand Slams,GRASS,3,Thomas Johansson,Andrei Pavel,Thomas Johansson,3-6; 7-6(4); 6-4; 7-6(4),R64,188,13,1,68,122,54,68,35,54,2,5,21,89,122,20,0,95,157,71,95,30,62,10,13,22,101,157
2005-06-20 00:00:00.000,Wimbledon England Grand Slams,GRASS,3,Andy Murray,Radek Stepanek,Andy Murray,6-4; 6-4; 6-4,R64,110,8,2,41,86,37,41,25,45,3,4,15,62,86,5,3,64,93,44,64,14,29,5,9,15,58,93
2005-06-20 00:00:00.000,Wimbledon England Grand Slams,GRASS,3,David Nalbandian,Karol Kucera,David Nalbandian,6-2; 6-4; 6-3,R64,106,4,2,54,78,39,54,16,24,0,1,14,55,78,8,4,50,85,30,50,17,35,10,15,13,47,85
2005-06-20 00:00:00.000,Wimbledon England Grand Slams,GRASS,3,Richard Gasquet,Gilles Elseneer,Richard Gasquet,7-6(7); 7-6(3); 6-7(3); 6-2,R64,171,18,3,107,150,87,107,21,43,2,2,22,108,150,12,10,77,142,60,77,41,65,5,7,22,101,142
2005-06-20 00:00:00.000,Wimbledon England Grand Slams,GRASS,3,Gilles Muller,Rafael Nadal,Gilles Muller,6-4; 4-6; 6-3; 6-4,R64,148,13,3,66,118,56,66,29,52,12,13,20,85,118,11,3,69,106,49,69,22,37,7,10,19,71,106
2005-06-20 00:00:00.000,Wimbledon England Grand Slams,GRASS,3,Dmitry Tursunov,Tim Henman,Dmitry Tursunov,3-6; 6-2; 3-6; 6-3; 8-6,R64,217,20,9,105,186,78,105,33,81,17,22,25,111,186,7,8,91,139,67,91,21,48,3,9,24,88,139
2005-06-20 00:00:00.000,Wimbledon England Grand Slams,GRASS,3,Alexander Popp,Wayne Arthurs,Alexander Popp,6-3; 6-7(4); 3-6; 7-6(4); 14-12,R64,249,24,8,137,203,110,137,37,66,8,9,33,147,203,40,13,129,212,102,129,49,83,14,17,35,151,212
2005-06-20 00:00:00.000,Wimbledon England Grand Slams,GRASS,3,Novak Djokovic,Guillermo Garcia-Lopez,Novak Djokovic,3-6; 3-6; 7-6(5); 7-6(3); 6-4,R64,248,8,4,105,173,75,105,31,68,9,18,26,106,173,6,5,108,182,76,108,33,74,10,17,26,109,182
2005-06-20 00:00:00.000,Wimbledon England Grand Slams,GRASS,3,Sebastien Grosjean,Victor Hanescu,Sebastien Grosjean,6-3; 6-4; 6-2,R64,97,11,1,46,73,39,46,18,27,2,2,14,57,73,7,0,50,79,32,50,14,29,3,7,13,46,79
2005-06-20 00:00:00.000,Wimbledon England Grand Slams,GRASS,3,Guillermo Coria,Xavier Malisse,Guillermo Coria,3-6; 6-3; 7-5; 6-7(3); 6-4,R64,197,6,9,87,155,70,87,35,68,8,11,26,105,155,20,4,104,170,75,104,35,66,7,12,26,110,170
2005-06-20 00:00:00.000,Wimbledon England Grand Slams,GRASS,3,Jurgen Melzer,Alex Calatrava,Jurgen Melzer,6-4; 6-4; 6-1,R64,89,9,5,38,75,34,38,23,37,1,1,14,57,75,5,1,50,77,35,50,12,27,8,12,13,47,77
2005-06-20 00:00:00.000,Wimbledon England Grand Slams,GRASS,3,Igor Andreev,Davide Sanguinetti,Igor Andreev,6-4; 6-2; 3-6; 6-3,R64,126,5,0,66,93,48,66,19,27,0,3,18,67,93,5,7,67,127,49,67,24,60,6,12,18,73,127
2005-06-20 00:00:00.000,Wimbledon England Grand Slams,GRASS,3,Andy Roddick,Daniele Bracciali,Andy Roddick,7-5; 6-3; 6-7(3); 4-6; 6-3,R64,174,23,4,108,155,87,108,25,47,1,2,27,112,155,15,8,72,149,61,72,42,77,8,11,25,103,149
2005-06-20 00:00:00.000,Wimbledon England Grand Slams,GRASS,3,Roger Federer,Nicolas Kiefer,Roger Federer,6-2; 6-7(5); 6-1; 7-5,R32,155,14,4,81,115,58,81,22,34,2,4,20,80,115,5,2,56,108,44,56,19,52,2,9,19,63,108
2005-06-20 00:00:00.000,Wimbledon England Grand Slams,GRASS,3,Juan Carlos Ferrero,Florian Mayer,Juan Carlos Ferrero,3-6; 6-2; 6-1; 6-1,R32,109,7,1,50,83,39,50,21,33,3,4,15,60,83,2,2,64,106,40,64,16,42,8,15,16,56,106
2005-06-20 00:00:00.000,Wimbledon England Grand Slams,GRASS,3,Fernando Gonzalez,Joachim Johansson,Fernando Gonzalez,6-4; 6-4; 6-2,R32,94,20,2,49,72,43,49,17,23,4,4,14,60,72,9,2,84,109,53,84,10,25,9,13,14,63,109
2005-06-20 00:00:00.000,Wimbledon England Grand Slams,GRASS,3,Mikhail Youzhny,Jonas Bjorkman,Mikhail Youzhny,7-5; 6-3; 3-6; 7-6(9),R32,195,6,6,74,142,51,74,32,68,9,16,21,83,142,6,7,90,168,58,90,33,78,9,17,21,91,168
2005-06-20 00:00:00.000,Wimbledon England Grand Slams,GRASS,3,Lleyton Hewitt,Justin Gimelstob,Lleyton Hewitt,7-6(5); 6-4; 7-5,R32,151,14,3,68,110,55,68,22,42,3,3,17,77,110,15,3,70,114,46,70,27,44,7,9,17,73,114
2005-06-20 00:00:00.000,Wimbledon England Grand Slams,GRASS,3,Taylor Dent,Tomas Berdych,Taylor Dent,6-3; 7-6(5); 6-3,R32,115,19,7,57,106,47,57,26,49,6,7,16,73,106,9,2,59,98,40,59,22,39,6,9,14,62,98
2005-06-20 00:00:00.000,Wimbledon England Grand Slams,GRASS,3,Mario Ancic,Gael Monfils,Mario Ancic,6-3; 6-3; 6-1,R32,81,10,5,43,63,40,43,12,20,0,0,13,52,63,3,3,38,72,25,38,15,34,4,9,12,40,72
2005-06-20 00:00:00.000,Wimbledon England Grand Slams,GRASS,3,Feliciano Lopez,Marat Safin,Feliciano Lopez,6-4; 7-6(4); 6-3,R32,109,14,1,59,98,53,59,21,39,4,4,16,74,98,6,1,53,83,42,53,16,30,0,2,15,58,83
2005-06-20 00:00:00.000,Wimbledon England Grand Slams,GRASS,3,Max Mirnyi,Jiri Novak,Max Mirnyi,5-7; 7-5; 6-4; 7-6(2),R32,163,25,2,92,128,74,92,20,36,3,6,23,94,128,8,1,109,149,71,109,23,40,6,10,23,94,149
2005-06-20 00:00:00.000,Wimbledon England Grand Slams,GRASS,3,Thomas Johansson,Janko Tipsarevic,Thomas Johansson,6-2; 6-3; 6-1,R32,74,12,1,45,67,39,45,12,22,4,4,12,51,67,6,1,42,66,24,42,11,24,2,8,12,35,66
2005-06-20 00:00:00.000,Wimbledon England Grand Slams,GRASS,3,David Nalbandian,Andy Murray,David Nalbandian,6-7(4); 1-6; 6-0; 6-4; 6-1,R32,193,3,2,95,140,61,95,23,45,9,15,21,84,140,6,8,71,145,46,71,29,74,11,21,21,75,145
2005-06-20 00:00:00.000,Wimbledon England Grand Slams,GRASS,3,Richard Gasquet,Gilles Muller,Richard Gasquet,7-6(3); 6-3; 6-3,R32,101,12,1,61,87,52,61,15,26,2,2,15,67,87,7,3,72,99,46,72,17,27,5,8,15,63,99
2005-06-20 00:00:00.000,Wimbledon England Grand Slams,GRASS,3,Dmitry Tursunov,Alexander Popp,Dmitry Tursunov,5-7; 7-6(5); 6-2; 6-2,R32,154,11,10,73,127,61,73,26,54,10,12,20,87,127,7,7,82,140,57,82,24,58,11,16,20,81,140
2005-06-20 00:00:00.000,Wimbledon England Grand Slams,GRASS,3,Sebastien Grosjean,Novak Djokovic,Sebastien Grosjean,7-5; 6-4; 5-7; 6-4,R32,171,7,3,79,140,60,79,35,61,3,4,22,95,140,6,4,88,126,66,88,21,38,6,9,22,87,126
2005-06-20 00:00:00.000,Wimbledon England Grand Slams,GRASS,3,Guillermo Coria,Jurgen Melzer,Guillermo Coria,3-6; 3-6; 6-2; 6-2; 6-4,R32,169,9,10,75,135,51,75,32,60,6,10,22,83,135,8,11,99,172,66,99,33,73,16,22,22,99,172
2005-06-20 00:00:00.000,Wimbledon England Grand Slams,GRASS,3,Andy Roddick,Igor Andreev,Andy Roddick,6-2; 6-2; 7-6(4),R32,114,15,1,66,86,57,66,8,20,6,6,14,65,86,2,1,74,105,44,74,14,31,7,11,14,58,105
2005-06-20 00:00:00.000,Wimbledon England Grand Slams,GRASS,3,Roger Federer,Juan Carlos Ferrero,Roger Federer,6-3; 6-4; 7-6(6),R16,135,12,1,67,102,53,67,19,35,2,3,16,72,102,4,3,73,110,53,73,15,37,6,9,15,68,110
2005-06-20 00:00:00.000,Wimbledon England Grand Slams,GRASS,3,Fernando Gonzalez,Mikhail Youzhny,Fernando Gonzalez,7-6(3); 7-6(5); 6-3,R16,125,7,6,58,106,47,58,28,48,4,6,17,75,106,9,4,58,101,41,58,23,43,1,4,16,64,101
2005-06-20 00:00:00.000,Wimbledon England Grand Slams,GRASS,3,Lleyton Hewitt,Taylor Dent,Lleyton Hewitt,6-4; 6-4; 6-7(7); 6-3,R16,182,11,7,74,149,58,74,39,75,6,8,21,97,149,18,14,74,137,58,74,27,63,9,14,20,85,137
2005-06-20 00:00:00.000,Wimbledon England Grand Slams,GRASS,3,Feliciano Lopez,Mario Ancic,Feliciano Lopez,6-4; 6-4; 6-2,R16,100,7,1,47,69,41,47,13,22,2,3,14,54,69,16,15,42,93,33,42,22,51,10,15,14,55,93
2005-06-20 00:00:00.000,Wimbledon England Grand Slams,GRASS,3,Thomas Johansson,Max Mirnyi,Thomas Johansson,6-4; 7-5; 6-4,R16,133,12,0,66,99,51,66,19,33,5,6,16,70,99,15,6,56,102,43,56,19,46,2,6,16,62,102
2005-06-20 00:00:00.000,Wimbledon England Grand Slams,GRASS,3,David Nalbandian,Richard Gasquet,David Nalbandian,6-4; 7-6(3); 6-0,R16,135,3,4,62,94,48,62,16,32,3,4,14,64,94,3,3,82,112,49,82,11,30,11,16,14,60,112
2005-06-20 00:00:00.000,Wimbledon England Grand Slams,GRASS,3,Sebastien Grosjean,Dmitry Tursunov,Sebastien Grosjean,6-4; 6-7(5); 6-3; 3-6; 6-1,R16,208,13,6,86,165,63,86,37,79,10,15,24,100,165,15,7,81,142,57,81,28,61,9,17,23,85,142
2005-06-20 00:00:00.000,Wimbledon England Grand Slams,GRASS,3,Andy Roddick,Guillermo Coria,Andy Roddick,6-3; 7-6(1); 6-4,R16,112,13,3,59,94,46,59,19,35,7,9,15,65,94,6,8,65,111,47,65,16,46,8,13,16,63,111
2005-06-20 00:00:00.000,Wimbledon England Grand Slams,GRASS,3,Roger Federer,Fernando Gonzalez,Roger Federer,7-5; 6-2; 7-6(2),Q,111,9,0,53,89,41,53,26,36,2,3,16,67,89,5,4,65,98,42,65,18,33,2,6,16,60,98
2005-06-20 00:00:00.000,Wimbledon England Grand Slams,GRASS,3,Lleyton Hewitt,Feliciano Lopez,Lleyton Hewitt,7-5; 6-4; 7-6(2),Q,119,15,2,56,89,50,56,22,33,2,3,17,72,89,7,2,54,94,42,54,22,40,3,6,17,64,94
2005-06-20 00:00:00.000,Wimbledon England Grand Slams,GRASS,3,Thomas Johansson,David Nalbandian,Thomas Johansson,7-6(5); 6-2; 6-2,Q,137,7,1,53,92,41,53,20,39,7,9,14,61,92,5,1,79,121,44,79,18,42,10,16,14,62,121
2005-06-20 00:00:00.000,Wimbledon England Grand Slams,GRASS,3,Andy Roddick,Sebastien Grosjean,Andy Roddick,3-6; 6-2; 6-1; 3-6; 6-3,Q,170,14,0,82,123,64,82,22,41,5,7,21,86,123,10,4,60,136,44,60,40,76,11,16,21,84,136
2005-06-20 00:00:00.000,Wimbledon England Grand Slams,GRASS,3,Roger Federer,Lleyton Hewitt,Roger Federer,6-3; 6-4; 7-6(4),S,128,10,3,49,94,42,49,26,45,0,1,16,68,94,5,4,47,102,35,47,31,55,5,8,15,66,102
2005-06-20 00:00:00.000,Wimbledon England Grand Slams,GRASS,3,Andy Roddick,Thomas Johansson,Andy Roddick,6-7(6); 6-2; 7-6(10); 7-6(5),S,179,19,0,107,143,84,107,26,36,3,4,22,110,143,19,2,89,155,69,89,35,66,2,5,22,104,155
2005-06-20 00:00:00.000,Wimbledon England Grand Slams,GRASS,3,Roger Federer,Andy Roddick,Roger Federer,6-2; 7-6(2); 6-4,F,101,12,0,49,79,40,49,22,30,1,2,15,62,79,7,1,68,96,46,68,11,28,5,9,15,57,96
2005-07-04 00:00:00.000,Bastad Sweden ATP World Tour,CLAY,2,Rafael Nadal,Juan Monaco,Rafael Nadal,6-1; 6-1,R32,55,3,2,28,38,23,28,5,10,0,0,7,28,38,0,1,25,39,11,25,3,14,1,6,7,14,39
2005-07-04 00:00:00.000,Bastad Sweden ATP World Tour,CLAY,2,Alberto Martin,Agustin Calleri,Alberto Martin,6-1; 6-1,R32,48,0,0,23,38,20,23,9,15,1,1,7,29,38,0,1,21,37,11,21,4,16,4,9,7,15,37
2005-07-04 00:00:00.000,Bastad Sweden ATP World Tour,CLAY,2,Guillermo Garcia-Lopez,Nicolas Lapentti,Guillermo Garcia-Lopez,7-5; 6-1,R32,85,0,2,42,62,31,42,6,20,5,8,10,37,62,0,1,41,57,19,41,6,16,5,11,9,25,57
2005-07-04 00:00:00.000,Bastad Sweden ATP World Tour,CLAY,2,Juan Carlos Ferrero,Lukas Dlouhy,Juan Carlos Ferrero,6-4; 6-1,R32,61,0,0,36,51,22,36,9,15,2,4,8,31,51,1,6,24,51,14,24,8,27,4,10,9,22,51
2005-07-04 00:00:00.000,Bastad Sweden ATP World Tour,CLAY,2,Tommy Robredo,Michal Tabara,Tommy Robredo,7-5; 6-0,R32,69,2,1,34,51,25,34,11,17,1,2,9,36,51,0,11,27,67,14,27,19,40,3,8,9,33,67
2005-07-04 00:00:00.000,Bastad Sweden ATP World Tour,CLAY,2,Gael Monfils,Jonas Bjorkman,Gael Monfils,6-2; 6-2,R32,64,4,2,24,53,18,24,18,29,6,7,8,36,53,2,2,25,45,14,25,6,20,1,6,8,20,45
2005-07-04 00:00:00.000,Bastad Sweden ATP World Tour,CLAY,2,Andreas Vinciguerra,Michael Ryderstedt,Andreas Vinciguerra,6-3; 6-1,R32,69,6,1,27,44,23,27,11,17,1,1,8,34,44,0,2,43,65,26,43,6,22,3,7,8,32,65
2005-07-04 00:00:00.000,Bastad Sweden ATP World Tour,CLAY,2,Mikhail Youzhny,Jerome Haehnel,Mikhail Youzhny,6-1; 6-1,R32,50,0,1,20,35,15,20,13,15,0,0,7,28,35,1,1,28,52,13,28,8,24,4,9,7,21,52
2005-07-04 00:00:00.000,Bastad Sweden ATP World Tour,CLAY,2,Nicolas Almagro,Jose Acasuso,Nicolas Almagro,6-4; 6-1,R32,66,3,0,39,55,26,39,10,16,5,7,9,36,55,0,2,20,49,12,20,10,29,3,8,8,22,49
2005-07-04 00:00:00.000,Bastad Sweden ATP World Tour,CLAY,2,Tomas Berdych,Kevin Kim,Tomas Berdych,6-2; 6-3,R32,67,6,1,33,57,28,33,14,24,2,2,9,42,57,7,2,31,53,20,31,9,22,5,8,8,29,53
2005-07-04 00:00:00.000,Bastad Sweden ATP World Tour,CLAY,2,Mariano Zabaleta,Raemon Sluiter,Mariano Zabaleta,2-6; 6-1; 6-4,R32,120,8,4,46,70,36,46,12,24,2,4,13,48,70,8,6,50,102,32,50,27,52,10,13,12,59,102
2005-07-04 00:00:00.000,Bastad Sweden ATP World Tour,CLAY,2,Carlos Moya,Alex Calatrava,Carlos Moya,7-5; 6-2,R32,80,2,0,48,69,32,48,11,21,7,9,10,43,69,2,2,38,58,22,38,8,20,2,7,10,30,58
2005-07-04 00:00:00.000,Bastad Sweden ATP World Tour,CLAY,2,Robin Soderling,Florian Mayer,Robin Soderling,6-2; 6-4,R32,69,3,1,37,58,30,37,12,21,2,2,9,42,58,3,3,31,54,20,31,10,23,2,5,9,30,54
2005-07-04 00:00:00.000,Bastad Sweden ATP World Tour,CLAY,2,Oscar Hernandez,Gorka Fraile,Oscar Hernandez,3-6; 6-2; 6-2,R32,108,2,1,57,81,34,57,12,24,5,8,12,46,81,0,1,48,72,27,48,12,24,6,12,13,39,72
2005-07-04 00:00:00.000,Bastad Sweden ATP World Tour,CLAY,2,Florent Serra,Jarkko Nieminen,Florent Serra,7-5; 6-1,R32,88,1,1,46,74,29,46,16,28,11,12,9,45,74,2,3,36,70,20,36,17,34,6,11,10,37,70
2005-07-04 00:00:00.000,Bastad Sweden ATP World Tour,CLAY,2,Jiri Vanek,Joachim Johansson,Jiri Vanek,6-7(2); 7-6(2); 6-2,R32,130,10,4,60,106,48,60,25,46,6,8,16,73,106,14,6,75,112,57,75,14,37,5,9,16,71,112
2005-07-04 00:00:00.000,Bastad Sweden ATP World Tour,CLAY,2,Rafael Nadal,Alberto Martin,Rafael Nadal,6-2; 6-4,R16,101,0,0,42,56,31,42,7,14,6,7,9,38,56,0,3,36,61,21,36,12,25,2,6,9,33,61
2005-07-04 00:00:00.000,Bastad Sweden ATP World Tour,CLAY,2,Juan Carlos Ferrero,Guillermo Garcia-Lopez,Juan Carlos Ferrero,6-3; 6-4,R16,99,0,0,51,71,30,51,14,20,4,6,10,44,71,1,2,47,63,24,47,8,16,1,5,9,32,63
2005-07-04 00:00:00.000,Bastad Sweden ATP World Tour,CLAY,2,Tommy Robredo,Gael Monfils,Tommy Robredo,6-4; 4-2 RET,R16,88,1,2,32,48,24,32,10,16,0,0,8,34,48,2,2,37,64,22,37,13,27,8,10,8,35,64
2005-07-04 00:00:00.000,Bastad Sweden ATP World Tour,CLAY,2,Mikhail Youzhny,Andreas Vinciguerra,Mikhail Youzhny,4-6; 7-6(4); 7-5,R16,157,8,9,57,112,40,57,24,55,2,8,17,64,112,5,2,57,112,33,57,30,55,7,13,17,63,112
2005-07-04 00:00:00.000,Bastad Sweden ATP World Tour,CLAY,2,Tomas Berdych,Nicolas Almagro,Tomas Berdych,4-6; 6-3; 6-4,R16,123,7,3,61,106,43,61,22,45,6,8,15,65,106,2,3,58,84,41,58,13,26,5,8,14,54,84
2005-07-04 00:00:00.000,Bastad Sweden ATP World Tour,CLAY,2,Mariano Zabaleta,Carlos Moya,Mariano Zabaleta,7-6(3); 6-2,R16,99,2,4,40,70,28,40,18,30,3,5,10,46,70,2,0,58,76,36,58,6,18,6,10,10,42,76
2005-07-04 00:00:00.000,Bastad Sweden ATP World Tour,CLAY,2,Oscar Hernandez,Robin Soderling,Oscar Hernandez,1-6; 6-3; 6-2,R16,100,1,2,42,74,22,42,18,32,5,10,12,40,74,5,3,42,64,28,42,7,22,5,11,12,35,64
2005-07-04 00:00:00.000,Bastad Sweden ATP World Tour,CLAY,2,Jiri Vanek,Florent Serra,Jiri Vanek,6-4; 1-6; 6-3,R16,149,6,2,41,100,29,41,24,59,16,21,13,53,100,2,1,60,104,33,60,22,44,11,16,13,55,104
2005-07-04 00:00:00.000,Bastad Sweden ATP World Tour,CLAY,2,Rafael Nadal,Juan Carlos Ferrero,Rafael Nadal,6-3; 6-3,Q,65,3,1,47,64,32,47,11,17,6,6,9,43,64,4,0,51,70,28,51,11,19,11,14,9,39,70
2005-07-04 00:00:00.000,Bastad Sweden ATP World Tour,CLAY,2,Tommy Robredo,Mikhail Youzhny,Tommy Robredo,3-6; 6-4; 6-3,Q,126,1,3,53,87,34,53,18,34,7,12,14,52,87,6,2,57,94,36,57,14,37,7,13,14,50,94
2005-07-04 00:00:00.000,Bastad Sweden ATP World Tour,CLAY,2,Tomas Berdych,Mariano Zabaleta,Tomas Berdych,6-3; 6-2,Q,66,6,2,31,47,23,31,14,16,1,1,9,37,47,3,2,34,56,25,34,6,22,9,12,8,31,56
2005-07-04 00:00:00.000,Bastad Sweden ATP World Tour,CLAY,2,Jiri Vanek,Oscar Hernandez,Jiri Vanek,6-4; 6-2,Q,100,5,2,33,59,26,33,15,26,4,4,9,41,59,0,3,47,75,33,47,9,28,4,7,9,42,75
2005-07-04 00:00:00.000,Bastad Sweden ATP World Tour,CLAY,2,Rafael Nadal,Tommy Robredo,Rafael Nadal,6-3; 6-3,S,90,0,1,41,58,27,41,7,17,7,9,9,34,58,0,1,42,61,22,42,7,19,10,15,9,29,61
2005-07-04 00:00:00.000,Bastad Sweden ATP World Tour,CLAY,2,Tomas Berdych,Jiri Vanek,Tomas Berdych,7-5; 6-1,S,76,3,3,43,67,31,43,14,24,5,6,10,45,67,5,2,28,62,21,28,13,34,6,10,9,34,62
2005-07-04 00:00:00.000,Bastad Sweden ATP World Tour,CLAY,2,Rafael Nadal,Tomas Berdych,Rafael Nadal,2-6; 6-2; 6-4,F,120,1,1,51,71,32,51,12,20,5,9,13,44,71,1,0,47,86,26,47,19,39,2,7,13,45,86
2005-07-04 00:00:00.000,Gstaad Switzerland ATP World Tour,CLAY,2,Sargis Sargsian,Nikolay Davydenko,Sargis Sargsian,1-6; 0-1 RET,R32,33,0,4,12,27,5,12,6,15,4,7,4,11,27,1,1,14,20,11,14,5,6,0,0,4,16,20
2005-07-04 00:00:00.000,Gstaad Switzerland ATP World Tour,CLAY,2,Razvan Sabau,Michael Lammer,Razvan Sabau,3-6; 6-2; 6-3,R32,122,4,7,57,94,38,57,14,37,6,10,13,52,94,4,5,41,75,25,41,16,34,5,11,13,41,75
2005-07-04 00:00:00.000,Gstaad Switzerland ATP World Tour,CLAY,2,Feliciano Lopez,Igor Andreev,Feliciano Lopez,7-5; 6-3,R32,68,10,4,44,69,37,44,12,25,3,3,11,49,69,5,0,38,52,25,38,11,14,1,3,10,36,52
2005-07-04 00:00:00.000,Gstaad Switzerland ATP World Tour,CLAY,2,Potito Starace,Jiri Novak,Potito Starace,6-3; 6-7(3); 7-5,R32,112,0,3,88,107,54,88,9,19,8,13,16,63,107,2,2,65,114,40,65,22,49,4,12,17,62,114
2005-07-04 00:00:00.000,Gstaad Switzerland ATP World Tour,CLAY,2,Radek Stepanek,Yves Allegro,Radek Stepanek,7-6(6); 6-1,R32,76,5,2,43,63,37,43,12,20,3,3,10,49,63,5,6,43,74,32,43,12,31,8,10,9,44,74
2005-07-04 00:00:00.000,Gstaad Switzerland ATP World Tour,CLAY,2,Frantisek Cermak,Philipp Kohlschreiber,Frantisek Cermak,6-3; 7-5,R32,76,9,6,38,69,27,38,15,31,7,9,10,42,69,0,2,37,60,19,37,13,23,3,8,11,32,60
2005-07-04 00:00:00.000,Gstaad Switzerland ATP World Tour,CLAY,2,Fernando Verdasco,Jaroslav Pospisil,Fernando Verdasco,6-2; 6-4,R32,67,7,3,27,48,23,27,13,21,0,0,9,36,48,4,2,38,60,25,38,9,22,3,6,9,34,60
2005-07-04 00:00:00.000,Gstaad Switzerland ATP World Tour,CLAY,2,Stanislas Wawrinka,Filippo Volandri,Stanislas Wawrinka,6-1; 2-6; 6-4,R32,100,4,5,36,68,27,36,16,32,5,9,13,43,68,0,6,63,93,33,63,17,30,6,11,12,50,93
2005-07-04 00:00:00.000,Gstaad Switzerland ATP World Tour,CLAY,2,Nicolas Massu,Tomas Behrend,Nicolas Massu,7-6(4); 7-6(3),R32,110,11,7,43,84,34,43,22,41,5,7,12,56,84,6,3,52,92,35,52,20,40,4,6,12,55,92
2005-07-04 00:00:00.000,Gstaad Switzerland ATP World Tour,CLAY,2,Jan Hernych,Hugo Armando,Jan Hernych,7-5; 6-3,R32,80,3,1,56,75,40,56,9,19,2,3,11,49,75,1,2,39,65,24,39,13,26,3,6,10,37,65
2005-07-04 00:00:00.000,Gstaad Switzerland ATP World Tour,CLAY,2,Luis Horna,Tomas Zib,Luis Horna,7-6(8); 6-4,R32,102,17,5,39,73,35,39,12,34,1,3,11,47,73,8,3,54,91,34,54,20,37,8,11,11,54,91
2005-07-04 00:00:00.000,Gstaad Switzerland ATP World Tour,CLAY,2,Alessio Di Mauro,David Ferrer,Alessio Di Mauro,6-4; 1-6; 6-3,R32,108,1,1,46,81,33,46,13,35,5,10,13,46,81,1,5,40,87,25,40,25,47,7,12,13,50,87
2005-07-04 00:00:00.000,Gstaad Switzerland ATP World Tour,CLAY,2,Ivan Ljubicic,Ricardo Mello,Ivan Ljubicic,6-3; 6-2,R32,52,12,5,24,50,20,24,18,26,2,2,9,38,50,3,0,27,42,15,27,11,15,1,4,8,26,42
2005-07-04 00:00:00.000,Gstaad Switzerland ATP World Tour,CLAY,2,Andreas Seppi,Stefan Koubek,Andreas Seppi,6-7(5); 7-6(5); 7-6(6),R32,200,6,10,65,130,46,65,36,65,5,8,18,82,130,8,4,86,135,60,86,27,49,14,17,18,87,135
2005-07-04 00:00:00.000,Gstaad Switzerland ATP World Tour,CLAY,2,Davide Sanguinetti,Rainer Schuettler,Davide Sanguinetti,6-7(6); 6-2; 6-3,R32,103,4,1,49,84,35,49,24,35,2,4,15,59,84,0,5,57,90,35,57,18,33,4,9,14,53,90
2005-07-04 00:00:00.000,Gstaad Switzerland ATP World Tour,CLAY,2,Gaston Gaudio,George Bastl,Gaston Gaudio,7-5; 6-2,R32,87,1,3,31,54,22,31,11,23,1,4,10,33,54,3,4,41,72,24,41,12,31,6,12,10,36,72
2005-07-04 00:00:00.000,Gstaad Switzerland ATP World Tour,CLAY,2,Razvan Sabau,Sargis Sargsian,Razvan Sabau,6-4; 6-4,R16,75,6,2,27,49,20,27,15,22,1,3,10,35,49,4,7,42,74,28,42,12,32,5,9,10,40,74
2005-07-04 00:00:00.000,Gstaad Switzerland ATP World Tour,CLAY,2,Potito Starace,Feliciano Lopez,Potito Starace,7-6(6); 6-0,R16,64,1,0,48,56,38,48,6,8,1,1,9,44,56,5,3,31,64,22,31,14,33,2,5,9,36,64
2005-07-04 00:00:00.000,Gstaad Switzerland ATP World Tour,CLAY,2,Frantisek Cermak,Radek Stepanek,Frantisek Cermak,6-7(5); 6-4; 6-4,R16,138,6,4,67,99,50,67,18,32,2,3,16,68,99,8,4,69,116,47,69,26,47,7,10,16,73,116
2005-07-04 00:00:00.000,Gstaad Switzerland ATP World Tour,CLAY,2,Stanislas Wawrinka,Fernando Verdasco,Stanislas Wawrinka,3-6; 6-4; 7-6(8),R16,143,4,2,49,95,40,49,24,46,6,9,16,64,95,7,4,74,108,51,74,18,34,4,6,15,69,108
2005-07-04 00:00:00.000,Gstaad Switzerland ATP World Tour,CLAY,2,Nicolas Massu,Jan Hernych,Nicolas Massu,7-5; 2-6; 6-4,R16,137,4,2,51,103,35,51,23,52,11,16,15,58,103,3,5,69,106,43,69,16,37,12,17,15,59,106
2005-07-04 00:00:00.000,Gstaad Switzerland ATP World Tour,CLAY,2,Luis Horna,Alessio Di Mauro,Luis Horna,6-3; 6-4,R16,52,6,1,30,48,27,30,13,18,0,0,10,40,48,4,2,24,41,17,24,13,17,0,2,9,30,41
2005-07-04 00:00:00.000,Gstaad Switzerland ATP World Tour,CLAY,2,Andreas Seppi,Ivan Ljubicic,Andreas Seppi,7-6(4); 6-3,R16,91,3,3,43,72,33,43,19,29,9,10,11,52,72,15,1,36,70,25,36,18,34,3,5,10,43,70
2005-07-04 00:00:00.000,Gstaad Switzerland ATP World Tour,CLAY,2,Gaston Gaudio,Davide Sanguinetti,Gaston Gaudio,6-2; 6-2,R16,57,2,2,29,45,23,29,10,16,1,1,8,33,45,1,1,30,53,22,30,5,23,4,8,8,27,53
2005-07-04 00:00:00.000,Gstaad Switzerland ATP World Tour,CLAY,2,Razvan Sabau,Potito Starace,Razvan Sabau,0-6; 7-5; 7-5,Q,152,6,3,72,122,41,72,26,50,10,15,15,67,122,4,1,82,109,53,82,13,27,8,12,15,66,109
2005-07-04 00:00:00.000,Gstaad Switzerland ATP World Tour,CLAY,2,Stanislas Wawrinka,Frantisek Cermak,Stanislas Wawrinka,6-4; 7-6(5),Q,97,2,3,48,75,38,48,12,27,5,6,11,50,75,1,6,48,80,37,48,12,32,7,9,11,49,80
2005-07-04 00:00:00.000,Gstaad Switzerland ATP World Tour,CLAY,2,Nicolas Massu,Luis Horna,Nicolas Massu,6-4; 6-4,Q,80,2,0,38,56,33,38,9,18,0,0,10,42,56,3,4,37,57,29,37,8,20,4,6,10,37,57
2005-07-04 00:00:00.000,Gstaad Switzerland ATP World Tour,CLAY,2,Gaston Gaudio,Andreas Seppi,Gaston Gaudio,6-4; 1-6; 7-6(5),Q,142,8,3,60,103,33,60,19,43,5,13,15,52,103,4,5,44,99,31,44,22,55,5,11,14,53,99
2005-07-04 00:00:00.000,Gstaad Switzerland ATP World Tour,CLAY,2,Stanislas Wawrinka,Razvan Sabau,Stanislas Wawrinka,7-6(7); 6-4,S,198,7,1,54,82,39,54,15,28,9,10,11,54,82,1,5,39,83,27,39,21,44,5,7,11,48,83
2005-07-04 00:00:00.000,Gstaad Switzerland ATP World Tour,CLAY,2,Gaston Gaudio,Nicolas Massu,Gaston Gaudio,6-3; 6-2,S,87,3,1,34,54,27,34,10,20,4,5,9,37,54,2,2,30,65,20,30,12,35,9,13,8,32,65
2005-07-04 00:00:00.000,Gstaad Switzerland ATP World Tour,CLAY,2,Gaston Gaudio,Stanislas Wawrinka,Gaston Gaudio,6-4; 6-4,F,104,1,3,48,64,31,48,11,16,3,4,10,42,64,13,6,46,91,34,46,17,45,9,12,10,51,91
2005-07-04 00:00:00.000,Newport RI; U.S.A. ATP World Tour,GRASS,2,Taylor Dent,Amer Delic,Taylor Dent,7-6(3); 6-4,R32,70,3,9,29,63,27,29,21,34,1,1,11,48,63,8,0,42,61,30,42,14,19,3,4,11,44,61
2005-07-04 00:00:00.000,Newport RI; U.S.A. ATP World Tour,GRASS,2,Wesley Moodie,Jimmy Wang,Wesley Moodie,6-4; 6-4,R32,75,9,1,41,50,32,41,5,9,0,1,10,37,50,1,4,41,76,23,41,20,35,5,8,10,43,76
2005-07-04 00:00:00.000,Newport RI; U.S.A. ATP World Tour,GRASS,2,Michal Mertinak,Bobby Reynolds,Michal Mertinak,6-4; 6-7(4); 6-3,R32,118,5,6,63,91,44,63,13,28,1,4,15,57,91,18,7,68,106,53,68,9,38,5,11,16,62,106
2005-07-04 00:00:00.000,Newport RI; U.S.A. ATP World Tour,GRASS,2,Robby Ginepri,Scott Oudsema,Robby Ginepri,6-2; 6-7(6); 6-0,R32,98,4,1,51,79,36,51,20,28,3,4,13,56,79,7,7,59,103,37,59,15,44,9,15,13,52,103
2005-07-04 00:00:00.000,Newport RI; U.S.A. ATP World Tour,GRASS,2,Greg Rusedski,Uros Vico,Greg Rusedski,2-6; 6-4; 6-4,R32,96,15,6,43,80,33,43,20,37,5,7,14,53,80,9,1,55,85,42,55,18,30,3,5,14,60,85
2005-07-04 00:00:00.000,Newport RI; U.S.A. ATP World Tour,GRASS,2,Robin Vik,Frank Dancevic,Robin Vik,6-4; 1-6; 6-3,R32,98,4,4,52,86,38,52,15,34,6,9,13,53,86,14,2,40,86,32,40,22,46,5,8,13,54,86
2005-07-04 00:00:00.000,Newport RI; U.S.A. ATP World Tour,GRASS,2,Andy Murray,Gregory Carraz,Andy Murray,6-4; 7-5,R32,84,4,2,37,69,31,37,17,32,3,3,11,48,69,4,5,39,73,28,39,17,34,4,6,11,45,73
2005-07-04 00:00:00.000,Newport RI; U.S.A. ATP World Tour,GRASS,2,Antony Dupuis,James Blake,Antony Dupuis,6-2; 6-4,R32,56,3,4,35,51,27,35,10,16,2,3,9,37,51,5,3,30,52,21,30,7,22,2,6,9,28,52
2005-07-04 00:00:00.000,Newport RI; U.S.A. ATP World Tour,GRASS,2,Paul Goldstein,Dick Norman,Paul Goldstein,6-3; 1-6; 6-3,R32,105,1,4,62,96,44,62,14,34,8,10,13,58,96,13,7,47,88,35,47,20,41,7,9,12,55,88
2005-07-04 00:00:00.000,Newport RI; U.S.A. ATP World Tour,GRASS,2,Florin Mergea,Brian Wilson,Florin Mergea,6-2; 6-2,R32,44,1,2,35,42,29,35,3,7,0,0,8,32,42,2,5,27,45,20,27,3,18,4,8,8,23,45
2005-07-04 00:00:00.000,Newport RI; U.S.A. ATP World Tour,GRASS,2,Alexander Waske,Gilles Elseneer,Alexander Waske,7-6(5); 4-6; 6-4,R32,117,17,6,42,89,35,42,31,47,0,1,16,66,89,9,5,61,94,50,61,20,33,4,5,16,70,94
2005-07-04 00:00:00.000,Newport RI; U.S.A. ATP World Tour,GRASS,2,Daniele Bracciali,Cyril Saulnier,Daniele Bracciali,7-5; 6-3,R32,79,10,2,36,64,32,36,13,28,6,6,10,45,64,2,2,30,63,20,30,18,33,4,7,11,38,63
2005-07-04 00:00:00.000,Newport RI; U.S.A. ATP World Tour,GRASS,2,Giovanni Lapentti,Lars Burgsmuller,Giovanni Lapentti,7-6(3); 3-1 RET,R32,69,7,4,35,55,27,35,9,20,2,3,8,36,55,1,8,36,64,28,36,10,28,5,7,8,38,64
2005-07-04 00:00:00.000,Newport RI; U.S.A. ATP World Tour,GRASS,2,Dusan Vemic,Alex Bogomolov Jr.,Dusan Vemic,6-2; 6-3,R32,58,2,1,29,46,20,29,13,17,1,1,8,33,46,2,2,35,59,22,35,11,24,9,13,9,33,59
2005-07-04 00:00:00.000,Newport RI; U.S.A. ATP World Tour,GRASS,2,Karol Kucera,Jeff Morrison,Karol Kucera,7-6(8); 7-6(1),R32,108,4,11,42,93,35,42,25,51,4,6,12,60,93,6,5,55,86,40,55,16,31,2,4,12,56,86
2005-07-04 00:00:00.000,Newport RI; U.S.A. ATP World Tour,GRASS,2,Vincent Spadea,Alexander Popp,Vincent Spadea,4-6; 6-3; 6-2,R32,104,3,4,51,91,37,51,18,40,6,9,14,55,91,1,6,54,93,34,54,17,39,7,12,13,51,93
2005-07-04 00:00:00.000,Newport RI; U.S.A. ATP World Tour,GRASS,2,Wesley Moodie,Taylor Dent,Wesley Moodie,6-4; 6-1,R16,67,10,3,36,54,25,36,11,18,1,1,8,36,54,6,15,31,66,21,31,14,35,4,8,9,35,66
2005-07-04 00:00:00.000,Newport RI; U.S.A. ATP World Tour,GRASS,2,Michal Mertinak,Robby Ginepri,Michal Mertinak,6-3; 6-4,R16,70,0,1,42,61,32,42,8,19,3,4,9,40,61,6,0,35,60,19,35,14,25,3,7,10,33,60
2005-07-04 00:00:00.000,Newport RI; U.S.A. ATP World Tour,GRASS,2,Greg Rusedski,Robin Vik,Greg Rusedski,6-2; 7-6(5),R16,83,10,4,42,70,32,42,16,28,3,4,10,48,70,2,4,40,64,28,40,12,24,6,9,10,40,64
2005-07-04 00:00:00.000,Newport RI; U.S.A. ATP World Tour,GRASS,2,Antony Dupuis,Andy Murray,Antony Dupuis,6-4; 6-1,R16,67,5,0,32,59,23,32,20,27,4,4,9,43,59,3,2,23,43,15,23,8,20,4,7,8,23,43
2005-07-04 00:00:00.000,Newport RI; U.S.A. ATP World Tour,GRASS,2,Paul Goldstein,Florin Mergea,Paul Goldstein,6-1; 6-3,R16,65,0,3,32,52,22,32,10,20,3,5,8,32,52,1,5,44,72,21,44,10,28,3,9,8,31,72
2005-07-04 00:00:00.000,Newport RI; U.S.A. ATP World Tour,GRASS,2,Alexander Waske,Daniele Bracciali,Alexander Waske,7-6(7); 7-6(6),R16,121,12,4,51,82,43,51,17,31,3,4,12,60,82,9,2,40,90,32,40,29,50,2,3,12,61,90
2005-07-04 00:00:00.000,Newport RI; U.S.A. ATP World Tour,GRASS,2,Dusan Vemic,Giovanni Lapentti,Dusan Vemic,6-7(5); 7-5; 3-2 RET,R16,165,6,1,70,99,45,70,19,29,5,6,14,64,99,1,4,87,136,56,87,27,49,16,19,15,83,136
2005-07-04 00:00:00.000,Newport RI; U.S.A. ATP World Tour,GRASS,2,Vincent Spadea,Karol Kucera,Vincent Spadea,6-1; 6-4,R16,64,2,0,26,47,20,26,14,21,0,1,9,34,47,2,8,35,65,20,35,12,30,7,11,8,32,65
2005-07-04 00:00:00.000,Newport RI; U.S.A. ATP World Tour,GRASS,2,Wesley Moodie,Michal Mertinak,Wesley Moodie,6-4; 6-3,Q,75,10,3,48,63,33,48,9,15,3,4,10,42,63,2,1,28,44,18,28,11,16,1,4,9,29,44
2005-07-04 00:00:00.000,Newport RI; U.S.A. ATP World Tour,GRASS,2,Greg Rusedski,Antony Dupuis,Greg Rusedski,7-6(3); 6-4,Q,97,7,9,43,75,34,43,18,32,6,7,11,52,75,8,1,47,76,30,47,16,29,5,7,11,46,76
2005-07-04 00:00:00.000,Newport RI; U.S.A. ATP World Tour,GRASS,2,Paul Goldstein,Alexander Waske,Paul Goldstein,6-3; 3-6; 7-6(5),Q,125,2,1,95,114,62,95,10,19,7,8,15,72,114,12,7,56,101,41,56,27,45,8,9,15,68,101
2005-07-04 00:00:00.000,Newport RI; U.S.A. ATP World Tour,GRASS,2,Vincent Spadea,Dusan Vemic,Vincent Spadea,6-3; 6-4,Q,80,3,4,40,75,31,40,15,35,1,2,10,46,75,6,3,43,61,26,43,9,18,2,5,9,35,61
2005-07-04 00:00:00.000,Newport RI; U.S.A. ATP World Tour,GRASS,2,Greg Rusedski,Wesley Moodie,Greg Rusedski,7-6(2); 6-4,S,80,9,4,48,69,40,48,13,21,5,5,11,53,69,8,2,54,65,39,54,8,11,4,5,11,47,65
2005-07-04 00:00:00.000,Newport RI; U.S.A. ATP World Tour,GRASS,2,Vincent Spadea,Paul Goldstein,Vincent Spadea,7-6(6); 6-2,S,93,1,4,46,81,25,46,14,35,3,9,10,39,81,0,4,33,68,16,33,10,35,0,8,10,26,68
2005-07-04 00:00:00.000,Newport RI; U.S.A. ATP World Tour,GRASS,2,Greg Rusedski,Vincent Spadea,Greg Rusedski,7-6(3); 2-6; 6-4,F,116,8,8,45,82,40,45,19,37,4,7,15,59,82,0,2,59,100,41,59,26,41,7,9,15,67,100
2005-07-18 00:00:00.000,Amersfoort The Netherlands ATP World Tour,CLAY,2,Mariano Puerta,Janko Tipsarevic,Mariano Puerta,6-2; 6-2,R32,67,5,2,33,46,25,33,8,13,1,1,8,33,46,5,3,36,63,24,36,9,27,6,10,8,33,63
2005-07-18 00:00:00.000,Amersfoort The Netherlands ATP World Tour,CLAY,2,Juan Antonio Marin,Francesco Aldi,Juan Antonio Marin,7-6(5); 6-1,R32,125,4,0,55,88,32,55,22,33,8,9,10,54,88,0,1,50,71,30,50,10,21,6,9,9,40,71
2005-07-18 00:00:00.000,Amersfoort The Netherlands ATP World Tour,CLAY,2,Ivo Minar,Florent Serra,Ivo Minar,6-4; 6-2,R32,66,5,1,35,56,27,35,10,21,3,4,9,37,56,1,3,41,62,22,41,10,21,4,8,9,32,62
2005-07-18 00:00:00.000,Amersfoort The Netherlands ATP World Tour,CLAY,2,Santiago Ventura,Oscar Hernandez,Santiago Ventura,3-6; 6-0; 6-1,R32,89,7,3,44,63,33,44,8,19,5,7,11,41,63,0,2,37,57,17,37,8,20,2,8,11,25,57
2005-07-18 00:00:00.000,Amersfoort The Netherlands ATP World Tour,CLAY,2,Christophe Rochus,Michal Tabara,Christophe Rochus,4-6; 6-2; 7-5,R32,134,8,6,81,132,57,81,20,51,15,18,15,77,132,5,4,45,96,27,45,25,51,8,13,15,52,96
2005-07-18 00:00:00.000,Amersfoort The Netherlands ATP World Tour,CLAY,2,Melle Van Gemerden,Dennis van Scheppingen,Melle Van Gemerden,6-0 RET,R32,28,3,0,11,14,9,11,3,3,0,0,3,12,14,0,3,9,23,7,9,1,14,3,6,3,8,23
2005-07-18 00:00:00.000,Amersfoort The Netherlands ATP World Tour,CLAY,2,Agustin Calleri,Julien Benneteau,Agustin Calleri,6-4; 2-6; 6-3,R32,115,6,4,44,78,27,44,19,34,3,7,13,46,78,6,1,59,85,35,59,12,26,6,11,14,47,85
2005-07-18 00:00:00.000,Amersfoort The Netherlands ATP World Tour,CLAY,2,Victor Hanescu,Steven Korteling,Victor Hanescu,6-4; 7-5,R32,79,5,0,48,71,34,48,14,23,4,5,11,48,71,6,0,44,63,31,44,8,19,3,6,11,39,63
2005-07-18 00:00:00.000,Amersfoort The Netherlands ATP World Tour,CLAY,2,David Sanchez,Tomas Behrend,David Sanchez,6-4; 7-5,R32,97,3,2,59,86,35,59,17,27,7,10,11,52,86,5,2,36,63,24,36,9,27,3,8,11,33,63
2005-07-18 00:00:00.000,Amersfoort The Netherlands ATP World Tour,CLAY,2,Alex Calatrava,Sergio Roitman,Alex Calatrava,3-6; 6-3; 7-5,R32,120,9,4,71,104,52,71,13,33,10,13,15,65,104,2,3,68,100,42,68,17,32,4,8,15,59,100
2005-07-18 00:00:00.000,Amersfoort The Netherlands ATP World Tour,CLAY,2,Jiri Vanek,Dick Norman,Jiri Vanek,6-7(5); 6-2; 6-3,R32,126,4,3,60,95,47,60,21,35,1,1,15,68,95,8,6,56,95,40,56,16,39,6,9,14,56,95
2005-07-18 00:00:00.000,Amersfoort The Netherlands ATP World Tour,CLAY,2,Nicolas Massu,Nicolas Thomann,Nicolas Massu,6-4; 6-2,R32,97,4,3,42,69,29,42,14,27,9,10,9,43,69,5,2,41,64,23,41,12,23,3,7,9,35,64
2005-07-18 00:00:00.000,Amersfoort The Netherlands ATP World Tour,CLAY,2,Raemon Sluiter,Luis Horna,Raemon Sluiter,6-7(7); 6-3; 7-5,R32,143,13,7,55,108,52,55,27,53,4,5,17,79,108,9,1,71,98,47,71,17,27,2,5,16,64,98
2005-07-18 00:00:00.000,Amersfoort The Netherlands ATP World Tour,CLAY,2,Daniele Bracciali,Radim Zitko,Daniele Bracciali,7-6(2); 6-3,R32,104,9,2,38,73,24,38,22,35,4,7,11,46,73,1,5,48,76,30,48,9,28,8,12,10,39,76
2005-07-18 00:00:00.000,Amersfoort The Netherlands ATP World Tour,CLAY,2,Robin Vik,Nicolas Lapentti,Robin Vik,6-1; 6-3,R32,66,2,4,29,47,23,29,11,18,1,1,8,34,47,2,1,33,52,18,33,9,19,4,8,8,27,52
2005-07-18 00:00:00.000,Amersfoort The Netherlands ATP World Tour,CLAY,2,Fernando Gonzalez,Kristof Vliegen,Fernando Gonzalez,6-2; 6-1,R32,49,5,1,32,47,24,32,11,15,2,2,8,35,47,1,2,30,43,17,30,4,13,3,7,7,21,43
2005-07-18 00:00:00.000,Amersfoort The Netherlands ATP World Tour,CLAY,2,Mariano Puerta,Juan Antonio Marin,Mariano Puerta,6-2; 6-2,R16,61,2,1,32,43,24,32,7,11,1,2,8,31,43,3,2,22,43,12,22,6,21,1,6,8,18,43
2005-07-18 00:00:00.000,Amersfoort The Netherlands ATP World Tour,CLAY,2,Ivo Minar,Santiago Ventura,Ivo Minar,7-6(5); 6-4,R16,80,3,1,37,70,31,37,17,33,1,2,11,48,70,5,0,42,68,29,42,13,26,1,3,11,42,68
2005-07-18 00:00:00.000,Amersfoort The Netherlands ATP World Tour,CLAY,2,Melle Van Gemerden,Christophe Rochus,Melle Van Gemerden,6-2; 7-5,R16,93,8,0,27,51,17,27,20,24,1,3,10,37,51,0,2,38,66,22,38,12,28,4,9,10,34,66
2005-07-18 00:00:00.000,Amersfoort The Netherlands ATP World Tour,CLAY,2,Agustin Calleri,Victor Hanescu,Agustin Calleri,7-6(5); 6-4,R16,256,4,0,36,67,26,36,24,31,0,0,11,50,67,3,2,65,93,46,65,12,28,11,12,11,58,93
2005-07-18 00:00:00.000,Amersfoort The Netherlands ATP World Tour,CLAY,2,David Sanchez,Alex Calatrava,David Sanchez,6-2; 6-2,R16,64,1,0,34,52,26,34,10,18,2,2,8,36,52,2,2,26,46,13,26,9,20,2,6,8,22,46
2005-07-18 00:00:00.000,Amersfoort The Netherlands ATP World Tour,CLAY,2,Nicolas Massu,Jiri Vanek,Nicolas Massu,6-4; 7-5,R16,91,4,3,41,63,28,41,14,22,3,5,11,42,63,6,1,50,66,30,50,7,16,1,5,11,37,66
2005-07-18 00:00:00.000,Amersfoort The Netherlands ATP World Tour,CLAY,2,Daniele Bracciali,Raemon Sluiter,Daniele Bracciali,1-6; 7-6(5); 6-2,R16,115,8,3,54,90,38,54,22,36,10,12,13,60,90,11,1,52,89,39,52,20,37,3,5,14,59,89
2005-07-18 00:00:00.000,Amersfoort The Netherlands ATP World Tour,CLAY,2,Fernando Gonzalez,Robin Vik,Fernando Gonzalez,6-2; 6-2,R16,51,4,3,27,43,18,27,8,16,0,2,8,26,43,0,2,21,46,11,21,7,25,4,10,8,18,46
2005-07-18 00:00:00.000,Amersfoort The Netherlands ATP World Tour,CLAY,2,Ivo Minar,Mariano Puerta,Ivo Minar,6-2; 5-7; 7-6(4),Q,123,16,0,63,111,49,63,23,48,7,10,16,72,111,6,0,66,97,44,66,17,31,5,9,16,61,97
2005-07-18 00:00:00.000,Amersfoort The Netherlands ATP World Tour,CLAY,2,Agustin Calleri,Melle Van Gemerden,Agustin Calleri,6-4; 6-4,Q,98,11,3,50,85,38,50,17,35,8,8,10,55,85,3,4,33,58,23,33,13,25,0,2,10,36,58
2005-07-18 00:00:00.000,Amersfoort The Netherlands ATP World Tour,CLAY,2,David Sanchez,Nicolas Massu,David Sanchez,6-3; 4-6; 6-3,Q,152,4,0,58,90,39,58,17,32,6,9,14,56,90,1,4,58,103,35,58,22,45,14,19,14,57,103
2005-07-18 00:00:00.000,Amersfoort The Netherlands ATP World Tour,CLAY,2,Fernando Gonzalez,Daniele Bracciali,Fernando Gonzalez,6-3; 6-3,Q,52,8,3,25,51,23,25,13,26,3,4,9,36,51,3,2,26,48,17,26,11,22,3,7,9,28,48
2005-07-18 00:00:00.000,Amersfoort The Netherlands ATP World Tour,CLAY,2,Agustin Calleri,Ivo Minar,Agustin Calleri,6-4; 6-4,S,68,14,1,30,56,24,30,16,26,0,1,10,40,56,5,4,41,74,25,41,16,33,6,9,10,41,74
2005-07-18 00:00:00.000,Amersfoort The Netherlands ATP World Tour,CLAY,2,Fernando Gonzalez,David Sanchez,Fernando Gonzalez,6-2; 6-1,S,53,4,0,24,42,22,24,10,18,0,0,8,32,42,1,1,28,38,18,28,1,10,0,4,7,19,38
2005-07-18 00:00:00.000,Amersfoort The Netherlands ATP World Tour,CLAY,2,Fernando Gonzalez,Agustin Calleri,Fernando Gonzalez,7-5; 6-3,F,83,6,2,38,56,36,38,7,18,2,3,11,43,56,2,6,41,76,26,41,16,35,4,7,10,42,76
2005-07-18 00:00:00.000,Indianapolis IN; U.S.A. ATP World Tour,HARD,2,Andy Roddick,N/A Bye,Andy Roddick,,R64,0,0,0,0,0,0,0,0,0,0,0,0,0,0,0,0,0,0,0,0,0,0,0,0,0,0,0
2005-07-18 00:00:00.000,Indianapolis IN; U.S.A. ATP World Tour,HARD,2,Dmitry Tursunov,Yen-Hsun Lu,Dmitry Tursunov,6-3; 6-4,R64,73,11,4,30,65,26,30,18,35,3,4,10,44,65,5,5,28,54,18,28,15,26,2,5,9,33,54
2005-07-18 00:00:00.000,Indianapolis IN; U.S.A. ATP World Tour,HARD,2,Noam Okun,Brendan Evans,Noam Okun,6-3; 6-3,R64,74,2,2,32,51,25,32,11,19,2,3,9,36,51,3,4,46,72,29,46,9,26,11,15,9,38,72
2005-07-18 00:00:00.000,Indianapolis IN; U.S.A. ATP World Tour,HARD,2,Xavier Malisse,N/A Bye,Xavier Malisse,,R64,0,0,0,0,0,0,0,0,0,0,0,0,0,0,0,0,0,0,0,0,0,0,0,0,0,0,0
2005-07-18 00:00:00.000,Indianapolis IN; U.S.A. ATP World Tour,HARD,2,Paradorn Srichaphan,N/A Bye,Paradorn Srichaphan,,R64,0,0,0,0,0,0,0,0,0,0,0,0,0,0,0,0,0,0,0,0,0,0,0,0,0,0,0
2005-07-18 00:00:00.000,Indianapolis IN; U.S.A. ATP World Tour,HARD,2,Gregory Carraz,James Blake,Gregory Carraz,7-5; 6-7(3); 7-5,R64,128,12,6,66,115,55,66,24,49,1,1,18,79,115,12,1,56,105,43,56,33,49,4,6,18,76,105
2005-07-18 00:00:00.000,Indianapolis IN; U.S.A. ATP World Tour,HARD,2,Robby Ginepri,Michael Ryderstedt,Robby Ginepri,6-1; 6-4,R64,57,8,1,26,44,22,26,14,18,0,0,9,36,44,2,2,35,54,23,35,7,19,6,9,8,30,54
2005-07-18 00:00:00.000,Indianapolis IN; U.S.A. ATP World Tour,HARD,2,Vincent Spadea,N/A Bye,Vincent Spadea,,R64,0,0,0,0,0,0,0,0,0,0,0,0,0,0,0,0,0,0,0,0,0,0,0,0,0,0,0
2005-07-18 00:00:00.000,Indianapolis IN; U.S.A. ATP World Tour,HARD,2,Dominik Hrbaty,N/A Bye,Dominik Hrbaty,,R64,0,0,0,0,0,0,0,0,0,0,0,0,0,0,0,0,0,0,0,0,0,0,0,0,0,0,0
2005-07-18 00:00:00.000,Indianapolis IN; U.S.A. ATP World Tour,HARD,2,George Bastl,Jeff Morrison,George Bastl,6-4; 6-4,R64,91,2,4,29,57,23,29,17,28,3,4,10,40,57,9,4,43,77,29,43,14,34,4,7,10,43,77
2005-07-18 00:00:00.000,Indianapolis IN; U.S.A. ATP World Tour,HARD,2,Andy Murray,Jesse Witten,Andy Murray,6-4; 6-2,R64,65,4,5,32,53,27,32,10,21,4,5,9,37,53,4,5,33,65,21,33,13,32,8,12,9,34,65
2005-07-18 00:00:00.000,Indianapolis IN; U.S.A. ATP World Tour,HARD,2,Mardy Fish,N/A Bye,Mardy Fish,,R64,0,0,0,0,0,0,0,0,0,0,0,0,0,0,0,0,0,0,0,0,0,0,0,0,0,0,0
2005-07-18 00:00:00.000,Indianapolis IN; U.S.A. ATP World Tour,HARD,2,Karol Beck,N/A Bye,Karol Beck,,R64,0,0,0,0,0,0,0,0,0,0,0,0,0,0,0,0,0,0,0,0,0,0,0,0,0,0,0
2005-07-18 00:00:00.000,Indianapolis IN; U.S.A. ATP World Tour,HARD,2,Jonas Bjorkman,Lukas Dlouhy,Jonas Bjorkman,6-4; 6-1,R64,71,2,4,31,60,23,31,14,29,5,7,9,37,60,7,6,30,57,17,30,8,27,1,6,8,25,57
2005-07-18 00:00:00.000,Indianapolis IN; U.S.A. ATP World Tour,HARD,2,Rajeev Ram,Sjeng Schalken,Rajeev Ram,7-5; 7-6(1),R64,102,11,3,39,73,31,39,18,34,2,4,12,49,73,3,3,50,75,31,50,13,25,2,5,12,44,75
2005-07-18 00:00:00.000,Indianapolis IN; U.S.A. ATP World Tour,HARD,2,Tomas Cakl,N/A Bye,Tomas Cakl,,R64,0,0,0,0,0,0,0,0,0,0,0,0,0,0,0,0,0,0,0,0,0,0,0,0,0,0,0
2005-07-18 00:00:00.000,Indianapolis IN; U.S.A. ATP World Tour,HARD,2,Max Mirnyi,N/A Bye,Max Mirnyi,,R64,0,0,0,0,0,0,0,0,0,0,0,0,0,0,0,0,0,0,0,0,0,0,0,0,0,0,0
2005-07-18 00:00:00.000,Indianapolis IN; U.S.A. ATP World Tour,HARD,2,Paul Goldstein,Alejandro Falla,Paul Goldstein,6-0; 6-4,R64,63,2,7,33,55,25,33,9,22,2,3,8,34,55,4,5,36,60,22,36,6,24,6,11,8,28,60
2005-07-18 00:00:00.000,Indianapolis IN; U.S.A. ATP World Tour,HARD,2,Giovanni Lapentti,Mashiska Washington,Giovanni Lapentti,7-6(3); 6-3,R64,96,2,0,45,64,36,45,13,19,2,2,11,49,64,0,0,56,79,31,56,18,23,7,8,10,49,79
2005-07-18 00:00:00.000,Indianapolis IN; U.S.A. ATP World Tour,HARD,2,Cyril Saulnier,N/A Bye,Cyril Saulnier,,R64,0,0,0,0,0,0,0,0,0,0,0,0,0,0,0,0,0,0,0,0,0,0,0,0,0,0,0
2005-07-18 00:00:00.000,Indianapolis IN; U.S.A. ATP World Tour,HARD,2,Jan Hernych,N/A Bye,Jan Hernych,,R64,0,0,0,0,0,0,0,0,0,0,0,0,0,0,0,0,0,0,0,0,0,0,0,0,0,0,0
2005-07-18 00:00:00.000,Indianapolis IN; U.S.A. ATP World Tour,HARD,2,Bjorn Phau,Amer Delic,Bjorn Phau,6-4; 6-7(4); 6-3,R64,116,3,4,49,102,37,49,33,53,3,4,16,70,102,11,3,56,90,43,56,17,34,4,7,15,60,90
2005-07-18 00:00:00.000,Indianapolis IN; U.S.A. ATP World Tour,HARD,2,Jan-Michael Gambill,Donald Young,Jan-Michael Gambill,7-6(10); 6-2,R64,95,9,9,43,79,37,43,16,36,6,7,10,53,79,6,3,40,74,25,40,20,34,2,5,10,45,74
2005-07-18 00:00:00.000,Indianapolis IN; U.S.A. ATP World Tour,HARD,2,Taylor Dent,N/A Bye,Taylor Dent,,R64,0,0,0,0,0,0,0,0,0,0,0,0,0,0,0,0,0,0,0,0,0,0,0,0,0,0,0
2005-07-18 00:00:00.000,Indianapolis IN; U.S.A. ATP World Tour,HARD,2,Greg Rusedski,N/A Bye,Greg Rusedski,,R64,0,0,0,0,0,0,0,0,0,0,0,0,0,0,0,0,0,0,0,0,0,0,0,0,0,0,0
2005-07-18 00:00:00.000,Indianapolis IN; U.S.A. ATP World Tour,HARD,2,Wesley Moodie,Jean-Rene Lisnard,Wesley Moodie,6-3; 6-3,R64,82,4,2,34,46,23,34,7,12,1,4,9,30,46,1,12,33,84,20,33,19,51,15,21,9,39,84
2005-07-18 00:00:00.000,Indianapolis IN; U.S.A. ATP World Tour,HARD,2,Marcos Baghdatis,Sebastien De Chaunac,Marcos Baghdatis,1-6; 6-3; 6-4,R64,103,9,1,40,70,31,40,13,30,3,7,13,44,70,9,4,46,90,34,46,18,44,7,11,13,52,90
2005-07-18 00:00:00.000,Indianapolis IN; U.S.A. ATP World Tour,HARD,2,Kenneth Carlsen,N/A Bye,Kenneth Carlsen,,R64,0,0,0,0,0,0,0,0,0,0,0,0,0,0,0,0,0,0,0,0,0,0,0,0,0,0,0
2005-07-18 00:00:00.000,Indianapolis IN; U.S.A. ATP World Tour,HARD,2,Hyung-Taik Lee,N/A Bye,Hyung-Taik Lee,,R64,0,0,0,0,0,0,0,0,0,0,0,0,0,0,0,0,0,0,0,0,0,0,0,0,0,0,0
2005-07-18 00:00:00.000,Indianapolis IN; U.S.A. ATP World Tour,HARD,2,Kevin Kim,Ivo Karlovic,Kevin Kim,6-4; 6-7(3); 6-3,R64,97,5,6,53,93,41,53,25,40,3,4,16,66,93,17,10,52,86,44,52,13,34,4,7,15,57,86
2005-07-18 00:00:00.000,Indianapolis IN; U.S.A. ATP World Tour,HARD,2,Antony Dupuis,Alexander Popp,Antony Dupuis,7-5; 6-1,R64,72,3,1,31,55,23,31,16,24,3,4,10,39,55,2,6,31,58,22,31,9,27,6,10,9,31,58
2005-07-18 00:00:00.000,Indianapolis IN; U.S.A. ATP World Tour,HARD,2,Nicolas Kiefer,N/A Bye,Nicolas Kiefer,,R64,0,0,0,0,0,0,0,0,0,0,0,0,0,0,0,0,0,0,0,0,0,0,0,0,0,0,0
2005-07-18 00:00:00.000,Indianapolis IN; U.S.A. ATP World Tour,HARD,2,Andy Roddick,Dmitry Tursunov,Andy Roddick,7-6(6); 6-7(7); 7-6(5),R32,160,17,3,81,121,61,81,24,40,1,3,18,85,121,18,12,72,139,60,72,31,67,6,8,18,91,139
2005-07-18 00:00:00.000,Indianapolis IN; U.S.A. ATP World Tour,HARD,2,Noam Okun,Xavier Malisse,Noam Okun,6-2; 6-4,R32,78,5,4,34,53,21,34,10,19,5,8,9,31,53,4,3,34,63,19,34,9,29,9,15,9,28,63
2005-07-18 00:00:00.000,Indianapolis IN; U.S.A. ATP World Tour,HARD,2,Paradorn Srichaphan,Gregory Carraz,Paradorn Srichaphan,6-3; 7-6(3),R32,86,7,2,35,66,26,35,23,31,0,1,11,49,66,5,8,25,67,20,25,21,42,3,5,10,41,67
2005-07-18 00:00:00.000,Indianapolis IN; U.S.A. ATP World Tour,HARD,2,Robby Ginepri,Vincent Spadea,Robby Ginepri,6-4; 6-3,R32,64,6,2,38,59,29,38,9,21,0,2,10,38,59,1,4,29,52,17,29,9,23,1,5,9,26,52
2005-07-18 00:00:00.000,Indianapolis IN; U.S.A. ATP World Tour,HARD,2,George Bastl,Dominik Hrbaty,George Bastl,6-4; 6-7(6); 6-4,R32,157,13,4,68,110,44,68,22,42,5,8,16,66,110,13,6,66,111,45,66,20,45,11,16,16,65,111
2005-07-18 00:00:00.000,Indianapolis IN; U.S.A. ATP World Tour,HARD,2,Mardy Fish,Andy Murray,Mardy Fish,6-4; 4-6; 6-4,R32,131,11,5,62,101,48,62,15,39,7,10,15,63,101,7,5,43,80,34,43,20,37,4,8,15,54,80
2005-07-18 00:00:00.000,Indianapolis IN; U.S.A. ATP World Tour,HARD,2,Karol Beck,Jonas Bjorkman,Karol Beck,6-4; 7-5,R32,96,5,3,37,67,25,37,17,30,4,6,11,42,67,5,4,37,76,24,37,19,39,7,11,11,43,76
2005-07-18 00:00:00.000,Indianapolis IN; U.S.A. ATP World Tour,HARD,2,Rajeev Ram,Tomas Cakl,Rajeev Ram,7-5; 7-6(3),R32,95,16,3,46,90,38,46,22,44,5,6,12,60,90,12,1,44,69,36,44,12,25,2,4,12,48,69
2005-07-18 00:00:00.000,Indianapolis IN; U.S.A. ATP World Tour,HARD,2,Paul Goldstein,Max Mirnyi,Paul Goldstein,0-6; 6-3; 6-3,R32,97,1,4,37,71,22,37,21,34,6,10,12,43,71,9,3,35,65,24,35,15,30,0,4,12,39,65
2005-07-18 00:00:00.000,Indianapolis IN; U.S.A. ATP World Tour,HARD,2,Giovanni Lapentti,Cyril Saulnier,Giovanni Lapentti,6-4; 5-7; 6-2,R32,104,7,1,57,78,45,57,13,21,1,3,15,58,78,11,5,54,85,39,54,16,31,3,7,15,55,85
2005-07-18 00:00:00.000,Indianapolis IN; U.S.A. ATP World Tour,HARD,2,Bjorn Phau,Jan Hernych,Bjorn Phau,7-6(3); 6-3,R32,87,9,4,47,84,38,47,18,37,6,8,11,56,84,3,3,33,63,24,33,13,30,3,6,10,37,63
2005-07-18 00:00:00.000,Indianapolis IN; U.S.A. ATP World Tour,HARD,2,Taylor Dent,Jan-Michael Gambill,Taylor Dent,6-3; 6-4,R32,80,6,3,24,53,23,24,17,29,0,1,10,40,53,10,7,34,68,26,34,13,34,4,7,9,39,68
2005-07-18 00:00:00.000,Indianapolis IN; U.S.A. ATP World Tour,HARD,2,Greg Rusedski,Wesley Moodie,Greg Rusedski,6-7(4); 7-6(7); 7-6(2),R32,144,21,7,64,111,57,64,24,47,1,2,18,81,111,18,6,73,120,54,73,29,47,6,7,18,83,120
2005-07-18 00:00:00.000,Indianapolis IN; U.S.A. ATP World Tour,HARD,2,Kenneth Carlsen,Marcos Baghdatis,Kenneth Carlsen,7-5; 2-6; 6-4,R32,120,8,3,52,86,45,52,14,34,1,3,15,59,86,5,2,58,106,39,58,28,48,9,11,15,67,106
2005-07-18 00:00:00.000,Indianapolis IN; U.S.A. ATP World Tour,HARD,2,Kevin Kim,Hyung-Taik Lee,Kevin Kim,7-6(8); 6-4,R32,95,8,4,38,81,27,38,25,43,3,4,11,52,81,7,3,42,76,31,42,18,34,3,5,11,49,76
2005-07-18 00:00:00.000,Indianapolis IN; U.S.A. ATP World Tour,HARD,2,Nicolas Kiefer,Antony Dupuis,Nicolas Kiefer,7-5; 6-4,R32,96,7,3,31,55,23,31,15,24,2,4,11,38,55,10,4,36,70,25,36,14,34,0,4,11,39,70
2005-07-18 00:00:00.000,Indianapolis IN; U.S.A. ATP World Tour,HARD,2,Andy Roddick,Noam Okun,Andy Roddick,6-3; 6-3,R16,69,9,3,42,64,32,42,10,22,1,1,9,42,64,3,1,33,52,17,33,11,19,2,5,9,28,52
2005-07-18 00:00:00.000,Indianapolis IN; U.S.A. ATP World Tour,HARD,2,Robby Ginepri,Paradorn Srichaphan,Robby Ginepri,6-0; 6-4,R16,47,10,1,27,40,23,27,9,13,0,0,8,32,40,3,3,27,45,20,27,4,18,4,8,8,24,45
2005-07-18 00:00:00.000,Indianapolis IN; U.S.A. ATP World Tour,HARD,2,George Bastl,Mardy Fish,George Bastl,1-2 RET,R16,20,0,0,3,7,0,3,3,4,1,2,1,3,7,2,1,8,12,6,8,1,4,0,1,2,7,12
2005-07-18 00:00:00.000,Indianapolis IN; U.S.A. ATP World Tour,HARD,2,Karol Beck,Rajeev Ram,Karol Beck,6-2; 6-4,R16,71,9,2,29,50,22,29,10,21,2,4,9,32,50,3,2,35,62,22,35,8,27,2,7,9,30,62
2005-07-18 00:00:00.000,Indianapolis IN; U.S.A. ATP World Tour,HARD,2,Paul Goldstein,Giovanni Lapentti,Paul Goldstein,6-3; 6-2,R16,81,1,6,34,64,23,34,17,30,3,4,9,40,64,3,2,37,55,24,37,4,18,1,5,8,28,55
2005-07-18 00:00:00.000,Indianapolis IN; U.S.A. ATP World Tour,HARD,2,Taylor Dent,Bjorn Phau,Taylor Dent,6-2; 6-2,R16,55,8,3,24,43,21,24,10,19,2,3,8,31,43,1,5,26,50,14,26,10,24,1,6,8,24,50
2005-07-18 00:00:00.000,Indianapolis IN; U.S.A. ATP World Tour,HARD,2,Greg Rusedski,Kenneth Carlsen,Greg Rusedski,7-6(3); 6-2,R16,93,9,7,32,65,27,32,21,33,1,1,10,48,65,1,4,38,69,23,38,17,31,6,8,10,40,69
2005-07-18 00:00:00.000,Indianapolis IN; U.S.A. ATP World Tour,HARD,2,Nicolas Kiefer,Kevin Kim,Nicolas Kiefer,6-1; 6-3,R16,59,7,4,24,42,19,24,10,18,0,1,8,29,42,7,5,29,57,18,29,8,28,1,6,8,26,57
2005-07-18 00:00:00.000,Indianapolis IN; U.S.A. ATP World Tour,HARD,2,Robby Ginepri,Andy Roddick,Robby Ginepri,4-6; 7-6(2); 7-5,Q,123,12,5,67,112,53,67,23,45,9,11,17,76,112,16,8,57,100,53,57,16,43,5,7,17,69,100
2005-07-18 00:00:00.000,Indianapolis IN; U.S.A. ATP World Tour,HARD,2,Karol Beck,George Bastl,Karol Beck,6-4; 7-5,Q,100,7,4,37,74,24,37,20,37,6,9,11,44,74,1,2,31,58,21,31,8,27,2,7,11,29,58
2005-07-18 00:00:00.000,Indianapolis IN; U.S.A. ATP World Tour,HARD,2,Taylor Dent,Paul Goldstein,Taylor Dent,6-3; 6-2,Q,58,5,5,32,54,27,32,11,22,1,2,9,38,54,2,0,28,41,13,28,9,13,1,5,8,22,41
2005-07-18 00:00:00.000,Indianapolis IN; U.S.A. ATP World Tour,HARD,2,Greg Rusedski,Nicolas Kiefer,Greg Rusedski,3-6; 7-6(4); 6-4,Q,152,8,16,50,108,42,50,24,58,5,8,15,66,108,12,7,52,100,40,52,25,48,3,6,16,65,100
2005-07-18 00:00:00.000,Indianapolis IN; U.S.A. ATP World Tour,HARD,2,Robby Ginepri,Karol Beck,Robby Ginepri,5-7; 6-2; 6-3,S,111,7,1,57,86,41,57,18,29,2,3,14,59,86,14,6,47,89,37,47,17,42,1,5,15,54,89
2005-07-18 00:00:00.000,Indianapolis IN; U.S.A. ATP World Tour,HARD,2,Taylor Dent,Greg Rusedski,Taylor Dent,6-4; 6-4,S,71,13,7,31,54,27,31,14,23,1,1,10,41,54,4,3,40,64,26,40,13,24,4,6,10,39,64
2005-07-18 00:00:00.000,Indianapolis IN; U.S.A. ATP World Tour,HARD,2,Robby Ginepri,Taylor Dent,Robby Ginepri,4-6; 6-0; 3-0 RET,F,86,6,1,41,58,29,41,13,17,2,3,10,42,58,5,5,37,68,23,37,12,31,4,8,9,35,68
2005-07-18 00:00:00.000,Stuttgart Germany ATP World Tour,CLAY,2,Rafael Nadal,N/A Bye,Rafael Nadal,,R64,0,0,0,0,0,0,0,0,0,0,0,0,0,0,0,0,0,0,0,0,0,0,0,0,0,0,0
2005-07-18 00:00:00.000,Stuttgart Germany ATP World Tour,CLAY,2,Hugo Armando,Gustavo Kuerten,Hugo Armando,6-4; 6-1,R64,79,3,1,34,64,27,34,13,30,4,5,9,40,64,2,1,28,51,17,28,10,23,3,7,8,27,51
2005-07-18 00:00:00.000,Stuttgart Germany ATP World Tour,CLAY,2,Fernando Verdasco,Nicolas Almagro,Fernando Verdasco,7-6(4); 6-0,R64,74,7,1,49,77,35,49,14,28,3,3,9,49,77,1,3,25,57,14,25,16,32,3,6,9,30,57
2005-07-18 00:00:00.000,Stuttgart Germany ATP World Tour,CLAY,2,Igor Andreev,N/A Bye,Igor Andreev,,R64,0,0,0,0,0,0,0,0,0,0,0,0,0,0,0,0,0,0,0,0,0,0,0,0,0,0,0
2005-07-18 00:00:00.000,Stuttgart Germany ATP World Tour,CLAY,2,Andrei Pavel,N/A Bye,Andrei Pavel,,R64,0,0,0,0,0,0,0,0,0,0,0,0,0,0,0,0,0,0,0,0,0,0,0,0,0,0,0
2005-07-18 00:00:00.000,Stuttgart Germany ATP World Tour,CLAY,2,Tomas Zib,Simon Greul,Tomas Zib,4-6; 7-6(7); 6-2,R64,114,6,4,59,98,45,59,21,39,5,8,15,66,98,21,4,57,99,39,57,23,42,8,12,15,62,99
2005-07-18 00:00:00.000,Stuttgart Germany ATP World Tour,CLAY,2,Juan Monaco,Tobias Summerer,Juan Monaco,6-1; 6-4,R64,71,2,2,45,67,28,45,13,22,1,2,9,41,67,2,2,33,51,22,33,5,18,1,5,8,27,51
2005-07-18 00:00:00.000,Stuttgart Germany ATP World Tour,CLAY,2,David Ferrer,N/A Bye,David Ferrer,,R64,0,0,0,0,0,0,0,0,0,0,0,0,0,0,0,0,0,0,0,0,0,0,0,0,0,0,0
2005-07-18 00:00:00.000,Stuttgart Germany ATP World Tour,CLAY,2,Tommy Robredo,N/A Bye,Tommy Robredo,,R64,0,0,0,0,0,0,0,0,0,0,0,0,0,0,0,0,0,0,0,0,0,0,0,0,0,0,0
2005-07-18 00:00:00.000,Stuttgart Germany ATP World Tour,CLAY,2,Potito Starace,Gael Monfils,Potito Starace,6-2; 6-3,R64,58,0,1,33,42,26,33,7,9,0,0,8,33,42,9,3,39,64,26,39,7,25,8,12,9,33,64
2005-07-18 00:00:00.000,Stuttgart Germany ATP World Tour,CLAY,2,Andreas Seppi,Florian Mayer,Andreas Seppi,7-6(3); 6-3,R64,74,7,2,36,67,28,36,19,31,4,5,11,47,67,2,4,38,68,25,38,15,30,0,2,10,40,68
2005-07-18 00:00:00.000,Stuttgart Germany ATP World Tour,CLAY,2,Alberto Martin,N/A Bye,Alberto Martin,,R64,0,0,0,0,0,0,0,0,0,0,0,0,0,0,0,0,0,0,0,0,0,0,0,0,0,0,0
2005-07-18 00:00:00.000,Stuttgart Germany ATP World Tour,CLAY,2,Jurgen Melzer,N/A Bye,Jurgen Melzer,,R64,0,0,0,0,0,0,0,0,0,0,0,0,0,0,0,0,0,0,0,0,0,0,0,0,0,0,0
2005-07-18 00:00:00.000,Stuttgart Germany ATP World Tour,CLAY,2,Jarkko Nieminen,Lars Burgsmuller,Jarkko Nieminen,6-7(5); 6-0; 6-1,R64,113,0,3,57,91,38,57,19,34,6,8,12,57,91,4,9,52,88,29,52,12,36,3,11,13,41,88
2005-07-18 00:00:00.000,Stuttgart Germany ATP World Tour,CLAY,2,Razvan Sabau,Carlos Berlocq,Razvan Sabau,6-2; 6-2,R64,61,1,2,32,52,24,32,12,20,5,5,8,36,52,1,4,25,42,17,25,5,17,2,6,8,22,42
2005-07-18 00:00:00.000,Stuttgart Germany ATP World Tour,CLAY,2,Jiri Novak,N/A Bye,Jiri Novak,,R64,0,0,0,0,0,0,0,0,0,0,0,0,0,0,0,0,0,0,0,0,0,0,0,0,0,0,0
2005-07-18 00:00:00.000,Stuttgart Germany ATP World Tour,CLAY,2,Filippo Volandri,N/A Bye,Filippo Volandri,,R64,0,0,0,0,0,0,0,0,0,0,0,0,0,0,0,0,0,0,0,0,0,0,0,0,0,0,0
2005-07-18 00:00:00.000,Stuttgart Germany ATP World Tour,CLAY,2,Gilles Simon,Albert Montanes,Gilles Simon,6-7(3); 6-1; 6-1,R64,204,7,5,58,96,44,58,22,38,4,4,13,66,96,10,6,52,89,33,52,17,37,2,7,13,50,89
2005-07-18 00:00:00.000,Stuttgart Germany ATP World Tour,CLAY,2,Mariano Zabaleta,Aljoscha Thron,Mariano Zabaleta,6-2; 6-3,R64,84,4,5,31,56,21,31,15,25,10,11,8,36,56,5,9,37,77,26,37,13,40,6,11,9,39,77
2005-07-18 00:00:00.000,Stuttgart Germany ATP World Tour,CLAY,2,Olivier Rochus,N/A Bye,Olivier Rochus,,R64,0,0,0,0,0,0,0,0,0,0,0,0,0,0,0,0,0,0,0,0,0,0,0,0,0,0,0
2005-07-18 00:00:00.000,Stuttgart Germany ATP World Tour,CLAY,2,Paul-Henri Mathieu,N/A Bye,Paul-Henri Mathieu,,R64,0,0,0,0,0,0,0,0,0,0,0,0,0,0,0,0,0,0,0,0,0,0,0,0,0,0,0
2005-07-18 00:00:00.000,Stuttgart Germany ATP World Tour,CLAY,2,Albert Costa,Galo Blanco,Albert Costa,6-4; 6-4,R64,97,4,3,41,65,29,41,11,24,4,6,10,40,65,4,1,30,61,19,30,13,31,5,9,10,32,61
2005-07-18 00:00:00.000,Stuttgart Germany ATP World Tour,CLAY,2,Andreas Beck,Alessio Di Mauro,Andreas Beck,6-4; 6-3,R64,92,1,3,38,60,26,38,14,22,0,1,10,40,60,6,1,28,58,20,28,14,30,4,7,9,34,58
2005-07-18 00:00:00.000,Stuttgart Germany ATP World Tour,CLAY,2,Gaston Gaudio,N/A Bye,Gaston Gaudio,,R64,0,0,0,0,0,0,0,0,0,0,0,0,0,0,0,0,0,0,0,0,0,0,0,0,0,0,0
2005-07-18 00:00:00.000,Stuttgart Germany ATP World Tour,CLAY,2,Mikhail Youzhny,N/A Bye,Mikhail Youzhny,,R64,0,0,0,0,0,0,0,0,0,0,0,0,0,0,0,0,0,0,0,0,0,0,0,0,0,0,0
2005-07-18 00:00:00.000,Stuttgart Germany ATP World Tour,CLAY,2,Rainer Schuettler,Fernando Vicente,Rainer Schuettler,7-6(3); 6-4,R64,93,1,1,51,71,33,51,10,20,2,5,11,43,71,1,2,50,80,25,50,18,30,7,11,11,43,80
2005-07-18 00:00:00.000,Stuttgart Germany ATP World Tour,CLAY,2,Philipp Kohlschreiber,Juan Pablo Brzezicki,Philipp Kohlschreiber,3-6; 6-3; 6-3,R64,119,2,1,52,78,30,52,17,26,6,10,13,47,78,0,6,61,102,36,61,17,41,7,13,14,53,102
2005-07-18 00:00:00.000,Stuttgart Germany ATP World Tour,CLAY,2,Tomas Berdych,N/A Bye,Tomas Berdych,,R64,0,0,0,0,0,0,0,0,0,0,0,0,0,0,0,0,0,0,0,0,0,0,0,0,0,0,0
2005-07-18 00:00:00.000,Stuttgart Germany ATP World Tour,CLAY,2,Jose Acasuso,N/A Bye,Jose Acasuso,,R64,0,0,0,0,0,0,0,0,0,0,0,0,0,0,0,0,0,0,0,0,0,0,0,0,0,0,0
2005-07-18 00:00:00.000,Stuttgart Germany ATP World Tour,CLAY,2,Alexander Waske,Jerome Haehnel,Alexander Waske,7-5; 6-2,R64,75,8,2,37,59,30,37,10,22,3,5,10,40,59,4,5,36,65,22,36,12,29,8,13,10,34,65
2005-07-18 00:00:00.000,Stuttgart Germany ATP World Tour,CLAY,2,Ruben Ramirez Hidalgo,Stefan Koubek,Ruben Ramirez Hidalgo,6-4; 6-3,R64,85,3,0,39,61,27,39,11,22,4,5,9,38,61,2,7,42,81,27,42,15,39,7,11,10,42,81
2005-07-18 00:00:00.000,Stuttgart Germany ATP World Tour,CLAY,2,Nikolay Davydenko,N/A Bye,Nikolay Davydenko,,R64,0,0,0,0,0,0,0,0,0,0,0,0,0,0,0,0,0,0,0,0,0,0,0,0,0,0,0
2005-07-18 00:00:00.000,Stuttgart Germany ATP World Tour,CLAY,2,Rafael Nadal,Hugo Armando,Rafael Nadal,6-1; 6-2,R32,62,2,1,19,41,15,19,15,22,1,1,7,30,41,0,1,27,48,16,27,5,21,4,9,8,21,48
2005-07-18 00:00:00.000,Stuttgart Germany ATP World Tour,CLAY,2,Fernando Verdasco,Igor Andreev,Fernando Verdasco,6-4; 5-7; 7-6(5),R32,142,9,8,68,113,46,68,27,45,10,13,17,73,113,3,3,72,118,42,72,29,46,9,12,17,71,118
2005-07-18 00:00:00.000,Stuttgart Germany ATP World Tour,CLAY,2,Tomas Zib,Andrei Pavel,Tomas Zib,5-7; 6-3; 6-1,R32,124,6,4,56,109,38,56,29,53,2,4,14,67,109,10,2,58,88,34,58,14,30,3,8,14,48,88
2005-07-18 00:00:00.000,Stuttgart Germany ATP World Tour,CLAY,2,Juan Monaco,David Ferrer,Juan Monaco,6-4; 6-2,R32,74,1,1,44,64,33,44,10,20,4,4,9,43,64,0,0,30,47,18,30,9,17,0,3,9,27,47
2005-07-18 00:00:00.000,Stuttgart Germany ATP World Tour,CLAY,2,Tommy Robredo,Potito Starace,Tommy Robredo,6-7(4); 6-3; 6-2,R32,125,4,1,68,117,51,68,26,49,13,14,15,77,117,2,3,67,90,44,67,11,23,6,10,14,55,90
2005-07-18 00:00:00.000,Stuttgart Germany ATP World Tour,CLAY,2,Andreas Seppi,Alberto Martin,Andreas Seppi,6-4; 6-4,R32,95,4,3,40,79,31,40,19,39,13,14,10,50,79,2,4,27,63,16,27,21,36,3,6,10,37,63
2005-07-18 00:00:00.000,Stuttgart Germany ATP World Tour,CLAY,2,Jarkko Nieminen,Jurgen Melzer,Jarkko Nieminen,6-4; 6-7(4); 6-4,R32,124,2,2,78,120,40,78,25,42,5,11,16,65,120,2,2,76,116,42,76,16,40,5,13,16,58,116
2005-07-18 00:00:00.000,Stuttgart Germany ATP World Tour,CLAY,2,Jiri Novak,Razvan Sabau,Jiri Novak,4-6; 6-4; 6-0,R32,94,6,2,52,82,34,52,16,30,3,6,13,50,82,6,8,40,84,25,40,19,44,2,8,13,44,84
2005-07-18 00:00:00.000,Stuttgart Germany ATP World Tour,CLAY,2,Gilles Simon,Filippo Volandri,Gilles Simon,6-3; 2-6; 6-4,R32,104,3,2,56,102,34,56,17,46,8,15,14,51,102,2,2,64,79,34,64,4,15,3,10,13,38,79
2005-07-18 00:00:00.000,Stuttgart Germany ATP World Tour,CLAY,2,Mariano Zabaleta,Olivier Rochus,Mariano Zabaleta,4-6; 6-2; 6-3,R32,115,9,3,42,78,30,42,22,36,4,7,14,52,78,1,5,48,91,34,48,17,43,6,11,13,51,91
2005-07-18 00:00:00.000,Stuttgart Germany ATP World Tour,CLAY,2,Paul-Henri Mathieu,Albert Costa,Paul-Henri Mathieu,6-3; 6-4,R32,103,2,1,33,62,23,33,15,29,1,3,10,38,62,1,3,45,70,27,45,9,25,4,8,9,36,70
2005-07-18 00:00:00.000,Stuttgart Germany ATP World Tour,CLAY,2,Gaston Gaudio,Andreas Beck,Gaston Gaudio,6-3; 6-3,R32,78,9,2,26,53,23,26,14,27,3,4,9,37,53,5,3,35,66,18,35,17,31,10,14,9,35,66
2005-07-18 00:00:00.000,Stuttgart Germany ATP World Tour,CLAY,2,Rainer Schuettler,Mikhail Youzhny,Rainer Schuettler,7-5; 6-3,R32,93,3,6,46,71,30,46,11,25,6,9,11,41,71,0,3,33,68,21,33,14,35,5,10,10,35,68
2005-07-18 00:00:00.000,Stuttgart Germany ATP World Tour,CLAY,2,Tomas Berdych,Philipp Kohlschreiber,Tomas Berdych,7-6(4); 1-6; 6-3,R32,107,2,7,48,84,42,48,15,36,3,5,14,57,84,3,2,60,96,46,60,18,36,1,2,14,64,96
2005-07-18 00:00:00.000,Stuttgart Germany ATP World Tour,CLAY,2,Alexander Waske,Jose Acasuso,Alexander Waske,7-5; 6-4,R32,79,10,2,38,55,29,38,10,17,1,3,11,39,55,6,3,34,71,22,34,18,37,3,7,11,40,71
2005-07-18 00:00:00.000,Stuttgart Germany ATP World Tour,CLAY,2,Nikolay Davydenko,Ruben Ramirez Hidalgo,Nikolay Davydenko,6-4; 6-1,R32,70,6,2,28,41,20,28,7,13,0,2,8,27,41,0,3,31,54,13,31,11,23,3,9,9,24,54
2005-07-18 00:00:00.000,Stuttgart Germany ATP World Tour,CLAY,2,Rafael Nadal,Fernando Verdasco,Rafael Nadal,6-3; 6-2,R16,77,3,1,28,46,22,28,12,18,3,3,8,34,46,2,1,40,67,27,40,8,27,4,8,9,35,67
2005-07-18 00:00:00.000,Stuttgart Germany ATP World Tour,CLAY,2,Tomas Zib,Juan Monaco,Tomas Zib,6-4; 7-6(4),R16,101,1,3,38,72,24,38,18,34,1,5,11,42,72,7,0,52,77,33,52,9,25,2,7,11,42,77
2005-07-18 00:00:00.000,Stuttgart Germany ATP World Tour,CLAY,2,Andreas Seppi,Tommy Robredo,Andreas Seppi,7-5; 2-6; 6-1,R16,92,2,4,47,80,32,47,20,33,7,10,14,52,80,2,3,56,78,39,56,9,22,8,12,13,48,78
2005-07-18 00:00:00.000,Stuttgart Germany ATP World Tour,CLAY,2,Jarkko Nieminen,Jiri Novak,Jarkko Nieminen,2-6; 6-2; 7-6(8),R16,108,2,1,54,90,36,54,14,36,4,9,14,50,90,7,6,60,94,39,60,14,34,9,14,14,53,94
2005-07-18 00:00:00.000,Stuttgart Germany ATP World Tour,CLAY,2,Mariano Zabaleta,Gilles Simon,Mariano Zabaleta,7-6(3); 6-1,R16,83,3,7,36,71,24,36,19,35,1,3,10,43,71,2,2,31,66,18,31,16,35,5,9,9,34,66
2005-07-18 00:00:00.000,Stuttgart Germany ATP World Tour,CLAY,2,Gaston Gaudio,Paul-Henri Mathieu,Gaston Gaudio,6-2; 6-7(3); 6-0,R16,121,2,2,51,85,30,51,22,34,2,4,13,52,85,0,5,45,79,25,45,14,34,2,9,13,39,79
2005-07-18 00:00:00.000,Stuttgart Germany ATP World Tour,CLAY,2,Tomas Berdych,Rainer Schuettler,Tomas Berdych,7-6(4); 6-1,R16,75,5,0,34,53,25,34,12,19,1,2,9,37,53,2,3,34,66,22,34,14,32,4,8,10,36,66
2005-07-18 00:00:00.000,Stuttgart Germany ATP World Tour,CLAY,2,Nikolay Davydenko,Alexander Waske,Nikolay Davydenko,7-6(3); 6-3,R16,91,2,2,50,70,36,50,11,20,1,3,11,47,70,6,4,35,70,23,35,17,35,3,6,10,40,70
2005-07-18 00:00:00.000,Stuttgart Germany ATP World Tour,CLAY,2,Rafael Nadal,Tomas Zib,Rafael Nadal,6-2; 6-1,Q,80,6,1,26,43,19,26,12,17,2,2,7,31,43,0,0,34,55,15,34,10,21,4,9,8,25,55
2005-07-18 00:00:00.000,Stuttgart Germany ATP World Tour,CLAY,2,Jarkko Nieminen,Andreas Seppi,Jarkko Nieminen,6-2; 6-3,Q,83,1,1,47,66,31,47,10,19,4,5,8,41,66,3,5,29,59,18,29,10,30,4,9,9,28,59
2005-07-18 00:00:00.000,Stuttgart Germany ATP World Tour,CLAY,2,Gaston Gaudio,Mariano Zabaleta,Gaston Gaudio,6-4; 1-6; 6-2,Q,103,1,0,51,72,34,51,11,21,5,8,12,45,72,2,3,47,76,33,47,12,29,3,7,13,45,76
2005-07-18 00:00:00.000,Stuttgart Germany ATP World Tour,CLAY,2,Nikolay Davydenko,Tomas Berdych,Nikolay Davydenko,6-4; 6-2,Q,72,3,3,26,49,21,26,16,23,0,0,9,37,49,0,2,42,62,25,42,10,20,3,6,9,35,62
2005-07-18 00:00:00.000,Stuttgart Germany ATP World Tour,CLAY,2,Rafael Nadal,Jarkko Nieminen,Rafael Nadal,6-2; 7-5,S,89,2,1,31,50,25,31,10,19,0,2,10,35,50,2,2,52,81,27,52,13,29,5,10,10,40,81
2005-07-18 00:00:00.000,Stuttgart Germany ATP World Tour,CLAY,2,Gaston Gaudio,Nikolay Davydenko,Gaston Gaudio,6-3; 2-1 RET,S,56,2,1,23,40,15,23,8,17,2,4,6,23,40,2,1,20,32,8,20,6,12,2,6,6,14,32
2005-07-18 00:00:00.000,Stuttgart Germany ATP World Tour,CLAY,2,Rafael Nadal,Gaston Gaudio,Rafael Nadal,6-3; 6-3; 6-4,F,161,3,2,63,91,44,63,13,28,3,5,14,57,91,4,1,73,113,43,73,17,40,15,21,14,60,113
2005-07-25 00:00:00.000,Kitzbuhel Austria ATP World Tour,CLAY,2,Nikolay Davydenko,N/A Bye,Nikolay Davydenko,,R64,0,0,0,0,0,0,0,0,0,0,0,0,0,0,0,0,0,0,0,0,0,0,0,0,0,0,0
2005-07-25 00:00:00.000,Kitzbuhel Austria ATP World Tour,CLAY,2,Mariano Zabaleta,Jerome Haehnel,Mariano Zabaleta,6-2; 7-6(3),R64,81,5,3,43,73,29,43,17,30,3,5,10,46,73,2,9,29,71,21,29,18,42,2,6,10,39,71
2005-07-25 00:00:00.000,Kitzbuhel Austria ATP World Tour,CLAY,2,Nicolas Almagro,Razvan Sabau,Nicolas Almagro,6-3; 6-2,R64,66,6,2,31,51,23,31,14,20,2,2,9,37,51,0,1,42,55,22,42,8,13,4,7,8,30,55
2005-07-25 00:00:00.000,Kitzbuhel Austria ATP World Tour,CLAY,2,Igor Andreev,N/A Bye,Igor Andreev,,R64,0,0,0,0,0,0,0,0,0,0,0,0,0,0,0,0,0,0,0,0,0,0,0,0,0,0,0
2005-07-25 00:00:00.000,Kitzbuhel Austria ATP World Tour,CLAY,2,Jose Acasuso,N/A Bye,Jose Acasuso,,R64,0,0,0,0,0,0,0,0,0,0,0,0,0,0,0,0,0,0,0,0,0,0,0,0,0,0,0
2005-07-25 00:00:00.000,Kitzbuhel Austria ATP World Tour,CLAY,2,Florian Mayer,Juan Monaco,Florian Mayer,5-7; 7-6(4); 6-4,R64,146,6,4,83,134,53,83,25,51,8,13,17,78,134,1,3,81,116,52,81,16,35,8,13,17,68,116
2005-07-25 00:00:00.000,Kitzbuhel Austria ATP World Tour,CLAY,2,Alessio Di Mauro,Raemon Sluiter,Alessio Di Mauro,6-2; 6-3,R64,66,5,1,31,51,20,31,14,20,0,1,9,34,51,1,4,26,48,19,26,5,22,1,5,8,24,48
2005-07-25 00:00:00.000,Kitzbuhel Austria ATP World Tour,CLAY,2,Feliciano Lopez,N/A Bye,Feliciano Lopez,,R64,0,0,0,0,0,0,0,0,0,0,0,0,0,0,0,0,0,0,0,0,0,0,0,0,0,0,0
2005-07-25 00:00:00.000,Kitzbuhel Austria ATP World Tour,CLAY,2,Gaston Gaudio,N/A Bye,Gaston Gaudio,,R64,0,0,0,0,0,0,0,0,0,0,0,0,0,0,0,0,0,0,0,0,0,0,0,0,0,0,0
2005-07-25 00:00:00.000,Kitzbuhel Austria ATP World Tour,CLAY,2,Philipp Kohlschreiber,Albert Costa,Philipp Kohlschreiber,6-2; 6-4,R64,73,10,0,28,52,24,28,16,24,5,5,9,40,52,3,5,34,54,22,34,9,20,6,9,9,31,54
2005-07-25 00:00:00.000,Kitzbuhel Austria ATP World Tour,CLAY,2,Robin Vik,Peter Luczak,Robin Vik,6-3; 7-6(4),R64,89,7,3,45,66,32,45,15,21,2,4,11,47,66,2,2,49,73,32,49,10,24,0,3,10,42,73
2005-07-25 00:00:00.000,Kitzbuhel Austria ATP World Tour,CLAY,2,Paul-Henri Mathieu,N/A Bye,Paul-Henri Mathieu,,R64,0,0,0,0,0,0,0,0,0,0,0,0,0,0,0,0,0,0,0,0,0,0,0,0,0,0,0
2005-07-25 00:00:00.000,Kitzbuhel Austria ATP World Tour,CLAY,2,Andrei Pavel,N/A Bye,Andrei Pavel,,R64,0,0,0,0,0,0,0,0,0,0,0,0,0,0,0,0,0,0,0,0,0,0,0,0,0,0,0
2005-07-25 00:00:00.000,Kitzbuhel Austria ATP World Tour,CLAY,2,Rainer Schuettler,David Sanchez,Rainer Schuettler,6-3; 6-3,R64,78,3,4,29,48,20,29,15,19,2,3,9,35,48,0,3,28,54,19,28,10,26,3,7,9,29,54
2005-07-25 00:00:00.000,Kitzbuhel Austria ATP World Tour,CLAY,2,Ivo Minar,Yuri Schukin,Ivo Minar,6-3; 7-6(5),R64,89,3,3,36,75,29,36,22,39,1,1,10,51,75,6,7,44,82,30,44,20,38,6,8,11,50,82
2005-07-25 00:00:00.000,Kitzbuhel Austria ATP World Tour,CLAY,2,Mikhail Youzhny,N/A Bye,Mikhail Youzhny,,R64,0,0,0,0,0,0,0,0,0,0,0,0,0,0,0,0,0,0,0,0,0,0,0,0,0,0,0
2005-07-25 00:00:00.000,Kitzbuhel Austria ATP World Tour,CLAY,2,Nicolas Massu,N/A Bye,Nicolas Massu,,R64,0,0,0,0,0,0,0,0,0,0,0,0,0,0,0,0,0,0,0,0,0,0,0,0,0,0,0
2005-07-25 00:00:00.000,Kitzbuhel Austria ATP World Tour,CLAY,2,Daniel Koellerer,Michal Tabara,Daniel Koellerer,7-6(4); 3-6; 6-4,R64,129,5,2,64,102,47,64,20,38,3,5,16,67,102,7,7,35,94,30,35,34,59,3,4,15,64,94
2005-07-25 00:00:00.000,Kitzbuhel Austria ATP World Tour,CLAY,2,Stefan Koubek,Hugo Armando,Stefan Koubek,6-4; 6-2,R64,61,11,4,34,55,29,34,12,21,2,2,9,41,55,2,0,28,51,16,28,14,23,2,5,9,30,51
2005-07-25 00:00:00.000,Kitzbuhel Austria ATP World Tour,CLAY,2,Christophe Rochus,N/A Bye,Christophe Rochus,,R64,0,0,0,0,0,0,0,0,0,0,0,0,0,0,0,0,0,0,0,0,0,0,0,0,0,0,0
2005-07-25 00:00:00.000,Kitzbuhel Austria ATP World Tour,CLAY,2,Luis Horna,N/A Bye,Luis Horna,,R64,0,0,0,0,0,0,0,0,0,0,0,0,0,0,0,0,0,0,0,0,0,0,0,0,0,0,0
2005-07-25 00:00:00.000,Kitzbuhel Austria ATP World Tour,CLAY,2,Nicolas Lapentti,Agustin Calleri,Nicolas Lapentti,6-4; 3-0 RET,R64,60,2,2,29,40,24,29,5,11,0,0,7,29,40,2,1,26,47,17,26,8,21,3,5,6,25,47
2005-07-25 00:00:00.000,Kitzbuhel Austria ATP World Tour,CLAY,2,Oliver Marach,Tomas Zib,Oliver Marach,3-6; 7-5; 6-2,R64,153,11,4,58,97,42,58,18,39,7,10,14,60,97,4,3,54,100,35,54,20,46,4,9,15,55,100
2005-07-25 00:00:00.000,Kitzbuhel Austria ATP World Tour,CLAY,2,Fernando Gonzalez,N/A Bye,Fernando Gonzalez,,R64,0,0,0,0,0,0,0,0,0,0,0,0,0,0,0,0,0,0,0,0,0,0,0,0,0,0,0
2005-07-25 00:00:00.000,Kitzbuhel Austria ATP World Tour,CLAY,2,Olivier Rochus,N/A Bye,Olivier Rochus,,R64,0,0,0,0,0,0,0,0,0,0,0,0,0,0,0,0,0,0,0,0,0,0,0,0,0,0,0
2005-07-25 00:00:00.000,Kitzbuhel Austria ATP World Tour,CLAY,2,Fernando Verdasco,Andreas Seppi,Fernando Verdasco,6-2; 6-4,R64,75,4,0,41,59,30,41,13,18,7,7,9,43,59,2,2,27,54,19,27,14,27,3,6,9,33,54
2005-07-25 00:00:00.000,Kitzbuhel Austria ATP World Tour,CLAY,2,Dusan Vemic,Markus Hipfl,Dusan Vemic,6-3; 1-6; 6-3,R64,110,8,3,49,82,36,49,14,33,6,10,13,50,82,3,4,53,84,32,53,15,31,10,14,12,47,84
2005-07-25 00:00:00.000,Kitzbuhel Austria ATP World Tour,CLAY,2,Jurgen Melzer,N/A Bye,Jurgen Melzer,,R64,0,0,0,0,0,0,0,0,0,0,0,0,0,0,0,0,0,0,0,0,0,0,0,0,0,0,0
2005-07-25 00:00:00.000,Kitzbuhel Austria ATP World Tour,CLAY,2,Victor Hanescu,N/A Bye,Victor Hanescu,,R64,0,0,0,0,0,0,0,0,0,0,0,0,0,0,0,0,0,0,0,0,0,0,0,0,0,0,0
2005-07-25 00:00:00.000,Kitzbuhel Austria ATP World Tour,CLAY,2,Tomas Behrend,Santiago Ventura,Tomas Behrend,6-4; 6-2,R64,74,2,4,42,64,27,42,10,22,6,9,9,37,64,0,2,30,54,14,30,9,24,4,10,9,23,54
2005-07-25 00:00:00.000,Kitzbuhel Austria ATP World Tour,CLAY,2,Irakli Labadze,Ruben Ramirez Hidalgo,Irakli Labadze,6-3; 6-3,R64,88,7,2,40,49,27,40,5,9,1,3,9,32,49,1,4,36,69,19,36,14,33,7,12,9,33,69
2005-07-25 00:00:00.000,Kitzbuhel Austria ATP World Tour,CLAY,2,Mariano Puerta,N/A Bye,Mariano Puerta,,R64,0,0,0,0,0,0,0,0,0,0,0,0,0,0,0,0,0,0,0,0,0,0,0,0,0,0,0
2005-07-25 00:00:00.000,Kitzbuhel Austria ATP World Tour,CLAY,2,Mariano Zabaleta,Nikolay Davydenko,Mariano Zabaleta,6-4; 7-6(5),R32,121,6,7,49,104,37,49,24,55,13,16,11,61,104,2,1,52,77,30,52,14,25,10,14,11,44,77
2005-07-25 00:00:00.000,Kitzbuhel Austria ATP World Tour,CLAY,2,Nicolas Almagro,Igor Andreev,Nicolas Almagro,6-3; 6-2,R32,66,2,2,35,52,24,35,13,17,1,1,9,37,52,1,1,24,46,14,24,11,22,1,4,8,25,46
2005-07-25 00:00:00.000,Kitzbuhel Austria ATP World Tour,CLAY,2,Florian Mayer,Jose Acasuso,Florian Mayer,6-3; 6-4,R32,66,5,2,41,61,32,41,8,20,4,6,10,40,61,0,3,27,55,15,27,15,28,5,9,9,30,55
2005-07-25 00:00:00.000,Kitzbuhel Austria ATP World Tour,CLAY,2,Feliciano Lopez,Alessio Di Mauro,Feliciano Lopez,7-6(4); 6-4,R32,76,9,2,46,69,37,46,12,23,1,2,11,49,69,6,4,53,79,40,53,7,26,2,4,11,47,79
2005-07-25 00:00:00.000,Kitzbuhel Austria ATP World Tour,CLAY,2,Gaston Gaudio,Philipp Kohlschreiber,Gaston Gaudio,7-5; 6-3,R32,98,2,1,34,54,27,34,9,20,0,2,10,36,54,9,4,51,84,32,51,11,33,8,13,11,43,84
2005-07-25 00:00:00.000,Kitzbuhel Austria ATP World Tour,CLAY,2,Robin Vik,Paul-Henri Mathieu,Robin Vik,7-5; 1-0 RET,R32,58,2,0,25,36,17,25,5,11,3,4,6,22,36,1,5,17,43,13,17,10,26,1,4,7,23,43
2005-07-25 00:00:00.000,Kitzbuhel Austria ATP World Tour,CLAY,2,Andrei Pavel,Rainer Schuettler,Andrei Pavel,6-4; 3-6; 7-6(4),R32,151,4,3,69,108,45,69,20,39,11,15,15,65,108,8,4,63,119,43,63,24,56,7,11,16,67,119
2005-07-25 00:00:00.000,Kitzbuhel Austria ATP World Tour,CLAY,2,Mikhail Youzhny,Ivo Minar,Mikhail Youzhny,6-0; 7-5,R32,60,6,4,21,52,16,21,22,31,1,2,9,38,52,3,4,30,61,17,30,13,31,3,8,9,30,61
2005-07-25 00:00:00.000,Kitzbuhel Austria ATP World Tour,CLAY,2,Nicolas Massu,Daniel Koellerer,Nicolas Massu,7-6(5); 7-5,R32,133,4,2,45,83,31,45,18,38,2,5,12,49,83,3,0,64,78,40,64,7,14,7,11,12,47,78
2005-07-25 00:00:00.000,Kitzbuhel Austria ATP World Tour,CLAY,2,Stefan Koubek,Christophe Rochus,Stefan Koubek,4-6; 6-4; 5-4 RET,R32,139,4,6,65,125,40,65,32,60,9,13,15,72,125,3,3,47,89,32,47,21,42,6,10,14,53,89
2005-07-25 00:00:00.000,Kitzbuhel Austria ATP World Tour,CLAY,2,Nicolas Lapentti,Luis Horna,Nicolas Lapentti,6-4; 6-1,R32,60,2,0,32,40,27,32,5,8,0,0,8,32,40,2,4,33,57,20,33,10,24,7,11,9,30,57
2005-07-25 00:00:00.000,Kitzbuhel Austria ATP World Tour,CLAY,2,Fernando Gonzalez,Oliver Marach,Fernando Gonzalez,6-3; 6-4,R32,69,6,3,30,53,26,30,14,23,0,0,10,40,53,9,1,36,55,24,36,10,19,5,7,9,34,55
2005-07-25 00:00:00.000,Kitzbuhel Austria ATP World Tour,CLAY,2,Fernando Verdasco,Olivier Rochus,Fernando Verdasco,7-5; 6-3,R32,83,6,0,39,53,31,39,12,14,1,1,10,43,53,0,3,43,72,32,43,11,29,4,7,11,43,72
2005-07-25 00:00:00.000,Kitzbuhel Austria ATP World Tour,CLAY,2,Jurgen Melzer,Dusan Vemic,Jurgen Melzer,6-2; 3-6; 6-3,R32,101,5,1,49,74,38,49,11,25,2,5,13,49,74,5,2,43,73,25,43,15,30,3,8,13,40,73
2005-07-25 00:00:00.000,Kitzbuhel Austria ATP World Tour,CLAY,2,Victor Hanescu,Tomas Behrend,Victor Hanescu,6-0; 6-1,R32,50,5,2,26,47,21,26,13,21,1,1,7,34,47,1,2,22,36,9,22,5,14,4,9,6,14,36
2005-07-25 00:00:00.000,Kitzbuhel Austria ATP World Tour,CLAY,2,Mariano Puerta,Irakli Labadze,Mariano Puerta,6-3; 6-4,R32,73,4,1,43,55,34,43,9,12,1,1,10,43,55,5,4,45,65,32,45,8,20,5,7,9,40,65
2005-07-25 00:00:00.000,Kitzbuhel Austria ATP World Tour,CLAY,2,Mariano Zabaleta,Nicolas Almagro,Mariano Zabaleta,6-3; 4-6; 6-3,R16,107,6,3,47,81,38,47,19,34,2,3,14,57,81,10,2,66,96,49,66,9,30,3,6,14,58,96
2005-07-25 00:00:00.000,Kitzbuhel Austria ATP World Tour,CLAY,2,Feliciano Lopez,Florian Mayer,Feliciano Lopez,7-5; 6-1,R16,66,4,1,33,58,26,33,16,25,4,5,10,42,58,1,3,29,63,18,29,15,34,5,9,9,33,63
2005-07-25 00:00:00.000,Kitzbuhel Austria ATP World Tour,CLAY,2,Gaston Gaudio,Robin Vik,Gaston Gaudio,6-4; 6-2,R16,83,3,2,52,67,36,52,6,15,6,7,9,42,67,2,3,31,57,19,31,9,26,4,8,9,28,57
2005-07-25 00:00:00.000,Kitzbuhel Austria ATP World Tour,CLAY,2,Mikhail Youzhny,Andrei Pavel,Mikhail Youzhny,6-2; 1-0 RET,R16,47,2,4,9,31,9,9,13,22,1,1,4,22,31,0,2,14,28,9,14,4,14,0,3,5,13,28
2005-07-25 00:00:00.000,Kitzbuhel Austria ATP World Tour,CLAY,2,Nicolas Massu,Stefan Koubek,Nicolas Massu,7-5; 6-2,R16,198,4,0,32,61,27,32,18,29,2,2,10,45,61,3,2,39,62,24,39,10,23,2,5,10,34,62
2005-07-25 00:00:00.000,Kitzbuhel Austria ATP World Tour,CLAY,2,Nicolas Lapentti,Fernando Gonzalez,Nicolas Lapentti,4-6; 7-5; 6-3,R16,146,4,2,61,95,48,61,19,34,9,11,16,67,95,5,9,53,108,34,53,32,55,10,13,15,66,108
2005-07-25 00:00:00.000,Kitzbuhel Austria ATP World Tour,CLAY,2,Fernando Verdasco,Jurgen Melzer,Fernando Verdasco,1-6; 6-2; 6-1,R16,128,8,4,48,76,33,48,15,28,7,9,11,48,76,2,2,35,70,22,35,19,35,3,7,11,41,70
2005-07-25 00:00:00.000,Kitzbuhel Austria ATP World Tour,CLAY,2,Victor Hanescu,Mariano Puerta,Victor Hanescu,6-4; 6-3,R16,74,13,0,41,52,34,41,6,11,3,3,9,40,52,6,4,30,57,22,30,14,27,4,7,10,36,57
2005-07-25 00:00:00.000,Kitzbuhel Austria ATP World Tour,CLAY,2,Mariano Zabaleta,Feliciano Lopez,Mariano Zabaleta,6-4; 6-2,Q,71,5,5,30,52,25,30,13,22,4,4,9,38,52,3,3,37,65,24,37,12,28,5,8,9,36,65
2005-07-25 00:00:00.000,Kitzbuhel Austria ATP World Tour,CLAY,2,Gaston Gaudio,Mikhail Youzhny,Gaston Gaudio,6-4; 4-6; 6-4,Q,124,0,3,59,88,44,59,14,29,4,7,15,58,88,2,3,70,100,43,70,13,30,5,9,15,56,100
2005-07-25 00:00:00.000,Kitzbuhel Austria ATP World Tour,CLAY,2,Nicolas Massu,Nicolas Lapentti,Nicolas Massu,6-4; 6-7(0); 6-2,Q,201,3,6,45,107,34,45,30,62,7,11,15,64,107,4,4,52,101,32,52,24,49,7,14,15,56,101
2005-07-25 00:00:00.000,Kitzbuhel Austria ATP World Tour,CLAY,2,Fernando Verdasco,Victor Hanescu,Fernando Verdasco,6-3; 6-3,Q,64,1,1,39,52,32,39,6,13,5,6,9,38,52,2,0,34,50,25,34,2,16,1,5,9,27,50
2005-07-25 00:00:00.000,Kitzbuhel Austria ATP World Tour,CLAY,2,Gaston Gaudio,Mariano Zabaleta,Gaston Gaudio,6-1; 6-1,S,80,1,2,26,38,20,26,7,12,1,2,7,27,38,1,2,30,55,14,30,8,25,5,11,7,22,55
2005-07-25 00:00:00.000,Kitzbuhel Austria ATP World Tour,CLAY,2,Fernando Verdasco,Nicolas Massu,Fernando Verdasco,3-6; 6-3; 7-5,S,141,6,4,74,98,50,74,12,24,4,7,15,62,98,4,3,57,89,34,57,18,32,3,7,15,52,89
2005-07-25 00:00:00.000,Kitzbuhel Austria ATP World Tour,CLAY,2,Gaston Gaudio,Fernando Verdasco,Gaston Gaudio,2-6; 6-2; 6-4; 6-4,F,161,2,5,83,123,55,83,19,40,9,15,18,74,123,7,5,77,119,47,77,16,42,6,14,18,63,119
2005-07-25 00:00:00.000,Los Angeles CA; U.S.A. ATP World Tour,HARD,2,Andre Agassi,Jean-Rene Lisnard,Andre Agassi,6-1; 6-0,R32,47,3,3,27,47,19,27,13,20,4,4,7,32,47,1,5,12,32,5,12,6,20,2,7,6,11,32
2005-07-25 00:00:00.000,Los Angeles CA; U.S.A. ATP World Tour,HARD,2,Kevin Kim,Kenneth Carlsen,Kevin Kim,7-6(2); 6-7(3); 6-4,R32,160,6,4,60,108,46,60,25,48,5,9,17,71,108,9,3,57,105,46,57,19,48,7,12,17,65,105
2005-07-25 00:00:00.000,Los Angeles CA; U.S.A. ATP World Tour,HARD,2,Paul Goldstein,Cyril Saulnier,Paul Goldstein,6-4; 6-4,R32,70,1,1,35,59,25,35,16,24,0,1,10,41,59,10,1,37,52,24,37,9,15,1,4,10,33,52
2005-07-25 00:00:00.000,Los Angeles CA; U.S.A. ATP World Tour,HARD,2,Paradorn Srichaphan,Mario Ancic,Paradorn Srichaphan,7-6(6); 6-7(4); 6-2,R32,177,10,2,56,99,42,56,26,43,1,2,16,68,99,11,8,67,130,45,67,33,63,6,9,16,78,130
2005-07-25 00:00:00.000,Los Angeles CA; U.S.A. ATP World Tour,HARD,2,Tommy Haas,Ivo Karlovic,Tommy Haas,6-4; 6-4,R32,75,13,3,36,52,29,36,11,16,0,0,10,40,52,14,4,49,76,37,49,10,27,6,8,10,47,76
2005-07-25 00:00:00.000,Los Angeles CA; U.S.A. ATP World Tour,HARD,2,Xavier Malisse,Hyung-Taik Lee,Xavier Malisse,6-3; 6-4,R32,73,8,2,36,61,27,36,17,25,6,7,10,44,61,0,0,25,50,13,25,15,25,3,6,9,28,50
2005-07-25 00:00:00.000,Los Angeles CA; U.S.A. ATP World Tour,HARD,2,Juan Ignacio Chela,Marcos Baghdatis,Juan Ignacio Chela,6-7(7); 6-3; 6-4,R32,128,1,3,48,102,34,48,26,54,7,13,16,60,102,4,2,49,94,31,49,15,45,4,12,15,46,94
2005-07-25 00:00:00.000,Los Angeles CA; U.S.A. ATP World Tour,HARD,2,Dmitry Tursunov,Noam Okun,Dmitry Tursunov,6-1; 6-2,R32,53,5,2,16,46,15,16,19,30,3,3,8,34,46,6,2,27,48,19,27,4,21,5,9,7,23,48
2005-07-25 00:00:00.000,Los Angeles CA; U.S.A. ATP World Tour,HARD,2,Zack Fleishman,Vincent Spadea,Zack Fleishman,4-6; 6-2; 6-4,R32,101,6,2,55,88,37,55,22,33,8,10,14,59,88,3,0,42,79,29,42,22,37,3,7,14,51,79
2005-07-25 00:00:00.000,Los Angeles CA; U.S.A. ATP World Tour,HARD,2,Gilles Muller,Sebastien De Chaunac,Gilles Muller,2-6; 6-3; 7-6(6),R32,132,11,3,53,97,40,53,28,44,5,7,15,68,97,13,3,59,95,47,59,19,36,2,3,14,66,95
2005-07-25 00:00:00.000,Los Angeles CA; U.S.A. ATP World Tour,HARD,2,Robby Ginepri,Wayne Arthurs,Robby Ginepri,6-4; 6-4,R32,59,12,0,36,56,29,36,15,20,2,2,10,44,56,6,5,31,55,25,31,12,24,2,4,10,37,55
2005-07-25 00:00:00.000,Los Angeles CA; U.S.A. ATP World Tour,HARD,2,James Blake,Nicolas Kiefer,James Blake,3-2 RET,R32,21,0,0,9,15,8,9,2,6,0,0,2,10,15,0,2,8,16,4,8,5,8,0,1,3,9,16
2005-07-25 00:00:00.000,Los Angeles CA; U.S.A. ATP World Tour,HARD,2,Ricardo Mello,Sebastien Grosjean,Ricardo Mello,1-6; 6-2; 6-3,R32,113,2,1,53,69,39,53,8,16,1,3,12,47,69,10,1,46,90,34,46,20,44,5,8,12,54,90
2005-07-25 00:00:00.000,Los Angeles CA; U.S.A. ATP World Tour,HARD,2,Amir Hadad,Cecil Mamiit,Amir Hadad,2-6; 6-3; 6-3,R32,103,2,1,45,79,34,45,18,34,10,12,13,52,79,6,3,55,84,39,55,15,29,8,11,13,54,84
2005-07-25 00:00:00.000,Los Angeles CA; U.S.A. ATP World Tour,HARD,2,Jan Hernych,Jonas Bjorkman,Jan Hernych,6-4; 6-4,R32,89,5,5,49,76,34,49,13,27,5,6,10,47,76,3,3,27,61,20,27,17,34,2,5,10,37,61
2005-07-25 00:00:00.000,Los Angeles CA; U.S.A. ATP World Tour,HARD,2,Dominik Hrbaty,Karol Beck,Dominik Hrbaty,6-4; 6-1,R32,62,2,4,38,55,24,38,10,17,4,6,9,34,55,0,4,23,47,12,23,8,24,1,6,8,20,47
2005-07-25 00:00:00.000,Los Angeles CA; U.S.A. ATP World Tour,HARD,2,Andre Agassi,Kevin Kim,Andre Agassi,6-2; 7-5,R16,75,8,0,29,55,25,29,16,26,0,0,10,41,55,4,1,51,73,33,51,8,22,4,7,10,41,73
2005-07-25 00:00:00.000,Los Angeles CA; U.S.A. ATP World Tour,HARD,2,Paradorn Srichaphan,Paul Goldstein,Paradorn Srichaphan,6-1; 6-4,R16,67,7,2,28,52,27,28,11,24,4,4,9,38,52,1,4,41,55,27,41,3,14,4,7,8,30,55
2005-07-25 00:00:00.000,Los Angeles CA; U.S.A. ATP World Tour,HARD,2,Xavier Malisse,Tommy Haas,Xavier Malisse,1-6; 6-3; 6-4,R16,95,18,2,42,73,36,42,14,31,2,4,13,50,73,2,2,41,77,32,41,19,36,4,6,13,51,77
2005-07-25 00:00:00.000,Los Angeles CA; U.S.A. ATP World Tour,HARD,2,Juan Ignacio Chela,Dmitry Tursunov,Juan Ignacio Chela,3-6; 6-4; 6-2,R16,118,6,1,46,78,31,46,15,32,2,6,13,46,78,8,9,48,103,35,48,19,55,12,18,14,54,103
2005-07-25 00:00:00.000,Los Angeles CA; U.S.A. ATP World Tour,HARD,2,Gilles Muller,Zack Fleishman,Gilles Muller,6-3; 7-5,R16,67,7,1,38,59,28,38,18,21,1,1,11,46,59,5,1,33,53,23,33,14,20,0,2,10,37,53
2005-07-25 00:00:00.000,Los Angeles CA; U.S.A. ATP World Tour,HARD,2,Robby Ginepri,James Blake,Robby Ginepri,6-3; 7-6(2),R16,80,7,0,47,66,37,47,12,19,1,1,11,49,66,1,1,39,70,29,39,16,31,6,7,10,45,70
2005-07-25 00:00:00.000,Los Angeles CA; U.S.A. ATP World Tour,HARD,2,Ricardo Mello,Amir Hadad,Ricardo Mello,6-3; 6-1,R16,66,0,1,30,51,24,30,9,21,3,4,8,33,51,6,2,40,70,22,40,11,30,10,15,8,33,70
2005-07-25 00:00:00.000,Los Angeles CA; U.S.A. ATP World Tour,HARD,2,Dominik Hrbaty,Jan Hernych,Dominik Hrbaty,6-4; 6-2,R16,62,1,6,35,49,27,35,5,14,2,4,9,32,49,0,5,27,52,15,27,8,25,1,6,9,23,52
2005-07-25 00:00:00.000,Los Angeles CA; U.S.A. ATP World Tour,HARD,2,Andre Agassi,Paradorn Srichaphan,Andre Agassi,6-2; 4-6; 6-4,Q,112,4,4,47,75,36,47,16,28,1,3,14,52,75,6,4,62,105,42,62,18,43,8,12,14,60,105
2005-07-25 00:00:00.000,Los Angeles CA; U.S.A. ATP World Tour,HARD,2,Juan Ignacio Chela,Xavier Malisse,Juan Ignacio Chela,6-4; 7-6(3),Q,83,3,4,42,68,34,42,15,26,5,6,11,49,68,7,1,39,73,31,39,17,34,4,6,11,48,73
2005-07-25 00:00:00.000,Los Angeles CA; U.S.A. ATP World Tour,HARD,2,Gilles Muller,Robby Ginepri,Gilles Muller,7-6(5); 7-5,Q,88,13,1,49,74,42,49,13,25,3,4,12,55,74,4,5,46,74,35,46,15,28,5,7,12,50,74
2005-07-25 00:00:00.000,Los Angeles CA; U.S.A. ATP World Tour,HARD,2,Dominik Hrbaty,Ricardo Mello,Dominik Hrbaty,4-6; 7-6(9); 6-2,Q,135,2,9,66,108,44,66,22,42,7,11,15,66,108,1,0,69,102,42,69,17,33,4,9,15,59,102
2005-07-25 00:00:00.000,Los Angeles CA; U.S.A. ATP World Tour,HARD,2,Andre Agassi,Juan Ignacio Chela,Andre Agassi,6-4; 6-2,S,70,5,1,34,53,27,34,11,19,0,0,9,38,53,6,2,39,57,27,39,8,18,4,7,9,35,57
2005-07-25 00:00:00.000,Los Angeles CA; U.S.A. ATP World Tour,HARD,2,Gilles Muller,Dominik Hrbaty,Gilles Muller,4-6; 7-6(4); 6-1,S,107,12,6,64,100,51,64,16,36,7,9,15,67,100,3,1,54,79,35,54,15,25,3,6,14,50,79
2005-07-25 00:00:00.000,Los Angeles CA; U.S.A. ATP World Tour,HARD,2,Andre Agassi,Gilles Muller,Andre Agassi,6-4; 7-5,F,88,6,2,46,66,38,46,11,20,2,2,11,49,66,10,1,42,77,28,42,20,35,6,8,11,48,77
2005-07-25 00:00:00.000,Umag Croatia ATP World Tour,CLAY,2,Lukas Dlouhy,Alberto Martin,Lukas Dlouhy,7-5; 6-3,R32,92,2,5,55,76,37,55,7,21,2,5,11,44,76,0,5,37,62,22,37,10,25,3,8,10,32,62
2005-07-25 00:00:00.000,Umag Croatia ATP World Tour,CLAY,2,Ilija Bozoljac,Francesco Aldi,Ilija Bozoljac,6-3; 6-3,R32,64,12,2,27,55,23,27,13,28,5,6,9,36,55,1,2,37,49,22,37,5,12,2,6,9,27,49
2005-07-25 00:00:00.000,Umag Croatia ATP World Tour,CLAY,2,Albert Portas,Jiri Vanek,Albert Portas,6-1; 6-0,R32,40,6,3,22,38,18,22,11,16,1,1,7,29,38,1,0,22,31,9,22,0,9,2,7,6,9,31
2005-07-25 00:00:00.000,Umag Croatia ATP World Tour,CLAY,2,Jiri Novak,Albert Montanes,Jiri Novak,6-3; 6-3,R32,61,6,0,33,48,28,33,8,15,0,0,9,36,48,3,3,38,61,26,38,8,23,7,10,9,34,61
2005-07-25 00:00:00.000,Umag Croatia ATP World Tour,CLAY,2,David Ferrer,Potito Starace,David Ferrer,6-3; 3-6; 6-2,R32,113,1,3,54,81,35,54,14,27,3,6,13,49,81,0,1,63,89,38,63,10,26,8,13,13,48,89
2005-07-25 00:00:00.000,Umag Croatia ATP World Tour,CLAY,2,Fernando Vicente,Victor Ionita,Fernando Vicente,6-2; 6-2,R32,65,1,0,27,51,19,27,11,24,3,5,8,30,51,1,4,22,41,8,22,6,19,3,9,8,14,41
2005-07-25 00:00:00.000,Umag Croatia ATP World Tour,CLAY,2,Kristof Vliegen,Marin Cilic,Kristof Vliegen,7-5; 6-2,R32,95,2,0,36,63,25,36,17,27,1,2,10,42,63,2,2,32,63,18,32,14,31,1,5,10,32,63
2005-07-25 00:00:00.000,Umag Croatia ATP World Tour,CLAY,2,Carlos Moya,Bohdan Ulihrach,Carlos Moya,6-2 RET,R32,46,0,2,13,31,9,13,12,18,1,1,4,21,31,0,2,24,41,13,24,8,17,5,7,4,21,41
2005-07-25 00:00:00.000,Umag Croatia ATP World Tour,CLAY,2,Filippo Volandri,Sasa Tuksar,Filippo Volandri,6-2; 6-1,R32,53,2,2,38,45,26,38,3,7,1,2,7,29,45,1,1,23,41,9,23,7,18,1,7,8,16,41
2005-07-25 00:00:00.000,Umag Croatia ATP World Tour,CLAY,2,Guillermo Garcia-Lopez,Oscar Hernandez,Guillermo Garcia-Lopez,6-2; 6-2,R32,54,1,3,23,44,16,23,14,21,1,2,8,30,44,1,1,36,51,16,36,7,15,2,7,8,23,51
2005-07-25 00:00:00.000,Umag Croatia ATP World Tour,CLAY,2,Janko Tipsarevic,Dick Norman,Janko Tipsarevic,6-0; 6-0,R32,45,2,2,16,41,11,16,17,25,5,5,6,28,41,3,9,13,32,6,13,1,19,2,8,6,7,32
2005-07-25 00:00:00.000,Umag Croatia ATP World Tour,CLAY,2,Tommy Robredo,Gustavo Kuerten,Tommy Robredo,6-4; 6-4,R32,89,3,5,36,61,26,36,10,25,4,7,10,36,61,1,5,34,70,23,34,13,36,1,6,10,36,70
2005-07-25 00:00:00.000,Umag Croatia ATP World Tour,CLAY,2,Juan Carlos Ferrero,Jarkko Nieminen,Juan Carlos Ferrero,6-0; 3-1 RET,R32,40,1,2,23,33,19,23,3,10,0,0,5,22,33,0,0,23,31,7,23,3,8,3,7,5,10,31
2005-07-25 00:00:00.000,Umag Croatia ATP World Tour,CLAY,2,Novak Djokovic,Alex Calatrava,Novak Djokovic,6-1; 6-4,R32,63,1,0,36,52,26,36,13,16,4,4,9,39,52,1,1,25,41,17,25,7,16,1,4,8,24,41
2005-07-25 00:00:00.000,Umag Croatia ATP World Tour,CLAY,2,Felix Mantilla,Alan Mackin,Felix Mantilla,6-2; 6-1,R32,59,2,0,24,45,16,24,12,21,2,4,7,28,45,3,4,22,48,12,22,4,26,2,9,8,16,48
2005-07-25 00:00:00.000,Umag Croatia ATP World Tour,CLAY,2,Guillermo Coria,Zeljko Krajan,Guillermo Coria,5-7; 6-3; 6-4,R32,159,8,10,46,92,35,46,14,46,3,9,16,49,92,1,2,62,110,38,62,20,48,11,18,15,58,110
2005-07-25 00:00:00.000,Umag Croatia ATP World Tour,CLAY,2,Lukas Dlouhy,Ilija Bozoljac,Lukas Dlouhy,6-3; 6-2,R16,56,2,3,27,41,21,27,7,14,1,3,8,28,41,2,4,21,52,10,21,11,31,2,8,9,21,52
2005-07-25 00:00:00.000,Umag Croatia ATP World Tour,CLAY,2,Jiri Novak,Albert Portas,Jiri Novak,6-0; 4-6; 7-5,R16,113,7,3,54,86,43,54,14,32,6,9,14,57,86,6,13,40,84,31,40,16,44,6,12,14,47,84
2005-07-25 00:00:00.000,Umag Croatia ATP World Tour,CLAY,2,David Ferrer,Fernando Vicente,David Ferrer,6-2; 6-3,R16,79,1,1,43,57,33,43,9,14,3,3,9,42,57,3,0,32,62,21,32,13,30,7,10,8,34,62
2005-07-25 00:00:00.000,Umag Croatia ATP World Tour,CLAY,2,Carlos Moya,Kristof Vliegen,Carlos Moya,6-3; 6-1,R16,68,1,2,25,47,19,25,13,22,2,3,8,32,47,0,1,34,54,15,34,10,20,4,9,8,25,54
2005-07-25 00:00:00.000,Umag Croatia ATP World Tour,CLAY,2,Filippo Volandri,Guillermo Garcia-Lopez,Filippo Volandri,6-1; 6-1,R16,66,1,2,23,40,16,23,8,17,3,5,7,24,40,0,9,33,57,15,33,6,24,6,13,7,21,57
2005-07-25 00:00:00.000,Umag Croatia ATP World Tour,CLAY,2,Tommy Robredo,Janko Tipsarevic,Tommy Robredo,6-3; 6-1,R16,68,2,1,17,45,13,17,20,28,3,3,8,33,45,3,4,18,52,13,18,14,34,2,6,8,27,52
2005-07-25 00:00:00.000,Umag Croatia ATP World Tour,CLAY,2,Juan Carlos Ferrero,Novak Djokovic,Juan Carlos Ferrero,6-4; 6-2,R16,78,0,2,43,55,30,43,6,12,2,4,9,36,55,1,6,37,62,22,37,8,25,10,15,9,30,62
2005-07-25 00:00:00.000,Umag Croatia ATP World Tour,CLAY,2,Guillermo Coria,Felix Mantilla,Guillermo Coria,3-6; 6-2; 6-1,R16,128,3,3,55,80,37,55,15,25,4,6,12,52,80,0,4,42,91,26,42,21,49,5,10,12,47,91
2005-07-25 00:00:00.000,Umag Croatia ATP World Tour,CLAY,2,Jiri Novak,Lukas Dlouhy,Jiri Novak,6-0; 6-3,Q,54,2,0,42,55,30,42,6,13,2,3,8,36,55,0,8,24,44,16,24,3,20,5,10,7,19,44
2005-07-25 00:00:00.000,Umag Croatia ATP World Tour,CLAY,2,Carlos Moya,David Ferrer,Carlos Moya,6-4; 0-6; 6-3,Q,111,3,5,44,91,31,44,20,47,7,11,13,51,91,0,2,47,73,30,47,14,26,5,8,12,44,73
2005-07-25 00:00:00.000,Umag Croatia ATP World Tour,CLAY,2,Filippo Volandri,Tommy Robredo,Filippo Volandri,3-6; 6-3; 6-3,Q,117,0,3,62,79,39,62,7,17,5,9,13,46,79,3,2,51,86,32,51,14,35,6,12,14,46,86
2005-07-25 00:00:00.000,Umag Croatia ATP World Tour,CLAY,2,Guillermo Coria,Juan Carlos Ferrero,Guillermo Coria,6-3; 6-0,Q,86,3,2,28,46,22,28,10,18,1,1,7,32,46,1,2,40,64,22,40,7,24,4,9,8,29,64
2005-07-25 00:00:00.000,Umag Croatia ATP World Tour,CLAY,2,Carlos Moya,Jiri Novak,Carlos Moya,6-4; 6-4,S,87,3,4,41,67,27,41,13,26,3,5,10,40,67,3,5,58,80,34,58,8,22,8,12,10,42,80
2005-07-25 00:00:00.000,Umag Croatia ATP World Tour,CLAY,2,Guillermo Coria,Filippo Volandri,Guillermo Coria,4-6; 6-3; 6-2,S,118,4,4,46,85,30,46,26,39,10,12,13,56,85,0,1,66,83,41,66,6,17,2,7,14,47,83
2005-07-25 00:00:00.000,Umag Croatia ATP World Tour,CLAY,2,Guillermo Coria,Carlos Moya,Guillermo Coria,6-2; 4-6; 6-2,F,130,0,9,54,88,37,54,19,34,4,6,13,56,88,2,3,38,79,26,38,19,41,4,9,13,45,79
2005-08-01 00:00:00.000,Sopot Poland ATP World Tour,CLAY,2,Jarkko Nieminen,Mariano Puerta,Jarkko Nieminen,6-4; 7-6(1),R32,104,4,2,43,69,31,43,16,26,3,4,11,47,69,3,0,61,81,37,61,10,20,6,8,11,47,81
2005-08-01 00:00:00.000,Sopot Poland ATP World Tour,CLAY,2,Nicolas Almagro,Albert Portas,Nicolas Almagro,7-6(2); 3-6; 6-4,R32,146,13,3,70,123,50,70,22,53,8,12,15,72,123,9,4,67,119,49,67,23,52,9,13,16,72,119
2005-08-01 00:00:00.000,Sopot Poland ATP World Tour,CLAY,2,Florian Mayer,Mariano Zabaleta,Florian Mayer,6-4; 4-6; 6-1,R32,97,9,1,54,77,40,54,13,23,1,3,14,53,77,2,2,52,81,30,52,17,29,4,8,13,47,81
2005-08-01 00:00:00.000,Sopot Poland ATP World Tour,CLAY,2,Filippo Volandri,Lukasz Kubot,Filippo Volandri,6-3; 6-1,R32,71,1,0,40,51,31,40,6,11,2,2,8,37,51,0,1,44,53,21,44,5,9,1,5,8,26,53
2005-08-01 00:00:00.000,Sopot Poland ATP World Tour,CLAY,2,Guillermo Coria,Gustavo Kuerten,Guillermo Coria,6-3; 4-0 RET,R32,45,2,1,22,33,16,22,6,11,1,2,6,22,33,0,3,26,38,11,26,4,12,3,8,7,15,38
2005-08-01 00:00:00.000,Sopot Poland ATP World Tour,CLAY,2,Felix Mantilla,Marcin Matkowski,Felix Mantilla,6-0; 6-7(2); 6-1,R32,115,3,0,63,86,38,63,11,23,6,10,13,49,86,5,8,37,92,23,37,18,55,7,16,12,41,92
2005-08-01 00:00:00.000,Sopot Poland ATP World Tour,CLAY,2,Razvan Sabau,Oscar Hernandez,Razvan Sabau,2-6; 6-1; 6-4,R32,110,0,3,50,68,37,50,9,18,1,3,13,46,68,6,6,37,77,27,37,18,40,4,7,12,45,77
2005-08-01 00:00:00.000,Sopot Poland ATP World Tour,CLAY,2,Igor Andreev,Guillermo Garcia-Lopez,Igor Andreev,6-2; 6-7(4); 6-2,R32,133,2,4,64,99,38,64,19,35,3,7,14,57,99,0,5,55,88,31,55,13,33,5,13,14,44,88
2005-08-01 00:00:00.000,Sopot Poland ATP World Tour,CLAY,2,Jose Acasuso,Jiri Vanek,Jose Acasuso,7-5; 4-6; 7-5,R32,138,9,2,54,87,42,54,17,33,1,5,17,59,87,5,3,75,116,50,75,15,41,6,11,17,65,116
2005-08-01 00:00:00.000,Sopot Poland ATP World Tour,CLAY,2,Adam Chadaj,Alessio Di Mauro,Adam Chadaj,6-3; 5-7; 6-1,R32,121,1,5,53,89,37,53,16,36,6,9,14,53,89,6,2,50,79,30,50,13,29,6,12,14,43,79
2005-08-01 00:00:00.000,Sopot Poland ATP World Tour,CLAY,2,Potito Starace,Stefan Koubek,Potito Starace,6-4; 6-2,R32,73,1,2,54,60,37,54,2,6,3,4,9,39,60,0,1,43,64,23,43,9,21,4,8,9,32,64
2005-08-01 00:00:00.000,Sopot Poland ATP World Tour,CLAY,2,Carlos Moya,Mariusz Fyrstenberg,Carlos Moya,6-7(5); 6-3; 7-5,R32,147,10,3,77,112,57,77,18,35,6,9,17,75,112,4,6,77,119,48,77,22,42,9,14,16,70,119
2005-08-01 00:00:00.000,Sopot Poland ATP World Tour,CLAY,2,Victor Hanescu,Albert Montanes,Victor Hanescu,7-6(3); 5-7; 6-3,R32,119,12,0,70,95,52,70,18,25,8,9,16,70,95,4,3,58,109,41,58,29,51,7,9,17,70,109
2005-08-01 00:00:00.000,Sopot Poland ATP World Tour,CLAY,2,Albert Costa,Philipp Kohlschreiber,Albert Costa,7-5; 6-3,R32,84,1,2,41,59,29,41,9,18,0,2,11,38,59,1,1,41,61,24,41,12,20,2,6,10,36,61
2005-08-01 00:00:00.000,Sopot Poland ATP World Tour,CLAY,2,Juan Monaco,Alan Mackin,Juan Monaco,6-3; 6-1,R32,79,5,0,24,41,19,24,12,17,1,2,8,31,41,0,4,37,67,21,37,11,30,10,15,8,32,67
2005-08-01 00:00:00.000,Sopot Poland ATP World Tour,CLAY,2,Gael Monfils,Juan Antonio Marin,Gael Monfils,6-0; 6-4,R32,85,1,3,26,53,15,26,11,27,3,6,8,26,53,0,0,17,53,7,17,13,36,4,11,8,20,53
2005-08-01 00:00:00.000,Sopot Poland ATP World Tour,CLAY,2,Jarkko Nieminen,Nicolas Almagro,Jarkko Nieminen,3-6; 6-4; 7-6(6),R16,118,2,1,57,87,42,57,15,30,2,5,15,57,87,9,4,54,103,39,54,26,49,5,8,16,65,103
2005-08-01 00:00:00.000,Sopot Poland ATP World Tour,CLAY,2,Florian Mayer,Filippo Volandri,Florian Mayer,6-3; 7-5,R16,71,2,1,34,60,24,34,13,26,0,3,11,37,60,0,1,48,62,24,48,8,14,5,10,10,32,62
2005-08-01 00:00:00.000,Sopot Poland ATP World Tour,CLAY,2,Guillermo Coria,Felix Mantilla,Guillermo Coria,3-6; 6-3; 6-3,R16,109,7,2,38,71,30,38,23,33,2,3,13,53,71,3,2,52,92,35,52,23,40,6,9,14,58,92
2005-08-01 00:00:00.000,Sopot Poland ATP World Tour,CLAY,2,Igor Andreev,Razvan Sabau,Igor Andreev,6-3; 5-1 RET,R16,59,3,0,28,43,22,28,10,15,3,3,7,32,43,2,3,28,52,15,28,10,24,4,8,8,25,52
2005-08-01 00:00:00.000,Sopot Poland ATP World Tour,CLAY,2,Jose Acasuso,Adam Chadaj,Jose Acasuso,6-3; 6-4,R16,85,6,2,39,69,26,39,16,30,2,4,10,42,69,2,4,47,67,26,47,9,20,3,7,9,35,67
2005-08-01 00:00:00.000,Sopot Poland ATP World Tour,CLAY,2,Potito Starace,Carlos Moya,Potito Starace,2-6; 7-6(0); 7-5,R16,126,1,0,73,101,51,73,13,28,6,10,16,64,101,9,2,67,99,45,67,17,32,4,7,16,62,99
2005-08-01 00:00:00.000,Sopot Poland ATP World Tour,CLAY,2,Victor Hanescu,Albert Costa,Victor Hanescu,6-3; 6-4,R16,89,4,0,39,55,29,39,10,16,1,2,10,39,55,3,1,42,64,24,42,12,22,5,8,9,36,64
2005-08-01 00:00:00.000,Sopot Poland ATP World Tour,CLAY,2,Gael Monfils,Juan Monaco,Gael Monfils,6-4; 7-6(5),R16,119,6,2,39,76,30,39,17,37,2,5,11,47,76,2,1,60,90,35,60,15,30,5,9,11,50,90
2005-08-01 00:00:00.000,Sopot Poland ATP World Tour,CLAY,2,Florian Mayer,Jarkko Nieminen,Florian Mayer,6-2; 6-2,Q,52,1,1,27,46,21,27,12,19,0,0,8,33,46,0,2,41,54,22,41,7,13,4,8,8,29,54
2005-08-01 00:00:00.000,Sopot Poland ATP World Tour,CLAY,2,Guillermo Coria,Igor Andreev,Guillermo Coria,6-4; 7-6(5),Q,105,4,2,52,79,35,52,15,27,4,6,11,50,79,0,0,40,64,24,40,14,24,2,5,11,38,64
2005-08-01 00:00:00.000,Sopot Poland ATP World Tour,CLAY,2,Potito Starace,Jose Acasuso,Potito Starace,4-6; 6-4; 6-4,Q,138,3,0,82,111,51,82,17,29,5,8,15,68,111,14,1,60,108,42,60,21,48,10,14,15,63,108
2005-08-01 00:00:00.000,Sopot Poland ATP World Tour,CLAY,2,Gael Monfils,Victor Hanescu,Gael Monfils,6-3; 6-3,Q,73,1,2,28,49,21,28,9,21,3,6,9,30,49,0,0,40,56,20,40,5,16,3,9,9,25,56
2005-08-01 00:00:00.000,Sopot Poland ATP World Tour,CLAY,2,Florian Mayer,Guillermo Coria,Florian Mayer,6-4; 5-7; 6-3,S,135,3,1,70,106,41,70,20,36,8,13,16,61,106,4,6,67,110,45,67,15,43,15,21,15,60,110
2005-08-01 00:00:00.000,Sopot Poland ATP World Tour,CLAY,2,Gael Monfils,Potito Starace,Gael Monfils,3-6; 7-5; 6-4,S,137,3,5,46,86,30,46,17,40,1,7,15,47,86,1,1,87,110,48,87,10,23,7,14,16,58,110
2005-08-01 00:00:00.000,Sopot Poland ATP World Tour,CLAY,2,Gael Monfils,Florian Mayer,Gael Monfils,7-6(6); 4-6; 7-5,F,127,9,2,59,101,44,59,22,42,4,8,17,66,101,4,2,70,110,49,70,20,40,0,4,17,69,110
2005-08-01 00:00:00.000,Washington DC; U.S.A. ATP World Tour,HARD,2,Andy Roddick,N/A Bye,Andy Roddick,,R64,0,0,0,0,0,0,0,0,0,0,0,0,0,0,0,0,0,0,0,0,0,0,0,0,0,0,0
2005-08-01 00:00:00.000,Washington DC; U.S.A. ATP World Tour,HARD,2,Giovanni Lapentti,Nicolas Mahut,Giovanni Lapentti,6-2; 6-3,R64,68,8,1,27,43,23,27,13,16,0,0,9,36,43,5,4,22,50,17,22,11,28,1,4,8,28,50
2005-08-01 00:00:00.000,Washington DC; U.S.A. ATP World Tour,HARD,2,Brian Baker,Ivo Heuberger,Brian Baker,6-2; 6-4,R64,83,1,3,41,59,29,41,10,18,1,1,9,39,59,10,4,34,64,23,34,15,30,8,11,9,38,64
2005-08-01 00:00:00.000,Washington DC; U.S.A. ATP World Tour,HARD,2,Juan Ignacio Chela,N/A Bye,Juan Ignacio Chela,,R64,0,0,0,0,0,0,0,0,0,0,0,0,0,0,0,0,0,0,0,0,0,0,0,0,0,0,0
2005-08-01 00:00:00.000,Washington DC; U.S.A. ATP World Tour,HARD,2,Greg Rusedski,N/A Bye,Greg Rusedski,,R64,0,0,0,0,0,0,0,0,0,0,0,0,0,0,0,0,0,0,0,0,0,0,0,0,0,0,0
2005-08-01 00:00:00.000,Washington DC; U.S.A. ATP World Tour,HARD,2,Nathan Healey,Gregory Carraz,Nathan Healey,6-2; 6-1,R64,46,18,3,21,35,21,21,8,14,0,0,7,29,35,6,4,31,50,18,31,5,19,6,11,8,23,50
2005-08-01 00:00:00.000,Washington DC; U.S.A. ATP World Tour,HARD,2,Ivo Karlovic,Kenneth Carlsen,Ivo Karlovic,6-3; 6-7(5); 6-3,R64,110,32,3,62,88,56,62,15,26,0,0,16,71,88,6,0,56,80,43,56,16,24,3,5,14,59,80
2005-08-01 00:00:00.000,Washington DC; U.S.A. ATP World Tour,HARD,2,Max Mirnyi,N/A Bye,Max Mirnyi,,R64,0,0,0,0,0,0,0,0,0,0,0,0,0,0,0,0,0,0,0,0,0,0,0,0,0,0,0
2005-08-01 00:00:00.000,Washington DC; U.S.A. ATP World Tour,HARD,2,Tim Henman,N/A Bye,Tim Henman,,R64,0,0,0,0,0,0,0,0,0,0,0,0,0,0,0,0,0,0,0,0,0,0,0,0,0,0,0
2005-08-01 00:00:00.000,Washington DC; U.S.A. ATP World Tour,HARD,2,Wesley Moodie,Robert Smeets,Wesley Moodie,6-4; 7-6(4),R64,92,15,3,45,67,39,45,12,22,2,2,11,51,67,10,6,45,81,38,45,15,36,6,7,11,53,81
2005-08-01 00:00:00.000,Washington DC; U.S.A. ATP World Tour,HARD,2,Paul Goldstein,Alejandro Falla,Paul Goldstein,6-3; 6-2,R64,64,1,0,18,43,15,18,21,25,0,0,9,36,43,10,3,30,52,18,30,10,22,6,9,8,28,52
2005-08-01 00:00:00.000,Washington DC; U.S.A. ATP World Tour,HARD,2,Paradorn Srichaphan,N/A Bye,Paradorn Srichaphan,,R64,0,0,0,0,0,0,0,0,0,0,0,0,0,0,0,0,0,0,0,0,0,0,0,0,0,0,0
2005-08-01 00:00:00.000,Washington DC; U.S.A. ATP World Tour,HARD,2,Karol Beck,N/A Bye,Karol Beck,,R64,0,0,0,0,0,0,0,0,0,0,0,0,0,0,0,0,0,0,0,0,0,0,0,0,0,0,0
2005-08-01 00:00:00.000,Washington DC; U.S.A. ATP World Tour,HARD,2,Robby Ginepri,Kevin Kim,Robby Ginepri,6-2; 6-3,R64,72,6,1,38,61,26,38,14,23,3,4,9,40,61,3,1,27,52,17,27,9,25,6,10,8,26,52
2005-08-01 00:00:00.000,Washington DC; U.S.A. ATP World Tour,HARD,2,Luis Horna,Mark Philippoussis,Luis Horna,7-5; 6-4,R64,83,7,1,35,60,31,35,14,25,1,1,11,45,60,8,2,37,63,28,37,14,26,2,4,11,42,63
2005-08-01 00:00:00.000,Washington DC; U.S.A. ATP World Tour,HARD,2,Dominik Hrbaty,N/A Bye,Dominik Hrbaty,,R64,0,0,0,0,0,0,0,0,0,0,0,0,0,0,0,0,0,0,0,0,0,0,0,0,0,0,0
2005-08-01 00:00:00.000,Washington DC; U.S.A. ATP World Tour,HARD,2,Richard Bloomfield,N/A Bye,Richard Bloomfield,,R64,0,0,0,0,0,0,0,0,0,0,0,0,0,0,0,0,0,0,0,0,0,0,0,0,0,0,0
2005-08-01 00:00:00.000,Washington DC; U.S.A. ATP World Tour,HARD,2,Arnaud Clement,Nicolas Lapentti,Arnaud Clement,6-1; 3-6; 6-3,R64,111,10,1,44,74,31,44,20,30,6,8,13,51,74,8,4,41,70,28,41,11,29,3,7,12,39,70
2005-08-01 00:00:00.000,Washington DC; U.S.A. ATP World Tour,HARD,2,Gilles Muller,Davide Sanguinetti,Gilles Muller,6-3; 6-4,R64,63,9,4,31,59,26,31,18,28,1,1,10,44,59,6,2,38,58,29,38,7,20,7,9,9,36,58
2005-08-01 00:00:00.000,Washington DC; U.S.A. ATP World Tour,HARD,2,Nicolas Massu,N/A Bye,Nicolas Massu,,R64,0,0,0,0,0,0,0,0,0,0,0,0,0,0,0,0,0,0,0,0,0,0,0,0,0,0,0
2005-08-01 00:00:00.000,Washington DC; U.S.A. ATP World Tour,HARD,2,Tomas Zib,N/A Bye,Tomas Zib,,R64,0,0,0,0,0,0,0,0,0,0,0,0,0,0,0,0,0,0,0,0,0,0,0,0,0,0,0
2005-08-01 00:00:00.000,Washington DC; U.S.A. ATP World Tour,HARD,2,Jonas Bjorkman,Jeff Morrison,Jonas Bjorkman,6-3; 6-4,R64,73,6,2,26,51,18,26,19,25,2,3,9,37,51,7,1,41,69,27,41,10,28,2,6,10,37,69
2005-08-01 00:00:00.000,Washington DC; U.S.A. ATP World Tour,HARD,2,James Blake,Jean-Rene Lisnard,James Blake,6-4; 6-3,R64,83,6,2,44,79,32,44,17,35,7,9,10,49,79,2,6,20,57,14,20,17,37,4,8,9,31,57
2005-08-01 00:00:00.000,Washington DC; U.S.A. ATP World Tour,HARD,2,Radek Stepanek,N/A Bye,Radek Stepanek,,R64,0,0,0,0,0,0,0,0,0,0,0,0,0,0,0,0,0,0,0,0,0,0,0,0,0,0,0
2005-08-01 00:00:00.000,Washington DC; U.S.A. ATP World Tour,HARD,2,Sebastien Grosjean,N/A Bye,Sebastien Grosjean,,R64,0,0,0,0,0,0,0,0,0,0,0,0,0,0,0,0,0,0,0,0,0,0,0,0,0,0,0
2005-08-01 00:00:00.000,Washington DC; U.S.A. ATP World Tour,HARD,2,Alexander Popp,Bjorn Phau,Alexander Popp,7-6(4); 2-6; 6-3,R64,111,6,9,59,97,43,59,17,38,8,12,15,60,97,5,3,46,91,29,46,30,45,6,9,14,59,91
2005-08-01 00:00:00.000,Washington DC; U.S.A. ATP World Tour,HARD,2,Wayne Arthurs,Phillip Simmonds,Wayne Arthurs,0-6; 6-3; 6-1,R64,76,9,4,37,69,27,37,14,32,6,9,11,41,69,5,5,31,59,20,31,15,28,5,9,11,35,59
2005-08-01 00:00:00.000,Washington DC; U.S.A. ATP World Tour,HARD,2,Tomas Berdych,N/A Bye,Tomas Berdych,,R64,0,0,0,0,0,0,0,0,0,0,0,0,0,0,0,0,0,0,0,0,0,0,0,0,0,0,0
2005-08-01 00:00:00.000,Washington DC; U.S.A. ATP World Tour,HARD,2,Ricardo Mello,N/A Bye,Ricardo Mello,,R64,0,0,0,0,0,0,0,0,0,0,0,0,0,0,0,0,0,0,0,0,0,0,0,0,0,0,0
2005-08-01 00:00:00.000,Washington DC; U.S.A. ATP World Tour,HARD,2,Bobby Reynolds,Alex Clayton,Bobby Reynolds,7-5; 6-4,R64,87,15,1,37,60,32,37,16,23,4,4,11,48,60,11,3,36,77,27,36,22,41,4,6,11,49,77
2005-08-01 00:00:00.000,Washington DC; U.S.A. ATP World Tour,HARD,2,Jan Hernych,Jamie Delgado,Jan Hernych,6-4; 6-3,R64,72,3,0,34,48,26,34,8,14,2,3,9,34,48,7,2,34,70,24,34,14,36,0,4,10,38,70
2005-08-01 00:00:00.000,Washington DC; U.S.A. ATP World Tour,HARD,2,Sebastien De Chaunac,N/A Bye,Sebastien De Chaunac,,R64,0,0,0,0,0,0,0,0,0,0,0,0,0,0,0,0,0,0,0,0,0,0,0,0,0,0,0
2005-08-01 00:00:00.000,Washington DC; U.S.A. ATP World Tour,HARD,2,Andy Roddick,Giovanni Lapentti,Andy Roddick,6-3; 6-4,R32,68,8,1,37,50,32,37,8,13,0,0,10,40,50,4,0,40,54,27,40,7,14,1,3,9,34,54
2005-08-01 00:00:00.000,Washington DC; U.S.A. ATP World Tour,HARD,2,Juan Ignacio Chela,Brian Baker,Juan Ignacio Chela,6-3; 6-3,R32,75,5,6,35,59,25,35,15,24,4,4,9,40,59,1,4,36,63,25,36,8,27,8,11,9,33,63
2005-08-01 00:00:00.000,Washington DC; U.S.A. ATP World Tour,HARD,2,Greg Rusedski,Nathan Healey,Greg Rusedski,7-6(2); 6-2,R32,81,9,4,34,65,30,34,19,31,2,2,10,49,65,12,3,40,66,31,40,11,26,5,7,10,42,66
2005-08-01 00:00:00.000,Washington DC; U.S.A. ATP World Tour,HARD,2,Ivo Karlovic,Max Mirnyi,Ivo Karlovic,4-6; 6-3; 6-4,R32,119,18,4,56,89,46,56,19,33,3,4,15,65,89,10,4,40,78,30,40,25,38,1,3,14,55,78
2005-08-01 00:00:00.000,Washington DC; U.S.A. ATP World Tour,HARD,2,Wesley Moodie,Tim Henman,Wesley Moodie,7-6(4); 7-5,R32,106,9,2,41,67,33,41,16,26,0,1,12,49,67,3,5,58,88,40,58,14,30,7,9,12,54,88
2005-08-01 00:00:00.000,Washington DC; U.S.A. ATP World Tour,HARD,2,Paradorn Srichaphan,Paul Goldstein,Paradorn Srichaphan,6-4; 3-6; 7-5,R32,152,8,4,62,102,41,62,21,40,9,13,15,62,102,0,3,95,121,57,95,10,26,13,18,16,67,121
2005-08-01 00:00:00.000,Washington DC; U.S.A. ATP World Tour,HARD,2,Robby Ginepri,Karol Beck,Robby Ginepri,6-3; 6-4,R32,63,8,1,30,48,23,30,15,18,0,0,9,38,48,5,3,30,61,22,30,14,31,3,6,10,36,61
2005-08-01 00:00:00.000,Washington DC; U.S.A. ATP World Tour,HARD,2,Luis Horna,Dominik Hrbaty,Luis Horna,6-4; 6-7(2); 7-6(4),R32,163,14,4,74,121,59,74,20,47,10,12,17,79,121,13,10,78,113,57,78,15,35,5,8,17,72,113
2005-08-01 00:00:00.000,Washington DC; U.S.A. ATP World Tour,HARD,2,Arnaud Clement,Richard Bloomfield,Arnaud Clement,6-2; 4-6; 7-6(7),R32,134,5,3,47,86,41,47,25,39,2,3,15,66,86,13,6,47,88,38,47,21,41,2,4,15,59,88
2005-08-01 00:00:00.000,Washington DC; U.S.A. ATP World Tour,HARD,2,Gilles Muller,Nicolas Massu,Gilles Muller,7-6(2); 6-4,R32,102,12,1,41,64,35,41,15,23,0,0,11,50,64,11,4,51,82,38,51,13,31,5,6,11,51,82
2005-08-01 00:00:00.000,Washington DC; U.S.A. ATP World Tour,HARD,2,Tomas Zib,Jonas Bjorkman,Tomas Zib,0-6; 6-3; 7-5,R32,101,7,2,37,68,29,37,16,31,1,4,13,45,68,14,4,41,81,35,41,15,40,2,5,14,50,81
2005-08-01 00:00:00.000,Washington DC; U.S.A. ATP World Tour,HARD,2,James Blake,Radek Stepanek,James Blake,6-4; 2-6; 6-4,R32,101,11,2,51,83,36,51,17,32,7,10,14,53,83,10,3,53,78,38,53,13,25,3,6,14,51,78
2005-08-01 00:00:00.000,Washington DC; U.S.A. ATP World Tour,HARD,2,Sebastien Grosjean,Alexander Popp,Sebastien Grosjean,6-2; 6-3,R32,67,5,0,22,53,19,22,20,31,5,5,9,39,53,1,3,26,44,20,26,6,18,2,5,8,26,44
2005-08-01 00:00:00.000,Washington DC; U.S.A. ATP World Tour,HARD,2,Tomas Berdych,Wayne Arthurs,Tomas Berdych,6-4; 4-6; 6-4,R32,101,13,5,47,82,41,47,20,35,6,7,15,61,82,13,10,55,85,47,55,10,30,3,5,15,57,85
2005-08-01 00:00:00.000,Washington DC; U.S.A. ATP World Tour,HARD,2,Bobby Reynolds,Ricardo Mello,Bobby Reynolds,6-3; 3-6; 7-5,R32,105,11,1,61,84,46,61,14,23,1,2,15,60,84,6,2,56,83,41,56,16,27,0,2,15,57,83
2005-08-01 00:00:00.000,Washington DC; U.S.A. ATP World Tour,HARD,2,Jan Hernych,Sebastien De Chaunac,Jan Hernych,7-6(7); 6-1,R32,100,0,2,47,71,29,47,13,24,3,5,10,42,71,4,1,32,68,17,32,17,36,2,6,9,34,68
2005-08-01 00:00:00.000,Washington DC; U.S.A. ATP World Tour,HARD,2,Andy Roddick,Juan Ignacio Chela,Andy Roddick,6-4; 6-7(4); 6-4,R16,128,9,2,62,89,53,62,17,27,2,2,16,70,89,7,9,69,115,56,69,21,46,5,7,16,77,115
2005-08-01 00:00:00.000,Washington DC; U.S.A. ATP World Tour,HARD,2,Ivo Karlovic,Greg Rusedski,Ivo Karlovic,7-6(4); 6-2,R16,77,14,2,39,60,37,39,11,21,5,5,10,48,60,7,8,41,67,33,41,10,26,0,2,10,43,67
2005-08-01 00:00:00.000,Washington DC; U.S.A. ATP World Tour,HARD,2,Paradorn Srichaphan,Wesley Moodie,Paradorn Srichaphan,6-3; 7-6(1),R16,91,5,2,46,73,33,46,21,27,4,4,11,54,73,15,4,50,73,35,50,11,23,3,4,10,46,73
2005-08-01 00:00:00.000,Washington DC; U.S.A. ATP World Tour,HARD,2,Luis Horna,Robby Ginepri,Luis Horna,6-4; 7-6(8),R16,93,13,1,51,80,40,51,15,29,4,4,11,55,80,15,2,42,61,36,42,9,19,0,1,11,45,61
2005-08-01 00:00:00.000,Washington DC; U.S.A. ATP World Tour,HARD,2,Arnaud Clement,Gilles Muller,Arnaud Clement,4-6; 6-3; 6-4,R16,119,12,1,50,90,39,50,22,40,5,7,15,61,90,16,5,52,82,37,52,14,30,4,7,14,51,82
2005-08-01 00:00:00.000,Washington DC; U.S.A. ATP World Tour,HARD,2,James Blake,Tomas Zib,James Blake,6-4; 2-6; 6-4,R16,58,6,0,25,46,20,25,15,21,3,4,9,35,46,2,0,36,58,20,36,9,22,5,9,9,29,58
2005-08-01 00:00:00.000,Washington DC; U.S.A. ATP World Tour,HARD,2,Tomas Berdych,Sebastien Grosjean,Tomas Berdych,7-5; 6-2,R16,85,6,2,38,60,29,38,12,22,3,4,10,41,60,6,5,33,67,20,33,17,34,4,8,10,37,67
2005-08-01 00:00:00.000,Washington DC; U.S.A. ATP World Tour,HARD,2,Bobby Reynolds,Jan Hernych,Bobby Reynolds,2-6; 6-4; 6-3,R16,111,3,6,44,74,26,44,22,30,2,5,13,48,74,5,3,61,90,38,61,16,29,6,10,14,54,90
2005-08-01 00:00:00.000,Washington DC; U.S.A. ATP World Tour,HARD,2,Andy Roddick,Ivo Karlovic,Andy Roddick,6-7(7); 7-5; 6-4,Q,119,19,3,66,90,57,66,17,24,0,0,17,74,90,29,4,60,98,50,60,22,38,5,7,17,72,98
2005-08-01 00:00:00.000,Washington DC; U.S.A. ATP World Tour,HARD,2,Paradorn Srichaphan,Luis Horna,Paradorn Srichaphan,6-4; 7-5,Q,86,11,1,35,61,29,35,15,26,0,1,11,44,61,6,3,35,59,25,35,12,24,0,3,11,37,59
2005-08-01 00:00:00.000,Washington DC; U.S.A. ATP World Tour,HARD,2,James Blake,Arnaud Clement,James Blake,6-3; 6-2,Q,71,8,3,27,50,25,27,13,23,1,1,9,38,50,2,2,21,49,17,21,9,28,2,5,8,26,49
2005-08-01 00:00:00.000,Washington DC; U.S.A. ATP World Tour,HARD,2,Tomas Berdych,Bobby Reynolds,Tomas Berdych,7-6(5); 7-6(9),Q,106,14,3,52,86,44,52,20,34,5,6,12,64,86,15,3,51,86,40,51,22,35,3,4,12,62,86
2005-08-01 00:00:00.000,Washington DC; U.S.A. ATP World Tour,HARD,2,Andy Roddick,Paradorn Srichaphan,Andy Roddick,7-6(4); 6-2,S,82,13,0,35,48,33,35,11,13,0,0,10,44,48,5,4,44,76,32,44,15,32,2,4,10,47,76
2005-08-01 00:00:00.000,Washington DC; U.S.A. ATP World Tour,HARD,2,James Blake,Tomas Berdych,James Blake,6-4; 6-3,S,68,9,1,33,53,31,33,11,20,1,1,10,42,53,7,6,36,65,26,36,14,29,9,11,9,40,65
2005-08-01 00:00:00.000,Washington DC; U.S.A. ATP World Tour,HARD,2,Andy Roddick,James Blake,Andy Roddick,7-5; 6-3,F,79,18,0,48,70,35,48,11,22,3,4,11,46,70,6,0,35,58,26,35,11,23,3,6,10,37,58
2005-08-08 00:00:00.000,ATP Masters Series Canada Montreal; Canada ATP World Tour,HARD,2,Rafael Nadal,Carlos Moya,Rafael Nadal,6-3; 6-7(0); 6-3,R64,158,2,1,57,88,46,57,19,31,1,1,16,65,88,9,1,59,108,41,59,26,49,13,15,14,67,108
2005-08-08 00:00:00.000,ATP Masters Series Canada Montreal; Canada ATP World Tour,HARD,2,Ricardo Mello,Philip Bester,Ricardo Mello,6-4; 6-2,R64,62,4,2,37,58,31,37,12,21,2,2,9,43,58,3,2,32,52,21,32,9,20,4,7,9,30,52
2005-08-08 00:00:00.000,ATP Masters Series Canada Montreal; Canada ATP World Tour,HARD,2,Sebastien Grosjean,Paradorn Srichaphan,Sebastien Grosjean,7-6(1); 3-6; 6-2,R64,133,6,3,56,95,42,56,18,39,3,6,14,60,95,6,3,65,96,44,65,14,31,6,10,15,58,96
2005-08-08 00:00:00.000,ATP Masters Series Canada Montreal; Canada ATP World Tour,HARD,2,Richard Gasquet,Mikhail Youzhny,Richard Gasquet,6-3; 7-6(3),R64,79,6,2,42,61,39,42,11,19,1,1,11,50,61,6,3,35,63,25,35,18,28,6,7,10,43,63
2005-08-08 00:00:00.000,ATP Masters Series Canada Montreal; Canada ATP World Tour,HARD,2,Thomas Johansson,Ivo Karlovic,Thomas Johansson,6-1; 7-5,R64,68,7,0,33,47,29,33,11,14,0,0,10,40,47,7,9,28,55,25,28,7,27,6,9,9,32,55
2005-08-08 00:00:00.000,ATP Masters Series Canada Montreal; Canada ATP World Tour,HARD,2,Xavier Malisse,Frank Dancevic,Xavier Malisse,6-2; 6-2,R64,60,7,0,23,42,19,23,13,19,0,0,8,32,42,3,4,30,60,20,30,10,30,3,7,8,30,60
2005-08-08 00:00:00.000,ATP Masters Series Canada Montreal; Canada ATP World Tour,HARD,2,Andrei Pavel,Christophe Rochus,Andrei Pavel,6-1; 7-5,R64,73,14,1,32,52,23,32,10,20,0,2,9,33,52,2,5,44,77,29,44,8,33,8,14,10,37,77
2005-08-08 00:00:00.000,ATP Masters Series Canada Montreal; Canada ATP World Tour,HARD,2,Mariano Puerta,Luis Horna,Mariano Puerta,7-6(7); 7-6(3),R64,103,5,1,57,74,46,57,13,17,0,0,12,59,74,13,3,52,79,44,52,14,27,3,3,12,58,79
2005-08-08 00:00:00.000,ATP Masters Series Canada Montreal; Canada ATP World Tour,HARD,2,Paul-Henri Mathieu,Andy Roddick,Paul-Henri Mathieu,7-5; 6-3,R64,80,14,2,32,59,27,32,18,27,2,3,11,45,59,3,1,27,50,22,27,11,23,0,3,10,33,50
2005-08-08 00:00:00.000,ATP Masters Series Canada Montreal; Canada ATP World Tour,HARD,2,Arnaud Clement,Jose Acasuso,Arnaud Clement,2-6; 6-3; 6-3,R64,132,5,3,53,87,35,53,18,34,6,9,13,53,87,14,5,53,104,39,53,21,51,8,12,13,60,104
2005-08-08 00:00:00.000,ATP Masters Series Canada Montreal; Canada ATP World Tour,HARD,2,Olivier Rochus,Nicolas Mahut,Olivier Rochus,6-3; 6-4,R64,85,2,1,35,58,25,35,17,23,6,7,10,42,58,4,3,45,71,28,45,11,26,6,9,9,39,71
2005-08-08 00:00:00.000,ATP Masters Series Canada Montreal; Canada ATP World Tour,HARD,2,Robin Soderling,Radek Stepanek,Robin Soderling,6-3; 6-4,R64,84,9,2,35,59,28,35,12,24,3,5,10,40,59,4,3,33,75,21,33,18,42,7,11,9,39,75
2005-08-08 00:00:00.000,ATP Masters Series Canada Montreal; Canada ATP World Tour,HARD,2,David Nalbandian,Juan Ignacio Chela,David Nalbandian,6-4; 6-1,R64,66,1,1,20,47,14,20,21,27,0,1,9,35,47,1,2,31,49,18,31,7,18,5,9,8,25,49
2005-08-08 00:00:00.000,ATP Masters Series Canada Montreal; Canada ATP World Tour,HARD,2,Karol Beck,Noam Okun,Karol Beck,6-3; 6-2,R64,71,2,2,26,53,22,26,13,27,1,2,9,35,53,1,1,32,45,17,32,9,13,3,7,8,26,45
2005-08-08 00:00:00.000,ATP Masters Series Canada Montreal; Canada ATP World Tour,HARD,2,Tomas Berdych,Jurgen Melzer,Tomas Berdych,6-1; 6-3,R64,54,4,0,19,38,16,19,16,19,0,0,8,32,38,5,3,26,48,16,26,9,22,6,10,8,25,48
2005-08-08 00:00:00.000,ATP Masters Series Canada Montreal; Canada ATP World Tour,HARD,2,Nikolay Davydenko,Frederic Niemeyer,Nikolay Davydenko,6-2; 6-1,R64,63,4,2,33,46,26,33,7,13,2,2,8,33,46,2,5,26,50,17,26,7,24,4,8,7,24,50
2005-08-08 00:00:00.000,ATP Masters Series Canada Montreal; Canada ATP World Tour,HARD,2,Gaston Gaudio,Davide Sanguinetti,Gaston Gaudio,1-6; 7-6(5); 7-5,R64,130,5,6,55,97,40,55,19,42,4,8,15,59,97,5,0,46,92,31,46,30,46,1,4,16,61,92
2005-08-08 00:00:00.000,ATP Masters Series Canada Montreal; Canada ATP World Tour,HARD,2,Kenneth Carlsen,Rob Steckley,Kenneth Carlsen,5-7; 6-4; 6-3,R64,122,11,2,58,94,43,58,18,36,4,6,15,61,94,1,2,52,90,34,52,22,38,1,5,16,56,90
2005-08-08 00:00:00.000,ATP Masters Series Canada Montreal; Canada ATP World Tour,HARD,2,Younes El Aynaoui,Feliciano Lopez,Younes El Aynaoui,7-6(3); 6-3,R64,82,7,5,51,75,41,51,14,24,6,6,11,55,75,4,4,38,63,30,38,11,25,7,8,10,41,63
2005-08-08 00:00:00.000,ATP Masters Series Canada Montreal; Canada ATP World Tour,HARD,2,Tommy Robredo,Kevin Kim,Tommy Robredo,7-5; 3-6; 6-1,R64,118,4,3,39,78,31,39,22,39,2,4,14,53,78,5,5,66,108,48,66,15,42,9,13,14,63,108
2005-08-08 00:00:00.000,ATP Masters Series Canada Montreal; Canada ATP World Tour,HARD,2,Taylor Dent,Ivan Ljubicic,Taylor Dent,1-6; 7-5; 6-3,R64,121,9,6,39,92,32,39,26,53,6,9,14,58,92,13,2,50,82,37,50,16,32,3,6,14,53,82
2005-08-08 00:00:00.000,ATP Masters Series Canada Montreal; Canada ATP World Tour,HARD,2,Nicolas Kiefer,Nicolas Massu,Nicolas Kiefer,6-3; 6-2,R64,91,7,3,25,57,22,25,19,32,4,4,9,41,57,5,1,34,53,23,34,6,19,4,7,8,29,53
2005-08-08 00:00:00.000,ATP Masters Series Canada Montreal; Canada ATP World Tour,HARD,2,Jonas Bjorkman,Vincent Spadea,Jonas Bjorkman,6-3; 6-2,R64,59,1,3,39,56,28,39,9,17,4,5,9,37,56,0,3,23,43,12,23,8,20,0,4,8,20,43
2005-08-08 00:00:00.000,ATP Masters Series Canada Montreal; Canada ATP World Tour,HARD,2,Andre Agassi,Alberto Martin,Andre Agassi,6-4; 6-2,R64,68,8,1,30,60,23,30,18,30,5,6,9,41,60,3,6,22,51,15,22,11,29,4,8,9,26,51
2005-08-08 00:00:00.000,ATP Masters Series Canada Montreal; Canada ATP World Tour,HARD,2,Juan Carlos Ferrero,Guillermo Coria,Juan Carlos Ferrero,6-3; 6-2,R64,79,3,0,22,48,17,22,14,26,3,5,9,31,48,3,5,35,63,21,35,10,28,9,14,8,31,63
2005-08-08 00:00:00.000,ATP Masters Series Canada Montreal; Canada ATP World Tour,HARD,2,David Ferrer,Fabrice Santoro,David Ferrer,3-6; 6-1; 6-2,R64,111,5,3,66,99,50,66,13,33,12,13,12,63,99,2,4,49,93,31,49,20,44,9,13,12,51,93
2005-08-08 00:00:00.000,ATP Masters Series Canada Montreal; Canada ATP World Tour,HARD,2,Jiri Novak,Igor Andreev,Jiri Novak,6-4; 6-7(1); 6-1,R64,112,9,5,53,91,41,53,21,38,4,5,15,62,91,4,1,52,88,38,52,13,36,3,7,14,51,88
2005-08-08 00:00:00.000,ATP Masters Series Canada Montreal; Canada ATP World Tour,HARD,2,Dominik Hrbaty,Tim Henman,Dominik Hrbaty,3-6; 7-5; 6-1,R64,120,2,6,48,78,37,48,16,30,2,4,14,53,78,5,7,53,93,41,53,14,40,9,13,14,55,93
2005-08-08 00:00:00.000,ATP Masters Series Canada Montreal; Canada ATP World Tour,HARD,2,Max Mirnyi,Fernando Gonzalez,Max Mirnyi,7-6(5); 6-4,R64,84,10,5,36,65,32,36,16,29,1,2,11,48,65,7,5,37,70,30,37,16,33,4,6,11,46,70
2005-08-08 00:00:00.000,ATP Masters Series Canada Montreal; Canada ATP World Tour,HARD,2,Greg Rusedski,Stanislas Wawrinka,Greg Rusedski,6-7(5); 6-2; 6-3,R64,139,3,15,48,99,44,48,24,51,6,8,15,68,99,7,3,61,116,40,61,25,55,13,18,14,65,116
2005-08-08 00:00:00.000,ATP Masters Series Canada Montreal; Canada ATP World Tour,HARD,2,Mario Ancic,Cyril Saulnier,Mario Ancic,6-3; 7-6(8),R64,96,12,1,47,73,37,47,13,26,0,1,11,50,73,6,3,45,71,33,45,11,26,1,3,10,44,71
2005-08-08 00:00:00.000,ATP Masters Series Canada Montreal; Canada ATP World Tour,HARD,2,Florent Serra,Lleyton Hewitt,Florent Serra,4-3 RET,R64,52,2,1,9,16,6,9,4,7,0,1,3,10,16,0,4,13,27,10,13,3,14,1,3,4,13,27
2005-08-08 00:00:00.000,ATP Masters Series Canada Montreal; Canada ATP World Tour,HARD,2,Rafael Nadal,Ricardo Mello,Rafael Nadal,6-1; 6-2,R32,66,2,0,35,44,27,35,6,9,0,0,8,33,44,1,3,33,48,18,33,3,15,3,7,7,21,48
2005-08-08 00:00:00.000,ATP Masters Series Canada Montreal; Canada ATP World Tour,HARD,2,Sebastien Grosjean,Richard Gasquet,Sebastien Grosjean,7-6(5); 6-3,R32,106,10,0,43,73,35,43,14,30,2,3,11,49,73,1,3,34,65,28,34,14,31,1,3,10,42,65
2005-08-08 00:00:00.000,ATP Masters Series Canada Montreal; Canada ATP World Tour,HARD,2,Xavier Malisse,Thomas Johansson,Xavier Malisse,7-5; 7-6(4),R32,107,10,0,40,72,30,40,21,32,3,5,12,51,72,8,0,62,97,39,62,19,35,8,11,12,58,97
2005-08-08 00:00:00.000,ATP Masters Series Canada Montreal; Canada ATP World Tour,HARD,2,Mariano Puerta,Andrei Pavel,Mariano Puerta,3-6; 6-3; 6-4,R32,111,11,2,59,80,45,59,11,21,5,8,14,56,80,9,2,42,90,34,42,21,48,2,6,14,55,90
2005-08-08 00:00:00.000,ATP Masters Series Canada Montreal; Canada ATP World Tour,HARD,2,Paul-Henri Mathieu,Arnaud Clement,Paul-Henri Mathieu,6-3; 3-6; 6-3,R32,129,9,1,40,77,33,40,24,37,3,4,14,57,77,3,0,44,79,38,44,15,35,1,3,13,53,79
2005-08-08 00:00:00.000,ATP Masters Series Canada Montreal; Canada ATP World Tour,HARD,2,Olivier Rochus,Robin Soderling,Olivier Rochus,6-2; 6-7(2); 5-2 RET,R32,126,4,3,44,84,32,44,24,40,5,7,14,56,84,22,9,58,114,44,58,22,56,11,16,13,66,114
2005-08-08 00:00:00.000,ATP Masters Series Canada Montreal; Canada ATP World Tour,HARD,2,Karol Beck,David Nalbandian,Karol Beck,7-6(1); 6-7(3); 6-3,R32,163,11,5,68,130,51,68,32,62,7,9,17,83,130,1,8,58,100,41,58,25,42,5,8,16,66,100
2005-08-08 00:00:00.000,ATP Masters Series Canada Montreal; Canada ATP World Tour,HARD,2,Nikolay Davydenko,Tomas Berdych,Nikolay Davydenko,5-7; 6-1; 6-3,R32,128,4,6,66,108,46,66,21,42,13,15,14,67,108,2,2,52,93,38,52,15,41,8,13,14,53,93
2005-08-08 00:00:00.000,ATP Masters Series Canada Montreal; Canada ATP World Tour,HARD,2,Gaston Gaudio,Kenneth Carlsen,Gaston Gaudio,3-6; 6-2; 7-5,R32,142,4,1,58,78,41,58,16,20,2,3,14,57,78,9,1,75,110,50,75,16,35,11,14,15,66,110
2005-08-08 00:00:00.000,ATP Masters Series Canada Montreal; Canada ATP World Tour,HARD,2,Tommy Robredo,Younes El Aynaoui,Tommy Robredo,7-6(4); 7-6(6),R32,112,1,7,43,75,34,43,16,32,1,4,12,50,75,3,5,44,82,30,44,19,38,1,4,12,49,82
2005-08-08 00:00:00.000,ATP Masters Series Canada Montreal; Canada ATP World Tour,HARD,2,Nicolas Kiefer,Taylor Dent,Nicolas Kiefer,6-4; 6-4,R32,98,3,3,33,63,28,33,17,30,5,5,10,45,63,9,5,43,75,33,43,14,32,8,10,10,47,75
2005-08-08 00:00:00.000,ATP Masters Series Canada Montreal; Canada ATP World Tour,HARD,2,Andre Agassi,Jonas Bjorkman,Andre Agassi,6-1; 3-6; 6-2,R32,99,8,4,44,75,33,44,15,31,5,7,12,48,75,6,5,41,77,24,41,19,36,2,7,12,43,77
2005-08-08 00:00:00.000,ATP Masters Series Canada Montreal; Canada ATP World Tour,HARD,2,Juan Carlos Ferrero,David Ferrer,Juan Carlos Ferrero,7-5; 4-6; 6-3,R32,139,3,2,66,97,44,66,18,31,6,10,16,62,97,2,1,61,96,36,61,17,35,4,9,15,53,96
2005-08-08 00:00:00.000,ATP Masters Series Canada Montreal; Canada ATP World Tour,HARD,2,Dominik Hrbaty,Jiri Novak,Dominik Hrbaty,6-3; 4-6; 6-0,R32,93,6,4,57,96,37,57,23,39,9,10,12,60,96,6,3,53,72,33,53,8,19,2,7,13,41,72
2005-08-08 00:00:00.000,ATP Masters Series Canada Montreal; Canada ATP World Tour,HARD,2,Greg Rusedski,Max Mirnyi,Greg Rusedski,4-6; 6-4; 7-6(2),R32,133,9,5,50,103,39,50,32,53,3,5,16,71,103,18,5,60,94,45,60,20,34,4,6,16,65,94
2005-08-08 00:00:00.000,ATP Masters Series Canada Montreal; Canada ATP World Tour,HARD,2,Mario Ancic,Florent Serra,Mario Ancic,6-3; 3-6; 7-5,R32,133,16,6,49,86,41,49,19,37,1,2,15,60,86,3,2,71,111,47,71,23,40,9,11,15,70,111
2005-08-08 00:00:00.000,ATP Masters Series Canada Montreal; Canada ATP World Tour,HARD,2,Rafael Nadal,Sebastien Grosjean,Rafael Nadal,6-4; 6-4,R16,100,0,2,44,67,32,44,14,23,5,5,10,46,67,2,1,41,59,31,41,8,18,3,5,10,39,59
2005-08-08 00:00:00.000,ATP Masters Series Canada Montreal; Canada ATP World Tour,HARD,2,Mariano Puerta,Xavier Malisse,Mariano Puerta,6-2; 6-4,R16,65,4,0,31,40,22,31,7,9,0,2,9,29,40,7,4,35,64,20,35,12,29,3,8,9,32,64
2005-08-08 00:00:00.000,ATP Masters Series Canada Montreal; Canada ATP World Tour,HARD,2,Paul-Henri Mathieu,Olivier Rochus,Paul-Henri Mathieu,6-1; 6-2,R16,79,9,3,29,58,23,29,16,29,3,3,8,39,58,0,1,28,57,11,28,16,29,3,7,7,27,57
2005-08-08 00:00:00.000,ATP Masters Series Canada Montreal; Canada ATP World Tour,HARD,2,Karol Beck,Nikolay Davydenko,Karol Beck,6-4; 3-6; 7-6(4),R16,140,4,5,55,100,37,55,18,45,4,10,15,55,100,1,5,68,106,44,68,14,38,7,13,16,58,106
2005-08-08 00:00:00.000,ATP Masters Series Canada Montreal; Canada ATP World Tour,HARD,2,Gaston Gaudio,Tommy Robredo,Gaston Gaudio,6-3; 7-6(0),R16,104,2,1,47,69,33,47,15,22,2,4,11,48,69,7,5,51,82,30,51,15,31,10,13,10,45,82
2005-08-08 00:00:00.000,ATP Masters Series Canada Montreal; Canada ATP World Tour,HARD,2,Andre Agassi,Nicolas Kiefer,Andre Agassi,6-4; 6-2,R16,86,4,1,31,48,28,31,9,17,1,1,9,37,48,7,5,37,68,25,37,14,31,7,10,9,39,68
2005-08-08 00:00:00.000,ATP Masters Series Canada Montreal; Canada ATP World Tour,HARD,2,Dominik Hrbaty,Juan Carlos Ferrero,Dominik Hrbaty,6-4; 6-2,R16,95,7,3,36,59,26,36,13,23,2,3,9,39,59,3,3,51,78,29,51,11,27,6,10,9,40,78
2005-08-08 00:00:00.000,ATP Masters Series Canada Montreal; Canada ATP World Tour,HARD,2,Greg Rusedski,Mario Ancic,Greg Rusedski,6-2; 3-6; 6-2,R16,104,7,8,52,85,40,52,16,33,6,7,12,56,85,11,1,44,67,34,44,11,23,2,6,13,45,67
2005-08-08 00:00:00.000,ATP Masters Series Canada Montreal; Canada ATP World Tour,HARD,2,Rafael Nadal,Mariano Puerta,Rafael Nadal,6-3; 6-1,Q,70,3,0,25,38,21,25,11,13,0,0,8,32,38,1,0,32,54,16,32,11,22,4,8,8,27,54
2005-08-08 00:00:00.000,ATP Masters Series Canada Montreal; Canada ATP World Tour,HARD,2,Paul-Henri Mathieu,Karol Beck,Paul-Henri Mathieu,6-1; 6-2,Q,67,7,1,30,52,26,30,11,22,2,2,8,37,52,2,5,19,44,15,19,8,25,3,7,7,23,44
2005-08-08 00:00:00.000,ATP Masters Series Canada Montreal; Canada ATP World Tour,HARD,2,Andre Agassi,Gaston Gaudio,Andre Agassi,6-3; 6-4,Q,86,9,1,40,67,27,40,17,27,6,7,10,44,67,4,2,36,57,24,36,8,21,3,6,9,32,57
2005-08-08 00:00:00.000,ATP Masters Series Canada Montreal; Canada ATP World Tour,HARD,2,Greg Rusedski,Dominik Hrbaty,Greg Rusedski,6-3; 6-4,Q,67,7,1,28,47,23,28,17,19,0,0,10,40,47,9,0,32,59,20,32,16,27,3,5,9,36,59
2005-08-08 00:00:00.000,ATP Masters Series Canada Montreal; Canada ATP World Tour,HARD,2,Rafael Nadal,Paul-Henri Mathieu,Rafael Nadal,6-4; 7-5,S,110,4,4,48,71,37,48,10,23,4,5,11,47,71,5,4,31,62,19,31,18,31,1,4,11,37,62
2005-08-08 00:00:00.000,ATP Masters Series Canada Montreal; Canada ATP World Tour,HARD,2,Andre Agassi,Greg Rusedski,Andre Agassi,6-4; 6-4,S,63,4,0,34,44,30,34,10,10,0,0,10,40,44,9,2,37,59,26,37,13,22,2,4,10,39,59
2005-08-08 00:00:00.000,ATP Masters Series Canada Montreal; Canada ATP World Tour,HARD,2,Rafael Nadal,Andre Agassi,Rafael Nadal,6-3; 4-6; 6-2,F,118,7,1,54,81,39,54,19,27,2,3,14,58,81,7,4,43,75,31,43,16,32,3,6,13,47,75
2005-08-15 00:00:00.000,ATP Masters Series Cincinnati Ohio; USA ATP World Tour,HARD,2,Roger Federer,James Blake,Roger Federer,7-6(3); 7-5,R64,98,4,2,50,79,35,50,19,29,4,5,12,54,79,8,3,52,85,37,52,16,33,2,4,12,53,85
2005-08-15 00:00:00.000,ATP Masters Series Cincinnati Ohio; USA ATP World Tour,HARD,2,Nicolas Kiefer,Nicolas Lapentti,Nicolas Kiefer,6-1; 6-4,R64,79,7,3,26,53,24,26,15,27,2,2,9,39,53,3,1,37,54,21,37,10,17,2,5,8,31,54
2005-08-15 00:00:00.000,ATP Masters Series Cincinnati Ohio; USA ATP World Tour,HARD,2,Olivier Rochus,Filippo Volandri,Olivier Rochus,4-6; 6-3; 6-1,R64,120,0,6,55,85,37,55,13,30,7,11,13,50,85,3,12,68,110,37,68,17,42,16,23,13,54,110
2005-08-15 00:00:00.000,ATP Masters Series Cincinnati Ohio; USA ATP World Tour,HARD,2,Fabrice Santoro,Ivan Ljubicic,Fabrice Santoro,6-7(4); 7-6(7); 7-5,R64,178,8,2,84,130,63,84,26,46,6,7,18,89,130,21,3,67,113,53,67,29,46,8,10,18,82,113
2005-08-15 00:00:00.000,ATP Masters Series Cincinnati Ohio; USA ATP World Tour,HARD,2,Guillermo Coria,Paradorn Srichaphan,Guillermo Coria,6-4; 6-2,R64,101,3,4,40,60,24,40,14,20,6,7,9,38,60,0,5,35,70,22,35,15,35,4,8,9,37,70
2005-08-15 00:00:00.000,ATP Masters Series Cincinnati Ohio; USA ATP World Tour,HARD,2,Luis Horna,Christophe Rochus,Luis Horna,6-3; 6-0,R64,50,8,0,25,36,24,25,6,11,0,1,8,30,36,2,3,32,51,14,32,9,19,3,8,7,23,51
2005-08-15 00:00:00.000,ATP Masters Series Cincinnati Ohio; USA ATP World Tour,HARD,2,Jose Acasuso,Younes El Aynaoui,Jose Acasuso,6-3; 6-2,R64,73,7,0,30,51,25,30,14,21,4,4,9,39,51,1,2,31,48,19,31,8,17,4,7,8,27,48
2005-08-15 00:00:00.000,ATP Masters Series Cincinnati Ohio; USA ATP World Tour,HARD,2,Tommy Robredo,Gaston Gaudio,Tommy Robredo,2-6; 6-3; 6-3,R64,115,4,3,43,83,29,43,19,40,5,9,13,48,83,2,2,53,75,30,53,12,22,0,5,13,42,75
2005-08-15 00:00:00.000,ATP Masters Series Cincinnati Ohio; USA ATP World Tour,HARD,2,Marat Safin,Jan Hernych,Marat Safin,7-6(3); 6-4,R64,87,4,2,37,65,29,37,14,28,2,4,11,43,65,2,2,45,72,27,45,15,27,7,10,11,42,72
2005-08-15 00:00:00.000,ATP Masters Series Cincinnati Ohio; USA ATP World Tour,HARD,2,Andy Murray,Taylor Dent,Andy Murray,7-6(4); 7-6(1),R64,105,4,4,43,77,34,43,19,34,0,2,12,53,77,6,11,41,84,32,41,20,43,2,4,12,52,84
2005-08-15 00:00:00.000,ATP Masters Series Cincinnati Ohio; USA ATP World Tour,HARD,2,Robin Soderling,Max Mirnyi,Robin Soderling,6-2; 6-4,R64,73,7,2,31,57,25,31,16,26,2,2,9,41,57,6,4,40,69,28,40,13,29,3,6,9,41,69
2005-08-15 00:00:00.000,ATP Masters Series Cincinnati Ohio; USA ATP World Tour,HARD,2,Dominik Hrbaty,Thomas Johansson,Dominik Hrbaty,6-1; 7-5,R64,76,4,0,29,59,21,29,21,30,4,4,9,42,59,7,2,36,68,22,36,13,32,7,11,10,35,68
2005-08-15 00:00:00.000,ATP Masters Series Cincinnati Ohio; USA ATP World Tour,HARD,2,Robby Ginepri,Mariano Puerta,Robby Ginepri,7-6(2); 6-1,R64,82,15,1,40,60,34,40,11,20,0,1,10,45,60,3,1,46,70,26,46,13,24,5,8,9,39,70
2005-08-15 00:00:00.000,ATP Masters Series Cincinnati Ohio; USA ATP World Tour,HARD,2,David Ferrer,Wesley Moodie,David Ferrer,6-2; 6-1,R64,61,0,1,24,41,19,24,11,17,3,3,7,30,41,9,1,33,46,17,33,4,13,2,7,8,21,46
2005-08-15 00:00:00.000,ATP Masters Series Cincinnati Ohio; USA ATP World Tour,HARD,2,Gilles Simon,Vincent Spadea,Gilles Simon,2-6; 6-2; 6-3,R64,74,6,1,39,66,31,39,16,27,1,3,12,47,66,5,3,40,68,27,40,17,28,0,4,13,44,68
2005-08-15 00:00:00.000,ATP Masters Series Cincinnati Ohio; USA ATP World Tour,HARD,2,Carlos Moya,Xavier Malisse,Carlos Moya,6-4; 6-4,R64,70,6,0,30,57,28,30,15,27,4,4,10,43,57,4,2,23,51,18,23,19,28,0,2,10,37,51
2005-08-15 00:00:00.000,ATP Masters Series Cincinnati Ohio; USA ATP World Tour,HARD,2,Nikolay Davydenko,Sebastien Grosjean,Nikolay Davydenko,7-6(4); 7-5,R64,93,1,0,44,71,37,44,18,27,2,3,12,55,71,9,1,55,75,41,55,10,20,3,5,12,51,75
2005-08-15 00:00:00.000,ATP Masters Series Cincinnati Ohio; USA ATP World Tour,HARD,2,Paul-Henri Mathieu,Tommy Haas,Paul-Henri Mathieu,6-3; 2-6; 6-1,R64,104,13,2,52,76,38,52,11,24,4,7,12,49,76,4,6,32,64,19,32,17,32,1,6,12,36,64
2005-08-15 00:00:00.000,ATP Masters Series Cincinnati Ohio; USA ATP World Tour,HARD,2,Fernando Gonzalez,Novak Djokovic,Fernando Gonzalez,3-6; 7-6(7); 6-4,R64,127,13,5,62,97,49,62,16,35,3,5,15,65,97,10,1,55,92,45,55,20,37,1,3,16,65,92
2005-08-15 00:00:00.000,ATP Masters Series Cincinnati Ohio; USA ATP World Tour,HARD,2,David Nalbandian,Andrei Pavel,David Nalbandian,6-2; 7-6(3),R64,87,4,1,40,57,31,40,11,17,0,1,10,42,57,9,1,48,77,32,48,11,29,3,6,10,43,77
2005-08-15 00:00:00.000,ATP Masters Series Cincinnati Ohio; USA ATP World Tour,HARD,2,Richard Gasquet,Feliciano Lopez,Richard Gasquet,7-5; 4-6; 6-1,R64,114,3,4,60,90,46,60,17,30,8,10,15,63,90,8,10,48,101,37,48,22,53,4,8,14,59,101
2005-08-15 00:00:00.000,ATP Masters Series Cincinnati Ohio; USA ATP World Tour,HARD,2,Mario Ancic,Ricardo Mello,Mario Ancic,6-2; 6-3,R64,67,5,4,32,53,24,32,12,21,2,2,8,36,53,0,2,42,52,20,42,7,10,4,8,9,27,52
2005-08-15 00:00:00.000,ATP Masters Series Cincinnati Ohio; USA ATP World Tour,HARD,2,Greg Rusedski,Dmitry Tursunov,Greg Rusedski,4-6; 7-5; 6-4,R64,103,15,3,46,77,39,46,21,31,1,3,16,60,77,10,3,55,91,41,55,22,36,4,7,16,63,91
2005-08-15 00:00:00.000,ATP Masters Series Cincinnati Ohio; USA ATP World Tour,HARD,2,Lleyton Hewitt,Igor Andreev,Lleyton Hewitt,6-3; 6-4,R64,127,10,1,30,55,25,30,14,25,1,2,10,39,55,3,0,27,48,17,27,11,21,0,3,9,28,48
2005-08-15 00:00:00.000,ATP Masters Series Cincinnati Ohio; USA ATP World Tour,HARD,2,Andy Roddick,Jurgen Melzer,Andy Roddick,6-3; 6-4,R64,77,4,2,27,50,24,27,16,23,0,0,10,40,50,2,3,40,69,28,40,12,29,1,3,9,40,69
2005-08-15 00:00:00.000,ATP Masters Series Cincinnati Ohio; USA ATP World Tour,HARD,2,Juan Carlos Ferrero,Stefan Koubek,Juan Carlos Ferrero,0-6; 6-3; 6-2,R64,82,5,1,34,60,23,34,13,26,0,3,11,36,60,7,2,35,67,23,35,15,32,2,6,12,38,67
2005-08-15 00:00:00.000,ATP Masters Series Cincinnati Ohio; USA ATP World Tour,HARD,2,Juan Ignacio Chela,Alberto Martin,Juan Ignacio Chela,6-6(4) RET,R64,64,5,2,33,52,20,33,10,19,6,8,6,30,52,2,1,18,38,16,18,7,20,2,4,6,23,38
2005-08-15 00:00:00.000,ATP Masters Series Cincinnati Ohio; USA ATP World Tour,HARD,2,Tim Henman,Nicolas Massu,Tim Henman,6-2; 6-1,R64,69,2,1,23,43,19,23,14,20,1,1,8,33,43,4,3,34,62,21,34,10,28,8,12,7,31,62
2005-08-15 00:00:00.000,ATP Masters Series Cincinnati Ohio; USA ATP World Tour,HARD,2,Gael Monfils,Radek Stepanek,Gael Monfils,6-3; 6-2,R64,60,13,1,34,57,25,34,14,23,3,4,9,39,57,4,0,25,42,18,25,3,17,1,5,8,21,42
2005-08-15 00:00:00.000,ATP Masters Series Cincinnati Ohio; USA ATP World Tour,HARD,2,Karol Beck,Jiri Novak,Karol Beck,6-4; 6-3,R64,79,6,1,33,64,26,33,16,31,2,3,10,42,64,1,2,47,71,29,47,10,24,8,11,9,39,71
2005-08-15 00:00:00.000,ATP Masters Series Cincinnati Ohio; USA ATP World Tour,HARD,2,Mikhail Youzhny,Cyril Saulnier,Mikhail Youzhny,6-2; 3-6; 7-6(4),R64,120,6,2,57,88,40,57,15,31,3,8,15,55,88,6,1,60,101,36,60,22,41,8,13,14,58,101
2005-08-15 00:00:00.000,ATP Masters Series Cincinnati Ohio; USA ATP World Tour,HARD,2,Tomas Berdych,Rafael Nadal,Tomas Berdych,6-7(4); 6-2; 7-6(3),R64,177,11,3,65,124,53,65,28,59,10,12,16,81,124,4,6,59,111,41,59,28,52,2,6,16,69,111
2005-08-15 00:00:00.000,ATP Masters Series Cincinnati Ohio; USA ATP World Tour,HARD,2,Roger Federer,Nicolas Kiefer,Roger Federer,4-6; 6-4; 6-4,R32,133,7,2,48,82,37,48,17,34,2,6,15,54,82,7,4,44,97,31,44,24,53,6,11,15,55,97
2005-08-15 00:00:00.000,ATP Masters Series Cincinnati Ohio; USA ATP World Tour,HARD,2,Olivier Rochus,Fabrice Santoro,Olivier Rochus,7-5; 6-3,R32,87,2,0,34,55,21,34,10,21,1,5,10,31,55,3,2,32,62,15,32,14,30,5,12,11,29,62
2005-08-15 00:00:00.000,ATP Masters Series Cincinnati Ohio; USA ATP World Tour,HARD,2,Luis Horna,Guillermo Coria,Luis Horna,6-4; 6-4,R32,69,8,2,42,64,36,42,9,22,2,2,10,45,64,7,2,32,46,28,32,6,14,1,3,10,34,46
2005-08-15 00:00:00.000,ATP Masters Series Cincinnati Ohio; USA ATP World Tour,HARD,2,Jose Acasuso,Tommy Robredo,Jose Acasuso,7-6(6); 6-2,R32,98,8,1,33,62,28,33,17,29,1,2,10,45,62,5,5,48,79,37,48,7,31,4,7,10,44,79
2005-08-15 00:00:00.000,ATP Masters Series Cincinnati Ohio; USA ATP World Tour,HARD,2,Marat Safin,Andy Murray,Marat Safin,6-4; 1-6; 6-1,R32,98,7,3,40,71,30,40,13,31,0,3,12,43,71,3,7,36,76,27,36,15,40,7,11,12,42,76
2005-08-15 00:00:00.000,ATP Masters Series Cincinnati Ohio; USA ATP World Tour,HARD,2,Dominik Hrbaty,Robin Soderling,Dominik Hrbaty,6-4; 7-6(4),R32,99,11,3,41,78,31,41,20,37,3,4,11,51,78,6,5,38,84,27,38,24,46,12,14,11,51,84
2005-08-15 00:00:00.000,ATP Masters Series Cincinnati Ohio; USA ATP World Tour,HARD,2,Robby Ginepri,David Ferrer,Robby Ginepri,6-4; 6-3,R32,82,4,0,36,59,24,36,19,23,1,1,10,43,59,1,4,51,83,29,51,18,32,6,8,9,47,83
2005-08-15 00:00:00.000,ATP Masters Series Cincinnati Ohio; USA ATP World Tour,HARD,2,Carlos Moya,Gilles Simon,Carlos Moya,7-6(5); 7-5,R32,95,11,5,47,85,39,47,15,38,3,5,12,54,85,3,3,36,79,24,36,23,43,5,8,12,47,79
2005-08-15 00:00:00.000,ATP Masters Series Cincinnati Ohio; USA ATP World Tour,HARD,2,Nikolay Davydenko,Paul-Henri Mathieu,Nikolay Davydenko,6-2; 6-2,R32,83,2,2,35,50,25,35,11,15,2,2,8,36,50,2,2,31,60,19,31,12,29,3,7,8,31,60
2005-08-15 00:00:00.000,ATP Masters Series Cincinnati Ohio; USA ATP World Tour,HARD,2,Fernando Gonzalez,David Nalbandian,Fernando Gonzalez,3-6; 6-1; 6-2,R32,86,7,10,43,83,33,43,18,40,4,6,12,51,83,9,2,39,61,26,39,10,22,2,7,12,36,61
2005-08-15 00:00:00.000,ATP Masters Series Cincinnati Ohio; USA ATP World Tour,HARD,2,Mario Ancic,Richard Gasquet,Mario Ancic,6-4; 7-6(4),R32,106,9,4,40,69,33,40,13,29,3,5,11,46,69,1,0,60,78,40,60,9,18,4,7,11,49,78
2005-08-15 00:00:00.000,ATP Masters Series Cincinnati Ohio; USA ATP World Tour,HARD,2,Lleyton Hewitt,Greg Rusedski,Lleyton Hewitt,1-6; 7-5; 6-4,R32,126,5,6,54,106,37,54,29,52,7,9,14,66,106,9,4,54,91,41,54,22,37,2,4,15,63,91
2005-08-15 00:00:00.000,ATP Masters Series Cincinnati Ohio; USA ATP World Tour,HARD,2,Andy Roddick,Juan Carlos Ferrero,Andy Roddick,6-7(3); 7-6(5); 6-2,R32,129,15,3,60,94,53,60,20,34,2,2,16,73,94,8,1,75,98,53,75,15,23,1,3,16,68,98
2005-08-15 00:00:00.000,ATP Masters Series Cincinnati Ohio; USA ATP World Tour,HARD,2,Juan Ignacio Chela,Tim Henman,Juan Ignacio Chela,6-4; 6-4,R32,95,8,2,40,59,31,40,13,19,3,3,10,44,59,3,4,47,78,34,47,13,31,8,10,10,47,78
2005-08-15 00:00:00.000,ATP Masters Series Cincinnati Ohio; USA ATP World Tour,HARD,2,Gael Monfils,Karol Beck,Gael Monfils,6-1; 7-6(6),R32,86,9,4,37,68,27,37,12,31,6,8,9,39,68,1,7,34,67,21,34,12,33,2,7,10,33,67
2005-08-15 00:00:00.000,ATP Masters Series Cincinnati Ohio; USA ATP World Tour,HARD,2,Mikhail Youzhny,Tomas Berdych,Mikhail Youzhny,4-6; 7-6(4); 7-6(3),R32,139,8,1,55,97,48,55,27,42,1,2,17,75,97,15,6,74,126,55,74,31,52,4,4,17,86,126
2005-08-15 00:00:00.000,ATP Masters Series Cincinnati Ohio; USA ATP World Tour,HARD,2,Roger Federer,Olivier Rochus,Roger Federer,6-3; 6-4,R16,63,14,2,37,50,32,37,8,13,0,0,10,40,50,0,2,35,54,22,35,13,19,3,5,9,35,54
2005-08-15 00:00:00.000,ATP Masters Series Cincinnati Ohio; USA ATP World Tour,HARD,2,Jose Acasuso,Luis Horna,Jose Acasuso,7-6(5); 7-5,R16,99,16,0,39,63,35,39,17,24,0,0,12,52,63,10,3,54,85,44,54,11,31,3,4,12,55,85
2005-08-15 00:00:00.000,ATP Masters Series Cincinnati Ohio; USA ATP World Tour,HARD,2,Marat Safin,Dominik Hrbaty,Marat Safin,6-0; 6-3,R16,68,3,3,22,50,19,22,13,28,1,3,8,32,50,2,3,34,59,16,34,9,25,6,12,7,25,59
2005-08-15 00:00:00.000,ATP Masters Series Cincinnati Ohio; USA ATP World Tour,HARD,2,Robby Ginepri,Carlos Moya,Robby Ginepri,6-3; 6-4,R16,56,2,1,35,54,29,35,12,19,3,3,10,41,54,9,2,29,45,24,29,6,16,0,2,9,30,45
2005-08-15 00:00:00.000,ATP Masters Series Cincinnati Ohio; USA ATP World Tour,HARD,2,Nikolay Davydenko,Fernando Gonzalez,Nikolay Davydenko,6-3; 6-4,R16,72,8,3,43,62,33,43,10,19,6,7,10,43,62,4,2,25,50,19,25,12,25,4,7,9,31,50
2005-08-15 00:00:00.000,ATP Masters Series Cincinnati Ohio; USA ATP World Tour,HARD,2,Lleyton Hewitt,Mario Ancic,Lleyton Hewitt,6-1; 6-4,R16,61,9,0,24,47,21,24,16,23,1,1,9,37,47,8,1,31,46,21,31,4,15,3,6,8,25,46
2005-08-15 00:00:00.000,ATP Masters Series Cincinnati Ohio; USA ATP World Tour,HARD,2,Andy Roddick,Juan Ignacio Chela,Andy Roddick,7-6(4); 6-2,R16,87,14,3,39,70,33,39,17,31,2,2,10,50,70,7,1,41,75,29,41,15,34,2,4,10,44,75
2005-08-15 00:00:00.000,ATP Masters Series Cincinnati Ohio; USA ATP World Tour,HARD,2,Mikhail Youzhny,Gael Monfils,Mikhail Youzhny,4-6; 6-1; 6-1,R16,84,1,1,38,68,29,38,20,30,3,4,12,49,68,8,3,28,64,22,28,14,36,2,7,12,36,64
2005-08-15 00:00:00.000,ATP Masters Series Cincinnati Ohio; USA ATP World Tour,HARD,2,Roger Federer,Jose Acasuso,Roger Federer,6-4; 6-3,Q,76,7,1,38,60,27,38,16,22,2,3,10,43,60,6,0,27,59,20,27,13,32,4,7,9,33,59
2005-08-15 00:00:00.000,ATP Masters Series Cincinnati Ohio; USA ATP World Tour,HARD,2,Robby Ginepri,Marat Safin,Robby Ginepri,6-2; 6-3,Q,56,6,0,31,42,28,31,8,11,0,0,9,36,42,2,2,26,47,18,26,10,21,2,5,8,28,47
2005-08-15 00:00:00.000,ATP Masters Series Cincinnati Ohio; USA ATP World Tour,HARD,2,Lleyton Hewitt,Nikolay Davydenko,Lleyton Hewitt,6-2; 6-3,Q,67,3,1,27,45,21,27,13,18,1,2,9,34,45,4,0,32,56,16,32,12,24,3,7,8,28,56
2005-08-15 00:00:00.000,ATP Masters Series Cincinnati Ohio; USA ATP World Tour,HARD,2,Andy Roddick,Mikhail Youzhny,Andy Roddick,2-6; 6-3; 6-4,Q,88,14,6,50,72,42,50,9,22,0,2,14,51,72,10,1,45,71,36,45,13,26,0,2,13,49,71
2005-08-15 00:00:00.000,ATP Masters Series Cincinnati Ohio; USA ATP World Tour,HARD,2,Roger Federer,Robby Ginepri,Roger Federer,4-6; 7-5; 6-4,S,108,12,1,49,77,42,49,19,28,0,1,16,61,77,3,0,66,97,46,66,19,31,2,4,16,65,97
2005-08-15 00:00:00.000,ATP Masters Series Cincinnati Ohio; USA ATP World Tour,HARD,2,Andy Roddick,Lleyton Hewitt,Andy Roddick,6-4; 7-6(4),S,97,24,4,51,83,39,51,20,32,3,3,11,59,83,11,2,43,73,30,43,20,30,2,3,11,50,73
2005-08-15 00:00:00.000,ATP Masters Series Cincinnati Ohio; USA ATP World Tour,HARD,2,Roger Federer,Andy Roddick,Roger Federer,6-3; 7-5,F,75,5,1,32,50,28,32,10,18,1,2,10,38,50,11,1,33,59,24,33,12,26,2,6,11,36,59
2005-08-22 00:00:00.000,New Haven New Haven; CT; USA ATP World Tour,HARD,2,Nikolay Davydenko,N/A Bye,Nikolay Davydenko,,R64,0,0,0,0,0,0,0,0,0,0,0,0,0,0,0,0,0,0,0,0,0,0,0,0,0,0,0
2005-08-22 00:00:00.000,New Haven New Haven; CT; USA ATP World Tour,HARD,2,Juan Ignacio Chela,Marcos Baghdatis,Juan Ignacio Chela,6-2; 6-4,R64,68,2,0,29,50,21,29,16,21,0,0,9,37,50,2,1,35,55,22,35,11,20,5,8,9,33,55
2005-08-22 00:00:00.000,New Haven New Haven; CT; USA ATP World Tour,HARD,2,Fabrice Santoro,Kenneth Carlsen,Fabrice Santoro,6-3; 6-0,R64,63,6,1,34,50,25,34,10,16,2,2,8,35,50,2,2,19,39,14,19,4,20,0,4,7,18,39
2005-08-22 00:00:00.000,New Haven New Haven; CT; USA ATP World Tour,HARD,2,Paul-Henri Mathieu,N/A Bye,Paul-Henri Mathieu,,R64,0,0,0,0,0,0,0,0,0,0,0,0,0,0,0,0,0,0,0,0,0,0,0,0,0,0,0
2005-08-22 00:00:00.000,New Haven New Haven; CT; USA ATP World Tour,HARD,2,Filippo Volandri,N/A Bye,Filippo Volandri,,R64,0,0,0,0,0,0,0,0,0,0,0,0,0,0,0,0,0,0,0,0,0,0,0,0,0,0,0
2005-08-22 00:00:00.000,New Haven New Haven; CT; USA ATP World Tour,HARD,2,James Blake,Michael Llodra,James Blake,6-1; 6-4,R64,56,7,1,34,48,27,34,8,14,4,4,8,35,48,2,1,37,59,22,37,9,22,5,9,9,31,59
2005-08-22 00:00:00.000,New Haven New Haven; CT; USA ATP World Tour,HARD,2,Christophe Rochus,Alberto Martin,Christophe Rochus,7-5; 6-1,R64,73,1,4,26,59,18,26,17,33,3,5,9,35,59,1,3,33,60,18,33,10,27,5,11,10,28,60
2005-08-22 00:00:00.000,New Haven New Haven; CT; USA ATP World Tour,HARD,2,Tommy Haas,N/A Bye,Tommy Haas,,R64,0,0,0,0,0,0,0,0,0,0,0,0,0,0,0,0,0,0,0,0,0,0,0,0,0,0,0
2005-08-22 00:00:00.000,New Haven New Haven; CT; USA ATP World Tour,HARD,2,Tommy Robredo,N/A Bye,Tommy Robredo,,R64,0,0,0,0,0,0,0,0,0,0,0,0,0,0,0,0,0,0,0,0,0,0,0,0,0,0,0
2005-08-22 00:00:00.000,New Haven New Haven; CT; USA ATP World Tour,HARD,2,Scoville Jenkins,Jarkko Nieminen,Scoville Jenkins,2-6; 6-3; 6-4,R64,110,17,6,65,102,45,65,20,37,8,10,14,65,102,4,1,48,75,37,48,15,27,4,6,13,52,75
2005-08-22 00:00:00.000,New Haven New Haven; CT; USA ATP World Tour,HARD,2,Stefan Koubek,Bobby Reynolds,Stefan Koubek,6-3; 6-4,R64,70,8,1,46,67,35,46,11,21,5,6,10,46,67,6,2,40,62,27,40,7,22,2,5,9,34,62
2005-08-22 00:00:00.000,New Haven New Haven; CT; USA ATP World Tour,HARD,2,Gael Monfils,N/A Bye,Gael Monfils,,R64,0,0,0,0,0,0,0,0,0,0,0,0,0,0,0,0,0,0,0,0,0,0,0,0,0,0,0
2005-08-22 00:00:00.000,New Haven New Haven; CT; USA ATP World Tour,HARD,2,Ivo Minar,N/A Bye,Ivo Minar,,R64,0,0,0,0,0,0,0,0,0,0,0,0,0,0,0,0,0,0,0,0,0,0,0,0,0,0,0
2005-08-22 00:00:00.000,New Haven New Haven; CT; USA ATP World Tour,HARD,2,Victor Hanescu,Luis Horna,Victor Hanescu,6-7(4); 7-6(5); 7-6(5),R64,166,14,7,76,137,59,76,29,61,8,11,18,88,137,15,3,70,117,53,70,25,47,5,8,18,78,117
2005-08-22 00:00:00.000,New Haven New Haven; CT; USA ATP World Tour,HARD,2,Andy Ram,Ricardo Mello,Andy Ram,6-1; 6-4,R64,68,5,2,35,59,28,35,14,24,4,4,9,42,59,1,2,34,55,24,34,6,21,8,11,8,30,55
2005-08-22 00:00:00.000,New Haven New Haven; CT; USA ATP World Tour,HARD,2,Nicolas Massu,N/A Bye,Nicolas Massu,,R64,0,0,0,0,0,0,0,0,0,0,0,0,0,0,0,0,0,0,0,0,0,0,0,0,0,0,0
2005-08-22 00:00:00.000,New Haven New Haven; CT; USA ATP World Tour,HARD,2,Olivier Rochus,N/A Bye,Olivier Rochus,,R64,0,0,0,0,0,0,0,0,0,0,0,0,0,0,0,0,0,0,0,0,0,0,0,0,0,0,0
2005-08-22 00:00:00.000,New Haven New Haven; CT; USA ATP World Tour,HARD,2,Igor Andreev,Juan Monaco,Igor Andreev,6-3; 6-4,R64,78,2,4,37,63,28,37,15,26,4,5,10,43,63,0,5,38,58,24,38,10,20,1,4,9,34,58
2005-08-22 00:00:00.000,New Haven New Haven; CT; USA ATP World Tour,HARD,2,Philipp Kohlschreiber,Mardy Fish,Philipp Kohlschreiber,6-4; 6-4,R64,71,8,2,33,55,31,33,11,22,3,3,10,42,55,3,2,29,55,23,29,14,26,3,5,10,37,55
2005-08-22 00:00:00.000,New Haven New Haven; CT; USA ATP World Tour,HARD,2,Jurgen Melzer,N/A Bye,Jurgen Melzer,,R64,0,0,0,0,0,0,0,0,0,0,0,0,0,0,0,0,0,0,0,0,0,0,0,0,0,0,0
2005-08-22 00:00:00.000,New Haven New Haven; CT; USA ATP World Tour,HARD,2,Paradorn Srichaphan,N/A Bye,Paradorn Srichaphan,,R64,0,0,0,0,0,0,0,0,0,0,0,0,0,0,0,0,0,0,0,0,0,0,0,0,0,0,0
2005-08-22 00:00:00.000,New Haven New Haven; CT; USA ATP World Tour,HARD,2,Cyril Saulnier,Stanislas Wawrinka,Cyril Saulnier,6-3; 6-2,R64,67,2,0,31,51,25,31,14,20,2,2,9,39,51,4,2,24,50,14,24,15,26,3,6,8,29,50
2005-08-22 00:00:00.000,New Haven New Haven; CT; USA ATP World Tour,HARD,2,Tomas Zib,Gilles Muller,Tomas Zib,6-4; 3-6; 6-3,R64,100,3,3,45,80,37,45,18,35,3,5,14,55,80,12,5,51,86,35,51,19,35,3,6,14,54,86
2005-08-22 00:00:00.000,New Haven New Haven; CT; USA ATP World Tour,HARD,2,David Ferrer,N/A Bye,David Ferrer,,R64,0,0,0,0,0,0,0,0,0,0,0,0,0,0,0,0,0,0,0,0,0,0,0,0,0,0,0
2005-08-22 00:00:00.000,New Haven New Haven; CT; USA ATP World Tour,HARD,2,Feliciano Lopez,N/A Bye,Feliciano Lopez,,R64,0,0,0,0,0,0,0,0,0,0,0,0,0,0,0,0,0,0,0,0,0,0,0,0,0,0,0
2005-08-22 00:00:00.000,New Haven New Haven; CT; USA ATP World Tour,HARD,2,Davide Sanguinetti,Kevin Kim,Davide Sanguinetti,7-6(6); 6-3,R64,88,6,0,38,73,28,38,23,35,7,8,11,51,73,6,5,55,88,40,55,12,33,9,11,10,52,88
2005-08-22 00:00:00.000,New Haven New Haven; CT; USA ATP World Tour,HARD,2,Andreas Seppi,Dmitry Tursunov,Andreas Seppi,1-6; 6-3; 6-4,R64,100,6,4,41,81,29,41,20,40,8,11,13,49,81,8,5,38,82,32,38,20,44,4,7,13,52,82
2005-08-22 00:00:00.000,New Haven New Haven; CT; USA ATP World Tour,HARD,2,Vincent Spadea,N/A Bye,Vincent Spadea,,R64,0,0,0,0,0,0,0,0,0,0,0,0,0,0,0,0,0,0,0,0,0,0,0,0,0,0,0
2005-08-22 00:00:00.000,New Haven New Haven; CT; USA ATP World Tour,HARD,2,Robin Soderling,N/A Bye,Robin Soderling,,R64,0,0,0,0,0,0,0,0,0,0,0,0,0,0,0,0,0,0,0,0,0,0,0,0,0,0,0
2005-08-22 00:00:00.000,New Haven New Haven; CT; USA ATP World Tour,HARD,2,Fernando Verdasco,Jan Hernych,Fernando Verdasco,6-0; 6-4,R64,66,1,2,28,41,21,28,9,13,0,1,8,30,41,0,2,42,64,18,42,10,22,6,11,8,28,64
2005-08-22 00:00:00.000,New Haven New Haven; CT; USA ATP World Tour,HARD,2,Justin Gimelstob,Guillermo Garcia-Lopez,Justin Gimelstob,3-6; 7-5; 7-6(4),R64,132,17,7,56,102,47,56,25,46,4,6,17,72,102,2,4,48,92,36,48,29,44,2,3,16,65,92
2005-08-22 00:00:00.000,New Haven New Haven; CT; USA ATP World Tour,HARD,2,Fernando Gonzalez,N/A Bye,Fernando Gonzalez,,R64,0,0,0,0,0,0,0,0,0,0,0,0,0,0,0,0,0,0,0,0,0,0,0,0,0,0,0
2005-08-22 00:00:00.000,New Haven New Haven; CT; USA ATP World Tour,HARD,2,Juan Ignacio Chela,Nikolay Davydenko,Juan Ignacio Chela,6-1; 7-6(5),R32,79,4,1,40,63,31,40,11,23,0,2,10,42,63,2,2,39,60,23,39,10,21,5,9,9,33,60
2005-08-22 00:00:00.000,New Haven New Haven; CT; USA ATP World Tour,HARD,2,Fabrice Santoro,Paul-Henri Mathieu,Fabrice Santoro,6-4; 7-6(2),R32,110,5,0,51,87,32,51,21,36,7,9,11,53,87,6,4,46,70,31,46,9,24,6,9,11,40,70
2005-08-22 00:00:00.000,New Haven New Haven; CT; USA ATP World Tour,HARD,2,James Blake,Filippo Volandri,James Blake,6-1; 6-3,R32,45,6,0,26,39,23,26,9,13,0,0,8,32,39,2,2,22,42,10,22,9,20,0,4,8,19,42
2005-08-22 00:00:00.000,New Haven New Haven; CT; USA ATP World Tour,HARD,2,Tommy Haas,Christophe Rochus,Tommy Haas,6-2; 4-6; 6-0,R32,86,16,7,50,94,36,50,23,44,8,9,12,59,94,1,6,33,66,21,33,15,33,3,8,12,36,66
2005-08-22 00:00:00.000,New Haven New Haven; CT; USA ATP World Tour,HARD,2,Tommy Robredo,Scoville Jenkins,Tommy Robredo,6-2; 3-6; 6-4,R32,126,12,4,45,84,35,45,17,39,4,7,13,52,84,7,15,53,106,35,53,22,53,9,14,14,57,106
2005-08-22 00:00:00.000,New Haven New Haven; CT; USA ATP World Tour,HARD,2,Stefan Koubek,Gael Monfils,Stefan Koubek,4-6; 7-5; 7-5,R32,141,3,5,66,108,41,66,23,42,6,11,17,64,108,3,2,52,118,32,52,35,66,5,11,17,67,118
2005-08-22 00:00:00.000,New Haven New Haven; CT; USA ATP World Tour,HARD,2,Victor Hanescu,Ivo Minar,Victor Hanescu,6-3; 6-2,R32,56,13,0,38,57,31,38,11,19,3,3,9,42,57,4,1,27,50,17,27,12,23,2,5,8,29,50
2005-08-22 00:00:00.000,New Haven New Haven; CT; USA ATP World Tour,HARD,2,Nicolas Massu,Andy Ram,Nicolas Massu,6-4; 5-7; 7-5,R32,132,2,5,65,108,48,65,21,43,8,11,17,69,108,11,2,55,100,42,55,23,45,6,10,17,65,100
2005-08-22 00:00:00.000,New Haven New Haven; CT; USA ATP World Tour,HARD,2,Igor Andreev,Olivier Rochus,Igor Andreev,7-6(1); 7-6(2),R32,108,7,3,44,74,36,44,19,30,2,3,12,55,74,0,4,43,79,30,43,21,36,3,4,12,51,79
2005-08-22 00:00:00.000,New Haven New Haven; CT; USA ATP World Tour,HARD,2,Philipp Kohlschreiber,Jurgen Melzer,Philipp Kohlschreiber,6-4; 6-1,R32,59,8,1,24,40,19,24,10,16,0,1,8,29,40,2,3,34,52,17,34,7,18,3,8,9,24,52
2005-08-22 00:00:00.000,New Haven New Haven; CT; USA ATP World Tour,HARD,2,Paradorn Srichaphan,Cyril Saulnier,Paradorn Srichaphan,7-6(3); 7-6(5),R32,109,7,2,46,82,35,46,24,36,2,2,12,59,82,6,2,57,74,46,57,7,17,1,1,12,53,74
2005-08-22 00:00:00.000,New Haven New Haven; CT; USA ATP World Tour,HARD,2,David Ferrer,Tomas Zib,David Ferrer,6-3; 6-3,R32,69,8,0,38,53,29,38,7,15,1,2,9,36,53,2,1,31,54,16,31,13,23,3,7,9,29,54
2005-08-22 00:00:00.000,New Haven New Haven; CT; USA ATP World Tour,HARD,2,Feliciano Lopez,Davide Sanguinetti,Feliciano Lopez,6-4; 6-3,R32,64,8,2,46,66,33,46,10,20,5,5,9,43,66,3,1,34,61,24,34,13,27,3,6,10,37,61
2005-08-22 00:00:00.000,New Haven New Haven; CT; USA ATP World Tour,HARD,2,Vincent Spadea,Andreas Seppi,Vincent Spadea,6-3; 7-5,R32,84,6,3,52,83,36,52,17,31,7,8,11,53,83,0,0,32,56,24,32,10,24,1,4,10,34,56
2005-08-22 00:00:00.000,New Haven New Haven; CT; USA ATP World Tour,HARD,2,Fernando Verdasco,Robin Soderling,Fernando Verdasco,7-6(3); 7-6(4),R32,100,9,4,54,81,37,54,15,27,0,3,12,52,81,4,6,56,91,39,56,16,35,7,10,12,55,91
2005-08-22 00:00:00.000,New Haven New Haven; CT; USA ATP World Tour,HARD,2,Fernando Gonzalez,Justin Gimelstob,Fernando Gonzalez,6-2; 3-6; 6-4,R32,87,11,3,55,79,41,55,12,24,4,6,13,53,79,7,6,41,76,34,41,14,35,2,6,14,48,76
2005-08-22 00:00:00.000,New Haven New Haven; CT; USA ATP World Tour,HARD,2,Juan Ignacio Chela,Fabrice Santoro,Juan Ignacio Chela,6-4; 6-1,R16,71,0,0,27,49,18,27,16,22,1,1,8,34,49,1,0,29,53,14,29,16,24,3,7,9,30,53
2005-08-22 00:00:00.000,New Haven New Haven; CT; USA ATP World Tour,HARD,2,James Blake,Tommy Haas,James Blake,1-6; 6-3; 6-3,R16,84,7,1,46,69,33,46,13,23,3,5,12,46,69,16,5,45,76,37,45,11,31,4,7,13,48,76
2005-08-22 00:00:00.000,New Haven New Haven; CT; USA ATP World Tour,HARD,2,Tommy Robredo,Stefan Koubek,Tommy Robredo,6-2; 6-2,R16,60,3,4,20,42,19,20,14,22,1,1,8,33,42,2,4,37,63,20,37,11,26,8,12,8,31,63
2005-08-22 00:00:00.000,New Haven New Haven; CT; USA ATP World Tour,HARD,2,Victor Hanescu,Nicolas Massu,Victor Hanescu,6-4; 6-4,R16,90,2,1,35,55,27,35,15,20,1,1,10,42,55,6,5,43,75,32,43,16,32,5,7,10,48,75
2005-08-22 00:00:00.000,New Haven New Haven; CT; USA ATP World Tour,HARD,2,Igor Andreev,Philipp Kohlschreiber,Igor Andreev,6-2; 6-3,R16,70,6,2,33,58,24,33,16,25,5,5,9,40,58,3,4,21,43,15,21,10,22,2,5,8,25,43
2005-08-22 00:00:00.000,New Haven New Haven; CT; USA ATP World Tour,HARD,2,David Ferrer,Paradorn Srichaphan,David Ferrer,6-4; 6-2,R16,71,3,2,37,60,25,37,16,23,5,6,9,41,60,2,4,33,53,21,33,8,20,0,4,9,29,53
2005-08-22 00:00:00.000,New Haven New Haven; CT; USA ATP World Tour,HARD,2,Feliciano Lopez,Vincent Spadea,Feliciano Lopez,6-7(5); 6-3; 6-4,R16,106,12,4,67,104,52,67,20,37,2,3,16,72,104,11,4,58,94,43,58,20,36,3,6,15,63,94
2005-08-22 00:00:00.000,New Haven New Haven; CT; USA ATP World Tour,HARD,2,Fernando Verdasco,Fernando Gonzalez,Fernando Verdasco,6-7(3); 7-5; 7-6(3),R16,133,14,10,67,110,54,67,27,43,1,2,18,81,110,9,8,67,117,52,67,27,50,2,4,18,79,117
2005-08-22 00:00:00.000,New Haven New Haven; CT; USA ATP World Tour,HARD,2,James Blake,Juan Ignacio Chela,James Blake,7-6(4); 4-6; 6-3,Q,108,12,3,62,96,47,62,20,34,5,7,16,67,96,7,2,56,89,40,56,22,33,2,4,15,62,89
2005-08-22 00:00:00.000,New Haven New Haven; CT; USA ATP World Tour,HARD,2,Victor Hanescu,Tommy Robredo,Victor Hanescu,6-7(4); 6-4; 6-4,Q,132,7,3,91,122,62,91,20,31,13,13,16,82,122,10,6,63,102,52,63,18,39,3,5,16,70,102
2005-08-22 00:00:00.000,New Haven New Haven; CT; USA ATP World Tour,HARD,2,David Ferrer,Igor Andreev,David Ferrer,6-3; 6-4,Q,95,1,2,58,77,37,58,11,19,7,8,10,48,77,4,2,40,72,33,40,7,32,9,12,9,40,72
2005-08-22 00:00:00.000,New Haven New Haven; CT; USA ATP World Tour,HARD,2,Feliciano Lopez,Fernando Verdasco,Feliciano Lopez,6-4; 1-6; 6-2,Q,81,8,2,45,69,30,45,13,24,1,3,12,43,69,7,2,54,74,40,54,9,20,2,5,13,49,74
2005-08-22 00:00:00.000,New Haven New Haven; CT; USA ATP World Tour,HARD,2,James Blake,Victor Hanescu,James Blake,7-6(4); 6-7(3); 6-1,S,125,5,4,59,100,45,59,24,41,2,3,15,69,100,6,2,70,102,48,70,18,32,6,10,16,66,102
2005-08-22 00:00:00.000,New Haven New Haven; CT; USA ATP World Tour,HARD,2,Feliciano Lopez,David Ferrer,Feliciano Lopez,4-6; 6-3; 6-2,S,94,10,1,46,81,39,46,20,35,5,6,14,59,81,3,4,51,84,41,51,11,33,3,6,13,52,84
2005-08-22 00:00:00.000,New Haven New Haven; CT; USA ATP World Tour,HARD,2,James Blake,Feliciano Lopez,James Blake,3-6; 7-5; 6-1,F,98,7,2,39,73,33,39,20,34,2,4,14,53,73,10,2,58,88,40,58,14,30,6,10,14,54,88
2005-08-29 00:00:00.000,US Open NY; U.S.A. Grand Slams,HARD,3,Roger Federer,Ivo Minar,Roger Federer,6-1; 6-1; 6-1,R128,63,11,2,45,63,38,45,9,18,1,1,11,47,63,3,3,35,59,19,35,6,24,3,10,10,25,59
2005-08-29 00:00:00.000,US Open NY; U.S.A. Grand Slams,HARD,3,Fabrice Santoro,Jurgen Melzer,Fabrice Santoro,6-2; 6-1; 6-3,R128,105,9,0,45,75,35,45,15,30,7,9,12,50,75,0,4,51,88,26,51,13,37,8,16,12,39,88
2005-08-29 00:00:00.000,US Open NY; U.S.A. Grand Slams,HARD,3,Albert Montanes,Victor Hanescu,Albert Montanes,6-4; 3-6; 6-3; 2-1 RET,R128,113,7,1,53,95,39,53,24,42,1,3,15,63,95,9,8,52,94,40,52,21,42,5,9,16,61,94
2005-08-29 00:00:00.000,US Open NY; U.S.A. Grand Slams,HARD,3,Olivier Rochus,Robin Vik,Olivier Rochus,5-7; 6-2; 6-2; 6-2,R128,160,4,11,76,129,54,76,25,53,8,12,18,79,129,10,8,69,122,41,69,21,53,9,18,18,62,122
2005-08-29 00:00:00.000,US Open NY; U.S.A. Grand Slams,HARD,3,Arnaud Clement,Juan Carlos Ferrero,Arnaud Clement,7-5; 7-5; 6-1,R128,157,8,4,46,101,38,46,28,55,5,7,16,66,101,5,4,59,101,36,59,17,42,9,15,15,53,101
2005-08-29 00:00:00.000,US Open NY; U.S.A. Grand Slams,HARD,3,Andy Murray,Andrei Pavel,Andy Murray,6-3; 3-6; 3-6; 6-1; 6-4,R128,192,13,4,67,142,48,67,35,75,2,8,22,83,142,11,3,94,149,62,94,21,55,9,17,22,83,149
2005-08-29 00:00:00.000,US Open NY; U.S.A. Grand Slams,HARD,3,Nicolas Kiefer,Jiri Vanek,Nicolas Kiefer,6-4; 6-2; 6-3,R128,115,13,7,52,98,43,52,20,46,11,12,14,63,98,4,8,43,78,30,43,12,35,0,5,13,42,78
2005-08-29 00:00:00.000,US Open NY; U.S.A. Grand Slams,HARD,3,Radek Stepanek,Nicolas Lapentti,Radek Stepanek,7-5; 7-6(5); 6-1,R128,150,13,2,64,106,51,64,22,42,3,4,16,73,106,6,1,61,101,38,61,22,40,6,10,15,60,101
2005-08-29 00:00:00.000,US Open NY; U.S.A. Grand Slams,HARD,3,David Nalbandian,Alex Bogomolov Jr.,David Nalbandian,6-2; 7-5; 6-4,R128,138,5,3,57,99,36,57,22,42,6,10,15,58,99,4,5,66,104,39,66,12,38,14,22,15,51,104
2005-08-29 00:00:00.000,US Open NY; U.S.A. Grand Slams,HARD,3,Peter Wessels,Christophe Rochus,Peter Wessels,6-7(4); 6-3; 6-4; 6-4,R128,156,26,5,83,140,67,83,30,57,8,9,21,97,140,4,8,71,133,53,71,32,62,4,8,20,85,133
2005-08-29 00:00:00.000,US Open NY; U.S.A. Grand Slams,HARD,3,Dmitry Tursunov,Marcos Baghdatis,Dmitry Tursunov,6-4; 6-3; 6-7(7); 6-2,R128,158,12,5,62,114,49,62,35,52,2,3,19,84,114,9,2,68,130,52,68,29,62,7,13,20,81,130
2005-08-29 00:00:00.000,US Open NY; U.S.A. Grand Slams,HARD,3,Fernando Gonzalez,Wesley Moodie,Fernando Gonzalez,4-6; 6-4; 7-5; 7-5,R128,152,13,5,74,117,59,74,26,43,2,4,22,85,117,23,8,87,134,60,87,25,47,3,7,22,85,134
2005-08-29 00:00:00.000,US Open NY; U.S.A. Grand Slams,HARD,3,Carlos Moya,Michael Llodra,Carlos Moya,6-4; 6-4; 2-1 RET,R128,87,7,2,36,63,33,36,15,27,1,1,11,48,63,5,5,49,78,32,49,14,29,3,6,12,46,78
2005-08-29 00:00:00.000,US Open NY; U.S.A. Grand Slams,HARD,3,Davide Sanguinetti,Wayne Arthurs,Davide Sanguinetti,6-3; 6-3; 7-6(3),R128,98,12,3,45,84,40,45,26,39,2,2,15,66,84,11,5,50,94,37,50,22,44,4,7,15,59,94
2005-08-29 00:00:00.000,US Open NY; U.S.A. Grand Slams,HARD,3,Paradorn Srichaphan,Younes El Aynaoui,Paradorn Srichaphan,6-4; 6-3; 6-0,R128,100,6,4,41,78,32,41,25,37,2,2,13,57,78,1,6,44,75,30,44,12,31,5,10,12,42,75
2005-08-29 00:00:00.000,US Open NY; U.S.A. Grand Slams,HARD,3,Nikolay Davydenko,Tomas Zib,Nikolay Davydenko,6-2; 6-0; 6-4,R128,95,15,5,46,66,40,46,10,20,2,2,12,50,66,2,3,46,82,23,46,17,36,6,12,12,40,82
2005-08-29 00:00:00.000,US Open NY; U.S.A. Grand Slams,HARD,3,Lleyton Hewitt,Albert Costa,Lleyton Hewitt,6-1; 6-2; 6-1,R128,80,8,0,41,55,35,41,10,14,2,2,11,45,55,0,5,39,66,17,39,10,27,4,11,11,27,66
2005-08-29 00:00:00.000,US Open NY; U.S.A. Grand Slams,HARD,3,Jose Acasuso,Luis Horna,Jose Acasuso,4-6; 6-3; 6-4; 7-6(11),R128,220,17,5,71,136,62,71,38,65,2,3,21,100,136,13,8,93,148,71,93,24,55,6,8,20,95,148
2005-08-29 00:00:00.000,US Open NY; U.S.A. Grand Slams,HARD,3,Nicolas Almagro,Kenneth Carlsen,Nicolas Almagro,7-6(4); 7-5; 6-4,R128,178,11,6,64,117,48,64,30,53,7,8,17,78,117,7,6,63,117,46,63,27,54,4,7,17,73,117
2005-08-29 00:00:00.000,US Open NY; U.S.A. Grand Slams,HARD,3,Taylor Dent,Lars Burgsmuller,Taylor Dent,6-3; 3-6; 6-1; 6-4,R128,148,16,13,48,107,41,48,31,59,3,5,18,72,107,1,8,60,112,40,60,26,52,7,12,17,66,112
2005-08-29 00:00:00.000,US Open NY; U.S.A. Grand Slams,HARD,3,David Ferrer,Agustin Calleri,David Ferrer,4-6; 6-4; 6-7(4); 6-1; 6-1,R128,251,3,9,135,195,80,135,29,60,19,25,23,109,195,8,11,86,175,54,86,38,89,14,25,23,92,175
2005-08-29 00:00:00.000,US Open NY; U.S.A. Grand Slams,HARD,3,Karol Kucera,Mark Philippoussis,Karol Kucera,6-4; 6-2; 7-5,R128,116,10,2,47,76,37,47,22,29,2,3,15,59,76,9,7,51,88,32,51,18,37,3,8,15,50,88
2005-08-29 00:00:00.000,US Open NY; U.S.A. Grand Slams,HARD,3,Michael Lammer,Kevin Kim,Michael Lammer,3-6; 6-3; 7-5; 6-4,R128,157,3,3,74,129,49,74,34,55,7,10,20,83,129,9,2,78,115,57,78,18,37,6,11,20,75,115
2005-08-29 00:00:00.000,US Open NY; U.S.A. Grand Slams,HARD,3,Dominik Hrbaty,Andreas Seppi,Dominik Hrbaty,6-2; 6-4; 6-7(6); 6-2,R128,150,5,9,64,129,48,64,37,65,9,11,19,85,129,7,7,68,121,46,68,22,53,9,16,19,68,121
2005-08-29 00:00:00.000,US Open NY; U.S.A. Grand Slams,HARD,3,Fernando Verdasco,Tim Henman,Fernando Verdasco,6-4; 6-2; 6-2,R128,103,10,7,48,74,40,48,14,26,1,1,13,54,74,3,6,51,85,32,51,14,34,4,9,13,46,85
2005-08-29 00:00:00.000,US Open NY; U.S.A. Grand Slams,HARD,3,Paul Capdeville,Paul-Henri Mathieu,Paul Capdeville,6-2; 4-6; 7-5; 6-2,R128,153,14,1,65,118,47,65,27,53,4,8,19,74,118,3,4,44,92,26,44,25,48,5,13,19,51,92
2005-08-29 00:00:00.000,US Open NY; U.S.A. Grand Slams,HARD,3,Novak Djokovic,Gael Monfils,Novak Djokovic,7-5; 4-6; 7-6(5); 0-6; 7-5,R128,237,3,5,119,179,81,119,29,60,12,16,26,110,179,22,5,78,147,67,78,39,69,1,3,26,106,147
2005-08-29 00:00:00.000,US Open NY; U.S.A. Grand Slams,HARD,3,Mario Ancic,Hyung-Taik Lee,Mario Ancic,6-2; 6-1; 7-5,R128,130,13,0,50,80,42,50,15,30,1,2,14,57,80,3,2,72,103,40,72,14,31,7,13,13,54,103
2005-08-29 00:00:00.000,US Open NY; U.S.A. Grand Slams,HARD,3,Max Mirnyi,Justin Gimelstob,Max Mirnyi,6-2; 7-5; 6-2,R128,113,10,5,51,87,40,51,21,36,6,7,14,61,87,8,10,37,85,27,37,20,48,1,7,14,47,85
2005-08-29 00:00:00.000,US Open NY; U.S.A. Grand Slams,HARD,3,Florent Serra,Stefan Koubek,Florent Serra,6-1; 6-4; 4-6; 6-4,R128,145,1,3,60,100,46,60,24,40,2,4,18,70,100,6,2,74,123,51,74,19,49,8,14,19,70,123
2005-08-29 00:00:00.000,US Open NY; U.S.A. Grand Slams,HARD,3,Jarkko Nieminen,Karol Beck,Jarkko Nieminen,6-4; 2-6; 7-5; 0-6; 7-5,R128,194,3,5,83,154,47,83,40,71,19,28,24,87,154,16,7,68,149,47,68,42,81,11,18,24,89,149
2005-08-29 00:00:00.000,US Open NY; U.S.A. Grand Slams,HARD,3,Bjorn Phau,Alexander Popp,Bjorn Phau,6-1; 6-3; 6-3,R128,86,6,2,25,67,22,25,29,42,1,1,12,51,67,5,6,48,83,24,48,21,35,4,10,13,45,83
2005-08-29 00:00:00.000,US Open NY; U.S.A. Grand Slams,HARD,3,Guillermo Coria,Felix Mantilla,Guillermo Coria,7-6(5); 6-1; 6-3,R128,128,11,12,57,91,44,57,15,34,2,4,14,59,91,2,5,55,91,37,55,14,36,8,14,14,51,91
2005-08-29 00:00:00.000,US Open NY; U.S.A. Grand Slams,HARD,3,Vincent Spadea,Glenn Weiner,Vincent Spadea,6-4; 6-2; 6-0,R128,85,2,3,33,69,27,33,23,36,1,1,12,50,69,4,8,28,62,21,28,12,34,1,7,12,33,62
2005-08-29 00:00:00.000,US Open NY; U.S.A. Grand Slams,HARD,3,Robin Soderling,Juan Ignacio Chela,Robin Soderling,6-7(3); 7-6(4); 6-3; 6-4,R128,183,8,9,91,153,69,91,30,62,9,12,22,99,153,14,8,79,142,59,79,29,63,9,14,21,88,142
2005-08-29 00:00:00.000,US Open NY; U.S.A. Grand Slams,HARD,3,Feliciano Lopez,Filippo Volandri,Feliciano Lopez,6-2; 4-6; 7-6(5); 6-1,R128,138,15,6,59,107,48,59,21,48,4,9,18,69,107,3,8,67,112,39,67,21,45,7,16,19,60,112
2005-08-29 00:00:00.000,US Open NY; U.S.A. Grand Slams,HARD,3,Jiri Novak,Dick Norman,Jiri Novak,6-4; 6-4; 6-2,R128,89,6,1,53,88,42,53,19,35,11,12,14,61,88,15,8,52,83,31,52,15,31,6,11,14,46,83
2005-08-29 00:00:00.000,US Open NY; U.S.A. Grand Slams,HARD,3,Nicolas Massu,Jan-Michael Gambill,Nicolas Massu,7-6(4); 6-2; 6-3,R128,134,6,5,46,90,38,46,31,44,3,3,15,69,90,12,2,41,84,31,41,23,43,4,7,14,54,84
2005-08-29 00:00:00.000,US Open NY; U.S.A. Grand Slams,HARD,3,Stanislas Wawrinka,Rajeev Ram,Stanislas Wawrinka,2-6; 6-4; 7-6(6); 6-7(2); 7-5,R128,234,25,6,89,154,72,89,34,65,3,7,27,106,154,15,7,109,186,84,109,39,77,7,11,27,123,186
2005-08-29 00:00:00.000,US Open NY; U.S.A. Grand Slams,HARD,3,Mariano Puerta,Noam Okun,Mariano Puerta,7-6(4); 6-7(3); 6-4; 6-0,R128,173,12,2,83,118,61,83,27,35,4,6,20,88,118,9,5,88,132,58,88,22,44,4,10,20,80,132
2005-08-29 00:00:00.000,US Open NY; U.S.A. Grand Slams,HARD,3,Richard Gasquet,Alberto Martin,Richard Gasquet,6-2; 6-3; 1-6; 6-7(4); 6-4,R128,181,11,5,98,152,72,98,23,54,9,13,23,95,152,8,14,69,147,47,69,44,78,10,16,23,91,147
2005-08-29 00:00:00.000,US Open NY; U.S.A. Grand Slams,HARD,3,Giorgio Galimberti,Donald Young,Giorgio Galimberti,7-6(4); 6-1; 6-2,R128,111,11,3,55,94,40,55,20,39,6,9,14,60,94,0,8,73,111,38,73,17,38,6,13,13,55,111
2005-08-29 00:00:00.000,US Open NY; U.S.A. Grand Slams,HARD,3,Cyril Saulnier,Janko Tipsarevic,Cyril Saulnier,6-7(7); 7-6(3); 6-4; 6-3,R128,207,27,2,78,132,64,78,32,54,4,6,21,96,132,10,8,72,154,53,72,41,82,7,12,22,94,154
2005-08-29 00:00:00.000,US Open NY; U.S.A. Grand Slams,HARD,3,Ivan Ljubicic,Tobias Summerer,Ivan Ljubicic,6-3; 7-6(4); 6-3,R128,130,17,7,57,104,44,57,23,47,1,4,16,67,104,9,9,43,96,25,43,27,53,6,11,14,52,96
2005-08-29 00:00:00.000,US Open NY; U.S.A. Grand Slams,HARD,3,Tommy Haas,Peter Luczak,Tommy Haas,3-6; 6-3; 6-2; 6-3,R128,122,12,4,47,96,33,47,29,49,5,9,17,62,96,3,4,65,97,35,65,18,32,1,9,18,53,97
2005-08-29 00:00:00.000,US Open NY; U.S.A. Grand Slams,HARD,3,Rainer Schuettler,Potito Starace,Rainer Schuettler,6-1; 6-4; 1-6; 7-6(4),R128,155,2,5,63,106,40,63,30,43,2,5,18,70,106,7,8,58,110,43,58,22,52,4,8,18,65,110
2005-08-29 00:00:00.000,US Open NY; U.S.A. Grand Slams,HARD,3,Robby Ginepri,Guillermo Garcia-Lopez,Robby Ginepri,6-3; 6-2; 7-6(5),R128,106,8,2,58,91,45,58,20,33,3,4,15,65,91,7,6,49,91,34,49,20,42,7,11,14,54,91
2005-08-29 00:00:00.000,US Open NY; U.S.A. Grand Slams,HARD,3,Gilles Muller,Andy Roddick,Gilles Muller,7-6(4); 7-6(8); 7-6(1),R128,125,24,3,65,112,55,65,31,47,0,1,18,86,112,16,0,76,105,61,76,19,29,5,6,18,80,105
2005-08-29 00:00:00.000,US Open NY; U.S.A. Grand Slams,HARD,3,Andre Agassi,Razvan Sabau,Andre Agassi,6-3; 6-3; 6-1,R128,68,12,1,39,57,34,39,13,18,0,1,12,47,57,2,8,43,73,24,43,11,30,1,8,13,35,73
2005-08-29 00:00:00.000,US Open NY; U.S.A. Grand Slams,HARD,3,Ivo Karlovic,Mardy Fish,Ivo Karlovic,7-6(4); 6-3; 5-7; 7-6(4),R128,189,31,14,88,146,76,88,27,58,4,7,23,103,146,10,7,69,128,56,69,36,59,3,6,22,92,128
2005-08-29 00:00:00.000,US Open NY; U.S.A. Grand Slams,HARD,3,Ricardo Mello,Juan Monaco,Ricardo Mello,6-7(2); 6-2; 6-1; 6-4,R128,166,1,1,99,131,70,99,20,32,9,10,19,90,131,6,5,78,113,58,78,11,35,5,11,18,69,113
2005-08-29 00:00:00.000,US Open NY; U.S.A. Grand Slams,HARD,3,Tomas Berdych,Philipp Kohlschreiber,Tomas Berdych,7-6(6); 7-6(4); 6-4,R128,142,21,3,68,103,56,68,20,35,0,1,17,76,103,11,9,59,115,46,59,28,56,6,8,17,74,115
2005-08-29 00:00:00.000,US Open NY; U.S.A. Grand Slams,HARD,3,Mikhail Youzhny,Florian Mayer,Mikhail Youzhny,6-1; 6-0; 6-2,R128,70,7,2,29,56,23,29,19,27,1,2,11,42,56,0,4,32,66,16,32,8,34,3,11,10,24,66
2005-08-29 00:00:00.000,US Open NY; U.S.A. Grand Slams,HARD,3,Jonas Bjorkman,Tomas Behrend,Jonas Bjorkman,6-3; 6-3; 6-0,R128,98,4,5,42,80,29,42,23,38,3,5,12,52,80,3,5,51,88,27,51,11,37,10,18,12,38,88
2005-08-29 00:00:00.000,US Open NY; U.S.A. Grand Slams,HARD,3,Xavier Malisse,Jan Hernych,Xavier Malisse,6-2; 7-5; 6-2,R128,110,7,2,47,97,34,47,30,50,6,7,14,64,97,3,4,47,79,27,47,15,32,3,9,14,42,79
2005-08-29 00:00:00.000,US Open NY; U.S.A. Grand Slams,HARD,3,Brian Baker,Gaston Gaudio,Brian Baker,7-6(9); 6-2; 6-4,R128,147,5,6,64,105,48,64,25,41,6,7,15,73,105,8,5,68,115,47,68,25,47,9,13,15,72,115
2005-08-29 00:00:00.000,US Open NY; U.S.A. Grand Slams,HARD,3,Thomas Johansson,Mariano Zabaleta,Thomas Johansson,6-3; 6-4; 6-3,R128,107,10,4,31,68,28,31,28,37,0,0,14,56,68,12,10,60,112,43,60,21,52,12,16,14,64,112
2005-08-29 00:00:00.000,US Open NY; U.S.A. Grand Slams,HARD,3,Sebastien Grosjean,Oscar Hernandez,Sebastien Grosjean,6-2; 6-3; 6-2,R128,102,6,0,33,68,27,33,25,35,1,2,13,52,68,2,2,45,77,26,45,12,32,4,10,12,38,77
2005-08-29 00:00:00.000,US Open NY; U.S.A. Grand Slams,HARD,3,Gustavo Kuerten,Paul Goldstein,Gustavo Kuerten,6-2; 6-7(5); 6-3; 7-6(3),R128,179,35,7,75,151,65,75,39,76,7,7,21,104,151,4,6,75,144,56,75,34,69,15,18,20,90,144
2005-08-29 00:00:00.000,US Open NY; U.S.A. Grand Slams,HARD,3,Tommy Robredo,Daniele Bracciali,Tommy Robredo,3-6; 6-3; 6-4; 6-2,R128,151,9,6,68,125,46,68,35,57,6,8,18,81,125,9,3,60,117,42,60,31,57,7,12,18,73,117
2005-08-29 00:00:00.000,US Open NY; U.S.A. Grand Slams,HARD,3,James Blake,Greg Rusedski,James Blake,7-5; 7-6(3); 6-3,R128,112,7,4,53,96,43,53,27,43,3,4,17,70,96,13,1,59,87,41,59,19,28,6,9,16,60,87
2005-08-29 00:00:00.000,US Open NY; U.S.A. Grand Slams,HARD,3,Igor Andreev,Gilles Elseneer,Igor Andreev,6-4; 6-4; 6-2,R128,120,4,1,51,79,35,51,18,28,3,6,14,53,79,8,2,62,101,36,62,14,39,5,12,14,50,101
2005-08-29 00:00:00.000,US Open NY; U.S.A. Grand Slams,HARD,3,Scoville Jenkins,George Bastl,Scoville Jenkins,7-6(4); 6-0; 6-7(1); 4-6; 7-6(5),R128,269,11,10,112,181,77,112,35,69,10,16,26,112,181,8,10,119,192,80,119,34,73,15,23,26,114,192
2005-08-29 00:00:00.000,US Open NY; U.S.A. Grand Slams,HARD,3,Rafael Nadal,Bobby Reynolds,Rafael Nadal,6-3; 6-3; 6-4,R128,109,9,1,47,67,43,47,14,20,2,2,14,57,67,9,5,52,95,40,52,16,43,7,11,14,56,95
2005-08-29 00:00:00.000,US Open NY; U.S.A. Grand Slams,HARD,3,Roger Federer,Fabrice Santoro,Roger Federer,7-5; 7-5; 7-6(2),R64,137,9,3,76,111,61,76,18,35,4,6,18,79,111,5,0,78,120,48,78,24,42,6,10,18,72,120
2005-08-29 00:00:00.000,US Open NY; U.S.A. Grand Slams,HARD,3,Olivier Rochus,Albert Montanes,Olivier Rochus,4-6; 6-2; 6-1; 6-3,R64,116,5,5,55,94,41,55,20,39,4,8,17,61,94,9,7,55,98,36,55,12,43,3,12,17,48,98
2005-08-29 00:00:00.000,US Open NY; U.S.A. Grand Slams,HARD,3,Arnaud Clement,Andy Murray,Arnaud Clement,6-2; 7-6(2); 2-6; 6-7(4); 6-0,R64,241,8,4,91,169,65,91,45,78,6,9,23,110,169,26,14,83,157,62,83,33,74,13,19,23,95,157
2005-08-29 00:00:00.000,US Open NY; U.S.A. Grand Slams,HARD,3,Nicolas Kiefer,Radek Stepanek,Nicolas Kiefer,4-6; 4-6; 6-4; 6-3; 6-3,R64,209,14,4,75,147,57,75,43,72,7,9,24,100,147,10,7,82,149,61,82,36,67,13,17,24,97,149
2005-08-29 00:00:00.000,US Open NY; U.S.A. Grand Slams,HARD,3,David Nalbandian,Peter Wessels,David Nalbandian,7-6(4); 1-6; 6-2; 7-6(4),R64,167,8,2,72,128,44,72,34,56,7,14,20,78,128,7,8,69,138,55,69,24,69,10,16,19,79,138
2005-08-29 00:00:00.000,US Open NY; U.S.A. Grand Slams,HARD,3,Fernando Gonzalez,Dmitry Tursunov,Fernando Gonzalez,6-4; 3-6; 6-4; 6-3,R64,132,12,5,66,108,52,66,22,42,2,5,19,74,108,6,4,68,121,44,68,30,53,6,11,19,74,121
2005-08-29 00:00:00.000,US Open NY; U.S.A. Grand Slams,HARD,3,Davide Sanguinetti,Carlos Moya,Davide Sanguinetti,3-6; 6-1; 6-2; 6-4,R64,134,11,1,71,116,48,71,22,45,7,11,17,70,116,3,4,61,114,36,61,23,53,6,14,17,59,114
2005-08-29 00:00:00.000,US Open NY; U.S.A. Grand Slams,HARD,3,Paradorn Srichaphan,Nikolay Davydenko,Paradorn Srichaphan,6-4; 7-5; 6-3,R64,140,9,3,59,91,44,59,19,32,6,8,16,63,91,7,2,77,111,48,77,16,34,12,17,15,64,111
2005-08-29 00:00:00.000,US Open NY; U.S.A. Grand Slams,HARD,3,Lleyton Hewitt,Jose Acasuso,Lleyton Hewitt,7-6(6); 7-6(3); 6-2,R64,150,10,3,65,115,54,65,24,50,5,7,16,78,115,11,6,51,111,37,51,29,60,4,8,16,66,111
2005-08-29 00:00:00.000,US Open NY; U.S.A. Grand Slams,HARD,3,Taylor Dent,Nicolas Almagro,Taylor Dent,6-3; 6-2; 4-6; 7-5,R64,153,17,9,56,113,43,56,34,57,1,4,20,77,113,11,7,84,150,55,84,30,66,10,16,19,85,150
2005-08-29 00:00:00.000,US Open NY; U.S.A. Grand Slams,HARD,3,David Ferrer,Karol Kucera,David Ferrer,6-3; 6-0; 6-2,R64,98,3,3,59,78,42,59,14,19,10,10,12,56,78,3,3,43,76,19,43,17,33,13,19,11,36,76
2005-08-29 00:00:00.000,US Open NY; U.S.A. Grand Slams,HARD,3,Dominik Hrbaty,Michael Lammer,Dominik Hrbaty,6-1; 6-1; 6-3,R64,92,6,1,42,63,34,42,10,21,2,3,11,44,63,1,6,34,78,15,34,17,44,4,12,12,32,78
2005-08-29 00:00:00.000,US Open NY; U.S.A. Grand Slams,HARD,3,Fernando Verdasco,Paul Capdeville,Fernando Verdasco,6-4; 6-2; 7-5,R64,131,5,11,69,98,59,69,9,29,11,12,15,68,98,2,4,62,107,38,62,22,45,6,11,15,60,107
2005-08-29 00:00:00.000,US Open NY; U.S.A. Grand Slams,HARD,3,Novak Djokovic,Mario Ancic,Novak Djokovic,6-3; 5-7; 7-6(4); 6-3,R64,207,6,4,85,138,64,85,26,53,3,7,22,90,138,8,3,88,133,64,88,20,45,8,13,20,84,133
2005-08-29 00:00:00.000,US Open NY; U.S.A. Grand Slams,HARD,3,Max Mirnyi,Florent Serra,Max Mirnyi,7-6(5); 6-7(4); 6-4; 7-6(4),R64,171,26,11,75,144,62,75,37,69,4,7,23,99,144,10,4,87,145,64,87,31,58,2,6,23,95,145
2005-08-29 00:00:00.000,US Open NY; U.S.A. Grand Slams,HARD,3,Jarkko Nieminen,Bjorn Phau,Jarkko Nieminen,6-2; 6-4; 5-7; 6-4,R64,151,0,3,69,118,50,69,27,49,3,7,20,77,118,5,11,64,122,49,64,21,58,7,14,20,70,122
2005-08-29 00:00:00.000,US Open NY; U.S.A. Grand Slams,HARD,3,Guillermo Coria,Vincent Spadea,Guillermo Coria,6-2; 6-3; 6-2,R64,110,3,4,42,77,34,42,16,35,5,7,12,50,77,2,3,41,84,25,41,13,43,8,16,13,38,84
2005-08-29 00:00:00.000,US Open NY; U.S.A. Grand Slams,HARD,3,Robin Soderling,Feliciano Lopez,Robin Soderling,6-2; 6-2; 7-6(6),R64,101,7,3,54,87,43,54,22,33,4,4,14,65,87,10,4,51,97,38,51,20,46,7,11,14,58,97
2005-08-29 00:00:00.000,US Open NY; U.S.A. Grand Slams,HARD,3,Nicolas Massu,Jiri Novak,Nicolas Massu,W/O,R64,0,0,0,0,0,0,0,0,0,0,0,0,0,0,0,0,0,0,0,0,0,0,0,0,0,0,0
2005-08-29 00:00:00.000,US Open NY; U.S.A. Grand Slams,HARD,3,Stanislas Wawrinka,Mariano Puerta,Stanislas Wawrinka,3-6; 6-4; 6-3; 6-7(4); 6-1,R64,198,24,13,89,149,73,89,28,60,5,8,24,101,149,4,8,109,166,70,109,29,57,13,19,23,99,166
2005-08-29 00:00:00.000,US Open NY; U.S.A. Grand Slams,HARD,3,Richard Gasquet,Giorgio Galimberti,Richard Gasquet,6-1; 3-6; 6-3; 3-2 RET,R64,102,5,2,59,78,45,59,13,19,2,4,15,58,78,2,3,59,95,35,59,19,36,3,8,15,54,95
2005-08-29 00:00:00.000,US Open NY; U.S.A. Grand Slams,HARD,3,Ivan Ljubicic,Cyril Saulnier,Ivan Ljubicic,7-6(5); 5-7; 6-4; 6-4,R64,177,33,4,89,131,74,89,27,42,10,11,22,101,131,10,3,78,135,57,78,38,57,7,9,22,95,135
2005-08-29 00:00:00.000,US Open NY; U.S.A. Grand Slams,HARD,3,Tommy Haas,Rainer Schuettler,Tommy Haas,7-6(5); 6-2; 6-0,R64,115,15,2,39,75,33,39,24,36,2,3,13,57,75,10,7,57,108,38,57,19,51,5,11,13,57,108
2005-08-29 00:00:00.000,US Open NY; U.S.A. Grand Slams,HARD,3,Robby Ginepri,Gilles Muller,Robby Ginepri,6-1; 6-1; 6-4,R64,79,5,0,35,64,28,35,22,29,4,4,12,50,64,5,1,38,69,22,38,13,31,4,10,12,35,69
2005-08-29 00:00:00.000,US Open NY; U.S.A. Grand Slams,HARD,3,Andre Agassi,Ivo Karlovic,Andre Agassi,7-6(4); 7-6(5); 7-6(4),R64,148,5,1,92,115,72,92,16,23,1,2,18,88,115,28,7,93,139,74,93,21,46,10,11,18,95,139
2005-08-29 00:00:00.000,US Open NY; U.S.A. Grand Slams,HARD,3,Tomas Berdych,Ricardo Mello,Tomas Berdych,6-3; 6-2; 6-0,R64,89,13,3,33,74,29,33,25,41,4,4,12,54,74,2,4,42,71,24,42,9,29,4,10,11,33,71
2005-08-29 00:00:00.000,US Open NY; U.S.A. Grand Slams,HARD,3,Mikhail Youzhny,Jonas Bjorkman,Mikhail Youzhny,6-4; 6-4; 6-3,R64,110,5,2,44,81,37,44,19,37,3,5,14,56,81,4,4,44,92,34,44,19,48,10,16,15,53,92
2005-08-29 00:00:00.000,US Open NY; U.S.A. Grand Slams,HARD,3,Xavier Malisse,Brian Baker,Xavier Malisse,6-7(5); 6-2; 6-3; 6-4,R64,162,21,7,89,142,73,89,26,53,12,12,20,99,142,9,3,74,127,50,74,31,53,8,12,19,81,127
2005-08-29 00:00:00.000,US Open NY; U.S.A. Grand Slams,HARD,3,Sebastien Grosjean,Thomas Johansson,Sebastien Grosjean,6-3; 6-2; 4-6; 6-2,R64,140,10,1,50,98,41,50,32,48,2,3,18,73,98,2,4,55,95,37,55,22,40,1,6,17,59,95
2005-08-29 00:00:00.000,US Open NY; U.S.A. Grand Slams,HARD,3,Tommy Robredo,Gustavo Kuerten,Tommy Robredo,5-7; 7-6(3); 6-3; 6-2,R64,163,15,6,81,124,69,81,25,43,4,5,21,94,124,9,3,64,139,49,64,40,75,11,14,20,89,139
2005-08-29 00:00:00.000,US Open NY; U.S.A. Grand Slams,HARD,3,James Blake,Igor Andreev,James Blake,6-2; 6-2; 6-4,R64,96,7,3,45,71,38,45,15,26,0,0,13,53,71,3,3,63,93,40,63,12,30,8,13,13,52,93
2005-08-29 00:00:00.000,US Open NY; U.S.A. Grand Slams,HARD,3,Rafael Nadal,Scoville Jenkins,Rafael Nadal,6-4; 7-5; 6-4,R64,146,4,2,52,80,40,52,23,28,5,6,16,63,80,5,8,68,117,45,68,24,49,9,13,16,69,117
2005-08-29 00:00:00.000,US Open NY; U.S.A. Grand Slams,HARD,3,Roger Federer,Olivier Rochus,Roger Federer,6-3; 7-6(6); 6-2,R32,114,10,2,66,95,56,66,13,29,1,2,15,69,95,2,3,62,97,38,62,19,35,4,8,14,57,97
2005-08-29 00:00:00.000,US Open NY; U.S.A. Grand Slams,HARD,3,Nicolas Kiefer,Arnaud Clement,Nicolas Kiefer,6-4; 6-7(5); 6-4; 6-1,R32,187,19,6,71,123,56,71,26,52,4,7,20,82,123,5,8,69,123,46,69,23,54,5,12,19,69,123
2005-08-29 00:00:00.000,US Open NY; U.S.A. Grand Slams,HARD,3,David Nalbandian,Fernando Gonzalez,David Nalbandian,7-5; 6-3; 6-0,R32,114,5,3,59,90,42,59,18,31,7,9,14,60,90,3,8,39,86,23,39,20,47,5,12,13,43,86
2005-08-29 00:00:00.000,US Open NY; U.S.A. Grand Slams,HARD,3,Davide Sanguinetti,Paradorn Srichaphan,Davide Sanguinetti,6-3; 4-6; 6-7(2); 7-6(6); 7-6(5),R32,263,9,2,128,191,91,128,30,63,11,17,27,121,191,11,8,104,184,73,104,39,80,7,14,28,112,184
2005-08-29 00:00:00.000,US Open NY; U.S.A. Grand Slams,HARD,3,Lleyton Hewitt,Taylor Dent,Lleyton Hewitt,6-3; 3-6; 6-7(2); 6-2; 7-5,R32,200,7,8,80,161,59,80,41,81,4,9,25,100,161,19,10,85,157,60,85,31,72,8,16,25,91,157
2005-08-29 00:00:00.000,US Open NY; U.S.A. Grand Slams,HARD,3,Dominik Hrbaty,David Ferrer,Dominik Hrbaty,6-7(7); 7-5; 7-5; 7-5,R32,187,13,10,76,138,60,76,32,62,3,7,24,92,138,3,6,107,170,67,107,31,63,13,20,24,98,170
2005-08-29 00:00:00.000,US Open NY; U.S.A. Grand Slams,HARD,3,Fernando Verdasco,Novak Djokovic,Fernando Verdasco,6-1; 4-6; 6-7(2); 6-4; 6-4,R32,184,13,13,90,148,69,90,29,58,7,11,24,98,148,5,3,106,154,66,106,26,48,6,14,25,92,154
2005-08-29 00:00:00.000,US Open NY; U.S.A. Grand Slams,HARD,3,Jarkko Nieminen,Max Mirnyi,Jarkko Nieminen,6-3; 7-6(5); 3-6; 6-3,R32,146,3,1,87,115,65,87,19,28,4,5,19,84,115,22,8,84,132,60,84,27,48,9,12,20,87,132
2005-08-29 00:00:00.000,US Open NY; U.S.A. Grand Slams,HARD,3,Guillermo Coria,Robin Soderling,Guillermo Coria,6-2; 6-7(4); 6-1; 6-4,R32,161,9,6,95,128,68,95,19,33,3,3,19,87,128,14,9,92,146,61,92,22,54,7,12,18,83,146
2005-08-29 00:00:00.000,US Open NY; U.S.A. Grand Slams,HARD,3,Nicolas Massu,Stanislas Wawrinka,Nicolas Massu,6-4; 6-3; 6-0,R32,144,1,2,61,98,40,61,19,37,12,14,12,59,98,4,4,46,80,23,46,15,34,5,13,13,38,80
2005-08-29 00:00:00.000,US Open NY; U.S.A. Grand Slams,HARD,3,Richard Gasquet,Ivan Ljubicic,Richard Gasquet,3-6; 7-6(6); 6-7(7); 6-3; 6-2,R32,227,6,5,125,172,90,125,22,47,7,10,25,112,172,21,3,102,166,69,102,36,64,8,13,25,105,166
2005-08-29 00:00:00.000,US Open NY; U.S.A. Grand Slams,HARD,3,Robby Ginepri,Tommy Haas,Robby Ginepri,7-5; 6-7(3); 6-4; 2-6; 6-3,R32,198,20,4,92,163,66,92,36,71,9,14,26,102,163,9,7,80,150,56,80,39,70,7,13,25,95,150
2005-08-29 00:00:00.000,US Open NY; U.S.A. Grand Slams,HARD,3,Andre Agassi,Tomas Berdych,Andre Agassi,3-6; 6-1; 6-4; 7-6(2),R32,149,14,7,75,133,51,75,35,58,5,7,19,86,133,11,3,72,121,50,72,26,49,5,9,19,76,121
2005-08-29 00:00:00.000,US Open NY; U.S.A. Grand Slams,HARD,3,Xavier Malisse,Mikhail Youzhny,Xavier Malisse,5-7; 1-6; 6-1; 7-5; 7-6(1),R32,177,14,4,93,152,72,93,28,59,7,12,25,100,152,6,3,73,150,52,73,44,77,9,14,25,96,150
2005-08-29 00:00:00.000,US Open NY; U.S.A. Grand Slams,HARD,3,Tommy Robredo,Sebastien Grosjean,Tommy Robredo,6-4; 7-5; 6-7(3); 7-6(3),R32,201,7,5,100,151,73,100,31,51,6,8,23,104,151,7,2,73,145,57,73,39,72,4,8,23,96,145
2005-08-29 00:00:00.000,US Open NY; U.S.A. Grand Slams,HARD,3,James Blake,Rafael Nadal,James Blake,6-4; 4-6; 6-3; 6-1,R32,145,10,3,74,115,56,74,21,41,8,10,18,77,115,3,4,79,102,48,79,10,23,1,7,18,58,102
2005-08-29 00:00:00.000,US Open NY; U.S.A. Grand Slams,HARD,3,Roger Federer,Nicolas Kiefer,Roger Federer,6-4; 6-7(3); 6-3; 6-4,R16,180,7,4,81,133,58,81,31,52,4,6,21,89,133,12,11,71,131,52,71,29,60,6,11,20,81,131
2005-08-29 00:00:00.000,US Open NY; U.S.A. Grand Slams,HARD,3,David Nalbandian,Davide Sanguinetti,David Nalbandian,4-6; 7-6(4); 6-4; 6-2,R16,177,8,9,79,133,58,79,26,54,6,9,20,84,133,6,3,81,138,52,81,31,57,9,14,20,83,138
2005-08-29 00:00:00.000,US Open NY; U.S.A. Grand Slams,HARD,3,Lleyton Hewitt,Dominik Hrbaty,Lleyton Hewitt,6-1; 6-4; 6-2,R16,93,12,2,48,84,36,48,17,36,3,6,13,53,84,2,4,38,71,21,38,9,33,4,12,12,30,71
2005-08-29 00:00:00.000,US Open NY; U.S.A. Grand Slams,HARD,3,Jarkko Nieminen,Fernando Verdasco,Jarkko Nieminen,6-2; 7-6(6); 6-3,R16,109,1,0,66,100,47,66,23,34,2,2,15,70,100,8,8,67,93,45,67,12,26,5,8,14,57,93
2005-08-29 00:00:00.000,US Open NY; U.S.A. Grand Slams,HARD,3,Guillermo Coria,Nicolas Massu,Guillermo Coria,6-4; 2-6; 6-7(5); 6-2; 6-2,R16,272,8,20,90,148,62,90,30,58,3,9,23,92,148,5,9,95,175,59,95,36,80,18,27,23,95,175
2005-08-29 00:00:00.000,US Open NY; U.S.A. Grand Slams,HARD,3,Robby Ginepri,Richard Gasquet,Robby Ginepri,6-3; 3-6; 6-7(8); 6-4; 6-0,R16,177,15,2,91,141,69,91,29,50,3,5,23,98,141,4,5,115,161,69,115,29,46,10,16,23,98,161
2005-08-29 00:00:00.000,US Open NY; U.S.A. Grand Slams,HARD,3,Andre Agassi,Xavier Malisse,Andre Agassi,6-3; 6-4; 6-7(5); 4-6; 6-2,R16,174,11,5,94,147,71,94,29,53,4,6,25,100,147,26,4,88,152,63,88,35,64,7,12,24,98,152
2005-08-29 00:00:00.000,US Open NY; U.S.A. Grand Slams,HARD,3,James Blake,Tommy Robredo,James Blake,4-6; 7-5; 6-2; 6-3,R16,140,5,3,64,109,49,64,26,45,3,6,19,75,109,3,7,76,123,47,76,21,47,8,15,20,68,123
2005-08-29 00:00:00.000,US Open NY; U.S.A. Grand Slams,HARD,3,Roger Federer,David Nalbandian,Roger Federer,6-2; 6-4; 6-1,Q,99,11,0,40,74,32,40,18,34,3,5,13,50,74,0,6,42,75,23,42,11,33,4,11,12,34,75
2005-08-29 00:00:00.000,US Open NY; U.S.A. Grand Slams,HARD,3,Lleyton Hewitt,Jarkko Nieminen,Lleyton Hewitt,2-6; 6-1; 3-6; 6-3; 6-1,Q,144,6,5,65,109,53,65,23,44,4,7,20,76,109,8,1,87,135,55,87,25,48,11,17,20,80,135
2005-08-29 00:00:00.000,US Open NY; U.S.A. Grand Slams,HARD,3,Robby Ginepri,Guillermo Coria,Robby Ginepri,4-6; 6-1; 7-5; 3-6; 7-5,Q,181,9,5,90,146,64,90,27,56,3,9,25,91,146,11,14,87,147,59,87,31,60,12,20,25,90,147
2005-08-29 00:00:00.000,US Open NY; U.S.A. Grand Slams,HARD,3,Andre Agassi,James Blake,Andre Agassi,3-6; 3-6; 6-3; 6-3; 7-6(6),Q,170,11,3,105,163,67,105,31,58,10,17,24,98,163,19,5,91,155,60,91,31,64,6,13,24,91,155
2005-08-29 00:00:00.000,US Open NY; U.S.A. Grand Slams,HARD,3,Roger Federer,Lleyton Hewitt,Roger Federer,6-3; 7-6(0); 4-6; 6-3,S,178,8,2,91,150,62,91,34,59,10,13,21,96,150,6,8,69,140,53,69,28,71,11,15,19,81,140
2005-08-29 00:00:00.000,US Open NY; U.S.A. Grand Slams,HARD,3,Andre Agassi,Robby Ginepri,Andre Agassi,6-4; 5-7; 6-3; 4-6; 6-3,S,164,17,3,88,152,67,88,34,64,12,16,25,101,152,17,3,99,158,66,99,34,59,7,13,25,100,158
2005-08-29 00:00:00.000,US Open NY; U.S.A. Grand Slams,HARD,3,Roger Federer,Andre Agassi,Roger Federer,6-3; 2-6; 7-6(1); 6-1,F,139,19,0,81,107,60,81,15,26,3,6,19,75,107,6,4,78,131,45,78,29,53,14,18,17,74,131
2005-09-12 00:00:00.000,Beijing China ATP World Tour,HARD,2,Rafael Nadal,Jimmy Wang,Rafael Nadal,6-2; 6-4,R32,88,2,3,38,61,25,38,11,23,3,5,9,36,61,1,2,53,75,30,53,8,22,11,16,9,38,75
2005-09-12 00:00:00.000,Beijing China ATP World Tour,HARD,2,Justin Gimelstob,Roko Karanusic,Justin Gimelstob,6-4; 6-1,R32,61,4,3,27,43,21,27,12,16,0,0,8,33,43,1,2,33,50,19,33,7,17,2,6,9,26,50
2005-09-12 00:00:00.000,Beijing China ATP World Tour,HARD,2,Peter Wessels,Wayne Arthurs,Peter Wessels,7-6(5); 6-4,R32,73,12,0,41,64,33,41,18,23,1,1,11,51,64,13,10,43,72,35,43,15,29,4,5,11,50,72
2005-09-12 00:00:00.000,Beijing China ATP World Tour,HARD,2,Yu Jr. Wang,Luka Gregorc,Yu Jr. Wang,7-6(5); 6-1,R32,91,1,1,45,59,34,45,9,14,1,1,10,43,59,4,7,36,68,28,36,10,32,5,7,9,38,68
2005-09-12 00:00:00.000,Beijing China ATP World Tour,HARD,2,David Nalbandian,Kristian Pless,David Nalbandian,6-3; 7-6(2),R32,81,3,2,46,75,37,46,15,29,5,6,11,52,75,6,3,37,64,25,37,14,27,3,5,10,39,64
2005-09-12 00:00:00.000,Beijing China ATP World Tour,HARD,2,Amir Hadad,Dick Norman,Amir Hadad,7-5; 7-6(7),R32,80,4,0,66,75,48,66,7,9,1,2,12,55,75,11,3,53,67,41,53,7,14,0,2,12,48,67
2005-09-12 00:00:00.000,Beijing China ATP World Tour,HARD,2,Dmitry Tursunov,Lars Burgsmuller,Dmitry Tursunov,6-3; 6-4,R32,79,7,7,27,59,23,27,15,32,1,3,10,38,59,3,3,27,61,20,27,13,34,3,7,9,33,61
2005-09-12 00:00:00.000,Beijing China ATP World Tour,HARD,2,Juan Carlos Ferrero,Hyung-Taik Lee,Juan Carlos Ferrero,4-6; 6-3; 7-5,R32,128,3,3,53,81,39,53,20,28,3,4,15,59,81,4,4,66,113,46,66,23,47,13,16,16,69,113
2005-09-12 00:00:00.000,Beijing China ATP World Tour,HARD,2,Carlos Moya,Paradorn Srichaphan,Carlos Moya,7-6(6); 6-3,R32,81,2,2,30,64,24,30,24,34,1,2,11,48,64,6,4,31,65,27,31,16,34,0,2,10,43,65
2005-09-12 00:00:00.000,Beijing China ATP World Tour,HARD,2,Stefan Koubek,Ivo Heuberger,Stefan Koubek,6-3; 7-6(6),R32,100,3,2,49,73,34,49,13,24,1,3,11,47,73,4,2,41,80,29,41,18,39,4,7,10,47,80
2005-09-12 00:00:00.000,Beijing China ATP World Tour,HARD,2,Jarkko Nieminen,Rainer Schuettler,Jarkko Nieminen,6-4; 6-2,R32,70,0,2,35,50,28,35,6,15,1,2,9,34,50,2,5,30,62,22,30,12,32,2,6,9,34,62
2005-09-12 00:00:00.000,Beijing China ATP World Tour,HARD,2,Thomas Johansson,Jonas Bjorkman,Thomas Johansson,6-4; 6-3,R32,70,6,0,29,44,25,29,11,15,0,0,9,36,44,1,3,39,61,26,39,11,22,7,10,10,37,61
2005-09-12 00:00:00.000,Beijing China ATP World Tour,HARD,2,Mikhail Youzhny,Nathan Healey,Mikhail Youzhny,7-5; 6-4,R32,91,2,1,41,65,27,41,15,24,0,2,11,42,65,5,4,54,87,35,54,11,33,5,9,11,46,87
2005-09-12 00:00:00.000,Beijing China ATP World Tour,HARD,2,Danai Udomchoke,Noam Okun,Danai Udomchoke,7-6(4); 3-6; 6-4,R32,128,2,2,70,109,40,70,24,39,10,15,16,64,109,4,3,58,95,40,58,17,37,3,7,15,57,95
2005-09-12 00:00:00.000,Beijing China ATP World Tour,HARD,2,Toshihide Matsui,Peng Sun,Toshihide Matsui,6-4; 5-7; 6-4,R32,143,6,6,73,111,42,73,23,38,6,10,16,65,111,1,10,79,119,51,79,16,40,10,15,16,67,119
2005-09-12 00:00:00.000,Beijing China ATP World Tour,HARD,2,Guillermo Coria,Shao-Xuan Zeng,Guillermo Coria,6-2; 6-1,R32,58,0,3,34,45,28,34,5,11,0,1,8,33,45,0,2,44,53,18,44,3,9,7,12,7,21,53
2005-09-12 00:00:00.000,Beijing China ATP World Tour,HARD,2,Rafael Nadal,Justin Gimelstob,Rafael Nadal,5-7; 6-4; 6-4,R16,152,5,0,75,104,53,75,18,29,10,12,16,71,104,10,3,53,97,38,53,24,44,5,8,16,62,97
2005-09-12 00:00:00.000,Beijing China ATP World Tour,HARD,2,Peter Wessels,Yu Jr. Wang,Peter Wessels,6-1; 7-6(9),R16,109,11,2,56,76,44,56,11,20,3,3,10,55,76,4,7,63,86,43,63,8,23,8,10,9,51,86
2005-09-12 00:00:00.000,Beijing China ATP World Tour,HARD,2,David Nalbandian,Amir Hadad,David Nalbandian,6-4; 6-0,R16,50,3,2,28,40,25,28,8,12,2,2,8,33,40,2,1,29,49,16,29,9,20,4,8,8,25,49
2005-09-12 00:00:00.000,Beijing China ATP World Tour,HARD,2,Juan Carlos Ferrero,Dmitry Tursunov,Juan Carlos Ferrero,6-4; 7-6(4),R16,110,5,3,60,94,40,60,16,34,8,10,11,56,94,15,4,35,68,27,35,17,33,3,6,11,44,68
2005-09-12 00:00:00.000,Beijing China ATP World Tour,HARD,2,Carlos Moya,Stefan Koubek,Carlos Moya,3-6; 6-3; 6-2,R16,89,7,5,43,82,33,43,20,39,3,5,13,53,82,6,3,50,73,34,50,12,23,1,5,13,46,73
2005-09-12 00:00:00.000,Beijing China ATP World Tour,HARD,2,Thomas Johansson,Jarkko Nieminen,Thomas Johansson,6-4; 6-4,R16,77,11,1,39,61,33,39,11,22,3,3,10,44,61,2,0,35,63,26,35,14,28,5,7,10,40,63
2005-09-12 00:00:00.000,Beijing China ATP World Tour,HARD,2,Mikhail Youzhny,Danai Udomchoke,Mikhail Youzhny,7-5; 6-1,R16,69,3,4,35,60,25,35,14,25,2,4,10,39,60,2,3,25,59,17,25,12,34,4,9,9,29,59
2005-09-12 00:00:00.000,Beijing China ATP World Tour,HARD,2,Guillermo Coria,Toshihide Matsui,Guillermo Coria,6-1; 6-0,R16,54,4,3,22,36,18,22,9,14,3,3,6,27,36,2,3,37,61,20,37,4,24,6,12,7,24,61
2005-09-12 00:00:00.000,Beijing China ATP World Tour,HARD,2,Rafael Nadal,Peter Wessels,Rafael Nadal,7-6(3); 6-2,Q,83,4,3,40,62,32,40,14,22,3,4,10,46,62,5,1,42,74,30,42,13,32,7,10,10,43,74
2005-09-12 00:00:00.000,Beijing China ATP World Tour,HARD,2,Juan Carlos Ferrero,David Nalbandian,Juan Carlos Ferrero,6-2; 3-6; 6-3,Q,111,5,0,58,78,42,58,12,20,7,8,13,54,78,4,3,51,77,36,51,12,26,1,4,13,48,77
2005-09-12 00:00:00.000,Beijing China ATP World Tour,HARD,2,Thomas Johansson,Carlos Moya,Thomas Johansson,7-6(3); 6-3,Q,77,4,2,40,63,34,40,12,23,0,1,11,46,63,6,2,31,57,26,31,11,26,0,2,10,37,57
2005-09-12 00:00:00.000,Beijing China ATP World Tour,HARD,2,Guillermo Coria,Mikhail Youzhny,Guillermo Coria,6-4; 1-6; 6-1,Q,106,4,3,46,67,28,46,11,21,2,6,12,39,67,4,4,44,85,28,44,18,41,11,16,12,46,85
2005-09-12 00:00:00.000,Beijing China ATP World Tour,HARD,2,Rafael Nadal,Juan Carlos Ferrero,Rafael Nadal,6-4; 6-4,S,89,3,1,29,50,23,29,15,21,0,1,10,38,50,2,0,38,54,28,38,6,16,3,6,10,34,54
2005-09-12 00:00:00.000,Beijing China ATP World Tour,HARD,2,Guillermo Coria,Thomas Johansson,Guillermo Coria,4-6; 7-5; 6-2,S,119,5,11,64,101,43,64,18,37,6,9,15,61,101,8,5,60,97,44,60,10,37,3,8,15,54,97
2005-09-12 00:00:00.000,Beijing China ATP World Tour,HARD,2,Rafael Nadal,Guillermo Coria,Rafael Nadal,5-7; 6-1; 6-2,F,116,4,0,62,77,43,62,8,15,2,4,14,51,77,4,4,61,82,39,61,7,21,8,13,13,46,82
2005-09-12 00:00:00.000,Bucharest Romania ATP World Tour,CLAY,2,Mariano Puerta,Janko Tipsarevic,Mariano Puerta,7-5; 6-2,R32,81,6,0,31,48,27,31,10,17,0,1,10,37,48,5,3,38,68,24,38,12,30,8,12,10,36,68
2005-09-12 00:00:00.000,Bucharest Romania ATP World Tour,CLAY,2,Guillermo Garcia-Lopez,Luis Horna,Guillermo Garcia-Lopez,6-3; 3-6; 6-2,R32,126,3,3,56,81,38,56,15,25,3,5,13,53,81,6,3,69,94,45,69,10,25,3,7,13,55,94
2005-09-12 00:00:00.000,Bucharest Romania ATP World Tour,CLAY,2,Igor Andreev,Alexander Waske,Igor Andreev,6-4; 7-6(4),R32,91,10,0,37,57,33,37,16,20,1,1,11,49,57,7,6,44,82,33,44,18,38,4,5,11,51,82
2005-09-12 00:00:00.000,Bucharest Romania ATP World Tour,CLAY,2,Albert Montanes,Gael Monfils,Albert Montanes,3-6; 6-1; 6-4,R32,137,2,3,51,82,32,51,15,31,6,10,13,47,82,4,7,50,89,36,50,11,39,5,11,13,47,89
2005-09-12 00:00:00.000,Bucharest Romania ATP World Tour,CLAY,2,Victor Hanescu,Potito Starace,Victor Hanescu,6-3; 6-2,R32,54,2,4,36,56,26,36,11,20,2,2,8,37,56,1,3,32,50,17,32,9,18,0,4,9,26,50
2005-09-12 00:00:00.000,Bucharest Romania ATP World Tour,CLAY,2,Davide Sanguinetti,Razvan Sabau,Davide Sanguinetti,6-4; 6-3,R32,60,5,0,34,50,28,34,9,16,0,0,9,37,50,0,4,41,59,25,41,11,18,2,5,10,36,59
2005-09-12 00:00:00.000,Bucharest Romania ATP World Tour,CLAY,2,Ruben Ramirez Hidalgo,Nicolas Almagro,Ruben Ramirez Hidalgo,7-6(8); 6-1,R32,101,1,0,31,58,25,31,16,27,0,1,9,41,58,1,1,52,80,34,52,11,28,9,13,10,45,80
2005-09-12 00:00:00.000,Bucharest Romania ATP World Tour,CLAY,2,Jose Acasuso,Juan Ignacio Chela,Jose Acasuso,6-2; 6-4,R32,96,5,0,27,49,23,27,14,22,0,0,9,37,49,1,4,42,67,25,42,14,25,11,14,9,39,67
2005-09-12 00:00:00.000,Bucharest Romania ATP World Tour,CLAY,2,Fernando Verdasco,Mariano Zabaleta,Fernando Verdasco,6-2; 6-4,R32,80,2,2,44,57,30,44,4,13,2,4,9,34,57,1,1,35,55,17,35,9,20,6,11,9,26,55
2005-09-12 00:00:00.000,Bucharest Romania ATP World Tour,CLAY,2,Florian Mayer,Oscar Hernandez,Florian Mayer,6-2; 6-0,R32,53,2,0,31,41,22,31,8,10,2,2,7,30,41,0,0,29,44,11,29,7,15,6,11,7,18,44
2005-09-12 00:00:00.000,Bucharest Romania ATP World Tour,CLAY,2,Oliver Marach,Mariusz Fyrstenberg,Oliver Marach,6-4; 6-4,R32,100,3,2,26,52,18,26,17,26,1,3,10,35,52,4,2,30,59,19,30,12,29,0,4,10,31,59
2005-09-12 00:00:00.000,Bucharest Romania ATP World Tour,CLAY,2,Andrei Pavel,Alberto Martin,Andrei Pavel,6-4; 6-4,R32,88,4,0,58,72,39,58,7,14,6,7,10,46,72,2,3,41,63,24,41,11,22,0,3,10,35,63
2005-09-12 00:00:00.000,Bucharest Romania ATP World Tour,CLAY,2,Paul-Henri Mathieu,David Sanchez,Paul-Henri Mathieu,2-6; 6-2; 6-1,R32,89,3,2,35,65,25,35,19,30,0,2,12,44,65,4,0,39,63,25,39,9,24,3,7,11,34,63
2005-09-12 00:00:00.000,Bucharest Romania ATP World Tour,CLAY,2,Albert Portas,Christophe Rochus,Albert Portas,6-4; 6-1,R32,75,6,1,28,49,19,28,10,21,3,5,8,29,49,2,5,30,59,15,30,11,29,2,8,9,26,59
2005-09-12 00:00:00.000,Bucharest Romania ATP World Tour,CLAY,2,Florent Serra,Victor Crivoi,Florent Serra,3-6; 7-6(5); 6-1,R32,121,4,5,45,83,29,45,16,38,3,9,13,45,83,3,1,74,107,38,74,13,33,8,16,15,51,107
2005-09-12 00:00:00.000,Bucharest Romania ATP World Tour,CLAY,2,Filippo Volandri,Tomas Behrend,Filippo Volandri,6-2; 6-4,R32,73,1,1,38,58,28,38,12,20,3,4,9,40,58,0,1,35,59,22,35,10,24,5,9,9,32,59
2005-09-12 00:00:00.000,Bucharest Romania ATP World Tour,CLAY,2,Mariano Puerta,Guillermo Garcia-Lopez,Mariano Puerta,6-2; 6-4,R16,86,4,1,43,63,27,43,12,20,5,6,9,39,63,4,2,45,59,26,45,5,14,4,8,9,31,59
2005-09-12 00:00:00.000,Bucharest Romania ATP World Tour,CLAY,2,Igor Andreev,Albert Montanes,Igor Andreev,6-2; 6-2,R16,58,0,1,30,48,23,30,9,18,1,2,8,32,48,1,1,24,39,13,24,4,15,0,5,8,17,39
2005-09-12 00:00:00.000,Bucharest Romania ATP World Tour,CLAY,2,Victor Hanescu,Davide Sanguinetti,Victor Hanescu,6-2; 6-3,R16,70,3,0,42,54,31,42,7,12,7,8,9,38,54,4,1,34,58,19,34,9,24,6,10,8,28,58
2005-09-12 00:00:00.000,Bucharest Romania ATP World Tour,CLAY,2,Ruben Ramirez Hidalgo,Jose Acasuso,Ruben Ramirez Hidalgo,6-4; 7-5,R16,97,2,0,54,67,40,54,7,13,3,4,11,47,67,5,0,43,64,27,43,13,21,5,8,11,40,64
2005-09-12 00:00:00.000,Bucharest Romania ATP World Tour,CLAY,2,Florian Mayer,Fernando Verdasco,Florian Mayer,7-5; 7-6(7),R16,104,3,2,62,88,44,62,13,26,7,10,12,57,88,2,3,65,86,43,65,9,21,2,6,12,52,86
2005-09-12 00:00:00.000,Bucharest Romania ATP World Tour,CLAY,2,Andrei Pavel,Oliver Marach,Andrei Pavel,3-6; 7-6(2); 6-4,R16,154,7,0,73,102,49,73,16,29,3,6,15,65,102,4,4,54,94,37,54,21,40,3,6,16,58,94
2005-09-12 00:00:00.000,Bucharest Romania ATP World Tour,CLAY,2,Paul-Henri Mathieu,Albert Portas,Paul-Henri Mathieu,6-2; 6-0,R16,78,1,0,20,41,18,20,12,21,2,2,7,30,41,3,1,31,47,13,31,7,16,8,13,7,20,47
2005-09-12 00:00:00.000,Bucharest Romania ATP World Tour,CLAY,2,Florent Serra,Filippo Volandri,Florent Serra,1-6; 6-4; 6-3,R16,94,2,1,52,82,28,52,17,30,5,10,13,45,82,0,0,54,70,27,54,13,16,0,5,13,40,70
2005-09-12 00:00:00.000,Bucharest Romania ATP World Tour,CLAY,2,Igor Andreev,Mariano Puerta,Igor Andreev,4-6; 6-1; 6-1,Q,114,2,1,47,86,30,47,27,39,7,8,12,57,86,3,3,45,71,27,45,12,26,0,5,12,39,71
2005-09-12 00:00:00.000,Bucharest Romania ATP World Tour,CLAY,2,Victor Hanescu,Ruben Ramirez Hidalgo,Victor Hanescu,6-4; 6-4,Q,77,7,0,49,56,38,49,5,7,4,4,10,43,56,3,2,41,55,30,41,7,14,3,5,10,37,55
2005-09-12 00:00:00.000,Bucharest Romania ATP World Tour,CLAY,2,Andrei Pavel,Florian Mayer,Andrei Pavel,7-5; 7-6(4),Q,96,7,2,53,73,40,53,13,20,0,1,12,53,73,3,1,51,80,35,51,15,29,5,7,12,50,80
2005-09-12 00:00:00.000,Bucharest Romania ATP World Tour,CLAY,2,Florent Serra,Paul-Henri Mathieu,Florent Serra,6-3; 6-1,Q,70,3,0,25,50,19,25,13,25,0,1,8,32,50,1,2,21,46,11,21,9,25,1,6,8,20,46
2005-09-12 00:00:00.000,Bucharest Romania ATP World Tour,CLAY,2,Igor Andreev,Victor Hanescu,Igor Andreev,4-6; 7-6(2); 6-3,S,169,5,3,73,112,47,73,24,39,4,7,16,71,112,2,1,93,121,57,93,15,28,4,7,15,72,121
2005-09-12 00:00:00.000,Bucharest Romania ATP World Tour,CLAY,2,Florent Serra,Andrei Pavel,Florent Serra,6-7(5); 6-2; 6-3,S,157,3,1,60,111,45,60,29,51,5,5,15,74,111,5,1,66,111,43,66,24,45,8,11,14,67,111
2005-09-12 00:00:00.000,Bucharest Romania ATP World Tour,CLAY,2,Florent Serra,Igor Andreev,Florent Serra,6-3; 6-4,F,96,0,0,31,56,21,31,15,25,2,4,9,36,56,0,1,54,80,30,54,11,26,7,12,10,41,80
2005-09-26 00:00:00.000,Bangkok Thailand ATP World Tour,HARD,2,Roger Federer,Marcos Daniel,Roger Federer,7-6(4); 6-4,R32,92,5,1,41,64,34,41,15,23,1,2,11,49,64,4,4,59,95,38,59,21,36,11,13,11,59,95
2005-09-26 00:00:00.000,Bangkok Thailand ATP World Tour,HARD,2,Denis Gremelmayr,Roko Karanusic,Denis Gremelmayr,6-2; 7-5,R32,55,3,2,30,47,25,30,13,17,1,2,10,38,47,0,1,49,63,29,49,6,14,4,8,10,35,63
2005-09-26 00:00:00.000,Bangkok Thailand ATP World Tour,HARD,2,Gilles Muller,Mark Philippoussis,Gilles Muller,7-6(5); 2-6; 7-5,R32,123,18,5,52,97,38,52,27,45,5,8,16,65,97,14,5,52,89,43,52,22,37,3,5,16,65,89
2005-09-26 00:00:00.000,Bangkok Thailand ATP World Tour,HARD,2,Luis Horna,Ivo Minar,Luis Horna,4-6; 7-6(6); 6-4,R32,114,11,1,52,85,39,52,23,33,0,3,16,62,85,15,2,55,100,43,55,25,45,2,5,16,68,100
2005-09-26 00:00:00.000,Bangkok Thailand ATP World Tour,HARD,2,Tommy Haas,Irakli Labadze,Tommy Haas,6-3; 4-6; 6-4,R32,114,10,6,49,86,41,49,17,37,2,5,15,58,86,9,2,65,101,41,65,17,36,6,10,14,58,101
2005-09-26 00:00:00.000,Bangkok Thailand ATP World Tour,HARD,2,Jimmy Wang,Kevin Kim,Jimmy Wang,6-3; 7-6(8),R32,83,7,1,39,66,30,39,20,27,0,1,11,50,66,1,1,52,73,38,52,7,21,2,4,10,45,73
2005-09-26 00:00:00.000,Bangkok Thailand ATP World Tour,HARD,2,Dmitry Tursunov,Alex Calatrava,Dmitry Tursunov,2-6; 6-3; 7-5,R32,116,11,2,59,93,43,59,14,34,8,12,15,57,93,2,3,52,82,35,52,15,30,1,5,14,50,82
2005-09-26 00:00:00.000,Bangkok Thailand ATP World Tour,HARD,2,Jarkko Nieminen,Karol Kucera,Jarkko Nieminen,6-1; 3-1 RET,R32,42,2,0,22,29,19,22,2,7,0,0,5,21,29,2,0,18,34,7,18,8,16,1,5,6,15,34
2005-09-26 00:00:00.000,Bangkok Thailand ATP World Tour,HARD,2,Robin Soderling,Robin Vik,Robin Soderling,4-6; 6-1; 6-2,R32,102,14,2,49,85,39,49,17,36,9,11,13,56,85,6,6,63,97,40,63,11,34,10,15,12,51,97
2005-09-26 00:00:00.000,Bangkok Thailand ATP World Tour,HARD,2,Andy Murray,George Bastl,Andy Murray,6-2; 6-4,R32,88,7,3,26,55,22,26,14,29,1,2,9,36,55,2,2,46,72,26,46,10,26,9,13,9,36,72
2005-09-26 00:00:00.000,Bangkok Thailand ATP World Tour,HARD,2,Nicolas Thomann,Dick Norman,Nicolas Thomann,6-4; 7-6(3),R32,80,8,2,41,57,35,41,12,16,0,1,11,47,57,17,6,43,69,33,43,12,26,4,6,11,45,69
2005-09-26 00:00:00.000,Bangkok Thailand ATP World Tour,HARD,2,Robby Ginepri,Danai Udomchoke,Robby Ginepri,4-6; 6-3; 6-1,R32,96,4,3,52,82,37,52,16,30,1,3,13,53,82,7,4,39,75,25,39,18,36,4,9,13,43,75
2005-09-26 00:00:00.000,Bangkok Thailand ATP World Tour,HARD,2,Paradorn Srichaphan,Ti Chen,Paradorn Srichaphan,6-3; 6-4,R32,75,5,5,25,55,23,25,13,30,0,2,10,36,55,1,1,35,55,19,35,10,20,2,6,9,29,55
2005-09-26 00:00:00.000,Bangkok Thailand ATP World Tour,HARD,2,Guillermo Garcia-Lopez,John Paul Fruttero,Guillermo Garcia-Lopez,3-6; 6-3; 7-6(4),R32,135,5,1,48,86,33,48,26,38,1,3,15,59,86,8,9,70,116,48,70,23,46,8,10,15,71,116
2005-09-26 00:00:00.000,Bangkok Thailand ATP World Tour,HARD,2,Justin Gimelstob,Nicolas Lapentti,Justin Gimelstob,6-4; 6-3,R32,70,8,1,33,50,29,33,12,17,1,1,10,41,50,4,1,40,56,27,40,7,16,2,4,9,34,56
2005-09-26 00:00:00.000,Bangkok Thailand ATP World Tour,HARD,2,Lleyton Hewitt,Lukas Dlouhy,Lleyton Hewitt,6-3; 3-6; 7-5,R32,112,8,6,54,95,34,54,21,41,7,11,15,55,95,7,16,53,100,39,53,18,47,12,17,15,57,100
2005-09-26 00:00:00.000,Bangkok Thailand ATP World Tour,HARD,2,Roger Federer,Denis Gremelmayr,Roger Federer,6-3; 6-2,R16,63,3,1,38,66,31,38,14,28,7,7,9,45,66,1,3,26,50,19,26,9,24,2,5,8,28,50
2005-09-26 00:00:00.000,Bangkok Thailand ATP World Tour,HARD,2,Gilles Muller,Luis Horna,Gilles Muller,6-7(4); 7-6(4); 6-3,R16,136,22,4,68,113,56,68,24,45,6,7,17,80,113,11,2,60,95,48,60,23,35,1,3,16,71,95
2005-09-26 00:00:00.000,Bangkok Thailand ATP World Tour,HARD,2,Jimmy Wang,Tommy Haas,Jimmy Wang,7-5; 6-3,R16,77,5,0,30,56,23,30,13,26,0,3,11,36,56,2,2,37,61,25,37,7,24,3,8,10,32,61
2005-09-26 00:00:00.000,Bangkok Thailand ATP World Tour,HARD,2,Jarkko Nieminen,Dmitry Tursunov,Jarkko Nieminen,7-6(2); 6-4,R16,97,4,3,47,73,30,47,18,26,3,5,11,48,73,12,4,51,81,39,51,9,30,8,11,11,48,81
2005-09-26 00:00:00.000,Bangkok Thailand ATP World Tour,HARD,2,Andy Murray,Robin Soderling,Andy Murray,7-6(3); 7-6(5),R16,113,6,4,38,95,32,38,29,57,4,7,12,61,95,10,5,60,92,44,60,12,32,7,10,12,56,92
2005-09-26 00:00:00.000,Bangkok Thailand ATP World Tour,HARD,2,Robby Ginepri,Nicolas Thomann,Robby Ginepri,6-3; 7-6(4),R16,91,13,2,48,75,32,48,15,27,0,2,11,47,75,8,2,31,76,25,31,18,45,8,11,10,43,76
2005-09-26 00:00:00.000,Bangkok Thailand ATP World Tour,HARD,2,Paradorn Srichaphan,Guillermo Garcia-Lopez,Paradorn Srichaphan,7-5; 6-4,R16,86,6,5,40,82,28,40,20,42,5,8,11,48,82,1,4,46,67,30,46,5,21,6,11,11,35,67
2005-09-26 00:00:00.000,Bangkok Thailand ATP World Tour,HARD,2,Lleyton Hewitt,Justin Gimelstob,Lleyton Hewitt,6-4; 5-7; 7-6(9),R16,148,7,6,58,111,41,58,23,53,4,10,17,64,111,12,5,61,108,39,61,23,47,1,7,17,62,108
2005-09-26 00:00:00.000,Bangkok Thailand ATP World Tour,HARD,2,Roger Federer,Gilles Muller,Roger Federer,6-4; 6-3,Q,71,6,0,28,50,24,28,13,22,0,0,9,37,50,7,3,39,68,27,39,12,29,8,11,10,39,68
2005-09-26 00:00:00.000,Bangkok Thailand ATP World Tour,HARD,2,Jarkko Nieminen,Jimmy Wang,Jarkko Nieminen,6-4; 6-7(3); 6-4,Q,148,5,2,67,101,48,67,17,34,8,11,16,65,101,4,3,68,115,42,68,25,47,12,17,16,67,115
2005-09-26 00:00:00.000,Bangkok Thailand ATP World Tour,HARD,2,Andy Murray,Robby Ginepri,Andy Murray,4-6; 6-4; 6-3,Q,77,10,1,35,72,27,35,23,37,1,3,14,50,72,8,5,62,89,45,62,12,27,3,7,15,57,89
2005-09-26 00:00:00.000,Bangkok Thailand ATP World Tour,HARD,2,Paradorn Srichaphan,Lleyton Hewitt,Paradorn Srichaphan,W/O,Q,0,0,0,0,0,0,0,0,0,0,0,0,0,0,0,0,0,0,0,0,0,0,0,0,0,0,0
2005-09-26 00:00:00.000,Bangkok Thailand ATP World Tour,HARD,2,Roger Federer,Jarkko Nieminen,Roger Federer,6-3; 6-4,S,57,4,2,44,56,33,44,7,12,2,3,10,40,56,2,1,39,51,22,39,6,12,2,5,9,28,51
2005-09-26 00:00:00.000,Bangkok Thailand ATP World Tour,HARD,2,Andy Murray,Paradorn Srichaphan,Andy Murray,6-7(3); 7-5; 6-2,S,161,8,5,53,113,42,53,31,60,5,6,16,73,113,8,3,62,112,44,62,24,50,2,6,16,68,112
2005-09-26 00:00:00.000,Bangkok Thailand ATP World Tour,HARD,2,Roger Federer,Andy Murray,Roger Federer,6-3; 7-5,F,86,2,2,36,67,26,36,21,31,2,3,11,47,67,6,3,34,75,24,34,20,41,6,9,10,44,75
2005-09-26 00:00:00.000,Ho Chi Minh City Vietnam ATP World Tour,HARD,2,Mariano Puerta,Go Soeda,Mariano Puerta,6-4; 6-7(5); 6-4,R32,129,9,0,70,83,56,70,9,13,0,1,16,65,83,10,4,62,109,46,62,25,47,3,6,16,71,109
2005-09-26 00:00:00.000,Ho Chi Minh City Vietnam ATP World Tour,HARD,2,Wayne Arthurs,Juan Pablo Brzezicki,Wayne Arthurs,7-6(5); 7-6(3),R32,125,17,5,45,77,41,45,15,32,2,3,12,56,77,2,3,66,107,45,66,23,41,9,10,12,68,107
2005-09-26 00:00:00.000,Ho Chi Minh City Vietnam ATP World Tour,HARD,2,Rainer Schuettler,Simon Greul,Rainer Schuettler,6-7(4); 6-3; 6-1,R32,118,5,3,54,89,42,54,20,35,5,6,14,62,89,9,5,51,93,37,51,17,42,5,10,14,54,93
2005-09-26 00:00:00.000,Ho Chi Minh City Vietnam ATP World Tour,HARD,2,Wesley Moodie,Philipp Kohlschreiber,Wesley Moodie,6-4; 7-6(2),R32,91,8,1,49,63,42,49,7,14,0,0,11,49,63,6,1,42,65,33,42,13,23,0,1,11,46,65
2005-09-26 00:00:00.000,Ho Chi Minh City Vietnam ATP World Tour,HARD,2,Jonas Bjorkman,Kenneth Carlsen,Jonas Bjorkman,6-3; 6-4,R32,80,9,0,29,51,27,29,13,22,0,0,10,40,51,5,5,43,65,30,43,10,22,8,10,9,40,65
2005-09-26 00:00:00.000,Ho Chi Minh City Vietnam ATP World Tour,HARD,2,Cecil Mamiit,Aljoscha Thron,Cecil Mamiit,6-2; 6-3,R32,61,3,1,29,39,25,29,7,10,0,0,8,32,39,5,3,29,56,18,29,11,27,2,6,9,29,56
2005-09-26 00:00:00.000,Ho Chi Minh City Vietnam ATP World Tour,HARD,2,Alexander Waske,Raemon Sluiter,Alexander Waske,7-6(3); 6-7(4); 7-6(7),R32,186,32,11,72,124,60,72,33,52,4,4,18,93,124,16,4,67,121,54,67,38,54,3,3,18,92,121
2005-09-26 00:00:00.000,Ho Chi Minh City Vietnam ATP World Tour,HARD,2,Lars Burgsmuller,Kristian Pless,Lars Burgsmuller,6-3; 6-7(8); 6-2,R32,132,12,3,52,103,40,52,29,51,1,2,15,69,103,11,7,45,88,37,45,20,43,3,7,14,57,88
2005-09-26 00:00:00.000,Ho Chi Minh City Vietnam ATP World Tour,HARD,2,Juan Monaco,Sasa Tuksar,Juan Monaco,6-3; 7-5,R32,79,5,4,40,63,31,40,13,23,1,2,11,44,63,0,2,39,67,26,39,12,28,2,5,10,38,67
2005-09-26 00:00:00.000,Ho Chi Minh City Vietnam ATP World Tour,HARD,2,Yen-Hsun Lu,Antony Dupuis,Yen-Hsun Lu,6-1; 6-4,R32,70,2,3,30,53,27,30,11,23,2,2,9,38,53,2,3,19,44,14,19,11,25,0,3,8,25,44
2005-09-26 00:00:00.000,Ho Chi Minh City Vietnam ATP World Tour,HARD,2,Uros Vico,Janko Tipsarevic,Uros Vico,6-7(5); 6-3; 6-4,R32,148,13,1,57,112,43,57,32,55,10,11,16,75,112,9,1,45,96,31,45,33,51,1,4,15,64,96
2005-09-26 00:00:00.000,Ho Chi Minh City Vietnam ATP World Tour,HARD,2,Radek Stepanek,Hyung-Taik Lee,Radek Stepanek,7-6(3); 6-1,R32,72,7,0,41,59,36,41,12,18,1,1,10,48,59,0,1,29,57,23,29,11,28,1,3,9,34,57
2005-09-26 00:00:00.000,Ho Chi Minh City Vietnam ATP World Tour,HARD,2,Cyril Saulnier,Peter Wessels,Cyril Saulnier,6-2; 6-4,R32,55,7,0,30,43,27,30,9,13,0,0,9,36,43,7,4,36,53,26,36,4,17,2,5,9,30,53
2005-09-26 00:00:00.000,Ho Chi Minh City Vietnam ATP World Tour,HARD,2,Jiri Vanek,Prakash Amritraj,Jiri Vanek,6-7(6); 7-6(5); 6-4,R32,162,16,3,66,102,58,66,21,36,1,3,17,79,102,2,1,72,127,52,72,30,55,4,7,17,82,127
2005-09-26 00:00:00.000,Ho Chi Minh City Vietnam ATP World Tour,HARD,2,Bjorn Phau,Minh-Quan Do,Bjorn Phau,6-3; 6-2,R32,59,0,3,21,44,16,21,16,23,1,2,8,32,44,0,3,27,52,18,27,6,25,1,6,9,24,52
2005-09-26 00:00:00.000,Ho Chi Minh City Vietnam ATP World Tour,HARD,2,Thomas Johansson,Alexander Popp,Thomas Johansson,4-6; 6-4; 6-3,R32,101,7,4,43,81,38,43,23,38,1,2,15,61,81,5,3,47,73,37,47,17,26,4,6,14,54,73
2005-09-26 00:00:00.000,Ho Chi Minh City Vietnam ATP World Tour,HARD,2,Mariano Puerta,Wayne Arthurs,Mariano Puerta,4-6; 7-6(3); 7-6(3),R16,115,6,1,73,95,61,73,15,22,3,4,17,76,95,30,6,59,93,52,59,21,34,0,0,17,73,93
2005-09-26 00:00:00.000,Ho Chi Minh City Vietnam ATP World Tour,HARD,2,Rainer Schuettler,Wesley Moodie,Rainer Schuettler,7-6(10); 6-3,R16,105,1,2,46,68,34,46,15,22,0,1,10,49,68,6,2,48,70,36,48,11,22,0,3,11,47,70
2005-09-26 00:00:00.000,Ho Chi Minh City Vietnam ATP World Tour,HARD,2,Jonas Bjorkman,Cecil Mamiit,Jonas Bjorkman,6-4; 4-3 RET,R16,74,7,2,25,48,23,25,12,23,3,3,8,35,48,2,2,38,58,25,38,11,20,0,2,9,36,58
2005-09-26 00:00:00.000,Ho Chi Minh City Vietnam ATP World Tour,HARD,2,Alexander Waske,Lars Burgsmuller,Alexander Waske,7-6(3); 7-6(3),R16,119,9,10,39,79,34,39,21,40,0,1,12,55,79,7,2,43,74,32,43,17,31,0,1,12,49,74
2005-09-26 00:00:00.000,Ho Chi Minh City Vietnam ATP World Tour,HARD,2,Juan Monaco,Yen-Hsun Lu,Juan Monaco,W/O,R16,0,0,0,0,0,0,0,0,0,0,0,0,0,0,0,0,0,0,0,0,0,0,0,0,0,0,0
2005-09-26 00:00:00.000,Ho Chi Minh City Vietnam ATP World Tour,HARD,2,Radek Stepanek,Uros Vico,Radek Stepanek,6-2; 6-1,R16,56,6,1,27,39,22,27,8,12,0,0,7,30,39,2,1,27,54,14,27,11,27,4,9,8,25,54
2005-09-26 00:00:00.000,Ho Chi Minh City Vietnam ATP World Tour,HARD,2,Cyril Saulnier,Jiri Vanek,Cyril Saulnier,7-6(3); 7-6(10),R16,117,12,2,49,91,42,49,24,42,2,2,12,66,91,14,3,51,85,45,51,16,34,2,2,12,61,85
2005-09-26 00:00:00.000,Ho Chi Minh City Vietnam ATP World Tour,HARD,2,Thomas Johansson,Bjorn Phau,Thomas Johansson,6-3; 6-2,R16,64,8,0,29,50,25,29,14,21,1,1,9,39,50,3,4,29,52,17,29,11,23,4,7,8,28,52
2005-09-26 00:00:00.000,Ho Chi Minh City Vietnam ATP World Tour,HARD,2,Mariano Puerta,Rainer Schuettler,Mariano Puerta,3-6; 6-2; 7-6(5),Q,144,7,1,77,109,58,77,14,32,8,9,14,72,109,12,3,58,95,44,58,21,37,6,8,15,65,95
2005-09-26 00:00:00.000,Ho Chi Minh City Vietnam ATP World Tour,HARD,2,Jonas Bjorkman,Alexander Waske,Jonas Bjorkman,6-2; 6-3,Q,72,5,3,25,48,23,25,14,23,0,0,9,37,48,3,2,35,58,20,35,11,23,1,4,8,31,58
2005-09-26 00:00:00.000,Ho Chi Minh City Vietnam ATP World Tour,HARD,2,Radek Stepanek,Juan Monaco,Radek Stepanek,6-3; 6-4,Q,82,5,0,36,60,28,36,16,24,4,4,10,44,60,3,1,32,62,21,32,16,30,2,4,9,37,62
2005-09-26 00:00:00.000,Ho Chi Minh City Vietnam ATP World Tour,HARD,2,Thomas Johansson,Cyril Saulnier,Thomas Johansson,7-6(2); 6-2,Q,98,11,1,31,56,29,31,17,25,2,2,10,46,56,9,3,52,79,32,52,14,27,6,8,10,46,79
2005-09-26 00:00:00.000,Ho Chi Minh City Vietnam ATP World Tour,HARD,2,Jonas Bjorkman,Mariano Puerta,Jonas Bjorkman,6-1; 6-0,S,67,4,4,20,39,14,20,12,19,1,2,7,26,39,3,4,41,66,18,41,8,25,12,18,6,26,66
2005-09-26 00:00:00.000,Ho Chi Minh City Vietnam ATP World Tour,HARD,2,Radek Stepanek,Thomas Johansson,Radek Stepanek,7-5; 6-4,S,109,12,3,42,66,35,42,11,24,2,3,11,46,66,13,4,48,89,31,48,21,41,8,11,11,52,89
2005-09-26 00:00:00.000,Ho Chi Minh City Vietnam ATP World Tour,HARD,2,Jonas Bjorkman,Radek Stepanek,Jonas Bjorkman,6-3; 7-6(4),F,84,9,4,39,63,34,39,16,24,0,0,11,50,63,7,0,47,66,36,47,10,19,1,2,10,46,66
2005-09-26 00:00:00.000,Palermo Italy ATP World Tour,CLAY,2,Francesco Aldi,David Ferrer,Francesco Aldi,6-2; 6-2,R32,62,0,0,35,46,24,35,10,11,4,4,8,34,46,0,2,28,46,17,28,8,18,3,7,8,25,46
2005-09-26 00:00:00.000,Palermo Italy ATP World Tour,CLAY,2,Igor Andreev,Nicolas Almagro,Igor Andreev,6-4; 2-6; 6-4,R32,120,1,5,55,89,31,55,19,34,4,9,14,50,89,7,3,58,90,36,58,14,32,1,6,14,50,90
2005-09-26 00:00:00.000,Palermo Italy ATP World Tour,CLAY,2,Daniel Elsner,Fabio Fognini,Daniel Elsner,4-6; 6-3; 7-5,R32,136,1,4,57,101,38,57,27,44,7,10,16,65,101,2,6,67,97,43,67,15,30,5,9,15,58,97
2005-09-26 00:00:00.000,Palermo Italy ATP World Tour,CLAY,2,Alberto Martin,Gael Monfils,Alberto Martin,1-6; 6-1; 6-4,R32,111,1,1,39,67,24,39,17,28,3,7,12,41,67,7,5,45,91,27,45,22,46,5,10,12,49,91
2005-09-26 00:00:00.000,Palermo Italy ATP World Tour,CLAY,2,Andreas Seppi,Tomas Berdych,Andreas Seppi,4-6; 6-4; 6-4,R32,128,4,1,44,83,33,44,25,39,0,2,15,58,83,6,5,56,105,38,56,24,49,7,10,15,62,105
2005-09-26 00:00:00.000,Palermo Italy ATP World Tour,CLAY,2,Razvan Sabau,Mariano Zabaleta,Razvan Sabau,6-3; 7-6(6),R32,94,4,3,45,68,34,45,10,23,2,4,10,44,68,6,2,41,80,23,41,21,39,6,10,11,44,80
2005-09-26 00:00:00.000,Palermo Italy ATP World Tour,CLAY,2,Juan Ignacio Chela,Jose Antonio Sanchez-de Luna,Juan Ignacio Chela,6-4; 6-2,R32,96,1,5,38,70,24,38,12,32,2,6,9,36,70,1,0,51,66,22,51,5,15,5,12,9,27,66
2005-09-26 00:00:00.000,Palermo Italy ATP World Tour,CLAY,2,Davide Sanguinetti,Florent Serra,Davide Sanguinetti,6-7(10); 6-1; 6-2,R32,106,12,3,60,97,44,60,18,37,4,7,14,62,97,1,1,50,80,29,50,14,30,3,10,13,43,80
2005-09-26 00:00:00.000,Palermo Italy ATP World Tour,CLAY,2,Fernando Verdasco,Tomas Zib,Fernando Verdasco,6-2; 6-2,R32,58,6,2,20,46,18,20,18,26,2,2,8,36,46,2,3,24,44,14,24,8,20,2,6,8,22,44
2005-09-26 00:00:00.000,Palermo Italy ATP World Tour,CLAY,2,Tomas Behrend,Daniele Bracciali,Tomas Behrend,6-4; 4-6; 6-3,R32,118,9,4,55,93,37,55,20,38,7,11,15,57,93,8,4,46,81,33,46,15,35,3,8,14,48,81
2005-09-26 00:00:00.000,Palermo Italy ATP World Tour,CLAY,2,Oscar Hernandez,Gianluca Naso,Oscar Hernandez,6-7(3); 6-0; 6-4,R32,151,3,3,66,94,46,66,14,28,6,8,14,60,94,1,7,56,117,37,56,25,61,13,19,14,62,117
2005-09-26 00:00:00.000,Palermo Italy ATP World Tour,CLAY,2,Juan Carlos Ferrero,Florian Mayer,Juan Carlos Ferrero,6-3; 6-3,R32,76,4,0,36,53,27,36,13,17,3,3,9,40,53,6,2,43,78,27,43,16,35,11,14,9,43,78
2005-09-26 00:00:00.000,Palermo Italy ATP World Tour,CLAY,2,Filippo Volandri,Nicolas Massu,Filippo Volandri,6-3; 6-0,R32,75,2,0,33,50,25,33,10,17,0,0,8,35,50,2,3,30,52,20,30,6,22,6,10,7,26,52
2005-09-26 00:00:00.000,Palermo Italy ATP World Tour,CLAY,2,Christophe Rochus,David Sanchez,Christophe Rochus,6-1; 6-2,R32,53,4,2,19,39,18,19,11,20,0,1,8,29,39,4,2,20,42,12,20,5,22,1,6,7,17,42
2005-09-26 00:00:00.000,Palermo Italy ATP World Tour,CLAY,2,Albert Montanes,Agustin Calleri,Albert Montanes,7-5; 6-0,R32,66,6,0,29,46,19,29,13,17,1,3,9,32,46,1,4,33,59,17,33,9,26,5,11,9,26,59
2005-09-26 00:00:00.000,Palermo Italy ATP World Tour,CLAY,2,Tommy Robredo,Albert Portas,Tommy Robredo,6-3; 7-5,R32,94,4,5,41,70,30,41,15,29,4,5,10,45,70,6,4,33,68,24,33,17,35,2,6,11,41,68
2005-09-26 00:00:00.000,Palermo Italy ATP World Tour,CLAY,2,Igor Andreev,Francesco Aldi,Igor Andreev,2-6; 6-0; 6-3,R16,119,4,2,59,87,39,59,11,28,3,7,12,50,87,0,4,55,73,32,55,3,18,6,12,11,35,73
2005-09-26 00:00:00.000,Palermo Italy ATP World Tour,CLAY,2,Alberto Martin,Daniel Elsner,Alberto Martin,6-4; 6-2,R16,89,3,2,29,57,20,29,14,28,1,3,9,34,57,1,4,45,76,21,45,16,31,8,13,9,37,76
2005-09-26 00:00:00.000,Palermo Italy ATP World Tour,CLAY,2,Andreas Seppi,Razvan Sabau,Andreas Seppi,6-7(6); 6-3; 7-5,R16,164,18,7,73,127,43,73,22,54,14,20,16,65,127,5,8,70,122,38,70,23,52,13,22,17,61,122
2005-09-26 00:00:00.000,Palermo Italy ATP World Tour,CLAY,2,Davide Sanguinetti,Juan Ignacio Chela,Davide Sanguinetti,6-3; 6-4,R16,84,1,2,33,64,22,33,16,31,3,6,10,38,64,3,5,32,61,19,32,10,29,4,9,9,29,61
2005-09-26 00:00:00.000,Palermo Italy ATP World Tour,CLAY,2,Tomas Behrend,Fernando Verdasco,Tomas Behrend,6-4; 2-6; 6-1,R16,95,1,2,50,84,36,50,14,34,2,5,13,50,84,4,2,45,74,28,45,15,29,1,5,12,43,74
2005-09-26 00:00:00.000,Palermo Italy ATP World Tour,CLAY,2,Juan Carlos Ferrero,Oscar Hernandez,Juan Carlos Ferrero,6-3; 6-4,R16,98,0,2,39,60,26,39,12,21,3,5,10,38,60,3,4,32,59,18,32,13,27,4,8,9,31,59
2005-09-26 00:00:00.000,Palermo Italy ATP World Tour,CLAY,2,Filippo Volandri,Christophe Rochus,Filippo Volandri,6-0; 6-0,R16,37,1,2,32,37,23,32,3,5,2,2,6,26,37,0,0,18,31,3,18,4,13,2,8,6,7,31
2005-09-26 00:00:00.000,Palermo Italy ATP World Tour,CLAY,2,Tommy Robredo,Albert Montanes,Tommy Robredo,7-5; 6-2,R16,76,4,2,31,55,24,31,13,24,0,1,10,37,55,0,4,37,70,20,37,17,33,7,11,10,37,70
2005-09-26 00:00:00.000,Palermo Italy ATP World Tour,CLAY,2,Igor Andreev,Alberto Martin,Igor Andreev,7-5; 7-5,Q,108,2,2,54,75,35,54,10,21,3,7,12,45,75,1,3,49,83,28,49,14,34,10,16,12,42,83
2005-09-26 00:00:00.000,Palermo Italy ATP World Tour,CLAY,2,Andreas Seppi,Davide Sanguinetti,Andreas Seppi,6-3; 6-4,Q,77,0,0,33,54,23,33,13,21,4,5,9,36,54,3,0,24,59,13,24,20,35,4,8,10,33,59
2005-09-26 00:00:00.000,Palermo Italy ATP World Tour,CLAY,2,Tomas Behrend,Juan Carlos Ferrero,Tomas Behrend,6-7(2); 7-6(4); 7-5,Q,156,10,6,69,118,51,69,21,49,5,10,18,72,118,2,2,80,113,50,80,18,33,7,13,18,68,113
2005-09-26 00:00:00.000,Palermo Italy ATP World Tour,CLAY,2,Filippo Volandri,Tommy Robredo,Filippo Volandri,6-4; 6-2,Q,91,1,3,62,87,39,62,13,25,10,11,9,52,87,3,4,40,64,24,40,9,24,3,7,9,33,64
2005-09-26 00:00:00.000,Palermo Italy ATP World Tour,CLAY,2,Igor Andreev,Andreas Seppi,Igor Andreev,6-2; 6-4,S,61,6,0,32,43,26,32,7,11,1,2,9,33,43,1,3,31,59,20,31,13,28,3,7,9,33,59
2005-09-26 00:00:00.000,Palermo Italy ATP World Tour,CLAY,2,Filippo Volandri,Tomas Behrend,Filippo Volandri,6-4; 6-2,S,79,4,4,35,57,24,35,11,22,3,5,9,35,57,2,5,33,69,19,33,15,36,3,8,9,34,69
2005-09-26 00:00:00.000,Palermo Italy ATP World Tour,CLAY,2,Igor Andreev,Filippo Volandri,Igor Andreev,0-6; 6-1; 6-3,F,94,1,2,43,71,27,43,12,28,7,11,11,39,71,1,5,46,71,26,46,13,25,5,10,11,39,71
2005-10-03 00:00:00.000,Metz France ATP World Tour,HARD,2,Nikolay Davydenko,Ricardo Mello,Nikolay Davydenko,6-3; 6-1,R32,54,1,0,30,44,24,30,9,14,2,2,8,33,44,2,1,29,45,17,29,5,16,5,9,8,22,45
2005-10-03 00:00:00.000,Metz France ATP World Tour,HARD,2,Michael Llodra,Gilles Simon,Michael Llodra,6-4; 6-0,R32,63,6,0,35,51,27,35,10,16,2,2,8,37,51,4,0,31,51,18,31,7,20,6,10,8,25,51
2005-10-03 00:00:00.000,Metz France ATP World Tour,HARD,2,Andreas Seppi,Razvan Sabau,Andreas Seppi,7-5; 6-3,R32,75,11,3,51,69,35,51,10,18,6,7,10,45,69,2,8,43,73,28,43,11,30,1,5,11,39,73
2005-10-03 00:00:00.000,Metz France ATP World Tour,HARD,2,Andrei Pavel,Davide Sanguinetti,Andrei Pavel,6-7(5); 6-3; 6-3,R32,115,10,3,53,89,40,53,17,36,3,6,15,57,89,8,1,60,105,38,60,20,45,12,18,15,58,105
2005-10-03 00:00:00.000,Metz France ATP World Tour,HARD,2,Ivan Ljubicic,Jose Acasuso,Ivan Ljubicic,7-6(2); 6-3,R32,71,16,3,39,58,35,39,11,19,2,2,10,46,58,8,3,48,72,33,48,12,24,2,4,11,45,72
2005-10-03 00:00:00.000,Metz France ATP World Tour,HARD,2,Fabrice Santoro,Jurgen Melzer,Fabrice Santoro,4-6; 6-3; 6-2,R32,105,4,1,48,77,36,48,17,29,2,5,14,53,77,5,1,49,81,33,49,12,32,7,12,13,45,81
2005-10-03 00:00:00.000,Metz France ATP World Tour,HARD,2,Peter Luczak,Yuri Schukin,Peter Luczak,6-4; 7-6(4),R32,83,7,0,45,67,38,45,11,22,0,1,11,49,67,5,1,40,63,30,40,12,23,1,3,11,42,63
2005-10-03 00:00:00.000,Metz France ATP World Tour,HARD,2,Robin Soderling,Tomas Zib,Robin Soderling,7-6(5); 6-4,R32,81,21,5,42,72,38,42,13,30,3,4,11,51,72,5,1,46,74,38,46,10,28,3,5,11,48,74
2005-10-03 00:00:00.000,Metz France ATP World Tour,HARD,2,Agustin Calleri,Nicolas Massu,Agustin Calleri,7-5; 7-5,R32,95,12,2,41,69,32,41,17,28,4,5,12,49,69,5,4,40,69,29,40,15,29,2,5,12,44,69
2005-10-03 00:00:00.000,Metz France ATP World Tour,HARD,2,Mark Philippoussis,Tomas Behrend,Mark Philippoussis,6-1; 3-6; 6-3,R32,86,20,6,58,80,44,58,12,22,2,3,13,56,80,2,1,43,68,29,43,14,25,3,6,12,43,68
2005-10-03 00:00:00.000,Metz France ATP World Tour,HARD,2,Florian Mayer,Younes El Aynaoui,Florian Mayer,4-6; 7-5; 6-1,R32,101,13,2,56,91,41,56,20,35,3,4,15,61,91,7,2,53,77,40,53,10,24,3,6,14,50,77
2005-10-03 00:00:00.000,Metz France ATP World Tour,HARD,2,Dominik Hrbaty,Thierry Ascione,Dominik Hrbaty,6-3; 6-4,R32,77,5,0,36,57,25,36,14,21,1,1,9,39,57,4,4,38,63,26,38,11,25,3,6,10,37,63
2005-10-03 00:00:00.000,Metz France ATP World Tour,HARD,2,Gael Monfils,Juan Ignacio Chela,Gael Monfils,2-6; 6-1; 7-6(4),R32,111,15,3,58,90,45,58,12,32,5,9,14,57,90,0,3,55,82,35,55,14,27,2,6,13,49,82
2005-10-03 00:00:00.000,Metz France ATP World Tour,HARD,2,Arnaud Clement,Tobias Summerer,Arnaud Clement,7-6(3); 6-4,R32,118,8,0,35,63,29,35,18,28,3,4,11,47,63,7,1,40,82,28,40,22,42,10,12,11,50,82
2005-10-03 00:00:00.000,Metz France ATP World Tour,HARD,2,Paul-Henri Mathieu,Igor Andreev,Paul-Henri Mathieu,7-6(5); 6-4,R32,85,2,3,38,72,30,38,21,34,3,4,11,51,72,14,1,38,66,26,38,18,28,1,3,11,44,66
2005-10-03 00:00:00.000,Metz France ATP World Tour,HARD,2,Richard Gasquet,Karol Beck,Richard Gasquet,6-4; 6-2,R32,60,4,1,32,52,24,32,12,20,5,6,9,36,52,4,2,25,46,18,25,5,21,3,7,9,23,46
2005-10-03 00:00:00.000,Metz France ATP World Tour,HARD,2,Nikolay Davydenko,Michael Llodra,Nikolay Davydenko,6-4; 6-4,R16,71,3,0,41,58,32,41,11,17,1,1,10,43,58,4,2,42,60,31,42,6,18,0,2,10,37,60
2005-10-03 00:00:00.000,Metz France ATP World Tour,HARD,2,Andreas Seppi,Andrei Pavel,Andreas Seppi,7-5; 7-6(2),R16,99,10,2,49,73,38,49,16,24,5,5,12,54,73,12,2,61,92,44,61,14,31,9,10,12,58,92
2005-10-03 00:00:00.000,Metz France ATP World Tour,HARD,2,Ivan Ljubicic,Fabrice Santoro,Ivan Ljubicic,4-6; 6-1; 7-6(3),R16,118,19,5,64,103,51,64,19,39,5,7,15,70,103,6,0,51,78,38,51,14,27,0,3,14,52,78
2005-10-03 00:00:00.000,Metz France ATP World Tour,HARD,2,Robin Soderling,Peter Luczak,Robin Soderling,7-6(4); 6-3,R16,69,18,0,50,64,41,50,7,14,5,5,10,48,64,3,2,39,63,27,39,14,24,0,2,11,41,63
2005-10-03 00:00:00.000,Metz France ATP World Tour,HARD,2,Mark Philippoussis,Agustin Calleri,Mark Philippoussis,7-6(8); 6-4,R16,92,10,1,52,71,43,52,11,19,0,0,11,54,71,15,2,46,73,37,46,15,27,1,2,11,52,73
2005-10-03 00:00:00.000,Metz France ATP World Tour,HARD,2,Dominik Hrbaty,Florian Mayer,Dominik Hrbaty,7-6(5); 6-1,R16,67,3,1,34,56,27,34,15,22,0,0,9,42,56,4,2,34,65,22,34,16,31,2,5,10,38,65
2005-10-03 00:00:00.000,Metz France ATP World Tour,HARD,2,Gael Monfils,Arnaud Clement,Gael Monfils,6-2; 6-2,R16,72,7,1,25,43,22,25,12,18,2,2,8,34,43,2,1,38,59,23,38,6,21,6,10,8,29,59
2005-10-03 00:00:00.000,Metz France ATP World Tour,HARD,2,Richard Gasquet,Paul-Henri Mathieu,Richard Gasquet,6-2; 6-2,R16,58,6,0,21,36,20,21,12,15,0,0,8,32,36,3,2,23,54,15,23,12,31,1,5,8,27,54
2005-10-03 00:00:00.000,Metz France ATP World Tour,HARD,2,Nikolay Davydenko,Andreas Seppi,Nikolay Davydenko,6-3; 6-1,Q,64,5,1,30,40,27,30,5,10,0,0,8,32,40,5,4,31,56,21,31,8,25,5,9,8,29,56
2005-10-03 00:00:00.000,Metz France ATP World Tour,HARD,2,Ivan Ljubicic,Robin Soderling,Ivan Ljubicic,6-7(6); 6-3; 6-4,Q,121,24,7,57,95,47,57,24,38,3,3,16,71,95,18,7,61,96,45,61,19,35,5,7,15,64,96
2005-10-03 00:00:00.000,Metz France ATP World Tour,HARD,2,Dominik Hrbaty,Mark Philippoussis,Dominik Hrbaty,6-4; 4-6; 6-1,Q,100,12,3,56,79,42,56,16,23,4,5,14,58,79,13,4,59,83,42,59,9,24,7,10,13,51,83
2005-10-03 00:00:00.000,Metz France ATP World Tour,HARD,2,Gael Monfils,Richard Gasquet,Gael Monfils,7-6(3); 6-3,Q,89,13,2,37,61,28,37,12,24,2,4,10,40,61,2,4,47,73,29,47,9,26,3,7,10,38,73
2005-10-03 00:00:00.000,Metz France ATP World Tour,HARD,2,Ivan Ljubicic,Nikolay Davydenko,Ivan Ljubicic,6-1; 6-4,S,64,10,0,32,42,29,32,7,10,0,0,9,36,42,1,3,38,55,25,38,5,17,6,9,8,30,55
2005-10-03 00:00:00.000,Metz France ATP World Tour,HARD,2,Gael Monfils,Dominik Hrbaty,Gael Monfils,7-6(1); 1-6; 6-2,S,129,11,2,48,89,32,48,19,41,2,6,13,51,89,2,1,64,98,41,64,16,34,7,11,14,57,98
2005-10-03 00:00:00.000,Metz France ATP World Tour,HARD,2,Ivan Ljubicic,Gael Monfils,Ivan Ljubicic,7-6(7); 6-0,F,89,12,2,36,58,33,36,10,22,1,2,9,43,58,5,2,26,58,18,26,14,32,3,7,9,32,58
2005-10-03 00:00:00.000,Tokyo Japan ATP World Tour,HARD,2,Mariano Puerta,N/A Bye,Mariano Puerta,,R64,0,0,0,0,0,0,0,0,0,0,0,0,0,0,0,0,0,0,0,0,0,0,0,0,0,0,0
2005-10-03 00:00:00.000,Tokyo Japan ATP World Tour,HARD,2,Eric Taino,Tasuku Iwami,Eric Taino,7-6(9); 6-4,R64,120,3,2,54,77,37,54,14,23,1,2,11,51,77,5,6,61,104,40,61,19,43,12,14,11,59,104
2005-10-03 00:00:00.000,Tokyo Japan ATP World Tour,HARD,2,Marcos Baghdatis,Janko Tipsarevic,Marcos Baghdatis,6-4; 6-4,R64,70,12,1,33,51,30,33,10,18,0,0,10,40,51,3,3,35,59,26,35,13,24,2,4,10,39,59
2005-10-03 00:00:00.000,Tokyo Japan ATP World Tour,HARD,2,Ivo Minar,N/A Bye,Ivo Minar,,R64,0,0,0,0,0,0,0,0,0,0,0,0,0,0,0,0,0,0,0,0,0,0,0,0,0,0,0
2005-10-03 00:00:00.000,Tokyo Japan ATP World Tour,HARD,2,Cyril Saulnier,N/A Bye,Cyril Saulnier,,R64,0,0,0,0,0,0,0,0,0,0,0,0,0,0,0,0,0,0,0,0,0,0,0,0,0,0,0
2005-10-03 00:00:00.000,Tokyo Japan ATP World Tour,HARD,2,Raemon Sluiter,Lars Burgsmuller,Raemon Sluiter,6-3; 6-1,R64,56,6,0,27,45,22,27,12,18,1,1,8,34,45,2,7,19,45,12,19,11,26,2,6,8,23,45
2005-10-03 00:00:00.000,Tokyo Japan ATP World Tour,HARD,2,Jan-Michael Gambill,Peter Wessels,Jan-Michael Gambill,6-2; 5-7; 6-3,R64,99,17,1,55,87,43,55,18,32,2,3,15,61,87,5,0,62,89,40,62,17,27,6,9,14,57,89
2005-10-03 00:00:00.000,Tokyo Japan ATP World Tour,HARD,2,Mario Ancic,N/A Bye,Mario Ancic,,R64,0,0,0,0,0,0,0,0,0,0,0,0,0,0,0,0,0,0,0,0,0,0,0,0,0,0,0
2005-10-03 00:00:00.000,Tokyo Japan ATP World Tour,HARD,2,Robby Ginepri,N/A Bye,Robby Ginepri,,R64,0,0,0,0,0,0,0,0,0,0,0,0,0,0,0,0,0,0,0,0,0,0,0,0,0,0,0
2005-10-03 00:00:00.000,Tokyo Japan ATP World Tour,HARD,2,Alexander Popp,Gouichi Motomura,Alexander Popp,6-2; 6-4,R64,70,8,1,36,55,30,36,10,19,0,0,9,40,55,1,3,23,53,15,23,15,30,0,3,9,30,53
2005-10-03 00:00:00.000,Tokyo Japan ATP World Tour,HARD,2,Alexander Waske,Justin Gimelstob,Alexander Waske,3-6; 7-6(5); 7-6(3),R64,144,10,8,73,120,52,73,24,47,3,5,16,76,120,25,3,63,102,52,63,21,39,2,3,17,73,102
2005-10-03 00:00:00.000,Tokyo Japan ATP World Tour,HARD,2,Gilles Muller,N/A Bye,Gilles Muller,,R64,0,0,0,0,0,0,0,0,0,0,0,0,0,0,0,0,0,0,0,0,0,0,0,0,0,0,0
2005-10-03 00:00:00.000,Tokyo Japan ATP World Tour,HARD,2,Kenneth Carlsen,N/A Bye,Kenneth Carlsen,,R64,0,0,0,0,0,0,0,0,0,0,0,0,0,0,0,0,0,0,0,0,0,0,0,0,0,0,0
2005-10-03 00:00:00.000,Tokyo Japan ATP World Tour,HARD,2,Nicolas Lapentti,Takahiro Ittogi,Nicolas Lapentti,6-0; 6-1,R64,46,3,0,17,29,15,17,9,12,0,0,6,24,29,1,2,31,43,14,31,1,12,5,11,7,15,43
2005-10-03 00:00:00.000,Tokyo Japan ATP World Tour,HARD,2,Bjorn Phau,Stefan Koubek,Bjorn Phau,6-7(7); 6-4; 7-6(5),R64,144,7,6,61,122,35,61,30,61,4,11,17,65,122,1,4,71,117,40,71,23,46,4,12,17,63,117
2005-10-03 00:00:00.000,Tokyo Japan ATP World Tour,HARD,2,Vincent Spadea,N/A Bye,Vincent Spadea,,R64,0,0,0,0,0,0,0,0,0,0,0,0,0,0,0,0,0,0,0,0,0,0,0,0,0,0,0
2005-10-03 00:00:00.000,Tokyo Japan ATP World Tour,HARD,2,Jarkko Nieminen,N/A Bye,Jarkko Nieminen,,R64,0,0,0,0,0,0,0,0,0,0,0,0,0,0,0,0,0,0,0,0,0,0,0,0,0,0,0
2005-10-03 00:00:00.000,Tokyo Japan ATP World Tour,HARD,2,Rainer Schuettler,Go Soeda,Rainer Schuettler,6-4; 4-6; 6-2,R64,118,5,2,46,80,30,46,20,34,4,7,14,50,80,0,4,57,98,30,57,23,41,4,9,14,53,98
2005-10-03 00:00:00.000,Tokyo Japan ATP World Tour,HARD,2,Takahiro Terachi,Philipp Kohlschreiber,Takahiro Terachi,6-3; 7-6(1),R64,86,1,3,30,67,22,30,23,37,4,6,11,45,67,5,3,37,61,26,37,8,24,2,5,10,34,61
2005-10-03 00:00:00.000,Tokyo Japan ATP World Tour,HARD,2,Paradorn Srichaphan,N/A Bye,Paradorn Srichaphan,,R64,0,0,0,0,0,0,0,0,0,0,0,0,0,0,0,0,0,0,0,0,0,0,0,0,0,0,0
2005-10-03 00:00:00.000,Tokyo Japan ATP World Tour,HARD,2,Juan Monaco,N/A Bye,Juan Monaco,,R64,0,0,0,0,0,0,0,0,0,0,0,0,0,0,0,0,0,0,0,0,0,0,0,0,0,0,0
2005-10-03 00:00:00.000,Tokyo Japan ATP World Tour,HARD,2,Wayne Arthurs,Takao Suzuki,Wayne Arthurs,6-3; 1-6; 7-6(2),R64,98,18,2,49,75,40,49,16,26,0,2,14,56,75,14,4,51,81,43,51,14,30,5,6,14,57,81
2005-10-03 00:00:00.000,Tokyo Japan ATP World Tour,HARD,2,Dmitry Tursunov,Guillermo Garcia-Lopez,Dmitry Tursunov,3-6; 6-4; 6-1,R64,83,15,8,45,70,38,45,9,25,5,8,13,47,70,0,4,59,86,35,59,13,27,3,8,13,48,86
2005-10-03 00:00:00.000,Tokyo Japan ATP World Tour,HARD,2,Taylor Dent,N/A Bye,Taylor Dent,,R64,0,0,0,0,0,0,0,0,0,0,0,0,0,0,0,0,0,0,0,0,0,0,0,0,0,0,0
2005-10-03 00:00:00.000,Tokyo Japan ATP World Tour,HARD,2,Mikhail Youzhny,N/A Bye,Mikhail Youzhny,,R64,0,0,0,0,0,0,0,0,0,0,0,0,0,0,0,0,0,0,0,0,0,0,0,0,0,0,0
2005-10-03 00:00:00.000,Tokyo Japan ATP World Tour,HARD,2,Wesley Moodie,Jimmy Wang,Wesley Moodie,6-1; 6-4,R64,48,8,0,35,44,30,35,3,9,1,2,9,33,44,1,3,29,41,15,29,6,12,0,4,8,21,41
2005-10-03 00:00:00.000,Tokyo Japan ATP World Tour,HARD,2,Roko Karanusic,Danai Udomchoke,Roko Karanusic,7-6(5); 6-4,R64,93,1,0,49,75,35,49,14,26,3,5,11,49,75,0,3,62,97,36,62,19,35,13,16,11,55,97
2005-10-03 00:00:00.000,Tokyo Japan ATP World Tour,HARD,2,Luis Horna,N/A Bye,Luis Horna,,R64,0,0,0,0,0,0,0,0,0,0,0,0,0,0,0,0,0,0,0,0,0,0,0,0,0,0,0
2005-10-03 00:00:00.000,Tokyo Japan ATP World Tour,HARD,2,Robin Vik,N/A Bye,Robin Vik,,R64,0,0,0,0,0,0,0,0,0,0,0,0,0,0,0,0,0,0,0,0,0,0,0,0,0,0,0
2005-10-03 00:00:00.000,Tokyo Japan ATP World Tour,HARD,2,Kevin Kim,Denis Gremelmayr,Kevin Kim,6-2; 7-6(3),R64,81,3,2,48,72,33,48,11,24,7,9,10,44,72,1,3,49,77,26,49,14,28,6,10,10,40,77
2005-10-03 00:00:00.000,Tokyo Japan ATP World Tour,HARD,2,Jiri Vanek,Lukas Dlouhy,Jiri Vanek,7-6(4); 7-6(5),R64,114,12,2,53,79,41,53,11,26,3,5,12,52,79,8,4,66,99,41,66,19,33,5,7,12,60,99
2005-10-03 00:00:00.000,Tokyo Japan ATP World Tour,HARD,2,Radek Stepanek,N/A Bye,Radek Stepanek,,R64,0,0,0,0,0,0,0,0,0,0,0,0,0,0,0,0,0,0,0,0,0,0,0,0,0,0,0
2005-10-03 00:00:00.000,Tokyo Japan ATP World Tour,HARD,2,Mariano Puerta,Eric Taino,Mariano Puerta,6-3; 6-4,R32,59,7,0,39,54,34,39,8,15,0,0,10,42,54,10,3,31,46,25,31,7,15,0,2,9,32,46
2005-10-03 00:00:00.000,Tokyo Japan ATP World Tour,HARD,2,Marcos Baghdatis,Ivo Minar,Marcos Baghdatis,6-4; 6-2,R32,76,6,1,35,54,26,35,13,19,1,1,9,39,54,3,4,52,77,31,52,10,25,5,8,9,41,77
2005-10-03 00:00:00.000,Tokyo Japan ATP World Tour,HARD,2,Cyril Saulnier,Raemon Sluiter,Cyril Saulnier,6-3; 6-7(5); 7-5,R32,136,10,3,68,112,51,68,23,44,5,7,17,74,112,9,6,55,100,40,55,22,45,3,7,16,62,100
2005-10-03 00:00:00.000,Tokyo Japan ATP World Tour,HARD,2,Mario Ancic,Jan-Michael Gambill,Mario Ancic,3-6; 6-3; 6-4,R32,113,9,2,50,75,42,50,16,25,5,6,14,58,75,12,3,56,95,44,56,18,39,8,10,14,62,95
2005-10-03 00:00:00.000,Tokyo Japan ATP World Tour,HARD,2,Robby Ginepri,Alexander Popp,Robby Ginepri,6-4; 6-0,R32,50,6,0,25,39,20,25,12,14,0,0,8,32,39,4,2,31,49,17,31,9,18,4,8,8,26,49
2005-10-03 00:00:00.000,Tokyo Japan ATP World Tour,HARD,2,Gilles Muller,Alexander Waske,Gilles Muller,7-5; 4-6; 6-1,R32,123,12,7,61,107,46,61,24,46,8,9,15,70,107,14,4,51,80,41,51,13,29,4,7,14,54,80
2005-10-03 00:00:00.000,Tokyo Japan ATP World Tour,HARD,2,Kenneth Carlsen,Nicolas Lapentti,Kenneth Carlsen,7-6(1); 7-6(9),R32,126,12,2,56,83,45,56,17,27,1,1,12,62,83,7,2,61,86,47,61,14,25,2,2,12,61,86
2005-10-03 00:00:00.000,Tokyo Japan ATP World Tour,HARD,2,Bjorn Phau,Vincent Spadea,Bjorn Phau,6-4; 7-5,R32,88,7,3,37,74,27,37,19,37,6,8,11,46,74,2,2,40,72,25,40,17,32,8,12,11,42,72
2005-10-03 00:00:00.000,Tokyo Japan ATP World Tour,HARD,2,Jarkko Nieminen,Rainer Schuettler,Jarkko Nieminen,6-1; 6-1,R32,46,2,0,31,40,25,31,4,9,1,1,7,29,40,1,3,27,44,11,27,8,17,4,9,7,19,44
2005-10-03 00:00:00.000,Tokyo Japan ATP World Tour,HARD,2,Paradorn Srichaphan,Takahiro Terachi,Paradorn Srichaphan,6-1; 6-4,R32,73,4,1,36,56,28,36,9,20,2,3,9,37,56,2,3,29,60,15,29,15,31,6,10,8,30,60
2005-10-03 00:00:00.000,Tokyo Japan ATP World Tour,HARD,2,Wayne Arthurs,Juan Monaco,Wayne Arthurs,4-6; 6-1; 6-4,R32,110,24,5,64,101,47,64,20,37,7,8,14,67,101,1,0,61,86,36,61,17,25,4,7,13,53,86
2005-10-03 00:00:00.000,Tokyo Japan ATP World Tour,HARD,2,Taylor Dent,Dmitry Tursunov,Taylor Dent,6-3; 7-6(3),R32,91,7,7,36,81,26,36,23,45,4,7,11,49,81,6,7,38,74,29,38,11,36,6,10,10,40,74
2005-10-03 00:00:00.000,Tokyo Japan ATP World Tour,HARD,2,Wesley Moodie,Mikhail Youzhny,Wesley Moodie,6-1; 3-6; 6-3,R32,115,11,3,55,80,40,55,16,25,3,4,13,56,80,5,4,49,89,35,49,19,40,9,12,12,54,89
2005-10-03 00:00:00.000,Tokyo Japan ATP World Tour,HARD,2,Luis Horna,Roko Karanusic,Luis Horna,6-2; 7-5,R32,73,6,0,38,57,28,38,12,19,2,3,10,40,57,3,1,35,64,25,35,10,29,10,14,10,35,64
2005-10-03 00:00:00.000,Tokyo Japan ATP World Tour,HARD,2,Kevin Kim,Robin Vik,Kevin Kim,6-2; 6-4,R32,63,1,1,36,60,26,36,13,24,0,1,9,39,60,2,1,38,50,21,38,6,12,1,5,9,27,50
2005-10-03 00:00:00.000,Tokyo Japan ATP World Tour,HARD,2,Radek Stepanek,Jiri Vanek,Radek Stepanek,7-5; 6-4,R32,73,10,1,46,69,37,46,13,23,5,5,11,50,69,8,3,40,67,30,40,13,27,5,7,11,43,67
2005-10-03 00:00:00.000,Tokyo Japan ATP World Tour,HARD,2,Marcos Baghdatis,Mariano Puerta,Marcos Baghdatis,6-2; 6-7(11); 7-5,R16,146,17,4,59,107,48,59,30,48,5,6,16,78,107,5,1,74,110,55,74,15,36,4,8,16,70,110
2005-10-03 00:00:00.000,Tokyo Japan ATP World Tour,HARD,2,Mario Ancic,Cyril Saulnier,Mario Ancic,6-2; 6-1,R16,60,7,0,21,43,18,21,15,22,0,0,8,33,43,3,2,22,36,14,22,5,14,0,4,7,19,36
2005-10-03 00:00:00.000,Tokyo Japan ATP World Tour,HARD,2,Robby Ginepri,Gilles Muller,Robby Ginepri,6-4; 6-4,R16,70,6,3,30,52,26,30,11,22,0,1,10,37,52,11,6,42,62,28,42,7,20,1,4,10,35,62
2005-10-03 00:00:00.000,Tokyo Japan ATP World Tour,HARD,2,Bjorn Phau,Kenneth Carlsen,Bjorn Phau,6-1; 6-2,R16,60,0,0,19,41,14,19,15,22,1,2,8,29,41,1,1,23,44,11,23,5,21,3,8,7,16,44
2005-10-03 00:00:00.000,Tokyo Japan ATP World Tour,HARD,2,Jarkko Nieminen,Paradorn Srichaphan,Jarkko Nieminen,2-6; 7-6(6); 7-5,R16,126,4,2,73,106,51,73,17,33,7,10,16,68,106,8,1,69,103,51,69,18,34,3,5,16,69,103
2005-10-03 00:00:00.000,Tokyo Japan ATP World Tour,HARD,2,Taylor Dent,Wayne Arthurs,Taylor Dent,6-4; 6-7(5); 6-3,R16,103,8,7,50,99,40,50,32,49,5,5,16,72,99,12,3,64,89,50,64,15,25,2,4,15,65,89
2005-10-03 00:00:00.000,Tokyo Japan ATP World Tour,HARD,2,Wesley Moodie,Luis Horna,Wesley Moodie,7-6(4); 6-7(2); 6-4,R16,144,20,3,84,114,66,84,15,30,1,1,17,81,114,6,1,71,99,57,71,19,28,1,2,17,76,99
2005-10-03 00:00:00.000,Tokyo Japan ATP World Tour,HARD,2,Radek Stepanek,Kevin Kim,Radek Stepanek,6-1; 6-3,R16,59,5,0,39,59,27,39,12,20,4,4,8,39,59,0,1,34,50,16,34,8,16,2,6,8,24,50
2005-10-03 00:00:00.000,Tokyo Japan ATP World Tour,HARD,2,Mario Ancic,Marcos Baghdatis,Mario Ancic,6-1; 7-6(4),Q,84,8,3,37,61,29,37,13,24,1,2,10,42,61,3,1,33,60,21,33,11,27,3,6,9,32,60
2005-10-03 00:00:00.000,Tokyo Japan ATP World Tour,HARD,2,Bjorn Phau,Robby Ginepri,Bjorn Phau,6-4; 6-3,Q,65,5,0,31,54,27,31,11,23,1,2,9,38,54,2,1,33,63,19,33,14,30,0,4,10,33,63
2005-10-03 00:00:00.000,Tokyo Japan ATP World Tour,HARD,2,Jarkko Nieminen,Taylor Dent,Jarkko Nieminen,6-4; 5-7; 7-6(3),Q,135,2,1,87,122,49,87,25,35,11,16,17,74,122,12,8,74,121,50,74,18,47,7,12,17,68,121
2005-10-03 00:00:00.000,Tokyo Japan ATP World Tour,HARD,2,Wesley Moodie,Radek Stepanek,Wesley Moodie,7-6(2); 7-6(6),Q,109,9,1,57,79,46,57,15,22,1,1,12,61,79,9,3,67,97,53,67,13,30,6,6,12,66,97
2005-10-03 00:00:00.000,Tokyo Japan ATP World Tour,HARD,2,Mario Ancic,Bjorn Phau,Mario Ancic,6-2; 6-1,S,69,13,2,30,44,26,30,7,14,1,1,8,33,44,1,4,26,63,16,26,15,37,4,8,7,31,63
2005-10-03 00:00:00.000,Tokyo Japan ATP World Tour,HARD,2,Wesley Moodie,Jarkko Nieminen,Wesley Moodie,4-6; 6-1; 7-6(4),S,128,17,4,67,103,52,67,15,36,5,7,15,67,103,2,3,76,107,48,76,15,31,10,13,14,63,107
2005-10-03 00:00:00.000,Tokyo Japan ATP World Tour,HARD,2,Wesley Moodie,Mario Ancic,Wesley Moodie,1-6; 7-6(7); 6-4,F,137,11,0,74,102,51,74,13,28,6,9,14,64,102,12,3,52,89,42,52,19,37,1,3,15,61,89
2005-10-10 00:00:00.000,Moscow Russia ATP World Tour,HARD,2,Daniele Bracciali,Nikolay Davydenko,Daniele Bracciali,3-6; 6-4; 6-4,R32,113,0,4,47,88,39,47,21,41,5,7,15,60,88,7,2,61,88,42,61,15,27,3,5,14,57,88
2005-10-10 00:00:00.000,Moscow Russia ATP World Tour,HARD,2,Jan Hernych,Florent Serra,Jan Hernych,6-4; 6-4,R32,68,3,0,38,59,28,38,12,21,5,7,10,40,59,1,4,31,58,20,31,12,27,2,6,10,32,58
2005-10-10 00:00:00.000,Moscow Russia ATP World Tour,HARD,2,Arnaud Clement,Robin Vik,Arnaud Clement,7-5; 6-2,R32,96,3,1,33,66,29,33,16,33,3,4,10,45,66,2,3,42,70,28,42,12,28,3,7,10,40,70
2005-10-10 00:00:00.000,Moscow Russia ATP World Tour,HARD,2,Igor Andreev,Philipp Kohlschreiber,Igor Andreev,6-4; 6-2,R32,68,1,1,33,50,27,33,11,17,3,3,9,38,50,1,3,31,69,22,31,14,38,5,8,9,36,69
2005-10-10 00:00:00.000,Moscow Russia ATP World Tour,HARD,2,Mikhail Youzhny,Lukas Dlouhy,Mikhail Youzhny,6-4; 6-3,R32,73,2,2,40,61,33,40,8,21,1,2,10,41,61,3,3,36,60,19,36,16,24,3,6,9,35,60
2005-10-10 00:00:00.000,Moscow Russia ATP World Tour,HARD,2,Paul Goldstein,Mikhail Ledovskikh,Paul Goldstein,6-2; 6-4,R32,73,2,1,45,64,28,45,11,19,1,2,9,39,64,2,4,29,58,18,29,12,29,3,7,9,30,58
2005-10-10 00:00:00.000,Moscow Russia ATP World Tour,HARD,2,Dmitry Tursunov,Kenneth Carlsen,Dmitry Tursunov,6-1; 1-0 RET,R32,28,3,2,15,22,13,15,3,7,0,0,4,16,22,3,0,11,22,5,11,4,11,3,6,4,9,22
2005-10-10 00:00:00.000,Moscow Russia ATP World Tour,HARD,2,Filippo Volandri,Razvan Sabau,Filippo Volandri,6-0; 6-1,R32,39,2,4,22,38,20,22,9,16,1,1,7,29,38,1,1,28,40,12,28,2,12,3,8,6,14,40
2005-10-10 00:00:00.000,Moscow Russia ATP World Tour,HARD,2,Nicolas Kiefer,Alexander Popp,Nicolas Kiefer,6-4; 6-1,R32,83,1,1,30,54,22,30,13,24,1,2,9,35,54,1,4,28,54,14,28,13,26,3,7,8,27,54
2005-10-10 00:00:00.000,Moscow Russia ATP World Tour,HARD,2,Florian Mayer,Lars Burgsmuller,Florian Mayer,6-3; 6-2,R32,57,3,1,29,54,23,29,16,25,1,1,9,39,54,4,3,27,42,18,27,6,15,0,3,8,24,42
2005-10-10 00:00:00.000,Moscow Russia ATP World Tour,HARD,2,Teymuraz Gabashvili,Gilles Muller,Teymuraz Gabashvili,6-3; 6-1,R32,67,7,0,33,47,26,33,9,14,0,0,8,35,47,4,1,29,50,19,29,8,21,5,9,8,27,50
2005-10-10 00:00:00.000,Moscow Russia ATP World Tour,HARD,2,Max Mirnyi,Evgeny Kirillov,Max Mirnyi,6-1; 6-3,R32,65,6,4,39,54,29,39,6,15,6,7,8,35,54,3,4,33,63,17,33,12,30,1,6,8,29,63
2005-10-10 00:00:00.000,Moscow Russia ATP World Tour,HARD,2,Greg Rusedski,Michael Llodra,Greg Rusedski,6-3; 6-1,R32,55,7,2,26,44,25,26,9,18,0,0,8,34,44,2,4,38,58,23,38,6,20,5,9,8,29,58
2005-10-10 00:00:00.000,Moscow Russia ATP World Tour,HARD,2,Igor Kunitsyn,Fabrice Santoro,Igor Kunitsyn,6-4; 6-4,R32,99,0,1,30,53,19,30,14,23,2,5,10,33,53,2,2,39,83,20,39,21,44,7,12,10,41,83
2005-10-10 00:00:00.000,Moscow Russia ATP World Tour,HARD,2,Andrei Pavel,Stephane Bohli,Andrei Pavel,6-4; 6-4,R32,73,6,1,46,71,37,46,12,25,6,6,10,49,71,0,2,34,57,23,34,14,23,0,2,10,37,57
2005-10-10 00:00:00.000,Moscow Russia ATP World Tour,HARD,2,Cyril Saulnier,Dominik Hrbaty,Cyril Saulnier,4-6; 6-3; 6-3,R32,101,8,0,43,75,34,43,21,32,3,4,14,55,75,8,3,44,80,32,44,20,36,6,9,14,52,80
2005-10-10 00:00:00.000,Moscow Russia ATP World Tour,HARD,2,Daniele Bracciali,Jan Hernych,Daniele Bracciali,6-3; 7-6(6),R16,97,3,1,46,66,32,46,8,20,1,3,10,40,66,2,1,63,84,33,63,11,21,6,10,11,44,84
2005-10-10 00:00:00.000,Moscow Russia ATP World Tour,HARD,2,Igor Andreev,Arnaud Clement,Igor Andreev,6-2; 6-4,R16,68,10,0,36,49,29,36,6,13,3,4,9,35,49,1,3,28,48,18,28,9,20,2,6,9,27,48
2005-10-10 00:00:00.000,Moscow Russia ATP World Tour,HARD,2,Mikhail Youzhny,Paul Goldstein,Mikhail Youzhny,7-5; 4-6; 6-3,R16,136,5,1,58,96,40,58,18,38,4,9,16,58,96,5,4,68,100,38,68,15,32,6,12,15,53,100
2005-10-10 00:00:00.000,Moscow Russia ATP World Tour,HARD,2,Dmitry Tursunov,Filippo Volandri,Dmitry Tursunov,6-1; 7-6(6),R16,88,5,5,38,77,30,38,18,39,3,4,10,48,77,1,1,39,63,22,39,13,24,1,4,9,35,63
2005-10-10 00:00:00.000,Moscow Russia ATP World Tour,HARD,2,Nicolas Kiefer,Florian Mayer,Nicolas Kiefer,6-4; 6-3,R16,82,4,1,30,64,21,30,24,34,4,4,10,45,64,2,1,47,63,31,47,8,16,4,6,9,39,63
2005-10-10 00:00:00.000,Moscow Russia ATP World Tour,HARD,2,Max Mirnyi,Teymuraz Gabashvili,Max Mirnyi,4-6; 6-3; 6-1,R16,94,12,1,48,70,42,48,8,22,2,4,13,50,70,4,6,40,71,28,40,15,31,2,7,13,43,71
2005-10-10 00:00:00.000,Moscow Russia ATP World Tour,HARD,2,Igor Kunitsyn,Greg Rusedski,Igor Kunitsyn,7-6(5); 6-3,R16,84,1,2,39,62,29,39,16,23,1,2,11,45,62,3,7,45,75,30,45,15,30,5,7,10,45,75
2005-10-10 00:00:00.000,Moscow Russia ATP World Tour,HARD,2,Andrei Pavel,Cyril Saulnier,Andrei Pavel,7-6(3); 2-6; 7-5,R16,136,8,1,71,107,48,71,20,36,4,8,16,68,107,4,6,59,102,42,59,25,43,3,6,16,67,102
2005-10-10 00:00:00.000,Moscow Russia ATP World Tour,HARD,2,Igor Andreev,Daniele Bracciali,Igor Andreev,6-4; 6-1,Q,66,6,0,33,48,25,33,9,15,2,2,8,34,48,2,2,24,51,17,24,12,27,2,6,9,29,51
2005-10-10 00:00:00.000,Moscow Russia ATP World Tour,HARD,2,Dmitry Tursunov,Mikhail Youzhny,Dmitry Tursunov,6-2; 4-6; 6-2,Q,100,5,1,53,73,44,53,11,20,5,6,13,55,73,4,1,44,70,29,44,15,26,4,8,13,44,70
2005-10-10 00:00:00.000,Moscow Russia ATP World Tour,HARD,2,Nicolas Kiefer,Max Mirnyi,Nicolas Kiefer,6-3; 6-4,Q,70,5,1,31,54,27,31,15,23,1,1,10,42,54,6,1,30,45,24,30,5,15,0,2,9,29,45
2005-10-10 00:00:00.000,Moscow Russia ATP World Tour,HARD,2,Igor Kunitsyn,Andrei Pavel,Igor Kunitsyn,6-3; 6-2,Q,66,2,0,28,55,22,28,16,27,3,3,8,38,55,3,2,33,53,23,33,6,20,2,6,9,29,53
2005-10-10 00:00:00.000,Moscow Russia ATP World Tour,HARD,2,Igor Andreev,Dmitry Tursunov,Igor Andreev,5-7; 7-5; 6-2,S,155,7,1,62,106,47,62,20,44,2,5,16,67,106,8,6,69,115,47,69,19,46,11,16,16,66,115
2005-10-10 00:00:00.000,Moscow Russia ATP World Tour,HARD,2,Nicolas Kiefer,Igor Kunitsyn,Nicolas Kiefer,6-2; 6-4,S,80,10,4,22,47,21,22,11,25,1,3,9,32,47,0,1,28,57,14,28,14,29,2,7,9,28,57
2005-10-10 00:00:00.000,Moscow Russia ATP World Tour,HARD,2,Igor Andreev,Nicolas Kiefer,Igor Andreev,5-7; 7-6(3); 6-2,F,194,9,1,75,111,52,75,14,36,7,11,16,66,111,11,5,58,95,41,58,14,37,3,8,16,55,95
2005-10-10 00:00:00.000,Stockholm Sweden ATP World Tour,HARD,2,Thomas Johansson,Ervin Eleskovic,Thomas Johansson,7-6(4); 7-6(4),R32,111,7,0,43,78,37,43,20,35,0,0,12,57,78,12,9,52,92,44,52,16,40,2,2,12,60,92
2005-10-10 00:00:00.000,Stockholm Sweden ATP World Tour,HARD,2,Vincent Spadea,Juan Ignacio Chela,Vincent Spadea,6-2; 4-6; 6-1,R32,112,3,5,53,99,36,53,24,46,4,6,13,60,99,2,3,54,88,33,54,15,34,4,9,12,48,88
2005-10-10 00:00:00.000,Stockholm Sweden ATP World Tour,HARD,2,Alexander Waske,Tomas Behrend,Alexander Waske,7-5; 6-4,R32,80,12,6,35,61,33,35,12,26,2,3,11,45,61,7,3,38,65,27,38,13,27,2,5,11,40,65
2005-10-10 00:00:00.000,Stockholm Sweden ATP World Tour,HARD,2,Paradorn Srichaphan,Fernando Verdasco,Paradorn Srichaphan,7-6(4); 6-3,R32,87,3,1,40,67,30,40,11,27,2,5,10,41,67,7,3,45,73,25,45,13,28,1,6,11,38,73
2005-10-10 00:00:00.000,Stockholm Sweden ATP World Tour,HARD,2,Davide Sanguinetti,Taylor Dent,Davide Sanguinetti,2-6; 6-4; 6-4,R32,106,6,1,60,90,44,60,15,30,7,9,14,59,90,13,12,53,104,40,53,25,51,8,10,14,65,104
2005-10-10 00:00:00.000,Stockholm Sweden ATP World Tour,HARD,2,George Bastl,Tomas Cakl,George Bastl,6-4; 7-5,R32,96,10,2,41,65,33,41,15,24,0,0,11,48,65,11,9,36,84,28,36,22,48,8,10,11,50,84
2005-10-10 00:00:00.000,Stockholm Sweden ATP World Tour,HARD,2,Rainer Schuettler,Thomas Enqvist,Rainer Schuettler,6-4; 6-3,R32,77,8,1,32,55,20,32,9,23,3,8,10,29,55,5,4,19,51,11,19,9,32,4,11,9,20,51
2005-10-10 00:00:00.000,Stockholm Sweden ATP World Tour,HARD,2,Jarkko Nieminen,Nicolas Massu,Jarkko Nieminen,7-6(1); 6-2,R32,92,2,2,35,57,30,35,15,22,2,2,10,45,57,7,3,40,70,29,40,13,30,1,3,10,42,70
2005-10-10 00:00:00.000,Stockholm Sweden ATP World Tour,HARD,2,Olivier Rochus,Frederic Niemeyer,Olivier Rochus,6-2; 6-4,R32,72,1,1,41,61,26,41,11,20,3,5,9,37,61,6,2,23,49,13,23,13,26,3,8,9,26,49
2005-10-10 00:00:00.000,Stockholm Sweden ATP World Tour,HARD,2,Julien Benneteau,Paul-Henri Mathieu,Julien Benneteau,6-1; 6-3,R32,66,3,2,31,46,26,31,9,15,5,5,8,35,46,3,5,24,55,16,24,12,31,4,8,8,28,55
2005-10-10 00:00:00.000,Stockholm Sweden ATP World Tour,HARD,2,Jonas Bjorkman,Wesley Moodie,Jonas Bjorkman,6-4; 6-2,R32,63,6,0,28,47,25,28,13,19,1,1,9,38,47,4,5,35,56,22,35,9,21,5,8,9,31,56
2005-10-10 00:00:00.000,Stockholm Sweden ATP World Tour,HARD,2,Mario Ancic,Karol Beck,Mario Ancic,7-6(2); 6-4,R32,101,13,2,36,68,28,36,19,32,3,4,11,47,68,8,4,44,69,30,44,11,25,1,3,11,41,69
2005-10-10 00:00:00.000,Stockholm Sweden ATP World Tour,HARD,2,James Blake,Guillermo Garcia-Lopez,James Blake,7-6(4); 6-4,R32,85,6,2,39,66,31,39,16,27,1,2,11,47,66,2,2,51,78,35,51,14,27,3,5,11,49,78
2005-10-10 00:00:00.000,Stockholm Sweden ATP World Tour,HARD,2,Christophe Rochus,Jose Acasuso,Christophe Rochus,6-3; 6-7(4); 6-2,R32,94,4,4,50,80,41,50,14,30,2,4,14,55,80,13,5,59,98,35,59,19,39,5,11,15,54,98
2005-10-10 00:00:00.000,Stockholm Sweden ATP World Tour,HARD,2,Xavier Malisse,Juan Monaco,Xavier Malisse,7-6(3); 7-5,R32,98,4,0,43,69,31,43,13,26,3,6,12,44,69,0,1,48,73,27,48,14,25,0,4,12,41,73
2005-10-10 00:00:00.000,Stockholm Sweden ATP World Tour,HARD,2,Alberto Martin,David Ferrer,Alberto Martin,2-6; 6-3; 6-2,R32,107,2,1,56,93,36,56,14,37,3,8,13,50,93,1,4,40,76,24,40,15,36,3,9,12,39,76
2005-10-10 00:00:00.000,Stockholm Sweden ATP World Tour,HARD,2,Thomas Johansson,Vincent Spadea,Thomas Johansson,6-3; 6-4,R16,77,6,0,29,49,25,29,13,20,0,0,9,38,49,1,1,48,70,32,48,10,22,5,8,10,42,70
2005-10-10 00:00:00.000,Stockholm Sweden ATP World Tour,HARD,2,Paradorn Srichaphan,Alexander Waske,Paradorn Srichaphan,6-3; 6-2,R16,58,4,3,30,48,27,30,10,18,1,1,9,37,48,6,3,22,46,14,22,12,24,0,3,8,26,46
2005-10-10 00:00:00.000,Stockholm Sweden ATP World Tour,HARD,2,Davide Sanguinetti,George Bastl,Davide Sanguinetti,5-7; 6-4; 6-4,R16,138,6,2,67,106,47,67,22,39,8,10,16,69,106,8,2,59,94,44,59,17,35,8,11,16,61,94
2005-10-10 00:00:00.000,Stockholm Sweden ATP World Tour,HARD,2,Rainer Schuettler,Jarkko Nieminen,Rainer Schuettler,6-3; 3-0 RET,R16,51,1,0,20,36,14,20,8,16,1,2,6,22,36,0,3,17,34,7,17,6,17,3,7,6,13,34
2005-10-10 00:00:00.000,Stockholm Sweden ATP World Tour,HARD,2,Olivier Rochus,Julien Benneteau,Olivier Rochus,6-4; 6-2,R16,94,2,0,44,66,31,44,14,22,2,2,9,45,66,9,3,44,69,30,44,10,25,8,11,9,40,69
2005-10-10 00:00:00.000,Stockholm Sweden ATP World Tour,HARD,2,Jonas Bjorkman,Mario Ancic,Jonas Bjorkman,7-5; 7-6(7),R16,120,5,4,46,82,37,46,18,36,4,6,12,55,82,9,2,52,82,31,52,19,30,4,7,12,50,82
2005-10-10 00:00:00.000,Stockholm Sweden ATP World Tour,HARD,2,James Blake,Christophe Rochus,James Blake,6-7(9); 7-5; 6-2,R16,117,15,3,62,107,44,62,19,45,2,7,16,63,107,1,8,56,105,32,56,23,49,4,12,16,55,105
2005-10-10 00:00:00.000,Stockholm Sweden ATP World Tour,HARD,2,Alberto Martin,Xavier Malisse,Alberto Martin,3-6; 6-3; 7-6(4),R16,141,3,6,52,119,37,52,33,67,8,11,15,70,119,9,2,61,91,41,61,18,30,3,6,15,59,91
2005-10-10 00:00:00.000,Stockholm Sweden ATP World Tour,HARD,2,Paradorn Srichaphan,Thomas Johansson,Paradorn Srichaphan,2-6; 6-1; 6-4,Q,98,4,3,50,79,39,50,13,29,4,6,13,52,79,12,0,41,67,30,41,13,26,3,6,12,43,67
2005-10-10 00:00:00.000,Stockholm Sweden ATP World Tour,HARD,2,Davide Sanguinetti,Rainer Schuettler,Davide Sanguinetti,6-4; 6-3,Q,73,3,0,43,72,31,43,15,29,1,1,9,46,72,2,1,34,58,21,34,14,24,3,6,10,35,58
2005-10-10 00:00:00.000,Stockholm Sweden ATP World Tour,HARD,2,Olivier Rochus,Jonas Bjorkman,Olivier Rochus,1-6; 7-6(3); 6-2,Q,116,1,2,68,96,48,68,12,28,7,10,13,60,96,9,4,44,78,35,44,17,34,2,5,14,52,78
2005-10-10 00:00:00.000,Stockholm Sweden ATP World Tour,HARD,2,James Blake,Alberto Martin,James Blake,6-1; 6-2,Q,52,6,2,25,41,20,25,9,16,0,1,8,29,41,0,3,23,49,7,23,14,26,3,8,7,21,49
2005-10-10 00:00:00.000,Stockholm Sweden ATP World Tour,HARD,2,Paradorn Srichaphan,Davide Sanguinetti,Paradorn Srichaphan,4-6; 7-5; 6-3,S,125,8,4,49,92,34,49,26,43,5,8,16,60,92,7,1,63,112,39,63,26,49,12,16,15,65,112
2005-10-10 00:00:00.000,Stockholm Sweden ATP World Tour,HARD,2,James Blake,Olivier Rochus,James Blake,6-4; 6-3,S,75,17,1,40,68,29,40,11,28,8,10,9,40,68,0,1,36,57,20,36,10,21,1,6,10,30,57
2005-10-10 00:00:00.000,Stockholm Sweden ATP World Tour,HARD,2,James Blake,Paradorn Srichaphan,James Blake,6-1; 7-6(6),F,82,7,1,39,66,32,39,14,27,4,5,9,46,66,0,7,35,77,22,35,20,42,8,12,10,42,77
2005-10-10 00:00:00.000,Vienna Austria ATP World Tour,HARD,2,David Nalbandian,Sebastien Grosjean,David Nalbandian,6-4; 6-7(9); 6-3,R32,149,3,5,55,104,40,55,29,49,1,3,16,69,104,8,4,59,106,45,59,20,47,3,7,15,65,106
2005-10-10 00:00:00.000,Vienna Austria ATP World Tour,HARD,2,Rainer Eitzinger,Nicolas Almagro,Rainer Eitzinger,7-6(6); 6-2,R32,84,0,3,51,83,39,51,15,32,6,7,10,54,83,8,2,42,65,28,42,14,23,1,4,10,42,65
2005-10-10 00:00:00.000,Vienna Austria ATP World Tour,HARD,2,Nicolas Lapentti,Andreas Seppi,Nicolas Lapentti,7-5; 7-6(6),R32,138,2,2,36,70,27,36,13,34,2,6,12,40,70,4,3,57,107,37,57,17,50,8,13,12,54,107
2005-10-10 00:00:00.000,Vienna Austria ATP World Tour,HARD,2,Juan Carlos Ferrero,Stanislas Wawrinka,Juan Carlos Ferrero,3-6; 6-2; 6-3,R32,95,2,0,42,70,31,42,20,28,1,2,13,51,70,7,4,55,81,40,55,11,26,3,6,13,51,81
2005-10-10 00:00:00.000,Vienna Austria ATP World Tour,HARD,2,Radek Stepanek,Luis Horna,Radek Stepanek,6-7(2); 6-0; 6-3,R32,118,10,0,51,86,41,51,23,35,3,3,14,64,86,4,8,51,88,37,51,16,37,3,7,13,53,88
2005-10-10 00:00:00.000,Vienna Austria ATP World Tour,HARD,2,Tim Henman,Antony Dupuis,Tim Henman,7-5; 6-3,R32,88,5,1,41,64,32,41,14,23,1,2,11,46,64,0,1,37,64,23,37,14,27,4,7,10,37,64
2005-10-10 00:00:00.000,Vienna Austria ATP World Tour,HARD,2,Oliver Marach,Jiri Novak,Oliver Marach,6-4; 6-3,R32,68,6,0,30,50,25,30,10,20,1,2,9,35,50,1,4,37,59,23,37,11,22,3,7,10,34,59
2005-10-10 00:00:00.000,Vienna Austria ATP World Tour,HARD,2,Feliciano Lopez,Alexander Peya,Feliciano Lopez,6-3; 3-6; 6-2,R32,115,4,3,47,76,35,47,17,29,3,5,13,52,76,10,2,61,97,38,61,18,36,9,13,13,56,97
2005-10-10 00:00:00.000,Vienna Austria ATP World Tour,HARD,2,Fernando Gonzalez,Tomas Berdych,Fernando Gonzalez,6-2; 6-2,R32,73,6,2,24,44,21,24,13,20,0,0,8,34,44,2,1,32,65,21,32,12,33,7,11,8,33,65
2005-10-10 00:00:00.000,Vienna Austria ATP World Tour,HARD,2,Carlos Moya,Bjorn Phau,Carlos Moya,7-5; 6-4,R32,93,3,1,44,80,31,44,19,36,5,6,11,50,80,2,2,44,70,30,44,11,26,6,9,11,41,70
2005-10-10 00:00:00.000,Vienna Austria ATP World Tour,HARD,2,Tommy Haas,Tomas Zib,Tommy Haas,6-4; 6-3,R32,72,8,4,28,47,26,28,8,19,0,1,9,34,47,3,1,33,62,24,33,10,29,3,7,10,34,62
2005-10-10 00:00:00.000,Vienna Austria ATP World Tour,HARD,2,Ivan Ljubicic,Agustin Calleri,Ivan Ljubicic,6-4; 6-3,R32,70,8,0,36,59,29,36,14,23,2,2,10,43,59,4,1,27,46,19,27,14,19,1,3,9,33,46
2005-10-10 00:00:00.000,Vienna Austria ATP World Tour,HARD,2,Tommy Robredo,Ricardo Mello,Tommy Robredo,7-5; 3-6; 6-2,R32,126,3,1,36,72,29,36,21,36,1,5,14,50,72,3,4,71,113,40,71,21,42,9,15,15,61,113
2005-10-10 00:00:00.000,Vienna Austria ATP World Tour,HARD,2,Ivo Minar,Kevin Kim,Ivo Minar,7-6(0); 6-3,R32,63,6,3,38,68,31,38,15,30,2,4,11,46,68,2,0,46,65,29,46,9,19,3,6,10,38,65
2005-10-10 00:00:00.000,Vienna Austria ATP World Tour,HARD,2,Jean-Rene Lisnard,Stefan Koubek,Jean-Rene Lisnard,4-6; 7-6(5); 6-3,R32,145,2,6,49,106,35,49,24,57,5,11,16,59,106,2,3,77,122,45,77,18,45,11,17,15,63,122
2005-10-10 00:00:00.000,Vienna Austria ATP World Tour,HARD,2,Jurgen Melzer,Gaston Gaudio,Jurgen Melzer,6-7(4); 6-3; 7-6(5),R32,149,10,6,46,98,37,46,27,52,4,7,16,64,98,4,5,80,121,54,80,21,41,6,11,17,75,121
2005-10-10 00:00:00.000,Vienna Austria ATP World Tour,HARD,2,David Nalbandian,Rainer Eitzinger,David Nalbandian,6-1; 7-5,R16,72,2,3,34,56,26,34,15,22,3,4,10,41,56,2,4,32,53,21,32,8,21,1,5,9,29,53
2005-10-10 00:00:00.000,Vienna Austria ATP World Tour,HARD,2,Juan Carlos Ferrero,Nicolas Lapentti,Juan Carlos Ferrero,6-4; 6-4,R16,93,3,1,37,56,29,37,13,19,2,2,10,42,56,5,2,27,60,22,27,16,33,3,5,10,38,60
2005-10-10 00:00:00.000,Vienna Austria ATP World Tour,HARD,2,Radek Stepanek,Tim Henman,Radek Stepanek,6-7(2); 7-6(3); 6-1,R16,150,13,2,84,121,56,84,20,37,13,15,15,76,121,4,2,64,109,40,64,26,45,6,11,16,66,109
2005-10-10 00:00:00.000,Vienna Austria ATP World Tour,HARD,2,Feliciano Lopez,Oliver Marach,Feliciano Lopez,6-4; 6-7(5); 7-5,R16,149,11,4,64,103,50,64,21,39,4,6,17,71,103,14,7,66,115,44,66,29,49,6,10,17,73,115
2005-10-10 00:00:00.000,Vienna Austria ATP World Tour,HARD,2,Fernando Gonzalez,Carlos Moya,Fernando Gonzalez,6-4; 7-5,R16,76,4,2,41,65,32,41,13,24,0,1,11,45,65,7,4,43,67,28,43,13,24,3,6,11,41,67
2005-10-10 00:00:00.000,Vienna Austria ATP World Tour,HARD,2,Ivan Ljubicic,Tommy Haas,Ivan Ljubicic,6-3; 6-4,R16,60,12,1,35,56,30,35,11,21,2,2,10,41,56,3,1,25,46,19,25,13,21,0,2,9,32,46
2005-10-10 00:00:00.000,Vienna Austria ATP World Tour,HARD,2,Tommy Robredo,Ivo Minar,Tommy Robredo,7-6(4); 6-4,R16,133,1,4,27,64,22,27,22,37,2,4,11,44,64,2,4,32,71,19,32,25,39,2,5,11,44,71
2005-10-10 00:00:00.000,Vienna Austria ATP World Tour,HARD,2,Jean-Rene Lisnard,Jurgen Melzer,Jean-Rene Lisnard,5-7; 6-2; 7-6(4),R16,143,2,4,50,108,39,50,31,58,7,10,16,70,108,4,1,54,104,41,54,24,50,5,9,16,65,104
2005-10-10 00:00:00.000,Vienna Austria ATP World Tour,HARD,2,Juan Carlos Ferrero,David Nalbandian,Juan Carlos Ferrero,7-6(5); 6-3,Q,127,6,1,48,81,32,48,17,33,5,8,11,49,81,1,3,47,78,28,47,14,31,7,11,10,42,78
2005-10-10 00:00:00.000,Vienna Austria ATP World Tour,HARD,2,Radek Stepanek,Feliciano Lopez,Radek Stepanek,7-6(8); 7-6(5),Q,105,5,1,56,81,42,56,20,25,1,1,12,62,81,5,1,55,88,46,55,16,33,2,2,12,62,88
2005-10-10 00:00:00.000,Vienna Austria ATP World Tour,HARD,2,Ivan Ljubicic,Fernando Gonzalez,Ivan Ljubicic,6-3; 7-5,Q,85,9,1,38,63,29,38,19,25,3,3,11,48,63,1,5,36,56,27,36,10,20,1,3,10,37,56
2005-10-10 00:00:00.000,Vienna Austria ATP World Tour,HARD,2,Tommy Robredo,Jean-Rene Lisnard,Tommy Robredo,6-1; 6-1,Q,62,2,1,34,47,25,34,8,13,4,4,7,33,47,1,3,23,50,15,23,7,27,3,8,7,22,50
2005-10-10 00:00:00.000,Vienna Austria ATP World Tour,HARD,2,Juan Carlos Ferrero,Radek Stepanek,Juan Carlos Ferrero,7-6(3); 6-3,S,105,6,1,45,67,34,45,15,22,4,4,10,49,67,6,1,65,87,44,65,8,22,4,6,11,52,87
2005-10-10 00:00:00.000,Vienna Austria ATP World Tour,HARD,2,Ivan Ljubicic,Tommy Robredo,Ivan Ljubicic,7-6(5); 6-4,S,117,10,2,57,97,45,57,21,40,6,6,11,66,97,2,1,51,78,34,51,18,27,7,8,11,52,78
2005-10-10 00:00:00.000,Vienna Austria ATP World Tour,HARD,2,Ivan Ljubicic,Juan Carlos Ferrero,Ivan Ljubicic,6-2; 6-4; 7-6(5),F,151,21,3,67,100,54,67,19,33,4,4,15,73,100,3,2,68,103,53,68,15,35,5,8,15,68,103
2005-10-17 00:00:00.000,ATP Masters Series Madrid Spain ATP World Tour,HARD,2,Rafael Nadal,N/A Bye,Rafael Nadal,,R64,0,0,0,0,0,0,0,0,0,0,0,0,0,0,0,0,0,0,0,0,0,0,0,0,0,0,0
2005-10-17 00:00:00.000,ATP Masters Series Madrid Spain ATP World Tour,HARD,2,Victor Hanescu,Tomas Zib,Victor Hanescu,6-1; 6-4,R64,59,10,1,33,50,25,33,14,17,3,3,9,39,50,3,3,27,44,20,27,6,17,2,5,8,26,44
2005-10-17 00:00:00.000,ATP Masters Series Madrid Spain ATP World Tour,HARD,2,Carlos Moya,Filippo Volandri,Carlos Moya,6-1; 6-2,R64,65,3,2,26,49,22,26,15,23,6,6,8,37,49,1,6,24,52,16,24,9,28,5,9,7,25,52
2005-10-17 00:00:00.000,ATP Masters Series Madrid Spain ATP World Tour,HARD,2,Tommy Robredo,N/A Bye,Tommy Robredo,,R64,0,0,0,0,0,0,0,0,0,0,0,0,0,0,0,0,0,0,0,0,0,0,0,0,0,0,0
2005-10-17 00:00:00.000,ATP Masters Series Madrid Spain ATP World Tour,HARD,2,Radek Stepanek,N/A Bye,Radek Stepanek,,R64,0,0,0,0,0,0,0,0,0,0,0,0,0,0,0,0,0,0,0,0,0,0,0,0,0,0,0
2005-10-17 00:00:00.000,ATP Masters Series Madrid Spain ATP World Tour,HARD,2,Tim Henman,Taylor Dent,Tim Henman,6-2; 6-4,R64,78,3,1,34,58,27,34,14,24,2,2,9,41,58,5,7,22,59,15,22,20,37,1,4,9,35,59
2005-10-17 00:00:00.000,ATP Masters Series Madrid Spain ATP World Tour,HARD,2,Jose Acasuso,Mikhail Youzhny,Jose Acasuso,6-7(5); 6-4; 2-0 RET,R64,104,11,2,44,81,34,44,19,37,1,3,12,53,81,4,9,32,82,22,32,25,50,4,8,12,47,82
2005-10-17 00:00:00.000,ATP Masters Series Madrid Spain ATP World Tour,HARD,2,Gaston Gaudio,N/A Bye,Gaston Gaudio,,R64,0,0,0,0,0,0,0,0,0,0,0,0,0,0,0,0,0,0,0,0,0,0,0,0,0,0,0
2005-10-17 00:00:00.000,ATP Masters Series Madrid Spain ATP World Tour,HARD,2,Nikolay Davydenko,N/A Bye,Nikolay Davydenko,,R64,0,0,0,0,0,0,0,0,0,0,0,0,0,0,0,0,0,0,0,0,0,0,0,0,0,0,0
2005-10-17 00:00:00.000,ATP Masters Series Madrid Spain ATP World Tour,HARD,2,Karol Beck,Nicolas Kiefer,Karol Beck,6-2; 2-1 RET,R64,61,3,3,12,37,11,12,14,25,3,3,5,25,37,2,0,21,37,13,21,6,16,2,5,6,19,37
2005-10-17 00:00:00.000,ATP Masters Series Madrid Spain ATP World Tour,HARD,2,Sebastien Grosjean,Feliciano Lopez,Sebastien Grosjean,7-5; 4-6; 6-2,R64,124,14,2,41,89,30,41,32,48,0,1,15,62,89,10,7,48,85,35,48,20,37,4,7,15,55,85
2005-10-17 00:00:00.000,ATP Masters Series Madrid Spain ATP World Tour,HARD,2,Robby Ginepri,N/A Bye,Robby Ginepri,,R64,0,0,0,0,0,0,0,0,0,0,0,0,0,0,0,0,0,0,0,0,0,0,0,0,0,0,0
2005-10-17 00:00:00.000,ATP Masters Series Madrid Spain ATP World Tour,HARD,2,David Ferrer,N/A Bye,David Ferrer,,R64,0,0,0,0,0,0,0,0,0,0,0,0,0,0,0,0,0,0,0,0,0,0,0,0,0,0,0
2005-10-17 00:00:00.000,ATP Masters Series Madrid Spain ATP World Tour,HARD,2,Agustin Calleri,Albert Costa,Agustin Calleri,6-0; 7-5,R64,74,12,1,34,52,29,34,10,18,3,3,9,39,52,0,2,20,49,13,20,13,29,1,5,9,26,49
2005-10-17 00:00:00.000,ATP Masters Series Madrid Spain ATP World Tour,HARD,2,Max Mirnyi,Juan Carlos Ferrero,Max Mirnyi,7-5; 7-6(2),R64,108,11,1,64,91,48,64,11,27,10,11,12,59,91,2,1,57,75,37,57,11,18,1,3,12,48,75
2005-10-17 00:00:00.000,ATP Masters Series Madrid Spain ATP World Tour,HARD,2,Mariano Puerta,N/A Bye,Mariano Puerta,,R64,0,0,0,0,0,0,0,0,0,0,0,0,0,0,0,0,0,0,0,0,0,0,0,0,0,0,0
2005-10-17 00:00:00.000,ATP Masters Series Madrid Spain ATP World Tour,HARD,2,Ivan Ljubicic,N/A Bye,Ivan Ljubicic,,R64,0,0,0,0,0,0,0,0,0,0,0,0,0,0,0,0,0,0,0,0,0,0,0,0,0,0,0
2005-10-17 00:00:00.000,ATP Masters Series Madrid Spain ATP World Tour,HARD,2,Alberto Martin,Jiri Novak,Alberto Martin,3-6; 7-6(1); 6-4,R64,129,12,3,64,104,49,64,21,40,6,7,15,70,104,7,5,77,117,55,77,17,40,8,9,16,72,117
2005-10-17 00:00:00.000,ATP Masters Series Madrid Spain ATP World Tour,HARD,2,Olivier Rochus,Tomas Berdych,Olivier Rochus,1-6; 7-6(6); 6-3,R64,122,4,4,52,83,40,52,15,31,2,5,13,55,83,19,5,69,122,54,69,19,53,11,14,15,73,122
2005-10-17 00:00:00.000,ATP Masters Series Madrid Spain ATP World Tour,HARD,2,Mario Ancic,N/A Bye,Mario Ancic,,R64,0,0,0,0,0,0,0,0,0,0,0,0,0,0,0,0,0,0,0,0,0,0,0,0,0,0,0
2005-10-17 00:00:00.000,ATP Masters Series Madrid Spain ATP World Tour,HARD,2,Fernando Gonzalez,N/A Bye,Fernando Gonzalez,,R64,0,0,0,0,0,0,0,0,0,0,0,0,0,0,0,0,0,0,0,0,0,0,0,0,0,0,0
2005-10-17 00:00:00.000,ATP Masters Series Madrid Spain ATP World Tour,HARD,2,Fernando Verdasco,Paul-Henri Mathieu,Fernando Verdasco,6-4; 3-6; 6-3,R64,108,15,7,46,78,38,46,15,32,2,4,14,53,78,0,4,57,83,37,57,12,26,3,6,14,49,83
2005-10-17 00:00:00.000,ATP Masters Series Madrid Spain ATP World Tour,HARD,2,Christophe Rochus,Gael Monfils,Christophe Rochus,6-4; 6-4,R64,58,1,4,35,53,27,35,11,18,0,1,10,38,53,10,1,35,55,23,35,10,20,1,4,10,33,55
2005-10-17 00:00:00.000,ATP Masters Series Madrid Spain ATP World Tour,HARD,2,Guillermo Coria,N/A Bye,Guillermo Coria,,R64,0,0,0,0,0,0,0,0,0,0,0,0,0,0,0,0,0,0,0,0,0,0,0,0,0,0,0
2005-10-17 00:00:00.000,ATP Masters Series Madrid Spain ATP World Tour,HARD,2,David Nalbandian,N/A Bye,David Nalbandian,,R64,0,0,0,0,0,0,0,0,0,0,0,0,0,0,0,0,0,0,0,0,0,0,0,0,0,0,0
2005-10-17 00:00:00.000,ATP Masters Series Madrid Spain ATP World Tour,HARD,2,Jurgen Melzer,Vincent Spadea,Jurgen Melzer,3-6; 6-4; 6-4,R64,100,4,0,66,87,43,66,14,21,6,9,14,57,87,4,3,57,97,40,57,18,40,4,8,15,58,97
2005-10-17 00:00:00.000,ATP Masters Series Madrid Spain ATP World Tour,HARD,2,Juan Ignacio Chela,Nicolas Massu,Juan Ignacio Chela,6-2; 6-3,R64,128,3,0,23,42,21,23,15,19,0,0,9,36,42,0,4,26,47,18,26,10,21,5,8,8,28,47
2005-10-17 00:00:00.000,ATP Masters Series Madrid Spain ATP World Tour,HARD,2,Thomas Johansson,N/A Bye,Thomas Johansson,,R64,0,0,0,0,0,0,0,0,0,0,0,0,0,0,0,0,0,0,0,0,0,0,0,0,0,0,0
2005-10-17 00:00:00.000,ATP Masters Series Madrid Spain ATP World Tour,HARD,2,Dominik Hrbaty,N/A Bye,Dominik Hrbaty,,R64,0,0,0,0,0,0,0,0,0,0,0,0,0,0,0,0,0,0,0,0,0,0,0,0,0,0,0
2005-10-17 00:00:00.000,ATP Masters Series Madrid Spain ATP World Tour,HARD,2,Tommy Haas,Andrei Pavel,Tommy Haas,7-6(4); 6-2,R64,79,8,5,38,68,34,38,15,30,3,3,10,49,68,6,1,30,65,21,30,18,35,0,2,10,39,65
2005-10-17 00:00:00.000,ATP Masters Series Madrid Spain ATP World Tour,HARD,2,Ivo Karlovic,Greg Rusedski,Ivo Karlovic,6-7(5); 7-6(2); 7-6(3),R64,137,24,5,70,103,67,70,20,33,2,2,18,87,103,9,10,60,116,49,60,35,56,3,3,18,84,116
2005-10-17 00:00:00.000,ATP Masters Series Madrid Spain ATP World Tour,HARD,2,Andy Roddick,N/A Bye,Andy Roddick,,R64,0,0,0,0,0,0,0,0,0,0,0,0,0,0,0,0,0,0,0,0,0,0,0,0,0,0,0
2005-10-17 00:00:00.000,ATP Masters Series Madrid Spain ATP World Tour,HARD,2,Rafael Nadal,Victor Hanescu,Rafael Nadal,7-6(5); 6-3,R32,100,2,1,36,54,29,36,13,18,0,1,10,42,54,9,1,51,73,30,51,13,22,3,6,11,43,73
2005-10-17 00:00:00.000,ATP Masters Series Madrid Spain ATP World Tour,HARD,2,Tommy Robredo,Carlos Moya,Tommy Robredo,6-4; 3-6; 6-1,R32,95,2,1,42,75,32,42,23,33,4,5,13,55,75,4,4,33,72,28,33,19,39,4,7,13,47,72
2005-10-17 00:00:00.000,ATP Masters Series Madrid Spain ATP World Tour,HARD,2,Radek Stepanek,Tim Henman,Radek Stepanek,6-4; 1-6; 6-3,R32,110,5,2,55,77,37,55,11,22,3,6,13,48,77,4,3,43,79,29,43,23,36,5,8,13,52,79
2005-10-17 00:00:00.000,ATP Masters Series Madrid Spain ATP World Tour,HARD,2,Jose Acasuso,Gaston Gaudio,Jose Acasuso,7-6(4); 6-2,R32,96,7,0,38,63,30,38,15,25,1,2,10,45,63,3,3,33,66,24,33,16,33,2,5,10,40,66
2005-10-17 00:00:00.000,ATP Masters Series Madrid Spain ATP World Tour,HARD,2,Nikolay Davydenko,Karol Beck,Nikolay Davydenko,6-4; 6-1,R32,73,1,2,39,50,26,39,6,11,4,6,8,32,50,6,6,28,63,20,28,8,35,7,13,9,28,63
2005-10-17 00:00:00.000,ATP Masters Series Madrid Spain ATP World Tour,HARD,2,Robby Ginepri,Sebastien Grosjean,Robby Ginepri,4-6; 6-4; 6-4,R32,112,7,2,51,85,38,51,20,34,5,7,15,58,85,14,0,51,91,38,51,21,40,3,6,15,59,91
2005-10-17 00:00:00.000,ATP Masters Series Madrid Spain ATP World Tour,HARD,2,David Ferrer,Agustin Calleri,David Ferrer,6-3; 4-6; 6-4,R32,113,6,5,53,96,41,53,19,43,7,9,14,60,96,6,6,46,83,35,46,16,37,2,6,15,51,83
2005-10-17 00:00:00.000,ATP Masters Series Madrid Spain ATP World Tour,HARD,2,Mariano Puerta,Max Mirnyi,Mariano Puerta,7-6(5); 7-6(5),R32,108,6,5,55,89,41,55,20,34,3,4,12,61,89,16,0,57,82,40,57,18,25,5,6,12,58,82
2005-10-17 00:00:00.000,ATP Masters Series Madrid Spain ATP World Tour,HARD,2,Ivan Ljubicic,Alberto Martin,Ivan Ljubicic,6-3; 7-6(7),R32,79,11,2,36,64,32,36,18,28,0,0,11,50,64,3,1,29,59,23,29,20,30,0,1,10,43,59
2005-10-17 00:00:00.000,ATP Masters Series Madrid Spain ATP World Tour,HARD,2,Olivier Rochus,Mario Ancic,Olivier Rochus,1-6; 6-4; 7-6(5),R32,134,1,4,63,98,39,63,21,35,4,8,15,60,98,18,2,53,92,44,53,15,39,3,5,14,59,92
2005-10-17 00:00:00.000,ATP Masters Series Madrid Spain ATP World Tour,HARD,2,Fernando Gonzalez,Fernando Verdasco,Fernando Gonzalez,6-3; 1-6; 6-3,R32,108,6,2,55,86,39,55,15,31,2,4,13,54,86,7,12,55,93,39,55,16,38,6,8,12,55,93
2005-10-17 00:00:00.000,ATP Masters Series Madrid Spain ATP World Tour,HARD,2,Guillermo Coria,Christophe Rochus,Guillermo Coria,6-3; 6-4,R32,87,4,10,38,67,25,38,13,29,3,6,10,38,67,0,5,38,61,16,38,12,23,4,9,9,28,61
2005-10-17 00:00:00.000,ATP Masters Series Madrid Spain ATP World Tour,HARD,2,David Nalbandian,Jurgen Melzer,David Nalbandian,7-6(1); 6-3,R32,77,4,1,41,58,34,41,11,17,0,1,11,45,58,2,1,40,63,24,40,13,23,2,4,10,37,63
2005-10-17 00:00:00.000,ATP Masters Series Madrid Spain ATP World Tour,HARD,2,Thomas Johansson,Juan Ignacio Chela,Thomas Johansson,7-6(2); 6-3,R32,79,13,0,40,64,34,40,12,24,1,2,11,46,64,7,0,31,61,22,31,17,30,5,7,10,39,61
2005-10-17 00:00:00.000,ATP Masters Series Madrid Spain ATP World Tour,HARD,2,Dominik Hrbaty,Tommy Haas,Dominik Hrbaty,6-4; 6-2,R32,63,7,0,41,65,28,41,15,24,5,5,9,43,65,5,3,31,47,22,31,7,16,3,6,9,29,47
2005-10-17 00:00:00.000,ATP Masters Series Madrid Spain ATP World Tour,HARD,2,Ivo Karlovic,Andy Roddick,Ivo Karlovic,3-6; 7-6(7); 7-6(3),R32,126,17,1,62,96,52,62,24,34,2,3,16,76,96,14,5,69,108,58,69,24,39,2,2,17,82,108
2005-10-17 00:00:00.000,ATP Masters Series Madrid Spain ATP World Tour,HARD,2,Rafael Nadal,Tommy Robredo,Rafael Nadal,6-2; 6-4,R16,79,2,2,33,50,25,33,10,17,0,1,9,35,50,1,3,35,51,21,35,6,16,2,6,9,27,51
2005-10-17 00:00:00.000,ATP Masters Series Madrid Spain ATP World Tour,HARD,2,Radek Stepanek,Jose Acasuso,Radek Stepanek,7-6(3); 4-6; 7-6(5),R16,155,6,3,74,112,55,74,23,38,3,4,17,78,112,20,5,61,120,53,61,28,59,6,6,17,81,120
2005-10-17 00:00:00.000,ATP Masters Series Madrid Spain ATP World Tour,HARD,2,Robby Ginepri,Nikolay Davydenko,Robby Ginepri,6-3; 7-5,R16,84,3,1,43,72,27,43,18,29,3,5,11,45,72,2,2,44,66,23,44,14,22,5,9,10,37,66
2005-10-17 00:00:00.000,ATP Masters Series Madrid Spain ATP World Tour,HARD,2,David Ferrer,Mariano Puerta,David Ferrer,6-7(5); 6-1; 6-4,R16,135,11,1,61,92,50,61,20,31,1,1,15,70,92,10,3,78,111,57,78,12,33,8,11,14,69,111
2005-10-17 00:00:00.000,ATP Masters Series Madrid Spain ATP World Tour,HARD,2,Ivan Ljubicic,Olivier Rochus,Ivan Ljubicic,6-4; 6-4,R16,72,20,0,30,47,28,30,12,17,0,0,10,40,47,1,1,54,78,34,54,12,24,7,9,10,46,78
2005-10-17 00:00:00.000,ATP Masters Series Madrid Spain ATP World Tour,HARD,2,Fernando Gonzalez,Guillermo Coria,Fernando Gonzalez,7-5; 6-3,R16,91,5,3,33,59,27,33,14,26,2,4,11,41,59,0,3,47,78,27,47,13,31,7,11,10,40,78
2005-10-17 00:00:00.000,ATP Masters Series Madrid Spain ATP World Tour,HARD,2,David Nalbandian,Thomas Johansson,David Nalbandian,6-3; 7-5,R16,83,4,2,44,66,35,44,13,22,0,0,11,48,66,9,2,41,67,28,41,12,26,3,5,10,40,67
2005-10-17 00:00:00.000,ATP Masters Series Madrid Spain ATP World Tour,HARD,2,Ivo Karlovic,Dominik Hrbaty,Ivo Karlovic,7-6(9); 7-6(3),R16,97,25,2,58,82,46,58,18,24,0,0,12,64,82,1,6,42,79,39,42,21,37,1,1,12,60,79
2005-10-17 00:00:00.000,ATP Masters Series Madrid Spain ATP World Tour,HARD,2,Rafael Nadal,Radek Stepanek,Rafael Nadal,7-6(9); 6-4,Q,111,0,2,59,87,39,59,18,28,3,4,11,57,87,11,2,49,72,36,49,10,23,2,4,11,46,72
2005-10-17 00:00:00.000,ATP Masters Series Madrid Spain ATP World Tour,HARD,2,Robby Ginepri,David Ferrer,Robby Ginepri,6-1; 6-4,Q,76,1,0,35,63,23,35,19,28,0,0,9,42,63,1,0,34,56,18,34,11,22,1,4,8,29,56
2005-10-17 00:00:00.000,ATP Masters Series Madrid Spain ATP World Tour,HARD,2,Ivan Ljubicic,Fernando Gonzalez,Ivan Ljubicic,4-6; 7-6(2); 6-4,Q,131,19,2,56,94,42,56,24,38,3,5,16,66,94,11,5,63,104,50,63,19,41,8,10,16,69,104
2005-10-17 00:00:00.000,ATP Masters Series Madrid Spain ATP World Tour,HARD,2,David Nalbandian,Ivo Karlovic,David Nalbandian,6-4; 7-6(4),Q,92,2,3,51,76,37,51,19,25,2,2,11,56,76,11,4,59,74,45,59,4,15,3,4,11,49,74
2005-10-17 00:00:00.000,ATP Masters Series Madrid Spain ATP World Tour,HARD,2,Rafael Nadal,Robby Ginepri,Rafael Nadal,7-5; 7-6(1),S,101,2,2,47,71,32,47,15,24,0,2,12,47,71,12,0,49,78,36,49,10,29,5,8,12,46,78
2005-10-17 00:00:00.000,ATP Masters Series Madrid Spain ATP World Tour,HARD,2,Ivan Ljubicic,David Nalbandian,Ivan Ljubicic,6-3; 3-6; 6-3,S,128,19,4,46,91,40,46,22,45,10,11,14,62,91,3,3,57,91,35,57,20,34,6,8,13,55,91
2005-10-17 00:00:00.000,ATP Masters Series Madrid Spain ATP World Tour,HARD,2,Rafael Nadal,Ivan Ljubicic,Rafael Nadal,3-6; 2-6; 6-3; 6-4; 7-6(3),F,233,6,2,123,159,88,123,13,36,8,13,24,101,159,32,6,93,140,72,93,24,47,5,9,24,96,140
2005-10-24 00:00:00.000,Basel Switzerland ATP World Tour,HARD,2,Guillermo Coria,Alberto Martin,Guillermo Coria,6-2; 6-4,R32,71,3,3,35,51,26,35,7,16,1,3,9,33,51,1,4,34,60,20,34,10,26,4,9,9,30,60
2005-10-24 00:00:00.000,Basel Switzerland ATP World Tour,HARD,2,Kristof Vliegen,Stanislas Wawrinka,Kristof Vliegen,7-6(4); 4-6; 6-3,R32,131,3,0,64,93,46,64,19,29,1,3,16,65,93,6,3,57,96,43,57,20,39,5,7,15,63,96
2005-10-24 00:00:00.000,Basel Switzerland ATP World Tour,HARD,2,Agustin Calleri,Razvan Sabau,Agustin Calleri,6-0; 6-3,R32,49,10,0,20,34,18,20,9,14,2,3,7,27,34,2,3,37,60,16,37,9,23,8,14,8,25,60
2005-10-24 00:00:00.000,Basel Switzerland ATP World Tour,HARD,2,Dominik Hrbaty,Juan Ignacio Chela,Dominik Hrbaty,7-6(7); 6-2,R32,81,5,0,43,69,31,43,16,26,5,6,10,47,69,6,2,45,69,32,45,7,24,6,9,10,39,69
2005-10-24 00:00:00.000,Basel Switzerland ATP World Tour,HARD,2,Fernando Gonzalez,Andreas Seppi,Fernando Gonzalez,7-6(3); 6-3,R32,74,9,9,41,76,32,41,16,35,2,4,11,48,76,2,7,40,65,29,40,10,25,3,6,10,39,65
2005-10-24 00:00:00.000,Basel Switzerland ATP World Tour,HARD,2,Michael Berrer,Tomas Zib,Michael Berrer,6-3; 7-5,R32,75,11,2,32,53,31,32,13,21,0,0,11,44,53,2,1,34,70,22,34,20,36,3,5,10,42,70
2005-10-24 00:00:00.000,Basel Switzerland ATP World Tour,HARD,2,Tomas Berdych,George Bastl,Tomas Berdych,5-7; 6-4; 6-2,R32,102,8,1,45,81,40,45,21,36,1,2,15,61,81,15,0,64,87,47,64,10,23,6,9,15,57,87
2005-10-24 00:00:00.000,Basel Switzerland ATP World Tour,HARD,2,Andy Murray,Tim Henman,Andy Murray,6-2; 5-7; 7-6(4),R32,134,6,2,53,94,44,53,17,41,1,4,16,61,94,7,1,50,97,36,50,24,47,3,7,16,60,97
2005-10-24 00:00:00.000,Basel Switzerland ATP World Tour,HARD,2,Tommy Haas,Alexander Waske,Tommy Haas,7-6(5); 6-4,R32,85,6,4,38,58,36,38,14,20,0,0,11,50,58,16,2,46,72,42,46,9,26,4,5,11,51,72
2005-10-24 00:00:00.000,Basel Switzerland ATP World Tour,HARD,2,Marcos Baghdatis,Alan Mackin,Marcos Baghdatis,6-1; 6-3,R32,72,4,1,21,39,17,21,10,18,0,2,8,27,39,3,3,43,70,23,43,8,27,7,13,8,31,70
2005-10-24 00:00:00.000,Basel Switzerland ATP World Tour,HARD,2,Jose Acasuso,Nicolas Massu,Jose Acasuso,4-6; 7-6(3); 6-4,R32,134,10,3,57,101,47,57,23,44,3,5,16,70,101,8,4,59,96,45,59,19,37,2,4,16,64,96
2005-10-24 00:00:00.000,Basel Switzerland ATP World Tour,HARD,2,Juan Carlos Ferrero,Filippo Volandri,Juan Carlos Ferrero,6-2; 6-4,R32,69,3,0,31,48,25,31,11,17,2,3,9,36,48,0,7,27,57,16,27,12,30,2,6,9,28,57
2005-10-24 00:00:00.000,Basel Switzerland ATP World Tour,HARD,2,Jiri Novak,Michael Lammer,Jiri Novak,7-6(4); 7-6(5),R32,109,5,3,62,86,42,62,10,24,3,7,12,52,86,8,4,61,88,39,61,11,27,4,8,12,50,88
2005-10-24 00:00:00.000,Basel Switzerland ATP World Tour,HARD,2,Paradorn Srichaphan,Christophe Rochus,Paradorn Srichaphan,6-3; 6-2,R32,58,9,2,33,50,28,33,10,17,1,1,9,38,50,1,4,33,50,22,33,6,17,1,4,8,28,50
2005-10-24 00:00:00.000,Basel Switzerland ATP World Tour,HARD,2,Florian Mayer,Wesley Moodie,Florian Mayer,7-6(1); 1-6; 6-3,R32,97,7,2,57,85,44,57,9,28,3,6,14,53,85,18,5,61,89,45,61,17,28,4,6,14,62,89
2005-10-24 00:00:00.000,Basel Switzerland ATP World Tour,HARD,2,David Nalbandian,Ivo Karlovic,David Nalbandian,6-3; 7-6(4),R32,81,4,0,44,60,35,44,11,16,1,2,11,46,60,17,3,47,71,37,47,6,24,1,3,10,43,71
2005-10-24 00:00:00.000,Basel Switzerland ATP World Tour,HARD,2,Kristof Vliegen,Guillermo Coria,Kristof Vliegen,7-6(0); 7-5,R16,101,5,2,55,77,40,55,12,22,6,7,12,52,77,3,5,54,70,38,54,6,16,2,4,12,44,70
2005-10-24 00:00:00.000,Basel Switzerland ATP World Tour,HARD,2,Dominik Hrbaty,Agustin Calleri,Dominik Hrbaty,3-6; 6-3; 6-2,R16,109,8,6,64,103,43,64,18,39,10,12,13,61,103,16,5,56,103,41,56,17,47,7,11,13,58,103
2005-10-24 00:00:00.000,Basel Switzerland ATP World Tour,HARD,2,Fernando Gonzalez,Michael Berrer,Fernando Gonzalez,6-4; 7-5,R16,73,5,2,32,56,29,32,16,24,0,0,11,45,56,5,4,40,67,32,40,12,27,3,5,11,44,67
2005-10-24 00:00:00.000,Basel Switzerland ATP World Tour,HARD,2,Andy Murray,Tomas Berdych,Andy Murray,6-4; 2-6; 6-4,R16,115,11,4,60,114,44,60,25,54,9,11,14,69,114,10,4,44,73,37,44,13,29,2,4,14,50,73
2005-10-24 00:00:00.000,Basel Switzerland ATP World Tour,HARD,2,Marcos Baghdatis,Tommy Haas,Marcos Baghdatis,6-2; 6-3,R16,70,8,0,34,54,27,34,8,20,4,5,8,35,54,3,3,39,56,23,39,3,17,3,8,9,26,56
2005-10-24 00:00:00.000,Basel Switzerland ATP World Tour,HARD,2,Jose Acasuso,Juan Carlos Ferrero,Jose Acasuso,6-3; 6-7(7); 6-3,R16,129,19,1,53,88,48,53,23,35,1,1,16,71,88,2,1,56,87,37,56,24,31,5,7,14,61,87
2005-10-24 00:00:00.000,Basel Switzerland ATP World Tour,HARD,2,Paradorn Srichaphan,Jiri Novak,Paradorn Srichaphan,6-3; 6-2,R16,48,11,1,29,53,24,29,16,24,1,1,9,40,53,5,0,30,43,19,30,6,13,2,5,8,25,43
2005-10-24 00:00:00.000,Basel Switzerland ATP World Tour,HARD,2,David Nalbandian,Florian Mayer,David Nalbandian,6-3; 6-2,R16,63,6,0,33,49,27,33,10,16,1,2,9,37,49,4,0,34,55,20,34,7,21,5,9,8,27,55
2005-10-24 00:00:00.000,Basel Switzerland ATP World Tour,HARD,2,Dominik Hrbaty,Kristof Vliegen,Dominik Hrbaty,6-7(9); 6-1; 6-3,Q,109,6,2,58,89,49,58,15,31,1,1,14,64,89,3,0,58,89,38,58,15,31,5,9,14,53,89
2005-10-24 00:00:00.000,Basel Switzerland ATP World Tour,HARD,2,Fernando Gonzalez,Andy Murray,Fernando Gonzalez,6-4; 3-6; 6-1,Q,86,15,6,30,67,28,30,22,37,0,1,13,50,67,8,2,50,85,36,50,19,35,10,13,13,55,85
2005-10-24 00:00:00.000,Basel Switzerland ATP World Tour,HARD,2,Marcos Baghdatis,Jose Acasuso,Marcos Baghdatis,6-7(2); 7-6(5); 6-3,Q,170,12,1,75,112,53,75,20,37,4,6,16,73,112,14,4,68,134,56,68,27,66,7,11,17,83,134
2005-10-24 00:00:00.000,Basel Switzerland ATP World Tour,HARD,2,David Nalbandian,Paradorn Srichaphan,David Nalbandian,6-2; 6-2,Q,59,1,0,25,40,19,25,11,15,0,1,8,30,40,3,1,33,52,19,33,5,19,2,7,8,24,52
2005-10-24 00:00:00.000,Basel Switzerland ATP World Tour,HARD,2,Fernando Gonzalez,Dominik Hrbaty,Fernando Gonzalez,6-0; 6-3,S,55,7,3,29,57,20,29,18,28,5,5,8,38,57,1,3,18,38,12,18,7,20,2,6,7,19,38
2005-10-24 00:00:00.000,Basel Switzerland ATP World Tour,HARD,2,Marcos Baghdatis,David Nalbandian,Marcos Baghdatis,6-2; 7-6(3),S,88,9,0,38,57,29,38,11,19,0,1,10,40,57,3,1,47,70,30,47,8,23,5,8,10,38,70
2005-10-24 00:00:00.000,Basel Switzerland ATP World Tour,HARD,2,Fernando Gonzalez,Marcos Baghdatis,Fernando Gonzalez,6-7(8); 6-3; 7-5; 6-4,F,179,18,6,73,135,63,73,35,62,0,1,22,98,135,10,5,85,138,67,85,23,53,6,10,21,90,138
2005-10-24 00:00:00.000,Lyon France ATP World Tour,HARD,2,Andy Roddick,Thierry Ascione,Andy Roddick,7-5; 6-3,R32,69,12,1,35,51,33,35,11,16,0,0,11,44,51,5,4,43,68,29,43,13,25,1,3,10,42,68
2005-10-24 00:00:00.000,Lyon France ATP World Tour,HARD,2,Nicolas Mahut,Julien Benneteau,Nicolas Mahut,6-4; 7-5,R32,86,12,4,44,69,38,44,8,25,4,5,11,46,69,11,4,38,59,32,38,7,21,4,7,11,39,59
2005-10-24 00:00:00.000,Lyon France ATP World Tour,HARD,2,Thomas Enqvist,Gregory Carraz,Thomas Enqvist,6-1; 6-4,R32,55,6,0,27,49,24,27,15,22,3,3,9,39,49,11,3,28,48,24,28,1,20,4,7,8,25,48
2005-10-24 00:00:00.000,Lyon France ATP World Tour,HARD,2,Mario Ancic,James Blake,Mario Ancic,6-2; 7-6(5),R32,88,12,1,42,58,36,42,9,16,0,0,10,45,58,5,2,50,89,34,50,19,39,5,7,10,53,89
2005-10-24 00:00:00.000,Lyon France ATP World Tour,HARD,2,Vincent Spadea,Ivan Ljubicic,Vincent Spadea,7-6(5); 7-5,R32,93,9,3,48,76,41,48,16,28,2,2,12,57,76,13,2,61,94,45,61,16,33,9,10,12,61,94
2005-10-24 00:00:00.000,Lyon France ATP World Tour,HARD,2,Michael Llodra,Xavier Malisse,Michael Llodra,7-6(6); 6-3,R32,77,11,1,41,59,38,41,9,18,1,1,10,47,59,6,1,47,79,33,47,17,32,1,3,11,50,79
2005-10-24 00:00:00.000,Lyon France ATP World Tour,HARD,2,Fabrice Santoro,Taylor Dent,Fabrice Santoro,6-3; 7-5,R32,84,1,3,39,68,30,39,13,29,3,5,11,43,68,5,11,38,67,27,38,9,29,4,8,10,36,67
2005-10-24 00:00:00.000,Lyon France ATP World Tour,HARD,2,Paul-Henri Mathieu,Robby Ginepri,Paul-Henri Mathieu,5-2 RET,R32,28,3,1,11,24,6,11,10,13,3,4,4,16,24,1,0,11,15,4,11,1,4,0,2,3,5,15
2005-10-24 00:00:00.000,Lyon France ATP World Tour,HARD,2,Marc Gicquel,David Ferrer,Marc Gicquel,6-4; 6-0,R32,50,9,0,21,36,21,21,11,15,0,0,8,32,36,1,3,39,53,25,39,2,14,6,10,8,27,53
2005-10-24 00:00:00.000,Lyon France ATP World Tour,HARD,2,Davide Sanguinetti,Feliciano Lopez,Davide Sanguinetti,6-7(5); 6-4; 6-4,R32,101,9,0,54,89,44,54,26,35,0,0,16,70,89,17,12,57,111,46,57,28,54,7,9,16,74,111
2005-10-24 00:00:00.000,Lyon France ATP World Tour,HARD,2,Gael Monfils,Jan Hernych,Gael Monfils,6-4; 5-7; 6-3,R32,130,12,2,54,89,40,54,18,35,4,7,15,58,89,0,0,83,115,50,83,16,32,14,19,16,66,115
2005-10-24 00:00:00.000,Lyon France ATP World Tour,HARD,2,Gaston Gaudio,Arnaud Clement,Gaston Gaudio,6-3; 4-6; 6-3,R32,126,6,4,55,86,40,55,15,31,7,9,14,55,86,5,0,48,83,33,48,16,35,2,6,14,49,83
2005-10-24 00:00:00.000,Lyon France ATP World Tour,HARD,2,Tommy Robredo,Nicolas Lapentti,Tommy Robredo,2-6; 7-5; 6-4,R32,120,4,1,60,94,44,60,18,34,2,5,15,62,94,2,3,56,81,45,56,9,25,2,5,15,54,81
2005-10-24 00:00:00.000,Lyon France ATP World Tour,HARD,2,Sebastien Grosjean,Victor Hanescu,Sebastien Grosjean,4-6; 6-3; 6-4,R32,118,9,2,51,92,43,51,20,41,5,6,15,63,92,1,3,51,89,39,51,18,38,8,10,14,57,89
2005-10-24 00:00:00.000,Lyon France ATP World Tour,HARD,2,Novak Djokovic,Ricardo Mello,Novak Djokovic,7-6(5); 6-4,R32,105,4,3,51,80,37,51,12,29,5,7,11,49,80,5,5,65,90,38,65,14,25,6,9,11,52,90
2005-10-24 00:00:00.000,Lyon France ATP World Tour,HARD,2,Olivier Rochus,Mariano Puerta,Olivier Rochus,4-6; 7-5; 6-3,R32,106,16,3,71,92,56,71,10,21,7,8,16,66,92,16,1,74,96,54,74,10,22,7,9,15,64,96
2005-10-24 00:00:00.000,Lyon France ATP World Tour,HARD,2,Andy Roddick,Nicolas Mahut,Andy Roddick,7-6(5); 6-3,R16,90,13,0,34,51,31,34,13,17,0,0,10,44,51,9,2,48,80,35,48,14,32,2,4,11,49,80
2005-10-24 00:00:00.000,Lyon France ATP World Tour,HARD,2,Mario Ancic,Thomas Enqvist,Mario Ancic,6-7(4); 7-6(5); 6-4,R16,147,32,2,72,112,61,72,23,40,4,4,17,84,112,13,1,58,98,49,58,26,40,1,2,17,75,98
2005-10-24 00:00:00.000,Lyon France ATP World Tour,HARD,2,Vincent Spadea,Michael Llodra,Vincent Spadea,6-4; 6-3,R16,70,2,2,32,51,27,32,13,19,3,4,10,40,51,9,2,40,68,28,40,12,28,4,7,9,40,68
2005-10-24 00:00:00.000,Lyon France ATP World Tour,HARD,2,Fabrice Santoro,Paul-Henri Mathieu,Fabrice Santoro,6-1; 6-4,R16,74,7,1,37,53,31,37,8,16,1,1,9,39,53,1,1,31,54,19,31,12,23,6,9,8,31,54
2005-10-24 00:00:00.000,Lyon France ATP World Tour,HARD,2,Marc Gicquel,Davide Sanguinetti,Marc Gicquel,6-3; 6-2,R16,54,9,4,39,52,30,39,7,13,4,5,9,37,52,3,0,30,52,18,30,10,22,2,6,8,28,52
2005-10-24 00:00:00.000,Lyon France ATP World Tour,HARD,2,Gael Monfils,Gaston Gaudio,Gael Monfils,6-4; 6-3,R16,68,16,1,29,48,29,29,9,19,1,2,10,38,48,0,0,46,69,24,46,13,23,7,10,9,37,69
2005-10-24 00:00:00.000,Lyon France ATP World Tour,HARD,2,Sebastien Grosjean,Tommy Robredo,Sebastien Grosjean,7-5; 6-3,R16,87,7,2,41,75,32,41,18,34,7,8,11,50,75,1,2,41,61,27,41,10,20,2,5,10,37,61
2005-10-24 00:00:00.000,Lyon France ATP World Tour,HARD,2,Olivier Rochus,Novak Djokovic,Olivier Rochus,7-6(4); 7-5,R16,114,2,1,58,76,46,58,9,18,1,2,12,55,76,13,3,64,95,44,64,15,31,9,11,12,59,95
2005-10-24 00:00:00.000,Lyon France ATP World Tour,HARD,2,Andy Roddick,Mario Ancic,Andy Roddick,6-4; 6-4,Q,64,13,0,35,48,30,35,10,13,0,0,10,40,48,4,0,40,54,29,40,7,14,4,6,10,36,54
2005-10-24 00:00:00.000,Lyon France ATP World Tour,HARD,2,Fabrice Santoro,Vincent Spadea,Fabrice Santoro,6-2; 6-2,Q,67,3,0,28,49,20,28,12,21,1,2,8,32,49,1,3,32,47,16,32,4,15,7,12,8,20,47
2005-10-24 00:00:00.000,Lyon France ATP World Tour,HARD,2,Gael Monfils,Marc Gicquel,Gael Monfils,6-4; 6-1,Q,67,9,1,25,44,22,25,9,19,2,3,8,31,44,2,3,35,60,21,35,8,25,2,7,9,29,60
2005-10-24 00:00:00.000,Lyon France ATP World Tour,HARD,2,Sebastien Grosjean,Olivier Rochus,Sebastien Grosjean,6-3; 7-6(4),Q,84,16,3,40,63,31,40,13,23,0,1,11,44,63,2,0,48,69,30,48,12,21,3,5,10,42,69
2005-10-24 00:00:00.000,Lyon France ATP World Tour,HARD,2,Andy Roddick,Fabrice Santoro,Andy Roddick,6-4; 7-6(5),S,99,23,0,51,72,40,51,12,21,1,1,11,52,72,3,0,45,80,33,45,20,35,2,3,11,53,80
2005-10-24 00:00:00.000,Lyon France ATP World Tour,HARD,2,Gael Monfils,Sebastien Grosjean,Gael Monfils,6-4; 7-5,S,96,5,2,35,67,27,35,18,32,3,4,11,45,67,0,2,32,64,26,32,14,32,5,8,11,40,64
2005-10-24 00:00:00.000,Lyon France ATP World Tour,HARD,2,Andy Roddick,Gael Monfils,Andy Roddick,6-3; 6-2,F,60,9,0,35,47,31,35,7,12,2,2,9,38,47,6,2,35,55,22,35,9,20,1,4,8,31,55
2005-10-24 00:00:00.000,St. Petersburg Russia ATP World Tour,HARD,2,Nikolay Davydenko,Lukas Dlouhy,Nikolay Davydenko,6-2; 6-1,R32,54,1,2,26,41,21,26,12,15,0,0,8,33,41,2,5,32,55,17,32,10,23,4,8,7,27,55
2005-10-24 00:00:00.000,St. Petersburg Russia ATP World Tour,HARD,2,Paul Goldstein,Lars Burgsmuller,Paul Goldstein,7-6(6); 2-6; 6-3,R32,130,2,2,49,91,34,49,21,42,0,4,14,55,91,5,3,71,109,45,71,22,38,2,6,15,67,109
2005-10-24 00:00:00.000,St. Petersburg Russia ATP World Tour,HARD,2,Jurgen Melzer,Vadim Davletshin,Jurgen Melzer,6-3; 6-4,R32,67,2,2,42,57,31,42,12,15,2,2,10,43,57,3,2,35,59,20,35,15,24,2,4,9,35,59
2005-10-24 00:00:00.000,St. Petersburg Russia ATP World Tour,HARD,2,Nicolas Kiefer,Guillermo Garcia-Lopez,Nicolas Kiefer,6-3; 3-6; 6-4,R32,113,8,5,43,80,32,43,20,37,3,6,14,52,80,8,5,53,75,36,53,8,22,0,4,14,44,75
2005-10-24 00:00:00.000,St. Petersburg Russia ATP World Tour,HARD,2,Mikhail Youzhny,Karol Beck,Mikhail Youzhny,6-3; 4-1 RET,R32,63,0,2,30,46,22,30,7,16,1,2,7,29,46,5,3,25,48,17,25,7,23,1,5,7,24,48
2005-10-24 00:00:00.000,St. Petersburg Russia ATP World Tour,HARD,2,Cyril Saulnier,Igor Kunitsyn,Cyril Saulnier,6-3; 6-2,R32,67,8,2,37,61,27,37,12,24,4,5,9,39,61,3,0,25,41,16,25,7,16,0,4,8,23,41
2005-10-24 00:00:00.000,St. Petersburg Russia ATP World Tour,HARD,2,Florent Serra,Jonas Bjorkman,Florent Serra,6-7(2); 6-3; 6-4,R32,139,5,1,65,102,46,65,20,37,6,8,16,66,102,5,1,79,109,48,79,18,30,9,13,15,66,109
2005-10-24 00:00:00.000,St. Petersburg Russia ATP World Tour,HARD,2,Robin Vik,Jarkko Nieminen,Robin Vik,6-4; 6-4,R32,63,6,1,40,54,32,40,7,14,1,2,10,39,54,1,1,38,57,28,38,8,19,4,7,10,36,57
2005-10-24 00:00:00.000,St. Petersburg Russia ATP World Tour,HARD,2,Fernando Verdasco,Mark Philippoussis,Fernando Verdasco,7-6(4); 4-6; 6-2,R32,112,7,4,59,89,44,59,20,30,4,6,15,64,89,10,1,66,90,47,66,14,24,6,9,15,61,90
2005-10-24 00:00:00.000,St. Petersburg Russia ATP World Tour,HARD,2,Juan Monaco,Teymuraz Gabashvili,Juan Monaco,6-3; 6-3,R32,83,6,3,39,68,28,39,16,29,8,9,9,44,68,5,1,25,54,19,25,12,29,1,5,9,31,54
2005-10-24 00:00:00.000,St. Petersburg Russia ATP World Tour,HARD,2,Sergiy Stakhovsky,Alexander Popp,Sergiy Stakhovsky,6-3; 4-6; 6-4,R32,100,5,2,54,87,42,54,17,33,2,5,15,59,87,1,7,41,87,26,41,25,46,7,11,14,51,87
2005-10-24 00:00:00.000,St. Petersburg Russia ATP World Tour,HARD,2,Kenneth Carlsen,Max Mirnyi,Kenneth Carlsen,6-7(4); 7-6(5); 6-4,R32,150,9,3,72,104,56,72,17,32,4,6,17,73,104,10,5,70,111,51,70,23,41,2,5,17,74,111
2005-10-24 00:00:00.000,St. Petersburg Russia ATP World Tour,HARD,2,Greg Rusedski,Dmitry Tursunov,Greg Rusedski,6-4; 6-4,R32,73,6,4,37,64,29,37,16,27,3,3,10,45,64,12,4,40,55,32,40,5,15,3,5,10,37,55
2005-10-24 00:00:00.000,St. Petersburg Russia ATP World Tour,HARD,2,Kevin Kim,Ivo Minar,Kevin Kim,6-1; 4-6; 7-5,R32,82,10,6,50,81,37,50,13,31,5,9,14,50,81,7,4,37,91,23,37,23,54,3,10,15,46,91
2005-10-24 00:00:00.000,St. Petersburg Russia ATP World Tour,HARD,2,Andrei Pavel,Jiri Vanek,Andrei Pavel,6-3; 7-6(5),R32,79,5,2,46,69,38,46,16,23,7,7,11,54,69,14,4,47,76,33,47,15,29,5,6,10,48,76
2005-10-24 00:00:00.000,St. Petersburg Russia ATP World Tour,HARD,2,Thomas Johansson,Philipp Kohlschreiber,Thomas Johansson,6-3; 6-4,R32,66,8,1,38,56,31,38,11,18,0,0,10,42,56,3,1,34,49,21,34,10,15,1,3,9,31,49
2005-10-24 00:00:00.000,St. Petersburg Russia ATP World Tour,HARD,2,Nikolay Davydenko,Paul Goldstein,Nikolay Davydenko,6-3; 6-4,R16,74,2,0,37,55,28,37,7,18,2,4,10,35,55,0,2,30,58,21,30,8,28,2,6,9,29,58
2005-10-24 00:00:00.000,St. Petersburg Russia ATP World Tour,HARD,2,Nicolas Kiefer,Jurgen Melzer,Nicolas Kiefer,3-6; 6-3; 7-5,R16,146,14,3,53,96,41,53,25,43,0,1,15,66,96,8,1,62,112,42,62,26,50,5,7,15,68,112
2005-10-24 00:00:00.000,St. Petersburg Russia ATP World Tour,HARD,2,Mikhail Youzhny,Cyril Saulnier,Mikhail Youzhny,6-1; 6-1,R16,49,2,2,24,40,21,24,8,16,2,2,7,29,40,2,7,22,41,11,22,5,19,4,9,7,16,41
2005-10-24 00:00:00.000,St. Petersburg Russia ATP World Tour,HARD,2,Robin Vik,Florent Serra,Robin Vik,7-6(3); 2-6; 6-3,R16,101,3,4,61,90,45,61,14,29,5,8,15,59,90,8,4,47,80,36,47,17,33,0,2,14,53,80
2005-10-24 00:00:00.000,St. Petersburg Russia ATP World Tour,HARD,2,Fernando Verdasco,Juan Monaco,Fernando Verdasco,7-5; 6-3,R16,100,9,3,43,67,35,43,9,24,5,7,11,44,67,3,7,44,75,27,44,14,31,10,14,10,41,75
2005-10-24 00:00:00.000,St. Petersburg Russia ATP World Tour,HARD,2,Kenneth Carlsen,Sergiy Stakhovsky,Kenneth Carlsen,6-7(5); 7-6(2); 7-6(6),R16,186,6,2,103,149,72,103,21,46,7,9,18,93,149,11,3,78,115,59,78,20,37,4,6,18,79,115
2005-10-24 00:00:00.000,St. Petersburg Russia ATP World Tour,HARD,2,Greg Rusedski,Kevin Kim,Greg Rusedski,4-6; 6-3; 6-4,R16,97,17,8,48,79,43,48,16,31,2,3,15,59,79,1,4,54,83,37,54,18,29,2,4,14,55,83
2005-10-24 00:00:00.000,St. Petersburg Russia ATP World Tour,HARD,2,Thomas Johansson,Andrei Pavel,Thomas Johansson,6-2; 6-2,R16,58,4,0,20,34,18,20,14,14,0,0,8,32,34,4,3,38,61,21,38,10,23,4,8,8,31,61
2005-10-24 00:00:00.000,St. Petersburg Russia ATP World Tour,HARD,2,Nicolas Kiefer,Nikolay Davydenko,Nicolas Kiefer,6-1; 6-1,Q,55,4,1,20,38,18,20,11,18,2,2,7,29,38,0,0,31,43,13,31,5,12,2,7,7,18,43
2005-10-24 00:00:00.000,St. Petersburg Russia ATP World Tour,HARD,2,Robin Vik,Mikhail Youzhny,Robin Vik,1-6; 6-4; 6-2,Q,99,4,1,50,72,28,50,14,22,2,7,12,42,72,0,2,51,80,27,51,15,29,4,10,13,42,80
2005-10-24 00:00:00.000,St. Petersburg Russia ATP World Tour,HARD,2,Fernando Verdasco,Kenneth Carlsen,Fernando Verdasco,6-4; 6-2,Q,69,5,0,39,50,28,39,7,11,1,2,9,35,50,3,1,32,49,21,32,7,17,3,7,9,28,49
2005-10-24 00:00:00.000,St. Petersburg Russia ATP World Tour,HARD,2,Thomas Johansson,Greg Rusedski,Thomas Johansson,6-2; 7-6(6),Q,86,9,2,42,67,33,42,14,25,2,3,10,47,67,6,3,35,68,25,35,16,33,3,6,10,41,68
2005-10-24 00:00:00.000,St. Petersburg Russia ATP World Tour,HARD,2,Nicolas Kiefer,Robin Vik,Nicolas Kiefer,6-3; 6-4,S,72,7,3,30,50,24,30,14,20,0,1,10,38,50,3,1,33,60,21,33,13,27,5,8,9,34,60
2005-10-24 00:00:00.000,St. Petersburg Russia ATP World Tour,HARD,2,Thomas Johansson,Fernando Verdasco,Thomas Johansson,6-3; 3-6; 6-3,S,98,6,3,40,76,35,40,19,36,1,2,14,54,76,8,1,47,72,37,47,12,25,1,3,13,49,72
2005-10-24 00:00:00.000,St. Petersburg Russia ATP World Tour,HARD,2,Thomas Johansson,Nicolas Kiefer,Thomas Johansson,6-4; 6-2,F,95,10,0,46,65,33,46,11,19,8,8,9,44,65,6,2,36,65,22,36,16,29,9,12,9,38,65
2005-10-31 00:00:00.000,ATP Masters Series Paris France ATP World Tour,HARD,2,Andy Roddick,N/A Bye,Andy Roddick,,R64,0,0,0,0,0,0,0,0,0,0,0,0,0,0,0,0,0,0,0,0,0,0,0,0,0,0,0
2005-10-31 00:00:00.000,ATP Masters Series Paris France ATP World Tour,HARD,2,Taylor Dent,Sebastien Grosjean,Taylor Dent,6-4; 7-6(4),R64,100,5,5,45,83,34,45,22,38,5,6,11,56,83,5,4,48,77,37,48,11,29,3,5,11,48,77
2005-10-31 00:00:00.000,ATP Masters Series Paris France ATP World Tour,HARD,2,Jean-Rene Lisnard,Nicolas Mahut,Jean-Rene Lisnard,6-3; 1-6; 7-6(5),R64,104,4,1,54,94,44,54,19,40,4,6,14,63,94,8,4,50,73,43,50,14,23,0,1,14,57,73
2005-10-31 00:00:00.000,ATP Masters Series Paris France ATP World Tour,HARD,2,Dominik Hrbaty,N/A Bye,Dominik Hrbaty,,R64,0,0,0,0,0,0,0,0,0,0,0,0,0,0,0,0,0,0,0,0,0,0,0,0,0,0,0
2005-10-31 00:00:00.000,ATP Masters Series Paris France ATP World Tour,HARD,2,David Ferrer,N/A Bye,David Ferrer,,R64,0,0,0,0,0,0,0,0,0,0,0,0,0,0,0,0,0,0,0,0,0,0,0,0,0,0,0
2005-10-31 00:00:00.000,ATP Masters Series Paris France ATP World Tour,HARD,2,Max Mirnyi,Nicolas Massu,Max Mirnyi,6-2; 6-3,R64,61,7,5,28,49,26,28,10,21,0,0,9,36,49,1,3,22,48,18,22,11,26,2,5,8,29,48
2005-10-31 00:00:00.000,ATP Masters Series Paris France ATP World Tour,HARD,2,Tommy Haas,Andrei Pavel,Tommy Haas,7-6(6); 6-4,R64,90,14,3,46,76,33,46,14,30,5,8,11,47,76,9,1,37,71,28,37,13,34,3,7,11,41,71
2005-10-31 00:00:00.000,ATP Masters Series Paris France ATP World Tour,HARD,2,David Nalbandian,N/A Bye,David Nalbandian,,R64,0,0,0,0,0,0,0,0,0,0,0,0,0,0,0,0,0,0,0,0,0,0,0,0,0,0,0
2005-10-31 00:00:00.000,ATP Masters Series Paris France ATP World Tour,HARD,2,Mariano Puerta,N/A Bye,Mariano Puerta,,R64,0,0,0,0,0,0,0,0,0,0,0,0,0,0,0,0,0,0,0,0,0,0,0,0,0,0,0
2005-10-31 00:00:00.000,ATP Masters Series Paris France ATP World Tour,HARD,2,Novak Djokovic,Victor Hanescu,Novak Djokovic,4-1 RET,R64,19,1,1,8,12,6,8,2,4,0,0,2,8,12,0,1,12,20,8,12,1,8,3,5,3,9,20
2005-10-31 00:00:00.000,ATP Masters Series Paris France ATP World Tour,HARD,2,Arnaud Clement,Nicolas Kiefer,Arnaud Clement,6-4; 1-6; 7-6(6),R64,162,6,3,51,94,40,51,18,43,2,5,14,58,94,20,5,53,106,40,53,26,53,3,5,15,66,106
2005-10-31 00:00:00.000,ATP Masters Series Paris France ATP World Tour,HARD,2,Tommy Robredo,N/A Bye,Tommy Robredo,,R64,0,0,0,0,0,0,0,0,0,0,0,0,0,0,0,0,0,0,0,0,0,0,0,0,0,0,0
2005-10-31 00:00:00.000,ATP Masters Series Paris France ATP World Tour,HARD,2,Thomas Johansson,N/A Bye,Thomas Johansson,,R64,0,0,0,0,0,0,0,0,0,0,0,0,0,0,0,0,0,0,0,0,0,0,0,0,0,0,0
2005-10-31 00:00:00.000,ATP Masters Series Paris France ATP World Tour,HARD,2,Kristof Vliegen,Christophe Rochus,Kristof Vliegen,3-6; 7-6(3); 6-2,R64,101,10,1,49,77,39,49,16,28,3,5,14,55,77,2,6,59,91,41,59,16,32,3,6,15,57,91
2005-10-31 00:00:00.000,ATP Masters Series Paris France ATP World Tour,HARD,2,James Blake,Olivier Rochus,James Blake,6-4; 6-3,R64,60,8,2,28,45,27,28,9,17,0,0,9,36,45,1,2,37,63,26,37,12,26,5,8,10,38,63
2005-10-31 00:00:00.000,ATP Masters Series Paris France ATP World Tour,HARD,2,Ivan Ljubicic,N/A Bye,Ivan Ljubicic,,R64,0,0,0,0,0,0,0,0,0,0,0,0,0,0,0,0,0,0,0,0,0,0,0,0,0,0,0
2005-10-31 00:00:00.000,ATP Masters Series Paris France ATP World Tour,HARD,2,Radek Stepanek,N/A Bye,Radek Stepanek,,R64,0,0,0,0,0,0,0,0,0,0,0,0,0,0,0,0,0,0,0,0,0,0,0,0,0,0,0
2005-10-31 00:00:00.000,ATP Masters Series Paris France ATP World Tour,HARD,2,Feliciano Lopez,Xavier Malisse,Feliciano Lopez,4-6; 7-6(2); 6-4,R64,119,9,5,65,122,46,65,33,57,9,10,16,79,122,14,1,69,93,55,69,11,24,2,3,16,66,93
2005-10-31 00:00:00.000,ATP Masters Series Paris France ATP World Tour,HARD,2,Paul-Henri Mathieu,Davide Sanguinetti,Paul-Henri Mathieu,5-7; 7-6(4); 6-4,R64,152,8,1,62,102,49,62,23,40,5,7,17,72,102,12,1,70,111,50,70,25,41,6,8,17,75,111
2005-10-31 00:00:00.000,ATP Masters Series Paris France ATP World Tour,HARD,2,Fernando Gonzalez,N/A Bye,Fernando Gonzalez,,R64,0,0,0,0,0,0,0,0,0,0,0,0,0,0,0,0,0,0,0,0,0,0,0,0,0,0,0
2005-10-31 00:00:00.000,ATP Masters Series Paris France ATP World Tour,HARD,2,Mario Ancic,N/A Bye,Mario Ancic,,R64,0,0,0,0,0,0,0,0,0,0,0,0,0,0,0,0,0,0,0,0,0,0,0,0,0,0,0
2005-10-31 00:00:00.000,ATP Masters Series Paris France ATP World Tour,HARD,2,Dmitry Tursunov,Vincent Spadea,Dmitry Tursunov,6-1; 6-2,R64,50,11,0,37,52,28,37,8,15,1,1,8,36,52,0,3,26,42,14,26,6,16,2,6,7,20,42
2005-10-31 00:00:00.000,ATP Masters Series Paris France ATP World Tour,HARD,2,Greg Rusedski,Andreas Seppi,Greg Rusedski,6-3; 6-4,R64,65,9,5,29,55,23,29,17,26,2,3,10,40,55,4,2,32,56,25,32,7,24,4,7,9,32,56
2005-10-31 00:00:00.000,ATP Masters Series Paris France ATP World Tour,HARD,2,Nikolay Davydenko,N/A Bye,Nikolay Davydenko,,R64,0,0,0,0,0,0,0,0,0,0,0,0,0,0,0,0,0,0,0,0,0,0,0,0,0,0,0
2005-10-31 00:00:00.000,ATP Masters Series Paris France ATP World Tour,HARD,2,Gaston Gaudio,N/A Bye,Gaston Gaudio,,R64,0,0,0,0,0,0,0,0,0,0,0,0,0,0,0,0,0,0,0,0,0,0,0,0,0,0,0
2005-10-31 00:00:00.000,ATP Masters Series Paris France ATP World Tour,HARD,2,Fabrice Santoro,Jarkko Nieminen,Fabrice Santoro,6-7(8); 7-6(4); 6-3,R64,171,4,1,87,136,58,87,28,49,11,13,17,86,136,6,1,80,121,52,80,23,41,10,13,16,75,121
2005-10-31 00:00:00.000,ATP Masters Series Paris France ATP World Tour,HARD,2,Fernando Verdasco,Nicolas Lapentti,Fernando Verdasco,6-7(5); 7-5; 7-5,R64,150,26,10,85,136,70,85,21,51,11,12,18,91,136,12,4,71,103,53,71,18,32,4,7,18,71,103
2005-10-31 00:00:00.000,ATP Masters Series Paris France ATP World Tour,HARD,2,Robby Ginepri,N/A Bye,Robby Ginepri,,R64,0,0,0,0,0,0,0,0,0,0,0,0,0,0,0,0,0,0,0,0,0,0,0,0,0,0,0
2005-10-31 00:00:00.000,ATP Masters Series Paris France ATP World Tour,HARD,2,Juan Carlos Ferrero,N/A Bye,Juan Carlos Ferrero,,R64,0,0,0,0,0,0,0,0,0,0,0,0,0,0,0,0,0,0,0,0,0,0,0,0,0,0,0
2005-10-31 00:00:00.000,ATP Masters Series Paris France ATP World Tour,HARD,2,Stanislas Wawrinka,Florent Serra,Stanislas Wawrinka,6-3; 6-4,R64,72,5,3,32,57,23,32,17,25,3,4,10,40,57,4,2,32,56,21,32,13,24,1,4,9,34,56
2005-10-31 00:00:00.000,ATP Masters Series Paris France ATP World Tour,HARD,2,Tomas Berdych,Jiri Novak,Tomas Berdych,7-5; 6-3,R64,59,14,2,38,60,30,38,15,22,0,0,11,45,60,6,0,44,60,31,44,10,16,6,8,10,41,60
2005-10-31 00:00:00.000,ATP Masters Series Paris France ATP World Tour,HARD,2,Guillermo Coria,N/A Bye,Guillermo Coria,,R64,0,0,0,0,0,0,0,0,0,0,0,0,0,0,0,0,0,0,0,0,0,0,0,0,0,0,0
2005-10-31 00:00:00.000,ATP Masters Series Paris France ATP World Tour,HARD,2,Andy Roddick,Taylor Dent,Andy Roddick,6-4; 6-7(2); 7-5,R32,139,7,2,85,126,64,85,22,41,11,11,17,86,126,13,8,60,104,49,60,24,44,4,6,17,73,104
2005-10-31 00:00:00.000,ATP Masters Series Paris France ATP World Tour,HARD,2,Dominik Hrbaty,Jean-Rene Lisnard,Dominik Hrbaty,6-3; 6-3,R32,71,5,1,36,57,30,36,10,21,2,2,9,40,57,4,1,26,57,17,26,14,31,5,8,9,31,57
2005-10-31 00:00:00.000,ATP Masters Series Paris France ATP World Tour,HARD,2,David Ferrer,Max Mirnyi,David Ferrer,6-4; 6-4,R32,74,2,2,35,62,26,35,16,27,7,8,10,42,62,9,1,31,56,23,31,12,25,0,3,10,35,56
2005-10-31 00:00:00.000,ATP Masters Series Paris France ATP World Tour,HARD,2,Tommy Haas,David Nalbandian,Tommy Haas,6-4; 6-3,R32,77,4,2,28,63,20,28,20,35,1,3,10,40,63,1,2,26,53,17,26,12,27,5,9,9,29,53
2005-10-31 00:00:00.000,ATP Masters Series Paris France ATP World Tour,HARD,2,Novak Djokovic,Mariano Puerta,Novak Djokovic,6-3; 7-6(9),R32,105,12,2,51,82,38,51,19,31,4,5,11,57,82,4,2,49,74,34,49,12,25,6,8,10,46,74
2005-10-31 00:00:00.000,ATP Masters Series Paris France ATP World Tour,HARD,2,Tommy Robredo,Arnaud Clement,Tommy Robredo,7-5; 6-2,R32,86,6,2,40,53,28,40,7,13,2,4,10,35,53,3,1,43,73,29,43,9,30,9,14,10,38,73
2005-10-31 00:00:00.000,ATP Masters Series Paris France ATP World Tour,HARD,2,Thomas Johansson,Kristof Vliegen,Thomas Johansson,6-3; 6-2,R32,55,14,3,25,46,22,25,14,21,0,0,9,36,46,5,1,39,51,23,39,6,12,4,7,8,29,51
2005-10-31 00:00:00.000,ATP Masters Series Paris France ATP World Tour,HARD,2,Ivan Ljubicic,James Blake,Ivan Ljubicic,6-3; 6-4,R32,70,11,4,41,62,36,41,10,21,5,5,10,46,62,2,4,25,50,20,25,14,25,1,3,9,34,50
2005-10-31 00:00:00.000,ATP Masters Series Paris France ATP World Tour,HARD,2,Radek Stepanek,Feliciano Lopez,Radek Stepanek,7-5; 6-2,R32,56,14,1,41,55,35,41,8,14,2,2,10,43,55,3,5,37,57,26,37,7,20,6,9,10,33,57
2005-10-31 00:00:00.000,ATP Masters Series Paris France ATP World Tour,HARD,2,Paul-Henri Mathieu,Fernando Gonzalez,Paul-Henri Mathieu,6-3; 3-6; 7-6(4),R32,117,10,2,53,86,45,53,18,33,4,5,15,63,86,16,8,54,104,40,54,28,50,3,4,15,68,104
2005-10-31 00:00:00.000,ATP Masters Series Paris France ATP World Tour,HARD,2,Dmitry Tursunov,Mario Ancic,Dmitry Tursunov,5-7; 6-4; 7-6(3),R32,149,3,9,56,113,42,56,31,57,8,11,17,73,113,13,2,69,108,52,69,20,39,7,10,17,72,108
2005-10-31 00:00:00.000,ATP Masters Series Paris France ATP World Tour,HARD,2,Nikolay Davydenko,Greg Rusedski,Nikolay Davydenko,6-2; 6-2,R32,64,2,0,32,41,27,32,6,9,1,1,8,33,41,8,5,30,56,19,30,10,26,2,6,8,29,56
2005-10-31 00:00:00.000,ATP Masters Series Paris France ATP World Tour,HARD,2,Gaston Gaudio,Fabrice Santoro,Gaston Gaudio,6-4; 7-5,R32,98,5,3,42,61,31,42,12,19,1,2,11,43,61,4,3,44,78,27,44,16,34,6,9,11,43,78
2005-10-31 00:00:00.000,ATP Masters Series Paris France ATP World Tour,HARD,2,Robby Ginepri,Fernando Verdasco,Robby Ginepri,6-3; 6-7(7); 6-3,R32,112,6,2,56,107,39,56,33,51,3,4,16,72,107,13,6,42,90,38,42,22,48,2,5,14,60,90
2005-10-31 00:00:00.000,ATP Masters Series Paris France ATP World Tour,HARD,2,Juan Carlos Ferrero,Stanislas Wawrinka,Juan Carlos Ferrero,7-6(4); 7-6(4),R32,102,6,2,53,78,44,53,15,25,3,3,12,59,78,8,3,50,88,40,50,21,38,2,2,12,61,88
2005-10-31 00:00:00.000,ATP Masters Series Paris France ATP World Tour,HARD,2,Tomas Berdych,Guillermo Coria,Tomas Berdych,6-4; 6-2,R32,61,5,1,22,43,21,22,12,21,1,2,9,33,43,0,5,25,45,17,25,8,20,2,6,9,25,45
2005-10-31 00:00:00.000,ATP Masters Series Paris France ATP World Tour,HARD,2,Andy Roddick,Dominik Hrbaty,Andy Roddick,6-1; 6-2,R16,50,16,0,32,38,28,32,4,6,0,0,8,32,38,0,2,24,46,16,24,7,22,7,11,7,23,46
2005-10-31 00:00:00.000,ATP Masters Series Paris France ATP World Tour,HARD,2,David Ferrer,Tommy Haas,David Ferrer,6-2; 6-7(3); 6-3,R16,113,5,6,57,90,45,57,20,33,2,3,15,65,90,3,6,47,92,33,47,20,45,2,6,14,53,92
2005-10-31 00:00:00.000,ATP Masters Series Paris France ATP World Tour,HARD,2,Tommy Robredo,Novak Djokovic,Tommy Robredo,6-4; 6-3,R16,81,6,3,33,57,27,33,11,24,3,4,9,38,57,4,3,41,78,27,41,15,37,9,13,10,42,78
2005-10-31 00:00:00.000,ATP Masters Series Paris France ATP World Tour,HARD,2,Ivan Ljubicic,Thomas Johansson,Ivan Ljubicic,6-3; 7-6(4),R16,81,19,2,36,61,35,36,15,25,0,0,11,50,61,7,0,44,69,32,44,14,25,4,5,10,46,69
2005-10-31 00:00:00.000,ATP Masters Series Paris France ATP World Tour,HARD,2,Radek Stepanek,Paul-Henri Mathieu,Radek Stepanek,7-5; 6-4,R16,89,10,1,35,54,28,35,17,19,1,1,11,45,54,7,3,43,74,32,43,14,31,2,4,11,46,74
2005-10-31 00:00:00.000,ATP Masters Series Paris France ATP World Tour,HARD,2,Nikolay Davydenko,Dmitry Tursunov,Nikolay Davydenko,3-6; 6-2; 6-3,R16,138,2,0,69,94,46,69,11,25,7,10,13,57,94,4,6,48,94,35,48,17,46,8,13,13,52,94
2005-10-31 00:00:00.000,ATP Masters Series Paris France ATP World Tour,HARD,2,Gaston Gaudio,Robby Ginepri,Gaston Gaudio,6-4; 6-1,R16,62,4,3,29,43,27,29,5,14,0,1,8,32,43,7,2,40,71,26,40,8,31,4,9,9,34,71
2005-10-31 00:00:00.000,ATP Masters Series Paris France ATP World Tour,HARD,2,Tomas Berdych,Juan Carlos Ferrero,Tomas Berdych,7-5; 6-7(7); 6-4,R16,152,20,3,72,128,60,72,20,56,8,11,17,80,128,16,4,68,103,47,68,14,35,4,9,17,61,103
2005-10-31 00:00:00.000,ATP Masters Series Paris France ATP World Tour,HARD,2,Andy Roddick,David Ferrer,Andy Roddick,2-6; 6-3; 7-6(8),Q,132,21,3,68,114,51,68,19,46,6,9,15,70,114,12,3,53,85,41,53,20,32,3,5,14,61,85
2005-10-31 00:00:00.000,ATP Masters Series Paris France ATP World Tour,HARD,2,Ivan Ljubicic,Tommy Robredo,Ivan Ljubicic,7-6(6); 3-6; 6-1,Q,140,12,3,68,113,49,68,23,45,6,8,14,72,113,3,4,59,92,46,59,15,33,6,9,14,61,92
2005-10-31 00:00:00.000,ATP Masters Series Paris France ATP World Tour,HARD,2,Radek Stepanek,Nikolay Davydenko,Radek Stepanek,7-5; 6-4,Q,73,5,2,44,57,36,44,7,13,4,5,11,43,57,2,1,38,56,23,38,12,18,0,3,11,35,56
2005-10-31 00:00:00.000,ATP Masters Series Paris France ATP World Tour,HARD,2,Tomas Berdych,Gaston Gaudio,Tomas Berdych,7-5; 6-0,Q,68,12,0,31,56,27,31,11,25,2,3,9,38,56,2,1,34,48,18,34,7,14,6,11,9,25,48
2005-10-31 00:00:00.000,ATP Masters Series Paris France ATP World Tour,HARD,2,Ivan Ljubicic,Andy Roddick,Ivan Ljubicic,6-3; 7-5,S,65,15,1,29,50,26,29,18,21,0,0,11,44,50,10,1,36,58,28,36,10,22,3,5,10,38,58
2005-10-31 00:00:00.000,ATP Masters Series Paris France ATP World Tour,HARD,2,Tomas Berdych,Radek Stepanek,Tomas Berdych,6-1; 3-6; 6-3,S,83,11,2,47,73,38,47,11,26,4,6,13,49,73,18,1,51,68,35,51,7,17,5,9,12,42,68
2005-10-31 00:00:00.000,ATP Masters Series Paris France ATP World Tour,HARD,2,Tomas Berdych,Ivan Ljubicic,Tomas Berdych,6-3; 6-4; 3-6; 4-6; 6-4,F,182,18,2,79,136,66,79,31,57,1,3,24,97,136,28,2,85,126,71,85,22,41,6,9,24,93,126
