event_time,event_name,surface,num_of_sets,playerA,playerB,winner,score,round,duration_minutes,a_aces,a_double_faults,a_first_serve_hits,a_first_serve_total,a_first_serve_won,a_first_serve_played,a_second_serve_won,a_second_serve_played,a_break_points_saved,a_break_points_total,a_service_games,a_service_points_won,a_service_points_total,b_aces,b_double_faults,b_first_serve_hits,b_first_serve_total,b_first_serve_won,b_first_serve_played,b_second_serve_won,b_second_serve_played,b_break_points_saved,b_break_points_total,b_service_games,b_service_points_won,b_service_points_total
2007-12-31 00:00:00.000,Adelaide Australia ATP World Tour,HARD,2,Lleyton Hewitt,Dudi Sela,Lleyton Hewitt,6-2; 6-2,R32,66,7,2,29,46,26,29,8,17,3,3,8,34,46,5,2,37,59,22,37,8,22,7,11,8,30,59
2007-12-31 00:00:00.000,Adelaide Australia ATP World Tour,HARD,2,Jose Acasuso,Alejandro Falla,Jose Acasuso,6-3; 7-6(3),R32,101,8,4,40,76,31,40,14,36,8,12,11,45,76,2,1,40,68,21,40,14,28,5,10,10,35,68
2007-12-31 00:00:00.000,Adelaide Australia ATP World Tour,HARD,2,Ernests Gulbis,Andrey Golubev,Ernests Gulbis,6-7(9); 6-4; 6-2,R32,138,7,6,80,133,59,80,22,53,14,16,15,81,133,6,4,63,109,43,63,20,46,3,8,15,63,109
2007-12-31 00:00:00.000,Adelaide Australia ATP World Tour,HARD,2,Jo-Wilfried Tsonga,Victor Hanescu,Jo-Wilfried Tsonga,6-3; 4-6; 7-5,R32,120,11,6,46,84,38,46,21,38,3,6,16,59,84,1,0,56,93,39,56,19,37,3,7,15,58,93
2007-12-31 00:00:00.000,Adelaide Australia ATP World Tour,HARD,2,Jarkko Nieminen,Ivo Klec,Jarkko Nieminen,6-2; 6-4,R32,66,1,1,34,48,24,34,10,14,0,1,9,34,48,3,2,40,65,25,40,9,25,1,5,9,34,65
2007-12-31 00:00:00.000,Adelaide Australia ATP World Tour,HARD,2,Frank Dancevic,Simone Bolelli,Frank Dancevic,6-2; 7-6(3),R32,77,4,0,39,73,30,39,22,34,5,5,10,52,73,8,2,43,65,29,43,12,22,3,5,10,41,65
2007-12-31 00:00:00.000,Adelaide Australia ATP World Tour,HARD,2,Mischa Zverev,Florian Mayer,Mischa Zverev,6-3; 6-3,R32,56,2,0,29,50,26,29,11,21,0,0,9,37,50,0,4,32,51,20,32,9,19,0,3,9,29,51
2007-12-31 00:00:00.000,Adelaide Australia ATP World Tour,HARD,2,Vincent Spadea,Sebastien Grosjean,Vincent Spadea,4-6; 6-1; 6-3,R32,115,6,3,46,84,31,46,18,38,5,9,13,49,84,6,5,47,83,33,47,11,36,3,10,13,44,83
2007-12-31 00:00:00.000,Adelaide Australia ATP World Tour,HARD,2,Michael Russell,Juan Martin Del Potro,Michael Russell,6-3; 6-3,R32,92,6,0,48,64,34,48,8,16,5,6,9,42,64,7,9,33,66,20,33,13,33,9,13,9,33,66
2007-12-31 00:00:00.000,Adelaide Australia ATP World Tour,HARD,2,Benjamin Becker,Robert Smeets,Benjamin Becker,3-6; 6-4; 6-2,R32,107,11,4,38,80,31,38,24,42,1,2,13,55,80,11,6,53,90,35,53,21,37,8,11,14,56,90
2007-12-31 00:00:00.000,Adelaide Australia ATP World Tour,HARD,2,Evgeny Korolev,Alun Jones,Evgeny Korolev,6-2; 7-6(7),R32,82,7,0,36,65,31,36,16,29,3,3,10,47,65,4,2,49,67,31,49,12,18,3,5,10,43,67
2007-12-31 00:00:00.000,Adelaide Australia ATP World Tour,HARD,2,Michael Llodra,Gilles Simon,Michael Llodra,7-6(3); 6-3,R32,89,1,1,41,66,33,41,18,25,3,4,11,51,66,7,4,44,72,32,44,13,28,4,6,10,45,72
2007-12-31 00:00:00.000,Adelaide Australia ATP World Tour,HARD,2,Joseph Sirianni,Radek Stepanek,Joseph Sirianni,7-6(3); 4-3 RET,R32,99,8,2,35,67,27,35,17,32,3,4,9,44,67,8,3,35,61,25,35,16,26,3,5,10,41,61
2007-12-31 00:00:00.000,Adelaide Australia ATP World Tour,HARD,2,Sam Querrey,Steve Darcis,Sam Querrey,7-5; 6-4,R32,80,11,2,32,61,26,32,14,29,1,3,11,40,61,0,6,55,77,34,55,10,22,7,11,11,44,77
2007-12-31 00:00:00.000,Adelaide Australia ATP World Tour,HARD,2,Chris Guccione,Wayne Odesnik,Chris Guccione,7-5; 7-6(5),R32,86,23,4,40,72,35,40,21,32,2,2,12,56,72,5,1,43,74,31,43,23,31,4,5,12,54,74
2007-12-31 00:00:00.000,Adelaide Australia ATP World Tour,HARD,2,Paul-Henri Mathieu,Julien Benneteau,Paul-Henri Mathieu,7-6(2); 7-5,R32,141,8,3,49,94,36,49,22,45,8,11,12,58,94,7,5,51,84,33,51,14,33,5,9,12,47,84
2007-12-31 00:00:00.000,Adelaide Australia ATP World Tour,HARD,2,Lleyton Hewitt,Jose Acasuso,Lleyton Hewitt,6-2; 6-2,R16,61,8,3,14,43,13,14,21,29,1,1,8,34,43,0,4,21,46,13,21,9,25,4,8,8,22,46
2007-12-31 00:00:00.000,Adelaide Australia ATP World Tour,HARD,2,Jo-Wilfried Tsonga,Ernests Gulbis,Jo-Wilfried Tsonga,6-3; 6-2,R16,62,10,1,33,52,29,33,11,19,3,3,9,40,52,3,3,40,60,24,40,7,20,4,7,8,31,60
2007-12-31 00:00:00.000,Adelaide Australia ATP World Tour,HARD,2,Jarkko Nieminen,Frank Dancevic,Jarkko Nieminen,6-4; 6-1,R16,57,2,0,31,52,24,31,13,21,3,3,8,37,52,5,2,32,52,22,32,6,20,3,7,9,28,52
2007-12-31 00:00:00.000,Adelaide Australia ATP World Tour,HARD,2,Vincent Spadea,Mischa Zverev,Vincent Spadea,6-3; 7-5,R16,80,2,3,46,74,33,46,14,28,4,5,11,47,74,2,1,50,65,33,50,6,15,4,7,10,39,65
2007-12-31 00:00:00.000,Adelaide Australia ATP World Tour,HARD,2,Benjamin Becker,Michael Russell,Benjamin Becker,6-4; 6-4,R16,80,8,1,35,58,29,35,12,23,4,5,10,41,58,3,2,37,61,27,37,12,24,4,7,10,39,61
2007-12-31 00:00:00.000,Adelaide Australia ATP World Tour,HARD,2,Michael Llodra,Evgeny Korolev,Michael Llodra,7-6(3); 6-3,R16,83,14,5,41,64,36,41,14,23,6,6,10,50,64,1,2,42,72,31,42,16,30,1,3,11,47,72
2007-12-31 00:00:00.000,Adelaide Australia ATP World Tour,HARD,2,Joseph Sirianni,Sam Querrey,Joseph Sirianni,6-7(5); 6-2; 6-3,R16,109,4,2,50,92,42,50,24,42,4,5,15,66,92,18,1,59,94,41,59,16,35,4,8,14,57,94
2007-12-31 00:00:00.000,Adelaide Australia ATP World Tour,HARD,2,Paul-Henri Mathieu,Chris Guccione,Paul-Henri Mathieu,4-6; 6-3; 6-4,R16,93,9,4,41,78,35,41,24,37,2,3,15,59,78,24,2,46,69,37,46,13,23,1,3,14,50,69
2007-12-31 00:00:00.000,Adelaide Australia ATP World Tour,HARD,2,Jo-Wilfried Tsonga,Lleyton Hewitt,Jo-Wilfried Tsonga,6-4; 6-2,Q,80,14,3,41,64,29,41,10,23,5,6,9,39,64,0,3,26,52,14,26,14,26,3,7,9,28,52
2007-12-31 00:00:00.000,Adelaide Australia ATP World Tour,HARD,2,Jarkko Nieminen,Vincent Spadea,Jarkko Nieminen,7-6(5); 6-7(7); 7-6(5),Q,166,9,4,99,132,70,99,13,33,5,8,18,83,132,6,3,81,138,57,81,27,57,9,12,18,84,138
2007-12-31 00:00:00.000,Adelaide Australia ATP World Tour,HARD,2,Michael Llodra,Benjamin Becker,Michael Llodra,7-6(5); 6-4,Q,110,17,3,47,82,37,47,21,35,4,4,11,58,82,10,2,46,76,32,46,19,30,2,3,11,51,76
2007-12-31 00:00:00.000,Adelaide Australia ATP World Tour,HARD,2,Joseph Sirianni,Paul-Henri Mathieu,Joseph Sirianni,1-6; 6-1; 7-6(6),Q,133,17,4,49,102,39,49,27,53,7,9,13,66,102,12,6,45,93,32,45,27,48,5,7,13,59,93
2007-12-31 00:00:00.000,Adelaide Australia ATP World Tour,HARD,2,Jarkko Nieminen,Jo-Wilfried Tsonga,Jarkko Nieminen,6-2; 6-4,S,64,3,2,42,55,34,42,5,13,3,3,9,39,55,5,2,30,50,24,30,6,20,4,7,9,30,50
2007-12-31 00:00:00.000,Adelaide Australia ATP World Tour,HARD,2,Michael Llodra,Joseph Sirianni,Michael Llodra,6-3; 7-6(8),S,98,14,0,38,63,34,38,18,25,2,2,11,52,63,7,4,38,76,27,38,20,38,3,4,10,47,76
2007-12-31 00:00:00.000,Adelaide Australia ATP World Tour,HARD,2,Michael Llodra,Jarkko Nieminen,Michael Llodra,6-3; 6-4,F,77,6,1,34,53,30,34,12,19,1,1,10,42,53,3,2,53,79,34,53,12,26,12,14,9,46,79
2007-12-31 00:00:00.000,Chennai India ATP World Tour,HARD,2,Rafael Nadal,Mathieu Montcourt,Rafael Nadal,6-2; 6-4,R32,96,2,0,35,59,21,35,14,24,1,4,9,35,59,0,1,41,60,18,41,7,19,4,10,9,25,60
2007-12-31 00:00:00.000,Chennai India ATP World Tour,HARD,2,Rajeev Ram,Yuri Schukin,Rajeev Ram,7-6(6); 7-6(2),R32,113,9,1,63,89,47,63,14,26,2,3,12,61,89,4,2,52,81,36,52,19,29,0,1,12,55,81
2007-12-31 00:00:00.000,Chennai India ATP World Tour,HARD,2,Guillermo Garcia-Lopez,Alexander Peya,Guillermo Garcia-Lopez,6-4; 6-4,R32,88,2,3,39,63,20,39,16,24,1,4,10,36,63,1,7,27,47,16,27,6,20,0,5,10,22,47
2007-12-31 00:00:00.000,Chennai India ATP World Tour,HARD,2,Werner Eschauer,Bartolome Salva-Vidal,Werner Eschauer,7-6(3); 5-7; 6-4,R32,164,4,4,63,108,50,63,27,45,3,4,17,77,108,2,2,66,108,52,66,22,42,5,6,17,74,108
2007-12-31 00:00:00.000,Chennai India ATP World Tour,HARD,2,Carlos Moya,Teymuraz Gabashvili,Carlos Moya,6-4; 6-1,R32,66,5,1,31,44,21,31,9,13,0,2,8,30,44,4,3,36,64,19,36,9,28,6,12,9,28,64
2007-12-31 00:00:00.000,Chennai India ATP World Tour,HARD,2,Alexander Kudryavtsev,Prakash Amritraj,Alexander Kudryavtsev,6-3; 4-6; 7-6(8),R32,120,6,3,49,99,36,49,29,50,3,6,15,65,99,3,2,65,98,42,65,17,33,5,9,16,59,98
2007-12-31 00:00:00.000,Chennai India ATP World Tour,HARD,2,Florent Serra,Ivan Navarro,Florent Serra,6-4; 7-6(6),R32,105,3,0,45,68,34,45,16,23,4,4,11,50,68,9,0,45,83,35,45,18,38,7,8,11,53,83
2007-12-31 00:00:00.000,Chennai India ATP World Tour,HARD,2,Kristof Vliegen,Marc Gicquel,Kristof Vliegen,7-6(5); 6-4,R32,98,7,0,44,69,31,44,16,25,3,5,11,47,69,7,3,43,69,29,43,14,26,3,6,11,43,69
2007-12-31 00:00:00.000,Chennai India ATP World Tour,HARD,2,Jurgen Melzer,Paul Capdeville,Jurgen Melzer,6-2; 6-4,R32,68,6,0,30,50,25,30,13,20,1,1,9,38,50,3,1,36,60,26,36,8,24,5,8,9,34,60
2007-12-31 00:00:00.000,Chennai India ATP World Tour,HARD,2,Xavier Malisse,Gilles Muller,Xavier Malisse,6-4; 6-3,R32,74,7,2,25,45,24,25,12,20,0,0,9,36,45,6,1,41,63,28,41,11,22,4,7,10,39,63
2007-12-31 00:00:00.000,Chennai India ATP World Tour,HARD,2,Edouard Roger-Vasselin,Vishnu Vardhan,Edouard Roger-Vasselin,6-1; 6-2,R32,52,3,3,30,45,24,30,9,15,0,0,8,33,45,1,3,19,35,12,19,6,16,1,5,7,18,35
2007-12-31 00:00:00.000,Chennai India ATP World Tour,HARD,2,Mikhail Youzhny,Jiri Vanek,Mikhail Youzhny,6-3; 6-2,R32,73,7,2,49,70,35,49,11,21,8,9,9,46,70,4,0,29,46,18,29,5,17,3,7,8,23,46
2007-12-31 00:00:00.000,Chennai India ATP World Tour,HARD,2,Nicolas Mahut,Denis Gremelmayr,Nicolas Mahut,6-3; 6-3,R32,68,2,2,28,52,21,28,14,24,3,4,9,35,52,3,3,35,55,22,35,9,20,6,10,9,31,55
2007-12-31 00:00:00.000,Chennai India ATP World Tour,HARD,2,Marin Cilic,Viktor Troicki,Marin Cilic,3-6; 7-6(6); 6-1,R32,134,7,2,48,93,38,48,24,45,4,7,15,62,93,3,3,51,97,31,51,28,46,4,7,13,59,97
2007-12-31 00:00:00.000,Chennai India ATP World Tour,HARD,2,Lovro Zovko,Thierry Ascione,Lovro Zovko,6-4; 6-0,R32,59,15,4,40,57,29,40,8,17,8,8,8,37,57,3,4,26,41,13,26,8,15,2,6,8,21,41
2007-12-31 00:00:00.000,Chennai India ATP World Tour,HARD,2,Robin Haase,Marcos Baghdatis,Robin Haase,6-3; 6-4,R32,84,4,4,52,83,39,52,16,31,7,7,10,55,83,3,2,35,56,26,35,10,21,1,3,9,36,56
2007-12-31 00:00:00.000,Chennai India ATP World Tour,HARD,2,Rafael Nadal,Rajeev Ram,Rafael Nadal,6-2; 6-1,R16,66,4,0,32,45,24,32,11,13,2,2,8,35,45,0,2,27,43,17,27,4,16,2,6,7,21,43
2007-12-31 00:00:00.000,Chennai India ATP World Tour,HARD,2,Guillermo Garcia-Lopez,Werner Eschauer,Guillermo Garcia-Lopez,4-6; 7-5; 7-6(3),R16,152,9,5,63,97,52,63,19,34,2,4,17,71,97,10,2,64,114,48,64,29,50,5,7,17,77,114
2007-12-31 00:00:00.000,Chennai India ATP World Tour,HARD,2,Carlos Moya,Alexander Kudryavtsev,Carlos Moya,6-3; 6-7(4); 6-2,R16,112,4,2,52,95,39,52,27,43,3,3,14,66,95,1,1,35,86,26,35,30,51,1,5,15,56,86
2007-12-31 00:00:00.000,Chennai India ATP World Tour,HARD,2,Florent Serra,Kristof Vliegen,Florent Serra,7-5; 4-6; 7-6(3),R16,146,3,3,60,107,44,60,23,47,2,6,17,67,107,13,3,67,108,46,67,21,41,3,7,17,67,108
2007-12-31 00:00:00.000,Chennai India ATP World Tour,HARD,2,Xavier Malisse,Jurgen Melzer,Xavier Malisse,7-6(3); 6-2,R16,94,8,2,32,62,24,32,21,30,0,0,10,45,62,1,1,62,89,39,62,11,27,13,15,10,50,89
2007-12-31 00:00:00.000,Chennai India ATP World Tour,HARD,2,Mikhail Youzhny,Edouard Roger-Vasselin,Mikhail Youzhny,7-5; 1-6; 6-2,R16,108,1,3,46,74,30,46,17,28,4,8,13,47,74,1,3,57,82,35,57,9,25,2,7,14,44,82
2007-12-31 00:00:00.000,Chennai India ATP World Tour,HARD,2,Marin Cilic,Nicolas Mahut,Marin Cilic,6-2; 6-4,R16,77,8,3,30,53,23,30,12,23,2,3,9,35,53,4,4,47,74,32,47,8,27,8,12,9,40,74
2007-12-31 00:00:00.000,Chennai India ATP World Tour,HARD,2,Robin Haase,Lovro Zovko,Robin Haase,6-1; 7-5,R16,79,6,1,37,54,27,37,13,17,3,3,9,40,54,8,4,44,84,29,44,16,40,12,16,10,45,84
2007-12-31 00:00:00.000,Chennai India ATP World Tour,HARD,2,Rafael Nadal,Guillermo Garcia-Lopez,Rafael Nadal,6-3; 6-2,Q,80,1,0,30,45,24,30,12,15,0,0,9,36,45,6,5,24,52,18,24,9,28,3,6,8,27,52
2007-12-31 00:00:00.000,Chennai India ATP World Tour,HARD,2,Carlos Moya,Florent Serra,Carlos Moya,6-3; 6-4,Q,75,8,1,31,53,25,31,15,22,0,0,10,40,53,0,3,48,75,32,48,12,27,8,10,9,44,75
2007-12-31 00:00:00.000,Chennai India ATP World Tour,HARD,2,Mikhail Youzhny,Xavier Malisse,Mikhail Youzhny,6-4; 6-4,Q,70,1,2,29,47,27,29,13,18,0,0,10,40,47,6,1,35,57,25,35,12,22,2,4,10,37,57
2007-12-31 00:00:00.000,Chennai India ATP World Tour,HARD,2,Marin Cilic,Robin Haase,Marin Cilic,4-6; 6-2; 6-3,Q,107,6,1,48,86,35,48,21,38,3,5,14,56,86,5,4,51,85,35,51,15,34,5,9,13,50,85
2007-12-31 00:00:00.000,Chennai India ATP World Tour,HARD,2,Rafael Nadal,Carlos Moya,Rafael Nadal,6-7(3); 7-6(8); 7-6(1),S,235,4,1,81,121,58,81,27,40,2,4,18,85,121,9,4,109,153,74,109,24,44,15,17,18,98,153
2007-12-31 00:00:00.000,Chennai India ATP World Tour,HARD,2,Mikhail Youzhny,Marin Cilic,Mikhail Youzhny,6-2; 6-3,S,83,3,0,29,43,24,29,9,14,1,1,8,33,43,3,2,35,76,21,35,18,41,4,8,9,39,76
2007-12-31 00:00:00.000,Chennai India ATP World Tour,HARD,2,Mikhail Youzhny,Rafael Nadal,Mikhail Youzhny,6-0; 6-1,F,57,9,0,23,33,21,23,7,10,0,0,7,28,33,1,1,21,32,10,21,2,11,1,6,6,12,32
2007-12-31 00:00:00.000,Doha Qatar ATP World Tour,HARD,2,Nikolay Davydenko,Benedikt Dorsch,Nikolay Davydenko,6-3; 6-0,R32,76,1,3,41,45,29,41,0,4,2,3,7,29,45,2,2,43,59,18,43,8,16,7,13,8,26,59
2007-12-31 00:00:00.000,Doha Qatar ATP World Tour,HARD,2,Fabrice Santoro,Andreas Seppi,Fabrice Santoro,6-4; 1-6; 6-2,R32,118,1,1,47,86,32,47,19,39,8,11,12,51,86,2,6,46,79,35,46,11,33,4,8,13,46,79
2007-12-31 00:00:00.000,Doha Qatar ATP World Tour,HARD,2,Nicolas Kiefer,Sebastien De Chaunac,Nicolas Kiefer,6-4; 6-3,R32,84,3,0,26,44,25,26,8,18,0,1,9,33,44,5,1,41,63,23,41,9,22,5,9,10,32,63
2007-12-31 00:00:00.000,Doha Qatar ATP World Tour,HARD,2,Dmitry Tursunov,Albert Montanes,Dmitry Tursunov,6-2; 7-5,R32,81,9,1,44,67,34,44,10,23,3,4,10,44,67,5,2,40,65,29,40,8,25,2,6,10,37,65
2007-12-31 00:00:00.000,Doha Qatar ATP World Tour,HARD,2,Andy Murray,Olivier Rochus,Andy Murray,6-0; 6-2,R32,79,5,1,21,38,16,21,11,17,0,1,7,27,38,1,5,38,73,24,38,6,35,11,17,7,30,73
2007-12-31 00:00:00.000,Doha Qatar ATP World Tour,HARD,2,Rainer Schuettler,Andrei Pavel,Rainer Schuettler,1-6; 6-2; 6-0,R32,100,3,2,41,74,31,41,15,33,5,8,11,46,74,5,2,39,64,23,39,12,25,5,10,10,35,64
2007-12-31 00:00:00.000,Doha Qatar ATP World Tour,HARD,2,Michael Berrer,Abdulla Hajji,Michael Berrer,6-1; 6-1,R32,35,6,0,20,28,20,20,8,8,0,0,7,28,28,0,4,26,40,15,26,1,14,2,7,7,16,40
2007-12-31 00:00:00.000,Doha Qatar ATP World Tour,HARD,2,Thomas Johansson,Igor Andreev,Thomas Johansson,6-1; 6-0,R32,47,3,1,24,35,21,24,7,11,0,0,7,28,35,0,1,23,36,8,23,5,13,3,8,6,13,36
2007-12-31 00:00:00.000,Doha Qatar ATP World Tour,HARD,2,Philipp Kohlschreiber,Oscar Hernandez,Philipp Kohlschreiber,6-3; 6-1,R32,78,5,4,34,54,26,34,9,20,2,3,8,35,54,3,5,26,59,15,26,11,33,8,13,8,26,59
2007-12-31 00:00:00.000,Doha Qatar ATP World Tour,HARD,2,Filippo Volandri,Diego Hartfield,Filippo Volandri,4-6; 6-3; 7-6(3),R32,166,4,7,86,121,55,86,15,35,12,16,16,70,121,3,5,70,112,45,70,16,42,6,10,15,61,112
2007-12-31 00:00:00.000,Doha Qatar ATP World Tour,HARD,2,Janko Tipsarevic,Santiago Ventura,Janko Tipsarevic,3-6; 6-3; 6-4,R32,140,2,3,43,81,33,43,20,38,7,10,14,53,81,9,3,53,105,38,53,22,52,8,12,14,60,105
2007-12-31 00:00:00.000,Doha Qatar ATP World Tour,HARD,2,Ivan Ljubicic,Stefan Koubek,Ivan Ljubicic,6-4; 6-4,R32,73,10,0,44,56,33,44,7,12,0,1,10,40,56,2,3,36,61,25,36,9,25,2,5,10,34,61
2007-12-31 00:00:00.000,Doha Qatar ATP World Tour,HARD,2,Christophe Rochus,Ivo Karlovic,Christophe Rochus,7-6(2); 6-2,R32,84,3,2,49,71,38,49,11,22,4,4,10,49,71,16,1,45,64,34,45,7,19,1,3,10,41,64
2007-12-31 00:00:00.000,Doha Qatar ATP World Tour,HARD,2,Stanislas Wawrinka,Alberto Martin,Stanislas Wawrinka,6-2; 6-2,R32,73,5,0,23,46,19,23,12,23,0,1,8,31,46,1,2,35,65,18,35,12,30,9,14,8,30,65
2007-12-31 00:00:00.000,Doha Qatar ATP World Tour,HARD,2,Hyung-Taik Lee,Max Mirnyi,Hyung-Taik Lee,6-3; 6-2,R32,57,1,1,36,50,25,36,10,14,1,2,9,35,50,1,0,26,40,14,26,7,14,0,4,8,21,40
2007-12-31 00:00:00.000,Doha Qatar ATP World Tour,HARD,2,Agustin Calleri,Tommy Robredo,Agustin Calleri,6-4; 6-4,R32,104,4,3,33,64,26,33,16,31,3,4,10,42,64,1,1,40,57,27,40,8,17,3,6,10,35,57
2007-12-31 00:00:00.000,Doha Qatar ATP World Tour,HARD,2,Nikolay Davydenko,Fabrice Santoro,Nikolay Davydenko,6-3; 6-3,R16,73,1,2,36,57,27,36,13,21,2,2,9,40,57,0,2,25,47,15,25,13,22,3,6,9,28,47
2007-12-31 00:00:00.000,Doha Qatar ATP World Tour,HARD,2,Dmitry Tursunov,Nicolas Kiefer,Dmitry Tursunov,W/O,R16,0,0,0,0,0,0,0,0,0,0,0,0,0,0,0,0,0,0,0,0,0,0,0,0,0,0,0
2007-12-31 00:00:00.000,Doha Qatar ATP World Tour,HARD,2,Andy Murray,Rainer Schuettler,Andy Murray,1-6; 6-0; 6-1,R16,94,5,2,44,73,32,44,12,29,4,6,10,44,73,0,1,28,50,15,28,12,22,3,8,10,27,50
2007-12-31 00:00:00.000,Doha Qatar ATP World Tour,HARD,2,Thomas Johansson,Michael Berrer,Thomas Johansson,6-3; 7-5,R16,92,3,0,56,79,43,56,11,23,6,6,11,54,79,6,5,39,65,28,39,14,26,4,6,10,42,65
2007-12-31 00:00:00.000,Doha Qatar ATP World Tour,HARD,2,Philipp Kohlschreiber,Filippo Volandri,Philipp Kohlschreiber,6-4; 6-1,R16,65,1,1,29,47,22,29,10,18,0,1,8,32,47,1,1,28,50,17,28,8,22,2,7,9,25,50
2007-12-31 00:00:00.000,Doha Qatar ATP World Tour,HARD,2,Ivan Ljubicic,Janko Tipsarevic,Ivan Ljubicic,W/O,R16,0,0,0,0,0,0,0,0,0,0,0,0,0,0,0,0,0,0,0,0,0,0,0,0,0,0,0
2007-12-31 00:00:00.000,Doha Qatar ATP World Tour,HARD,2,Stanislas Wawrinka,Christophe Rochus,Stanislas Wawrinka,6-2; 7-5,R16,98,10,1,38,68,29,38,15,30,3,4,10,44,68,1,1,46,72,29,46,9,26,7,11,10,38,72
2007-12-31 00:00:00.000,Doha Qatar ATP World Tour,HARD,2,Agustin Calleri,Hyung-Taik Lee,Agustin Calleri,6-3; 6-1,R16,65,7,2,23,44,18,23,13,21,2,3,8,31,44,2,1,37,57,20,37,5,20,4,9,8,25,57
2007-12-31 00:00:00.000,Doha Qatar ATP World Tour,HARD,2,Nikolay Davydenko,Dmitry Tursunov,Nikolay Davydenko,7-5; 6-3,Q,106,5,4,46,64,30,46,9,18,6,9,10,39,64,3,3,44,81,25,44,14,37,4,10,11,39,81
2007-12-31 00:00:00.000,Doha Qatar ATP World Tour,HARD,2,Andy Murray,Thomas Johansson,Andy Murray,7-6(4); 6-0,Q,88,11,2,35,55,28,35,15,20,0,0,9,43,55,2,2,44,61,24,44,9,17,2,5,9,33,61
2007-12-31 00:00:00.000,Doha Qatar ATP World Tour,HARD,2,Ivan Ljubicic,Philipp Kohlschreiber,Ivan Ljubicic,6-3; 6-7(4); 6-3,Q,136,14,2,67,99,54,67,15,32,5,6,16,69,99,5,2,52,85,42,52,13,33,3,6,14,55,85
2007-12-31 00:00:00.000,Doha Qatar ATP World Tour,HARD,2,Stanislas Wawrinka,Agustin Calleri,Stanislas Wawrinka,6-3; 6-0,Q,65,4,0,23,39,20,23,12,16,0,0,8,32,39,2,3,28,59,19,28,9,31,5,9,7,28,59
2007-12-31 00:00:00.000,Doha Qatar ATP World Tour,HARD,2,Andy Murray,Nikolay Davydenko,Andy Murray,6-4; 6-3,S,83,2,1,28,51,21,28,17,23,0,1,10,38,51,1,2,38,57,24,38,9,19,6,9,9,33,57
2007-12-31 00:00:00.000,Doha Qatar ATP World Tour,HARD,2,Stanislas Wawrinka,Ivan Ljubicic,Stanislas Wawrinka,7-6(1); 6-4,S,92,8,4,34,58,30,34,17,24,0,0,11,47,58,8,2,45,63,35,45,8,18,1,2,11,43,63
2007-12-31 00:00:00.000,Doha Qatar ATP World Tour,HARD,2,Andy Murray,Stanislas Wawrinka,Andy Murray,6-4; 4-6; 6-2,F,148,4,5,51,91,36,51,20,40,2,5,14,56,91,6,3,77,101,39,77,15,24,8,13,14,54,101
2008-01-07 00:00:00.000,Auckland New Zealand ATP World Tour,HARD,2,David Ferrer,Oscar Hernandez,David Ferrer,6-1; 6-2,R32,57,2,1,25,37,23,25,9,12,0,0,8,32,37,0,3,29,44,13,29,6,15,4,8,7,19,44
2008-01-07 00:00:00.000,Auckland New Zealand ATP World Tour,HARD,2,Sergio Roitman,Lukas Rosol,Sergio Roitman,6-2; 7-5,R32,69,4,0,32,53,26,32,12,21,0,1,10,38,53,2,2,27,56,18,27,11,29,3,7,10,29,56
2008-01-07 00:00:00.000,Auckland New Zealand ATP World Tour,HARD,2,Julien Benneteau,Dudi Sela,Julien Benneteau,6-4; 7-6(3),R32,100,3,1,58,85,37,58,15,27,12,14,11,52,85,2,4,39,70,25,39,15,31,3,6,11,40,70
2008-01-07 00:00:00.000,Auckland New Zealand ATP World Tour,HARD,2,Nicolas Almagro,Jose Acasuso,Nicolas Almagro,6-3; 6-4,R32,67,9,3,39,64,29,39,13,25,4,5,10,42,64,4,2,38,58,25,38,8,20,6,9,9,33,58
2008-01-07 00:00:00.000,Auckland New Zealand ATP World Tour,HARD,2,Juan Carlos Ferrero,Jesse Levine,Juan Carlos Ferrero,6-4; 6-1,R32,79,5,1,33,50,23,33,13,17,3,3,8,36,50,3,3,38,67,23,38,13,29,11,15,9,36,67
2008-01-07 00:00:00.000,Auckland New Zealand ATP World Tour,HARD,2,Jurgen Melzer,Werner Eschauer,Jurgen Melzer,6-4; 1-6; 6-3,R32,112,7,4,55,86,36,55,14,31,4,8,13,50,86,3,6,45,86,31,45,18,41,2,6,13,49,86
2008-01-07 00:00:00.000,Auckland New Zealand ATP World Tour,HARD,2,Nicolas Massu,G.D. Jones,Nicolas Massu,6-4; 6-2,R32,83,5,0,31,44,26,31,8,13,0,1,9,34,44,2,3,38,55,23,38,6,17,2,6,9,29,55
2008-01-07 00:00:00.000,Auckland New Zealand ATP World Tour,HARD,2,Xavier Malisse,Jarkko Nieminen,Xavier Malisse,7-6(3); 6-3,R32,82,7,2,35,63,29,35,16,28,0,1,11,45,63,0,1,42,70,25,42,17,28,0,2,10,42,70
2008-01-07 00:00:00.000,Auckland New Zealand ATP World Tour,HARD,2,Albert Montanes,Jose (Rubin) Statham,Albert Montanes,6-4; 6-4,R32,71,6,4,32,54,28,32,13,22,0,0,10,41,54,8,1,46,73,36,46,9,27,2,4,10,45,73
2008-01-07 00:00:00.000,Auckland New Zealand ATP World Tour,HARD,2,Michael Llodra,Hyung-Taik Lee,Michael Llodra,6-1; 6-4,R32,63,5,1,28,44,24,28,12,16,0,0,9,36,44,1,3,33,56,22,33,9,23,2,5,8,31,56
2008-01-07 00:00:00.000,Auckland New Zealand ATP World Tour,HARD,2,Olivier Rochus,Michael Berrer,Olivier Rochus,6-7(8); 6-2; 6-4,R32,140,1,2,72,100,56,72,13,28,6,7,15,69,100,12,8,60,101,41,60,19,41,7,11,15,60,101
2008-01-07 00:00:00.000,Auckland New Zealand ATP World Tour,HARD,2,Juan Monaco,Thomas Johansson,Juan Monaco,6-3; 6-4,R32,61,3,2,48,58,37,48,5,10,1,2,10,42,58,7,2,31,47,23,31,6,16,1,4,9,29,47
2008-01-07 00:00:00.000,Auckland New Zealand ATP World Tour,HARD,2,Philipp Kohlschreiber,Michael Russell,Philipp Kohlschreiber,7-5; 6-2,R32,93,7,5,37,70,28,37,13,33,5,7,10,41,70,5,3,29,56,15,29,13,27,0,5,10,28,56
2008-01-07 00:00:00.000,Auckland New Zealand ATP World Tour,HARD,2,Marin Cilic,Tomas Cakl,Marin Cilic,6-4; 6-3,R32,76,6,1,36,67,29,36,15,31,5,5,9,44,67,4,4,33,64,24,33,12,31,6,9,10,36,64
2008-01-07 00:00:00.000,Auckland New Zealand ATP World Tour,HARD,2,Florian Mayer,Sam Querrey,Florian Mayer,7-5; 6-3,R32,73,3,1,35,59,26,35,17,24,2,2,10,43,59,7,7,36,68,28,36,14,32,6,9,11,42,68
2008-01-07 00:00:00.000,Auckland New Zealand ATP World Tour,HARD,2,Juan Ignacio Chela,Daniel King-Turner,Juan Ignacio Chela,5-7; 6-2; 7-5,R32,145,2,6,54,97,39,54,26,43,3,5,16,65,97,9,4,70,110,52,70,14,40,9,13,16,66,110
2008-01-07 00:00:00.000,Auckland New Zealand ATP World Tour,HARD,2,David Ferrer,Sergio Roitman,David Ferrer,6-1; 7-6(2),R16,89,2,2,41,60,32,41,12,19,2,3,10,44,60,4,1,49,80,31,49,12,31,9,12,9,43,80
2008-01-07 00:00:00.000,Auckland New Zealand ATP World Tour,HARD,2,Julien Benneteau,Nicolas Almagro,Julien Benneteau,6-4; 2-6; 6-2,R16,110,0,3,71,95,48,71,11,24,10,12,13,59,95,10,0,44,72,30,44,18,28,5,8,13,48,72
2008-01-07 00:00:00.000,Auckland New Zealand ATP World Tour,HARD,2,Juan Carlos Ferrero,Jurgen Melzer,Juan Carlos Ferrero,6-3; 7-6(6),R16,78,3,0,41,63,34,41,16,22,2,2,11,50,63,1,0,38,60,25,38,17,22,2,3,10,42,60
2008-01-07 00:00:00.000,Auckland New Zealand ATP World Tour,HARD,2,Nicolas Massu,Xavier Malisse,Nicolas Massu,6-4; 6-4,R16,99,3,3,43,70,29,43,15,27,6,7,10,44,70,5,0,37,55,28,37,6,18,2,5,10,34,55
2008-01-07 00:00:00.000,Auckland New Zealand ATP World Tour,HARD,2,Michael Llodra,Albert Montanes,Michael Llodra,6-3; 6-4,R16,79,12,3,47,68,36,47,12,21,6,6,10,48,68,4,5,35,60,26,35,10,25,1,3,9,36,60
2008-01-07 00:00:00.000,Auckland New Zealand ATP World Tour,HARD,2,Juan Monaco,Olivier Rochus,Juan Monaco,6-3; 6-3,R16,75,5,2,32,52,25,32,7,20,1,3,9,32,52,0,2,37,53,23,37,4,16,7,12,9,27,53
2008-01-07 00:00:00.000,Auckland New Zealand ATP World Tour,HARD,2,Philipp Kohlschreiber,Marin Cilic,Philipp Kohlschreiber,6-3; 6-7(5); 6-4,R16,131,4,3,64,98,52,64,18,34,3,5,16,70,98,19,3,55,90,43,55,15,35,3,7,15,58,90
2008-01-07 00:00:00.000,Auckland New Zealand ATP World Tour,HARD,2,Florian Mayer,Juan Ignacio Chela,Florian Mayer,6-3; 7-6(7),R16,85,3,0,36,71,28,36,22,35,1,2,11,50,71,3,3,31,64,23,31,17,33,1,3,10,40,64
2008-01-07 00:00:00.000,Auckland New Zealand ATP World Tour,HARD,2,Julien Benneteau,David Ferrer,Julien Benneteau,6-4; 6-0,Q,64,3,1,30,42,25,30,8,12,0,0,8,33,42,0,0,35,53,21,35,6,18,5,9,8,27,53
2008-01-07 00:00:00.000,Auckland New Zealand ATP World Tour,HARD,2,Juan Carlos Ferrero,Nicolas Massu,Juan Carlos Ferrero,4-6; 6-3; 6-4,Q,153,1,1,57,82,40,57,12,25,2,5,14,52,82,6,5,65,108,40,65,21,43,7,12,15,61,108
2008-01-07 00:00:00.000,Auckland New Zealand ATP World Tour,HARD,2,Juan Monaco,Michael Llodra,Juan Monaco,4-6; 7-6(5); 7-6(5),Q,142,1,3,83,116,54,83,19,33,4,8,17,73,116,15,3,59,98,45,59,22,39,3,6,17,67,98
2008-01-07 00:00:00.000,Auckland New Zealand ATP World Tour,HARD,2,Philipp Kohlschreiber,Florian Mayer,Philipp Kohlschreiber,6-3; 6-4,Q,72,2,0,36,54,26,36,11,18,3,5,10,37,54,2,1,39,61,24,39,8,22,6,10,9,32,61
2008-01-07 00:00:00.000,Auckland New Zealand ATP World Tour,HARD,2,Juan Carlos Ferrero,Julien Benneteau,Juan Carlos Ferrero,6-3; 6-4,S,97,3,2,52,75,36,52,14,23,5,5,10,50,75,3,0,38,59,26,38,9,21,2,4,9,35,59
2008-01-07 00:00:00.000,Auckland New Zealand ATP World Tour,HARD,2,Philipp Kohlschreiber,Juan Monaco,Philipp Kohlschreiber,6-2; 6-1,S,66,2,2,24,43,18,24,10,19,1,2,7,28,43,1,1,35,53,13,35,9,18,4,10,8,22,53
2008-01-07 00:00:00.000,Auckland New Zealand ATP World Tour,HARD,2,Philipp Kohlschreiber,Juan Carlos Ferrero,Philipp Kohlschreiber,7-6(4); 7-5,F,114,7,7,54,89,39,54,19,35,4,5,12,58,89,5,1,59,76,43,59,9,17,3,5,12,52,76
2008-01-07 00:00:00.000,Sydney Australia ATP World Tour,HARD,2,Richard Gasquet,Igor Andreev,Richard Gasquet,6-3; 7-6(6),R32,94,7,5,40,70,35,40,15,30,3,4,11,50,70,2,4,41,66,29,41,11,25,1,3,10,40,66
2008-01-07 00:00:00.000,Sydney Australia ATP World Tour,HARD,2,Dmitry Tursunov,Stanislas Wawrinka,Dmitry Tursunov,6-3; 6-3,R32,67,3,2,27,51,22,27,13,24,3,4,9,35,51,2,1,37,54,23,37,7,17,2,6,9,30,54
2008-01-07 00:00:00.000,Sydney Australia ATP World Tour,HARD,2,Sebastien Grosjean,Peter Luczak,Sebastien Grosjean,6-4; 4-6; 6-0,R32,126,9,2,40,78,32,40,20,38,4,6,13,52,78,5,1,63,98,34,63,20,35,6,11,13,54,98
2008-01-07 00:00:00.000,Sydney Australia ATP World Tour,HARD,2,Fernando Verdasco,Feliciano Lopez,Fernando Verdasco,6-3; 4-6; 6-2,R32,124,3,4,64,83,44,64,8,19,5,8,14,52,83,11,5,54,99,35,54,19,45,8,13,13,54,99
2008-01-07 00:00:00.000,Sydney Australia ATP World Tour,HARD,2,Fabrice Santoro,James Blake,Fabrice Santoro,7-6(4); 6-2,R32,80,5,2,27,68,18,27,23,41,5,8,10,41,68,3,1,31,57,21,31,10,26,2,7,10,31,57
2008-01-07 00:00:00.000,Sydney Australia ATP World Tour,HARD,2,Steve Darcis,Joseph Sirianni,Steve Darcis,6-1; 7-6(4),R32,69,6,2,38,57,32,38,11,19,0,1,10,43,57,1,2,26,56,21,26,14,30,4,7,9,35,56
2008-01-07 00:00:00.000,Sydney Australia ATP World Tour,HARD,2,Ivo Minar,Alun Jones,Ivo Minar,6-2; 7-5,R32,73,5,2,50,71,34,50,10,21,6,8,10,44,71,2,0,34,54,18,34,9,20,0,5,10,27,54
2008-01-07 00:00:00.000,Sydney Australia ATP World Tour,HARD,2,Evgeny Korolev,Paul-Henri Mathieu,Evgeny Korolev,6-1 RET,R32,34,3,2,21,27,16,21,0,6,2,3,4,16,27,2,1,10,20,6,10,1,10,3,6,3,7,20
2008-01-07 00:00:00.000,Sydney Australia ATP World Tour,HARD,2,Lleyton Hewitt,Nicolas Mahut,Lleyton Hewitt,6-3; 6-4,R32,88,5,4,26,48,20,26,12,22,1,3,9,32,48,4,13,41,82,28,41,14,41,8,13,10,42,82
2008-01-07 00:00:00.000,Sydney Australia ATP World Tour,HARD,2,Chris Guccione,Alberto Martin,Chris Guccione,7-6(6); 6-4,R32,77,18,3,43,62,39,43,12,19,1,1,11,51,62,2,3,35,64,27,35,19,29,0,1,11,46,64
2008-01-07 00:00:00.000,Sydney Australia ATP World Tour,HARD,2,Gilles Simon,Mardy Fish,Gilles Simon,7-6(6); 6-1,R32,72,4,2,32,59,23,32,17,27,0,2,10,40,59,5,1,30,60,22,30,10,30,1,5,9,32,60
2008-01-07 00:00:00.000,Sydney Australia ATP World Tour,HARD,2,Tomas Berdych,Filippo Volandri,Tomas Berdych,6-1; 6-3,R32,72,7,1,33,55,26,33,12,22,3,3,8,38,55,1,6,31,66,18,31,15,35,9,13,8,33,66
2008-01-07 00:00:00.000,Sydney Australia ATP World Tour,HARD,2,Carlos Moya,Stefan Koubek,Carlos Moya,1-6; 6-4; 6-2,R32,90,2,3,42,74,30,42,19,32,7,9,12,49,74,3,3,44,72,32,44,13,28,0,3,13,45,72
2008-01-07 00:00:00.000,Sydney Australia ATP World Tour,HARD,2,Agustin Calleri,Greg Jones,Agustin Calleri,6-3; 6-2,R32,76,6,2,22,42,21,22,11,20,0,0,8,32,42,3,3,44,67,25,44,10,23,8,12,9,35,67
2008-01-07 00:00:00.000,Sydney Australia ATP World Tour,HARD,2,Andreas Seppi,Jo-Wilfried Tsonga,Andreas Seppi,3-6; 6-3; 6-2,R32,111,2,0,49,87,34,49,21,38,8,10,13,55,87,7,1,53,87,32,53,19,34,7,11,13,51,87
2008-01-07 00:00:00.000,Sydney Australia ATP World Tour,HARD,2,Radek Stepanek,Tommy Robredo,Radek Stepanek,6-4; 6-2,R32,91,2,3,39,69,26,39,16,30,4,5,9,42,69,1,3,39,57,22,39,8,18,3,7,9,30,57
2008-01-07 00:00:00.000,Sydney Australia ATP World Tour,HARD,2,Dmitry Tursunov,Richard Gasquet,Dmitry Tursunov,3-6; 6-3; 6-4,R16,123,8,2,49,91,39,49,23,42,3,4,14,62,91,7,4,62,96,43,62,17,34,5,7,14,60,96
2008-01-07 00:00:00.000,Sydney Australia ATP World Tour,HARD,2,Sebastien Grosjean,Fernando Verdasco,Sebastien Grosjean,6-3; 6-4,R16,78,3,0,31,52,26,31,10,21,1,3,10,36,52,5,0,47,60,21,47,9,13,7,11,9,30,60
2008-01-07 00:00:00.000,Sydney Australia ATP World Tour,HARD,2,Fabrice Santoro,Steve Darcis,Fabrice Santoro,6-1; 6-3,R16,60,5,0,39,48,28,39,5,9,1,2,8,33,48,1,0,30,43,17,30,2,13,2,7,8,19,43
2008-01-07 00:00:00.000,Sydney Australia ATP World Tour,HARD,2,Evgeny Korolev,Ivo Minar,Evgeny Korolev,6-2; 6-3,R16,66,3,5,29,55,23,29,13,26,3,4,9,36,55,2,4,35,62,20,35,11,27,8,12,8,31,62
2008-01-07 00:00:00.000,Sydney Australia ATP World Tour,HARD,2,Chris Guccione,Lleyton Hewitt,Chris Guccione,7-6(4); 7-6(2),R16,97,23,4,45,80,43,45,18,35,4,4,12,61,80,8,3,40,74,34,40,20,34,0,0,12,54,74
2008-01-07 00:00:00.000,Sydney Australia ATP World Tour,HARD,2,Tomas Berdych,Gilles Simon,Tomas Berdych,7-6(3); 6-2,R16,86,6,3,41,58,32,41,9,17,3,5,10,41,58,2,1,46,76,24,46,14,30,4,8,10,38,76
2008-01-07 00:00:00.000,Sydney Australia ATP World Tour,HARD,2,Agustin Calleri,Carlos Moya,Agustin Calleri,6-3; 6-4,R16,71,10,2,30,53,27,30,13,23,2,3,10,40,53,1,1,38,62,22,38,11,24,5,8,9,33,62
2008-01-07 00:00:00.000,Sydney Australia ATP World Tour,HARD,2,Radek Stepanek,Andreas Seppi,Radek Stepanek,7-5; 2-6; 6-4,R16,140,6,1,57,90,41,57,19,33,6,9,15,60,90,7,1,61,104,43,61,21,43,7,10,15,64,104
2008-01-07 00:00:00.000,Sydney Australia ATP World Tour,HARD,2,Dmitry Tursunov,Sebastien Grosjean,Dmitry Tursunov,6-4; 6-2,Q,74,8,1,38,58,29,38,10,20,7,8,9,39,58,4,1,35,62,22,35,13,27,3,7,9,35,62
2008-01-07 00:00:00.000,Sydney Australia ATP World Tour,HARD,2,Fabrice Santoro,Evgeny Korolev,Fabrice Santoro,6-3; 6-3,Q,78,7,1,38,56,31,38,10,18,3,3,9,41,56,1,1,34,59,21,34,12,25,5,8,9,33,59
2008-01-07 00:00:00.000,Sydney Australia ATP World Tour,HARD,2,Chris Guccione,Tomas Berdych,Chris Guccione,4-6; 7-6(6); 6-4,Q,125,19,5,69,111,53,69,24,42,6,7,16,77,111,7,4,54,97,43,54,26,43,2,3,16,69,97
2008-01-07 00:00:00.000,Sydney Australia ATP World Tour,HARD,2,Radek Stepanek,Agustin Calleri,Radek Stepanek,6-2; 6-4,Q,68,5,1,35,47,28,35,6,12,2,3,9,34,47,1,3,31,55,20,31,11,24,6,10,9,31,55
2008-01-07 00:00:00.000,Sydney Australia ATP World Tour,HARD,2,Dmitry Tursunov,Fabrice Santoro,Dmitry Tursunov,6-3; 7-6(4),S,102,8,2,43,71,31,43,18,28,3,4,11,49,71,3,3,39,77,25,39,21,38,7,9,10,46,77
2008-01-07 00:00:00.000,Sydney Australia ATP World Tour,HARD,2,Chris Guccione,Radek Stepanek,Chris Guccione,7-6(5); 3-6; 6-4,S,178,13,3,60,90,54,60,13,30,4,5,15,67,90,6,1,52,90,42,52,26,38,2,3,16,68,90
2008-01-07 00:00:00.000,Sydney Australia ATP World Tour,HARD,2,Dmitry Tursunov,Chris Guccione,Dmitry Tursunov,7-6(3); 7-6(4),F,83,6,1,43,74,38,43,20,31,0,0,12,58,74,15,0,39,65,36,39,18,26,0,0,12,54,65
2008-01-14 00:00:00.000,Australian Open Australia Grand Slams,HARD,3,Roger Federer,Diego Hartfield,Roger Federer,6-0; 6-3; 6-0,R128,72,11,1,50,65,42,50,7,15,2,2,11,49,65,3,1,40,62,21,40,5,22,3,10,10,26,62
2008-01-14 00:00:00.000,Australian Open Australia Grand Slams,HARD,3,Fabrice Santoro,John Isner,Fabrice Santoro,6-2; 6-2; 6-4,R128,110,3,0,41,67,29,41,21,26,1,2,13,50,67,11,6,56,80,37,56,7,24,3,9,13,44,80
2008-01-14 00:00:00.000,Australian Open Australia Grand Slams,HARD,3,Janko Tipsarevic,Joseph Sirianni,Janko Tipsarevic,7-5; 6-2; 6-7(6); 0-6; 6-0,R128,220,25,5,86,156,65,86,36,70,6,9,22,101,156,11,5,81,157,55,81,41,76,9,15,22,96,157
2008-01-14 00:00:00.000,Australian Open Australia Grand Slams,HARD,3,Fernando Verdasco,Thierry Ascione,Fernando Verdasco,6-4; 6-0; 6-3,R128,97,4,2,56,72,37,56,9,16,6,9,12,46,72,2,5,57,88,28,57,11,31,6,15,13,39,88
2008-01-14 00:00:00.000,Australian Open Australia Grand Slams,HARD,3,Juan Monaco,Carlos Berlocq,Juan Monaco,7-6(5); 7-5; 6-1,R128,139,6,2,62,94,44,62,14,32,2,6,16,58,94,8,7,46,102,30,46,22,56,3,10,15,52,102
2008-01-14 00:00:00.000,Australian Open Australia Grand Slams,HARD,3,Amer Delic,Robert Kendrick,Amer Delic,6-4; 7-5; 6-2,R128,103,8,4,62,93,46,62,18,31,4,5,15,64,93,6,2,46,82,35,46,13,36,1,6,15,48,82
2008-01-14 00:00:00.000,Australian Open Australia Grand Slams,HARD,3,Oscar Hernandez,Ivo Minar,Oscar Hernandez,1-6; 7-6(5); 6-2; 6-1,R128,122,10,4,65,107,51,65,19,42,4,8,18,70,107,3,2,55,96,32,55,25,41,4,9,16,57,96
2008-01-14 00:00:00.000,Australian Open Australia Grand Slams,HARD,3,Tomas Berdych,Werner Eschauer,Tomas Berdych,6-4; 6-4; 6-4,R128,127,10,2,51,79,36,51,18,28,1,4,15,54,79,9,5,58,106,37,58,18,48,3,9,15,55,106
2008-01-14 00:00:00.000,Australian Open Australia Grand Slams,HARD,3,James Blake,Nicolas Massu,James Blake,6-3; 6-2; 6-2,R128,96,11,2,44,80,36,44,20,36,3,4,13,56,80,6,3,54,76,32,54,7,22,7,13,12,39,76
2008-01-14 00:00:00.000,Australian Open Australia Grand Slams,HARD,3,Michael Russell,Fabio Fognini,Michael Russell,6-1; 4-6; 6-2; 3-6; 6-3,R128,183,6,3,94,135,63,94,26,41,2,5,22,89,135,6,9,58,128,38,58,36,70,5,11,21,74,128
2008-01-14 00:00:00.000,Australian Open Australia Grand Slams,HARD,3,Sebastien Grosjean,Filippo Volandri,Sebastien Grosjean,7-6(3); 6-3; 7-6(0),R128,138,4,0,57,96,42,57,22,39,3,7,16,64,96,0,5,55,112,36,55,24,57,4,10,17,60,112
2008-01-14 00:00:00.000,Australian Open Australia Grand Slams,HARD,3,Robin Haase,Ivan Ljubicic,Robin Haase,6-7(2); 6-3; 6-0; 7-6(1),R128,177,16,9,76,134,61,76,29,58,7,9,20,90,134,16,4,79,140,54,79,26,61,8,14,19,80,140
2008-01-14 00:00:00.000,Australian Open Australia Grand Slams,HARD,3,Marin Cilic,Nicolas Almagro,Marin Cilic,7-6(4); 7-5; 6-2,R128,131,16,1,56,103,42,56,29,47,2,4,16,71,103,10,5,57,101,40,57,17,44,7,12,16,57,101
2008-01-14 00:00:00.000,Australian Open Australia Grand Slams,HARD,3,Jurgen Melzer,Jiri Vanek,Jurgen Melzer,6-3; 6-4; 6-4,R128,99,14,2,49,78,42,49,15,29,2,4,15,57,78,8,3,64,107,44,64,15,43,7,12,14,59,107
2008-01-14 00:00:00.000,Australian Open Australia Grand Slams,HARD,3,Hyung-Taik Lee,Chris Guccione,Hyung-Taik Lee,7-6(6); 6-3; 6-4,R128,114,7,0,53,91,45,53,24,38,0,0,16,69,91,16,2,59,93,46,59,18,34,7,9,15,64,93
2008-01-14 00:00:00.000,Australian Open Australia Grand Slams,HARD,3,Fernando Gonzalez,Konstantinos Economidis,Fernando Gonzalez,6-4; 7-6(2); 6-1,R128,110,10,4,51,87,42,51,23,36,1,1,15,65,87,2,4,52,88,34,52,18,36,3,6,14,52,88
2008-01-14 00:00:00.000,Australian Open Australia Grand Slams,HARD,3,Novak Djokovic,Benjamin Becker,Novak Djokovic,6-0; 6-2; 7-6(5),R128,120,6,4,50,79,42,50,13,29,1,2,13,55,79,7,2,38,82,22,38,19,44,1,7,13,41,82
2008-01-14 00:00:00.000,Australian Open Australia Grand Slams,HARD,3,Simone Bolelli,Rajeev Ram,Simone Bolelli,7-6(5); 3-6; 6-4; 2-6; 6-3,R128,187,9,2,94,147,69,94,26,53,9,15,24,95,147,12,3,101,147,75,101,17,46,10,15,24,92,147
2008-01-14 00:00:00.000,Australian Open Australia Grand Slams,HARD,3,Sam Querrey,Olivier Rochus,Sam Querrey,6-3; 6-2; 7-5,R128,118,21,4,49,82,42,49,17,33,4,6,15,59,82,2,4,53,104,26,53,26,51,9,15,14,52,104
2008-01-14 00:00:00.000,Australian Open Australia Grand Slams,HARD,3,Dmitry Tursunov,Xavier Malisse,Dmitry Tursunov,6-7(1); 5-7; 6-2; 6-1; 6-3,R128,183,15,1,90,140,66,90,32,50,5,7,24,98,140,11,4,74,138,56,74,32,64,8,15,24,88,138
2008-01-14 00:00:00.000,Australian Open Australia Grand Slams,HARD,3,Lleyton Hewitt,Steve Darcis,Lleyton Hewitt,6-0; 6-3; 6-0,R128,76,14,6,30,55,25,30,17,25,0,1,11,42,55,1,0,26,53,15,26,5,27,5,13,10,20,53
2008-01-14 00:00:00.000,Australian Open Australia Grand Slams,HARD,3,Denis Istomin,Lukas Lacko,Denis Istomin,6-3; 6-7(1); 7-6(4); 6-1,R128,167,5,3,79,122,57,79,27,43,5,7,20,84,122,8,7,79,145,56,79,31,66,11,17,20,87,145
2008-01-14 00:00:00.000,Australian Open Australia Grand Slams,HARD,3,Marat Safin,Ernests Gulbis,Marat Safin,6-0; 6-4; 7-6(2),R128,114,6,1,39,84,31,39,28,45,2,3,14,59,84,9,6,56,109,36,56,23,53,9,14,14,59,109
2008-01-14 00:00:00.000,Australian Open Australia Grand Slams,HARD,3,Marcos Baghdatis,Thomas Johansson,Marcos Baghdatis,7-6(0); 6-2; 3-6; 6-3,R128,188,16,4,63,125,52,63,30,62,7,10,19,82,125,8,5,72,129,48,72,26,57,11,16,19,74,129
2008-01-14 00:00:00.000,Australian Open Australia Grand Slams,HARD,3,David Nalbandian,Robert Smeets,David Nalbandian,6-1; 6-1; 7-6(3),R128,102,4,5,39,75,32,39,24,36,1,2,13,56,75,6,5,38,87,24,38,20,49,3,9,13,44,87
2008-01-14 00:00:00.000,Australian Open Australia Grand Slams,HARD,3,Peter Luczak,Mariano Zabaleta,Peter Luczak,6-1; 6-7(2); 6-3; 6-4,R128,155,11,7,76,120,61,76,23,44,4,6,20,84,120,13,7,51,111,42,51,25,60,7,13,18,67,111
2008-01-14 00:00:00.000,Australian Open Australia Grand Slams,HARD,3,Alun Jones,Albert Montanes,Alun Jones,6-4; 6-3; 3-6; 6-2,R128,166,5,2,90,129,58,90,16,39,12,17,18,74,129,5,9,69,119,44,69,20,50,6,14,18,64,119
2008-01-14 00:00:00.000,Australian Open Australia Grand Slams,HARD,3,Juan Carlos Ferrero,Nicolas Kiefer,Juan Carlos Ferrero,6-4; 6-3; 6-1,R128,123,8,2,58,81,45,58,13,23,4,4,13,58,81,6,5,43,80,28,43,15,37,4,9,13,43,80
2008-01-14 00:00:00.000,Australian Open Australia Grand Slams,HARD,3,Vincent Spadea,Radek Stepanek,Vincent Spadea,2-6; 2-6; 7-5; 6-2; 6-3,R128,186,0,8,81,146,57,81,34,65,9,14,23,91,146,8,1,72,126,48,72,32,54,3,8,22,80,126
2008-01-14 00:00:00.000,Australian Open Australia Grand Slams,HARD,3,Denis Gremelmayr,Sergio Roitman,Denis Gremelmayr,6-1; 0-6; 6-4; 7-5,R128,146,13,5,67,126,50,67,27,59,19,23,18,77,126,7,6,63,115,39,63,28,52,6,11,17,67,115
2008-01-14 00:00:00.000,Australian Open Australia Grand Slams,HARD,3,Juan Martin Del Potro,Santiago Ventura,Juan Martin Del Potro,6-3; 6-1; 6-3,R128,98,3,2,53,80,41,53,16,27,2,2,13,57,80,8,6,35,74,24,35,15,39,8,13,12,39,74
2008-01-14 00:00:00.000,Australian Open Australia Grand Slams,HARD,3,David Ferrer,Edouard Roger-Vasselin,David Ferrer,6-2; 6-2; 6-1,R128,85,3,2,46,61,35,46,11,15,5,6,11,46,61,2,2,44,74,21,44,10,30,3,11,12,31,74
2008-01-14 00:00:00.000,Australian Open Australia Grand Slams,HARD,3,Richard Gasquet,Nick Lindahl,Richard Gasquet,6-0; 6-1; 3-6; 6-2,R128,104,10,3,52,77,39,52,20,25,1,2,15,59,77,7,3,77,114,48,77,13,37,11,18,15,61,114
2008-01-14 00:00:00.000,Australian Open Australia Grand Slams,HARD,3,Feliciano Lopez,Wayne Odesnik,Feliciano Lopez,7-6(6); 6-1; 6-4,R128,100,28,6,55,95,46,55,25,40,2,2,15,71,95,6,3,41,78,29,41,25,37,1,4,14,54,78
2008-01-14 00:00:00.000,Australian Open Australia Grand Slams,HARD,3,Kristof Vliegen,Olivier Patience,Kristof Vliegen,6-0; 6-1; 7-6(3),R128,98,9,1,46,75,36,46,20,29,3,4,13,56,75,4,2,69,93,36,69,10,24,6,12,12,46,93
2008-01-14 00:00:00.000,Australian Open Australia Grand Slams,HARD,3,Igor Andreev,Andrei Pavel,Igor Andreev,5-7; 6-2; 7-6(4); 6-3,R128,182,7,2,92,126,69,92,22,34,3,4,21,91,126,3,1,105,141,65,105,24,36,3,6,20,89,141
2008-01-14 00:00:00.000,Australian Open Australia Grand Slams,HARD,3,Guillermo Garcia-Lopez,Juan Ignacio Chela,Guillermo Garcia-Lopez,6-4; 6-2; 1-6; 6-2,R128,150,1,4,63,94,40,63,16,31,1,6,16,56,94,2,8,75,125,43,75,23,50,10,18,17,66,125
2008-01-14 00:00:00.000,Australian Open Australia Grand Slams,HARD,3,Alejandro Falla,Kevin Anderson,Alejandro Falla,5-7; 7-5; 6-7(8); 6-2; 7-5,R128,246,4,4,106,175,71,106,40,69,12,17,28,111,175,13,8,138,200,85,138,32,62,10,18,28,117,200
2008-01-14 00:00:00.000,Australian Open Australia Grand Slams,HARD,3,Sam Warburg,Juan Pablo Brzezicki,Sam Warburg,2-6; 6-2; 6-3; 2-6; 6-4,R128,207,5,4,97,138,58,97,24,41,9,16,22,82,138,7,4,94,140,58,94,21,46,9,16,21,79,140
2008-01-14 00:00:00.000,Australian Open Australia Grand Slams,HARD,3,Jo-Wilfried Tsonga,Andy Murray,Jo-Wilfried Tsonga,7-5; 6-4; 0-6; 7-6(5),R128,192,7,6,81,136,58,81,23,55,5,10,20,81,136,7,3,79,136,55,79,27,57,9,13,20,82,136
2008-01-14 00:00:00.000,Australian Open Australia Grand Slams,HARD,3,Mikhail Youzhny,Mathieu Montcourt,Mikhail Youzhny,6-0; 6-2; 7-6(3),R128,111,4,2,59,97,45,59,18,38,11,12,13,63,97,1,4,48,75,28,48,10,27,0,6,13,38,75
2008-01-14 00:00:00.000,Australian Open Australia Grand Slams,HARD,3,Andreas Seppi,Harel Levy,Andreas Seppi,6-4; 6-2; 6-1,R128,87,6,1,42,76,33,42,19,34,0,2,13,52,76,0,3,43,75,20,43,16,32,7,14,12,36,75
2008-01-14 00:00:00.000,Australian Open Australia Grand Slams,HARD,3,Dudi Sela,Martin Slanar,Dudi Sela,6-2; 6-4; 6-2,R128,117,1,3,72,103,52,72,18,31,5,5,13,70,103,3,4,52,87,33,52,13,35,6,11,13,46,87
2008-01-14 00:00:00.000,Australian Open Australia Grand Slams,HARD,3,Ivo Karlovic,Jamie Baker,Ivo Karlovic,6-4; 6-4; 6-7(1); 6-4,R128,209,19,4,76,126,57,76,29,50,4,6,21,86,126,6,2,94,136,57,94,27,42,9,14,21,84,136
2008-01-14 00:00:00.000,Australian Open Australia Grand Slams,HARD,3,Stanislas Wawrinka,Julien Benneteau,Stanislas Wawrinka,6-3; 6-3; 6-3,R128,108,14,3,45,78,38,45,17,33,1,3,14,55,78,2,6,45,88,27,45,18,43,7,13,13,45,88
2008-01-14 00:00:00.000,Australian Open Australia Grand Slams,HARD,3,Marc Gicquel,Yen-Hsun Lu,Marc Gicquel,6-3; 4-6; 6-7(6); 6-4; 6-2,R128,270,14,8,113,184,83,113,30,71,14,18,24,113,184,3,5,102,180,67,102,39,78,10,18,25,106,180
2008-01-14 00:00:00.000,Australian Open Australia Grand Slams,HARD,3,Nicolas Mahut,Jose Acasuso,Nicolas Mahut,7-6(2); 5-7; 6-2; 3-6; 7-5,R128,228,13,9,97,167,69,97,42,70,8,12,26,111,167,14,7,98,178,71,98,41,80,9,14,27,112,178
2008-01-14 00:00:00.000,Australian Open Australia Grand Slams,HARD,3,Nikolay Davydenko,Michael Llodra,Nikolay Davydenko,7-5; 7-5; 6-3,R128,128,1,3,72,92,55,72,8,20,3,5,16,63,92,4,4,60,103,41,60,17,43,4,10,17,58,103
2008-01-14 00:00:00.000,Australian Open Australia Grand Slams,HARD,3,Andy Roddick,Lukas Dlouhy,Andy Roddick,6-3; 6-4; 7-5,R128,98,13,2,58,89,44,58,18,31,5,7,16,62,89,7,12,49,88,33,49,16,39,6,11,0,49,88
2008-01-14 00:00:00.000,Australian Open Australia Grand Slams,HARD,3,Michael Berrer,Donald Young,Michael Berrer,6-7(5); 7-6(4); 6-3; 7-6(5),R128,199,7,10,99,146,77,99,22,47,3,6,22,99,146,5,8,109,178,70,109,35,69,10,15,23,105,178
2008-01-14 00:00:00.000,Australian Open Australia Grand Slams,HARD,3,Evgeny Korolev,Marcel Granollers,Evgeny Korolev,7-5; 6-2; 6-0,R128,89,3,1,47,78,37,47,18,31,8,9,13,55,78,1,7,42,73,19,42,17,31,2,9,13,36,73
2008-01-14 00:00:00.000,Australian Open Australia Grand Slams,HARD,3,Philipp Kohlschreiber,Roko Karanusic,Philipp Kohlschreiber,6-4; 7-6(5); 6-1,R128,132,4,2,88,115,59,88,16,27,10,11,15,75,115,6,1,59,91,41,59,13,32,5,9,14,54,91
2008-01-14 00:00:00.000,Australian Open Australia Grand Slams,HARD,3,Jarkko Nieminen,Frank Dancevic,Jarkko Nieminen,6-3; 6-1; 5-7; 2-6; 6-1,R128,131,1,2,76,113,58,76,19,37,0,3,21,77,113,13,1,79,127,54,79,25,48,7,14,22,79,127
2008-01-14 00:00:00.000,Australian Open Australia Grand Slams,HARD,3,Jesse Levine,Martin Vassallo Arguello,Jesse Levine,6-1; 7-5; 6-1,R128,101,3,3,52,80,38,52,14,28,5,7,13,52,80,1,5,46,77,24,46,11,31,3,11,13,35,77
2008-01-14 00:00:00.000,Australian Open Australia Grand Slams,HARD,3,Mardy Fish,Boris Pashanski,Mardy Fish,6-2; 6-3; 3-6; 6-3,R128,140,12,2,64,107,49,64,22,43,2,5,18,71,107,1,5,83,121,52,83,15,38,10,16,17,67,121
2008-01-14 00:00:00.000,Australian Open Australia Grand Slams,HARD,3,Tommy Robredo,Mischa Zverev,Tommy Robredo,4-6; 2-6; 7-6(2); 6-4; 7-5,R128,238,4,7,123,188,85,123,27,65,11,19,26,112,188,2,1,142,188,91,142,16,46,10,17,26,107,188
2008-01-14 00:00:00.000,Australian Open Australia Grand Slams,HARD,3,Stefan Koubek,Carlos Moya,Stefan Koubek,7-6(5); 6-7(2); 7-5; 6-4,R128,214,5,11,88,158,61,88,38,70,6,9,23,99,158,7,4,105,161,67,105,31,56,5,10,23,98,161
2008-01-14 00:00:00.000,Australian Open Australia Grand Slams,HARD,3,Agustin Calleri,Luis Horna,Agustin Calleri,6-4; 6-7(6); 6-3; 6-4,R128,165,16,4,65,130,50,65,44,65,7,7,21,94,130,14,3,71,118,57,71,22,47,5,8,20,79,118
2008-01-14 00:00:00.000,Australian Open Australia Grand Slams,HARD,3,Paul Capdeville,Brydan Klein,Paul Capdeville,6-4; 7-5; 6-4,R128,154,3,1,72,97,52,72,13,25,2,4,16,65,97,4,7,63,113,40,63,26,50,6,11,16,66,113
2008-01-14 00:00:00.000,Australian Open Australia Grand Slams,HARD,3,Paul-Henri Mathieu,Victor Hanescu,Paul-Henri Mathieu,6-1; 7-6(4); 6-2,R128,134,8,7,53,88,45,53,18,35,5,6,14,63,88,1,2,73,102,47,73,9,29,14,19,13,56,102
2008-01-14 00:00:00.000,Australian Open Australia Grand Slams,HARD,3,Gilles Simon,Bobby Reynolds,Gilles Simon,4-6; 6-4; 6-2; 6-7(3); 6-4,R128,222,10,6,121,176,90,121,24,55,17,20,25,114,176,11,2,93,171,63,93,43,78,12,18,25,106,171
2008-01-14 00:00:00.000,Australian Open Australia Grand Slams,HARD,3,Rainer Schuettler,Arnaud Clement,Rainer Schuettler,6-4; 6-2; 6-7(3); 6-4,R128,192,4,5,83,124,51,83,28,41,8,11,20,79,124,3,4,89,142,56,89,25,53,8,15,20,81,142
2008-01-14 00:00:00.000,Australian Open Australia Grand Slams,HARD,3,Florent Serra,Florian Mayer,Florent Serra,6-3; 7-6(2); 7-6(5),R128,124,2,3,56,101,41,56,28,45,6,10,16,69,101,8,3,87,133,55,87,21,46,8,14,17,76,133
2008-01-14 00:00:00.000,Australian Open Australia Grand Slams,HARD,3,Rafael Nadal,Viktor Troicki,Rafael Nadal,7-6(3); 7-5; 6-1,R128,154,4,4,58,95,39,58,28,37,3,5,16,67,95,14,2,66,97,47,66,10,31,7,12,15,57,97
2008-01-14 00:00:00.000,Australian Open Australia Grand Slams,HARD,3,Roger Federer,Fabrice Santoro,Roger Federer,6-1; 6-2; 6-0,R64,80,6,1,42,61,32,42,15,19,2,2,11,47,61,2,0,45,69,20,45,9,24,7,14,10,29,69
2008-01-14 00:00:00.000,Australian Open Australia Grand Slams,HARD,3,Janko Tipsarevic,Fernando Verdasco,Janko Tipsarevic,7-5; 7-6(3); 7-6(3),R64,160,8,2,72,111,55,72,23,39,0,3,18,78,111,15,6,80,110,57,80,13,30,2,6,18,70,110
2008-01-14 00:00:00.000,Australian Open Australia Grand Slams,HARD,3,Juan Monaco,Amer Delic,Juan Monaco,6-3; 7-6(6); 5-7; 6-7(8); 8-6,R64,251,4,7,145,195,100,145,29,50,9,14,30,129,195,17,12,107,192,81,107,41,85,10,16,29,122,192
2008-01-14 00:00:00.000,Australian Open Australia Grand Slams,HARD,3,Tomas Berdych,Oscar Hernandez,Tomas Berdych,6-2; 6-1; 6-3,R64,91,9,4,39,65,35,39,14,26,2,2,12,49,65,1,2,48,71,31,48,6,23,5,11,12,37,71
2008-01-14 00:00:00.000,Australian Open Australia Grand Slams,HARD,3,James Blake,Michael Russell,James Blake,6-3; 6-2; 6-2,R64,84,8,3,41,69,33,41,17,28,0,1,13,50,69,2,2,50,72,24,50,12,22,4,10,12,36,72
2008-01-14 00:00:00.000,Australian Open Australia Grand Slams,HARD,3,Sebastien Grosjean,Robin Haase,Sebastien Grosjean,4-6; 6-4; 6-0; 6-7(4); 6-4,R64,181,7,2,84,132,63,84,30,48,2,5,24,93,132,5,3,77,138,55,77,31,61,4,11,24,86,138
2008-01-14 00:00:00.000,Australian Open Australia Grand Slams,HARD,3,Marin Cilic,Jurgen Melzer,Marin Cilic,6-4; 6-3; 6-4,R64,116,7,1,49,92,35,49,29,43,1,2,15,64,92,3,2,66,93,34,66,19,27,7,11,14,53,93
2008-01-14 00:00:00.000,Australian Open Australia Grand Slams,HARD,3,Fernando Gonzalez,Hyung-Taik Lee,Fernando Gonzalez,4-6; 6-3; 6-2; 6-4,R64,156,15,4,74,125,47,74,28,51,8,12,19,75,125,5,4,70,116,44,70,21,46,10,17,18,65,116
2008-01-14 00:00:00.000,Australian Open Australia Grand Slams,HARD,3,Novak Djokovic,Simone Bolelli,Novak Djokovic,6-1; 6-2; 6-2,R64,92,12,3,45,73,34,45,18,28,2,2,12,52,73,5,2,38,64,19,38,11,26,2,8,11,30,64
2008-01-14 00:00:00.000,Australian Open Australia Grand Slams,HARD,3,Sam Querrey,Dmitry Tursunov,Sam Querrey,7-6(5); 4-6; 6-4; 6-2,R64,193,13,6,72,132,56,72,29,60,5,8,20,85,132,7,7,81,146,54,81,30,65,3,8,20,84,146
2008-01-14 00:00:00.000,Australian Open Australia Grand Slams,HARD,3,Lleyton Hewitt,Denis Istomin,Lleyton Hewitt,7-6(5); 6-3; 5-7; 6-1,R64,184,13,2,71,123,47,71,36,52,9,12,20,83,123,9,1,74,134,52,74,25,60,6,12,20,77,134
2008-01-14 00:00:00.000,Australian Open Australia Grand Slams,HARD,3,Marcos Baghdatis,Marat Safin,Marcos Baghdatis,6-4; 6-4; 2-6; 3-6; 6-2,R64,192,4,4,80,134,59,80,29,54,3,7,22,88,134,12,0,84,149,57,84,36,65,12,17,23,93,149
2008-01-14 00:00:00.000,Australian Open Australia Grand Slams,HARD,3,David Nalbandian,Peter Luczak,David Nalbandian,4-6; 7-5; 6-4; 6-1,R64,160,19,5,69,113,57,69,25,44,2,3,20,82,113,15,3,76,119,56,76,20,43,3,7,19,76,119
2008-01-14 00:00:00.000,Australian Open Australia Grand Slams,HARD,3,Juan Carlos Ferrero,Alun Jones,Juan Carlos Ferrero,6-4; 6-4; 6-2,R64,107,7,1,55,87,42,55,18,32,8,9,14,60,87,3,2,45,78,31,45,16,33,3,8,14,47,78
2008-01-14 00:00:00.000,Australian Open Australia Grand Slams,HARD,3,Vincent Spadea,Denis Gremelmayr,Vincent Spadea,4-6; 6-2; 6-3; 2-6; 9-7,R64,227,2,1,119,178,81,119,29,59,16,22,26,110,178,8,7,88,169,60,88,39,81,12,19,25,99,169
2008-01-14 00:00:00.000,Australian Open Australia Grand Slams,HARD,3,David Ferrer,Juan Martin Del Potro,David Ferrer,6-3; 6-4 RET,R64,98,1,1,40,53,28,40,5,13,1,3,9,33,53,0,2,62,77,32,62,7,15,7,12,10,39,77
2008-01-14 00:00:00.000,Australian Open Australia Grand Slams,HARD,3,Richard Gasquet,Feliciano Lopez,Richard Gasquet,6-2; 6-1; 6-3,R64,88,8,1,41,59,32,41,16,18,0,0,12,48,59,3,5,55,86,28,55,14,31,5,11,12,42,86
2008-01-14 00:00:00.000,Australian Open Australia Grand Slams,HARD,3,Igor Andreev,Kristof Vliegen,Igor Andreev,7-5; 7-5; 6-2,R64,132,2,8,68,103,54,68,18,35,8,8,16,72,103,5,3,75,99,46,75,15,24,7,11,16,61,99
2008-01-14 00:00:00.000,Australian Open Australia Grand Slams,HARD,3,Guillermo Garcia-Lopez,Alejandro Falla,Guillermo Garcia-Lopez,6-4; 5-7; 6-4; 7-6(6),R64,212,5,6,79,137,59,79,26,58,6,11,22,85,137,5,7,114,178,67,114,34,64,16,22,22,101,178
2008-01-14 00:00:00.000,Australian Open Australia Grand Slams,HARD,3,Jo-Wilfried Tsonga,Sam Warburg,Jo-Wilfried Tsonga,6-4; 7-6(4); 6-2,R64,133,14,0,57,89,46,57,16,32,3,4,15,62,89,3,2,82,115,48,82,15,33,9,13,15,63,115
2008-01-14 00:00:00.000,Australian Open Australia Grand Slams,HARD,3,Mikhail Youzhny,Andreas Seppi,Mikhail Youzhny,4-6; 7-5; 6-3; 7-6(4),R64,199,8,6,91,146,68,91,28,55,8,12,22,96,146,6,3,65,124,48,65,30,59,7,12,21,78,124
2008-01-14 00:00:00.000,Australian Open Australia Grand Slams,HARD,3,Ivo Karlovic,Dudi Sela,Ivo Karlovic,6-7(5); 6-4; 6-3; 6-1,R64,165,15,1,77,122,63,77,22,45,4,4,19,85,122,0,1,89,128,52,89,28,39,8,13,19,80,128
2008-01-14 00:00:00.000,Australian Open Australia Grand Slams,HARD,3,Marc Gicquel,Stanislas Wawrinka,Marc Gicquel,6-2; 3-6; 7-6(5); 2-1 RET,R64,171,2,3,65,110,41,65,28,45,5,8,15,69,110,9,3,59,109,44,59,21,50,3,8,17,65,109
2008-01-14 00:00:00.000,Australian Open Australia Grand Slams,HARD,3,Nikolay Davydenko,Nicolas Mahut,Nikolay Davydenko,6-4; 6-0; 6-3,R64,113,3,2,70,91,43,70,8,21,7,11,13,51,91,3,7,50,75,23,50,8,25,4,13,12,31,75
2008-01-14 00:00:00.000,Australian Open Australia Grand Slams,HARD,3,Andy Roddick,Michael Berrer,Andy Roddick,6-2; 6-2; 6-4,R64,117,10,1,57,75,46,57,9,18,2,3,13,55,75,6,7,63,101,41,63,12,38,12,18,13,53,101
2008-01-14 00:00:00.000,Australian Open Australia Grand Slams,HARD,3,Philipp Kohlschreiber,Evgeny Korolev,Philipp Kohlschreiber,6-4; 6-2; 0-1 RET,R64,85,6,1,29,49,23,29,14,20,1,1,9,37,49,3,5,42,69,32,42,9,27,6,9,10,41,69
2008-01-14 00:00:00.000,Australian Open Australia Grand Slams,HARD,3,Jarkko Nieminen,Jesse Levine,Jarkko Nieminen,6-2; 7-5; 7-6(2),R64,143,4,7,74,102,52,74,9,28,5,10,16,61,102,7,6,68,123,40,68,22,55,15,23,16,62,123
2008-01-14 00:00:00.000,Australian Open Australia Grand Slams,HARD,3,Mardy Fish,Tommy Robredo,Mardy Fish,6-1; 6-2; 6-3,R64,94,4,5,40,70,33,40,15,30,2,3,12,48,70,1,5,52,82,27,52,12,30,7,14,12,39,82
2008-01-14 00:00:00.000,Australian Open Australia Grand Slams,HARD,3,Stefan Koubek,Agustin Calleri,Stefan Koubek,6-3; 7-6(6); 7-6(5),R64,133,3,2,76,119,54,76,29,43,5,6,17,83,119,6,4,53,100,40,53,29,47,2,4,16,69,100
2008-01-14 00:00:00.000,Australian Open Australia Grand Slams,HARD,3,Paul-Henri Mathieu,Paul Capdeville,Paul-Henri Mathieu,6-7(5); 6-0; 6-4; 6-4,R64,183,11,2,70,125,53,70,33,55,4,5,19,86,125,4,2,73,115,50,73,18,42,7,13,19,68,115
2008-01-14 00:00:00.000,Australian Open Australia Grand Slams,HARD,3,Gilles Simon,Rainer Schuettler,Gilles Simon,6-2; 6-2; 6-1,R64,88,4,2,51,70,37,51,12,19,2,2,11,49,70,1,1,47,75,25,47,13,28,10,17,12,38,75
2008-01-14 00:00:00.000,Australian Open Australia Grand Slams,HARD,3,Rafael Nadal,Florent Serra,Rafael Nadal,6-0; 6-2; 6-2,R64,92,9,1,48,67,37,48,8,19,1,3,11,45,67,0,2,45,63,22,45,3,18,5,14,11,25,63
2008-01-14 00:00:00.000,Australian Open Australia Grand Slams,HARD,3,Roger Federer,Janko Tipsarevic,Roger Federer,6-7(5); 7-6(1); 5-7; 6-1; 10-8,R32,265,39,1,107,167,95,107,33,60,0,3,31,128,167,12,6,106,207,75,106,58,101,16,21,30,133,207
2008-01-14 00:00:00.000,Australian Open Australia Grand Slams,HARD,3,Tomas Berdych,Juan Monaco,Tomas Berdych,3-6; 6-3; 7-6(5); 6-2,R32,153,15,7,83,116,63,83,15,33,3,6,19,78,116,10,2,95,130,63,95,15,35,4,9,19,78,130
2008-01-14 00:00:00.000,Australian Open Australia Grand Slams,HARD,3,James Blake,Sebastien Grosjean,James Blake,4-6; 2-6; 6-0; 7-6(5); 6-2,R32,185,10,3,92,167,60,92,41,75,14,20,22,101,167,4,2,81,137,53,81,26,56,6,14,22,79,137
2008-01-14 00:00:00.000,Australian Open Australia Grand Slams,HARD,3,Marin Cilic,Fernando Gonzalez,Marin Cilic,6-2; 6-7(4); 6-3; 6-1,R32,156,14,5,62,111,45,62,32,49,3,4,18,77,111,2,7,82,126,48,82,19,44,8,15,18,67,126
2008-01-14 00:00:00.000,Australian Open Australia Grand Slams,HARD,3,Novak Djokovic,Sam Querrey,Novak Djokovic,6-3; 6-1; 6-3,R32,94,5,1,46,62,35,46,13,16,3,4,12,48,62,8,5,57,92,35,57,11,35,7,14,13,46,92
2008-01-14 00:00:00.000,Australian Open Australia Grand Slams,HARD,3,Lleyton Hewitt,Marcos Baghdatis,Lleyton Hewitt,4-6; 7-5; 7-5; 6-7(4); 6-3,R32,283,9,6,95,168,72,95,36,73,9,14,27,108,168,28,8,108,206,81,108,40,98,15,23,28,121,206
2008-01-14 00:00:00.000,Australian Open Australia Grand Slams,HARD,3,Juan Carlos Ferrero,David Nalbandian,Juan Carlos Ferrero,6-1; 6-2; 6-3,R32,103,11,2,48,77,38,48,17,29,1,1,12,55,77,3,4,36,67,22,36,12,31,4,10,12,34,67
2008-01-14 00:00:00.000,Australian Open Australia Grand Slams,HARD,3,David Ferrer,Vincent Spadea,David Ferrer,6-3; 6-3; 6-2,R32,106,5,2,50,77,41,50,14,27,2,2,13,55,77,0,1,55,93,33,55,18,38,4,9,13,51,93
2008-01-14 00:00:00.000,Australian Open Australia Grand Slams,HARD,3,Richard Gasquet,Igor Andreev,Richard Gasquet,6-3; 6-2; 4-6; 6-4,R32,142,9,2,66,99,49,66,22,33,0,2,19,71,99,2,0,72,105,44,72,22,33,8,13,18,66,105
2008-01-14 00:00:00.000,Australian Open Australia Grand Slams,HARD,3,Jo-Wilfried Tsonga,Guillermo Garcia-Lopez,Jo-Wilfried Tsonga,6-3; 6-4; 6-2,R32,102,21,1,53,76,44,53,10,23,0,1,14,54,76,6,7,42,79,22,42,20,37,3,8,13,42,79
2008-01-14 00:00:00.000,Australian Open Australia Grand Slams,HARD,3,Mikhail Youzhny,Ivo Karlovic,Mikhail Youzhny,6-2; 6-4; 6-2,R32,94,4,1,50,68,41,50,13,18,2,2,13,54,68,11,1,46,71,28,46,12,25,1,6,13,40,71
2008-01-14 00:00:00.000,Australian Open Australia Grand Slams,HARD,3,Nikolay Davydenko,Marc Gicquel,Nikolay Davydenko,6-3; 6-2; 6-3,R32,139,2,1,58,89,38,58,18,31,4,6,13,56,89,7,0,62,95,38,62,10,33,6,13,13,48,95
2008-01-14 00:00:00.000,Australian Open Australia Grand Slams,HARD,3,Philipp Kohlschreiber,Andy Roddick,Philipp Kohlschreiber,6-4; 3-6; 7-6(9); 6-7(3); 8-6,R32,230,32,2,107,165,91,107,37,58,8,9,28,128,165,42,3,131,182,109,131,24,51,9,11,29,133,182
2008-01-14 00:00:00.000,Australian Open Australia Grand Slams,HARD,3,Jarkko Nieminen,Mardy Fish,Jarkko Nieminen,3-6; 7-6(4); 6-3; 6-1,R32,157,11,4,97,133,74,97,17,36,11,12,18,91,133,13,3,72,125,57,72,23,53,9,13,19,80,125
2008-01-14 00:00:00.000,Australian Open Australia Grand Slams,HARD,3,Paul-Henri Mathieu,Stefan Koubek,Paul-Henri Mathieu,4-6; 7-6(4); 2-6; 7-5; 8-6,R32,238,7,8,104,184,72,104,39,80,11,18,28,111,184,18,5,120,188,85,120,31,68,14,20,28,116,188
2008-01-14 00:00:00.000,Australian Open Australia Grand Slams,HARD,3,Rafael Nadal,Gilles Simon,Rafael Nadal,7-5; 6-2; 6-3,R32,145,7,1,51,86,38,51,22,35,5,6,14,60,86,5,0,67,109,42,67,18,42,11,17,15,60,109
2008-01-14 00:00:00.000,Australian Open Australia Grand Slams,HARD,3,Roger Federer,Tomas Berdych,Roger Federer,6-4; 7-6(7); 6-3,R16,117,11,1,59,94,44,59,26,35,2,3,16,70,94,7,4,54,96,41,54,20,42,4,7,15,61,96
2008-01-14 00:00:00.000,Australian Open Australia Grand Slams,HARD,3,James Blake,Marin Cilic,James Blake,6-3; 6-4; 6-4,R16,100,4,0,55,88,42,55,24,33,3,3,15,66,88,5,3,44,78,31,44,18,34,2,5,14,49,78
2008-01-14 00:00:00.000,Australian Open Australia Grand Slams,HARD,3,Novak Djokovic,Lleyton Hewitt,Novak Djokovic,7-5; 6-3; 6-3,R16,146,13,6,62,104,45,62,19,42,4,7,15,64,104,6,4,48,90,28,48,18,42,5,12,15,46,90
2008-01-14 00:00:00.000,Australian Open Australia Grand Slams,HARD,3,David Ferrer,Juan Carlos Ferrero,David Ferrer,7-5; 3-6; 6-4; 6-1,R16,185,6,0,89,120,62,89,13,31,12,16,19,75,120,3,7,93,142,60,93,17,49,15,22,19,77,142
2008-01-14 00:00:00.000,Australian Open Australia Grand Slams,HARD,3,Jo-Wilfried Tsonga,Richard Gasquet,Jo-Wilfried Tsonga,6-2; 6-7(5); 7-6(6); 6-3,R16,195,19,2,88,134,73,88,23,46,7,8,20,96,134,5,4,92,151,64,92,29,59,7,12,21,93,151
2008-01-14 00:00:00.000,Australian Open Australia Grand Slams,HARD,3,Mikhail Youzhny,Nikolay Davydenko,Mikhail Youzhny,7-6(2); 6-3; 6-1,R16,144,5,2,53,87,40,53,17,34,3,6,14,57,87,2,1,58,94,34,58,15,36,2,9,14,49,94
2008-01-14 00:00:00.000,Australian Open Australia Grand Slams,HARD,3,Jarkko Nieminen,Philipp Kohlschreiber,Jarkko Nieminen,3-6; 7-6(7); 7-6(9); 6-3,R16,211,4,4,109,175,68,109,30,66,15,22,21,98,175,9,7,79,149,54,79,31,70,7,14,21,85,149
2008-01-14 00:00:00.000,Australian Open Australia Grand Slams,HARD,3,Rafael Nadal,Paul-Henri Mathieu,Rafael Nadal,6-4; 3-0 RET,R16,51,3,1,27,29,24,27,0,2,0,0,6,24,29,5,3,22,37,12,22,6,15,0,3,7,18,37
2008-01-14 00:00:00.000,Australian Open Australia Grand Slams,HARD,3,Roger Federer,James Blake,Roger Federer,7-5; 7-6(5); 6-4,Q,119,13,0,65,96,49,65,18,31,0,3,17,67,96,8,5,67,116,47,67,21,49,5,10,17,68,116
2008-01-14 00:00:00.000,Australian Open Australia Grand Slams,HARD,3,Novak Djokovic,David Ferrer,Novak Djokovic,6-0; 6-3; 7-5,Q,132,7,3,58,93,44,58,18,35,8,9,14,62,93,4,4,52,91,29,52,17,39,8,14,13,46,91
2008-01-14 00:00:00.000,Australian Open Australia Grand Slams,HARD,3,Jo-Wilfried Tsonga,Mikhail Youzhny,Jo-Wilfried Tsonga,7-5; 6-0; 7-6(6),Q,136,8,1,57,86,49,57,17,29,0,0,15,66,86,0,3,78,106,53,78,9,28,3,7,15,62,106
2008-01-14 00:00:00.000,Australian Open Australia Grand Slams,HARD,3,Rafael Nadal,Jarkko Nieminen,Rafael Nadal,7-5; 6-3; 6-1,Q,138,5,5,55,92,43,55,18,37,7,8,14,61,92,2,2,63,91,40,63,10,28,3,9,14,50,91
2008-01-14 00:00:00.000,Australian Open Australia Grand Slams,HARD,3,Novak Djokovic,Roger Federer,Novak Djokovic,7-5; 6-3; 7-6(5),S,146,13,6,77,113,60,77,15,36,7,9,17,75,113,10,2,68,109,48,68,18,41,7,11,16,66,109
2008-01-14 00:00:00.000,Australian Open Australia Grand Slams,HARD,3,Jo-Wilfried Tsonga,Rafael Nadal,Jo-Wilfried Tsonga,6-2; 6-3; 6-2,S,116,18,1,48,76,41,48,16,28,3,3,13,57,76,2,1,48,70,27,48,11,22,2,7,12,38,70
2008-01-14 00:00:00.000,Australian Open Australia Grand Slams,HARD,3,Novak Djokovic,Jo-Wilfried Tsonga,Novak Djokovic,4-6; 6-4; 6-3; 7-6(2),F,185,11,2,68,122,53,68,34,54,3,5,20,87,122,15,2,97,136,69,97,18,39,8,12,21,87,136
2008-01-28 00:00:00.000,Vi±a del Mar Chile ATP World Tour,CLAY,2,Fernando Gonzalez,Paul Capdeville,Fernando Gonzalez,7-5; 6-3,R32,75,5,2,38,57,28,38,9,19,1,4,11,37,57,1,3,46,63,26,46,6,17,2,7,10,32,63
2008-01-28 00:00:00.000,Vi±a del Mar Chile ATP World Tour,CLAY,2,Diego Hartfield,Mariano Zabaleta,Diego Hartfield,6-3; 7-5,R32,91,2,4,46,71,32,46,13,25,5,7,11,45,71,4,6,39,71,24,39,13,32,7,11,10,37,71
2008-01-28 00:00:00.000,Vi±a del Mar Chile ATP World Tour,CLAY,2,Carlos Berlocq,Nicolas Devilder,Carlos Berlocq,7-5; 6-2,R32,128,5,2,31,66,25,31,19,35,3,4,10,44,66,2,4,48,81,30,48,13,33,8,12,10,43,81
2008-01-28 00:00:00.000,Vi±a del Mar Chile ATP World Tour,CLAY,2,Luis Horna,Agustin Calleri,Luis Horna,6-4; 6-4,R32,82,2,2,41,57,35,41,9,16,4,4,10,44,57,10,2,38,66,31,38,10,28,2,4,10,41,66
2008-01-28 00:00:00.000,Vi±a del Mar Chile ATP World Tour,CLAY,2,Fernando Verdasco,Hans Podlipnik-Castillo,Fernando Verdasco,6-4; 6-3,R32,82,6,0,32,48,24,32,10,16,1,2,9,34,48,1,4,58,77,35,58,7,19,4,8,10,42,77
2008-01-28 00:00:00.000,Vi±a del Mar Chile ATP World Tour,CLAY,2,Pablo Cuevas,Guillermo Coria,Pablo Cuevas,6-4; 4-6; 6-3,R32,124,4,2,53,90,35,53,17,37,5,9,14,52,90,0,10,53,91,34,53,16,38,4,10,15,50,91
2008-01-28 00:00:00.000,Vi±a del Mar Chile ATP World Tour,CLAY,2,Daniel Gimeno-Traver,Eduardo Schwank,Daniel Gimeno-Traver,6-4; 1-6; 6-1,R32,79,4,0,37,55,27,37,14,18,0,2,12,41,55,0,0,41,58,31,41,9,17,2,5,12,40,58
2008-01-28 00:00:00.000,Vi±a del Mar Chile ATP World Tour,CLAY,2,Jose Acasuso,Peter Luczak,Jose Acasuso,6-2; 6-4,R32,86,6,2,27,60,25,27,18,33,4,4,9,43,60,4,2,28,56,21,28,12,28,6,9,9,33,56
2008-01-28 00:00:00.000,Vi±a del Mar Chile ATP World Tour,CLAY,2,Juan Pablo Brzezicki,Oscar Hernandez,Juan Pablo Brzezicki,7-6(4); 6-1,R32,123,1,3,43,68,24,43,15,25,2,6,10,39,68,1,5,36,61,20,36,7,25,0,6,9,27,61
2008-01-28 00:00:00.000,Vi±a del Mar Chile ATP World Tour,CLAY,2,Marcel Granollers,Boris Pashanski,Marcel Granollers,7-6(4); 6-2,R32,104,7,2,41,64,34,41,10,23,3,4,10,44,64,0,3,61,89,36,61,12,28,6,9,10,48,89
2008-01-28 00:00:00.000,Vi±a del Mar Chile ATP World Tour,CLAY,2,Martin Vassallo Arguello,Olivier Patience,Martin Vassallo Arguello,6-4; 6-1,R32,73,1,1,35,48,28,35,7,13,1,1,8,35,48,0,4,39,60,21,39,11,21,6,10,9,32,60
2008-01-28 00:00:00.000,Vi±a del Mar Chile ATP World Tour,CLAY,2,Juan Monaco,Nicolas Lapentti,Juan Monaco,2-6; 6-3; 6-4,R32,153,6,1,72,102,45,72,17,30,9,12,14,62,102,2,2,51,87,35,51,18,36,8,11,13,53,87
2008-01-28 00:00:00.000,Vi±a del Mar Chile ATP World Tour,CLAY,2,Sergio Roitman,Nicolas Massu,Sergio Roitman,6-7(3); 7-6(4); 6-3,R32,199,3,1,69,121,46,69,28,52,9,13,17,74,121,4,8,70,118,47,70,25,48,6,11,16,72,118
2008-01-28 00:00:00.000,Vi±a del Mar Chile ATP World Tour,CLAY,2,Santiago Ventura,Gaston Gaudio,Santiago Ventura,6-3; 6-0,R32,66,9,3,24,54,21,24,13,30,3,5,8,34,54,1,3,26,49,8,26,11,23,3,9,7,19,49
2008-01-28 00:00:00.000,Vi±a del Mar Chile ATP World Tour,CLAY,2,David Marrero,Adrian Garcia,David Marrero,6-7(2); 7-6(3); 6-4,R32,172,11,5,74,113,51,74,25,39,3,4,17,76,113,8,2,76,121,51,76,27,45,10,12,17,78,121
2008-01-28 00:00:00.000,Vi±a del Mar Chile ATP World Tour,CLAY,2,Fabio Fognini,Juan Ignacio Chela,Fabio Fognini,7-6(0); 6-2,R32,86,3,0,33,61,26,33,20,28,2,2,10,46,61,1,2,37,65,25,37,14,28,6,8,10,39,65
2008-01-28 00:00:00.000,Vi±a del Mar Chile ATP World Tour,CLAY,2,Fernando Gonzalez,Diego Hartfield,Fernando Gonzalez,6-3; 6-4,R16,67,6,6,38,64,29,38,12,26,2,4,10,41,64,1,1,29,47,15,29,11,18,1,5,9,26,47
2008-01-28 00:00:00.000,Vi±a del Mar Chile ATP World Tour,CLAY,2,Carlos Berlocq,Luis Horna,Carlos Berlocq,7-6(3); 3-6; 7-6(3),R16,184,12,2,58,110,41,58,31,52,4,8,16,72,110,3,1,86,111,61,86,10,25,5,8,17,71,111
2008-01-28 00:00:00.000,Vi±a del Mar Chile ATP World Tour,CLAY,2,Pablo Cuevas,Fernando Verdasco,Pablo Cuevas,7-5; 6-3,R16,87,4,1,46,75,33,46,19,29,6,6,11,52,75,1,6,38,63,26,38,15,25,3,5,10,41,63
2008-01-28 00:00:00.000,Vi±a del Mar Chile ATP World Tour,CLAY,2,Jose Acasuso,Daniel Gimeno-Traver,Jose Acasuso,6-2; 6-2,R16,60,1,0,31,41,26,31,6,10,0,0,8,32,41,3,4,37,62,25,37,7,25,7,11,8,32,62
2008-01-28 00:00:00.000,Vi±a del Mar Chile ATP World Tour,CLAY,2,Juan Pablo Brzezicki,Marcel Granollers,Juan Pablo Brzezicki,6-2; 6-2,R16,88,1,0,29,49,23,29,12,20,1,1,8,35,49,1,2,32,67,15,32,19,35,11,15,8,34,67
2008-01-28 00:00:00.000,Vi±a del Mar Chile ATP World Tour,CLAY,2,Juan Monaco,Martin Vassallo Arguello,Juan Monaco,6-3; 4-6; 7-5,R16,165,7,2,64,106,45,64,21,42,9,12,16,66,106,1,2,70,106,43,70,18,36,5,9,15,61,106
2008-01-28 00:00:00.000,Vi±a del Mar Chile ATP World Tour,CLAY,2,Santiago Ventura,Sergio Roitman,Santiago Ventura,4-6; 6-3; 7-6(4),R16,138,2,6,49,97,34,49,18,48,8,15,16,52,97,6,1,59,98,29,59,22,39,7,14,15,51,98
2008-01-28 00:00:00.000,Vi±a del Mar Chile ATP World Tour,CLAY,2,Fabio Fognini,David Marrero,Fabio Fognini,6-4; 6-7(5); 6-3,R16,132,9,4,52,104,41,52,31,52,7,8,16,72,104,4,1,64,103,42,64,22,39,8,11,15,64,103
2008-01-28 00:00:00.000,Vi±a del Mar Chile ATP World Tour,CLAY,2,Fernando Gonzalez,Carlos Berlocq,Fernando Gonzalez,7-5; 6-0,Q,83,4,1,37,57,26,37,14,20,3,3,9,40,57,1,4,42,64,27,42,7,22,3,7,9,34,64
2008-01-28 00:00:00.000,Vi±a del Mar Chile ATP World Tour,CLAY,2,Pablo Cuevas,Jose Acasuso,Pablo Cuevas,6-3; 6-3,Q,91,5,2,45,71,32,45,12,26,3,4,9,44,71,5,4,39,73,24,39,13,34,12,16,9,37,73
2008-01-28 00:00:00.000,Vi±a del Mar Chile ATP World Tour,CLAY,2,Juan Monaco,Juan Pablo Brzezicki,Juan Monaco,6-2; 6-3,Q,84,3,0,27,53,22,27,14,26,1,2,9,36,53,1,2,41,66,23,41,10,25,10,14,8,33,66
2008-01-28 00:00:00.000,Vi±a del Mar Chile ATP World Tour,CLAY,2,Santiago Ventura,Fabio Fognini,Santiago Ventura,6-3; 6-3,Q,80,6,1,30,52,24,30,14,22,1,1,9,38,52,2,1,39,69,26,39,13,30,5,8,9,39,69
2008-01-28 00:00:00.000,Vi±a del Mar Chile ATP World Tour,CLAY,2,Fernando Gonzalez,Pablo Cuevas,Fernando Gonzalez,6-7(4); 7-6(6); 6-2,S,168,10,2,61,107,44,61,26,46,7,10,16,70,107,4,1,80,115,50,80,17,35,2,7,16,67,115
2008-01-28 00:00:00.000,Vi±a del Mar Chile ATP World Tour,CLAY,2,Juan Monaco,Santiago Ventura,Juan Monaco,6-2; 6-4,S,75,1,1,33,52,23,33,12,19,2,3,9,35,52,5,3,27,57,21,27,10,30,3,7,9,31,57
2008-01-28 00:00:00.000,Vi±a del Mar Chile ATP World Tour,CLAY,2,Fernando Gonzalez,Juan Monaco,Fernando Gonzalez,W/O,F,0,0,0,0,0,0,0,0,0,0,0,0,0,0,0,0,0,0,0,0,0,0,0,0,0,0,0
2008-02-11 00:00:00.000,Costa Do Sauipe Brazil ATP World Tour,CLAY,2,Carlos Moya,Santiago Ventura,Carlos Moya,6-4; 4-6; 6-4,R32,149,3,4,52,95,39,52,27,43,2,3,15,66,95,4,9,53,107,39,53,29,54,5,7,15,68,107
2008-02-11 00:00:00.000,Costa Do Sauipe Brazil ATP World Tour,CLAY,2,Olivier Patience,Juan Pablo Brzezicki,Olivier Patience,6-3; 7-5,R32,84,8,0,39,58,29,39,7,19,1,5,11,36,58,3,2,37,58,18,37,9,21,1,7,10,27,58
2008-02-11 00:00:00.000,Costa Do Sauipe Brazil ATP World Tour,CLAY,2,Oscar Hernandez,Pablo Cuevas,Oscar Hernandez,7-6(5); 6-4,R32,100,2,5,45,69,34,45,11,24,1,3,11,45,69,6,1,41,67,28,41,14,26,1,4,11,42,67
2008-02-11 00:00:00.000,Costa Do Sauipe Brazil ATP World Tour,CLAY,2,Sergio Roitman,Agustin Calleri,Sergio Roitman,6-3; 6-2,R32,62,10,1,30,50,25,30,11,20,0,0,9,36,50,5,2,29,46,20,29,6,17,2,5,8,26,46
2008-02-11 00:00:00.000,Costa Do Sauipe Brazil ATP World Tour,CLAY,2,Eduardo Schwank,Igor Andreev,Eduardo Schwank,6-3; 6-2,R32,72,2,1,32,44,27,32,9,12,0,0,9,36,44,0,1,37,53,23,37,7,16,3,6,8,30,53
2008-02-11 00:00:00.000,Costa Do Sauipe Brazil ATP World Tour,CLAY,2,Peter Luczak,Marcos Daniel,Peter Luczak,7-5; 6-4,R32,96,5,1,38,65,28,38,17,27,3,4,11,45,65,5,4,34,67,23,34,17,33,3,6,11,40,67
2008-02-11 00:00:00.000,Costa Do Sauipe Brazil ATP World Tour,CLAY,2,Nicolas Lapentti,Thomaz Bellucci,Nicolas Lapentti,6-2; 6-2,R32,85,2,0,26,39,23,26,10,13,0,0,8,33,39,11,5,41,75,27,41,11,34,11,15,8,38,75
2008-02-11 00:00:00.000,Costa Do Sauipe Brazil ATP World Tour,CLAY,2,Sebastian Decoud,Jose Acasuso,Sebastian Decoud,6-3; 1-6; 7-6(3),R32,158,3,3,64,93,42,64,15,29,8,11,14,57,93,11,4,61,97,43,61,17,36,7,9,14,60,97
2008-02-11 00:00:00.000,Costa Do Sauipe Brazil ATP World Tour,CLAY,2,Albert Montanes,Nicolas Devilder,Albert Montanes,6-4; 6-4,R32,95,8,6,37,71,30,37,18,34,4,5,10,48,71,3,2,27,60,22,27,14,33,4,7,10,36,60
2008-02-11 00:00:00.000,Costa Do Sauipe Brazil ATP World Tour,CLAY,2,Fabio Fognini,Jiri Vanek,Fabio Fognini,6-3; 6-7(4); 7-6(3),R32,163,5,8,68,133,49,68,29,65,6,10,17,78,133,7,4,59,117,38,59,25,58,7,12,16,63,117
2008-02-11 00:00:00.000,Costa Do Sauipe Brazil ATP World Tour,CLAY,2,Carlos Berlocq,Gustavo Kuerten,Carlos Berlocq,7-5; 6-1,R32,80,8,1,32,49,26,32,11,17,1,2,10,37,49,3,4,35,56,22,35,8,21,2,6,9,30,56
2008-02-11 00:00:00.000,Costa Do Sauipe Brazil ATP World Tour,CLAY,2,Ivo Minar,Potito Starace,Ivo Minar,6-4; 4-6; 6-2,R32,129,4,2,38,75,29,38,22,37,7,10,14,51,75,1,3,54,81,36,54,12,27,8,13,14,48,81
2008-02-11 00:00:00.000,Costa Do Sauipe Brazil ATP World Tour,CLAY,2,Filippo Volandri,Daniel Munoz-De La Nava,Filippo Volandri,6-2; 6-4,R32,84,0,1,40,56,23,40,10,16,4,7,9,33,56,0,1,33,59,18,33,8,26,6,12,9,26,59
2008-02-11 00:00:00.000,Costa Do Sauipe Brazil ATP World Tour,CLAY,2,Guillermo Coria,Francesco Aldi,Guillermo Coria,6-4; 7-5,R32,117,0,16,48,77,25,48,12,29,8,14,11,37,77,0,8,43,65,19,43,8,22,5,13,11,27,65
2008-02-11 00:00:00.000,Costa Do Sauipe Brazil ATP World Tour,CLAY,2,Boris Pashanski,Martin Vassallo Arguello,Boris Pashanski,6-4; 6-4,R32,108,1,4,39,65,25,39,11,26,4,8,10,36,65,0,1,35,59,17,35,11,24,3,9,10,28,59
2008-02-11 00:00:00.000,Costa Do Sauipe Brazil ATP World Tour,CLAY,2,Nicolas Almagro,Nicolas Massu,Nicolas Almagro,6-3; 6-2,R32,64,10,1,34,46,27,34,7,12,1,2,9,34,46,2,4,20,46,14,20,9,26,1,5,8,23,46
2008-02-11 00:00:00.000,Costa Do Sauipe Brazil ATP World Tour,CLAY,2,Carlos Moya,Olivier Patience,Carlos Moya,5-7; 6-1; 6-0,R16,97,10,2,43,72,37,43,13,29,1,2,12,50,72,3,2,54,81,33,54,10,27,5,11,13,43,81
2008-02-11 00:00:00.000,Costa Do Sauipe Brazil ATP World Tour,CLAY,2,Oscar Hernandez,Sergio Roitman,Oscar Hernandez,6-3; 2-6; 6-4,R16,161,1,4,77,110,47,77,13,33,12,17,14,60,110,3,3,55,88,36,55,13,33,5,10,13,49,88
2008-02-11 00:00:00.000,Costa Do Sauipe Brazil ATP World Tour,CLAY,2,Eduardo Schwank,Peter Luczak,Eduardo Schwank,6-2; 6-2,R16,82,5,2,41,54,26,41,8,13,3,5,8,34,54,3,5,28,58,16,28,10,30,2,8,8,26,58
2008-02-11 00:00:00.000,Costa Do Sauipe Brazil ATP World Tour,CLAY,2,Nicolas Lapentti,Sebastian Decoud,Nicolas Lapentti,6-1; 6-2,R16,79,2,0,35,42,26,35,5,7,0,1,8,31,42,0,2,37,47,19,37,1,10,4,9,7,20,47
2008-02-11 00:00:00.000,Costa Do Sauipe Brazil ATP World Tour,CLAY,2,Fabio Fognini,Albert Montanes,Fabio Fognini,7-5; 6-3,R16,98,4,2,28,68,22,28,22,40,7,9,11,44,68,1,9,43,75,27,43,14,32,9,13,10,41,75
2008-02-11 00:00:00.000,Costa Do Sauipe Brazil ATP World Tour,CLAY,2,Ivo Minar,Carlos Berlocq,Ivo Minar,6-4; 6-4,R16,93,4,1,37,65,25,37,18,28,2,3,10,43,65,3,1,35,62,20,35,16,27,2,5,10,36,62
2008-02-11 00:00:00.000,Costa Do Sauipe Brazil ATP World Tour,CLAY,2,Filippo Volandri,Guillermo Coria,Filippo Volandri,6-1; 6-2,R16,51,0,1,27,36,20,27,6,9,2,4,8,26,36,0,7,25,42,10,25,3,17,4,10,7,13,42
2008-02-11 00:00:00.000,Costa Do Sauipe Brazil ATP World Tour,CLAY,2,Nicolas Almagro,Boris Pashanski,Nicolas Almagro,6-2; 6-3,R16,79,8,1,22,41,21,22,12,19,2,2,8,33,41,5,4,46,77,28,46,12,31,7,11,9,40,77
2008-02-11 00:00:00.000,Costa Do Sauipe Brazil ATP World Tour,CLAY,2,Carlos Moya,Oscar Hernandez,Carlos Moya,6-3; 3-6; 7-5,Q,143,2,1,71,102,45,71,16,31,6,9,15,61,102,0,4,72,88,47,72,7,16,3,7,15,54,88
2008-02-11 00:00:00.000,Costa Do Sauipe Brazil ATP World Tour,CLAY,2,Nicolas Lapentti,Eduardo Schwank,Nicolas Lapentti,1-6; 6-4; 7-6(4),Q,172,2,3,66,98,47,66,13,32,4,8,15,60,98,4,4,71,103,47,71,17,32,7,9,14,64,103
2008-02-11 00:00:00.000,Costa Do Sauipe Brazil ATP World Tour,CLAY,2,Fabio Fognini,Ivo Minar,Fabio Fognini,6-7(2); 6-2; 6-3,Q,118,8,2,50,93,45,50,22,43,2,2,15,67,93,7,1,49,88,37,49,19,39,5,8,14,56,88
2008-02-11 00:00:00.000,Costa Do Sauipe Brazil ATP World Tour,CLAY,2,Nicolas Almagro,Filippo Volandri,Nicolas Almagro,7-5; 2-6; 6-1,Q,107,5,3,45,82,33,45,16,37,4,8,14,49,82,1,1,70,83,40,70,5,13,4,9,13,45,83
2008-02-11 00:00:00.000,Costa Do Sauipe Brazil ATP World Tour,CLAY,2,Carlos Moya,Nicolas Lapentti,Carlos Moya,6-2; 3-6; 7-6(5),S,160,5,1,54,82,41,54,18,28,0,2,14,59,82,0,3,64,98,43,64,18,34,9,12,15,61,98
2008-02-11 00:00:00.000,Costa Do Sauipe Brazil ATP World Tour,CLAY,2,Nicolas Almagro,Fabio Fognini,Nicolas Almagro,6-1; 6-1,S,55,5,1,20,41,17,20,15,21,3,3,7,32,41,1,6,24,43,15,24,1,19,2,7,7,16,43
2008-02-11 00:00:00.000,Costa Do Sauipe Brazil ATP World Tour,CLAY,2,Nicolas Almagro,Carlos Moya,Nicolas Almagro,7-6(4); 3-6; 7-5,F,147,3,0,84,108,56,84,15,24,4,8,17,71,108,6,2,70,109,48,70,20,39,9,12,16,68,109
2008-02-11 00:00:00.000,Delray Beach FL; U.S.A. ATP World Tour,HARD,2,James Blake,Robert Kendrick,James Blake,7-5; 7-5,R32,82,5,4,47,79,33,47,18,32,3,5,12,51,79,11,4,35,68,27,35,15,33,6,10,12,42,68
2008-02-11 00:00:00.000,Delray Beach FL; U.S.A. ATP World Tour,HARD,2,Paul Capdeville,Clint Bowles,Paul Capdeville,6-2; 6-4,R32,64,1,2,31,48,19,31,9,17,1,4,9,28,48,0,1,42,60,22,42,6,18,4,10,9,28,60
2008-02-11 00:00:00.000,Delray Beach FL; U.S.A. ATP World Tour,HARD,2,Igor Kunitsyn,Benjamin Becker,Igor Kunitsyn,6-3; 7-6(1),R32,95,2,3,33,67,26,33,22,34,2,3,11,48,67,3,3,34,72,22,34,18,38,6,8,10,40,72
2008-02-11 00:00:00.000,Delray Beach FL; U.S.A. ATP World Tour,HARD,2,Max Mirnyi,Luka Gregorc,Max Mirnyi,7-6(5); 6-2,R32,92,10,1,41,58,35,41,11,17,0,0,10,46,58,4,7,52,81,36,52,13,29,4,6,10,49,81
2008-02-11 00:00:00.000,Delray Beach FL; U.S.A. ATP World Tour,HARD,2,Michael Russell,Alex Bogomolov Jr.,Michael Russell,6-1; 6-0,R32,50,3,0,33,45,26,33,7,12,3,3,7,33,45,0,3,25,38,10,25,4,13,3,8,6,14,38
2008-02-11 00:00:00.000,Delray Beach FL; U.S.A. ATP World Tour,HARD,2,Robby Ginepri,Mathieu Montcourt,Robby Ginepri,6-3; 6-0,R32,45,5,1,23,34,20,23,8,11,0,0,7,28,34,1,4,26,44,14,26,5,18,3,8,8,19,44
2008-02-11 00:00:00.000,Delray Beach FL; U.S.A. ATP World Tour,HARD,2,Ivan Navarro,Florent Serra,Ivan Navarro,6-3; 3-6; 6-3,R32,106,16,5,49,83,36,49,22,34,1,2,14,58,83,3,1,47,79,33,47,19,32,5,7,13,52,79
2008-02-11 00:00:00.000,Delray Beach FL; U.S.A. ATP World Tour,HARD,2,Mardy Fish,Marco Crugnola,Mardy Fish,6-1; 7-5,R32,64,5,0,23,49,19,23,21,26,0,0,10,40,49,1,5,29,52,19,29,10,23,4,7,9,29,52
2008-02-11 00:00:00.000,Delray Beach FL; U.S.A. ATP World Tour,HARD,2,Vincent Spadea,Denis Gremelmayr,Vincent Spadea,6-3; 6-4,R32,95,1,0,36,62,24,36,16,26,4,5,10,40,62,4,3,50,88,28,50,19,38,12,15,9,47,88
2008-02-11 00:00:00.000,Delray Beach FL; U.S.A. ATP World Tour,HARD,2,Gilles Muller,Jesse Levine,Gilles Muller,7-5; 7-6(4),R32,95,10,0,42,69,33,42,17,27,1,2,12,50,69,2,5,45,75,27,45,17,30,2,4,12,44,75
2008-02-11 00:00:00.000,Delray Beach FL; U.S.A. ATP World Tour,HARD,2,Guillermo Garcia-Lopez,Wayne Odesnik,Guillermo Garcia-Lopez,6-4; 6-2,R32,87,2,8,37,74,24,37,18,37,8,10,9,42,74,2,5,31,64,19,31,13,33,6,11,9,32,64
2008-02-11 00:00:00.000,Delray Beach FL; U.S.A. ATP World Tour,HARD,2,Sam Querrey,Yuri Schukin,Sam Querrey,6-1; 6-4,R32,63,12,1,33,49,30,33,7,16,3,3,9,37,49,3,5,32,65,21,32,14,33,9,12,8,35,65
2008-02-11 00:00:00.000,Delray Beach FL; U.S.A. ATP World Tour,HARD,2,Kei Nishikori,Florian Mayer,Kei Nishikori,6-0; 4-3 RET,R32,45,2,0,27,39,17,27,8,12,2,3,6,25,39,2,3,25,48,14,25,6,23,4,9,7,20,48
2008-02-11 00:00:00.000,Delray Beach FL; U.S.A. ATP World Tour,HARD,2,Amer Delic,Donald Young,Amer Delic,7-6(7); 6-3,R32,83,3,5,42,72,32,42,14,30,5,8,11,46,72,3,6,49,79,30,49,13,30,3,7,10,43,79
2008-02-11 00:00:00.000,Delray Beach FL; U.S.A. ATP World Tour,HARD,2,Bobby Reynolds,Xavier Malisse,Bobby Reynolds,6-2; 4-6; 6-3,R32,116,9,7,50,112,37,50,32,62,15,17,14,69,112,5,3,37,78,28,37,18,41,4,8,13,46,78
2008-02-11 00:00:00.000,Delray Beach FL; U.S.A. ATP World Tour,HARD,2,Diego Hartfield,Tommy Haas,Diego Hartfield,6-2; 3-6; 6-2,R32,116,3,3,46,77,29,46,19,31,6,8,12,48,77,5,4,50,94,32,50,20,44,12,17,13,52,94
2008-02-11 00:00:00.000,Delray Beach FL; U.S.A. ATP World Tour,HARD,2,James Blake,Paul Capdeville,James Blake,6-1; 6-4,R16,58,5,2,40,61,30,40,10,21,7,8,9,40,61,1,3,30,51,15,30,9,21,1,5,8,24,51
2008-02-11 00:00:00.000,Delray Beach FL; U.S.A. ATP World Tour,HARD,2,Igor Kunitsyn,Max Mirnyi,Igor Kunitsyn,7-6(4); 6-3,R16,96,2,1,46,72,37,46,15,26,3,3,11,52,72,9,1,54,76,36,54,13,22,6,7,10,49,76
2008-02-11 00:00:00.000,Delray Beach FL; U.S.A. ATP World Tour,HARD,2,Robby Ginepri,Michael Russell,Robby Ginepri,7-5; 4-6; 6-2,R16,152,8,7,61,117,38,61,27,56,9,14,15,65,117,2,9,71,112,41,71,16,41,8,15,15,57,112
2008-02-11 00:00:00.000,Delray Beach FL; U.S.A. ATP World Tour,HARD,2,Mardy Fish,Ivan Navarro,Mardy Fish,2-6; 7-5; 6-3,R16,147,11,3,57,113,37,57,23,56,10,16,15,60,113,6,6,43,87,27,43,22,44,3,9,14,49,87
2008-02-11 00:00:00.000,Delray Beach FL; U.S.A. ATP World Tour,HARD,2,Vincent Spadea,Gilles Muller,Vincent Spadea,7-5; 4-6; 6-3,R16,116,8,1,59,94,42,59,22,35,3,5,16,64,94,15,3,57,98,45,57,19,41,3,6,15,64,98
2008-02-11 00:00:00.000,Delray Beach FL; U.S.A. ATP World Tour,HARD,2,Sam Querrey,Guillermo Garcia-Lopez,Sam Querrey,6-4; 5-7; 6-4,R16,129,9,5,67,113,45,67,23,46,10,13,16,68,113,3,9,54,96,39,54,20,42,3,7,16,59,96
2008-02-11 00:00:00.000,Delray Beach FL; U.S.A. ATP World Tour,HARD,2,Kei Nishikori,Amer Delic,Kei Nishikori,6-7(7); 6-4; 6-2,R16,131,2,1,74,118,56,74,21,44,12,12,15,77,118,16,2,64,109,45,64,24,45,6,9,15,69,109
2008-02-11 00:00:00.000,Delray Beach FL; U.S.A. ATP World Tour,HARD,2,Bobby Reynolds,Diego Hartfield,Bobby Reynolds,7-5; 2-6; 7-6(3),R16,157,13,4,83,132,57,83,20,49,15,20,16,77,132,11,7,60,103,45,60,18,43,8,12,16,63,103
2008-02-11 00:00:00.000,Delray Beach FL; U.S.A. ATP World Tour,HARD,2,James Blake,Igor Kunitsyn,James Blake,6-2; 6-4,Q,80,2,2,34,64,27,34,10,30,7,10,9,37,64,0,5,36,64,18,36,10,28,7,13,9,28,64
2008-02-11 00:00:00.000,Delray Beach FL; U.S.A. ATP World Tour,HARD,2,Robby Ginepri,Mardy Fish,Robby Ginepri,6-1; 4-6; 6-4,Q,106,3,1,42,66,33,42,14,24,3,5,13,47,66,11,2,39,95,28,39,26,56,7,12,14,54,95
2008-02-11 00:00:00.000,Delray Beach FL; U.S.A. ATP World Tour,HARD,2,Sam Querrey,Vincent Spadea,Sam Querrey,6-2; 6-4,Q,57,10,1,33,48,27,33,9,15,0,0,9,36,48,0,3,28,49,20,28,8,21,2,5,9,28,49
2008-02-11 00:00:00.000,Delray Beach FL; U.S.A. ATP World Tour,HARD,2,Kei Nishikori,Bobby Reynolds,Kei Nishikori,6-2; 6-4,Q,65,3,1,30,51,24,30,11,21,2,3,9,35,51,3,1,31,54,20,31,8,23,5,9,9,28,54
2008-02-11 00:00:00.000,Delray Beach FL; U.S.A. ATP World Tour,HARD,2,James Blake,Robby Ginepri,James Blake,6-4; 6-4,S,72,9,2,36,63,27,36,14,27,1,3,10,41,63,4,1,44,64,28,44,7,20,4,8,10,35,64
2008-02-11 00:00:00.000,Delray Beach FL; U.S.A. ATP World Tour,HARD,2,Kei Nishikori,Sam Querrey,Kei Nishikori,4-6; 6-2; 7-6(7),S,113,6,3,57,95,45,57,19,38,1,3,15,64,95,10,2,55,88,46,55,14,33,1,4,15,60,88
2008-02-11 00:00:00.000,Delray Beach FL; U.S.A. ATP World Tour,HARD,2,Kei Nishikori,James Blake,Kei Nishikori,3-6; 6-1; 6-4,F,86,3,0,51,76,39,51,15,25,4,5,13,54,76,8,5,39,75,34,39,16,36,5,8,13,50,75
2008-02-11 00:00:00.000,Marseille France ATP World Tour,HARD,2,Novak Djokovic,Ivan Dodig,Novak Djokovic,6-1; 6-4,R32,70,7,2,25,49,20,25,17,24,0,0,9,37,49,1,0,30,53,21,30,8,23,2,5,8,29,53
2008-02-11 00:00:00.000,Marseille France ATP World Tour,HARD,2,Gilles Simon,David Guez,Gilles Simon,6-2; 6-4,R32,78,4,1,30,57,22,30,15,27,4,5,9,37,57,1,0,30,47,18,30,8,17,3,7,9,26,47
2008-02-11 00:00:00.000,Marseille France ATP World Tour,HARD,2,Michael Llodra,Andreas Seppi,Michael Llodra,6-2; 7-6(5),R32,83,12,2,42,68,33,42,17,26,4,4,10,50,68,5,1,39,63,30,39,13,24,3,5,10,43,63
2008-02-11 00:00:00.000,Marseille France ATP World Tour,HARD,2,Paul-Henri Mathieu,Marc Gicquel,Paul-Henri Mathieu,7-6(7); 7-6(4),R32,113,11,1,37,79,31,37,28,42,1,2,12,59,79,9,6,42,81,36,42,22,39,5,6,12,58,81
2008-02-11 00:00:00.000,Marseille France ATP World Tour,HARD,2,Andy Murray,Jesse Huta Galung,Andy Murray,6-4; 6-4,R32,72,7,2,29,55,23,29,14,26,4,6,10,37,55,4,2,32,59,23,32,10,27,3,7,10,33,59
2008-02-11 00:00:00.000,Marseille France ATP World Tour,HARD,2,Stanislas Wawrinka,Sebastien Grosjean,Stanislas Wawrinka,3-6; 6-4; 6-4,R32,134,5,1,65,103,44,65,21,38,3,5,15,65,103,5,1,46,78,37,46,18,32,4,6,14,55,78
2008-02-11 00:00:00.000,Marseille France ATP World Tour,HARD,2,Nicolas Mahut,Mikhail Elgin,Nicolas Mahut,6-3; 6-3,R32,66,5,0,31,50,28,31,10,19,0,0,9,38,50,6,3,36,60,24,36,11,24,3,6,9,35,60
2008-02-11 00:00:00.000,Marseille France ATP World Tour,HARD,2,Juan Carlos Ferrero,Hyung-Taik Lee,Juan Carlos Ferrero,6-4; 6-1,R32,87,7,0,37,53,27,37,6,16,5,6,8,33,53,2,5,59,95,35,59,12,36,13,18,9,47,95
2008-02-11 00:00:00.000,Marseille France ATP World Tour,HARD,2,Marcos Baghdatis,Arnaud Clement,Marcos Baghdatis,6-3; 6-4,R32,80,10,0,23,50,22,23,19,27,1,1,10,41,50,4,1,35,61,25,35,13,26,5,7,9,38,61
2008-02-11 00:00:00.000,Marseille France ATP World Tour,HARD,2,Ivo Karlovic,Feliciano Lopez,Ivo Karlovic,6-7(6); 7-5; 7-6(4),R32,131,33,2,73,101,66,73,17,28,0,0,18,83,101,13,1,78,113,63,78,21,35,2,3,18,84,113
2008-02-11 00:00:00.000,Marseille France ATP World Tour,HARD,2,Julien Benneteau,Andrei Pavel,Julien Benneteau,6-2; 1-0 RET,R32,41,6,1,12,22,12,12,8,10,0,0,5,20,22,2,0,16,27,11,16,3,11,0,2,4,14,27
2008-02-11 00:00:00.000,Marseille France ATP World Tour,HARD,2,Mikhail Youzhny,Marin Cilic,Mikhail Youzhny,6-4; 7-6(3),R32,112,8,0,49,76,34,49,19,27,2,2,11,53,76,10,2,41,71,33,41,12,30,2,3,11,45,71
2008-02-11 00:00:00.000,Marseille France ATP World Tour,HARD,2,Mario Ancic,Jo-Wilfried Tsonga,Mario Ancic,7-5; 7-6(3),R32,105,3,1,51,68,46,51,8,17,2,2,12,54,68,11,0,40,72,34,40,17,32,4,5,12,51,72
2008-02-11 00:00:00.000,Marseille France ATP World Tour,HARD,2,Teymuraz Gabashvili,Michael Berrer,Teymuraz Gabashvili,7-6(5); 6-4,R32,158,8,2,37,68,31,37,22,31,2,2,11,53,68,8,6,45,76,37,45,15,31,3,4,11,52,76
2008-02-11 00:00:00.000,Marseille France ATP World Tour,HARD,2,Robin Soderling,Jarkko Nieminen,Robin Soderling,6-3; 5-7; 7-5,R32,113,14,9,61,102,48,61,22,41,8,10,17,70,102,6,2,62,92,46,62,16,30,5,8,16,62,92
2008-02-11 00:00:00.000,Marseille France ATP World Tour,HARD,2,Richard Gasquet,Simone Bolelli,Richard Gasquet,6-3; 6-3,R32,70,17,1,29,48,27,29,9,19,0,0,9,36,48,5,2,40,61,27,40,8,21,6,9,9,35,61
2008-02-11 00:00:00.000,Marseille France ATP World Tour,HARD,2,Gilles Simon,Novak Djokovic,Gilles Simon,6-2; 6-7(6); 6-3,R16,127,8,3,60,107,43,60,32,47,6,6,15,75,107,5,3,52,81,40,52,14,29,2,5,14,54,81
2008-02-11 00:00:00.000,Marseille France ATP World Tour,HARD,2,Paul-Henri Mathieu,Michael Llodra,Paul-Henri Mathieu,7-6(4); 7-6(5),R16,114,3,4,38,74,30,38,26,36,0,1,12,56,74,23,3,46,84,34,46,23,38,4,5,12,57,84
2008-02-11 00:00:00.000,Marseille France ATP World Tour,HARD,2,Andy Murray,Stanislas Wawrinka,Andy Murray,3-6; 7-6(5); 6-1,R16,141,8,6,44,87,30,44,18,43,8,13,13,48,87,6,1,58,102,35,58,17,44,4,11,15,52,102
2008-02-11 00:00:00.000,Marseille France ATP World Tour,HARD,2,Nicolas Mahut,Juan Carlos Ferrero,Nicolas Mahut,5-7; 6-4; 7-6(1),R16,152,18,5,58,111,50,58,25,53,5,7,17,75,111,8,0,55,98,43,55,26,43,5,7,17,69,98
2008-02-11 00:00:00.000,Marseille France ATP World Tour,HARD,2,Marcos Baghdatis,Ivo Karlovic,Marcos Baghdatis,6-4; 6-4,R16,78,15,2,51,71,39,51,10,20,6,6,10,49,71,14,2,36,51,28,36,7,15,1,3,10,35,51
2008-02-11 00:00:00.000,Marseille France ATP World Tour,HARD,2,Mikhail Youzhny,Julien Benneteau,Mikhail Youzhny,7-5; 6-3,R16,93,6,3,38,71,29,38,21,33,7,7,11,50,71,4,2,31,52,23,31,12,21,1,3,10,35,52
2008-02-11 00:00:00.000,Marseille France ATP World Tour,HARD,2,Mario Ancic,Teymuraz Gabashvili,Mario Ancic,6-3; 6-2,R16,62,11,0,28,43,24,28,11,15,1,1,8,35,43,4,2,35,54,25,35,5,19,2,6,9,30,54
2008-02-11 00:00:00.000,Marseille France ATP World Tour,HARD,2,Robin Soderling,Richard Gasquet,Robin Soderling,4-6; 6-3; 6-2,R16,94,19,4,47,73,42,47,13,26,2,3,14,55,73,8,7,32,75,27,32,22,43,4,7,13,49,75
2008-02-11 00:00:00.000,Marseille France ATP World Tour,HARD,2,Paul-Henri Mathieu,Gilles Simon,Paul-Henri Mathieu,6-3; 6-4,Q,75,8,2,37,58,32,37,12,21,3,3,10,44,58,4,2,35,56,27,35,7,21,5,7,9,34,56
2008-02-11 00:00:00.000,Marseille France ATP World Tour,HARD,2,Andy Murray,Nicolas Mahut,Andy Murray,7-5; 7-6(5),Q,104,14,1,48,73,38,48,16,25,1,1,12,54,73,10,3,50,83,37,50,18,33,3,4,12,55,83
2008-02-11 00:00:00.000,Marseille France ATP World Tour,HARD,2,Marcos Baghdatis,Mikhail Youzhny,Marcos Baghdatis,7-6(2); 6-3,Q,102,7,2,40,68,31,40,19,28,1,1,10,50,68,5,0,49,74,38,49,11,25,8,10,11,49,74
2008-02-11 00:00:00.000,Marseille France ATP World Tour,HARD,2,Mario Ancic,Robin Soderling,Mario Ancic,6-3; 6-7(4); 6-2,Q,107,25,1,55,80,45,55,17,25,1,1,14,62,80,7,6,53,90,42,53,16,37,5,9,15,58,90
2008-02-11 00:00:00.000,Marseille France ATP World Tour,HARD,2,Andy Murray,Paul-Henri Mathieu,Andy Murray,6-2; 6-2,S,63,4,0,16,38,16,16,16,22,0,0,8,32,38,1,1,25,49,16,25,9,24,5,9,8,25,49
2008-02-11 00:00:00.000,Marseille France ATP World Tour,HARD,2,Mario Ancic,Marcos Baghdatis,Mario Ancic,6-4; 6-2,S,81,4,2,28,53,24,28,15,25,3,3,9,39,53,5,2,31,55,20,31,11,24,2,5,9,31,55
2008-02-11 00:00:00.000,Marseille France ATP World Tour,HARD,2,Andy Murray,Mario Ancic,Andy Murray,6-3; 6-4,F,113,11,1,40,79,33,40,17,39,9,10,10,50,79,4,1,39,59,24,39,8,20,5,8,9,32,59
2008-02-18 00:00:00.000,Buenos Aires Argentina ATP World Tour,CLAY,2,David Nalbandian,Peter Luczak,David Nalbandian,6-3; 6-3,R32,72,10,2,27,45,21,27,12,18,0,1,9,33,45,3,1,40,66,25,40,11,26,1,5,9,36,66
2008-02-18 00:00:00.000,Buenos Aires Argentina ATP World Tour,CLAY,2,Fabio Fognini,Eduardo Schwank,Fabio Fognini,6-2; 6-1,R32,72,0,2,36,44,26,36,4,8,6,7,7,30,44,0,3,28,57,15,28,10,29,2,8,8,25,57
2008-02-18 00:00:00.000,Buenos Aires Argentina ATP World Tour,CLAY,2,Juan Pablo Brzezicki,Nicolas Lapentti,Juan Pablo Brzezicki,6-3; 6-2,R32,81,1,1,38,53,30,38,7,15,4,5,9,37,53,0,0,26,50,15,26,11,24,5,9,8,26,50
2008-02-18 00:00:00.000,Buenos Aires Argentina ATP World Tour,CLAY,2,Potito Starace,Boris Pashanski,Potito Starace,6-1; 3-6; 6-4,R32,111,1,1,60,84,41,60,11,24,5,7,13,52,84,1,2,47,73,28,47,14,26,0,4,13,42,73
2008-02-18 00:00:00.000,Buenos Aires Argentina ATP World Tour,CLAY,2,Juan Ignacio Chela,Santiago Ventura,Juan Ignacio Chela,5-7; 6-3; 6-2,R32,136,2,6,55,86,40,55,14,31,2,5,14,54,86,2,6,63,108,39,63,18,45,10,16,15,57,108
2008-02-18 00:00:00.000,Buenos Aires Argentina ATP World Tour,CLAY,2,Thomaz Bellucci,Werner Eschauer,Thomaz Bellucci,6-4; 6-4,R32,89,3,1,35,58,27,35,14,23,1,2,10,41,58,2,4,37,60,23,37,11,23,4,7,10,34,60
2008-02-18 00:00:00.000,Buenos Aires Argentina ATP World Tour,CLAY,2,Oscar Hernandez,Eric Prodon,Oscar Hernandez,6-4; 6-3,R32,89,2,0,39,51,31,39,7,12,1,1,9,38,51,1,2,40,75,28,40,15,35,6,9,10,43,75
2008-02-18 00:00:00.000,Buenos Aires Argentina ATP World Tour,CLAY,2,Nicolas Almagro,Martin Vassallo Arguello,Nicolas Almagro,7-6(5); 7-6(2),R32,122,3,1,65,84,48,65,14,19,1,1,12,62,84,3,0,66,93,49,66,15,27,6,6,12,64,93
2008-02-18 00:00:00.000,Buenos Aires Argentina ATP World Tour,CLAY,2,Igor Andreev,Albert Montanes,Igor Andreev,6-3; 6-7(8); 7-6(4),R32,170,6,2,70,105,57,70,23,35,2,2,17,80,105,1,2,67,98,51,67,21,31,0,1,16,72,98
2008-02-18 00:00:00.000,Buenos Aires Argentina ATP World Tour,CLAY,2,Jiri Vanek,Carlos Berlocq,Jiri Vanek,6-4; 7-5,R32,92,4,3,35,58,29,35,11,23,3,5,11,40,58,1,1,39,61,22,39,13,22,4,8,11,35,61
2008-02-18 00:00:00.000,Buenos Aires Argentina ATP World Tour,CLAY,2,Daniel Gimeno-Traver,Ruben Ramirez Hidalgo,Daniel Gimeno-Traver,2-6; 6-1; 6-2,R32,109,6,2,36,64,24,36,18,28,1,3,11,42,64,0,7,40,74,26,40,14,34,7,12,12,40,74
2008-02-18 00:00:00.000,Buenos Aires Argentina ATP World Tour,CLAY,2,Jose Acasuso,Carlos Moya,Jose Acasuso,6-2; 6-4,R32,80,2,1,25,44,20,25,13,19,0,1,9,33,44,4,1,38,58,24,38,7,20,1,5,9,31,58
2008-02-18 00:00:00.000,Buenos Aires Argentina ATP World Tour,CLAY,2,Filippo Volandri,Nicolas Massu,Filippo Volandri,6-4; 6-2,R32,80,0,1,40,55,23,40,13,15,4,5,9,36,55,3,1,24,47,14,24,10,23,2,6,9,24,47
2008-02-18 00:00:00.000,Buenos Aires Argentina ATP World Tour,CLAY,2,Sergio Roitman,Ivo Minar,Sergio Roitman,4-0 RET,R32,31,2,1,6,13,4,6,5,7,0,0,2,9,13,0,1,6,14,2,6,2,8,0,2,2,4,14
2008-02-18 00:00:00.000,Buenos Aires Argentina ATP World Tour,CLAY,2,Luis Horna,Maximo Gonzalez,Luis Horna,6-4; 6-4,R32,93,2,0,49,60,37,49,5,11,3,4,10,42,60,1,1,39,73,26,39,16,34,7,10,10,42,73
2008-02-18 00:00:00.000,Buenos Aires Argentina ATP World Tour,CLAY,2,Agustin Calleri,Juan Monaco,Agustin Calleri,6-4; 2-6; 6-3,R32,144,2,6,57,111,39,57,20,54,8,13,13,59,111,0,3,67,100,39,67,15,33,3,9,14,54,100
2008-02-18 00:00:00.000,Buenos Aires Argentina ATP World Tour,CLAY,2,David Nalbandian,Fabio Fognini,David Nalbandian,7-6(5); 4-6; 6-3,R16,152,4,6,57,99,40,57,22,42,3,7,16,62,99,4,3,73,110,48,73,16,37,7,11,15,64,110
2008-02-18 00:00:00.000,Buenos Aires Argentina ATP World Tour,CLAY,2,Potito Starace,Juan Pablo Brzezicki,Potito Starace,6-3; 6-3,R16,79,0,0,38,54,29,38,12,16,0,0,9,41,54,1,0,27,46,20,27,10,19,2,5,9,30,46
2008-02-18 00:00:00.000,Buenos Aires Argentina ATP World Tour,CLAY,2,Juan Ignacio Chela,Thomaz Bellucci,Juan Ignacio Chela,6-4; 6-4,R16,74,0,3,29,52,24,29,14,23,1,2,10,38,52,1,1,35,52,21,35,11,17,0,3,10,32,52
2008-02-18 00:00:00.000,Buenos Aires Argentina ATP World Tour,CLAY,2,Nicolas Almagro,Oscar Hernandez,Nicolas Almagro,6-2; 2-6; 6-3,R16,128,7,1,67,98,46,67,15,31,11,13,13,61,98,0,2,44,68,26,44,16,24,3,6,12,42,68
2008-02-18 00:00:00.000,Buenos Aires Argentina ATP World Tour,CLAY,2,Igor Andreev,Jiri Vanek,Igor Andreev,6-1; 0-6; 6-4,R16,107,5,4,51,79,32,51,14,28,3,7,12,46,79,4,4,37,69,23,37,15,32,5,9,11,38,69
2008-02-18 00:00:00.000,Buenos Aires Argentina ATP World Tour,CLAY,2,Jose Acasuso,Daniel Gimeno-Traver,Jose Acasuso,6-3; 6-4,R16,79,2,1,40,58,32,40,11,18,1,1,10,43,58,1,2,26,48,19,26,13,22,1,3,9,32,48
2008-02-18 00:00:00.000,Buenos Aires Argentina ATP World Tour,CLAY,2,Filippo Volandri,Sergio Roitman,Filippo Volandri,7-5; 7-5,R16,105,1,1,69,85,42,69,9,16,11,14,12,51,85,4,2,47,77,28,47,13,30,6,11,12,41,77
2008-02-18 00:00:00.000,Buenos Aires Argentina ATP World Tour,CLAY,2,Agustin Calleri,Luis Horna,Agustin Calleri,3-6; 6-2; 6-2,R16,108,10,1,41,66,30,41,16,25,5,7,12,46,66,2,3,82,94,49,82,4,12,6,11,13,53,94
2008-02-18 00:00:00.000,Buenos Aires Argentina ATP World Tour,CLAY,2,David Nalbandian,Potito Starace,David Nalbandian,4-6; 7-6(5); 6-4,Q,157,6,6,52,105,38,52,28,53,3,7,16,66,105,1,1,100,108,63,100,3,8,6,10,16,66,108
2008-02-18 00:00:00.000,Buenos Aires Argentina ATP World Tour,CLAY,2,Juan Ignacio Chela,Nicolas Almagro,Juan Ignacio Chela,6-3; 2-1 RET,Q,65,3,0,29,50,18,29,13,21,5,6,6,31,50,2,0,19,40,9,19,11,21,0,3,6,20,40
2008-02-18 00:00:00.000,Buenos Aires Argentina ATP World Tour,CLAY,2,Jose Acasuso,Igor Andreev,Jose Acasuso,3-6; 6-1; 6-3,Q,125,4,1,45,78,28,45,21,33,3,5,12,49,78,4,2,74,93,46,74,6,19,4,9,13,52,93
2008-02-18 00:00:00.000,Buenos Aires Argentina ATP World Tour,CLAY,2,Filippo Volandri,Agustin Calleri,Filippo Volandri,6-4; 6-4,Q,81,1,0,62,84,41,62,12,22,11,11,10,53,84,9,0,44,56,33,44,4,12,2,4,10,37,56
2008-02-18 00:00:00.000,Buenos Aires Argentina ATP World Tour,CLAY,2,David Nalbandian,Juan Ignacio Chela,David Nalbandian,6-1; 6-2,S,58,1,2,21,41,16,21,16,20,0,0,8,32,41,3,4,18,39,9,18,8,21,1,5,7,17,39
2008-02-18 00:00:00.000,Buenos Aires Argentina ATP World Tour,CLAY,2,Jose Acasuso,Filippo Volandri,Jose Acasuso,4-6; 6-4; 6-4,S,143,6,3,53,89,39,53,15,36,3,7,15,54,89,0,5,87,100,53,87,4,13,8,13,15,57,100
2008-02-18 00:00:00.000,Buenos Aires Argentina ATP World Tour,CLAY,2,David Nalbandian,Jose Acasuso,David Nalbandian,3-6; 7-6(5); 6-4,F,163,2,2,59,98,40,59,24,39,4,7,15,64,98,6,1,51,104,36,51,29,53,2,5,16,65,104
2008-02-18 00:00:00.000,Rotterdam The Netherlands ATP World Tour,HARD,2,Rafael Nadal,Dmitry Tursunov,Rafael Nadal,6-4; 6-4,R32,84,2,1,35,52,29,35,11,17,0,0,10,40,52,9,2,29,62,24,29,16,33,1,3,10,40,62
2008-02-18 00:00:00.000,Rotterdam The Netherlands ATP World Tour,HARD,2,Andreas Seppi,Lleyton Hewitt,Andreas Seppi,3-6; 7-6(4); 7-6(4),R32,173,10,2,68,129,50,68,28,61,13,18,17,78,129,7,4,49,104,37,49,30,55,5,8,16,67,104
2008-02-18 00:00:00.000,Rotterdam The Netherlands ATP World Tour,HARD,2,Fernando Verdasco,Jarkko Nieminen,Fernando Verdasco,6-2; 6-2,R32,68,2,2,25,40,20,25,10,15,0,1,8,30,40,2,2,37,63,19,37,10,26,10,15,8,29,63
2008-02-18 00:00:00.000,Rotterdam The Netherlands ATP World Tour,HARD,2,Robin Soderling,Marcos Baghdatis,Robin Soderling,6-3; 3-6; 6-4,R32,104,10,2,45,81,35,45,23,36,2,3,14,58,81,13,1,44,75,34,44,17,31,0,2,14,51,75
2008-02-18 00:00:00.000,Rotterdam The Netherlands ATP World Tour,HARD,2,Janko Tipsarevic,Mikhail Youzhny,Janko Tipsarevic,7-6(3); 6-4,R32,107,7,3,41,75,30,41,22,34,7,8,11,52,75,4,2,37,63,30,37,15,26,3,5,11,45,63
2008-02-18 00:00:00.000,Rotterdam The Netherlands ATP World Tour,HARD,2,Gilles Simon,Feliciano Lopez,Gilles Simon,6-3; 6-4,R32,91,1,0,34,56,25,34,14,22,0,1,10,39,56,7,4,38,62,23,38,11,24,5,8,9,34,62
2008-02-18 00:00:00.000,Rotterdam The Netherlands ATP World Tour,HARD,2,Nicolas Mahut,Tommy Robredo,Nicolas Mahut,7-5; 6-4,R32,95,8,2,37,63,33,37,14,26,1,1,11,47,63,9,0,36,54,30,36,10,18,1,3,11,40,54
2008-02-18 00:00:00.000,Rotterdam The Netherlands ATP World Tour,HARD,2,Teymuraz Gabashvili,Juan Carlos Ferrero,Teymuraz Gabashvili,7-5; 6-1,R32,75,4,0,37,66,30,37,16,29,1,1,10,46,66,4,2,29,46,22,29,9,17,4,7,9,31,46
2008-02-18 00:00:00.000,Rotterdam The Netherlands ATP World Tour,HARD,2,Tomas Berdych,Ivan Ljubicic,Tomas Berdych,6-3; 6-3,R32,66,5,2,21,41,20,21,16,20,0,0,9,36,41,9,4,38,58,29,38,5,20,3,6,9,34,58
2008-02-18 00:00:00.000,Rotterdam The Netherlands ATP World Tour,HARD,2,Ivo Karlovic,Olivier Rochus,Ivo Karlovic,6-1; 6-2,R32,64,12,0,25,46,21,25,14,21,3,3,8,35,46,0,2,26,47,15,26,8,21,1,5,7,23,47
2008-02-18 00:00:00.000,Rotterdam The Netherlands ATP World Tour,HARD,2,Mischa Zverev,Philipp Kohlschreiber,Mischa Zverev,7-5; 7-5,R32,90,4,0,50,66,34,50,10,16,3,6,12,44,66,1,4,54,79,30,54,12,25,6,11,12,42,79
2008-02-18 00:00:00.000,Rotterdam The Netherlands ATP World Tour,HARD,2,David Ferrer,Simone Bolelli,David Ferrer,6-4; 7-5,R32,96,5,0,43,59,34,43,12,16,1,1,11,46,59,2,0,44,71,30,44,14,27,3,5,11,44,71
2008-02-18 00:00:00.000,Rotterdam The Netherlands ATP World Tour,HARD,2,Robin Haase,Andy Murray,Robin Haase,7-5; 6-3,R32,89,2,2,34,60,27,34,19,26,2,2,11,46,60,7,1,41,72,30,41,14,31,9,11,10,44,72
2008-02-18 00:00:00.000,Rotterdam The Netherlands ATP World Tour,HARD,2,Michael Berrer,Matthias Bachinger,Michael Berrer,6-3; 6-2,R32,62,2,1,28,54,23,28,15,26,4,4,9,38,54,2,2,16,37,13,16,10,21,1,4,8,23,37
2008-02-18 00:00:00.000,Rotterdam The Netherlands ATP World Tour,HARD,2,Michael Llodra,Raemon Sluiter,Michael Llodra,6-1; 7-6(6),R32,82,11,1,36,59,32,36,14,23,0,0,10,46,59,7,0,36,59,25,36,11,23,2,4,9,36,59
2008-02-18 00:00:00.000,Rotterdam The Netherlands ATP World Tour,HARD,2,Nikolay Davydenko,Jan Hernych,Nikolay Davydenko,6-3; 6-3,R32,76,2,1,28,45,24,28,9,17,0,1,9,33,45,0,1,51,67,28,51,8,16,3,7,9,36,67
2008-02-18 00:00:00.000,Rotterdam The Netherlands ATP World Tour,HARD,2,Andreas Seppi,Rafael Nadal,Andreas Seppi,3-6; 6-3; 6-4,R16,135,8,4,53,82,39,53,15,29,7,10,14,54,82,1,2,53,78,35,53,13,25,4,8,14,48,78
2008-02-18 00:00:00.000,Rotterdam The Netherlands ATP World Tour,HARD,2,Robin Soderling,Fernando Verdasco,Robin Soderling,6-4; 6-1,R16,69,11,1,35,48,29,35,8,13,3,3,9,37,48,6,2,37,56,22,37,10,19,3,6,8,32,56
2008-02-18 00:00:00.000,Rotterdam The Netherlands ATP World Tour,HARD,2,Gilles Simon,Janko Tipsarevic,Gilles Simon,7-6(4); 7-6(4),R16,129,8,1,52,76,37,52,10,24,2,6,12,47,76,10,2,61,108,40,61,19,47,6,10,12,59,108
2008-02-18 00:00:00.000,Rotterdam The Netherlands ATP World Tour,HARD,2,Teymuraz Gabashvili,Nicolas Mahut,Teymuraz Gabashvili,6-2; 7-6(7),R16,88,7,2,47,76,36,47,18,29,0,0,10,54,76,9,2,40,66,32,40,12,26,4,6,10,44,66
2008-02-18 00:00:00.000,Rotterdam The Netherlands ATP World Tour,HARD,2,Ivo Karlovic,Tomas Berdych,Ivo Karlovic,6-4; 6-4,R16,85,17,1,29,47,27,29,13,18,0,0,10,40,47,5,4,46,85,35,46,16,39,9,11,10,51,85
2008-02-18 00:00:00.000,Rotterdam The Netherlands ATP World Tour,HARD,2,Mischa Zverev,David Ferrer,Mischa Zverev,6-2; 7-5,R16,85,1,1,51,65,33,51,9,14,1,2,10,42,65,0,2,46,71,29,46,11,25,6,10,10,40,71
2008-02-18 00:00:00.000,Rotterdam The Netherlands ATP World Tour,HARD,2,Robin Haase,Michael Berrer,Robin Haase,5-7; 6-3; 6-3,R16,130,8,3,55,82,44,55,14,27,6,8,15,58,82,9,2,84,114,58,84,9,30,8,12,15,67,114
2008-02-18 00:00:00.000,Rotterdam The Netherlands ATP World Tour,HARD,2,Michael Llodra,Nikolay Davydenko,Michael Llodra,6-3; 7-5,R16,92,7,2,44,75,32,44,17,31,7,8,11,49,75,4,1,44,56,30,44,4,12,0,3,10,34,56
2008-02-18 00:00:00.000,Rotterdam The Netherlands ATP World Tour,HARD,2,Robin Soderling,Andreas Seppi,Robin Soderling,6-3; 6-2,Q,64,10,1,32,51,27,32,12,19,1,1,9,39,51,6,1,30,51,17,30,11,21,2,5,8,28,51
2008-02-18 00:00:00.000,Rotterdam The Netherlands ATP World Tour,HARD,2,Gilles Simon,Teymuraz Gabashvili,Gilles Simon,6-3; 6-2,Q,82,4,1,34,62,27,34,16,28,8,8,9,43,62,1,0,40,65,28,40,9,25,9,12,8,37,65
2008-02-18 00:00:00.000,Rotterdam The Netherlands ATP World Tour,HARD,2,Ivo Karlovic,Mischa Zverev,Ivo Karlovic,6-3; 6-1,Q,54,15,1,34,43,31,34,4,9,4,4,8,35,43,0,1,42,54,26,42,3,12,6,10,8,29,54
2008-02-18 00:00:00.000,Rotterdam The Netherlands ATP World Tour,HARD,2,Michael Llodra,Robin Haase,Michael Llodra,7-6(5); 7-6(5),Q,98,13,3,49,78,42,49,19,29,2,2,12,61,78,7,0,62,82,44,62,13,20,2,2,12,57,82
2008-02-18 00:00:00.000,Rotterdam The Netherlands ATP World Tour,HARD,2,Robin Soderling,Gilles Simon,Robin Soderling,6-2; 6-1,S,51,4,1,25,35,22,25,6,10,0,0,7,28,35,3,0,33,50,17,33,6,17,0,5,8,23,50
2008-02-18 00:00:00.000,Rotterdam The Netherlands ATP World Tour,HARD,2,Michael Llodra,Ivo Karlovic,Michael Llodra,7-5; 7-6(4),S,86,5,1,48,68,41,48,15,20,1,1,12,56,68,16,1,55,70,46,55,7,15,2,3,12,53,70
2008-02-18 00:00:00.000,Rotterdam The Netherlands ATP World Tour,HARD,2,Michael Llodra,Robin Soderling,Michael Llodra,6-7(3); 6-3; 7-6(4),F,129,15,3,61,107,51,61,26,46,2,3,17,77,107,22,2,63,93,50,63,20,30,1,3,16,70,93
2008-02-18 00:00:00.000,San Jose CA; U.S.A. ATP World Tour,HARD,2,Andy Roddick,Chris Guccione,Andy Roddick,6-3; 6-7(3); 7-6(5),R32,100,9,3,65,91,55,65,20,26,0,0,17,75,91,20,2,62,94,52,62,19,32,1,2,16,71,94
2008-02-18 00:00:00.000,San Jose CA; U.S.A. ATP World Tour,HARD,2,Kei Nishikori,Diego Hartfield,Kei Nishikori,7-5; 6-3,R32,74,2,3,29,56,24,29,9,27,2,5,10,33,56,0,3,38,60,19,38,10,22,2,8,11,29,60
2008-02-18 00:00:00.000,San Jose CA; U.S.A. ATP World Tour,HARD,2,Mardy Fish,Tim Smyczek,Mardy Fish,6-3; 6-4,R32,75,8,3,33,63,24,33,15,30,3,5,10,39,63,1,2,42,67,22,42,12,25,8,12,9,34,67
2008-02-18 00:00:00.000,San Jose CA; U.S.A. ATP World Tour,HARD,2,Denis Gremelmayr,Sam Querrey,Denis Gremelmayr,5-7; 7-6(1); 6-3,R32,114,5,2,51,92,38,51,22,41,3,7,17,60,92,7,3,51,89,37,51,20,38,1,5,16,57,89
2008-02-18 00:00:00.000,San Jose CA; U.S.A. ATP World Tour,HARD,2,Tommy Haas,Robert Kendrick,Tommy Haas,6-3; 4-6; 6-2,R32,107,6,4,55,89,41,55,19,34,5,7,14,60,89,11,4,54,91,39,54,13,37,5,9,13,52,91
2008-02-18 00:00:00.000,San Jose CA; U.S.A. ATP World Tour,HARD,2,John Isner,Florent Serra,John Isner,7-6(5); 6-4,R32,69,15,5,41,62,37,41,13,21,2,2,11,50,62,6,2,35,66,28,35,19,31,3,4,11,47,66
2008-02-18 00:00:00.000,San Jose CA; U.S.A. ATP World Tour,HARD,2,Benjamin Becker,Marcos Daniel,Benjamin Becker,6-1; 3-0 RET,R32,42,1,3,13,33,10,13,13,20,2,2,5,23,33,1,2,18,36,10,18,6,18,4,8,5,16,36
2008-02-18 00:00:00.000,San Jose CA; U.S.A. ATP World Tour,HARD,2,Guillermo Garcia-Lopez,Jurgen Melzer,Guillermo Garcia-Lopez,6-2; 6-7(5); 7-6(6),R32,162,3,6,58,122,43,58,33,64,3,6,16,76,122,7,3,62,107,43,62,22,45,7,12,16,65,107
2008-02-18 00:00:00.000,San Jose CA; U.S.A. ATP World Tour,HARD,2,Wayne Odesnik,Donald Young,Wayne Odesnik,6-1; 5-7; 6-4,R32,100,1,0,54,68,41,54,9,14,1,3,14,50,68,5,6,48,87,34,48,17,39,0,5,15,51,87
2008-02-18 00:00:00.000,San Jose CA; U.S.A. ATP World Tour,HARD,2,Yen-Hsun Lu,Max Mirnyi,Yen-Hsun Lu,7-6(4); 5-7; 6-2,R32,154,6,8,78,126,54,78,28,48,15,16,16,82,126,17,4,61,107,47,61,23,46,7,9,16,70,107
2008-02-18 00:00:00.000,San Jose CA; U.S.A. ATP World Tour,HARD,2,Bobby Reynolds,Benedikt Dorsch,Bobby Reynolds,7-5; 6-4,R32,81,13,2,40,61,30,40,16,21,1,1,11,46,61,3,1,41,66,28,41,14,25,1,3,11,42,66
2008-02-18 00:00:00.000,San Jose CA; U.S.A. ATP World Tour,HARD,2,Radek Stepanek,Paul Capdeville,Radek Stepanek,7-6(2); 6-1,R32,76,12,3,43,60,35,43,10,17,0,0,10,45,60,2,5,26,59,17,26,18,33,0,2,9,35,59
2008-02-18 00:00:00.000,San Jose CA; U.S.A. ATP World Tour,HARD,2,Kristof Vliegen,Victor Hanescu,Kristof Vliegen,6-4; 7-6(4),R32,81,14,0,40,61,34,40,12,21,0,1,11,46,61,6,4,52,74,36,52,12,22,5,7,11,48,74
2008-02-18 00:00:00.000,San Jose CA; U.S.A. ATP World Tour,HARD,2,Robby Ginepri,Jesse Witten,Robby Ginepri,6-2; 5-7; 6-4,R32,99,6,2,63,87,44,63,12,24,3,6,15,56,87,4,4,46,85,30,46,19,39,0,5,15,49,85
2008-02-18 00:00:00.000,San Jose CA; U.S.A. ATP World Tour,HARD,2,Jesse Levine,Steve Darcis,Jesse Levine,6-3; 2-6; 6-4,R32,126,9,5,49,90,34,49,18,41,7,11,13,52,90,12,7,62,112,42,62,19,50,11,16,14,61,112
2008-02-18 00:00:00.000,San Jose CA; U.S.A. ATP World Tour,HARD,2,James Blake,Sam Warburg,James Blake,6-3; 6-1,R32,55,9,6,23,44,20,23,12,21,0,0,8,32,44,3,4,27,44,18,27,5,17,1,5,8,23,44
2008-02-18 00:00:00.000,San Jose CA; U.S.A. ATP World Tour,HARD,2,Andy Roddick,Kei Nishikori,Andy Roddick,6-2; 6-4,R16,64,7,1,38,53,28,38,9,15,1,2,9,37,53,2,2,35,58,19,35,12,23,4,8,9,31,58
2008-02-18 00:00:00.000,San Jose CA; U.S.A. ATP World Tour,HARD,2,Mardy Fish,Denis Gremelmayr,Mardy Fish,6-7(4); 6-3; 6-3,R16,107,19,2,51,81,43,51,22,30,2,2,15,65,81,7,2,62,98,46,62,16,36,9,12,15,62,98
2008-02-18 00:00:00.000,San Jose CA; U.S.A. ATP World Tour,HARD,2,John Isner,Tommy Haas,John Isner,4-6; 7-6(6); 6-3,R16,120,22,5,69,97,54,69,16,28,2,4,16,70,97,9,3,67,98,46,67,20,31,8,10,15,66,98
2008-02-18 00:00:00.000,San Jose CA; U.S.A. ATP World Tour,HARD,2,Guillermo Garcia-Lopez,Benjamin Becker,Guillermo Garcia-Lopez,3-6; 7-6(3); 6-4,R16,142,7,5,56,86,43,56,11,30,0,3,15,54,86,16,4,65,123,48,65,25,58,9,12,16,73,123
2008-02-18 00:00:00.000,San Jose CA; U.S.A. ATP World Tour,HARD,2,Yen-Hsun Lu,Wayne Odesnik,Yen-Hsun Lu,6-4; 6-4,R16,93,5,3,42,66,31,42,14,24,4,5,10,45,66,6,2,35,57,26,35,10,22,5,8,10,36,57
2008-02-18 00:00:00.000,San Jose CA; U.S.A. ATP World Tour,HARD,2,Radek Stepanek,Bobby Reynolds,Radek Stepanek,7-5; 7-6(5),R16,92,16,1,44,68,38,44,16,24,2,3,12,54,68,6,2,48,77,39,48,14,29,1,3,12,53,77
2008-02-18 00:00:00.000,San Jose CA; U.S.A. ATP World Tour,HARD,2,Robby Ginepri,Kristof Vliegen,Robby Ginepri,6-2; 6-3,R16,68,3,1,28,54,25,28,14,26,3,3,8,39,54,6,2,40,61,24,40,8,21,7,11,9,32,61
2008-02-18 00:00:00.000,San Jose CA; U.S.A. ATP World Tour,HARD,2,James Blake,Jesse Levine,James Blake,6-3; 6-4,R16,64,9,2,36,64,28,36,17,28,5,5,10,45,64,4,1,26,49,17,26,15,23,1,3,9,32,49
2008-02-18 00:00:00.000,San Jose CA; U.S.A. ATP World Tour,HARD,2,Andy Roddick,Mardy Fish,Andy Roddick,7-6(6); 1-6; 7-5,Q,117,14,1,62,90,43,62,19,28,5,7,15,62,90,28,3,55,103,43,55,26,48,1,2,16,69,103
2008-02-18 00:00:00.000,San Jose CA; U.S.A. ATP World Tour,HARD,2,Guillermo Garcia-Lopez,John Isner,Guillermo Garcia-Lopez,7-6(4); 6-7(1); 7-6(11),Q,188,6,3,84,135,65,84,31,51,5,5,18,96,135,22,3,91,121,73,91,18,30,2,2,18,91,121
2008-02-18 00:00:00.000,San Jose CA; U.S.A. ATP World Tour,HARD,2,Radek Stepanek,Yen-Hsun Lu,Radek Stepanek,6-2; 7-6(5),Q,102,7,3,41,63,31,41,14,22,2,2,10,45,63,5,5,50,82,32,50,16,32,3,5,10,48,82
2008-02-18 00:00:00.000,San Jose CA; U.S.A. ATP World Tour,HARD,2,Robby Ginepri,James Blake,Robby Ginepri,6-2; 6-2,Q,51,4,2,24,43,17,24,13,19,0,1,8,30,43,6,4,28,52,19,28,6,24,8,13,8,25,52
2008-02-18 00:00:00.000,San Jose CA; U.S.A. ATP World Tour,HARD,2,Andy Roddick,Guillermo Garcia-Lopez,Andy Roddick,7-6(2); 6-1,S,93,16,3,44,63,37,44,9,19,1,1,9,46,63,4,2,43,71,25,43,16,28,9,12,10,41,71
2008-02-18 00:00:00.000,San Jose CA; U.S.A. ATP World Tour,HARD,2,Radek Stepanek,Robby Ginepri,Radek Stepanek,6-7(5); 6-4; 6-1,S,122,12,1,57,80,50,57,12,23,3,3,14,62,80,5,1,59,98,37,59,22,39,0,4,15,59,98
2008-02-18 00:00:00.000,San Jose CA; U.S.A. ATP World Tour,HARD,2,Andy Roddick,Radek Stepanek,Andy Roddick,6-4; 7-5,F,80,13,2,40,58,33,40,12,18,0,0,11,45,58,7,3,46,70,35,46,9,24,3,5,11,44,70
2008-02-25 00:00:00.000,Acapulco Mexico ATP World Tour,CLAY,2,David Nalbandian,Boris Pashanski,David Nalbandian,6-2; 7-5,R32,85,9,1,38,66,25,38,15,28,3,5,10,40,66,5,0,46,64,25,46,9,18,1,6,10,34,64
2008-02-25 00:00:00.000,Acapulco Mexico ATP World Tour,CLAY,2,Santiago Ventura,Cesar Ramirez,Santiago Ventura,6-3; 6-1,R32,74,0,1,31,62,23,31,18,31,5,5,8,41,62,0,2,30,49,16,30,11,19,6,10,8,27,49
2008-02-25 00:00:00.000,Acapulco Mexico ATP World Tour,CLAY,2,Peter Luczak,Sergio Roitman,Peter Luczak,6-3; 6-4,R32,81,3,1,40,57,30,40,11,17,4,5,10,41,57,3,1,24,50,17,24,13,26,2,5,9,30,50
2008-02-25 00:00:00.000,Acapulco Mexico ATP World Tour,CLAY,2,Potito Starace,Nicolas Lapentti,Potito Starace,6-4; 6-2,R32,91,5,1,38,55,26,38,10,17,4,5,9,36,55,3,4,30,61,18,30,13,31,8,12,9,31,61
2008-02-25 00:00:00.000,Acapulco Mexico ATP World Tour,CLAY,2,Juan Monaco,Juan Pablo Brzezicki,Juan Monaco,6-3; 2-6; 6-3,R32,112,4,1,53,73,34,53,14,20,5,8,13,48,73,5,0,58,82,36,58,11,24,6,10,13,47,82
2008-02-25 00:00:00.000,Acapulco Mexico ATP World Tour,CLAY,2,Luis Horna,Fabio Fognini,Luis Horna,6-4; 7-5,R32,89,8,2,47,67,34,47,10,20,3,5,11,44,67,2,3,41,65,23,41,16,24,2,6,11,39,65
2008-02-25 00:00:00.000,Acapulco Mexico ATP World Tour,CLAY,2,Agustin Calleri,Bruno Echagaray,Agustin Calleri,6-4; 6-1,R32,85,8,4,31,57,24,31,12,26,1,2,8,36,57,0,2,39,65,21,39,10,26,7,12,9,31,65
2008-02-25 00:00:00.000,Acapulco Mexico ATP World Tour,CLAY,2,Juan Ignacio Chela,Pablo Cuevas,Juan Ignacio Chela,7-6(4); 6-4,R32,97,2,4,34,72,22,34,22,38,2,4,11,44,72,1,1,41,68,24,41,16,27,2,5,11,40,68
2008-02-25 00:00:00.000,Acapulco Mexico ATP World Tour,CLAY,2,Albert Montanes,Igor Andreev,Albert Montanes,7-6(4); 6-3,R32,104,2,5,44,77,29,44,17,33,3,6,10,46,77,4,3,44,65,30,44,4,21,1,6,11,34,65
2008-02-25 00:00:00.000,Acapulco Mexico ATP World Tour,CLAY,2,Marcel Granollers,Bruno Rodriguez,Marcel Granollers,6-3; 6-3,R32,91,4,4,29,54,24,29,12,25,0,1,9,36,54,1,2,36,65,24,36,10,29,6,10,9,34,65
2008-02-25 00:00:00.000,Acapulco Mexico ATP World Tour,CLAY,2,Jose Acasuso,Oscar Hernandez,Jose Acasuso,6-4; 6-0,R32,72,4,2,22,38,19,22,8,16,2,4,8,27,38,1,2,39,56,17,39,6,17,4,10,8,23,56
2008-02-25 00:00:00.000,Acapulco Mexico ATP World Tour,CLAY,2,Guillermo Canas,Carlos Berlocq,Guillermo Canas,6-4; 6-7(5); 6-4,R32,192,1,4,74,113,49,74,19,39,6,10,16,68,113,9,3,63,110,43,63,18,47,8,14,16,61,110
2008-02-25 00:00:00.000,Acapulco Mexico ATP World Tour,CLAY,2,Nicolas Almagro,Jiri Vanek,Nicolas Almagro,6-1; 6-2,R32,54,13,3,25,45,23,25,11,20,1,1,8,34,45,4,3,37,62,24,37,5,25,6,10,7,29,62
2008-02-25 00:00:00.000,Acapulco Mexico ATP World Tour,CLAY,2,Filippo Volandri,Ivo Minar,Filippo Volandri,6-4; 7-5,R32,68,1,0,33,54,28,33,12,21,2,4,11,40,54,5,0,51,68,28,51,10,17,3,7,11,38,68
2008-02-25 00:00:00.000,Acapulco Mexico ATP World Tour,CLAY,2,Nicolas Massu,Martin Vassallo Arguello,Nicolas Massu,6-3; 6-4,R32,117,4,2,34,58,26,34,12,24,1,3,10,38,58,1,3,53,75,29,53,10,22,5,9,9,39,75
2008-02-25 00:00:00.000,Acapulco Mexico ATP World Tour,CLAY,2,Carlos Moya,Werner Eschauer,Carlos Moya,6-4; 6-4,R32,77,5,2,33,52,29,33,8,19,2,4,10,37,52,1,3,39,65,23,39,10,26,1,5,10,33,65
2008-02-25 00:00:00.000,Acapulco Mexico ATP World Tour,CLAY,2,David Nalbandian,Santiago Ventura,David Nalbandian,6-2; 6-3,R16,74,4,3,27,54,18,27,16,27,5,7,8,34,54,3,1,29,53,12,29,8,24,1,7,9,20,53
2008-02-25 00:00:00.000,Acapulco Mexico ATP World Tour,CLAY,2,Potito Starace,Peter Luczak,Potito Starace,6-3; 6-3,R16,99,1,1,39,51,28,39,7,12,1,2,9,35,51,3,2,49,77,29,49,11,28,10,14,9,40,77
2008-02-25 00:00:00.000,Acapulco Mexico ATP World Tour,CLAY,2,Luis Horna,Juan Monaco,Luis Horna,7-6(4); 6-3,R16,93,2,1,44,65,34,44,13,21,0,1,11,47,65,1,0,42,58,28,42,11,16,2,4,10,39,58
2008-02-25 00:00:00.000,Acapulco Mexico ATP World Tour,CLAY,2,Agustin Calleri,Juan Ignacio Chela,Agustin Calleri,7-6(4); 2-6; 6-1,R16,125,8,4,52,85,37,52,12,33,4,9,13,49,85,2,6,59,101,35,59,19,42,6,12,14,54,101
2008-02-25 00:00:00.000,Acapulco Mexico ATP World Tour,CLAY,2,Marcel Granollers,Albert Montanes,Marcel Granollers,6-2; 7-6(6),R16,91,4,2,44,76,31,44,18,32,5,6,10,49,76,1,2,41,56,31,41,6,15,3,6,10,37,56
2008-02-25 00:00:00.000,Acapulco Mexico ATP World Tour,CLAY,2,Jose Acasuso,Guillermo Canas,Jose Acasuso,4-6; 6-2; 6-2,R16,140,4,6,43,92,32,43,26,49,15,17,13,58,92,1,2,50,85,32,50,15,35,5,10,13,47,85
2008-02-25 00:00:00.000,Acapulco Mexico ATP World Tour,CLAY,2,Nicolas Almagro,Filippo Volandri,Nicolas Almagro,6-3; 6-3,R16,70,12,3,30,55,25,30,13,25,4,5,9,38,55,1,0,46,58,24,46,6,12,2,6,9,30,58
2008-02-25 00:00:00.000,Acapulco Mexico ATP World Tour,CLAY,2,Nicolas Massu,Carlos Moya,Nicolas Massu,6-4; 6-2,R16,99,2,2,37,60,30,37,13,23,1,1,9,43,60,4,2,45,66,28,45,9,21,6,9,9,37,66
2008-02-25 00:00:00.000,Acapulco Mexico ATP World Tour,CLAY,2,David Nalbandian,Potito Starace,David Nalbandian,6-3; 6-3,Q,77,4,1,37,53,30,37,10,16,3,3,9,40,53,2,2,44,65,27,44,10,21,6,9,9,37,65
2008-02-25 00:00:00.000,Acapulco Mexico ATP World Tour,CLAY,2,Luis Horna,Agustin Calleri,Luis Horna,6-4; 3-6; 6-3,Q,113,6,2,58,80,45,58,11,22,0,1,14,56,80,14,0,54,85,41,54,16,31,6,8,14,57,85
2008-02-25 00:00:00.000,Acapulco Mexico ATP World Tour,CLAY,2,Jose Acasuso,Marcel Granollers,Jose Acasuso,7-6(2); 6-3,Q,110,5,3,40,77,28,40,22,37,7,9,11,50,77,6,5,35,70,26,35,14,35,7,10,10,40,70
2008-02-25 00:00:00.000,Acapulco Mexico ATP World Tour,CLAY,2,Nicolas Almagro,Nicolas Massu,Nicolas Almagro,4-6; 6-3; 6-3,Q,119,11,2,57,74,47,57,9,17,3,4,14,56,74,3,0,62,85,41,62,11,23,2,5,14,52,85
2008-02-25 00:00:00.000,Acapulco Mexico ATP World Tour,CLAY,2,David Nalbandian,Luis Horna,David Nalbandian,7-5; 6-1,S,81,8,2,31,51,26,31,12,20,1,1,9,38,51,4,4,42,63,26,42,8,21,4,8,10,34,63
2008-02-25 00:00:00.000,Acapulco Mexico ATP World Tour,CLAY,2,Nicolas Almagro,Jose Acasuso,Nicolas Almagro,6-4; 3-6; 7-5,S,133,12,2,56,94,43,56,18,38,6,8,15,61,94,4,2,58,91,44,58,17,33,5,8,16,61,91
2008-02-25 00:00:00.000,Acapulco Mexico ATP World Tour,CLAY,2,Nicolas Almagro,David Nalbandian,Nicolas Almagro,6-1; 7-6(1),F,85,11,1,37,63,31,37,16,26,2,2,10,47,63,3,3,33,65,19,33,18,32,4,6,9,37,65
2008-02-25 00:00:00.000,Memphis TN; U.S.A. ATP World Tour,HARD,2,Andy Roddick,Gilles Muller,Andy Roddick,6-4; 7-6(4),R32,77,17,0,47,62,41,47,9,15,0,0,11,50,62,18,1,57,69,42,57,6,12,2,3,11,48,69
2008-02-25 00:00:00.000,Memphis TN; U.S.A. ATP World Tour,HARD,2,Mardy Fish,Bobby Reynolds,Mardy Fish,6-7(3); 6-4; 6-2,R32,119,16,2,47,85,39,47,25,38,0,0,15,64,85,14,3,74,104,53,74,13,30,4,7,15,66,104
2008-02-25 00:00:00.000,Memphis TN; U.S.A. ATP World Tour,HARD,2,Victor Hanescu,Yen-Hsun Lu,Victor Hanescu,6-3; 2-1 RET,R32,51,10,1,28,39,23,28,6,11,2,2,6,29,39,2,1,26,37,15,26,6,11,1,3,6,21,37
2008-02-25 00:00:00.000,Memphis TN; U.S.A. ATP World Tour,HARD,2,Robin Soderling,Frederic Niemeyer,Robin Soderling,6-2; 6-1,R32,47,16,4,34,50,28,34,8,16,2,2,8,36,50,5,2,29,44,15,29,6,15,5,9,7,21,44
2008-02-25 00:00:00.000,Memphis TN; U.S.A. ATP World Tour,HARD,2,Radek Stepanek,Jesse Levine,Radek Stepanek,6-1; 6-4,R32,57,7,1,28,41,26,28,10,13,0,0,9,36,41,4,5,30,53,20,30,9,23,1,4,8,29,53
2008-02-25 00:00:00.000,Memphis TN; U.S.A. ATP World Tour,HARD,2,Florent Serra,Marcos Daniel,Florent Serra,6-1; 6-2,R32,49,2,0,33,44,26,33,8,11,0,0,8,34,44,4,2,30,46,18,30,3,16,3,7,7,21,46
2008-02-25 00:00:00.000,Memphis TN; U.S.A. ATP World Tour,HARD,2,Chris Guccione,Robert Kendrick,Chris Guccione,7-6(6); 7-6(5),R32,91,17,3,56,97,46,56,21,41,7,7,12,67,97,13,1,45,75,39,45,19,30,0,0,12,58,75
2008-02-25 00:00:00.000,Memphis TN; U.S.A. ATP World Tour,HARD,2,Thomas Johansson,Marat Safin,Thomas Johansson,7-6(5); 7-6(2),R32,102,18,3,50,82,40,50,17,32,4,5,12,57,82,12,3,57,90,38,57,19,33,5,6,12,57,90
2008-02-25 00:00:00.000,Memphis TN; U.S.A. ATP World Tour,HARD,2,Jurgen Melzer,John Isner,Jurgen Melzer,6-7(8); 6-3; 7-6(4),R32,120,19,3,69,97,63,69,16,28,1,1,17,79,97,18,8,68,107,51,68,22,39,0,1,16,73,107
2008-02-25 00:00:00.000,Memphis TN; U.S.A. ATP World Tour,HARD,2,Steve Darcis,Vincent Spadea,Steve Darcis,7-5; 4-6; 7-6(4),R32,119,9,1,58,101,39,58,26,43,6,10,17,65,101,8,4,68,101,50,68,14,33,4,8,17,64,101
2008-02-25 00:00:00.000,Memphis TN; U.S.A. ATP World Tour,HARD,2,Benjamin Becker,Kristof Vliegen,Benjamin Becker,7-5; 7-6(1),R32,97,7,2,48,83,36,48,19,35,6,8,12,55,83,9,2,44,78,29,44,17,34,3,6,12,46,78
2008-02-25 00:00:00.000,Memphis TN; U.S.A. ATP World Tour,HARD,2,Tommy Haas,Diego Hartfield,Tommy Haas,6-3; 6-2,R32,74,2,2,32,56,23,32,13,24,3,5,9,36,56,3,3,34,57,16,34,11,23,5,10,8,27,57
2008-02-25 00:00:00.000,Memphis TN; U.S.A. ATP World Tour,HARD,2,Sam Querrey,Michael Russell,Sam Querrey,3-6; 6-3; 7-5,R32,111,17,4,51,91,42,51,20,40,3,5,15,62,91,1,3,66,97,45,66,16,31,5,8,15,61,97
2008-02-25 00:00:00.000,Memphis TN; U.S.A. ATP World Tour,HARD,2,Jonas Bjorkman,Paul Capdeville,Jonas Bjorkman,6-3; 6-1,R32,53,9,1,28,43,26,28,7,15,0,0,8,33,43,0,0,31,50,18,31,8,19,3,7,8,26,50
2008-02-25 00:00:00.000,Memphis TN; U.S.A. ATP World Tour,HARD,2,Alejandro Falla,Dudi Sela,Alejandro Falla,6-4; 6-2,R32,70,4,2,37,56,28,37,11,19,4,5,9,39,56,0,5,29,59,21,29,9,30,6,10,9,30,59
2008-02-25 00:00:00.000,Memphis TN; U.S.A. ATP World Tour,HARD,2,Donald Young,Sam Warburg,Donald Young,6-4; 6-4,R32,81,5,0,40,62,32,40,13,22,4,4,10,45,62,10,4,53,74,35,53,9,21,5,7,10,44,74
2008-02-25 00:00:00.000,Memphis TN; U.S.A. ATP World Tour,HARD,2,Andy Roddick,Mardy Fish,Andy Roddick,6-4; 6-2,R16,61,14,0,34,44,29,34,8,10,2,2,9,37,44,8,2,23,55,17,23,15,32,0,3,9,32,55
2008-02-25 00:00:00.000,Memphis TN; U.S.A. ATP World Tour,HARD,2,Robin Soderling,Victor Hanescu,Robin Soderling,6-2; 6-1,R16,44,8,0,21,33,18,21,10,12,0,0,7,28,33,1,1,29,43,16,29,4,14,1,6,8,20,43
2008-02-25 00:00:00.000,Memphis TN; U.S.A. ATP World Tour,HARD,2,Radek Stepanek,Florent Serra,Radek Stepanek,7-6(6); 2-6; 7-5,R16,155,13,10,62,116,49,62,21,54,8,12,16,70,116,8,3,75,119,54,75,17,44,8,11,16,71,119
2008-02-25 00:00:00.000,Memphis TN; U.S.A. ATP World Tour,HARD,2,Chris Guccione,Thomas Johansson,Chris Guccione,6-3; 6-4,R16,56,15,0,26,47,26,26,14,21,0,0,10,40,47,4,2,23,53,17,23,17,30,3,5,9,34,53
2008-02-25 00:00:00.000,Memphis TN; U.S.A. ATP World Tour,HARD,2,Steve Darcis,Jurgen Melzer,Steve Darcis,6-3; 7-6(4),R16,77,6,1,47,67,35,47,15,20,2,3,11,50,67,6,0,47,71,35,47,10,24,1,3,10,45,71
2008-02-25 00:00:00.000,Memphis TN; U.S.A. ATP World Tour,HARD,2,Benjamin Becker,Tommy Haas,Benjamin Becker,3-6; 6-2; 7-5,R16,113,8,3,43,80,31,43,24,37,4,6,14,55,80,11,8,59,99,44,59,16,40,5,9,15,60,99
2008-02-25 00:00:00.000,Memphis TN; U.S.A. ATP World Tour,HARD,2,Jonas Bjorkman,Sam Querrey,Jonas Bjorkman,6-4; 4-6; 7-6(4),R16,117,3,2,62,100,47,62,23,38,1,2,16,70,100,26,2,59,94,52,59,17,35,3,4,16,69,94
2008-02-25 00:00:00.000,Memphis TN; U.S.A. ATP World Tour,HARD,2,Donald Young,Alejandro Falla,Donald Young,6-1; 1-6; 6-3,R16,93,5,5,56,92,36,56,16,36,10,14,12,52,92,4,4,56,77,29,56,10,21,7,12,11,39,77
2008-02-25 00:00:00.000,Memphis TN; U.S.A. ATP World Tour,HARD,2,Robin Soderling,Andy Roddick,Robin Soderling,7-6(6); 6-3,Q,86,16,1,37,55,32,37,14,18,0,0,10,46,55,15,2,63,90,45,63,11,27,8,10,11,56,90
2008-02-25 00:00:00.000,Memphis TN; U.S.A. ATP World Tour,HARD,2,Radek Stepanek,Chris Guccione,Radek Stepanek,7-6(4); 6-1,Q,69,5,1,40,54,33,40,12,14,0,0,10,45,54,12,1,48,67,32,48,8,19,5,7,9,40,67
2008-02-25 00:00:00.000,Memphis TN; U.S.A. ATP World Tour,HARD,2,Steve Darcis,Benjamin Becker,Steve Darcis,6-1; 6-0,Q,50,9,0,23,47,20,23,13,24,4,4,7,33,47,2,3,18,36,10,18,4,18,5,10,6,14,36
2008-02-25 00:00:00.000,Memphis TN; U.S.A. ATP World Tour,HARD,2,Jonas Bjorkman,Donald Young,Jonas Bjorkman,1-6; 6-2; 7-6(6),Q,119,1,4,57,97,36,57,18,40,8,12,13,54,97,9,2,69,99,44,69,13,30,7,11,14,57,99
2008-02-25 00:00:00.000,Memphis TN; U.S.A. ATP World Tour,HARD,2,Robin Soderling,Radek Stepanek,Robin Soderling,7-6(2); 6-3,S,77,12,0,39,60,35,39,14,21,2,2,10,49,60,10,3,42,67,35,42,9,25,3,5,11,44,67
2008-02-25 00:00:00.000,Memphis TN; U.S.A. ATP World Tour,HARD,2,Steve Darcis,Jonas Bjorkman,Steve Darcis,4-6; 6-1; 6-4,S,107,7,3,49,83,40,49,18,34,2,3,14,58,83,6,2,57,89,39,57,15,32,8,11,13,54,89
2008-02-25 00:00:00.000,Memphis TN; U.S.A. ATP World Tour,HARD,2,Steve Darcis,Robin Soderling,Steve Darcis,6-3; 7-6(5),F,75,13,3,48,69,39,48,13,21,1,1,11,52,69,14,2,38,60,33,38,10,22,2,3,10,43,60
2008-02-25 00:00:00.000,Zagreb Croatia ATP World Tour,HARD,2,Ivan Ljubicic,Ernests Gulbis,Ivan Ljubicic,6-3; 7-6(7),R32,85,13,1,45,64,39,45,10,19,0,0,11,49,64,7,5,35,73,29,35,19,38,2,3,10,48,73
2008-02-25 00:00:00.000,Zagreb Croatia ATP World Tour,HARD,2,Lovro Zovko,Marc Gicquel,Lovro Zovko,6-3; 7-5,R32,75,10,1,27,59,24,27,17,32,3,4,10,41,59,3,3,37,64,26,37,11,27,6,10,11,37,64
2008-02-25 00:00:00.000,Zagreb Croatia ATP World Tour,HARD,2,Teymuraz Gabashvili,Florian Mayer,Teymuraz Gabashvili,7-6(6); 6-0,R32,65,7,2,35,51,29,35,8,16,0,1,9,37,51,3,1,37,59,21,37,10,22,1,5,9,31,59
2008-02-25 00:00:00.000,Zagreb Croatia ATP World Tour,HARD,2,Rik De Voest,Andreas Seppi,Rik De Voest,6-4; 7-6(3),R32,96,4,0,50,77,39,50,14,27,3,4,11,53,77,3,2,38,74,28,38,19,36,2,4,11,47,74
2008-02-25 00:00:00.000,Zagreb Croatia ATP World Tour,HARD,2,Gilles Simon,Pavol Cervenak,Gilles Simon,7-6(2); 6-1,R32,80,9,1,39,59,26,39,12,20,1,3,9,38,59,4,2,34,65,19,34,12,31,5,10,10,31,65
2008-02-25 00:00:00.000,Zagreb Croatia ATP World Tour,HARD,2,Robin Haase,Michael Berrer,Robin Haase,6-4; 6-3,R32,63,5,0,28,48,25,28,12,20,0,0,9,37,48,2,2,41,61,24,41,12,20,6,9,10,36,61
2008-02-25 00:00:00.000,Zagreb Croatia ATP World Tour,HARD,2,Denis Gremelmayr,Sebastien De Chaunac,Denis Gremelmayr,6-7(2); 6-1; 6-4,R32,115,3,0,63,87,46,63,16,24,2,3,15,62,87,7,1,37,78,28,37,23,41,0,4,14,51,78
2008-02-25 00:00:00.000,Zagreb Croatia ATP World Tour,HARD,2,Mario Ancic,Nicolas Mahut,Mario Ancic,7-6(3); 7-6(6),R32,105,16,1,55,78,49,55,11,23,0,1,12,60,78,16,2,54,79,39,54,16,25,1,2,12,55,79
2008-02-25 00:00:00.000,Zagreb Croatia ATP World Tour,HARD,2,Marin Cilic,Guillermo Garcia-Lopez,Marin Cilic,6-2; 6-2,R32,63,5,2,23,47,18,23,17,24,2,2,8,35,47,0,6,30,52,18,30,7,22,2,6,8,25,52
2008-02-25 00:00:00.000,Zagreb Croatia ATP World Tour,HARD,2,Simone Bolelli,Rainer Schuettler,Simone Bolelli,6-3; 6-2,R32,56,8,2,33,50,28,33,11,17,2,2,9,39,50,3,1,24,38,17,24,7,14,0,3,8,24,38
2008-02-25 00:00:00.000,Zagreb Croatia ATP World Tour,HARD,2,Stefan Koubek,Franko Skugor,Stefan Koubek,2-6; 7-6(2); 6-0,R32,117,7,2,48,79,33,48,17,31,9,13,13,50,79,6,4,36,91,30,36,19,55,4,9,13,49,91
2008-02-25 00:00:00.000,Zagreb Croatia ATP World Tour,HARD,2,Olivier Rochus,Fabrice Santoro,Olivier Rochus,6-3; 2-0 RET,R32,48,2,1,23,33,18,23,6,10,5,5,5,24,33,4,0,19,40,11,19,9,21,3,6,6,20,40
2008-02-25 00:00:00.000,Zagreb Croatia ATP World Tour,HARD,2,Janko Tipsarevic,Mischa Zverev,Janko Tipsarevic,6-3; 6-1,R32,52,11,0,24,42,21,24,11,18,0,0,8,32,42,5,2,27,43,14,27,6,16,2,6,8,20,43
2008-02-25 00:00:00.000,Zagreb Croatia ATP World Tour,HARD,2,Roko Karanusic,Blaz Kavcic,Roko Karanusic,6-7(9); 6-4; 6-4,R32,156,9,3,57,100,40,57,22,43,2,6,16,62,100,1,6,74,110,46,74,17,36,8,14,16,63,110
2008-02-25 00:00:00.000,Zagreb Croatia ATP World Tour,HARD,2,Viktor Troicki,George Bastl,Viktor Troicki,6-3; 7-6(3),R32,114,6,1,41,63,28,41,15,22,3,5,10,43,63,6,2,49,78,30,49,15,29,5,9,11,45,78
2008-02-25 00:00:00.000,Zagreb Croatia ATP World Tour,HARD,2,Sergiy Stakhovsky,Ivo Karlovic,Sergiy Stakhovsky,4-6; 7-6(5); 6-2,R32,139,10,1,62,109,46,62,27,47,6,7,15,73,109,14,3,75,106,54,75,15,31,8,10,15,69,106
2008-02-25 00:00:00.000,Zagreb Croatia ATP World Tour,HARD,2,Ivan Ljubicic,Lovro Zovko,Ivan Ljubicic,6-4; 7-6(3),R16,87,18,0,43,56,41,43,8,13,0,0,11,49,56,9,2,40,75,30,40,20,35,2,3,11,50,75
2008-02-25 00:00:00.000,Zagreb Croatia ATP World Tour,HARD,2,Teymuraz Gabashvili,Rik De Voest,Teymuraz Gabashvili,7-5; 6-1,R16,80,4,0,34,62,28,34,15,28,3,4,10,43,62,6,0,33,62,20,33,13,29,3,7,9,33,62
2008-02-25 00:00:00.000,Zagreb Croatia ATP World Tour,HARD,2,Robin Haase,Gilles Simon,Robin Haase,6-2; 6-4,R16,61,1,1,31,53,24,31,14,22,1,1,9,38,53,1,0,25,49,17,25,9,24,2,5,9,26,49
2008-02-25 00:00:00.000,Zagreb Croatia ATP World Tour,HARD,2,Mario Ancic,Denis Gremelmayr,Mario Ancic,6-3; 6-2,R16,74,7,0,30,44,27,30,9,14,0,0,9,36,44,2,1,31,64,18,31,16,33,9,12,8,34,64
2008-02-25 00:00:00.000,Zagreb Croatia ATP World Tour,HARD,2,Simone Bolelli,Marin Cilic,Simone Bolelli,6-4; 6-3,R16,72,9,1,37,56,32,37,11,19,1,1,10,43,56,8,2,29,53,24,29,9,24,1,3,9,33,53
2008-02-25 00:00:00.000,Zagreb Croatia ATP World Tour,HARD,2,Olivier Rochus,Stefan Koubek,Olivier Rochus,6-2; 6-4,R16,68,3,2,37,58,28,37,11,21,3,4,9,39,58,1,2,25,48,14,25,10,23,1,5,9,24,48
2008-02-25 00:00:00.000,Zagreb Croatia ATP World Tour,HARD,2,Janko Tipsarevic,Roko Karanusic,Janko Tipsarevic,6-3; 6-7(4); 6-4,R16,143,5,0,49,92,39,49,28,43,8,9,15,67,92,7,0,56,104,42,56,26,48,8,12,16,68,104
2008-02-25 00:00:00.000,Zagreb Croatia ATP World Tour,HARD,2,Sergiy Stakhovsky,Viktor Troicki,Sergiy Stakhovsky,7-6(7); 3-6; 6-4,R16,138,6,1,63,87,50,63,11,24,1,4,15,61,87,6,3,74,110,52,74,16,36,4,7,16,68,110
2008-02-25 00:00:00.000,Zagreb Croatia ATP World Tour,HARD,2,Ivan Ljubicic,Teymuraz Gabashvili,Ivan Ljubicic,6-2; 6-7(5); 6-3,Q,125,19,1,60,91,51,60,17,31,2,2,15,68,91,3,2,52,88,37,52,20,36,3,6,14,57,88
2008-02-25 00:00:00.000,Zagreb Croatia ATP World Tour,HARD,2,Mario Ancic,Robin Haase,Mario Ancic,6-3; 3-6; 6-3,Q,107,13,2,48,76,37,48,18,28,2,4,14,55,76,5,1,50,77,33,50,15,27,2,5,13,48,77
2008-02-25 00:00:00.000,Zagreb Croatia ATP World Tour,HARD,2,Simone Bolelli,Olivier Rochus,Simone Bolelli,7-6(5); 6-4,Q,92,4,0,54,74,38,54,12,20,4,5,11,50,74,4,2,38,59,26,38,14,21,0,2,11,40,59
2008-02-25 00:00:00.000,Zagreb Croatia ATP World Tour,HARD,2,Sergiy Stakhovsky,Janko Tipsarevic,Sergiy Stakhovsky,3-6; 6-4; 6-2,Q,108,7,4,54,90,39,54,18,36,5,7,14,57,90,5,3,38,68,31,38,14,30,0,3,13,45,68
2008-02-25 00:00:00.000,Zagreb Croatia ATP World Tour,HARD,2,Ivan Ljubicic,Mario Ancic,Ivan Ljubicic,7-6(2); 6-4,S,120,13,1,50,84,38,50,20,34,6,6,11,58,84,10,2,42,72,33,42,17,30,5,6,11,50,72
2008-02-25 00:00:00.000,Zagreb Croatia ATP World Tour,HARD,2,Sergiy Stakhovsky,Simone Bolelli,Sergiy Stakhovsky,6-4; 6-4,S,78,4,1,33,53,27,33,14,20,0,0,10,41,53,1,1,50,70,35,50,8,20,4,6,10,43,70
2008-02-25 00:00:00.000,Zagreb Croatia ATP World Tour,HARD,2,Sergiy Stakhovsky,Ivan Ljubicic,Sergiy Stakhovsky,7-5; 6-4,F,107,5,3,40,73,30,40,20,33,1,1,11,50,73,9,0,40,69,27,40,18,29,3,5,11,45,69
2008-03-03 00:00:00.000,Dubai U.A.E. ATP World Tour,HARD,2,Andy Murray,Roger Federer,Andy Murray,6-7(6); 6-3; 6-4,R32,115,10,3,53,96,48,53,25,43,0,0,16,73,96,6,2,58,88,44,58,18,30,2,4,15,62,88
2008-03-03 00:00:00.000,Dubai U.A.E. ATP World Tour,HARD,2,Fernando Verdasco,Rainer Schuettler,Fernando Verdasco,7-6(7); 4-6; 6-1,R32,115,12,1,69,95,52,69,15,26,4,6,15,67,95,4,5,51,86,38,51,19,35,0,3,14,57,86
2008-03-03 00:00:00.000,Dubai U.A.E. ATP World Tour,HARD,2,Jan Hernych,Stanislas Wawrinka,Jan Hernych,6-4; 6-4,R32,89,0,0,45,61,28,45,10,16,0,2,10,38,61,10,3,38,60,23,38,10,22,1,5,10,33,60
2008-03-03 00:00:00.000,Dubai U.A.E. ATP World Tour,HARD,2,Nikolay Davydenko,Mohammad Ghareeb,Nikolay Davydenko,6-4; 6-0,R32,57,3,1,28,40,23,28,9,12,0,0,8,32,40,1,2,33,51,21,33,5,18,5,9,8,26,51
2008-03-03 00:00:00.000,Dubai U.A.E. ATP World Tour,HARD,2,David Ferrer,Tommy Haas,David Ferrer,6-3; 6-0,R32,81,0,2,33,53,21,33,11,20,1,2,7,32,53,4,6,35,67,19,35,10,32,4,10,8,29,67
2008-03-03 00:00:00.000,Dubai U.A.E. ATP World Tour,HARD,2,Olivier Rochus,Jarkko Nieminen,Olivier Rochus,6-1; 6-2,R32,55,1,0,24,44,18,24,15,20,3,3,8,33,44,3,3,21,38,10,21,7,17,3,7,7,17,38
2008-03-03 00:00:00.000,Dubai U.A.E. ATP World Tour,HARD,2,Feliciano Lopez,Janko Tipsarevic,Feliciano Lopez,6-3; 4-6; 6-4,R32,109,19,6,45,98,42,45,24,53,1,2,15,66,98,8,2,32,68,25,32,25,36,2,4,14,50,68
2008-03-03 00:00:00.000,Dubai U.A.E. ATP World Tour,HARD,2,Tomas Berdych,Gael Monfils,Tomas Berdych,6-3; 6-2,R32,53,5,1,27,45,20,27,16,18,0,0,9,36,45,8,1,26,40,17,26,6,14,2,5,8,23,40
2008-03-03 00:00:00.000,Dubai U.A.E. ATP World Tour,HARD,2,Richard Gasquet,Dmitry Tursunov,Richard Gasquet,6-4; 6-4,R32,66,11,3,37,58,31,37,10,21,5,6,10,41,58,4,2,27,52,21,27,11,25,2,5,10,32,52
2008-03-03 00:00:00.000,Dubai U.A.E. ATP World Tour,HARD,2,Igor Andreev,Jan Minar,Igor Andreev,6-3; 6-4,R32,66,7,3,31,55,24,31,17,24,2,2,10,41,55,2,2,42,48,30,42,2,6,1,3,9,32,48
2008-03-03 00:00:00.000,Dubai U.A.E. ATP World Tour,HARD,2,Fabrice Santoro,Mikhail Youzhny,Fabrice Santoro,6-3; 6-4,R32,83,6,1,32,55,25,32,15,23,3,4,10,40,55,1,4,32,61,23,32,12,29,5,8,9,35,61
2008-03-03 00:00:00.000,Dubai U.A.E. ATP World Tour,HARD,2,Novak Djokovic,Marin Cilic,Novak Djokovic,6-4; 6-3,R32,78,5,2,34,51,27,34,11,17,0,0,9,38,51,2,4,28,64,19,28,17,36,2,5,10,36,64
2008-03-03 00:00:00.000,Dubai U.A.E. ATP World Tour,HARD,2,Andy Roddick,Juan Carlos Ferrero,Andy Roddick,6-2; 6-4,R32,60,18,0,39,50,31,39,8,11,0,0,9,39,50,2,1,29,50,18,29,11,21,2,5,9,29,50
2008-03-03 00:00:00.000,Dubai U.A.E. ATP World Tour,HARD,2,Paul-Henri Mathieu,Joseph Sirianni,Paul-Henri Mathieu,6-4; 6-4,R32,87,9,2,47,71,34,47,13,24,10,11,10,47,71,3,3,30,60,18,30,17,30,2,5,10,35,60
2008-03-03 00:00:00.000,Dubai U.A.E. ATP World Tour,HARD,2,Mikhail Ledovskikh,Mahmoud-Nader Al Baloushi,Mikhail Ledovskikh,6-1; 6-1,R32,46,6,2,24,34,23,24,5,10,0,0,7,28,34,1,4,35,52,16,35,5,17,5,10,7,21,52
2008-03-03 00:00:00.000,Dubai U.A.E. ATP World Tour,HARD,2,Rafael Nadal,Philipp Kohlschreiber,Rafael Nadal,3-6; 6-1; 6-4,R32,143,5,2,66,89,42,66,12,23,7,10,13,54,89,12,2,53,93,34,53,16,40,8,13,13,50,93
2008-03-03 00:00:00.000,Dubai U.A.E. ATP World Tour,HARD,2,Andy Murray,Fernando Verdasco,Andy Murray,6-3; 3-6; 7-6(5),R16,144,4,1,54,99,41,54,21,45,6,9,15,62,99,5,4,59,96,41,59,22,37,6,9,15,63,96
2008-03-03 00:00:00.000,Dubai U.A.E. ATP World Tour,HARD,2,Nikolay Davydenko,Jan Hernych,Nikolay Davydenko,6-1; 6-4,R16,73,0,2,34,55,23,34,12,21,3,5,9,35,55,0,1,23,46,10,23,10,23,1,6,8,20,46
2008-03-03 00:00:00.000,Dubai U.A.E. ATP World Tour,HARD,2,David Ferrer,Olivier Rochus,David Ferrer,3-6; 7-5; 6-1,R16,152,6,2,69,98,52,69,11,29,7,9,14,63,98,0,2,53,89,34,53,19,36,1,5,14,53,89
2008-03-03 00:00:00.000,Dubai U.A.E. ATP World Tour,HARD,2,Feliciano Lopez,Tomas Berdych,Feliciano Lopez,6-2; 7-5,R16,71,10,1,31,54,26,31,15,23,2,3,10,41,54,1,2,32,56,19,32,11,24,1,5,10,30,56
2008-03-03 00:00:00.000,Dubai U.A.E. ATP World Tour,HARD,2,Igor Andreev,Richard Gasquet,Igor Andreev,6-3; 6-4,R16,77,2,0,36,51,30,36,12,15,1,1,10,42,51,1,3,42,69,34,42,7,27,3,5,9,41,69
2008-03-03 00:00:00.000,Dubai U.A.E. ATP World Tour,HARD,2,Novak Djokovic,Fabrice Santoro,Novak Djokovic,6-3; 7-6(3),R16,96,9,1,41,62,34,41,16,21,3,4,11,50,62,2,1,37,73,26,37,20,36,4,6,10,46,73
2008-03-03 00:00:00.000,Dubai U.A.E. ATP World Tour,HARD,2,Andy Roddick,Paul-Henri Mathieu,Andy Roddick,6-3; 6-4,R16,78,13,1,40,68,34,40,13,28,5,5,10,47,68,2,0,22,51,13,22,19,29,0,2,9,32,51
2008-03-03 00:00:00.000,Dubai U.A.E. ATP World Tour,HARD,2,Rafael Nadal,Mikhail Ledovskikh,Rafael Nadal,6-4; 6-0,R16,71,5,1,29,41,24,29,9,12,0,0,8,33,41,8,3,37,61,23,37,7,24,6,10,8,30,61
2008-03-03 00:00:00.000,Dubai U.A.E. ATP World Tour,HARD,2,Nikolay Davydenko,Andy Murray,Nikolay Davydenko,7-5; 6-4,Q,104,1,4,57,73,39,57,9,16,5,6,11,48,73,6,1,45,73,33,45,11,28,3,6,11,44,73
2008-03-03 00:00:00.000,Dubai U.A.E. ATP World Tour,HARD,2,Feliciano Lopez,David Ferrer,Feliciano Lopez,6-4; 6-3,Q,71,10,2,44,65,34,44,7,21,4,6,10,41,65,1,1,30,50,17,30,8,20,3,7,9,25,50
2008-03-03 00:00:00.000,Dubai U.A.E. ATP World Tour,HARD,2,Novak Djokovic,Igor Andreev,Novak Djokovic,6-2; 6-1,Q,56,1,1,24,38,19,24,10,14,2,2,7,29,38,1,1,34,44,16,34,3,10,1,6,8,19,44
2008-03-03 00:00:00.000,Dubai U.A.E. ATP World Tour,HARD,2,Andy Roddick,Rafael Nadal,Andy Roddick,7-6(5); 6-2,Q,108,17,1,48,71,38,48,13,23,6,6,10,51,71,2,2,58,77,39,58,9,19,7,9,10,48,77
2008-03-03 00:00:00.000,Dubai U.A.E. ATP World Tour,HARD,2,Feliciano Lopez,Nikolay Davydenko,Feliciano Lopez,6-4; 4-6; 7-5,S,145,6,9,51,108,38,51,22,57,4,8,16,60,108,0,3,74,92,49,74,8,18,7,12,16,57,92
2008-03-03 00:00:00.000,Dubai U.A.E. ATP World Tour,HARD,2,Andy Roddick,Novak Djokovic,Andy Roddick,7-6(5); 6-3,S,90,14,2,47,68,39,47,12,21,2,2,11,51,68,9,0,56,76,41,56,8,20,4,5,10,49,76
2008-03-03 00:00:00.000,Dubai U.A.E. ATP World Tour,HARD,2,Andy Roddick,Feliciano Lopez,Andy Roddick,6-7(8); 6-4; 6-2,F,115,22,1,55,84,48,55,19,29,0,0,15,67,84,24,2,62,95,45,62,18,33,4,7,15,63,95
2008-03-03 00:00:00.000,Las Vegas NV; U.S.A. ATP World Tour,HARD,2,Fernando Gonzalez,Dudi Sela,Fernando Gonzalez,6-2; 7-6(2),R32,81,4,4,26,57,20,26,20,31,3,5,10,40,57,2,6,44,76,29,44,10,32,3,7,10,39,76
2008-03-03 00:00:00.000,Las Vegas NV; U.S.A. ATP World Tour,HARD,2,Evgeny Korolev,Sergio Roitman,Evgeny Korolev,6-4; 4-6; 6-3,R32,110,6,9,55,97,42,55,17,42,5,8,15,59,97,2,6,59,86,37,59,14,27,1,5,14,51,86
2008-03-03 00:00:00.000,Las Vegas NV; U.S.A. ATP World Tour,HARD,2,John Isner,Alejandro Falla,John Isner,4-6; 6-3; 6-4,R32,109,17,2,55,95,39,55,26,40,5,6,15,65,95,3,4,52,84,37,52,19,32,3,5,14,56,84
2008-03-03 00:00:00.000,Las Vegas NV; U.S.A. ATP World Tour,HARD,2,Kevin Anderson,Michael Llodra,Kevin Anderson,6-2; 7-6(2),R32,82,10,5,40,67,29,40,18,27,1,2,10,47,67,2,4,33,65,21,33,15,32,3,6,10,36,65
2008-03-03 00:00:00.000,Las Vegas NV; U.S.A. ATP World Tour,HARD,2,Marcos Baghdatis,Vincent Spadea,Marcos Baghdatis,7-6(5); 6-1,R32,71,2,5,31,57,27,31,15,26,0,1,10,42,57,0,5,33,67,21,33,16,34,5,8,9,37,67
2008-03-03 00:00:00.000,Las Vegas NV; U.S.A. ATP World Tour,HARD,2,Robby Ginepri,Xavier Malisse,Robby Ginepri,2-6; 6-3; 6-4,R32,117,2,2,63,109,43,63,19,46,12,16,14,62,109,6,4,43,84,31,43,17,41,6,10,13,48,84
2008-03-03 00:00:00.000,Las Vegas NV; U.S.A. ATP World Tour,HARD,2,Ernests Gulbis,Nicolas Massu,Ernests Gulbis,7-5; 4-6; 6-4,R32,114,19,8,58,104,44,58,25,46,5,6,16,69,104,7,4,55,84,43,55,18,29,3,5,16,61,84
2008-03-03 00:00:00.000,Las Vegas NV; U.S.A. ATP World Tour,HARD,2,Peter Luczak,Mischa Zverev,Peter Luczak,6-2; 1-0 RET,R32,27,4,0,12,19,11,12,5,7,0,0,4,16,19,2,1,20,31,10,20,4,11,3,6,5,14,31
2008-03-03 00:00:00.000,Las Vegas NV; U.S.A. ATP World Tour,HARD,2,Potito Starace,Carlos Berlocq,Potito Starace,7-6(5); 6-0,R32,90,3,0,47,64,33,47,9,17,4,5,9,42,64,1,4,32,66,18,32,14,34,5,9,9,32,66
2008-03-03 00:00:00.000,Las Vegas NV; U.S.A. ATP World Tour,HARD,2,Amer Delic,Jurgen Melzer,Amer Delic,7-5; 7-6(2),R32,88,10,3,43,75,35,43,19,32,4,4,12,54,75,2,0,48,64,35,48,9,16,0,1,12,44,64
2008-03-03 00:00:00.000,Las Vegas NV; U.S.A. ATP World Tour,HARD,2,Chris Guccione,Victor Hanescu,Chris Guccione,6-2; 4-6; 7-6(5),R32,98,12,2,46,85,41,46,23,39,1,2,15,64,85,10,1,61,81,46,61,13,20,1,3,15,59,81
2008-03-03 00:00:00.000,Las Vegas NV; U.S.A. ATP World Tour,HARD,2,Guillermo Canas,Thomas Johansson,Guillermo Canas,6-3; 7-6(3),R32,95,3,4,39,72,32,39,19,33,0,1,11,51,72,4,1,33,62,24,33,16,29,3,5,10,40,62
2008-03-03 00:00:00.000,Las Vegas NV; U.S.A. ATP World Tour,HARD,2,Nicolas Kiefer,Benjamin Becker,Nicolas Kiefer,6-4; 6-3,R32,80,8,6,39,68,25,39,15,29,7,10,10,40,68,4,4,20,52,15,20,12,32,4,9,9,27,52
2008-03-03 00:00:00.000,Las Vegas NV; U.S.A. ATP World Tour,HARD,2,Sam Querrey,Sebastien Grosjean,Sam Querrey,6-2; 4-6; 7-6(8),R32,125,9,7,53,102,42,53,26,49,4,7,15,68,102,0,1,45,109,32,45,36,64,4,8,15,68,109
2008-03-03 00:00:00.000,Las Vegas NV; U.S.A. ATP World Tour,HARD,2,Julien Benneteau,Jonas Bjorkman,Julien Benneteau,6-4; 7-6(4),R32,93,6,5,46,73,34,46,15,27,2,4,11,49,73,4,3,33,66,22,33,18,33,1,4,11,40,66
2008-03-03 00:00:00.000,Las Vegas NV; U.S.A. ATP World Tour,HARD,2,Lleyton Hewitt,Marat Safin,Lleyton Hewitt,6-2; 6-1,R32,57,7,2,23,46,19,23,15,23,2,2,8,34,46,3,3,20,42,8,20,11,22,2,6,7,19,42
2008-03-03 00:00:00.000,Las Vegas NV; U.S.A. ATP World Tour,HARD,2,Evgeny Korolev,Fernando Gonzalez,Evgeny Korolev,6-3; 7-6(4),R16,97,3,2,42,91,26,42,32,49,4,6,11,58,91,4,4,38,65,28,38,11,27,5,8,10,39,65
2008-03-03 00:00:00.000,Las Vegas NV; U.S.A. ATP World Tour,HARD,2,Kevin Anderson,John Isner,Kevin Anderson,7-6(2); 7-5,R16,101,5,3,44,67,37,44,17,23,0,0,12,54,67,11,4,40,85,29,40,25,45,3,4,12,54,85
2008-03-03 00:00:00.000,Las Vegas NV; U.S.A. ATP World Tour,HARD,2,Robby Ginepri,Marcos Baghdatis,Robby Ginepri,7-6(2); 6-3,R16,97,5,2,45,71,34,45,16,26,2,3,11,50,71,6,7,45,89,31,45,22,44,3,5,10,53,89
2008-03-03 00:00:00.000,Las Vegas NV; U.S.A. ATP World Tour,HARD,2,Ernests Gulbis,Peter Luczak,Ernests Gulbis,6-2; 6-1,R16,55,12,5,25,48,22,25,11,23,2,2,7,33,48,2,3,27,48,15,27,8,21,4,9,8,23,48
2008-03-03 00:00:00.000,Las Vegas NV; U.S.A. ATP World Tour,HARD,2,Amer Delic,Potito Starace,Amer Delic,6-3; 3-0 RET,R16,47,1,1,20,35,14,20,11,15,1,1,6,25,35,0,2,19,33,12,19,5,14,1,4,6,17,33
2008-03-03 00:00:00.000,Las Vegas NV; U.S.A. ATP World Tour,HARD,2,Guillermo Canas,Chris Guccione,Guillermo Canas,6-2; 7-5,R16,84,3,2,39,60,28,39,14,21,7,8,10,42,60,8,4,46,81,28,46,15,35,10,14,10,43,81
2008-03-03 00:00:00.000,Las Vegas NV; U.S.A. ATP World Tour,HARD,2,Sam Querrey,Nicolas Kiefer,Sam Querrey,6-3; 6-1,R16,58,6,3,23,53,17,23,17,30,1,2,8,34,53,2,0,27,47,12,27,9,20,1,6,8,21,47
2008-03-03 00:00:00.000,Las Vegas NV; U.S.A. ATP World Tour,HARD,2,Julien Benneteau,Lleyton Hewitt,Julien Benneteau,6-3; 7-5,R16,106,5,3,43,71,32,43,12,28,7,10,11,44,71,2,4,34,74,16,34,20,40,11,16,10,36,74
2008-03-03 00:00:00.000,Las Vegas NV; U.S.A. ATP World Tour,HARD,2,Kevin Anderson,Evgeny Korolev,Kevin Anderson,6-2; 6-0,Q,54,8,1,25,37,20,25,10,12,2,2,7,30,37,2,4,23,48,12,23,9,25,3,8,7,21,48
2008-03-03 00:00:00.000,Las Vegas NV; U.S.A. ATP World Tour,HARD,2,Robby Ginepri,Ernests Gulbis,Robby Ginepri,6-1; 6-2,Q,54,3,6,27,47,24,27,9,20,1,1,8,33,47,5,3,26,50,15,26,9,24,0,4,7,24,50
2008-03-03 00:00:00.000,Las Vegas NV; U.S.A. ATP World Tour,HARD,2,Guillermo Canas,Amer Delic,Guillermo Canas,6-4; 6-4,Q,80,2,0,30,51,26,30,14,21,0,0,10,40,51,3,2,37,64,27,37,14,27,5,7,10,41,64
2008-03-03 00:00:00.000,Las Vegas NV; U.S.A. ATP World Tour,HARD,2,Sam Querrey,Julien Benneteau,Sam Querrey,7-5; 6-2,Q,72,6,1,35,60,26,35,18,25,2,2,10,44,60,0,0,36,56,27,36,8,20,2,5,10,35,56
2008-03-03 00:00:00.000,Las Vegas NV; U.S.A. ATP World Tour,HARD,2,Kevin Anderson,Robby Ginepri,Kevin Anderson,7-6(4); 6-4,S,89,6,0,53,78,40,53,12,25,3,5,11,52,78,5,0,37,60,27,37,14,23,2,5,11,41,60
2008-03-03 00:00:00.000,Las Vegas NV; U.S.A. ATP World Tour,HARD,2,Sam Querrey,Guillermo Canas,Sam Querrey,7-5; 6-2,S,100,6,2,44,85,30,44,20,41,4,6,10,50,85,3,3,35,69,21,35,15,34,4,9,10,36,69
2008-03-03 00:00:00.000,Las Vegas NV; U.S.A. ATP World Tour,HARD,2,Sam Querrey,Kevin Anderson,Sam Querrey,4-6; 6-3; 6-4,F,121,12,5,63,110,51,63,23,47,9,10,15,74,110,7,1,64,89,46,64,11,25,2,4,14,57,89
2008-03-13 00:00:00.000,ATP Masters Series Indian Wells CA; U.S.A. ATP World Tour,HARD,2,Roger Federer,N/A Bye,Roger Federer,,R128,0,0,0,0,0,0,0,0,0,0,0,0,0,0,0,0,0,0,0,0,0,0,0,0,0,0,0
2008-03-13 00:00:00.000,ATP Masters Series Indian Wells CA; U.S.A. ATP World Tour,HARD,2,Guillermo Garcia-Lopez,Sergio Roitman,Guillermo Garcia-Lopez,6-1; 6-4,R128,91,2,6,44,67,32,44,9,23,6,7,8,41,67,0,2,52,83,27,52,14,31,10,15,9,41,83
2008-03-13 00:00:00.000,ATP Masters Series Indian Wells CA; U.S.A. ATP World Tour,HARD,2,Nicolas Mahut,Evgeny Korolev,Nicolas Mahut,3-6; 6-2; 6-2,R128,124,2,3,55,92,33,55,19,37,6,9,12,52,92,1,6,50,89,27,50,21,39,8,14,13,48,89
2008-03-13 00:00:00.000,ATP Masters Series Indian Wells CA; U.S.A. ATP World Tour,HARD,2,Nicolas Almagro,N/A Bye,Nicolas Almagro,,R128,0,0,0,0,0,0,0,0,0,0,0,0,0,0,0,0,0,0,0,0,0,0,0,0,0,0,0
2008-03-13 00:00:00.000,ATP Masters Series Indian Wells CA; U.S.A. ATP World Tour,HARD,2,Ivan Ljubicic,N/A Bye,Ivan Ljubicic,,R128,0,0,0,0,0,0,0,0,0,0,0,0,0,0,0,0,0,0,0,0,0,0,0,0,0,0,0
2008-03-13 00:00:00.000,ATP Masters Series Indian Wells CA; U.S.A. ATP World Tour,HARD,2,Marin Cilic,Kei Nishikori,Marin Cilic,6-2; 6-4,R128,70,5,2,34,54,28,34,10,20,4,5,9,38,54,1,3,36,58,20,36,13,22,7,11,9,33,58
2008-03-13 00:00:00.000,ATP Masters Series Indian Wells CA; U.S.A. ATP World Tour,HARD,2,Nicolas Massu,Janko Tipsarevic,Nicolas Massu,6-4; 3-6; 7-6(4),R128,192,10,4,63,113,43,63,29,50,9,12,15,72,113,20,10,63,128,47,63,32,65,10,13,16,79,128
2008-03-13 00:00:00.000,ATP Masters Series Indian Wells CA; U.S.A. ATP World Tour,HARD,2,Tommy Robredo,N/A Bye,Tommy Robredo,,R128,0,0,0,0,0,0,0,0,0,0,0,0,0,0,0,0,0,0,0,0,0,0,0,0,0,0,0
2008-03-13 00:00:00.000,ATP Masters Series Indian Wells CA; U.S.A. ATP World Tour,HARD,2,Andy Murray,N/A Bye,Andy Murray,,R128,0,0,0,0,0,0,0,0,0,0,0,0,0,0,0,0,0,0,0,0,0,0,0,0,0,0,0
2008-03-13 00:00:00.000,ATP Masters Series Indian Wells CA; U.S.A. ATP World Tour,HARD,2,Jurgen Melzer,Marat Safin,Jurgen Melzer,7-6(5); 2-6; 6-2,R128,114,5,3,50,84,38,50,17,34,1,4,14,55,84,6,7,48,94,36,48,23,46,5,8,14,59,94
2008-03-13 00:00:00.000,ATP Masters Series Indian Wells CA; U.S.A. ATP World Tour,HARD,2,Rik De Voest,Michael Berrer,Rik De Voest,7-6(4); 7-5,R128,104,1,3,53,75,36,53,13,22,2,4,12,49,75,3,6,48,83,31,48,19,35,8,11,12,50,83
2008-03-13 00:00:00.000,ATP Masters Series Indian Wells CA; U.S.A. ATP World Tour,HARD,2,Ivo Karlovic,N/A Bye,Ivo Karlovic,,R128,0,0,0,0,0,0,0,0,0,0,0,0,0,0,0,0,0,0,0,0,0,0,0,0,0,0,0
2008-03-13 00:00:00.000,ATP Masters Series Indian Wells CA; U.S.A. ATP World Tour,HARD,2,Fernando Verdasco,N/A Bye,Fernando Verdasco,,R128,0,0,0,0,0,0,0,0,0,0,0,0,0,0,0,0,0,0,0,0,0,0,0,0,0,0,0
2008-03-13 00:00:00.000,ATP Masters Series Indian Wells CA; U.S.A. ATP World Tour,HARD,2,Victor Hanescu,Albert Montanes,Victor Hanescu,1-6; 6-4; 6-4,R128,101,1,1,62,81,41,62,13,19,4,7,14,54,81,3,1,45,76,31,45,22,31,1,3,13,53,76
2008-03-13 00:00:00.000,ATP Masters Series Indian Wells CA; U.S.A. ATP World Tour,HARD,2,Tommy Haas,Julien Benneteau,Tommy Haas,3-6; 6-0; 6-2,R128,99,2,1,43,69,29,43,14,26,1,4,12,43,69,2,8,45,73,28,45,8,28,8,14,11,36,73
2008-03-13 00:00:00.000,ATP Masters Series Indian Wells CA; U.S.A. ATP World Tour,HARD,2,Andy Roddick,N/A Bye,Andy Roddick,,R128,0,0,0,0,0,0,0,0,0,0,0,0,0,0,0,0,0,0,0,0,0,0,0,0,0,0,0
2008-03-13 00:00:00.000,ATP Masters Series Indian Wells CA; U.S.A. ATP World Tour,HARD,2,Nikolay Davydenko,N/A Bye,Nikolay Davydenko,,R128,0,0,0,0,0,0,0,0,0,0,0,0,0,0,0,0,0,0,0,0,0,0,0,0,0,0,0
2008-03-13 00:00:00.000,ATP Masters Series Indian Wells CA; U.S.A. ATP World Tour,HARD,2,John Isner,Simone Bolelli,John Isner,6-3; 6-7(5); 7-6(2),R128,146,16,2,77,109,62,77,18,32,5,6,17,80,109,10,2,72,110,50,72,26,38,5,7,16,76,110
2008-03-13 00:00:00.000,ATP Masters Series Indian Wells CA; U.S.A. ATP World Tour,HARD,2,Mardy Fish,Florian Mayer,Mardy Fish,7-5; 6-4,R128,95,2,3,47,80,35,47,14,33,8,10,11,49,80,1,1,59,87,36,59,11,28,9,13,11,47,87
2008-03-13 00:00:00.000,ATP Masters Series Indian Wells CA; U.S.A. ATP World Tour,HARD,2,Igor Andreev,N/A Bye,Igor Andreev,,R128,0,0,0,0,0,0,0,0,0,0,0,0,0,0,0,0,0,0,0,0,0,0,0,0,0,0,0
2008-03-13 00:00:00.000,ATP Masters Series Indian Wells CA; U.S.A. ATP World Tour,HARD,2,Lleyton Hewitt,N/A Bye,Lleyton Hewitt,,R128,0,0,0,0,0,0,0,0,0,0,0,0,0,0,0,0,0,0,0,0,0,0,0,0,0,0,0
2008-03-13 00:00:00.000,ATP Masters Series Indian Wells CA; U.S.A. ATP World Tour,HARD,2,Sam Querrey,Luis Horna,Sam Querrey,7-6(5); 6-3,R128,81,12,2,40,67,36,40,16,27,1,1,11,52,67,4,0,46,69,33,46,14,23,4,5,10,47,69
2008-03-13 00:00:00.000,ATP Masters Series Indian Wells CA; U.S.A. ATP World Tour,HARD,2,Gilles Simon,Carlos Berlocq,Gilles Simon,6-2; 6-3,R128,77,0,5,34,61,22,34,17,27,1,2,9,39,61,0,3,43,67,27,43,6,24,6,10,8,33,67
2008-03-13 00:00:00.000,ATP Masters Series Indian Wells CA; U.S.A. ATP World Tour,HARD,2,Mikhail Youzhny,N/A Bye,Mikhail Youzhny,,R128,0,0,0,0,0,0,0,0,0,0,0,0,0,0,0,0,0,0,0,0,0,0,0,0,0,0,0
2008-03-13 00:00:00.000,ATP Masters Series Indian Wells CA; U.S.A. ATP World Tour,HARD,2,Fernando Gonzalez,N/A Bye,Fernando Gonzalez,,R128,0,0,0,0,0,0,0,0,0,0,0,0,0,0,0,0,0,0,0,0,0,0,0,0,0,0,0
2008-03-13 00:00:00.000,ATP Masters Series Indian Wells CA; U.S.A. ATP World Tour,HARD,2,Mario Ancic,Gael Monfils,Mario Ancic,6-3; 6-2,R128,83,2,1,39,54,27,39,9,15,2,3,9,36,54,5,7,32,63,21,32,10,31,5,9,8,31,63
2008-03-13 00:00:00.000,ATP Masters Series Indian Wells CA; U.S.A. ATP World Tour,HARD,2,Thomas Johansson,Yen-Hsun Lu,Thomas Johansson,6-4; 6-7(2); 6-4,R128,155,8,5,70,106,50,70,17,36,6,9,16,67,106,5,12,79,123,56,79,16,44,8,13,16,72,123
2008-03-13 00:00:00.000,ATP Masters Series Indian Wells CA; U.S.A. ATP World Tour,HARD,2,Juan Carlos Ferrero,N/A Bye,Juan Carlos Ferrero,,R128,0,0,0,0,0,0,0,0,0,0,0,0,0,0,0,0,0,0,0,0,0,0,0,0,0,0,0
2008-03-13 00:00:00.000,ATP Masters Series Indian Wells CA; U.S.A. ATP World Tour,HARD,2,Radek Stepanek,N/A Bye,Radek Stepanek,,R128,0,0,0,0,0,0,0,0,0,0,0,0,0,0,0,0,0,0,0,0,0,0,0,0,0,0,0
2008-03-13 00:00:00.000,ATP Masters Series Indian Wells CA; U.S.A. ATP World Tour,HARD,2,Max Mirnyi,Jose Acasuso,Max Mirnyi,7-5; 7-5,R128,93,11,3,50,70,40,50,10,20,3,4,12,50,70,6,3,40,67,27,40,15,27,2,5,12,42,67
2008-03-13 00:00:00.000,ATP Masters Series Indian Wells CA; U.S.A. ATP World Tour,HARD,2,Ernests Gulbis,Oscar Hernandez,Ernests Gulbis,6-2; 6-1,R128,55,6,4,22,38,18,22,10,16,0,0,7,28,38,0,4,34,55,18,34,7,21,5,10,8,25,55
2008-03-13 00:00:00.000,ATP Masters Series Indian Wells CA; U.S.A. ATP World Tour,HARD,2,David Nalbandian,N/A Bye,David Nalbandian,,R128,0,0,0,0,0,0,0,0,0,0,0,0,0,0,0,0,0,0,0,0,0,0,0,0,0,0,0
2008-03-13 00:00:00.000,ATP Masters Series Indian Wells CA; U.S.A. ATP World Tour,HARD,2,David Ferrer,N/A Bye,David Ferrer,,R128,0,0,0,0,0,0,0,0,0,0,0,0,0,0,0,0,0,0,0,0,0,0,0,0,0,0,0
2008-03-13 00:00:00.000,ATP Masters Series Indian Wells CA; U.S.A. ATP World Tour,HARD,2,Olivier Rochus,Arnaud Clement,Olivier Rochus,6-4; 6-4,R128,111,2,2,38,61,27,38,14,23,3,4,10,41,61,7,5,33,77,19,33,24,44,5,8,10,43,77
2008-03-13 00:00:00.000,ATP Masters Series Indian Wells CA; U.S.A. ATP World Tour,HARD,2,Hyung-Taik Lee,Michael Llodra,Hyung-Taik Lee,6-2; 6-3,R128,69,3,3,38,63,28,38,12,25,2,3,9,40,63,1,3,26,43,17,26,5,17,1,5,8,22,43
2008-03-13 00:00:00.000,ATP Masters Series Indian Wells CA; U.S.A. ATP World Tour,HARD,2,Jarkko Nieminen,N/A Bye,Jarkko Nieminen,,R128,0,0,0,0,0,0,0,0,0,0,0,0,0,0,0,0,0,0,0,0,0,0,0,0,0,0,0
2008-03-13 00:00:00.000,ATP Masters Series Indian Wells CA; U.S.A. ATP World Tour,HARD,2,Marcos Baghdatis,N/A Bye,Marcos Baghdatis,,R128,0,0,0,0,0,0,0,0,0,0,0,0,0,0,0,0,0,0,0,0,0,0,0,0,0,0,0
2008-03-13 00:00:00.000,ATP Masters Series Indian Wells CA; U.S.A. ATP World Tour,HARD,2,Wayne Odesnik,Igor Kunitsyn,Wayne Odesnik,2-6; 7-6(3); 6-3,R128,164,7,3,66,96,42,66,15,30,7,12,15,57,96,1,1,65,120,45,65,25,55,15,19,14,70,120
2008-03-13 00:00:00.000,ATP Masters Series Indian Wells CA; U.S.A. ATP World Tour,HARD,2,Stanislas Wawrinka,Jesse Levine,Stanislas Wawrinka,7-5; 4-6; 6-4,R128,156,11,3,57,101,37,57,25,44,4,8,16,62,101,6,3,63,108,43,63,20,45,7,12,16,63,108
2008-03-13 00:00:00.000,ATP Masters Series Indian Wells CA; U.S.A. ATP World Tour,HARD,2,Tomas Berdych,N/A Bye,Tomas Berdych,,R128,0,0,0,0,0,0,0,0,0,0,0,0,0,0,0,0,0,0,0,0,0,0,0,0,0,0,0
2008-03-13 00:00:00.000,ATP Masters Series Indian Wells CA; U.S.A. ATP World Tour,HARD,2,Guillermo Canas,N/A Bye,Guillermo Canas,,R128,0,0,0,0,0,0,0,0,0,0,0,0,0,0,0,0,0,0,0,0,0,0,0,0,0,0,0
2008-03-13 00:00:00.000,ATP Masters Series Indian Wells CA; U.S.A. ATP World Tour,HARD,2,Jonas Bjorkman,Filippo Volandri,Jonas Bjorkman,6-3; 7-6(5),R128,78,10,3,36,61,31,36,15,25,1,2,11,46,61,2,4,32,62,22,32,18,30,2,4,10,40,62
2008-03-13 00:00:00.000,ATP Masters Series Indian Wells CA; U.S.A. ATP World Tour,HARD,2,Robin Haase,Dusan Vemic,Robin Haase,3-6; 6-3; 6-2,R128,92,5,0,43,72,36,43,19,29,6,7,13,55,72,5,4,46,72,31,46,16,26,0,3,13,47,72
2008-03-13 00:00:00.000,ATP Masters Series Indian Wells CA; U.S.A. ATP World Tour,HARD,2,Juan Monaco,N/A Bye,Juan Monaco,,R128,0,0,0,0,0,0,0,0,0,0,0,0,0,0,0,0,0,0,0,0,0,0,0,0,0,0,0
2008-03-13 00:00:00.000,ATP Masters Series Indian Wells CA; U.S.A. ATP World Tour,HARD,2,Philipp Kohlschreiber,N/A Bye,Philipp Kohlschreiber,,R128,0,0,0,0,0,0,0,0,0,0,0,0,0,0,0,0,0,0,0,0,0,0,0,0,0,0,0
2008-03-13 00:00:00.000,ATP Masters Series Indian Wells CA; U.S.A. ATP World Tour,HARD,2,Xavier Malisse,Florent Serra,Xavier Malisse,6-7(5); 6-2; 6-0,R128,119,14,1,49,89,42,49,19,40,3,3,13,61,89,9,4,58,106,35,58,21,48,9,14,13,56,106
2008-03-13 00:00:00.000,ATP Masters Series Indian Wells CA; U.S.A. ATP World Tour,HARD,2,Andreas Seppi,Paul Capdeville,Andreas Seppi,4-6; 7-6(3); 6-2,R128,133,7,4,56,93,37,56,20,37,3,7,15,57,93,8,2,69,98,44,69,14,29,6,11,15,58,98
2008-03-13 00:00:00.000,ATP Masters Series Indian Wells CA; U.S.A. ATP World Tour,HARD,2,Novak Djokovic,N/A Bye,Novak Djokovic,,R128,0,0,0,0,0,0,0,0,0,0,0,0,0,0,0,0,0,0,0,0,0,0,0,0,0,0,0
2008-03-13 00:00:00.000,ATP Masters Series Indian Wells CA; U.S.A. ATP World Tour,HARD,2,Richard Gasquet,N/A Bye,Richard Gasquet,,R128,0,0,0,0,0,0,0,0,0,0,0,0,0,0,0,0,0,0,0,0,0,0,0,0,0,0,0
2008-03-13 00:00:00.000,ATP Masters Series Indian Wells CA; U.S.A. ATP World Tour,HARD,2,Robin Soderling,Sebastien Grosjean,Robin Soderling,6-3; 6-3,R128,87,7,5,26,60,19,26,19,34,2,3,9,38,60,5,1,34,75,26,34,15,41,7,11,9,41,75
2008-03-13 00:00:00.000,ATP Masters Series Indian Wells CA; U.S.A. ATP World Tour,HARD,2,Dmitry Tursunov,Benjamin Becker,Dmitry Tursunov,7-6(4); 6-3,R128,78,6,1,41,67,30,41,16,26,1,2,11,46,67,6,1,36,57,29,36,8,21,0,2,10,37,57
2008-03-13 00:00:00.000,ATP Masters Series Indian Wells CA; U.S.A. ATP World Tour,HARD,2,Juan Ignacio Chela,N/A Bye,Juan Ignacio Chela,,R128,0,0,0,0,0,0,0,0,0,0,0,0,0,0,0,0,0,0,0,0,0,0,0,0,0,0,0
2008-03-13 00:00:00.000,ATP Masters Series Indian Wells CA; U.S.A. ATP World Tour,HARD,2,Carlos Moya,N/A Bye,Carlos Moya,,R128,0,0,0,0,0,0,0,0,0,0,0,0,0,0,0,0,0,0,0,0,0,0,0,0,0,0,0
2008-03-13 00:00:00.000,ATP Masters Series Indian Wells CA; U.S.A. ATP World Tour,HARD,2,Robby Ginepri,Vincent Spadea,Robby Ginepri,6-1; 6-1,R128,64,3,1,33,46,24,33,7,13,0,0,7,31,46,1,1,21,47,11,21,10,26,3,8,7,21,47
2008-03-13 00:00:00.000,ATP Masters Series Indian Wells CA; U.S.A. ATP World Tour,HARD,2,Marc Gicquel,Potito Starace,Marc Gicquel,6-4; 6-3,R128,84,5,2,43,75,29,43,19,32,7,8,10,48,75,2,2,39,61,19,39,14,22,4,7,9,33,61
2008-03-13 00:00:00.000,ATP Masters Series Indian Wells CA; U.S.A. ATP World Tour,HARD,2,James Blake,N/A Bye,James Blake,,R128,0,0,0,0,0,0,0,0,0,0,0,0,0,0,0,0,0,0,0,0,0,0,0,0,0,0,0
2008-03-13 00:00:00.000,ATP Masters Series Indian Wells CA; U.S.A. ATP World Tour,HARD,2,Paul-Henri Mathieu,N/A Bye,Paul-Henri Mathieu,,R128,0,0,0,0,0,0,0,0,0,0,0,0,0,0,0,0,0,0,0,0,0,0,0,0,0,0,0
2008-03-13 00:00:00.000,ATP Masters Series Indian Wells CA; U.S.A. ATP World Tour,HARD,2,Fabio Fognini,Rainer Schuettler,Fabio Fognini,2-6; 6-3; 6-3,R128,124,2,7,55,96,36,55,20,41,8,12,13,56,96,0,4,53,100,32,53,22,47,10,15,13,54,100
2008-03-13 00:00:00.000,ATP Masters Series Indian Wells CA; U.S.A. ATP World Tour,HARD,2,Dudi Sela,Nicolas Kiefer,Dudi Sela,6-4; 6-7(4); 6-3,R128,159,1,2,68,105,46,68,20,37,0,3,16,66,105,5,1,46,96,33,46,24,50,2,7,15,57,96
2008-03-13 00:00:00.000,ATP Masters Series Indian Wells CA; U.S.A. ATP World Tour,HARD,2,Jo-Wilfried Tsonga,N/A Bye,Jo-Wilfried Tsonga,,R128,0,0,0,0,0,0,0,0,0,0,0,0,0,0,0,0,0,0,0,0,0,0,0,0,0,0,0
2008-03-13 00:00:00.000,ATP Masters Series Indian Wells CA; U.S.A. ATP World Tour,HARD,2,Feliciano Lopez,N/A Bye,Feliciano Lopez,,R128,0,0,0,0,0,0,0,0,0,0,0,0,0,0,0,0,0,0,0,0,0,0,0,0,0,0,0
2008-03-13 00:00:00.000,ATP Masters Series Indian Wells CA; U.S.A. ATP World Tour,HARD,2,Donald Young,Bobby Reynolds,Donald Young,6-3; 6-4,R128,61,5,1,27,56,21,27,20,29,2,2,10,41,56,4,3,24,45,18,24,12,21,0,2,9,30,45
2008-03-13 00:00:00.000,ATP Masters Series Indian Wells CA; U.S.A. ATP World Tour,HARD,2,Santiago Giraldo,Werner Eschauer,Santiago Giraldo,7-6(5); 6-4,R128,99,3,1,43,75,31,43,22,32,3,4,11,53,75,10,3,30,68,21,30,22,38,2,4,11,43,68
2008-03-13 00:00:00.000,ATP Masters Series Indian Wells CA; U.S.A. ATP World Tour,HARD,2,Rafael Nadal,N/A Bye,Rafael Nadal,,R128,0,0,0,0,0,0,0,0,0,0,0,0,0,0,0,0,0,0,0,0,0,0,0,0,0,0,0
2008-03-13 00:00:00.000,ATP Masters Series Indian Wells CA; U.S.A. ATP World Tour,HARD,2,Roger Federer,Guillermo Garcia-Lopez,Roger Federer,6-3; 6-2,R64,66,6,0,29,48,22,29,15,19,1,1,9,37,48,2,2,28,57,19,28,13,29,6,9,8,32,57
2008-03-13 00:00:00.000,ATP Masters Series Indian Wells CA; U.S.A. ATP World Tour,HARD,2,Nicolas Mahut,Nicolas Almagro,Nicolas Mahut,7-6(1); 6-2,R64,108,5,0,42,68,30,42,17,26,4,4,10,47,68,8,9,37,81,25,37,24,44,4,6,10,49,81
2008-03-13 00:00:00.000,ATP Masters Series Indian Wells CA; U.S.A. ATP World Tour,HARD,2,Ivan Ljubicic,Marin Cilic,Ivan Ljubicic,7-6(7); 7-5,R64,121,11,2,54,93,39,54,21,39,4,6,12,60,93,4,2,47,81,33,47,17,34,0,3,12,50,81
2008-03-13 00:00:00.000,ATP Masters Series Indian Wells CA; U.S.A. ATP World Tour,HARD,2,Tommy Robredo,Nicolas Massu,Tommy Robredo,6-4; 5-7; 7-6(5),R64,185,0,2,93,126,58,93,19,33,3,6,17,77,126,1,2,73,115,50,73,24,42,8,11,17,74,115
2008-03-13 00:00:00.000,ATP Masters Series Indian Wells CA; U.S.A. ATP World Tour,HARD,2,Andy Murray,Jurgen Melzer,Andy Murray,3-6; 6-3; 6-3,R64,112,3,1,40,75,30,40,18,35,3,6,13,48,75,6,2,60,96,40,60,14,36,9,14,14,54,96
2008-03-13 00:00:00.000,ATP Masters Series Indian Wells CA; U.S.A. ATP World Tour,HARD,2,Ivo Karlovic,Rik De Voest,Ivo Karlovic,6-3; 7-6(2),R64,117,15,0,40,58,37,40,12,18,0,0,11,49,58,4,0,44,73,29,44,18,29,3,4,10,47,73
2008-03-13 00:00:00.000,ATP Masters Series Indian Wells CA; U.S.A. ATP World Tour,HARD,2,Fernando Verdasco,Victor Hanescu,Fernando Verdasco,4-6; 6-4; 6-3,R64,124,0,2,53,71,40,53,13,18,0,2,14,53,71,5,2,103,127,62,103,10,24,15,19,15,72,127
2008-03-13 00:00:00.000,ATP Masters Series Indian Wells CA; U.S.A. ATP World Tour,HARD,2,Tommy Haas,Andy Roddick,Tommy Haas,6-4; 6-4,R64,85,4,0,48,66,34,48,12,18,2,2,10,46,66,6,2,28,52,22,28,14,24,0,2,10,36,52
2008-03-13 00:00:00.000,ATP Masters Series Indian Wells CA; U.S.A. ATP World Tour,HARD,2,Nikolay Davydenko,John Isner,Nikolay Davydenko,6-2; 7-6(3),R64,97,1,1,43,60,35,43,9,17,3,4,10,44,60,7,4,45,77,32,45,13,32,4,7,10,45,77
2008-03-13 00:00:00.000,ATP Masters Series Indian Wells CA; U.S.A. ATP World Tour,HARD,2,Mardy Fish,Igor Andreev,Mardy Fish,6-4; 6-3,R64,79,4,1,29,58,26,29,13,29,3,3,9,39,58,2,3,49,66,30,49,9,17,2,5,10,39,66
2008-03-13 00:00:00.000,ATP Masters Series Indian Wells CA; U.S.A. ATP World Tour,HARD,2,Lleyton Hewitt,Sam Querrey,Lleyton Hewitt,6-4; 6-3,R64,82,7,3,23,48,20,23,15,25,0,1,9,35,48,6,2,44,73,27,44,13,29,6,10,10,40,73
2008-03-13 00:00:00.000,ATP Masters Series Indian Wells CA; U.S.A. ATP World Tour,HARD,2,Mikhail Youzhny,Gilles Simon,Mikhail Youzhny,7-5; 6-4,R64,86,1,1,51,70,40,51,8,19,4,5,11,48,70,0,3,36,68,22,36,19,32,2,5,11,41,68
2008-03-13 00:00:00.000,ATP Masters Series Indian Wells CA; U.S.A. ATP World Tour,HARD,2,Mario Ancic,Fernando Gonzalez,Mario Ancic,7-5; 3-6; 6-3,R64,138,11,3,61,89,44,61,17,28,3,5,15,61,89,3,5,73,109,49,73,16,36,11,14,15,65,109
2008-03-13 00:00:00.000,ATP Masters Series Indian Wells CA; U.S.A. ATP World Tour,HARD,2,Juan Carlos Ferrero,Thomas Johansson,Juan Carlos Ferrero,6-4; 6-4,R64,81,5,0,40,55,28,40,11,15,0,1,10,39,55,3,1,29,51,22,29,10,22,1,4,10,32,51
2008-03-13 00:00:00.000,ATP Masters Series Indian Wells CA; U.S.A. ATP World Tour,HARD,2,Radek Stepanek,Max Mirnyi,Radek Stepanek,6-4; 6-2,R64,75,4,1,31,47,26,31,10,16,0,0,9,36,47,3,3,36,57,22,36,10,21,3,6,9,32,57
2008-03-13 00:00:00.000,ATP Masters Series Indian Wells CA; U.S.A. ATP World Tour,HARD,2,David Nalbandian,Ernests Gulbis,David Nalbandian,6-4; 4-6; 7-6(4),R64,159,4,3,76,124,55,76,19,48,12,16,16,74,124,19,4,64,106,49,64,15,42,7,11,16,64,106
2008-03-13 00:00:00.000,ATP Masters Series Indian Wells CA; U.S.A. ATP World Tour,HARD,2,David Ferrer,Olivier Rochus,David Ferrer,6-2; 6-2,R64,92,5,1,44,68,26,44,15,24,3,4,8,41,68,0,2,39,61,16,39,11,22,3,8,8,27,61
2008-03-13 00:00:00.000,ATP Masters Series Indian Wells CA; U.S.A. ATP World Tour,HARD,2,Hyung-Taik Lee,Jarkko Nieminen,Hyung-Taik Lee,4-6; 7-6(5); 6-3,R64,127,6,7,69,108,43,69,16,39,9,15,15,59,108,3,5,69,109,40,69,15,40,7,14,16,55,109
2008-03-13 00:00:00.000,ATP Masters Series Indian Wells CA; U.S.A. ATP World Tour,HARD,2,Marcos Baghdatis,Wayne Odesnik,Marcos Baghdatis,7-6(2); 1-6; 6-3,R64,160,3,1,54,90,38,54,16,36,8,13,14,54,90,6,0,83,122,48,83,19,39,15,19,14,67,122
2008-03-13 00:00:00.000,ATP Masters Series Indian Wells CA; U.S.A. ATP World Tour,HARD,2,Stanislas Wawrinka,Tomas Berdych,Stanislas Wawrinka,2-6; 7-6(3); 6-4,R64,146,4,4,63,101,45,63,14,38,5,10,15,59,101,7,6,61,90,39,61,14,29,2,6,15,53,90
2008-03-13 00:00:00.000,ATP Masters Series Indian Wells CA; U.S.A. ATP World Tour,HARD,2,Guillermo Canas,Jonas Bjorkman,Guillermo Canas,6-2; 7-6(4),R64,108,3,1,45,78,30,45,17,33,3,5,10,47,78,0,2,37,70,22,37,16,33,2,6,10,38,70
2008-03-13 00:00:00.000,ATP Masters Series Indian Wells CA; U.S.A. ATP World Tour,HARD,2,Juan Monaco,Robin Haase,Juan Monaco,6-2; 6-4,R64,70,2,4,34,54,22,34,13,20,2,4,9,35,54,2,5,28,54,15,28,9,26,5,10,9,24,54
2008-03-13 00:00:00.000,ATP Masters Series Indian Wells CA; U.S.A. ATP World Tour,HARD,2,Philipp Kohlschreiber,Xavier Malisse,Philipp Kohlschreiber,6-2; 5-7; 6-4,R64,127,8,1,59,91,42,59,21,32,4,5,15,63,91,11,4,68,103,49,68,13,35,10,13,15,62,103
2008-03-13 00:00:00.000,ATP Masters Series Indian Wells CA; U.S.A. ATP World Tour,HARD,2,Novak Djokovic,Andreas Seppi,Novak Djokovic,6-3; 7-6(3),R64,100,1,3,39,62,31,39,13,23,1,3,11,44,62,2,3,40,79,30,40,15,39,6,9,10,45,79
2008-03-13 00:00:00.000,ATP Masters Series Indian Wells CA; U.S.A. ATP World Tour,HARD,2,Richard Gasquet,Robin Soderling,Richard Gasquet,6-3; 6-2,R64,52,7,1,29,50,26,29,12,21,1,1,9,38,50,3,4,26,42,18,26,7,16,1,4,8,25,42
2008-03-13 00:00:00.000,ATP Masters Series Indian Wells CA; U.S.A. ATP World Tour,HARD,2,Juan Ignacio Chela,Dmitry Tursunov,Juan Ignacio Chela,6-7(1); 7-6(6); 6-4,R64,161,2,10,64,125,46,64,33,61,7,9,17,79,125,4,6,72,124,52,72,26,52,8,11,17,78,124
2008-03-13 00:00:00.000,ATP Masters Series Indian Wells CA; U.S.A. ATP World Tour,HARD,2,Carlos Moya,Robby Ginepri,Carlos Moya,2-6; 6-2; 6-4,R64,147,2,10,69,119,49,69,22,50,20,22,13,71,119,1,1,62,93,40,62,16,31,8,11,13,56,93
2008-03-13 00:00:00.000,ATP Masters Series Indian Wells CA; U.S.A. ATP World Tour,HARD,2,James Blake,Marc Gicquel,James Blake,6-3; 6-7(5); 6-1,R64,117,7,2,59,99,42,59,21,40,2,5,15,63,99,3,1,50,90,29,50,18,40,3,9,13,47,90
2008-03-13 00:00:00.000,ATP Masters Series Indian Wells CA; U.S.A. ATP World Tour,HARD,2,Paul-Henri Mathieu,Fabio Fognini,Paul-Henri Mathieu,6-1; 7-6(7),R64,87,8,5,32,63,29,32,18,31,3,3,10,47,63,1,3,39,73,25,39,18,34,5,7,9,43,73
2008-03-13 00:00:00.000,ATP Masters Series Indian Wells CA; U.S.A. ATP World Tour,HARD,2,Jo-Wilfried Tsonga,Dudi Sela,Jo-Wilfried Tsonga,6-2; 6-4,R64,80,1,1,29,50,22,29,14,21,0,1,9,36,50,0,2,62,75,32,62,7,13,7,11,9,39,75
2008-03-13 00:00:00.000,ATP Masters Series Indian Wells CA; U.S.A. ATP World Tour,HARD,2,Donald Young,Feliciano Lopez,Donald Young,6-4; 6-7(3); 6-2,R64,116,4,3,68,94,50,68,12,26,4,6,15,62,94,11,5,56,97,39,56,21,41,7,12,15,60,97
2008-03-13 00:00:00.000,ATP Masters Series Indian Wells CA; U.S.A. ATP World Tour,HARD,2,Rafael Nadal,Santiago Giraldo,Rafael Nadal,6-3; 6-3,R64,66,0,1,33,46,24,33,9,13,1,2,9,33,46,0,4,27,49,13,27,12,22,0,4,9,25,49
2008-03-13 00:00:00.000,ATP Masters Series Indian Wells CA; U.S.A. ATP World Tour,HARD,2,Roger Federer,Nicolas Mahut,Roger Federer,6-1; 6-1,R32,53,9,1,24,32,23,24,5,8,0,0,7,28,32,0,5,30,50,14,30,7,20,3,8,7,21,50
2008-03-13 00:00:00.000,ATP Masters Series Indian Wells CA; U.S.A. ATP World Tour,HARD,2,Ivan Ljubicic,Tommy Robredo,Ivan Ljubicic,6-3; 6-4,R32,80,4,1,32,54,25,32,16,22,1,1,10,41,54,1,1,36,57,22,36,12,21,5,7,9,34,57
2008-03-13 00:00:00.000,ATP Masters Series Indian Wells CA; U.S.A. ATP World Tour,HARD,2,Andy Murray,Ivo Karlovic,Andy Murray,7-6(7); 6-7(3); 6-3,R32,140,3,4,69,112,52,69,24,43,2,5,17,76,112,11,2,68,101,50,68,14,33,1,5,16,64,101
2008-03-13 00:00:00.000,ATP Masters Series Indian Wells CA; U.S.A. ATP World Tour,HARD,2,Tommy Haas,Fernando Verdasco,Tommy Haas,7-6(5); 4-6; 6-1,R32,141,4,2,57,95,42,57,18,38,8,11,14,60,95,2,2,70,94,44,70,13,24,5,10,15,57,94
2008-03-13 00:00:00.000,ATP Masters Series Indian Wells CA; U.S.A. ATP World Tour,HARD,2,Mardy Fish,Nikolay Davydenko,Mardy Fish,6-3; 6-2,R32,75,0,1,28,58,22,28,15,30,0,1,9,37,58,4,1,28,46,17,28,7,18,1,5,8,24,46
2008-03-13 00:00:00.000,ATP Masters Series Indian Wells CA; U.S.A. ATP World Tour,HARD,2,Lleyton Hewitt,Mikhail Youzhny,Lleyton Hewitt,7-5; 6-1,R32,97,2,3,21,44,17,21,16,23,0,1,9,33,44,2,5,45,85,26,45,17,40,7,12,10,43,85
2008-03-13 00:00:00.000,ATP Masters Series Indian Wells CA; U.S.A. ATP World Tour,HARD,2,Juan Carlos Ferrero,Mario Ancic,Juan Carlos Ferrero,7-5; 4-6; 7-6(7),R32,181,5,3,71,115,53,71,25,44,6,8,17,78,115,12,2,81,118,55,81,24,37,7,9,17,79,118
2008-03-13 00:00:00.000,ATP Masters Series Indian Wells CA; U.S.A. ATP World Tour,HARD,2,David Nalbandian,Radek Stepanek,David Nalbandian,7-6(1); 0-6; 7-6(6),R32,133,12,4,56,96,42,56,18,40,3,8,15,60,96,12,3,50,87,41,50,20,37,3,5,15,61,87
2008-03-13 00:00:00.000,ATP Masters Series Indian Wells CA; U.S.A. ATP World Tour,HARD,2,Hyung-Taik Lee,David Ferrer,Hyung-Taik Lee,7-6(5); 6-7(5); 7-6(3),R32,170,4,0,76,127,50,76,31,51,4,8,18,81,127,4,1,85,126,59,85,20,41,10,14,18,79,126
2008-03-13 00:00:00.000,ATP Masters Series Indian Wells CA; U.S.A. ATP World Tour,HARD,2,Stanislas Wawrinka,Marcos Baghdatis,Stanislas Wawrinka,6-3; 6-7(1); 6-0,R32,129,5,3,41,81,33,41,21,40,1,3,14,54,81,3,2,43,88,29,43,19,45,5,11,13,48,88
2008-03-13 00:00:00.000,ATP Masters Series Indian Wells CA; U.S.A. ATP World Tour,HARD,2,Guillermo Canas,Juan Monaco,Guillermo Canas,6-3; 6-7(1); 6-2,R32,160,5,4,44,87,33,44,25,43,5,7,14,58,87,1,3,77,105,43,77,14,28,7,13,15,57,105
2008-03-13 00:00:00.000,ATP Masters Series Indian Wells CA; U.S.A. ATP World Tour,HARD,2,Novak Djokovic,Philipp Kohlschreiber,Novak Djokovic,6-3; 6-2,R32,69,3,3,33,49,25,33,11,16,0,0,9,36,49,2,2,22,46,12,22,14,24,4,7,8,26,46
2008-03-13 00:00:00.000,ATP Masters Series Indian Wells CA; U.S.A. ATP World Tour,HARD,2,Richard Gasquet,Juan Ignacio Chela,Richard Gasquet,6-2; 6-1,R32,62,6,0,29,47,23,29,12,18,1,1,8,35,47,2,3,32,46,17,32,4,14,5,9,7,21,46
2008-03-13 00:00:00.000,ATP Masters Series Indian Wells CA; U.S.A. ATP World Tour,HARD,2,James Blake,Carlos Moya,James Blake,6-3; 6-4,R32,75,1,1,34,61,24,34,17,27,4,6,10,41,61,3,2,37,53,19,37,9,16,3,7,9,28,53
2008-03-13 00:00:00.000,ATP Masters Series Indian Wells CA; U.S.A. ATP World Tour,HARD,2,Jo-Wilfried Tsonga,Paul-Henri Mathieu,Jo-Wilfried Tsonga,7-6(5); 6-4,R32,108,15,1,48,58,38,48,6,10,0,1,11,44,58,1,4,37,89,24,37,28,52,5,7,11,52,89
2008-03-13 00:00:00.000,ATP Masters Series Indian Wells CA; U.S.A. ATP World Tour,HARD,2,Rafael Nadal,Donald Young,Rafael Nadal,6-1; 6-3,R32,82,0,1,34,50,26,34,8,16,1,1,8,34,50,2,2,40,69,21,40,15,29,11,15,8,36,69
2008-03-13 00:00:00.000,ATP Masters Series Indian Wells CA; U.S.A. ATP World Tour,HARD,2,Roger Federer,Ivan Ljubicic,Roger Federer,6-3; 6-4,R16,76,6,0,38,51,30,38,8,13,2,3,10,38,51,4,1,43,68,25,43,13,25,8,11,9,38,68
2008-03-13 00:00:00.000,ATP Masters Series Indian Wells CA; U.S.A. ATP World Tour,HARD,2,Tommy Haas,Andy Murray,Tommy Haas,2-6; 7-5; 6-3,R16,132,5,0,58,84,44,58,11,26,9,12,15,55,84,8,2,44,91,35,44,20,47,5,8,14,55,91
2008-03-13 00:00:00.000,ATP Masters Series Indian Wells CA; U.S.A. ATP World Tour,HARD,2,Mardy Fish,Lleyton Hewitt,Mardy Fish,7-5; 3-6; 7-6(4),R16,148,13,1,54,103,41,54,28,49,5,7,16,69,103,14,5,56,103,41,56,31,47,5,7,17,72,103
2008-03-13 00:00:00.000,ATP Masters Series Indian Wells CA; U.S.A. ATP World Tour,HARD,2,David Nalbandian,Juan Carlos Ferrero,David Nalbandian,6-2; 6-2,R16,73,3,2,22,46,16,22,14,24,0,1,8,30,46,1,0,38,55,17,38,8,17,4,9,8,25,55
2008-03-13 00:00:00.000,ATP Masters Series Indian Wells CA; U.S.A. ATP World Tour,HARD,2,Stanislas Wawrinka,Hyung-Taik Lee,Stanislas Wawrinka,6-1; 5-7; 6-4,R16,141,4,0,49,85,39,49,18,36,2,5,15,57,85,1,2,68,105,44,68,16,37,11,16,14,60,105
2008-03-13 00:00:00.000,ATP Masters Series Indian Wells CA; U.S.A. ATP World Tour,HARD,2,Novak Djokovic,Guillermo Canas,Novak Djokovic,6-2; 6-3,R16,85,3,1,35,55,26,35,13,20,5,5,9,39,55,3,1,30,56,24,30,6,26,5,8,8,30,56
2008-03-13 00:00:00.000,ATP Masters Series Indian Wells CA; U.S.A. ATP World Tour,HARD,2,James Blake,Richard Gasquet,James Blake,6-4; 6-2,R16,66,5,0,24,50,20,24,16,26,1,2,9,36,50,5,1,43,65,28,43,7,22,6,10,9,35,65
2008-03-13 00:00:00.000,ATP Masters Series Indian Wells CA; U.S.A. ATP World Tour,HARD,2,Rafael Nadal,Jo-Wilfried Tsonga,Rafael Nadal,6-7(4); 7-6(3); 7-5,R16,183,3,1,74,106,54,74,20,32,4,7,18,74,106,12,7,67,119,51,67,24,52,8,12,18,75,119
2008-03-13 00:00:00.000,ATP Masters Series Indian Wells CA; U.S.A. ATP World Tour,HARD,2,Roger Federer,Tommy Haas,Roger Federer,W/O,Q,0,0,0,0,0,0,0,0,0,0,0,0,0,0,0,0,0,0,0,0,0,0,0,0,0,0,0
2008-03-13 00:00:00.000,ATP Masters Series Indian Wells CA; U.S.A. ATP World Tour,HARD,2,Mardy Fish,David Nalbandian,Mardy Fish,6-3; 6-7(5); 7-6(4),Q,165,23,4,66,119,51,66,29,53,5,8,17,80,119,7,8,68,124,50,68,25,56,12,16,16,75,124
2008-03-13 00:00:00.000,ATP Masters Series Indian Wells CA; U.S.A. ATP World Tour,HARD,2,Novak Djokovic,Stanislas Wawrinka,Novak Djokovic,7-6(5); 6-2,Q,126,7,1,43,66,32,43,10,23,3,6,10,42,66,1,1,53,87,27,53,18,34,10,15,10,45,87
2008-03-13 00:00:00.000,ATP Masters Series Indian Wells CA; U.S.A. ATP World Tour,HARD,2,Rafael Nadal,James Blake,Rafael Nadal,7-5; 3-6; 6-3,Q,126,6,1,70,93,44,70,16,23,6,8,15,60,93,5,2,43,80,33,43,20,37,1,4,15,53,80
2008-03-13 00:00:00.000,ATP Masters Series Indian Wells CA; U.S.A. ATP World Tour,HARD,2,Mardy Fish,Roger Federer,Mardy Fish,6-3; 6-2,S,64,7,1,17,50,15,17,22,33,1,1,9,37,50,2,0,28,53,16,28,14,25,4,7,8,30,53
2008-03-13 00:00:00.000,ATP Masters Series Indian Wells CA; U.S.A. ATP World Tour,HARD,2,Novak Djokovic,Rafael Nadal,Novak Djokovic,6-3; 6-2,S,88,8,0,31,50,25,31,11,19,2,3,9,36,50,2,2,31,51,18,31,8,20,3,7,8,26,51
2008-03-13 00:00:00.000,ATP Masters Series Indian Wells CA; U.S.A. ATP World Tour,HARD,2,Novak Djokovic,Mardy Fish,Novak Djokovic,6-2; 5-7; 6-3,F,125,10,1,53,84,35,53,19,31,3,6,15,54,84,6,4,35,87,26,35,25,52,1,6,14,51,87
2008-03-27 00:00:00.000,ATP Masters Series Miami FL; U.S.A. ATP World Tour,HARD,2,Roger Federer,N/A Bye,Roger Federer,,R128,0,0,0,0,0,0,0,0,0,0,0,0,0,0,0,0,0,0,0,0,0,0,0,0,0,0,0
2008-03-27 00:00:00.000,ATP Masters Series Miami FL; U.S.A. ATP World Tour,HARD,2,Gael Monfils,John Isner,Gael Monfils,6-7(8); 6-3; 6-3,R128,131,8,4,62,104,46,62,25,42,11,13,15,71,104,10,8,61,104,41,61,19,43,4,9,15,60,104
2008-03-27 00:00:00.000,ATP Masters Series Miami FL; U.S.A. ATP World Tour,HARD,2,Robin Soderling,Stefan Koubek,Robin Soderling,6-0; 6-1,R128,38,7,2,19,38,19,19,10,19,1,1,7,29,38,1,1,19,38,10,19,4,19,2,7,6,14,38
2008-03-27 00:00:00.000,ATP Masters Series Miami FL; U.S.A. ATP World Tour,HARD,2,Stanislas Wawrinka,N/A Bye,Stanislas Wawrinka,,R128,0,0,0,0,0,0,0,0,0,0,0,0,0,0,0,0,0,0,0,0,0,0,0,0,0,0,0
2008-03-27 00:00:00.000,ATP Masters Series Miami FL; U.S.A. ATP World Tour,HARD,2,Lleyton Hewitt,N/A Bye,Lleyton Hewitt,,R128,0,0,0,0,0,0,0,0,0,0,0,0,0,0,0,0,0,0,0,0,0,0,0,0,0,0,0
2008-03-27 00:00:00.000,ATP Masters Series Miami FL; U.S.A. ATP World Tour,HARD,2,Jose Acasuso,Santiago Ventura,Jose Acasuso,6-2; 6-4,R128,83,7,7,29,58,23,29,10,29,2,5,9,33,58,5,5,28,68,15,28,17,40,4,10,9,32,68
2008-03-27 00:00:00.000,ATP Masters Series Miami FL; U.S.A. ATP World Tour,HARD,2,Dudi Sela,Hyung-Taik Lee,Dudi Sela,6-4; 6-3,R128,76,0,1,41,66,29,41,15,25,5,5,9,44,66,3,3,37,54,24,37,10,17,2,5,10,34,54
2008-03-27 00:00:00.000,ATP Masters Series Miami FL; U.S.A. ATP World Tour,HARD,2,Tommy Robredo,N/A Bye,Tommy Robredo,,R128,0,0,0,0,0,0,0,0,0,0,0,0,0,0,0,0,0,0,0,0,0,0,0,0,0,0,0
2008-03-27 00:00:00.000,ATP Masters Series Miami FL; U.S.A. ATP World Tour,HARD,2,Jo-Wilfried Tsonga,N/A Bye,Jo-Wilfried Tsonga,,R128,0,0,0,0,0,0,0,0,0,0,0,0,0,0,0,0,0,0,0,0,0,0,0,0,0,0,0
2008-03-27 00:00:00.000,ATP Masters Series Miami FL; U.S.A. ATP World Tour,HARD,2,Jurgen Melzer,Michael Llodra,Jurgen Melzer,7-6(6); 7-6(5),R128,107,7,3,51,92,32,51,28,41,5,6,12,60,92,10,5,51,80,37,51,16,29,3,4,12,53,80
2008-03-27 00:00:00.000,ATP Masters Series Miami FL; U.S.A. ATP World Tour,HARD,2,Julien Benneteau,Rainer Schuettler,Julien Benneteau,1-6; 6-1; 6-2,R128,89,2,5,45,74,37,45,10,29,1,3,11,47,74,0,4,33,57,24,33,9,24,1,5,11,33,57
2008-03-27 00:00:00.000,ATP Masters Series Miami FL; U.S.A. ATP World Tour,HARD,2,Ivo Karlovic,N/A Bye,Ivo Karlovic,,R128,0,0,0,0,0,0,0,0,0,0,0,0,0,0,0,0,0,0,0,0,0,0,0,0,0,0,0
2008-03-27 00:00:00.000,ATP Masters Series Miami FL; U.S.A. ATP World Tour,HARD,2,Juan Ignacio Chela,N/A Bye,Juan Ignacio Chela,,R128,0,0,0,0,0,0,0,0,0,0,0,0,0,0,0,0,0,0,0,0,0,0,0,0,0,0,0
2008-03-27 00:00:00.000,ATP Masters Series Miami FL; U.S.A. ATP World Tour,HARD,2,Ivo Minar,Olivier Rochus,Ivo Minar,6-3; 6-2,R128,71,7,0,28,52,22,28,13,24,2,3,9,35,52,2,3,34,57,19,34,9,23,3,7,8,28,57
2008-03-27 00:00:00.000,ATP Masters Series Miami FL; U.S.A. ATP World Tour,HARD,2,Viktor Troicki,Victor Hanescu,Viktor Troicki,6-4; 6-1,R128,68,3,0,22,40,17,22,13,18,0,1,8,30,40,2,2,42,67,24,42,9,25,10,15,9,33,67
2008-03-27 00:00:00.000,ATP Masters Series Miami FL; U.S.A. ATP World Tour,HARD,2,Andy Roddick,N/A Bye,Andy Roddick,,R128,0,0,0,0,0,0,0,0,0,0,0,0,0,0,0,0,0,0,0,0,0,0,0,0,0,0,0
2008-03-27 00:00:00.000,ATP Masters Series Miami FL; U.S.A. ATP World Tour,HARD,2,Nikolay Davydenko,N/A Bye,Nikolay Davydenko,,R128,0,0,0,0,0,0,0,0,0,0,0,0,0,0,0,0,0,0,0,0,0,0,0,0,0,0,0
2008-03-27 00:00:00.000,ATP Masters Series Miami FL; U.S.A. ATP World Tour,HARD,2,Ernests Gulbis,Dominik Hrbaty,Ernests Gulbis,6-3; 4-6; 6-1,R128,110,10,7,45,90,33,45,21,45,6,9,13,54,90,4,10,54,86,34,54,11,32,6,12,13,45,86
2008-03-27 00:00:00.000,ATP Masters Series Miami FL; U.S.A. ATP World Tour,HARD,2,Simone Bolelli,Santiago Giraldo,Simone Bolelli,6-3; 7-5,R128,89,3,3,49,81,36,49,16,32,4,5,11,52,81,6,1,39,59,27,39,7,20,1,4,10,34,59
2008-03-27 00:00:00.000,ATP Masters Series Miami FL; U.S.A. ATP World Tour,HARD,2,Philipp Kohlschreiber,N/A Bye,Philipp Kohlschreiber,,R128,0,0,0,0,0,0,0,0,0,0,0,0,0,0,0,0,0,0,0,0,0,0,0,0,0,0,0
2008-03-27 00:00:00.000,ATP Masters Series Miami FL; U.S.A. ATP World Tour,HARD,2,Juan Monaco,N/A Bye,Juan Monaco,,R128,0,0,0,0,0,0,0,0,0,0,0,0,0,0,0,0,0,0,0,0,0,0,0,0,0,0,0
2008-03-27 00:00:00.000,ATP Masters Series Miami FL; U.S.A. ATP World Tour,HARD,2,Ryan Sweeting,Filippo Volandri,Ryan Sweeting,6-3; 6-2,R128,72,1,3,41,59,31,41,9,18,5,6,9,40,59,0,2,36,60,19,36,11,24,5,9,8,30,60
2008-03-27 00:00:00.000,ATP Masters Series Miami FL; U.S.A. ATP World Tour,HARD,2,Mario Ancic,Gilles Simon,Mario Ancic,6-2; 6-7(2); 6-3,R128,143,4,1,66,102,48,66,17,36,5,7,15,65,102,3,3,65,105,42,65,15,40,9,14,14,57,105
2008-03-27 00:00:00.000,ATP Masters Series Miami FL; U.S.A. ATP World Tour,HARD,2,Andy Murray,N/A Bye,Andy Murray,,R128,0,0,0,0,0,0,0,0,0,0,0,0,0,0,0,0,0,0,0,0,0,0,0,0,0,0,0
2008-03-27 00:00:00.000,ATP Masters Series Miami FL; U.S.A. ATP World Tour,HARD,2,Mikhail Youzhny,N/A Bye,Mikhail Youzhny,,R128,0,0,0,0,0,0,0,0,0,0,0,0,0,0,0,0,0,0,0,0,0,0,0,0,0,0,0
2008-03-27 00:00:00.000,ATP Masters Series Miami FL; U.S.A. ATP World Tour,HARD,2,Bobby Reynolds,Marat Safin,Bobby Reynolds,7-6(3); 4-6; 7-6(5),R128,137,19,3,61,98,49,61,23,37,3,5,17,72,98,19,7,63,117,50,63,25,54,9,10,17,75,117
2008-03-27 00:00:00.000,ATP Masters Series Miami FL; U.S.A. ATP World Tour,HARD,2,Arnaud Clement,Mardy Fish,Arnaud Clement,6-3; 6-3,R128,69,9,3,25,52,21,25,18,27,4,4,9,39,52,8,0,26,55,21,26,12,29,3,6,9,33,55
2008-03-27 00:00:00.000,ATP Masters Series Miami FL; U.S.A. ATP World Tour,HARD,2,Nicolas Almagro,N/A Bye,Nicolas Almagro,,R128,0,0,0,0,0,0,0,0,0,0,0,0,0,0,0,0,0,0,0,0,0,0,0,0,0,0,0
2008-03-27 00:00:00.000,ATP Masters Series Miami FL; U.S.A. ATP World Tour,HARD,2,Fernando Verdasco,N/A Bye,Fernando Verdasco,,R128,0,0,0,0,0,0,0,0,0,0,0,0,0,0,0,0,0,0,0,0,0,0,0,0,0,0,0
2008-03-27 00:00:00.000,ATP Masters Series Miami FL; U.S.A. ATP World Tour,HARD,2,Janko Tipsarevic,Yen-Hsun Lu,Janko Tipsarevic,6-1; 4-6; 6-4,R128,109,8,0,46,73,37,46,18,27,0,1,14,55,73,5,3,47,72,33,47,10,25,2,5,13,43,72
2008-03-27 00:00:00.000,ATP Masters Series Miami FL; U.S.A. ATP World Tour,HARD,2,Thomas Johansson,Igor Kunitsyn,Thomas Johansson,4-6; 6-1; 6-2,R128,105,9,3,51,81,37,51,12,30,6,9,12,49,81,4,2,39,73,23,39,11,34,1,8,13,34,73
2008-03-27 00:00:00.000,ATP Masters Series Miami FL; U.S.A. ATP World Tour,HARD,2,David Ferrer,N/A Bye,David Ferrer,,R128,0,0,0,0,0,0,0,0,0,0,0,0,0,0,0,0,0,0,0,0,0,0,0,0,0,0,0
2008-03-27 00:00:00.000,ATP Masters Series Miami FL; U.S.A. ATP World Tour,HARD,2,Richard Gasquet,N/A Bye,Richard Gasquet,,R128,0,0,0,0,0,0,0,0,0,0,0,0,0,0,0,0,0,0,0,0,0,0,0,0,0,0,0
2008-03-27 00:00:00.000,ATP Masters Series Miami FL; U.S.A. ATP World Tour,HARD,2,Dmitry Tursunov,Evgeny Korolev,Dmitry Tursunov,4-6; 6-3; 6-2,R128,104,16,2,53,80,39,53,17,27,3,4,14,56,80,6,9,52,93,36,52,20,41,5,8,13,56,93
2008-03-27 00:00:00.000,ATP Masters Series Miami FL; U.S.A. ATP World Tour,HARD,2,Juan Martin Del Potro,Jesse Levine,Juan Martin Del Potro,7-5; 6-1,R128,76,3,3,41,66,29,41,15,25,5,6,10,44,66,2,5,28,51,18,28,10,23,2,6,9,28,51
2008-03-27 00:00:00.000,ATP Masters Series Miami FL; U.S.A. ATP World Tour,HARD,2,Feliciano Lopez,N/A Bye,Feliciano Lopez,,R128,0,0,0,0,0,0,0,0,0,0,0,0,0,0,0,0,0,0,0,0,0,0,0,0,0,0,0
2008-03-27 00:00:00.000,ATP Masters Series Miami FL; U.S.A. ATP World Tour,HARD,2,Juan Carlos Ferrero,N/A Bye,Juan Carlos Ferrero,,R128,0,0,0,0,0,0,0,0,0,0,0,0,0,0,0,0,0,0,0,0,0,0,0,0,0,0,0
2008-03-27 00:00:00.000,ATP Masters Series Miami FL; U.S.A. ATP World Tour,HARD,2,Albert Montanes,Kei Nishikori,Albert Montanes,7-5; 6-2,R128,90,3,2,42,67,31,42,13,25,2,3,10,44,67,3,4,51,84,31,51,14,33,3,7,10,45,84
2008-03-27 00:00:00.000,ATP Masters Series Miami FL; U.S.A. ATP World Tour,HARD,2,Sam Querrey,Carlos Berlocq,Sam Querrey,7-6(4); 6-3,R128,82,8,3,49,75,35,49,15,26,2,4,11,50,75,2,1,36,63,22,36,16,27,0,3,10,38,63
2008-03-27 00:00:00.000,ATP Masters Series Miami FL; U.S.A. ATP World Tour,HARD,2,Tomas Berdych,N/A Bye,Tomas Berdych,,R128,0,0,0,0,0,0,0,0,0,0,0,0,0,0,0,0,0,0,0,0,0,0,0,0,0,0,0
2008-03-27 00:00:00.000,ATP Masters Series Miami FL; U.S.A. ATP World Tour,HARD,2,Guillermo Canas,N/A Bye,Guillermo Canas,,R128,0,0,0,0,0,0,0,0,0,0,0,0,0,0,0,0,0,0,0,0,0,0,0,0,0,0,0
2008-03-27 00:00:00.000,ATP Masters Series Miami FL; U.S.A. ATP World Tour,HARD,2,Sam Warburg,Potito Starace,Sam Warburg,7-6(2); 6-2,R128,75,6,0,31,53,27,31,19,22,1,1,10,46,53,5,2,47,62,31,47,8,15,2,4,10,39,62
2008-03-27 00:00:00.000,ATP Masters Series Miami FL; U.S.A. ATP World Tour,HARD,2,Pablo Cuevas,Vincent Spadea,Pablo Cuevas,6-4; 6-2,R128,73,6,2,38,63,27,38,17,25,4,4,9,44,63,4,3,36,62,27,36,10,26,7,10,9,37,62
2008-03-27 00:00:00.000,ATP Masters Series Miami FL; U.S.A. ATP World Tour,HARD,2,Fernando Gonzalez,N/A Bye,Fernando Gonzalez,,R128,0,0,0,0,0,0,0,0,0,0,0,0,0,0,0,0,0,0,0,0,0,0,0,0,0,0,0
2008-03-27 00:00:00.000,ATP Masters Series Miami FL; U.S.A. ATP World Tour,HARD,2,Igor Andreev,N/A Bye,Igor Andreev,,R128,0,0,0,0,0,0,0,0,0,0,0,0,0,0,0,0,0,0,0,0,0,0,0,0,0,0,0
2008-03-27 00:00:00.000,ATP Masters Series Miami FL; U.S.A. ATP World Tour,HARD,2,Michael Berrer,Robin Haase,Michael Berrer,6-4; 6-4,R128,85,3,2,35,58,24,35,12,23,4,7,10,36,58,4,2,35,68,21,35,13,33,0,5,10,34,68
2008-03-27 00:00:00.000,ATP Masters Series Miami FL; U.S.A. ATP World Tour,HARD,2,Kevin Anderson,Agustin Calleri,Kevin Anderson,7-6(5); 3-6; 7-6(4),R128,132,19,1,76,112,57,76,20,36,4,7,17,77,112,9,7,54,106,43,54,31,52,4,5,16,74,106
2008-03-27 00:00:00.000,ATP Masters Series Miami FL; U.S.A. ATP World Tour,HARD,2,Novak Djokovic,N/A Bye,Novak Djokovic,,R128,0,0,0,0,0,0,0,0,0,0,0,0,0,0,0,0,0,0,0,0,0,0,0,0,0,0,0
2008-03-27 00:00:00.000,ATP Masters Series Miami FL; U.S.A. ATP World Tour,HARD,2,David Nalbandian,N/A Bye,David Nalbandian,,R128,0,0,0,0,0,0,0,0,0,0,0,0,0,0,0,0,0,0,0,0,0,0,0,0,0,0,0
2008-03-27 00:00:00.000,ATP Masters Series Miami FL; U.S.A. ATP World Tour,HARD,2,Xavier Malisse,Oscar Hernandez,Xavier Malisse,6-1; 6-1,R128,58,5,0,20,36,17,20,11,16,0,0,7,28,36,0,1,31,48,14,31,7,17,2,7,7,21,48
2008-03-27 00:00:00.000,ATP Masters Series Miami FL; U.S.A. ATP World Tour,HARD,2,Sebastien Grosjean,Gustavo Kuerten,Sebastien Grosjean,6-1; 7-5,R128,76,2,0,29,50,24,29,17,21,3,3,10,41,50,1,2,29,63,20,29,15,34,3,6,9,35,63
2008-03-27 00:00:00.000,ATP Masters Series Miami FL; U.S.A. ATP World Tour,HARD,2,Radek Stepanek,N/A Bye,Radek Stepanek,,R128,0,0,0,0,0,0,0,0,0,0,0,0,0,0,0,0,0,0,0,0,0,0,0,0,0,0,0
2008-03-27 00:00:00.000,ATP Masters Series Miami FL; U.S.A. ATP World Tour,HARD,2,Ivan Ljubicic,N/A Bye,Ivan Ljubicic,,R128,0,0,0,0,0,0,0,0,0,0,0,0,0,0,0,0,0,0,0,0,0,0,0,0,0,0,0
2008-03-27 00:00:00.000,ATP Masters Series Miami FL; U.S.A. ATP World Tour,HARD,2,Fabrice Santoro,Jonas Bjorkman,Fabrice Santoro,6-1; 6-0,R128,46,3,0,12,30,11,12,13,18,0,0,6,24,30,0,4,25,38,10,25,1,13,3,9,7,11,38
2008-03-27 00:00:00.000,ATP Masters Series Miami FL; U.S.A. ATP World Tour,HARD,2,Andreas Seppi,Marc Gicquel,Andreas Seppi,2-6; 6-4; 6-2,R128,112,4,6,36,84,20,36,22,48,9,16,13,42,84,8,2,47,80,25,47,11,33,4,12,13,36,80
2008-03-27 00:00:00.000,ATP Masters Series Miami FL; U.S.A. ATP World Tour,HARD,2,James Blake,N/A Bye,James Blake,,R128,0,0,0,0,0,0,0,0,0,0,0,0,0,0,0,0,0,0,0,0,0,0,0,0,0,0,0
2008-03-27 00:00:00.000,ATP Masters Series Miami FL; U.S.A. ATP World Tour,HARD,2,Paul-Henri Mathieu,N/A Bye,Paul-Henri Mathieu,,R128,0,0,0,0,0,0,0,0,0,0,0,0,0,0,0,0,0,0,0,0,0,0,0,0,0,0,0
2008-03-27 00:00:00.000,ATP Masters Series Miami FL; U.S.A. ATP World Tour,HARD,2,Marin Cilic,Kristof Vliegen,Marin Cilic,6-3; 6-2,R128,73,6,2,35,56,26,35,13,21,3,3,9,39,56,3,1,42,65,27,42,9,23,9,12,8,36,65
2008-03-27 00:00:00.000,ATP Masters Series Miami FL; U.S.A. ATP World Tour,HARD,2,Nicolas Mahut,Florian Mayer,Nicolas Mahut,7-6(6); 6-3,R128,92,10,1,52,81,34,52,14,29,6,9,11,48,81,1,0,37,59,25,37,6,22,2,6,10,31,59
2008-03-27 00:00:00.000,ATP Masters Series Miami FL; U.S.A. ATP World Tour,HARD,2,Carlos Moya,N/A Bye,Carlos Moya,,R128,0,0,0,0,0,0,0,0,0,0,0,0,0,0,0,0,0,0,0,0,0,0,0,0,0,0,0
2008-03-27 00:00:00.000,ATP Masters Series Miami FL; U.S.A. ATP World Tour,HARD,2,Jarkko Nieminen,N/A Bye,Jarkko Nieminen,,R128,0,0,0,0,0,0,0,0,0,0,0,0,0,0,0,0,0,0,0,0,0,0,0,0,0,0,0
2008-03-27 00:00:00.000,ATP Masters Series Miami FL; U.S.A. ATP World Tour,HARD,2,Nicolas Kiefer,Guillermo Garcia-Lopez,Nicolas Kiefer,4-6; 7-6(9); 6-4,R128,141,10,2,53,100,40,53,28,47,2,5,16,68,100,7,8,53,99,41,53,25,46,2,5,16,66,99
2008-03-27 00:00:00.000,ATP Masters Series Miami FL; U.S.A. ATP World Tour,HARD,2,Benjamin Becker,Sergio Roitman,Benjamin Becker,6-3; 6-4,R128,74,6,2,40,64,31,40,9,24,2,3,10,40,64,6,0,28,47,20,28,10,19,1,4,9,30,47
2008-03-27 00:00:00.000,ATP Masters Series Miami FL; U.S.A. ATP World Tour,HARD,2,Rafael Nadal,N/A Bye,Rafael Nadal,,R128,0,0,0,0,0,0,0,0,0,0,0,0,0,0,0,0,0,0,0,0,0,0,0,0,0,0,0
2008-03-27 00:00:00.000,ATP Masters Series Miami FL; U.S.A. ATP World Tour,HARD,2,Roger Federer,Gael Monfils,Roger Federer,6-3; 6-4,R64,67,2,1,46,67,35,46,13,21,7,7,10,48,67,8,2,31,52,23,31,9,21,0,2,9,32,52
2008-03-27 00:00:00.000,ATP Masters Series Miami FL; U.S.A. ATP World Tour,HARD,2,Robin Soderling,Stanislas Wawrinka,Robin Soderling,3-6; 6-4; 6-3,R64,112,8,3,53,86,43,53,15,33,5,6,14,58,86,5,3,38,74,29,38,21,36,0,2,14,50,74
2008-03-27 00:00:00.000,ATP Masters Series Miami FL; U.S.A. ATP World Tour,HARD,2,Jose Acasuso,Lleyton Hewitt,Jose Acasuso,6-3; 7-6(4),R64,113,13,4,40,82,31,40,26,42,3,3,11,57,82,9,2,37,64,29,37,14,27,4,5,10,43,64
2008-03-27 00:00:00.000,ATP Masters Series Miami FL; U.S.A. ATP World Tour,HARD,2,Dudi Sela,Tommy Robredo,Dudi Sela,7-6(5); 6-1,R64,91,1,0,55,66,38,55,4,11,5,7,10,42,66,0,0,38,67,23,38,12,29,5,9,9,35,67
2008-03-27 00:00:00.000,ATP Masters Series Miami FL; U.S.A. ATP World Tour,HARD,2,Jo-Wilfried Tsonga,Jurgen Melzer,Jo-Wilfried Tsonga,6-7(4); 7-5; 6-1,R64,123,5,3,54,89,44,54,22,35,3,4,16,66,89,3,5,66,101,41,66,20,35,3,7,15,61,101
2008-03-27 00:00:00.000,ATP Masters Series Miami FL; U.S.A. ATP World Tour,HARD,2,Julien Benneteau,Ivo Karlovic,Julien Benneteau,3-6; 6-4; 7-6(2),R64,130,3,3,43,88,33,43,31,45,2,4,16,64,88,22,1,66,101,48,66,21,35,5,6,15,69,101
2008-03-27 00:00:00.000,ATP Masters Series Miami FL; U.S.A. ATP World Tour,HARD,2,Ivo Minar,Juan Ignacio Chela,Ivo Minar,6-3; 5-7; 6-3,R64,129,6,2,52,99,32,52,29,47,6,10,15,61,99,4,2,44,88,29,44,20,44,6,12,15,49,88
2008-03-27 00:00:00.000,ATP Masters Series Miami FL; U.S.A. ATP World Tour,HARD,2,Andy Roddick,Viktor Troicki,Andy Roddick,5-7; 6-2; 6-4,R64,134,13,5,51,89,41,51,21,38,5,7,15,62,89,5,6,55,100,37,55,23,45,6,10,15,60,100
2008-03-27 00:00:00.000,ATP Masters Series Miami FL; U.S.A. ATP World Tour,HARD,2,Nikolay Davydenko,Ernests Gulbis,Nikolay Davydenko,3-6; 7-6(6); 7-6(3),R64,161,6,3,66,105,43,66,22,39,3,7,16,65,105,8,7,74,128,49,74,28,54,6,9,17,77,128
2008-03-27 00:00:00.000,ATP Masters Series Miami FL; U.S.A. ATP World Tour,HARD,2,Simone Bolelli,Philipp Kohlschreiber,Simone Bolelli,6-4; 6-3,R64,78,3,1,45,66,33,45,13,21,3,4,10,46,66,4,3,37,58,27,37,7,21,4,7,9,34,58
2008-03-27 00:00:00.000,ATP Masters Series Miami FL; U.S.A. ATP World Tour,HARD,2,Juan Monaco,Ryan Sweeting,Juan Monaco,6-3; 7-5,R64,91,4,2,41,60,32,41,11,19,1,2,11,43,60,6,4,46,74,31,46,12,28,7,10,10,43,74
2008-03-27 00:00:00.000,ATP Masters Series Miami FL; U.S.A. ATP World Tour,HARD,2,Mario Ancic,Andy Murray,Mario Ancic,6-2; 2-6; 7-6(7),R64,149,6,2,51,95,38,51,18,44,5,9,14,56,95,2,3,43,94,25,43,26,51,7,11,14,51,94
2008-03-27 00:00:00.000,ATP Masters Series Miami FL; U.S.A. ATP World Tour,HARD,2,Mikhail Youzhny,Bobby Reynolds,Mikhail Youzhny,6-2; 6-2,R64,64,7,2,35,46,27,35,6,11,0,0,8,33,46,5,3,34,53,21,34,5,19,7,11,8,26,53
2008-03-27 00:00:00.000,ATP Masters Series Miami FL; U.S.A. ATP World Tour,HARD,2,Nicolas Almagro,Arnaud Clement,Nicolas Almagro,6-2; 6-2,R64,63,13,5,27,54,22,27,16,27,7,7,8,38,54,3,2,21,39,12,21,8,18,0,4,8,20,39
2008-03-27 00:00:00.000,ATP Masters Series Miami FL; U.S.A. ATP World Tour,HARD,2,Janko Tipsarevic,Fernando Verdasco,Janko Tipsarevic,6-4; 7-6(4),R64,97,7,4,33,56,27,33,15,23,0,2,11,42,56,5,6,43,75,28,43,16,32,5,8,11,44,75
2008-03-27 00:00:00.000,ATP Masters Series Miami FL; U.S.A. ATP World Tour,HARD,2,Thomas Johansson,David Ferrer,Thomas Johansson,6-4; 7-5,R64,104,9,3,40,84,31,40,20,44,7,9,11,51,84,2,3,39,71,22,39,18,32,3,7,11,40,71
2008-03-27 00:00:00.000,ATP Masters Series Miami FL; U.S.A. ATP World Tour,HARD,2,Dmitry Tursunov,Richard Gasquet,Dmitry Tursunov,6-3; 6-7(2); 7-6(5),R64,149,12,5,54,113,40,54,32,59,8,11,17,72,113,10,2,59,102,43,59,21,43,1,5,16,64,102
2008-03-27 00:00:00.000,ATP Masters Series Miami FL; U.S.A. ATP World Tour,HARD,2,Feliciano Lopez,Juan Martin Del Potro,Feliciano Lopez,6-4; 6-2,R64,65,8,4,35,56,29,35,8,21,2,3,9,37,56,1,2,32,44,19,32,5,12,1,5,9,24,44
2008-03-27 00:00:00.000,ATP Masters Series Miami FL; U.S.A. ATP World Tour,HARD,2,Juan Carlos Ferrero,Albert Montanes,Juan Carlos Ferrero,6-3; 6-2,R64,65,8,1,27,55,21,27,20,28,3,3,9,41,55,2,4,26,44,18,26,7,18,3,6,8,25,44
2008-03-27 00:00:00.000,ATP Masters Series Miami FL; U.S.A. ATP World Tour,HARD,2,Tomas Berdych,Sam Querrey,Tomas Berdych,6-1; 6-2,R64,60,5,0,20,43,18,20,15,23,1,1,8,33,43,5,2,37,59,17,37,12,22,9,13,7,29,59
2008-03-27 00:00:00.000,ATP Masters Series Miami FL; U.S.A. ATP World Tour,HARD,2,Guillermo Canas,Sam Warburg,Guillermo Canas,6-3; 4-6; 7-5,R64,151,13,5,64,119,47,64,28,55,9,11,15,75,119,7,4,57,88,44,57,12,31,2,6,16,56,88
2008-03-27 00:00:00.000,ATP Masters Series Miami FL; U.S.A. ATP World Tour,HARD,2,Fernando Gonzalez,Pablo Cuevas,Fernando Gonzalez,6-3; 6-3,R64,71,3,2,32,51,26,32,12,19,0,0,9,38,51,5,1,48,75,25,48,16,27,5,8,9,41,75
2008-03-27 00:00:00.000,ATP Masters Series Miami FL; U.S.A. ATP World Tour,HARD,2,Igor Andreev,Michael Berrer,Igor Andreev,6-2; 6-1,R64,71,5,0,38,50,29,38,6,12,2,2,8,35,50,3,2,35,56,18,35,9,21,4,8,7,27,56
2008-03-27 00:00:00.000,ATP Masters Series Miami FL; U.S.A. ATP World Tour,HARD,2,Kevin Anderson,Novak Djokovic,Kevin Anderson,7-6(1); 3-6; 6-4,R64,142,6,5,70,107,51,70,19,37,3,6,16,70,107,4,1,50,89,34,50,22,39,3,5,15,56,89
2008-03-27 00:00:00.000,ATP Masters Series Miami FL; U.S.A. ATP World Tour,HARD,2,Xavier Malisse,David Nalbandian,Xavier Malisse,6-1; 6-4,R64,71,3,1,36,51,24,36,8,15,6,8,8,32,51,0,2,24,49,14,24,8,25,2,8,9,22,49
2008-03-27 00:00:00.000,ATP Masters Series Miami FL; U.S.A. ATP World Tour,HARD,2,Radek Stepanek,Sebastien Grosjean,Radek Stepanek,6-3; 6-3,R64,77,3,2,44,61,33,44,9,17,4,4,9,42,61,2,1,35,53,21,35,10,18,1,4,9,31,53
2008-03-27 00:00:00.000,ATP Masters Series Miami FL; U.S.A. ATP World Tour,HARD,2,Fabrice Santoro,Ivan Ljubicic,Fabrice Santoro,7-6(4); 2-6; 6-3,R64,124,3,1,50,92,36,50,26,42,4,7,15,62,92,14,2,52,87,42,52,17,35,2,4,14,59,87
2008-03-27 00:00:00.000,ATP Masters Series Miami FL; U.S.A. ATP World Tour,HARD,2,James Blake,Andreas Seppi,James Blake,7-5; 6-3,R64,67,7,3,37,67,28,37,16,30,2,3,11,44,67,6,5,32,53,22,32,12,21,3,6,10,34,53
2008-03-27 00:00:00.000,ATP Masters Series Miami FL; U.S.A. ATP World Tour,HARD,2,Paul-Henri Mathieu,Marin Cilic,Paul-Henri Mathieu,4-6; 6-1; 6-4,R64,125,3,6,46,92,35,46,21,46,4,7,14,56,92,7,7,39,82,26,39,20,43,7,12,13,46,82
2008-03-27 00:00:00.000,ATP Masters Series Miami FL; U.S.A. ATP World Tour,HARD,2,Carlos Moya,Nicolas Mahut,Carlos Moya,7-6(10); 6-4,R64,101,5,2,48,70,37,48,14,22,0,1,11,51,70,5,4,51,80,37,51,14,29,3,5,11,51,80
2008-03-27 00:00:00.000,ATP Masters Series Miami FL; U.S.A. ATP World Tour,HARD,2,Nicolas Kiefer,Jarkko Nieminen,Nicolas Kiefer,6-3; 6-2,R64,61,8,2,28,51,26,28,13,23,5,5,9,39,51,4,1,28,42,19,28,6,14,1,4,8,25,42
2008-03-27 00:00:00.000,ATP Masters Series Miami FL; U.S.A. ATP World Tour,HARD,2,Rafael Nadal,Benjamin Becker,Rafael Nadal,7-5; 6-2,R64,81,8,1,33,52,24,33,15,19,2,3,10,39,52,8,1,25,54,15,25,15,29,1,5,10,30,54
2008-03-27 00:00:00.000,ATP Masters Series Miami FL; U.S.A. ATP World Tour,HARD,2,Roger Federer,Robin Soderling,Roger Federer,6-4; 3-0 RET,R32,47,6,1,29,41,23,29,6,12,3,4,7,29,41,0,2,17,33,10,17,5,16,2,5,6,15,33
2008-03-27 00:00:00.000,ATP Masters Series Miami FL; U.S.A. ATP World Tour,HARD,2,Jose Acasuso,Dudi Sela,Jose Acasuso,6-4; 6-4,R32,86,7,2,33,65,28,33,15,32,2,3,10,43,65,1,1,41,61,26,41,10,20,4,7,10,36,61
2008-03-27 00:00:00.000,ATP Masters Series Miami FL; U.S.A. ATP World Tour,HARD,2,Julien Benneteau,Jo-Wilfried Tsonga,Julien Benneteau,6-3; 6-3,R32,86,4,3,29,60,21,29,21,31,4,4,9,42,60,4,2,34,60,24,34,10,26,8,11,9,34,60
2008-03-27 00:00:00.000,ATP Masters Series Miami FL; U.S.A. ATP World Tour,HARD,2,Andy Roddick,Ivo Minar,Andy Roddick,7-6(4); 6-4,R32,99,10,0,37,65,30,37,16,28,0,1,11,46,65,4,1,48,88,31,48,22,40,7,9,11,53,88
2008-03-27 00:00:00.000,ATP Masters Series Miami FL; U.S.A. ATP World Tour,HARD,2,Nikolay Davydenko,Simone Bolelli,Nikolay Davydenko,6-7(5); 7-5; 6-1,R32,158,4,2,65,115,52,65,27,50,6,6,16,79,115,5,2,72,102,47,72,17,30,8,11,15,64,102
2008-03-27 00:00:00.000,ATP Masters Series Miami FL; U.S.A. ATP World Tour,HARD,2,Mario Ancic,Juan Monaco,Mario Ancic,7-6(5); 4-6; 6-1,R32,160,8,4,56,101,45,56,20,45,3,6,15,65,101,1,7,67,103,46,67,14,36,6,10,14,60,103
2008-03-27 00:00:00.000,ATP Masters Series Miami FL; U.S.A. ATP World Tour,HARD,2,Mikhail Youzhny,Nicolas Almagro,Mikhail Youzhny,7-6(4); 3-6; 7-6(6),R32,163,6,5,78,130,51,78,23,52,17,23,16,74,130,10,5,66,122,46,66,25,56,11,16,17,71,122
2008-03-27 00:00:00.000,ATP Masters Series Miami FL; U.S.A. ATP World Tour,HARD,2,Janko Tipsarevic,Thomas Johansson,Janko Tipsarevic,6-4; 6-4,R32,91,16,3,32,66,28,32,20,34,5,5,10,48,66,7,4,28,59,20,28,16,31,3,5,10,36,59
2008-03-27 00:00:00.000,ATP Masters Series Miami FL; U.S.A. ATP World Tour,HARD,2,Dmitry Tursunov,Feliciano Lopez,Dmitry Tursunov,4-6; 6-3; 6-4,R32,131,14,2,50,93,41,50,23,43,2,3,15,64,93,15,0,46,79,33,46,21,33,1,3,14,54,79
2008-03-27 00:00:00.000,ATP Masters Series Miami FL; U.S.A. ATP World Tour,HARD,2,Tomas Berdych,Juan Carlos Ferrero,Tomas Berdych,6-1; 6-3,R32,65,6,1,24,45,19,24,12,21,1,2,8,31,45,1,2,23,46,13,23,5,23,2,7,8,18,46
2008-03-27 00:00:00.000,ATP Masters Series Miami FL; U.S.A. ATP World Tour,HARD,2,Guillermo Canas,Fernando Gonzalez,Guillermo Canas,7-6(6); 7-5,R32,136,10,1,45,81,35,45,22,36,6,7,12,57,81,2,3,47,86,30,47,22,39,1,3,12,52,86
2008-03-27 00:00:00.000,ATP Masters Series Miami FL; U.S.A. ATP World Tour,HARD,2,Igor Andreev,Kevin Anderson,Igor Andreev,6-4; 6-7(4); 6-4,R32,141,8,3,59,94,46,59,24,35,2,2,16,70,94,2,5,64,110,43,64,30,46,3,5,16,73,110
2008-03-27 00:00:00.000,ATP Masters Series Miami FL; U.S.A. ATP World Tour,HARD,2,Radek Stepanek,Xavier Malisse,Radek Stepanek,6-3; 7-6(4),R32,100,5,2,38,70,29,38,22,32,3,3,11,51,70,7,1,42,75,29,42,18,33,5,6,10,47,75
2008-03-27 00:00:00.000,ATP Masters Series Miami FL; U.S.A. ATP World Tour,HARD,2,James Blake,Fabrice Santoro,James Blake,6-3; 6-7(4); 6-4,R32,136,6,5,60,114,45,60,22,54,4,8,16,67,114,5,1,58,105,34,58,24,47,7,13,15,58,105
2008-03-27 00:00:00.000,ATP Masters Series Miami FL; U.S.A. ATP World Tour,HARD,2,Paul-Henri Mathieu,Carlos Moya,Paul-Henri Mathieu,7-6(1); 7-5,R32,111,4,2,40,75,31,40,21,35,0,1,12,52,75,11,1,46,70,33,46,12,24,0,2,12,45,70
2008-03-27 00:00:00.000,ATP Masters Series Miami FL; U.S.A. ATP World Tour,HARD,2,Rafael Nadal,Nicolas Kiefer,Rafael Nadal,6-2; 6-4,R32,110,6,0,34,52,27,34,12,18,0,0,9,39,52,8,0,31,56,21,31,9,25,1,4,9,30,56
2008-03-27 00:00:00.000,ATP Masters Series Miami FL; U.S.A. ATP World Tour,HARD,2,Roger Federer,Jose Acasuso,Roger Federer,7-6(5); 6-2,R16,75,12,4,39,55,36,39,9,16,0,0,10,45,55,5,6,33,63,22,33,17,30,5,7,10,39,63
2008-03-27 00:00:00.000,ATP Masters Series Miami FL; U.S.A. ATP World Tour,HARD,2,Andy Roddick,Julien Benneteau,Andy Roddick,4-6; 6-3; 6-2,R16,128,11,1,49,84,43,49,17,35,3,4,14,60,84,6,7,39,89,29,39,24,50,5,8,13,53,89
2008-03-27 00:00:00.000,ATP Masters Series Miami FL; U.S.A. ATP World Tour,HARD,2,Nikolay Davydenko,Mario Ancic,Nikolay Davydenko,4-6; 6-3; 7-5,R16,150,4,4,60,93,38,60,20,33,2,6,16,58,93,4,2,49,92,36,49,17,43,1,6,15,53,92
2008-03-27 00:00:00.000,ATP Masters Series Miami FL; U.S.A. ATP World Tour,HARD,2,Janko Tipsarevic,Mikhail Youzhny,Janko Tipsarevic,3-6; 6-0; 6-3,R16,118,3,1,36,70,28,36,18,34,3,5,12,46,70,1,4,36,82,27,36,17,46,7,12,12,44,82
2008-03-27 00:00:00.000,ATP Masters Series Miami FL; U.S.A. ATP World Tour,HARD,2,Tomas Berdych,Dmitry Tursunov,Tomas Berdych,6-2; 6-2,R16,65,8,4,26,49,23,26,11,23,1,1,8,34,49,6,1,27,42,19,27,3,15,0,4,8,22,42
2008-03-27 00:00:00.000,ATP Masters Series Miami FL; U.S.A. ATP World Tour,HARD,2,Igor Andreev,Guillermo Canas,Igor Andreev,6-4; 7-6(6),R16,124,6,1,49,80,33,49,18,31,3,5,11,51,80,4,2,42,74,26,42,18,32,3,6,11,44,74
2008-03-27 00:00:00.000,ATP Masters Series Miami FL; U.S.A. ATP World Tour,HARD,2,James Blake,Radek Stepanek,James Blake,6-3; 6-4,R16,83,7,1,35,64,25,35,13,29,1,3,10,38,64,5,1,43,58,23,43,8,15,5,9,9,31,58
2008-03-27 00:00:00.000,ATP Masters Series Miami FL; U.S.A. ATP World Tour,HARD,2,Rafael Nadal,Paul-Henri Mathieu,Rafael Nadal,6-4; 6-4,R16,90,3,1,42,55,36,42,4,13,0,1,10,40,55,4,1,38,62,22,38,16,24,8,11,10,38,62
2008-03-27 00:00:00.000,ATP Masters Series Miami FL; U.S.A. ATP World Tour,HARD,2,Andy Roddick,Roger Federer,Andy Roddick,7-6(4); 4-6; 6-3,Q,115,17,1,70,101,54,70,15,31,2,3,16,69,101,7,1,54,85,40,54,19,31,0,1,15,59,85
2008-03-27 00:00:00.000,ATP Masters Series Miami FL; U.S.A. ATP World Tour,HARD,2,Nikolay Davydenko,Janko Tipsarevic,Nikolay Davydenko,6-2; 6-1,Q,72,9,3,32,53,22,32,13,21,1,2,8,35,53,3,1,23,45,14,23,5,22,1,6,7,19,45
2008-03-27 00:00:00.000,ATP Masters Series Miami FL; U.S.A. ATP World Tour,HARD,2,Tomas Berdych,Igor Andreev,Tomas Berdych,6-4; 6-4,Q,78,4,0,33,55,25,33,17,22,3,3,10,42,55,3,0,37,53,29,37,8,16,0,2,10,37,53
2008-03-27 00:00:00.000,ATP Masters Series Miami FL; U.S.A. ATP World Tour,HARD,2,Rafael Nadal,James Blake,Rafael Nadal,3-6; 6-3; 6-1,Q,121,3,0,47,66,31,47,16,19,2,3,12,47,66,9,5,51,100,37,51,20,49,15,19,13,57,100
2008-03-27 00:00:00.000,ATP Masters Series Miami FL; U.S.A. ATP World Tour,HARD,2,Nikolay Davydenko,Andy Roddick,Nikolay Davydenko,7-6(5); 6-2,S,89,6,0,39,52,34,39,5,13,0,1,10,39,52,9,1,53,74,35,53,8,21,5,8,10,43,74
2008-03-27 00:00:00.000,ATP Masters Series Miami FL; U.S.A. ATP World Tour,HARD,2,Rafael Nadal,Tomas Berdych,Rafael Nadal,7-6(6); 6-2,S,102,6,2,43,63,33,43,14,20,3,4,10,47,63,5,1,35,64,25,35,12,29,2,5,10,37,64
2008-03-27 00:00:00.000,ATP Masters Series Miami FL; U.S.A. ATP World Tour,HARD,2,Nikolay Davydenko,Rafael Nadal,Nikolay Davydenko,6-4; 6-2,F,91,3,2,30,47,24,30,10,17,2,3,9,34,47,0,1,35,50,21,35,6,15,2,6,9,27,50
2008-04-14 00:00:00.000,Estoril Portugal ATP World Tour,CLAY,2,Roger Federer,Olivier Rochus,Roger Federer,4-6; 6-3; 6-2,R32,120,17,3,46,79,41,46,16,33,1,2,14,57,79,1,5,74,110,44,74,20,36,10,13,13,64,110
2008-04-14 00:00:00.000,Estoril Portugal ATP World Tour,CLAY,2,Victor Hanescu,Olivier Patience,Victor Hanescu,6-1; 7-6(2),R32,72,0,2,38,55,30,38,12,17,0,1,10,42,55,2,4,35,57,24,35,8,22,1,4,9,32,57
2008-04-14 00:00:00.000,Estoril Portugal ATP World Tour,CLAY,2,Joao Sousa,Oliver Marach,Joao Sousa,6-1; 6-3,R32,57,4,0,24,44,17,24,14,20,3,4,8,31,44,1,1,16,41,7,16,11,25,3,8,8,18,41
2008-04-14 00:00:00.000,Estoril Portugal ATP World Tour,CLAY,2,Frederico Gil,Nicolas Mahut,Frederico Gil,6-0; 6-3,R32,68,3,1,27,46,21,27,11,19,0,0,8,32,46,1,4,25,49,16,25,7,24,5,9,7,23,49
2008-04-14 00:00:00.000,Estoril Portugal ATP World Tour,CLAY,2,Denis Gremelmayr,Jarkko Nieminen,Denis Gremelmayr,3-6; 6-1; 6-2,R32,86,6,1,36,67,28,36,16,31,2,5,12,44,67,0,2,67,92,38,67,11,25,12,18,12,49,92
2008-04-14 00:00:00.000,Estoril Portugal ATP World Tour,CLAY,2,Teymuraz Gabashvili,Florian Mayer,Teymuraz Gabashvili,7-5; 7-5,R32,109,3,5,50,92,30,50,22,42,10,14,12,52,92,0,3,51,84,25,51,16,33,4,10,12,41,84
2008-04-14 00:00:00.000,Estoril Portugal ATP World Tour,CLAY,2,Jiri Vanek,Philipp Petzschner,Jiri Vanek,4-6; 6-3; 6-4,R32,139,2,6,47,96,35,47,26,49,9,12,14,61,96,2,4,50,98,36,50,18,48,3,8,15,54,98
2008-04-14 00:00:00.000,Estoril Portugal ATP World Tour,CLAY,2,Michael Berrer,Gastao Elias,Michael Berrer,6-4; 7-5,R32,106,2,4,39,64,29,39,9,25,2,5,11,38,64,4,3,35,74,17,35,23,39,2,7,11,40,74
2008-04-14 00:00:00.000,Estoril Portugal ATP World Tour,CLAY,2,Gilles Simon,Roko Karanusic,Gilles Simon,7-5; 7-5,R32,95,3,1,38,65,27,38,15,27,1,4,12,42,65,1,1,42,80,25,42,19,38,8,13,12,44,80
2008-04-14 00:00:00.000,Estoril Portugal ATP World Tour,CLAY,2,Flavio Cipolla,Edouard Roger-Vasselin,Flavio Cipolla,6-4; 5-7; 6-4,R32,166,0,1,86,114,54,86,13,28,13,18,16,67,114,1,4,81,124,52,81,16,43,14,20,16,68,124
2008-04-14 00:00:00.000,Estoril Portugal ATP World Tour,CLAY,2,Florent Serra,Gianluca Naso,Florent Serra,6-1; 6-2,R32,72,2,1,40,56,29,40,6,16,2,3,8,35,56,2,2,27,54,14,27,9,27,4,9,7,23,54
2008-04-14 00:00:00.000,Estoril Portugal ATP World Tour,CLAY,2,Rui Machado,Ivo Karlovic,Rui Machado,6-4; 1-0 RET,R32,43,0,2,16,23,13,16,5,7,0,1,5,18,23,5,1,18,35,14,18,4,17,1,4,6,18,35
2008-04-14 00:00:00.000,Estoril Portugal ATP World Tour,CLAY,2,Marc Gicquel,Boris Pashanski,Marc Gicquel,6-4; 6-3,R32,78,12,1,30,50,26,30,10,20,1,2,9,36,50,1,4,22,60,14,22,18,38,3,7,10,32,60
2008-04-14 00:00:00.000,Estoril Portugal ATP World Tour,CLAY,2,Thierry Ascione,Alexander Kudryavtsev,Thierry Ascione,6-1; 6-4,R32,64,0,0,31,52,20,31,16,21,3,4,9,36,52,2,3,27,55,16,27,12,28,5,9,8,28,55
2008-04-14 00:00:00.000,Estoril Portugal ATP World Tour,CLAY,2,Ivo Minar,Martin Vassallo Arguello,Ivo Minar,7-5; 6-1,R32,90,2,2,34,66,21,34,18,32,2,5,10,39,66,0,0,38,57,14,38,11,19,2,8,9,25,57
2008-04-14 00:00:00.000,Estoril Portugal ATP World Tour,CLAY,2,Nikolay Davydenko,Jurgen Melzer,Nikolay Davydenko,6-3; 6-1,R32,60,0,1,31,40,23,31,5,9,0,1,8,28,40,1,2,36,59,18,36,9,23,7,12,8,27,59
2008-04-14 00:00:00.000,Estoril Portugal ATP World Tour,CLAY,2,Roger Federer,Victor Hanescu,Roger Federer,6-3; 6-2,R16,60,3,1,26,48,22,26,15,22,0,0,9,37,48,1,0,35,51,18,35,9,16,2,5,8,27,51
2008-04-14 00:00:00.000,Estoril Portugal ATP World Tour,CLAY,2,Frederico Gil,Joao Sousa,Frederico Gil,7-6(5); 6-2,R16,120,2,0,44,61,36,44,11,17,2,2,10,47,61,3,3,47,75,30,47,17,28,4,6,10,47,75
2008-04-14 00:00:00.000,Estoril Portugal ATP World Tour,CLAY,2,Denis Gremelmayr,Teymuraz Gabashvili,Denis Gremelmayr,7-6(6); 6-1,R16,100,2,1,33,60,23,33,14,27,1,4,10,37,60,5,5,38,74,22,38,14,36,12,17,9,36,74
2008-04-14 00:00:00.000,Estoril Portugal ATP World Tour,CLAY,2,Jiri Vanek,Michael Berrer,Jiri Vanek,6-3; 3-6; 7-5,R16,143,2,3,48,90,31,48,27,42,2,5,15,58,90,2,6,60,98,44,60,16,38,6,10,15,60,98
2008-04-14 00:00:00.000,Estoril Portugal ATP World Tour,CLAY,2,Flavio Cipolla,Gilles Simon,Flavio Cipolla,6-2; 5-3 RET,R16,73,1,5,46,63,32,46,6,17,6,8,8,38,63,3,3,24,41,11,24,4,17,0,5,8,15,41
2008-04-14 00:00:00.000,Estoril Portugal ATP World Tour,CLAY,2,Florent Serra,Rui Machado,Florent Serra,7-6(5); 6-1,R16,106,1,0,47,75,29,47,15,28,2,4,9,44,75,0,4,44,81,23,44,17,37,6,11,10,40,81
2008-04-14 00:00:00.000,Estoril Portugal ATP World Tour,CLAY,2,Marc Gicquel,Thierry Ascione,Marc Gicquel,7-6(2); 6-3,R16,97,7,3,33,75,25,33,22,42,4,7,11,47,75,2,1,46,70,29,46,9,24,2,6,10,38,70
2008-04-14 00:00:00.000,Estoril Portugal ATP World Tour,CLAY,2,Nikolay Davydenko,Ivo Minar,Nikolay Davydenko,2-6; 6-2; 6-4,R16,112,3,4,57,85,41,57,9,28,3,7,13,50,85,5,1,49,74,34,49,7,25,2,7,13,41,74
2008-04-14 00:00:00.000,Estoril Portugal ATP World Tour,CLAY,2,Roger Federer,Frederico Gil,Roger Federer,6-4; 6-1,Q,94,5,1,35,50,26,35,7,15,3,5,9,33,50,0,1,34,44,14,34,4,10,2,7,8,18,44
2008-04-14 00:00:00.000,Estoril Portugal ATP World Tour,CLAY,2,Denis Gremelmayr,Jiri Vanek,Denis Gremelmayr,6-2; 3-6; 6-2,Q,94,4,1,38,65,27,38,20,27,3,4,12,47,65,4,1,44,78,30,44,17,34,6,10,13,47,78
2008-04-14 00:00:00.000,Estoril Portugal ATP World Tour,CLAY,2,Florent Serra,Flavio Cipolla,Florent Serra,6-1; 6-1,Q,62,1,1,34,58,26,34,12,24,9,9,7,38,58,0,5,44,56,22,44,3,12,9,14,7,25,56
2008-04-14 00:00:00.000,Estoril Portugal ATP World Tour,CLAY,2,Nikolay Davydenko,Marc Gicquel,Nikolay Davydenko,6-4; 5-7; 6-3,Q,150,4,3,53,96,38,53,21,43,7,11,15,59,96,1,1,61,111,40,61,20,50,2,8,16,60,111
2008-04-14 00:00:00.000,Estoril Portugal ATP World Tour,CLAY,2,Roger Federer,Denis Gremelmayr,Roger Federer,2-6; 7-5; 6-1,S,93,10,0,51,73,36,51,14,22,1,4,14,50,73,3,4,44,81,30,44,15,37,2,6,13,45,81
2008-04-14 00:00:00.000,Estoril Portugal ATP World Tour,CLAY,2,Nikolay Davydenko,Florent Serra,Nikolay Davydenko,6-2; 6-2,S,72,1,3,35,60,26,35,13,25,7,8,8,39,60,0,0,35,44,16,35,4,9,3,8,8,20,44
2008-04-14 00:00:00.000,Estoril Portugal ATP World Tour,CLAY,2,Roger Federer,Nikolay Davydenko,Roger Federer,7-6(5); 1-2 RET,F,79,5,0,36,58,26,36,11,22,4,5,8,37,58,3,1,39,53,26,39,9,14,5,5,7,35,53
2008-04-14 00:00:00.000,Houston TX; U.S.A. ATP World Tour,CLAY,2,James Blake,Kei Nishikori,James Blake,6-4; 6-4,R32,87,4,0,30,59,19,30,18,29,2,4,10,37,59,4,2,43,84,22,43,22,41,7,11,10,44,84
2008-04-14 00:00:00.000,Houston TX; U.S.A. ATP World Tour,CLAY,2,Ryan Harrison,Pablo Cuevas,Ryan Harrison,6-4; 6-3,R32,58,6,1,29,49,22,29,11,20,1,3,10,33,49,1,2,29,51,18,29,10,22,2,6,9,28,51
2008-04-14 00:00:00.000,Houston TX; U.S.A. ATP World Tour,CLAY,2,Paul Capdeville,Diego Hartfield,Paul Capdeville,6-0; 6-4,R32,98,1,3,43,90,26,43,23,47,17,19,8,49,90,0,1,34,48,16,34,3,14,1,7,8,19,48
2008-04-14 00:00:00.000,Houston TX; U.S.A. ATP World Tour,CLAY,2,Agustin Calleri,Vincent Spadea,Agustin Calleri,6-4; 6-3,R32,82,4,4,27,68,20,27,23,41,3,4,9,43,68,0,4,39,62,24,39,9,23,4,8,10,33,62
2008-04-14 00:00:00.000,Houston TX; U.S.A. ATP World Tour,CLAY,2,Mardy Fish,Rainer Schuettler,Mardy Fish,7-6(4); 6-3,R32,82,11,3,32,62,27,32,20,30,0,1,11,47,62,2,3,42,66,32,42,8,24,3,5,10,40,66
2008-04-14 00:00:00.000,Houston TX; U.S.A. ATP World Tour,CLAY,2,Hugo Armando,Carlos Berlocq,Hugo Armando,6-3; 4-6; 7-5,R32,165,2,2,71,103,42,71,17,32,6,11,16,59,103,3,0,67,98,40,67,14,31,5,11,15,54,98
2008-04-14 00:00:00.000,Houston TX; U.S.A. ATP World Tour,CLAY,2,Donald Young,Fernando Vicente,Donald Young,6-3; 7-6(5),R32,102,0,4,54,82,36,54,11,28,10,14,11,47,82,0,1,34,68,21,34,15,34,5,10,10,36,68
2008-04-14 00:00:00.000,Houston TX; U.S.A. ATP World Tour,CLAY,2,Oscar Hernandez,Juan Pablo Brzezicki,Oscar Hernandez,3-6; 6-3; 6-2,R32,90,1,3,44,72,33,44,14,28,1,4,13,47,72,1,9,50,84,31,50,13,34,4,9,13,44,84
2008-04-14 00:00:00.000,Houston TX; U.S.A. ATP World Tour,CLAY,2,Marcel Granollers,Ernests Gulbis,Marcel Granollers,6-2; 6-0,R32,50,0,6,22,41,20,22,9,19,0,0,7,29,41,0,4,19,36,8,19,6,17,2,7,7,14,36
2008-04-14 00:00:00.000,Houston TX; U.S.A. ATP World Tour,CLAY,2,Peter Luczak,Harel Levy,Peter Luczak,6-4; 6-4,R32,84,3,3,44,69,30,44,14,25,12,13,10,44,69,4,3,30,57,23,30,13,27,2,5,10,36,57
2008-04-14 00:00:00.000,Houston TX; U.S.A. ATP World Tour,CLAY,2,Marcos Daniel,Viktor Troicki,Marcos Daniel,6-3; 6-4,R32,83,4,2,36,53,29,36,12,17,2,2,10,41,53,4,0,40,57,25,40,11,17,4,6,9,36,57
2008-04-14 00:00:00.000,Houston TX; U.S.A. ATP World Tour,CLAY,2,Nicolas Massu,Sam Querrey,Nicolas Massu,5-7; 6-4; 6-4,R32,168,4,3,68,98,47,68,15,30,3,7,16,62,98,8,8,54,121,37,54,31,67,15,20,16,68,121
2008-04-14 00:00:00.000,Houston TX; U.S.A. ATP World Tour,CLAY,2,Dudi Sela,Robby Ginepri,Dudi Sela,7-6(5); 6-2,R32,86,4,3,48,74,32,48,12,26,5,7,10,44,74,1,2,49,70,29,49,10,21,3,7,10,39,70
2008-04-14 00:00:00.000,Houston TX; U.S.A. ATP World Tour,CLAY,2,Wayne Odesnik,Amer Delic,Wayne Odesnik,6-3; 6-3,R32,91,2,1,52,73,41,52,8,21,7,7,9,49,73,5,3,43,66,28,43,8,23,5,8,9,36,66
2008-04-14 00:00:00.000,Houston TX; U.S.A. ATP World Tour,CLAY,2,Sergio Roitman,John Isner,Sergio Roitman,3-6; 7-6(6); 6-3,R32,132,3,0,66,92,51,66,13,26,6,7,14,64,92,12,1,70,108,47,70,23,38,8,10,16,70,108
2008-04-14 00:00:00.000,Houston TX; U.S.A. ATP World Tour,CLAY,2,Igor Kunitsyn,Tommy Haas,Igor Kunitsyn,5-7; 6-4; 6-4,R32,168,1,6,68,111,40,68,21,43,9,15,16,61,111,7,12,63,129,36,63,31,66,8,15,16,67,129
2008-04-14 00:00:00.000,Houston TX; U.S.A. ATP World Tour,CLAY,2,James Blake,Ryan Harrison,James Blake,6-3; 6-2,R16,51,2,3,19,37,15,19,10,18,0,2,8,25,37,0,5,24,49,15,24,7,25,1,7,9,22,49
2008-04-14 00:00:00.000,Houston TX; U.S.A. ATP World Tour,CLAY,2,Agustin Calleri,Paul Capdeville,Agustin Calleri,6-2; 6-1,R16,59,4,5,25,51,23,25,14,26,1,1,8,37,51,0,1,33,53,19,33,6,20,11,15,7,25,53
2008-04-14 00:00:00.000,Houston TX; U.S.A. ATP World Tour,CLAY,2,Mardy Fish,Hugo Armando,Mardy Fish,6-3; 6-2,R16,79,9,2,37,66,28,37,14,29,5,6,9,42,66,0,4,33,54,18,33,10,21,3,7,8,28,54
2008-04-14 00:00:00.000,Houston TX; U.S.A. ATP World Tour,CLAY,2,Oscar Hernandez,Donald Young,Oscar Hernandez,6-4; 6-4,R16,96,4,3,46,66,36,46,10,20,6,6,10,46,66,2,1,48,75,30,48,13,27,7,9,10,43,75
2008-04-14 00:00:00.000,Houston TX; U.S.A. ATP World Tour,CLAY,2,Marcel Granollers,Peter Luczak,Marcel Granollers,6-3; 6-2,R16,91,4,3,41,70,25,41,17,29,7,8,9,42,70,0,1,33,52,16,33,9,19,3,7,8,25,52
2008-04-14 00:00:00.000,Houston TX; U.S.A. ATP World Tour,CLAY,2,Marcos Daniel,Nicolas Massu,Marcos Daniel,7-6(3); 6-2,R16,111,3,0,53,78,41,53,13,25,4,4,10,54,78,2,3,36,65,25,36,16,29,4,6,10,41,65
2008-04-14 00:00:00.000,Houston TX; U.S.A. ATP World Tour,CLAY,2,Wayne Odesnik,Dudi Sela,Wayne Odesnik,6-3; 7-5,R16,83,1,1,38,64,27,38,14,26,3,5,11,41,64,0,2,28,59,17,28,14,31,5,9,10,31,59
2008-04-14 00:00:00.000,Houston TX; U.S.A. ATP World Tour,CLAY,2,Sergio Roitman,Igor Kunitsyn,Sergio Roitman,6-3; 7-6(3),R16,115,0,3,52,72,31,52,12,20,4,7,10,43,72,1,1,56,85,32,56,12,29,10,15,11,44,85
2008-04-14 00:00:00.000,Houston TX; U.S.A. ATP World Tour,CLAY,2,James Blake,Agustin Calleri,James Blake,6-4; 6-3,Q,67,7,1,33,54,25,33,17,21,2,2,10,42,54,3,4,25,55,18,25,16,30,0,2,9,34,55
2008-04-14 00:00:00.000,Houston TX; U.S.A. ATP World Tour,CLAY,2,Oscar Hernandez,Mardy Fish,Oscar Hernandez,6-2; 7-6(5),Q,107,3,2,33,55,25,33,13,22,2,4,10,38,55,7,4,36,86,28,36,19,50,6,10,10,47,86
2008-04-14 00:00:00.000,Houston TX; U.S.A. ATP World Tour,CLAY,2,Marcel Granollers,Marcos Daniel,Marcel Granollers,6-3; 6-2,Q,77,2,5,25,52,19,25,14,27,1,2,8,33,52,1,3,34,55,18,34,8,21,2,7,9,26,55
2008-04-14 00:00:00.000,Houston TX; U.S.A. ATP World Tour,CLAY,2,Wayne Odesnik,Sergio Roitman,Wayne Odesnik,2-6; 7-6(4); 6-1,Q,159,2,3,51,88,31,51,16,37,5,11,13,47,88,3,5,52,96,28,52,19,44,9,16,14,47,96
2008-04-14 00:00:00.000,Houston TX; U.S.A. ATP World Tour,CLAY,2,James Blake,Oscar Hernandez,James Blake,6-3; 7-6(3),S,95,4,2,30,68,24,30,23,38,2,3,11,47,68,3,3,48,72,32,48,13,24,4,6,10,45,72
2008-04-14 00:00:00.000,Houston TX; U.S.A. ATP World Tour,CLAY,2,Marcel Granollers,Wayne Odesnik,Marcel Granollers,3-6; 7-5; 6-3,S,135,5,5,46,88,35,46,27,42,4,6,15,62,88,3,0,59,92,40,59,19,33,2,5,15,59,92
2008-04-14 00:00:00.000,Houston TX; U.S.A. ATP World Tour,CLAY,2,Marcel Granollers,James Blake,Marcel Granollers,6-4; 1-6; 7-5,F,132,1,6,51,85,32,51,13,34,2,8,15,45,85,5,4,44,89,31,44,21,45,8,13,14,52,89
2008-04-14 00:00:00.000,Valencia Spain ATP World Tour,CLAY,2,David Ferrer,Ivan Navarro,David Ferrer,6-3; 6-4,R32,93,2,1,46,62,33,46,9,16,2,3,10,42,62,4,3,52,73,35,52,6,21,8,11,9,41,73
2008-04-14 00:00:00.000,Valencia Spain ATP World Tour,CLAY,2,Pablo Andujar,Kristof Vliegen,Pablo Andujar,6-4; 6-1,R32,69,1,0,42,51,33,42,3,9,1,2,9,36,51,1,0,31,57,19,31,12,26,8,12,8,31,57
2008-04-14 00:00:00.000,Valencia Spain ATP World Tour,CLAY,2,Mischa Zverev,Luis Horna,Mischa Zverev,6-3; 6-7(5); 6-4,R32,132,9,1,65,90,50,65,16,25,2,2,15,66,90,3,2,87,113,62,87,10,26,11,14,16,72,113
2008-04-14 00:00:00.000,Valencia Spain ATP World Tour,CLAY,2,Fernando Verdasco,Nicolas Lapentti,Fernando Verdasco,5-7; 6-3; 6-4,R32,159,4,2,92,113,63,92,10,21,8,9,16,73,113,2,0,58,92,44,58,16,34,3,5,15,60,92
2008-04-14 00:00:00.000,Valencia Spain ATP World Tour,CLAY,2,Tommy Robredo,Albert Montanes,Tommy Robredo,6-3; 7-5,R32,102,2,0,47,66,33,47,10,19,1,3,11,43,66,0,4,38,69,25,38,12,31,7,11,10,37,69
2008-04-14 00:00:00.000,Valencia Spain ATP World Tour,CLAY,2,Santiago Ventura,David Marrero,Santiago Ventura,7-6(3); 7-6(6),R32,152,7,0,44,89,34,44,26,45,2,3,12,60,89,5,1,63,96,45,63,17,33,3,4,12,62,96
2008-04-14 00:00:00.000,Valencia Spain ATP World Tour,CLAY,2,Gael Monfils,Maximo Gonzalez,Gael Monfils,6-3; 6-4,R32,89,5,1,29,49,21,29,13,20,2,4,9,34,49,0,3,39,74,22,39,16,35,10,15,10,38,74
2008-04-14 00:00:00.000,Valencia Spain ATP World Tour,CLAY,2,Potito Starace,Simone Bolelli,Potito Starace,6-3; 6-1,R32,65,1,1,40,49,29,40,6,9,2,2,8,35,49,0,0,34,51,16,34,8,17,4,8,8,24,51
2008-04-14 00:00:00.000,Valencia Spain ATP World Tour,CLAY,2,Evgeny Korolev,Igor Andreev,Evgeny Korolev,6-4; 4-6; 7-6(4),R32,148,2,1,71,105,53,71,20,34,5,6,16,73,105,8,2,76,122,52,76,26,46,7,8,16,78,122
2008-04-14 00:00:00.000,Valencia Spain ATP World Tour,CLAY,2,Daniel Gimeno-Traver,Sergiy Stakhovsky,Daniel Gimeno-Traver,6-4; 6-4,R32,75,2,0,32,46,29,32,11,14,0,0,10,40,46,3,2,47,69,32,47,11,22,3,5,10,43,69
2008-04-14 00:00:00.000,Valencia Spain ATP World Tour,CLAY,2,Robin Haase,Yuri Schukin,Robin Haase,6-4; 4-1 RET,R32,65,9,0,32,44,24,32,6,12,4,6,8,30,44,1,0,34,59,16,34,11,25,3,7,7,27,59
2008-04-14 00:00:00.000,Valencia Spain ATP World Tour,CLAY,2,Marat Safin,Juan Carlos Ferrero,Marat Safin,6-3; 5-7; 6-4,R32,129,8,3,56,91,45,56,18,35,4,6,16,63,91,4,2,62,85,41,62,12,23,0,3,15,53,85
2008-04-14 00:00:00.000,Valencia Spain ATP World Tour,CLAY,2,Nicolas Almagro,Miguel Angel Lopez Jaen,Nicolas Almagro,7-5; 6-3,R32,100,13,6,46,91,37,46,20,45,6,7,11,57,91,3,0,45,72,35,45,8,27,5,8,10,43,72
2008-04-14 00:00:00.000,Valencia Spain ATP World Tour,CLAY,2,Eduardo Schwank,Christophe Rochus,Eduardo Schwank,6-2; 2-0 RET,R32,50,4,1,30,43,22,30,5,13,1,1,5,27,43,0,1,15,30,11,15,3,15,2,5,5,14,30
2008-04-14 00:00:00.000,Valencia Spain ATP World Tour,CLAY,2,Guillermo Garcia-Lopez,Steve Darcis,Guillermo Garcia-Lopez,6-4 RET,R32,43,0,2,19,31,10,19,8,12,3,4,5,18,31,1,0,13,27,7,13,8,14,2,4,5,15,27
2008-04-14 00:00:00.000,Valencia Spain ATP World Tour,CLAY,2,Juan Monaco,Werner Eschauer,Juan Monaco,6-7(5); 6-4; 6-4,R32,166,3,3,69,113,43,69,22,44,5,11,16,65,113,4,7,69,132,45,69,24,63,12,20,16,69,132
2008-04-14 00:00:00.000,Valencia Spain ATP World Tour,CLAY,2,David Ferrer,Pablo Andujar,David Ferrer,6-3; 6-4,R16,83,2,0,36,55,26,36,7,19,1,3,9,33,55,1,1,36,57,24,36,6,21,5,10,10,30,57
2008-04-14 00:00:00.000,Valencia Spain ATP World Tour,CLAY,2,Fernando Verdasco,Mischa Zverev,Fernando Verdasco,6-4; 6-2,R16,97,1,2,40,46,29,40,3,6,1,3,9,32,46,1,2,37,64,18,37,13,27,3,8,9,31,64
2008-04-14 00:00:00.000,Valencia Spain ATP World Tour,CLAY,2,Tommy Robredo,Santiago Ventura,Tommy Robredo,6-7(7); 6-3; 6-4,R16,157,2,2,73,103,57,73,18,30,1,1,16,75,103,0,3,74,110,50,74,20,36,6,8,15,70,110
2008-04-14 00:00:00.000,Valencia Spain ATP World Tour,CLAY,2,Potito Starace,Gael Monfils,Potito Starace,7-5; 6-1,R16,92,0,0,56,67,35,56,6,11,8,10,9,41,67,5,1,39,56,22,39,5,17,3,9,10,27,56
2008-04-14 00:00:00.000,Valencia Spain ATP World Tour,CLAY,2,Evgeny Korolev,Daniel Gimeno-Traver,Evgeny Korolev,6-7(8); 7-6(2); 6-3,R16,161,4,3,75,121,54,75,24,46,4,6,17,78,121,6,2,69,101,50,69,17,32,1,4,16,67,101
2008-04-14 00:00:00.000,Valencia Spain ATP World Tour,CLAY,2,Robin Haase,Marat Safin,Robin Haase,2-6; 7-6(9); 6-4,R16,147,2,3,59,98,39,59,22,39,2,6,15,61,98,5,4,68,121,50,68,25,53,8,11,15,75,121
2008-04-14 00:00:00.000,Valencia Spain ATP World Tour,CLAY,2,Nicolas Almagro,Eduardo Schwank,Nicolas Almagro,6-3; 6-4,R16,79,6,0,41,56,31,41,10,15,2,3,10,41,56,0,2,34,57,21,34,13,23,6,9,9,34,57
2008-04-14 00:00:00.000,Valencia Spain ATP World Tour,CLAY,2,Juan Monaco,Guillermo Garcia-Lopez,Juan Monaco,6-4; 6-4,R16,90,1,0,46,58,32,46,8,12,1,2,10,40,58,1,1,45,68,33,45,8,23,6,9,10,41,68
2008-04-14 00:00:00.000,Valencia Spain ATP World Tour,CLAY,2,David Ferrer,Fernando Verdasco,David Ferrer,6-3; 1-6; 7-5,Q,129,0,2,56,83,34,56,12,27,3,8,14,46,83,0,7,78,106,45,78,14,28,6,11,14,59,106
2008-04-14 00:00:00.000,Valencia Spain ATP World Tour,CLAY,2,Tommy Robredo,Potito Starace,Tommy Robredo,6-3; 3-0 RET,Q,63,1,0,38,47,28,38,5,9,4,4,6,33,47,0,0,30,39,16,30,4,9,4,7,6,20,39
2008-04-14 00:00:00.000,Valencia Spain ATP World Tour,CLAY,2,Evgeny Korolev,Robin Haase,Evgeny Korolev,7-5; 6-4,Q,113,6,2,60,89,36,60,13,29,8,12,11,49,89,6,0,54,80,28,54,10,26,6,12,11,38,80
2008-04-14 00:00:00.000,Valencia Spain ATP World Tour,CLAY,2,Nicolas Almagro,Juan Monaco,Nicolas Almagro,6-3; 6-2,Q,74,2,3,35,66,25,35,18,31,5,6,9,43,66,1,2,30,46,16,30,8,16,0,4,8,24,46
2008-04-14 00:00:00.000,Valencia Spain ATP World Tour,CLAY,2,David Ferrer,Tommy Robredo,David Ferrer,2-6; 6-2; 6-3,S,137,0,1,59,87,37,59,15,28,8,11,13,52,87,0,0,64,89,39,64,12,25,7,11,12,51,89
2008-04-14 00:00:00.000,Valencia Spain ATP World Tour,CLAY,2,Nicolas Almagro,Evgeny Korolev,Nicolas Almagro,6-1; 6-4,S,60,10,3,36,55,27,36,12,19,1,1,9,39,55,2,3,26,40,15,26,7,14,0,3,8,22,40
2008-04-14 00:00:00.000,Valencia Spain ATP World Tour,CLAY,2,David Ferrer,Nicolas Almagro,David Ferrer,4-6; 6-2; 7-6(2),F,125,0,4,59,92,43,59,16,33,2,5,15,59,92,11,6,58,90,41,58,13,32,0,4,15,54,90
2008-04-20 00:00:00.000,ATP Masters Series Monte Carlo Monaco ATP World Tour,CLAY,2,Roger Federer,N/A Bye,Roger Federer,,R64,0,0,0,0,0,0,0,0,0,0,0,0,0,0,0,0,0,0,0,0,0,0,0,0,0,0,0
2008-04-20 00:00:00.000,ATP Masters Series Monte Carlo Monaco ATP World Tour,CLAY,2,Ruben Ramirez Hidalgo,Gilles Simon,Ruben Ramirez Hidalgo,6-1; 6-1,R64,58,2,3,22,52,20,22,16,30,3,3,7,36,52,1,0,32,46,14,32,4,14,3,8,7,18,46
2008-04-20 00:00:00.000,ATP Masters Series Monte Carlo Monaco ATP World Tour,CLAY,2,Gael Monfils,Fernando Verdasco,Gael Monfils,7-5; 6-4,R64,79,6,2,31,57,26,31,17,26,0,1,11,43,57,1,3,49,66,31,49,10,17,7,10,11,41,66
2008-04-20 00:00:00.000,ATP Masters Series Monte Carlo Monaco ATP World Tour,CLAY,2,Ivo Karlovic,Sebastien Grosjean,Ivo Karlovic,4-6; 6-4; 4-1 RET,R64,108,7,5,50,87,42,50,16,37,6,7,13,58,87,0,0,53,71,36,53,11,18,5,7,12,47,71
2008-04-20 00:00:00.000,ATP Masters Series Monte Carlo Monaco ATP World Tour,CLAY,2,Tommy Robredo,Stanislas Wawrinka,Tommy Robredo,6-4; 7-5,R64,97,0,0,41,61,23,41,12,20,3,7,11,35,61,2,2,38,67,20,38,12,29,3,9,11,32,67
2008-04-20 00:00:00.000,ATP Masters Series Monte Carlo Monaco ATP World Tour,CLAY,2,Robin Soderling,Radek Stepanek,Robin Soderling,6-4; 6-7(6); 6-3,R64,139,10,6,53,95,40,53,22,42,0,2,15,62,95,7,3,62,112,37,62,28,50,7,12,16,65,112
2008-04-20 00:00:00.000,ATP Masters Series Monte Carlo Monaco ATP World Tour,CLAY,2,Olivier Rochus,Tommy Haas,Olivier Rochus,6-1; 3-0 RET,R64,49,0,0,26,35,19,26,5,9,4,4,5,24,35,3,2,17,32,9,17,3,15,2,6,5,12,32
2008-04-20 00:00:00.000,ATP Masters Series Monte Carlo Monaco ATP World Tour,CLAY,2,David Nalbandian,N/A Bye,David Nalbandian,,R64,0,0,0,0,0,0,0,0,0,0,0,0,0,0,0,0,0,0,0,0,0,0,0,0,0,0,0
2008-04-20 00:00:00.000,ATP Masters Series Monte Carlo Monaco ATP World Tour,CLAY,2,Novak Djokovic,N/A Bye,Novak Djokovic,,R64,0,0,0,0,0,0,0,0,0,0,0,0,0,0,0,0,0,0,0,0,0,0,0,0,0,0,0
2008-04-20 00:00:00.000,ATP Masters Series Monte Carlo Monaco ATP World Tour,CLAY,2,Ivan Ljubicic,Gustavo Kuerten,Ivan Ljubicic,6-1; 6-2,R64,52,7,0,19,40,15,19,17,21,0,0,8,32,40,1,3,28,52,19,28,7,24,4,8,7,26,52
2008-04-20 00:00:00.000,ATP Masters Series Monte Carlo Monaco ATP World Tour,CLAY,2,Filippo Volandri,Nicolas Mahut,Filippo Volandri,6-2; 6-3,R64,68,0,2,31,48,23,31,12,17,2,3,9,35,48,5,6,41,66,25,41,8,25,5,9,8,33,66
2008-04-20 00:00:00.000,ATP Masters Series Monte Carlo Monaco ATP World Tour,CLAY,2,Andy Murray,Feliciano Lopez,Andy Murray,7-6(5); 6-4,R64,94,2,1,44,68,34,44,14,24,2,3,11,48,68,2,2,44,70,30,44,15,26,1,3,11,45,70
2008-04-20 00:00:00.000,ATP Masters Series Monte Carlo Monaco ATP World Tour,CLAY,2,Sam Querrey,Carlos Moya,Sam Querrey,6-3; 1-6; 6-3,R64,98,4,3,42,86,32,42,22,44,2,4,13,54,86,2,1,38,68,27,38,19,30,4,6,12,46,68
2008-04-20 00:00:00.000,ATP Masters Series Monte Carlo Monaco ATP World Tour,CLAY,2,Andreas Seppi,Agustin Calleri,Andreas Seppi,6-4; 6-3,R64,85,4,3,39,57,27,39,7,18,3,5,9,34,57,4,5,40,78,28,40,11,38,9,14,10,39,78
2008-04-20 00:00:00.000,ATP Masters Series Monte Carlo Monaco ATP World Tour,CLAY,2,Kristof Vliegen,Fabrice Santoro,Kristof Vliegen,7-6(4); 6-1,R64,101,7,2,45,73,32,45,11,28,4,6,9,43,73,1,3,53,92,29,53,17,39,10,15,10,46,92
2008-04-20 00:00:00.000,ATP Masters Series Monte Carlo Monaco ATP World Tour,CLAY,2,Richard Gasquet,N/A Bye,Richard Gasquet,,R64,0,0,0,0,0,0,0,0,0,0,0,0,0,0,0,0,0,0,0,0,0,0,0,0,0,0,0
2008-04-20 00:00:00.000,ATP Masters Series Monte Carlo Monaco ATP World Tour,CLAY,2,Mikhail Youzhny,N/A Bye,Mikhail Youzhny,,R64,0,0,0,0,0,0,0,0,0,0,0,0,0,0,0,0,0,0,0,0,0,0,0,0,0,0,0
2008-04-20 00:00:00.000,ATP Masters Series Monte Carlo Monaco ATP World Tour,CLAY,2,Igor Andreev,Dmitry Tursunov,Igor Andreev,7-5; 6-3,R64,97,5,2,42,70,31,42,15,28,1,2,10,46,70,6,6,35,71,28,35,12,36,4,8,11,40,71
2008-04-20 00:00:00.000,ATP Masters Series Monte Carlo Monaco ATP World Tour,CLAY,2,Nicolas Almagro,Jean-Rene Lisnard,Nicolas Almagro,6-4; 6-4,R64,87,3,1,32,54,24,32,14,22,0,1,10,38,54,3,1,43,78,27,43,16,35,4,7,10,43,78
2008-04-20 00:00:00.000,ATP Masters Series Monte Carlo Monaco ATP World Tour,CLAY,2,Juan Monaco,Hyung-Taik Lee,Juan Monaco,6-0; 7-5,R64,75,2,0,42,55,25,42,9,13,4,6,9,34,55,1,5,33,61,17,33,10,28,3,9,9,27,61
2008-04-20 00:00:00.000,ATP Masters Series Monte Carlo Monaco ATP World Tour,CLAY,2,Philipp Kohlschreiber,Jose Acasuso,Philipp Kohlschreiber,7-6(4); 6-3,R64,104,1,2,50,73,33,50,8,23,5,9,11,41,73,3,3,46,86,29,46,15,40,10,15,10,44,86
2008-04-20 00:00:00.000,ATP Masters Series Monte Carlo Monaco ATP World Tour,CLAY,2,Nicolas Kiefer,Marin Cilic,Nicolas Kiefer,3-6; 7-6(4); 6-3,R64,163,1,3,51,99,35,51,24,48,3,6,14,59,99,4,4,63,116,38,63,28,53,6,10,16,66,116
2008-04-20 00:00:00.000,ATP Masters Series Monte Carlo Monaco ATP World Tour,CLAY,2,Simone Bolelli,Juan Ignacio Chela,Simone Bolelli,6-2; 6-2,R64,75,1,0,31,50,22,31,14,19,1,1,8,36,50,0,6,22,50,14,22,12,28,3,7,8,26,50
2008-04-20 00:00:00.000,ATP Masters Series Monte Carlo Monaco ATP World Tour,CLAY,2,Nikolay Davydenko,N/A Bye,Nikolay Davydenko,,R64,0,0,0,0,0,0,0,0,0,0,0,0,0,0,0,0,0,0,0,0,0,0,0,0,0,0,0
2008-04-20 00:00:00.000,ATP Masters Series Monte Carlo Monaco ATP World Tour,CLAY,2,David Ferrer,N/A Bye,David Ferrer,,R64,0,0,0,0,0,0,0,0,0,0,0,0,0,0,0,0,0,0,0,0,0,0,0,0,0,0,0
2008-04-20 00:00:00.000,ATP Masters Series Monte Carlo Monaco ATP World Tour,CLAY,2,Marat Safin,Xavier Malisse,Marat Safin,6-3; 6-2,R64,79,7,0,28,53,20,28,15,25,3,4,9,35,53,2,1,29,47,19,29,6,18,0,4,8,25,47
2008-04-20 00:00:00.000,ATP Masters Series Monte Carlo Monaco ATP World Tour,CLAY,2,Nicolas Lapentti,Potito Starace,Nicolas Lapentti,7-6(3); 6-7(2); 6-4,R64,200,3,3,85,121,51,85,21,36,8,12,17,72,121,4,3,91,134,58,91,19,43,9,14,17,77,134
2008-04-20 00:00:00.000,ATP Masters Series Monte Carlo Monaco ATP World Tour,CLAY,2,Janko Tipsarevic,Paul-Henri Mathieu,Janko Tipsarevic,6-4; 2-6; 6-3,R64,138,4,5,40,79,30,40,21,39,0,2,13,51,79,5,6,54,90,40,54,17,36,5,8,14,57,90
2008-04-20 00:00:00.000,ATP Masters Series Monte Carlo Monaco ATP World Tour,CLAY,2,Juan Carlos Ferrero,Michael Llodra,Juan Carlos Ferrero,6-7(5); 6-1; 6-1,R64,122,1,1,64,85,46,64,13,21,7,9,13,59,85,6,8,52,111,31,52,25,59,5,12,13,56,111
2008-04-20 00:00:00.000,ATP Masters Series Monte Carlo Monaco ATP World Tour,CLAY,2,Jarkko Nieminen,Marc Gicquel,Jarkko Nieminen,6-0; 6-4,R64,81,0,1,28,38,23,28,5,10,3,5,8,28,38,3,2,22,45,10,22,6,23,4,10,8,16,45
2008-04-20 00:00:00.000,ATP Masters Series Monte Carlo Monaco ATP World Tour,CLAY,2,Mario Ancic,Ivo Minar,Mario Ancic,6-3; 6-4,R64,77,2,3,30,53,22,30,14,23,1,2,9,36,53,3,0,38,66,23,38,14,28,3,7,10,37,66
2008-04-20 00:00:00.000,ATP Masters Series Monte Carlo Monaco ATP World Tour,CLAY,2,Rafael Nadal,N/A Bye,Rafael Nadal,,R64,0,0,0,0,0,0,0,0,0,0,0,0,0,0,0,0,0,0,0,0,0,0,0,0,0,0,0
2008-04-20 00:00:00.000,ATP Masters Series Monte Carlo Monaco ATP World Tour,CLAY,2,Roger Federer,Ruben Ramirez Hidalgo,Roger Federer,6-1; 3-6; 7-6(1),R32,124,5,3,57,92,39,57,19,35,4,7,14,58,92,2,8,55,101,36,55,20,46,3,7,14,56,101
2008-04-20 00:00:00.000,ATP Masters Series Monte Carlo Monaco ATP World Tour,CLAY,2,Gael Monfils,Ivo Karlovic,Gael Monfils,7-6(8); 6-1,R32,87,5,2,42,58,34,42,9,16,0,1,10,43,58,0,3,44,73,28,44,10,29,3,6,9,38,73
2008-04-20 00:00:00.000,ATP Masters Series Monte Carlo Monaco ATP World Tour,CLAY,2,Tommy Robredo,Robin Soderling,Tommy Robredo,6-4; 7-6(3),R32,118,0,1,79,99,49,79,8,20,13,16,11,57,99,5,5,49,86,32,49,14,37,10,14,11,46,86
2008-04-20 00:00:00.000,ATP Masters Series Monte Carlo Monaco ATP World Tour,CLAY,2,David Nalbandian,Olivier Rochus,David Nalbandian,6-4; 6-3,R32,88,3,2,43,61,28,43,13,18,5,6,10,41,61,1,2,46,65,28,46,9,19,8,11,9,37,65
2008-04-20 00:00:00.000,ATP Masters Series Monte Carlo Monaco ATP World Tour,CLAY,2,Novak Djokovic,Ivan Ljubicic,Novak Djokovic,6-3; 6-3,R32,82,3,0,40,63,26,40,14,23,7,8,9,40,63,2,4,29,52,19,29,8,23,1,5,9,27,52
2008-04-20 00:00:00.000,ATP Masters Series Monte Carlo Monaco ATP World Tour,CLAY,2,Andy Murray,Filippo Volandri,Andy Murray,6-4; 6-1,R32,85,5,0,40,72,23,40,21,32,8,9,9,44,72,0,0,28,49,15,28,7,21,4,8,8,22,49
2008-04-20 00:00:00.000,ATP Masters Series Monte Carlo Monaco ATP World Tour,CLAY,2,Sam Querrey,Andreas Seppi,Sam Querrey,6-1; 7-5,R32,80,7,0,36,61,23,36,18,25,3,4,10,41,61,0,0,32,60,18,32,15,28,7,11,9,33,60
2008-04-20 00:00:00.000,ATP Masters Series Monte Carlo Monaco ATP World Tour,CLAY,2,Richard Gasquet,Kristof Vliegen,Richard Gasquet,6-1; 6-2,R32,62,1,2,18,40,15,18,17,22,0,0,8,32,40,4,1,49,68,28,49,5,19,9,13,7,33,68
2008-04-20 00:00:00.000,ATP Masters Series Monte Carlo Monaco ATP World Tour,CLAY,2,Igor Andreev,Mikhail Youzhny,Igor Andreev,6-3 RET,R32,36,2,1,23,31,17,23,3,8,0,1,5,20,31,0,0,25,28,13,25,1,3,0,2,4,14,28
2008-04-20 00:00:00.000,ATP Masters Series Monte Carlo Monaco ATP World Tour,CLAY,2,Nicolas Almagro,Juan Monaco,Nicolas Almagro,6-2; 3-0 RET,R32,51,3,1,14,37,11,14,14,23,3,4,6,25,37,0,3,16,29,6,16,4,13,3,7,5,10,29
2008-04-20 00:00:00.000,ATP Masters Series Monte Carlo Monaco ATP World Tour,CLAY,2,Philipp Kohlschreiber,Nicolas Kiefer,Philipp Kohlschreiber,6-2; 6-4,R32,87,3,0,32,49,24,32,11,17,1,2,9,35,49,7,4,30,68,15,30,21,38,6,10,9,36,68
2008-04-20 00:00:00.000,ATP Masters Series Monte Carlo Monaco ATP World Tour,CLAY,2,Nikolay Davydenko,Simone Bolelli,Nikolay Davydenko,6-2; 7-6(5),R32,118,1,3,45,67,31,45,9,22,2,5,10,40,67,0,2,58,86,34,58,11,28,11,16,10,45,86
2008-04-20 00:00:00.000,ATP Masters Series Monte Carlo Monaco ATP World Tour,CLAY,2,David Ferrer,Marat Safin,David Ferrer,6-2; 6-3,R32,77,1,0,33,49,26,33,11,16,0,1,9,37,49,5,4,28,60,18,28,12,32,5,9,8,30,60
2008-04-20 00:00:00.000,ATP Masters Series Monte Carlo Monaco ATP World Tour,CLAY,2,Janko Tipsarevic,Nicolas Lapentti,Janko Tipsarevic,5-7; 7-6(5); 6-4,R32,184,7,5,62,123,52,62,27,61,3,5,17,79,123,4,0,62,92,51,62,16,30,2,4,17,67,92
2008-04-20 00:00:00.000,ATP Masters Series Monte Carlo Monaco ATP World Tour,CLAY,2,Juan Carlos Ferrero,Jarkko Nieminen,Juan Carlos Ferrero,6-3; 6-3,R32,87,5,2,46,69,35,46,9,23,5,6,9,44,69,2,1,49,69,24,49,11,20,10,14,9,35,69
2008-04-20 00:00:00.000,ATP Masters Series Monte Carlo Monaco ATP World Tour,CLAY,2,Rafael Nadal,Mario Ancic,Rafael Nadal,6-0; 6-3,R32,76,1,0,35,40,25,35,4,5,0,1,8,29,40,3,5,27,53,13,27,9,26,3,8,7,22,53
2008-04-20 00:00:00.000,ATP Masters Series Monte Carlo Monaco ATP World Tour,CLAY,2,Roger Federer,Gael Monfils,Roger Federer,6-3; 6-4,R16,71,0,0,36,57,22,36,17,21,0,1,10,39,57,7,4,33,55,21,33,12,22,5,8,9,33,55
2008-04-20 00:00:00.000,ATP Masters Series Monte Carlo Monaco ATP World Tour,CLAY,2,David Nalbandian,Tommy Robredo,David Nalbandian,6-1; 6-0,R16,60,1,3,26,41,24,26,7,15,3,3,7,31,41,0,3,29,45,14,29,5,16,2,7,6,19,45
2008-04-20 00:00:00.000,ATP Masters Series Monte Carlo Monaco ATP World Tour,CLAY,2,Novak Djokovic,Andy Murray,Novak Djokovic,6-0; 6-4,R16,78,0,0,20,45,14,20,17,25,4,5,8,31,45,3,5,25,60,14,25,14,35,5,10,8,28,60
2008-04-20 00:00:00.000,ATP Masters Series Monte Carlo Monaco ATP World Tour,CLAY,2,Sam Querrey,Richard Gasquet,Sam Querrey,2-6; 6-4; 6-3,R16,95,11,3,54,85,44,54,14,31,8,10,14,58,85,7,2,42,75,31,42,20,33,2,4,13,51,75
2008-04-20 00:00:00.000,ATP Masters Series Monte Carlo Monaco ATP World Tour,CLAY,2,Igor Andreev,Nicolas Almagro,Igor Andreev,7-5; 4-6; 6-4,R16,148,7,1,62,90,42,62,19,28,2,5,16,61,90,3,2,63,115,41,63,26,52,8,12,16,67,115
2008-04-20 00:00:00.000,ATP Masters Series Monte Carlo Monaco ATP World Tour,CLAY,2,Nikolay Davydenko,Philipp Kohlschreiber,Nikolay Davydenko,3-6; 7-5; 6-2,R16,131,6,2,51,84,31,51,17,33,3,9,15,48,84,1,1,62,89,34,62,10,27,5,12,14,44,89
2008-04-20 00:00:00.000,ATP Masters Series Monte Carlo Monaco ATP World Tour,CLAY,2,David Ferrer,Janko Tipsarevic,David Ferrer,6-4; 6-0,R16,67,1,0,33,47,23,33,7,14,1,3,8,30,47,1,3,14,48,7,14,13,34,2,8,8,20,48
2008-04-20 00:00:00.000,ATP Masters Series Monte Carlo Monaco ATP World Tour,CLAY,2,Rafael Nadal,Juan Carlos Ferrero,Rafael Nadal,6-4; 6-1,R16,106,3,0,34,51,23,34,9,17,0,2,9,32,51,1,0,36,67,19,36,14,31,10,15,8,33,67
2008-04-20 00:00:00.000,ATP Masters Series Monte Carlo Monaco ATP World Tour,CLAY,2,Roger Federer,David Nalbandian,Roger Federer,5-7; 6-2; 6-2,Q,128,9,2,46,88,34,46,24,42,3,5,14,58,88,2,5,54,93,35,54,15,39,0,5,14,50,93
2008-04-20 00:00:00.000,ATP Masters Series Monte Carlo Monaco ATP World Tour,CLAY,2,Novak Djokovic,Sam Querrey,Novak Djokovic,6-4; 6-0,Q,60,5,1,33,41,29,33,4,8,0,0,8,33,41,1,2,31,57,16,31,12,26,6,10,8,28,57
2008-04-20 00:00:00.000,ATP Masters Series Monte Carlo Monaco ATP World Tour,CLAY,2,Nikolay Davydenko,Igor Andreev,Nikolay Davydenko,6-3; 4-6; 7-5,Q,164,1,1,65,106,36,65,19,41,13,20,15,55,106,0,5,73,113,39,73,16,40,9,18,16,55,113
2008-04-20 00:00:00.000,ATP Masters Series Monte Carlo Monaco ATP World Tour,CLAY,2,Rafael Nadal,David Ferrer,Rafael Nadal,6-1; 7-5,Q,100,0,1,38,52,26,38,7,14,2,4,9,33,52,0,2,48,71,25,48,8,23,2,8,10,33,71
2008-04-20 00:00:00.000,ATP Masters Series Monte Carlo Monaco ATP World Tour,CLAY,2,Roger Federer,Novak Djokovic,Roger Federer,6-3; 3-2 RET,S,72,1,0,22,42,18,22,10,20,3,4,7,28,42,2,3,37,62,22,37,10,25,2,5,7,32,62
2008-04-20 00:00:00.000,ATP Masters Series Monte Carlo Monaco ATP World Tour,CLAY,2,Rafael Nadal,Nikolay Davydenko,Rafael Nadal,6-3; 6-2,S,101,0,1,37,54,22,37,12,17,4,5,8,34,54,0,5,37,60,20,37,7,23,2,7,9,27,60
2008-04-20 00:00:00.000,ATP Masters Series Monte Carlo Monaco ATP World Tour,CLAY,2,Rafael Nadal,Roger Federer,Rafael Nadal,7-5; 7-5,F,103,1,2,51,63,32,51,5,12,1,5,12,37,63,5,0,47,75,28,47,8,28,1,7,12,36,75
2008-04-28 00:00:00.000,Barcelona Spain ATP World Tour,CLAY,2,Rafael Nadal,N/A Bye,Rafael Nadal,,R64,0,0,0,0,0,0,0,0,0,0,0,0,0,0,0,0,0,0,0,0,0,0,0,0,0,0,0
2008-04-28 00:00:00.000,Barcelona Spain ATP World Tour,CLAY,2,Potito Starace,Peter Luczak,Potito Starace,7-6(4); 6-1,R64,90,3,0,43,57,34,43,11,14,0,0,10,45,57,3,1,40,62,28,40,11,22,2,4,9,39,62
2008-04-28 00:00:00.000,Barcelona Spain ATP World Tour,CLAY,2,Alberto Martin,Matteo Marrai,Alberto Martin,6-3; 6-3,R64,70,4,2,27,51,17,27,14,24,1,3,9,31,51,3,0,36,57,20,36,8,21,8,13,9,28,57
2008-04-28 00:00:00.000,Barcelona Spain ATP World Tour,CLAY,2,Feliciano Lopez,Jose Acasuso,Feliciano Lopez,5-2 RET,R64,36,2,0,5,14,5,5,7,9,0,0,3,12,14,1,2,10,25,6,10,7,15,1,3,4,13,25
2008-04-28 00:00:00.000,Barcelona Spain ATP World Tour,CLAY,2,Juan Ignacio Chela,Guillermo Garcia-Lopez,Juan Ignacio Chela,6-7(2); 6-4; 6-2,R64,173,0,7,76,111,43,76,12,35,9,16,15,55,111,0,6,68,105,37,68,11,37,10,20,15,48,105
2008-04-28 00:00:00.000,Barcelona Spain ATP World Tour,CLAY,2,Marc Lopez,Ivo Minar,Marc Lopez,3-1 RET,R64,24,1,0,8,12,8,8,1,4,1,1,2,9,12,0,1,7,15,4,7,3,8,0,1,2,7,15
2008-04-28 00:00:00.000,Barcelona Spain ATP World Tour,CLAY,2,Ernests Gulbis,Janko Tipsarevic,Ernests Gulbis,6-4; 4-2 RET,R64,65,6,2,30,47,23,30,8,17,3,5,8,31,47,2,0,30,46,16,30,7,16,4,8,8,23,46
2008-04-28 00:00:00.000,Barcelona Spain ATP World Tour,CLAY,2,Carlos Moya,N/A Bye,Carlos Moya,,R64,0,0,0,0,0,0,0,0,0,0,0,0,0,0,0,0,0,0,0,0,0,0,0,0,0,0,0
2008-04-28 00:00:00.000,Barcelona Spain ATP World Tour,CLAY,2,James Blake,N/A Bye,James Blake,,R64,0,0,0,0,0,0,0,0,0,0,0,0,0,0,0,0,0,0,0,0,0,0,0,0,0,0,0
2008-04-28 00:00:00.000,Barcelona Spain ATP World Tour,CLAY,2,Denis Gremelmayr,Ruben Ramirez Hidalgo,Denis Gremelmayr,7-6(7); 2-1 RET,R64,93,4,2,39,59,28,39,10,20,2,3,7,38,59,0,0,32,57,24,32,10,25,1,3,8,34,57
2008-04-28 00:00:00.000,Barcelona Spain ATP World Tour,CLAY,2,Marcos Daniel,Ivan Navarro,Marcos Daniel,6-1; 6-4,R64,69,4,0,28,46,24,28,12,18,0,0,9,36,46,1,3,30,47,21,30,6,17,2,5,8,27,47
2008-04-28 00:00:00.000,Barcelona Spain ATP World Tour,CLAY,2,Dmitry Tursunov,Kevin Anderson,Dmitry Tursunov,6-4; 6-3,R64,81,9,0,33,53,27,33,14,20,0,0,10,41,53,10,2,52,78,33,52,13,26,8,10,9,46,78
2008-04-28 00:00:00.000,Barcelona Spain ATP World Tour,CLAY,2,Nicolas Almagro,Viktor Troicki,Nicolas Almagro,6-2 RET,R64,27,2,0,14,20,13,14,3,6,0,0,4,16,20,0,1,13,18,8,13,1,5,0,2,4,9,18
2008-04-28 00:00:00.000,Barcelona Spain ATP World Tour,CLAY,2,Filippo Volandri,Jurgen Melzer,Filippo Volandri,6-2; 6-4,R64,67,0,3,51,64,32,51,5,13,6,9,9,37,64,0,2,29,49,13,29,7,20,2,8,9,20,49
2008-04-28 00:00:00.000,Barcelona Spain ATP World Tour,CLAY,2,Mario Ancic,Mischa Zverev,Mario Ancic,6-1; 6-0,R64,42,6,1,20,28,19,20,5,8,0,0,6,24,28,0,1,28,40,12,28,0,12,1,7,7,12,40
2008-04-28 00:00:00.000,Barcelona Spain ATP World Tour,CLAY,2,Andy Murray,N/A Bye,Andy Murray,,R64,0,0,0,0,0,0,0,0,0,0,0,0,0,0,0,0,0,0,0,0,0,0,0,0,0,0,0
2008-04-28 00:00:00.000,Barcelona Spain ATP World Tour,CLAY,2,Ivo Karlovic,N/A Bye,Ivo Karlovic,,R64,0,0,0,0,0,0,0,0,0,0,0,0,0,0,0,0,0,0,0,0,0,0,0,0,0,0,0
2008-04-28 00:00:00.000,Barcelona Spain ATP World Tour,CLAY,2,Albert Montanes,Marcel Granollers,Albert Montanes,3-6; 6-3; 6-2,R64,112,2,8,47,93,31,47,21,46,8,13,13,52,93,4,14,42,87,23,42,20,45,8,15,13,43,87
2008-04-28 00:00:00.000,Barcelona Spain ATP World Tour,CLAY,2,Pablo Cuevas,Juan Pablo Brzezicki,Pablo Cuevas,6-3; 7-6(3),R64,82,9,1,48,72,34,48,15,24,3,5,11,49,72,2,4,41,67,25,41,12,26,3,6,10,37,67
2008-04-28 00:00:00.000,Barcelona Spain ATP World Tour,CLAY,2,Mikhail Kukushkin,Jarkko Nieminen,Mikhail Kukushkin,6-4; 6-4,R64,86,2,1,40,58,27,40,11,18,3,5,10,38,58,4,2,49,84,28,49,17,35,9,13,10,45,84
2008-04-28 00:00:00.000,Barcelona Spain ATP World Tour,CLAY,2,Stanislas Wawrinka,Jose Antonio Sanchez-de Luna,Stanislas Wawrinka,6-3; 6-3,R64,81,1,1,26,51,18,26,15,25,3,5,9,33,51,0,2,42,61,24,42,6,19,5,10,9,30,61
2008-04-28 00:00:00.000,Barcelona Spain ATP World Tour,CLAY,2,Yuri Schukin,Robby Ginepri,Yuri Schukin,6-4; 6-2,R64,83,3,4,50,74,32,50,14,24,8,9,9,46,74,2,1,35,46,23,35,4,11,2,6,9,27,46
2008-04-28 00:00:00.000,Barcelona Spain ATP World Tour,CLAY,2,Agustin Calleri,Thomas Johansson,Agustin Calleri,6-1; 6-3,R64,62,6,0,24,46,19,24,15,22,2,2,8,34,46,4,2,40,61,22,40,8,21,8,12,8,30,61
2008-04-28 00:00:00.000,Barcelona Spain ATP World Tour,CLAY,2,David Nalbandian,N/A Bye,David Nalbandian,,R64,0,0,0,0,0,0,0,0,0,0,0,0,0,0,0,0,0,0,0,0,0,0,0,0,0,0,0
2008-04-28 00:00:00.000,Barcelona Spain ATP World Tour,CLAY,2,Tommy Robredo,N/A Bye,Tommy Robredo,,R64,0,0,0,0,0,0,0,0,0,0,0,0,0,0,0,0,0,0,0,0,0,0,0,0,0,0,0
2008-04-28 00:00:00.000,Barcelona Spain ATP World Tour,CLAY,2,Robin Haase,Max Mirnyi,Robin Haase,6-2; 6-2,R64,54,3,0,28,44,21,28,12,16,2,2,8,33,44,0,0,34,44,19,34,3,10,1,5,8,22,44
2008-04-28 00:00:00.000,Barcelona Spain ATP World Tour,CLAY,2,Teymuraz Gabashvili,Guillermo Coria,Teymuraz Gabashvili,5-7; 6-4; 6-4,R64,135,5,3,59,99,39,59,20,40,5,10,16,59,99,2,9,83,113,50,83,12,30,13,19,16,62,113
2008-04-28 00:00:00.000,Barcelona Spain ATP World Tour,CLAY,2,Guillermo Canas,Oscar Hernandez,Guillermo Canas,6-1; 6-4,R64,93,4,1,24,56,18,24,19,32,2,3,9,37,56,0,2,36,51,21,36,4,15,3,7,8,25,51
2008-04-28 00:00:00.000,Barcelona Spain ATP World Tour,CLAY,2,Nicolas Lapentti,Fernando Verdasco,Nicolas Lapentti,6-3; 6-4,R64,111,5,2,51,78,35,51,13,27,7,8,10,48,78,0,1,45,58,24,45,8,13,4,7,9,32,58
2008-04-28 00:00:00.000,Barcelona Spain ATP World Tour,CLAY,2,Daniel Gimeno-Traver,Santiago Ventura,Daniel Gimeno-Traver,6-2; 6-1,R64,61,5,0,30,37,24,30,5,7,1,1,7,29,37,0,2,49,65,22,49,7,16,6,11,8,29,65
2008-04-28 00:00:00.000,Barcelona Spain ATP World Tour,CLAY,2,Gabriel Trujillo-Soler,Werner Eschauer,Gabriel Trujillo-Soler,6-4; 4-6; 6-2,R64,100,7,1,57,79,41,57,16,22,5,6,14,57,79,2,4,44,79,31,44,20,35,2,5,14,51,79
2008-04-28 00:00:00.000,Barcelona Spain ATP World Tour,CLAY,2,David Ferrer,N/A Bye,David Ferrer,,R64,0,0,0,0,0,0,0,0,0,0,0,0,0,0,0,0,0,0,0,0,0,0,0,0,0,0,0
2008-04-28 00:00:00.000,Barcelona Spain ATP World Tour,CLAY,2,Rafael Nadal,Potito Starace,Rafael Nadal,6-4; 6-2,R32,78,2,1,35,48,26,35,11,13,2,3,9,37,48,2,1,44,55,22,44,7,11,4,8,9,29,55
2008-04-28 00:00:00.000,Barcelona Spain ATP World Tour,CLAY,2,Feliciano Lopez,Alberto Martin,Feliciano Lopez,3-6; 6-2; 6-4,R32,120,12,3,55,94,41,55,17,39,9,12,14,58,94,3,2,43,87,30,43,22,44,2,6,13,52,87
2008-04-28 00:00:00.000,Barcelona Spain ATP World Tour,CLAY,2,Juan Ignacio Chela,Marc Lopez,Juan Ignacio Chela,5-1 RET,R32,37,0,1,11,21,8,11,6,10,1,1,3,14,21,0,0,15,21,7,15,2,6,2,4,3,9,21
2008-04-28 00:00:00.000,Barcelona Spain ATP World Tour,CLAY,2,Ernests Gulbis,Carlos Moya,Ernests Gulbis,4-6; 6-1; 6-4,R32,106,6,2,48,87,39,48,20,39,5,6,14,59,87,2,1,52,77,36,52,15,25,4,7,13,51,77
2008-04-28 00:00:00.000,Barcelona Spain ATP World Tour,CLAY,2,Denis Gremelmayr,James Blake,Denis Gremelmayr,6-1; 6-4,R32,68,5,1,27,52,20,27,18,25,1,1,9,38,52,1,3,19,50,13,19,14,31,1,4,8,27,50
2008-04-28 00:00:00.000,Barcelona Spain ATP World Tour,CLAY,2,Dmitry Tursunov,Marcos Daniel,Dmitry Tursunov,6-4; 6-3,R32,75,4,0,39,58,33,39,10,19,3,3,9,43,58,2,1,31,58,21,31,14,27,4,7,10,35,58
2008-04-28 00:00:00.000,Barcelona Spain ATP World Tour,CLAY,2,Nicolas Almagro,Filippo Volandri,Nicolas Almagro,6-4; 7-6(5),R32,91,16,1,39,65,32,39,10,26,0,2,11,42,65,1,2,51,66,32,51,7,15,1,4,11,39,66
2008-04-28 00:00:00.000,Barcelona Spain ATP World Tour,CLAY,2,Mario Ancic,Andy Murray,Mario Ancic,6-4; 6-4,R32,101,3,1,48,77,34,48,15,29,5,6,10,49,77,2,4,46,66,30,46,7,20,3,6,10,37,66
2008-04-28 00:00:00.000,Barcelona Spain ATP World Tour,CLAY,2,Albert Montanes,Ivo Karlovic,Albert Montanes,6-7(7); 6-3; 7-5,R32,134,6,2,86,118,68,86,17,32,8,8,17,85,118,17,0,55,96,46,55,23,41,7,9,16,69,96
2008-04-28 00:00:00.000,Barcelona Spain ATP World Tour,CLAY,2,Mikhail Kukushkin,Pablo Cuevas,Mikhail Kukushkin,6-0; 6-4,R32,63,2,1,33,51,23,33,13,18,2,2,8,36,51,0,1,26,49,12,26,13,23,2,6,8,25,49
2008-04-28 00:00:00.000,Barcelona Spain ATP World Tour,CLAY,2,Stanislas Wawrinka,Yuri Schukin,Stanislas Wawrinka,6-3; 6-4,R32,85,5,2,37,58,31,37,10,21,2,2,10,41,58,0,1,40,65,26,40,10,25,2,4,9,36,65
2008-04-28 00:00:00.000,Barcelona Spain ATP World Tour,CLAY,2,David Nalbandian,Agustin Calleri,David Nalbandian,1-6; 7-6(2); 6-3,R32,119,2,4,50,77,31,50,13,27,1,5,13,44,77,11,8,47,101,37,47,21,54,2,6,15,58,101
2008-04-28 00:00:00.000,Barcelona Spain ATP World Tour,CLAY,2,Tommy Robredo,Robin Haase,Tommy Robredo,6-2; 6-4,R32,73,1,0,38,45,29,38,5,7,2,3,9,34,45,1,1,46,66,28,46,7,20,7,11,9,35,66
2008-04-28 00:00:00.000,Barcelona Spain ATP World Tour,CLAY,2,Guillermo Canas,Teymuraz Gabashvili,Guillermo Canas,6-1; 6-2,R32,79,5,1,22,43,17,22,13,21,0,0,7,30,43,1,6,36,60,17,36,9,24,7,12,8,26,60
2008-04-28 00:00:00.000,Barcelona Spain ATP World Tour,CLAY,2,Nicolas Lapentti,Daniel Gimeno-Traver,Nicolas Lapentti,6-3; 6-7(5); 7-5,R32,173,0,2,59,98,34,59,21,39,4,9,16,55,98,2,1,76,124,38,76,23,48,9,17,17,61,124
2008-04-28 00:00:00.000,Barcelona Spain ATP World Tour,CLAY,2,David Ferrer,Gabriel Trujillo-Soler,David Ferrer,6-1; 6-1,R32,50,1,1,24,39,19,24,10,15,1,1,7,29,39,1,2,21,40,10,21,6,19,2,7,7,16,40
2008-04-28 00:00:00.000,Barcelona Spain ATP World Tour,CLAY,2,Rafael Nadal,Feliciano Lopez,Rafael Nadal,6-4; 6-3,R16,106,3,1,33,50,26,33,12,17,0,0,9,38,50,4,1,56,86,34,56,14,30,6,9,10,48,86
2008-04-28 00:00:00.000,Barcelona Spain ATP World Tour,CLAY,2,Juan Ignacio Chela,Ernests Gulbis,Juan Ignacio Chela,2-6; 6-4; 6-3,R16,106,2,4,43,75,29,43,20,32,3,5,13,49,75,7,2,45,81,31,45,22,36,5,8,14,53,81
2008-04-28 00:00:00.000,Barcelona Spain ATP World Tour,CLAY,2,Denis Gremelmayr,Dmitry Tursunov,Denis Gremelmayr,6-4; 6-0,R16,63,6,0,33,50,24,33,9,17,4,5,8,33,50,3,3,23,45,14,23,6,22,0,5,8,20,45
2008-04-28 00:00:00.000,Barcelona Spain ATP World Tour,CLAY,2,Nicolas Almagro,Mario Ancic,Nicolas Almagro,7-6(5); 6-2,R16,97,5,0,37,64,32,37,17,27,2,2,10,49,64,5,1,47,73,32,47,16,26,4,6,10,48,73
2008-04-28 00:00:00.000,Barcelona Spain ATP World Tour,CLAY,2,Albert Montanes,Mikhail Kukushkin,Albert Montanes,6-3; 3-6; 6-3,R16,114,1,1,48,77,38,48,12,29,1,4,14,50,77,3,0,42,80,26,42,20,38,6,10,13,46,80
2008-04-28 00:00:00.000,Barcelona Spain ATP World Tour,CLAY,2,Stanislas Wawrinka,David Nalbandian,Stanislas Wawrinka,6-3; 6-1,R16,85,1,1,32,59,20,32,19,27,9,10,8,39,59,0,2,32,59,14,32,12,27,5,10,8,26,59
2008-04-28 00:00:00.000,Barcelona Spain ATP World Tour,CLAY,2,Tommy Robredo,Guillermo Canas,Tommy Robredo,6-1; 7-5,R16,79,3,0,45,52,34,45,3,7,1,2,10,37,52,1,1,20,48,13,20,13,28,1,5,9,26,48
2008-04-28 00:00:00.000,Barcelona Spain ATP World Tour,CLAY,2,David Ferrer,Nicolas Lapentti,David Ferrer,4-6; 6-4; 6-3,R16,151,2,2,56,98,39,56,24,42,7,9,15,63,98,3,3,52,87,39,52,14,35,2,5,14,53,87
2008-04-28 00:00:00.000,Barcelona Spain ATP World Tour,CLAY,2,Rafael Nadal,Juan Ignacio Chela,Rafael Nadal,6-4; 6-2,Q,102,0,0,34,51,27,34,6,17,0,1,9,33,51,0,2,44,70,23,44,15,26,7,11,9,38,70
2008-04-28 00:00:00.000,Barcelona Spain ATP World Tour,CLAY,2,Denis Gremelmayr,Nicolas Almagro,Denis Gremelmayr,6-2; 3-6; 7-6(7),Q,129,3,5,60,105,38,60,24,45,5,8,14,62,105,11,0,48,83,39,48,18,35,3,7,15,57,83
2008-04-28 00:00:00.000,Barcelona Spain ATP World Tour,CLAY,2,Stanislas Wawrinka,Albert Montanes,Stanislas Wawrinka,6-3; 6-7(6); 6-4,Q,166,2,4,64,118,42,64,30,54,4,6,16,72,118,1,6,51,92,38,51,20,41,4,8,15,58,92
2008-04-28 00:00:00.000,Barcelona Spain ATP World Tour,CLAY,2,David Ferrer,Tommy Robredo,David Ferrer,7-6(4); 6-4,Q,126,1,0,48,78,32,48,15,30,5,8,11,47,78,2,2,50,88,31,50,17,38,9,13,11,48,88
2008-04-28 00:00:00.000,Barcelona Spain ATP World Tour,CLAY,2,Rafael Nadal,Denis Gremelmayr,Rafael Nadal,6-1; 6-0,S,51,3,0,23,33,20,23,8,10,0,0,7,28,33,0,1,18,32,9,18,1,14,2,7,6,10,32
2008-04-28 00:00:00.000,Barcelona Spain ATP World Tour,CLAY,2,David Ferrer,Stanislas Wawrinka,David Ferrer,7-6(8); 6-3,S,114,2,1,47,72,32,47,18,25,1,2,10,50,72,3,2,47,84,30,47,20,37,5,8,11,50,84
2008-04-28 00:00:00.000,Barcelona Spain ATP World Tour,CLAY,2,Rafael Nadal,David Ferrer,Rafael Nadal,6-1; 4-6; 6-1,F,134,3,3,51,74,32,51,16,23,5,7,12,48,74,2,1,61,87,34,61,10,26,4,10,12,44,87
2008-04-28 00:00:00.000,Munich Germany ATP World Tour,CLAY,2,Paul-Henri Mathieu,Daniel Brands,Paul-Henri Mathieu,6-3; 6-3,R32,72,4,1,35,61,29,35,14,26,2,2,9,43,61,5,3,26,44,20,26,5,18,0,3,9,25,44
2008-04-28 00:00:00.000,Munich Germany ATP World Tour,CLAY,2,Gianluca Naso,Rainer Schuettler,Gianluca Naso,6-7(2); 6-3; 6-4,R32,154,6,4,65,134,45,65,38,69,9,10,16,83,134,6,6,64,111,49,64,25,47,5,8,15,74,111
2008-04-28 00:00:00.000,Munich Germany ATP World Tour,CLAY,2,Philipp Petzschner,Evgeny Korolev,Philipp Petzschner,6-4; 0-6; 6-2,R32,102,1,4,45,67,28,45,12,22,4,8,12,40,67,3,6,43,85,30,43,18,42,5,9,12,48,85
2008-04-28 00:00:00.000,Munich Germany ATP World Tour,CLAY,2,Marin Cilic,Olivier Rochus,Marin Cilic,6-4; 6-4,R32,84,10,0,32,57,26,32,15,25,1,2,10,41,57,1,6,38,62,24,38,11,24,6,9,10,35,62
2008-04-28 00:00:00.000,Munich Germany ATP World Tour,CLAY,2,Julio Silva,Matthias Bachinger,Julio Silva,3-6; 6-2; 6-3,R32,87,7,0,56,76,37,56,13,20,8,11,13,50,76,7,4,41,73,32,41,12,32,4,9,13,44,73
2008-04-28 00:00:00.000,Munich Germany ATP World Tour,CLAY,2,Hyung-Taik Lee,Rainer Eitzinger,Hyung-Taik Lee,1-6; 7-5; 6-2,R32,120,0,3,66,101,40,66,19,35,10,13,13,59,101,0,2,61,85,36,61,15,24,2,6,14,51,85
2008-04-28 00:00:00.000,Munich Germany ATP World Tour,CLAY,2,Simone Bolelli,Marc Gicquel,Simone Bolelli,6-4; 6-2,R32,75,5,1,38,52,28,38,9,14,0,0,9,37,52,6,3,46,72,27,46,14,26,11,14,9,41,72
2008-04-28 00:00:00.000,Munich Germany ATP World Tour,CLAY,2,Andreas Seppi,Roko Karanusic,Andreas Seppi,6-3; 6-3,R32,75,3,4,41,65,30,41,11,24,6,8,9,41,65,1,0,43,69,20,43,13,26,9,14,9,33,69
2008-04-28 00:00:00.000,Munich Germany ATP World Tour,CLAY,2,Steve Darcis,Benjamin Becker,Steve Darcis,6-3; 6-4,R32,66,6,1,35,52,29,35,11,17,0,0,10,40,52,2,0,23,48,16,23,15,25,1,3,9,31,48
2008-04-28 00:00:00.000,Munich Germany ATP World Tour,CLAY,2,Younes El Aynaoui,Alexandre Sidorenko,Younes El Aynaoui,6-4; 7-6(6),R32,92,14,3,51,80,40,51,15,29,1,1,11,55,80,3,3,41,64,33,41,12,23,1,2,11,45,64
2008-04-28 00:00:00.000,Munich Germany ATP World Tour,CLAY,2,Juan Martin Del Potro,Arnaud Clement,Juan Martin Del Potro,6-3; 6-1,R32,76,12,3,29,57,22,29,17,28,7,7,8,39,57,4,3,29,48,21,29,5,19,2,6,8,26,48
2008-04-28 00:00:00.000,Munich Germany ATP World Tour,CLAY,2,Igor Andreev,Gael Monfils,Igor Andreev,6-3; 6-4,R32,90,0,0,37,61,26,37,18,24,4,4,10,44,61,7,4,37,75,28,37,16,38,9,11,9,44,75
2008-04-28 00:00:00.000,Munich Germany ATP World Tour,CLAY,2,Michael Berrer,Ivo Klec,Michael Berrer,6-1; 7-6(6),R32,111,2,4,54,85,37,54,16,31,3,4,10,53,85,1,0,39,65,29,39,8,26,6,9,9,37,65
2008-04-28 00:00:00.000,Munich Germany ATP World Tour,CLAY,2,Marat Safin,Carlos Berlocq,Marat Safin,6-3; 3-6; 6-4,R32,126,10,4,56,98,41,56,20,42,8,10,14,61,98,0,4,56,83,36,56,14,27,3,6,14,50,83
2008-04-28 00:00:00.000,Munich Germany ATP World Tour,CLAY,2,Kristof Vliegen,Sergio Roitman,Kristof Vliegen,7-6(3); 6-3,R32,98,10,2,45,82,36,45,19,37,6,6,11,55,82,4,3,45,65,33,45,11,20,5,6,10,44,65
2008-04-28 00:00:00.000,Munich Germany ATP World Tour,CLAY,2,Fernando Gonzalez,Dudi Sela,Fernando Gonzalez,6-3; 6-4,R32,75,5,1,30,59,25,30,19,29,4,4,10,44,59,0,3,41,58,29,41,8,17,3,5,9,37,58
2008-04-28 00:00:00.000,Munich Germany ATP World Tour,CLAY,2,Paul-Henri Mathieu,Gianluca Naso,Paul-Henri Mathieu,6-3; 6-4,R16,93,12,2,36,64,32,36,14,28,2,2,10,46,64,5,1,57,87,37,57,12,30,15,17,9,49,87
2008-04-28 00:00:00.000,Munich Germany ATP World Tour,CLAY,2,Marin Cilic,Philipp Petzschner,Marin Cilic,6-4; 7-6(7),R16,114,6,7,61,102,43,61,21,41,13,14,11,64,102,1,2,42,76,28,42,19,34,2,4,11,47,76
2008-04-28 00:00:00.000,Munich Germany ATP World Tour,CLAY,2,Hyung-Taik Lee,Julio Silva,Hyung-Taik Lee,6-1; 6-4,R16,69,2,0,41,58,28,41,11,17,2,3,9,39,58,3,2,39,56,21,39,7,17,8,12,8,28,56
2008-04-28 00:00:00.000,Munich Germany ATP World Tour,CLAY,2,Simone Bolelli,Andreas Seppi,Simone Bolelli,6-4; 7-5,R16,94,6,1,57,75,42,57,11,18,6,6,11,53,75,3,4,35,67,29,35,14,32,3,5,11,43,67
2008-04-28 00:00:00.000,Munich Germany ATP World Tour,CLAY,2,Younes El Aynaoui,Steve Darcis,Younes El Aynaoui,6-4; 3-6; 6-3,R16,98,7,1,64,89,49,64,11,25,4,5,14,60,89,4,0,44,75,33,44,20,31,1,3,14,53,75
2008-04-28 00:00:00.000,Munich Germany ATP World Tour,CLAY,2,Juan Martin Del Potro,Igor Andreev,Juan Martin Del Potro,1-6; 6-0; 6-4,R16,109,2,4,39,68,29,39,10,29,4,8,11,39,68,5,2,56,77,32,56,7,21,9,15,12,39,77
2008-04-28 00:00:00.000,Munich Germany ATP World Tour,CLAY,2,Marat Safin,Michael Berrer,Marat Safin,7-6(4); 6-7(5); 6-3,R16,161,12,2,56,114,39,56,39,58,2,4,17,78,114,3,2,83,105,58,83,9,22,6,9,16,67,105
2008-04-28 00:00:00.000,Munich Germany ATP World Tour,CLAY,2,Fernando Gonzalez,Kristof Vliegen,Fernando Gonzalez,1-6; 7-5; 6-3,R16,111,5,5,60,94,38,60,15,34,11,16,14,53,94,6,1,52,82,36,52,13,30,4,9,14,49,82
2008-04-28 00:00:00.000,Munich Germany ATP World Tour,CLAY,2,Paul-Henri Mathieu,Marin Cilic,Paul-Henri Mathieu,6-2; 4-6; 6-3,Q,122,3,0,45,83,37,45,21,38,3,5,14,58,83,9,1,43,82,28,43,22,39,8,12,13,50,82
2008-04-28 00:00:00.000,Munich Germany ATP World Tour,CLAY,2,Simone Bolelli,Hyung-Taik Lee,Simone Bolelli,6-4; 7-6(3),Q,87,7,1,44,60,37,44,11,16,3,4,11,48,60,5,0,33,62,22,33,20,29,0,2,11,42,62
2008-04-28 00:00:00.000,Munich Germany ATP World Tour,CLAY,2,Younes El Aynaoui,Juan Martin Del Potro,Younes El Aynaoui,6-4; 6-4,Q,80,7,1,33,53,29,33,11,20,1,2,10,40,53,1,1,44,58,26,44,7,14,2,5,10,33,58
2008-04-28 00:00:00.000,Munich Germany ATP World Tour,CLAY,2,Fernando Gonzalez,Marat Safin,Fernando Gonzalez,6-3; 7-5,Q,129,2,2,48,77,34,48,17,29,5,6,11,51,77,1,1,33,56,23,33,10,23,0,3,10,33,56
2008-04-28 00:00:00.000,Munich Germany ATP World Tour,CLAY,2,Simone Bolelli,Paul-Henri Mathieu,Simone Bolelli,7-6(1); 4-6; 7-6(4),S,186,15,3,88,128,61,88,20,40,4,7,17,81,128,6,3,69,111,50,69,22,42,5,7,17,72,111
2008-04-28 00:00:00.000,Munich Germany ATP World Tour,CLAY,2,Fernando Gonzalez,Younes El Aynaoui,Fernando Gonzalez,3-6; 6-4; 6-3,S,112,2,3,53,83,41,53,16,30,3,5,14,57,83,7,3,57,84,42,57,12,27,1,4,14,54,84
2008-04-28 00:00:00.000,Munich Germany ATP World Tour,CLAY,2,Fernando Gonzalez,Simone Bolelli,Fernando Gonzalez,7-6(4); 6-7(4); 6-3,F,156,4,3,69,105,55,69,22,36,3,3,16,77,105,6,2,89,125,60,89,21,36,4,6,17,81,125
2008-05-05 00:00:00.000,ATP Masters Series Rome Italy ATP World Tour,CLAY,2,Roger Federer,N/A Bye,Roger Federer,,R64,0,0,0,0,0,0,0,0,0,0,0,0,0,0,0,0,0,0,0,0,0,0,0,0,0,0,0
2008-05-05 00:00:00.000,ATP Masters Series Rome Italy ATP World Tour,CLAY,2,Guillermo Canas,Gianluca Naso,Guillermo Canas,6-7(8); 6-3; 6-2,R64,157,8,4,78,118,59,78,18,40,12,13,15,77,118,2,4,55,93,38,55,21,38,4,8,14,59,93
2008-05-05 00:00:00.000,ATP Masters Series Rome Italy ATP World Tour,CLAY,2,Potito Starace,Marin Cilic,Potito Starace,6-4; 2-6; 6-4,R64,133,2,1,55,84,36,55,11,29,6,11,14,47,84,3,2,47,92,27,47,25,45,5,10,14,52,92
2008-05-05 00:00:00.000,ATP Masters Series Rome Italy ATP World Tour,CLAY,2,Ivo Karlovic,Paul-Henri Mathieu,Ivo Karlovic,7-6(4); 6-2,R64,89,13,2,38,60,30,38,12,22,0,0,10,42,60,1,3,37,62,22,37,13,25,1,3,10,35,62
2008-05-05 00:00:00.000,ATP Masters Series Rome Italy ATP World Tour,CLAY,2,Luis Horna,Richard Gasquet,Luis Horna,6-4; 6-1,R64,60,0,0,27,41,21,27,11,14,0,0,8,32,41,8,4,23,45,17,23,9,22,3,7,9,26,45
2008-05-05 00:00:00.000,ATP Masters Series Rome Italy ATP World Tour,CLAY,2,Jose Acasuso,Dmitry Tursunov,Jose Acasuso,6-4; 6-2,R64,115,3,4,39,75,25,39,19,36,9,11,9,44,75,5,2,39,71,24,39,11,32,10,15,9,35,71
2008-05-05 00:00:00.000,ATP Masters Series Rome Italy ATP World Tour,CLAY,2,Radek Stepanek,Jarkko Nieminen,Radek Stepanek,6-3; 3-6; 6-3,R64,104,3,3,46,81,41,46,16,35,1,2,14,57,81,3,1,43,73,32,43,18,30,2,4,13,50,73
2008-05-05 00:00:00.000,ATP Masters Series Rome Italy ATP World Tour,CLAY,2,David Ferrer,N/A Bye,David Ferrer,,R64,0,0,0,0,0,0,0,0,0,0,0,0,0,0,0,0,0,0,0,0,0,0,0,0,0,0,0
2008-05-05 00:00:00.000,ATP Masters Series Rome Italy ATP World Tour,CLAY,2,Novak Djokovic,N/A Bye,Novak Djokovic,,R64,0,0,0,0,0,0,0,0,0,0,0,0,0,0,0,0,0,0,0,0,0,0,0,0,0,0,0
2008-05-05 00:00:00.000,ATP Masters Series Rome Italy ATP World Tour,CLAY,2,Steve Darcis,Ivan Ljubicic,Steve Darcis,7-5; 7-6(5),R64,123,6,1,52,94,39,52,22,42,6,7,12,61,94,11,4,50,89,38,50,17,39,9,11,12,55,89
2008-05-05 00:00:00.000,ATP Masters Series Rome Italy ATP World Tour,CLAY,2,Igor Andreev,Hyung-Taik Lee,Igor Andreev,6-4; 7-5,R64,83,7,1,45,61,32,45,11,16,5,6,11,43,61,1,2,50,72,33,50,9,22,2,5,11,42,72
2008-05-05 00:00:00.000,ATP Masters Series Rome Italy ATP World Tour,CLAY,2,Juan Monaco,Pablo Cuevas,Juan Monaco,6-0; 6-4,R64,72,1,0,28,48,19,28,13,20,2,3,8,32,48,1,3,21,45,11,21,10,24,6,11,8,21,45
2008-05-05 00:00:00.000,ATP Masters Series Rome Italy ATP World Tour,CLAY,2,Fernando Gonzalez,Janko Tipsarevic,Fernando Gonzalez,3-6; 7-6(0); 7-6(6),R64,160,7,4,60,101,50,60,17,41,4,9,17,67,101,6,4,61,109,46,61,21,48,4,7,16,67,109
2008-05-05 00:00:00.000,ATP Masters Series Rome Italy ATP World Tour,CLAY,2,Evgeny Korolev,Robin Soderling,Evgeny Korolev,1-6; 6-3; 6-4,R64,116,8,4,68,84,46,68,8,16,7,9,13,54,84,16,5,71,80,50,71,2,9,5,7,13,52,80
2008-05-05 00:00:00.000,ATP Masters Series Rome Italy ATP World Tour,CLAY,2,Nicolas Almagro,Flavio Cipolla,Nicolas Almagro,6-1; 6-3,R64,59,6,1,21,39,16,21,13,18,0,1,8,29,39,0,1,32,53,13,32,11,21,7,12,8,24,53
2008-05-05 00:00:00.000,ATP Masters Series Rome Italy ATP World Tour,CLAY,2,David Nalbandian,N/A Bye,David Nalbandian,,R64,0,0,0,0,0,0,0,0,0,0,0,0,0,0,0,0,0,0,0,0,0,0,0,0,0,0,0
2008-05-05 00:00:00.000,ATP Masters Series Rome Italy ATP World Tour,CLAY,2,Andy Roddick,N/A Bye,Andy Roddick,,R64,0,0,0,0,0,0,0,0,0,0,0,0,0,0,0,0,0,0,0,0,0,0,0,0,0,0,0
2008-05-05 00:00:00.000,ATP Masters Series Rome Italy ATP World Tour,CLAY,2,Mardy Fish,Michael Llodra,Mardy Fish,7-5; 3-6; 7-6(2),R64,142,3,4,41,100,28,41,40,59,7,9,16,68,100,8,3,62,119,46,62,30,57,10,12,17,76,119
2008-05-05 00:00:00.000,ATP Masters Series Rome Italy ATP World Tour,CLAY,2,Simone Bolelli,Olivier Patience,Simone Bolelli,6-0; 6-3,R64,62,1,1,36,51,28,36,9,15,2,2,8,37,51,2,2,25,42,11,25,9,17,1,5,7,20,42
2008-05-05 00:00:00.000,ATP Masters Series Rome Italy ATP World Tour,CLAY,2,Gilles Simon,Jo-Wilfried Tsonga,Gilles Simon,6-2; 4-6; 7-6(6),R64,140,0,1,53,99,34,53,28,46,4,6,15,62,99,3,1,58,98,40,58,19,40,2,5,15,59,98
2008-05-05 00:00:00.000,ATP Masters Series Rome Italy ATP World Tour,CLAY,2,Tommy Robredo,Juan Ignacio Chela,Tommy Robredo,6-4; 6-1,R64,79,3,1,26,43,19,26,8,17,0,2,8,27,43,1,3,33,62,17,33,10,29,4,10,9,27,62
2008-05-05 00:00:00.000,ATP Masters Series Rome Italy ATP World Tour,CLAY,2,Nicolas Mahut,Thomas Fabbiano,Nicolas Mahut,6-7(5); 6-4; 7-5,R64,153,9,4,71,116,53,71,26,45,5,6,17,79,116,3,6,77,111,51,77,18,34,2,5,17,69,111
2008-05-05 00:00:00.000,ATP Masters Series Rome Italy ATP World Tour,CLAY,2,Mario Ancic,Feliciano Lopez,Mario Ancic,6-4; 6-4,R64,129,4,0,44,76,30,44,21,32,12,12,10,51,76,5,1,56,87,36,56,15,31,6,8,10,51,87
2008-05-05 00:00:00.000,ATP Masters Series Rome Italy ATP World Tour,CLAY,2,Nikolay Davydenko,N/A Bye,Nikolay Davydenko,,R64,0,0,0,0,0,0,0,0,0,0,0,0,0,0,0,0,0,0,0,0,0,0,0,0,0,0,0
2008-05-05 00:00:00.000,ATP Masters Series Rome Italy ATP World Tour,CLAY,2,James Blake,N/A Bye,James Blake,,R64,0,0,0,0,0,0,0,0,0,0,0,0,0,0,0,0,0,0,0,0,0,0,0,0,0,0,0
2008-05-05 00:00:00.000,ATP Masters Series Rome Italy ATP World Tour,CLAY,2,Andreas Seppi,Fabrice Santoro,Andreas Seppi,6-4; 6-2,R64,79,2,3,43,65,33,43,7,22,7,8,9,40,65,2,0,27,51,16,27,11,24,3,7,9,27,51
2008-05-05 00:00:00.000,ATP Masters Series Rome Italy ATP World Tour,CLAY,2,Nicolas Lapentti,Filippo Volandri,Nicolas Lapentti,7-6(6); 2-6; 6-2,R64,153,4,2,52,96,30,52,20,44,5,11,14,50,96,0,6,60,97,31,60,22,37,5,11,14,53,97
2008-05-05 00:00:00.000,ATP Masters Series Rome Italy ATP World Tour,CLAY,2,Fernando Verdasco,Carlos Moya,Fernando Verdasco,6-3; 6-4,R64,80,0,1,44,54,29,44,6,10,6,8,9,35,54,2,1,30,56,17,30,11,26,3,8,10,28,56
2008-05-05 00:00:00.000,ATP Masters Series Rome Italy ATP World Tour,CLAY,2,Andy Murray,Juan Martin Del Potro,Andy Murray,5-7; 6-4; 1-0 RET,R64,128,2,1,41,71,27,41,14,30,2,6,11,41,71,1,1,54,82,30,54,11,28,2,7,12,41,82
2008-05-05 00:00:00.000,ATP Masters Series Rome Italy ATP World Tour,CLAY,2,Stanislas Wawrinka,Marat Safin,Stanislas Wawrinka,6-7(5); 6-2; 6-1,R64,136,5,5,58,90,37,58,13,32,9,13,13,50,90,5,5,51,96,32,51,11,45,7,16,14,43,96
2008-05-05 00:00:00.000,ATP Masters Series Rome Italy ATP World Tour,CLAY,2,Juan Carlos Ferrero,Nicolas Kiefer,Juan Carlos Ferrero,6-7(5); 6-3; 6-4,R64,149,8,1,58,88,46,58,20,30,4,5,16,66,88,10,6,37,102,28,37,34,65,1,4,15,62,102
2008-05-05 00:00:00.000,ATP Masters Series Rome Italy ATP World Tour,CLAY,2,Rafael Nadal,N/A Bye,Rafael Nadal,,R64,0,0,0,0,0,0,0,0,0,0,0,0,0,0,0,0,0,0,0,0,0,0,0,0,0,0,0
2008-05-05 00:00:00.000,ATP Masters Series Rome Italy ATP World Tour,CLAY,2,Roger Federer,Guillermo Canas,Roger Federer,6-3; 6-3,R32,83,8,0,29,51,22,29,17,22,1,1,9,39,51,0,2,39,61,25,39,9,22,4,7,9,34,61
2008-05-05 00:00:00.000,ATP Masters Series Rome Italy ATP World Tour,CLAY,2,Ivo Karlovic,Potito Starace,Ivo Karlovic,6-3; 6-7(5); 7-6(3),R32,155,18,2,73,98,60,73,15,25,2,3,17,75,98,1,3,85,116,56,85,20,31,7,9,16,76,116
2008-05-05 00:00:00.000,ATP Masters Series Rome Italy ATP World Tour,CLAY,2,Luis Horna,Jose Acasuso,Luis Horna,6-3; 7-6(1),R32,100,11,1,55,72,39,55,9,17,4,6,11,48,72,3,1,37,70,23,37,17,33,4,7,10,40,70
2008-05-05 00:00:00.000,ATP Masters Series Rome Italy ATP World Tour,CLAY,2,Radek Stepanek,David Ferrer,Radek Stepanek,4-6; 6-2; 6-1,R32,105,2,2,46,74,34,46,17,28,2,3,12,51,74,0,1,44,70,27,44,10,26,2,7,13,37,70
2008-05-05 00:00:00.000,ATP Masters Series Rome Italy ATP World Tour,CLAY,2,Novak Djokovic,Steve Darcis,Novak Djokovic,6-4; 6-0,R32,73,3,2,36,55,26,36,11,19,4,5,8,37,55,2,0,25,49,14,25,7,24,1,6,8,21,49
2008-05-05 00:00:00.000,ATP Masters Series Rome Italy ATP World Tour,CLAY,2,Igor Andreev,Juan Monaco,Igor Andreev,4-6; 6-1; 6-4,R32,138,7,3,69,100,46,69,12,31,10,14,14,58,100,0,3,56,80,33,56,9,24,4,10,13,42,80
2008-05-05 00:00:00.000,ATP Masters Series Rome Italy ATP World Tour,CLAY,2,Fernando Gonzalez,Evgeny Korolev,Fernando Gonzalez,6-3; 6-2,R32,62,0,0,41,51,33,41,5,10,0,0,9,38,51,2,1,34,47,24,34,2,13,1,4,8,26,47
2008-05-05 00:00:00.000,ATP Masters Series Rome Italy ATP World Tour,CLAY,2,Nicolas Almagro,David Nalbandian,Nicolas Almagro,6-4; 7-5,R32,97,7,3,44,62,30,44,11,18,0,2,11,41,62,1,4,50,83,33,50,13,33,8,12,11,46,83
2008-05-05 00:00:00.000,ATP Masters Series Rome Italy ATP World Tour,CLAY,2,Andy Roddick,Mardy Fish,Andy Roddick,6-1; 6-4,R32,67,4,0,30,52,20,30,17,22,1,1,9,37,52,5,3,20,46,15,20,12,26,4,7,8,27,46
2008-05-05 00:00:00.000,ATP Masters Series Rome Italy ATP World Tour,CLAY,2,Simone Bolelli,Gilles Simon,Simone Bolelli,6-4; 6-4,R32,89,2,1,47,67,31,47,12,20,3,4,10,43,67,2,0,34,56,22,34,13,22,1,4,10,35,56
2008-05-05 00:00:00.000,ATP Masters Series Rome Italy ATP World Tour,CLAY,2,Tommy Robredo,Nicolas Mahut,Tommy Robredo,7-5; 7-6(5),R32,118,2,2,55,71,46,55,9,16,5,5,12,55,71,2,2,56,83,41,56,14,27,5,6,12,55,83
2008-05-05 00:00:00.000,ATP Masters Series Rome Italy ATP World Tour,CLAY,2,Nikolay Davydenko,Mario Ancic,Nikolay Davydenko,6-2; 6-2,R32,72,0,1,30,45,24,30,8,15,0,0,8,32,45,1,1,37,46,19,37,3,9,4,8,8,22,46
2008-05-05 00:00:00.000,ATP Masters Series Rome Italy ATP World Tour,CLAY,2,James Blake,Andreas Seppi,James Blake,7-6(5); 3-6; 6-1,R32,135,6,2,43,87,26,43,23,44,2,6,14,49,87,6,6,61,116,38,61,24,55,7,12,14,62,116
2008-05-05 00:00:00.000,ATP Masters Series Rome Italy ATP World Tour,CLAY,2,Fernando Verdasco,Nicolas Lapentti,Fernando Verdasco,6-2; 5-7; 6-2,R32,154,3,3,69,93,45,69,14,24,9,12,14,59,93,1,1,41,77,25,41,18,36,3,9,14,43,77
2008-05-05 00:00:00.000,ATP Masters Series Rome Italy ATP World Tour,CLAY,2,Stanislas Wawrinka,Andy Murray,Stanislas Wawrinka,6-2; 7-6(5),R32,105,1,1,51,70,34,51,14,19,1,2,10,48,70,0,2,39,72,25,39,16,33,6,9,10,41,72
2008-05-05 00:00:00.000,ATP Masters Series Rome Italy ATP World Tour,CLAY,2,Juan Carlos Ferrero,Rafael Nadal,Juan Carlos Ferrero,7-5; 6-1,R32,114,3,2,38,65,27,38,18,27,5,5,10,45,65,1,1,33,55,21,33,12,22,3,6,9,33,55
2008-05-05 00:00:00.000,ATP Masters Series Rome Italy ATP World Tour,CLAY,2,Roger Federer,Ivo Karlovic,Roger Federer,7-6(4); 6-3,R16,93,2,0,32,55,26,32,19,23,2,2,10,45,55,12,0,53,82,41,53,10,29,10,12,11,51,82
2008-05-05 00:00:00.000,ATP Masters Series Rome Italy ATP World Tour,CLAY,2,Radek Stepanek,Luis Horna,Radek Stepanek,6-4; 1-6; 6-3,R16,123,5,5,54,83,39,54,14,29,3,5,13,53,83,4,2,52,69,33,52,14,17,0,2,13,47,69
2008-05-05 00:00:00.000,ATP Masters Series Rome Italy ATP World Tour,CLAY,2,Novak Djokovic,Igor Andreev,Novak Djokovic,6-3; 3-6; 6-3,R16,162,1,3,75,111,47,75,21,36,9,11,14,68,111,3,8,63,93,41,63,16,30,2,5,13,57,93
2008-05-05 00:00:00.000,ATP Masters Series Rome Italy ATP World Tour,CLAY,2,Nicolas Almagro,Fernando Gonzalez,Nicolas Almagro,W/O,R16,0,0,0,0,0,0,0,0,0,0,0,0,0,0,0,0,0,0,0,0,0,0,0,0,0,0,0
2008-05-05 00:00:00.000,ATP Masters Series Rome Italy ATP World Tour,CLAY,2,Andy Roddick,Simone Bolelli,Andy Roddick,7-6(5); 6-3,R16,117,8,5,45,69,35,45,12,24,4,5,10,47,69,2,1,61,90,35,61,15,29,6,9,11,50,90
2008-05-05 00:00:00.000,ATP Masters Series Rome Italy ATP World Tour,CLAY,2,Tommy Robredo,Nikolay Davydenko,Tommy Robredo,4-6; 6-2; 7-6(4),R16,161,6,3,69,102,40,69,16,33,9,15,15,56,102,0,5,86,106,45,86,9,20,9,16,15,54,106
2008-05-05 00:00:00.000,ATP Masters Series Rome Italy ATP World Tour,CLAY,2,James Blake,Fernando Verdasco,James Blake,5-7; 7-5; 6-2,R16,155,5,4,73,119,45,73,26,46,10,13,16,71,119,7,1,76,95,47,76,11,19,8,13,16,58,95
2008-05-05 00:00:00.000,ATP Masters Series Rome Italy ATP World Tour,CLAY,2,Stanislas Wawrinka,Juan Carlos Ferrero,Stanislas Wawrinka,6-4; 6-3,R16,85,3,0,32,48,24,32,12,16,0,1,10,36,48,0,0,41,62,28,41,8,21,5,8,9,36,62
2008-05-05 00:00:00.000,ATP Masters Series Rome Italy ATP World Tour,CLAY,2,Radek Stepanek,Roger Federer,Radek Stepanek,7-6(4); 7-6(7),Q,115,8,4,61,94,45,61,15,33,3,5,12,60,94,7,1,48,76,41,48,13,28,1,3,12,54,76
2008-05-05 00:00:00.000,ATP Masters Series Rome Italy ATP World Tour,CLAY,2,Novak Djokovic,Nicolas Almagro,Novak Djokovic,6-1; 1-0 RET,Q,34,0,1,19,27,14,19,5,8,1,1,4,19,27,1,0,13,20,5,13,2,7,1,4,4,7,20
2008-05-05 00:00:00.000,ATP Masters Series Rome Italy ATP World Tour,CLAY,2,Andy Roddick,Tommy Robredo,Andy Roddick,6-3; 4-6; 7-6(4),Q,133,11,7,67,108,51,67,21,41,5,7,16,72,108,6,1,74,95,54,74,11,21,8,10,15,65,95
2008-05-05 00:00:00.000,ATP Masters Series Rome Italy ATP World Tour,CLAY,2,Stanislas Wawrinka,James Blake,Stanislas Wawrinka,6-7(5); 7-6(5); 6-1,Q,152,4,2,66,99,48,66,20,33,3,6,15,68,99,4,1,63,112,39,63,28,49,3,9,16,67,112
2008-05-05 00:00:00.000,ATP Masters Series Rome Italy ATP World Tour,CLAY,2,Novak Djokovic,Radek Stepanek,Novak Djokovic,6-0; 1-0 RET,S,34,2,0,13,19,11,13,5,6,0,0,4,16,19,0,2,10,16,3,10,1,6,0,3,3,4,16
2008-05-05 00:00:00.000,ATP Masters Series Rome Italy ATP World Tour,CLAY,2,Stanislas Wawrinka,Andy Roddick,Stanislas Wawrinka,3-0 RET,S,29,1,1,7,12,5,7,3,5,0,0,2,8,12,0,1,2,5,0,2,0,3,0,1,1,0,5
2008-05-05 00:00:00.000,ATP Masters Series Rome Italy ATP World Tour,CLAY,2,Novak Djokovic,Stanislas Wawrinka,Novak Djokovic,4-6; 6-3; 6-3,F,124,0,1,48,71,40,48,15,23,2,3,14,55,71,2,3,55,87,36,55,19,32,3,6,14,55,87
2008-05-11 00:00:00.000,ATP Masters Series Hamburg Germany ATP World Tour,CLAY,2,Roger Federer,N/A Bye,Roger Federer,,R64,0,0,0,0,0,0,0,0,0,0,0,0,0,0,0,0,0,0,0,0,0,0,0,0,0,0,0
2008-05-11 00:00:00.000,ATP Masters Series Hamburg Germany ATP World Tour,CLAY,2,Jarkko Nieminen,Rainer Schuettler,Jarkko Nieminen,6-1; 6-3,R64,68,1,0,32,44,26,32,7,12,0,0,8,33,44,1,3,26,48,14,26,9,22,2,6,8,23,48
2008-05-11 00:00:00.000,ATP Masters Series Hamburg Germany ATP World Tour,CLAY,2,Robin Soderling,Igor Andreev,Robin Soderling,4-6; 6-3; 6-3,R64,121,4,4,53,90,42,53,17,37,4,6,14,59,90,7,3,55,90,38,55,16,35,3,7,14,54,90
2008-05-11 00:00:00.000,ATP Masters Series Hamburg Germany ATP World Tour,CLAY,2,Jo-Wilfried Tsonga,Nicolas Mahut,Jo-Wilfried Tsonga,0-6; 7-6(5); 6-2,R64,114,5,1,56,81,37,56,16,25,2,5,13,53,81,5,3,60,85,43,60,13,25,3,5,13,56,85
2008-05-11 00:00:00.000,ATP Masters Series Hamburg Germany ATP World Tour,CLAY,2,Fernando Verdasco,Mikhail Youzhny,Fernando Verdasco,6-3; 6-2,R64,76,6,2,30,47,23,30,11,17,1,2,9,34,47,1,2,32,51,18,32,7,19,4,8,8,25,51
2008-05-11 00:00:00.000,ATP Masters Series Hamburg Germany ATP World Tour,CLAY,2,Michael Llodra,Guillermo Canas,Michael Llodra,7-6(7); 6-2,R64,98,2,4,30,65,23,30,20,35,1,3,10,43,65,6,4,43,76,23,43,20,33,8,12,10,43,76
2008-05-11 00:00:00.000,ATP Masters Series Hamburg Germany ATP World Tour,CLAY,2,Ivo Minar,Feliciano Lopez,Ivo Minar,6-3; 6-4,R64,74,3,0,38,56,30,38,11,18,0,0,10,41,56,5,2,48,70,30,48,11,22,6,8,9,41,70
2008-05-11 00:00:00.000,ATP Masters Series Hamburg Germany ATP World Tour,CLAY,2,David Ferrer,N/A Bye,David Ferrer,,R64,0,0,0,0,0,0,0,0,0,0,0,0,0,0,0,0,0,0,0,0,0,0,0,0,0,0,0
2008-05-11 00:00:00.000,ATP Masters Series Hamburg Germany ATP World Tour,CLAY,2,Nikolay Davydenko,N/A Bye,Nikolay Davydenko,,R64,0,0,0,0,0,0,0,0,0,0,0,0,0,0,0,0,0,0,0,0,0,0,0,0,0,0,0
2008-05-11 00:00:00.000,ATP Masters Series Hamburg Germany ATP World Tour,CLAY,2,Ivan Ljubicic,Steve Darcis,Ivan Ljubicic,6-7(6); 7-5; 7-6(4),R64,182,16,0,70,126,54,70,28,56,9,12,18,82,126,3,0,94,145,63,94,24,51,9,13,18,87,145
2008-05-11 00:00:00.000,ATP Masters Series Hamburg Germany ATP World Tour,CLAY,2,Stanislas Wawrinka,Alberto Martin,Stanislas Wawrinka,6-3; 6-3,R64,89,0,2,38,68,28,38,15,30,6,7,9,43,68,2,3,40,68,25,40,11,28,6,10,9,36,68
2008-05-11 00:00:00.000,ATP Masters Series Hamburg Germany ATP World Tour,CLAY,2,Nicolas Kiefer,Paul-Henri Mathieu,Nicolas Kiefer,6-4; 6-4,R64,100,13,3,41,69,33,41,12,28,4,5,10,45,69,3,0,39,64,24,39,13,25,4,7,10,37,64
2008-05-11 00:00:00.000,ATP Masters Series Hamburg Germany ATP World Tour,CLAY,2,Juan Monaco,Filippo Volandri,Juan Monaco,6-1; 4-0 RET,R64,58,3,1,24,43,18,24,11,19,3,3,6,29,43,0,1,22,31,10,22,2,9,6,10,5,12,31
2008-05-11 00:00:00.000,ATP Masters Series Hamburg Germany ATP World Tour,CLAY,2,Simone Bolelli,Marcel Granollers,Simone Bolelli,7-5; 6-2,R64,93,3,0,38,56,27,38,13,18,1,2,10,40,56,1,5,40,67,26,40,9,27,9,13,10,35,67
2008-05-11 00:00:00.000,ATP Masters Series Hamburg Germany ATP World Tour,CLAY,2,Andreas Seppi,Michael Berrer,Andreas Seppi,6-3; 6-0,R64,56,3,0,31,44,24,31,9,13,0,0,8,33,44,1,1,28,43,14,28,6,15,2,6,7,20,43
2008-05-11 00:00:00.000,ATP Masters Series Hamburg Germany ATP World Tour,CLAY,2,Richard Gasquet,N/A Bye,Richard Gasquet,,R64,0,0,0,0,0,0,0,0,0,0,0,0,0,0,0,0,0,0,0,0,0,0,0,0,0,0,0
2008-05-11 00:00:00.000,ATP Masters Series Hamburg Germany ATP World Tour,CLAY,2,James Blake,N/A Bye,James Blake,,R64,0,0,0,0,0,0,0,0,0,0,0,0,0,0,0,0,0,0,0,0,0,0,0,0,0,0,0
2008-05-11 00:00:00.000,ATP Masters Series Hamburg Germany ATP World Tour,CLAY,2,Janko Tipsarevic,Andreas Beck,Janko Tipsarevic,3-6; 6-3; 6-1,R64,106,15,2,47,74,34,47,14,27,2,5,12,48,74,5,0,51,77,28,51,14,26,2,7,12,42,77
2008-05-11 00:00:00.000,ATP Masters Series Hamburg Germany ATP World Tour,CLAY,2,Albert Montanes,Mardy Fish,Albert Montanes,6-1; 6-3,R64,63,0,7,27,53,20,27,14,26,4,5,8,34,53,3,1,16,45,13,16,9,29,4,9,8,22,45
2008-05-11 00:00:00.000,ATP Masters Series Hamburg Germany ATP World Tour,CLAY,2,Jose Acasuso,Kristof Vliegen,Jose Acasuso,5-2 RET,R64,35,1,2,9,20,6,9,5,11,0,1,3,11,20,0,0,20,27,9,20,2,7,1,4,4,11,27
2008-05-11 00:00:00.000,ATP Masters Series Hamburg Germany ATP World Tour,CLAY,2,Tommy Robredo,Philipp Kohlschreiber,Tommy Robredo,2-6; 7-6(5); 6-3,R64,151,3,2,71,107,47,71,15,36,9,14,15,62,107,3,1,51,91,32,51,23,40,4,8,14,55,91
2008-05-11 00:00:00.000,ATP Masters Series Hamburg Germany ATP World Tour,CLAY,2,Ivo Karlovic,Mischa Zverev,Ivo Karlovic,7-6(4); 7-6(3),R64,92,14,0,54,77,40,54,18,23,0,0,12,58,77,4,2,53,75,40,53,15,22,0,0,12,55,75
2008-05-11 00:00:00.000,ATP Masters Series Hamburg Germany ATP World Tour,CLAY,2,Juan Ignacio Chela,Jose Antonio Sanchez-de Luna,Juan Ignacio Chela,6-3; 6-3,R64,97,0,5,54,74,29,54,9,20,7,11,9,38,74,0,2,45,62,22,45,4,17,7,14,9,26,62
2008-05-11 00:00:00.000,ATP Masters Series Hamburg Germany ATP World Tour,CLAY,2,Novak Djokovic,N/A Bye,Novak Djokovic,,R64,0,0,0,0,0,0,0,0,0,0,0,0,0,0,0,0,0,0,0,0,0,0,0,0,0,0,0
2008-05-11 00:00:00.000,ATP Masters Series Hamburg Germany ATP World Tour,CLAY,2,Tomas Berdych,N/A Bye,Tomas Berdych,,R64,0,0,0,0,0,0,0,0,0,0,0,0,0,0,0,0,0,0,0,0,0,0,0,0,0,0,0
2008-05-11 00:00:00.000,ATP Masters Series Hamburg Germany ATP World Tour,CLAY,2,Marat Safin,Marin Cilic,Marat Safin,7-5; 6-2,R64,89,8,3,42,79,32,42,19,37,8,8,10,51,79,5,3,33,55,26,33,9,22,0,3,10,35,55
2008-05-11 00:00:00.000,ATP Masters Series Hamburg Germany ATP World Tour,CLAY,2,Olivier Rochus,Gianluca Naso,Olivier Rochus,7-6(11); 2-6; 6-4,R64,154,4,2,93,131,61,93,18,38,15,18,15,79,131,12,6,50,92,41,50,22,42,0,2,15,63,92
2008-05-11 00:00:00.000,ATP Masters Series Hamburg Germany ATP World Tour,CLAY,2,Carlos Moya,Julien Benneteau,Carlos Moya,3-6; 6-4; 7-6(7),R64,140,2,5,60,103,42,60,20,43,8,12,15,62,103,3,6,57,91,41,57,18,34,3,7,16,59,91
2008-05-11 00:00:00.000,ATP Masters Series Hamburg Germany ATP World Tour,CLAY,2,Andy Murray,Dmitry Tursunov,Andy Murray,6-4; 6-1,R64,92,1,1,33,52,22,33,15,19,3,3,8,37,52,1,4,40,77,25,40,15,37,5,9,9,40,77
2008-05-11 00:00:00.000,ATP Masters Series Hamburg Germany ATP World Tour,CLAY,2,Gilles Simon,Xavier Malisse,Gilles Simon,6-4; 7-5,R64,86,2,2,37,66,24,37,15,29,2,5,11,39,66,3,0,40,75,24,40,14,35,5,10,11,38,75
2008-05-11 00:00:00.000,ATP Masters Series Hamburg Germany ATP World Tour,CLAY,2,Potito Starace,Luis Horna,Potito Starace,6-3; 4-2 RET,R64,60,0,0,30,35,23,30,3,5,0,1,7,26,35,1,1,29,40,15,29,4,11,1,5,8,19,40
2008-05-11 00:00:00.000,ATP Masters Series Hamburg Germany ATP World Tour,CLAY,2,Rafael Nadal,N/A Bye,Rafael Nadal,,R64,0,0,0,0,0,0,0,0,0,0,0,0,0,0,0,0,0,0,0,0,0,0,0,0,0,0,0
2008-05-11 00:00:00.000,ATP Masters Series Hamburg Germany ATP World Tour,CLAY,2,Roger Federer,Jarkko Nieminen,Roger Federer,6-1; 6-3,R32,58,2,0,33,42,22,33,5,9,0,2,8,27,42,1,4,39,59,21,39,2,20,5,11,8,23,59
2008-05-11 00:00:00.000,ATP Masters Series Hamburg Germany ATP World Tour,CLAY,2,Robin Soderling,Jo-Wilfried Tsonga,Robin Soderling,6-2; 7-5,R32,72,6,2,39,58,31,39,9,19,0,1,10,40,58,4,1,42,58,25,42,7,16,4,8,10,32,58
2008-05-11 00:00:00.000,ATP Masters Series Hamburg Germany ATP World Tour,CLAY,2,Fernando Verdasco,Michael Llodra,Fernando Verdasco,6-2; 6-0,R32,51,2,2,32,42,26,32,5,10,0,0,7,31,42,3,2,36,47,15,36,3,11,3,8,7,18,47
2008-05-11 00:00:00.000,ATP Masters Series Hamburg Germany ATP World Tour,CLAY,2,David Ferrer,Ivo Minar,David Ferrer,6-3; 6-3,R32,76,0,1,36,54,25,36,9,18,2,4,9,34,54,1,1,38,55,19,38,7,17,2,7,9,26,55
2008-05-11 00:00:00.000,ATP Masters Series Hamburg Germany ATP World Tour,CLAY,2,Nikolay Davydenko,Ivan Ljubicic,Nikolay Davydenko,6-4; 6-1,R32,85,0,0,35,43,22,35,5,8,0,2,8,27,43,6,1,44,71,27,44,5,27,9,15,9,32,71
2008-05-11 00:00:00.000,ATP Masters Series Hamburg Germany ATP World Tour,CLAY,2,Nicolas Kiefer,Stanislas Wawrinka,Nicolas Kiefer,7-5; 7-5,R32,143,3,1,37,79,29,37,22,42,4,6,12,51,79,1,1,61,89,33,61,18,28,7,11,12,51,89
2008-05-11 00:00:00.000,ATP Masters Series Hamburg Germany ATP World Tour,CLAY,2,Juan Monaco,Simone Bolelli,Juan Monaco,6-2; 6-1,R32,66,3,0,35,49,27,35,9,14,5,5,8,36,49,3,2,30,49,16,30,8,19,7,11,7,24,49
2008-05-11 00:00:00.000,ATP Masters Series Hamburg Germany ATP World Tour,CLAY,2,Andreas Seppi,Richard Gasquet,Andreas Seppi,6-3; 6-2,R32,72,3,2,32,45,27,32,9,13,2,2,8,36,45,4,3,32,56,22,32,8,24,4,8,9,30,56
2008-05-11 00:00:00.000,ATP Masters Series Hamburg Germany ATP World Tour,CLAY,2,Janko Tipsarevic,James Blake,Janko Tipsarevic,4-6; 6-3; 6-3,R32,119,11,0,50,94,42,50,22,44,2,3,14,64,94,6,4,47,87,37,47,19,40,1,4,14,56,87
2008-05-11 00:00:00.000,ATP Masters Series Hamburg Germany ATP World Tour,CLAY,2,Albert Montanes,Jose Acasuso,Albert Montanes,7-6(3); 6-3,R32,95,2,2,40,67,30,40,11,27,4,7,10,41,67,2,10,39,79,30,39,9,40,7,12,11,39,79
2008-05-11 00:00:00.000,ATP Masters Series Hamburg Germany ATP World Tour,CLAY,2,Ivo Karlovic,Tommy Robredo,Ivo Karlovic,3-6; 6-2; 7-6(3),R32,116,20,2,65,99,49,65,18,34,5,8,15,67,99,1,0,65,76,46,65,5,11,3,6,14,51,76
2008-05-11 00:00:00.000,ATP Masters Series Hamburg Germany ATP World Tour,CLAY,2,Novak Djokovic,Juan Ignacio Chela,Novak Djokovic,6-3; 6-1,R32,66,4,2,32,46,26,32,6,14,2,3,8,32,46,0,1,32,57,17,32,9,25,2,7,8,26,57
2008-05-11 00:00:00.000,ATP Masters Series Hamburg Germany ATP World Tour,CLAY,2,Marat Safin,Tomas Berdych,Marat Safin,7-5; 6-4,R32,91,4,3,47,77,34,47,15,30,3,4,11,49,77,2,3,31,54,22,31,12,23,1,4,11,34,54
2008-05-11 00:00:00.000,ATP Masters Series Hamburg Germany ATP World Tour,CLAY,2,Carlos Moya,Olivier Rochus,Carlos Moya,7-5; 6-3,R32,93,5,1,26,59,20,26,23,33,1,2,11,43,59,0,1,38,63,21,38,14,25,3,6,10,35,63
2008-05-11 00:00:00.000,ATP Masters Series Hamburg Germany ATP World Tour,CLAY,2,Andy Murray,Gilles Simon,Andy Murray,6-3; 6-3,R32,77,0,1,24,53,20,24,16,29,3,4,9,36,53,0,4,29,59,16,29,14,30,5,9,9,30,59
2008-05-11 00:00:00.000,ATP Masters Series Hamburg Germany ATP World Tour,CLAY,2,Rafael Nadal,Potito Starace,Rafael Nadal,6-4; 7-6(6),R32,128,2,2,53,65,37,53,5,12,0,2,11,42,65,0,3,66,85,41,66,6,19,4,7,11,47,85
2008-05-11 00:00:00.000,ATP Masters Series Hamburg Germany ATP World Tour,CLAY,2,Roger Federer,Robin Soderling,Roger Federer,6-3; 6-2,R16,64,6,0,25,48,21,25,16,23,2,2,9,37,48,6,0,37,56,22,37,9,19,6,9,8,31,56
2008-05-11 00:00:00.000,ATP Masters Series Hamburg Germany ATP World Tour,CLAY,2,Fernando Verdasco,David Ferrer,Fernando Verdasco,7-6(4); 6-2,R16,130,6,2,66,84,40,66,9,18,7,10,10,49,84,2,3,63,97,37,63,12,34,11,16,10,49,97
2008-05-11 00:00:00.000,ATP Masters Series Hamburg Germany ATP World Tour,CLAY,2,Nicolas Kiefer,Nikolay Davydenko,Nicolas Kiefer,7-5; 6-3,R16,115,8,1,47,79,32,47,21,32,4,5,11,53,79,0,2,36,60,24,36,11,24,2,5,10,35,60
2008-05-11 00:00:00.000,ATP Masters Series Hamburg Germany ATP World Tour,CLAY,2,Andreas Seppi,Juan Monaco,Andreas Seppi,6-0; 6-3,R16,72,1,1,26,44,18,26,9,18,2,4,7,27,44,0,2,30,50,10,30,7,20,1,8,8,17,50
2008-05-11 00:00:00.000,ATP Masters Series Hamburg Germany ATP World Tour,CLAY,2,Albert Montanes,Janko Tipsarevic,Albert Montanes,6-2; 6-1,R16,63,5,0,26,37,19,26,9,11,0,0,7,28,37,4,2,22,52,14,22,9,30,1,6,8,23,52
2008-05-11 00:00:00.000,ATP Masters Series Hamburg Germany ATP World Tour,CLAY,2,Novak Djokovic,Ivo Karlovic,Novak Djokovic,7-6(3); 6-3,R16,98,4,2,54,78,39,54,14,24,3,4,11,53,78,12,0,41,64,30,41,10,23,1,3,10,40,64
2008-05-11 00:00:00.000,ATP Masters Series Hamburg Germany ATP World Tour,CLAY,2,Carlos Moya,Marat Safin,Carlos Moya,6-2; 6-7(3); 6-1,R16,147,5,1,61,99,38,61,27,38,4,5,14,65,99,4,1,45,85,32,45,17,40,5,10,13,49,85
2008-05-11 00:00:00.000,ATP Masters Series Hamburg Germany ATP World Tour,CLAY,2,Rafael Nadal,Andy Murray,Rafael Nadal,6-3; 6-2,R16,78,1,0,34,43,25,34,6,9,2,3,8,31,43,3,0,40,64,21,40,11,24,3,8,9,32,64
2008-05-11 00:00:00.000,ATP Masters Series Hamburg Germany ATP World Tour,CLAY,2,Roger Federer,Fernando Verdasco,Roger Federer,6-3; 6-3,Q,81,2,1,38,55,28,38,11,17,3,3,9,39,55,1,4,43,60,28,43,7,17,5,8,9,35,60
2008-05-11 00:00:00.000,ATP Masters Series Hamburg Germany ATP World Tour,CLAY,2,Andreas Seppi,Nicolas Kiefer,Andreas Seppi,6-3; 5-7; 7-5,Q,193,1,5,73,119,46,73,23,46,10,14,16,69,119,8,3,49,112,32,49,31,63,7,13,17,63,112
2008-05-11 00:00:00.000,ATP Masters Series Hamburg Germany ATP World Tour,CLAY,2,Novak Djokovic,Albert Montanes,Novak Djokovic,6-2; 6-3,Q,77,4,0,48,62,33,48,8,14,3,4,9,41,62,0,2,37,56,20,37,8,19,3,7,8,28,56
2008-05-11 00:00:00.000,ATP Masters Series Hamburg Germany ATP World Tour,CLAY,2,Rafael Nadal,Carlos Moya,Rafael Nadal,6-1; 6-3,Q,75,0,0,41,51,27,41,8,10,2,3,8,35,51,3,0,32,49,17,32,6,17,4,9,8,23,49
2008-05-11 00:00:00.000,ATP Masters Series Hamburg Germany ATP World Tour,CLAY,2,Roger Federer,Andreas Seppi,Roger Federer,6-3; 6-1,S,79,1,0,24,46,19,24,14,22,1,1,8,33,46,2,1,44,73,26,44,12,29,10,14,8,38,73
2008-05-11 00:00:00.000,ATP Masters Series Hamburg Germany ATP World Tour,CLAY,2,Rafael Nadal,Novak Djokovic,Rafael Nadal,7-5; 2-6; 6-2,S,183,3,2,82,110,47,82,14,28,15,19,14,61,110,0,0,60,93,35,60,15,33,4,9,14,50,93
2008-05-11 00:00:00.000,ATP Masters Series Hamburg Germany ATP World Tour,CLAY,2,Rafael Nadal,Roger Federer,Rafael Nadal,7-5; 6-7(3); 6-3,F,172,3,3,77,101,51,77,8,24,3,7,17,59,101,7,0,72,118,48,72,16,46,11,17,16,64,118
2008-05-18 00:00:00.000,Casablanca Morocco ATP World Tour,CLAY,2,Jo-Wilfried Tsonga,Albert Montanes,Jo-Wilfried Tsonga,6-4; 7-6(10),R32,96,4,1,52,70,43,52,10,18,0,0,11,53,70,3,2,55,82,39,55,14,27,2,3,11,53,82
2008-05-18 00:00:00.000,Casablanca Morocco ATP World Tour,CLAY,2,Lamine Ouahab,Martin Vassallo Arguello,Lamine Ouahab,7-5; 6-2,R32,86,1,0,40,62,30,40,11,22,3,4,10,41,62,4,2,53,68,32,53,5,15,5,9,10,37,68
2008-05-18 00:00:00.000,Casablanca Morocco ATP World Tour,CLAY,2,Santiago Ventura,Arnaud Clement,Santiago Ventura,7-6(6); 6-1,R32,89,7,0,31,62,21,31,24,31,1,2,10,45,62,6,0,27,58,21,27,13,31,1,4,9,34,58
2008-05-18 00:00:00.000,Casablanca Morocco ATP World Tour,CLAY,2,Rainer Schuettler,Chris Guccione,Rainer Schuettler,6-4; 6-7(5); 6-2,R32,121,3,3,64,86,51,64,10,22,4,6,15,61,86,14,2,67,104,44,67,16,37,9,14,15,60,104
2008-05-18 00:00:00.000,Casablanca Morocco ATP World Tour,CLAY,2,Marc Gicquel,Ruben Ramirez Hidalgo,Marc Gicquel,6-3; 6-0,R32,57,8,1,19,42,17,19,13,23,2,2,7,30,42,3,2,23,48,11,23,10,25,1,6,8,21,48
2008-05-18 00:00:00.000,Casablanca Morocco ATP World Tour,CLAY,2,Guillermo Coria,Peter Polansky,Guillermo Coria,4-6; 6-4; 6-3,R32,127,2,7,59,93,41,59,17,34,6,9,14,58,93,10,2,57,95,38,57,14,38,6,11,15,52,95
2008-05-18 00:00:00.000,Casablanca Morocco ATP World Tour,CLAY,2,Boris Pashanski,Benjamin Becker,Boris Pashanski,2-6; 6-3; 7-6(3),R32,103,4,4,58,89,46,58,18,31,2,4,15,64,89,9,2,48,78,36,48,22,30,2,3,14,58,78
2008-05-18 00:00:00.000,Casablanca Morocco ATP World Tour,CLAY,2,Gilles Simon,Florent Serra,Gilles Simon,6-2; 5-7; 6-3,R32,142,6,2,59,107,35,59,25,48,9,14,15,60,107,0,0,59,99,32,59,19,40,9,16,14,51,99
2008-05-18 00:00:00.000,Casablanca Morocco ATP World Tour,CLAY,2,Younes El Aynaoui,Victor Hanescu,Younes El Aynaoui,6-2; 6-7(6); 6-3,R32,130,12,8,71,109,53,71,19,38,10,11,15,72,109,9,2,58,84,39,58,13,26,4,8,14,52,84
2008-05-18 00:00:00.000,Casablanca Morocco ATP World Tour,CLAY,2,Dominik Hrbaty,Peter Luczak,Dominik Hrbaty,2-1 RET,R32,10,0,1,7,11,5,7,1,4,0,1,2,6,11,0,2,1,4,0,1,0,3,0,1,1,0,4
2008-05-18 00:00:00.000,Casablanca Morocco ATP World Tour,CLAY,2,Olivier Patience,Marcos Daniel,Olivier Patience,6-7(5); 7-6(0); 6-4,R32,151,11,2,74,115,54,74,24,41,4,6,17,78,115,12,0,65,111,50,65,25,46,10,13,17,75,111
2008-05-18 00:00:00.000,Casablanca Morocco ATP World Tour,CLAY,2,Agustin Calleri,Thierry Ascione,Agustin Calleri,3-6; 6-1; 6-2,R32,120,12,5,40,78,33,40,18,38,5,7,12,51,78,0,4,70,99,37,70,14,29,12,17,12,51,99
2008-05-18 00:00:00.000,Casablanca Morocco ATP World Tour,CLAY,2,Julien Benneteau,Florian Mayer,Julien Benneteau,2-6; 6-3; 6-4,R32,109,2,1,60,92,34,60,19,32,3,7,14,53,92,5,0,47,74,32,47,14,27,3,7,13,46,74
2008-05-18 00:00:00.000,Casablanca Morocco ATP World Tour,CLAY,2,Pablo Cuevas,Woong-Sun Jun,Pablo Cuevas,6-4; 6-1,R32,65,7,1,37,56,28,37,12,19,3,3,9,40,56,1,2,23,44,15,23,12,21,3,6,8,27,44
2008-05-18 00:00:00.000,Casablanca Morocco ATP World Tour,CLAY,2,Oscar Hernandez,Frank Dancevic,Oscar Hernandez,6-7(4); 6-4; 7-6(5),R32,174,3,2,84,121,57,84,22,37,6,8,17,79,121,10,2,86,134,66,86,17,48,12,15,17,83,134
2008-05-18 00:00:00.000,Casablanca Morocco ATP World Tour,CLAY,2,Gael Monfils,Guillermo Garcia-Lopez,Gael Monfils,6-7(8); 7-5; 6-0,R32,124,8,5,54,88,41,54,20,34,2,4,15,61,88,1,3,51,92,34,51,17,41,3,9,15,51,92
2008-05-18 00:00:00.000,Casablanca Morocco ATP World Tour,CLAY,2,Jo-Wilfried Tsonga,Lamine Ouahab,Jo-Wilfried Tsonga,6-3; 6-2,R16,68,7,0,43,56,34,43,8,13,1,1,9,42,56,2,1,34,51,21,34,8,17,1,4,8,29,51
2008-05-18 00:00:00.000,Casablanca Morocco ATP World Tour,CLAY,2,Santiago Ventura,Rainer Schuettler,Santiago Ventura,2-6; 6-4; 6-0,R16,111,4,3,43,75,32,43,15,32,2,5,12,47,75,2,0,51,73,27,51,12,22,2,7,12,39,73
2008-05-18 00:00:00.000,Casablanca Morocco ATP World Tour,CLAY,2,Marc Gicquel,Guillermo Coria,Marc Gicquel,6-1; 2-6; 7-6(2),R16,108,5,1,62,93,40,62,15,31,6,9,14,55,93,4,8,52,78,35,52,12,26,0,3,13,47,78
2008-05-18 00:00:00.000,Casablanca Morocco ATP World Tour,CLAY,2,Gilles Simon,Boris Pashanski,Gilles Simon,3-6; 6-4; 6-3,R16,148,5,3,55,88,38,55,14,33,5,9,14,52,88,2,3,54,104,33,54,22,50,6,11,14,55,104
2008-05-18 00:00:00.000,Casablanca Morocco ATP World Tour,CLAY,2,Younes El Aynaoui,Dominik Hrbaty,Younes El Aynaoui,6-3; 7-5,R16,96,10,0,34,64,26,34,14,30,2,5,11,40,64,4,7,41,66,28,41,6,25,1,6,10,34,66
2008-05-18 00:00:00.000,Casablanca Morocco ATP World Tour,CLAY,2,Agustin Calleri,Olivier Patience,Agustin Calleri,6-2; 7-5,R16,77,12,2,32,58,28,32,14,26,4,5,10,42,58,1,2,45,64,26,45,10,19,5,9,10,36,64
2008-05-18 00:00:00.000,Casablanca Morocco ATP World Tour,CLAY,2,Julien Benneteau,Pablo Cuevas,Julien Benneteau,6-4; 6-4,R16,67,4,3,35,50,26,35,11,15,1,2,10,37,50,2,1,31,55,19,31,14,24,2,5,10,33,55
2008-05-18 00:00:00.000,Casablanca Morocco ATP World Tour,CLAY,2,Oscar Hernandez,Gael Monfils,Oscar Hernandez,6-3; 6-2,R16,72,2,1,43,56,31,43,10,13,2,2,9,41,56,1,1,33,45,21,33,6,12,3,6,8,27,45
2008-05-18 00:00:00.000,Casablanca Morocco ATP World Tour,CLAY,2,Jo-Wilfried Tsonga,Santiago Ventura,Jo-Wilfried Tsonga,6-3; 6-3,Q,71,7,0,33,47,29,33,8,14,2,2,9,37,47,2,4,30,64,20,30,16,34,5,8,9,36,64
2008-05-18 00:00:00.000,Casablanca Morocco ATP World Tour,CLAY,2,Gilles Simon,Marc Gicquel,Gilles Simon,6-3; 6-2,Q,81,5,6,41,78,31,41,17,37,5,6,9,48,78,4,4,25,53,18,25,9,28,6,10,8,27,53
2008-05-18 00:00:00.000,Casablanca Morocco ATP World Tour,CLAY,2,Agustin Calleri,Younes El Aynaoui,Agustin Calleri,W/O,Q,0,0,0,0,0,0,0,0,0,0,0,0,0,0,0,0,0,0,0,0,0,0,0,0,0,0,0
2008-05-18 00:00:00.000,Casablanca Morocco ATP World Tour,CLAY,2,Julien Benneteau,Oscar Hernandez,Julien Benneteau,6-3; 5-2 RET,Q,74,5,2,39,48,28,39,5,9,2,3,8,33,48,1,2,41,54,22,41,5,13,3,7,8,27,54
2008-05-18 00:00:00.000,Casablanca Morocco ATP World Tour,CLAY,2,Gilles Simon,Jo-Wilfried Tsonga,Gilles Simon,W/O,S,0,0,0,0,0,0,0,0,0,0,0,0,0,0,0,0,0,0,0,0,0,0,0,0,0,0,0
2008-05-18 00:00:00.000,Casablanca Morocco ATP World Tour,CLAY,2,Julien Benneteau,Agustin Calleri,Julien Benneteau,1-6; 6-1; 6-3,S,99,6,1,48,74,31,48,12,26,3,7,12,43,74,8,2,46,72,29,46,8,26,5,10,11,37,72
2008-05-18 00:00:00.000,Casablanca Morocco ATP World Tour,CLAY,2,Gilles Simon,Julien Benneteau,Gilles Simon,7-5; 6-2,F,77,3,0,34,51,29,34,9,17,1,2,10,38,51,3,3,48,70,29,48,9,22,4,8,10,38,70
2008-05-18 00:00:00.000,Poertschach Austria ATP World Tour,CLAY,2,Nikolay Davydenko,Rainer Eitzinger,Nikolay Davydenko,6-1; 6-1,R32,57,3,0,33,43,25,33,6,10,2,2,7,31,43,0,1,34,47,14,34,4,13,3,8,7,18,47
2008-05-18 00:00:00.000,Poertschach Austria ATP World Tour,CLAY,2,John Isner,Simone Vagnozzi,John Isner,6-3; 6-2,R32,53,11,0,37,54,28,37,10,17,1,1,9,38,54,2,0,34,40,20,34,3,6,0,3,8,23,40
2008-05-18 00:00:00.000,Poertschach Austria ATP World Tour,CLAY,2,Dudi Sela,Mischa Zverev,Dudi Sela,7-6(2); 6-0,R32,94,1,3,43,67,31,43,14,24,6,7,9,45,67,0,1,33,58,18,33,12,25,2,6,9,30,58
2008-05-18 00:00:00.000,Poertschach Austria ATP World Tour,CLAY,2,Andreas Seppi,Ernests Gulbis,Andreas Seppi,1-6; 6-4; 6-3,R32,101,3,1,30,74,23,30,24,44,1,4,13,47,74,9,4,46,74,37,46,13,28,2,5,13,50,74
2008-05-18 00:00:00.000,Poertschach Austria ATP World Tour,CLAY,2,Igor Kunitsyn,Mardy Fish,Igor Kunitsyn,6-1; 6-1,R32,54,6,0,24,40,19,24,10,16,0,0,7,29,40,2,2,16,35,7,16,7,19,1,6,7,14,35
2008-05-18 00:00:00.000,Poertschach Austria ATP World Tour,CLAY,2,Blaz Kavcic,Teymuraz Gabashvili,Blaz Kavcic,4-6; 6-4; 7-6(3),R32,141,8,11,58,104,45,58,20,46,10,14,16,65,104,2,1,62,101,42,62,22,39,6,10,16,64,101
2008-05-18 00:00:00.000,Poertschach Austria ATP World Tour,CLAY,2,Jurgen Melzer,Donald Young,Jurgen Melzer,7-5; 6-2,R32,85,3,3,36,60,26,36,9,24,1,4,10,35,60,1,4,49,85,25,49,14,36,10,16,10,39,85
2008-05-18 00:00:00.000,Poertschach Austria ATP World Tour,CLAY,2,Robin Haase,Sergio Roitman,Robin Haase,7-6(7); 6-4,R32,93,8,3,53,79,40,53,10,26,2,4,11,50,79,1,1,49,79,32,49,16,30,4,7,11,48,79
2008-05-18 00:00:00.000,Poertschach Austria ATP World Tour,CLAY,2,Sam Querrey,Oliver Marach,Sam Querrey,3-6; 6-4; 6-4,R32,120,11,4,53,88,44,53,14,35,5,7,15,58,88,4,3,60,90,45,60,14,30,6,8,14,59,90
2008-05-18 00:00:00.000,Poertschach Austria ATP World Tour,CLAY,2,Daniel Gimeno-Traver,Werner Eschauer,Daniel Gimeno-Traver,6-4; 6-2,R32,64,4,0,32,47,20,32,13,15,3,4,9,33,47,2,3,31,56,17,31,11,25,4,8,9,28,56
2008-05-18 00:00:00.000,Poertschach Austria ATP World Tour,CLAY,2,Ivan Navarro,Vincent Spadea,Ivan Navarro,6-4; 6-4,R32,79,4,2,44,58,32,44,9,14,0,1,10,41,58,4,5,38,64,24,38,14,26,1,4,10,38,64
2008-05-18 00:00:00.000,Poertschach Austria ATP World Tour,CLAY,2,Ivan Ljubicic,Jan Hajek,Ivan Ljubicic,4-6; 6-0; 6-3,R32,98,12,0,55,88,43,55,16,33,5,6,13,59,88,2,1,37,66,24,37,12,29,0,4,12,36,66
2008-05-18 00:00:00.000,Poertschach Austria ATP World Tour,CLAY,2,Robby Ginepri,Mario Ancic,Robby Ginepri,4-6; 6-3; 7-6(8),R32,132,5,1,64,99,43,64,21,35,3,6,16,64,99,12,5,65,96,51,65,11,31,3,6,15,62,96
2008-05-18 00:00:00.000,Poertschach Austria ATP World Tour,CLAY,2,Olivier Rochus,Michal Przysiezny,Olivier Rochus,6-2; 6-4,R32,76,5,0,40,56,30,40,10,16,1,1,9,40,56,9,3,31,55,22,31,11,24,2,5,9,33,55
2008-05-18 00:00:00.000,Poertschach Austria ATP World Tour,CLAY,2,Jiri Vanek,Martin Verkerk,Jiri Vanek,7-5; 4-6; 6-2,R32,112,15,2,56,80,44,56,13,24,2,4,15,57,80,15,4,57,94,44,57,15,37,2,6,15,59,94
2008-05-18 00:00:00.000,Poertschach Austria ATP World Tour,CLAY,2,Juan Monaco,Carlos Berlocq,Juan Monaco,4-1 RET,R32,17,2,2,5,10,5,5,3,5,0,0,2,8,10,1,1,12,15,6,12,0,3,0,2,3,6,15
2008-05-18 00:00:00.000,Poertschach Austria ATP World Tour,CLAY,2,Nikolay Davydenko,John Isner,Nikolay Davydenko,6-2; 6-7(6); 6-3,R16,119,1,2,64,86,51,64,17,22,2,2,15,68,86,21,6,51,86,42,51,14,35,2,5,14,56,86
2008-05-18 00:00:00.000,Poertschach Austria ATP World Tour,CLAY,2,Andreas Seppi,Dudi Sela,Andreas Seppi,7-5; 6-1,R16,75,4,1,41,66,30,41,14,25,9,9,9,44,66,2,0,43,63,24,43,10,20,4,8,10,34,63
2008-05-18 00:00:00.000,Poertschach Austria ATP World Tour,CLAY,2,Igor Kunitsyn,Blaz Kavcic,Igor Kunitsyn,6-1; 6-4,R16,81,2,0,27,58,16,27,22,31,4,5,9,38,58,1,2,28,56,18,28,9,28,3,7,8,27,56
2008-05-18 00:00:00.000,Poertschach Austria ATP World Tour,CLAY,2,Jurgen Melzer,Robin Haase,Jurgen Melzer,6-3; 4-6; 6-2,R16,101,3,1,41,75,25,41,21,34,2,5,13,46,75,5,5,46,82,27,46,18,36,5,11,14,45,82
2008-05-18 00:00:00.000,Poertschach Austria ATP World Tour,CLAY,2,Daniel Gimeno-Traver,Sam Querrey,Daniel Gimeno-Traver,6-1; 6-3,R16,54,4,2,30,46,26,30,8,16,1,1,8,34,46,1,2,24,44,14,24,9,20,0,4,8,23,44
2008-05-18 00:00:00.000,Poertschach Austria ATP World Tour,CLAY,2,Ivan Ljubicic,Ivan Navarro,Ivan Ljubicic,7-6(3); 6-4,R16,76,15,1,39,60,36,39,14,21,0,0,11,50,60,6,1,41,58,32,41,12,17,0,1,11,44,58
2008-05-18 00:00:00.000,Poertschach Austria ATP World Tour,CLAY,2,Robby Ginepri,Olivier Rochus,Robby Ginepri,4-6; 6-2; 6-3,R16,131,8,1,60,100,36,60,20,40,15,19,14,56,100,2,4,47,80,27,47,13,33,4,10,13,40,80
2008-05-18 00:00:00.000,Poertschach Austria ATP World Tour,CLAY,2,Juan Monaco,Jiri Vanek,Juan Monaco,6-2; 6-2,R16,59,6,0,25,42,22,25,9,17,0,1,8,31,42,1,3,36,56,19,36,6,20,6,11,8,25,56
2008-05-18 00:00:00.000,Poertschach Austria ATP World Tour,CLAY,2,Nikolay Davydenko,Andreas Seppi,Nikolay Davydenko,6-3; 1-6; 6-3,Q,97,5,0,53,72,37,53,12,19,1,3,13,49,72,1,2,30,66,22,30,21,36,2,4,12,43,66
2008-05-18 00:00:00.000,Poertschach Austria ATP World Tour,CLAY,2,Igor Kunitsyn,Jurgen Melzer,Igor Kunitsyn,6-4; 3-6; 6-3,Q,138,3,1,55,98,39,55,21,43,10,14,14,60,98,7,0,53,95,33,53,20,42,6,11,14,53,95
2008-05-18 00:00:00.000,Poertschach Austria ATP World Tour,CLAY,2,Ivan Ljubicic,Daniel Gimeno-Traver,Ivan Ljubicic,6-3; 4-6; 7-6(6),Q,131,15,0,64,102,56,64,18,38,4,5,16,74,102,7,4,63,99,49,63,20,36,3,4,15,69,99
2008-05-18 00:00:00.000,Poertschach Austria ATP World Tour,CLAY,2,Juan Monaco,Robby Ginepri,Juan Monaco,7-5; 7-6(3),Q,106,3,4,52,85,33,52,17,33,7,11,12,50,85,5,1,51,82,30,51,14,31,6,11,12,44,82
2008-05-18 00:00:00.000,Poertschach Austria ATP World Tour,CLAY,2,Nikolay Davydenko,Igor Kunitsyn,Nikolay Davydenko,6-3; 6-2,S,83,2,0,27,49,21,27,14,22,1,2,9,35,49,0,1,35,60,20,35,10,25,5,9,8,30,60
2008-05-18 00:00:00.000,Poertschach Austria ATP World Tour,CLAY,2,Juan Monaco,Ivan Ljubicic,Juan Monaco,6-4; 6-7(4); 7-6(4),S,175,5,3,74,121,49,74,27,47,9,11,17,76,121,12,3,57,107,43,57,25,50,1,4,17,68,107
2008-05-18 00:00:00.000,Poertschach Austria ATP World Tour,CLAY,2,Nikolay Davydenko,Juan Monaco,Nikolay Davydenko,6-2; 2-6; 6-2,F,125,5,2,38,78,24,38,23,40,4,7,12,47,78,3,2,41,73,27,41,13,32,5,10,12,40,73
2008-05-25 00:00:00.000,Roland Garros France Grand Slams,CLAY,3,Roger Federer,Sam Querrey,Roger Federer,6-4; 6-4; 6-3,R128,95,5,1,53,79,42,53,14,26,1,2,14,56,79,6,4,41,92,26,41,28,51,7,12,15,54,92
2008-05-25 00:00:00.000,Roland Garros France Grand Slams,CLAY,3,Albert Montanes,Kristof Vliegen,Albert Montanes,7-6(5); 7-6(2); 7-6(3),R128,147,6,2,72,112,61,72,20,40,4,7,18,81,112,8,2,67,114,48,67,24,47,0,3,18,72,114
2008-05-25 00:00:00.000,Roland Garros France Grand Slams,CLAY,3,David Marrero,Victor Crivoi,David Marrero,6-3; 6-3; 5-7; 6-4,R128,153,5,1,81,118,55,81,30,37,5,7,20,85,118,14,3,86,114,57,86,16,28,10,15,20,73,114
2008-05-25 00:00:00.000,Roland Garros France Grand Slams,CLAY,3,Mario Ancic,Andreas Seppi,Mario Ancic,6-2; 7-6(1); 6-2,R128,137,9,1,56,83,41,56,17,27,6,8,14,58,83,4,4,72,103,38,72,14,31,7,13,14,52,103
2008-05-25 00:00:00.000,Roland Garros France Grand Slams,CLAY,3,Alejandro Falla,Ivo Karlovic,Alejandro Falla,3-6; 7-6(4); 7-6(6); 5-7; 6-4,R128,216,9,2,122,174,90,122,31,52,8,11,27,121,174,35,5,103,163,82,103,37,60,3,5,28,119,163
2008-05-25 00:00:00.000,Roland Garros France Grand Slams,CLAY,3,Julien Benneteau,Vincent Spadea,Julien Benneteau,6-4; 6-4; 3-6; 3-6; 6-3,R128,191,5,9,71,126,49,71,28,55,4,10,23,77,126,9,4,101,166,66,101,30,65,9,16,24,96,166
2008-05-25 00:00:00.000,Roland Garros France Grand Slams,CLAY,3,Paul Capdeville,Mischa Zverev,Paul Capdeville,6-1; 6-4; 6-2,R128,80,3,2,61,82,45,61,11,21,9,10,13,56,82,2,2,42,64,28,42,5,22,2,8,12,33,64
2008-05-25 00:00:00.000,Roland Garros France Grand Slams,CLAY,3,Robin Soderling,Juan Monaco,Robin Soderling,6-2; 6-3; 6-1,R128,102,9,0,41,69,33,41,17,28,2,2,12,50,69,3,0,62,90,34,62,12,28,3,9,12,46,90
2008-05-25 00:00:00.000,Roland Garros France Grand Slams,CLAY,3,Stanislas Wawrinka,Philipp Kohlschreiber,Stanislas Wawrinka,6-3; 6-4; 6-3,R128,108,7,3,52,79,36,52,17,27,3,6,14,53,79,0,3,53,88,31,53,15,35,7,14,14,46,88
2008-05-25 00:00:00.000,Roland Garros France Grand Slams,CLAY,3,Marin Cilic,Robin Haase,Marin Cilic,7-6(6); 6-2; 7-6(4),R128,167,7,5,74,136,52,74,35,62,14,16,16,87,136,5,5,75,128,51,75,26,53,5,9,16,77,128
2008-05-25 00:00:00.000,Roland Garros France Grand Slams,CLAY,3,Pablo Andujar,Filippo Volandri,Pablo Andujar,6-7(6); 6-2; 6-3; 6-3,R128,195,1,1,98,129,61,98,16,31,8,13,19,77,129,1,9,131,179,69,131,20,48,24,34,19,89,179
2008-05-25 00:00:00.000,Roland Garros France Grand Slams,CLAY,3,Fernando Gonzalez,Pablo Cuevas,Fernando Gonzalez,6-3; 6-3; 6-1,R128,94,10,4,50,81,41,50,17,31,2,2,13,58,81,4,3,54,77,29,54,10,23,5,10,12,39,77
2008-05-25 00:00:00.000,Roland Garros France Grand Slams,CLAY,3,Igor Andreev,Potito Starace,Igor Andreev,6-1; 6-7(3); 6-1; 6-4,R128,140,14,1,76,101,59,76,14,25,1,3,19,73,101,4,1,76,117,42,76,23,41,8,15,17,65,117
2008-05-25 00:00:00.000,Roland Garros France Grand Slams,CLAY,3,Robby Ginepri,Donald Young,Robby Ginepri,6-2; 3-6; 7-6(4); 6-2,R128,148,12,2,75,111,56,75,21,36,2,4,18,77,111,1,7,76,137,45,76,34,61,9,14,19,79,137
2008-05-25 00:00:00.000,Roland Garros France Grand Slams,CLAY,3,Victor Hanescu,Dudi Sela,Victor Hanescu,4-6; 6-2; 4-6; 6-4; 6-3,R128,213,7,1,115,157,73,115,25,42,12,18,24,98,157,2,5,98,157,63,98,25,59,11,19,23,88,157
2008-05-25 00:00:00.000,Roland Garros France Grand Slams,CLAY,3,Florent Serra,Santiago Giraldo,Florent Serra,6-4; 6-3; 6-2,R128,94,3,1,45,70,35,45,21,25,1,2,14,56,70,4,0,42,82,24,42,22,40,3,8,13,46,82
2008-05-25 00:00:00.000,Roland Garros France Grand Slams,CLAY,3,Nikolay Davydenko,Thomas Johansson,Nikolay Davydenko,6-3; 6-3; 6-3,R128,106,9,2,53,73,44,53,12,20,1,1,13,56,73,6,0,45,81,35,45,13,36,5,10,14,48,81
2008-05-25 00:00:00.000,Roland Garros France Grand Slams,CLAY,3,Marat Safin,Jean-Rene Lisnard,Marat Safin,6-7(5); 6-1; 6-3; 6-2,R128,171,15,4,80,115,61,80,18,35,1,2,18,79,115,2,7,83,143,53,83,25,60,9,16,18,78,143
2008-05-25 00:00:00.000,Roland Garros France Grand Slams,CLAY,3,Diego Junqueira,Adrian Mannarino,Diego Junqueira,6-1; 6-2; 6-2,R128,84,2,1,42,63,36,42,14,21,0,0,12,50,63,2,4,39,62,19,39,11,23,2,8,11,30,62
2008-05-25 00:00:00.000,Roland Garros France Grand Slams,CLAY,3,Ivan Ljubicic,Eric Prodon,Ivan Ljubicic,7-5; 7-6(6); 7-6(4),R128,140,29,1,65,101,57,65,24,36,0,0,18,81,101,8,1,79,131,53,79,33,52,6,7,18,86,131
2008-05-25 00:00:00.000,Roland Garros France Grand Slams,CLAY,3,Marcos Daniel,Juan Carlos Ferrero,Marcos Daniel,6-7(5); 2-2 RET,R128,93,7,1,36,64,25,36,14,28,4,6,8,39,64,2,2,47,64,28,47,9,17,0,2,8,37,64
2008-05-25 00:00:00.000,Roland Garros France Grand Slams,CLAY,3,Jurgen Melzer,Peter Luczak,Jurgen Melzer,6-3; 6-2; 6-4,R128,113,12,1,48,83,37,48,22,35,1,2,14,59,83,1,4,51,96,29,51,24,45,6,11,13,53,96
2008-05-25 00:00:00.000,Roland Garros France Grand Slams,CLAY,3,Gael Monfils,Arnaud Clement,Gael Monfils,7-5; 6-3; 6-1,R128,110,12,7,41,75,32,41,15,34,0,4,14,47,75,1,1,47,88,26,47,13,41,6,15,14,39,88
2008-05-25 00:00:00.000,Roland Garros France Grand Slams,CLAY,3,Luis Horna,Scoville Jenkins,Luis Horna,6-4; 5-7; 6-3; 6-0,R128,166,2,2,73,97,55,73,11,24,2,5,18,66,97,9,7,77,129,48,77,22,52,15,23,19,70,129
2008-05-25 00:00:00.000,Roland Garros France Grand Slams,CLAY,3,Tommy Robredo,Guillermo Coria,Tommy Robredo,5-7; 6-4; 6-1; 6-4,R128,165,5,0,92,128,59,92,13,36,5,11,19,72,128,0,14,77,117,44,77,13,40,11,21,20,57,117
2008-05-25 00:00:00.000,Roland Garros France Grand Slams,CLAY,3,Marc Gicquel,Viktor Troicki,Marc Gicquel,6-4; 6-3; 4-6; 7-5,R128,186,2,4,76,131,51,76,29,55,14,19,20,80,131,7,2,62,119,39,62,31,57,4,12,21,70,119
2008-05-25 00:00:00.000,Roland Garros France Grand Slams,CLAY,3,Jiri Vanek,Jesse Huta Galung,Jiri Vanek,6-3; 7-5; 6-2,R128,125,8,1,77,103,52,77,15,26,3,4,15,67,103,9,1,48,90,31,48,22,42,10,15,14,53,90
2008-05-25 00:00:00.000,Roland Garros France Grand Slams,CLAY,3,Radek Stepanek,Gilles Simon,Radek Stepanek,6-2; 6-4; 6-1,R128,117,2,4,48,84,40,48,14,36,6,7,12,54,84,0,2,38,80,17,38,22,42,3,10,13,39,80
2008-05-25 00:00:00.000,Roland Garros France Grand Slams,CLAY,3,Lleyton Hewitt,Nicolas Mahut,Lleyton Hewitt,6-4; 6-2; 6-4,R128,121,7,4,51,83,40,51,19,32,2,3,14,59,83,6,3,60,88,36,60,14,28,5,10,14,50,88
2008-05-25 00:00:00.000,Roland Garros France Grand Slams,CLAY,3,Mardy Fish,Agustin Calleri,Mardy Fish,6-7(6); 6-4; 6-2; 6-4,R128,171,13,0,70,135,54,70,34,65,4,6,20,88,135,11,7,82,139,57,82,24,57,9,15,20,81,139
2008-05-25 00:00:00.000,Roland Garros France Grand Slams,CLAY,3,Fabrice Santoro,Evgeny Korolev,Fabrice Santoro,7-6(3); 6-1; 6-4,R128,124,10,2,48,96,40,48,24,48,6,8,14,64,96,2,6,53,93,31,53,19,40,5,11,15,50,93
2008-05-25 00:00:00.000,Roland Garros France Grand Slams,CLAY,3,David Ferrer,Steve Darcis,David Ferrer,6-3; 6-4; 6-3,R128,134,2,1,67,95,45,67,17,28,6,7,14,62,95,3,1,60,106,40,60,19,46,5,10,14,59,106
2008-05-25 00:00:00.000,Roland Garros France Grand Slams,CLAY,3,James Blake,Rainer Schuettler,James Blake,6-4; 6-1; 7-6(3),R128,112,10,2,59,96,43,59,22,37,3,5,15,65,96,6,5,60,102,35,60,21,42,8,13,14,56,102
2008-05-25 00:00:00.000,Roland Garros France Grand Slams,CLAY,3,Ernests Gulbis,Simon Greul,Ernests Gulbis,6-4; 6-0; 6-4,R128,96,9,2,44,70,35,44,17,26,1,2,13,52,70,4,0,41,78,23,41,17,37,6,12,13,40,78
2008-05-25 00:00:00.000,Roland Garros France Grand Slams,CLAY,3,Bobby Reynolds,Thierry Ascione,Bobby Reynolds,7-6(2); 4-6; 6-3; 6-2,R128,172,20,3,81,131,62,81,24,50,2,4,20,86,131,4,3,73,119,53,73,20,46,2,6,19,73,119
2008-05-25 00:00:00.000,Roland Garros France Grand Slams,CLAY,3,Nicolas Lapentti,Janko Tipsarevic,Nicolas Lapentti,6-4; 4-6; 6-1; 7-6(7),R128,221,6,0,86,135,59,86,31,49,7,10,20,90,135,12,3,80,132,56,80,24,52,8,13,19,80,132
2008-05-25 00:00:00.000,Roland Garros France Grand Slams,CLAY,3,Simone Bolelli,Marcos Baghdatis,Simone Bolelli,6-2; 6-4; 6-2,R128,130,2,0,46,71,34,46,17,25,1,2,13,51,71,5,8,59,120,37,59,24,61,10,16,13,61,120
2008-05-25 00:00:00.000,Roland Garros France Grand Slams,CLAY,3,Juan Martin Del Potro,Josselin Ouanna,Juan Martin Del Potro,6-3; 6-2; 6-3,R128,121,8,3,46,82,41,46,18,36,5,5,13,59,82,5,2,39,86,29,39,17,47,4,9,13,46,86
2008-05-25 00:00:00.000,Roland Garros France Grand Slams,CLAY,3,Michael Llodra,Olivier Patience,Michael Llodra,3-6; 7-6(1); 6-3; 7-5,R128,157,21,6,82,122,65,82,24,40,4,5,20,89,122,6,6,104,149,72,104,24,45,4,7,22,96,149
2008-05-25 00:00:00.000,Roland Garros France Grand Slams,CLAY,3,Tomas Berdych,Robert Smeets,Tomas Berdych,6-1; 6-0; 6-0,R128,67,8,0,30,49,28,30,12,19,0,0,10,40,49,0,6,26,56,9,26,9,30,3,11,9,18,56
2008-05-25 00:00:00.000,Roland Garros France Grand Slams,CLAY,3,Eduardo Schwank,Carlos Moya,Eduardo Schwank,7-6(4); 6-2; 6-7(1); 4-6; 6-3,R128,238,5,3,91,155,64,91,51,64,7,8,26,115,155,10,2,98,164,71,98,39,66,4,7,25,110,164
2008-05-25 00:00:00.000,Roland Garros France Grand Slams,CLAY,3,Marcel Granollers,Michael Berrer,Marcel Granollers,6-3; 3-6; 6-2; 6-3,R128,154,5,5,77,119,53,77,23,42,9,12,18,76,119,5,2,77,99,47,77,13,22,4,10,17,60,99
2008-05-25 00:00:00.000,Roland Garros France Grand Slams,CLAY,3,Oscar Hernandez,Ivo Minar,Oscar Hernandez,4-6; 7-6(5); 6-3; 7-5,R128,218,4,2,98,150,62,98,31,52,1,5,22,93,150,6,2,84,129,59,84,20,45,2,7,21,79,129
2008-05-25 00:00:00.000,Roland Garros France Grand Slams,CLAY,3,Paul-Henri Mathieu,Gustavo Kuerten,Paul-Henri Mathieu,6-3; 6-4; 6-2,R128,109,6,1,48,76,40,48,17,28,2,3,14,57,76,9,2,47,89,32,47,18,42,6,11,13,50,89
2008-05-25 00:00:00.000,Roland Garros France Grand Slams,CLAY,3,Wayne Odesnik,Guillermo Canas,Wayne Odesnik,7-6(6); 7-6(3); 7-6(8),R128,227,5,1,99,146,67,99,27,47,9,11,18,94,146,10,3,65,132,49,65,35,67,7,9,18,84,132
2008-05-25 00:00:00.000,Roland Garros France Grand Slams,CLAY,3,Hyung-Taik Lee,Jonas Bjorkman,Hyung-Taik Lee,6-4; 6-4; 6-3,R128,129,4,3,57,91,44,57,17,34,5,6,14,61,91,3,2,76,104,51,76,7,28,8,13,15,58,104
2008-05-25 00:00:00.000,Roland Garros France Grand Slams,CLAY,3,Miguel Angel Lopez Jaen,Frank Dancevic,Miguel Angel Lopez Jaen,7-6(6); 3-6; 7-5; 7-6(2),R128,201,9,3,100,154,68,100,28,54,3,8,22,96,154,18,1,95,156,68,95,30,61,6,11,23,98,156
2008-05-25 00:00:00.000,Roland Garros France Grand Slams,CLAY,3,Novak Djokovic,Denis Gremelmayr,Novak Djokovic,4-6; 6-3; 7-5; 6-2,R128,149,5,3,75,112,50,75,22,37,3,7,20,72,112,3,5,46,100,30,46,29,54,5,12,19,59,100
2008-05-25 00:00:00.000,Roland Garros France Grand Slams,CLAY,3,David Nalbandian,Carlos Berlocq,David Nalbandian,6-2; 6-4; 6-1,R128,113,1,1,49,85,35,49,18,36,3,5,12,53,85,0,1,71,84,35,71,3,13,10,18,13,38,84
2008-05-25 00:00:00.000,Roland Garros France Grand Slams,CLAY,3,Jeremy Chardy,Frederico Gil,Jeremy Chardy,6-3; 6-2; 7-6(1),R128,107,9,3,55,78,46,55,13,23,2,4,15,59,78,2,3,64,99,43,64,12,35,8,13,14,55,99
2008-05-25 00:00:00.000,Roland Garros France Grand Slams,CLAY,3,Guillermo Garcia-Lopez,Sergio Roitman,Guillermo Garcia-Lopez,6-2; 6-4; 7-6(5),R128,132,3,3,66,103,43,66,23,37,6,9,15,66,103,1,1,53,84,32,53,17,31,3,9,15,49,84
2008-05-25 00:00:00.000,Roland Garros France Grand Slams,CLAY,3,Dmitry Tursunov,Daniel Brands,Dmitry Tursunov,6-2; 6-4; 7-5,R128,111,13,3,51,91,38,51,26,40,5,6,15,64,91,5,8,47,90,31,47,22,43,5,10,15,53,90
2008-05-25 00:00:00.000,Roland Garros France Grand Slams,CLAY,3,Nicolas Almagro,Boris Pashanski,Nicolas Almagro,6-4; 7-5; 6-1,R128,114,20,1,58,92,47,58,19,34,7,7,14,66,92,4,5,46,91,31,46,22,45,3,8,15,53,91
2008-05-25 00:00:00.000,Roland Garros France Grand Slams,CLAY,3,Sebastian Decoud,Olivier Rochus,Sebastian Decoud,3-6; 6-4; 6-3; 6-7(8); 6-1,R128,232,14,2,122,163,84,122,20,41,10,12,24,104,163,4,3,102,144,66,102,25,42,7,12,23,91,144
2008-05-25 00:00:00.000,Roland Garros France Grand Slams,CLAY,3,Jose Acasuso,Dominik Hrbaty,Jose Acasuso,6-4; 6-2; 6-4,R128,138,4,2,41,77,30,41,22,36,1,3,14,52,77,1,5,58,106,36,58,19,48,4,10,14,55,106
2008-05-25 00:00:00.000,Roland Garros France Grand Slams,CLAY,3,Andy Murray,Jonathan Eysseric,Andy Murray,6-2; 1-6; 4-6; 6-0; 6-2,R128,164,3,0,72,113,49,72,18,41,8,15,19,67,113,1,7,66,132,41,66,25,66,6,17,20,66,132
2008-05-25 00:00:00.000,Roland Garros France Grand Slams,CLAY,3,Mikhail Youzhny,Benjamin Becker,Mikhail Youzhny,6-1; 6-3; 7-6(4),R128,134,6,1,49,84,39,49,25,35,5,6,14,64,84,7,1,45,98,31,45,23,53,11,16,14,54,98
2008-05-25 00:00:00.000,Roland Garros France Grand Slams,CLAY,3,Maximo Gonzalez,Roko Karanusic,Maximo Gonzalez,6-3; 7-5; 4-6; 3-6; 6-2,R128,215,2,5,108,168,67,108,28,60,17,25,24,95,168,6,3,81,155,49,81,33,74,12,22,24,82,155
2008-05-25 00:00:00.000,Roland Garros France Grand Slams,CLAY,3,Juan Ignacio Chela,John Isner,Juan Ignacio Chela,2-6; 3-6; 7-5; 6-3; 6-4,R128,207,4,3,130,168,91,130,20,38,17,20,24,111,168,15,7,102,151,82,102,22,49,10,13,24,104,151
2008-05-25 00:00:00.000,Roland Garros France Grand Slams,CLAY,3,Fernando Verdasco,Santiago Ventura,Fernando Verdasco,4-6; 6-3; 6-4; 6-7(6); 6-1,R128,220,1,7,117,164,78,117,24,47,9,14,25,102,164,10,6,82,164,57,82,35,82,6,14,23,92,164
2008-05-25 00:00:00.000,Roland Garros France Grand Slams,CLAY,3,Jarkko Nieminen,Marc Lopez,Jarkko Nieminen,2-6; 6-3; 6-4; 6-3,R128,167,8,4,97,131,61,97,18,34,14,18,18,79,131,1,0,64,104,42,64,18,40,7,13,18,60,104
2008-05-25 00:00:00.000,Roland Garros France Grand Slams,CLAY,3,Martin Vassallo Arguello,Feliciano Lopez,Martin Vassallo Arguello,7-6(1); 6-4; 3-6; 4-6; 6-3,R128,214,7,5,128,171,82,128,27,43,10,13,25,109,171,13,5,97,150,69,97,31,53,7,10,25,100,150
2008-05-25 00:00:00.000,Roland Garros France Grand Slams,CLAY,3,Nicolas Devilder,Chris Guccione,Nicolas Devilder,6-4; 6-1; 6-4,R128,105,3,4,48,77,39,48,17,29,1,2,14,56,77,12,2,59,97,38,59,17,38,7,12,13,55,97
2008-05-25 00:00:00.000,Roland Garros France Grand Slams,CLAY,3,Rafael Nadal,Thomaz Bellucci,Rafael Nadal,7-5; 6-3; 6-1,R128,154,2,1,67,90,46,67,14,23,2,4,14,60,90,3,5,49,91,25,49,22,42,6,13,14,47,91
2008-05-25 00:00:00.000,Roland Garros France Grand Slams,CLAY,3,Roger Federer,Albert Montanes,Roger Federer,6-7(5); 6-1; 6-0; 6-4,R64,145,13,1,76,110,65,76,18,34,6,6,18,83,110,2,8,83,135,49,83,25,52,12,18,17,74,135
2008-05-25 00:00:00.000,Roland Garros France Grand Slams,CLAY,3,Mario Ancic,David Marrero,Mario Ancic,4-6; 6-0; 6-3; 6-2,R64,162,17,1,67,105,52,67,22,38,9,10,17,74,105,1,2,54,108,33,54,26,54,5,11,16,59,108
2008-05-25 00:00:00.000,Roland Garros France Grand Slams,CLAY,3,Julien Benneteau,Alejandro Falla,Julien Benneteau,1-6; 7-6(6); 6-3; 6-7(4); 6-0,R64,228,5,3,124,169,82,124,23,45,11,17,24,105,169,5,1,91,151,57,91,29,60,8,15,22,86,151
2008-05-25 00:00:00.000,Roland Garros France Grand Slams,CLAY,3,Robin Soderling,Paul Capdeville,Robin Soderling,6-3; 6-2; 6-4,R64,102,12,2,61,90,47,61,13,29,8,9,14,60,90,3,1,61,89,38,61,12,28,5,10,13,50,89
2008-05-25 00:00:00.000,Roland Garros France Grand Slams,CLAY,3,Stanislas Wawrinka,Marin Cilic,Stanislas Wawrinka,7-6(3); 7-6(4); 6-1,R64,164,3,1,62,103,43,62,26,41,2,6,16,69,103,6,6,49,107,36,49,23,58,6,12,15,59,107
2008-05-25 00:00:00.000,Roland Garros France Grand Slams,CLAY,3,Fernando Gonzalez,Pablo Andujar,Fernando Gonzalez,7-5; 6-0; 6-7(4); 7-6(3),R64,168,15,5,83,138,61,83,32,55,7,9,21,93,138,6,1,127,144,76,127,9,17,9,15,21,85,144
2008-05-25 00:00:00.000,Roland Garros France Grand Slams,CLAY,3,Robby Ginepri,Igor Andreev,Robby Ginepri,4-6; 6-2; 7-6(5); 6-2,R64,170,4,1,89,122,63,89,21,33,5,7,19,84,122,10,2,82,130,57,82,22,48,9,14,19,79,130
2008-05-25 00:00:00.000,Roland Garros France Grand Slams,CLAY,3,Florent Serra,Victor Hanescu,Florent Serra,6-4; 6-3; 6-7(5); 7-6(5),R64,181,4,4,79,139,60,79,33,60,8,13,22,93,139,11,2,115,155,79,115,12,40,11,18,21,91,155
2008-05-25 00:00:00.000,Roland Garros France Grand Slams,CLAY,3,Nikolay Davydenko,Marat Safin,Nikolay Davydenko,7-6(4); 6-2; 6-2,R64,136,9,2,60,85,45,60,15,25,3,4,14,60,85,6,2,60,110,41,60,18,50,8,13,14,59,110
2008-05-25 00:00:00.000,Roland Garros France Grand Slams,CLAY,3,Ivan Ljubicic,Diego Junqueira,Ivan Ljubicic,6-3; 6-4; 6-2,R64,107,13,2,49,81,43,49,16,32,3,3,14,59,81,2,3,40,79,29,40,19,39,8,12,13,48,79
2008-05-25 00:00:00.000,Roland Garros France Grand Slams,CLAY,3,Jurgen Melzer,Marcos Daniel,Jurgen Melzer,4-6; 6-3; 2-6; 6-3; 6-4,R64,194,9,4,87,134,66,87,25,47,9,12,23,91,134,6,1,109,155,76,109,24,46,13,17,23,100,155
2008-05-25 00:00:00.000,Roland Garros France Grand Slams,CLAY,3,Gael Monfils,Luis Horna,Gael Monfils,7-6(5); 6-4; 7-5,R64,179,5,15,59,120,45,59,30,61,5,8,17,75,120,0,4,84,113,52,84,14,29,5,10,17,66,113
2008-05-25 00:00:00.000,Roland Garros France Grand Slams,CLAY,3,Tommy Robredo,Marc Gicquel,Tommy Robredo,6-7(7); 6-4; 6-4; 6-4,R64,225,2,0,110,147,74,110,23,37,4,7,21,97,147,5,4,86,164,62,86,36,78,18,24,21,98,164
2008-05-25 00:00:00.000,Roland Garros France Grand Slams,CLAY,3,Radek Stepanek,Jiri Vanek,Radek Stepanek,6-1; 6-0; 6-7(7); 6-3,R64,143,11,2,65,102,52,65,20,37,2,2,16,72,102,8,4,72,128,51,72,20,56,11,19,18,71,128
2008-05-25 00:00:00.000,Roland Garros France Grand Slams,CLAY,3,Lleyton Hewitt,Mardy Fish,Lleyton Hewitt,6-4; 6-3; 6-2,R64,126,8,1,38,72,25,38,19,34,3,7,13,44,72,6,7,39,102,24,39,23,63,11,20,14,47,102
2008-05-25 00:00:00.000,Roland Garros France Grand Slams,CLAY,3,David Ferrer,Fabrice Santoro,David Ferrer,6-0; 6-1; 6-0,R64,84,2,0,49,54,39,49,4,5,2,2,10,43,54,0,1,37,67,16,37,9,30,4,12,9,25,67
2008-05-25 00:00:00.000,Roland Garros France Grand Slams,CLAY,3,Ernests Gulbis,James Blake,Ernests Gulbis,7-6(2); 3-6; 7-5; 6-3,R64,156,11,4,77,124,59,77,30,47,5,7,21,89,124,4,0,88,144,57,88,34,56,7,10,21,91,144
2008-05-25 00:00:00.000,Roland Garros France Grand Slams,CLAY,3,Nicolas Lapentti,Bobby Reynolds,Nicolas Lapentti,7-5; 6-4; 5-7; 7-5,R64,221,10,4,95,146,70,95,26,51,6,9,23,96,146,6,8,90,149,63,90,29,59,6,11,23,92,149
2008-05-25 00:00:00.000,Roland Garros France Grand Slams,CLAY,3,Simone Bolelli,Juan Martin Del Potro,Simone Bolelli,3-6; 7-6(0); 7-5; 6-2,R64,190,7,3,92,134,65,92,24,42,12,15,20,89,134,12,3,66,117,48,66,27,51,3,8,21,75,117
2008-05-25 00:00:00.000,Roland Garros France Grand Slams,CLAY,3,Michael Llodra,Tomas Berdych,Michael Llodra,6-3; 4-6; 5-7; 6-3; 6-4,R64,186,10,6,94,157,72,94,29,63,10,13,25,101,157,12,4,78,120,66,78,21,42,5,10,25,87,120
2008-05-25 00:00:00.000,Roland Garros France Grand Slams,CLAY,3,Eduardo Schwank,Marcel Granollers,Eduardo Schwank,6-7(5); 6-2; 6-4; 6-4,R64,193,5,2,89,130,67,89,29,41,5,5,20,96,130,5,0,102,142,65,102,24,40,9,13,20,89,142
2008-05-25 00:00:00.000,Roland Garros France Grand Slams,CLAY,3,Paul-Henri Mathieu,Oscar Hernandez,Paul-Henri Mathieu,2-6; 1-6; 6-4; 6-3; 6-2,R64,251,4,8,86,147,58,86,28,61,16,22,21,86,147,4,4,96,157,58,96,29,61,14,20,21,87,157
2008-05-25 00:00:00.000,Roland Garros France Grand Slams,CLAY,3,Wayne Odesnik,Hyung-Taik Lee,Wayne Odesnik,6-2; 4-6; 6-3; 6-2,R64,140,11,1,74,118,58,74,22,44,4,5,18,80,118,4,2,76,109,49,76,15,33,8,13,17,64,109
2008-05-25 00:00:00.000,Roland Garros France Grand Slams,CLAY,3,Novak Djokovic,Miguel Angel Lopez Jaen,Novak Djokovic,6-1; 6-1; 6-3,R64,80,3,2,45,68,36,45,15,23,0,0,12,51,68,6,2,46,69,26,46,6,23,4,10,11,32,69
2008-05-25 00:00:00.000,Roland Garros France Grand Slams,CLAY,3,Jeremy Chardy,David Nalbandian,Jeremy Chardy,3-6; 4-6; 6-2; 6-1; 6-2,R64,183,18,10,88,161,62,88,34,73,10,14,21,96,161,10,4,72,131,48,72,27,59,10,18,21,75,131
2008-05-25 00:00:00.000,Roland Garros France Grand Slams,CLAY,3,Dmitry Tursunov,Guillermo Garcia-Lopez,Dmitry Tursunov,7-6(4); 6-0; 6-0,R64,139,11,1,65,110,43,65,23,45,12,13,12,66,110,1,2,53,81,23,53,14,28,8,15,12,37,81
2008-05-25 00:00:00.000,Roland Garros France Grand Slams,CLAY,3,Nicolas Almagro,Sebastian Decoud,Nicolas Almagro,7-6(2); 6-2; 6-1,R64,118,18,2,33,71,30,33,26,38,0,1,13,56,71,3,3,59,95,39,59,14,36,7,13,14,53,95
2008-05-25 00:00:00.000,Roland Garros France Grand Slams,CLAY,3,Andy Murray,Jose Acasuso,Andy Murray,6-4; 6-0; 6-4,R64,98,9,0,56,84,45,56,15,28,6,6,13,60,84,0,9,44,83,34,44,12,39,3,8,13,46,83
2008-05-25 00:00:00.000,Roland Garros France Grand Slams,CLAY,3,Mikhail Youzhny,Maximo Gonzalez,Mikhail Youzhny,6-3; 6-2; 6-2,R64,108,3,2,52,83,38,52,22,31,3,3,13,60,83,0,0,52,90,30,52,18,38,7,12,12,48,90
2008-05-25 00:00:00.000,Roland Garros France Grand Slams,CLAY,3,Fernando Verdasco,Juan Ignacio Chela,Fernando Verdasco,7-5; 4-6; 6-3; 7-5,R64,206,5,10,102,148,65,102,18,46,12,20,22,83,148,2,3,107,151,53,107,25,44,14,24,21,78,151
2008-05-25 00:00:00.000,Roland Garros France Grand Slams,CLAY,3,Jarkko Nieminen,Martin Vassallo Arguello,Jarkko Nieminen,7-5; 6-1; 3-6; 7-6(2),R64,178,0,1,91,124,63,91,17,33,0,3,20,80,124,2,3,83,128,52,83,25,45,5,10,20,77,128
2008-05-25 00:00:00.000,Roland Garros France Grand Slams,CLAY,3,Rafael Nadal,Nicolas Devilder,Rafael Nadal,6-4; 6-0; 6-1,R64,114,1,1,51,74,35,51,15,23,7,8,12,50,74,1,3,52,69,25,52,5,17,2,9,11,30,69
2008-05-25 00:00:00.000,Roland Garros France Grand Slams,CLAY,3,Roger Federer,Mario Ancic,Roger Federer,6-3; 6-4; 6-2,R32,96,8,1,45,71,36,45,20,26,2,3,14,56,71,2,0,47,75,31,47,10,28,2,7,13,41,75
2008-05-25 00:00:00.000,Roland Garros France Grand Slams,CLAY,3,Julien Benneteau,Robin Soderling,Julien Benneteau,1-6; 7-6(6); 6-0; 6-1,R32,143,3,3,63,96,40,63,22,33,8,11,15,62,96,5,2,80,108,47,80,12,28,7,14,17,59,108
2008-05-25 00:00:00.000,Roland Garros France Grand Slams,CLAY,3,Fernando Gonzalez,Stanislas Wawrinka,Fernando Gonzalez,5-7; 2-6; 6-4; 6-4; 6-4,R32,199,5,2,100,141,77,100,19,41,8,12,25,96,141,9,1,102,153,76,102,27,51,10,14,25,103,153
2008-05-25 00:00:00.000,Roland Garros France Grand Slams,CLAY,3,Robby Ginepri,Florent Serra,Robby Ginepri,6-4; 6-4; 6-4,R32,104,3,0,56,86,42,56,20,30,6,7,15,62,86,2,2,67,95,47,67,11,28,7,11,15,58,95
2008-05-25 00:00:00.000,Roland Garros France Grand Slams,CLAY,3,Ivan Ljubicic,Nikolay Davydenko,Ivan Ljubicic,4-6; 2-6; 6-3; 6-2; 6-4,R32,193,15,2,88,149,62,88,31,61,7,11,23,93,149,8,2,80,110,55,80,20,30,0,5,22,75,110
2008-05-25 00:00:00.000,Roland Garros France Grand Slams,CLAY,3,Gael Monfils,Jurgen Melzer,Gael Monfils,4-6; 7-5; 4-6; 6-0; 6-2,R32,180,19,6,95,148,70,95,26,53,15,18,23,96,148,1,3,76,126,46,76,28,50,5,12,23,74,126
2008-05-25 00:00:00.000,Roland Garros France Grand Slams,CLAY,3,Radek Stepanek,Tommy Robredo,Radek Stepanek,6-3; 6-2; 6-1,R32,109,4,3,45,73,39,45,15,28,4,4,12,54,73,1,0,53,77,30,53,11,24,6,12,12,41,77
2008-05-25 00:00:00.000,Roland Garros France Grand Slams,CLAY,3,David Ferrer,Lleyton Hewitt,David Ferrer,6-2; 3-6; 3-6; 6-3; 6-4,R32,215,8,4,83,136,59,83,27,53,5,10,23,86,136,8,4,82,147,52,82,33,65,9,15,22,85,147
2008-05-25 00:00:00.000,Roland Garros France Grand Slams,CLAY,3,Ernests Gulbis,Nicolas Lapentti,Ernests Gulbis,6-3; 7-5; 6-2,R32,127,8,3,41,77,32,41,24,36,0,2,15,56,77,0,3,58,98,32,58,20,40,9,15,14,52,98
2008-05-25 00:00:00.000,Roland Garros France Grand Slams,CLAY,3,Michael Llodra,Simone Bolelli,Michael Llodra,7-6(2); 6-4; 7-6(5),R32,155,17,2,74,115,62,74,23,41,5,6,17,85,115,2,2,92,118,64,92,15,26,6,8,17,79,118
2008-05-25 00:00:00.000,Roland Garros France Grand Slams,CLAY,3,Paul-Henri Mathieu,Eduardo Schwank,Paul-Henri Mathieu,6-2; 6-3; 3-6; 7-6(9),R32,182,7,1,70,113,52,70,25,43,1,5,19,77,113,8,6,81,131,51,81,23,50,7,13,19,74,131
2008-05-25 00:00:00.000,Roland Garros France Grand Slams,CLAY,3,Novak Djokovic,Wayne Odesnik,Novak Djokovic,7-5; 6-4; 6-2,R32,137,10,0,59,85,42,59,15,26,3,6,15,57,85,10,3,62,119,37,62,24,57,5,12,15,61,119
2008-05-25 00:00:00.000,Roland Garros France Grand Slams,CLAY,3,Jeremy Chardy,Dmitry Tursunov,Jeremy Chardy,7-6(1); 6-3; 6-4,R32,124,8,3,63,98,49,63,20,35,1,2,16,69,98,11,3,56,103,44,56,17,47,3,6,15,61,103
2008-05-25 00:00:00.000,Roland Garros France Grand Slams,CLAY,3,Nicolas Almagro,Andy Murray,Nicolas Almagro,6-3; 6-7(3); 6-3; 7-5,R32,169,21,5,71,126,57,71,34,55,3,5,22,91,126,10,9,67,136,51,67,30,69,12,17,20,81,136
2008-05-25 00:00:00.000,Roland Garros France Grand Slams,CLAY,3,Fernando Verdasco,Mikhail Youzhny,Fernando Verdasco,7-6(5); 5-7; 7-5; 6-1,R32,204,3,4,110,131,72,110,11,21,3,9,22,83,131,8,6,70,132,47,70,25,62,3,11,21,72,132
2008-05-25 00:00:00.000,Roland Garros France Grand Slams,CLAY,3,Rafael Nadal,Jarkko Nieminen,Rafael Nadal,6-1; 6-3; 6-1,R32,118,3,1,55,78,40,55,11,23,7,8,12,51,78,0,0,49,74,26,49,5,25,6,13,11,31,74
2008-05-25 00:00:00.000,Roland Garros France Grand Slams,CLAY,3,Roger Federer,Julien Benneteau,Roger Federer,6-4; 7-5; 7-5,R16,146,6,3,52,98,40,52,26,46,7,10,17,66,98,5,1,74,118,38,74,28,44,10,16,17,66,118
2008-05-25 00:00:00.000,Roland Garros France Grand Slams,CLAY,3,Fernando Gonzalez,Robby Ginepri,Fernando Gonzalez,7-6(4); 6-3; 6-1,R16,113,10,1,64,88,44,64,16,24,4,6,14,60,88,2,2,61,99,31,61,20,38,8,14,14,51,99
2008-05-25 00:00:00.000,Roland Garros France Grand Slams,CLAY,3,Gael Monfils,Ivan Ljubicic,Gael Monfils,7-6(1); 4-6; 6-3; 6-2,R16,171,12,4,64,114,53,64,25,50,1,4,20,78,114,10,3,70,117,49,70,22,47,5,10,19,71,117
2008-05-25 00:00:00.000,Roland Garros France Grand Slams,CLAY,3,David Ferrer,Radek Stepanek,David Ferrer,4-6; 6-2; 1-6; 6-3; 6-3,R16,172,2,2,91,123,54,91,19,32,8,16,22,73,123,4,9,53,118,36,53,27,65,2,11,21,63,118
2008-05-25 00:00:00.000,Roland Garros France Grand Slams,CLAY,3,Ernests Gulbis,Michael Llodra,Ernests Gulbis,6-4; 7-6(4); 6-3,R16,129,11,2,55,95,44,55,26,40,3,4,16,70,95,2,6,62,102,40,62,20,40,7,10,15,60,102
2008-05-25 00:00:00.000,Roland Garros France Grand Slams,CLAY,3,Novak Djokovic,Paul-Henri Mathieu,Novak Djokovic,6-4; 6-3; 6-4,R16,140,14,1,54,77,45,54,11,23,7,8,14,56,77,8,4,63,111,45,63,18,48,7,12,15,63,111
2008-05-25 00:00:00.000,Roland Garros France Grand Slams,CLAY,3,Nicolas Almagro,Jeremy Chardy,Nicolas Almagro,7-6(0); 7-6(7); 7-5,R16,168,19,4,69,124,55,69,32,55,6,7,18,87,124,10,12,92,160,67,92,29,68,15,17,18,96,160
2008-05-25 00:00:00.000,Roland Garros France Grand Slams,CLAY,3,Rafael Nadal,Fernando Verdasco,Rafael Nadal,6-1; 6-0; 6-2,R16,114,1,1,44,69,30,44,15,25,3,5,11,45,69,1,6,47,70,20,47,7,23,6,15,10,27,70
2008-05-25 00:00:00.000,Roland Garros France Grand Slams,CLAY,3,Roger Federer,Fernando Gonzalez,Roger Federer,2-6; 6-2; 6-3; 6-4,Q,121,11,0,62,96,44,62,24,34,3,6,18,68,96,3,0,72,100,40,72,17,28,8,13,17,57,100
2008-05-25 00:00:00.000,Roland Garros France Grand Slams,CLAY,3,Gael Monfils,David Ferrer,Gael Monfils,6-3; 3-6; 6-3; 6-1,Q,147,10,5,55,100,44,55,24,45,5,7,17,68,100,1,1,67,104,40,67,20,37,7,13,17,60,104
2008-05-25 00:00:00.000,Roland Garros France Grand Slams,CLAY,3,Novak Djokovic,Ernests Gulbis,Novak Djokovic,7-5; 7-6(3); 7-5,Q,187,6,1,82,125,58,82,24,43,4,6,18,82,125,12,7,85,138,58,85,24,53,12,16,18,82,138
2008-05-25 00:00:00.000,Roland Garros France Grand Slams,CLAY,3,Rafael Nadal,Nicolas Almagro,Rafael Nadal,6-1; 6-1; 6-1,Q,104,1,1,44,65,36,44,11,21,5,5,10,47,65,3,3,25,65,13,25,14,40,5,13,11,27,65
2008-05-25 00:00:00.000,Roland Garros France Grand Slams,CLAY,3,Roger Federer,Gael Monfils,Roger Federer,6-2; 5-7; 6-3; 7-5,S,185,2,1,97,136,67,97,20,39,10,13,20,87,136,10,5,89,150,62,89,22,61,8,15,21,84,150
2008-05-25 00:00:00.000,Roland Garros France Grand Slams,CLAY,3,Rafael Nadal,Novak Djokovic,Rafael Nadal,6-4; 6-2; 7-6(3),S,169,0,0,71,98,47,71,19,27,4,6,15,66,98,2,1,54,100,31,54,27,46,9,14,15,58,100
2008-05-25 00:00:00.000,Roland Garros France Grand Slams,CLAY,3,Rafael Nadal,Roger Federer,Rafael Nadal,6-1; 6-3; 6-0,F,108,0,0,50,67,35,50,11,17,3,4,11,46,67,2,0,53,77,26,53,5,24,9,17,11,31,77
2008-06-09 00:00:00.000,Halle Germany ATP World Tour,GRASS,2,Roger Federer,Michael Berrer,Roger Federer,6-4; 6-2,R32,62,11,1,37,48,33,37,5,11,1,1,9,38,48,2,3,39,58,28,39,6,19,3,6,9,34,58
2008-06-09 00:00:00.000,Halle Germany ATP World Tour,GRASS,2,Jan Vacek,Scott Lipsky,Jan Vacek,3-6; 6-3; 6-2,R32,84,3,4,47,77,35,47,17,30,0,1,13,52,77,8,3,48,77,33,48,15,29,1,4,13,48,77
2008-06-09 00:00:00.000,Halle Germany ATP World Tour,GRASS,2,Fabrice Santoro,Rainer Schuettler,Fabrice Santoro,7-6(4); 6-4,R32,115,4,2,52,84,37,52,16,32,7,8,11,53,84,3,1,47,86,29,47,20,39,8,10,11,49,86
2008-06-09 00:00:00.000,Halle Germany ATP World Tour,GRASS,2,Marcos Baghdatis,Jan Hernych,Marcos Baghdatis,6-4; 7-5,R32,73,6,6,27,58,23,27,21,31,0,0,11,44,58,3,1,50,68,34,50,10,18,1,3,11,44,68
2008-06-09 00:00:00.000,Halle Germany ATP World Tour,GRASS,2,Mikhail Youzhny,Dmitry Tursunov,Mikhail Youzhny,6-3; 6-1,R32,68,3,0,29,52,22,29,15,23,3,3,8,37,52,3,2,36,53,24,36,4,17,5,9,8,28,53
2008-06-09 00:00:00.000,Halle Germany ATP World Tour,GRASS,2,Nicolas Kiefer,Robin Haase,Nicolas Kiefer,4-6; 6-3; 6-2,R32,96,11,3,46,76,40,46,18,30,3,4,14,58,76,7,2,36,74,29,36,19,38,2,5,13,48,74
2008-06-09 00:00:00.000,Halle Germany ATP World Tour,GRASS,2,Steve Darcis,Olivier Rochus,Steve Darcis,6-1; 6-4,R32,53,6,1,31,56,24,31,16,25,1,1,9,40,56,1,0,28,45,15,28,10,17,2,5,8,25,45
2008-06-09 00:00:00.000,Halle Germany ATP World Tour,GRASS,2,Michael Llodra,Ivan Ljubicic,Michael Llodra,6-7(6); 7-6(5); 7-5,R32,152,20,7,81,126,65,81,23,45,8,8,18,88,126,19,3,73,112,61,73,19,39,3,4,18,80,112
2008-06-09 00:00:00.000,Halle Germany ATP World Tour,GRASS,2,Tommy Haas,Radek Stepanek,Tommy Haas,6-7(0); 7-6(3); 6-4,R32,138,19,3,78,112,60,78,18,34,4,4,17,78,112,12,4,66,100,54,66,19,34,1,2,17,73,100
2008-06-09 00:00:00.000,Halle Germany ATP World Tour,GRASS,2,Philipp Kohlschreiber,Julien Benneteau,Philipp Kohlschreiber,6-4; 6-1,R32,69,6,2,30,52,26,30,12,22,2,2,9,38,52,6,4,38,51,24,38,4,13,3,6,8,28,51
2008-06-09 00:00:00.000,Halle Germany ATP World Tour,GRASS,2,Robin Soderling,Philipp Petzschner,Robin Soderling,6-4; 4-6; 6-4,R32,110,11,3,62,88,47,62,12,26,3,5,15,59,88,10,10,52,101,40,52,23,49,3,6,15,63,101
2008-06-09 00:00:00.000,Halle Germany ATP World Tour,GRASS,2,Tomas Berdych,Thomas Johansson,Tomas Berdych,6-3; 7-5,R32,78,9,1,36,60,31,36,12,24,2,3,11,43,60,11,3,36,70,27,36,14,34,8,11,10,41,70
2008-06-09 00:00:00.000,Halle Germany ATP World Tour,GRASS,2,Mischa Zverev,Jarkko Nieminen,Mischa Zverev,2-6; 6-4; 6-2,R32,80,4,0,62,85,41,62,17,23,10,12,13,58,85,3,2,47,70,31,47,15,23,2,5,13,46,70
2008-06-09 00:00:00.000,Halle Germany ATP World Tour,GRASS,2,Andreas Beck,Marc Gicquel,Andreas Beck,6-7(4); 7-6(4); 6-3,R32,154,14,11,79,127,57,79,26,48,3,4,17,83,127,19,2,66,105,53,66,21,39,3,5,16,74,105
2008-06-09 00:00:00.000,Halle Germany ATP World Tour,GRASS,2,Benjamin Becker,Denis Gremelmayr,Benjamin Becker,6-4; 6-2,R32,68,8,3,28,52,26,28,13,24,1,1,9,39,52,7,5,38,67,25,38,12,29,5,8,9,37,67
2008-06-09 00:00:00.000,Halle Germany ATP World Tour,GRASS,2,James Blake,Bjorn Phau,James Blake,6-4; 6-1,R32,50,8,2,25,41,21,25,12,16,0,0,8,33,41,2,2,18,47,10,18,15,29,0,4,9,25,47
2008-06-09 00:00:00.000,Halle Germany ATP World Tour,GRASS,2,Roger Federer,Jan Vacek,Roger Federer,7-5; 6-3,R16,70,5,0,43,56,35,43,9,13,0,0,11,44,56,2,3,39,70,29,39,14,31,5,7,10,43,70
2008-06-09 00:00:00.000,Halle Germany ATP World Tour,GRASS,2,Marcos Baghdatis,Fabrice Santoro,Marcos Baghdatis,6-4; 6-3,R16,73,8,3,31,55,26,31,11,24,1,3,10,37,55,0,2,38,58,25,38,7,20,1,5,9,32,58
2008-06-09 00:00:00.000,Halle Germany ATP World Tour,GRASS,2,Nicolas Kiefer,Mikhail Youzhny,Nicolas Kiefer,6-2; 5-7; 6-3,R16,136,7,2,55,85,39,55,17,30,4,7,15,56,85,4,2,63,89,34,63,15,26,2,7,14,49,89
2008-06-09 00:00:00.000,Halle Germany ATP World Tour,GRASS,2,Michael Llodra,Steve Darcis,Michael Llodra,7-6(6); 7-6(3),R16,101,9,0,47,74,39,47,21,27,0,0,12,60,74,2,0,70,105,43,70,23,35,3,3,12,66,105
2008-06-09 00:00:00.000,Halle Germany ATP World Tour,GRASS,2,Philipp Kohlschreiber,Tommy Haas,Philipp Kohlschreiber,7-5; 5-7; 7-6(5),R16,148,7,3,64,103,48,64,28,39,4,6,18,76,103,13,8,64,111,49,64,27,47,3,5,18,76,111
2008-06-09 00:00:00.000,Halle Germany ATP World Tour,GRASS,2,Robin Soderling,Tomas Berdych,Robin Soderling,6-2; 7-5,R16,64,13,0,32,49,28,32,12,17,0,0,10,40,49,8,0,41,63,26,41,10,22,2,5,10,36,63
2008-06-09 00:00:00.000,Halle Germany ATP World Tour,GRASS,2,Andreas Beck,Mischa Zverev,Andreas Beck,6-7(5); 7-6(5); 6-1,R16,114,9,5,70,101,55,70,17,31,7,8,16,72,101,16,2,63,93,48,63,14,30,1,4,15,62,93
2008-06-09 00:00:00.000,Halle Germany ATP World Tour,GRASS,2,James Blake,Benjamin Becker,James Blake,4-6; 7-5; 6-3,R16,113,12,2,50,83,39,50,21,33,2,4,16,60,83,11,8,59,104,47,59,18,45,9,12,15,65,104
2008-06-09 00:00:00.000,Halle Germany ATP World Tour,GRASS,2,Roger Federer,Marcos Baghdatis,Roger Federer,6-4; 6-4,Q,72,0,0,45,58,33,45,10,13,4,4,10,43,58,4,3,32,61,26,32,13,29,2,4,10,39,61
2008-06-09 00:00:00.000,Halle Germany ATP World Tour,GRASS,2,Nicolas Kiefer,Michael Llodra,Nicolas Kiefer,4-0 RET,Q,20,2,1,7,11,5,7,3,4,0,0,2,8,11,0,2,2,8,0,2,0,6,0,2,2,0,8
2008-06-09 00:00:00.000,Halle Germany ATP World Tour,GRASS,2,Philipp Kohlschreiber,Robin Soderling,Philipp Kohlschreiber,6-4; 7-6(4),Q,91,12,3,46,71,35,46,16,25,3,3,11,51,71,8,0,45,77,32,45,19,32,3,4,11,51,77
2008-06-09 00:00:00.000,Halle Germany ATP World Tour,GRASS,2,James Blake,Andreas Beck,James Blake,7-6(4); 7-6(5),Q,105,13,3,48,77,39,48,16,29,2,4,12,55,77,9,6,78,105,52,78,15,27,10,12,12,67,105
2008-06-09 00:00:00.000,Halle Germany ATP World Tour,GRASS,2,Roger Federer,Nicolas Kiefer,Roger Federer,6-1; 6-4,S,65,7,1,37,59,27,37,13,22,4,4,9,40,59,4,3,18,40,15,18,9,22,0,3,8,24,40
2008-06-09 00:00:00.000,Halle Germany ATP World Tour,GRASS,2,Philipp Kohlschreiber,James Blake,Philipp Kohlschreiber,6-3; 7-5,S,72,7,1,34,57,23,34,16,23,3,4,10,39,57,5,2,35,64,24,35,13,29,2,6,11,37,64
2008-06-09 00:00:00.000,Halle Germany ATP World Tour,GRASS,2,Roger Federer,Philipp Kohlschreiber,Roger Federer,6-3; 6-4,F,74,6,0,36,51,31,36,10,15,2,2,10,41,51,6,2,40,65,28,40,12,25,2,4,9,40,65
2008-06-09 00:00:00.000,London / Queen's Club Great Britain ATP World Tour,GRASS,2,Rafael Nadal,N/A Bye,Rafael Nadal,,R64,0,0,0,0,0,0,0,0,0,0,0,0,0,0,0,0,0,0,0,0,0,0,0,0,0,0,0
2008-06-09 00:00:00.000,London / Queen's Club Great Britain ATP World Tour,GRASS,2,Jonas Bjorkman,Igor Kunitsyn,Jonas Bjorkman,7-6(3); 4-6; 6-4,R64,146,2,5,56,107,40,56,26,51,5,10,16,66,107,6,2,67,113,41,67,24,46,5,10,16,65,113
2008-06-09 00:00:00.000,London / Queen's Club Great Britain ATP World Tour,GRASS,2,Kei Nishikori,Alejandro Falla,Kei Nishikori,2-6; 6-4; 6-2,R64,102,3,2,48,78,37,48,16,30,4,6,13,53,78,7,2,41,80,31,41,19,39,5,8,13,50,80
2008-06-09 00:00:00.000,London / Queen's Club Great Britain ATP World Tour,GRASS,2,Olivier Patience,Sam Querrey,Olivier Patience,7-5; 5-7; 6-4,R64,123,4,5,62,100,47,62,16,38,5,9,17,63,100,14,4,69,115,50,69,17,46,7,12,17,67,115
2008-06-09 00:00:00.000,London / Queen's Club Great Britain ATP World Tour,GRASS,2,Fernando Gonzalez,Richard Bloomfield,Fernando Gonzalez,7-6(5); 6-3,R64,92,9,2,42,64,35,42,14,22,0,0,11,49,64,8,9,48,81,33,48,20,33,5,6,10,53,81
2008-06-09 00:00:00.000,London / Queen's Club Great Britain ATP World Tour,GRASS,2,Marat Safin,James Ward,Marat Safin,4-6; 6-1; 6-4,R64,112,6,1,52,92,42,52,20,40,5,6,14,62,92,3,6,40,81,25,40,24,41,3,6,13,49,81
2008-06-09 00:00:00.000,London / Queen's Club Great Britain ATP World Tour,GRASS,2,Joseph Sirianni,Alex Bogdanovic,Joseph Sirianni,6-3; 6-3,R64,82,3,2,42,72,35,42,12,30,6,6,9,47,72,3,3,32,61,21,32,13,29,5,8,9,34,61
2008-06-09 00:00:00.000,London / Queen's Club Great Britain ATP World Tour,GRASS,2,Ivo Karlovic,N/A Bye,Ivo Karlovic,,R64,0,0,0,0,0,0,0,0,0,0,0,0,0,0,0,0,0,0,0,0,0,0,0,0,0,0,0
2008-06-09 00:00:00.000,London / Queen's Club Great Britain ATP World Tour,GRASS,2,Andy Roddick,N/A Bye,Andy Roddick,,R64,0,0,0,0,0,0,0,0,0,0,0,0,0,0,0,0,0,0,0,0,0,0,0,0,0,0,0
2008-06-09 00:00:00.000,London / Queen's Club Great Britain ATP World Tour,GRASS,2,Robby Ginepri,Vincent Spadea,Robby Ginepri,6-4; 7-6(4),R64,77,13,1,47,65,40,47,10,18,1,1,11,50,65,9,2,48,76,38,48,12,28,4,5,11,50,76
2008-06-09 00:00:00.000,London / Queen's Club Great Britain ATP World Tour,GRASS,2,Chris Guccione,Yen-Hsun Lu,Chris Guccione,6-4; 6-7(2); 7-5,R64,134,19,2,75,105,60,75,16,30,4,4,17,76,105,13,5,66,108,50,66,25,42,5,7,17,75,108
2008-06-09 00:00:00.000,London / Queen's Club Great Britain ATP World Tour,GRASS,2,Mardy Fish,Edouard Roger-Vasselin,Mardy Fish,6-1; 6-4,R64,54,12,2,29,39,25,29,7,10,0,0,8,32,39,2,1,38,59,22,38,8,21,4,8,9,30,59
2008-06-09 00:00:00.000,London / Queen's Club Great Britain ATP World Tour,GRASS,2,Andreas Seppi,Arnaud Clement,Andreas Seppi,6-3; 4-6; 6-1,R64,106,6,4,49,74,37,49,13,25,3,5,13,50,74,7,4,49,88,31,49,18,39,9,14,13,49,88
2008-06-09 00:00:00.000,London / Queen's Club Great Britain ATP World Tour,GRASS,2,Ernests Gulbis,Kristof Vliegen,Ernests Gulbis,6-4; 7-5,R64,85,5,2,46,68,35,46,13,22,0,0,11,48,68,6,1,38,69,28,38,16,31,2,4,11,44,69
2008-06-09 00:00:00.000,London / Queen's Club Great Britain ATP World Tour,GRASS,2,Sebastien Grosjean,Rik De Voest,Sebastien Grosjean,7-6(6); 6-1,R64,90,2,2,37,70,25,37,16,33,5,7,9,41,70,1,3,38,67,24,38,10,29,4,9,10,34,67
2008-06-09 00:00:00.000,London / Queen's Club Great Britain ATP World Tour,GRASS,2,Andy Murray,N/A Bye,Andy Murray,,R64,0,0,0,0,0,0,0,0,0,0,0,0,0,0,0,0,0,0,0,0,0,0,0,0,0,0,0
2008-06-09 00:00:00.000,London / Queen's Club Great Britain ATP World Tour,GRASS,2,Richard Gasquet,N/A Bye,Richard Gasquet,,R64,0,0,0,0,0,0,0,0,0,0,0,0,0,0,0,0,0,0,0,0,0,0,0,0,0,0,0
2008-06-09 00:00:00.000,London / Queen's Club Great Britain ATP World Tour,GRASS,2,Simone Bolelli,Frank Dancevic,Simone Bolelli,2-2 RET,R64,28,1,0,7,10,5,7,3,3,0,0,2,8,10,2,0,15,25,11,15,5,10,2,2,2,16,25
2008-06-09 00:00:00.000,London / Queen's Club Great Britain ATP World Tour,GRASS,2,Mario Ancic,Nicolas Lapentti,Mario Ancic,7-5; 6-3,R64,91,17,2,47,67,34,47,13,20,0,1,11,47,67,0,5,41,67,30,41,7,26,7,10,10,37,67
2008-06-09 00:00:00.000,London / Queen's Club Great Britain ATP World Tour,GRASS,2,Fernando Verdasco,Hyung-Taik Lee,Fernando Verdasco,5-3 RET,R64,35,4,2,20,26,14,20,4,6,5,5,4,18,26,2,0,17,24,13,17,2,7,2,3,4,15,24
2008-06-09 00:00:00.000,London / Queen's Club Great Britain ATP World Tour,GRASS,2,Nicolas Mahut,Feliciano Lopez,Nicolas Mahut,6-3; 6-7(4); 7-6(4),R64,142,27,5,83,119,68,83,16,36,3,3,17,84,119,19,6,71,106,54,71,18,35,3,4,16,72,106
2008-06-09 00:00:00.000,London / Queen's Club Great Britain ATP World Tour,GRASS,2,John Isner,Kevin Anderson,John Isner,7-6(5); 6-4,R64,73,11,1,52,64,40,52,9,12,0,0,11,49,64,9,2,49,67,38,49,11,18,2,3,11,49,67
2008-06-09 00:00:00.000,London / Queen's Club Great Britain ATP World Tour,GRASS,2,Viktor Troicki,Dudi Sela,Viktor Troicki,6-4; 6-4,R64,79,3,0,39,58,27,39,12,19,3,5,10,39,58,1,2,41,60,27,41,7,19,3,7,10,34,60
2008-06-09 00:00:00.000,London / Queen's Club Great Britain ATP World Tour,GRASS,2,David Nalbandian,N/A Bye,David Nalbandian,,R64,0,0,0,0,0,0,0,0,0,0,0,0,0,0,0,0,0,0,0,0,0,0,0,0,0,0,0
2008-06-09 00:00:00.000,London / Queen's Club Great Britain ATP World Tour,GRASS,2,Paul-Henri Mathieu,N/A Bye,Paul-Henri Mathieu,,R64,0,0,0,0,0,0,0,0,0,0,0,0,0,0,0,0,0,0,0,0,0,0,0,0,0,0,0
2008-06-09 00:00:00.000,London / Queen's Club Great Britain ATP World Tour,GRASS,2,Marin Cilic,Jurgen Melzer,Marin Cilic,7-6(2); 7-6(5),R64,96,9,3,53,84,43,53,19,31,4,5,12,62,84,6,4,51,74,41,51,13,23,4,5,12,54,74
2008-06-09 00:00:00.000,London / Queen's Club Great Britain ATP World Tour,GRASS,2,Xavier Malisse,Daniel Evans,Xavier Malisse,6-1; 6-1,R64,50,4,0,18,33,17,18,11,15,0,0,7,28,33,1,4,29,49,14,29,7,20,2,7,7,21,49
2008-06-09 00:00:00.000,London / Queen's Club Great Britain ATP World Tour,GRASS,2,Lleyton Hewitt,Josh Goodall,Lleyton Hewitt,6-4; 6-4,R64,73,13,2,30,54,28,30,15,24,0,0,10,43,54,13,4,30,58,23,30,15,28,0,2,10,38,58
2008-06-09 00:00:00.000,London / Queen's Club Great Britain ATP World Tour,GRASS,2,Janko Tipsarevic,Ivan Navarro,Janko Tipsarevic,7-6(2); 6-4,R64,90,1,0,36,67,25,36,26,31,0,1,11,51,67,17,3,43,63,34,43,10,20,2,4,11,44,63
2008-06-09 00:00:00.000,London / Queen's Club Great Britain ATP World Tour,GRASS,2,Ivo Minar,Bobby Reynolds,Ivo Minar,6-1; 7-5,R64,70,12,1,45,69,33,45,12,24,5,6,10,45,69,9,3,29,57,23,29,7,28,4,8,9,30,57
2008-06-09 00:00:00.000,London / Queen's Club Great Britain ATP World Tour,GRASS,2,Roko Karanusic,Flavio Cipolla,Roko Karanusic,6-4; 6-3,R64,83,1,2,31,60,16,31,14,29,4,8,9,30,60,0,5,48,69,22,48,8,21,7,14,10,30,69
2008-06-09 00:00:00.000,London / Queen's Club Great Britain ATP World Tour,GRASS,2,Novak Djokovic,N/A Bye,Novak Djokovic,,R64,0,0,0,0,0,0,0,0,0,0,0,0,0,0,0,0,0,0,0,0,0,0,0,0,0,0,0
2008-06-09 00:00:00.000,London / Queen's Club Great Britain ATP World Tour,GRASS,2,Rafael Nadal,Jonas Bjorkman,Rafael Nadal,6-2; 6-2,R32,65,2,1,26,43,25,26,9,17,1,1,8,34,43,4,2,35,57,23,35,7,22,2,6,8,30,57
2008-06-09 00:00:00.000,London / Queen's Club Great Britain ATP World Tour,GRASS,2,Kei Nishikori,Olivier Patience,Kei Nishikori,7-6(8); 6-3,R32,95,4,2,37,70,26,37,19,33,0,2,11,45,70,0,1,51,78,27,51,16,27,4,7,10,43,78
2008-06-09 00:00:00.000,London / Queen's Club Great Britain ATP World Tour,GRASS,2,Fernando Gonzalez,Marat Safin,Fernando Gonzalez,6-3; 7-6(3),R32,67,6,0,40,59,33,40,12,19,0,0,10,45,59,7,1,43,61,31,43,10,18,1,3,11,41,61
2008-06-09 00:00:00.000,London / Queen's Club Great Britain ATP World Tour,GRASS,2,Ivo Karlovic,Joseph Sirianni,Ivo Karlovic,6-3; 6-2,R32,57,19,2,29,48,26,29,12,19,1,1,9,38,48,0,2,27,48,19,27,8,21,4,7,8,27,48
2008-06-09 00:00:00.000,London / Queen's Club Great Britain ATP World Tour,GRASS,2,Andy Roddick,Robby Ginepri,Andy Roddick,6-7(6); 6-1; 6-1,R32,85,15,1,47,72,41,47,14,25,0,0,13,55,72,4,2,51,78,36,51,10,27,4,9,13,46,78
2008-06-09 00:00:00.000,London / Queen's Club Great Britain ATP World Tour,GRASS,2,Mardy Fish,Chris Guccione,Mardy Fish,4-6; 7-6(0); 6-4,R32,116,16,4,38,91,32,38,34,53,0,1,16,66,91,15,2,70,99,53,70,16,29,1,2,16,69,99
2008-06-09 00:00:00.000,London / Queen's Club Great Britain ATP World Tour,GRASS,2,Ernests Gulbis,Andreas Seppi,Ernests Gulbis,6-3; 6-7(7); 6-3,R32,120,13,1,81,113,61,81,16,32,10,11,16,77,113,6,1,62,96,44,62,20,34,10,13,14,64,96
2008-06-09 00:00:00.000,London / Queen's Club Great Britain ATP World Tour,GRASS,2,Andy Murray,Sebastien Grosjean,Andy Murray,2-0 RET,R32,15,3,0,6,8,3,6,2,2,1,1,1,5,8,1,1,10,14,6,10,0,4,3,4,1,6,14
2008-06-09 00:00:00.000,London / Queen's Club Great Britain ATP World Tour,GRASS,2,Richard Gasquet,Simone Bolelli,Richard Gasquet,6-3; 6-3,R32,66,4,0,37,56,26,37,12,19,2,3,9,38,56,3,0,33,52,20,33,8,19,6,10,9,28,52
2008-06-09 00:00:00.000,London / Queen's Club Great Britain ATP World Tour,GRASS,2,Mario Ancic,Fernando Verdasco,Mario Ancic,7-6(6); 6-4,R32,93,10,2,43,69,35,43,15,26,3,4,11,50,69,8,5,45,68,33,45,12,23,4,6,11,45,68
2008-06-09 00:00:00.000,London / Queen's Club Great Britain ATP World Tour,GRASS,2,Nicolas Mahut,John Isner,Nicolas Mahut,7-5; 6-4,R32,72,15,6,36,61,32,36,16,25,1,1,11,48,61,8,1,40,55,31,40,8,15,2,4,11,39,55
2008-06-09 00:00:00.000,London / Queen's Club Great Britain ATP World Tour,GRASS,2,David Nalbandian,Viktor Troicki,David Nalbandian,6-4; 7-6(4),R32,99,3,3,48,76,38,48,18,28,4,4,11,56,76,11,1,49,74,34,49,14,25,4,5,11,48,74
2008-06-09 00:00:00.000,London / Queen's Club Great Britain ATP World Tour,GRASS,2,Paul-Henri Mathieu,Marin Cilic,Paul-Henri Mathieu,6-3; 3-6; 6-4,R32,107,6,4,44,81,37,44,19,37,1,3,14,56,81,16,6,47,81,43,47,10,34,4,7,14,53,81
2008-06-09 00:00:00.000,London / Queen's Club Great Britain ATP World Tour,GRASS,2,Lleyton Hewitt,Xavier Malisse,Lleyton Hewitt,6-3; 6-2,R32,67,4,1,45,64,30,45,13,19,3,3,9,43,64,5,1,28,45,20,28,5,17,3,6,8,25,45
2008-06-09 00:00:00.000,London / Queen's Club Great Britain ATP World Tour,GRASS,2,Janko Tipsarevic,Ivo Minar,Janko Tipsarevic,3-6; 6-3; 6-4,R32,107,13,3,53,81,39,53,14,28,4,7,14,53,81,9,3,63,99,42,63,16,36,6,10,14,58,99
2008-06-09 00:00:00.000,London / Queen's Club Great Britain ATP World Tour,GRASS,2,Novak Djokovic,Roko Karanusic,Novak Djokovic,6-2; 7-6(7),R32,79,3,1,41,62,28,41,16,21,1,2,10,44,62,3,0,33,68,22,33,18,35,4,7,10,40,68
2008-06-09 00:00:00.000,London / Queen's Club Great Britain ATP World Tour,GRASS,2,Rafael Nadal,Kei Nishikori,Rafael Nadal,6-4; 3-6; 6-3,R16,124,9,2,62,93,46,62,17,31,5,6,14,63,93,5,5,57,88,43,57,15,31,2,4,14,58,88
2008-06-09 00:00:00.000,London / Queen's Club Great Britain ATP World Tour,GRASS,2,Ivo Karlovic,Fernando Gonzalez,Ivo Karlovic,6-3; 7-5,R16,56,10,0,38,48,35,38,9,10,0,0,11,44,48,3,3,38,56,28,38,7,18,0,2,10,35,56
2008-06-09 00:00:00.000,London / Queen's Club Great Britain ATP World Tour,GRASS,2,Andy Roddick,Mardy Fish,Andy Roddick,7-6(5) RET,R16,59,8,0,32,40,25,32,7,8,2,2,6,32,40,11,1,26,50,23,26,11,24,3,3,6,34,50
2008-06-09 00:00:00.000,London / Queen's Club Great Britain ATP World Tour,GRASS,2,Andy Murray,Ernests Gulbis,Andy Murray,5-7; 6-1; 6-4,R16,120,4,1,57,89,45,57,17,32,3,4,15,62,89,10,2,57,87,41,57,13,30,4,7,14,54,87
2008-06-09 00:00:00.000,London / Queen's Club Great Britain ATP World Tour,GRASS,2,Richard Gasquet,Mario Ancic,Richard Gasquet,7-6(5); 6-4,R16,98,6,0,47,76,35,47,20,29,1,1,11,55,76,10,5,43,79,32,43,21,36,9,10,11,53,79
2008-06-09 00:00:00.000,London / Queen's Club Great Britain ATP World Tour,GRASS,2,David Nalbandian,Nicolas Mahut,David Nalbandian,6-4; 6-1,R16,54,6,0,28,39,25,28,8,11,0,0,8,33,39,10,2,34,47,23,34,3,13,0,4,9,26,47
2008-06-09 00:00:00.000,London / Queen's Club Great Britain ATP World Tour,GRASS,2,Lleyton Hewitt,Paul-Henri Mathieu,Lleyton Hewitt,6-4; 6-4,R16,80,11,2,41,58,31,41,8,17,2,3,10,39,58,6,1,37,70,23,37,15,33,6,9,10,38,70
2008-06-09 00:00:00.000,London / Queen's Club Great Britain ATP World Tour,GRASS,2,Novak Djokovic,Janko Tipsarevic,Novak Djokovic,2-6; 6-1; 6-4,R16,103,15,4,60,87,47,60,10,27,5,8,13,57,87,8,0,51,73,33,51,10,22,3,7,12,43,73
2008-06-09 00:00:00.000,London / Queen's Club Great Britain ATP World Tour,GRASS,2,Rafael Nadal,Ivo Karlovic,Rafael Nadal,6-7(5); 7-6(5); 7-6(4),Q,144,6,3,80,113,65,80,25,33,0,0,18,90,113,35,1,80,108,69,80,19,28,2,2,18,88,108
2008-06-09 00:00:00.000,London / Queen's Club Great Britain ATP World Tour,GRASS,2,Andy Roddick,Andy Murray,Andy Roddick,W/O,Q,0,0,0,0,0,0,0,0,0,0,0,0,0,0,0,0,0,0,0,0,0,0,0,0,0,0,0
2008-06-09 00:00:00.000,London / Queen's Club Great Britain ATP World Tour,GRASS,2,David Nalbandian,Richard Gasquet,David Nalbandian,6-4; 3-6; 7-6(3),Q,114,6,4,64,88,52,64,12,24,1,2,15,64,88,15,1,55,96,40,55,25,41,0,1,16,65,96
2008-06-09 00:00:00.000,London / Queen's Club Great Britain ATP World Tour,GRASS,2,Novak Djokovic,Lleyton Hewitt,Novak Djokovic,6-2; 6-2,Q,72,13,2,48,62,34,48,7,14,3,3,8,41,62,4,2,33,57,22,33,8,24,2,6,8,30,57
2008-06-09 00:00:00.000,London / Queen's Club Great Britain ATP World Tour,GRASS,2,Rafael Nadal,Andy Roddick,Rafael Nadal,7-5; 6-4,S,87,7,0,45,61,35,45,12,16,4,4,11,47,61,14,3,46,71,34,46,13,25,5,7,11,47,71
2008-06-09 00:00:00.000,London / Queen's Club Great Britain ATP World Tour,GRASS,2,Novak Djokovic,David Nalbandian,Novak Djokovic,6-1; 6-0,S,48,5,1,20,32,17,20,7,12,0,0,6,24,32,1,5,24,44,12,24,5,20,4,10,7,17,44
2008-06-09 00:00:00.000,London / Queen's Club Great Britain ATP World Tour,GRASS,2,Rafael Nadal,Novak Djokovic,Rafael Nadal,7-6(6); 7-5,F,136,3,0,50,82,34,50,16,32,5,8,12,50,82,4,0,69,90,42,69,10,21,9,13,12,52,90
2008-06-09 00:00:00.000,Warsaw Poland ATP World Tour,CLAY,2,Nikolay Davydenko,Pablo Cuevas,Nikolay Davydenko,6-3; 6-2,R32,66,3,3,22,45,20,22,13,23,0,0,8,33,45,4,5,23,49,15,23,12,26,2,6,9,27,49
2008-06-09 00:00:00.000,Warsaw Poland ATP World Tour,CLAY,2,Jiri Vanek,Carlos Berlocq,Jiri Vanek,1-6; 6-2; 7-6(5),R32,167,4,1,58,95,40,58,14,37,9,13,13,54,95,3,3,70,106,45,70,16,36,8,12,14,61,106
2008-06-09 00:00:00.000,Warsaw Poland ATP World Tour,CLAY,2,Evgeny Korolev,Victor Hanescu,Evgeny Korolev,6-4; 6-2,R32,73,3,3,38,57,27,38,10,19,2,4,9,37,57,2,0,33,54,22,33,4,21,6,11,9,26,54
2008-06-09 00:00:00.000,Warsaw Poland ATP World Tour,CLAY,2,Potito Starace,Dawid Olejniczak,Potito Starace,6-2; 6-3,R32,68,2,0,36,44,25,36,6,8,1,2,8,31,44,2,5,32,55,20,32,8,23,6,11,9,28,55
2008-06-09 00:00:00.000,Warsaw Poland ATP World Tour,CLAY,2,Christophe Rochus,Gilles Simon,Christophe Rochus,6-1; 3-6; 6-3,R32,115,3,1,52,94,36,52,23,42,3,5,13,59,94,11,4,41,80,32,41,16,39,8,12,12,48,80
2008-06-09 00:00:00.000,Warsaw Poland ATP World Tour,CLAY,2,Fabio Fognini,Guillermo Garcia-Lopez,Fabio Fognini,7-5; 0-6; 6-4,R32,135,3,7,42,85,35,42,15,43,2,7,14,50,85,2,5,52,90,37,52,18,38,5,9,14,55,90
2008-06-09 00:00:00.000,Warsaw Poland ATP World Tour,CLAY,2,Santiago Ventura,Boris Pashanski,Santiago Ventura,6-4; 6-2,R32,92,4,1,31,68,24,31,19,37,7,8,9,43,68,1,2,36,57,21,36,8,21,4,8,9,29,57
2008-06-09 00:00:00.000,Warsaw Poland ATP World Tour,CLAY,2,Guillermo Canas,Luis Horna,Guillermo Canas,6-2; 6-7(5); 6-4,R32,141,6,2,58,102,40,58,29,44,5,6,15,69,102,5,7,52,83,35,52,17,31,2,6,15,52,83
2008-06-09 00:00:00.000,Warsaw Poland ATP World Tour,CLAY,2,Marcel Granollers,Michal Mertinak,Marcel Granollers,7-6(2); 6-4,R32,126,4,3,57,96,34,57,25,39,11,13,11,59,96,1,4,41,76,29,41,13,35,2,5,11,42,76
2008-06-09 00:00:00.000,Warsaw Poland ATP World Tour,CLAY,2,Marcos Daniel,Filippo Volandri,Marcos Daniel,6-3; 6-4,R32,79,5,3,28,52,23,28,17,24,0,0,10,40,52,3,2,54,68,34,54,7,14,8,10,9,41,68
2008-06-09 00:00:00.000,Warsaw Poland ATP World Tour,CLAY,2,Florent Serra,Guillermo Coria,Florent Serra,6-3 RET,R32,46,2,0,19,32,10,19,6,13,0,2,5,16,32,0,3,17,26,7,17,3,9,2,5,4,10,26
2008-06-09 00:00:00.000,Warsaw Poland ATP World Tour,CLAY,2,Juan Monaco,Jerzy Janowicz,Juan Monaco,6-4; 6-3,R32,75,5,3,30,50,26,30,12,20,3,4,9,38,50,8,1,38,72,26,38,13,34,3,7,10,39,72
2008-06-09 00:00:00.000,Warsaw Poland ATP World Tour,CLAY,2,Albert Montanes,David Skoch,Albert Montanes,7-6(4); 6-4,R32,76,7,4,30,60,24,30,20,30,2,4,11,44,60,3,1,57,79,35,57,12,22,2,5,11,47,79
2008-06-09 00:00:00.000,Warsaw Poland ATP World Tour,CLAY,2,Oscar Hernandez,Sergio Roitman,Oscar Hernandez,3-6; 6-4; 6-0,R32,107,1,2,63,83,44,63,8,20,3,6,13,52,83,3,2,40,76,26,40,15,36,5,10,12,41,76
2008-06-09 00:00:00.000,Warsaw Poland ATP World Tour,CLAY,2,Wayne Odesnik,Ricardas Berankis,Wayne Odesnik,6-4; 6-3,R32,84,3,3,39,59,29,39,10,20,5,6,9,39,59,3,4,35,65,23,35,11,30,3,7,10,34,65
2008-06-09 00:00:00.000,Warsaw Poland ATP World Tour,CLAY,2,Tommy Robredo,Michal Przysiezny,Tommy Robredo,7-5; 6-2,R32,90,4,1,39,56,31,39,12,17,1,1,10,43,56,5,1,44,72,28,44,13,28,6,9,10,41,72
2008-06-09 00:00:00.000,Warsaw Poland ATP World Tour,CLAY,2,Nikolay Davydenko,Jiri Vanek,Nikolay Davydenko,4-6; 7-5; 6-1,R16,132,6,2,49,86,38,49,19,37,1,4,15,57,86,5,4,64,108,39,64,18,44,14,19,14,57,108
2008-06-09 00:00:00.000,Warsaw Poland ATP World Tour,CLAY,2,Evgeny Korolev,Potito Starace,Evgeny Korolev,7-5; 4-0 RET,R16,72,3,2,21,42,19,21,15,21,2,2,8,34,42,1,1,42,58,26,42,5,16,4,7,8,31,58
2008-06-09 00:00:00.000,Warsaw Poland ATP World Tour,CLAY,2,Fabio Fognini,Christophe Rochus,Fabio Fognini,5-4 RET,R16,47,4,2,15,29,10,15,5,14,1,3,4,15,29,0,1,23,39,11,23,8,16,3,6,5,19,39
2008-06-09 00:00:00.000,Warsaw Poland ATP World Tour,CLAY,2,Guillermo Canas,Santiago Ventura,Guillermo Canas,6-2; 1-6; 6-3,R16,103,2,5,46,84,28,46,19,38,6,10,12,47,84,1,3,39,65,24,39,11,26,0,5,12,35,65
2008-06-09 00:00:00.000,Warsaw Poland ATP World Tour,CLAY,2,Marcel Granollers,Marcos Daniel,Marcel Granollers,6-2; 6-4,R16,82,2,3,26,51,19,26,16,25,3,4,9,35,51,2,2,41,62,24,41,9,21,5,9,9,33,62
2008-06-09 00:00:00.000,Warsaw Poland ATP World Tour,CLAY,2,Juan Monaco,Florent Serra,Juan Monaco,7-5; 6-3,R16,88,3,1,24,56,19,24,14,32,3,7,10,33,56,0,1,38,68,15,38,15,30,4,11,11,30,68
2008-06-09 00:00:00.000,Warsaw Poland ATP World Tour,CLAY,2,Oscar Hernandez,Albert Montanes,Oscar Hernandez,6-3; 6-2,R16,78,0,1,40,51,31,40,4,11,3,5,9,35,51,2,3,26,49,13,26,9,23,8,13,8,22,49
2008-06-09 00:00:00.000,Warsaw Poland ATP World Tour,CLAY,2,Tommy Robredo,Wayne Odesnik,Tommy Robredo,6-4; 1-1 RET,R16,60,1,1,24,38,15,24,7,14,0,2,6,22,38,2,2,17,43,8,17,11,26,5,8,6,19,43
2008-06-09 00:00:00.000,Warsaw Poland ATP World Tour,CLAY,2,Nikolay Davydenko,Evgeny Korolev,Nikolay Davydenko,6-4; 6-2,Q,97,2,0,27,53,20,27,17,26,3,4,9,37,53,1,7,43,73,25,43,13,30,6,10,9,38,73
2008-06-09 00:00:00.000,Warsaw Poland ATP World Tour,CLAY,2,Fabio Fognini,Guillermo Canas,Fabio Fognini,7-5; 7-5,Q,104,3,2,39,74,28,39,19,35,1,4,12,47,74,7,3,35,66,24,35,15,31,3,8,12,39,66
2008-06-09 00:00:00.000,Warsaw Poland ATP World Tour,CLAY,2,Juan Monaco,Marcel Granollers,Juan Monaco,6-4; 6-3,Q,94,2,1,30,51,19,30,8,21,3,7,9,27,51,2,3,34,74,20,34,13,40,7,14,10,33,74
2008-06-09 00:00:00.000,Warsaw Poland ATP World Tour,CLAY,2,Tommy Robredo,Oscar Hernandez,Tommy Robredo,4-6; 6-2; 6-2,Q,143,1,2,56,97,37,56,24,41,9,11,13,61,97,3,5,60,95,35,60,16,35,6,11,13,51,95
2008-06-09 00:00:00.000,Warsaw Poland ATP World Tour,CLAY,2,Nikolay Davydenko,Fabio Fognini,Nikolay Davydenko,6-2; 6-3,S,76,4,2,28,46,23,28,10,18,1,1,8,33,46,2,3,33,67,17,33,17,34,8,12,9,34,67
2008-06-09 00:00:00.000,Warsaw Poland ATP World Tour,CLAY,2,Tommy Robredo,Juan Monaco,Tommy Robredo,6-4; 6-4,S,90,1,1,52,69,36,52,9,17,10,11,10,45,69,0,2,35,55,20,35,12,20,0,3,10,32,55
2008-06-09 00:00:00.000,Warsaw Poland ATP World Tour,CLAY,2,Nikolay Davydenko,Tommy Robredo,Nikolay Davydenko,6-3; 6-3,F,95,3,2,44,68,29,44,13,24,6,7,9,42,68,2,1,42,60,25,42,7,18,3,7,9,32,60
2008-06-15 00:00:00.000,s-Hertogenbosch The Netherlands ATP World Tour,GRASS,2,David Ferrer,Jesse Huta Galung,David Ferrer,6-2; 6-3,R32,61,1,2,36,49,27,36,8,13,1,1,8,35,49,3,3,29,50,16,29,11,21,3,7,9,27,50
2008-06-15 00:00:00.000,s-Hertogenbosch The Netherlands ATP World Tour,GRASS,2,Massimo Dell'Acqua,Fabio Fognini,Massimo Dell'Acqua,7-6(4); 6-2,R32,67,12,2,36,56,30,36,14,20,0,1,10,44,56,5,3,34,57,24,34,13,23,0,3,10,37,57
2008-06-15 00:00:00.000,s-Hertogenbosch The Netherlands ATP World Tour,GRASS,2,Steve Darcis,Florent Serra,Steve Darcis,7-5; 6-3,R32,72,7,2,38,69,30,38,16,31,2,3,11,46,69,1,0,31,54,23,31,11,23,2,5,10,34,54
2008-06-15 00:00:00.000,s-Hertogenbosch The Netherlands ATP World Tour,GRASS,2,Mario Ancic,Ivo Minar,Mario Ancic,6-1; 7-6(0),R32,68,3,0,37,50,30,37,9,13,0,0,9,39,50,1,0,62,78,32,62,10,16,4,7,10,42,78
2008-06-15 00:00:00.000,s-Hertogenbosch The Netherlands ATP World Tour,GRASS,2,Arnaud Clement,Benjamin Becker,Arnaud Clement,6-3; 3-6; 6-4,R32,115,5,5,42,79,34,42,21,37,5,7,14,55,79,10,8,42,83,34,42,17,41,1,4,14,51,83
2008-06-15 00:00:00.000,s-Hertogenbosch The Netherlands ATP World Tour,GRASS,2,Marcel Granollers,Kristof Vliegen,Marcel Granollers,6-0; 1-0 RET,R32,27,2,0,17,20,12,17,2,3,1,1,3,14,20,1,0,9,24,2,9,5,15,2,6,4,7,24
2008-06-15 00:00:00.000,s-Hertogenbosch The Netherlands ATP World Tour,GRASS,2,Rainer Schuettler,Michael Berrer,Rainer Schuettler,6-7(4); 6-4; 6-4,R32,146,8,1,53,97,48,53,26,44,2,2,16,74,97,10,4,64,116,49,64,29,52,4,6,16,78,116
2008-06-15 00:00:00.000,s-Hertogenbosch The Netherlands ATP World Tour,GRASS,2,Juan Martin Del Potro,Fabrice Santoro,Juan Martin Del Potro,6-3; 6-1,R32,60,4,0,29,44,26,29,8,15,3,3,8,34,44,0,3,26,42,16,26,6,16,2,6,8,22,42
2008-06-15 00:00:00.000,s-Hertogenbosch The Netherlands ATP World Tour,GRASS,2,Guillermo Canas,Mischa Zverev,Guillermo Canas,5-7; 6-3; 6-3,R32,128,6,2,54,96,34,54,25,42,4,7,15,59,96,5,2,68,106,46,68,16,38,10,15,15,62,106
2008-06-15 00:00:00.000,s-Hertogenbosch The Netherlands ATP World Tour,GRASS,2,Rohan Bopanna,Martin Verkerk,Rohan Bopanna,6-7(8); 7-6(2); 6-4,R32,123,21,3,56,98,52,56,27,42,0,0,17,79,98,22,10,68,106,55,68,22,38,1,2,17,77,106
2008-06-15 00:00:00.000,s-Hertogenbosch The Netherlands ATP World Tour,GRASS,2,Viktor Troicki,Denis Gremelmayr,Viktor Troicki,6-3; 7-5,R32,69,9,4,36,58,32,36,13,22,0,0,11,45,58,6,2,45,67,32,45,9,22,10,12,10,41,67
2008-06-15 00:00:00.000,s-Hertogenbosch The Netherlands ATP World Tour,GRASS,2,Ivan Ljubicic,Robin Haase,Ivan Ljubicic,6-3; 7-6(5),R32,78,8,2,37,66,28,37,17,29,0,1,11,45,66,8,6,30,61,24,30,14,31,0,2,10,38,61
2008-06-15 00:00:00.000,s-Hertogenbosch The Netherlands ATP World Tour,GRASS,2,Igor Andreev,Grigor Dimitrov,Igor Andreev,6-1; 6-3,R32,51,5,2,26,43,24,26,10,17,3,3,8,34,43,1,3,34,48,20,34,5,14,2,6,8,25,48
2008-06-15 00:00:00.000,s-Hertogenbosch The Netherlands ATP World Tour,GRASS,2,Jurgen Melzer,Victor Hanescu,Jurgen Melzer,6-7(11); 6-2; 6-4,R32,125,5,3,72,107,58,72,21,35,8,8,15,79,107,10,0,66,94,49,66,15,28,5,8,15,64,94
2008-06-15 00:00:00.000,s-Hertogenbosch The Netherlands ATP World Tour,GRASS,2,Marc Gicquel,Matwe Middelkoop,Marc Gicquel,6-4; 6-1,R32,66,5,3,29,47,26,29,9,18,3,3,8,35,47,4,3,28,62,15,28,17,34,1,5,9,32,62
2008-06-15 00:00:00.000,s-Hertogenbosch The Netherlands ATP World Tour,GRASS,2,Richard Gasquet,Olivier Rochus,Richard Gasquet,6-2; 7-6(3),R32,94,7,3,38,59,32,38,9,21,0,1,10,41,59,1,1,55,86,29,55,17,31,10,13,10,46,86
2008-06-15 00:00:00.000,s-Hertogenbosch The Netherlands ATP World Tour,GRASS,2,David Ferrer,Massimo Dell'Acqua,David Ferrer,6-2; 7-6(3),R16,82,7,2,46,67,35,46,12,21,5,6,10,47,67,7,6,38,64,28,38,8,26,2,5,10,36,64
2008-06-15 00:00:00.000,s-Hertogenbosch The Netherlands ATP World Tour,GRASS,2,Mario Ancic,Steve Darcis,Mario Ancic,6-2; 6-4,R16,78,4,3,34,61,27,34,16,27,7,7,9,43,61,8,0,41,63,28,41,9,22,5,8,9,37,63
2008-06-15 00:00:00.000,s-Hertogenbosch The Netherlands ATP World Tour,GRASS,2,Arnaud Clement,Marcel Granollers,Arnaud Clement,6-7(6); 6-3; 6-3,R16,138,7,1,68,109,46,68,24,41,16,18,15,70,109,2,3,49,84,30,49,21,35,3,8,15,51,84
2008-06-15 00:00:00.000,s-Hertogenbosch The Netherlands ATP World Tour,GRASS,2,Juan Martin Del Potro,Rainer Schuettler,Juan Martin Del Potro,7-6(3); 4-3,R16,90,13,2,39,58,34,39,13,19,4,4,10,47,58,2,0,43,70,31,43,17,27,5,5,9,48,70
2008-06-15 00:00:00.000,s-Hertogenbosch The Netherlands ATP World Tour,GRASS,2,Guillermo Canas,Rohan Bopanna,Guillermo Canas,6-2; 6-4,R16,62,5,2,31,48,28,31,8,17,0,0,9,36,48,6,1,27,50,18,27,13,23,4,7,9,31,50
2008-06-15 00:00:00.000,s-Hertogenbosch The Netherlands ATP World Tour,GRASS,2,Viktor Troicki,Ivan Ljubicic,Viktor Troicki,5-7; 6-4; 7-6(5),R16,138,9,6,52,90,47,52,22,38,0,1,17,69,90,25,6,73,118,57,73,22,45,10,11,17,79,118
2008-06-15 00:00:00.000,s-Hertogenbosch The Netherlands ATP World Tour,GRASS,2,Jurgen Melzer,Igor Andreev,Jurgen Melzer,6-4; 1-6; 6-1,R16,98,7,4,42,71,33,42,15,29,4,6,12,48,71,4,4,47,85,32,47,18,38,7,10,12,50,85
2008-06-15 00:00:00.000,s-Hertogenbosch The Netherlands ATP World Tour,GRASS,2,Marc Gicquel,Richard Gasquet,Marc Gicquel,7-5; 7-6(6),R16,102,9,2,48,85,38,48,23,37,7,7,12,61,85,6,1,45,64,36,45,14,19,1,2,12,50,64
2008-06-15 00:00:00.000,s-Hertogenbosch The Netherlands ATP World Tour,GRASS,2,David Ferrer,Mario Ancic,David Ferrer,6-4; 7-6(4),Q,95,1,2,53,75,40,53,13,22,1,1,11,53,75,4,4,43,74,34,43,13,31,5,6,11,47,74
2008-06-15 00:00:00.000,s-Hertogenbosch The Netherlands ATP World Tour,GRASS,2,Juan Martin Del Potro,Arnaud Clement,Juan Martin Del Potro,2-6; 6-3; 6-1,Q,122,13,6,52,81,32,52,15,29,6,10,12,47,81,8,4,38,79,22,38,18,41,5,11,12,40,79
2008-06-15 00:00:00.000,s-Hertogenbosch The Netherlands ATP World Tour,GRASS,2,Guillermo Canas,Viktor Troicki,Guillermo Canas,6-2; 6-2,Q,67,5,3,25,42,21,25,11,17,1,2,8,32,42,3,3,32,57,16,32,10,25,2,7,8,26,57
2008-06-15 00:00:00.000,s-Hertogenbosch The Netherlands ATP World Tour,GRASS,2,Marc Gicquel,Jurgen Melzer,Marc Gicquel,6-3; 6-4,Q,100,5,0,37,58,30,37,12,21,5,6,10,42,58,5,4,36,60,25,36,10,24,6,9,9,35,60
2008-06-15 00:00:00.000,s-Hertogenbosch The Netherlands ATP World Tour,GRASS,2,David Ferrer,Juan Martin Del Potro,David Ferrer,7-6(4); 6-1,S,87,6,1,60,78,42,60,11,18,6,6,10,53,78,2,1,30,52,23,30,12,22,1,3,9,35,52
2008-06-15 00:00:00.000,s-Hertogenbosch The Netherlands ATP World Tour,GRASS,2,Marc Gicquel,Guillermo Canas,Marc Gicquel,3-6; 6-0; 6-4,S,114,4,0,51,87,36,51,18,36,8,10,13,54,87,9,4,25,68,19,25,22,43,1,5,12,41,68
2008-06-15 00:00:00.000,s-Hertogenbosch The Netherlands ATP World Tour,GRASS,2,David Ferrer,Marc Gicquel,David Ferrer,6-4; 6-2,F,82,12,0,43,65,30,43,14,22,2,2,9,44,65,7,0,43,63,28,43,8,20,4,7,9,36,63
2008-06-16 00:00:00.000,Nottingham Great Britain ATP World Tour,GRASS,2,Radek Stepanek,John Isner,Radek Stepanek,6-3; 6-2,R32,50,8,1,34,46,29,34,8,12,0,0,9,37,46,7,4,31,43,20,31,4,12,0,3,8,24,43
2008-06-16 00:00:00.000,Nottingham Great Britain ATP World Tour,GRASS,2,Vincent Spadea,Alexander Slabinsky,Vincent Spadea,6-1; 7-5,R32,57,6,0,35,52,29,35,11,17,0,0,10,40,52,5,2,31,57,21,31,14,26,2,5,9,35,57
2008-06-16 00:00:00.000,Nottingham Great Britain ATP World Tour,GRASS,2,Julien Benneteau,Simone Bolelli,Julien Benneteau,6-1; 6-4,R32,67,7,2,29,45,26,29,10,16,0,0,9,36,45,3,0,43,57,27,43,4,14,1,4,8,31,57
2008-06-16 00:00:00.000,Nottingham Great Britain ATP World Tour,GRASS,2,Gael Monfils,Chris Guccione,Gael Monfils,7-6(4); 6-4,R32,73,11,3,42,71,34,42,20,29,4,4,11,54,71,6,2,48,77,35,48,15,29,4,5,11,50,77
2008-06-16 00:00:00.000,Nottingham Great Britain ATP World Tour,GRASS,2,Ivo Karlovic,Jonas Bjorkman,Ivo Karlovic,6-3; 6-4,R32,65,15,0,39,52,33,39,7,13,0,0,10,40,52,0,1,26,51,18,26,17,25,1,3,9,35,51
2008-06-16 00:00:00.000,Nottingham Great Britain ATP World Tour,GRASS,2,Sam Querrey,Alejandro Falla,Sam Querrey,6-3; 6-4,R32,64,10,1,35,55,29,35,12,20,0,0,10,41,55,7,3,31,58,22,31,11,27,3,5,9,33,58
2008-06-16 00:00:00.000,Nottingham Great Britain ATP World Tour,GRASS,2,Eduardo Schwank,Frederik Nielsen,Eduardo Schwank,6-3; 6-3,R32,78,2,2,49,75,38,49,7,26,4,5,9,45,75,1,3,33,55,22,33,7,22,2,6,9,29,55
2008-06-16 00:00:00.000,Nottingham Great Britain ATP World Tour,GRASS,2,Andreas Seppi,Dudi Sela,Andreas Seppi,3-6; 6-4; 7-5,R32,130,7,2,54,90,37,54,13,36,7,13,16,50,90,3,4,59,107,36,59,19,48,3,9,15,55,107
2008-06-16 00:00:00.000,Nottingham Great Britain ATP World Tour,GRASS,2,Gilles Simon,Donald Young,Gilles Simon,6-1; 6-4,R32,49,4,2,34,51,28,34,11,17,4,4,9,39,51,1,0,33,48,22,33,6,15,3,6,8,28,48
2008-06-16 00:00:00.000,Nottingham Great Britain ATP World Tour,GRASS,2,Samuel Groth,Jamie Baker,Samuel Groth,7-6(7); 6-3,R32,74,20,3,35,60,31,35,18,25,0,0,11,49,60,0,3,41,64,30,41,13,23,1,2,10,43,64
2008-06-16 00:00:00.000,Nottingham Great Britain ATP World Tour,GRASS,2,Bobby Reynolds,Nicolas Mahut,Bobby Reynolds,7-5; 4-6; 6-4,R32,121,19,1,53,87,40,53,18,34,3,6,16,58,87,15,12,52,95,43,52,17,43,9,13,16,60,95
2008-06-16 00:00:00.000,Nottingham Great Britain ATP World Tour,GRASS,2,Fernando Verdasco,Marcos Daniel,Fernando Verdasco,6-4; 7-6(3),R32,80,4,3,47,67,34,47,12,20,3,5,11,46,67,8,1,46,68,34,46,8,22,3,6,11,42,68
2008-06-16 00:00:00.000,Nottingham Great Britain ATP World Tour,GRASS,2,Dmitry Tursunov,Yen-Hsun Lu,Dmitry Tursunov,7-5; 6-4,R32,71,4,1,35,52,27,35,13,17,0,1,11,40,52,1,3,46,70,33,46,11,24,7,10,11,44,70
2008-06-16 00:00:00.000,Nottingham Great Britain ATP World Tour,GRASS,2,Thomas Johansson,Kei Nishikori,Thomas Johansson,7-5 RET,R32,48,6,2,22,37,19,22,8,15,1,1,6,27,37,2,1,25,43,18,25,9,18,3,4,6,27,43
2008-06-16 00:00:00.000,Nottingham Great Britain ATP World Tour,GRASS,2,Alex Bogdanovic,James Ward,Alex Bogdanovic,6-3; 6-4,R32,69,12,3,40,60,32,40,10,20,1,2,10,42,60,4,3,34,56,23,34,10,22,3,6,9,33,56
2008-06-16 00:00:00.000,Nottingham Great Britain ATP World Tour,GRASS,2,Marin Cilic,Paul-Henri Mathieu,Marin Cilic,1-6; 6-4; 6-3,R32,100,15,4,39,75,30,39,21,36,2,4,13,51,75,10,3,44,77,32,44,19,33,1,3,13,51,77
2008-06-16 00:00:00.000,Nottingham Great Britain ATP World Tour,GRASS,2,Vincent Spadea,Radek Stepanek,Vincent Spadea,W/O,R16,0,0,0,0,0,0,0,0,0,0,0,0,0,0,0,0,0,0,0,0,0,0,0,0,0,0,0
2008-06-16 00:00:00.000,Nottingham Great Britain ATP World Tour,GRASS,2,Gael Monfils,Julien Benneteau,Gael Monfils,3-6; 6-4; 6-2,R16,104,8,1,53,75,41,53,9,22,3,5,13,50,75,2,2,55,86,38,55,15,31,6,10,14,53,86
2008-06-16 00:00:00.000,Nottingham Great Britain ATP World Tour,GRASS,2,Ivo Karlovic,Sam Querrey,Ivo Karlovic,7-6(3); 7-6(14),R16,111,27,2,54,82,48,54,17,28,0,0,12,65,82,9,2,70,100,54,70,15,30,2,2,12,69,100
2008-06-16 00:00:00.000,Nottingham Great Britain ATP World Tour,GRASS,2,Andreas Seppi,Eduardo Schwank,Andreas Seppi,6-1; 4-6; 7-6(7),R16,131,4,3,68,103,50,68,18,35,6,8,15,68,103,8,6,65,94,42,65,15,29,8,11,14,57,94
2008-06-16 00:00:00.000,Nottingham Great Britain ATP World Tour,GRASS,2,Gilles Simon,Samuel Groth,Gilles Simon,6-7(1); 6-4; 6-4,R16,122,6,1,64,104,45,64,24,40,3,4,16,69,104,18,9,59,116,51,59,23,57,11,14,16,74,116
2008-06-16 00:00:00.000,Nottingham Great Britain ATP World Tour,GRASS,2,Fernando Verdasco,Bobby Reynolds,Fernando Verdasco,6-2; 6-3,R16,59,3,0,35,45,27,35,7,10,3,3,8,34,45,6,2,36,59,25,36,7,23,1,5,9,32,59
2008-06-16 00:00:00.000,Nottingham Great Britain ATP World Tour,GRASS,2,Thomas Johansson,Dmitry Tursunov,Thomas Johansson,W/O,R16,0,0,0,0,0,0,0,0,0,0,0,0,0,0,0,0,0,0,0,0,0,0,0,0,0,0,0
2008-06-16 00:00:00.000,Nottingham Great Britain ATP World Tour,GRASS,2,Marin Cilic,Alex Bogdanovic,Marin Cilic,6-4; 6-4,R16,83,10,1,46,77,31,46,15,31,3,5,10,46,77,2,6,34,60,22,34,11,26,4,8,10,33,60
2008-06-16 00:00:00.000,Nottingham Great Britain ATP World Tour,GRASS,2,Gael Monfils,Vincent Spadea,Gael Monfils,7-6(4); 6-2,Q,77,7,1,45,67,37,45,11,22,2,3,10,48,67,2,1,45,71,26,45,16,26,2,5,10,42,71
2008-06-16 00:00:00.000,Nottingham Great Britain ATP World Tour,GRASS,2,Ivo Karlovic,Andreas Seppi,Ivo Karlovic,6-3; 3-6; 6-4,Q,111,19,4,58,83,49,58,9,25,2,3,14,58,83,6,3,48,88,33,48,23,40,1,3,14,56,88
2008-06-16 00:00:00.000,Nottingham Great Britain ATP World Tour,GRASS,2,Fernando Verdasco,Gilles Simon,Fernando Verdasco,6-3; 2-6; 6-3,Q,96,4,5,56,82,35,56,13,26,5,8,13,48,82,3,4,41,73,24,41,19,32,1,5,13,43,73
2008-06-16 00:00:00.000,Nottingham Great Britain ATP World Tour,GRASS,2,Marin Cilic,Thomas Johansson,Marin Cilic,6-1; 6-2,Q,55,4,0,22,48,21,22,13,26,1,1,8,34,48,1,1,24,46,13,24,9,22,3,7,7,22,46
2008-06-16 00:00:00.000,Nottingham Great Britain ATP World Tour,GRASS,2,Ivo Karlovic,Gael Monfils,Ivo Karlovic,7-6(4); 7-6(4),S,104,11,3,47,71,39,47,16,24,1,3,12,55,71,0,4,64,94,40,64,16,30,4,6,12,56,94
2008-06-16 00:00:00.000,Nottingham Great Britain ATP World Tour,GRASS,2,Fernando Verdasco,Marin Cilic,Fernando Verdasco,6-3; 6-1,S,63,3,0,33,42,26,33,7,9,2,2,8,33,42,1,2,31,60,16,31,14,29,4,8,8,30,60
2008-06-16 00:00:00.000,Nottingham Great Britain ATP World Tour,GRASS,2,Ivo Karlovic,Fernando Verdasco,Ivo Karlovic,7-5; 6-7(4); 7-6(8),F,142,29,2,74,112,63,74,22,38,1,2,18,85,112,4,6,82,104,70,82,9,22,2,4,18,79,104
2008-06-23 00:00:00.000,Wimbledon Great Britain Grand Slams,GRASS,3,Roger Federer,Dominik Hrbaty,Roger Federer,6-3; 6-2; 6-2,R128,80,10,0,54,78,42,54,15,24,0,0,13,57,78,2,7,39,69,24,39,12,30,6,11,12,36,69
2008-06-23 00:00:00.000,Wimbledon Great Britain Grand Slams,GRASS,3,Robin Soderling,Kevin Kim,Robin Soderling,7-5; 0-6; 6-3; 6-4,R128,140,9,2,57,111,45,57,28,54,5,9,19,73,111,12,6,91,141,64,91,21,50,11,15,18,85,141
2008-06-23 00:00:00.000,Wimbledon Great Britain Grand Slams,GRASS,3,Marc Gicquel,Kei Nishikori,Marc Gicquel,4-6; 7-5 RET,R128,75,4,1,36,59,32,36,13,23,0,1,11,45,59,5,3,47,64,36,47,9,17,2,3,11,45,64
2008-06-23 00:00:00.000,Wimbledon Great Britain Grand Slams,GRASS,3,Ilija Bozoljac,Chris Guccione,Ilija Bozoljac,3-6; 6-4; 6-4; 6-3,R128,116,20,6,59,107,52,59,26,48,4,5,19,78,107,9,4,62,104,48,62,22,42,1,4,19,70,104
2008-06-23 00:00:00.000,Wimbledon Great Britain Grand Slams,GRASS,3,Lleyton Hewitt,Robin Haase,Lleyton Hewitt,6-7(4); 6-3; 6-3; 6-7(1); 6-2,R128,217,18,8,80,144,68,80,39,64,3,4,25,107,144,27,9,98,181,72,98,39,83,10,16,25,111,181
2008-06-23 00:00:00.000,Wimbledon Great Britain Grand Slams,GRASS,3,Albert Montanes,Carlos Berlocq,Albert Montanes,6-3; 7-6(2); 6-4,R128,111,2,5,70,104,52,70,18,34,6,8,15,70,104,1,2,55,93,42,55,13,38,6,11,16,55,93
2008-06-23 00:00:00.000,Wimbledon Great Britain Grand Slams,GRASS,3,Simone Bolelli,Alex Bogdanovic,Simone Bolelli,7-6(4); 4-6; 6-3; 7-6(4),R128,186,18,2,109,161,82,109,27,52,5,6,22,109,161,13,6,81,129,62,81,32,48,5,6,21,94,129
2008-06-23 00:00:00.000,Wimbledon Great Britain Grand Slams,GRASS,3,Fernando Gonzalez,Robby Ginepri,Fernando Gonzalez,7-6(3); 7-5; 7-5,R128,131,17,5,65,114,52,65,27,49,6,7,18,79,114,11,3,80,124,58,80,19,44,9,12,18,77,124
2008-06-23 00:00:00.000,Wimbledon Great Britain Grand Slams,GRASS,3,Tomas Berdych,Evgeny Korolev,Tomas Berdych,4-6; 6-1; 6-4; 3-6; 7-5,R128,181,26,6,89,154,68,89,30,65,9,13,24,98,154,22,8,75,140,61,75,25,65,7,13,24,86,140
2008-06-23 00:00:00.000,Wimbledon Great Britain Grand Slams,GRASS,3,Victor Hanescu,Alejandro Falla,Victor Hanescu,6-3; 6-7(2); 6-0; 6-4,R128,164,10,3,76,112,55,76,17,36,2,5,19,72,112,4,2,79,135,52,79,24,56,16,24,18,76,135
2008-06-23 00:00:00.000,Wimbledon Great Britain Grand Slams,GRASS,3,Olivier Rochus,Dudi Sela,Olivier Rochus,6-4; 7-5; 6-4,R128,129,0,3,63,109,47,63,23,46,9,12,16,70,109,5,1,48,86,32,48,18,38,4,10,16,50,86
2008-06-23 00:00:00.000,Wimbledon Great Britain Grand Slams,GRASS,3,Fernando Verdasco,Philipp Kohlschreiber,Fernando Verdasco,6-4; 6-3; 6-2,R128,99,2,3,55,74,38,55,13,19,1,3,14,51,74,2,5,44,86,29,44,16,42,10,16,13,45,86
2008-06-23 00:00:00.000,Wimbledon Great Britain Grand Slams,GRASS,3,Mario Ancic,Michael Llodra,Mario Ancic,6-4; 7-6(7); 2-0 RET,R128,94,18,3,43,66,39,43,17,23,0,0,12,56,66,0,5,58,86,37,58,17,28,4,6,12,54,86
2008-06-23 00:00:00.000,Wimbledon Great Britain Grand Slams,GRASS,3,Philipp Petzschner,Hyung-Taik Lee,Philipp Petzschner,6-7(4); 6-1; 6-4 RET,R128,89,19,6,42,83,37,42,25,41,0,0,14,62,83,1,5,65,100,44,65,16,35,6,9,14,60,100
2008-06-23 00:00:00.000,Wimbledon Great Britain Grand Slams,GRASS,3,Igor Andreev,Jiri Vanek,Igor Andreev,6-7(6); 7-6(2); 6-2; 6-2,R128,150,23,3,64,108,56,64,27,44,1,3,20,83,108,10,8,99,160,66,99,26,61,14,20,20,92,160
2008-06-23 00:00:00.000,Wimbledon Great Britain Grand Slams,GRASS,3,David Ferrer,Sergiy Stakhovsky,David Ferrer,7-6(6); 6-3; 1-3 RET,R128,118,3,2,59,81,45,59,12,22,1,2,13,57,81,4,3,70,95,52,70,9,25,5,6,12,61,95
2008-06-23 00:00:00.000,Wimbledon Great Britain Grand Slams,GRASS,3,Novak Djokovic,Michael Berrer,Novak Djokovic,7-5; 2-6; 6-3; 6-0,R128,127,13,5,67,94,53,67,15,27,3,5,18,68,94,10,7,75,113,54,75,12,38,11,16,17,66,113
2008-06-23 00:00:00.000,Wimbledon Great Britain Grand Slams,GRASS,3,Marat Safin,Fabio Fognini,Marat Safin,6-1; 6-2; 7-6(3),R128,100,9,3,55,88,36,55,20,33,2,5,14,56,88,2,5,44,93,29,44,20,49,4,11,13,49,93
2008-06-23 00:00:00.000,Wimbledon Great Britain Grand Slams,GRASS,3,Florent Serra,Yen-Hsun Lu,Florent Serra,6-4; 6-4; 6-7(3); 6-3,R128,193,6,1,97,144,66,97,25,47,9,11,21,91,144,10,8,99,155,66,99,26,56,11,16,20,92,155
2008-06-23 00:00:00.000,Wimbledon Great Britain Grand Slams,GRASS,3,Andreas Seppi,Tobias Kamke,Andreas Seppi,5-7; 6-3; 6-2; 6-4,R128,157,6,3,64,113,52,64,27,49,6,9,20,79,113,3,11,74,127,48,74,24,53,2,8,19,72,127
2008-06-23 00:00:00.000,Wimbledon Great Britain Grand Slams,GRASS,3,Juan Carlos Ferrero,Sam Querrey,Juan Carlos Ferrero,2-6; 6-4; 6-4; 6-4,R128,145,7,5,90,124,65,90,18,34,8,10,19,83,124,16,5,77,126,58,77,20,49,10,13,19,78,126
2008-06-23 00:00:00.000,Wimbledon Great Britain Grand Slams,GRASS,3,Mischa Zverev,Alexander Peya,Mischa Zverev,6-3; 6-4; 6-4,R128,86,8,1,53,72,46,53,14,19,0,0,15,60,72,4,5,55,83,42,55,12,28,4,7,14,54,83
2008-06-23 00:00:00.000,Wimbledon Great Britain Grand Slams,GRASS,3,Juan Martin Del Potro,Pavel Snobel,Juan Martin Del Potro,6-4; 6-2; 6-3,R128,102,3,1,44,74,30,44,22,30,4,5,13,52,74,5,7,47,96,30,47,20,49,10,16,14,50,96
2008-06-23 00:00:00.000,Wimbledon Great Britain Grand Slams,GRASS,3,Stanislas Wawrinka,Marcos Daniel,Stanislas Wawrinka,6-3; 6-2; 7-5,R128,94,9,5,45,78,40,45,19,33,2,3,15,59,78,5,0,61,87,36,61,13,26,7,12,14,49,87
2008-06-23 00:00:00.000,Wimbledon Great Britain Grand Slams,GRASS,3,Marcos Baghdatis,Steve Darcis,Marcos Baghdatis,6-3; 6-2; 6-7(5); 6-3,R128,162,9,8,64,121,53,64,32,57,7,8,20,85,121,3,3,85,139,54,85,27,54,4,9,18,81,139
2008-06-23 00:00:00.000,Wimbledon Great Britain Grand Slams,GRASS,3,Thomas Johansson,Vincent Spadea,Thomas Johansson,6-7(8); 6-7(5); 6-3; 6-4; 6-3,R128,210,13,7,122,186,89,122,32,64,12,15,26,121,186,13,4,115,177,81,115,32,62,10,17,26,113,177
2008-06-23 00:00:00.000,Wimbledon Great Britain Grand Slams,GRASS,3,Thomaz Bellucci,Igor Kunitsyn,Thomaz Bellucci,7-6(5); 7-6(5); 3-6; 6-2,R128,157,17,5,76,126,56,76,29,50,4,7,20,85,126,3,8,95,150,66,95,25,55,9,13,21,91,150
2008-06-23 00:00:00.000,Wimbledon Great Britain Grand Slams,GRASS,3,Simon Stadler,Ivo Karlovic,Simon Stadler,4-6; 7-6(4); 6-3; 7-5,R128,166,5,6,102,152,75,102,30,50,10,12,22,105,152,23,4,88,127,73,88,15,39,5,8,21,88,127
2008-06-23 00:00:00.000,Wimbledon Great Britain Grand Slams,GRASS,3,Feliciano Lopez,Brian Dabul,Feliciano Lopez,7-6(1); 3-6; 6-3; 6-4,R128,164,29,7,85,123,71,85,14,38,5,7,20,85,123,5,0,112,140,76,112,13,28,10,13,20,89,140
2008-06-23 00:00:00.000,Wimbledon Great Britain Grand Slams,GRASS,3,Roko Karanusic,Luis Horna,Roko Karanusic,7-6(4); 6-3; 6-1,R128,118,8,2,63,87,50,63,14,24,0,1,14,64,87,1,2,65,102,38,65,17,37,10,15,14,55,102
2008-06-23 00:00:00.000,Wimbledon Great Britain Grand Slams,GRASS,3,Bobby Reynolds,Filippo Volandri,Bobby Reynolds,6-2; 6-2 RET,R128,68,11,1,27,44,25,27,8,17,1,1,8,33,44,1,6,47,74,30,47,8,27,15,19,8,38,74
2008-06-23 00:00:00.000,Wimbledon Great Britain Grand Slams,GRASS,3,Frank Dancevic,David Nalbandian,Frank Dancevic,6-4; 6-2; 6-4,R128,96,16,0,53,81,40,53,18,28,4,5,14,58,81,3,4,45,74,32,45,13,29,3,8,14,45,74
2008-06-23 00:00:00.000,Wimbledon Great Britain Grand Slams,GRASS,3,Andy Roddick,Eduardo Schwank,Andy Roddick,7-5; 6-4; 7-6(0),R128,135,15,3,64,96,52,64,21,32,0,0,17,73,96,5,6,75,121,51,75,24,46,10,12,17,75,121
2008-06-23 00:00:00.000,Wimbledon Great Britain Grand Slams,GRASS,3,Janko Tipsarevic,Thierry Ascione,Janko Tipsarevic,7-6(4); 6-4; 6-2,R128,102,18,2,50,79,42,50,19,29,0,1,15,61,79,2,2,56,92,39,56,15,36,3,7,15,54,92
2008-06-23 00:00:00.000,Wimbledon Great Britain Grand Slams,GRASS,3,Chris Eaton,Boris Pashanski,Chris Eaton,6-3; 7-6(6); 6-4,R128,113,26,2,66,91,58,66,14,25,1,1,16,72,91,2,2,74,99,52,74,16,25,3,5,15,68,99
2008-06-23 00:00:00.000,Wimbledon Great Britain Grand Slams,GRASS,3,Dmitry Tursunov,Nicolas Mahut,Dmitry Tursunov,6-4; 6-7(8); 7-6(7); 3-6; 7-5,R128,232,27,5,96,170,80,96,47,74,3,4,27,127,170,32,13,115,178,94,115,35,63,9,11,28,129,178
2008-06-23 00:00:00.000,Wimbledon Great Britain Grand Slams,GRASS,3,Nicolas Almagro,Marcel Granollers,Nicolas Almagro,4-6; 6-3; 7-5; 6-2,R128,128,8,4,62,116,46,62,32,54,9,12,20,78,116,5,4,66,100,47,66,17,34,8,14,19,64,100
2008-06-23 00:00:00.000,Wimbledon Great Britain Grand Slams,GRASS,3,Guillermo Garcia-Lopez,Izak Van der Merwe,Guillermo Garcia-Lopez,7-5; 6-2; 6-2,R128,117,1,4,69,102,49,69,15,33,5,7,14,64,102,7,2,46,78,30,46,12,32,3,10,14,42,78
2008-06-23 00:00:00.000,Wimbledon Great Britain Grand Slams,GRASS,3,Rainer Schuettler,Santiago Ventura,Rainer Schuettler,6-3; 6-2; 6-4,R128,119,8,3,52,84,43,52,19,32,3,3,14,62,84,5,3,40,87,27,40,23,47,6,10,13,50,87
2008-06-23 00:00:00.000,Wimbledon Great Britain Grand Slams,GRASS,3,James Blake,Christophe Rochus,James Blake,3-6; 6-3; 6-1; 6-4,R128,108,19,7,61,107,49,61,21,46,10,13,17,70,107,3,0,78,108,44,78,15,30,5,12,18,59,108
2008-06-23 00:00:00.000,Wimbledon Great Britain Grand Slams,GRASS,3,Paul-Henri Mathieu,Oscar Hernandez,Paul-Henri Mathieu,3-6; 6-2; 6-0; 6-2,R128,121,8,1,51,86,44,51,18,35,3,5,16,62,86,2,3,60,96,36,60,12,36,5,12,15,48,96
2008-06-23 00:00:00.000,Wimbledon Great Britain Grand Slams,GRASS,3,Jeremy Chardy,Frederico Gil,Jeremy Chardy,7-5; 6-7(1); 4-6; 6-4; 6-3,R128,180,23,13,102,161,86,102,27,59,5,6,27,113,161,5,8,111,160,83,111,27,49,10,13,26,110,160
2008-06-23 00:00:00.000,Wimbledon Great Britain Grand Slams,GRASS,3,Marin Cilic,Edouard Roger-Vasselin,Marin Cilic,6-4; 6-3; 7-6(4),R128,114,12,3,53,88,46,53,23,35,1,2,16,69,88,4,2,59,95,41,59,22,36,6,9,15,63,95
2008-06-23 00:00:00.000,Wimbledon Great Britain Grand Slams,GRASS,3,Jarkko Nieminen,Wayne Odesnik,Jarkko Nieminen,6-3 RET,R128,35,3,0,20,28,14,20,3,8,0,1,5,17,28,1,0,18,24,9,18,3,6,1,3,4,12,24
2008-06-23 00:00:00.000,Wimbledon Great Britain Grand Slams,GRASS,3,Jurgen Melzer,Ivan Ljubicic,Jurgen Melzer,6-4; 7-6(7); 4-6; 2-6; 6-3,R128,194,15,1,101,174,78,101,42,73,12,15,25,120,174,33,5,101,148,80,101,28,47,10,12,24,108,148
2008-06-23 00:00:00.000,Wimbledon Great Britain Grand Slams,GRASS,3,Jesse Levine,Donald Young,Jesse Levine,4-6; 6-2; 6-3; 6-4,R128,130,8,8,57,110,38,57,29,53,6,12,19,67,110,5,4,61,107,31,61,24,46,3,12,18,55,107
2008-06-23 00:00:00.000,Wimbledon Great Britain Grand Slams,GRASS,3,Arnaud Clement,Jonas Bjorkman,Arnaud Clement,4-6; 7-6(2); 6-4; 7-6(4),R128,208,11,9,90,151,69,90,35,61,8,9,22,104,151,14,0,86,142,65,86,31,56,6,7,22,96,142
2008-06-23 00:00:00.000,Wimbledon Great Britain Grand Slams,GRASS,3,Benjamin Becker,Nikolay Davydenko,Benjamin Becker,6-4; 6-4; 6-4,R128,104,10,1,49,79,42,49,18,30,1,2,15,60,79,7,5,57,88,41,57,12,31,1,5,15,53,88
2008-06-23 00:00:00.000,Wimbledon Great Britain Grand Slams,GRASS,3,Richard Gasquet,Mardy Fish,Richard Gasquet,6-3; 6-4; 6-2,R128,112,10,3,54,92,42,54,21,38,1,1,14,63,92,8,2,39,82,22,39,26,43,2,6,13,48,82
2008-06-23 00:00:00.000,Wimbledon Great Britain Grand Slams,GRASS,3,Sebastien Grosjean,Potito Starace,Sebastien Grosjean,6-2; 7-5; 6-1,R128,82,8,0,42,69,37,42,19,27,3,4,14,56,69,0,1,49,71,27,49,12,22,4,10,13,39,71
2008-06-23 00:00:00.000,Wimbledon Great Britain Grand Slams,GRASS,3,Agustin Calleri,Kevin Anderson,Agustin Calleri,4-6; 7-5; 7-5; 6-1,R128,125,11,5,70,118,59,70,28,48,6,7,21,87,118,15,6,67,105,54,67,19,38,1,5,20,73,105
2008-06-23 00:00:00.000,Wimbledon Great Britain Grand Slams,GRASS,3,Gilles Simon,Dawid Olejniczak,Gilles Simon,6-3; 6-4; 6-2,R128,94,8,2,49,84,40,49,21,35,2,2,14,61,84,5,5,49,91,36,49,16,42,5,9,13,52,91
2008-06-23 00:00:00.000,Wimbledon Great Britain Grand Slams,GRASS,3,Tommy Robredo,Kristof Vliegen,Tommy Robredo,6-1; 6-3; 6-7(4); 6-4,R128,165,7,4,79,126,59,79,28,47,6,7,19,87,126,17,8,70,126,51,70,24,56,4,10,19,75,126
2008-06-23 00:00:00.000,Wimbledon Great Britain Grand Slams,GRASS,3,Tommy Haas,Guillermo Canas,Tommy Haas,3-6; 6-4; 6-4; 6-4,R128,154,3,3,63,112,41,63,31,49,3,8,20,72,112,12,10,67,126,46,67,27,59,6,12,19,73,126
2008-06-23 00:00:00.000,Wimbledon Great Britain Grand Slams,GRASS,3,Xavier Malisse,Denis Gremelmayr,Xavier Malisse,6-3; 6-4; 6-2,R128,79,7,2,49,74,41,49,16,25,1,1,14,57,74,9,6,39,69,28,39,16,30,3,7,13,44,69
2008-06-23 00:00:00.000,Wimbledon Great Britain Grand Slams,GRASS,3,Andy Murray,Fabrice Santoro,Andy Murray,6-3; 6-4; 7-6(5),R128,134,8,1,51,83,43,51,20,32,0,2,15,63,83,1,3,77,127,54,77,20,50,10,15,16,74,127
2008-06-23 00:00:00.000,Wimbledon Great Britain Grand Slams,GRASS,3,Radek Stepanek,Jan Hernych,Radek Stepanek,6-3; 7-5; 6-0,R128,114,7,2,45,73,38,45,14,28,5,6,13,52,73,1,5,70,103,35,70,17,33,4,11,14,52,103
2008-06-23 00:00:00.000,Wimbledon Great Britain Grand Slams,GRASS,3,Viktor Troicki,Nicolas Lapentti,Viktor Troicki,6-3; 4-0 RET,R128,53,4,2,21,39,16,21,12,18,0,0,7,28,39,0,2,31,42,15,31,4,11,1,4,6,19,42
2008-06-23 00:00:00.000,Wimbledon Great Britain Grand Slams,GRASS,3,Stefano Galvani,Jamie Baker,Stefano Galvani,6-4; 6-2; 6-3,R128,97,4,1,42,64,32,42,15,22,2,4,13,47,64,5,3,61,91,32,61,10,30,5,12,14,42,91
2008-06-23 00:00:00.000,Wimbledon Great Britain Grand Slams,GRASS,3,Mikhail Youzhny,Sergio Roitman,Mikhail Youzhny,6-1; 6-4; 6-0,R128,83,10,0,52,74,43,52,11,22,3,3,12,54,74,1,4,55,76,32,55,5,21,3,9,11,37,76
2008-06-23 00:00:00.000,Wimbledon Great Britain Grand Slams,GRASS,3,Nicolas Kiefer,Julien Benneteau,Nicolas Kiefer,6-1; 7-5; 6-3,R128,111,10,1,45,75,39,45,18,30,1,1,14,57,75,1,2,52,87,30,52,18,35,7,12,14,48,87
2008-06-23 00:00:00.000,Wimbledon Great Britain Grand Slams,GRASS,3,Martin Vassallo Arguello,Ivo Minar,Martin Vassallo Arguello,6-4; 2-6; 2-6; 6-2; 6-2,R128,161,4,6,81,124,55,81,23,43,3,7,21,78,124,15,4,81,130,59,81,24,49,4,9,21,83,130
2008-06-23 00:00:00.000,Wimbledon Great Britain Grand Slams,GRASS,3,Ernests Gulbis,John Isner,Ernests Gulbis,7-5; 7-5; 6-7(3); 7-6(6),R128,174,15,3,92,134,78,92,29,42,2,2,24,107,134,31,5,99,157,74,99,33,58,4,6,24,107,157
2008-06-23 00:00:00.000,Wimbledon Great Britain Grand Slams,GRASS,3,Rafael Nadal,Andreas Beck,Rafael Nadal,6-4; 6-4; 7-6(0),R128,141,17,4,65,87,57,65,11,22,0,0,16,68,87,4,5,66,110,47,66,20,44,7,9,16,67,110
2008-06-23 00:00:00.000,Wimbledon Great Britain Grand Slams,GRASS,3,Roger Federer,Robin Soderling,Roger Federer,6-3; 6-4; 7-6(3),R64,121,15,0,58,96,47,58,22,38,3,4,16,69,96,6,5,63,114,44,63,25,51,5,8,15,69,114
2008-06-23 00:00:00.000,Wimbledon Great Britain Grand Slams,GRASS,3,Marc Gicquel,Ilija Bozoljac,Marc Gicquel,4-6; 5-7; 7-6(1); 7-6(0); 6-3,R64,212,16,2,101,162,79,101,41,61,5,7,28,120,162,31,13,92,176,75,92,46,84,10,11,27,121,176
2008-06-23 00:00:00.000,Wimbledon Great Britain Grand Slams,GRASS,3,Lleyton Hewitt,Albert Montanes,Lleyton Hewitt,7-6(4); 6-0; 6-2,R64,112,9,0,41,81,35,41,25,40,4,4,13,60,81,7,6,48,92,34,48,18,44,5,10,13,52,92
2008-06-23 00:00:00.000,Wimbledon Great Britain Grand Slams,GRASS,3,Simone Bolelli,Fernando Gonzalez,Simone Bolelli,7-6(8); 7-6(7); 3-6; 7-6(4),R64,182,8,4,98,153,72,98,36,55,11,14,22,108,153,18,7,90,144,72,90,31,54,1,3,23,103,144
2008-06-23 00:00:00.000,Wimbledon Great Britain Grand Slams,GRASS,3,Tomas Berdych,Victor Hanescu,Tomas Berdych,6-7(5); 7-6(6); 6-1; 6-2,R64,135,13,4,64,108,59,64,28,44,2,2,19,87,108,11,5,81,121,57,81,20,40,4,9,20,77,121
2008-06-23 00:00:00.000,Wimbledon Great Britain Grand Slams,GRASS,3,Fernando Verdasco,Olivier Rochus,Fernando Verdasco,7-6(4); 6-7(5); 6-1; 6-1,R64,153,15,3,82,120,55,82,22,38,4,9,19,77,120,2,3,77,121,42,77,17,44,6,16,19,59,121
2008-06-23 00:00:00.000,Wimbledon Great Britain Grand Slams,GRASS,3,Mario Ancic,Philipp Petzschner,Mario Ancic,6-1; 6-4; 6-7(1); 4-6; 6-3,R64,199,20,4,101,160,76,101,33,59,6,7,25,109,160,12,8,74,151,61,74,37,77,10,14,23,98,151
2008-06-23 00:00:00.000,Wimbledon Great Britain Grand Slams,GRASS,3,David Ferrer,Igor Andreev,David Ferrer,3-6; 6-3; 6-4; 6-2,R64,131,0,1,58,95,44,58,24,37,1,3,18,68,95,2,2,74,109,54,74,13,35,4,9,18,67,109
2008-06-23 00:00:00.000,Wimbledon Great Britain Grand Slams,GRASS,3,Marat Safin,Novak Djokovic,Marat Safin,6-4; 7-6(3); 6-2,R64,122,7,3,54,95,43,54,25,41,0,1,15,68,95,4,10,63,97,46,63,12,34,8,12,15,58,97
2008-06-23 00:00:00.000,Wimbledon Great Britain Grand Slams,GRASS,3,Andreas Seppi,Florent Serra,Andreas Seppi,6-3; 6-7(4); 6-2; 6-7(5); 6-4,R64,182,19,4,101,155,79,101,30,54,4,5,25,109,155,9,2,120,162,85,120,23,42,14,20,26,108,162
2008-06-23 00:00:00.000,Wimbledon Great Britain Grand Slams,GRASS,3,Mischa Zverev,Juan Carlos Ferrero,Mischa Zverev,6-4; 6-4; 2-1 RET,R64,82,12,4,53,76,44,53,10,23,4,4,11,54,76,4,2,51,70,31,51,11,19,3,6,12,42,70
2008-06-23 00:00:00.000,Wimbledon Great Britain Grand Slams,GRASS,3,Stanislas Wawrinka,Juan Martin Del Potro,Stanislas Wawrinka,7-6(5); 6-3; 7-5,R64,150,14,2,58,98,44,58,23,40,3,5,16,67,98,3,2,74,114,48,74,22,40,3,8,17,70,114
2008-06-23 00:00:00.000,Wimbledon Great Britain Grand Slams,GRASS,3,Marcos Baghdatis,Thomas Johansson,Marcos Baghdatis,6-4; 6-4; 6-4,R64,105,9,0,39,80,33,39,25,41,2,3,15,58,80,7,4,50,97,36,50,21,47,4,8,15,57,97
2008-06-23 00:00:00.000,Wimbledon Great Britain Grand Slams,GRASS,3,Simon Stadler,Thomaz Bellucci,Simon Stadler,3-6; 6-3; 6-1; 6-7(5); 8-6,R64,222,3,4,113,153,85,113,20,40,5,8,25,105,153,9,15,107,198,75,107,40,91,16,23,26,115,198
2008-06-23 00:00:00.000,Wimbledon Great Britain Grand Slams,GRASS,3,Feliciano Lopez,Roko Karanusic,Feliciano Lopez,6-3; 6-3; 6-4,R64,80,15,1,48,72,38,48,20,24,1,1,14,58,72,7,1,52,85,35,52,16,33,2,6,14,51,85
2008-06-23 00:00:00.000,Wimbledon Great Britain Grand Slams,GRASS,3,Bobby Reynolds,Frank Dancevic,Bobby Reynolds,4-6; 7-6(10); 6-4; 6-4,R64,146,27,7,78,120,68,78,22,42,1,4,21,90,120,13,3,88,134,60,88,27,46,2,6,21,87,134
2008-06-23 00:00:00.000,Wimbledon Great Britain Grand Slams,GRASS,3,Janko Tipsarevic,Andy Roddick,Janko Tipsarevic,6-7(5); 7-5; 6-4; 7-6(4),R64,187,14,3,91,162,71,91,44,71,8,8,23,115,162,27,4,91,128,78,91,19,37,0,2,23,97,128
2008-06-23 00:00:00.000,Wimbledon Great Britain Grand Slams,GRASS,3,Dmitry Tursunov,Chris Eaton,Dmitry Tursunov,7-6(2); 6-2; 6-4,R64,116,5,7,59,102,47,59,24,43,2,2,15,71,102,12,9,49,88,39,49,18,39,3,6,15,57,88
2008-06-23 00:00:00.000,Wimbledon Great Britain Grand Slams,GRASS,3,Guillermo Garcia-Lopez,Nicolas Almagro,Guillermo Garcia-Lopez,6-3; 3-6; 5-7; 6-1; 6-2,R64,161,12,9,83,131,68,83,19,48,3,7,23,87,131,13,6,64,125,45,64,31,61,8,15,22,76,125
2008-06-23 00:00:00.000,Wimbledon Great Britain Grand Slams,GRASS,3,Rainer Schuettler,James Blake,Rainer Schuettler,6-3; 6-7(8); 4-6; 6-4; 6-4,R64,200,9,6,96,165,74,96,38,69,10,13,26,112,165,18,6,113,178,80,113,31,65,9,14,25,111,178
2008-06-23 00:00:00.000,Wimbledon Great Britain Grand Slams,GRASS,3,Paul-Henri Mathieu,Jeremy Chardy,Paul-Henri Mathieu,6-3; 7-5; 7-6(1),R64,125,6,6,60,101,48,60,24,41,5,7,17,72,101,13,9,51,101,39,51,21,50,2,6,16,60,101
2008-06-23 00:00:00.000,Wimbledon Great Britain Grand Slams,GRASS,3,Marin Cilic,Jarkko Nieminen,Marin Cilic,6-4; 3-6; 6-3; 6-7(6); 7-5,R64,197,19,5,90,157,72,90,38,67,10,14,26,110,157,3,4,114,166,67,114,33,52,10,16,26,100,166
2008-06-23 00:00:00.000,Wimbledon Great Britain Grand Slams,GRASS,3,Jurgen Melzer,Jesse Levine,Jurgen Melzer,4-6; 6-2; 3-6; 6-4; 6-1,R64,152,14,2,74,112,58,74,22,38,1,4,22,80,112,8,7,97,148,67,97,19,51,10,16,22,86,148
2008-06-23 00:00:00.000,Wimbledon Great Britain Grand Slams,GRASS,3,Arnaud Clement,Benjamin Becker,Arnaud Clement,7-6(7); 7-6(3); 6-3,R64,151,5,1,52,107,44,52,38,55,2,3,17,82,107,16,4,63,111,50,63,25,48,5,7,16,75,111
2008-06-23 00:00:00.000,Wimbledon Great Britain Grand Slams,GRASS,3,Richard Gasquet,Sebastien Grosjean,Richard Gasquet,6-2; 6-2 RET,R64,56,3,2,34,44,28,34,5,10,2,2,8,33,44,3,0,30,50,16,30,8,20,2,6,8,24,50
2008-06-23 00:00:00.000,Wimbledon Great Britain Grand Slams,GRASS,3,Gilles Simon,Agustin Calleri,Gilles Simon,5-7; 6-2; 6-3; 6-4,R64,118,6,1,70,112,57,70,24,42,0,1,20,81,112,10,4,67,115,48,67,26,48,4,8,19,74,115
2008-06-23 00:00:00.000,Wimbledon Great Britain Grand Slams,GRASS,3,Tommy Haas,Tommy Robredo,Tommy Haas,6-4; 6-4; 6-3,R64,124,7,6,55,76,49,55,9,21,0,1,15,58,76,7,1,71,129,45,71,26,58,17,21,14,71,129
2008-06-23 00:00:00.000,Wimbledon Great Britain Grand Slams,GRASS,3,Andy Murray,Xavier Malisse,Andy Murray,6-4; 6-2; 6-2,R64,95,17,2,55,82,45,55,13,27,2,3,13,58,82,2,2,53,84,32,53,11,31,5,11,13,43,84
2008-06-23 00:00:00.000,Wimbledon Great Britain Grand Slams,GRASS,3,Radek Stepanek,Viktor Troicki,Radek Stepanek,6-7(1); 6-7(3); 6-3; 6-1; 6-2,R64,196,15,8,107,159,77,107,30,52,8,10,24,107,159,14,7,111,163,74,111,24,52,11,19,24,98,163
2008-06-23 00:00:00.000,Wimbledon Great Britain Grand Slams,GRASS,3,Mikhail Youzhny,Stefano Galvani,Mikhail Youzhny,4-6; 6-4; 6-3; 3-6; 6-3,R64,205,12,7,89,147,68,89,30,58,6,10,24,98,147,5,6,98,157,67,98,30,59,6,11,23,97,157
2008-06-23 00:00:00.000,Wimbledon Great Britain Grand Slams,GRASS,3,Nicolas Kiefer,Martin Vassallo Arguello,Nicolas Kiefer,6-0; 6-3; 6-1,R64,94,10,2,35,60,31,35,14,25,1,1,11,45,60,3,5,49,74,24,49,9,25,10,17,11,33,74
2008-06-23 00:00:00.000,Wimbledon Great Britain Grand Slams,GRASS,3,Rafael Nadal,Ernests Gulbis,Rafael Nadal,5-7; 6-2; 7-6(2); 6-3,R64,178,4,1,81,122,65,81,25,41,1,2,21,90,122,15,3,82,120,62,82,17,38,4,7,20,79,120
2008-06-23 00:00:00.000,Wimbledon Great Britain Grand Slams,GRASS,3,Roger Federer,Marc Gicquel,Roger Federer,6-3; 6-3; 6-1,R32,82,10,1,49,68,41,49,11,19,2,3,13,52,68,5,1,55,82,35,55,7,27,7,13,12,42,82
2008-06-23 00:00:00.000,Wimbledon Great Britain Grand Slams,GRASS,3,Lleyton Hewitt,Simone Bolelli,Lleyton Hewitt,6-1; 6-3; 7-6(2),R32,125,14,0,40,76,37,40,24,36,0,0,14,61,76,12,4,64,102,43,64,14,38,8,12,14,57,102
2008-06-23 00:00:00.000,Wimbledon Great Britain Grand Slams,GRASS,3,Fernando Verdasco,Tomas Berdych,Fernando Verdasco,6-4; 6-4; 6-0,R32,100,11,0,42,69,38,42,17,27,0,0,13,55,69,4,2,44,85,29,44,20,41,5,10,13,49,85
2008-06-23 00:00:00.000,Wimbledon Great Britain Grand Slams,GRASS,3,Mario Ancic,David Ferrer,Mario Ancic,6-4; 6-4; 6-7(5); 7-6(3),R32,191,23,3,87,144,73,87,33,57,6,6,22,106,144,5,3,92,131,71,92,20,39,2,4,22,91,131
2008-06-23 00:00:00.000,Wimbledon Great Britain Grand Slams,GRASS,3,Marat Safin,Andreas Seppi,Marat Safin,7-6(5); 3-6; 7-6(3); 6-4,R32,176,16,5,78,134,62,78,28,56,4,8,21,90,134,4,4,93,143,65,93,28,50,3,7,22,93,143
2008-06-23 00:00:00.000,Wimbledon Great Britain Grand Slams,GRASS,3,Stanislas Wawrinka,Mischa Zverev,Stanislas Wawrinka,7-5; 6-1 RET,R32,82,8,4,39,69,30,39,17,30,4,4,10,47,69,1,1,42,61,26,42,11,19,4,7,9,37,61
2008-06-23 00:00:00.000,Wimbledon Great Britain Grand Slams,GRASS,3,Marcos Baghdatis,Simon Stadler,Marcos Baghdatis,7-6(2); 6-4; 6-2,R32,120,5,2,60,100,45,60,23,40,3,4,15,68,100,0,2,67,93,45,67,13,26,4,8,15,58,93
2008-06-23 00:00:00.000,Wimbledon Great Britain Grand Slams,GRASS,3,Feliciano Lopez,Bobby Reynolds,Feliciano Lopez,6-4; 7-5; 4-6; 6-4,R32,135,24,0,74,108,62,74,21,34,2,3,21,83,108,17,2,77,120,57,77,24,43,3,6,21,81,120
2008-06-23 00:00:00.000,Wimbledon Great Britain Grand Slams,GRASS,3,Janko Tipsarevic,Dmitry Tursunov,Janko Tipsarevic,7-6(1); 7-6(3); 6-3,R32,143,13,4,71,113,59,71,25,42,7,7,17,84,113,16,5,63,105,50,63,25,42,6,7,16,75,105
2008-06-23 00:00:00.000,Wimbledon Great Britain Grand Slams,GRASS,3,Rainer Schuettler,Guillermo Garcia-Lopez,Rainer Schuettler,6-2; 6-3; 6-4,R32,123,4,2,41,79,30,41,21,38,2,5,14,51,79,0,4,56,87,31,56,12,31,7,14,13,43,87
2008-06-23 00:00:00.000,Wimbledon Great Britain Grand Slams,GRASS,3,Marin Cilic,Paul-Henri Mathieu,Marin Cilic,6-7(5); 6-3; 6-4; 7-6(7),R32,179,18,5,90,146,70,90,33,56,5,6,22,103,146,6,2,72,126,51,72,35,54,1,4,21,86,126
2008-06-23 00:00:00.000,Wimbledon Great Britain Grand Slams,GRASS,3,Arnaud Clement,Jurgen Melzer,Arnaud Clement,4-6; 6-3; 6-4; 6-4,R32,157,16,3,68,121,51,68,33,53,5,7,20,84,121,16,4,62,115,47,62,25,53,5,9,19,72,115
2008-06-23 00:00:00.000,Wimbledon Great Britain Grand Slams,GRASS,3,Richard Gasquet,Gilles Simon,Richard Gasquet,6-3; 6-3; 6-7(3); 6-3,R32,151,14,2,83,133,60,83,23,50,2,6,20,83,133,5,3,75,123,44,75,23,48,2,10,19,67,123
2008-06-23 00:00:00.000,Wimbledon Great Britain Grand Slams,GRASS,3,Andy Murray,Tommy Haas,Andy Murray,6-4; 6-7(4); 6-3; 6-2,R32,155,14,4,68,127,55,68,33,59,3,4,20,88,127,11,6,68,109,54,68,16,41,7,12,19,70,109
2008-06-23 00:00:00.000,Wimbledon Great Britain Grand Slams,GRASS,3,Mikhail Youzhny,Radek Stepanek,Mikhail Youzhny,7-5; 6-7(5); 6-4; 6-7(4); 6-3,R32,255,12,2,131,209,96,131,43,78,14,15,28,139,209,17,7,105,157,81,105,28,52,6,10,27,109,157
2008-06-23 00:00:00.000,Wimbledon Great Britain Grand Slams,GRASS,3,Rafael Nadal,Nicolas Kiefer,Rafael Nadal,7-6(3); 6-2; 6-3,R32,142,5,1,68,87,51,68,13,19,1,2,15,64,87,13,2,46,88,38,46,14,42,2,6,14,52,88
2008-06-23 00:00:00.000,Wimbledon Great Britain Grand Slams,GRASS,3,Roger Federer,Lleyton Hewitt,Roger Federer,7-6(7); 6-2; 6-4,R16,110,21,3,60,98,51,60,20,38,8,8,15,71,98,8,1,54,87,42,54,16,33,0,3,15,58,87
2008-06-23 00:00:00.000,Wimbledon Great Britain Grand Slams,GRASS,3,Mario Ancic,Fernando Verdasco,Mario Ancic,3-6; 4-6; 6-3; 6-4; 13-11,R16,230,15,6,111,183,86,111,35,72,5,9,31,121,183,10,14,122,172,90,122,26,50,3,8,31,116,172
2008-06-23 00:00:00.000,Wimbledon Great Britain Grand Slams,GRASS,3,Marat Safin,Stanislas Wawrinka,Marat Safin,6-4; 6-3; 5-7; 6-1,R16,161,6,5,66,126,49,66,33,60,11,14,19,82,126,8,8,63,114,40,63,21,51,6,13,19,61,114
2008-06-23 00:00:00.000,Wimbledon Great Britain Grand Slams,GRASS,3,Feliciano Lopez,Marcos Baghdatis,Feliciano Lopez,5-7; 6-2; 3-6; 7-6(4); 8-6,R16,222,25,3,106,171,83,106,38,65,10,12,27,121,171,18,5,98,173,76,98,42,75,7,10,28,118,173
2008-06-23 00:00:00.000,Wimbledon Great Britain Grand Slams,GRASS,3,Rainer Schuettler,Janko Tipsarevic,Rainer Schuettler,6-4; 3-6; 6-4; 7-6(4),R16,186,11,5,74,129,62,74,29,55,4,5,20,91,129,20,4,78,135,63,78,30,57,9,11,21,93,135
2008-06-23 00:00:00.000,Wimbledon Great Britain Grand Slams,GRASS,3,Arnaud Clement,Marin Cilic,Arnaud Clement,6-3; 7-5; 6-2,R16,118,6,0,58,94,43,58,21,36,3,4,15,64,94,16,3,48,87,36,48,16,39,4,9,14,52,87
2008-06-23 00:00:00.000,Wimbledon Great Britain Grand Slams,GRASS,3,Andy Murray,Richard Gasquet,Andy Murray,5-7; 3-6; 7-6(3); 6-2; 6-4,R16,238,15,6,103,187,78,103,43,84,15,18,25,121,187,12,6,114,188,85,114,32,74,11,15,26,117,188
2008-06-23 00:00:00.000,Wimbledon Great Britain Grand Slams,GRASS,3,Rafael Nadal,Mikhail Youzhny,Rafael Nadal,6-3; 6-3; 6-1,R16,131,3,1,49,70,38,49,13,21,3,4,13,51,70,4,5,60,95,35,60,12,35,10,16,12,47,95
2008-06-23 00:00:00.000,Wimbledon Great Britain Grand Slams,GRASS,3,Roger Federer,Mario Ancic,Roger Federer,6-1; 7-5; 6-4,Q,102,15,0,49,71,43,49,18,22,0,0,15,61,71,9,2,58,95,41,58,17,37,6,10,14,58,95
2008-06-23 00:00:00.000,Wimbledon Great Britain Grand Slams,GRASS,3,Marat Safin,Feliciano Lopez,Marat Safin,3-6; 7-5; 7-6(1); 6-3,Q,160,18,3,69,122,53,69,31,53,5,8,20,84,122,17,6,74,127,57,74,22,53,3,8,22,79,127
2008-06-23 00:00:00.000,Wimbledon Great Britain Grand Slams,GRASS,3,Rainer Schuettler,Arnaud Clement,Rainer Schuettler,6-3; 5-7; 7-6(6); 6-7(7); 8-6,Q,312,13,7,116,202,79,116,46,86,8,15,30,125,202,9,5,118,214,74,118,52,96,11,19,29,126,214
2008-06-23 00:00:00.000,Wimbledon Great Britain Grand Slams,GRASS,3,Rafael Nadal,Andy Murray,Rafael Nadal,6-3; 6-2; 6-4,Q,115,4,1,41,66,36,41,20,25,0,0,14,56,66,5,2,46,91,31,46,18,45,6,10,13,49,91
2008-06-23 00:00:00.000,Wimbledon Great Britain Grand Slams,GRASS,3,Roger Federer,Marat Safin,Roger Federer,6-3; 7-6(3); 6-4,S,103,15,0,60,90,46,60,24,30,2,2,16,70,90,13,0,62,93,46,62,17,31,3,5,15,63,93
2008-06-23 00:00:00.000,Wimbledon Great Britain Grand Slams,GRASS,3,Rafael Nadal,Rainer Schuettler,Rafael Nadal,6-1; 7-6(3); 6-4,S,122,6,1,60,75,49,60,10,15,1,2,14,59,75,3,0,60,89,39,60,13,29,7,12,15,52,89
2008-06-23 00:00:00.000,Wimbledon Great Britain Grand Slams,GRASS,3,Rafael Nadal,Roger Federer,Rafael Nadal,6-4; 6-4; 6-7(5); 6-7(8); 9-7,F,288,6,3,160,218,111,160,34,58,12,13,30,145,218,25,2,127,195,92,127,39,68,9,13,30,131,195
2008-07-07 00:00:00.000,Bsstad Sweden ATP World Tour,CLAY,2,David Ferrer,N/A Bye,David Ferrer,,R32,0,0,0,0,0,0,0,0,0,0,0,0,0,0,0,0,0,0,0,0,0,0,0,0,0,0,0
2008-07-07 00:00:00.000,Bsstad Sweden ATP World Tour,CLAY,2,Boris Pashanski,Nicolas Massu,Boris Pashanski,6-2; 6-3,R32,82,1,0,38,59,29,38,12,21,4,4,9,41,59,1,2,19,46,13,19,11,27,3,6,8,24,46
2008-07-07 00:00:00.000,Bsstad Sweden ATP World Tour,CLAY,2,Olivier Rochus,Marc Gicquel,Olivier Rochus,6-3; 6-4,R32,71,3,3,35,67,23,35,21,32,8,9,10,44,67,9,0,37,55,26,37,5,18,4,7,9,31,55
2008-07-07 00:00:00.000,Bsstad Sweden ATP World Tour,CLAY,2,Robin Soderling,Fabio Fognini,Robin Soderling,6-1; 6-7(4); 7-5,R32,141,13,1,60,106,42,60,30,46,7,9,16,72,106,3,1,49,101,37,49,22,52,5,10,15,59,101
2008-07-07 00:00:00.000,Bsstad Sweden ATP World Tour,CLAY,2,Tommy Robredo,N/A Bye,Tommy Robredo,,R32,0,0,0,0,0,0,0,0,0,0,0,0,0,0,0,0,0,0,0,0,0,0,0,0,0,0,0
2008-07-07 00:00:00.000,Bsstad Sweden ATP World Tour,CLAY,2,Jonas Bjorkman,Marcel Granollers,Jonas Bjorkman,6-3; 6-1,R32,65,2,0,19,37,18,19,14,18,0,0,8,32,37,2,1,44,61,26,44,6,17,8,12,8,32,61
2008-07-07 00:00:00.000,Bsstad Sweden ATP World Tour,CLAY,2,Steve Darcis,Daniel Koellerer,Steve Darcis,7-6(4); 6-0,R32,67,4,1,53,57,39,53,3,4,1,2,9,42,57,1,2,51,60,26,51,5,9,1,5,9,31,60
2008-07-07 00:00:00.000,Bsstad Sweden ATP World Tour,CLAY,2,Jarkko Nieminen,Sergio Roitman,Jarkko Nieminen,6-4; 6-2,R32,70,0,1,48,67,36,48,10,19,5,5,9,46,67,2,2,42,65,33,42,4,23,6,9,9,37,65
2008-07-07 00:00:00.000,Bsstad Sweden ATP World Tour,CLAY,2,Potito Starace,Carlos Moya,Potito Starace,6-7(4); 7-6(6); 6-4,R32,178,1,2,91,125,57,91,22,34,6,8,17,79,125,5,4,72,119,49,72,29,47,6,9,17,78,119
2008-07-07 00:00:00.000,Bsstad Sweden ATP World Tour,CLAY,2,Marat Safin,Marc Lopez,Marat Safin,7-6(6); 7-5,R32,141,6,1,41,79,32,41,21,38,3,5,12,53,79,1,1,65,116,38,65,24,51,12,15,12,62,116
2008-07-07 00:00:00.000,Bsstad Sweden ATP World Tour,CLAY,2,Thomas Johansson,Filip Prpic,Thomas Johansson,7-6(4); 6-3,R32,97,8,2,43,75,31,43,19,32,2,3,11,50,75,5,6,46,75,33,46,13,29,6,8,10,46,75
2008-07-07 00:00:00.000,Bsstad Sweden ATP World Tour,CLAY,2,Tomas Berdych,N/A Bye,Tomas Berdych,,R32,0,0,0,0,0,0,0,0,0,0,0,0,0,0,0,0,0,0,0,0,0,0,0,0,0,0,0
2008-07-07 00:00:00.000,Bsstad Sweden ATP World Tour,CLAY,2,Michael Ryderstedt,Tim Goransson,Michael Ryderstedt,6-1; 6-2,R32,80,4,0,33,51,22,33,15,18,3,3,8,37,51,5,4,31,64,18,31,14,33,6,10,7,32,64
2008-07-07 00:00:00.000,Bsstad Sweden ATP World Tour,CLAY,2,Bjorn Rehnquist,Michal Przysiezny,Bjorn Rehnquist,7-5; 6-2,R32,93,1,2,32,56,22,32,15,24,5,7,10,37,56,1,5,39,72,22,39,14,33,5,10,10,36,72
2008-07-07 00:00:00.000,Bsstad Sweden ATP World Tour,CLAY,2,Ervin Eleskovic,Filippo Volandri,Ervin Eleskovic,6-4; 6-4,R32,91,9,1,41,66,32,41,11,25,6,7,10,43,66,0,0,61,79,37,61,7,18,8,11,10,44,79
2008-07-07 00:00:00.000,Bsstad Sweden ATP World Tour,CLAY,2,Fernando Verdasco,N/A Bye,Fernando Verdasco,,R32,0,0,0,0,0,0,0,0,0,0,0,0,0,0,0,0,0,0,0,0,0,0,0,0,0,0,0
2008-07-07 00:00:00.000,Bsstad Sweden ATP World Tour,CLAY,2,David Ferrer,Boris Pashanski,David Ferrer,7-5; 6-1,R16,86,1,3,29,51,20,29,15,22,1,3,10,35,51,2,7,40,75,24,40,12,35,6,11,9,36,75
2008-07-07 00:00:00.000,Bsstad Sweden ATP World Tour,CLAY,2,Robin Soderling,Olivier Rochus,Robin Soderling,6-3; 6-3,R16,72,11,2,30,55,26,30,13,25,4,4,9,39,55,4,1,39,56,25,39,8,17,5,8,9,33,56
2008-07-07 00:00:00.000,Bsstad Sweden ATP World Tour,CLAY,2,Tommy Robredo,Jonas Bjorkman,Tommy Robredo,6-2; 6-3,R16,67,2,1,27,39,21,27,9,12,0,1,8,30,39,0,3,37,57,26,37,3,20,6,11,9,29,57
2008-07-07 00:00:00.000,Bsstad Sweden ATP World Tour,CLAY,2,Jarkko Nieminen,Steve Darcis,Jarkko Nieminen,6-3; 6-1,R16,56,0,0,29,41,23,29,9,12,0,0,8,32,41,3,2,27,45,19,27,3,18,0,4,8,22,45
2008-07-07 00:00:00.000,Bsstad Sweden ATP World Tour,CLAY,2,Potito Starace,Marat Safin,Potito Starace,7-6(4); 3-6; 6-4,R16,131,2,0,74,101,47,74,19,27,3,5,16,66,101,11,4,54,90,45,54,17,36,3,4,15,62,90
2008-07-07 00:00:00.000,Bsstad Sweden ATP World Tour,CLAY,2,Tomas Berdych,Thomas Johansson,Tomas Berdych,7-6(2); 6-2,R16,76,12,0,39,55,34,39,13,16,1,1,10,47,55,4,1,51,71,33,51,9,20,4,6,10,42,71
2008-07-07 00:00:00.000,Bsstad Sweden ATP World Tour,CLAY,2,Bjorn Rehnquist,Michael Ryderstedt,Bjorn Rehnquist,6-3; 7-5,R16,110,2,3,37,64,26,37,16,27,1,4,11,42,64,0,3,37,66,21,37,12,29,8,13,10,33,66
2008-07-07 00:00:00.000,Bsstad Sweden ATP World Tour,CLAY,2,Fernando Verdasco,Ervin Eleskovic,Fernando Verdasco,6-0; 4-2 RET,R16,43,2,1,29,35,22,29,4,6,2,2,6,26,35,2,5,22,35,11,22,3,13,5,9,6,14,35
2008-07-07 00:00:00.000,Bsstad Sweden ATP World Tour,CLAY,2,David Ferrer,Robin Soderling,David Ferrer,7-5; 6-7(3); 6-1,Q,163,4,4,79,131,50,79,27,52,13,16,16,77,131,0,6,58,106,37,58,23,48,7,13,15,60,106
2008-07-07 00:00:00.000,Bsstad Sweden ATP World Tour,CLAY,2,Tommy Robredo,Jarkko Nieminen,Tommy Robredo,6-2; 7-6(4),Q,92,4,0,44,60,33,44,9,16,0,2,10,42,60,0,3,41,64,27,41,9,23,4,8,10,36,64
2008-07-07 00:00:00.000,Bsstad Sweden ATP World Tour,CLAY,2,Tomas Berdych,Potito Starace,Tomas Berdych,6-3; 6-2,Q,57,7,1,31,46,26,31,11,15,0,0,9,37,46,1,0,38,43,23,38,2,5,3,6,8,25,43
2008-07-07 00:00:00.000,Bsstad Sweden ATP World Tour,CLAY,2,Fernando Verdasco,Bjorn Rehnquist,Fernando Verdasco,2-6; 6-1; 6-0,Q,108,1,6,53,74,33,53,9,21,8,11,10,42,74,0,4,60,79,32,60,4,19,8,15,11,36,79
2008-07-07 00:00:00.000,Bsstad Sweden ATP World Tour,CLAY,2,Tommy Robredo,David Ferrer,Tommy Robredo,2-6; 6-1; 6-2,S,126,1,0,63,85,40,63,11,22,5,7,12,51,85,0,1,44,69,28,44,11,25,7,11,11,39,69
2008-07-07 00:00:00.000,Bsstad Sweden ATP World Tour,CLAY,2,Tomas Berdych,Fernando Verdasco,Tomas Berdych,2-6; 6-3; 6-2,S,113,8,4,61,91,43,61,14,30,5,7,13,57,91,4,10,54,81,42,54,7,27,3,6,12,49,81
2008-07-07 00:00:00.000,Bsstad Sweden ATP World Tour,CLAY,2,Tommy Robredo,Tomas Berdych,Tommy Robredo,6-4; 6-1,F,74,4,1,45,55,30,45,5,10,4,5,8,35,55,2,1,30,47,17,30,5,17,2,7,9,22,47
2008-07-07 00:00:00.000,Gstaad Switzerland ATP World Tour,CLAY,2,Stanislas Wawrinka,N/A Bye,Stanislas Wawrinka,,R32,0,0,0,0,0,0,0,0,0,0,0,0,0,0,0,0,0,0,0,0,0,0,0,0,0,0,0
2008-07-07 00:00:00.000,Gstaad Switzerland ATP World Tour,CLAY,2,Stephane Bohli,Robin Roshardt,Stephane Bohli,6-2; 4-6; 6-4,R32,106,9,2,40,75,32,40,18,35,1,4,14,50,75,1,4,36,94,25,36,29,58,6,11,14,54,94
2008-07-07 00:00:00.000,Gstaad Switzerland ATP World Tour,CLAY,2,Kristof Vliegen,Martin Vassallo Arguello,Kristof Vliegen,6-3; 6-4,R32,83,5,2,37,64,29,37,17,27,1,1,10,46,64,3,2,43,68,29,43,12,25,8,10,9,41,68
2008-07-07 00:00:00.000,Gstaad Switzerland ATP World Tour,CLAY,2,Guillermo Canas,Ivo Minar,Guillermo Canas,7-6(9); 6-3,R32,105,4,4,43,88,32,43,24,45,1,2,11,56,88,2,3,44,80,27,44,23,36,5,7,10,50,80
2008-07-07 00:00:00.000,Gstaad Switzerland ATP World Tour,CLAY,2,Ivo Karlovic,N/A Bye,Ivo Karlovic,,R32,0,0,0,0,0,0,0,0,0,0,0,0,0,0,0,0,0,0,0,0,0,0,0,0,0,0,0
2008-07-07 00:00:00.000,Gstaad Switzerland ATP World Tour,CLAY,2,Victor Hanescu,Olivier Patience,Victor Hanescu,7-6(4); 6-2,R32,76,3,1,41,63,31,41,16,22,1,1,10,47,63,2,1,35,62,23,35,16,27,2,4,10,39,62
2008-07-07 00:00:00.000,Gstaad Switzerland ATP World Tour,CLAY,2,Jeremy Chardy,Luis Horna,Jeremy Chardy,7-6(5); 6-7(6); 7-5,R32,151,22,10,73,128,61,73,26,55,6,7,18,87,128,7,4,78,120,57,78,26,42,6,8,18,83,120
2008-07-07 00:00:00.000,Gstaad Switzerland ATP World Tour,CLAY,2,Dominik Meffert,Andreas Seppi,Dominik Meffert,6-2; 5-7; 6-4,R32,137,8,6,73,111,49,73,17,38,10,13,15,66,111,7,10,51,110,35,51,26,59,9,14,15,61,110
2008-07-07 00:00:00.000,Gstaad Switzerland ATP World Tour,CLAY,2,Nicolas Kiefer,Gianluca Naso,Nicolas Kiefer,6-3; 6-2,R32,78,7,2,27,57,22,27,17,30,2,3,9,39,57,4,1,27,53,18,27,7,26,5,9,8,25,53
2008-07-07 00:00:00.000,Gstaad Switzerland ATP World Tour,CLAY,2,Guillermo Garcia-Lopez,Michael Lammer,Guillermo Garcia-Lopez,5-7; 6-3; 6-2,R32,146,5,6,69,106,46,69,18,37,4,7,15,64,106,5,2,53,93,35,53,16,40,9,14,14,51,93
2008-07-07 00:00:00.000,Gstaad Switzerland ATP World Tour,CLAY,2,Flavio Cipolla,Jiri Vanek,Flavio Cipolla,5-7; 6-4; 6-4,R32,149,1,2,70,103,45,70,15,33,7,11,16,60,103,5,3,66,111,47,66,17,45,13,18,16,64,111
2008-07-07 00:00:00.000,Gstaad Switzerland ATP World Tour,CLAY,2,Mikhail Youzhny,N/A Bye,Mikhail Youzhny,,R32,0,0,0,0,0,0,0,0,0,0,0,0,0,0,0,0,0,0,0,0,0,0,0,0,0,0,0
2008-07-07 00:00:00.000,Gstaad Switzerland ATP World Tour,CLAY,2,Igor Andreev,Marcos Daniel,Igor Andreev,6-4; 7-5,R32,84,6,5,41,65,36,41,12,24,5,5,11,48,65,6,1,43,72,32,43,13,29,2,4,11,45,72
2008-07-07 00:00:00.000,Gstaad Switzerland ATP World Tour,CLAY,2,Florent Serra,Daniel Gimeno-Traver,Florent Serra,7-6(2); 7-6(5),R32,103,1,2,48,83,35,48,19,35,4,6,12,54,83,10,4,43,86,29,43,22,43,6,8,12,51,86
2008-07-07 00:00:00.000,Gstaad Switzerland ATP World Tour,CLAY,2,Marin Cilic,Josselin Ouanna,Marin Cilic,6-3; 6-4,R32,67,13,3,27,54,24,27,18,27,1,1,10,42,54,4,2,32,66,21,32,18,34,3,5,9,39,66
2008-07-07 00:00:00.000,Gstaad Switzerland ATP World Tour,CLAY,2,Paul-Henri Mathieu,N/A Bye,Paul-Henri Mathieu,,R32,0,0,0,0,0,0,0,0,0,0,0,0,0,0,0,0,0,0,0,0,0,0,0,0,0,0,0
2008-07-07 00:00:00.000,Gstaad Switzerland ATP World Tour,CLAY,2,Stanislas Wawrinka,Stephane Bohli,Stanislas Wawrinka,7-6(6); 5-7; 7-6(3),R16,165,13,5,68,111,54,68,26,43,3,4,18,80,111,4,6,61,123,45,61,38,62,3,3,18,83,123
2008-07-07 00:00:00.000,Gstaad Switzerland ATP World Tour,CLAY,2,Guillermo Canas,Kristof Vliegen,Guillermo Canas,W/O,R16,0,0,0,0,0,0,0,0,0,0,0,0,0,0,0,0,0,0,0,0,0,0,0,0,0,0,0
2008-07-07 00:00:00.000,Gstaad Switzerland ATP World Tour,CLAY,2,Victor Hanescu,Ivo Karlovic,Victor Hanescu,6-7(4); 7-6(3); 7-6(11),R16,152,9,0,81,114,68,81,26,33,1,1,18,94,114,28,4,89,131,78,89,20,42,4,4,18,98,131
2008-07-07 00:00:00.000,Gstaad Switzerland ATP World Tour,CLAY,2,Jeremy Chardy,Dominik Meffert,Jeremy Chardy,6-7(1); 7-6(5); 7-6(4),R16,166,19,9,65,130,58,65,31,65,6,8,18,89,130,6,9,69,123,50,69,34,54,4,6,18,84,123
2008-07-07 00:00:00.000,Gstaad Switzerland ATP World Tour,CLAY,2,Guillermo Garcia-Lopez,Nicolas Kiefer,Guillermo Garcia-Lopez,W/O,R16,0,0,0,0,0,0,0,0,0,0,0,0,0,0,0,0,0,0,0,0,0,0,0,0,0,0,0
2008-07-07 00:00:00.000,Gstaad Switzerland ATP World Tour,CLAY,2,Mikhail Youzhny,Flavio Cipolla,Mikhail Youzhny,6-3; 6-2,R16,92,6,8,52,89,37,52,16,37,12,13,9,53,89,0,5,37,58,20,37,8,21,7,11,8,28,58
2008-07-07 00:00:00.000,Gstaad Switzerland ATP World Tour,CLAY,2,Igor Andreev,Florent Serra,Igor Andreev,7-5; 6-4,R16,70,12,5,30,57,26,30,17,27,3,4,11,43,57,2,4,38,69,27,38,14,31,0,3,11,41,69
2008-07-07 00:00:00.000,Gstaad Switzerland ATP World Tour,CLAY,2,Marin Cilic,Paul-Henri Mathieu,Marin Cilic,6-3; 6-4,R16,84,11,4,23,53,21,23,20,30,3,3,10,41,53,3,3,29,70,19,29,23,41,8,10,9,42,70
2008-07-07 00:00:00.000,Gstaad Switzerland ATP World Tour,CLAY,2,Stanislas Wawrinka,Guillermo Canas,Stanislas Wawrinka,4-6; 6-4; 7-6(2),Q,152,6,6,60,91,44,60,16,31,2,6,16,60,91,17,4,61,113,43,61,23,52,8,12,16,66,113
2008-07-07 00:00:00.000,Gstaad Switzerland ATP World Tour,CLAY,2,Victor Hanescu,Jeremy Chardy,Victor Hanescu,6-3; 7-6(3),Q,77,4,1,46,61,38,46,12,15,3,3,11,50,61,2,2,33,57,25,33,16,24,1,2,10,41,57
2008-07-07 00:00:00.000,Gstaad Switzerland ATP World Tour,CLAY,2,Guillermo Garcia-Lopez,Mikhail Youzhny,Guillermo Garcia-Lopez,4-6; 7-5; 6-3,Q,128,4,4,54,98,41,54,24,44,7,9,16,65,98,7,2,42,84,31,42,26,42,4,7,15,57,84
2008-07-07 00:00:00.000,Gstaad Switzerland ATP World Tour,CLAY,2,Igor Andreev,Marin Cilic,Igor Andreev,7-6(4); 6-3,Q,85,6,4,51,79,41,51,14,28,4,4,11,55,79,12,6,32,64,24,32,18,32,2,3,10,42,64
2008-07-07 00:00:00.000,Gstaad Switzerland ATP World Tour,CLAY,2,Victor Hanescu,Stanislas Wawrinka,Victor Hanescu,6-3; 3-6; 6-4,S,124,12,2,52,80,38,52,14,28,2,4,14,52,80,6,1,61,97,40,61,20,36,8,11,14,60,97
2008-07-07 00:00:00.000,Gstaad Switzerland ATP World Tour,CLAY,2,Igor Andreev,Guillermo Garcia-Lopez,Igor Andreev,7-6(2); 5-7; 7-6(5),S,182,8,3,66,106,55,66,25,40,3,4,18,80,106,3,7,69,129,52,69,33,60,7,7,18,85,129
2008-07-07 00:00:00.000,Gstaad Switzerland ATP World Tour,CLAY,2,Victor Hanescu,Igor Andreev,Victor Hanescu,6-3; 6-4,F,70,1,1,37,52,29,37,11,15,0,0,10,40,52,2,0,38,57,26,38,11,19,3,5,9,37,57
2008-07-07 00:00:00.000,Newport RI; U.S.A. ATP World Tour,GRASS,2,Mardy Fish,N/A Bye,Mardy Fish,,R32,0,0,0,0,0,0,0,0,0,0,0,0,0,0,0,0,0,0,0,0,0,0,0,0,0,0,0
2008-07-07 00:00:00.000,Newport RI; U.S.A. ATP World Tour,GRASS,2,Rohan Bopanna,Kevin Kim,Rohan Bopanna,6-3; 6-4,R32,72,15,7,37,79,28,37,20,42,8,9,10,48,79,1,9,19,65,13,19,24,46,7,10,9,37,65
2008-07-07 00:00:00.000,Newport RI; U.S.A. ATP World Tour,GRASS,2,Prakash Amritraj,Joseph Sirianni,Prakash Amritraj,6-7(3); 6-4; 6-4,R32,120,4,6,55,96,45,55,24,41,3,3,16,69,96,6,6,52,98,40,52,28,46,5,7,16,68,98
2008-07-07 00:00:00.000,Newport RI; U.S.A. ATP World Tour,GRASS,2,Jesse Levine,John Isner,Jesse Levine,6-3; 6-1,R32,54,1,4,27,44,14,27,7,17,1,5,8,21,44,7,4,30,49,24,30,10,19,0,0,8,34,49
2008-07-07 00:00:00.000,Newport RI; U.S.A. ATP World Tour,GRASS,2,Igor Kunitsyn,N/A Bye,Igor Kunitsyn,,R32,0,0,0,0,0,0,0,0,0,0,0,0,0,0,0,0,0,0,0,0,0,0,0,0,0,0,0
2008-07-07 00:00:00.000,Newport RI; U.S.A. ATP World Tour,GRASS,2,Mikhail Ledovskikh,Kristian Pless,Mikhail Ledovskikh,4-6; 7-5; 6-4,R32,103,7,8,53,98,37,53,17,45,4,11,16,54,98,4,22,51,98,39,51,9,47,9,17,16,48,98
2008-07-07 00:00:00.000,Newport RI; U.S.A. ATP World Tour,GRASS,2,Brendan Evans,Paul Capdeville,Brendan Evans,6-4; 3-6; 6-1,R32,94,7,6,66,97,41,66,19,31,10,12,13,60,97,9,4,39,75,25,39,22,36,4,8,13,47,75
2008-07-07 00:00:00.000,Newport RI; U.S.A. ATP World Tour,GRASS,2,Frank Dancevic,Taylor Dent,Frank Dancevic,3-6; 7-5; 6-1,R32,101,6,9,56,95,43,56,16,39,8,11,14,59,95,8,11,51,89,35,51,17,38,6,11,14,52,89
2008-07-07 00:00:00.000,Newport RI; U.S.A. ATP World Tour,GRASS,2,Donald Young,Woong-Sun Jun,Donald Young,6-3; 2-6; 6-4,R32,98,3,7,50,93,37,50,22,43,6,8,14,59,93,3,5,44,78,37,44,16,34,1,3,13,53,78
2008-07-07 00:00:00.000,Newport RI; U.S.A. ATP World Tour,GRASS,2,Alexander Peya,Philipp Petzschner,Alexander Peya,6-7(3); 6-3; 7-5,R32,120,2,1,80,105,54,80,13,25,7,9,16,67,105,1,7,60,110,38,60,28,50,8,13,17,66,110
2008-07-07 00:00:00.000,Newport RI; U.S.A. ATP World Tour,GRASS,2,Vincent Spadea,Simon Stadler,Vincent Spadea,6-2; 3-6; 6-4,R32,89,3,4,47,76,32,47,12,29,2,7,14,44,76,1,3,54,82,31,54,12,28,4,10,13,43,82
2008-07-07 00:00:00.000,Newport RI; U.S.A. ATP World Tour,GRASS,2,Nicolas Mahut,N/A Bye,Nicolas Mahut,,R32,0,0,0,0,0,0,0,0,0,0,0,0,0,0,0,0,0,0,0,0,0,0,0,0,0,0,0
2008-07-07 00:00:00.000,Newport RI; U.S.A. ATP World Tour,GRASS,2,Kevin Anderson,Gilles Muller,Kevin Anderson,6-7(3); 6-3; 6-3,R32,123,11,4,49,84,40,49,22,35,3,4,15,62,84,14,6,55,110,41,55,25,55,7,11,15,66,110
2008-07-07 00:00:00.000,Newport RI; U.S.A. ATP World Tour,GRASS,2,Ivan Navarro,Rik De Voest,Ivan Navarro,7-5; 6-4,R32,78,2,4,34,57,28,34,15,23,0,1,11,43,57,0,2,42,67,25,42,14,25,3,6,11,39,67
2008-07-07 00:00:00.000,Newport RI; U.S.A. ATP World Tour,GRASS,2,Aisam-Ul-Haq Qureshi,Benjamin Becker,Aisam-Ul-Haq Qureshi,7-5; 7-6(5),R32,91,7,4,43,72,39,43,17,29,2,2,12,56,72,14,5,37,73,32,37,21,36,2,3,12,53,73
2008-07-07 00:00:00.000,Newport RI; U.S.A. ATP World Tour,GRASS,2,Fabrice Santoro,N/A Bye,Fabrice Santoro,,R32,0,0,0,0,0,0,0,0,0,0,0,0,0,0,0,0,0,0,0,0,0,0,0,0,0,0,0
2008-07-07 00:00:00.000,Newport RI; U.S.A. ATP World Tour,GRASS,2,Rohan Bopanna,Mardy Fish,Rohan Bopanna,7-6(6); 7-5,R16,93,14,5,45,88,38,45,19,43,7,9,12,57,88,8,3,32,71,27,32,20,39,1,4,12,47,71
2008-07-07 00:00:00.000,Newport RI; U.S.A. ATP World Tour,GRASS,2,Prakash Amritraj,Jesse Levine,Prakash Amritraj,7-5; 6-3,R16,90,5,2,32,55,27,32,13,23,1,2,10,40,55,8,10,43,87,27,43,21,44,12,16,11,48,87
2008-07-07 00:00:00.000,Newport RI; U.S.A. ATP World Tour,GRASS,2,Igor Kunitsyn,Mikhail Ledovskikh,Igor Kunitsyn,6-1; 6-1,R16,50,0,1,22,39,18,22,9,17,0,1,7,27,39,3,5,26,47,13,26,5,21,3,9,7,18,47
2008-07-07 00:00:00.000,Newport RI; U.S.A. ATP World Tour,GRASS,2,Frank Dancevic,Brendan Evans,Frank Dancevic,5-7; 6-4; 7-6(3),R16,126,16,3,73,123,52,73,31,50,10,11,17,83,123,5,5,71,105,54,71,19,34,11,12,17,73,105
2008-07-07 00:00:00.000,Newport RI; U.S.A. ATP World Tour,GRASS,2,Alexander Peya,Donald Young,Alexander Peya,7-6(4); 6-3,R16,72,2,2,50,73,39,50,15,23,2,2,11,54,73,4,4,38,68,30,38,15,30,4,5,10,45,68
2008-07-07 00:00:00.000,Newport RI; U.S.A. ATP World Tour,GRASS,2,Vincent Spadea,Nicolas Mahut,Vincent Spadea,6-2; 6-3,R16,61,4,1,28,52,23,28,15,24,1,1,9,38,52,0,3,27,48,17,27,12,21,4,7,8,29,48
2008-07-07 00:00:00.000,Newport RI; U.S.A. ATP World Tour,GRASS,2,Ivan Navarro,Kevin Anderson,Ivan Navarro,7-6(3); 3-6; 6-4,R16,135,9,2,66,113,47,66,27,47,5,7,16,74,113,9,2,60,92,44,60,21,32,3,4,15,65,92
2008-07-07 00:00:00.000,Newport RI; U.S.A. ATP World Tour,GRASS,2,Fabrice Santoro,Aisam-Ul-Haq Qureshi,Fabrice Santoro,7-6(4); 6-2,R16,85,3,1,31,53,26,31,17,22,0,0,10,43,53,2,3,40,70,29,40,12,30,4,6,10,41,70
2008-07-07 00:00:00.000,Newport RI; U.S.A. ATP World Tour,GRASS,2,Prakash Amritraj,Rohan Bopanna,Prakash Amritraj,6-4; 6-3,Q,60,9,0,29,50,27,29,14,21,0,0,10,41,50,9,6,27,49,23,27,8,22,3,5,9,31,49
2008-07-07 00:00:00.000,Newport RI; U.S.A. ATP World Tour,GRASS,2,Frank Dancevic,Igor Kunitsyn,Frank Dancevic,7-5; 6-3,Q,78,6,2,50,82,37,50,18,32,6,6,11,55,82,2,5,30,62,22,30,18,32,4,6,10,40,62
2008-07-07 00:00:00.000,Newport RI; U.S.A. ATP World Tour,GRASS,2,Vincent Spadea,Alexander Peya,Vincent Spadea,7-6(3); 7-5,Q,105,4,1,47,83,40,47,15,36,4,6,12,55,83,5,4,47,83,39,47,12,36,5,8,12,51,83
2008-07-07 00:00:00.000,Newport RI; U.S.A. ATP World Tour,GRASS,2,Fabrice Santoro,Ivan Navarro,Fabrice Santoro,6-3; 7-6(4),Q,110,2,1,43,72,27,43,20,29,1,2,11,47,72,5,3,51,89,31,51,19,38,7,9,10,50,89
2008-07-07 00:00:00.000,Newport RI; U.S.A. ATP World Tour,GRASS,2,Prakash Amritraj,Frank Dancevic,Prakash Amritraj,7-6(4); 4-6; 6-3,S,139,7,4,65,103,51,65,22,38,2,3,16,73,103,13,1,79,116,58,79,21,37,13,14,15,79,116
2008-07-07 00:00:00.000,Newport RI; U.S.A. ATP World Tour,GRASS,2,Fabrice Santoro,Vincent Spadea,Fabrice Santoro,7-6(4); 6-1,S,78,2,1,46,65,37,46,9,19,3,4,10,46,65,2,1,36,57,25,36,9,21,1,4,9,34,57
2008-07-07 00:00:00.000,Newport RI; U.S.A. ATP World Tour,GRASS,2,Fabrice Santoro,Prakash Amritraj,Fabrice Santoro,6-3; 7-5,F,75,2,0,38,54,29,38,13,16,0,1,11,42,54,4,3,32,56,19,32,17,24,2,5,10,36,56
2008-07-07 00:00:00.000,Stuttgart Germany ATP World Tour,CLAY,2,Jan Hernych,N/A Bye,Jan Hernych,,R32,0,0,0,0,0,0,0,0,0,0,0,0,0,0,0,0,0,0,0,0,0,0,0,0,0,0,0
2008-07-07 00:00:00.000,Stuttgart Germany ATP World Tour,CLAY,2,Brian Dabul,Denis Gremelmayr,Brian Dabul,6-3; 5-7; 6-3,R32,152,3,2,75,102,43,75,16,27,6,10,15,59,102,2,4,73,116,41,73,20,43,13,19,15,61,116
2008-07-07 00:00:00.000,Stuttgart Germany ATP World Tour,CLAY,2,Andreas Beck,Daniel Brands,Andreas Beck,3-6; 6-3; 6-4,R32,117,4,2,64,102,46,64,20,38,4,5,14,66,102,13,5,72,94,55,72,6,22,7,9,14,61,94
2008-07-07 00:00:00.000,Stuttgart Germany ATP World Tour,CLAY,2,Eduardo Schwank,Guillermo Coria,Eduardo Schwank,0-6; 6-1; 6-2,R32,116,5,1,51,71,30,51,9,20,2,6,10,39,71,0,19,37,72,21,37,12,35,2,8,11,33,72
2008-07-07 00:00:00.000,Stuttgart Germany ATP World Tour,CLAY,2,Philipp Kohlschreiber,N/A Bye,Philipp Kohlschreiber,,R32,0,0,0,0,0,0,0,0,0,0,0,0,0,0,0,0,0,0,0,0,0,0,0,0,0,0,0
2008-07-07 00:00:00.000,Stuttgart Germany ATP World Tour,CLAY,2,Yuri Schukin,Carlos Berlocq,Yuri Schukin,4-6; 7-5; 6-3,R32,162,0,2,68,94,36,68,14,26,6,12,15,50,94,4,1,77,115,45,77,17,38,5,13,16,62,115
2008-07-07 00:00:00.000,Stuttgart Germany ATP World Tour,CLAY,2,Juan Martin Del Potro,Evgeny Korolev,Juan Martin Del Potro,6-3; 7-5,R32,93,5,5,33,61,24,33,18,28,1,3,11,42,61,2,6,34,58,22,34,10,24,6,10,10,32,58
2008-07-07 00:00:00.000,Stuttgart Germany ATP World Tour,CLAY,2,Simone Bolelli,Mischa Zverev,Simone Bolelli,6-7(6); 6-4; 6-2,R32,152,3,1,81,108,61,81,13,27,4,4,15,74,108,7,1,66,104,46,66,18,38,5,8,15,64,104
2008-07-07 00:00:00.000,Stuttgart Germany ATP World Tour,CLAY,2,Agustin Calleri,Jurgen Melzer,Agustin Calleri,7-6(3); 6-4,R32,84,8,5,33,65,26,33,19,32,2,4,11,45,65,5,2,47,71,29,47,13,24,4,7,11,42,71
2008-07-07 00:00:00.000,Stuttgart Germany ATP World Tour,CLAY,2,Pablo Cuevas,Santiago Giraldo,Pablo Cuevas,4-6; 6-4; 7-6(11),R32,158,9,7,63,130,42,63,29,67,7,13,16,71,130,11,5,60,109,40,60,25,49,7,13,16,65,109
2008-07-07 00:00:00.000,Stuttgart Germany ATP World Tour,CLAY,2,Michael Berrer,Eric Prodon,Michael Berrer,6-3; 6-4,R32,70,12,11,38,69,32,38,11,31,10,12,10,43,69,4,3,30,47,20,30,5,17,2,6,9,25,47
2008-07-07 00:00:00.000,Stuttgart Germany ATP World Tour,CLAY,2,Nicolas Almagro,N/A Bye,Nicolas Almagro,,R32,0,0,0,0,0,0,0,0,0,0,0,0,0,0,0,0,0,0,0,0,0,0,0,0,0,0,0
2008-07-07 00:00:00.000,Stuttgart Germany ATP World Tour,CLAY,2,Albert Montanes,Jose Acasuso,Albert Montanes,6-3; 7-6(5),R32,94,6,4,35,70,27,35,22,35,0,1,11,49,70,2,6,38,64,28,38,11,26,3,5,10,39,64
2008-07-07 00:00:00.000,Stuttgart Germany ATP World Tour,CLAY,2,Oscar Hernandez,Santiago Ventura,Oscar Hernandez,6-1; 6-4,R32,85,3,2,39,53,28,39,8,14,1,2,9,36,53,3,5,34,70,21,34,13,36,12,16,8,34,70
2008-07-07 00:00:00.000,Stuttgart Germany ATP World Tour,CLAY,2,Lukas Rosol,Martin Fischer,Lukas Rosol,6-2; 6-4,R32,66,3,4,30,54,23,30,11,24,2,4,9,34,54,4,3,28,50,16,28,9,22,1,6,9,25,50
2008-07-07 00:00:00.000,Stuttgart Germany ATP World Tour,CLAY,2,Richard Gasquet,N/A Bye,Richard Gasquet,,R32,0,0,0,0,0,0,0,0,0,0,0,0,0,0,0,0,0,0,0,0,0,0,0,0,0,0,0
2008-07-07 00:00:00.000,Stuttgart Germany ATP World Tour,CLAY,2,Jan Hernych,Brian Dabul,Jan Hernych,7-6(5); 0-6; 7-6(5),R16,150,7,1,73,100,48,73,15,27,4,8,15,63,100,6,1,62,101,44,62,25,39,5,6,15,69,101
2008-07-07 00:00:00.000,Stuttgart Germany ATP World Tour,CLAY,2,Eduardo Schwank,Andreas Beck,Eduardo Schwank,7-6(5); 6-2,R16,93,11,1,45,67,39,45,11,22,1,1,10,50,67,7,5,39,69,30,39,11,30,2,4,10,41,69
2008-07-07 00:00:00.000,Stuttgart Germany ATP World Tour,CLAY,2,Philipp Kohlschreiber,Yuri Schukin,Philipp Kohlschreiber,6-3; 6-3,R16,81,4,4,30,52,22,30,12,22,1,2,9,34,52,3,3,44,72,23,44,13,28,5,9,9,36,72
2008-07-07 00:00:00.000,Stuttgart Germany ATP World Tour,CLAY,2,Juan Martin Del Potro,Simone Bolelli,Juan Martin Del Potro,6-3; 3-6; 6-3,R16,121,4,6,36,76,32,36,20,40,0,2,14,52,76,7,4,64,95,46,64,13,31,10,13,13,59,95
2008-07-07 00:00:00.000,Stuttgart Germany ATP World Tour,CLAY,2,Agustin Calleri,Pablo Cuevas,Agustin Calleri,5-7; 7-5; 6-1,R16,108,10,3,52,88,42,52,18,36,3,5,15,60,88,7,3,55,95,37,55,21,40,3,8,16,58,95
2008-07-07 00:00:00.000,Stuttgart Germany ATP World Tour,CLAY,2,Michael Berrer,Nicolas Almagro,Michael Berrer,7-5 RET,R16,44,0,0,14,28,12,14,12,14,0,0,6,24,28,6,2,21,37,17,21,10,16,1,2,6,27,37
2008-07-07 00:00:00.000,Stuttgart Germany ATP World Tour,CLAY,2,Albert Montanes,Oscar Hernandez,Albert Montanes,7-6(4); 6-4,R16,113,8,1,34,64,27,34,20,30,1,2,11,47,64,1,2,55,80,36,55,12,25,4,6,11,48,80
2008-07-07 00:00:00.000,Stuttgart Germany ATP World Tour,CLAY,2,Richard Gasquet,Lukas Rosol,Richard Gasquet,6-7(7); 6-2; 6-2,R16,112,12,2,54,88,40,54,15,34,3,6,14,55,88,3,5,42,94,27,42,22,52,3,10,14,49,94
2008-07-07 00:00:00.000,Stuttgart Germany ATP World Tour,CLAY,2,Eduardo Schwank,Jan Hernych,Eduardo Schwank,6-0; 4-6; 6-3,Q,115,1,2,48,78,37,48,15,30,5,7,13,52,78,4,1,59,91,34,59,15,32,10,15,12,49,91
2008-07-07 00:00:00.000,Stuttgart Germany ATP World Tour,CLAY,2,Juan Martin Del Potro,Philipp Kohlschreiber,Juan Martin Del Potro,7-6(3); 6-3,Q,132,9,2,31,66,28,31,24,35,4,4,11,52,66,4,2,34,59,28,34,14,25,0,1,10,42,59
2008-07-07 00:00:00.000,Stuttgart Germany ATP World Tour,CLAY,2,Agustin Calleri,Michael Berrer,Agustin Calleri,6-4; 6-2,Q,66,9,4,29,45,28,29,8,16,0,0,9,36,45,3,5,40,65,27,40,10,25,4,7,9,37,65
2008-07-07 00:00:00.000,Stuttgart Germany ATP World Tour,CLAY,2,Richard Gasquet,Albert Montanes,Richard Gasquet,6-3; 7-6(5),Q,96,7,4,38,73,27,38,23,35,7,8,10,50,73,3,7,39,75,29,39,15,36,3,6,11,44,75
2008-07-07 00:00:00.000,Stuttgart Germany ATP World Tour,CLAY,2,Juan Martin Del Potro,Eduardo Schwank,Juan Martin Del Potro,6-2; 6-4,S,87,4,3,34,56,25,34,14,22,0,0,9,39,56,0,4,34,60,25,34,10,26,2,5,9,35,60
2008-07-07 00:00:00.000,Stuttgart Germany ATP World Tour,CLAY,2,Richard Gasquet,Agustin Calleri,Richard Gasquet,6-7(3); 6-2; 6-3,S,125,10,0,48,85,38,48,23,37,3,4,14,61,85,10,4,62,107,38,62,23,45,11,16,15,61,107
2008-07-07 00:00:00.000,Stuttgart Germany ATP World Tour,CLAY,2,Juan Martin Del Potro,Richard Gasquet,Juan Martin Del Potro,6-4; 7-5,F,95,2,1,31,53,22,31,17,22,0,2,11,39,53,5,1,39,69,26,39,14,30,2,6,11,40,69
2008-07-14 00:00:00.000,Amersfoort The Netherlands ATP World Tour,CLAY,2,Marc Gicquel,N/A Bye,Marc Gicquel,,R32,0,0,0,0,0,0,0,0,0,0,0,0,0,0,0,0,0,0,0,0,0,0,0,0,0,0,0
2008-07-14 00:00:00.000,Amersfoort The Netherlands ATP World Tour,CLAY,2,Thiemo de Bakker,Adrian Cruciat,Thiemo de Bakker,7-5; 6-4,R32,84,10,1,34,66,24,34,22,32,4,5,11,46,66,6,2,45,69,33,45,8,24,5,8,11,41,69
2008-07-14 00:00:00.000,Amersfoort The Netherlands ATP World Tour,CLAY,2,Teymuraz Gabashvili,Thierry Ascione,Teymuraz Gabashvili,6-2; 7-6(1),R32,87,7,1,40,62,30,40,14,22,1,2,10,44,62,6,0,39,69,24,39,14,30,5,8,10,38,69
2008-07-14 00:00:00.000,Amersfoort The Netherlands ATP World Tour,CLAY,2,Martin Vassallo Arguello,Alberto Brizzi,Martin Vassallo Arguello,6-4; 6-3,R32,97,3,2,51,77,36,51,12,26,12,13,10,48,77,0,5,51,70,33,51,6,19,7,10,9,39,70
2008-07-14 00:00:00.000,Amersfoort The Netherlands ATP World Tour,CLAY,2,Steve Darcis,N/A Bye,Steve Darcis,,R32,0,0,0,0,0,0,0,0,0,0,0,0,0,0,0,0,0,0,0,0,0,0,0,0,0,0,0
2008-07-14 00:00:00.000,Amersfoort The Netherlands ATP World Tour,CLAY,2,Alberto Martin,Yuri Schukin,Alberto Martin,7-6(8); 6-4,R32,103,7,6,41,71,33,41,12,30,1,4,11,45,71,0,4,52,83,28,52,16,31,7,11,11,44,83
2008-07-14 00:00:00.000,Amersfoort The Netherlands ATP World Tour,CLAY,2,Christophe Rochus,David Marrero,Christophe Rochus,7-5; 6-2,R32,87,5,2,39,68,28,39,16,29,6,8,10,44,68,8,2,42,65,24,42,9,23,6,11,10,33,65
2008-07-14 00:00:00.000,Amersfoort The Netherlands ATP World Tour,CLAY,2,Philipp Petzschner,Florent Serra,Philipp Petzschner,2-6; 6-4; 6-4,R32,96,6,3,49,82,37,49,16,33,5,8,14,53,82,2,2,58,85,44,58,9,27,4,7,14,53,85
2008-07-14 00:00:00.000,Amersfoort The Netherlands ATP World Tour,CLAY,2,Jesse Huta Galung,Santiago Ventura,Jesse Huta Galung,6-1; 1-0 RET,R32,36,2,1,17,32,14,17,8,15,0,0,4,22,32,0,0,21,28,8,21,3,7,1,4,4,11,28
2008-07-14 00:00:00.000,Amersfoort The Netherlands ATP World Tour,CLAY,2,Oscar Hernandez,Denis Matsukevich,Oscar Hernandez,6-1; 6-3,R32,73,2,0,32,41,21,32,7,9,0,1,8,28,41,0,2,36,59,16,36,12,23,3,8,8,28,59
2008-07-14 00:00:00.000,Amersfoort The Netherlands ATP World Tour,CLAY,2,Ivan Navarro,Igor Sijsling,Ivan Navarro,6-3; 6-1,R32,59,6,2,27,41,24,27,8,14,0,0,8,32,41,2,2,21,44,13,21,8,23,0,4,8,21,44
2008-07-14 00:00:00.000,Amersfoort The Netherlands ATP World Tour,CLAY,2,Marcel Granollers,N/A Bye,Marcel Granollers,,R32,0,0,0,0,0,0,0,0,0,0,0,0,0,0,0,0,0,0,0,0,0,0,0,0,0,0,0
2008-07-14 00:00:00.000,Amersfoort The Netherlands ATP World Tour,CLAY,2,Albert Montanes,Kristof Vliegen,Albert Montanes,6-4; 6-2,R32,57,7,4,36,55,27,36,7,19,6,9,9,34,55,0,2,42,61,18,42,9,19,5,11,9,27,61
2008-07-14 00:00:00.000,Amersfoort The Netherlands ATP World Tour,CLAY,2,Pablo Cuevas,Werner Eschauer,Pablo Cuevas,7-5; 6-2,R32,91,3,0,42,69,30,42,17,27,4,5,10,47,69,1,2,32,61,21,32,14,29,4,8,10,35,61
2008-07-14 00:00:00.000,Amersfoort The Netherlands ATP World Tour,CLAY,2,Edouard Roger-Vasselin,Martin Verkerk,Edouard Roger-Vasselin,2-6; 7-6(9); 4-3 RET,R32,124,7,5,57,91,42,57,16,34,7,10,13,58,91,10,2,55,84,39,55,17,29,0,2,14,56,84
2008-07-14 00:00:00.000,Amersfoort The Netherlands ATP World Tour,CLAY,2,Jose Acasuso,N/A Bye,Jose Acasuso,,R32,0,0,0,0,0,0,0,0,0,0,0,0,0,0,0,0,0,0,0,0,0,0,0,0,0,0,0
2008-07-14 00:00:00.000,Amersfoort The Netherlands ATP World Tour,CLAY,2,Marc Gicquel,Thiemo de Bakker,Marc Gicquel,7-6(6); 6-3,R16,101,3,3,39,62,31,39,14,23,3,4,10,45,62,5,1,45,77,34,45,14,32,4,7,11,48,77
2008-07-14 00:00:00.000,Amersfoort The Netherlands ATP World Tour,CLAY,2,Teymuraz Gabashvili,Martin Vassallo Arguello,Teymuraz Gabashvili,6-4; 6-0,R16,79,4,4,32,53,25,32,12,21,3,3,8,37,53,2,1,42,55,19,42,8,13,2,6,8,27,55
2008-07-14 00:00:00.000,Amersfoort The Netherlands ATP World Tour,CLAY,2,Steve Darcis,Alberto Martin,Steve Darcis,6-1; 7-6(5),R16,87,3,4,44,75,30,44,15,31,5,7,10,45,75,0,1,35,60,20,35,12,25,5,9,9,32,60
2008-07-14 00:00:00.000,Amersfoort The Netherlands ATP World Tour,CLAY,2,Christophe Rochus,Philipp Petzschner,Christophe Rochus,6-3; 6-4,R16,65,1,0,40,55,33,40,7,15,1,2,10,40,55,10,2,27,65,20,27,17,38,5,8,9,37,65
2008-07-14 00:00:00.000,Amersfoort The Netherlands ATP World Tour,CLAY,2,Oscar Hernandez,Jesse Huta Galung,Oscar Hernandez,6-3; 6-2,R16,82,2,1,40,60,31,40,10,20,1,1,9,41,60,2,2,23,52,15,23,14,29,5,8,8,29,52
2008-07-14 00:00:00.000,Amersfoort The Netherlands ATP World Tour,CLAY,2,Marcel Granollers,Ivan Navarro,Marcel Granollers,6-4; 6-4,R16,98,1,1,42,66,31,42,13,24,8,9,10,44,66,4,3,33,60,22,33,13,27,4,7,10,35,60
2008-07-14 00:00:00.000,Amersfoort The Netherlands ATP World Tour,CLAY,2,Albert Montanes,Pablo Cuevas,Albert Montanes,6-4; 6-4,R16,94,2,3,47,76,36,47,15,29,5,5,10,51,76,1,0,43,70,23,43,19,27,9,11,10,42,70
2008-07-14 00:00:00.000,Amersfoort The Netherlands ATP World Tour,CLAY,2,Jose Acasuso,Edouard Roger-Vasselin,Jose Acasuso,6-3; 6-4,R16,86,5,0,32,58,26,32,15,26,1,2,10,41,58,2,1,37,62,24,37,10,25,8,11,9,34,62
2008-07-14 00:00:00.000,Amersfoort The Netherlands ATP World Tour,CLAY,2,Marc Gicquel,Teymuraz Gabashvili,Marc Gicquel,6-4; 6-1,Q,63,5,1,25,44,22,25,9,19,0,1,8,31,44,1,4,32,52,16,32,7,20,5,10,9,23,52
2008-07-14 00:00:00.000,Amersfoort The Netherlands ATP World Tour,CLAY,2,Steve Darcis,Christophe Rochus,Steve Darcis,7-5; 6-3,Q,68,8,2,31,56,26,31,15,25,1,2,11,41,56,1,1,38,58,22,38,13,20,2,5,10,35,58
2008-07-14 00:00:00.000,Amersfoort The Netherlands ATP World Tour,CLAY,2,Oscar Hernandez,Marcel Granollers,Oscar Hernandez,7-5; 6-2,Q,101,2,2,45,63,29,45,11,18,2,4,10,40,63,3,1,37,58,24,37,6,21,4,9,10,30,58
2008-07-14 00:00:00.000,Amersfoort The Netherlands ATP World Tour,CLAY,2,Albert Montanes,Jose Acasuso,Albert Montanes,6-0; 6-2,Q,49,1,0,24,38,20,24,10,14,1,1,7,30,38,1,3,22,38,9,22,5,16,2,7,7,14,38
2008-07-14 00:00:00.000,Amersfoort The Netherlands ATP World Tour,CLAY,2,Steve Darcis,Marc Gicquel,Steve Darcis,7-6(3); 3-6; 7-5,S,130,4,4,59,105,46,59,25,46,7,9,16,71,105,5,2,59,102,49,59,20,43,1,3,17,69,102
2008-07-14 00:00:00.000,Amersfoort The Netherlands ATP World Tour,CLAY,2,Albert Montanes,Oscar Hernandez,Albert Montanes,6-1; 6-3,S,78,2,0,28,51,21,28,14,23,5,5,8,35,51,0,3,42,62,24,42,8,20,8,12,8,32,62
2008-07-14 00:00:00.000,Amersfoort The Netherlands ATP World Tour,CLAY,2,Albert Montanes,Steve Darcis,Albert Montanes,1-6; 7-5; 6-3,F,107,3,4,53,80,40,53,13,27,1,4,14,53,80,9,5,52,81,36,52,14,29,2,5,14,50,81
2008-07-14 00:00:00.000,Indianapolis IN; U.S.A. ATP World Tour,HARD,2,James Blake,Dudi Sela,James Blake,7-6(2); 6-2,R32,77,5,4,34,69,25,34,16,35,1,4,10,41,69,3,3,41,72,23,41,11,31,8,13,10,34,72
2008-07-14 00:00:00.000,Indianapolis IN; U.S.A. ATP World Tour,HARD,2,Woong-Sun Jun,Chris Guccione,Woong-Sun Jun,6-4; 7-6(4),R32,83,5,2,44,70,38,44,12,26,3,4,11,50,70,3,5,46,79,38,46,14,33,7,9,11,52,79
2008-07-14 00:00:00.000,Indianapolis IN; U.S.A. ATP World Tour,HARD,2,Yen-Hsun Lu,Justin O'Neal,Yen-Hsun Lu,7-6(2); 7-6(12),R32,114,5,4,48,82,37,48,19,34,3,6,12,56,82,7,3,57,88,42,57,11,31,4,7,12,53,88
2008-07-14 00:00:00.000,Indianapolis IN; U.S.A. ATP World Tour,HARD,2,Rajeev Ram,Fabrice Santoro,Rajeev Ram,7-6(6); 6-4,R32,105,4,1,57,84,42,57,14,27,1,2,11,56,84,2,4,43,71,32,43,15,28,4,6,11,47,71
2008-07-14 00:00:00.000,Indianapolis IN; U.S.A. ATP World Tour,HARD,2,Dmitry Tursunov,Igor Kunitsyn,Dmitry Tursunov,6-3; 7-5,R32,86,6,4,28,70,26,28,21,42,6,7,11,47,70,7,3,30,67,24,30,15,37,6,9,10,39,67
2008-07-14 00:00:00.000,Indianapolis IN; U.S.A. ATP World Tour,HARD,2,Wayne Odesnik,Aisam-Ul-Haq Qureshi,Wayne Odesnik,6-4; 7-5,R32,77,2,3,27,55,24,27,17,28,1,2,11,41,55,17,5,36,64,27,36,11,28,3,6,11,38,64
2008-07-14 00:00:00.000,Indianapolis IN; U.S.A. ATP World Tour,HARD,2,Joseph Sirianni,Mikhail Ledovskikh,Joseph Sirianni,6-3; 1-2 RET,R32,71,2,0,19,34,14,19,6,15,1,3,6,20,34,6,4,26,61,16,26,15,35,11,14,6,31,61
2008-07-14 00:00:00.000,Indianapolis IN; U.S.A. ATP World Tour,HARD,2,Paul Capdeville,Robby Ginepri,Paul Capdeville,6-4; 6-2,R32,75,6,3,38,56,25,38,8,18,3,6,9,33,56,1,2,33,68,14,33,17,35,9,15,9,31,68
2008-07-14 00:00:00.000,Indianapolis IN; U.S.A. ATP World Tour,HARD,2,Alejandro Falla,Thomaz Bellucci,Alejandro Falla,3-6; 6-4; 6-1,R32,126,3,5,52,87,35,52,15,35,5,9,13,50,87,2,7,53,98,31,53,18,45,6,12,13,49,98
2008-07-14 00:00:00.000,Indianapolis IN; U.S.A. ATP World Tour,HARD,2,Bobby Reynolds,Frank Dancevic,Bobby Reynolds,6-7(6); 6-3; 6-2,R32,113,17,8,59,112,45,59,27,53,5,6,15,72,112,12,7,49,94,36,49,22,45,6,10,14,58,94
2008-07-14 00:00:00.000,Indianapolis IN; U.S.A. ATP World Tour,HARD,2,Vincent Spadea,Donald Young,Vincent Spadea,6-2; 6-4,R32,52,2,2,18,45,18,18,18,27,0,0,9,36,45,1,0,28,52,19,28,11,24,4,7,9,30,52
2008-07-14 00:00:00.000,Indianapolis IN; U.S.A. ATP World Tour,HARD,2,Sam Querrey,Go Soeda,Sam Querrey,6-4; 6-4,R32,74,3,1,26,50,20,26,17,24,1,2,10,37,50,2,1,41,71,30,41,11,30,6,9,10,41,71
2008-07-14 00:00:00.000,Indianapolis IN; U.S.A. ATP World Tour,HARD,2,Tommy Haas,Jesse Levine,Tommy Haas,7-6(4); 6-2,R32,96,6,6,37,75,31,37,20,38,8,9,10,51,75,4,6,41,70,32,41,7,29,1,4,10,39,70
2008-07-14 00:00:00.000,Indianapolis IN; U.S.A. ATP World Tour,HARD,2,John Isner,Robert Kendrick,John Isner,7-5; 6-4,R32,94,23,5,57,86,42,57,13,29,11,11,11,55,86,9,5,41,72,34,41,15,31,4,6,11,49,72
2008-07-14 00:00:00.000,Indianapolis IN; U.S.A. ATP World Tour,HARD,2,Benjamin Becker,Kristian Pless,Benjamin Becker,6-3; 6-4,R32,85,10,2,38,73,29,38,19,35,6,7,9,48,73,6,14,42,82,29,42,17,40,9,13,10,46,82
2008-07-14 00:00:00.000,Indianapolis IN; U.S.A. ATP World Tour,HARD,2,Gilles Simon,Nicolas Mahut,Gilles Simon,6-2; 3-6; 6-3,R32,111,2,5,31,81,22,31,30,50,2,3,13,52,81,8,1,47,83,30,47,20,36,2,5,13,50,83
2008-07-14 00:00:00.000,Indianapolis IN; U.S.A. ATP World Tour,HARD,2,James Blake,Woong-Sun Jun,James Blake,6-3; 7-5,R16,72,10,3,38,77,33,38,19,39,7,8,11,52,77,7,4,37,58,26,37,9,21,6,9,10,35,58
2008-07-14 00:00:00.000,Indianapolis IN; U.S.A. ATP World Tour,HARD,2,Yen-Hsun Lu,Rajeev Ram,Yen-Hsun Lu,6-1; 7-6(1),R16,103,6,4,37,70,28,37,15,33,6,8,10,43,70,6,1,35,67,24,35,9,32,2,6,9,33,67
2008-07-14 00:00:00.000,Indianapolis IN; U.S.A. ATP World Tour,HARD,2,Dmitry Tursunov,Wayne Odesnik,Dmitry Tursunov,W/O,R16,0,0,0,0,0,0,0,0,0,0,0,0,0,0,0,0,0,0,0,0,0,0,0,0,0,0,0
2008-07-14 00:00:00.000,Indianapolis IN; U.S.A. ATP World Tour,HARD,2,Paul Capdeville,Joseph Sirianni,Paul Capdeville,6-3; 6-4,R16,75,4,0,27,50,23,27,16,23,5,6,10,39,50,2,5,32,59,22,32,12,27,6,9,9,34,59
2008-07-14 00:00:00.000,Indianapolis IN; U.S.A. ATP World Tour,HARD,2,Bobby Reynolds,Alejandro Falla,Bobby Reynolds,6-1; 6-1,R16,63,5,3,30,56,21,30,13,26,4,5,7,34,56,2,5,20,47,12,20,5,27,4,10,7,17,47
2008-07-14 00:00:00.000,Indianapolis IN; U.S.A. ATP World Tour,HARD,2,Sam Querrey,Vincent Spadea,Sam Querrey,4-6; 6-3; 6-4,R16,99,10,2,50,84,40,50,20,34,0,1,15,60,84,6,5,46,94,30,46,28,48,9,11,14,58,94
2008-07-14 00:00:00.000,Indianapolis IN; U.S.A. ATP World Tour,HARD,2,Tommy Haas,John Isner,Tommy Haas,6-3; 6-4,R16,76,7,1,27,53,22,27,21,26,3,3,10,43,53,8,1,30,49,21,30,11,19,4,6,9,32,49
2008-07-14 00:00:00.000,Indianapolis IN; U.S.A. ATP World Tour,HARD,2,Gilles Simon,Benjamin Becker,Gilles Simon,7-5; 3-6; 6-0,R16,106,8,4,38,75,28,38,20,37,3,6,13,48,75,5,3,43,98,26,43,25,55,7,13,14,51,98
2008-07-14 00:00:00.000,Indianapolis IN; U.S.A. ATP World Tour,HARD,2,James Blake,Yen-Hsun Lu,James Blake,6-2; 6-0,Q,45,7,3,20,35,20,20,8,15,0,0,7,28,35,2,5,21,41,8,21,10,20,3,8,7,18,41
2008-07-14 00:00:00.000,Indianapolis IN; U.S.A. ATP World Tour,HARD,2,Dmitry Tursunov,Paul Capdeville,Dmitry Tursunov,3-6; 6-3; 6-1,Q,82,12,9,30,72,24,30,25,42,1,3,13,49,72,4,2,36,64,22,36,16,28,0,4,12,38,64
2008-07-14 00:00:00.000,Indianapolis IN; U.S.A. ATP World Tour,HARD,2,Sam Querrey,Bobby Reynolds,Sam Querrey,6-1; 3-6; 6-3,Q,76,17,5,49,72,38,49,11,23,3,5,13,49,72,8,2,43,62,27,43,11,19,2,6,12,38,62
2008-07-14 00:00:00.000,Indianapolis IN; U.S.A. ATP World Tour,HARD,2,Gilles Simon,Tommy Haas,Gilles Simon,4-6; 6-4; 6-2,Q,122,7,5,40,80,29,40,25,40,1,3,14,54,80,7,5,50,99,33,50,26,49,8,12,14,59,99
2008-07-14 00:00:00.000,Indianapolis IN; U.S.A. ATP World Tour,HARD,2,Dmitry Tursunov,James Blake,Dmitry Tursunov,4-6; 6-3; 6-4,S,116,8,3,55,93,40,55,20,38,3,5,15,60,93,3,2,37,85,27,37,25,48,0,3,14,52,85
2008-07-14 00:00:00.000,Indianapolis IN; U.S.A. ATP World Tour,HARD,2,Gilles Simon,Sam Querrey,Gilles Simon,6-3; 4-6; 6-4,S,126,11,6,66,114,43,66,24,48,16,19,14,67,114,3,3,46,84,32,46,19,38,3,8,15,51,84
2008-07-14 00:00:00.000,Indianapolis IN; U.S.A. ATP World Tour,HARD,2,Gilles Simon,Dmitry Tursunov,Gilles Simon,6-4; 6-4,F,95,4,2,47,72,33,47,16,25,9,9,10,49,72,9,6,39,68,30,39,10,29,4,6,10,40,68
2008-07-14 00:00:00.000,Kitzbnhel Austria ATP World Tour,CLAY,2,Nicolas Devilder,Matthias Bachinger,Nicolas Devilder,6-3; 6-3,R32,85,2,2,26,61,16,26,22,35,5,7,9,38,61,4,7,42,82,28,42,12,40,8,13,9,40,82
2008-07-14 00:00:00.000,Kitzbnhel Austria ATP World Tour,CLAY,2,Alexander Peya,Guillermo Coria,Alexander Peya,5-7 RET,R32,49,2,2,15,35,11,15,9,20,1,3,6,20,35,0,7,27,45,21,27,9,18,8,9,6,30,45
2008-07-14 00:00:00.000,Kitzbnhel Austria ATP World Tour,CLAY,2,Sergio Roitman,Martin Fischer,Sergio Roitman,6-4; 6-2,R32,66,1,2,35,53,25,35,11,18,0,1,9,36,53,2,0,38,58,19,38,12,20,5,9,9,31,58
2008-07-14 00:00:00.000,Kitzbnhel Austria ATP World Tour,CLAY,2,Juan Martin Del Potro,Josselin Ouanna,Juan Martin Del Potro,6-3; 6-3,R32,74,1,4,33,50,22,33,11,17,2,3,9,33,50,4,0,30,54,17,30,11,24,2,6,9,28,54
2008-07-14 00:00:00.000,Kitzbnhel Austria ATP World Tour,CLAY,2,Guillermo Garcia-Lopez,Agustin Calleri,Guillermo Garcia-Lopez,6-4; 6-4,R32,103,5,2,39,66,28,39,16,27,2,3,10,44,66,3,2,67,95,43,67,10,28,11,14,10,53,95
2008-07-14 00:00:00.000,Kitzbnhel Austria ATP World Tour,CLAY,2,Victor Hanescu,Pablo Andujar,Victor Hanescu,6-3; 1-6; 7-6(2),R32,143,3,3,65,111,48,65,17,46,8,11,14,65,111,0,4,74,98,47,74,13,24,6,8,14,60,98
2008-07-14 00:00:00.000,Kitzbnhel Austria ATP World Tour,CLAY,2,Brian Dabul,Stephane Bohli,Brian Dabul,6-1; 6-1,R32,53,2,3,24,38,20,24,9,14,2,2,7,29,38,4,4,29,52,11,29,12,23,7,12,7,23,52
2008-07-14 00:00:00.000,Kitzbnhel Austria ATP World Tour,CLAY,2,Ivo Minar,Olivier Rochus,Ivo Minar,3-6; 6-4; 6-0,R32,100,6,6,43,75,31,43,14,32,2,5,12,45,75,1,3,37,76,23,37,15,39,2,8,13,38,76
2008-07-14 00:00:00.000,Kitzbnhel Austria ATP World Tour,CLAY,2,Eduardo Schwank,Michael Berrer,Eduardo Schwank,6-4; 6-1,R32,68,4,1,32,48,25,32,9,16,1,1,8,34,48,2,2,36,61,23,36,9,25,4,8,9,32,61
2008-07-14 00:00:00.000,Kitzbnhel Austria ATP World Tour,CLAY,2,Daniel Brands,Eric Prodon,Daniel Brands,6-3; 6-4,R32,51,15,0,32,51,30,32,11,19,0,0,10,41,51,4,2,29,51,23,29,11,22,0,2,9,34,51
2008-07-14 00:00:00.000,Kitzbnhel Austria ATP World Tour,CLAY,2,Daniel Koellerer,Philipp Oswald,Daniel Koellerer,7-6(5); 7-6(4),R32,123,2,2,49,80,34,49,15,31,4,8,12,49,80,9,7,58,91,36,58,13,33,3,7,12,49,91
2008-07-14 00:00:00.000,Kitzbnhel Austria ATP World Tour,CLAY,2,Potito Starace,Santiago Giraldo,Potito Starace,6-1; 6-2,R32,65,1,0,39,53,30,39,7,14,7,7,8,37,53,0,1,17,41,9,17,10,24,3,7,7,19,41
2008-07-14 00:00:00.000,Kitzbnhel Austria ATP World Tour,CLAY,2,Jurgen Melzer,Luis Horna,Jurgen Melzer,6-3; 6-1,R32,53,2,1,21,42,16,21,13,21,1,2,8,29,42,3,5,28,46,14,28,6,18,2,7,8,20,46
2008-07-14 00:00:00.000,Kitzbnhel Austria ATP World Tour,CLAY,2,Leonardo Mayer,Denis Gremelmayr,Leonardo Mayer,6-1; 7-6(3),R32,67,13,3,32,54,28,32,13,22,0,2,10,41,54,2,2,39,61,23,39,9,22,8,12,9,32,61
2008-07-14 00:00:00.000,Kitzbnhel Austria ATP World Tour,CLAY,2,Jan Hernych,Ruben Ramirez Hidalgo,Jan Hernych,7-5; 7-5,R32,101,1,2,45,70,32,45,11,25,3,7,12,43,70,0,9,44,82,26,44,14,38,12,18,12,40,82
2008-07-14 00:00:00.000,Kitzbnhel Austria ATP World Tour,CLAY,2,Rainer Schuettler,Andreas Beck,Rainer Schuettler,3-6; 7-6(5); 6-2,R32,139,10,2,39,89,33,39,30,50,2,3,14,63,89,6,9,61,105,43,61,25,44,5,7,15,68,105
2008-07-14 00:00:00.000,Kitzbnhel Austria ATP World Tour,CLAY,2,Nicolas Devilder,Alexander Peya,Nicolas Devilder,6-4; 6-4,R16,93,4,1,47,67,32,47,10,20,3,5,10,42,67,3,2,27,55,18,27,12,28,2,6,10,30,55
2008-07-14 00:00:00.000,Kitzbnhel Austria ATP World Tour,CLAY,2,Juan Martin Del Potro,Sergio Roitman,Juan Martin Del Potro,6-2; 6-4,R16,80,6,3,35,64,27,35,16,29,5,5,9,43,64,1,2,28,45,16,28,10,17,0,3,9,26,45
2008-07-14 00:00:00.000,Kitzbnhel Austria ATP World Tour,CLAY,2,Victor Hanescu,Guillermo Garcia-Lopez,Victor Hanescu,6-2; 6-1,R16,61,2,1,22,35,19,22,9,13,0,0,7,28,35,1,6,32,53,18,32,6,21,3,8,8,24,53
2008-07-14 00:00:00.000,Kitzbnhel Austria ATP World Tour,CLAY,2,Brian Dabul,Ivo Minar,Brian Dabul,6-4; 6-3,R16,81,2,0,37,53,25,37,9,16,0,2,9,34,53,2,5,38,71,23,38,13,33,2,7,10,36,71
2008-07-14 00:00:00.000,Kitzbnhel Austria ATP World Tour,CLAY,2,Eduardo Schwank,Daniel Brands,Eduardo Schwank,6-1; 6-4,R16,67,3,2,22,48,18,22,18,26,0,0,9,36,48,2,6,36,62,24,36,10,26,6,9,8,34,62
2008-07-14 00:00:00.000,Kitzbnhel Austria ATP World Tour,CLAY,2,Potito Starace,Daniel Koellerer,Potito Starace,6-4; 6-3,R16,98,1,1,53,70,36,53,11,17,8,9,10,47,70,0,3,35,55,20,35,12,20,2,5,9,32,55
2008-07-14 00:00:00.000,Kitzbnhel Austria ATP World Tour,CLAY,2,Jurgen Melzer,Leonardo Mayer,Jurgen Melzer,6-4; 6-2,R16,61,3,2,32,50,30,32,8,18,0,0,9,38,50,2,4,21,46,18,21,11,25,1,4,9,29,46
2008-07-14 00:00:00.000,Kitzbnhel Austria ATP World Tour,CLAY,2,Rainer Schuettler,Jan Hernych,Rainer Schuettler,2-6; 6-4; 7-5,R16,121,4,7,54,102,35,54,23,48,4,9,15,58,102,0,4,50,86,32,50,17,36,4,9,15,49,86
2008-07-14 00:00:00.000,Kitzbnhel Austria ATP World Tour,CLAY,2,Juan Martin Del Potro,Nicolas Devilder,Juan Martin Del Potro,6-2; 6-3,Q,72,1,1,27,44,21,27,9,17,0,1,8,30,44,2,3,26,58,12,26,14,32,6,11,9,26,58
2008-07-14 00:00:00.000,Kitzbnhel Austria ATP World Tour,CLAY,2,Victor Hanescu,Brian Dabul,Victor Hanescu,6-3; 6-4,Q,73,7,2,34,53,31,34,10,19,1,1,10,41,53,2,0,40,58,29,40,7,18,5,7,9,36,58
2008-07-14 00:00:00.000,Kitzbnhel Austria ATP World Tour,CLAY,2,Potito Starace,Eduardo Schwank,Potito Starace,6-1; 6-2,Q,58,3,3,35,46,29,35,5,11,1,1,8,34,46,2,1,29,39,16,29,2,10,2,6,7,18,39
2008-07-14 00:00:00.000,Kitzbnhel Austria ATP World Tour,CLAY,2,Jurgen Melzer,Rainer Schuettler,Jurgen Melzer,2-6; 7-5; 7-5,Q,142,4,4,54,91,34,54,21,37,1,5,16,55,91,6,2,63,109,47,63,20,46,10,14,16,67,109
2008-07-14 00:00:00.000,Kitzbnhel Austria ATP World Tour,CLAY,2,Juan Martin Del Potro,Victor Hanescu,Juan Martin Del Potro,6-3; 7-6(5),S,100,6,5,40,77,33,40,21,37,5,5,10,54,77,1,2,37,68,27,37,19,31,1,3,11,46,68
2008-07-14 00:00:00.000,Kitzbnhel Austria ATP World Tour,CLAY,2,Jurgen Melzer,Potito Starace,Jurgen Melzer,6-4; 6-7(6); 6-3,S,124,8,6,61,107,48,61,24,46,6,8,16,72,107,2,1,74,100,46,74,17,26,6,10,15,63,100
2008-07-14 00:00:00.000,Kitzbnhel Austria ATP World Tour,CLAY,2,Juan Martin Del Potro,Jurgen Melzer,Juan Martin Del Potro,6-2; 6-1,F,59,4,1,20,35,17,20,12,15,1,1,7,29,35,2,6,28,51,13,28,11,23,5,10,8,24,51
2008-07-14 00:00:00.000,Umag Croatia ATP World Tour,CLAY,2,Fernando Verdasco,N/A Bye,Fernando Verdasco,,R32,0,0,0,0,0,0,0,0,0,0,0,0,0,0,0,0,0,0,0,0,0,0,0,0,0,0,0
2008-07-14 00:00:00.000,Umag Croatia ATP World Tour,CLAY,2,Mathieu Montcourt,Antonio Veic,Mathieu Montcourt,6-4; 6-2,R32,89,0,3,43,52,28,43,4,9,1,3,9,32,52,0,5,35,67,22,35,11,32,9,14,9,33,67
2008-07-14 00:00:00.000,Umag Croatia ATP World Tour,CLAY,2,Mischa Zverev,Luka Belic,Mischa Zverev,6-2; 6-3,R32,73,3,0,36,59,25,36,14,23,4,5,9,39,59,2,3,32,56,19,32,8,24,3,7,8,27,56
2008-07-14 00:00:00.000,Umag Croatia ATP World Tour,CLAY,2,Marcos Daniel,Carlos Berlocq,Marcos Daniel,6-3; 4-6; 6-4,R32,136,0,1,44,84,26,44,20,40,2,8,15,46,84,1,2,50,87,29,50,16,37,8,15,14,45,87
2008-07-14 00:00:00.000,Umag Croatia ATP World Tour,CLAY,2,Carlos Moya,N/A Bye,Carlos Moya,,R32,0,0,0,0,0,0,0,0,0,0,0,0,0,0,0,0,0,0,0,0,0,0,0,0,0,0,0
2008-07-14 00:00:00.000,Umag Croatia ATP World Tour,CLAY,2,Viktor Troicki,Jiri Vanek,Viktor Troicki,6-3; 6-1,R32,62,1,2,21,36,19,21,11,15,0,1,8,30,36,1,0,34,59,17,34,10,25,5,10,8,27,59
2008-07-14 00:00:00.000,Umag Croatia ATP World Tour,CLAY,2,Filippo Volandri,Flavio Cipolla,Filippo Volandri,6-1; 6-4,R32,75,0,1,41,59,28,41,10,18,4,6,9,38,59,0,2,37,50,20,37,4,13,6,11,8,24,50
2008-07-14 00:00:00.000,Umag Croatia ATP World Tour,CLAY,2,Fabio Fognini,Ricardas Berankis,Fabio Fognini,6-3; 6-2,R32,62,5,0,27,48,22,27,12,21,3,3,8,34,48,0,3,19,50,11,19,14,31,1,5,9,25,50
2008-07-14 00:00:00.000,Umag Croatia ATP World Tour,CLAY,2,Guillermo Canas,Nicolas Massu,Guillermo Canas,7-5; 6-2,R32,105,4,4,32,60,23,32,10,28,4,8,10,33,60,0,7,39,64,21,39,5,25,1,8,10,26,64
2008-07-14 00:00:00.000,Umag Croatia ATP World Tour,CLAY,2,Boris Pashanski,Gianluca Naso,Boris Pashanski,6-3; 2-6; 7-6(9),R32,151,7,2,73,123,48,73,26,50,7,10,15,74,123,6,1,57,93,42,57,18,36,3,5,14,60,93
2008-07-14 00:00:00.000,Umag Croatia ATP World Tour,CLAY,2,Daniel Gimeno-Traver,Olivier Patience,Daniel Gimeno-Traver,6-2; 6-2,R32,70,1,1,29,50,24,29,11,21,6,6,8,35,50,3,1,32,49,18,32,7,17,6,10,8,25,49
2008-07-14 00:00:00.000,Umag Croatia ATP World Tour,CLAY,2,Igor Andreev,N/A Bye,Igor Andreev,,R32,0,0,0,0,0,0,0,0,0,0,0,0,0,0,0,0,0,0,0,0,0,0,0,0,0,0,0
2008-07-14 00:00:00.000,Umag Croatia ATP World Tour,CLAY,2,Ivan Ljubicic,Mikhail Kukushkin,Ivan Ljubicic,6-1; 6-2,R32,52,8,0,21,38,21,21,12,17,0,0,8,33,38,0,2,19,39,10,19,9,20,1,5,7,19,39
2008-07-14 00:00:00.000,Umag Croatia ATP World Tour,CLAY,2,Roko Karanusic,Francesco Piccari,Roko Karanusic,6-2; 6-2,R32,55,3,0,24,40,17,24,15,16,0,0,8,32,40,1,0,23,44,11,23,10,21,2,6,8,21,44
2008-07-14 00:00:00.000,Umag Croatia ATP World Tour,CLAY,2,Maximo Gonzalez,Filip Prpic,Maximo Gonzalez,7-5; 6-3,R32,98,3,2,44,67,30,44,9,23,7,10,10,39,67,0,4,41,72,24,41,9,31,4,10,11,33,72
2008-07-14 00:00:00.000,Umag Croatia ATP World Tour,CLAY,2,Ivo Karlovic,N/A Bye,Ivo Karlovic,,R32,0,0,0,0,0,0,0,0,0,0,0,0,0,0,0,0,0,0,0,0,0,0,0,0,0,0,0
2008-07-14 00:00:00.000,Umag Croatia ATP World Tour,CLAY,2,Fernando Verdasco,Mathieu Montcourt,Fernando Verdasco,7-6(5); 6-1,R16,87,1,7,41,61,25,41,8,20,1,5,10,33,61,0,4,36,59,15,36,8,23,6,12,9,23,59
2008-07-14 00:00:00.000,Umag Croatia ATP World Tour,CLAY,2,Mischa Zverev,Marcos Daniel,Mischa Zverev,6-4; 6-2,R16,87,2,2,27,54,24,27,15,27,0,0,9,39,54,2,5,52,70,32,52,7,18,5,8,9,39,70
2008-07-14 00:00:00.000,Umag Croatia ATP World Tour,CLAY,2,Carlos Moya,Viktor Troicki,Carlos Moya,3-6; 7-6(2); 7-5,R16,165,3,5,50,113,35,50,32,63,6,10,16,67,113,8,1,71,111,49,71,20,40,7,11,17,69,111
2008-07-14 00:00:00.000,Umag Croatia ATP World Tour,CLAY,2,Fabio Fognini,Filippo Volandri,Fabio Fognini,6-4; 6-4,R16,79,4,3,35,60,25,35,9,25,4,7,10,34,60,0,1,42,66,26,42,9,24,5,10,10,35,66
2008-07-14 00:00:00.000,Umag Croatia ATP World Tour,CLAY,2,Guillermo Canas,Boris Pashanski,Guillermo Canas,6-7(3); 6-3; 7-5,R16,166,6,1,47,93,32,47,23,46,1,6,16,55,93,6,5,50,109,31,50,26,59,3,11,17,57,109
2008-07-14 00:00:00.000,Umag Croatia ATP World Tour,CLAY,2,Igor Andreev,Daniel Gimeno-Traver,Igor Andreev,6-2; 7-6(3),R16,99,4,2,39,63,28,39,15,24,1,3,10,43,63,2,2,40,76,26,40,15,36,5,9,10,41,76
2008-07-14 00:00:00.000,Umag Croatia ATP World Tour,CLAY,2,Roko Karanusic,Ivan Ljubicic,Roko Karanusic,W/O,R16,0,0,0,0,0,0,0,0,0,0,0,0,0,0,0,0,0,0,0,0,0,0,0,0,0,0,0
2008-07-14 00:00:00.000,Umag Croatia ATP World Tour,CLAY,2,Maximo Gonzalez,Ivo Karlovic,Maximo Gonzalez,3-6; 6-3; 6-4,R16,133,1,5,57,90,40,57,19,33,4,6,14,59,90,15,2,53,87,37,53,17,34,4,7,14,54,87
2008-07-14 00:00:00.000,Umag Croatia ATP World Tour,CLAY,2,Fernando Verdasco,Mischa Zverev,Fernando Verdasco,7-5; 7-5,Q,99,2,7,51,76,30,51,16,25,3,5,12,46,76,4,0,48,82,28,48,18,34,8,12,12,46,82
2008-07-14 00:00:00.000,Umag Croatia ATP World Tour,CLAY,2,Fabio Fognini,Carlos Moya,Fabio Fognini,6-4; 6-3,Q,77,1,4,28,53,22,28,12,25,2,5,9,34,53,2,2,36,64,18,36,14,28,7,13,10,32,64
2008-07-14 00:00:00.000,Umag Croatia ATP World Tour,CLAY,2,Igor Andreev,Guillermo Canas,Igor Andreev,7-5; 6-4,Q,124,7,0,38,60,32,38,14,22,3,4,11,46,60,3,2,41,66,28,41,10,25,0,3,11,38,66
2008-07-14 00:00:00.000,Umag Croatia ATP World Tour,CLAY,2,Maximo Gonzalez,Roko Karanusic,Maximo Gonzalez,2-6; 6-3; 7-6(4),Q,162,0,4,67,109,46,67,18,42,5,9,15,64,109,1,3,54,98,35,54,23,44,6,9,14,58,98
2008-07-14 00:00:00.000,Umag Croatia ATP World Tour,CLAY,2,Fernando Verdasco,Fabio Fognini,Fernando Verdasco,6-1; 6-3,S,59,0,3,34,43,26,34,5,9,0,1,8,31,43,0,5,25,46,14,25,6,21,2,7,8,20,46
2008-07-14 00:00:00.000,Umag Croatia ATP World Tour,CLAY,2,Igor Andreev,Maximo Gonzalez,Igor Andreev,6-2; 7-6(2),S,98,1,2,39,59,25,39,14,20,4,7,10,39,59,0,2,43,69,27,43,7,26,7,12,10,34,69
2008-07-14 00:00:00.000,Umag Croatia ATP World Tour,CLAY,2,Fernando Verdasco,Igor Andreev,Fernando Verdasco,3-6; 6-4; 7-6(4),F,171,2,4,69,99,47,69,17,30,2,6,16,64,99,4,7,62,116,37,62,33,54,11,14,15,70,116
2008-07-21 00:00:00.000,ATP Masters Series Canada Toronto; Canada ATP World Tour,HARD,2,Roger Federer,N/A Bye,Roger Federer,,R64,0,0,0,0,0,0,0,0,0,0,0,0,0,0,0,0,0,0,0,0,0,0,0,0,0,0,0
2008-07-21 00:00:00.000,ATP Masters Series Canada Toronto; Canada ATP World Tour,HARD,2,Gilles Simon,Donald Young,Gilles Simon,6-1; 6-3,R64,59,0,2,26,52,18,26,15,26,3,4,8,33,52,0,1,25,47,11,25,9,22,4,9,8,20,47
2008-07-21 00:00:00.000,ATP Masters Series Canada Toronto; Canada ATP World Tour,HARD,2,Jose Acasuso,Ernests Gulbis,Jose Acasuso,6-7(1); 6-3; 7-5,R64,134,4,2,65,118,45,65,29,53,8,10,17,74,118,19,5,57,93,46,57,13,36,6,10,16,59,93
2008-07-21 00:00:00.000,ATP Masters Series Canada Toronto; Canada ATP World Tour,HARD,2,Fernando Gonzalez,Julien Benneteau,Fernando Gonzalez,6-2; 6-1,R64,66,3,2,37,68,29,37,15,31,10,10,8,44,68,3,3,26,39,16,26,3,13,1,5,7,19,39
2008-07-21 00:00:00.000,ATP Masters Series Canada Toronto; Canada ATP World Tour,HARD,2,Tommy Robredo,Frederic Niemeyer,Tommy Robredo,7-6(4); 6-1,R64,93,7,0,52,77,38,52,15,25,6,6,10,53,77,8,1,38,62,25,38,13,24,2,4,9,38,62
2008-07-21 00:00:00.000,ATP Masters Series Canada Toronto; Canada ATP World Tour,HARD,2,Marin Cilic,Lukas Dlouhy,Marin Cilic,6-3; 4-6; 6-3,R64,101,14,4,46,78,36,46,14,32,1,4,14,50,78,7,8,59,98,43,59,14,39,9,14,14,57,98
2008-07-21 00:00:00.000,ATP Masters Series Canada Toronto; Canada ATP World Tour,HARD,2,Nicolas Mahut,Janko Tipsarevic,Nicolas Mahut,6-3; 6-7(5); 6-2,R64,140,8,5,54,90,41,54,23,36,1,2,15,64,90,15,4,50,102,36,50,24,52,8,12,14,60,102
2008-07-21 00:00:00.000,ATP Masters Series Canada Toronto; Canada ATP World Tour,HARD,2,Andy Roddick,N/A Bye,Andy Roddick,,R64,0,0,0,0,0,0,0,0,0,0,0,0,0,0,0,0,0,0,0,0,0,0,0,0,0,0,0
2008-07-21 00:00:00.000,ATP Masters Series Canada Toronto; Canada ATP World Tour,HARD,2,Nikolay Davydenko,N/A Bye,Nikolay Davydenko,,R64,0,0,0,0,0,0,0,0,0,0,0,0,0,0,0,0,0,0,0,0,0,0,0,0,0,0,0
2008-07-21 00:00:00.000,ATP Masters Series Canada Toronto; Canada ATP World Tour,HARD,2,Tommy Haas,Carlos Moya,Tommy Haas,6-3; 6-2,R64,54,4,1,28,42,26,28,10,14,0,0,9,36,42,6,2,30,46,19,30,6,16,2,5,8,25,46
2008-07-21 00:00:00.000,ATP Masters Series Canada Toronto; Canada ATP World Tour,HARD,2,Nicolas Kiefer,Mardy Fish,Nicolas Kiefer,7-5; 7-6(4),R64,114,6,0,42,71,35,42,14,29,6,8,12,49,71,7,2,51,82,33,51,18,31,6,9,12,51,82
2008-07-21 00:00:00.000,ATP Masters Series Canada Toronto; Canada ATP World Tour,HARD,2,Mikhail Youzhny,Andreas Seppi,Mikhail Youzhny,7-6(1); 6-2,R64,94,4,2,37,68,26,37,16,31,5,7,10,42,68,4,5,30,61,20,30,12,31,1,5,10,32,61
2008-07-21 00:00:00.000,ATP Masters Series Canada Toronto; Canada ATP World Tour,HARD,2,Feliciano Lopez,Radek Stepanek,Feliciano Lopez,4-6; 6-3; 6-4,R64,121,10,1,65,98,47,65,18,33,6,8,15,65,98,3,0,53,74,37,53,13,21,1,4,14,50,74
2008-07-21 00:00:00.000,ATP Masters Series Canada Toronto; Canada ATP World Tour,HARD,2,Dmitry Tursunov,Nicolas Lapentti,Dmitry Tursunov,6-3; 6-4,R64,72,4,2,36,56,32,36,12,20,1,1,10,44,56,4,0,28,53,19,28,15,25,3,5,9,34,53
2008-07-21 00:00:00.000,ATP Masters Series Canada Toronto; Canada ATP World Tour,HARD,2,Jonas Bjorkman,Arnaud Clement,Jonas Bjorkman,6-3; 3-6; 6-0,R64,113,8,2,40,84,33,40,21,44,3,4,12,54,84,3,3,38,67,27,38,11,29,2,6,12,38,67
2008-07-21 00:00:00.000,ATP Masters Series Canada Toronto; Canada ATP World Tour,HARD,2,James Blake,N/A Bye,James Blake,,R64,0,0,0,0,0,0,0,0,0,0,0,0,0,0,0,0,0,0,0,0,0,0,0,0,0,0,0
2008-07-21 00:00:00.000,ATP Masters Series Canada Toronto; Canada ATP World Tour,HARD,2,Andy Murray,N/A Bye,Andy Murray,,R64,0,0,0,0,0,0,0,0,0,0,0,0,0,0,0,0,0,0,0,0,0,0,0,0,0,0,0
2008-07-21 00:00:00.000,ATP Masters Series Canada Toronto; Canada ATP World Tour,HARD,2,Thomas Johansson,Andrey Golubev,Thomas Johansson,7-6(4); 6-1,R64,85,7,1,44,59,35,44,8,15,1,2,10,43,59,12,6,34,72,25,34,16,38,3,6,9,41,72
2008-07-21 00:00:00.000,ATP Masters Series Canada Toronto; Canada ATP World Tour,HARD,2,Marat Safin,Sam Querrey,Marat Safin,6-3; 6-3,R64,67,2,0,24,53,18,24,21,29,5,5,9,39,53,5,5,35,59,23,35,10,24,3,6,9,33,59
2008-07-21 00:00:00.000,ATP Masters Series Canada Toronto; Canada ATP World Tour,HARD,2,Stanislas Wawrinka,Simone Bolelli,Stanislas Wawrinka,6-4; 7-6(4),R64,96,4,1,36,56,28,36,13,20,0,2,11,41,56,1,1,55,85,34,55,16,30,5,8,11,50,85
2008-07-21 00:00:00.000,ATP Masters Series Canada Toronto; Canada ATP World Tour,HARD,2,Fernando Verdasco,Thomaz Bellucci,Fernando Verdasco,1-6; 6-3; 6-2,R64,109,4,7,44,66,30,44,9,22,1,5,12,39,66,5,1,39,90,30,39,18,51,10,15,12,48,90
2008-07-21 00:00:00.000,ATP Masters Series Canada Toronto; Canada ATP World Tour,HARD,2,Robin Soderling,Guillermo Canas,Robin Soderling,7-5; 6-1,R64,86,11,1,34,55,27,34,12,21,1,2,10,39,55,3,2,25,61,13,25,17,36,4,8,9,30,61
2008-07-21 00:00:00.000,ATP Masters Series Canada Toronto; Canada ATP World Tour,HARD,2,Frank Dancevic,Mario Ancic,Frank Dancevic,6-3; 6-4,R64,83,3,1,32,54,26,32,11,22,0,1,10,37,54,9,7,40,64,29,40,7,24,6,9,9,36,64
2008-07-21 00:00:00.000,ATP Masters Series Canada Toronto; Canada ATP World Tour,HARD,2,Novak Djokovic,N/A Bye,Novak Djokovic,,R64,0,0,0,0,0,0,0,0,0,0,0,0,0,0,0,0,0,0,0,0,0,0,0,0,0,0,0
2008-07-21 00:00:00.000,ATP Masters Series Canada Toronto; Canada ATP World Tour,HARD,2,David Ferrer,N/A Bye,David Ferrer,,R64,0,0,0,0,0,0,0,0,0,0,0,0,0,0,0,0,0,0,0,0,0,0,0,0,0,0,0
2008-07-21 00:00:00.000,ATP Masters Series Canada Toronto; Canada ATP World Tour,HARD,2,Robby Ginepri,Paul-Henri Mathieu,Robby Ginepri,6-3; 4-6; 6-4,R64,121,9,3,56,90,43,56,17,34,4,6,15,60,90,8,5,44,83,30,44,21,39,4,7,14,51,83
2008-07-21 00:00:00.000,ATP Masters Series Canada Toronto; Canada ATP World Tour,HARD,2,Alexander Kudryavtsev,Philipp Kohlschreiber,Alexander Kudryavtsev,6-2; 7-6(7),R64,83,7,1,40,69,30,40,20,29,3,3,10,50,69,4,3,39,64,30,39,13,25,4,6,10,43,64
2008-07-21 00:00:00.000,ATP Masters Series Canada Toronto; Canada ATP World Tour,HARD,2,Richard Gasquet,Michael Llodra,Richard Gasquet,6-2; 4-6; 6-3,R64,105,7,1,45,79,32,45,21,34,3,5,13,53,79,8,5,49,84,31,49,19,35,4,9,14,50,84
2008-07-21 00:00:00.000,ATP Masters Series Canada Toronto; Canada ATP World Tour,HARD,2,Tomas Berdych,Jarkko Nieminen,Tomas Berdych,6-3; 6-1,R64,51,12,1,32,50,25,32,11,18,2,2,8,36,50,0,2,33,44,18,33,3,11,2,6,8,21,44
2008-07-21 00:00:00.000,ATP Masters Series Canada Toronto; Canada ATP World Tour,HARD,2,Igor Andreev,Gael Monfils,Igor Andreev,7-6(5); 7-6(3),R64,111,2,3,49,78,36,49,21,29,0,1,12,57,78,7,3,44,84,36,44,21,40,6,7,12,57,84
2008-07-21 00:00:00.000,ATP Masters Series Canada Toronto; Canada ATP World Tour,HARD,2,Jesse Levine,Peter Polansky,Jesse Levine,6-2; 6-4,R64,80,2,0,32,57,18,32,16,25,6,8,9,34,57,1,0,35,60,15,35,14,25,7,12,9,29,60
2008-07-21 00:00:00.000,ATP Masters Series Canada Toronto; Canada ATP World Tour,HARD,2,Rafael Nadal,N/A Bye,Rafael Nadal,,R64,0,0,0,0,0,0,0,0,0,0,0,0,0,0,0,0,0,0,0,0,0,0,0,0,0,0,0
2008-07-21 00:00:00.000,ATP Masters Series Canada Toronto; Canada ATP World Tour,HARD,2,Gilles Simon,Roger Federer,Gilles Simon,2-6; 7-5; 6-4,R32,122,0,0,51,86,34,51,18,35,5,10,15,52,86,6,1,48,91,30,48,21,43,7,12,15,51,91
2008-07-21 00:00:00.000,ATP Masters Series Canada Toronto; Canada ATP World Tour,HARD,2,Jose Acasuso,Fernando Gonzalez,Jose Acasuso,6-3; 3-6; 6-3,R32,135,7,5,62,102,39,62,22,40,7,10,14,61,102,3,4,52,78,35,52,12,26,8,12,13,47,78
2008-07-21 00:00:00.000,ATP Masters Series Canada Toronto; Canada ATP World Tour,HARD,2,Marin Cilic,Tommy Robredo,Marin Cilic,6-3; 6-4,R32,74,7,2,33,55,25,33,14,22,0,1,10,39,55,1,0,45,56,25,45,6,11,5,8,9,31,56
2008-07-21 00:00:00.000,ATP Masters Series Canada Toronto; Canada ATP World Tour,HARD,2,Andy Roddick,Nicolas Mahut,Andy Roddick,6-1; 6-7(6); 6-3,R32,110,18,2,58,85,46,58,22,27,5,5,15,68,85,7,3,51,81,39,51,13,30,4,7,13,52,81
2008-07-21 00:00:00.000,ATP Masters Series Canada Toronto; Canada ATP World Tour,HARD,2,Nikolay Davydenko,Tommy Haas,Nikolay Davydenko,6-3; 7-6(6),R32,102,4,3,39,61,29,39,17,22,2,2,10,46,61,2,1,45,73,32,45,14,28,4,6,11,46,73
2008-07-21 00:00:00.000,ATP Masters Series Canada Toronto; Canada ATP World Tour,HARD,2,Nicolas Kiefer,Mikhail Youzhny,Nicolas Kiefer,7-6(4); 7-5,R32,139,11,2,50,84,39,50,17,34,5,6,12,56,84,4,0,56,88,38,56,15,32,4,6,12,53,88
2008-07-21 00:00:00.000,ATP Masters Series Canada Toronto; Canada ATP World Tour,HARD,2,Dmitry Tursunov,Feliciano Lopez,Dmitry Tursunov,6-3; 7-6(6),R32,99,7,4,49,86,37,49,22,37,4,4,11,59,86,8,2,42,66,28,42,16,24,1,2,10,44,66
2008-07-21 00:00:00.000,ATP Masters Series Canada Toronto; Canada ATP World Tour,HARD,2,James Blake,Jonas Bjorkman,James Blake,1-6; 6-1; 6-2,R32,78,4,3,34,66,27,34,16,32,1,3,11,43,66,1,5,29,58,20,29,13,29,4,8,11,33,58
2008-07-21 00:00:00.000,ATP Masters Series Canada Toronto; Canada ATP World Tour,HARD,2,Andy Murray,Thomas Johansson,Andy Murray,6-4; 6-4,R32,96,12,3,48,77,34,48,9,29,3,6,10,43,77,1,2,43,77,24,43,14,34,6,11,10,38,77
2008-07-21 00:00:00.000,ATP Masters Series Canada Toronto; Canada ATP World Tour,HARD,2,Stanislas Wawrinka,Marat Safin,Stanislas Wawrinka,6-3; 6-4,R32,92,0,3,47,68,35,47,11,21,6,6,10,46,68,5,1,27,52,22,27,10,25,3,5,9,32,52
2008-07-21 00:00:00.000,ATP Masters Series Canada Toronto; Canada ATP World Tour,HARD,2,Robin Soderling,Fernando Verdasco,Robin Soderling,6-4; 6-7(4); 6-4,R32,136,3,1,57,97,44,57,22,40,0,2,16,66,97,8,12,76,103,57,76,7,27,3,7,16,64,103
2008-07-21 00:00:00.000,ATP Masters Series Canada Toronto; Canada ATP World Tour,HARD,2,Novak Djokovic,Frank Dancevic,Novak Djokovic,6-4; 6-4,R32,77,3,1,36,58,29,36,13,22,2,3,10,42,58,3,0,41,56,26,41,8,15,2,5,10,34,56
2008-07-21 00:00:00.000,ATP Masters Series Canada Toronto; Canada ATP World Tour,HARD,2,David Ferrer,Robby Ginepri,David Ferrer,6-4; 6-4,R32,85,4,0,36,56,30,36,11,20,0,0,10,41,56,1,4,50,76,34,50,12,26,3,5,10,46,76
2008-07-21 00:00:00.000,ATP Masters Series Canada Toronto; Canada ATP World Tour,HARD,2,Richard Gasquet,Alexander Kudryavtsev,Richard Gasquet,7-5; 6-3,R32,70,10,0,36,56,31,36,11,20,0,1,11,42,56,5,5,41,70,29,41,12,29,2,5,10,41,70
2008-07-21 00:00:00.000,ATP Masters Series Canada Toronto; Canada ATP World Tour,HARD,2,Igor Andreev,Tomas Berdych,Igor Andreev,6-4; 3-6; 6-4,R32,109,4,0,48,79,38,48,18,31,0,1,14,56,79,11,2,47,79,39,47,15,32,1,3,15,54,79
2008-07-21 00:00:00.000,ATP Masters Series Canada Toronto; Canada ATP World Tour,HARD,2,Rafael Nadal,Jesse Levine,Rafael Nadal,6-4; 6-2,R32,97,2,3,51,67,34,51,8,16,6,7,9,42,67,2,4,30,60,23,30,11,30,3,7,9,34,60
2008-07-21 00:00:00.000,ATP Masters Series Canada Toronto; Canada ATP World Tour,HARD,2,Gilles Simon,Jose Acasuso,Gilles Simon,6-3; 6-4,R16,97,3,1,42,72,33,42,17,30,7,7,10,50,72,2,0,38,71,28,38,13,33,5,7,9,41,71
2008-07-21 00:00:00.000,ATP Masters Series Canada Toronto; Canada ATP World Tour,HARD,2,Marin Cilic,Andy Roddick,Marin Cilic,6-4; 4-6; 6-4,R16,115,7,3,41,82,30,41,26,41,2,5,15,56,82,13,2,61,88,41,61,14,27,5,9,15,55,88
2008-07-21 00:00:00.000,ATP Masters Series Canada Toronto; Canada ATP World Tour,HARD,2,Nicolas Kiefer,Nikolay Davydenko,Nicolas Kiefer,4-6; 6-4; 6-4,R16,180,10,0,53,89,42,53,17,36,2,4,15,59,89,6,1,61,92,44,61,17,31,4,7,15,61,92
2008-07-21 00:00:00.000,ATP Masters Series Canada Toronto; Canada ATP World Tour,HARD,2,James Blake,Dmitry Tursunov,James Blake,4-6; 6-1; 6-4,R16,109,5,1,45,80,34,45,14,35,3,6,13,48,80,9,6,49,90,33,49,16,41,4,10,14,49,90
2008-07-21 00:00:00.000,ATP Masters Series Canada Toronto; Canada ATP World Tour,HARD,2,Andy Murray,Stanislas Wawrinka,Andy Murray,6-2; 0-6; 6-4,R16,114,0,3,40,73,29,40,17,33,4,7,12,46,73,6,1,61,79,39,61,8,18,5,8,12,47,79
2008-07-21 00:00:00.000,ATP Masters Series Canada Toronto; Canada ATP World Tour,HARD,2,Novak Djokovic,Robin Soderling,Novak Djokovic,6-4; 6-4,R16,80,6,1,37,60,30,37,15,23,4,4,10,45,60,9,4,41,56,30,41,7,15,3,5,10,37,56
2008-07-21 00:00:00.000,ATP Masters Series Canada Toronto; Canada ATP World Tour,HARD,2,Richard Gasquet,David Ferrer,Richard Gasquet,6-3; 6-3,R16,82,6,1,29,50,27,29,9,21,3,4,9,36,50,0,1,37,66,23,37,13,29,4,8,9,36,66
2008-07-21 00:00:00.000,ATP Masters Series Canada Toronto; Canada ATP World Tour,HARD,2,Rafael Nadal,Igor Andreev,Rafael Nadal,6-2; 7-6(1),R16,111,4,2,42,54,36,42,8,12,0,0,10,44,54,1,0,50,79,32,50,15,29,7,9,10,47,79
2008-07-21 00:00:00.000,ATP Masters Series Canada Toronto; Canada ATP World Tour,HARD,2,Gilles Simon,Marin Cilic,Gilles Simon,3-6; 6-2; 6-3,Q,142,3,2,70,101,48,70,17,31,8,9,13,65,101,8,4,42,99,28,42,32,57,12,15,13,60,99
2008-07-21 00:00:00.000,ATP Masters Series Canada Toronto; Canada ATP World Tour,HARD,2,Nicolas Kiefer,James Blake,Nicolas Kiefer,6-1; 6-2,Q,60,4,0,20,39,15,20,15,19,1,1,7,30,39,2,1,26,53,14,26,11,27,2,7,8,25,53
2008-07-21 00:00:00.000,ATP Masters Series Canada Toronto; Canada ATP World Tour,HARD,2,Andy Murray,Novak Djokovic,Andy Murray,6-3; 7-6(3),Q,105,2,0,30,73,21,30,27,43,3,5,11,48,73,3,2,39,64,26,39,12,25,3,6,10,38,64
2008-07-21 00:00:00.000,ATP Masters Series Canada Toronto; Canada ATP World Tour,HARD,2,Rafael Nadal,Richard Gasquet,Rafael Nadal,6-7(12); 6-2; 6-1,Q,140,0,1,71,92,48,71,14,21,3,5,14,62,92,10,4,47,85,28,47,17,38,4,10,13,45,85
2008-07-21 00:00:00.000,ATP Masters Series Canada Toronto; Canada ATP World Tour,HARD,2,Nicolas Kiefer,Gilles Simon,Nicolas Kiefer,6-7(4); 6-3; 7-6(5),S,179,11,4,59,121,50,59,28,62,10,13,17,78,121,5,1,63,106,43,63,25,43,4,8,16,68,106
2008-07-21 00:00:00.000,ATP Masters Series Canada Toronto; Canada ATP World Tour,HARD,2,Rafael Nadal,Andy Murray,Rafael Nadal,7-6(2); 6-3,S,122,1,1,59,84,37,59,17,25,2,3,11,54,84,5,0,33,61,22,33,16,28,0,2,10,38,61
2008-07-21 00:00:00.000,ATP Masters Series Canada Toronto; Canada ATP World Tour,HARD,2,Rafael Nadal,Nicolas Kiefer,Rafael Nadal,6-3; 6-2,F,90,2,1,34,52,26,34,12,18,3,3,8,38,52,7,5,24,51,20,24,8,27,0,4,9,28,51
2008-07-28 00:00:00.000,ATP Masters Series Cincinnati OH; U.S.A. ATP World Tour,HARD,2,Roger Federer,N/A Bye,Roger Federer,,R64,0,0,0,0,0,0,0,0,0,0,0,0,0,0,0,0,0,0,0,0,0,0,0,0,0,0,0
2008-07-28 00:00:00.000,ATP Masters Series Cincinnati OH; U.S.A. ATP World Tour,HARD,2,Robby Ginepri,Jonas Bjorkman,Robby Ginepri,6-0; 7-6(5),R64,79,8,1,43,66,35,43,11,23,0,1,9,46,66,3,1,34,54,20,34,11,20,2,6,9,31,54
2008-07-28 00:00:00.000,ATP Masters Series Cincinnati OH; U.S.A. ATP World Tour,HARD,2,Jose Acasuso,Paul Capdeville,Jose Acasuso,5-7; 6-2; 6-2,R64,116,9,2,46,79,36,46,16,33,5,8,14,52,79,7,4,62,100,37,62,16,38,8,14,14,53,100
2008-07-28 00:00:00.000,ATP Masters Series Cincinnati OH; U.S.A. ATP World Tour,HARD,2,Ivo Karlovic,Thomaz Bellucci,Ivo Karlovic,6-3; 6-4,R64,70,18,3,40,58,35,40,8,18,5,5,10,43,58,4,1,33,53,23,33,11,20,4,6,9,34,53
2008-07-28 00:00:00.000,ATP Masters Series Cincinnati OH; U.S.A. ATP World Tour,HARD,2,Tommy Robredo,Mardy Fish,Tommy Robredo,6-2; 6-2,R64,63,2,0,18,38,14,18,18,20,0,0,8,32,38,9,6,25,52,19,25,8,27,5,9,8,27,52
2008-07-28 00:00:00.000,ATP Masters Series Cincinnati OH; U.S.A. ATP World Tour,HARD,2,Robin Soderling,Julien Benneteau,Robin Soderling,6-0; 6-3,R64,57,8,3,30,48,28,30,6,18,5,5,7,34,48,2,1,35,52,19,35,5,17,3,8,8,24,52
2008-07-28 00:00:00.000,ATP Masters Series Cincinnati OH; U.S.A. ATP World Tour,HARD,2,Philipp Kohlschreiber,Michael Yani,Philipp Kohlschreiber,6-3; 6-4,R64,71,6,0,44,57,35,44,8,13,1,1,10,43,57,8,1,35,51,23,35,11,16,0,2,9,34,51
2008-07-28 00:00:00.000,ATP Masters Series Cincinnati OH; U.S.A. ATP World Tour,HARD,2,Woong-Sun Jun,N/A Bye,Woong-Sun Jun,,R64,0,0,0,0,0,0,0,0,0,0,0,0,0,0,0,0,0,0,0,0,0,0,0,0,0,0,0
2008-07-28 00:00:00.000,ATP Masters Series Cincinnati OH; U.S.A. ATP World Tour,HARD,2,Nikolay Davydenko,N/A Bye,Nikolay Davydenko,,R64,0,0,0,0,0,0,0,0,0,0,0,0,0,0,0,0,0,0,0,0,0,0,0,0,0,0,0
2008-07-28 00:00:00.000,ATP Masters Series Cincinnati OH; U.S.A. ATP World Tour,HARD,2,Carlos Moya,Janko Tipsarevic,Carlos Moya,7-6(5); 7-5,R64,123,4,5,52,93,39,52,23,41,5,6,12,62,93,9,6,35,79,30,35,22,44,5,7,12,52,79
2008-07-28 00:00:00.000,ATP Masters Series Cincinnati OH; U.S.A. ATP World Tour,HARD,2,John Isner,Andrea Stoppini,John Isner,7-6(2); 6-3,R64,74,17,1,39,57,39,39,9,18,0,0,11,48,57,6,3,38,62,31,38,11,24,3,4,10,42,62
2008-07-28 00:00:00.000,ATP Masters Series Cincinnati OH; U.S.A. ATP World Tour,HARD,2,Igor Andreev,Radek Stepanek,Igor Andreev,7-6(4); 6-7(4); 7-6(3),R64,171,25,5,72,119,58,72,28,47,5,7,18,86,119,13,8,79,125,64,79,20,46,4,6,18,84,125
2008-07-28 00:00:00.000,ATP Masters Series Cincinnati OH; U.S.A. ATP World Tour,HARD,2,Richard Gasquet,Michael Llodra,Richard Gasquet,3-6; 6-1; 1-0 RET,R64,71,5,1,39,58,26,39,9,19,3,5,8,35,58,1,3,27,46,20,27,6,19,2,6,9,26,46
2008-07-28 00:00:00.000,ATP Masters Series Cincinnati OH; U.S.A. ATP World Tour,HARD,2,Dmitry Tursunov,Marat Safin,Dmitry Tursunov,7-6(5); 6-4,R64,91,6,3,39,62,36,39,15,23,2,2,11,51,62,7,9,31,71,26,31,25,40,6,7,11,51,71
2008-07-28 00:00:00.000,ATP Masters Series Cincinnati OH; U.S.A. ATP World Tour,HARD,2,Sam Querrey,Paul-Henri Mathieu,Sam Querrey,6-4; 4-6; 6-3,R64,112,20,3,56,85,47,56,14,29,3,5,15,61,85,12,7,45,88,36,45,19,43,2,5,14,55,88
2008-07-28 00:00:00.000,ATP Masters Series Cincinnati OH; U.S.A. ATP World Tour,HARD,2,Andy Murray,N/A Bye,Andy Murray,,R64,0,0,0,0,0,0,0,0,0,0,0,0,0,0,0,0,0,0,0,0,0,0,0,0,0,0,0
2008-07-28 00:00:00.000,ATP Masters Series Cincinnati OH; U.S.A. ATP World Tour,HARD,2,James Blake,N/A Bye,James Blake,,R64,0,0,0,0,0,0,0,0,0,0,0,0,0,0,0,0,0,0,0,0,0,0,0,0,0,0,0
2008-07-28 00:00:00.000,ATP Masters Series Cincinnati OH; U.S.A. ATP World Tour,HARD,2,Gilles Simon,Rajeev Ram,Gilles Simon,7-6(5); 6-4,R64,88,3,0,45,64,31,45,12,19,1,3,11,43,64,5,1,44,75,28,44,17,31,1,4,11,45,75
2008-07-28 00:00:00.000,ATP Masters Series Cincinnati OH; U.S.A. ATP World Tour,HARD,2,Ernests Gulbis,Jarkko Nieminen,Ernests Gulbis,7-6(7); 6-2,R64,85,13,4,35,69,30,35,17,34,1,1,10,47,69,0,1,53,70,32,53,9,17,5,7,10,41,70
2008-07-28 00:00:00.000,ATP Masters Series Cincinnati OH; U.S.A. ATP World Tour,HARD,2,Arnaud Clement,Thomas Johansson,Arnaud Clement,7-6(4); 6-7(5); 6-3,R64,156,25,2,60,107,48,60,25,47,4,6,17,73,107,28,9,64,116,49,64,25,52,9,12,16,74,116
2008-07-28 00:00:00.000,ATP Masters Series Cincinnati OH; U.S.A. ATP World Tour,HARD,2,Tomas Berdych,Fernando Gonzalez,Tomas Berdych,6-3; 3-6; 6-3,R64,100,6,2,39,75,31,39,19,36,0,2,14,50,75,7,3,42,68,31,42,16,26,2,5,13,47,68
2008-07-28 00:00:00.000,ATP Masters Series Cincinnati OH; U.S.A. ATP World Tour,HARD,2,Andreas Seppi,Feliciano Lopez,Andreas Seppi,7-5; 7-5,R64,102,9,2,50,92,36,50,20,42,8,10,12,56,92,11,4,38,62,28,38,11,24,4,8,12,39,62
2008-07-28 00:00:00.000,ATP Masters Series Cincinnati OH; U.S.A. ATP World Tour,HARD,2,Simone Bolelli,Kevin Anderson,Simone Bolelli,6-3; 7-6(1),R64,89,5,2,42,68,31,42,20,26,1,1,11,51,68,11,5,44,68,32,44,13,24,4,5,10,45,68
2008-07-28 00:00:00.000,ATP Masters Series Cincinnati OH; U.S.A. ATP World Tour,HARD,2,Novak Djokovic,N/A Bye,Novak Djokovic,,R64,0,0,0,0,0,0,0,0,0,0,0,0,0,0,0,0,0,0,0,0,0,0,0,0,0,0,0
2008-07-28 00:00:00.000,ATP Masters Series Cincinnati OH; U.S.A. ATP World Tour,HARD,2,David Ferrer,N/A Bye,David Ferrer,,R64,0,0,0,0,0,0,0,0,0,0,0,0,0,0,0,0,0,0,0,0,0,0,0,0,0,0,0
2008-07-28 00:00:00.000,ATP Masters Series Cincinnati OH; U.S.A. ATP World Tour,HARD,2,Nicolas Lapentti,Marin Cilic,Nicolas Lapentti,7-6(5); 6-2,R64,86,3,4,41,67,35,41,11,26,2,3,10,46,67,3,4,23,54,20,23,16,31,1,4,10,36,54
2008-07-28 00:00:00.000,ATP Masters Series Cincinnati OH; U.S.A. ATP World Tour,HARD,2,Chris Guccione,Jesse Levine,Chris Guccione,6-3; 6-4,R64,65,17,0,33,55,29,33,14,22,3,3,10,43,55,2,3,36,53,23,36,9,17,2,4,9,32,53
2008-07-28 00:00:00.000,ATP Masters Series Cincinnati OH; U.S.A. ATP World Tour,HARD,2,Fernando Verdasco,Victor Estrella Burgos,Fernando Verdasco,6-3; 7-5,R64,99,7,9,46,67,40,46,6,21,5,5,10,46,67,2,2,60,83,35,60,12,23,5,8,11,47,83
2008-07-28 00:00:00.000,ATP Masters Series Cincinnati OH; U.S.A. ATP World Tour,HARD,2,Tommy Haas,Mikhail Youzhny,Tommy Haas,7-6(2); 2-6; 6-4,R64,129,17,8,52,84,48,52,13,32,3,5,15,61,84,9,8,59,92,44,59,21,33,4,5,15,65,92
2008-07-28 00:00:00.000,ATP Masters Series Cincinnati OH; U.S.A. ATP World Tour,HARD,2,Gael Monfils,Donald Young,Gael Monfils,6-1; 6-1,R64,53,6,3,27,49,24,27,11,22,5,5,7,35,49,0,4,29,48,15,29,6,19,4,9,7,21,48
2008-07-28 00:00:00.000,ATP Masters Series Cincinnati OH; U.S.A. ATP World Tour,HARD,2,Florent Serra,Benjamin Becker,Florent Serra,4-6; 7-6(6); 6-4,R64,126,15,1,55,97,40,55,25,42,0,3,16,65,97,16,7,44,102,36,44,28,58,5,8,16,64,102
2008-07-28 00:00:00.000,ATP Masters Series Cincinnati OH; U.S.A. ATP World Tour,HARD,2,Rafael Nadal,N/A Bye,Rafael Nadal,,R64,0,0,0,0,0,0,0,0,0,0,0,0,0,0,0,0,0,0,0,0,0,0,0,0,0,0,0
2008-07-28 00:00:00.000,ATP Masters Series Cincinnati OH; U.S.A. ATP World Tour,HARD,2,Roger Federer,Robby Ginepri,Roger Federer,6-7(2); 7-6(5); 6-0,R32,133,21,2,60,94,50,60,16,34,3,6,15,66,94,7,4,79,130,51,79,21,51,10,16,15,72,130
2008-07-28 00:00:00.000,ATP Masters Series Cincinnati OH; U.S.A. ATP World Tour,HARD,2,Ivo Karlovic,Jose Acasuso,Ivo Karlovic,6-3; 7-6(3),R32,85,17,0,39,57,37,39,12,18,0,0,11,49,57,2,3,33,70,29,33,16,37,4,5,10,45,70
2008-07-28 00:00:00.000,ATP Masters Series Cincinnati OH; U.S.A. ATP World Tour,HARD,2,Robin Soderling,Tommy Robredo,Robin Soderling,7-6(6); 6-4,R32,95,10,1,37,64,30,37,21,27,0,0,11,51,64,5,2,44,63,37,44,13,19,1,2,11,50,63
2008-07-28 00:00:00.000,ATP Masters Series Cincinnati OH; U.S.A. ATP World Tour,HARD,2,Philipp Kohlschreiber,Woong-Sun Jun,Philipp Kohlschreiber,6-2; 6-2,R32,61,6,1,34,45,27,34,7,11,1,1,8,34,45,0,0,27,44,18,27,3,17,3,7,8,21,44
2008-07-28 00:00:00.000,ATP Masters Series Cincinnati OH; U.S.A. ATP World Tour,HARD,2,Carlos Moya,Nikolay Davydenko,Carlos Moya,7-6(8); 4-6; 6-2,R32,147,6,4,58,100,43,58,24,42,5,7,15,67,100,9,2,58,96,42,58,21,38,8,11,15,63,96
2008-07-28 00:00:00.000,ATP Masters Series Cincinnati OH; U.S.A. ATP World Tour,HARD,2,Igor Andreev,John Isner,Igor Andreev,3-6; 7-6(8); 7-5,R32,144,15,3,79,119,59,79,21,40,7,8,16,80,119,27,2,68,98,57,68,19,30,1,2,17,76,98
2008-07-28 00:00:00.000,ATP Masters Series Cincinnati OH; U.S.A. ATP World Tour,HARD,2,Dmitry Tursunov,Richard Gasquet,Dmitry Tursunov,7-6(8); 6-0,R32,77,5,3,28,53,25,28,18,25,2,2,9,43,53,8,2,41,67,30,41,10,26,5,8,9,40,67
2008-07-28 00:00:00.000,ATP Masters Series Cincinnati OH; U.S.A. ATP World Tour,HARD,2,Andy Murray,Sam Querrey,Andy Murray,7-6(3); 6-1,R32,77,11,5,34,55,28,34,10,21,0,2,10,38,55,7,3,43,76,27,43,11,33,6,10,9,38,76
2008-07-28 00:00:00.000,ATP Masters Series Cincinnati OH; U.S.A. ATP World Tour,HARD,2,James Blake,Gilles Simon,James Blake,6-4; 6-3,R32,61,5,4,32,54,28,32,10,22,1,2,10,38,54,1,0,44,58,23,44,10,14,3,6,9,33,58
2008-07-28 00:00:00.000,ATP Masters Series Cincinnati OH; U.S.A. ATP World Tour,HARD,2,Ernests Gulbis,Arnaud Clement,Ernests Gulbis,6-4; 3-6; 7-6(5),R32,149,12,6,55,91,39,55,19,36,3,6,15,58,91,6,3,58,107,46,58,21,49,4,7,16,67,107
2008-07-28 00:00:00.000,ATP Masters Series Cincinnati OH; U.S.A. ATP World Tour,HARD,2,Andreas Seppi,Tomas Berdych,Andreas Seppi,5-7; 7-5; 7-5,R32,141,9,5,59,100,48,59,23,41,2,4,18,71,100,19,3,63,113,51,63,23,50,4,7,18,74,113
2008-07-28 00:00:00.000,ATP Masters Series Cincinnati OH; U.S.A. ATP World Tour,HARD,2,Novak Djokovic,Simone Bolelli,Novak Djokovic,7-6(2); 7-6(2),R32,114,9,5,54,97,45,54,21,43,10,12,12,66,97,2,0,49,72,37,49,11,23,0,2,12,48,72
2008-07-28 00:00:00.000,ATP Masters Series Cincinnati OH; U.S.A. ATP World Tour,HARD,2,Nicolas Lapentti,David Ferrer,Nicolas Lapentti,7-6(2); 3-6; 6-3,R32,146,2,2,56,104,42,56,24,48,8,11,15,66,104,2,2,51,83,33,51,24,32,3,6,15,57,83
2008-07-28 00:00:00.000,ATP Masters Series Cincinnati OH; U.S.A. ATP World Tour,HARD,2,Fernando Verdasco,Chris Guccione,Fernando Verdasco,7-6(4); 7-6(4),R32,96,2,6,56,80,49,56,13,24,3,3,12,62,80,13,1,51,78,44,51,15,27,1,1,12,59,78
2008-07-28 00:00:00.000,ATP Masters Series Cincinnati OH; U.S.A. ATP World Tour,HARD,2,Tommy Haas,Gael Monfils,Tommy Haas,5-1 RET,R32,26,3,0,13,21,10,13,5,8,2,2,3,15,21,1,1,13,22,8,13,2,9,1,3,3,10,22
2008-07-28 00:00:00.000,ATP Masters Series Cincinnati OH; U.S.A. ATP World Tour,HARD,2,Rafael Nadal,Florent Serra,Rafael Nadal,6-0; 6-1,R32,46,3,2,25,37,21,25,7,12,0,0,7,28,37,1,3,14,33,5,14,6,19,6,11,6,11,33
2008-07-28 00:00:00.000,ATP Masters Series Cincinnati OH; U.S.A. ATP World Tour,HARD,2,Ivo Karlovic,Roger Federer,Ivo Karlovic,7-6(6); 4-6; 7-6(5),R16,130,22,1,78,110,62,78,22,32,2,3,17,84,110,6,0,66,97,58,66,22,31,2,2,17,80,97
2008-07-28 00:00:00.000,ATP Masters Series Cincinnati OH; U.S.A. ATP World Tour,HARD,2,Philipp Kohlschreiber,Robin Soderling,Philipp Kohlschreiber,7-6(4); 5-7; 7-6(8),R16,144,22,1,77,113,55,77,26,36,1,2,18,81,113,23,4,79,124,57,79,28,45,6,6,18,85,124
2008-07-28 00:00:00.000,ATP Masters Series Cincinnati OH; U.S.A. ATP World Tour,HARD,2,Carlos Moya,Igor Andreev,Carlos Moya,6-4; 7-6(2),R16,99,5,3,47,74,35,47,15,27,7,8,11,50,74,6,7,39,67,34,39,12,28,2,4,11,46,67
2008-07-28 00:00:00.000,ATP Masters Series Cincinnati OH; U.S.A. ATP World Tour,HARD,2,Andy Murray,Dmitry Tursunov,Andy Murray,6-3; 6-3,R16,69,5,2,28,53,24,28,12,25,2,3,9,36,53,6,5,30,50,20,30,9,20,3,7,9,29,50
2008-07-28 00:00:00.000,ATP Masters Series Cincinnati OH; U.S.A. ATP World Tour,HARD,2,Ernests Gulbis,James Blake,Ernests Gulbis,6-4; 1-6; 6-3,R16,108,10,3,47,85,35,47,20,38,2,4,13,55,85,6,2,35,77,25,35,26,42,1,3,13,51,77
2008-07-28 00:00:00.000,ATP Masters Series Cincinnati OH; U.S.A. ATP World Tour,HARD,2,Novak Djokovic,Andreas Seppi,Novak Djokovic,6-1; 6-2,R16,59,8,1,23,41,19,23,11,18,0,1,8,30,41,0,5,27,49,17,27,4,22,5,10,7,21,49
2008-07-28 00:00:00.000,ATP Masters Series Cincinnati OH; U.S.A. ATP World Tour,HARD,2,Nicolas Lapentti,Fernando Verdasco,Nicolas Lapentti,6-3; 7-5,R16,94,3,0,49,67,38,49,7,18,2,3,11,45,67,3,6,32,58,23,32,13,26,1,4,10,36,58
2008-07-28 00:00:00.000,ATP Masters Series Cincinnati OH; U.S.A. ATP World Tour,HARD,2,Rafael Nadal,Tommy Haas,Rafael Nadal,6-4; 7-6(0),R16,122,8,3,49,77,35,49,16,28,2,3,11,51,77,7,4,38,69,22,38,21,31,4,6,11,43,69
2008-07-28 00:00:00.000,ATP Masters Series Cincinnati OH; U.S.A. ATP World Tour,HARD,2,Ivo Karlovic,Philipp Kohlschreiber,Ivo Karlovic,7-6(6); 7-6(3),Q,104,24,2,53,74,43,53,15,21,0,0,12,58,74,6,3,47,79,37,47,18,32,1,1,12,55,79
2008-07-28 00:00:00.000,ATP Masters Series Cincinnati OH; U.S.A. ATP World Tour,HARD,2,Andy Murray,Carlos Moya,Andy Murray,2-6; 6-3; 6-1,Q,96,12,6,30,65,25,30,18,35,4,7,12,43,65,4,1,44,72,28,44,8,28,4,9,12,36,72
2008-07-28 00:00:00.000,ATP Masters Series Cincinnati OH; U.S.A. ATP World Tour,HARD,2,Novak Djokovic,Ernests Gulbis,Novak Djokovic,6-3; 6-4,Q,94,6,1,43,64,33,43,12,21,3,3,10,45,64,3,4,42,68,27,42,14,26,3,5,9,41,68
2008-07-28 00:00:00.000,ATP Masters Series Cincinnati OH; U.S.A. ATP World Tour,HARD,2,Rafael Nadal,Nicolas Lapentti,Rafael Nadal,7-6(3); 6-1,Q,108,3,0,42,63,35,42,13,21,3,3,10,48,63,3,1,31,54,19,31,16,23,0,2,9,35,54
2008-07-28 00:00:00.000,ATP Masters Series Cincinnati OH; U.S.A. ATP World Tour,HARD,2,Andy Murray,Ivo Karlovic,Andy Murray,6-4; 6-4,S,82,1,1,41,53,33,41,5,12,3,5,10,38,53,6,0,49,71,30,49,9,22,9,13,10,39,71
2008-07-28 00:00:00.000,ATP Masters Series Cincinnati OH; U.S.A. ATP World Tour,HARD,2,Novak Djokovic,Rafael Nadal,Novak Djokovic,6-1; 7-5,S,86,4,0,32,57,23,32,19,25,1,1,10,42,57,2,1,26,45,19,26,9,19,1,4,9,28,45
2008-07-28 00:00:00.000,ATP Masters Series Cincinnati OH; U.S.A. ATP World Tour,HARD,2,Andy Murray,Novak Djokovic,Andy Murray,7-6(4); 7-6(5),F,143,1,2,46,88,32,46,26,42,3,5,12,58,88,6,6,55,96,36,55,21,41,2,4,12,57,96
2008-08-04 00:00:00.000,Los Angeles CA; USA ATP World Tour,HARD,2,Andy Roddick,N/A Bye,Andy Roddick,,R32,0,0,0,0,0,0,0,0,0,0,0,0,0,0,0,0,0,0,0,0,0,0,0,0,0,0,0
2008-08-04 00:00:00.000,Los Angeles CA; USA ATP World Tour,HARD,2,Dusan Vemic,Sam Warburg,Dusan Vemic,3-6; 7-6(5); 6-4,R32,174,10,10,73,109,50,73,15,36,11,15,15,65,109,8,6,73,115,49,73,19,42,9,13,16,68,115
2008-08-04 00:00:00.000,Los Angeles CA; USA ATP World Tour,HARD,2,Marc Gicquel,Zack Fleishman,Marc Gicquel,6-3; 6-0,R32,50,2,3,28,48,23,28,12,20,1,1,8,35,48,4,4,20,37,8,20,8,17,1,5,7,16,37
2008-08-04 00:00:00.000,Los Angeles CA; USA ATP World Tour,HARD,2,Donald Young,Tommy Haas,Donald Young,6-2; 6-4,R32,83,2,6,26,52,21,26,12,26,1,2,9,33,52,5,2,31,63,20,31,14,32,5,9,9,34,63
2008-08-04 00:00:00.000,Los Angeles CA; USA ATP World Tour,HARD,2,Feliciano Lopez,N/A Bye,Feliciano Lopez,,R32,0,0,0,0,0,0,0,0,0,0,0,0,0,0,0,0,0,0,0,0,0,0,0,0,0,0,0
2008-08-04 00:00:00.000,Los Angeles CA; USA ATP World Tour,HARD,2,Denis Gremelmayr,Fabio Fognini,Denis Gremelmayr,6-4; 6-2,R32,60,4,3,24,49,16,24,16,25,4,6,9,32,49,2,3,26,49,16,26,8,23,1,6,9,24,49
2008-08-04 00:00:00.000,Los Angeles CA; USA ATP World Tour,HARD,2,Wayne Odesnik,Bobby Reynolds,Wayne Odesnik,4-6; 6-1; 6-4,R32,118,9,1,53,85,34,53,23,32,5,7,14,57,85,4,6,51,81,34,51,13,30,6,10,13,47,81
2008-08-04 00:00:00.000,Los Angeles CA; USA ATP World Tour,HARD,2,Marat Safin,John Isner,Marat Safin,6-3; 6-4,R32,77,9,2,32,58,28,32,15,26,1,1,10,43,58,11,2,38,60,29,38,8,22,3,5,9,37,60
2008-08-04 00:00:00.000,Los Angeles CA; USA ATP World Tour,HARD,2,Carlos Moya,Xavier Malisse,Carlos Moya,6-2; 1-6; 7-6(5),R32,127,2,2,43,94,29,43,29,51,8,11,13,58,94,9,2,64,100,43,64,18,36,9,12,14,61,100
2008-08-04 00:00:00.000,Los Angeles CA; USA ATP World Tour,HARD,2,Amer Delic,Dudi Sela,Amer Delic,6-4; 6-4,R32,79,4,4,43,73,34,43,14,30,5,5,10,48,73,0,5,45,77,29,45,17,32,4,6,10,46,77
2008-08-04 00:00:00.000,Los Angeles CA; USA ATP World Tour,HARD,2,Andrea Stoppini,Igor Kunitsyn,Andrea Stoppini,6-1; 6-3,R32,61,2,2,30,49,21,30,7,19,4,7,8,28,49,0,3,26,49,12,26,6,23,3,10,8,18,49
2008-08-04 00:00:00.000,Los Angeles CA; USA ATP World Tour,HARD,2,Juan Martin Del Potro,N/A Bye,Juan Martin Del Potro,,R32,0,0,0,0,0,0,0,0,0,0,0,0,0,0,0,0,0,0,0,0,0,0,0,0,0,0,0
2008-08-04 00:00:00.000,Los Angeles CA; USA ATP World Tour,HARD,2,Mardy Fish,Alejandro Falla,Mardy Fish,6-2; 6-2,R32,62,4,1,20,46,17,20,17,26,3,3,8,34,46,0,3,22,52,11,22,16,30,3,7,8,27,52
2008-08-04 00:00:00.000,Los Angeles CA; USA ATP World Tour,HARD,2,Vincent Spadea,Sebastien Grosjean,Vincent Spadea,6-3; 3-6; 6-3,R32,118,2,4,54,98,36,54,23,44,7,10,14,59,98,1,3,46,83,33,46,17,37,3,7,13,50,83
2008-08-04 00:00:00.000,Los Angeles CA; USA ATP World Tour,HARD,2,Florent Serra,Andrey Golubev,Florent Serra,6-4; 6-1,R32,56,1,1,32,48,26,32,8,16,0,1,9,34,48,1,1,24,41,14,24,6,17,0,4,8,20,41
2008-08-04 00:00:00.000,Los Angeles CA; USA ATP World Tour,HARD,2,Fernando Verdasco,N/A Bye,Fernando Verdasco,,R32,0,0,0,0,0,0,0,0,0,0,0,0,0,0,0,0,0,0,0,0,0,0,0,0,0,0,0
2008-08-04 00:00:00.000,Los Angeles CA; USA ATP World Tour,HARD,2,Andy Roddick,Dusan Vemic,Andy Roddick,6-2; 6-2,R16,73,8,4,31,47,27,31,7,16,4,4,8,34,47,4,2,43,61,25,43,7,18,4,8,8,32,61
2008-08-04 00:00:00.000,Los Angeles CA; USA ATP World Tour,HARD,2,Marc Gicquel,Donald Young,Marc Gicquel,6-3; 6-3,R16,71,5,2,35,60,26,35,15,25,2,2,9,41,60,4,2,32,53,23,32,10,21,4,7,9,33,53
2008-08-04 00:00:00.000,Los Angeles CA; USA ATP World Tour,HARD,2,Denis Gremelmayr,Feliciano Lopez,Denis Gremelmayr,7-5; 7-5,R16,115,5,1,41,81,29,41,23,40,7,8,12,52,81,11,4,43,79,28,43,19,36,5,8,12,47,79
2008-08-04 00:00:00.000,Los Angeles CA; USA ATP World Tour,HARD,2,Marat Safin,Wayne Odesnik,Marat Safin,6-3; 6-2,R16,80,11,3,32,61,25,32,11,29,3,5,9,36,61,0,4,23,48,12,23,10,25,1,6,8,22,48
2008-08-04 00:00:00.000,Los Angeles CA; USA ATP World Tour,HARD,2,Amer Delic,Carlos Moya,Amer Delic,6-2; 6-7(5); 7-6(5),R16,139,14,3,76,116,57,76,20,40,6,8,16,77,116,6,5,59,97,45,59,20,38,0,4,16,65,97
2008-08-04 00:00:00.000,Los Angeles CA; USA ATP World Tour,HARD,2,Juan Martin Del Potro,Andrea Stoppini,Juan Martin Del Potro,6-4; 6-2,R16,70,3,2,30,46,24,30,11,16,1,2,9,35,46,3,4,41,66,22,41,13,25,7,11,9,35,66
2008-08-04 00:00:00.000,Los Angeles CA; USA ATP World Tour,HARD,2,Mardy Fish,Vincent Spadea,Mardy Fish,6-7(5); 6-1; 6-0,R16,111,14,2,45,94,36,45,25,49,8,9,13,61,94,3,9,42,85,27,42,17,43,5,11,12,44,85
2008-08-04 00:00:00.000,Los Angeles CA; USA ATP World Tour,HARD,2,Florent Serra,Fernando Verdasco,Florent Serra,6-2; 7-6(4),R16,109,2,0,58,79,40,58,8,21,5,7,10,48,79,0,10,56,81,35,56,7,25,3,7,10,42,81
2008-08-04 00:00:00.000,Los Angeles CA; USA ATP World Tour,HARD,2,Andy Roddick,Marc Gicquel,Andy Roddick,6-3; 6-1,Q,66,6,0,33,47,26,33,8,14,1,1,8,34,47,6,3,28,53,17,28,11,25,5,9,8,28,53
2008-08-04 00:00:00.000,Los Angeles CA; USA ATP World Tour,HARD,2,Denis Gremelmayr,Marat Safin,Denis Gremelmayr,3-6; 6-3; 6-2,Q,106,3,2,46,74,32,46,17,28,2,4,13,49,74,5,5,42,82,31,42,16,40,4,8,13,47,82
2008-08-04 00:00:00.000,Los Angeles CA; USA ATP World Tour,HARD,2,Juan Martin Del Potro,Amer Delic,Juan Martin Del Potro,7-6(6); 6-2,Q,89,7,2,44,60,34,44,11,16,4,5,10,45,60,3,1,40,70,26,40,14,30,3,6,10,40,70
2008-08-04 00:00:00.000,Los Angeles CA; USA ATP World Tour,HARD,2,Mardy Fish,Florent Serra,Mardy Fish,6-4; 6-4,Q,76,8,3,35,64,26,35,17,29,1,2,10,43,64,3,1,49,61,29,49,8,12,2,5,10,37,61
2008-08-04 00:00:00.000,Los Angeles CA; USA ATP World Tour,HARD,2,Andy Roddick,Denis Gremelmayr,Andy Roddick,6-2; 6-2,S,62,6,0,32,46,24,32,11,14,4,4,8,35,46,4,2,32,47,19,32,7,15,7,11,8,26,47
2008-08-04 00:00:00.000,Los Angeles CA; USA ATP World Tour,HARD,2,Juan Martin Del Potro,Mardy Fish,Juan Martin Del Potro,6-2; 6-1,S,82,1,2,32,48,24,32,9,16,2,2,7,33,48,4,1,30,64,19,30,12,34,8,13,8,31,64
2008-08-04 00:00:00.000,Los Angeles CA; USA ATP World Tour,HARD,2,Juan Martin Del Potro,Andy Roddick,Juan Martin Del Potro,6-1; 7-6(2),F,89,1,1,43,58,36,43,8,15,0,0,9,44,58,4,2,40,64,28,40,10,24,1,4,10,38,64
2008-08-10 00:00:00.000,Washington DC; USA ATP World Tour,HARD,2,Andy Roddick,Ramon Delgado,Andy Roddick,6-3; 7-6(4),R32,87,21,8,45,73,35,45,14,28,1,3,11,49,73,7,4,35,65,29,35,10,30,2,5,10,39,65
2008-08-10 00:00:00.000,Washington DC; USA ATP World Tour,HARD,2,Eduardo Schwank,Sebastien Grosjean,Eduardo Schwank,6-3; 4-6; 6-3,R32,120,5,4,52,84,37,52,21,32,6,8,14,58,84,1,1,47,81,33,47,16,34,2,6,14,49,81
2008-08-10 00:00:00.000,Washington DC; USA ATP World Tour,HARD,2,Viktor Troicki,Denis Gremelmayr,Viktor Troicki,6-4; 6-2,R32,70,5,0,32,51,26,32,11,19,0,0,9,37,51,4,2,29,56,17,29,14,27,0,3,9,31,56
2008-08-10 00:00:00.000,Washington DC; USA ATP World Tour,HARD,2,Bobby Reynolds,Marc Gicquel,Bobby Reynolds,7-6(2); 3-6; 6-4,R32,121,12,2,56,102,41,56,26,46,5,8,15,67,102,8,4,51,88,41,51,16,37,1,4,16,57,88
2008-08-10 00:00:00.000,Washington DC; USA ATP World Tour,HARD,2,Robert Kendrick,Feliciano Lopez,Robert Kendrick,6-3; 7-5,R32,66,13,4,40,57,37,40,8,17,2,3,11,45,57,8,3,37,57,25,37,10,20,1,4,10,35,57
2008-08-10 00:00:00.000,Washington DC; USA ATP World Tour,HARD,2,Somdev Devvarman,Taylor Dent,Somdev Devvarman,7-6(3); 2-6; 6-1,R32,107,1,1,60,80,42,60,12,20,1,4,14,54,80,4,4,58,92,41,58,15,34,1,4,13,56,92
2008-08-10 00:00:00.000,Washington DC; USA ATP World Tour,HARD,2,Igor Kunitsyn,Mischa Zverev,Igor Kunitsyn,6-7(6); 6-4; 6-2,R32,122,4,1,68,90,50,68,14,22,1,2,15,64,90,11,3,66,113,49,66,18,47,10,14,15,67,113
2008-08-10 00:00:00.000,Washington DC; USA ATP World Tour,HARD,2,Fabio Fognini,Marat Safin,Fabio Fognini,7-5 RET,R32,56,1,2,17,35,12,17,10,18,2,3,6,22,35,3,2,19,43,13,19,12,24,4,6,6,25,43
2008-08-10 00:00:00.000,Washington DC; USA ATP World Tour,HARD,2,Alejandro Falla,Mardy Fish,Alejandro Falla,5-7; 6-4; 6-2,R32,127,7,4,47,89,35,47,22,42,2,5,15,57,89,6,8,29,84,23,29,24,55,2,7,15,47,84
2008-08-10 00:00:00.000,Washington DC; USA ATP World Tour,HARD,2,Florent Serra,Uladzimir Ignatik,Florent Serra,7-6(3); 6-3,R32,74,5,1,40,68,32,40,18,28,2,4,11,50,68,4,5,40,60,26,40,9,20,3,6,10,35,60
2008-08-10 00:00:00.000,Washington DC; USA ATP World Tour,HARD,2,Nicolas Mahut,Wayne Odesnik,Nicolas Mahut,4-6; 6-4; 6-4,R32,145,17,2,52,87,41,52,19,35,3,5,15,60,87,8,5,80,130,54,80,20,50,12,15,15,74,130
2008-08-10 00:00:00.000,Washington DC; USA ATP World Tour,HARD,2,Tommy Haas,Rik De Voest,Tommy Haas,6-4; 4-6; 6-1,R32,101,7,2,40,64,31,40,14,24,1,3,13,45,64,4,4,47,88,29,47,22,41,7,12,14,51,88
2008-08-10 00:00:00.000,Washington DC; USA ATP World Tour,HARD,2,John Isner,Marcel Granollers,John Isner,6-3; 6-7(5); 7-6(1),R32,128,12,7,81,110,61,81,15,29,4,6,17,76,110,6,7,53,93,41,53,22,40,1,4,16,63,93
2008-08-10 00:00:00.000,Washington DC; USA ATP World Tour,HARD,2,Donald Young,Luis Horna,Donald Young,6-3; 6-1,R32,61,4,2,23,44,20,23,13,21,1,1,8,33,44,2,1,35,57,20,35,10,22,6,10,8,30,57
2008-08-10 00:00:00.000,Washington DC; USA ATP World Tour,HARD,2,Dudi Sela,Vincent Spadea,Dudi Sela,7-6(6); 6-3,R32,87,2,2,44,71,34,44,14,27,5,6,10,48,71,2,1,43,73,24,43,18,30,1,4,11,42,73
2008-08-10 00:00:00.000,Washington DC; USA ATP World Tour,HARD,2,Juan Martin Del Potro,Jesse Levine,Juan Martin Del Potro,6-2; 6-3,R32,73,6,1,36,52,25,36,8,16,2,4,9,33,52,0,4,32,59,16,32,10,27,6,11,8,26,59
2008-08-10 00:00:00.000,Washington DC; USA ATP World Tour,HARD,2,Andy Roddick,Eduardo Schwank,Andy Roddick,4-6; 6-4; 7-6(2),R16,163,12,7,61,105,44,61,26,44,8,11,16,70,105,12,2,89,135,57,89,24,46,13,16,16,81,135
2008-08-10 00:00:00.000,Washington DC; USA ATP World Tour,HARD,2,Viktor Troicki,Bobby Reynolds,Viktor Troicki,6-4; 1-6; 6-4,R16,112,10,2,51,82,37,51,13,31,9,12,13,50,82,4,3,56,93,39,56,18,37,8,11,14,57,93
2008-08-10 00:00:00.000,Washington DC; USA ATP World Tour,HARD,2,Somdev Devvarman,Robert Kendrick,Somdev Devvarman,6-2; 6-7(5); 7-5,R16,142,2,1,69,106,53,69,19,37,2,3,16,72,106,7,3,61,117,48,61,23,56,9,13,16,71,117
2008-08-10 00:00:00.000,Washington DC; USA ATP World Tour,HARD,2,Igor Kunitsyn,Fabio Fognini,Igor Kunitsyn,2-6; 6-2; 7-6(6),R16,136,0,1,63,86,37,63,13,23,1,6,14,50,86,5,7,50,113,40,50,19,63,10,15,14,59,113
2008-08-10 00:00:00.000,Washington DC; USA ATP World Tour,HARD,2,Alejandro Falla,Florent Serra,Alejandro Falla,7-6(2); 7-6(11),R16,145,4,3,57,117,39,57,33,60,11,14,12,72,117,1,2,60,93,41,60,17,33,8,11,12,58,93
2008-08-10 00:00:00.000,Washington DC; USA ATP World Tour,HARD,2,Tommy Haas,Nicolas Mahut,Tommy Haas,7-6(4); 6-3,R16,95,12,7,39,63,35,39,11,24,5,6,10,46,63,7,4,52,87,34,52,14,35,6,9,11,48,87
2008-08-10 00:00:00.000,Washington DC; USA ATP World Tour,HARD,2,John Isner,Donald Young,John Isner,6-4; 7-6(4),R16,77,17,3,48,66,38,48,12,18,0,0,11,50,66,3,0,35,61,28,35,17,26,0,1,11,45,61
2008-08-10 00:00:00.000,Washington DC; USA ATP World Tour,HARD,2,Juan Martin Del Potro,Dudi Sela,Juan Martin Del Potro,6-0; 5-7; 6-2,R16,109,2,2,46,74,36,46,15,28,0,2,13,51,74,2,7,43,84,24,43,17,41,9,15,13,41,84
2008-08-10 00:00:00.000,Washington DC; USA ATP World Tour,HARD,2,Viktor Troicki,Andy Roddick,Viktor Troicki,0-6; 6-2; 6-4,Q,101,11,4,47,79,34,47,14,32,5,8,12,48,79,13,3,44,72,33,44,14,28,3,6,12,47,72
2008-08-10 00:00:00.000,Washington DC; USA ATP World Tour,HARD,2,Igor Kunitsyn,Somdev Devvarman,Igor Kunitsyn,6-4; 6-1,Q,83,2,0,34,55,21,34,11,21,0,3,9,32,55,0,0,31,54,17,31,6,23,3,9,8,23,54
2008-08-10 00:00:00.000,Washington DC; USA ATP World Tour,HARD,2,Tommy Haas,Alejandro Falla,Tommy Haas,7-5; 6-1,Q,83,8,2,33,66,29,33,13,33,6,8,10,42,66,3,2,28,55,16,28,12,27,7,12,9,28,55
2008-08-10 00:00:00.000,Washington DC; USA ATP World Tour,HARD,2,Juan Martin Del Potro,John Isner,Juan Martin Del Potro,6-4; 6-4,Q,70,6,0,30,49,25,30,15,19,0,0,10,40,49,7,1,36,51,28,36,7,15,0,2,10,35,51
2008-08-10 00:00:00.000,Washington DC; USA ATP World Tour,HARD,2,Viktor Troicki,Igor Kunitsyn,Viktor Troicki,6-4; 6-2,S,76,7,0,29,47,24,29,11,18,1,2,9,35,47,0,0,44,61,23,44,8,17,5,9,9,31,61
2008-08-10 00:00:00.000,Washington DC; USA ATP World Tour,HARD,2,Juan Martin Del Potro,Tommy Haas,Juan Martin Del Potro,6-2; 6-1,S,83,4,2,30,55,26,30,9,25,1,1,7,35,55,5,3,36,57,17,36,9,21,5,10,8,26,57
2008-08-10 00:00:00.000,Washington DC; USA ATP World Tour,HARD,2,Juan Martin Del Potro,Viktor Troicki,Juan Martin Del Potro,6-3; 6-3,F,93,5,7,37,68,30,37,14,31,6,7,9,44,68,9,4,32,59,25,32,7,27,5,9,9,32,59
2008-08-11 00:00:00.000,Beijing Olympics China ATP World Tour,HARD,2,Roger Federer,Dmitry Tursunov,Roger Federer,6-4; 6-2,R64,66,5,0,32,52,28,32,12,20,2,2,9,40,52,3,4,17,46,14,17,13,29,3,6,9,27,46
2008-08-11 00:00:00.000,Beijing Olympics China ATP World Tour,HARD,2,Rafael Arevalo,Hyung-Taik Lee,Rafael Arevalo,4-6; 6-3; 6-4,R64,129,5,4,59,91,42,59,19,32,5,7,15,61,91,2,1,57,90,36,57,21,33,5,8,14,57,90
2008-08-11 00:00:00.000,Beijing Olympics China ATP World Tour,HARD,2,Andreas Seppi,Tommy Robredo,Andreas Seppi,6-4; 4-6; 8-6,R64,150,1,6,63,106,41,63,25,43,5,9,17,66,106,5,6,50,93,36,50,21,43,0,5,17,57,93
2008-08-11 00:00:00.000,Beijing Olympics China ATP World Tour,HARD,2,Tomas Berdych,Xin-Yuan Yu,Tomas Berdych,6-1; 6-2,R64,55,8,2,23,36,21,23,7,13,0,0,7,28,36,3,3,29,50,16,29,7,21,3,8,8,23,50
2008-08-11 00:00:00.000,Beijing Olympics China ATP World Tour,HARD,2,Gilles Simon,Robin Soderling,Gilles Simon,6-4; 6-4,R64,74,1,2,26,52,19,26,16,26,0,2,10,35,52,8,1,33,63,22,33,13,30,5,9,10,35,63
2008-08-11 00:00:00.000,Beijing Olympics China ATP World Tour,HARD,2,Guillermo Canas,Frederic Niemeyer,Guillermo Canas,3-6; 4-2 RET,R64,79,1,7,14,46,10,14,17,32,5,7,7,27,46,5,7,35,61,24,35,12,26,8,10,8,36,61
2008-08-11 00:00:00.000,Beijing Olympics China ATP World Tour,HARD,2,Dominik Hrbaty,Thomaz Bellucci,Dominik Hrbaty,2-6; 6-4; 6-2,R64,112,5,4,51,85,35,51,18,34,7,10,13,53,85,8,2,37,74,28,37,18,37,2,6,13,46,74
2008-08-11 00:00:00.000,Beijing Olympics China ATP World Tour,HARD,2,James Blake,Chris Guccione,James Blake,6-3; 7-6(3),R64,73,2,4,39,67,33,39,18,28,1,1,11,51,67,11,0,36,59,27,36,15,23,0,1,10,42,59
2008-08-11 00:00:00.000,Beijing Olympics China ATP World Tour,HARD,2,Nikolay Davydenko,Ernests Gulbis,Nikolay Davydenko,6-4; 6-2,R64,81,5,1,27,46,21,27,13,19,0,1,9,34,46,4,2,40,61,25,40,6,21,9,13,9,31,61
2008-08-11 00:00:00.000,Beijing Olympics China ATP World Tour,HARD,2,Paul-Henri Mathieu,Nicolas Lapentti,Paul-Henri Mathieu,7-6(4); 6-2,R64,99,5,6,38,65,31,38,15,27,0,0,10,46,65,4,1,40,60,27,40,10,20,0,2,10,37,60
2008-08-11 00:00:00.000,Beijing Olympics China ATP World Tour,HARD,2,Kevin Anderson,Komlavi Loglo,Kevin Anderson,6-3; 6-2,R64,59,3,2,22,44,20,22,16,22,0,0,9,36,44,1,0,29,44,17,29,9,15,1,4,8,26,44
2008-08-11 00:00:00.000,Beijing Olympics China ATP World Tour,HARD,2,Nicolas Kiefer,Max Mirnyi,Nicolas Kiefer,6-3; 6-1,R64,71,7,2,32,50,28,32,8,18,2,2,8,36,50,4,2,30,51,15,30,10,21,2,6,8,25,51
2008-08-11 00:00:00.000,Beijing Olympics China ATP World Tour,HARD,2,Fernando Gonzalez,Peng Sun,Fernando Gonzalez,6-4; 6-4,R64,68,10,1,30,48,25,30,15,18,0,0,10,40,48,1,2,26,54,16,26,21,28,2,4,10,37,54
2008-08-11 00:00:00.000,Beijing Olympics China ATP World Tour,HARD,2,Marin Cilic,Juan Monaco,Marin Cilic,6-4; 6-7(5); 6-3,R64,167,6,3,41,89,34,41,29,48,3,4,15,63,89,0,4,68,112,40,68,28,44,7,11,16,68,112
2008-08-11 00:00:00.000,Beijing Olympics China ATP World Tour,HARD,2,Olivier Rochus,Ivo Minar,Olivier Rochus,6-3; 3-6; 6-3,R64,118,6,5,54,89,40,54,21,35,4,5,14,61,89,6,0,57,79,37,57,14,22,1,3,13,51,79
2008-08-11 00:00:00.000,Beijing Olympics China ATP World Tour,HARD,2,Janko Tipsarevic,David Ferrer,Janko Tipsarevic,7-6(8); 6-2,R64,129,5,2,32,66,26,32,19,34,1,2,10,45,66,2,4,52,93,32,52,20,41,10,13,10,52,93
2008-08-11 00:00:00.000,Beijing Olympics China ATP World Tour,HARD,2,David Nalbandian,Shao-Xuan Zeng,David Nalbandian,6-2; 6-1,R64,66,3,6,22,52,17,22,15,30,5,6,7,32,52,3,4,30,53,14,30,7,23,3,9,8,21,53
2008-08-11 00:00:00.000,Beijing Olympics China ATP World Tour,HARD,2,Nicolas Massu,Steve Darcis,Nicolas Massu,6-4; 7-5,R64,98,4,2,48,69,34,48,13,21,5,7,11,47,69,3,1,36,63,25,36,11,27,4,8,11,36,63
2008-08-11 00:00:00.000,Beijing Olympics China ATP World Tour,HARD,2,Victor Hanescu,Simone Bolelli,Victor Hanescu,7-5; 3-6; 6-4,R64,135,7,1,63,101,45,63,20,38,7,10,16,65,101,5,1,61,91,41,61,16,30,4,7,15,57,91
2008-08-11 00:00:00.000,Beijing Olympics China ATP World Tour,HARD,2,Gael Monfils,Nicolas Almagro,Gael Monfils,6-4; 3-6; 6-3,R64,115,13,2,49,80,42,49,12,31,4,7,14,54,80,2,3,48,86,30,48,23,38,5,9,14,53,86
2008-08-11 00:00:00.000,Beijing Olympics China ATP World Tour,HARD,2,Mikhail Youzhny,Jiri Vanek,Mikhail Youzhny,6-4; 6-1,R64,64,6,1,26,48,23,26,11,22,0,1,9,34,48,7,0,39,58,22,39,6,19,5,9,8,28,58
2008-08-11 00:00:00.000,Beijing Olympics China ATP World Tour,HARD,2,Thomas Johansson,Jarkko Nieminen,Thomas Johansson,4-6; 6-4; 6-4,R64,138,11,2,46,102,35,46,27,56,9,12,15,62,102,1,2,71,102,48,71,15,31,9,13,15,63,102
2008-08-11 00:00:00.000,Beijing Olympics China ATP World Tour,HARD,2,Rainer Schuettler,Kei Nishikori,Rainer Schuettler,6-4; 6-7(5); 6-3,R64,168,4,3,60,101,44,60,20,41,9,12,15,64,101,5,6,65,116,42,65,21,51,10,16,16,63,116
2008-08-11 00:00:00.000,Beijing Olympics China ATP World Tour,HARD,2,Novak Djokovic,Robby Ginepri,Novak Djokovic,6-4; 6-4,R64,72,6,1,38,51,28,38,7,13,1,3,10,35,51,3,4,30,58,18,30,15,28,1,5,10,33,58
2008-08-11 00:00:00.000,Beijing Olympics China ATP World Tour,HARD,2,Yen-Hsun Lu,Andy Murray,Yen-Hsun Lu,7-6(5); 6-4,R64,130,1,5,51,91,39,51,14,40,8,11,11,53,91,3,2,56,92,33,56,17,36,7,11,11,50,92
2008-08-11 00:00:00.000,Beijing Olympics China ATP World Tour,HARD,2,Agustin Calleri,Devin Mullings,Agustin Calleri,6-1; 6-1,R64,60,4,2,25,48,21,25,13,23,4,4,7,34,48,0,3,38,53,18,38,5,15,7,12,7,23,53
2008-08-11 00:00:00.000,Beijing Olympics China ATP World Tour,HARD,2,Jurgen Melzer,Marcos Daniel,Jurgen Melzer,6-7(9); 6-1; 8-6,R64,145,10,3,69,104,53,69,19,35,3,6,17,72,104,6,4,58,113,39,58,24,55,7,13,16,63,113
2008-08-11 00:00:00.000,Beijing Olympics China ATP World Tour,HARD,2,Stanislas Wawrinka,Frank Dancevic,Stanislas Wawrinka,4-6; 6-3; 6-2,R64,113,3,3,40,73,32,40,21,33,1,3,14,53,73,3,4,43,84,31,43,17,41,7,11,13,48,84
2008-08-11 00:00:00.000,Beijing Olympics China ATP World Tour,HARD,2,Michael Llodra,Radek Stepanek,Michael Llodra,4-6; 7-6(5); 11-9,R64,167,20,6,74,118,59,74,24,44,2,5,21,83,118,14,6,76,126,60,76,25,50,8,11,21,85,126
2008-08-11 00:00:00.000,Beijing Olympics China ATP World Tour,HARD,2,Igor Andreev,Sam Querrey,Igor Andreev,6-4; 6-4,R64,73,5,2,33,58,26,33,16,25,2,2,10,42,58,5,0,32,51,28,32,8,19,2,4,10,36,51
2008-08-11 00:00:00.000,Beijing Olympics China ATP World Tour,HARD,2,Lleyton Hewitt,Jonas Bjorkman,Lleyton Hewitt,7-5; 7-6(2),R64,118,5,3,31,70,24,31,21,39,1,4,12,45,70,6,5,44,87,28,44,20,43,2,6,12,48,87
2008-08-11 00:00:00.000,Beijing Olympics China ATP World Tour,HARD,2,Rafael Nadal,Potito Starace,Rafael Nadal,6-2; 3-6; 6-2,R64,135,4,1,40,63,33,40,13,23,2,3,12,46,63,1,1,74,99,44,74,12,25,9,13,13,56,99
2008-08-11 00:00:00.000,Beijing Olympics China ATP World Tour,HARD,2,Roger Federer,Rafael Arevalo,Roger Federer,6-2; 6-4,R32,77,7,0,27,47,21,27,16,20,1,1,9,37,47,0,2,45,59,26,45,8,14,7,10,9,34,59
2008-08-11 00:00:00.000,Beijing Olympics China ATP World Tour,HARD,2,Tomas Berdych,Andreas Seppi,Tomas Berdych,6-3; 7-6(4),R32,98,14,3,35,61,31,35,15,26,0,1,11,46,61,4,6,34,75,28,34,18,41,5,7,10,46,75
2008-08-11 00:00:00.000,Beijing Olympics China ATP World Tour,HARD,2,Gilles Simon,Guillermo Canas,Gilles Simon,7-5; 6-1,R32,88,2,2,32,56,25,32,15,24,0,1,10,40,56,2,3,34,66,21,34,13,32,4,8,9,34,66
2008-08-11 00:00:00.000,Beijing Olympics China ATP World Tour,HARD,2,James Blake,Dominik Hrbaty,James Blake,7-6(3); 4-6; 6-3,R32,128,6,3,52,108,30,52,31,56,8,13,15,61,108,1,10,61,106,39,61,18,45,8,14,16,57,106
2008-08-11 00:00:00.000,Beijing Olympics China ATP World Tour,HARD,2,Paul-Henri Mathieu,Nikolay Davydenko,Paul-Henri Mathieu,7-5; 6-3,R32,92,4,3,25,57,23,25,18,32,0,1,11,41,57,5,3,30,57,24,30,11,27,3,6,10,35,57
2008-08-11 00:00:00.000,Beijing Olympics China ATP World Tour,HARD,2,Nicolas Kiefer,Kevin Anderson,Nicolas Kiefer,6-4; 6-7(4); 6-4,R32,201,13,2,50,101,44,50,26,51,3,4,16,70,101,14,6,74,122,55,74,19,48,10,13,16,74,122
2008-08-11 00:00:00.000,Beijing Olympics China ATP World Tour,HARD,2,Fernando Gonzalez,Marin Cilic,Fernando Gonzalez,6-4; 6-2,R32,71,3,2,35,56,27,35,15,21,3,3,9,42,56,5,5,22,51,20,22,11,29,1,4,9,31,51
2008-08-11 00:00:00.000,Beijing Olympics China ATP World Tour,HARD,2,Olivier Rochus,Janko Tipsarevic,Olivier Rochus,7-6(5); 2-3 RET,R32,118,1,1,32,64,18,32,18,32,7,10,8,36,64,6,5,26,57,20,26,12,31,2,5,9,32,57
2008-08-11 00:00:00.000,Beijing Olympics China ATP World Tour,HARD,2,David Nalbandian,Nicolas Massu,David Nalbandian,7-6(0); 6-1,R32,86,8,4,38,64,32,38,13,26,1,2,10,45,64,5,4,32,55,20,32,11,23,1,4,9,31,55
2008-08-11 00:00:00.000,Beijing Olympics China ATP World Tour,HARD,2,Gael Monfils,Victor Hanescu,Gael Monfils,6-4; 7-6(5),R32,98,9,1,44,68,33,44,13,24,2,4,11,46,68,0,0,46,62,33,46,7,16,1,4,11,40,62
2008-08-11 00:00:00.000,Beijing Olympics China ATP World Tour,HARD,2,Mikhail Youzhny,Thomas Johansson,Mikhail Youzhny,7-5; 6-2,R32,106,5,4,36,70,27,36,16,34,4,5,10,43,70,5,4,43,87,26,43,19,44,9,13,10,45,87
2008-08-11 00:00:00.000,Beijing Olympics China ATP World Tour,HARD,2,Novak Djokovic,Rainer Schuettler,Novak Djokovic,6-4; 6-2,R32,74,5,2,31,43,29,31,5,12,0,1,9,34,43,2,3,37,64,25,37,9,27,7,11,9,34,64
2008-08-11 00:00:00.000,Beijing Olympics China ATP World Tour,HARD,2,Yen-Hsun Lu,Agustin Calleri,Yen-Hsun Lu,6-4; 6-4,R32,82,3,1,27,50,22,27,17,23,0,1,10,39,50,5,6,40,68,29,40,10,28,7,10,10,39,68
2008-08-11 00:00:00.000,Beijing Olympics China ATP World Tour,HARD,2,Jurgen Melzer,Stanislas Wawrinka,Jurgen Melzer,6-4; 6-0,R32,65,1,0,35,53,25,35,12,18,1,1,8,37,53,2,2,32,47,16,32,7,15,2,6,8,23,47
2008-08-11 00:00:00.000,Beijing Olympics China ATP World Tour,HARD,2,Igor Andreev,Michael Llodra,Igor Andreev,6-4; 3-6; 6-1,R32,119,8,2,50,81,36,50,19,31,2,3,13,55,81,9,2,59,89,38,59,15,30,6,9,13,53,89
2008-08-11 00:00:00.000,Beijing Olympics China ATP World Tour,HARD,2,Rafael Nadal,Lleyton Hewitt,Rafael Nadal,6-1; 6-2,R32,91,4,2,38,56,25,38,11,18,5,6,8,36,56,2,0,25,54,17,25,6,29,4,9,7,23,54
2008-08-11 00:00:00.000,Beijing Olympics China ATP World Tour,HARD,2,Roger Federer,Tomas Berdych,Roger Federer,6-3; 7-6(4),R16,90,11,3,37,61,32,37,12,24,1,3,11,44,61,4,4,33,75,20,33,22,42,6,9,10,42,75
2008-08-11 00:00:00.000,Beijing Olympics China ATP World Tour,HARD,2,James Blake,Gilles Simon,James Blake,6-4; 6-2,R16,76,7,6,45,84,37,45,16,39,8,8,9,53,84,1,3,22,52,15,22,16,30,2,5,9,31,52
2008-08-11 00:00:00.000,Beijing Olympics China ATP World Tour,HARD,2,Paul-Henri Mathieu,Nicolas Kiefer,Paul-Henri Mathieu,6-3; 7-5,R16,104,3,5,25,59,24,25,18,34,1,2,11,42,59,4,3,33,71,21,33,19,38,3,6,10,40,71
2008-08-11 00:00:00.000,Beijing Olympics China ATP World Tour,HARD,2,Fernando Gonzalez,Olivier Rochus,Fernando Gonzalez,6-0; 6-3,R16,58,3,0,30,47,24,30,10,17,0,0,8,34,47,2,3,24,39,12,24,5,15,2,6,7,17,39
2008-08-11 00:00:00.000,Beijing Olympics China ATP World Tour,HARD,2,Gael Monfils,David Nalbandian,Gael Monfils,6-4; 6-4,R16,91,12,4,28,55,22,28,17,27,3,4,10,39,55,0,5,29,66,20,29,19,37,3,6,10,39,66
2008-08-11 00:00:00.000,Beijing Olympics China ATP World Tour,HARD,2,Novak Djokovic,Mikhail Youzhny,Novak Djokovic,7-6(3); 6-3,R16,97,4,0,40,54,35,40,9,14,0,0,10,44,54,6,4,39,71,28,39,15,32,2,4,11,43,71
2008-08-11 00:00:00.000,Beijing Olympics China ATP World Tour,HARD,2,Jurgen Melzer,Yen-Hsun Lu,Jurgen Melzer,6-2; 6-4,R16,66,4,0,37,55,27,37,13,18,0,0,9,40,55,1,1,29,48,17,29,11,19,1,4,9,28,48
2008-08-11 00:00:00.000,Beijing Olympics China ATP World Tour,HARD,2,Rafael Nadal,Igor Andreev,Rafael Nadal,6-4; 6-2,R16,95,4,0,37,55,28,37,11,18,4,4,9,39,55,5,3,35,55,23,35,6,20,3,6,9,29,55
2008-08-11 00:00:00.000,Beijing Olympics China ATP World Tour,HARD,2,James Blake,Roger Federer,James Blake,6-4; 7-6(2),Q,91,2,2,36,65,27,36,20,29,0,1,11,47,65,3,2,48,89,33,48,19,41,4,6,11,52,89
2008-08-11 00:00:00.000,Beijing Olympics China ATP World Tour,HARD,2,Fernando Gonzalez,Paul-Henri Mathieu,Fernando Gonzalez,6-4; 6-4,Q,104,3,2,30,59,24,30,17,29,1,2,10,41,59,5,9,37,82,23,37,23,45,5,8,10,46,82
2008-08-11 00:00:00.000,Beijing Olympics China ATP World Tour,HARD,2,Novak Djokovic,Gael Monfils,Novak Djokovic,4-6; 6-1; 6-4,Q,142,4,1,69,100,48,69,15,31,5,7,14,63,100,6,3,46,83,30,46,18,37,2,6,13,48,83
2008-08-11 00:00:00.000,Beijing Olympics China ATP World Tour,HARD,2,Rafael Nadal,Jurgen Melzer,Rafael Nadal,6-0; 6-4,Q,64,0,0,24,38,17,24,12,14,0,1,8,29,38,6,1,30,49,18,30,5,19,2,7,8,23,49
2008-08-11 00:00:00.000,Beijing Olympics China ATP World Tour,HARD,2,Fernando Gonzalez,James Blake,Fernando Gonzalez,4-6; 7-5; 11-9,S,173,12,4,99,138,74,99,18,39,7,9,21,92,138,11,4,77,133,61,77,28,56,4,7,21,89,133
2008-08-11 00:00:00.000,Beijing Olympics China ATP World Tour,HARD,2,Rafael Nadal,Novak Djokovic,Rafael Nadal,6-4; 1-6; 6-4,S,131,3,1,54,75,33,54,14,21,1,4,13,47,75,9,5,54,85,39,54,15,31,4,7,14,54,85
2008-08-11 00:00:00.000,Beijing Olympics China ATP World Tour,HARD,2,Rafael Nadal,Fernando Gonzalez,Rafael Nadal,6-3; 7-6(2); 6-3,F,143,4,3,63,87,54,63,15,24,4,4,16,69,87,9,1,71,107,50,71,14,36,8,10,14,64,107
2008-08-17 00:00:00.000,New Haven CT; U.S.A. ATP World Tour,HARD,2,Fernando Verdasco,N/A Bye,Fernando Verdasco,,R64,0,0,0,0,0,0,0,0,0,0,0,0,0,0,0,0,0,0,0,0,0,0,0,0,0,0,0
2008-08-17 00:00:00.000,New Haven CT; U.S.A. ATP World Tour,HARD,2,Dudi Sela,Donald Young,Dudi Sela,6-4; 6-2,R64,70,2,1,30,50,25,30,13,20,0,0,9,38,50,1,5,46,71,28,46,11,25,7,10,9,39,71
2008-08-17 00:00:00.000,New Haven CT; U.S.A. ATP World Tour,HARD,2,Ivo Minar,Nicolas Mahut,Ivo Minar,5-7; 6-3; 6-3,R64,105,4,3,49,86,37,49,21,37,3,6,15,58,86,6,5,56,91,38,56,17,35,4,9,15,55,91
2008-08-17 00:00:00.000,New Haven CT; U.S.A. ATP World Tour,HARD,2,Eduardo Schwank,N/A Bye,Eduardo Schwank,,R64,0,0,0,0,0,0,0,0,0,0,0,0,0,0,0,0,0,0,0,0,0,0,0,0,0,0,0
2008-08-17 00:00:00.000,New Haven CT; U.S.A. ATP World Tour,HARD,2,Agustin Calleri,N/A Bye,Agustin Calleri,,R64,0,0,0,0,0,0,0,0,0,0,0,0,0,0,0,0,0,0,0,0,0,0,0,0,0,0,0
2008-08-17 00:00:00.000,New Haven CT; U.S.A. ATP World Tour,HARD,2,Robby Ginepri,Luis Horna,Robby Ginepri,7-6(4); 6-2,R64,68,8,1,36,54,29,36,12,18,1,2,10,41,54,3,3,33,58,20,33,14,25,2,5,10,34,58
2008-08-17 00:00:00.000,New Haven CT; U.S.A. ATP World Tour,HARD,2,Mischa Zverev,Florent Serra,Mischa Zverev,6-2; 7-6(6),R64,83,14,3,28,56,25,28,20,28,0,0,10,45,56,0,0,56,92,35,56,19,36,6,8,10,54,92
2008-08-17 00:00:00.000,New Haven CT; U.S.A. ATP World Tour,HARD,2,Juan Monaco,N/A Bye,Juan Monaco,,R64,0,0,0,0,0,0,0,0,0,0,0,0,0,0,0,0,0,0,0,0,0,0,0,0,0,0,0
2008-08-17 00:00:00.000,New Haven CT; U.S.A. ATP World Tour,HARD,2,Jesse Levine,N/A Bye,Jesse Levine,,R64,0,0,0,0,0,0,0,0,0,0,0,0,0,0,0,0,0,0,0,0,0,0,0,0,0,0,0
2008-08-17 00:00:00.000,New Haven CT; U.S.A. ATP World Tour,HARD,2,Guillermo Garcia-Lopez,Chris Guccione,Guillermo Garcia-Lopez,7-5; 6-3,R64,81,0,4,27,56,20,27,20,29,2,3,10,40,56,8,3,38,68,27,38,12,30,3,7,11,39,68
2008-08-17 00:00:00.000,New Haven CT; U.S.A. ATP World Tour,HARD,2,Steve Darcis,Vincent Spadea,Steve Darcis,7-5; 5-0 RET,R64,62,5,1,20,46,18,20,14,26,0,1,8,32,46,0,2,33,56,17,33,11,23,3,8,9,28,56
2008-08-17 00:00:00.000,New Haven CT; U.S.A. ATP World Tour,HARD,2,Marcel Granollers,N/A Bye,Marcel Granollers,,R64,0,0,0,0,0,0,0,0,0,0,0,0,0,0,0,0,0,0,0,0,0,0,0,0,0,0,0
2008-08-17 00:00:00.000,New Haven CT; U.S.A. ATP World Tour,HARD,2,Marc Gicquel,N/A Bye,Marc Gicquel,,R64,0,0,0,0,0,0,0,0,0,0,0,0,0,0,0,0,0,0,0,0,0,0,0,0,0,0,0
2008-08-17 00:00:00.000,New Haven CT; U.S.A. ATP World Tour,HARD,2,Albert Montanes,Nicolas Devilder,Albert Montanes,7-6(5); 7-5,R64,117,1,3,34,72,26,34,18,38,1,3,12,44,72,6,9,48,101,33,48,24,53,12,15,12,57,101
2008-08-17 00:00:00.000,New Haven CT; U.S.A. ATP World Tour,HARD,2,Wayne Odesnik,Sebastien Grosjean,Wayne Odesnik,7-5; 6-4,R64,87,7,4,54,77,38,54,7,23,4,7,11,45,77,4,5,33,62,24,33,10,29,2,7,11,34,62
2008-08-17 00:00:00.000,New Haven CT; U.S.A. ATP World Tour,HARD,2,Mardy Fish,N/A Bye,Mardy Fish,,R64,0,0,0,0,0,0,0,0,0,0,0,0,0,0,0,0,0,0,0,0,0,0,0,0,0,0,0
2008-08-17 00:00:00.000,New Haven CT; U.S.A. ATP World Tour,HARD,2,Marin Cilic,N/A Bye,Marin Cilic,,R64,0,0,0,0,0,0,0,0,0,0,0,0,0,0,0,0,0,0,0,0,0,0,0,0,0,0,0
2008-08-17 00:00:00.000,New Haven CT; U.S.A. ATP World Tour,HARD,2,Viktor Troicki,Alex Bogomolov Jr.,Viktor Troicki,7-5; 2-6; 6-1,R64,115,10,2,33,80,28,33,21,47,6,9,13,49,80,4,1,59,90,34,59,18,31,5,10,14,52,90
2008-08-17 00:00:00.000,New Haven CT; U.S.A. ATP World Tour,HARD,2,Arnaud Clement,Thomaz Bellucci,Arnaud Clement,6-4; 6-4,R64,90,2,1,25,54,20,25,19,29,2,3,10,39,54,4,1,52,76,28,52,14,24,7,10,10,42,76
2008-08-17 00:00:00.000,New Haven CT; U.S.A. ATP World Tour,HARD,2,Jurgen Melzer,N/A Bye,Jurgen Melzer,,R64,0,0,0,0,0,0,0,0,0,0,0,0,0,0,0,0,0,0,0,0,0,0,0,0,0,0,0
2008-08-17 00:00:00.000,New Haven CT; U.S.A. ATP World Tour,HARD,2,Victor Hanescu,N/A Bye,Victor Hanescu,,R64,0,0,0,0,0,0,0,0,0,0,0,0,0,0,0,0,0,0,0,0,0,0,0,0,0,0,0
2008-08-17 00:00:00.000,New Haven CT; U.S.A. ATP World Tour,HARD,2,Denis Gremelmayr,Marcos Daniel,Denis Gremelmayr,3-6; 6-3; 6-3,R64,128,15,9,55,97,43,55,18,42,8,9,13,61,97,7,2,51,89,36,51,20,38,5,8,14,56,89
2008-08-17 00:00:00.000,New Haven CT; U.S.A. ATP World Tour,HARD,2,Olivier Rochus,Evgeny Korolev,Olivier Rochus,6-4; 6-4,R64,95,2,3,30,56,22,30,16,26,1,2,10,38,56,11,11,41,93,31,41,22,52,13,16,10,53,93
2008-08-17 00:00:00.000,New Haven CT; U.S.A. ATP World Tour,HARD,2,Igor Andreev,N/A Bye,Igor Andreev,,R64,0,0,0,0,0,0,0,0,0,0,0,0,0,0,0,0,0,0,0,0,0,0,0,0,0,0,0
2008-08-17 00:00:00.000,New Haven CT; U.S.A. ATP World Tour,HARD,2,Andreas Seppi,N/A Bye,Andreas Seppi,,R64,0,0,0,0,0,0,0,0,0,0,0,0,0,0,0,0,0,0,0,0,0,0,0,0,0,0,0
2008-08-17 00:00:00.000,New Haven CT; U.S.A. ATP World Tour,HARD,2,Potito Starace,Jiri Vanek,Potito Starace,6-2; 7-6(7),R64,78,6,3,47,64,34,47,11,17,2,3,10,45,64,9,5,29,66,23,29,18,37,3,6,10,41,66
2008-08-17 00:00:00.000,New Haven CT; U.S.A. ATP World Tour,HARD,2,Fabio Fognini,Nicolas Lapentti,Fabio Fognini,6-4; 4-4 RET,R64,91,3,4,30,60,20,30,18,30,1,3,9,38,60,3,1,32,55,18,32,14,23,0,3,9,32,55
2008-08-17 00:00:00.000,New Haven CT; U.S.A. ATP World Tour,HARD,2,Simone Bolelli,N/A Bye,Simone Bolelli,,R64,0,0,0,0,0,0,0,0,0,0,0,0,0,0,0,0,0,0,0,0,0,0,0,0,0,0,0
2008-08-17 00:00:00.000,New Haven CT; U.S.A. ATP World Tour,HARD,2,Jose Acasuso,N/A Bye,Jose Acasuso,,R64,0,0,0,0,0,0,0,0,0,0,0,0,0,0,0,0,0,0,0,0,0,0,0,0,0,0,0
2008-08-17 00:00:00.000,New Haven CT; U.S.A. ATP World Tour,HARD,2,Luka Gregorc,Ramon Delgado,Luka Gregorc,6-2; 3-6; 6-0,R64,76,9,2,35,53,28,35,11,18,0,2,11,39,53,3,3,33,66,19,33,13,33,4,10,12,32,66
2008-08-17 00:00:00.000,New Haven CT; U.S.A. ATP World Tour,HARD,2,John Isner,Igor Kunitsyn,John Isner,6-4; 6-4,R64,71,9,1,34,49,29,34,11,15,0,0,10,40,49,0,1,47,64,33,47,8,17,3,5,10,41,64
2008-08-17 00:00:00.000,New Haven CT; U.S.A. ATP World Tour,HARD,2,Ivo Karlovic,N/A Bye,Ivo Karlovic,,R64,0,0,0,0,0,0,0,0,0,0,0,0,0,0,0,0,0,0,0,0,0,0,0,0,0,0,0
2008-08-17 00:00:00.000,New Haven CT; U.S.A. ATP World Tour,HARD,2,Fernando Verdasco,Dudi Sela,Fernando Verdasco,6-4; 6-4,R32,80,1,6,48,62,32,48,7,14,2,4,10,39,62,1,1,37,60,20,37,12,23,2,6,10,32,60
2008-08-17 00:00:00.000,New Haven CT; U.S.A. ATP World Tour,HARD,2,Ivo Minar,Eduardo Schwank,Ivo Minar,7-5; 6-3,R32,82,2,1,35,54,27,35,13,19,3,4,10,40,54,5,4,36,68,25,36,15,32,2,6,11,40,68
2008-08-17 00:00:00.000,New Haven CT; U.S.A. ATP World Tour,HARD,2,Robby Ginepri,Agustin Calleri,Robby Ginepri,6-2; 4-6; 6-2,R32,94,5,3,53,81,40,53,13,28,1,3,13,53,81,6,8,36,81,25,36,18,45,9,14,13,43,81
2008-08-17 00:00:00.000,New Haven CT; U.S.A. ATP World Tour,HARD,2,Mischa Zverev,Juan Monaco,Mischa Zverev,6-3; 6-3,R32,73,2,3,29,56,24,29,13,27,3,4,9,37,56,1,2,34,55,18,34,12,21,4,8,9,30,55
2008-08-17 00:00:00.000,New Haven CT; U.S.A. ATP World Tour,HARD,2,Jesse Levine,Guillermo Garcia-Lopez,Jesse Levine,6-0; 6-3,R32,66,1,7,28,59,21,28,14,31,5,6,8,35,59,1,4,23,41,12,23,5,18,2,7,7,17,41
2008-08-17 00:00:00.000,New Haven CT; U.S.A. ATP World Tour,HARD,2,Steve Darcis,Marcel Granollers,Steve Darcis,6-2; 6-2,R32,55,5,2,16,41,14,16,19,25,1,1,8,33,41,1,3,27,53,16,27,12,26,8,12,8,28,53
2008-08-17 00:00:00.000,New Haven CT; U.S.A. ATP World Tour,HARD,2,Marc Gicquel,Albert Montanes,Marc Gicquel,7-5; 6-3,R32,67,11,2,33,54,29,33,13,21,2,2,10,42,54,1,8,45,76,31,45,13,31,5,8,11,44,76
2008-08-17 00:00:00.000,New Haven CT; U.S.A. ATP World Tour,HARD,2,Mardy Fish,Wayne Odesnik,Mardy Fish,6-1; 4-6; 6-1,R32,99,13,2,37,78,31,37,20,41,5,7,12,51,78,3,9,39,70,23,39,13,31,5,11,12,36,70
2008-08-17 00:00:00.000,New Haven CT; U.S.A. ATP World Tour,HARD,2,Marin Cilic,Viktor Troicki,Marin Cilic,2-1 RET,R32,18,1,0,6,15,4,6,6,9,1,1,2,10,15,0,0,3,5,2,3,2,2,0,0,1,4,5
2008-08-17 00:00:00.000,New Haven CT; U.S.A. ATP World Tour,HARD,2,Jurgen Melzer,Arnaud Clement,Jurgen Melzer,7-6(1); 7-5,R32,112,8,6,51,96,34,51,28,45,8,10,12,62,96,5,4,50,85,35,50,16,35,7,10,12,51,85
2008-08-17 00:00:00.000,New Haven CT; U.S.A. ATP World Tour,HARD,2,Victor Hanescu,Denis Gremelmayr,Victor Hanescu,6-7(5); 7-6(3); 6-2,R32,140,6,1,86,111,62,86,15,25,7,8,16,77,111,11,4,68,114,44,68,26,46,6,9,16,70,114
2008-08-17 00:00:00.000,New Haven CT; U.S.A. ATP World Tour,HARD,2,Igor Andreev,Olivier Rochus,Igor Andreev,6-3; 6-4,R32,81,9,2,32,58,26,32,16,26,1,1,10,42,58,0,1,38,58,27,38,9,20,3,5,9,36,58
2008-08-17 00:00:00.000,New Haven CT; U.S.A. ATP World Tour,HARD,2,Andreas Seppi,Potito Starace,Andreas Seppi,4-6; 6-4; 6-4,R32,133,1,5,56,92,42,56,11,36,5,9,15,53,92,6,1,71,101,41,71,13,30,5,10,15,54,101
2008-08-17 00:00:00.000,New Haven CT; U.S.A. ATP World Tour,HARD,2,Fabio Fognini,Simone Bolelli,Fabio Fognini,6-2; 5-7; 6-4,R32,132,5,7,52,94,43,52,19,42,7,9,15,62,94,5,4,49,81,33,49,17,32,0,4,15,50,81
2008-08-17 00:00:00.000,New Haven CT; U.S.A. ATP World Tour,HARD,2,Luka Gregorc,Jose Acasuso,Luka Gregorc,6-4; 6-4,R32,95,5,1,35,66,18,35,17,31,1,5,10,35,66,0,3,36,68,22,36,9,32,0,6,10,31,68
2008-08-17 00:00:00.000,New Haven CT; U.S.A. ATP World Tour,HARD,2,Ivo Karlovic,John Isner,Ivo Karlovic,6-7(4); 6-3; 6-4,R32,117,17,1,51,90,45,51,24,39,0,0,16,69,90,13,2,71,106,57,71,12,35,4,6,15,69,106
2008-08-17 00:00:00.000,New Haven CT; U.S.A. ATP World Tour,HARD,2,Fernando Verdasco,Ivo Minar,Fernando Verdasco,6-3; 6-1,R16,54,4,2,28,40,24,28,8,12,0,0,8,32,40,1,2,27,47,12,27,13,20,3,7,8,25,47
2008-08-17 00:00:00.000,New Haven CT; U.S.A. ATP World Tour,HARD,2,Mischa Zverev,Robby Ginepri,Mischa Zverev,1-6; 6-3; 6-1,R16,94,6,3,47,72,32,47,8,25,5,9,11,40,72,3,2,55,87,34,55,11,32,7,13,12,45,87
2008-08-17 00:00:00.000,New Haven CT; U.S.A. ATP World Tour,HARD,2,Jesse Levine,Steve Darcis,Jesse Levine,2-0 RET,R16,7,1,0,3,8,1,3,4,5,1,1,1,5,8,0,2,2,4,0,2,0,2,0,1,1,0,4
2008-08-17 00:00:00.000,New Haven CT; U.S.A. ATP World Tour,HARD,2,Mardy Fish,Marc Gicquel,Mardy Fish,6-4; 6-3,R16,64,12,0,25,55,22,25,22,30,3,3,10,44,55,6,3,34,53,26,34,9,19,2,4,9,35,53
2008-08-17 00:00:00.000,New Haven CT; U.S.A. ATP World Tour,HARD,2,Marin Cilic,Jurgen Melzer,Marin Cilic,5-7; 6-4; 7-5,R16,157,8,6,69,130,49,69,34,61,11,13,17,83,130,7,3,76,103,51,76,14,27,3,6,17,65,103
2008-08-17 00:00:00.000,New Haven CT; U.S.A. ATP World Tour,HARD,2,Igor Andreev,Victor Hanescu,Igor Andreev,6-4; 7-5,R16,96,5,3,47,73,30,47,18,26,4,6,11,48,73,1,1,52,74,32,52,9,22,4,8,11,41,74
2008-08-17 00:00:00.000,New Haven CT; U.S.A. ATP World Tour,HARD,2,Andreas Seppi,Fabio Fognini,Andreas Seppi,6-4; 6-2,R16,86,0,2,32,58,17,32,16,26,6,9,9,33,58,2,3,45,65,25,45,4,20,9,15,9,29,65
2008-08-17 00:00:00.000,New Haven CT; U.S.A. ATP World Tour,HARD,2,Luka Gregorc,Ivo Karlovic,Luka Gregorc,7-6(4); 4-6; 6-2,R16,116,9,6,57,97,43,57,23,40,3,5,15,66,97,12,3,46,82,37,46,16,36,0,3,15,53,82
2008-08-17 00:00:00.000,New Haven CT; U.S.A. ATP World Tour,HARD,2,Fernando Verdasco,Mischa Zverev,Fernando Verdasco,6-2; 7-6(4),Q,78,2,4,57,66,42,57,3,9,3,5,10,45,66,6,0,36,60,21,36,13,24,3,7,10,34,60
2008-08-17 00:00:00.000,New Haven CT; U.S.A. ATP World Tour,HARD,2,Mardy Fish,Jesse Levine,Mardy Fish,6-3; 7-6(4),Q,100,12,6,37,67,33,37,17,30,0,0,11,50,67,5,5,65,97,44,65,14,32,13,14,10,58,97
2008-08-17 00:00:00.000,New Haven CT; U.S.A. ATP World Tour,HARD,2,Marin Cilic,Igor Andreev,Marin Cilic,6-3; 6-2,Q,83,3,3,25,59,21,25,18,34,3,3,8,39,59,1,1,43,64,23,43,10,21,5,9,9,33,64
2008-08-17 00:00:00.000,New Haven CT; U.S.A. ATP World Tour,HARD,2,Luka Gregorc,Andreas Seppi,Luka Gregorc,4-6; 6-4; 7-5,Q,138,14,9,63,106,46,63,18,43,5,9,16,64,106,4,5,48,93,31,48,24,45,5,10,16,55,93
2008-08-17 00:00:00.000,New Haven CT; U.S.A. ATP World Tour,HARD,2,Mardy Fish,Fernando Verdasco,Mardy Fish,6-0; 1-6; 6-3,S,88,7,3,31,67,23,31,17,36,4,7,11,40,67,0,9,45,66,28,45,8,21,6,11,11,36,66
2008-08-17 00:00:00.000,New Haven CT; U.S.A. ATP World Tour,HARD,2,Marin Cilic,Luka Gregorc,Marin Cilic,6-3; 6-3,S,74,5,0,25,48,19,25,16,23,1,2,9,35,48,7,7,34,65,24,34,10,31,7,11,9,34,65
2008-08-17 00:00:00.000,New Haven CT; U.S.A. ATP World Tour,HARD,2,Marin Cilic,Mardy Fish,Marin Cilic,6-4; 4-6; 6-2,F,115,11,0,43,76,31,43,19,33,2,5,14,50,76,5,3,41,79,29,41,18,38,1,6,14,47,79
2008-08-25 00:00:00.000,US Open NY; U.S.A. Grand Slams,HARD,3,Rafael Nadal,Bjorn Phau,Rafael Nadal,7-6(4); 6-3; 7-6(4),R128,179,7,2,77,107,58,77,19,30,2,3,17,77,107,6,4,67,132,49,67,30,65,11,13,16,79,132
2008-08-25 00:00:00.000,US Open NY; U.S.A. Grand Slams,HARD,3,Ryler DeHeart,Olivier Rochus,Ryler DeHeart,7-6(4); 5-7; 6-4; 3-6; 6-4,R128,223,19,8,87,166,64,87,44,79,11,15,26,108,166,4,4,108,185,73,108,47,77,7,11,27,120,185
2008-08-25 00:00:00.000,US Open NY; U.S.A. Grand Slams,HARD,3,Viktor Troicki,Carsten Ball,Viktor Troicki,7-6(3); 6-0; 6-1,R128,91,6,1,45,75,39,45,18,30,2,2,13,57,75,10,6,51,89,33,51,15,38,6,11,12,48,89
2008-08-25 00:00:00.000,US Open NY; U.S.A. Grand Slams,HARD,3,Philipp Kohlschreiber,Luis Horna,Philipp Kohlschreiber,6-2; 6-3; 6-2,R128,97,7,4,31,66,26,31,25,35,0,0,12,51,66,5,5,48,84,30,48,15,36,5,11,13,45,84
2008-08-25 00:00:00.000,US Open NY; U.S.A. Grand Slams,HARD,3,Sam Querrey,Tomas Berdych,Sam Querrey,6-3; 6-1; 6-2,R128,87,11,1,40,65,35,40,12,25,2,3,12,47,65,5,3,44,81,23,44,17,37,6,13,12,40,81
2008-08-25 00:00:00.000,US Open NY; U.S.A. Grand Slams,HARD,3,Nicolas Devilder,Pablo Andujar,Nicolas Devilder,6-4; 6-2; 6-2,R128,104,2,8,48,79,36,48,13,31,2,5,13,49,79,3,9,55,95,31,55,14,40,11,19,13,45,95
2008-08-25 00:00:00.000,US Open NY; U.S.A. Grand Slams,HARD,3,Florent Serra,Rainer Schuettler,Florent Serra,7-6(8); 6-0; 2-0 RET,R128,80,1,1,45,63,33,45,15,18,2,3,10,48,63,1,4,42,64,28,42,10,22,5,10,10,38,64
2008-08-25 00:00:00.000,US Open NY; U.S.A. Grand Slams,HARD,3,Ivo Karlovic,Jan Minar,Ivo Karlovic,7-5; 6-1; 6-4,R128,119,28,7,55,95,49,55,17,40,5,6,15,66,95,0,6,60,99,39,60,17,39,7,12,14,56,99
2008-08-25 00:00:00.000,US Open NY; U.S.A. Grand Slams,HARD,3,James Blake,Donald Young,James Blake,6-1; 3-6; 6-1; 4-6; 6-4,R128,169,7,5,91,156,68,91,33,65,10,13,22,101,156,6,6,82,138,52,82,27,56,9,15,21,79,138
2008-08-25 00:00:00.000,US Open NY; U.S.A. Grand Slams,HARD,3,Steve Darcis,Denis Gremelmayr,Steve Darcis,6-1; 6-7(6); 7-6(4); 6-4,R128,165,9,5,74,138,55,74,35,64,4,7,20,90,138,16,7,64,128,43,64,33,64,0,7,21,76,128
2008-08-25 00:00:00.000,US Open NY; U.S.A. Grand Slams,HARD,3,Mardy Fish,Robert Smeets,Mardy Fish,7-6(4); 6-7(3); 6-3; 6-4,R128,198,15,7,76,157,60,76,42,81,6,8,22,102,157,7,4,78,145,54,78,37,67,8,12,21,91,145
2008-08-25 00:00:00.000,US Open NY; U.S.A. Grand Slams,HARD,3,Paul-Henri Mathieu,Sebastien Grosjean,Paul-Henri Mathieu,6-7(4); 7-6(5); 6-3; 6-2,R128,170,7,4,74,133,54,74,41,59,4,5,21,95,133,22,4,69,128,56,69,28,59,3,7,20,84,128
2008-08-25 00:00:00.000,US Open NY; U.S.A. Grand Slams,HARD,3,Gael Monfils,Pablo Cuevas,Gael Monfils,6-4; 6-4; 6-1,R128,94,11,5,44,74,37,44,17,30,3,4,13,54,74,4,2,46,83,27,46,18,37,1,7,14,45,83
2008-08-25 00:00:00.000,US Open NY; U.S.A. Grand Slams,HARD,3,Evgeny Korolev,Robin Soderling,Evgeny Korolev,7-6(4); 6-3; 7-6(9),R128,141,15,7,75,132,61,75,26,57,11,14,17,87,132,18,8,57,116,47,57,28,59,9,13,16,75,116
2008-08-25 00:00:00.000,US Open NY; U.S.A. Grand Slams,HARD,3,Andrey Golubev,Brendan Evans,Andrey Golubev,6-4; 6-3; 6-2,R128,91,7,3,31,70,25,31,30,39,1,1,13,55,70,9,3,56,86,39,56,10,30,6,11,14,49,86
2008-08-25 00:00:00.000,US Open NY; U.S.A. Grand Slams,HARD,3,David Nalbandian,Marcos Daniel,David Nalbandian,6-1; 6-2; 6-4,R128,100,14,6,39,72,35,39,21,33,2,2,13,56,72,7,2,41,80,26,41,17,39,4,9,12,43,80
2008-08-25 00:00:00.000,US Open NY; U.S.A. Grand Slams,HARD,3,David Ferrer,Martin Vassallo Arguello,David Ferrer,7-6(1); 6-2; 6-2,R128,131,2,2,44,75,34,44,24,31,0,1,14,58,75,2,5,54,86,34,54,13,32,3,8,14,47,86
2008-08-25 00:00:00.000,US Open NY; U.S.A. Grand Slams,HARD,3,Andreas Beck,John Isner,Andreas Beck,7-6(5); 6-4; 7-6(3),R128,137,9,5,70,115,57,70,28,45,5,5,17,85,115,26,3,71,101,58,71,13,30,1,2,17,71,101
2008-08-25 00:00:00.000,US Open NY; U.S.A. Grand Slams,HARD,3,Roko Karanusic,Ryan Sweeting,Roko Karanusic,7-5; 7-5; 3-6; 6-2,R128,149,12,2,77,114,57,77,21,37,2,4,20,78,114,6,4,111,148,69,111,18,37,12,17,21,87,148
2008-08-25 00:00:00.000,US Open NY; U.S.A. Grand Slams,HARD,3,Kei Nishikori,Juan Monaco,Kei Nishikori,6-2; 6-2; 5-7; 6-2,R128,173,3,9,71,136,55,71,30,65,9,11,18,85,136,3,4,83,115,46,83,18,32,7,14,18,64,115
2008-08-25 00:00:00.000,US Open NY; U.S.A. Grand Slams,HARD,3,Juan Martin Del Potro,Guillermo Canas,Juan Martin Del Potro,4-6; 7-6(0); 6-4; 6-1,R128,204,3,4,73,118,53,73,22,45,8,13,19,75,118,7,9,65,140,39,65,33,75,12,20,20,72,140
2008-08-25 00:00:00.000,US Open NY; U.S.A. Grand Slams,HARD,3,Thomaz Bellucci,Oscar Hernandez,Thomaz Bellucci,6-3; 6-7(5); 6-4; 7-5,R128,192,7,6,77,144,55,77,31,67,9,14,21,86,144,3,5,93,153,55,93,28,60,12,21,22,83,153
2008-08-25 00:00:00.000,US Open NY; U.S.A. Grand Slams,HARD,3,Jose Acasuso,Michael Berrer,Jose Acasuso,6-4; 6-2; 6-2,R128,116,8,4,52,79,43,52,14,27,1,1,13,57,79,7,10,37,85,27,37,20,48,8,13,13,47,85
2008-08-25 00:00:00.000,US Open NY; U.S.A. Grand Slams,HARD,3,Gilles Simon,Marcel Granollers,Gilles Simon,6-4; 6-3; 5-7; 6-2,R128,154,6,1,56,102,41,56,35,46,1,3,20,76,102,7,5,67,121,50,67,23,54,7,12,19,73,121
2008-08-25 00:00:00.000,US Open NY; U.S.A. Grand Slams,HARD,3,Stanislas Wawrinka,Simone Bolelli,Stanislas Wawrinka,7-6(5); 6-3; 6-3,R128,131,8,4,72,110,55,72,20,38,7,8,15,75,110,3,2,56,86,39,56,16,30,3,7,15,55,86
2008-08-25 00:00:00.000,US Open NY; U.S.A. Grand Slams,HARD,3,Wayne Odesnik,Fabio Fognini,Wayne Odesnik,2-6; 6-0; 4-6; 6-3; 6-4,R128,180,7,6,87,139,60,87,25,52,12,17,22,85,139,5,12,76,139,56,76,25,63,9,16,21,81,139
2008-08-25 00:00:00.000,US Open NY; U.S.A. Grand Slams,HARD,3,Yen-Hsun Lu,Nicolas Lapentti,Yen-Hsun Lu,6-4; 1-6; 4-6; 6-4; 6-3,R128,236,4,11,99,163,61,99,32,64,20,27,23,93,163,13,4,104,159,71,104,21,55,13,20,23,92,159
2008-08-25 00:00:00.000,US Open NY; U.S.A. Grand Slams,HARD,3,Flavio Cipolla,Jan Hernych,Flavio Cipolla,6-7(2); 6-4; 2-6; 7-6(0); 7-6(4),R128,245,2,14,124,186,78,124,25,62,7,16,27,103,186,4,9,108,192,62,108,48,84,16,24,27,110,192
2008-08-25 00:00:00.000,US Open NY; U.S.A. Grand Slams,HARD,3,Jurgen Melzer,Feliciano Lopez,Jurgen Melzer,4-6; 7-6(5); 6-2; 2-6; 6-4,R128,185,9,5,91,150,63,91,32,59,7,12,24,95,150,15,9,78,140,59,78,31,62,4,9,24,90,140
2008-08-25 00:00:00.000,US Open NY; U.S.A. Grand Slams,HARD,3,Jiri Vanek,Stephane Bohli,Jiri Vanek,3-6; 6-3; 6-2; 7-5,R128,145,18,3,66,110,53,66,24,44,2,4,19,77,110,15,3,52,110,39,52,29,58,6,11,19,68,110
2008-08-25 00:00:00.000,US Open NY; U.S.A. Grand Slams,HARD,3,Michael Llodra,Teymuraz Gabashvili,Michael Llodra,6-3; 5-7; 7-6(5); 7-6(4),R128,204,17,6,81,145,61,81,43,64,4,6,23,104,145,13,12,91,164,64,91,41,73,15,17,22,105,164
2008-08-25 00:00:00.000,US Open NY; U.S.A. Grand Slams,HARD,3,Andy Murray,Sergio Roitman,Andy Murray,6-3; 6-4; 6-0,R128,94,9,3,41,85,33,41,26,44,2,2,13,59,85,3,2,49,73,29,49,11,24,7,12,12,40,73
2008-08-25 00:00:00.000,US Open NY; U.S.A. Grand Slams,HARD,3,Andy Roddick,Fabrice Santoro,Andy Roddick,6-2; 6-2; 6-2,R128,87,15,2,37,60,34,37,15,23,0,0,12,49,60,7,2,40,74,26,40,14,34,3,9,12,40,74
2008-08-25 00:00:00.000,US Open NY; U.S.A. Grand Slams,HARD,3,Ernests Gulbis,Thomas Johansson,Ernests Gulbis,7-5; 6-1; 7-6(3),R128,130,18,8,75,116,57,75,23,41,8,9,16,80,116,8,4,46,94,34,46,22,48,6,10,15,56,94
2008-08-25 00:00:00.000,US Open NY; U.S.A. Grand Slams,HARD,3,Guillermo Garcia-Lopez,Dominik Hrbaty,Guillermo Garcia-Lopez,4-6; 6-3; 6-4; 6-4,R128,169,2,12,62,122,42,62,24,60,4,12,20,66,122,3,10,80,137,51,80,20,57,10,20,19,71,137
2008-08-25 00:00:00.000,US Open NY; U.S.A. Grand Slams,HARD,3,Andreas Seppi,Hyung-Taik Lee,Andreas Seppi,6-3; 7-5; 3-6; 3-6; 6-3,R128,177,11,9,81,145,56,81,30,64,5,13,24,86,145,6,7,94,145,58,94,22,51,6,15,24,80,145
2008-08-25 00:00:00.000,US Open NY; U.S.A. Grand Slams,HARD,3,Ivo Minar,Nicolas Kiefer,Ivo Minar,4-6; 6-1; 6-4; 4-1 RET,R128,144,9,2,48,89,39,48,23,41,7,9,16,62,89,6,6,51,111,33,51,26,60,6,12,16,59,111
2008-08-25 00:00:00.000,US Open NY; U.S.A. Grand Slams,HARD,3,Jarkko Nieminen,Scoville Jenkins,Jarkko Nieminen,6-3; 6-3; 7-5,R128,125,5,2,59,91,45,59,18,32,8,10,15,63,91,9,6,58,102,39,58,16,44,8,14,15,55,102
2008-08-25 00:00:00.000,US Open NY; U.S.A. Grand Slams,HARD,3,Bobby Reynolds,Tomas Zib,Bobby Reynolds,6-4; 6-7(3); 2-6; 6-4; 7-6(4),R128,257,33,7,84,169,61,84,45,85,13,19,26,106,169,12,5,129,206,82,129,40,77,20,26,26,122,206
2008-08-25 00:00:00.000,US Open NY; U.S.A. Grand Slams,HARD,3,Fernando Gonzalez,Ivan Navarro,Fernando Gonzalez,7-6(3); 6-3; 4-6; 7-6(5),R128,176,14,4,88,138,71,88,29,50,2,3,22,100,138,21,5,92,141,71,92,28,49,6,7,21,99,141
2008-08-25 00:00:00.000,US Open NY; U.S.A. Grand Slams,HARD,3,Tommy Robredo,Mischa Zverev,Tommy Robredo,7-6(4); 6-2; 6-1,R128,103,2,2,51,82,40,51,19,31,5,6,13,59,82,3,5,47,90,29,47,20,43,5,11,14,49,90
2008-08-25 00:00:00.000,US Open NY; U.S.A. Grand Slams,HARD,3,Marat Safin,Vincent Spadea,Marat Safin,3-6; 6-2; 6-3; 4-6; 6-4,R128,155,7,10,75,136,57,75,30,61,2,6,23,87,136,6,6,74,129,52,74,29,55,5,11,23,81,129
2008-08-25 00:00:00.000,US Open NY; U.S.A. Grand Slams,HARD,3,Carlos Moya,Aisam-Ul-Haq Qureshi,Carlos Moya,6-4; 6-7(5); 7-6(2); 6-2,R128,165,18,8,78,111,71,78,23,33,0,0,21,94,111,33,4,83,137,67,83,23,54,3,6,21,90,137
2008-08-25 00:00:00.000,US Open NY; U.S.A. Grand Slams,HARD,3,Jo-Wilfried Tsonga,Santiago Ventura,Jo-Wilfried Tsonga,6-7(3); 6-4; 6-2; 6-3,R128,159,11,6,69,117,54,69,27,48,4,6,19,81,117,9,11,66,130,48,66,27,64,2,9,20,75,130
2008-08-25 00:00:00.000,US Open NY; U.S.A. Grand Slams,HARD,3,Marin Cilic,Julien Benneteau,Marin Cilic,4-6; 7-5; 6-3; 6-7(7); 6-2,R128,260,28,7,94,161,72,94,30,67,6,11,26,102,161,3,9,122,182,76,122,27,60,18,26,25,103,182
2008-08-25 00:00:00.000,US Open NY; U.S.A. Grand Slams,HARD,3,Robby Ginepri,Amer Delic,Robby Ginepri,6-1; 6-2; 7-6(5),R128,110,8,2,55,96,41,55,27,41,1,1,14,68,96,13,6,45,88,33,45,20,43,3,7,13,53,88
2008-08-25 00:00:00.000,US Open NY; U.S.A. Grand Slams,HARD,3,Robert Kendrick,Nicolas Mahut,Robert Kendrick,7-6(3); 6-4; 5-7; 7-5,R128,164,28,7,77,129,63,77,35,52,3,4,23,98,129,19,11,85,145,69,85,31,60,3,5,23,100,145
2008-08-25 00:00:00.000,US Open NY; U.S.A. Grand Slams,HARD,3,Novak Djokovic,Arnaud Clement,Novak Djokovic,6-3; 6-3; 6-4,R128,120,15,2,55,85,44,55,19,30,4,4,14,63,85,6,3,48,84,31,48,20,36,3,7,14,51,84
2008-08-25 00:00:00.000,US Open NY; U.S.A. Grand Slams,HARD,3,Nikolay Davydenko,Dudi Sela,Nikolay Davydenko,6-3; 6-3; 6-3,R128,122,3,3,47,80,31,47,24,33,5,6,13,55,80,1,4,55,86,34,55,11,31,4,10,14,45,86
2008-08-25 00:00:00.000,US Open NY; U.S.A. Grand Slams,HARD,3,Agustin Calleri,Austin Krajicek,Agustin Calleri,6-2; 6-2; 6-1,R128,78,17,2,34,56,34,34,10,22,0,0,11,44,56,5,9,49,78,26,49,8,29,2,9,12,34,78
2008-08-25 00:00:00.000,US Open NY; U.S.A. Grand Slams,HARD,3,Victor Hanescu,Albert Montanes,Victor Hanescu,7-6(5); 6-3; 2-6; 6-3,R128,128,13,3,76,107,56,76,21,31,6,9,19,77,107,3,2,63,110,44,63,27,47,1,5,19,71,110
2008-08-25 00:00:00.000,US Open NY; U.S.A. Grand Slams,HARD,3,Dmitry Tursunov,Eduardo Schwank,Dmitry Tursunov,7-5; 4-6; 7-5; 7-6(5),R128,186,13,11,69,135,59,69,34,66,3,6,23,93,135,13,3,104,163,74,104,28,59,10,14,23,102,163
2008-08-25 00:00:00.000,US Open NY; U.S.A. Grand Slams,HARD,3,Nicolas Almagro,Frank Dancevic,Nicolas Almagro,6-3; 6-4; 7-5,R128,104,20,3,59,97,48,59,23,38,2,2,16,71,97,10,2,53,95,42,53,19,42,3,6,15,61,95
2008-08-25 00:00:00.000,US Open NY; U.S.A. Grand Slams,HARD,3,Sam Warburg,Janko Tipsarevic,Sam Warburg,6-2; 1-0 RET,R128,32,6,0,14,20,12,14,4,6,0,0,4,16,20,2,3,17,27,10,17,2,10,1,4,5,12,27
2008-08-25 00:00:00.000,US Open NY; U.S.A. Grand Slams,HARD,3,Gilles Muller,Laurent Recouderc,Gilles Muller,6-4; 6-0; 4-6; 6-4,R128,136,18,5,59,103,48,59,24,44,4,6,18,72,103,5,6,72,120,49,72,19,48,8,14,18,68,120
2008-08-25 00:00:00.000,US Open NY; U.S.A. Grand Slams,HARD,3,Tommy Haas,Richard Gasquet,Tommy Haas,6-7(3); 6-4; 5-7; 7-5; 6-2,R128,217,14,4,98,167,67,98,47,69,3,6,27,114,167,20,8,92,169,65,92,46,77,6,12,27,111,169
2008-08-25 00:00:00.000,US Open NY; U.S.A. Grand Slams,HARD,3,Fernando Verdasco,Igor Kunitsyn,Fernando Verdasco,6-3; 6-4; 6-1,R128,96,4,2,61,77,44,61,13,16,5,5,13,57,77,1,1,57,80,32,57,13,23,4,9,13,45,80
2008-08-25 00:00:00.000,US Open NY; U.S.A. Grand Slams,HARD,3,Rui Machado,Rik De Voest,Rui Machado,6-4; 7-6(7); 6-1,R128,132,2,2,75,108,56,75,18,33,6,7,15,74,108,1,4,50,96,37,50,20,46,4,8,14,57,96
2008-08-25 00:00:00.000,US Open NY; U.S.A. Grand Slams,HARD,3,Jeremy Chardy,Frederico Gil,Jeremy Chardy,3-6; 6-3; 6-2; 6-3,R128,129,11,1,69,99,48,69,20,30,4,6,17,68,99,6,3,78,115,49,78,20,37,10,16,18,69,115
2008-08-25 00:00:00.000,US Open NY; U.S.A. Grand Slams,HARD,3,Igor Andreev,Marc Gicquel,Igor Andreev,7-6(3); 6-4; 6-4,R128,122,19,1,56,99,43,56,24,43,0,2,16,67,99,2,6,57,101,40,57,23,44,10,14,16,63,101
2008-08-25 00:00:00.000,US Open NY; U.S.A. Grand Slams,HARD,3,Radek Stepanek,Potito Starace,Radek Stepanek,7-5; 6-3; 6-1,R128,108,15,2,54,79,48,54,12,25,1,1,14,60,79,2,3,65,94,36,65,17,29,6,11,14,53,94
2008-08-25 00:00:00.000,US Open NY; U.S.A. Grand Slams,HARD,3,Chris Guccione,Jesse Levine,Chris Guccione,6-3; 3-6; 7-6(6); 7-6(6),R128,164,32,3,76,120,65,76,30,44,2,3,21,95,120,19,8,116,169,82,116,29,53,15,16,21,111,169
2008-08-25 00:00:00.000,US Open NY; U.S.A. Grand Slams,HARD,3,Thiago Alves,Paul Capdeville,Thiago Alves,4-6; 1-6; 6-1; 7-6(2); 6-4,R128,222,8,2,105,172,72,105,28,67,8,14,23,100,172,8,7,87,153,60,87,27,66,8,14,23,87,153
2008-08-25 00:00:00.000,US Open NY; U.S.A. Grand Slams,HARD,3,Roger Federer,Maximo Gonzalez,Roger Federer,6-3; 6-0; 6-3,R128,82,14,1,57,76,42,57,10,19,6,7,12,52,76,1,3,50,75,28,50,8,25,6,13,12,36,75
2008-08-25 00:00:00.000,US Open NY; U.S.A. Grand Slams,HARD,3,Rafael Nadal,Ryler DeHeart,Rafael Nadal,6-1; 6-2; 6-4,R64,101,1,3,47,67,38,47,12,20,0,1,13,50,67,4,2,42,73,25,42,12,31,6,12,12,37,73
2008-08-25 00:00:00.000,US Open NY; U.S.A. Grand Slams,HARD,3,Viktor Troicki,Philipp Kohlschreiber,Viktor Troicki,2-6; 6-3; 6-4; 3-0 RET,R64,133,9,5,55,85,39,55,17,30,5,8,15,56,85,4,3,64,112,40,64,23,48,6,11,15,63,112
2008-08-25 00:00:00.000,US Open NY; U.S.A. Grand Slams,HARD,3,Sam Querrey,Nicolas Devilder,Sam Querrey,7-6(6); 6-4; 4-6; 6-3,R64,187,17,3,85,148,64,85,36,63,9,11,21,100,148,6,2,96,144,69,96,24,48,8,11,20,93,144
2008-08-25 00:00:00.000,US Open NY; U.S.A. Grand Slams,HARD,3,Ivo Karlovic,Florent Serra,Ivo Karlovic,7-6(5); 6-4; 6-2,R64,95,42,2,67,86,60,67,8,19,1,1,15,68,86,0,3,61,88,42,61,18,27,4,7,15,60,88
2008-08-25 00:00:00.000,US Open NY; U.S.A. Grand Slams,HARD,3,James Blake,Steve Darcis,James Blake,4-6; 6-3; 1-0 RET,R64,88,8,3,39,69,29,39,13,30,7,9,10,42,69,2,4,49,88,31,49,17,39,13,16,10,48,88
2008-08-25 00:00:00.000,US Open NY; U.S.A. Grand Slams,HARD,3,Mardy Fish,Paul-Henri Mathieu,Mardy Fish,6-2; 3-6; 6-3; 6-4,R64,137,27,0,56,100,47,56,25,44,0,1,18,72,100,8,8,48,100,31,48,35,52,4,8,18,66,100
2008-08-25 00:00:00.000,US Open NY; U.S.A. Grand Slams,HARD,3,Gael Monfils,Evgeny Korolev,Gael Monfils,6-2; 6-3; 3-6; 6-4,R64,142,13,8,69,111,51,69,20,42,4,7,18,71,111,5,6,64,125,49,64,22,61,9,15,18,71,125
2008-08-25 00:00:00.000,US Open NY; U.S.A. Grand Slams,HARD,3,David Nalbandian,Andrey Golubev,David Nalbandian,6-2; 6-4; 6-2,R64,118,5,2,42,76,37,42,17,34,3,4,13,54,76,4,11,49,95,32,49,16,46,3,9,13,48,95
2008-08-25 00:00:00.000,US Open NY; U.S.A. Grand Slams,HARD,3,David Ferrer,Andreas Beck,David Ferrer,4-6; 7-5; 6-3; 7-6(5),R64,177,11,3,83,123,63,83,25,40,3,6,22,88,123,9,9,81,144,53,81,36,63,10,14,21,89,144
2008-08-25 00:00:00.000,US Open NY; U.S.A. Grand Slams,HARD,3,Kei Nishikori,Roko Karanusic,Kei Nishikori,6-1; 7-5 RET,R64,65,1,5,32,57,26,32,14,25,3,4,10,40,57,6,5,37,61,23,37,7,24,6,10,9,30,61
2008-08-25 00:00:00.000,US Open NY; U.S.A. Grand Slams,HARD,3,Juan Martin Del Potro,Thomaz Bellucci,Juan Martin Del Potro,4-6; 6-1; 7-5; 6-3,R64,183,7,2,67,119,49,67,28,52,6,9,19,77,119,6,0,69,119,41,69,27,50,7,14,19,68,119
2008-08-25 00:00:00.000,US Open NY; U.S.A. Grand Slams,HARD,3,Gilles Simon,Jose Acasuso,Gilles Simon,6-4; 6-1; 6-4,R64,104,5,4,48,92,34,48,26,44,7,9,14,60,92,4,6,32,73,24,32,13,41,1,7,13,37,73
2008-08-25 00:00:00.000,US Open NY; U.S.A. Grand Slams,HARD,3,Stanislas Wawrinka,Wayne Odesnik,Stanislas Wawrinka,6-4; 7-6(6); 6-2,R64,136,17,5,60,108,47,60,25,48,7,9,15,72,108,3,5,55,84,41,55,12,29,1,6,15,53,84
2008-08-25 00:00:00.000,US Open NY; U.S.A. Grand Slams,HARD,3,Flavio Cipolla,Yen-Hsun Lu,Flavio Cipolla,6-1; 4-6; 7-6(2); 6-4,R64,188,2,4,87,126,58,87,25,39,7,10,19,83,126,4,3,82,130,53,82,22,48,7,13,20,75,130
2008-08-25 00:00:00.000,US Open NY; U.S.A. Grand Slams,HARD,3,Jurgen Melzer,Jiri Vanek,Jurgen Melzer,6-0; 6-2; 6-2,R64,66,18,1,44,62,38,44,9,18,1,1,11,47,62,2,6,37,66,18,37,11,29,2,9,11,29,66
2008-08-25 00:00:00.000,US Open NY; U.S.A. Grand Slams,HARD,3,Andy Murray,Michael Llodra,Andy Murray,6-4; 1-6; 7-5; 7-6(7),R64,152,11,2,73,127,55,73,25,54,5,9,20,80,127,12,3,83,120,60,83,18,37,2,6,21,78,120
2008-08-25 00:00:00.000,US Open NY; U.S.A. Grand Slams,HARD,3,Andy Roddick,Ernests Gulbis,Andy Roddick,3-6; 7-5; 6-2; 7-5,R64,171,22,3,73,120,58,73,26,47,3,5,20,84,120,19,10,77,145,59,77,32,68,9,14,21,91,145
2008-08-25 00:00:00.000,US Open NY; U.S.A. Grand Slams,HARD,3,Andreas Seppi,Guillermo Garcia-Lopez,Andreas Seppi,6-2; 4-6; 6-2; 6-2,R64,147,3,6,68,115,46,68,27,47,9,12,17,73,115,0,6,63,106,35,63,21,43,4,12,17,56,106
2008-08-25 00:00:00.000,US Open NY; U.S.A. Grand Slams,HARD,3,Jarkko Nieminen,Ivo Minar,Jarkko Nieminen,6-7(2); 3-6; 6-4; 6-3; 6-2,R64,187,7,2,114,171,72,114,35,57,13,16,24,107,171,5,5,90,140,61,90,25,50,4,10,24,86,140
2008-08-25 00:00:00.000,US Open NY; U.S.A. Grand Slams,HARD,3,Fernando Gonzalez,Bobby Reynolds,Fernando Gonzalez,7-6(6); 6-4; 6-4,R64,127,8,4,50,88,39,50,25,38,2,4,16,64,88,8,3,68,103,39,68,21,35,3,7,16,60,103
2008-08-25 00:00:00.000,US Open NY; U.S.A. Grand Slams,HARD,3,Tommy Robredo,Marat Safin,Tommy Robredo,4-6; 7-6(4); 6-4; 6-0,R64,168,5,3,80,116,59,80,21,36,2,4,19,80,116,9,7,65,124,46,65,30,59,7,12,19,76,124
2008-08-25 00:00:00.000,US Open NY; U.S.A. Grand Slams,HARD,3,Jo-Wilfried Tsonga,Carlos Moya,Jo-Wilfried Tsonga,4-6; 6-3; 6-4; 6-4,R64,157,20,2,83,118,64,83,19,35,5,7,20,83,118,5,3,60,111,42,60,29,51,6,10,19,71,111
2008-08-25 00:00:00.000,US Open NY; U.S.A. Grand Slams,HARD,3,Marin Cilic,Robby Ginepri,Marin Cilic,6-4; 2-6; 6-2; 7-5,R64,154,12,4,65,109,46,65,27,44,3,6,19,73,109,7,1,75,122,52,75,21,47,9,14,19,73,122
2008-08-25 00:00:00.000,US Open NY; U.S.A. Grand Slams,HARD,3,Novak Djokovic,Robert Kendrick,Novak Djokovic,7-6(8); 6-4; 6-4,R64,126,11,0,77,106,56,77,20,29,4,4,16,76,106,19,7,58,102,46,58,21,44,1,3,16,67,102
2008-08-25 00:00:00.000,US Open NY; U.S.A. Grand Slams,HARD,3,Nikolay Davydenko,Agustin Calleri,Nikolay Davydenko,6-4; 6-4; 7-6(2),R64,152,6,0,69,101,52,69,18,32,3,4,16,70,101,12,3,44,104,36,44,29,60,6,9,16,65,104
2008-08-25 00:00:00.000,US Open NY; U.S.A. Grand Slams,HARD,3,Dmitry Tursunov,Victor Hanescu,Dmitry Tursunov,6-7(2); 6-3; 6-4; 6-2,R64,163,16,4,83,132,64,83,28,49,5,5,20,92,132,9,4,98,135,70,98,15,37,12,16,19,85,135
2008-08-25 00:00:00.000,US Open NY; U.S.A. Grand Slams,HARD,3,Nicolas Almagro,Sam Warburg,Nicolas Almagro,6-3; 6-4; 6-4,R64,129,15,3,56,88,46,56,18,32,4,5,15,64,88,6,5,77,102,47,77,13,25,8,12,14,60,102
2008-08-25 00:00:00.000,US Open NY; U.S.A. Grand Slams,HARD,3,Gilles Muller,Tommy Haas,Gilles Muller,2-6; 2-6; 7-6(5); 6-3; 6-3,R64,191,36,7,95,153,74,95,22,58,11,17,23,96,153,15,5,79,132,57,79,33,53,7,12,23,90,132
2008-08-25 00:00:00.000,US Open NY; U.S.A. Grand Slams,HARD,3,Fernando Verdasco,Rui Machado,Fernando Verdasco,6-7(5); 7-6(5); 6-4; 6-7(6); 6-0,R64,143,4,3,133,172,95,133,23,39,4,7,26,118,172,5,3,119,192,79,119,35,73,10,17,26,114,192
2008-08-25 00:00:00.000,US Open NY; U.S.A. Grand Slams,HARD,3,Igor Andreev,Jeremy Chardy,Igor Andreev,7-6(3); 6-4; 6-3,R64,117,9,2,53,91,46,53,27,38,1,1,16,73,91,8,2,66,94,53,66,12,28,9,11,15,65,94
2008-08-25 00:00:00.000,US Open NY; U.S.A. Grand Slams,HARD,3,Radek Stepanek,Chris Guccione,Radek Stepanek,6-4; 6-4; 6-7(3); 6-2,R64,151,14,2,74,107,63,74,20,33,0,0,20,83,107,19,6,73,115,56,73,20,42,5,9,20,76,115
2008-08-25 00:00:00.000,US Open NY; U.S.A. Grand Slams,HARD,3,Roger Federer,Thiago Alves,Roger Federer,6-3; 7-5; 6-4,R64,134,19,2,61,95,49,61,19,34,2,3,16,68,95,2,2,68,125,41,68,30,57,11,15,15,71,125
2008-08-25 00:00:00.000,US Open NY; U.S.A. Grand Slams,HARD,3,Rafael Nadal,Viktor Troicki,Rafael Nadal,6-4; 6-3; 6-0,R32,115,5,3,49,75,34,49,17,26,2,3,13,51,75,11,2,51,74,33,51,5,23,4,10,12,38,74
2008-08-25 00:00:00.000,US Open NY; U.S.A. Grand Slams,HARD,3,Sam Querrey,Ivo Karlovic,Sam Querrey,7-6(5); 7-6(5); 6-2,R32,133,20,2,73,109,63,73,19,36,3,3,16,82,109,24,5,68,106,53,68,20,38,5,7,16,73,106
2008-08-25 00:00:00.000,US Open NY; U.S.A. Grand Slams,HARD,3,Mardy Fish,James Blake,Mardy Fish,6-3; 6-3; 7-6(4),R32,122,16,4,56,98,47,56,19,42,2,4,15,66,98,7,3,55,101,38,55,23,46,8,13,15,61,101
2008-08-25 00:00:00.000,US Open NY; U.S.A. Grand Slams,HARD,3,Gael Monfils,David Nalbandian,Gael Monfils,6-3; 6-4; 6-2,R32,139,12,6,58,94,42,58,18,36,7,9,14,60,94,3,4,44,99,22,44,30,55,16,22,13,52,99
2008-08-25 00:00:00.000,US Open NY; U.S.A. Grand Slams,HARD,3,Kei Nishikori,David Ferrer,Kei Nishikori,6-4; 6-4; 3-6; 2-6; 7-5,R32,214,4,7,100,155,64,100,28,55,6,14,24,92,155,5,5,90,155,56,90,36,65,12,20,25,92,155
2008-08-25 00:00:00.000,US Open NY; U.S.A. Grand Slams,HARD,3,Juan Martin Del Potro,Gilles Simon,Juan Martin Del Potro,6-4; 6-7(4); 6-1; 3-6; 6-3,R32,225,10,7,90,144,68,90,31,54,3,5,24,99,144,16,5,77,155,57,77,39,78,9,14,23,96,155
2008-08-25 00:00:00.000,US Open NY; U.S.A. Grand Slams,HARD,3,Stanislas Wawrinka,Flavio Cipolla,Stanislas Wawrinka,5-7; 6-7(4); 6-4; 6-0; 6-4,R32,251,10,2,78,153,56,78,36,75,8,15,25,92,153,0,7,105,154,61,105,22,49,6,17,25,83,154
2008-08-25 00:00:00.000,US Open NY; U.S.A. Grand Slams,HARD,3,Andy Murray,Jurgen Melzer,Andy Murray,6-7(5); 4-6; 7-6(5); 6-1; 6-3,R32,231,18,2,79,145,65,79,40,66,7,9,25,105,145,15,9,124,206,83,124,37,82,14,19,25,120,206
2008-08-25 00:00:00.000,US Open NY; U.S.A. Grand Slams,HARD,3,Andy Roddick,Andreas Seppi,Andy Roddick,6-2; 7-5; 7-6(4),R32,123,19,5,66,89,56,66,12,23,1,2,16,68,89,3,3,75,105,50,75,15,30,5,9,16,65,105
2008-08-25 00:00:00.000,US Open NY; U.S.A. Grand Slams,HARD,3,Fernando Gonzalez,Jarkko Nieminen,Fernando Gonzalez,7-5; 6-4; 6-7(3); 6-1,R32,159,12,6,67,116,53,67,28,49,2,4,20,81,116,3,3,88,145,53,88,26,57,11,18,21,79,145
2008-08-25 00:00:00.000,US Open NY; U.S.A. Grand Slams,HARD,3,Tommy Robredo,Jo-Wilfried Tsonga,Tommy Robredo,7-6(2); 6-2; 6-3,R32,138,3,1,78,94,56,78,13,16,4,5,15,69,94,5,4,75,117,46,75,18,42,2,6,14,64,117
2008-08-25 00:00:00.000,US Open NY; U.S.A. Grand Slams,HARD,3,Novak Djokovic,Marin Cilic,Novak Djokovic,6-7(7); 7-5; 6-4; 7-6(0),R32,232,8,3,104,149,74,104,26,45,6,10,23,100,149,20,12,81,161,65,81,32,80,7,13,23,97,161
2008-08-25 00:00:00.000,US Open NY; U.S.A. Grand Slams,HARD,3,Nikolay Davydenko,Dmitry Tursunov,Nikolay Davydenko,6-2; 7-6(3); 6-3,R32,145,2,2,63,95,46,63,20,32,6,7,15,66,95,7,5,56,101,36,56,23,45,7,11,14,59,101
2008-08-25 00:00:00.000,US Open NY; U.S.A. Grand Slams,HARD,3,Gilles Muller,Nicolas Almagro,Gilles Muller,6-7(3); 3-6; 7-6(5); 7-6(6); 7-5,R32,234,38,5,119,183,97,119,34,64,9,10,28,131,183,22,5,108,179,91,108,44,71,7,8,29,135,179
2008-08-25 00:00:00.000,US Open NY; U.S.A. Grand Slams,HARD,3,Igor Andreev,Fernando Verdasco,Igor Andreev,6-2; 6-4; 6-4,R32,104,10,4,41,70,39,41,17,29,0,0,14,56,70,4,3,72,85,45,72,6,13,7,11,14,51,85
2008-08-25 00:00:00.000,US Open NY; U.S.A. Grand Slams,HARD,3,Roger Federer,Radek Stepanek,Roger Federer,6-3; 6-3; 6-2,R32,96,12,3,55,76,41,55,14,21,1,2,13,55,76,1,5,57,86,36,57,9,29,5,11,13,45,86
2008-08-25 00:00:00.000,US Open NY; U.S.A. Grand Slams,HARD,3,Rafael Nadal,Sam Querrey,Rafael Nadal,6-2; 5-7; 7-6(2); 6-3,R16,192,5,6,89,134,64,89,22,45,12,16,21,86,134,20,8,72,124,55,72,20,52,6,12,20,75,124
2008-08-25 00:00:00.000,US Open NY; U.S.A. Grand Slams,HARD,3,Mardy Fish,Gael Monfils,Mardy Fish,7-5; 6-2; 6-2,R16,118,5,5,45,96,36,45,28,51,6,7,14,64,96,6,4,62,88,37,62,10,26,7,13,14,47,88
2008-08-25 00:00:00.000,US Open NY; U.S.A. Grand Slams,HARD,3,Juan Martin Del Potro,Kei Nishikori,Juan Martin Del Potro,6-3; 6-4; 6-3,R16,128,6,3,47,81,33,47,19,34,2,5,14,52,81,3,2,52,93,28,52,21,41,3,10,14,49,93
2008-08-25 00:00:00.000,US Open NY; U.S.A. Grand Slams,HARD,3,Andy Murray,Stanislas Wawrinka,Andy Murray,6-1; 6-3; 6-3,R16,109,9,2,43,78,35,43,18,35,3,3,12,53,78,3,0,53,86,34,53,11,33,7,13,13,45,86
2008-08-25 00:00:00.000,US Open NY; U.S.A. Grand Slams,HARD,3,Andy Roddick,Fernando Gonzalez,Andy Roddick,6-2; 6-4; 6-1,R16,87,8,0,40,62,37,40,16,22,1,1,13,53,62,1,6,42,79,25,42,19,37,7,12,12,44,79
2008-08-25 00:00:00.000,US Open NY; U.S.A. Grand Slams,HARD,3,Novak Djokovic,Tommy Robredo,Novak Djokovic,4-6; 6-2; 6-3; 5-7; 6-3,R16,223,11,4,91,140,68,91,26,49,2,5,24,94,140,8,5,102,153,67,102,26,51,7,13,24,93,153
2008-08-25 00:00:00.000,US Open NY; U.S.A. Grand Slams,HARD,3,Gilles Muller,Nikolay Davydenko,Gilles Muller,6-4; 4-6; 6-3; 7-6(10),R16,187,22,5,84,142,71,84,26,58,13,15,21,97,142,5,5,95,126,65,95,20,31,3,6,20,85,126
2008-08-25 00:00:00.000,US Open NY; U.S.A. Grand Slams,HARD,3,Roger Federer,Igor Andreev,Roger Federer,6-7(5); 7-6(5); 6-3; 3-6; 6-3,R16,211,10,5,114,168,86,114,31,54,13,15,26,117,168,8,7,100,165,78,100,32,65,4,7,25,110,165
2008-08-25 00:00:00.000,US Open NY; U.S.A. Grand Slams,HARD,3,Rafael Nadal,Mardy Fish,Rafael Nadal,3-6; 6-1; 6-4; 6-2,Q,158,3,0,68,94,50,68,18,26,0,1,17,68,94,14,1,55,110,40,55,26,55,7,12,17,66,110
2008-08-25 00:00:00.000,US Open NY; U.S.A. Grand Slams,HARD,3,Andy Murray,Juan Martin Del Potro,Andy Murray,7-6(2); 7-6(1); 4-6; 7-5,Q,237,9,8,81,144,58,81,29,63,11,18,23,87,144,3,5,99,159,60,99,32,60,8,15,23,92,159
2008-08-25 00:00:00.000,US Open NY; U.S.A. Grand Slams,HARD,3,Novak Djokovic,Andy Roddick,Novak Djokovic,6-2; 6-3; 3-6; 7-6(5),Q,154,15,2,70,108,50,70,27,38,7,10,19,77,108,14,7,80,116,56,80,17,36,0,5,19,73,116
2008-08-25 00:00:00.000,US Open NY; U.S.A. Grand Slams,HARD,3,Roger Federer,Gilles Muller,Roger Federer,7-6(5); 6-4; 7-6(5),Q,144,8,0,63,103,54,63,26,40,2,2,17,80,103,16,4,76,121,59,76,25,45,10,11,17,84,121
2008-08-25 00:00:00.000,US Open NY; U.S.A. Grand Slams,HARD,3,Andy Murray,Rafael Nadal,Andy Murray,6-2; 7-6(5); 4-6; 6-4,S,211,21,3,70,108,55,70,24,38,1,3,20,79,108,7,2,120,167,71,120,26,47,16,20,20,97,167
2008-08-25 00:00:00.000,US Open NY; U.S.A. Grand Slams,HARD,3,Roger Federer,Novak Djokovic,Roger Federer,6-3; 5-7; 7-5; 6-2,S,164,20,1,80,125,61,80,27,45,2,4,21,88,125,6,5,80,124,57,80,20,44,7,12,20,77,124
2008-08-25 00:00:00.000,US Open NY; U.S.A. Grand Slams,HARD,3,Roger Federer,Andy Murray,Roger Federer,6-2; 7-5; 6-2,F,111,3,0,47,81,37,47,16,34,3,5,14,53,81,3,3,45,81,23,45,17,36,3,10,14,40,81
2008-09-08 00:00:00.000,Bucharest Romania ATP World Tour,CLAY,2,Richard Gasquet,Oscar Hernandez,Richard Gasquet,3-6; 6-4; 6-4,R32,139,10,2,54,87,39,54,17,33,2,5,15,56,87,6,2,48,84,38,48,17,36,5,8,14,55,84
2008-09-08 00:00:00.000,Bucharest Romania ATP World Tour,CLAY,2,Victor Crivoi,Ruben Ramirez Hidalgo,Victor Crivoi,3-6; 6-3; 6-4,R32,151,4,3,58,99,37,58,24,41,12,15,14,61,99,5,3,57,90,37,57,16,33,3,7,14,53,90
2008-09-08 00:00:00.000,Bucharest Romania ATP World Tour,CLAY,2,Adrian Cruciat,Filippo Volandri,Adrian Cruciat,7-5; 4-0 RET,R32,77,3,1,30,49,23,30,12,19,3,3,8,35,49,0,4,34,46,22,34,5,12,4,7,8,27,46
2008-09-08 00:00:00.000,Bucharest Romania ATP World Tour,CLAY,2,Teymuraz Gabashvili,Ernests Gulbis,Teymuraz Gabashvili,6-2; 2-6; 6-4,R32,113,2,7,64,94,49,64,10,30,8,10,13,59,94,6,2,51,80,32,51,16,29,7,10,13,48,80
2008-09-08 00:00:00.000,Bucharest Romania ATP World Tour,CLAY,2,Nicolas Almagro,Somdev Devvarman,Nicolas Almagro,6-7(6); 6-2; 7-5,R32,146,11,4,60,111,48,60,26,51,4,6,16,74,111,5,0,73,112,41,73,26,39,6,11,16,67,112
2008-09-08 00:00:00.000,Bucharest Romania ATP World Tour,CLAY,2,Guillermo Garcia-Lopez,Mischa Zverev,Guillermo Garcia-Lopez,6-4; 3-6; 6-0,R32,110,1,7,54,80,35,54,13,26,7,10,12,48,80,7,2,52,79,33,52,9,27,8,14,13,42,79
2008-09-08 00:00:00.000,Bucharest Romania ATP World Tour,CLAY,2,Pablo Andujar,Brian Dabul,Pablo Andujar,4-6; 6-2; 6-4,R32,138,5,5,69,89,48,69,11,20,4,6,14,59,89,2,0,56,85,34,56,17,29,4,8,14,51,85
2008-09-08 00:00:00.000,Bucharest Romania ATP World Tour,CLAY,2,Carlos Moya,Alberto Martin,Carlos Moya,6-4; 6-7(4); 6-4,R32,148,5,2,52,100,39,52,28,48,2,4,16,67,100,1,1,72,110,48,72,21,38,4,8,16,69,110
2008-09-08 00:00:00.000,Bucharest Romania ATP World Tour,CLAY,2,Jose Acasuso,Diego Junqueira,Jose Acasuso,6-2; 6-4,R32,106,4,1,37,61,28,37,14,24,2,3,9,42,61,2,3,54,80,32,54,11,26,10,14,9,43,80
2008-09-08 00:00:00.000,Bucharest Romania ATP World Tour,CLAY,2,Martin Vassallo Arguello,Victor Hanescu,Martin Vassallo Arguello,4-6; 7-5; 6-4,R32,141,4,4,73,96,47,73,12,23,2,6,16,59,96,1,4,69,99,38,69,20,30,8,13,16,58,99
2008-09-08 00:00:00.000,Bucharest Romania ATP World Tour,CLAY,2,Denis Gremelmayr,Jeremy Chardy,Denis Gremelmayr,6-1; 5-7; 6-4,R32,125,4,3,56,93,41,56,18,37,6,9,15,59,93,5,5,44,85,29,44,20,41,7,12,14,49,85
2008-09-08 00:00:00.000,Bucharest Romania ATP World Tour,CLAY,2,Ivan Navarro,Paul-Henri Mathieu,Ivan Navarro,6-4; 6-7(5); 6-3,R32,156,14,7,62,104,48,62,19,42,3,4,16,67,104,5,2,57,92,42,57,16,35,2,5,15,58,92
2008-09-08 00:00:00.000,Bucharest Romania ATP World Tour,CLAY,2,Potito Starace,Marcel Granollers,Potito Starace,6-2; 6-4,R32,81,1,0,46,55,35,46,3,9,2,3,9,38,55,2,0,46,62,24,46,10,16,10,14,9,34,62
2008-09-08 00:00:00.000,Bucharest Romania ATP World Tour,CLAY,2,Florent Serra,Nicolas Devilder,Florent Serra,3-6; 7-6(6); 7-6(4),R32,179,3,2,65,114,44,65,21,49,6,11,16,65,114,6,10,64,136,39,64,38,72,11,15,17,77,136
2008-09-08 00:00:00.000,Bucharest Romania ATP World Tour,CLAY,2,Albert Montanes,Hyung-Taik Lee,Albert Montanes,6-1; 7-6(4),R32,75,3,1,31,60,25,31,19,29,1,2,10,44,60,0,2,37,58,23,37,10,21,2,5,9,33,58
2008-09-08 00:00:00.000,Bucharest Romania ATP World Tour,CLAY,2,Gilles Simon,Evgeny Korolev,Gilles Simon,6-1; 6-2,R32,63,4,1,35,53,23,35,11,18,3,4,8,34,53,2,3,33,58,16,33,9,25,7,12,7,25,58
2008-09-08 00:00:00.000,Bucharest Romania ATP World Tour,CLAY,2,Richard Gasquet,Victor Crivoi,Richard Gasquet,6-3; 6-2,R16,65,3,1,23,41,20,23,10,18,1,2,8,30,41,1,2,37,56,17,37,9,19,4,9,9,26,56
2008-09-08 00:00:00.000,Bucharest Romania ATP World Tour,CLAY,2,Teymuraz Gabashvili,Adrian Cruciat,Teymuraz Gabashvili,6-1; 6-2,R16,59,4,3,33,50,25,33,12,17,4,4,8,37,50,3,0,25,42,15,25,5,17,2,6,7,20,42
2008-09-08 00:00:00.000,Bucharest Romania ATP World Tour,CLAY,2,Guillermo Garcia-Lopez,Nicolas Almagro,Guillermo Garcia-Lopez,6-4; 7-5,R16,98,2,1,41,60,32,41,13,19,3,3,11,45,60,6,2,52,80,38,52,11,28,2,4,11,49,80
2008-09-08 00:00:00.000,Bucharest Romania ATP World Tour,CLAY,2,Carlos Moya,Pablo Andujar,Carlos Moya,6-3; 7-6(6),R16,98,3,2,52,69,37,52,10,17,0,1,11,47,69,0,5,57,81,38,57,11,24,5,7,10,49,81
2008-09-08 00:00:00.000,Bucharest Romania ATP World Tour,CLAY,2,Jose Acasuso,Martin Vassallo Arguello,Jose Acasuso,6-4; 7-5,R16,120,5,3,41,72,29,41,13,31,5,8,11,42,72,1,5,52,74,29,52,9,22,5,10,11,38,74
2008-09-08 00:00:00.000,Bucharest Romania ATP World Tour,CLAY,2,Ivan Navarro,Denis Gremelmayr,Ivan Navarro,6-3; 1-0 RET,R16,55,1,1,20,30,15,20,7,10,3,3,5,22,30,2,0,28,41,16,28,5,13,4,6,5,21,41
2008-09-08 00:00:00.000,Bucharest Romania ATP World Tour,CLAY,2,Florent Serra,Potito Starace,Florent Serra,7-5; 0-6; 6-4,R16,129,3,1,58,81,38,58,14,23,4,8,14,52,81,8,2,79,114,52,79,17,35,13,16,14,69,114
2008-09-08 00:00:00.000,Bucharest Romania ATP World Tour,CLAY,2,Gilles Simon,Albert Montanes,Gilles Simon,6-3; 6-4,R16,93,8,0,34,62,27,34,17,28,3,3,10,44,62,2,5,36,68,24,36,16,32,8,10,9,40,68
2008-09-08 00:00:00.000,Bucharest Romania ATP World Tour,CLAY,2,Richard Gasquet,Teymuraz Gabashvili,Richard Gasquet,6-7(6); 6-1; 6-1,Q,109,8,1,47,79,37,47,19,32,0,1,13,56,79,3,4,49,79,30,49,12,30,2,8,13,42,79
2008-09-08 00:00:00.000,Bucharest Romania ATP World Tour,CLAY,2,Carlos Moya,Guillermo Garcia-Lopez,Carlos Moya,5-7; 6-3; 6-4,Q,154,10,3,58,90,44,58,22,32,1,2,16,66,90,1,1,78,107,51,78,18,29,4,6,15,69,107
2008-09-08 00:00:00.000,Bucharest Romania ATP World Tour,CLAY,2,Jose Acasuso,Ivan Navarro,Jose Acasuso,6-4; 6-4,Q,101,2,2,41,58,30,41,12,17,2,2,10,42,58,8,2,47,71,32,47,13,24,4,6,10,45,71
2008-09-08 00:00:00.000,Bucharest Romania ATP World Tour,CLAY,2,Gilles Simon,Florent Serra,Gilles Simon,6-2; 6-3,Q,73,0,1,23,50,15,23,12,27,2,5,8,27,50,1,4,24,54,11,24,6,30,3,10,9,17,54
2008-09-08 00:00:00.000,Bucharest Romania ATP World Tour,CLAY,2,Carlos Moya,Richard Gasquet,Carlos Moya,6-2; 6-4,S,78,3,2,32,48,27,32,11,16,2,2,9,38,48,4,5,40,66,27,40,8,26,5,8,9,35,66
2008-09-08 00:00:00.000,Bucharest Romania ATP World Tour,CLAY,2,Gilles Simon,Jose Acasuso,Gilles Simon,4-6; 7-6(4); 6-4,S,174,6,3,67,121,46,67,26,54,6,10,16,72,121,1,5,52,111,36,52,27,59,8,12,16,63,111
2008-09-08 00:00:00.000,Bucharest Romania ATP World Tour,CLAY,2,Gilles Simon,Carlos Moya,Gilles Simon,6-3; 6-4,F,90,0,3,32,66,30,32,16,34,6,6,10,46,66,1,0,48,67,32,48,8,19,5,7,9,40,67
2008-09-22 00:00:00.000,Bangkok Thailand ATP World Tour,HARD,2,Novak Djokovic,N/A Bye,Novak Djokovic,,R32,0,0,0,0,0,0,0,0,0,0,0,0,0,0,0,0,0,0,0,0,0,0,0,0,0,0,0
2008-09-22 00:00:00.000,Bangkok Thailand ATP World Tour,HARD,2,Simon Stadler,Julien Benneteau,Simon Stadler,7-5; 6-1,R32,77,3,0,42,58,30,42,10,16,1,2,10,40,58,1,3,43,57,24,43,6,14,5,9,9,30,57
2008-09-22 00:00:00.000,Bangkok Thailand ATP World Tour,HARD,2,Teymuraz Gabashvili,Michael Berrer,Teymuraz Gabashvili,6-4; 6-3,R32,76,6,1,42,54,36,42,5,12,0,0,10,41,54,4,3,36,61,24,36,13,25,2,4,9,37,61
2008-09-22 00:00:00.000,Bangkok Thailand ATP World Tour,HARD,2,Robin Soderling,Aisam-Ul-Haq Qureshi,Robin Soderling,6-2; 6-4,R32,69,14,2,40,56,32,40,9,16,4,4,9,41,56,7,3,33,50,23,33,6,17,5,8,9,29,50
2008-09-22 00:00:00.000,Bangkok Thailand ATP World Tour,HARD,2,Tomas Berdych,N/A Bye,Tomas Berdych,,R32,0,0,0,0,0,0,0,0,0,0,0,0,0,0,0,0,0,0,0,0,0,0,0,0,0,0,0
2008-09-22 00:00:00.000,Bangkok Thailand ATP World Tour,HARD,2,Simone Bolelli,Thomaz Bellucci,Simone Bolelli,6-3; 6-3,R32,69,3,0,34,51,29,34,8,17,0,0,9,37,51,5,0,28,51,18,28,11,23,0,3,9,29,51
2008-09-22 00:00:00.000,Bangkok Thailand ATP World Tour,HARD,2,Nicolas Mahut,Danai Udomchoke,Nicolas Mahut,6-2; 6-7(5); 6-2,R32,137,6,1,56,90,42,56,14,34,3,6,14,56,90,5,9,65,99,37,65,13,34,8,15,14,50,99
2008-09-22 00:00:00.000,Bangkok Thailand ATP World Tour,HARD,2,Jarkko Nieminen,Marko Djokovic,Jarkko Nieminen,6-2; 6-0,R32,47,1,0,26,34,22,26,6,8,0,0,7,28,34,0,2,29,41,13,29,3,12,2,7,7,16,41
2008-09-22 00:00:00.000,Bangkok Thailand ATP World Tour,HARD,2,Philipp Petzschner,Marat Safin,Philipp Petzschner,6-4; 7-6(4),R32,104,13,4,45,81,30,45,19,36,2,5,11,49,81,5,3,42,84,30,42,18,42,5,9,11,48,84
2008-09-22 00:00:00.000,Bangkok Thailand ATP World Tour,HARD,2,Mischa Zverev,Robert Smeets,Mischa Zverev,6-4; 6-4,R32,63,9,0,45,56,32,45,9,11,2,2,10,41,56,6,0,30,58,24,30,14,28,4,6,10,38,58
2008-09-22 00:00:00.000,Bangkok Thailand ATP World Tour,HARD,2,Robert Kendrick,George Bastl,Robert Kendrick,6-3; 7-6(4),R32,81,14,2,49,66,42,49,11,17,1,1,11,53,66,7,0,47,63,36,47,9,16,3,4,10,45,63
2008-09-22 00:00:00.000,Bangkok Thailand ATP World Tour,HARD,2,Gael Monfils,N/A Bye,Gael Monfils,,R32,0,0,0,0,0,0,0,0,0,0,0,0,0,0,0,0,0,0,0,0,0,0,0,0,0,0,0
2008-09-22 00:00:00.000,Bangkok Thailand ATP World Tour,HARD,2,Jurgen Melzer,Donald Young,Jurgen Melzer,6-3; 6-3,R32,71,3,1,28,45,23,28,9,17,0,1,9,32,45,3,2,38,69,22,38,17,31,9,13,9,39,69
2008-09-22 00:00:00.000,Bangkok Thailand ATP World Tour,HARD,2,Viktor Troicki,Fabrice Santoro,Viktor Troicki,7-6(4); 6-2,R32,95,3,0,48,68,31,48,14,20,1,2,10,45,68,3,0,46,73,26,46,16,27,4,7,10,42,73
2008-09-22 00:00:00.000,Bangkok Thailand ATP World Tour,HARD,2,Lukas Dlouhy,Benjamin Becker,Lukas Dlouhy,6-4; 7-6(4),R32,77,10,6,57,78,46,57,6,21,3,5,11,52,78,8,0,37,70,27,37,17,33,2,5,11,44,70
2008-09-22 00:00:00.000,Bangkok Thailand ATP World Tour,HARD,2,Jo-Wilfried Tsonga,N/A Bye,Jo-Wilfried Tsonga,,R32,0,0,0,0,0,0,0,0,0,0,0,0,0,0,0,0,0,0,0,0,0,0,0,0,0,0,0
2008-09-22 00:00:00.000,Bangkok Thailand ATP World Tour,HARD,2,Novak Djokovic,Simon Stadler,Novak Djokovic,6-1; 6-3,R16,66,5,1,30,51,19,30,16,21,1,2,8,35,51,1,2,47,55,22,47,2,8,4,9,8,24,55
2008-09-22 00:00:00.000,Bangkok Thailand ATP World Tour,HARD,2,Robin Soderling,Teymuraz Gabashvili,Robin Soderling,6-1; 6-3,R16,47,11,1,23,37,21,23,11,14,0,0,8,32,37,4,3,30,48,19,30,5,18,4,8,8,24,48
2008-09-22 00:00:00.000,Bangkok Thailand ATP World Tour,HARD,2,Tomas Berdych,Simone Bolelli,Tomas Berdych,7-5; 6-1,R16,83,10,2,39,62,29,39,14,23,3,4,10,43,62,5,3,37,61,21,37,11,24,4,8,9,32,61
2008-09-22 00:00:00.000,Bangkok Thailand ATP World Tour,HARD,2,Nicolas Mahut,Jarkko Nieminen,Nicolas Mahut,6-4; 3-6; 6-3,R16,105,4,0,44,72,35,44,19,28,0,2,14,54,72,4,2,52,86,37,52,16,34,6,9,14,53,86
2008-09-22 00:00:00.000,Bangkok Thailand ATP World Tour,HARD,2,Philipp Petzschner,Mischa Zverev,Philipp Petzschner,7-6(3); 3-6; 6-1,R16,106,12,1,61,96,45,61,19,35,6,8,14,64,96,4,2,60,86,37,60,17,26,6,9,14,54,86
2008-09-22 00:00:00.000,Bangkok Thailand ATP World Tour,HARD,2,Gael Monfils,Robert Kendrick,Gael Monfils,6-4; 7-6(4),R16,74,4,2,40,64,31,40,13,24,1,3,11,44,64,8,2,38,70,28,38,17,32,4,7,11,45,70
2008-09-22 00:00:00.000,Bangkok Thailand ATP World Tour,HARD,2,Jurgen Melzer,Viktor Troicki,Jurgen Melzer,6-4; 7-6(4),R16,86,1,2,39,67,35,39,15,28,1,1,11,50,67,4,0,44,59,36,44,8,15,0,1,11,44,59
2008-09-22 00:00:00.000,Bangkok Thailand ATP World Tour,HARD,2,Jo-Wilfried Tsonga,Lukas Dlouhy,Jo-Wilfried Tsonga,7-6(9); 3-6; 7-6(1),R16,116,21,2,67,100,51,67,18,33,2,5,16,69,100,5,4,70,108,51,70,20,38,2,4,17,71,108
2008-09-22 00:00:00.000,Bangkok Thailand ATP World Tour,HARD,2,Novak Djokovic,Robin Soderling,Novak Djokovic,6-4; 7-5,Q,88,9,0,48,68,36,48,11,20,4,5,11,47,68,12,2,46,69,36,46,7,23,6,9,11,43,69
2008-09-22 00:00:00.000,Bangkok Thailand ATP World Tour,HARD,2,Tomas Berdych,Nicolas Mahut,Tomas Berdych,7-6(6); 6-3,Q,104,11,0,47,68,36,47,14,21,2,2,10,50,68,10,5,65,91,43,65,11,26,9,11,11,54,91
2008-09-22 00:00:00.000,Bangkok Thailand ATP World Tour,HARD,2,Gael Monfils,Philipp Petzschner,Gael Monfils,7-6(6); 6-4,Q,141,9,1,47,68,38,47,11,21,1,2,11,49,68,3,2,41,67,31,41,14,26,4,6,11,45,67
2008-09-22 00:00:00.000,Bangkok Thailand ATP World Tour,HARD,2,Jo-Wilfried Tsonga,Jurgen Melzer,Jo-Wilfried Tsonga,6-3; 6-2,Q,60,13,1,31,47,25,31,13,16,1,1,9,38,47,2,1,33,50,20,33,10,17,3,6,8,30,50
2008-09-22 00:00:00.000,Bangkok Thailand ATP World Tour,HARD,2,Novak Djokovic,Tomas Berdych,Novak Djokovic,7-5; 6-1,S,81,6,2,42,64,31,42,13,22,3,3,10,44,64,1,3,26,49,18,26,10,23,0,3,9,28,49
2008-09-22 00:00:00.000,Bangkok Thailand ATP World Tour,HARD,2,Jo-Wilfried Tsonga,Gael Monfils,Jo-Wilfried Tsonga,6-0; 6-3,S,60,7,2,26,43,22,26,11,17,1,1,8,33,43,5,1,24,40,16,24,5,16,2,6,7,21,40
2008-09-22 00:00:00.000,Bangkok Thailand ATP World Tour,HARD,2,Jo-Wilfried Tsonga,Novak Djokovic,Jo-Wilfried Tsonga,7-6(4); 6-4,F,101,8,1,41,71,32,41,16,30,5,6,11,48,71,3,1,44,71,31,44,14,27,1,3,11,45,71
2008-09-22 00:00:00.000,Beijing China ATP World Tour,HARD,2,David Ferrer,N/A Bye,David Ferrer,,R32,0,0,0,0,0,0,0,0,0,0,0,0,0,0,0,0,0,0,0,0,0,0,0,0,0,0,0
2008-09-22 00:00:00.000,Beijing China ATP World Tour,HARD,2,Dudi Sela,Nicolas Devilder,Dudi Sela,6-4; 6-3,R32,70,1,2,31,53,26,31,13,22,3,3,9,39,53,3,8,32,64,23,32,11,32,2,5,10,34,64
2008-09-22 00:00:00.000,Beijing China ATP World Tour,HARD,2,Ivo Minar,Hyung-Taik Lee,Ivo Minar,6-3; 3-6; 6-2,R32,91,3,0,41,68,30,41,16,27,2,5,13,46,68,2,3,47,84,27,47,18,37,10,15,13,45,84
2008-09-22 00:00:00.000,Beijing China ATP World Tour,HARD,2,Tommy Robredo,Guillermo Garcia-Lopez,Tommy Robredo,6-4; 7-5,R32,118,3,4,44,77,31,44,15,33,4,6,11,46,77,1,3,42,83,25,42,20,41,11,15,11,45,83
2008-09-22 00:00:00.000,Beijing China ATP World Tour,HARD,2,Richard Gasquet,N/A Bye,Richard Gasquet,,R32,0,0,0,0,0,0,0,0,0,0,0,0,0,0,0,0,0,0,0,0,0,0,0,0,0,0,0
2008-09-22 00:00:00.000,Beijing China ATP World Tour,HARD,2,Yen-Hsun Lu,Jun-Chao Xu,Yen-Hsun Lu,6-4; 6-3,R32,83,4,3,27,55,24,27,15,28,0,0,9,39,55,2,2,37,65,21,37,16,28,5,8,10,37,65
2008-09-22 00:00:00.000,Beijing China ATP World Tour,HARD,2,Jean-Claude Scherrer,Peng Sun,Jean-Claude Scherrer,6-4; 7-6(7),R32,95,12,1,59,75,45,59,9,16,0,0,11,54,75,2,7,55,86,43,55,14,31,8,9,11,57,86
2008-09-22 00:00:00.000,Beijing China ATP World Tour,HARD,2,Rainer Schuettler,Ivan Navarro,Rainer Schuettler,2-6; 6-3; 6-4,R32,110,1,6,50,84,35,50,22,34,4,6,14,57,84,8,5,39,75,35,39,15,36,3,5,13,50,75
2008-09-22 00:00:00.000,Beijing China ATP World Tour,HARD,2,Sam Querrey,Jesse Levine,Sam Querrey,1-6; 6-2; 7-6(4),R32,103,6,4,59,91,41,59,17,32,1,5,14,58,91,5,2,63,85,41,63,9,22,2,5,13,50,85
2008-09-22 00:00:00.000,Beijing China ATP World Tour,HARD,2,Bjorn Phau,Hyun-Woo Nam,Bjorn Phau,6-1; 6-3,R32,67,4,2,29,46,25,29,11,17,6,6,8,36,46,1,2,41,64,20,41,12,23,5,9,8,32,64
2008-09-22 00:00:00.000,Beijing China ATP World Tour,HARD,2,Go Soeda,Yan Bai,Go Soeda,6-4; 7-5,R32,106,2,1,39,72,26,39,19,33,6,8,11,45,72,1,4,45,84,28,45,17,39,8,12,11,45,84
2008-09-22 00:00:00.000,Beijing China ATP World Tour,HARD,2,Fernando Gonzalez,N/A Bye,Fernando Gonzalez,,R32,0,0,0,0,0,0,0,0,0,0,0,0,0,0,0,0,0,0,0,0,0,0,0,0,0,0,0
2008-09-22 00:00:00.000,Beijing China ATP World Tour,HARD,2,Fernando Verdasco,Bobby Reynolds,Fernando Verdasco,6-3; 6-3,R32,65,1,2,35,44,27,35,5,9,0,1,9,32,44,7,4,35,63,22,35,11,28,6,10,9,33,63
2008-09-22 00:00:00.000,Beijing China ATP World Tour,HARD,2,Juan Carlos Ferrero,Alexander Kudryavtsev,Juan Carlos Ferrero,6-4; 6-3,R32,70,5,1,39,55,27,39,10,16,0,1,10,37,55,8,4,28,67,20,28,18,39,0,3,9,38,67
2008-09-22 00:00:00.000,Beijing China ATP World Tour,HARD,2,Brendan Evans,Roko Karanusic,Brendan Evans,7-6(5); 1-6; 7-6(10),R32,118,10,4,77,109,58,77,10,32,4,8,15,68,109,5,1,89,116,60,89,17,27,8,10,16,77,116
2008-09-22 00:00:00.000,Beijing China ATP World Tour,HARD,2,Andy Roddick,N/A Bye,Andy Roddick,,R32,0,0,0,0,0,0,0,0,0,0,0,0,0,0,0,0,0,0,0,0,0,0,0,0,0,0,0
2008-09-22 00:00:00.000,Beijing China ATP World Tour,HARD,2,Dudi Sela,David Ferrer,Dudi Sela,6-3; 6-3,R16,69,2,2,39,61,29,39,13,22,6,7,9,42,61,3,2,27,50,18,27,9,23,0,4,9,27,50
2008-09-22 00:00:00.000,Beijing China ATP World Tour,HARD,2,Tommy Robredo,Ivo Minar,Tommy Robredo,6-2; 6-3,R16,64,8,1,32,48,26,32,9,16,1,1,8,35,48,1,3,35,65,20,35,15,30,4,8,9,35,65
2008-09-22 00:00:00.000,Beijing China ATP World Tour,HARD,2,Richard Gasquet,Yen-Hsun Lu,Richard Gasquet,7-5; 6-1,R16,80,12,2,42,69,34,42,14,27,3,3,10,48,69,1,2,33,57,24,33,9,24,5,8,9,33,57
2008-09-22 00:00:00.000,Beijing China ATP World Tour,HARD,2,Rainer Schuettler,Jean-Claude Scherrer,Rainer Schuettler,6-1; 6-4,R16,76,4,2,41,66,33,41,13,25,6,6,9,46,66,2,2,38,55,26,38,5,17,5,8,8,31,55
2008-09-22 00:00:00.000,Beijing China ATP World Tour,HARD,2,Bjorn Phau,Sam Querrey,Bjorn Phau,5-7; 6-3; 6-4,R16,122,6,7,50,102,40,50,27,52,7,10,16,67,102,9,2,69,112,42,69,22,43,12,16,15,64,112
2008-09-22 00:00:00.000,Beijing China ATP World Tour,HARD,2,Fernando Gonzalez,Go Soeda,Fernando Gonzalez,3-6; 7-6(4); 6-1,R16,101,6,2,41,66,27,41,12,25,2,5,11,39,66,3,3,45,79,33,45,13,34,1,4,12,46,79
2008-09-22 00:00:00.000,Beijing China ATP World Tour,HARD,2,Juan Carlos Ferrero,Fernando Verdasco,Juan Carlos Ferrero,7-5; 6-4,R16,80,2,0,36,60,28,36,15,24,1,2,11,43,60,6,4,49,62,32,49,7,13,5,8,11,39,62
2008-09-22 00:00:00.000,Beijing China ATP World Tour,HARD,2,Andy Roddick,Brendan Evans,Andy Roddick,6-4; 6-3,R16,57,17,2,35,55,27,35,13,20,2,3,10,40,55,1,1,30,53,20,30,12,23,2,5,9,32,53
2008-09-22 00:00:00.000,Beijing China ATP World Tour,HARD,2,Dudi Sela,Tommy Robredo,Dudi Sela,6-4; 6-1,Q,79,3,1,28,44,22,28,10,16,5,6,8,32,44,1,1,50,75,30,50,6,25,8,13,9,36,75
2008-09-22 00:00:00.000,Beijing China ATP World Tour,HARD,2,Rainer Schuettler,Richard Gasquet,Rainer Schuettler,4-6; 6-3; 6-4,Q,141,6,4,61,101,43,61,19,40,7,10,15,62,101,12,6,54,104,39,54,20,50,7,11,14,59,104
2008-09-22 00:00:00.000,Beijing China ATP World Tour,HARD,2,Bjorn Phau,Fernando Gonzalez,Bjorn Phau,6-3; 4-6; 6-3,Q,110,5,1,38,76,28,38,21,38,3,6,14,49,76,4,3,56,83,37,56,12,27,10,15,14,49,83
2008-09-22 00:00:00.000,Beijing China ATP World Tour,HARD,2,Andy Roddick,Juan Carlos Ferrero,Andy Roddick,2-6; 6-3; 6-4,Q,56,12,4,32,50,24,32,7,18,1,3,7,31,50,0,1,31,43,21,31,5,12,1,2,6,26,43
2008-09-22 00:00:00.000,Beijing China ATP World Tour,HARD,2,Dudi Sela,Rainer Schuettler,Dudi Sela,6-3; 6-3,S,70,0,0,26,49,21,26,13,23,0,1,9,34,49,0,2,29,49,14,29,11,20,3,7,9,25,49
2008-09-22 00:00:00.000,Beijing China ATP World Tour,HARD,2,Andy Roddick,Bjorn Phau,Andy Roddick,6-2; 6-7(4); 6-1,S,103,16,1,54,70,48,54,9,16,0,0,13,57,70,2,7,47,98,31,47,26,51,2,7,14,57,98
2008-09-22 00:00:00.000,Beijing China ATP World Tour,HARD,2,Andy Roddick,Dudi Sela,Andy Roddick,6-4; 6-7(6); 6-3,F,121,17,2,73,109,56,73,20,36,9,10,16,76,109,2,1,58,91,43,58,20,33,7,10,15,63,91
2008-09-29 00:00:00.000,Metz France ATP World Tour,HARD,2,Ivo Karlovic,Marcos Baghdatis,Ivo Karlovic,4-6; 2-1 RET,R32,57,6,0,27,45,17,27,13,18,2,3,7,30,45,5,2,18,34,14,18,13,16,0,0,6,27,34
2008-09-29 00:00:00.000,Metz France ATP World Tour,HARD,2,Carlos Moya,Albert Montanes,Carlos Moya,6-1; 4-6; 6-4,R32,91,10,3,49,84,39,49,21,35,2,3,14,60,84,4,3,46,89,27,46,26,43,8,11,13,53,89
2008-09-29 00:00:00.000,Metz France ATP World Tour,HARD,2,Jose Acasuso,Guillermo Canas,Jose Acasuso,6-3; 2-6; 6-3,R32,140,8,2,40,88,29,40,25,48,7,10,13,54,88,11,5,44,96,33,44,22,52,8,12,13,55,96
2008-09-29 00:00:00.000,Metz France ATP World Tour,HARD,2,Dmitry Tursunov,Thierry Ascione,Dmitry Tursunov,6-7(3); 6-2; 6-4,R32,110,14,5,50,93,40,50,27,43,4,4,15,67,93,5,2,58,94,44,58,18,36,5,8,15,62,94
2008-09-29 00:00:00.000,Metz France ATP World Tour,HARD,2,Eduardo Schwank,Nicolas Almagro,Eduardo Schwank,7-6(5); 6-2,R32,91,10,1,44,73,32,44,16,29,2,3,10,48,73,1,1,50,72,31,50,12,22,8,11,10,43,72
2008-09-29 00:00:00.000,Metz France ATP World Tour,HARD,2,Victor Hanescu,Ivan Ljubicic,Victor Hanescu,6-1; 7-6(4),R32,78,7,1,34,64,28,34,17,30,1,2,10,45,64,7,4,26,53,20,26,12,27,0,3,9,32,53
2008-09-29 00:00:00.000,Metz France ATP World Tour,HARD,2,Michael Llodra,Feliciano Lopez,Michael Llodra,7-6(11); 6-7(6); 6-3,R32,149,20,4,72,107,58,72,25,35,0,0,17,83,107,17,5,82,137,62,82,26,55,7,8,16,88,137
2008-09-29 00:00:00.000,Metz France ATP World Tour,HARD,2,Radek Stepanek,Julien Benneteau,Radek Stepanek,6-3; 6-3,R32,71,7,1,34,58,26,34,15,24,2,2,9,41,58,4,3,35,51,23,35,7,16,3,6,9,30,51
2008-09-29 00:00:00.000,Metz France ATP World Tour,HARD,2,Ernests Gulbis,Mario Ancic,Ernests Gulbis,7-6(3); 6-4,R32,100,11,8,44,74,37,44,12,30,4,6,11,49,74,4,2,49,77,28,49,18,28,4,7,11,46,77
2008-09-29 00:00:00.000,Metz France ATP World Tour,HARD,2,Janko Tipsarevic,Jeremy Chardy,Janko Tipsarevic,7-6(5); 7-5,R32,115,15,1,44,84,37,44,22,40,4,4,12,59,84,8,7,50,84,37,50,16,34,2,3,12,53,84
2008-09-29 00:00:00.000,Metz France ATP World Tour,HARD,2,Romain Jouan,Agustin Calleri,Romain Jouan,5-7; 6-1; 6-2,R32,86,9,4,52,96,39,52,25,44,6,7,14,64,96,14,1,41,72,31,41,13,31,4,8,13,44,72
2008-09-29 00:00:00.000,Metz France ATP World Tour,HARD,2,Paul-Henri Mathieu,Nicolas Devilder,Paul-Henri Mathieu,6-0; 6-2,R32,60,3,2,32,48,25,32,8,16,3,3,7,33,48,4,2,30,52,14,30,10,22,6,11,7,24,52
2008-09-29 00:00:00.000,Metz France ATP World Tour,HARD,2,Adrian Mannarino,Andreas Seppi,Adrian Mannarino,6-4; 6-2,R32,72,3,2,31,54,23,31,13,23,6,7,9,36,54,1,4,31,57,21,31,9,26,1,5,9,30,57
2008-09-29 00:00:00.000,Metz France ATP World Tour,HARD,2,Rik De Voest,Arnaud Clement,Rik De Voest,4-6; 6-2; 7-5,R32,155,12,6,44,90,33,44,21,46,4,9,15,54,90,9,4,55,91,35,55,13,36,4,11,15,48,91
2008-09-29 00:00:00.000,Metz France ATP World Tour,HARD,2,Marc Gicquel,Marcel Granollers,Marc Gicquel,6-3; 6-2,R32,55,9,0,27,46,22,27,16,19,0,0,9,38,46,1,1,26,47,13,26,13,21,4,7,8,26,47
2008-09-29 00:00:00.000,Metz France ATP World Tour,HARD,2,Nicolas Mahut,Gilles Simon,Nicolas Mahut,6-4; 3-6; 6-1,R32,96,8,0,45,73,31,45,21,28,4,5,13,52,73,3,3,34,69,26,34,19,35,0,3,13,45,69
2008-09-29 00:00:00.000,Metz France ATP World Tour,HARD,2,Carlos Moya,Ivo Karlovic,Carlos Moya,6-3; 7-6(4),R16,72,5,1,36,56,33,36,17,20,0,0,11,50,56,18,1,42,59,35,42,9,17,2,3,10,44,59
2008-09-29 00:00:00.000,Metz France ATP World Tour,HARD,2,Dmitry Tursunov,Jose Acasuso,Dmitry Tursunov,6-2; 6-2,R16,48,10,1,28,40,25,28,8,12,1,1,8,33,40,5,0,26,43,15,26,6,17,0,4,8,21,43
2008-09-29 00:00:00.000,Metz France ATP World Tour,HARD,2,Eduardo Schwank,Victor Hanescu,Eduardo Schwank,7-6(6); 6-7(5); 6-3,R16,158,8,5,69,117,56,69,28,48,11,11,17,84,117,7,2,68,107,55,68,19,39,3,4,16,74,107
2008-09-29 00:00:00.000,Metz France ATP World Tour,HARD,2,Radek Stepanek,Michael Llodra,Radek Stepanek,6-7(5); 6-1; 7-6(0),R16,130,12,4,72,103,57,72,14,31,1,2,16,71,103,19,6,62,110,48,62,20,48,7,10,15,68,110
2008-09-29 00:00:00.000,Metz France ATP World Tour,HARD,2,Janko Tipsarevic,Ernests Gulbis,Janko Tipsarevic,6-4; 6-4,R16,76,9,4,40,59,31,40,9,19,2,3,10,40,59,9,3,35,58,28,35,7,23,4,7,10,35,58
2008-09-29 00:00:00.000,Metz France ATP World Tour,HARD,2,Paul-Henri Mathieu,Romain Jouan,Paul-Henri Mathieu,6-3; 6-3,R16,69,3,1,24,45,20,24,16,21,0,0,9,36,45,13,1,36,67,25,36,13,31,6,9,9,38,67
2008-09-29 00:00:00.000,Metz France ATP World Tour,HARD,2,Adrian Mannarino,Rik De Voest,Adrian Mannarino,6-4; 7-5,R16,83,7,0,45,67,34,45,11,22,0,1,11,45,67,8,1,32,60,24,32,16,28,1,4,11,40,60
2008-09-29 00:00:00.000,Metz France ATP World Tour,HARD,2,Marc Gicquel,Nicolas Mahut,Marc Gicquel,6-3; 7-6(4),R16,91,10,0,48,79,39,48,16,31,3,3,11,55,79,7,2,39,55,32,39,9,16,1,2,10,41,55
2008-09-29 00:00:00.000,Metz France ATP World Tour,HARD,2,Dmitry Tursunov,Carlos Moya,Dmitry Tursunov,6-3; 6-3,Q,72,9,1,35,58,28,35,14,23,4,4,9,42,58,4,4,33,57,20,33,13,24,7,10,9,33,57
2008-09-29 00:00:00.000,Metz France ATP World Tour,HARD,2,Radek Stepanek,Eduardo Schwank,Radek Stepanek,3-6; 7-6(4); 6-4,Q,146,5,2,69,94,55,69,11,25,1,2,15,66,94,6,3,64,105,47,64,26,41,9,10,16,73,105
2008-09-29 00:00:00.000,Metz France ATP World Tour,HARD,2,Paul-Henri Mathieu,Janko Tipsarevic,Paul-Henri Mathieu,7-6(4); 6-3,Q,97,12,0,51,74,42,51,14,23,5,5,11,56,74,13,2,42,66,33,42,13,24,4,5,10,46,66
2008-09-29 00:00:00.000,Metz France ATP World Tour,HARD,2,Adrian Mannarino,Marc Gicquel,Adrian Mannarino,6-4; 7-6(3),Q,92,2,0,40,63,31,40,16,23,2,3,11,47,63,9,1,47,77,34,47,13,30,5,7,11,47,77
2008-09-29 00:00:00.000,Metz France ATP World Tour,HARD,2,Dmitry Tursunov,Radek Stepanek,Dmitry Tursunov,6-3; 6-4,S,80,7,1,39,66,32,39,15,27,5,5,10,47,66,3,1,40,55,30,40,5,15,4,6,9,35,55
2008-09-29 00:00:00.000,Metz France ATP World Tour,HARD,2,Paul-Henri Mathieu,Adrian Mannarino,Paul-Henri Mathieu,7-6(8); 7-6(1),S,144,4,2,52,91,38,52,23,39,5,7,12,61,91,5,3,56,104,36,56,26,48,4,6,12,62,104
2008-09-29 00:00:00.000,Metz France ATP World Tour,HARD,2,Dmitry Tursunov,Paul-Henri Mathieu,Dmitry Tursunov,7-6(6); 1-6; 6-4,F,144,11,5,58,102,41,58,22,44,5,9,15,63,102,6,0,53,93,39,53,23,40,6,8,14,62,93
2008-09-29 00:00:00.000,Tokyo Japan ATP World Tour,HARD,2,David Ferrer,N/A Bye,David Ferrer,,R64,0,0,0,0,0,0,0,0,0,0,0,0,0,0,0,0,0,0,0,0,0,0,0,0,0,0,0
2008-09-29 00:00:00.000,Tokyo Japan ATP World Tour,HARD,2,Jesse Levine,Danai Udomchoke,Jesse Levine,4-6; 6-1; 6-0,R64,79,4,4,44,65,33,44,12,21,3,5,12,45,65,6,5,49,73,27,49,9,24,5,11,11,36,73
2008-09-29 00:00:00.000,Tokyo Japan ATP World Tour,HARD,2,Takao Suzuki,Yuichi Sugita,Takao Suzuki,6-3; 7-6(6),R64,103,10,1,49,74,35,49,14,25,3,4,10,49,74,2,2,55,83,36,55,9,28,6,9,11,45,83
2008-09-29 00:00:00.000,Tokyo Japan ATP World Tour,HARD,2,Simone Bolelli,N/A Bye,Simone Bolelli,,R64,0,0,0,0,0,0,0,0,0,0,0,0,0,0,0,0,0,0,0,0,0,0,0,0,0,0,0
2008-09-29 00:00:00.000,Tokyo Japan ATP World Tour,HARD,2,Jarkko Nieminen,N/A Bye,Jarkko Nieminen,,R64,0,0,0,0,0,0,0,0,0,0,0,0,0,0,0,0,0,0,0,0,0,0,0,0,0,0,0
2008-09-29 00:00:00.000,Tokyo Japan ATP World Tour,HARD,2,Cecil Mamiit,Brendan Evans,Cecil Mamiit,3-6; 7-5; 6-4,R64,101,9,2,55,85,42,55,19,30,2,3,15,61,85,9,2,67,97,49,67,16,30,4,6,16,65,97
2008-09-29 00:00:00.000,Tokyo Japan ATP World Tour,HARD,2,Dudi Sela,Bjorn Phau,Dudi Sela,7-5; 6-1,R64,75,8,1,39,57,29,39,13,18,6,7,10,42,57,2,4,34,65,21,34,12,31,7,11,9,33,65
2008-09-29 00:00:00.000,Tokyo Japan ATP World Tour,HARD,2,Juan Martin Del Potro,N/A Bye,Juan Martin Del Potro,,R64,0,0,0,0,0,0,0,0,0,0,0,0,0,0,0,0,0,0,0,0,0,0,0,0,0,0,0
2008-09-29 00:00:00.000,Tokyo Japan ATP World Tour,HARD,2,Richard Gasquet,N/A Bye,Richard Gasquet,,R64,0,0,0,0,0,0,0,0,0,0,0,0,0,0,0,0,0,0,0,0,0,0,0,0,0,0,0
2008-09-29 00:00:00.000,Tokyo Japan ATP World Tour,HARD,2,Martin Slanar,Donald Young,Martin Slanar,4-6; 6-3; 6-2,R64,113,7,5,52,90,39,52,18,38,3,5,14,57,90,2,4,60,104,39,60,18,44,9,13,13,57,104
2008-09-29 00:00:00.000,Tokyo Japan ATP World Tour,HARD,2,Kei Nishikori,Robert Kendrick,Kei Nishikori,7-6(3); 6-7(5); 6-2,R64,124,11,4,66,100,54,66,20,34,2,2,16,74,100,18,2,60,99,45,60,22,39,1,3,16,67,99
2008-09-29 00:00:00.000,Tokyo Japan ATP World Tour,HARD,2,Guillermo Garcia-Lopez,N/A Bye,Guillermo Garcia-Lopez,,R64,0,0,0,0,0,0,0,0,0,0,0,0,0,0,0,0,0,0,0,0,0,0,0,0,0,0,0
2008-09-29 00:00:00.000,Tokyo Japan ATP World Tour,HARD,2,Rainer Schuettler,N/A Bye,Rainer Schuettler,,R64,0,0,0,0,0,0,0,0,0,0,0,0,0,0,0,0,0,0,0,0,0,0,0,0,0,0,0
2008-09-29 00:00:00.000,Tokyo Japan ATP World Tour,HARD,2,Hyung-Taik Lee,Satoshi Iwabuchi,Hyung-Taik Lee,6-1; 6-4,R64,65,4,0,29,44,21,29,8,15,1,3,8,29,44,5,5,44,63,22,44,5,19,6,12,9,27,63
2008-09-29 00:00:00.000,Tokyo Japan ATP World Tour,HARD,2,Flavio Cipolla,Ivan Navarro,Flavio Cipolla,7-6(5); 7-6(4),R64,120,0,3,62,86,44,62,14,24,6,8,12,58,86,4,3,54,86,39,54,17,32,3,5,12,56,86
2008-09-29 00:00:00.000,Tokyo Japan ATP World Tour,HARD,2,Mikhail Youzhny,N/A Bye,Mikhail Youzhny,,R64,0,0,0,0,0,0,0,0,0,0,0,0,0,0,0,0,0,0,0,0,0,0,0,0,0,0,0
2008-09-29 00:00:00.000,Tokyo Japan ATP World Tour,HARD,2,Tommy Robredo,N/A Bye,Tommy Robredo,,R64,0,0,0,0,0,0,0,0,0,0,0,0,0,0,0,0,0,0,0,0,0,0,0,0,0,0,0
2008-09-29 00:00:00.000,Tokyo Japan ATP World Tour,HARD,2,Joseph Sirianni,Yuichi Ito,Joseph Sirianni,6-3; 6-2,R64,70,4,2,35,56,24,35,14,21,2,3,9,38,56,1,0,35,53,20,35,7,18,2,6,8,27,53
2008-09-29 00:00:00.000,Tokyo Japan ATP World Tour,HARD,2,Roko Karanusic,Hiroki Kondo,Roko Karanusic,6-2; 6-2,R64,56,3,1,20,40,19,20,13,20,0,0,8,32,40,2,1,22,46,13,22,11,24,1,5,8,24,46
2008-09-29 00:00:00.000,Tokyo Japan ATP World Tour,HARD,2,Tomas Berdych,N/A Bye,Tomas Berdych,,R64,0,0,0,0,0,0,0,0,0,0,0,0,0,0,0,0,0,0,0,0,0,0,0,0,0,0,0
2008-09-29 00:00:00.000,Tokyo Japan ATP World Tour,HARD,2,Sam Querrey,N/A Bye,Sam Querrey,,R64,0,0,0,0,0,0,0,0,0,0,0,0,0,0,0,0,0,0,0,0,0,0,0,0,0,0,0
2008-09-29 00:00:00.000,Tokyo Japan ATP World Tour,HARD,2,Amer Delic,Go Soeda,Amer Delic,6-4; 6-2,R64,70,14,1,38,54,28,38,11,16,5,5,9,39,54,3,2,43,62,30,43,7,19,3,6,9,37,62
2008-09-29 00:00:00.000,Tokyo Japan ATP World Tour,HARD,2,Yen-Hsun Lu,Luka Gregorc,Yen-Hsun Lu,6-4; 7-6(5),R64,102,3,5,45,74,34,45,15,29,4,5,11,49,74,8,3,62,89,41,62,11,27,8,10,11,52,89
2008-09-29 00:00:00.000,Tokyo Japan ATP World Tour,HARD,2,Fernando Gonzalez,N/A Bye,Fernando Gonzalez,,R64,0,0,0,0,0,0,0,0,0,0,0,0,0,0,0,0,0,0,0,0,0,0,0,0,0,0,0
2008-09-29 00:00:00.000,Tokyo Japan ATP World Tour,HARD,2,Jo-Wilfried Tsonga,N/A Bye,Jo-Wilfried Tsonga,,R64,0,0,0,0,0,0,0,0,0,0,0,0,0,0,0,0,0,0,0,0,0,0,0,0,0,0,0
2008-09-29 00:00:00.000,Tokyo Japan ATP World Tour,HARD,2,Bobby Reynolds,Tatsuma Ito,Bobby Reynolds,6-3; 6-1,R64,71,9,1,38,59,27,38,10,21,4,5,8,37,59,2,4,32,52,14,32,9,20,2,7,8,23,52
2008-09-29 00:00:00.000,Tokyo Japan ATP World Tour,HARD,2,Wayne Odesnik,Kevin Kim,Wayne Odesnik,6-4; 6-3,R64,71,7,1,36,54,31,36,10,18,0,0,10,41,54,6,0,30,60,21,30,16,30,5,7,9,37,60
2008-09-29 00:00:00.000,Tokyo Japan ATP World Tour,HARD,2,Viktor Troicki,N/A Bye,Viktor Troicki,,R64,0,0,0,0,0,0,0,0,0,0,0,0,0,0,0,0,0,0,0,0,0,0,0,0,0,0,0
2008-09-29 00:00:00.000,Tokyo Japan ATP World Tour,HARD,2,Jurgen Melzer,N/A Bye,Jurgen Melzer,,R64,0,0,0,0,0,0,0,0,0,0,0,0,0,0,0,0,0,0,0,0,0,0,0,0,0,0,0
2008-09-29 00:00:00.000,Tokyo Japan ATP World Tour,HARD,2,Simon Stadler,Philipp Petzschner,Simon Stadler,6-2; 6-4,R64,69,1,2,48,70,30,48,11,22,7,9,9,41,70,1,9,27,62,21,27,10,35,4,9,9,31,62
2008-09-29 00:00:00.000,Tokyo Japan ATP World Tour,HARD,2,Ivo Minar,Mischa Zverev,Ivo Minar,7-6(9); 2-6; 6-2,R64,95,12,0,72,96,53,72,11,24,6,8,14,64,96,4,1,64,90,49,64,12,26,3,5,14,61,90
2008-09-29 00:00:00.000,Tokyo Japan ATP World Tour,HARD,2,Andy Roddick,N/A Bye,Andy Roddick,,R64,0,0,0,0,0,0,0,0,0,0,0,0,0,0,0,0,0,0,0,0,0,0,0,0,0,0,0
2008-09-29 00:00:00.000,Tokyo Japan ATP World Tour,HARD,2,David Ferrer,Jesse Levine,David Ferrer,6-4; 4-6; 6-1,R32,108,5,2,47,69,38,47,13,22,1,3,14,51,69,4,2,58,90,32,58,18,32,9,13,13,50,90
2008-09-29 00:00:00.000,Tokyo Japan ATP World Tour,HARD,2,Takao Suzuki,Simone Bolelli,Takao Suzuki,7-6(5); 4-6; 7-6(5),R32,147,17,1,63,102,54,63,23,39,2,3,17,77,102,17,3,78,105,61,78,16,27,2,2,17,77,105
2008-09-29 00:00:00.000,Tokyo Japan ATP World Tour,HARD,2,Jarkko Nieminen,Cecil Mamiit,Jarkko Nieminen,7-6(7); 6-4,R32,88,6,2,54,70,35,54,8,16,1,4,11,43,70,2,2,44,77,30,44,13,33,5,9,11,43,77
2008-09-29 00:00:00.000,Tokyo Japan ATP World Tour,HARD,2,Juan Martin Del Potro,Dudi Sela,Juan Martin Del Potro,7-5; 6-0,R32,69,6,0,36,51,26,36,10,15,2,3,9,36,51,1,6,34,55,19,34,7,21,4,9,9,26,55
2008-09-29 00:00:00.000,Tokyo Japan ATP World Tour,HARD,2,Richard Gasquet,Martin Slanar,Richard Gasquet,6-4; 6-2,R32,83,6,3,31,63,22,31,18,32,8,10,9,40,63,5,7,35,67,19,35,12,32,2,7,9,31,67
2008-09-29 00:00:00.000,Tokyo Japan ATP World Tour,HARD,2,Kei Nishikori,Guillermo Garcia-Lopez,Kei Nishikori,6-4; 6-4,R32,112,3,3,34,58,26,34,14,24,2,3,10,40,58,3,8,64,106,39,64,19,42,13,16,10,58,106
2008-09-29 00:00:00.000,Tokyo Japan ATP World Tour,HARD,2,Rainer Schuettler,Hyung-Taik Lee,Rainer Schuettler,6-3; 6-7(3); 6-3,R32,135,10,3,68,116,47,68,21,48,8,12,16,68,116,2,1,65,94,37,65,15,29,4,10,14,52,94
2008-09-29 00:00:00.000,Tokyo Japan ATP World Tour,HARD,2,Mikhail Youzhny,Flavio Cipolla,Mikhail Youzhny,6-2; 6-2,R32,70,4,0,34,52,28,34,9,18,5,5,8,37,52,2,4,32,52,19,32,8,20,1,5,8,27,52
2008-09-29 00:00:00.000,Tokyo Japan ATP World Tour,HARD,2,Tommy Robredo,Joseph Sirianni,Tommy Robredo,6-2; 6-2,R32,65,6,1,25,42,21,25,12,17,0,0,8,33,42,0,2,41,64,23,41,10,23,6,10,8,33,64
2008-09-29 00:00:00.000,Tokyo Japan ATP World Tour,HARD,2,Tomas Berdych,Roko Karanusic,Tomas Berdych,6-3; 6-4,R32,74,7,0,37,54,29,37,13,17,1,1,10,42,54,5,1,38,71,27,38,15,33,6,8,9,42,71
2008-09-29 00:00:00.000,Tokyo Japan ATP World Tour,HARD,2,Amer Delic,Sam Querrey,Amer Delic,7-6(5); 6-3,R32,68,10,3,49,70,39,49,12,21,3,3,11,51,70,5,5,40,63,33,40,9,23,4,5,10,42,63
2008-09-29 00:00:00.000,Tokyo Japan ATP World Tour,HARD,2,Fernando Gonzalez,Yen-Hsun Lu,Fernando Gonzalez,1-6; 7-5; 6-3,R32,114,7,4,60,96,43,60,18,36,3,5,14,61,96,2,3,46,79,39,46,16,33,3,5,14,55,79
2008-09-29 00:00:00.000,Tokyo Japan ATP World Tour,HARD,2,Jo-Wilfried Tsonga,Bobby Reynolds,Jo-Wilfried Tsonga,4-6; 7-6(4); 6-4,R32,120,17,4,58,94,46,58,19,36,3,5,16,65,94,12,0,56,98,44,56,24,42,5,7,16,68,98
2008-09-29 00:00:00.000,Tokyo Japan ATP World Tour,HARD,2,Viktor Troicki,Wayne Odesnik,Viktor Troicki,6-2; 6-1,R32,64,9,0,33,54,27,33,11,21,4,4,8,38,54,2,2,29,49,19,29,6,20,3,7,7,25,49
2008-09-29 00:00:00.000,Tokyo Japan ATP World Tour,HARD,2,Jurgen Melzer,Simon Stadler,Jurgen Melzer,6-2; 6-3,R32,61,5,0,31,44,24,31,9,13,1,1,8,33,44,1,1,45,62,22,45,9,17,6,10,9,31,62
2008-09-29 00:00:00.000,Tokyo Japan ATP World Tour,HARD,2,Andy Roddick,Ivo Minar,Andy Roddick,7-6(11); 6-7(4); 7-6(2),R32,164,37,4,89,122,73,89,16,33,0,2,18,89,122,6,0,94,127,72,94,17,33,6,8,18,89,127
2008-09-29 00:00:00.000,Tokyo Japan ATP World Tour,HARD,2,David Ferrer,Takao Suzuki,David Ferrer,4-6; 6-3; 6-2,R16,116,3,0,46,68,34,46,16,22,0,2,14,50,68,9,5,49,94,37,49,17,45,7,11,13,54,94
2008-09-29 00:00:00.000,Tokyo Japan ATP World Tour,HARD,2,Juan Martin Del Potro,Jarkko Nieminen,Juan Martin Del Potro,6-1; 6-3,R16,68,8,5,37,59,31,37,7,22,3,4,8,38,59,0,1,26,48,11,26,11,22,3,8,8,22,48
2008-09-29 00:00:00.000,Tokyo Japan ATP World Tour,HARD,2,Richard Gasquet,Kei Nishikori,Richard Gasquet,6-1; 6-2,R16,55,7,0,24,42,21,24,12,18,0,0,8,33,42,0,1,23,44,14,23,8,21,4,8,7,22,44
2008-09-29 00:00:00.000,Tokyo Japan ATP World Tour,HARD,2,Rainer Schuettler,Mikhail Youzhny,Rainer Schuettler,6-3; 6-7(12); 6-4,R16,282,4,3,74,122,49,74,27,48,6,9,16,76,122,5,1,83,119,53,83,16,36,10,15,15,69,119
2008-09-29 00:00:00.000,Tokyo Japan ATP World Tour,HARD,2,Tomas Berdych,Tommy Robredo,Tomas Berdych,7-6(6); 6-2,R16,85,10,1,39,66,31,39,16,27,7,8,10,47,66,5,2,37,64,28,37,11,27,2,5,10,39,64
2008-09-29 00:00:00.000,Tokyo Japan ATP World Tour,HARD,2,Fernando Gonzalez,Amer Delic,Fernando Gonzalez,6-4; 7-6(4),R16,76,6,1,40,62,35,40,17,22,1,1,11,52,62,10,0,53,77,40,53,11,24,7,8,11,51,77
2008-09-29 00:00:00.000,Tokyo Japan ATP World Tour,HARD,2,Viktor Troicki,Jo-Wilfried Tsonga,Viktor Troicki,5-7; 2-1 RET,R16,67,3,0,34,49,22,34,4,15,4,7,7,26,49,3,0,37,51,24,37,5,14,4,7,8,29,51
2008-09-29 00:00:00.000,Tokyo Japan ATP World Tour,HARD,2,Andy Roddick,Jurgen Melzer,Andy Roddick,7-6(2); 6-2,R16,66,20,0,47,63,38,47,10,16,3,3,10,48,63,12,2,37,66,24,37,18,29,2,4,10,42,66
2008-09-29 00:00:00.000,Tokyo Japan ATP World Tour,HARD,2,Juan Martin Del Potro,David Ferrer,Juan Martin Del Potro,6-1; 7-5,Q,100,6,3,42,61,32,42,9,19,7,8,9,41,61,4,0,45,82,23,45,18,37,5,10,10,41,82
2008-09-29 00:00:00.000,Tokyo Japan ATP World Tour,HARD,2,Richard Gasquet,Rainer Schuettler,Richard Gasquet,6-3; 6-2,Q,60,8,3,29,47,22,29,14,18,0,0,9,36,47,2,3,27,45,17,27,8,18,0,3,8,25,45
2008-09-29 00:00:00.000,Tokyo Japan ATP World Tour,HARD,2,Tomas Berdych,Fernando Gonzalez,Tomas Berdych,6-0; 6-4,Q,61,5,0,31,49,22,31,12,18,2,2,8,34,49,1,1,28,45,15,28,6,17,3,7,8,21,45
2008-09-29 00:00:00.000,Tokyo Japan ATP World Tour,HARD,2,Andy Roddick,Viktor Troicki,Andy Roddick,6-3; 6-4,Q,81,7,1,42,61,31,42,9,19,1,2,10,40,61,4,4,35,63,23,35,11,28,7,10,9,34,63
2008-09-29 00:00:00.000,Tokyo Japan ATP World Tour,HARD,2,Juan Martin Del Potro,Richard Gasquet,Juan Martin Del Potro,6-3; 4-6; 7-5,S,124,14,3,62,91,50,62,12,29,7,9,15,62,91,15,3,49,85,37,49,19,36,3,7,16,56,85
2008-09-29 00:00:00.000,Tokyo Japan ATP World Tour,HARD,2,Tomas Berdych,Andy Roddick,Tomas Berdych,6-7(3); 7-5; 7-6(3),S,133,17,1,63,109,51,63,27,46,4,6,18,78,109,25,4,76,104,61,76,15,28,1,4,18,76,104
2008-09-29 00:00:00.000,Tokyo Japan ATP World Tour,HARD,2,Tomas Berdych,Juan Martin Del Potro,Tomas Berdych,6-1; 6-4,F,78,11,0,31,54,27,31,14,23,3,3,9,41,54,0,2,36,52,22,36,7,16,5,8,8,29,52
2008-10-06 00:00:00.000,Moscow Russia ATP World Tour,HARD,2,Nikolay Davydenko,Florent Serra,Nikolay Davydenko,6-1; 7-5,R32,79,6,1,31,62,20,31,25,31,4,4,10,45,62,1,0,46,60,29,46,5,14,4,7,9,34,60
2008-10-06 00:00:00.000,Moscow Russia ATP World Tour,HARD,2,Guillermo Garcia-Lopez,Nicolas Devilder,Guillermo Garcia-Lopez,6-2; 6-4,R32,84,1,4,36,59,30,36,8,23,5,6,9,38,59,4,4,40,67,23,40,11,27,7,11,9,34,67
2008-10-06 00:00:00.000,Moscow Russia ATP World Tour,HARD,2,Julien Benneteau,Harel Levy,Julien Benneteau,6-4; 6-3,R32,78,9,3,39,53,34,39,5,14,0,0,9,39,53,1,1,45,72,27,45,13,27,7,10,10,40,72
2008-10-06 00:00:00.000,Moscow Russia ATP World Tour,HARD,2,Marat Safin,Noam Okun,Marat Safin,7-6(5); 3-6; 6-4,R32,126,12,1,49,93,39,49,23,44,4,6,15,62,93,7,2,68,106,48,68,24,38,8,10,16,72,106
2008-10-06 00:00:00.000,Moscow Russia ATP World Tour,HARD,2,Teymuraz Gabashvili,Mikhail Youzhny,Teymuraz Gabashvili,7-5; 4-6; 7-6(1),R32,163,9,6,58,102,46,58,23,44,6,8,17,69,102,7,7,70,114,53,70,21,44,5,7,17,74,114
2008-10-06 00:00:00.000,Moscow Russia ATP World Tour,HARD,2,Mischa Zverev,Denis Gremelmayr,Mischa Zverev,6-3; 7-6(7),R32,88,7,5,39,73,30,39,19,34,2,4,11,49,73,2,2,52,89,32,52,19,37,12,15,10,51,89
2008-10-06 00:00:00.000,Moscow Russia ATP World Tour,HARD,2,Viktor Troicki,Evgeny Donskoy,Viktor Troicki,6-1; 6-3,R32,51,9,2,25,40,23,25,9,15,0,0,8,32,40,1,1,26,48,16,26,10,22,2,6,8,26,48
2008-10-06 00:00:00.000,Moscow Russia ATP World Tour,HARD,2,Janko Tipsarevic,Alexander Kudryavtsev,Janko Tipsarevic,4-6; 6-3; 7-6(6),R32,126,12,3,58,102,46,58,25,44,1,2,16,71,102,19,3,47,92,42,47,23,45,2,3,15,65,92
2008-10-06 00:00:00.000,Moscow Russia ATP World Tour,HARD,2,Denis Istomin,Michael Llodra,Denis Istomin,7-6(2); 6-3,R32,86,3,4,55,81,42,55,12,26,5,6,11,54,81,1,3,49,65,34,49,7,16,1,3,10,41,65
2008-10-06 00:00:00.000,Moscow Russia ATP World Tour,HARD,2,Fabrice Santoro,Yuri Schukin,Fabrice Santoro,4-6; 7-6(2); 6-4,R32,155,13,2,60,100,49,60,24,40,1,2,16,73,100,7,5,66,113,50,66,25,47,7,8,16,75,113
2008-10-06 00:00:00.000,Moscow Russia ATP World Tour,HARD,2,Dudi Sela,Victor Hanescu,Dudi Sela,6-3; 3-6; 6-2,R32,95,2,2,42,77,26,42,24,35,0,2,13,50,77,8,4,58,76,38,58,7,18,2,6,13,45,76
2008-10-06 00:00:00.000,Moscow Russia ATP World Tour,HARD,2,Paul-Henri Mathieu,Sergiy Stakhovsky,Paul-Henri Mathieu,6-3; 6-2,R32,87,0,2,30,55,23,30,17,25,3,3,9,40,55,4,0,41,61,26,41,8,20,9,12,8,34,61
2008-10-06 00:00:00.000,Moscow Russia ATP World Tour,HARD,2,Igor Kunitsyn,Mikhail Kukushkin,Igor Kunitsyn,6-1; 4-6; 6-1,R32,104,3,0,36,63,26,36,17,27,2,4,12,43,63,2,5,48,79,25,48,13,31,6,12,12,38,79
2008-10-06 00:00:00.000,Moscow Russia ATP World Tour,HARD,2,Robby Ginepri,Jiri Vanek,Robby Ginepri,6-3; 6-4,R32,62,5,1,34,48,30,34,10,14,0,0,10,40,48,11,3,42,65,33,42,8,23,3,5,9,41,65
2008-10-06 00:00:00.000,Moscow Russia ATP World Tour,HARD,2,Jeremy Chardy,Potito Starace,Jeremy Chardy,3-6; 6-1; 6-4,R32,104,4,2,50,77,35,50,19,27,0,1,13,54,77,3,3,50,89,31,50,23,39,3,6,13,54,89
2008-10-06 00:00:00.000,Moscow Russia ATP World Tour,HARD,2,Igor Andreev,Yen-Hsun Lu,Igor Andreev,6-2 RET,R32,39,1,1,16,27,12,16,6,11,0,0,4,18,27,0,2,15,26,9,15,5,11,0,2,4,14,26
2008-10-06 00:00:00.000,Moscow Russia ATP World Tour,HARD,2,Nikolay Davydenko,Guillermo Garcia-Lopez,Nikolay Davydenko,6-1; 6-1,R16,55,4,1,30,41,27,30,3,11,1,1,7,30,41,0,1,26,47,15,26,5,21,5,10,7,20,47
2008-10-06 00:00:00.000,Moscow Russia ATP World Tour,HARD,2,Marat Safin,Julien Benneteau,Marat Safin,6-4; 0-6; 6-2,R16,88,11,6,38,64,31,38,10,26,2,5,12,41,64,6,3,52,82,33,52,16,30,6,9,12,49,82
2008-10-06 00:00:00.000,Moscow Russia ATP World Tour,HARD,2,Mischa Zverev,Teymuraz Gabashvili,Mischa Zverev,6-2; 2-6; 6-1,R16,104,6,2,44,70,28,44,16,26,3,5,11,44,70,4,4,49,90,36,49,13,41,9,14,12,49,90
2008-10-06 00:00:00.000,Moscow Russia ATP World Tour,HARD,2,Viktor Troicki,Janko Tipsarevic,Viktor Troicki,6-3; 6-4,R16,82,4,3,26,53,22,26,13,27,3,5,10,35,53,1,1,42,68,26,42,10,26,4,8,9,36,68
2008-10-06 00:00:00.000,Moscow Russia ATP World Tour,HARD,2,Fabrice Santoro,Denis Istomin,Fabrice Santoro,6-2; 6-4,R16,86,1,0,25,53,21,25,15,28,3,4,9,36,53,1,0,42,69,23,42,13,27,5,9,9,36,69
2008-10-06 00:00:00.000,Moscow Russia ATP World Tour,HARD,2,Paul-Henri Mathieu,Dudi Sela,Paul-Henri Mathieu,6-7(3); 7-5; 7-6(0),R16,168,6,0,63,103,49,63,24,40,0,2,18,73,103,6,4,74,126,48,74,27,52,3,6,18,75,126
2008-10-06 00:00:00.000,Moscow Russia ATP World Tour,HARD,2,Igor Kunitsyn,Robby Ginepri,Igor Kunitsyn,6-4; 6-3,R16,81,3,0,38,65,24,38,12,27,4,7,9,36,65,3,2,36,58,18,36,8,22,1,7,10,26,58
2008-10-06 00:00:00.000,Moscow Russia ATP World Tour,HARD,2,Jeremy Chardy,Igor Andreev,Jeremy Chardy,3-6; 7-5; 6-4,R16,121,10,3,61,97,42,61,19,36,4,7,16,61,97,6,3,54,79,40,54,12,25,0,3,15,52,79
2008-10-06 00:00:00.000,Moscow Russia ATP World Tour,HARD,2,Marat Safin,Nikolay Davydenko,Marat Safin,7-6(5); 4-6; 6-4,Q,147,17,3,69,106,49,69,19,37,4,7,16,68,106,3,6,61,109,45,61,24,48,6,9,16,69,109
2008-10-06 00:00:00.000,Moscow Russia ATP World Tour,HARD,2,Mischa Zverev,Viktor Troicki,Mischa Zverev,6-4; 3-6; 7-5,Q,148,6,4,57,97,44,57,12,40,7,12,15,56,97,9,6,69,119,47,69,18,50,14,20,16,65,119
2008-10-06 00:00:00.000,Moscow Russia ATP World Tour,HARD,2,Fabrice Santoro,Paul-Henri Mathieu,Fabrice Santoro,6-3; 2-0 RET,Q,43,8,0,15,32,13,15,12,17,3,3,6,25,32,2,0,15,29,10,15,5,14,4,6,5,15,29
2008-10-06 00:00:00.000,Moscow Russia ATP World Tour,HARD,2,Igor Kunitsyn,Jeremy Chardy,Igor Kunitsyn,6-4; 6-2,Q,63,1,0,35,48,22,35,11,13,0,1,9,33,48,3,0,35,49,21,35,6,14,1,5,9,27,49
2008-10-06 00:00:00.000,Moscow Russia ATP World Tour,HARD,2,Marat Safin,Mischa Zverev,Marat Safin,W/O,S,0,0,0,0,0,0,0,0,0,0,0,0,0,0,0,0,0,0,0,0,0,0,0,0,0,0,0
2008-10-06 00:00:00.000,Moscow Russia ATP World Tour,HARD,2,Igor Kunitsyn,Fabrice Santoro,Igor Kunitsyn,6-4; 6-3,S,91,2,0,23,51,16,23,15,28,0,3,9,31,51,1,4,41,75,25,41,11,34,9,15,10,36,75
2008-10-06 00:00:00.000,Moscow Russia ATP World Tour,HARD,2,Igor Kunitsyn,Marat Safin,Igor Kunitsyn,7-6(6); 6-7(4); 6-3,F,170,7,0,51,110,38,51,38,59,5,6,17,76,110,21,6,55,113,39,55,32,58,8,10,16,71,113
2008-10-06 00:00:00.000,Stockholm Sweden ATP World Tour,HARD,2,David Nalbandian,Bobby Reynolds,David Nalbandian,6-1; 6-1,R32,56,4,1,21,38,19,21,11,17,2,2,7,30,38,3,4,24,58,14,24,12,34,2,7,7,26,58
2008-10-06 00:00:00.000,Stockholm Sweden ATP World Tour,HARD,2,Joachim Johansson,Nicolas Mahut,Joachim Johansson,7-5; 7-6(5),R32,89,20,0,48,64,44,48,9,16,0,0,12,53,64,12,6,51,81,41,51,14,30,4,5,12,55,81
2008-10-06 00:00:00.000,Stockholm Sweden ATP World Tour,HARD,2,George Bastl,Frederik Nielsen,George Bastl,7-6(6); 3-6; 7-6(4),R32,176,5,3,78,126,47,78,28,48,9,13,16,75,126,7,5,64,118,43,64,30,54,5,8,17,73,118
2008-10-06 00:00:00.000,Stockholm Sweden ATP World Tour,HARD,2,Albert Montanes,Thomas Johansson,Albert Montanes,6-3; 4-6; 6-3,R32,103,8,5,35,83,28,35,26,48,1,4,14,54,83,12,6,32,78,25,32,19,46,1,6,14,44,78
2008-10-06 00:00:00.000,Stockholm Sweden ATP World Tour,HARD,2,Jarkko Nieminen,Thomaz Bellucci,Jarkko Nieminen,6-7(5); 6-3; 7-5,R32,140,11,3,75,121,49,75,29,46,7,9,17,78,121,10,1,50,105,36,50,29,55,8,12,16,65,105
2008-10-06 00:00:00.000,Stockholm Sweden ATP World Tour,HARD,2,Arnaud Clement,Bjorn Rehnquist,Arnaud Clement,6-2; 6-1,R32,67,5,2,32,50,22,32,11,18,3,4,8,33,50,1,3,22,39,11,22,5,17,0,5,7,16,39
2008-10-06 00:00:00.000,Stockholm Sweden ATP World Tour,HARD,2,Oscar Hernandez,Ivo Minar,Oscar Hernandez,6-4; 6-3,R32,55,10,1,24,42,22,24,14,18,0,0,9,36,42,4,3,46,68,29,46,10,22,3,6,10,39,68
2008-10-06 00:00:00.000,Stockholm Sweden ATP World Tour,HARD,2,Jose Acasuso,Matthias Bachinger,Jose Acasuso,7-6(5); 3-6; 7-6(4),R32,135,9,4,66,114,51,66,19,48,6,10,17,70,114,10,3,69,112,52,69,21,43,8,10,16,73,112
2008-10-06 00:00:00.000,Stockholm Sweden ATP World Tour,HARD,2,Rainer Schuettler,Chris Guccione,Rainer Schuettler,6-0; 6-3,R32,54,5,1,31,42,28,31,4,11,0,0,8,32,42,6,3,25,49,14,25,9,24,6,10,7,23,49
2008-10-06 00:00:00.000,Stockholm Sweden ATP World Tour,HARD,2,Nicolas Lapentti,Ivan Navarro,Nicolas Lapentti,3-6; 7-6(7); 7-5,R32,176,6,6,68,111,48,68,24,43,5,9,17,72,111,10,4,52,106,41,52,24,54,9,12,16,65,106
2008-10-06 00:00:00.000,Stockholm Sweden ATP World Tour,HARD,2,Juan Monaco,Jonas Bjorkman,Juan Monaco,6-2; 6-4,R32,70,0,1,38,54,27,38,7,16,2,4,9,34,54,1,8,27,49,17,27,6,22,3,8,9,23,49
2008-10-06 00:00:00.000,Stockholm Sweden ATP World Tour,HARD,2,Robin Soderling,Benjamin Becker,Robin Soderling,7-5; 6-3,R32,76,10,2,39,61,33,39,14,22,2,2,11,47,61,12,4,28,64,24,28,17,36,4,6,10,41,64
2008-10-06 00:00:00.000,Stockholm Sweden ATP World Tour,HARD,2,Kei Nishikori,Marcel Granollers,Kei Nishikori,2-6; 6-4; 6-2,R32,109,4,3,45,76,32,45,17,31,2,5,13,49,76,6,6,30,79,23,30,24,49,2,6,13,47,79
2008-10-06 00:00:00.000,Stockholm Sweden ATP World Tour,HARD,2,Dominik Hrbaty,Pablo Andujar,Dominik Hrbaty,6-2; 6-1,R32,50,4,2,30,51,22,30,13,21,1,2,8,35,51,0,3,26,42,12,26,6,16,2,7,7,18,42
2008-10-06 00:00:00.000,Stockholm Sweden ATP World Tour,HARD,2,Steve Darcis,Christophe Rochus,Steve Darcis,2-6; 6-3; 6-3,R32,92,15,4,44,81,34,44,21,37,7,9,13,55,81,5,4,63,92,42,63,13,29,8,11,13,55,92
2008-10-06 00:00:00.000,Stockholm Sweden ATP World Tour,HARD,2,Mario Ancic,Olivier Rochus,Mario Ancic,7-6(6); 6-2,R32,87,19,3,37,58,35,37,10,21,0,1,10,45,58,3,1,36,74,26,36,16,38,4,7,10,42,74
2008-10-06 00:00:00.000,Stockholm Sweden ATP World Tour,HARD,2,David Nalbandian,Joachim Johansson,David Nalbandian,6-3; 6-2,R16,56,5,1,21,41,19,21,17,20,0,0,9,36,41,3,5,20,46,15,20,10,26,1,4,8,25,46
2008-10-06 00:00:00.000,Stockholm Sweden ATP World Tour,HARD,2,Albert Montanes,George Bastl,Albert Montanes,1-6; 6-3; 6-2,R16,99,2,2,38,67,28,38,17,29,5,7,12,45,67,3,3,36,67,25,36,17,31,2,5,12,42,67
2008-10-06 00:00:00.000,Stockholm Sweden ATP World Tour,HARD,2,Jarkko Nieminen,Arnaud Clement,Jarkko Nieminen,6-4; 6-7(5); 6-2,R16,167,7,1,69,106,49,69,22,37,8,9,15,71,106,1,3,59,115,42,59,27,56,5,9,15,69,115
2008-10-06 00:00:00.000,Stockholm Sweden ATP World Tour,HARD,2,Oscar Hernandez,Jose Acasuso,Oscar Hernandez,2-6; 6-3; 6-4,R16,131,6,3,62,111,48,62,17,49,12,15,14,65,111,4,4,39,76,29,39,20,37,4,7,13,49,76
2008-10-06 00:00:00.000,Stockholm Sweden ATP World Tour,HARD,2,Rainer Schuettler,Nicolas Lapentti,Rainer Schuettler,7-6(6); 6-3,R16,104,3,1,37,59,28,37,14,22,2,4,10,42,59,5,3,40,70,28,40,13,30,0,4,11,41,70
2008-10-06 00:00:00.000,Stockholm Sweden ATP World Tour,HARD,2,Robin Soderling,Juan Monaco,Robin Soderling,6-3; 6-3,R16,68,11,0,30,40,26,30,10,10,0,0,9,36,40,7,1,48,66,28,48,9,18,4,7,9,37,66
2008-10-06 00:00:00.000,Stockholm Sweden ATP World Tour,HARD,2,Kei Nishikori,Dominik Hrbaty,Kei Nishikori,6-1; 1-6; 7-5,R16,111,1,3,39,77,24,39,24,38,3,6,13,48,77,3,1,55,88,36,55,15,33,9,13,13,51,88
2008-10-06 00:00:00.000,Stockholm Sweden ATP World Tour,HARD,2,Mario Ancic,Steve Darcis,Mario Ancic,7-6(4); 6-4,R16,86,13,2,36,63,32,36,18,27,0,0,11,50,63,4,2,50,75,35,50,16,25,3,4,11,51,75
2008-10-06 00:00:00.000,Stockholm Sweden ATP World Tour,HARD,2,David Nalbandian,Albert Montanes,David Nalbandian,6-4; 6-1,Q,63,6,0,33,49,27,33,7,16,1,1,8,34,49,1,3,34,62,23,34,11,28,3,7,9,34,62
2008-10-06 00:00:00.000,Stockholm Sweden ATP World Tour,HARD,2,Jarkko Nieminen,Oscar Hernandez,Jarkko Nieminen,6-1; 6-4,Q,83,1,3,35,57,25,35,9,22,2,4,9,34,57,1,1,27,49,12,27,10,22,2,7,8,22,49
2008-10-06 00:00:00.000,Stockholm Sweden ATP World Tour,HARD,2,Robin Soderling,Rainer Schuettler,Robin Soderling,6-2; 7-5,Q,74,13,7,33,55,28,33,13,22,1,1,10,41,55,3,1,29,55,21,29,11,26,0,3,10,32,55
2008-10-06 00:00:00.000,Stockholm Sweden ATP World Tour,HARD,2,Kei Nishikori,Mario Ancic,Kei Nishikori,W/O,Q,0,0,0,0,0,0,0,0,0,0,0,0,0,0,0,0,0,0,0,0,0,0,0,0,0,0,0
2008-10-06 00:00:00.000,Stockholm Sweden ATP World Tour,HARD,2,David Nalbandian,Jarkko Nieminen,David Nalbandian,6-2; 6-1,S,65,4,3,30,51,22,30,10,21,6,7,7,32,51,4,3,35,53,12,35,9,18,3,9,8,21,53
2008-10-06 00:00:00.000,Stockholm Sweden ATP World Tour,HARD,2,Robin Soderling,Kei Nishikori,Robin Soderling,6-1; 6-0,S,44,13,2,25,39,22,25,7,14,0,0,7,29,39,3,4,26,39,13,26,2,13,2,7,6,15,39
2008-10-06 00:00:00.000,Stockholm Sweden ATP World Tour,HARD,2,David Nalbandian,Robin Soderling,David Nalbandian,6-2; 5-7; 6-3,F,97,13,3,45,73,33,45,19,28,2,4,14,52,73,18,7,47,85,39,47,12,38,4,9,15,51,85
2008-10-06 00:00:00.000,Vienna Austria ATP World Tour,HARD,2,Philipp Petzschner,Stanislas Wawrinka,Philipp Petzschner,6-7(5); 6-2; 7-6(5),R32,151,3,6,49,95,38,49,21,46,1,6,16,59,95,3,1,72,111,43,72,19,39,7,14,16,62,111
2008-10-06 00:00:00.000,Vienna Austria ATP World Tour,HARD,2,Jan Hernych,Roko Karanusic,Jan Hernych,4-6; 6-4; 7-6(5),R32,145,4,2,88,127,52,88,19,39,16,21,16,71,127,4,0,60,90,36,60,18,30,5,10,16,54,90
2008-10-06 00:00:00.000,Vienna Austria ATP World Tour,HARD,2,Carlos Moya,Michael Berrer,Carlos Moya,7-6(5); 7-6(6),R32,103,14,4,49,83,38,49,20,34,1,1,12,58,83,9,3,51,80,40,51,16,29,1,1,12,56,80
2008-10-06 00:00:00.000,Vienna Austria ATP World Tour,HARD,2,Eduardo Schwank,Gilles Simon,Eduardo Schwank,4-6; 7-5; 7-6(5),R32,152,1,0,80,116,54,80,20,36,10,13,17,74,116,3,2,56,98,47,56,20,42,5,8,17,67,98
2008-10-06 00:00:00.000,Vienna Austria ATP World Tour,HARD,2,Juan Carlos Ferrero,Ivo Karlovic,Juan Carlos Ferrero,6-4; 7-6(4),R32,92,0,3,49,71,42,49,13,22,2,2,11,55,71,17,0,44,67,37,44,10,23,3,4,11,47,67
2008-10-06 00:00:00.000,Vienna Austria ATP World Tour,HARD,2,Jurgen Melzer,Ivan Ljubicic,Jurgen Melzer,7-6(3); 6-3,R32,88,11,2,39,68,32,39,16,29,2,3,11,48,68,9,1,45,68,31,45,10,23,1,3,10,41,68
2008-10-06 00:00:00.000,Vienna Austria ATP World Tour,HARD,2,Feliciano Lopez,Agustin Calleri,Feliciano Lopez,7-6(2); 7-6(4),R32,96,13,1,47,73,41,47,18,26,1,1,12,59,73,12,2,53,84,39,53,23,31,8,8,12,62,84
2008-10-06 00:00:00.000,Vienna Austria ATP World Tour,HARD,2,Santiago Giraldo,Stefan Koubek,Santiago Giraldo,6-1; 6-2,R32,63,0,1,23,44,17,23,13,21,3,4,7,30,44,1,3,33,54,18,33,3,21,4,10,8,21,54
2008-10-06 00:00:00.000,Vienna Austria ATP World Tour,HARD,2,Fernando Verdasco,Victor Crivoi,Fernando Verdasco,6-4; 6-4,R32,93,4,4,42,62,35,42,9,20,3,3,10,44,62,1,3,50,75,36,50,9,25,6,8,10,45,75
2008-10-06 00:00:00.000,Vienna Austria ATP World Tour,HARD,2,Guillermo Canas,Andreas Seppi,Guillermo Canas,7-6(2); 6-3,R32,109,9,0,38,65,29,38,15,27,1,3,11,44,65,2,5,34,71,25,34,16,37,3,6,10,41,71
2008-10-06 00:00:00.000,Vienna Austria ATP World Tour,HARD,2,Philipp Kohlschreiber,Marc Gicquel,Philipp Kohlschreiber,6-2; 6-2,R32,69,8,1,36,51,27,36,9,15,0,0,8,36,51,7,2,32,55,19,32,8,23,3,7,8,27,55
2008-10-06 00:00:00.000,Vienna Austria ATP World Tour,HARD,2,Juan Martin Del Potro,Martin Fischer,Juan Martin Del Potro,7-6(7); 7-6(5),R32,131,7,0,53,80,40,53,11,27,1,4,12,51,80,5,0,60,98,34,60,22,38,6,9,12,56,98
2008-10-06 00:00:00.000,Vienna Austria ATP World Tour,HARD,2,Gael Monfils,Alexander Peya,Gael Monfils,3-6; 6-1; 6-3,R32,119,4,3,55,84,34,55,18,29,6,8,12,52,84,3,5,39,93,26,39,24,54,9,14,13,50,93
2008-10-06 00:00:00.000,Vienna Austria ATP World Tour,HARD,2,Radek Stepanek,Pavel Snobel,Radek Stepanek,6-4; 6-2,R32,80,4,0,43,61,30,43,10,18,2,3,9,40,61,8,6,36,71,25,36,12,35,10,14,9,37,71
2008-10-06 00:00:00.000,Vienna Austria ATP World Tour,HARD,2,Ernests Gulbis,Filippo Volandri,Ernests Gulbis,6-2; 6-3,R32,58,4,3,24,45,21,24,14,21,2,2,8,35,45,0,0,36,47,18,36,7,11,2,6,9,25,47
2008-10-06 00:00:00.000,Vienna Austria ATP World Tour,HARD,2,Fernando Gonzalez,Simone Bolelli,Fernando Gonzalez,4-6; 7-6(2); 6-2,R32,139,8,3,67,110,46,67,25,43,7,9,15,71,110,5,1,61,97,44,61,17,36,5,8,15,61,97
2008-10-06 00:00:00.000,Vienna Austria ATP World Tour,HARD,2,Philipp Petzschner,Jan Hernych,Philipp Petzschner,6-3; 6-4,R16,82,6,1,34,48,30,34,10,14,0,0,10,40,48,2,4,39,69,25,39,15,30,4,6,9,40,69
2008-10-06 00:00:00.000,Vienna Austria ATP World Tour,HARD,2,Carlos Moya,Eduardo Schwank,Carlos Moya,6-2; 6-3,R16,66,9,1,37,62,30,37,14,25,5,5,9,44,62,1,3,22,42,16,22,9,20,1,4,8,25,42
2008-10-06 00:00:00.000,Vienna Austria ATP World Tour,HARD,2,Jurgen Melzer,Juan Carlos Ferrero,Jurgen Melzer,7-6(4); 6-3,R16,97,7,1,46,68,36,46,17,22,2,3,11,53,68,3,3,52,77,39,52,9,25,4,6,10,48,77
2008-10-06 00:00:00.000,Vienna Austria ATP World Tour,HARD,2,Feliciano Lopez,Santiago Giraldo,Feliciano Lopez,7-6(5); 6-3,R16,102,5,5,35,71,30,35,21,36,1,1,11,51,71,3,0,47,78,30,47,18,31,2,3,10,48,78
2008-10-06 00:00:00.000,Vienna Austria ATP World Tour,HARD,2,Fernando Verdasco,Guillermo Canas,Fernando Verdasco,6-1; 6-2,R16,67,3,3,42,54,27,42,8,12,4,5,8,35,54,4,2,21,41,13,21,5,20,3,8,7,18,41
2008-10-06 00:00:00.000,Vienna Austria ATP World Tour,HARD,2,Philipp Kohlschreiber,Juan Martin Del Potro,Philipp Kohlschreiber,W/O,R16,0,0,0,0,0,0,0,0,0,0,0,0,0,0,0,0,0,0,0,0,0,0,0,0,0,0,0
2008-10-06 00:00:00.000,Vienna Austria ATP World Tour,HARD,2,Gael Monfils,Radek Stepanek,Gael Monfils,6-4; 6-3,R16,71,5,1,40,59,33,40,6,19,2,3,9,39,59,3,1,40,57,26,40,6,17,2,6,10,32,57
2008-10-06 00:00:00.000,Vienna Austria ATP World Tour,HARD,2,Fernando Gonzalez,Ernests Gulbis,Fernando Gonzalez,4-6; 7-6(11); 6-1,R16,130,7,2,70,104,53,70,16,34,4,7,15,69,104,4,7,57,95,40,57,18,38,7,11,14,58,95
2008-10-06 00:00:00.000,Vienna Austria ATP World Tour,HARD,2,Philipp Petzschner,Carlos Moya,Philipp Petzschner,6-4; 6-2,Q,61,10,0,35,48,31,35,7,13,2,2,9,38,48,4,3,35,53,23,35,8,18,1,4,9,31,53
2008-10-06 00:00:00.000,Vienna Austria ATP World Tour,HARD,2,Feliciano Lopez,Jurgen Melzer,Feliciano Lopez,4-6; 6-3; 6-4,Q,118,11,5,47,89,38,47,25,42,2,3,15,63,89,3,1,42,78,33,42,22,36,0,2,14,55,78
2008-10-06 00:00:00.000,Vienna Austria ATP World Tour,HARD,2,Philipp Kohlschreiber,Fernando Verdasco,Philipp Kohlschreiber,6-2; 6-3,Q,67,0,0,26,43,19,26,14,17,0,0,8,33,43,1,0,42,53,24,42,6,11,3,7,9,30,53
2008-10-06 00:00:00.000,Vienna Austria ATP World Tour,HARD,2,Gael Monfils,Fernando Gonzalez,Gael Monfils,6-3; 7-6(2),Q,101,6,2,49,79,38,49,16,30,7,8,11,54,79,2,0,38,62,22,38,16,24,2,4,10,38,62
2008-10-06 00:00:00.000,Vienna Austria ATP World Tour,HARD,2,Philipp Petzschner,Feliciano Lopez,Philipp Petzschner,3-6; 6-3; 6-3,S,104,6,2,39,72,31,39,20,33,2,3,13,51,72,8,1,65,95,44,65,16,30,7,10,14,60,95
2008-10-06 00:00:00.000,Vienna Austria ATP World Tour,HARD,2,Gael Monfils,Philipp Kohlschreiber,Gael Monfils,6-4; 5-7; 7-6(2),S,171,11,1,81,115,60,81,14,34,6,9,17,74,115,2,3,90,124,56,90,22,34,10,13,17,78,124
2008-10-06 00:00:00.000,Vienna Austria ATP World Tour,HARD,2,Philipp Petzschner,Gael Monfils,Philipp Petzschner,6-4; 6-4,F,89,3,0,29,51,21,29,16,22,0,1,10,37,51,6,4,44,71,29,44,11,27,6,9,10,40,71
2008-10-12 00:00:00.000,ATP Masters Series Madrid Spain ATP World Tour,HARD,2,Rafael Nadal,N/A Bye,Rafael Nadal,,R64,0,0,0,0,0,0,0,0,0,0,0,0,0,0,0,0,0,0,0,0,0,0,0,0,0,0,0
2008-10-12 00:00:00.000,ATP Masters Series Madrid Spain ATP World Tour,HARD,2,Ernests Gulbis,Nicolas Kiefer,Ernests Gulbis,5-7; 6-4; 7-5,R64,143,10,4,63,99,48,63,21,36,3,4,17,69,99,5,4,51,95,42,51,26,44,3,5,17,68,95
2008-10-12 00:00:00.000,ATP Masters Series Madrid Spain ATP World Tour,HARD,2,Mardy Fish,Steve Darcis,Mardy Fish,6-1; 6-4,R64,71,13,1,25,54,24,25,17,29,4,4,9,41,54,0,1,26,51,14,26,15,25,1,4,8,29,51
2008-10-12 00:00:00.000,ATP Masters Series Madrid Spain ATP World Tour,HARD,2,Richard Gasquet,N/A Bye,Richard Gasquet,,R64,0,0,0,0,0,0,0,0,0,0,0,0,0,0,0,0,0,0,0,0,0,0,0,0,0,0,0
2008-10-12 00:00:00.000,ATP Masters Series Madrid Spain ATP World Tour,HARD,2,Stanislas Wawrinka,N/A Bye,Stanislas Wawrinka,,R64,0,0,0,0,0,0,0,0,0,0,0,0,0,0,0,0,0,0,0,0,0,0,0,0,0,0,0
2008-10-12 00:00:00.000,ATP Masters Series Madrid Spain ATP World Tour,HARD,2,Philipp Kohlschreiber,Carlos Moya,Philipp Kohlschreiber,6-2; 6-2,R64,66,3,1,28,47,22,28,12,19,1,1,8,34,47,3,3,36,58,19,36,8,22,5,9,8,27,58
2008-10-12 00:00:00.000,ATP Masters Series Madrid Spain ATP World Tour,HARD,2,Feliciano Lopez,Albert Montanes,Feliciano Lopez,7-6(4); 6-3,R64,88,10,1,37,61,34,37,16,24,0,0,11,50,61,1,4,48,86,31,48,22,38,4,5,10,53,86
2008-10-12 00:00:00.000,ATP Masters Series Madrid Spain ATP World Tour,HARD,2,David Ferrer,N/A Bye,David Ferrer,,R64,0,0,0,0,0,0,0,0,0,0,0,0,0,0,0,0,0,0,0,0,0,0,0,0,0,0,0
2008-10-12 00:00:00.000,ATP Masters Series Madrid Spain ATP World Tour,HARD,2,Novak Djokovic,N/A Bye,Novak Djokovic,,R64,0,0,0,0,0,0,0,0,0,0,0,0,0,0,0,0,0,0,0,0,0,0,0,0,0,0,0
2008-10-12 00:00:00.000,ATP Masters Series Madrid Spain ATP World Tour,HARD,2,Victor Hanescu,Dmitry Tursunov,Victor Hanescu,4-6; 6-2; 6-3,R64,98,12,2,57,84,48,57,9,27,2,4,14,57,84,5,2,62,87,36,62,14,25,4,8,13,50,87
2008-10-12 00:00:00.000,ATP Masters Series Madrid Spain ATP World Tour,HARD,2,Robin Soderling,Florent Serra,Robin Soderling,6-3; 6-4,R64,70,11,2,27,57,20,27,15,30,3,6,10,35,57,4,2,36,56,21,36,6,20,4,9,9,27,56
2008-10-12 00:00:00.000,ATP Masters Series Madrid Spain ATP World Tour,HARD,2,Ivo Karlovic,N/A Bye,Ivo Karlovic,,R64,0,0,0,0,0,0,0,0,0,0,0,0,0,0,0,0,0,0,0,0,0,0,0,0,0,0,0
2008-10-12 00:00:00.000,ATP Masters Series Madrid Spain ATP World Tour,HARD,2,James Blake,N/A Bye,James Blake,,R64,0,0,0,0,0,0,0,0,0,0,0,0,0,0,0,0,0,0,0,0,0,0,0,0,0,0,0
2008-10-12 00:00:00.000,ATP Masters Series Madrid Spain ATP World Tour,HARD,2,Gilles Simon,Igor Andreev,Gilles Simon,4-6; 6-1; 7-6(7),R64,129,9,3,48,90,39,48,26,42,6,8,15,65,90,6,2,64,99,47,64,13,35,4,7,14,60,99
2008-10-12 00:00:00.000,ATP Masters Series Madrid Spain ATP World Tour,HARD,2,Robby Ginepri,Michael Llodra,Robby Ginepri,6-4; 6-4,R64,77,6,0,47,68,34,47,11,21,1,2,10,45,68,3,3,34,59,23,34,13,25,3,6,10,36,59
2008-10-12 00:00:00.000,ATP Masters Series Madrid Spain ATP World Tour,HARD,2,Nikolay Davydenko,N/A Bye,Nikolay Davydenko,,R64,0,0,0,0,0,0,0,0,0,0,0,0,0,0,0,0,0,0,0,0,0,0,0,0,0,0,0
2008-10-12 00:00:00.000,ATP Masters Series Madrid Spain ATP World Tour,HARD,2,Andy Roddick,N/A Bye,Andy Roddick,,R64,0,0,0,0,0,0,0,0,0,0,0,0,0,0,0,0,0,0,0,0,0,0,0,0,0,0,0
2008-10-12 00:00:00.000,ATP Masters Series Madrid Spain ATP World Tour,HARD,2,Tommy Robredo,Andreas Seppi,Tommy Robredo,7-6(5); 3-6; 6-3,R64,140,7,2,59,97,46,59,21,38,3,5,15,67,97,4,0,59,93,38,59,25,34,0,2,15,63,93
2008-10-12 00:00:00.000,ATP Masters Series Madrid Spain ATP World Tour,HARD,2,Gael Monfils,Fabio Fognini,Gael Monfils,6-2; 6-4,R64,69,5,1,33,57,21,33,16,24,1,2,9,37,57,1,7,30,58,17,30,14,28,7,11,9,31,58
2008-10-12 00:00:00.000,ATP Masters Series Madrid Spain ATP World Tour,HARD,2,Fernando Gonzalez,N/A Bye,Fernando Gonzalez,,R64,0,0,0,0,0,0,0,0,0,0,0,0,0,0,0,0,0,0,0,0,0,0,0,0,0,0,0
2008-10-12 00:00:00.000,ATP Masters Series Madrid Spain ATP World Tour,HARD,2,Fernando Verdasco,N/A Bye,Fernando Verdasco,,R64,0,0,0,0,0,0,0,0,0,0,0,0,0,0,0,0,0,0,0,0,0,0,0,0,0,0,0
2008-10-12 00:00:00.000,ATP Masters Series Madrid Spain ATP World Tour,HARD,2,Marin Cilic,Olivier Rochus,Marin Cilic,6-3; 7-5,R64,99,15,3,38,68,29,38,19,30,3,3,11,48,68,0,9,40,77,27,40,19,37,7,9,10,46,77
2008-10-12 00:00:00.000,ATP Masters Series Madrid Spain ATP World Tour,HARD,2,Simone Bolelli,Nicolas Almagro,Simone Bolelli,7-6(4); 6-1,R64,71,6,0,42,58,33,42,9,16,2,3,10,42,58,3,2,33,50,22,33,10,17,2,5,9,32,50
2008-10-12 00:00:00.000,ATP Masters Series Madrid Spain ATP World Tour,HARD,2,Andy Murray,N/A Bye,Andy Murray,,R64,0,0,0,0,0,0,0,0,0,0,0,0,0,0,0,0,0,0,0,0,0,0,0,0,0,0,0
2008-10-12 00:00:00.000,ATP Masters Series Madrid Spain ATP World Tour,HARD,2,David Nalbandian,N/A Bye,David Nalbandian,,R64,0,0,0,0,0,0,0,0,0,0,0,0,0,0,0,0,0,0,0,0,0,0,0,0,0,0,0
2008-10-12 00:00:00.000,ATP Masters Series Madrid Spain ATP World Tour,HARD,2,Tomas Berdych,Rainer Schuettler,Tomas Berdych,6-1; 6-2,R64,54,7,1,23,33,19,23,6,10,0,1,7,25,33,2,2,32,50,15,32,4,18,2,8,8,19,50
2008-10-12 00:00:00.000,ATP Masters Series Madrid Spain ATP World Tour,HARD,2,Jarkko Nieminen,Mikhail Youzhny,Jarkko Nieminen,7-5; 3-6; 6-2,R64,113,6,1,66,97,48,66,15,31,6,8,14,63,97,7,0,56,85,34,56,20,29,2,6,15,54,85
2008-10-12 00:00:00.000,ATP Masters Series Madrid Spain ATP World Tour,HARD,2,Juan Martin Del Potro,N/A Bye,Juan Martin Del Potro,,R64,0,0,0,0,0,0,0,0,0,0,0,0,0,0,0,0,0,0,0,0,0,0,0,0,0,0,0
2008-10-12 00:00:00.000,ATP Masters Series Madrid Spain ATP World Tour,HARD,2,Jo-Wilfried Tsonga,N/A Bye,Jo-Wilfried Tsonga,,R64,0,0,0,0,0,0,0,0,0,0,0,0,0,0,0,0,0,0,0,0,0,0,0,0,0,0,0
2008-10-12 00:00:00.000,ATP Masters Series Madrid Spain ATP World Tour,HARD,2,Marcel Granollers,Paul-Henri Mathieu,Marcel Granollers,6-4; 6-4,R64,83,7,0,30,54,24,30,16,24,0,0,10,40,54,2,2,28,59,20,28,16,31,3,5,10,36,59
2008-10-12 00:00:00.000,ATP Masters Series Madrid Spain ATP World Tour,HARD,2,Radek Stepanek,Juan Monaco,Radek Stepanek,6-1; 6-1,R64,52,3,2,26,39,23,26,7,13,1,1,7,30,39,1,1,26,40,10,26,7,14,2,7,7,17,40
2008-10-12 00:00:00.000,ATP Masters Series Madrid Spain ATP World Tour,HARD,2,Roger Federer,N/A Bye,Roger Federer,,R64,0,0,0,0,0,0,0,0,0,0,0,0,0,0,0,0,0,0,0,0,0,0,0,0,0,0,0
2008-10-12 00:00:00.000,ATP Masters Series Madrid Spain ATP World Tour,HARD,2,Rafael Nadal,Ernests Gulbis,Rafael Nadal,7-5; 3-6; 6-3,R32,142,2,2,66,98,47,66,18,32,4,5,15,65,98,15,8,56,90,46,56,13,34,3,5,15,59,90
2008-10-12 00:00:00.000,ATP Masters Series Madrid Spain ATP World Tour,HARD,2,Richard Gasquet,Mardy Fish,Richard Gasquet,6-7(3); 6-4; 6-3,R32,151,8,4,49,91,41,49,26,42,4,4,15,67,91,23,6,65,110,50,65,22,45,6,9,16,72,110
2008-10-12 00:00:00.000,ATP Masters Series Madrid Spain ATP World Tour,HARD,2,Stanislas Wawrinka,Philipp Kohlschreiber,Stanislas Wawrinka,3-6; 7-5; 7-6(5),R32,152,15,1,61,96,47,61,24,35,2,4,17,71,96,3,0,74,107,52,74,21,33,3,4,16,73,107
2008-10-12 00:00:00.000,ATP Masters Series Madrid Spain ATP World Tour,HARD,2,Feliciano Lopez,David Ferrer,Feliciano Lopez,6-4; 7-6(4),R32,97,8,6,34,77,28,34,23,43,3,4,11,51,77,4,2,44,63,35,44,8,19,0,2,11,43,63
2008-10-12 00:00:00.000,ATP Masters Series Madrid Spain ATP World Tour,HARD,2,Novak Djokovic,Victor Hanescu,Novak Djokovic,6-7(8); 7-6(6); 3-1 RET,R32,140,10,2,58,90,44,58,22,32,1,2,14,66,90,7,0,73,99,55,73,12,26,2,4,14,67,99
2008-10-12 00:00:00.000,ATP Masters Series Madrid Spain ATP World Tour,HARD,2,Ivo Karlovic,Robin Soderling,Ivo Karlovic,7-6(7); 7-6(8),R32,109,24,3,43,71,41,43,23,28,0,0,12,64,71,11,6,46,88,40,46,26,42,3,3,12,66,88
2008-10-12 00:00:00.000,ATP Masters Series Madrid Spain ATP World Tour,HARD,2,Gilles Simon,James Blake,Gilles Simon,3-6; 6-1; 6-4,R32,86,2,1,44,79,31,44,24,35,9,10,13,55,79,2,1,38,67,28,38,17,29,1,4,13,45,67
2008-10-12 00:00:00.000,ATP Masters Series Madrid Spain ATP World Tour,HARD,2,Robby Ginepri,Nikolay Davydenko,Robby Ginepri,4-6; 6-4; 6-4,R32,125,5,1,61,96,41,61,22,35,9,11,15,63,96,12,5,47,82,39,47,16,35,3,6,15,55,82
2008-10-12 00:00:00.000,ATP Masters Series Madrid Spain ATP World Tour,HARD,2,Andy Roddick,Tommy Robredo,Andy Roddick,6-3; 6-4,R32,69,13,1,40,56,29,40,12,16,1,1,10,41,56,1,1,26,46,19,26,11,20,1,3,9,30,46
2008-10-12 00:00:00.000,ATP Masters Series Madrid Spain ATP World Tour,HARD,2,Gael Monfils,Fernando Gonzalez,Gael Monfils,6-3; 6-4,R32,64,8,1,33,51,30,33,12,18,1,1,10,42,51,0,3,33,52,25,33,7,19,2,4,9,32,52
2008-10-12 00:00:00.000,ATP Masters Series Madrid Spain ATP World Tour,HARD,2,Marin Cilic,Fernando Verdasco,Marin Cilic,6-2; 6-3,R32,77,5,3,31,55,26,31,12,24,3,4,9,38,55,3,2,40,58,23,40,6,18,3,7,8,29,58
2008-10-12 00:00:00.000,ATP Masters Series Madrid Spain ATP World Tour,HARD,2,Andy Murray,Simone Bolelli,Andy Murray,6-0; 2-1 RET,R32,104,7,0,15,24,13,15,7,9,0,0,5,20,24,0,1,32,44,13,32,5,12,7,10,4,18,44
2008-10-12 00:00:00.000,ATP Masters Series Madrid Spain ATP World Tour,HARD,2,David Nalbandian,Tomas Berdych,David Nalbandian,6-2; 6-7(5); 6-1,R32,118,9,2,56,88,43,56,18,32,3,4,13,61,88,6,1,54,87,33,54,15,33,5,11,14,48,87
2008-10-12 00:00:00.000,ATP Masters Series Madrid Spain ATP World Tour,HARD,2,Juan Martin Del Potro,Jarkko Nieminen,Juan Martin Del Potro,6-2; 4-2 RET,R32,52,2,1,21,33,21,21,7,12,0,0,7,28,33,1,2,29,47,18,29,7,18,4,7,7,25,47
2008-10-12 00:00:00.000,ATP Masters Series Madrid Spain ATP World Tour,HARD,2,Jo-Wilfried Tsonga,Marcel Granollers,Jo-Wilfried Tsonga,3-6; 6-3; 7-6(5),R32,131,7,3,56,87,47,56,15,31,2,4,15,62,87,10,4,55,95,44,55,20,40,3,5,15,64,95
2008-10-12 00:00:00.000,ATP Masters Series Madrid Spain ATP World Tour,HARD,2,Roger Federer,Radek Stepanek,Roger Federer,6-3; 7-6(6),R32,87,10,1,40,65,37,40,15,25,0,0,11,52,65,9,4,32,63,27,32,16,31,2,3,10,43,63
2008-10-12 00:00:00.000,ATP Masters Series Madrid Spain ATP World Tour,HARD,2,Rafael Nadal,Richard Gasquet,Rafael Nadal,6-4; 6-2,R16,86,2,2,33,57,27,33,13,24,4,4,9,40,57,4,0,35,60,23,35,12,25,6,9,9,35,60
2008-10-12 00:00:00.000,ATP Masters Series Madrid Spain ATP World Tour,HARD,2,Feliciano Lopez,Stanislas Wawrinka,Feliciano Lopez,6-4; 6-4,R16,73,9,1,35,52,30,35,12,17,0,0,10,42,52,7,1,37,56,28,37,10,19,1,3,10,38,56
2008-10-12 00:00:00.000,ATP Masters Series Madrid Spain ATP World Tour,HARD,2,Ivo Karlovic,Novak Djokovic,Ivo Karlovic,7-6(4); 7-6(5),R16,102,20,0,54,83,48,54,14,29,3,3,12,62,83,8,0,47,71,39,47,17,24,1,1,12,56,71
2008-10-12 00:00:00.000,ATP Masters Series Madrid Spain ATP World Tour,HARD,2,Gilles Simon,Robby Ginepri,Gilles Simon,6-7(6); 6-4; 7-6(6),R16,155,12,4,62,112,46,62,29,50,3,6,17,75,112,6,4,91,128,59,91,19,37,10,14,17,78,128
2008-10-12 00:00:00.000,ATP Masters Series Madrid Spain ATP World Tour,HARD,2,Gael Monfils,Andy Roddick,Gael Monfils,6-4; 3-6; 6-3,R16,100,7,1,52,86,38,52,21,34,7,8,14,59,86,13,3,49,79,41,49,15,30,1,3,14,56,79
2008-10-12 00:00:00.000,ATP Masters Series Madrid Spain ATP World Tour,HARD,2,Andy Murray,Marin Cilic,Andy Murray,7-5; 7-6(2),R16,112,4,3,38,71,31,38,17,33,0,2,12,48,71,11,6,41,84,30,41,19,43,4,7,12,49,84
2008-10-12 00:00:00.000,ATP Masters Series Madrid Spain ATP World Tour,HARD,2,Juan Martin Del Potro,David Nalbandian,Juan Martin Del Potro,6-4; 6-2,R16,85,8,1,28,57,25,28,12,29,4,5,9,37,57,6,5,28,55,21,28,8,27,1,5,9,29,55
2008-10-12 00:00:00.000,ATP Masters Series Madrid Spain ATP World Tour,HARD,2,Roger Federer,Jo-Wilfried Tsonga,Roger Federer,6-4; 6-1,R16,63,9,1,31,50,25,31,13,19,4,4,9,38,50,3,5,24,50,18,24,11,26,5,8,8,29,50
2008-10-12 00:00:00.000,ATP Masters Series Madrid Spain ATP World Tour,HARD,2,Rafael Nadal,Feliciano Lopez,Rafael Nadal,6-4; 6-4,Q,91,0,0,43,61,32,43,13,18,2,2,10,45,61,4,1,29,54,21,29,14,25,2,4,10,35,54
2008-10-12 00:00:00.000,ATP Masters Series Madrid Spain ATP World Tour,HARD,2,Gilles Simon,Ivo Karlovic,Gilles Simon,7-6(1); 4-6; 7-6(2),Q,134,4,1,54,98,42,54,25,44,2,6,17,67,98,27,1,69,100,54,69,11,31,4,7,17,65,100
2008-10-12 00:00:00.000,ATP Masters Series Madrid Spain ATP World Tour,HARD,2,Andy Murray,Gael Monfils,Andy Murray,6-2; 6-2,Q,68,3,0,32,52,22,32,10,20,0,2,8,32,52,4,2,34,54,17,34,6,20,5,11,8,23,54
2008-10-12 00:00:00.000,ATP Masters Series Madrid Spain ATP World Tour,HARD,2,Roger Federer,Juan Martin Del Potro,Roger Federer,6-3; 6-3,Q,86,3,0,37,53,29,37,9,16,1,1,9,38,53,12,4,41,68,30,41,8,27,6,9,9,38,68
2008-10-12 00:00:00.000,ATP Masters Series Madrid Spain ATP World Tour,HARD,2,Gilles Simon,Rafael Nadal,Gilles Simon,3-6; 7-5; 7-6(6),S,203,3,3,90,147,57,90,28,57,17,22,17,85,147,2,1,63,102,41,63,23,39,4,8,16,64,102
2008-10-12 00:00:00.000,ATP Masters Series Madrid Spain ATP World Tour,HARD,2,Andy Murray,Roger Federer,Andy Murray,3-6; 6-3; 7-5,S,117,14,2,53,86,45,53,17,33,2,3,15,62,86,7,1,65,98,46,65,18,33,7,9,15,64,98
2008-10-12 00:00:00.000,ATP Masters Series Madrid Spain ATP World Tour,HARD,2,Andy Murray,Gilles Simon,Andy Murray,6-4; 7-6(6),F,95,11,0,44,66,37,44,11,22,0,0,11,48,66,1,1,41,75,29,41,19,34,3,4,11,48,75
2008-10-20 00:00:00.000,Basel Switzerland ATP World Tour,HARD,2,Roger Federer,Bobby Reynolds,Roger Federer,6-3; 6-7(6); 6-3,R32,110,17,2,53,89,44,53,24,36,0,0,16,68,89,15,1,58,95,46,58,18,37,10,12,14,64,95
2008-10-20 00:00:00.000,Basel Switzerland ATP World Tour,HARD,2,Jarkko Nieminen,Eduardo Schwank,Jarkko Nieminen,6-2; 6-4,R32,73,2,2,34,46,27,34,8,12,2,3,9,35,46,1,1,44,66,27,44,7,22,6,10,9,34,66
2008-10-20 00:00:00.000,Basel Switzerland ATP World Tour,HARD,2,Marcel Granollers,Marcos Baghdatis,Marcel Granollers,6-2; 4-6; 6-2,R32,139,6,2,53,95,34,53,26,42,8,10,13,60,95,3,6,34,87,25,34,24,53,5,10,13,49,87
2008-10-20 00:00:00.000,Basel Switzerland ATP World Tour,HARD,2,Simone Bolelli,Tomas Berdych,Simone Bolelli,6-4; 7-5,R32,96,2,0,39,64,35,39,12,25,2,2,11,47,64,11,4,49,75,40,49,7,26,4,6,11,47,75
2008-10-20 00:00:00.000,Basel Switzerland ATP World Tour,HARD,2,James Blake,Nicolas Kiefer,James Blake,3-6; 6-3; 6-4,R32,104,11,5,39,78,29,39,24,39,2,4,14,53,78,8,1,37,75,28,37,19,38,2,5,14,47,75
2008-10-20 00:00:00.000,Basel Switzerland ATP World Tour,HARD,2,Oscar Hernandez,Lukas Dlouhy,Oscar Hernandez,7-6(6); 6-7(5); 6-1,R32,155,5,2,68,104,41,68,23,36,4,7,15,64,104,3,16,76,128,53,76,17,52,8,14,16,70,128
2008-10-20 00:00:00.000,Basel Switzerland ATP World Tour,HARD,2,Feliciano Lopez,Marco Chiudinelli,Feliciano Lopez,7-6(5); 7-6(7),R32,124,15,2,49,84,39,49,24,35,2,2,12,63,84,4,2,54,95,46,54,19,41,5,5,12,65,95
2008-10-20 00:00:00.000,Basel Switzerland ATP World Tour,HARD,2,Mardy Fish,Agustin Calleri,Mardy Fish,7-6(5); 6-2,R32,89,9,2,24,68,21,24,27,44,2,2,10,48,68,8,2,32,61,26,32,14,29,1,3,10,40,61
2008-10-20 00:00:00.000,Basel Switzerland ATP World Tour,HARD,2,Igor Andreev,Jurgen Melzer,Igor Andreev,7-6(5); 7-5,R32,104,11,5,51,94,36,51,28,43,5,5,12,64,94,7,3,40,76,32,40,21,36,1,2,12,53,76
2008-10-20 00:00:00.000,Basel Switzerland ATP World Tour,HARD,2,Philipp Kohlschreiber,Denis Gremelmayr,Philipp Kohlschreiber,6-4; 7-6(5),R32,101,3,2,43,66,32,43,13,23,1,3,11,45,66,2,2,44,85,28,44,22,41,6,9,11,50,85
2008-10-20 00:00:00.000,Basel Switzerland ATP World Tour,HARD,2,Stephane Bohli,Jose Acasuso,Stephane Bohli,6-3; 6-2,R32,53,8,2,27,47,25,27,12,20,2,2,9,37,47,2,1,24,42,17,24,7,18,1,4,8,24,42
2008-10-20 00:00:00.000,Basel Switzerland ATP World Tour,HARD,2,Juan Martin Del Potro,George Bastl,Juan Martin Del Potro,6-2; 6-4,R32,83,6,2,30,44,28,30,6,14,1,2,9,34,44,8,5,39,60,24,39,7,21,4,8,9,31,60
2008-10-20 00:00:00.000,Basel Switzerland ATP World Tour,HARD,2,Benjamin Becker,Stanislas Wawrinka,Benjamin Becker,3-6; 7-6(5); 7-6(5),R32,150,10,5,57,105,42,57,23,48,4,9,16,65,105,9,2,65,107,42,65,26,42,0,4,17,68,107
2008-10-20 00:00:00.000,Basel Switzerland ATP World Tour,HARD,2,Andreas Beck,Nicolas Devilder,Andreas Beck,6-4; 6-4,R32,72,9,1,28,52,26,28,12,24,1,2,10,38,52,6,1,38,58,27,38,9,20,1,4,10,36,58
2008-10-20 00:00:00.000,Basel Switzerland ATP World Tour,HARD,2,Kristof Vliegen,Philipp Petzschner,Kristof Vliegen,6-2; 6-3,R32,65,7,0,24,51,20,24,18,27,4,4,9,38,51,6,1,22,52,14,22,15,30,4,7,8,29,52
2008-10-20 00:00:00.000,Basel Switzerland ATP World Tour,HARD,2,David Nalbandian,Albert Montanes,David Nalbandian,6-4; 6-2,R32,57,6,4,32,50,29,32,9,18,0,0,9,38,50,2,1,34,52,25,34,6,18,4,7,9,31,52
2008-10-20 00:00:00.000,Basel Switzerland ATP World Tour,HARD,2,Roger Federer,Jarkko Nieminen,Roger Federer,7-6(6); 7-6(1),R16,96,11,0,64,89,44,64,14,25,5,8,12,58,89,1,2,50,78,31,50,18,28,2,5,12,49,78
2008-10-20 00:00:00.000,Basel Switzerland ATP World Tour,HARD,2,Simone Bolelli,Marcel Granollers,Simone Bolelli,6-4; 6-2,R16,74,2,0,26,48,23,26,15,22,0,0,9,38,48,7,2,33,58,22,33,11,25,6,9,9,33,58
2008-10-20 00:00:00.000,Basel Switzerland ATP World Tour,HARD,2,James Blake,Oscar Hernandez,James Blake,6-7(4); 6-2; 6-4,R16,125,17,1,52,81,48,52,17,29,1,1,15,65,81,6,3,73,118,48,73,24,45,10,13,15,72,118
2008-10-20 00:00:00.000,Basel Switzerland ATP World Tour,HARD,2,Feliciano Lopez,Mardy Fish,Feliciano Lopez,7-6(9); 6-4,R16,89,16,3,52,71,43,52,11,19,2,2,11,54,71,14,6,37,77,33,37,21,40,4,5,11,54,77
2008-10-20 00:00:00.000,Basel Switzerland ATP World Tour,HARD,2,Igor Andreev,Philipp Kohlschreiber,Igor Andreev,7-6(6); 6-7(0); 7-5,R16,154,17,3,68,113,54,68,28,45,1,1,18,82,113,5,3,78,118,59,78,28,40,3,4,18,87,118
2008-10-20 00:00:00.000,Basel Switzerland ATP World Tour,HARD,2,Juan Martin Del Potro,Stephane Bohli,Juan Martin Del Potro,6-3; 6-3,R16,66,6,1,28,47,23,28,14,19,0,0,9,37,47,6,1,32,54,22,32,10,22,2,5,9,32,54
2008-10-20 00:00:00.000,Basel Switzerland ATP World Tour,HARD,2,Benjamin Becker,Andreas Beck,Benjamin Becker,3-6; 6-3; 6-4,R16,107,19,4,54,86,42,54,18,32,6,7,14,60,86,10,5,44,83,36,44,19,39,5,7,14,55,83
2008-10-20 00:00:00.000,Basel Switzerland ATP World Tour,HARD,2,David Nalbandian,Kristof Vliegen,David Nalbandian,6-4; 5-7; 7-6(4),R16,144,11,3,57,100,43,57,29,43,3,5,17,72,100,13,6,64,121,50,64,28,57,4,6,17,78,121
2008-10-20 00:00:00.000,Basel Switzerland ATP World Tour,HARD,2,Roger Federer,Simone Bolelli,Roger Federer,6-2; 6-3,Q,67,8,1,39,56,33,39,8,17,1,1,9,41,56,3,3,29,47,18,29,8,18,3,6,8,26,47
2008-10-20 00:00:00.000,Basel Switzerland ATP World Tour,HARD,2,Feliciano Lopez,James Blake,Feliciano Lopez,6-4; 7-6(7),Q,88,10,3,54,87,41,54,19,33,8,8,11,60,87,7,0,42,64,32,42,15,22,2,3,11,47,64
2008-10-20 00:00:00.000,Basel Switzerland ATP World Tour,HARD,2,Juan Martin Del Potro,Igor Andreev,Juan Martin Del Potro,6-4; 7-5,Q,114,5,1,35,69,28,35,21,34,3,3,11,49,69,10,2,51,81,35,51,14,30,7,9,11,49,81
2008-10-20 00:00:00.000,Basel Switzerland ATP World Tour,HARD,2,David Nalbandian,Benjamin Becker,David Nalbandian,7-6(4); 6-4,Q,103,8,2,43,76,37,43,16,33,3,3,11,53,76,12,2,58,88,43,58,12,30,8,9,11,55,88
2008-10-20 00:00:00.000,Basel Switzerland ATP World Tour,HARD,2,Roger Federer,Feliciano Lopez,Roger Federer,6-3; 6-2,S,61,15,2,31,54,28,31,12,23,2,2,9,40,54,5,2,25,52,18,25,11,27,1,4,8,29,52
2008-10-20 00:00:00.000,Basel Switzerland ATP World Tour,HARD,2,David Nalbandian,Juan Martin Del Potro,David Nalbandian,6-4; 6-4,S,80,7,1,43,57,32,43,8,14,2,3,10,40,57,6,0,37,56,22,37,11,19,2,5,10,33,56
2008-10-20 00:00:00.000,Basel Switzerland ATP World Tour,HARD,2,Roger Federer,David Nalbandian,Roger Federer,6-3; 6-4,F,70,8,0,30,47,26,30,14,17,0,0,10,40,47,5,3,41,61,27,41,10,20,6,8,9,37,61
2008-10-20 00:00:00.000,Lyon France ATP World Tour,HARD,2,Andy Roddick,Nicolas Mahut,Andy Roddick,7-6(5); 6-4,R32,78,18,3,44,62,39,44,10,18,0,0,11,49,62,18,5,50,71,41,50,9,21,3,4,11,50,71
2008-10-20 00:00:00.000,Lyon France ATP World Tour,HARD,2,Robby Ginepri,Sebastien Grosjean,Robby Ginepri,6-7(4); 6-4; 6-4,R32,134,5,2,61,97,44,61,17,36,4,7,16,61,97,0,4,84,113,53,84,13,29,14,19,16,66,113
2008-10-20 00:00:00.000,Lyon France ATP World Tour,HARD,2,Christophe Rochus,Gilles Muller,Christophe Rochus,6-2; 6-4,R32,75,4,0,31,44,24,31,12,13,0,0,9,36,44,20,7,42,75,30,42,11,33,9,12,9,41,75
2008-10-20 00:00:00.000,Lyon France ATP World Tour,HARD,2,Robin Soderling,Thierry Ascione,Robin Soderling,6-4; 6-1,R32,65,10,1,23,41,20,23,13,18,0,0,8,33,41,2,1,38,61,25,38,8,23,7,11,9,33,61
2008-10-20 00:00:00.000,Lyon France ATP World Tour,HARD,2,Gilles Simon,Juan Monaco,Gilles Simon,2-6; 6-4; 6-1,R32,128,8,3,61,107,38,61,24,46,8,11,13,62,107,4,1,43,78,31,43,13,35,5,9,12,44,78
2008-10-20 00:00:00.000,Lyon France ATP World Tour,HARD,2,Andreas Seppi,David Guez,Andreas Seppi,6-2; 7-5,R32,79,6,1,37,55,30,37,13,18,0,0,10,43,55,1,3,30,59,19,30,15,29,2,5,10,34,59
2008-10-20 00:00:00.000,Lyon France ATP World Tour,HARD,2,Josselin Ouanna,Ivan Ljubicic,Josselin Ouanna,6-7(2); 7-6(5); 6-4,R32,132,11,2,62,107,50,62,24,45,3,5,17,74,107,24,1,60,96,48,60,21,36,1,4,17,69,96
2008-10-20 00:00:00.000,Lyon France ATP World Tour,HARD,2,Nicolas Lapentti,Ivo Karlovic,Nicolas Lapentti,7-6(4); 6-3,R32,91,2,1,47,75,37,47,16,28,6,7,11,53,75,13,3,36,58,35,36,6,22,3,5,10,41,58
2008-10-20 00:00:00.000,Lyon France ATP World Tour,HARD,2,Paul-Henri Mathieu,Guillermo Canas,Paul-Henri Mathieu,6-3; 6-4,R32,88,2,2,36,71,26,36,21,35,3,4,10,47,71,10,1,29,51,22,29,8,22,3,6,9,30,51
2008-10-20 00:00:00.000,Lyon France ATP World Tour,HARD,2,Juan Carlos Ferrero,Sam Querrey,Juan Carlos Ferrero,6-3; 7-5,R32,81,9,0,51,68,39,51,12,17,2,2,11,51,68,7,2,45,68,32,45,9,23,4,6,10,41,68
2008-10-20 00:00:00.000,Lyon France ATP World Tour,HARD,2,Fabrice Santoro,Fabio Fognini,Fabrice Santoro,6-4; 6-1,R32,63,8,2,35,61,27,35,13,26,3,4,9,40,61,2,0,30,46,16,30,9,16,3,7,8,25,46
2008-10-20 00:00:00.000,Lyon France ATP World Tour,HARD,2,Jo-Wilfried Tsonga,Marc Gicquel,Jo-Wilfried Tsonga,7-5; 4-6; 6-3,R32,119,14,4,60,95,52,60,15,35,5,6,16,67,95,8,2,53,88,41,53,18,35,4,6,15,59,88
2008-10-20 00:00:00.000,Lyon France ATP World Tour,HARD,2,Tommy Robredo,Michael Llodra,Tommy Robredo,6-4; 6-3,R32,63,8,2,48,63,37,48,7,15,1,1,10,44,63,5,5,33,53,24,33,10,20,1,3,9,34,53
2008-10-20 00:00:00.000,Lyon France ATP World Tour,HARD,2,Julien Benneteau,Arnaud Clement,Julien Benneteau,6-3; 6-2,R32,86,10,6,30,51,26,30,10,21,2,2,8,36,51,5,3,41,67,23,41,12,26,9,13,9,35,67
2008-10-20 00:00:00.000,Lyon France ATP World Tour,HARD,2,Steve Darcis,Radek Stepanek,Steve Darcis,6-4; 3-6; 6-3,R32,92,3,3,59,88,45,59,17,29,4,5,14,62,88,13,11,48,85,38,48,18,37,4,6,14,56,85
2008-10-20 00:00:00.000,Lyon France ATP World Tour,HARD,2,Richard Gasquet,Santiago Giraldo,Richard Gasquet,5-7; 6-3; 7-6(3),R32,125,17,4,69,94,58,69,12,25,1,3,17,70,94,10,0,73,99,47,73,18,26,5,7,16,65,99
2008-10-20 00:00:00.000,Lyon France ATP World Tour,HARD,2,Andy Roddick,Robby Ginepri,Andy Roddick,7-6(5); 7-6(3),R16,98,26,0,63,79,53,63,8,16,2,2,12,61,79,11,1,65,98,50,65,15,33,6,6,12,65,98
2008-10-20 00:00:00.000,Lyon France ATP World Tour,HARD,2,Robin Soderling,Christophe Rochus,Robin Soderling,6-1; 6-2,R16,47,20,3,26,44,24,26,11,18,1,1,8,35,44,1,1,30,44,16,30,5,14,1,5,7,21,44
2008-10-20 00:00:00.000,Lyon France ATP World Tour,HARD,2,Gilles Simon,Andreas Seppi,Gilles Simon,7-6(5); 5-7; 6-4,R16,146,13,2,62,105,48,62,26,43,4,6,17,74,105,8,3,68,118,51,68,28,50,7,9,17,79,118
2008-10-20 00:00:00.000,Lyon France ATP World Tour,HARD,2,Josselin Ouanna,Nicolas Lapentti,Josselin Ouanna,6-3; 1-6; 6-3,R16,87,6,2,42,61,34,42,12,19,1,3,13,46,61,5,1,55,73,39,55,8,18,0,2,12,47,73
2008-10-20 00:00:00.000,Lyon France ATP World Tour,HARD,2,Juan Carlos Ferrero,Paul-Henri Mathieu,Juan Carlos Ferrero,6-4; 6-1,R16,58,9,1,27,40,24,27,9,13,0,0,8,33,40,2,1,36,54,22,36,6,18,3,7,9,28,54
2008-10-20 00:00:00.000,Lyon France ATP World Tour,HARD,2,Jo-Wilfried Tsonga,Fabrice Santoro,Jo-Wilfried Tsonga,6-2; 5-7; 6-3,R16,112,16,1,54,78,44,54,18,24,4,5,15,62,78,4,0,48,77,37,48,14,29,1,4,14,51,77
2008-10-20 00:00:00.000,Lyon France ATP World Tour,HARD,2,Julien Benneteau,Tommy Robredo,Julien Benneteau,6-2; 6-2,R16,70,7,4,31,49,26,31,10,18,1,1,8,36,49,5,2,40,64,25,40,6,24,9,13,8,31,64
2008-10-20 00:00:00.000,Lyon France ATP World Tour,HARD,2,Steve Darcis,Richard Gasquet,Steve Darcis,6-4; 3-6; 7-6(5),R16,115,2,0,58,86,43,58,15,28,4,7,15,58,86,17,2,66,99,55,66,11,33,3,6,16,66,99
2008-10-20 00:00:00.000,Lyon France ATP World Tour,HARD,2,Robin Soderling,Andy Roddick,Robin Soderling,7-6(5); 7-6(5),Q,84,20,6,45,74,40,45,18,29,1,1,12,58,74,22,2,58,81,46,58,13,23,4,4,12,59,81
2008-10-20 00:00:00.000,Lyon France ATP World Tour,HARD,2,Gilles Simon,Josselin Ouanna,Gilles Simon,6-3; 7-5,Q,72,7,1,34,63,27,34,20,29,0,0,11,47,63,7,1,38,58,28,38,9,20,0,2,10,37,58
2008-10-20 00:00:00.000,Lyon France ATP World Tour,HARD,2,Jo-Wilfried Tsonga,Juan Carlos Ferrero,Jo-Wilfried Tsonga,7-6(5); 6-1,Q,73,15,1,37,53,31,37,7,16,0,1,9,38,53,4,0,44,63,31,44,6,19,3,7,10,37,63
2008-10-20 00:00:00.000,Lyon France ATP World Tour,HARD,2,Julien Benneteau,Steve Darcis,Julien Benneteau,6-3; 6-2,Q,76,9,2,36,58,24,36,14,22,3,4,9,38,58,0,1,49,59,23,49,6,10,6,10,8,29,59
2008-10-20 00:00:00.000,Lyon France ATP World Tour,HARD,2,Robin Soderling,Gilles Simon,Robin Soderling,5-7; 6-3; 6-3,S,159,8,2,50,84,37,50,20,34,3,5,15,57,84,9,1,40,78,31,40,20,38,3,7,15,51,78
2008-10-20 00:00:00.000,Lyon France ATP World Tour,HARD,2,Julien Benneteau,Jo-Wilfried Tsonga,Julien Benneteau,7-6(4); 7-5,S,105,7,3,55,76,41,55,13,21,3,4,12,54,76,14,1,46,80,34,46,18,34,4,6,12,52,80
2008-10-20 00:00:00.000,Lyon France ATP World Tour,HARD,2,Robin Soderling,Julien Benneteau,Robin Soderling,6-3; 6-7(5); 6-1,F,103,10,1,64,86,53,64,13,22,3,4,15,66,86,7,3,47,75,32,47,15,28,1,5,13,47,75
2008-10-20 00:00:00.000,St. Petersburg Russia ATP World Tour,HARD,2,Andy Murray,Viktor Troicki,Andy Murray,6-3; 6-3,R32,67,4,0,26,48,24,26,13,22,1,1,9,37,48,4,2,38,57,28,38,6,19,4,7,9,34,57
2008-10-20 00:00:00.000,St. Petersburg Russia ATP World Tour,HARD,2,Ernests Gulbis,Guillermo Garcia-Lopez,Ernests Gulbis,6-0; 6-2,R32,51,11,1,29,35,25,29,4,6,0,0,7,29,35,0,2,31,47,15,31,5,16,1,6,7,20,47
2008-10-20 00:00:00.000,St. Petersburg Russia ATP World Tour,HARD,2,Janko Tipsarevic,Potito Starace,Janko Tipsarevic,6-3; 7-6(4),R32,86,12,2,37,66,34,37,16,29,1,1,11,50,66,2,2,54,73,38,54,10,19,5,6,10,48,73
2008-10-20 00:00:00.000,St. Petersburg Russia ATP World Tour,HARD,2,Jeremy Chardy,Mario Ancic,Jeremy Chardy,6-4; 3-6; 6-4,R32,115,8,4,52,77,42,52,13,25,4,6,14,55,77,12,4,49,83,39,49,16,34,4,7,15,55,83
2008-10-20 00:00:00.000,St. Petersburg Russia ATP World Tour,HARD,2,Fernando Verdasco,Teymuraz Gabashvili,Fernando Verdasco,1-6; 6-4; 6-3,R32,106,0,5,58,78,40,58,11,20,1,4,13,51,78,5,2,41,72,33,41,13,31,3,6,13,46,72
2008-10-20 00:00:00.000,St. Petersburg Russia ATP World Tour,HARD,2,Karlis Lejnieks,Alexander Kudryavtsev,Karlis Lejnieks,3-6; 7-6(1); 6-3,R32,112,14,6,75,125,55,75,21,50,10,13,16,76,125,6,3,42,72,32,42,18,30,0,2,14,50,72
2008-10-20 00:00:00.000,St. Petersburg Russia ATP World Tour,HARD,2,Rainer Schuettler,Igor Kunitsyn,Rainer Schuettler,6-2; 6-3,R32,80,2,1,35,56,22,35,14,21,2,3,9,36,56,3,2,35,49,20,35,5,14,3,7,8,25,49
2008-10-20 00:00:00.000,St. Petersburg Russia ATP World Tour,HARD,2,Dominik Hrbaty,Dmitry Tursunov,Dominik Hrbaty,6-1; 6-1,R32,56,0,1,29,46,22,29,8,17,1,2,7,30,46,2,1,46,53,20,46,2,7,5,11,7,22,53
2008-10-20 00:00:00.000,St. Petersburg Russia ATP World Tour,HARD,2,Marat Safin,Sergiy Stakhovsky,Marat Safin,6-2; 6-4,R32,68,9,1,26,59,21,26,18,33,3,4,9,39,59,1,4,38,61,25,38,7,23,3,7,9,32,61
2008-10-20 00:00:00.000,St. Petersburg Russia ATP World Tour,HARD,2,Andrey Golubev,Olivier Rochus,Andrey Golubev,6-1; 6-4,R32,69,17,0,24,52,19,24,18,28,3,4,9,37,52,1,1,28,52,17,28,11,24,7,11,8,28,52
2008-10-20 00:00:00.000,St. Petersburg Russia ATP World Tour,HARD,2,Mischa Zverev,Florent Serra,Mischa Zverev,6-4; 6-2,R32,53,1,1,33,46,28,33,8,13,0,0,9,36,46,2,2,41,54,23,41,7,13,3,6,9,30,54
2008-10-20 00:00:00.000,St. Petersburg Russia ATP World Tour,HARD,2,Mikhail Youzhny,Ivan Navarro,Mikhail Youzhny,6-2; 6-1,R32,55,3,0,24,43,22,24,12,19,3,3,8,34,43,1,1,25,44,16,25,7,19,2,6,7,23,44
2008-10-20 00:00:00.000,St. Petersburg Russia ATP World Tour,HARD,2,Mikhail Kukushkin,Marin Cilic,Mikhail Kukushkin,7-6(4); 4-6; 7-6(6),R32,177,10,5,68,114,56,68,20,46,3,6,17,76,114,19,4,72,138,54,72,37,66,8,10,17,91,138
2008-10-20 00:00:00.000,St. Petersburg Russia ATP World Tour,HARD,2,Victor Hanescu,Evgeny Korolev,Victor Hanescu,6-1; 6-2,R32,89,12,0,36,43,29,36,4,7,2,2,8,33,43,1,2,25,46,12,25,9,21,5,9,7,21,46
2008-10-20 00:00:00.000,St. Petersburg Russia ATP World Tour,HARD,2,Mikhail Elgin,Filippo Volandri,Mikhail Elgin,6-4; 6-4,R32,73,7,5,29,57,27,29,14,28,0,0,10,41,57,0,3,51,68,36,51,6,17,3,5,10,42,68
2008-10-20 00:00:00.000,St. Petersburg Russia ATP World Tour,HARD,2,Nikolay Davydenko,Chris Guccione,Nikolay Davydenko,6-4; 6-4,R32,77,4,2,26,56,22,26,20,30,0,0,10,42,56,9,3,44,65,33,44,8,21,6,8,10,41,65
2008-10-20 00:00:00.000,St. Petersburg Russia ATP World Tour,HARD,2,Andy Murray,Ernests Gulbis,Andy Murray,6-4; 6-2,R16,61,5,0,28,48,23,28,12,20,3,4,9,35,48,4,1,36,54,21,36,7,18,5,9,9,28,54
2008-10-20 00:00:00.000,St. Petersburg Russia ATP World Tour,HARD,2,Janko Tipsarevic,Jeremy Chardy,Janko Tipsarevic,6-4; 7-6(3),R16,96,11,0,40,69,33,40,16,29,3,4,11,49,69,6,2,49,67,36,49,8,18,2,4,11,44,67
2008-10-20 00:00:00.000,St. Petersburg Russia ATP World Tour,HARD,2,Fernando Verdasco,Karlis Lejnieks,Fernando Verdasco,6-1; 6-3,R16,65,2,4,27,43,24,27,10,16,1,1,8,34,43,3,1,42,59,22,42,6,17,2,6,8,28,59
2008-10-20 00:00:00.000,St. Petersburg Russia ATP World Tour,HARD,2,Rainer Schuettler,Dominik Hrbaty,Rainer Schuettler,6-3; 6-3,R16,68,1,4,30,47,27,30,10,17,1,1,9,37,47,1,1,31,52,19,31,10,21,4,7,9,29,52
2008-10-20 00:00:00.000,St. Petersburg Russia ATP World Tour,HARD,2,Andrey Golubev,Marat Safin,Andrey Golubev,6-4; 6-2,R16,74,7,4,27,51,24,27,12,24,1,2,9,36,51,5,2,33,71,19,33,18,38,6,10,9,37,71
2008-10-20 00:00:00.000,St. Petersburg Russia ATP World Tour,HARD,2,Mischa Zverev,Mikhail Youzhny,Mischa Zverev,7-5; 6-4,R16,87,5,0,50,63,34,50,8,13,4,6,11,42,63,0,3,42,65,25,42,11,23,1,5,11,36,65
2008-10-20 00:00:00.000,St. Petersburg Russia ATP World Tour,HARD,2,Victor Hanescu,Mikhail Kukushkin,Victor Hanescu,6-3; 7-6(7),R16,98,7,4,49,68,35,49,9,19,0,2,11,44,68,6,4,41,75,29,41,16,34,3,6,10,45,75
2008-10-20 00:00:00.000,St. Petersburg Russia ATP World Tour,HARD,2,Mikhail Elgin,Nikolay Davydenko,Mikhail Elgin,W/O,R16,0,0,0,0,0,0,0,0,0,0,0,0,0,0,0,0,0,0,0,0,0,0,0,0,0,0,0
2008-10-20 00:00:00.000,St. Petersburg Russia ATP World Tour,HARD,2,Andy Murray,Janko Tipsarevic,Andy Murray,7-6(5); 7-5,Q,129,9,2,47,85,35,47,19,38,5,7,12,54,85,7,4,43,87,32,43,19,44,5,8,12,51,87
2008-10-20 00:00:00.000,St. Petersburg Russia ATP World Tour,HARD,2,Fernando Verdasco,Rainer Schuettler,Fernando Verdasco,7-5; 6-2,Q,88,3,3,49,57,33,49,5,8,1,3,10,38,57,3,0,44,64,21,44,11,20,6,11,10,32,64
2008-10-20 00:00:00.000,St. Petersburg Russia ATP World Tour,HARD,2,Andrey Golubev,Mischa Zverev,Andrey Golubev,6-7(3); 6-4; 7-6(4),Q,157,6,2,71,118,54,71,24,47,8,10,17,78,118,1,1,87,112,59,87,15,25,4,7,17,74,112
2008-10-20 00:00:00.000,St. Petersburg Russia ATP World Tour,HARD,2,Victor Hanescu,Mikhail Elgin,Victor Hanescu,6-1; 6-4,Q,64,1,0,34,49,27,34,10,15,2,3,9,37,49,1,1,30,53,16,30,11,23,3,7,8,27,53
2008-10-20 00:00:00.000,St. Petersburg Russia ATP World Tour,HARD,2,Andy Murray,Fernando Verdasco,Andy Murray,6-0; 6-3,S,74,5,1,33,55,26,33,10,22,1,2,8,36,55,1,7,34,51,16,34,5,17,5,10,7,21,51
2008-10-20 00:00:00.000,St. Petersburg Russia ATP World Tour,HARD,2,Andrey Golubev,Victor Hanescu,Andrey Golubev,6-3; 6-0,S,54,2,1,27,38,20,27,8,11,0,0,7,28,38,1,1,37,46,18,37,2,9,4,9,8,20,46
2008-10-20 00:00:00.000,St. Petersburg Russia ATP World Tour,HARD,2,Andy Murray,Andrey Golubev,Andy Murray,6-1; 6-1,F,57,0,2,31,41,27,31,3,10,2,2,7,30,41,1,2,26,49,13,26,8,23,3,8,7,21,49
2008-10-26 00:00:00.000,ATP Masters Series Paris France ATP World Tour,HARD,2,Rafael Nadal,N/A Bye,Rafael Nadal,,R64,0,0,0,0,0,0,0,0,0,0,0,0,0,0,0,0,0,0,0,0,0,0,0,0,0,0,0
2008-10-26 00:00:00.000,ATP Masters Series Paris France ATP World Tour,HARD,2,Florent Serra,Guillermo Canas,Florent Serra,4-6; 7-5; 6-3,R64,124,2,3,57,92,43,57,20,35,5,7,16,63,92,14,5,42,90,36,42,23,48,9,12,15,59,90
2008-10-26 00:00:00.000,ATP Masters Series Paris France ATP World Tour,HARD,2,Juan Monaco,Marat Safin,Juan Monaco,6-0; 7-6(4),R64,79,2,0,40,59,30,40,10,19,3,4,9,40,59,7,7,36,70,25,36,12,34,7,11,9,37,70
2008-10-26 00:00:00.000,ATP Masters Series Paris France ATP World Tour,HARD,2,Gael Monfils,N/A Bye,Gael Monfils,,R64,0,0,0,0,0,0,0,0,0,0,0,0,0,0,0,0,0,0,0,0,0,0,0,0,0,0,0
2008-10-26 00:00:00.000,ATP Masters Series Paris France ATP World Tour,HARD,2,Stanislas Wawrinka,N/A Bye,Stanislas Wawrinka,,R64,0,0,0,0,0,0,0,0,0,0,0,0,0,0,0,0,0,0,0,0,0,0,0,0,0,0,0
2008-10-26 00:00:00.000,ATP Masters Series Paris France ATP World Tour,HARD,2,Tomas Berdych,Robby Ginepri,Tomas Berdych,6-4; 7-5,R64,86,6,3,45,70,32,45,14,25,6,8,11,46,70,6,3,50,81,32,50,12,31,4,8,11,44,81
2008-10-26 00:00:00.000,ATP Masters Series Paris France ATP World Tour,HARD,2,Ivan Ljubicic,Viktor Troicki,Ivan Ljubicic,6-3; 6-4,R64,72,7,3,34,54,28,34,14,20,0,0,10,42,54,3,5,41,61,30,41,6,20,4,6,9,36,61
2008-10-26 00:00:00.000,ATP Masters Series Paris France ATP World Tour,HARD,2,Nikolay Davydenko,N/A Bye,Nikolay Davydenko,,R64,0,0,0,0,0,0,0,0,0,0,0,0,0,0,0,0,0,0,0,0,0,0,0,0,0,0,0
2008-10-26 00:00:00.000,ATP Masters Series Paris France ATP World Tour,HARD,2,Andy Murray,N/A Bye,Andy Murray,,R64,0,0,0,0,0,0,0,0,0,0,0,0,0,0,0,0,0,0,0,0,0,0,0,0,0,0,0
2008-10-26 00:00:00.000,ATP Masters Series Paris France ATP World Tour,HARD,2,Sam Querrey,Marcos Baghdatis,Sam Querrey,7-5; 6-7(5); 3-2 RET,R64,107,17,1,65,87,52,65,8,22,2,3,14,60,87,9,8,45,89,38,45,22,44,2,5,15,60,89
2008-10-26 00:00:00.000,ATP Masters Series Paris France ATP World Tour,HARD,2,Tommy Robredo,Jeremy Chardy,Tommy Robredo,7-6(4); 7-6(5),R64,104,6,2,56,79,43,56,14,23,0,1,12,57,79,6,1,47,77,37,47,17,30,1,2,12,54,77
2008-10-26 00:00:00.000,ATP Masters Series Paris France ATP World Tour,HARD,2,Fernando Verdasco,N/A Bye,Fernando Verdasco,,R64,0,0,0,0,0,0,0,0,0,0,0,0,0,0,0,0,0,0,0,0,0,0,0,0,0,0,0
2008-10-26 00:00:00.000,ATP Masters Series Paris France ATP World Tour,HARD,2,Juan Martin Del Potro,N/A Bye,Juan Martin Del Potro,,R64,0,0,0,0,0,0,0,0,0,0,0,0,0,0,0,0,0,0,0,0,0,0,0,0,0,0,0
2008-10-26 00:00:00.000,ATP Masters Series Paris France ATP World Tour,HARD,2,Mario Ancic,Rainer Schuettler,Mario Ancic,6-4; 3-6; 6-1,R64,117,14,4,49,83,38,49,19,34,4,5,13,57,83,5,3,40,82,29,40,21,42,3,6,13,50,82
2008-10-26 00:00:00.000,ATP Masters Series Paris France ATP World Tour,HARD,2,Nicolas Kiefer,Ivo Karlovic,Nicolas Kiefer,6-4; 7-5,R64,80,4,1,30,48,29,30,15,18,0,0,11,44,48,12,2,47,70,32,47,12,23,2,4,11,44,70
2008-10-26 00:00:00.000,ATP Masters Series Paris France ATP World Tour,HARD,2,David Nalbandian,N/A Bye,David Nalbandian,,R64,0,0,0,0,0,0,0,0,0,0,0,0,0,0,0,0,0,0,0,0,0,0,0,0,0,0,0
2008-10-26 00:00:00.000,ATP Masters Series Paris France ATP World Tour,HARD,2,Andy Roddick,N/A Bye,Andy Roddick,,R64,0,0,0,0,0,0,0,0,0,0,0,0,0,0,0,0,0,0,0,0,0,0,0,0,0,0,0
2008-10-26 00:00:00.000,ATP Masters Series Paris France ATP World Tour,HARD,2,Feliciano Lopez,Janko Tipsarevic,Feliciano Lopez,6-3; 6-4,R64,69,11,4,33,55,30,33,11,22,2,2,10,41,55,6,1,34,52,24,34,9,18,0,2,9,33,52
2008-10-26 00:00:00.000,ATP Masters Series Paris France ATP World Tour,HARD,2,Igor Andreev,Paul-Henri Mathieu,Igor Andreev,7-6(6); 6-3,R64,87,8,1,35,66,32,35,19,31,0,0,11,51,66,3,6,41,69,30,41,14,28,2,3,10,44,69
2008-10-26 00:00:00.000,ATP Masters Series Paris France ATP World Tour,HARD,2,Gilles Simon,N/A Bye,Gilles Simon,,R64,0,0,0,0,0,0,0,0,0,0,0,0,0,0,0,0,0,0,0,0,0,0,0,0,0,0,0
2008-10-26 00:00:00.000,ATP Masters Series Paris France ATP World Tour,HARD,2,Jo-Wilfried Tsonga,N/A Bye,Jo-Wilfried Tsonga,,R64,0,0,0,0,0,0,0,0,0,0,0,0,0,0,0,0,0,0,0,0,0,0,0,0,0,0,0
2008-10-26 00:00:00.000,ATP Masters Series Paris France ATP World Tour,HARD,2,Radek Stepanek,Marc Gicquel,Radek Stepanek,6-4; 3-6; 6-4,R64,103,11,4,47,81,33,47,20,34,3,6,14,53,81,17,4,43,94,32,43,25,51,4,8,15,57,94
2008-10-26 00:00:00.000,ATP Masters Series Paris France ATP World Tour,HARD,2,Dmitry Tursunov,Adrian Mannarino,Dmitry Tursunov,6-3; 6-2,R64,78,3,4,31,49,23,31,9,18,1,2,8,32,49,3,5,36,68,26,36,8,32,5,10,9,34,68
2008-10-26 00:00:00.000,ATP Masters Series Paris France ATP World Tour,HARD,2,Novak Djokovic,N/A Bye,Novak Djokovic,,R64,0,0,0,0,0,0,0,0,0,0,0,0,0,0,0,0,0,0,0,0,0,0,0,0,0,0,0
2008-10-26 00:00:00.000,ATP Masters Series Paris France ATP World Tour,HARD,2,David Ferrer,N/A Bye,David Ferrer,,R64,0,0,0,0,0,0,0,0,0,0,0,0,0,0,0,0,0,0,0,0,0,0,0,0,0,0,0
2008-10-26 00:00:00.000,ATP Masters Series Paris France ATP World Tour,HARD,2,Philipp Kohlschreiber,Mikhail Youzhny,Philipp Kohlschreiber,6-1; 6-4,R64,77,5,1,43,64,31,43,14,21,8,8,9,45,64,0,0,29,51,18,29,10,22,2,5,8,28,51
2008-10-26 00:00:00.000,ATP Masters Series Paris France ATP World Tour,HARD,2,Simone Bolelli,Jarkko Nieminen,Simone Bolelli,7-5; 6-4,R64,90,2,0,43,62,33,43,10,19,2,3,11,43,62,7,3,46,79,31,46,17,33,5,8,11,48,79
2008-10-26 00:00:00.000,ATP Masters Series Paris France ATP World Tour,HARD,2,James Blake,N/A Bye,James Blake,,R64,0,0,0,0,0,0,0,0,0,0,0,0,0,0,0,0,0,0,0,0,0,0,0,0,0,0,0
2008-10-26 00:00:00.000,ATP Masters Series Paris France ATP World Tour,HARD,2,Marcel Granollers,N/A Bye,Marcel Granollers,,R64,0,0,0,0,0,0,0,0,0,0,0,0,0,0,0,0,0,0,0,0,0,0,0,0,0,0,0
2008-10-26 00:00:00.000,ATP Masters Series Paris France ATP World Tour,HARD,2,Marin Cilic,Andreas Seppi,Marin Cilic,7-6(5); 6-2,R64,97,8,4,37,75,29,37,18,38,4,6,10,47,75,2,7,51,85,33,51,11,34,5,9,10,44,85
2008-10-26 00:00:00.000,ATP Masters Series Paris France ATP World Tour,HARD,2,Robin Soderling,Josselin Ouanna,Robin Soderling,6-3; 6-4,R64,58,11,3,32,57,29,32,15,25,4,4,10,44,57,8,1,24,46,20,24,12,22,1,3,9,32,46
2008-10-26 00:00:00.000,ATP Masters Series Paris France ATP World Tour,HARD,2,Roger Federer,N/A Bye,Roger Federer,,R64,0,0,0,0,0,0,0,0,0,0,0,0,0,0,0,0,0,0,0,0,0,0,0,0,0,0,0
2008-10-26 00:00:00.000,ATP Masters Series Paris France ATP World Tour,HARD,2,Rafael Nadal,Florent Serra,Rafael Nadal,6-2; 6-4,R32,74,5,0,26,47,22,26,15,21,1,1,9,37,47,5,0,34,53,24,34,8,19,2,5,9,32,53
2008-10-26 00:00:00.000,ATP Masters Series Paris France ATP World Tour,HARD,2,Gael Monfils,Juan Monaco,Gael Monfils,6-4; 6-4,R32,80,12,0,26,47,24,26,9,21,1,3,10,33,47,0,1,37,65,25,37,10,28,6,10,10,35,65
2008-10-26 00:00:00.000,ATP Masters Series Paris France ATP World Tour,HARD,2,Tomas Berdych,Stanislas Wawrinka,Tomas Berdych,6-3; 7-5,R32,83,6,0,40,62,33,40,11,22,0,0,10,44,62,8,3,34,62,26,34,13,28,0,3,11,39,62
2008-10-26 00:00:00.000,ATP Masters Series Paris France ATP World Tour,HARD,2,Nikolay Davydenko,Ivan Ljubicic,Nikolay Davydenko,7-6(5); 7-5,R32,104,12,4,38,67,33,38,20,29,0,0,12,53,67,10,1,42,74,34,42,18,32,4,5,12,52,74
2008-10-26 00:00:00.000,ATP Masters Series Paris France ATP World Tour,HARD,2,Andy Murray,Sam Querrey,Andy Murray,6-2; 6-4,R32,75,8,4,42,66,27,42,12,24,5,7,9,39,66,4,5,29,57,18,29,11,28,3,8,9,29,57
2008-10-26 00:00:00.000,ATP Masters Series Paris France ATP World Tour,HARD,2,Fernando Verdasco,Tommy Robredo,Fernando Verdasco,6-2; 6-7(6); 6-2,R32,129,8,2,64,91,47,64,17,27,2,3,14,64,91,2,5,53,96,37,53,19,43,7,12,14,56,96
2008-10-26 00:00:00.000,ATP Masters Series Paris France ATP World Tour,HARD,2,Juan Martin Del Potro,Mario Ancic,Juan Martin Del Potro,6-0; 6-4,R32,78,3,0,30,50,23,30,12,20,1,1,8,35,50,5,3,27,56,21,27,8,29,3,7,8,29,56
2008-10-26 00:00:00.000,ATP Masters Series Paris France ATP World Tour,HARD,2,David Nalbandian,Nicolas Kiefer,David Nalbandian,7-6(5); 6-3,R32,127,6,2,48,90,33,48,24,42,2,3,11,57,90,8,7,46,86,34,46,16,40,4,6,10,50,86
2008-10-26 00:00:00.000,ATP Masters Series Paris France ATP World Tour,HARD,2,Andy Roddick,Feliciano Lopez,Andy Roddick,6-3; 6-4,R32,66,13,0,31,50,28,31,12,19,0,0,10,40,50,12,0,29,52,18,29,13,23,2,4,9,31,52
2008-10-26 00:00:00.000,ATP Masters Series Paris France ATP World Tour,HARD,2,Gilles Simon,Igor Andreev,Gilles Simon,6-3; 7-5,R32,90,6,0,41,71,29,41,14,30,4,7,11,43,71,1,2,34,61,21,34,9,27,7,12,10,30,61
2008-10-26 00:00:00.000,ATP Masters Series Paris France ATP World Tour,HARD,2,Jo-Wilfried Tsonga,Radek Stepanek,Jo-Wilfried Tsonga,3-6; 6-4; 6-4,R32,124,11,4,57,82,45,57,9,25,2,5,14,54,82,5,8,57,99,37,57,22,42,3,7,15,59,99
2008-10-26 00:00:00.000,ATP Masters Series Paris France ATP World Tour,HARD,2,Novak Djokovic,Dmitry Tursunov,Novak Djokovic,6-2; 4-3 RET,R32,54,8,1,26,39,21,26,7,13,0,1,8,28,39,0,1,26,44,15,26,9,18,4,7,7,24,44
2008-10-26 00:00:00.000,ATP Masters Series Paris France ATP World Tour,HARD,2,Philipp Kohlschreiber,David Ferrer,Philipp Kohlschreiber,6-3; 6-2,R32,73,2,1,48,61,39,48,4,13,6,6,9,43,61,3,1,35,56,21,35,11,21,1,4,8,32,56
2008-10-26 00:00:00.000,ATP Masters Series Paris France ATP World Tour,HARD,2,James Blake,Simone Bolelli,James Blake,6-7(10); 6-3; 6-4,R32,119,17,3,64,102,52,64,21,38,1,2,16,73,102,13,1,54,90,38,54,21,36,1,4,15,59,90
2008-10-26 00:00:00.000,ATP Masters Series Paris France ATP World Tour,HARD,2,Marin Cilic,Marcel Granollers,Marin Cilic,6-4; 7-6(2),R32,96,11,3,34,66,31,34,15,32,0,1,11,46,66,5,2,54,83,36,54,12,29,3,5,11,48,83
2008-10-26 00:00:00.000,ATP Masters Series Paris France ATP World Tour,HARD,2,Roger Federer,Robin Soderling,Roger Federer,6-4; 7-6(7),R32,75,10,0,42,60,38,42,12,18,0,0,11,50,60,5,1,44,68,34,44,13,24,1,2,11,47,68
2008-10-26 00:00:00.000,ATP Masters Series Paris France ATP World Tour,HARD,2,Rafael Nadal,Gael Monfils,Rafael Nadal,6-3; 6-2,R16,91,0,0,35,61,26,35,17,26,9,9,9,43,61,4,2,20,47,13,20,15,27,1,4,8,28,47
2008-10-26 00:00:00.000,ATP Masters Series Paris France ATP World Tour,HARD,2,Nikolay Davydenko,Tomas Berdych,Nikolay Davydenko,6-1; 6-1,R16,64,3,1,30,44,26,30,6,14,5,5,7,32,44,0,3,24,49,11,24,9,25,4,9,7,20,49
2008-10-26 00:00:00.000,ATP Masters Series Paris France ATP World Tour,HARD,2,Andy Murray,Fernando Verdasco,Andy Murray,6-3; 7-6(6),R16,82,10,3,40,62,36,40,14,22,0,0,11,50,62,8,6,37,63,31,37,14,26,0,1,10,45,63
2008-10-26 00:00:00.000,ATP Masters Series Paris France ATP World Tour,HARD,2,David Nalbandian,Juan Martin Del Potro,David Nalbandian,6-4; 6-0,R16,66,6,2,30,47,25,30,8,17,1,2,8,33,47,5,2,30,52,17,30,6,22,6,11,8,23,52
2008-10-26 00:00:00.000,ATP Masters Series Paris France ATP World Tour,HARD,2,Andy Roddick,Gilles Simon,Andy Roddick,6-3; 7-5,R16,78,15,3,36,58,32,36,12,22,4,4,10,44,58,5,1,41,74,29,41,17,33,5,8,11,46,74
2008-10-26 00:00:00.000,ATP Masters Series Paris France ATP World Tour,HARD,2,Jo-Wilfried Tsonga,Novak Djokovic,Jo-Wilfried Tsonga,6-4; 1-6; 6-3,R16,114,5,4,46,82,37,46,18,36,7,9,13,55,82,5,1,52,79,33,52,19,27,7,9,13,52,79
2008-10-26 00:00:00.000,ATP Masters Series Paris France ATP World Tour,HARD,2,James Blake,Philipp Kohlschreiber,James Blake,6-4; 6-4,R16,69,7,1,46,65,36,46,9,19,4,4,10,45,65,3,3,33,54,26,33,10,21,3,5,10,36,54
2008-10-26 00:00:00.000,ATP Masters Series Paris France ATP World Tour,HARD,2,Roger Federer,Marin Cilic,Roger Federer,6-3; 6-4,R16,71,4,0,37,61,26,37,16,24,1,2,10,42,61,7,3,34,59,24,34,9,25,3,6,9,33,59
2008-10-26 00:00:00.000,ATP Masters Series Paris France ATP World Tour,HARD,2,Nikolay Davydenko,Rafael Nadal,Nikolay Davydenko,6-1 RET,Q,48,0,0,14,27,9,14,8,13,3,3,3,17,27,0,1,19,33,10,19,4,14,5,8,4,14,33
2008-10-26 00:00:00.000,ATP Masters Series Paris France ATP World Tour,HARD,2,David Nalbandian,Andy Murray,David Nalbandian,7-6(3); 6-3,Q,104,2,2,35,60,27,35,10,25,3,6,10,37,60,11,4,39,83,28,39,16,44,8,13,11,44,83
2008-10-26 00:00:00.000,ATP Masters Series Paris France ATP World Tour,HARD,2,Jo-Wilfried Tsonga,Andy Roddick,Jo-Wilfried Tsonga,5-7; 6-4; 7-6(5),Q,166,15,6,91,144,61,91,25,53,14,17,17,86,144,14,0,66,99,51,66,17,33,2,5,17,68,99
2008-10-26 00:00:00.000,ATP Masters Series Paris France ATP World Tour,HARD,2,James Blake,Roger Federer,James Blake,W/O,Q,0,0,0,0,0,0,0,0,0,0,0,0,0,0,0,0,0,0,0,0,0,0,0,0,0,0,0
2008-10-26 00:00:00.000,ATP Masters Series Paris France ATP World Tour,HARD,2,David Nalbandian,Nikolay Davydenko,David Nalbandian,6-1; 5-7; 6-4,S,125,3,1,50,85,38,50,20,35,4,6,15,58,85,7,3,41,79,29,41,19,38,4,8,14,48,79
2008-10-26 00:00:00.000,ATP Masters Series Paris France ATP World Tour,HARD,2,Jo-Wilfried Tsonga,James Blake,Jo-Wilfried Tsonga,6-4; 6-3,S,67,12,1,28,44,25,28,11,16,0,0,9,36,44,4,1,43,66,30,43,8,23,4,7,10,38,66
2008-10-26 00:00:00.000,ATP Masters Series Paris France ATP World Tour,HARD,2,Jo-Wilfried Tsonga,David Nalbandian,Jo-Wilfried Tsonga,6-3; 4-6; 6-4,F,120,25,1,57,89,47,57,15,32,8,9,15,62,89,4,4,55,88,41,55,16,33,2,4,14,57,88
