event_time,event_name,surface,num_of_sets,playerA,playerB,winner,score,round,duration_minutes,a_aces,a_double_faults,a_first_serve_hits,a_first_serve_total,a_first_serve_won,a_first_serve_played,a_second_serve_won,a_second_serve_played,a_break_points_saved,a_break_points_total,a_service_games,a_service_points_won,a_service_points_total,b_aces,b_double_faults,b_first_serve_hits,b_first_serve_total,b_first_serve_won,b_first_serve_played,b_second_serve_won,b_second_serve_played,b_break_points_saved,b_break_points_total,b_service_games,b_service_points_won,b_service_points_total
2011-01-02 00:00:00.000,Brisbane Australia ATP World Tour 250,HARD,2,Robin Soderling,Ryan Harrison,Robin Soderling,6-2; 6-4,R32,66,8,3,32,52,26,32,13,20,1,1,9,39,52,4,1,27,50,16,27,12,23,1,4,9,28,50
2011-01-02 00:00:00.000,Brisbane Australia ATP World Tour 250,HARD,2,Michael Berrer,Dudi Sela,Michael Berrer,1-6; 7-6(3); 6-2,R32,152,9,3,54,99,34,54,28,45,8,10,13,62,99,16,4,59,103,42,59,20,44,3,5,14,62,103
2011-01-02 00:00:00.000,Brisbane Australia ATP World Tour 250,HARD,2,Matthew Ebden,John Millman,Matthew Ebden,4-6; 6-2; 6-4,R32,104,12,1,63,85,46,63,9,22,1,3,14,55,85,4,3,58,76,42,58,6,18,4,8,14,48,76
2011-01-02 00:00:00.000,Brisbane Australia ATP World Tour 250,HARD,2,Denis Istomin,Thiemo de Bakker,Denis Istomin,7-6(5); 6-4,R32,93,6,1,43,63,33,43,16,20,2,2,11,49,63,10,1,43,72,31,43,17,29,2,3,11,48,72
2011-01-02 00:00:00.000,Brisbane Australia ATP World Tour 250,HARD,2,Mardy Fish,Adrian Mannarino,Mardy Fish,6-1; 6-4,R32,79,11,0,28,51,23,28,16,23,1,1,9,39,51,1,6,37,68,24,37,11,31,3,6,8,35,68
2011-01-02 00:00:00.000,Brisbane Australia ATP World Tour 250,HARD,2,Radek Stepanek,Tobias Kamke,Radek Stepanek,5-7; 6-1; 6-4,R32,124,7,3,47,80,37,47,16,33,2,5,15,53,80,4,7,50,87,33,50,19,37,5,10,14,52,87
2011-01-02 00:00:00.000,Brisbane Australia ATP World Tour 250,HARD,2,Ricardas Berankis,Arnaud Clement,Ricardas Berankis,6-4; 6-3,R32,86,8,2,30,55,24,30,13,25,1,2,9,37,55,6,3,37,64,26,37,11,27,5,9,10,37,64
2011-01-02 00:00:00.000,Brisbane Australia ATP World Tour 250,HARD,2,Florian Mayer,Bernard Tomic,Florian Mayer,6-2; 6-2,R32,55,12,0,25,35,23,25,9,10,0,0,8,32,35,5,0,34,58,22,34,6,24,1,5,8,28,58
2011-01-02 00:00:00.000,Brisbane Australia ATP World Tour 250,HARD,2,Feliciano Lopez,Philipp Petzschner,Feliciano Lopez,6-4; 7-6(11),R32,100,11,7,39,77,33,39,21,38,4,5,11,54,77,9,5,30,68,25,30,22,38,0,2,11,47,68
2011-01-02 00:00:00.000,Brisbane Australia ATP World Tour 250,HARD,2,Kevin Anderson,Peter Luczak,Kevin Anderson,6-4; 6-4,R32,72,18,0,33,44,31,33,9,11,0,0,10,40,44,4,2,41,58,28,41,10,17,1,3,10,38,58
2011-01-02 00:00:00.000,Brisbane Australia ATP World Tour 250,HARD,2,Santiago Giraldo,Gilles Simon,Santiago Giraldo,6-2; 6-3,R32,86,2,0,57,74,37,57,9,17,5,5,8,46,74,5,2,30,53,22,30,8,23,1,5,9,30,53
2011-01-02 00:00:00.000,Brisbane Australia ATP World Tour 250,HARD,2,Benjamin Becker,Fernando Verdasco,Benjamin Becker,6-1; 6-7(2); 6-3,R32,133,6,4,53,99,42,53,23,46,6,7,15,65,99,10,5,47,78,34,47,14,31,1,5,13,48,78
2011-01-02 00:00:00.000,Brisbane Australia ATP World Tour 250,HARD,2,Marcos Baghdatis,Florent Serra,Marcos Baghdatis,3-6; 7-5; 6-4,R32,142,13,2,46,91,35,46,22,45,3,6,15,57,91,7,2,62,103,44,62,19,41,4,8,16,63,103
2011-01-02 00:00:00.000,Brisbane Australia ATP World Tour 250,HARD,2,Lukasz Kubot,Daniel Brands,Lukasz Kubot,6-2; 6-2,R32,70,7,1,31,51,24,31,13,20,6,6,8,37,51,6,4,29,45,16,29,7,16,1,5,8,23,45
2011-01-02 00:00:00.000,Brisbane Australia ATP World Tour 250,HARD,2,Alexandr Dolgopolov,Igor Andreev,Alexandr Dolgopolov,6-4; 6-2,R32,67,7,3,29,55,26,29,14,26,1,1,9,40,55,2,1,34,55,22,34,9,21,5,8,9,31,55
2011-01-02 00:00:00.000,Brisbane Australia ATP World Tour 250,HARD,2,Andy Roddick,Marinko Matosevic,Andy Roddick,6-3; 6-2,R32,73,5,1,29,47,23,29,13,18,3,4,9,36,47,2,0,22,48,12,22,12,26,2,6,8,24,48
2011-01-02 00:00:00.000,Brisbane Australia ATP World Tour 250,HARD,2,Robin Soderling,Michael Berrer,Robin Soderling,6-3; 7-6(7),R16,96,9,1,51,74,40,51,13,23,2,2,11,53,74,8,1,43,68,32,43,14,25,2,3,10,46,68
2011-01-02 00:00:00.000,Brisbane Australia ATP World Tour 250,HARD,2,Matthew Ebden,Denis Istomin,Matthew Ebden,6-4; 6-4,R16,73,5,1,45,62,32,45,7,17,0,2,10,39,62,1,7,30,56,18,30,14,26,1,5,10,32,56
2011-01-02 00:00:00.000,Brisbane Australia ATP World Tour 250,HARD,2,Radek Stepanek,Mardy Fish,Radek Stepanek,6-3; 6-1,R16,78,3,2,32,45,28,32,6,13,3,3,8,34,45,9,2,40,60,23,40,6,20,6,10,8,29,60
2011-01-02 00:00:00.000,Brisbane Australia ATP World Tour 250,HARD,2,Florian Mayer,Ricardas Berankis,Florian Mayer,6-4; 4-6; 6-4,R16,131,4,1,52,83,33,52,15,31,3,9,15,48,83,6,6,56,109,38,56,20,53,15,22,15,58,109
2011-01-02 00:00:00.000,Brisbane Australia ATP World Tour 250,HARD,2,Kevin Anderson,Feliciano Lopez,Kevin Anderson,6-3; 6-1,R16,56,15,1,27,38,24,27,8,11,0,0,8,32,38,6,0,38,53,22,38,6,15,5,9,8,28,53
2011-01-02 00:00:00.000,Brisbane Australia ATP World Tour 250,HARD,2,Santiago Giraldo,Benjamin Becker,Santiago Giraldo,6-3; 6-4,R16,78,2,0,52,73,36,52,13,21,6,6,10,49,73,7,0,26,43,21,26,10,17,0,2,9,31,43
2011-01-02 00:00:00.000,Brisbane Australia ATP World Tour 250,HARD,2,Marcos Baghdatis,Lukasz Kubot,Marcos Baghdatis,6-2; 6-2,R16,65,5,1,26,47,19,26,12,21,3,4,8,31,47,0,4,26,49,13,26,8,23,4,9,8,21,49
2011-01-02 00:00:00.000,Brisbane Australia ATP World Tour 250,HARD,2,Andy Roddick,Alexandr Dolgopolov,Andy Roddick,6-4; 6-1,R16,57,15,1,30,42,26,30,8,12,2,3,9,34,42,7,3,33,56,21,33,9,23,7,11,8,30,56
2011-01-02 00:00:00.000,Brisbane Australia ATP World Tour 250,HARD,2,Robin Soderling,Matthew Ebden,Robin Soderling,6-3; 6-2,Q,72,9,3,39,55,30,39,7,16,0,0,9,37,55,5,3,39,60,25,39,9,21,3,6,8,34,60
2011-01-02 00:00:00.000,Brisbane Australia ATP World Tour 250,HARD,2,Radek Stepanek,Florian Mayer,Radek Stepanek,6-3; 6-3,Q,83,3,0,24,50,20,24,16,26,1,2,9,36,50,1,2,43,71,27,43,11,28,9,13,9,38,71
2011-01-02 00:00:00.000,Brisbane Australia ATP World Tour 250,HARD,2,Kevin Anderson,Santiago Giraldo,Kevin Anderson,2-6; 6-3; 6-4,Q,114,12,3,54,82,41,54,10,28,6,10,14,51,82,3,1,46,70,34,46,11,24,3,7,13,45,70
2011-01-02 00:00:00.000,Brisbane Australia ATP World Tour 250,HARD,2,Andy Roddick,Marcos Baghdatis,Andy Roddick,6-2; 6-3,Q,74,7,0,31,48,24,31,10,17,3,4,9,34,48,3,0,19,49,15,19,10,30,4,8,8,25,49
2011-01-02 00:00:00.000,Brisbane Australia ATP World Tour 250,HARD,2,Robin Soderling,Radek Stepanek,Robin Soderling,6-3; 7-5,S,82,7,1,36,55,31,36,12,19,0,1,11,43,55,9,3,39,64,27,39,9,25,2,5,10,36,64
2011-01-02 00:00:00.000,Brisbane Australia ATP World Tour 250,HARD,2,Andy Roddick,Kevin Anderson,Andy Roddick,6-2; 4-6; 6-2,S,113,15,1,47,70,41,47,9,23,0,1,13,50,70,13,4,53,82,33,53,16,29,5,9,13,49,82
2011-01-02 00:00:00.000,Brisbane Australia ATP World Tour 250,HARD,2,Robin Soderling,Andy Roddick,Robin Soderling,6-3; 7-5,F,95,16,2,39,54,35,39,9,15,0,0,11,44,54,12,1,44,67,33,44,9,23,8,10,10,42,67
2011-01-03 00:00:00.000,Chennai India ATP World Tour 250,HARD,2,Tomas Berdych,Frederico Gil,Tomas Berdych,6-0; 6-1,R32,45,4,1,22,32,20,22,8,10,0,0,7,28,32,0,1,25,33,10,25,0,8,1,6,6,10,33
2011-01-03 00:00:00.000,Chennai India ATP World Tour 250,HARD,2,Ivan Dodig,Marcos Daniel,Ivan Dodig,6-2; 6-2,R32,70,1,1,26,44,21,26,12,18,0,0,8,33,44,0,3,24,48,15,24,9,24,1,5,8,24,48
2011-01-03 00:00:00.000,Chennai India ATP World Tour 250,HARD,2,Robert Kendrick,Denis Gremelmayr,Robert Kendrick,7-6(1); 6-4,R32,78,12,6,50,72,38,50,12,22,1,2,11,50,72,5,0,46,69,29,46,14,23,4,6,11,43,69
2011-01-03 00:00:00.000,Chennai India ATP World Tour 250,HARD,2,Blaz Kavcic,Jeremy Chardy,Blaz Kavcic,6-3; 6-2,R32,70,1,0,34,45,20,34,9,11,2,4,8,29,45,3,2,30,53,14,30,9,23,2,8,9,23,53
2011-01-03 00:00:00.000,Chennai India ATP World Tour 250,HARD,2,Stanislas Wawrinka,Rohan Bopanna,Stanislas Wawrinka,6-4; 6-4,R32,67,8,5,35,56,28,35,13,21,2,2,10,41,56,7,3,32,60,24,32,13,28,3,5,10,37,60
2011-01-03 00:00:00.000,Chennai India ATP World Tour 250,HARD,2,David Goffin,Somdev Devvarman,David Goffin,6-2; 6-4,R32,86,2,1,39,60,27,39,15,21,3,3,9,42,60,2,1,34,54,21,34,10,20,2,5,9,31,54
2011-01-03 00:00:00.000,Chennai India ATP World Tour 250,HARD,2,Yuichi Sugita,Dustin Brown,Yuichi Sugita,6-4; 2-6; 6-2,R32,89,2,2,48,71,36,48,10,23,1,4,13,46,71,13,3,35,81,23,35,25,46,6,10,13,48,81
2011-01-03 00:00:00.000,Chennai India ATP World Tour 250,HARD,2,Robin Haase,Frank Dancevic,Robin Haase,6-7(6); 6-4; 6-4,R32,145,7,3,68,109,47,68,26,41,6,8,16,73,109,14,2,70,120,47,70,26,50,6,10,16,73,120
2011-01-03 00:00:00.000,Chennai India ATP World Tour 250,HARD,2,Xavier Malisse,Marsel Ilhan,Xavier Malisse,6-3; 6-1,R32,71,4,0,19,38,15,19,12,19,0,2,8,27,38,2,4,34,61,18,34,9,27,8,14,8,27,61
2011-01-03 00:00:00.000,Chennai India ATP World Tour 250,HARD,2,Stephane Robert,Andreas Haider-Maurer,Stephane Robert,6-4; 6-4,R32,71,0,0,26,54,20,26,20,28,3,4,10,40,54,2,7,20,54,16,20,17,34,1,4,10,33,54
2011-01-03 00:00:00.000,Chennai India ATP World Tour 250,HARD,2,Bjorn Phau,Simone Bolelli,Bjorn Phau,6-2; 6-2,R32,74,2,1,24,42,21,24,10,18,1,2,8,31,42,1,0,40,57,21,40,6,17,4,9,8,27,57
2011-01-03 00:00:00.000,Chennai India ATP World Tour 250,HARD,2,Richard Gasquet,Edouard Roger-Vasselin,Richard Gasquet,6-1; 6-3,R32,73,1,0,33,47,27,33,7,14,0,0,8,34,47,3,3,34,58,19,34,10,24,4,8,8,29,58
2011-01-03 00:00:00.000,Chennai India ATP World Tour 250,HARD,2,Janko Tipsarevic,Eduardo Schwank,Janko Tipsarevic,6-3; 6-4,R32,80,9,2,29,53,27,29,14,24,3,3,10,41,53,0,2,34,54,23,34,11,20,2,4,9,34,54
2011-01-03 00:00:00.000,Chennai India ATP World Tour 250,HARD,2,Alexander Kudryavtsev,Yuki Bhambri,Alexander Kudryavtsev,6-2; 6-1,R32,50,4,1,17,36,16,17,10,19,0,1,7,26,36,2,3,24,43,11,24,7,19,4,10,8,18,43
2011-01-03 00:00:00.000,Chennai India ATP World Tour 250,HARD,2,Alejandro Falla,Rui Machado,Alejandro Falla,7-5; 6-3,R32,100,3,3,38,64,25,38,15,26,4,6,10,40,64,1,4,41,70,26,41,11,29,2,7,11,37,70
2011-01-03 00:00:00.000,Chennai India ATP World Tour 250,HARD,2,Kei Nishikori,Marin Cilic,Kei Nishikori,4-6; 7-6(0); 6-2,R32,154,1,2,66,106,51,66,22,40,10,11,15,73,106,5,4,49,92,37,49,23,43,3,5,15,60,92
2011-01-03 00:00:00.000,Chennai India ATP World Tour 250,HARD,2,Tomas Berdych,Ivan Dodig,Tomas Berdych,6-2; 6-4,R16,87,1,1,31,49,23,31,11,18,1,2,9,34,49,6,4,30,57,17,30,12,27,3,7,9,29,57
2011-01-03 00:00:00.000,Chennai India ATP World Tour 250,HARD,2,Blaz Kavcic,Robert Kendrick,Blaz Kavcic,6-2; 6-2,R16,57,4,2,31,43,27,31,6,12,0,0,8,33,43,4,1,23,44,12,23,10,21,1,5,8,22,44
2011-01-03 00:00:00.000,Chennai India ATP World Tour 250,HARD,2,Stanislas Wawrinka,David Goffin,Stanislas Wawrinka,7-6(3); 7-6(3),R16,116,7,2,50,86,35,50,21,36,4,6,12,56,86,5,3,64,91,41,64,15,27,5,7,12,56,91
2011-01-03 00:00:00.000,Chennai India ATP World Tour 250,HARD,2,Robin Haase,Yuichi Sugita,Robin Haase,4-6; 6-3; 6-4,R16,114,10,2,56,91,38,56,20,35,5,8,15,58,91,2,2,47,82,35,47,14,35,2,6,14,49,82
2011-01-03 00:00:00.000,Chennai India ATP World Tour 250,HARD,2,Xavier Malisse,Stephane Robert,Xavier Malisse,6-2; 6-2,R16,58,3,1,26,43,24,26,10,17,0,0,8,34,43,0,3,25,45,18,25,6,20,1,5,8,24,45
2011-01-03 00:00:00.000,Chennai India ATP World Tour 250,HARD,2,Bjorn Phau,Richard Gasquet,Bjorn Phau,1-6; 7-6(5); 7-6(4),R16,151,4,3,63,104,41,63,19,41,8,14,15,60,104,8,6,71,111,51,71,15,40,2,6,16,66,111
2011-01-03 00:00:00.000,Chennai India ATP World Tour 250,HARD,2,Janko Tipsarevic,Alexander Kudryavtsev,Janko Tipsarevic,6-2; 7-6(3),R16,82,7,0,31,56,27,31,19,25,0,0,10,46,56,5,0,47,73,33,47,11,26,3,5,10,44,73
2011-01-03 00:00:00.000,Chennai India ATP World Tour 250,HARD,2,Kei Nishikori,Alejandro Falla,Kei Nishikori,4-6; 6-3; 6-2,R16,129,4,5,53,82,34,53,17,29,4,8,14,51,82,1,5,68,100,38,68,14,32,14,20,13,52,100
2011-01-03 00:00:00.000,Chennai India ATP World Tour 250,HARD,2,Tomas Berdych,Blaz Kavcic,Tomas Berdych,6-3; 6-3,Q,85,3,1,41,59,28,41,6,18,4,6,9,34,59,2,9,34,56,22,34,5,22,4,9,9,27,56
2011-01-03 00:00:00.000,Chennai India ATP World Tour 250,HARD,2,Stanislas Wawrinka,Robin Haase,Stanislas Wawrinka,3-6; 6-3; 6-3,Q,115,7,1,56,82,40,56,14,26,4,6,14,54,82,4,2,59,95,38,59,18,36,11,14,13,56,95
2011-01-03 00:00:00.000,Chennai India ATP World Tour 250,HARD,2,Xavier Malisse,Bjorn Phau,Xavier Malisse,6-0; 6-2,Q,72,5,0,33,53,25,33,12,20,7,7,7,37,53,0,4,32,50,17,32,4,18,1,6,7,21,50
2011-01-03 00:00:00.000,Chennai India ATP World Tour 250,HARD,2,Janko Tipsarevic,Kei Nishikori,Janko Tipsarevic,6-4; 6-4,Q,103,5,0,45,63,29,45,15,18,4,5,10,44,63,1,1,45,68,26,45,14,23,3,6,10,40,68
2011-01-03 00:00:00.000,Chennai India ATP World Tour 250,HARD,2,Stanislas Wawrinka,Tomas Berdych,Stanislas Wawrinka,6-4; 6-1,S,76,7,1,33,50,22,33,12,17,1,1,8,34,50,4,2,34,51,22,34,7,17,1,5,9,29,51
2011-01-03 00:00:00.000,Chennai India ATP World Tour 250,HARD,2,Xavier Malisse,Janko Tipsarevic,Xavier Malisse,3-6; 6-3; 6-2,S,98,8,0,42,63,36,42,11,21,0,2,13,47,63,11,1,49,77,39,49,9,28,4,8,13,48,77
2011-01-03 00:00:00.000,Chennai India ATP World Tour 250,HARD,2,Stanislas Wawrinka,Xavier Malisse,Stanislas Wawrinka,7-5; 4-6; 6-1,F,134,5,0,54,90,40,54,22,36,3,5,15,62,90,1,2,44,83,32,44,21,39,4,8,14,53,83
2011-01-03 00:00:00.000,Doha Qatar ATP World Tour 250,HARD,2,Rafael Nadal,Karol Beck,Rafael Nadal,6-3; 6-0,R32,70,1,2,33,47,26,33,7,14,4,5,8,33,47,4,4,30,53,16,30,6,23,9,14,7,22,53
2011-01-03 00:00:00.000,Doha Qatar ATP World Tour 250,HARD,2,Lukas Lacko,Pere Riba,Lukas Lacko,5-7; 7-6(7); 7-6(4),R32,157,12,4,69,123,54,69,32,54,5,7,18,86,123,19,7,73,134,58,73,31,61,4,5,18,89,134
2011-01-03 00:00:00.000,Doha Qatar ATP World Tour 250,HARD,2,Antonio Veic,Sherif Sabry,Antonio Veic,3-6; 7-5; 6-0,R32,125,1,2,54,81,38,54,11,27,5,9,13,49,81,1,1,47,90,28,47,21,43,5,12,14,49,90
2011-01-03 00:00:00.000,Doha Qatar ATP World Tour 250,HARD,2,Ernests Gulbis,Victor Hanescu,Ernests Gulbis,6-3; 7-6(6),R32,91,11,2,41,63,31,41,13,22,0,2,11,44,63,6,0,51,67,33,51,8,16,1,4,10,41,67
2011-01-03 00:00:00.000,Doha Qatar ATP World Tour 250,HARD,2,Nikolay Davydenko,Fabio Fognini,Nikolay Davydenko,6-1; 6-4,R32,64,6,1,29,46,24,29,12,17,0,0,9,36,46,2,1,31,47,18,31,8,16,2,5,8,26,47
2011-01-03 00:00:00.000,Doha Qatar ATP World Tour 250,HARD,2,Jarkko Nieminen,Michal Przysiezny,Jarkko Nieminen,6-2; 3-6; 6-3,R32,123,7,2,37,63,31,37,18,26,1,2,13,49,63,7,1,72,110,47,72,15,38,11,14,13,62,110
2011-01-03 00:00:00.000,Doha Qatar ATP World Tour 250,HARD,2,Ivo Karlovic,Lukas Rosol,Ivo Karlovic,7-6(5); 7-6(7),R32,113,23,1,65,90,54,65,11,25,7,7,12,65,90,10,2,51,91,40,51,25,40,5,5,12,65,91
2011-01-03 00:00:00.000,Doha Qatar ATP World Tour 250,HARD,2,Philipp Kohlschreiber,Andreas Seppi,Philipp Kohlschreiber,6-2; 6-4,R32,78,3,2,33,55,24,33,16,22,2,2,9,40,55,4,2,32,57,20,32,15,25,2,5,9,35,57
2011-01-03 00:00:00.000,Doha Qatar ATP World Tour 250,HARD,2,Guillermo Garcia-Lopez,Mikhail Kukushkin,Guillermo Garcia-Lopez,6-1; 7-6(1),R32,90,0,3,37,73,25,37,20,36,4,6,10,45,73,3,1,34,56,19,34,9,22,0,4,9,28,56
2011-01-03 00:00:00.000,Doha Qatar ATP World Tour 250,HARD,2,Illya Marchenko,Mischa Zverev,Illya Marchenko,7-6(4); 6-4,R32,113,1,5,49,83,34,49,18,34,4,6,11,52,83,3,1,49,77,28,49,16,28,8,11,11,44,77
2011-01-03 00:00:00.000,Doha Qatar ATP World Tour 250,HARD,2,Sergei Bubka,Daniel Gimeno-Traver,Sergei Bubka,6-0; 6-3,R32,54,10,0,32,43,26,32,7,11,0,0,8,33,43,1,1,27,45,17,27,5,18,2,6,7,22,45
2011-01-03 00:00:00.000,Doha Qatar ATP World Tour 250,HARD,2,Jo-Wilfried Tsonga,Ruben Ramirez Hidalgo,Jo-Wilfried Tsonga,6-2; 6-0,R32,59,10,1,25,36,23,25,5,11,0,0,7,28,36,2,1,27,45,13,27,7,18,4,9,7,20,45
2011-01-03 00:00:00.000,Doha Qatar ATP World Tour 250,HARD,2,Viktor Troicki,Sergiy Stakhovsky,Viktor Troicki,6-4; 7-5,R32,78,5,0,34,54,27,34,17,20,0,0,11,44,54,1,0,41,58,27,41,12,17,1,3,11,39,58
2011-01-03 00:00:00.000,Doha Qatar ATP World Tour 250,HARD,2,Teymuraz Gabashvili,Rainer Schuettler,Teymuraz Gabashvili,6-4; 7-6(2),R32,115,3,1,45,81,32,45,21,36,4,5,11,53,81,6,0,50,74,31,50,13,24,7,9,11,44,74
2011-01-03 00:00:00.000,Doha Qatar ATP World Tour 250,HARD,2,Marco Chiudinelli,Reda El Amrani,Marco Chiudinelli,3-6; 7-6(3); 6-3,R32,133,5,1,69,101,49,69,22,32,6,8,16,71,101,14,5,54,92,40,54,20,38,10,11,14,60,92
2011-01-03 00:00:00.000,Doha Qatar ATP World Tour 250,HARD,2,Roger Federer,Thomas Schoorel,Roger Federer,7-6(3); 6-3,R32,79,13,0,46,70,37,46,16,24,6,6,11,53,70,4,2,43,66,30,43,12,23,1,2,10,42,66
2011-01-03 00:00:00.000,Doha Qatar ATP World Tour 250,HARD,2,Rafael Nadal,Lukas Lacko,Rafael Nadal,7-6(3); 0-6; 6-3,R16,138,9,4,60,93,38,60,13,33,9,14,13,51,93,8,3,56,91,36,56,16,35,5,9,14,52,91
2011-01-03 00:00:00.000,Doha Qatar ATP World Tour 250,HARD,2,Ernests Gulbis,Antonio Veic,Ernests Gulbis,6-3; 6-1,R16,49,10,1,31,38,28,31,5,7,0,0,8,33,38,4,3,30,51,19,30,7,21,5,9,8,26,51
2011-01-03 00:00:00.000,Doha Qatar ATP World Tour 250,HARD,2,Nikolay Davydenko,Jarkko Nieminen,Nikolay Davydenko,6-4; 7-5,R16,95,4,5,45,76,33,45,13,31,5,7,11,46,76,4,2,37,63,25,37,9,26,4,8,11,34,63
2011-01-03 00:00:00.000,Doha Qatar ATP World Tour 250,HARD,2,Ivo Karlovic,Philipp Kohlschreiber,Ivo Karlovic,7-6(5); 6-7(4); 7-6(2),R16,169,28,2,85,128,68,85,26,43,3,3,18,94,128,15,2,78,113,63,78,22,35,0,0,18,85,113
2011-01-03 00:00:00.000,Doha Qatar ATP World Tour 250,HARD,2,Guillermo Garcia-Lopez,Illya Marchenko,Guillermo Garcia-Lopez,6-1; 6-4,R16,83,4,2,37,54,31,37,8,17,1,1,9,39,54,5,4,26,51,17,26,11,25,1,4,8,28,51
2011-01-03 00:00:00.000,Doha Qatar ATP World Tour 250,HARD,2,Jo-Wilfried Tsonga,Sergei Bubka,Jo-Wilfried Tsonga,6-2; 6-4,R16,75,10,2,35,48,31,35,6,13,1,1,9,37,48,7,2,46,70,31,46,8,24,5,8,9,39,70
2011-01-03 00:00:00.000,Doha Qatar ATP World Tour 250,HARD,2,Viktor Troicki,Teymuraz Gabashvili,Viktor Troicki,6-3; 6-1,R16,50,17,0,31,40,29,31,3,9,0,0,8,32,40,2,1,23,38,13,23,6,15,1,5,8,19,38
2011-01-03 00:00:00.000,Doha Qatar ATP World Tour 250,HARD,2,Roger Federer,Marco Chiudinelli,Roger Federer,7-6(5); 7-5,R16,108,7,1,43,67,33,43,17,24,0,1,12,50,67,1,2,52,84,36,52,14,32,3,5,12,50,84
2011-01-03 00:00:00.000,Doha Qatar ATP World Tour 250,HARD,2,Rafael Nadal,Ernests Gulbis,Rafael Nadal,7-6(3); 6-3,Q,111,4,1,37,61,29,37,16,24,5,6,10,45,61,12,2,53,79,36,53,10,26,3,6,11,46,79
2011-01-03 00:00:00.000,Doha Qatar ATP World Tour 250,HARD,2,Nikolay Davydenko,Ivo Karlovic,Nikolay Davydenko,6-3; 7-5,Q,76,2,2,52,64,40,52,6,12,2,2,11,46,64,14,3,38,53,29,38,6,15,1,3,10,35,53
2011-01-03 00:00:00.000,Doha Qatar ATP World Tour 250,HARD,2,Jo-Wilfried Tsonga,Guillermo Garcia-Lopez,Jo-Wilfried Tsonga,7-6(4); 7-6(9),Q,111,11,1,58,88,49,58,14,30,4,6,12,63,88,2,6,51,74,39,51,14,23,0,2,12,53,74
2011-01-03 00:00:00.000,Doha Qatar ATP World Tour 250,HARD,2,Roger Federer,Viktor Troicki,Roger Federer,6-2; 6-2,Q,65,0,0,30,43,24,30,8,13,0,0,8,32,43,5,3,38,64,21,38,11,26,12,16,8,32,64
2011-01-03 00:00:00.000,Doha Qatar ATP World Tour 250,HARD,2,Nikolay Davydenko,Rafael Nadal,Nikolay Davydenko,6-3; 6-2,S,85,5,2,37,56,26,37,9,19,7,9,9,35,56,1,1,39,58,19,39,8,19,5,10,8,27,58
2011-01-03 00:00:00.000,Doha Qatar ATP World Tour 250,HARD,2,Roger Federer,Jo-Wilfried Tsonga,Roger Federer,6-3; 7-6(2),S,85,3,0,40,60,33,40,16,20,0,0,11,49,60,3,1,46,68,29,46,14,22,2,3,10,43,68
2011-01-03 00:00:00.000,Doha Qatar ATP World Tour 250,HARD,2,Roger Federer,Nikolay Davydenko,Roger Federer,6-3; 6-4,F,80,5,1,34,51,27,34,13,17,0,0,10,40,51,5,2,35,61,28,35,8,26,6,8,9,36,61
2011-01-10 00:00:00.000,Auckland New Zealand ATP World Tour 250,HARD,2,David Ferrer,N/A Bye,David Ferrer,,R32,0,0,0,0,0,0,0,0,0,0,0,0,0,0,0,0,0,0,0,0,0,0,0,0,0,0,0
2011-01-10 00:00:00.000,Auckland New Zealand ATP World Tour 250,HARD,2,Tobias Kamke,Pere Riba,Tobias Kamke,6-3; 6-4,R32,66,3,3,33,60,25,33,15,27,4,6,10,40,60,2,0,21,45,13,21,11,24,2,6,9,24,45
2011-01-10 00:00:00.000,Auckland New Zealand ATP World Tour 250,HARD,2,Marcel Granollers,Bobby Reynolds,Marcel Granollers,6-4; 6-3,R32,102,3,2,32,59,24,32,17,27,1,2,10,41,59,6,3,46,77,31,46,11,31,10,13,9,42,77
2011-01-10 00:00:00.000,Auckland New Zealand ATP World Tour 250,HARD,2,Philipp Kohlschreiber,Carlos Berlocq,Philipp Kohlschreiber,2-6; 6-3; 6-1,R32,102,6,5,40,75,26,40,20,35,6,8,12,46,75,5,1,42,67,24,42,16,25,6,10,12,40,67
2011-01-10 00:00:00.000,Auckland New Zealand ATP World Tour 250,HARD,2,Albert Montanes,N/A Bye,Albert Montanes,,R32,0,0,0,0,0,0,0,0,0,0,0,0,0,0,0,0,0,0,0,0,0,0,0,0,0,0,0
2011-01-10 00:00:00.000,Auckland New Zealand ATP World Tour 250,HARD,2,Santiago Giraldo,Daniel Gimeno-Traver,Santiago Giraldo,6-2; 6-4,R32,77,2,0,45,65,32,45,12,20,5,5,9,44,65,2,6,20,50,14,20,14,30,0,3,9,28,50
2011-01-10 00:00:00.000,Auckland New Zealand ATP World Tour 250,HARD,2,Tommy Robredo,Michael Venus,Tommy Robredo,6-7(6); 6-3; 6-0,R32,96,11,0,56,77,41,56,18,21,0,1,14,59,77,7,8,45,80,35,45,11,35,3,8,13,46,80
2011-01-10 00:00:00.000,Auckland New Zealand ATP World Tour 250,HARD,2,Thomaz Bellucci,Michael Russell,Thomaz Bellucci,6-4; 6-7(4); 7-5,R32,168,9,4,61,102,47,61,19,41,4,7,17,66,102,3,5,83,118,57,83,16,35,7,12,17,73,118
2011-01-10 00:00:00.000,Auckland New Zealand ATP World Tour 250,HARD,2,David Nalbandian,Fabio Fognini,David Nalbandian,7-6(3); 6-4,R32,110,3,2,46,70,34,46,14,24,2,3,11,48,70,4,4,58,103,38,58,22,45,12,14,11,60,103
2011-01-10 00:00:00.000,Auckland New Zealand ATP World Tour 250,HARD,2,Philipp Petzschner,Thiemo de Bakker,Philipp Petzschner,6-1; 6-7(5); 7-6(3),R32,136,17,4,63,114,49,63,30,51,2,2,16,79,114,7,0,52,97,38,52,28,45,2,4,15,66,97
2011-01-10 00:00:00.000,Auckland New Zealand ATP World Tour 250,HARD,2,Robin Haase,Pablo Cuevas,Robin Haase,3-6; 7-6(3); 7-6(3),R32,141,7,1,67,108,53,67,18,41,2,5,17,71,108,5,1,74,119,50,74,23,45,3,4,16,73,119
2011-01-10 00:00:00.000,Auckland New Zealand ATP World Tour 250,HARD,2,John Isner,N/A Bye,John Isner,,R32,0,0,0,0,0,0,0,0,0,0,0,0,0,0,0,0,0,0,0,0,0,0,0,0,0,0,0
2011-01-10 00:00:00.000,Auckland New Zealand ATP World Tour 250,HARD,2,Adrian Mannarino,Juan Monaco,Adrian Mannarino,6-4; 6-3,R32,77,4,0,31,49,21,31,11,18,2,5,10,32,49,1,1,39,57,19,39,8,18,6,11,9,27,57
2011-01-10 00:00:00.000,Auckland New Zealand ATP World Tour 250,HARD,2,Arnaud Clement,Xavier Malisse,Arnaud Clement,4-6; 6-2; 7-5,R32,150,7,2,50,89,34,50,23,39,0,3,15,57,89,5,2,63,108,43,63,18,45,9,14,15,61,108
2011-01-10 00:00:00.000,Auckland New Zealand ATP World Tour 250,HARD,2,Victor Hanescu,Kevin Anderson,Victor Hanescu,7-6(7); 6-7(3); 6-4,R32,161,6,0,82,113,54,82,19,31,5,7,17,73,113,10,7,75,116,54,75,22,41,7,10,17,76,116
2011-01-10 00:00:00.000,Auckland New Zealand ATP World Tour 250,HARD,2,Nicolas Almagro,N/A Bye,Nicolas Almagro,,R32,0,0,0,0,0,0,0,0,0,0,0,0,0,0,0,0,0,0,0,0,0,0,0,0,0,0,0
2011-01-10 00:00:00.000,Auckland New Zealand ATP World Tour 250,HARD,2,David Ferrer,Tobias Kamke,David Ferrer,3-6; 7-6(1); 6-4,R16,150,7,1,72,103,49,72,19,31,1,2,15,68,103,1,5,72,119,50,72,25,47,5,6,16,75,119
2011-01-10 00:00:00.000,Auckland New Zealand ATP World Tour 250,HARD,2,Philipp Kohlschreiber,Marcel Granollers,Philipp Kohlschreiber,6-4; 3-6; 6-2,R16,114,10,3,43,69,35,43,12,26,1,3,13,47,69,2,1,47,83,31,47,18,36,4,8,14,49,83
2011-01-10 00:00:00.000,Auckland New Zealand ATP World Tour 250,HARD,2,Santiago Giraldo,Albert Montanes,Santiago Giraldo,6-3; 4-6; 6-4,R16,116,6,3,66,96,45,66,19,30,4,6,15,64,96,6,2,53,81,41,53,12,28,4,7,14,53,81
2011-01-10 00:00:00.000,Auckland New Zealand ATP World Tour 250,HARD,2,Thomaz Bellucci,Tommy Robredo,Thomaz Bellucci,6-4; 3-6; 6-1,R16,108,6,1,48,73,40,48,11,25,3,4,13,51,73,5,3,60,85,40,60,11,25,5,8,13,51,85
2011-01-10 00:00:00.000,Auckland New Zealand ATP World Tour 250,HARD,2,David Nalbandian,Philipp Petzschner,David Nalbandian,6-3; 6-2,R16,63,3,3,30,56,24,30,16,26,4,4,9,40,56,3,2,23,46,19,23,8,23,3,6,8,27,46
2011-01-10 00:00:00.000,Auckland New Zealand ATP World Tour 250,HARD,2,John Isner,Robin Haase,John Isner,3-6; 7-6(4); 7-5,R16,133,22,2,82,124,61,82,19,42,8,10,17,80,124,8,2,54,87,44,54,22,33,0,1,16,66,87
2011-01-10 00:00:00.000,Auckland New Zealand ATP World Tour 250,HARD,2,Adrian Mannarino,Arnaud Clement,Adrian Mannarino,7-5; 6-4,R16,111,4,1,36,59,27,36,15,23,1,3,11,42,59,5,2,48,81,35,48,10,33,6,10,11,45,81
2011-01-10 00:00:00.000,Auckland New Zealand ATP World Tour 250,HARD,2,Nicolas Almagro,Victor Hanescu,Nicolas Almagro,6-4; 7-6(3),R16,98,5,2,39,76,29,39,22,37,5,6,11,51,76,6,1,52,73,37,52,8,21,1,3,11,45,73
2011-01-10 00:00:00.000,Auckland New Zealand ATP World Tour 250,HARD,2,David Ferrer,Philipp Kohlschreiber,David Ferrer,6-3; 6-7(4); 6-3,Q,163,5,2,83,123,59,83,21,40,11,12,16,80,123,4,4,61,117,39,61,28,56,12,15,14,67,117
2011-01-10 00:00:00.000,Auckland New Zealand ATP World Tour 250,HARD,2,Santiago Giraldo,Thomaz Bellucci,Santiago Giraldo,6-2; 6-4,Q,78,5,0,37,56,26,37,11,19,1,2,9,37,56,3,2,32,49,18,32,8,17,2,6,9,26,49
2011-01-10 00:00:00.000,Auckland New Zealand ATP World Tour 250,HARD,2,David Nalbandian,John Isner,David Nalbandian,6-4; 7-6(3),Q,85,4,2,34,65,28,34,22,31,3,3,11,50,65,8,3,53,68,39,53,8,15,0,1,11,47,68
2011-01-10 00:00:00.000,Auckland New Zealand ATP World Tour 250,HARD,2,Nicolas Almagro,Adrian Mannarino,Nicolas Almagro,7-6(3); 6-7(1); 6-2,Q,124,11,3,44,87,38,44,30,43,0,1,16,68,87,3,5,62,100,52,62,15,38,6,9,16,67,100
2011-01-10 00:00:00.000,Auckland New Zealand ATP World Tour 250,HARD,2,David Ferrer,Santiago Giraldo,David Ferrer,6-3; 7-5,S,74,4,0,40,58,32,40,12,18,1,2,11,44,58,2,0,36,52,28,36,6,16,2,5,10,34,52
2011-01-10 00:00:00.000,Auckland New Zealand ATP World Tour 250,HARD,2,David Nalbandian,Nicolas Almagro,David Nalbandian,6-4; 6-2,S,86,1,3,40,65,27,40,16,25,4,4,9,43,65,8,4,35,66,23,35,13,31,3,6,9,36,66
2011-01-10 00:00:00.000,Auckland New Zealand ATP World Tour 250,HARD,2,David Ferrer,David Nalbandian,David Ferrer,6-3; 6-2,F,69,2,1,41,56,30,41,10,15,3,3,9,40,56,2,0,29,49,15,29,12,20,2,5,8,27,49
2011-01-10 00:00:00.000,Sydney Australia ATP World Tour 250,HARD,2,Sam Querrey,N/A Bye,Sam Querrey,,R32,0,0,0,0,0,0,0,0,0,0,0,0,0,0,0,0,0,0,0,0,0,0,0,0,0,0,0
2011-01-10 00:00:00.000,Sydney Australia ATP World Tour 250,HARD,2,Alexandr Dolgopolov,Bernard Tomic,Alexandr Dolgopolov,6-7(3); 6-1; 6-2,R32,85,22,1,45,83,36,45,28,38,5,5,14,64,83,4,5,55,81,38,55,11,26,1,5,13,49,81
2011-01-10 00:00:00.000,Sydney Australia ATP World Tour 250,HARD,2,Frederico Gil,Jarkko Nieminen,Frederico Gil,6-2 RET,R32,32,1,0,19,26,14,19,4,7,4,4,4,18,26,0,0,12,20,6,12,5,8,0,2,4,11,20
2011-01-10 00:00:00.000,Sydney Australia ATP World Tour 250,HARD,2,Gilles Simon,Yen-Hsun Lu,Gilles Simon,6-0; 6-3,R32,57,4,0,26,38,23,26,9,12,0,0,8,32,38,0,1,28,47,16,28,7,19,4,8,7,23,47
2011-01-10 00:00:00.000,Sydney Australia ATP World Tour 250,HARD,2,Ernests Gulbis,N/A Bye,Ernests Gulbis,,R32,0,0,0,0,0,0,0,0,0,0,0,0,0,0,0,0,0,0,0,0,0,0,0,0,0,0,0
2011-01-10 00:00:00.000,Sydney Australia ATP World Tour 250,HARD,2,Igor Andreev,Jeremy Chardy,Igor Andreev,6-2; 6-4,R32,72,4,4,33,56,28,33,11,23,4,5,9,39,56,3,6,26,55,18,26,12,29,4,8,9,30,55
2011-01-10 00:00:00.000,Sydney Australia ATP World Tour 250,HARD,2,Sergiy Stakhovsky,Benjamin Becker,Sergiy Stakhovsky,7-6(3); 7-6(6),R32,105,8,1,52,80,38,52,17,28,4,6,12,55,80,6,4,60,94,39,60,19,34,6,8,12,58,94
2011-01-10 00:00:00.000,Sydney Australia ATP World Tour 250,HARD,2,Guillermo Garcia-Lopez,Chris Guccione,Guillermo Garcia-Lopez,7-6(5); 7-5,R32,110,8,5,55,86,40,55,18,31,4,4,12,58,86,13,3,69,103,51,69,13,34,13,14,12,64,103
2011-01-10 00:00:00.000,Sydney Australia ATP World Tour 250,HARD,2,Richard Gasquet,Matthew Ebden,Richard Gasquet,6-4; 6-3,R32,71,11,1,41,58,33,41,10,17,2,2,10,43,58,3,0,27,56,17,27,16,29,5,7,9,33,56
2011-01-10 00:00:00.000,Sydney Australia ATP World Tour 250,HARD,2,Andreas Seppi,Denis Istomin,Andreas Seppi,6-1; 6-0,R32,51,4,1,27,45,19,27,12,18,1,1,7,31,45,2,1,32,44,14,32,4,12,4,9,6,18,44
2011-01-10 00:00:00.000,Sydney Australia ATP World Tour 250,HARD,2,Juan Ignacio Chela,Radek Stepanek,Juan Ignacio Chela,4-6; 6-0; 6-3,R32,119,5,1,57,88,39,57,18,31,7,9,13,57,88,3,2,39,71,25,39,14,32,3,8,12,39,71
2011-01-10 00:00:00.000,Sydney Australia ATP World Tour 250,HARD,2,Viktor Troicki,N/A Bye,Viktor Troicki,,R32,0,0,0,0,0,0,0,0,0,0,0,0,0,0,0,0,0,0,0,0,0,0,0,0,0,0,0
2011-01-10 00:00:00.000,Sydney Australia ATP World Tour 250,HARD,2,Juan Martin Del Potro,Feliciano Lopez,Juan Martin Del Potro,6-7(5); 7-6(9); 7-6(3),R32,200,21,7,85,148,68,85,33,63,7,8,18,101,148,20,3,66,124,50,66,33,58,2,3,18,83,124
2011-01-10 00:00:00.000,Sydney Australia ATP World Tour 250,HARD,2,Florian Mayer,James Ward,Florian Mayer,7-5; 6-0,R32,70,0,0,33,49,25,33,9,16,2,3,9,34,49,3,5,39,66,21,39,11,27,3,8,9,32,66
2011-01-10 00:00:00.000,Sydney Australia ATP World Tour 250,HARD,2,Potito Starace,Julien Benneteau,Potito Starace,6-7(6); 6-3; 6-4,R32,140,3,2,68,98,40,68,20,30,2,6,16,60,98,4,4,50,95,33,50,18,45,2,8,15,51,95
2011-01-10 00:00:00.000,Sydney Australia ATP World Tour 250,HARD,2,Lukasz Kubot,N/A Bye,Lukasz Kubot,,R32,0,0,0,0,0,0,0,0,0,0,0,0,0,0,0,0,0,0,0,0,0,0,0,0,0,0,0
2011-01-10 00:00:00.000,Sydney Australia ATP World Tour 250,HARD,2,Alexandr Dolgopolov,Sam Querrey,Alexandr Dolgopolov,6-4; 6-3,R16,62,7,2,26,50,21,26,14,24,1,2,9,35,50,4,5,42,70,26,42,11,28,6,10,10,37,70
2011-01-10 00:00:00.000,Sydney Australia ATP World Tour 250,HARD,2,Gilles Simon,Frederico Gil,Gilles Simon,6-1; 6-3,R16,66,4,2,23,42,15,23,13,19,0,2,8,28,42,0,1,28,56,15,28,8,28,4,10,8,23,56
2011-01-10 00:00:00.000,Sydney Australia ATP World Tour 250,HARD,2,Ernests Gulbis,Igor Andreev,Ernests Gulbis,2-6; 6-4; 6-3,R16,140,17,5,45,79,37,45,18,34,1,3,14,55,79,6,5,60,101,42,60,20,41,10,12,13,62,101
2011-01-10 00:00:00.000,Sydney Australia ATP World Tour 250,HARD,2,Sergiy Stakhovsky,Guillermo Garcia-Lopez,Sergiy Stakhovsky,6-3; 6-4,R16,65,8,0,35,48,31,35,9,13,0,0,10,40,48,2,4,30,58,22,30,13,28,3,5,9,35,58
2011-01-10 00:00:00.000,Sydney Australia ATP World Tour 250,HARD,2,Richard Gasquet,Andreas Seppi,Richard Gasquet,3-6; 7-5; 6-4,R16,125,10,3,62,90,45,62,16,28,1,3,16,61,90,8,3,59,103,45,59,21,44,8,10,15,66,103
2011-01-10 00:00:00.000,Sydney Australia ATP World Tour 250,HARD,2,Viktor Troicki,Juan Ignacio Chela,Viktor Troicki,6-2; 6-3,R16,84,8,0,29,45,24,29,11,16,3,3,8,35,45,1,3,45,82,25,45,17,37,7,11,9,42,82
2011-01-10 00:00:00.000,Sydney Australia ATP World Tour 250,HARD,2,Florian Mayer,Juan Martin Del Potro,Florian Mayer,6-2; 7-5,R16,74,10,2,35,49,29,35,11,14,0,0,10,40,49,4,3,26,58,19,26,16,32,1,4,10,35,58
2011-01-10 00:00:00.000,Sydney Australia ATP World Tour 250,HARD,2,Potito Starace,Lukasz Kubot,Potito Starace,7-6(5); 2-6; 6-3,R16,132,7,1,74,102,48,74,15,28,7,11,15,63,102,10,7,49,83,37,49,16,34,4,7,14,53,83
2011-01-10 00:00:00.000,Sydney Australia ATP World Tour 250,HARD,2,Gilles Simon,Alexandr Dolgopolov,Gilles Simon,6-4; 6-3,Q,76,3,2,33,58,27,33,16,25,2,2,10,43,58,4,1,32,58,22,32,13,26,3,5,9,35,58
2011-01-10 00:00:00.000,Sydney Australia ATP World Tour 250,HARD,2,Ernests Gulbis,Sergiy Stakhovsky,Ernests Gulbis,6-4; 6-4,Q,93,3,4,45,74,32,45,16,29,5,6,10,48,74,5,1,37,61,22,37,15,24,4,7,10,37,61
2011-01-10 00:00:00.000,Sydney Australia ATP World Tour 250,HARD,2,Viktor Troicki,Richard Gasquet,Viktor Troicki,6-4; 6-4,Q,77,8,1,33,62,26,33,15,29,3,4,10,41,62,3,1,37,56,24,37,10,19,2,5,10,34,56
2011-01-10 00:00:00.000,Sydney Australia ATP World Tour 250,HARD,2,Florian Mayer,Potito Starace,Florian Mayer,6-4; 6-1,Q,65,3,0,30,47,23,30,9,17,2,4,9,32,47,0,1,33,56,17,33,8,23,1,6,8,25,56
2011-01-10 00:00:00.000,Sydney Australia ATP World Tour 250,HARD,2,Gilles Simon,Ernests Gulbis,Gilles Simon,7-6(1); 6-0,S,73,2,4,31,58,24,31,16,27,1,2,9,40,58,3,4,28,48,17,28,5,20,0,4,9,22,48
2011-01-10 00:00:00.000,Sydney Australia ATP World Tour 250,HARD,2,Viktor Troicki,Florian Mayer,Viktor Troicki,6-4; 7-6(4),S,84,13,4,36,69,32,36,12,33,2,5,11,44,69,2,1,51,73,27,51,15,22,4,8,11,42,73
2011-01-10 00:00:00.000,Sydney Australia ATP World Tour 250,HARD,2,Gilles Simon,Viktor Troicki,Gilles Simon,7-5; 7-6(4),F,119,3,2,46,86,25,46,22,40,3,7,12,47,86,5,3,42,82,30,42,13,40,8,13,12,43,82
2011-01-17 00:00:00.000,Australian Open Australia Grand Slams,HARD,3,Rafael Nadal,Marcos Daniel,Rafael Nadal,6-0; 5-0 RET,R128,47,4,3,19,35,16,19,9,16,4,4,5,25,35,0,0,17,26,2,17,0,9,0,6,6,2,26
2011-01-17 00:00:00.000,Australian Open Australia Grand Slams,HARD,3,Ryan Sweeting,Daniel Gimeno-Traver,Ryan Sweeting,6-4; 6-4; 6-1,R128,111,3,6,84,113,59,84,12,29,11,12,13,71,113,10,2,47,77,31,47,12,30,1,7,14,43,77
2011-01-17 00:00:00.000,Australian Open Australia Grand Slams,HARD,3,Bernard Tomic,Jeremy Chardy,Bernard Tomic,6-3; 6-2; 7-6(5),R128,110,2,3,62,92,44,62,22,30,2,2,15,66,92,12,7,56,92,41,56,14,36,3,6,14,55,92
2011-01-17 00:00:00.000,Australian Open Australia Grand Slams,HARD,3,Feliciano Lopez,Alejandro Falla,Feliciano Lopez,6-3; 7-6(6); 6-3,R128,134,17,6,61,102,46,61,21,41,7,10,16,67,102,6,3,59,95,38,59,16,36,7,12,14,54,95
2011-01-17 00:00:00.000,Australian Open Australia Grand Slams,HARD,3,John Isner,Florent Serra,John Isner,6-3; 7-6(8); 6-3,R128,110,27,4,77,106,62,77,14,29,3,4,16,76,106,4,5,58,92,43,58,17,34,2,5,14,60,92
2011-01-17 00:00:00.000,Australian Open Australia Grand Slams,HARD,3,Radek Stepanek,Denis Gremelmayr,Radek Stepanek,6-3; 6-2; 6-3,R128,84,7,1,37,65,30,37,20,28,2,3,13,50,65,5,1,46,88,27,46,20,42,4,10,13,47,88
2011-01-17 00:00:00.000,Australian Open Australia Grand Slams,HARD,3,Santiago Giraldo,Rui Machado,Santiago Giraldo,6-4; 6-3; 5-7; 6-1,R128,149,7,2,61,100,40,61,24,39,4,9,19,64,100,9,5,76,125,43,76,20,49,4,13,19,63,125
2011-01-17 00:00:00.000,Australian Open Australia Grand Slams,HARD,3,Marin Cilic,Donald Young,Marin Cilic,6-3; 6-2; 6-1,R128,91,8,0,42,67,34,42,16,25,1,1,12,50,67,1,3,47,75,28,47,11,28,5,11,12,39,75
2011-01-17 00:00:00.000,Australian Open Australia Grand Slams,HARD,3,Mikhail Youzhny,Marsel Ilhan,Mikhail Youzhny,6-2; 6-3; 7-6(5),R128,131,3,0,59,89,50,59,20,30,5,5,15,70,89,10,5,61,96,45,61,17,35,5,8,14,62,96
2011-01-17 00:00:00.000,Australian Open Australia Grand Slams,HARD,3,Blaz Kavcic,Kevin Anderson,Blaz Kavcic,2-6; 6-4; 7-6(4); 7-6(5),R128,201,4,2,93,142,69,93,21,49,6,11,21,90,142,23,2,84,131,64,84,23,47,5,9,21,87,131
2011-01-17 00:00:00.000,Australian Open Australia Grand Slams,HARD,3,Milos Raonic,Bjorn Phau,Milos Raonic,7-6(3); 6-3; 7-6(8),R128,127,27,6,68,104,57,68,23,36,0,0,17,80,104,5,3,58,107,44,58,28,49,1,2,16,72,107
2011-01-17 00:00:00.000,Australian Open Australia Grand Slams,HARD,3,Michael Llodra,Juan Ignacio Chela,Michael Llodra,6-3; 3-6; 6-2; 6-4,R128,143,9,5,67,109,50,67,21,42,7,10,18,71,109,3,5,67,112,43,67,19,45,5,11,18,62,112
2011-01-17 00:00:00.000,Australian Open Australia Grand Slams,HARD,3,David Nalbandian,Lleyton Hewitt,David Nalbandian,3-6; 6-4; 3-6; 7-6(1); 9-7,R128,288,7,6,136,210,88,136,37,74,23,29,28,125,210,10,5,103,176,73,103,35,73,6,12,28,108,176
2011-01-17 00:00:00.000,Australian Open Australia Grand Slams,HARD,3,Ricardas Berankis,Marinko Matosevic,Ricardas Berankis,6-4; 6-2; 7-5,R128,113,7,1,50,86,37,50,20,36,1,4,15,57,86,4,4,54,95,31,54,20,41,8,15,15,51,95
2011-01-17 00:00:00.000,Australian Open Australia Grand Slams,HARD,3,Michael Russell,Matthew Ebden,Michael Russell,6-3; 6-2; 5-7; 7-6(9),R128,203,4,3,104,147,69,104,19,43,5,11,21,88,147,13,2,83,133,55,83,20,50,5,13,20,75,133
2011-01-17 00:00:00.000,Australian Open Australia Grand Slams,HARD,3,David Ferrer,Jarkko Nieminen,David Ferrer,6-4; 6-3; 1-6; 6-2,R128,119,4,2,62,89,49,62,15,27,0,3,17,64,89,6,0,60,105,41,60,20,45,6,11,17,61,105
2011-01-17 00:00:00.000,Australian Open Australia Grand Slams,HARD,3,Robin Soderling,Potito Starace,Robin Soderling,6-4; 6-2; 6-2,R128,94,12,0,40,68,35,40,18,28,0,0,13,53,68,4,2,47,80,34,47,10,33,3,8,13,44,80
2011-01-17 00:00:00.000,Australian Open Australia Grand Slams,HARD,3,Gilles Muller,Simon Stadler,Gilles Muller,6-3; 7-6(5); 6-4,R128,134,11,1,74,108,56,74,19,34,6,8,16,75,108,3,1,62,91,40,62,17,29,4,8,15,57,91
2011-01-17 00:00:00.000,Australian Open Australia Grand Slams,HARD,3,Jan Hernych,Denis Istomin,Jan Hernych,6-3; 6-4; 3-6; 6-2,R128,153,4,1,76,116,50,76,26,40,11,13,18,76,116,2,3,81,118,50,81,19,37,10,15,18,69,118
2011-01-17 00:00:00.000,Australian Open Australia Grand Slams,HARD,3,Thomaz Bellucci,Ricardo Mello,Thomaz Bellucci,7-5; 7-5; 4-6; 3-6; 6-3,R128,237,15,9,95,175,73,95,32,80,16,22,26,105,175,4,4,97,165,58,97,38,68,10,17,26,96,165
2011-01-17 00:00:00.000,Australian Open Australia Grand Slams,HARD,3,Benjamin Becker,Ernests Gulbis,Benjamin Becker,7-6(5); 6-2; 6-4,R128,118,12,2,56,93,47,56,20,37,4,5,15,67,93,12,6,65,92,49,65,9,27,2,6,15,58,92
2011-01-17 00:00:00.000,Australian Open Australia Grand Slams,HARD,3,Alexandr Dolgopolov,Mikhail Kukushkin,Alexandr Dolgopolov,6-3; 6-2; 6-4,R128,100,16,3,35,75,31,35,23,40,0,2,14,54,75,1,5,47,79,28,47,11,32,8,14,13,39,79
2011-01-17 00:00:00.000,Australian Open Australia Grand Slams,HARD,3,Andreas Seppi,Arnaud Clement,Andreas Seppi,3-6; 2-6; 7-5; 6-3; 6-2,R128,219,12,5,81,142,60,81,29,61,3,8,23,89,142,5,8,96,169,62,96,38,73,16,22,23,100,169
2011-01-17 00:00:00.000,Australian Open Australia Grand Slams,HARD,3,Jo-Wilfried Tsonga,Philipp Petzschner,Jo-Wilfried Tsonga,4-6; 2-6; 6-2; 6-3; 6-4,R128,195,11,5,109,166,75,109,25,57,13,18,23,100,166,14,7,72,129,52,72,24,57,7,13,22,76,129
2011-01-17 00:00:00.000,Australian Open Australia Grand Slams,HARD,3,Jurgen Melzer,Vincent Millot,Jurgen Melzer,6-2; 6-4; 6-2,R128,108,4,1,48,81,36,48,20,33,2,3,13,56,81,5,3,60,94,29,60,19,34,10,16,13,48,94
2011-01-17 00:00:00.000,Australian Open Australia Grand Slams,HARD,3,Pere Riba,Carsten Ball,Pere Riba,1-6; 7-6(5); 6-2; 2-6; 6-4,R128,172,10,6,72,132,44,72,38,60,3,8,22,82,132,23,11,92,134,70,92,19,42,5,9,23,89,134
2011-01-17 00:00:00.000,Australian Open Australia Grand Slams,HARD,3,Juan Martin Del Potro,Dudi Sela,Juan Martin Del Potro,7-6(13); 6-4; 6-4,R128,159,19,3,71,112,54,71,20,41,3,5,16,74,112,4,1,52,96,37,52,25,44,2,6,16,62,96
2011-01-17 00:00:00.000,Australian Open Australia Grand Slams,HARD,3,Marcos Baghdatis,Grega Zemlja,Marcos Baghdatis,3-6; 7-5; 6-1; 4-6; 6-2,R128,203,15,3,72,137,54,72,35,65,9,13,23,89,137,9,5,87,162,57,87,37,75,15,22,23,94,162
2011-01-17 00:00:00.000,Australian Open Australia Grand Slams,HARD,3,Guillermo Garcia-Lopez,Michael Berrer,Guillermo Garcia-Lopez,6-4; 6-4; 3-6; 6-3,R128,152,8,5,77,118,55,77,19,41,10,14,19,74,118,16,4,86,124,53,86,16,38,5,12,19,69,124
2011-01-17 00:00:00.000,Australian Open Australia Grand Slams,HARD,3,Eduardo Schwank,Leonardo Mayer,Eduardo Schwank,6-2; 6-0; 6-4,R128,102,6,0,36,60,29,36,19,24,0,0,12,48,60,2,5,55,85,31,55,12,30,7,13,12,43,85
2011-01-17 00:00:00.000,Australian Open Australia Grand Slams,HARD,3,Illya Marchenko,Ruben Ramirez Hidalgo,Illya Marchenko,6-3; 6-4; 6-1,R128,133,9,8,49,88,35,49,18,39,11,14,13,53,88,1,5,35,84,21,35,17,49,4,12,13,38,84
2011-01-17 00:00:00.000,Australian Open Australia Grand Slams,HARD,3,Andy Murray,Karol Beck,Andy Murray,6-3; 6-1; 4-2 RET,R128,102,2,3,38,66,33,38,14,28,3,3,11,47,66,5,5,50,83,32,50,12,33,4,9,11,44,83
2011-01-17 00:00:00.000,Australian Open Australia Grand Slams,HARD,3,Tomas Berdych,Marco Crugnola,Tomas Berdych,6-4; 6-0; 6-2,R128,99,2,1,41,65,36,41,10,24,0,1,12,46,65,0,9,50,81,29,50,10,31,4,11,12,39,81
2011-01-17 00:00:00.000,Australian Open Australia Grand Slams,HARD,3,Philipp Kohlschreiber,Tobias Kamke,Philipp Kohlschreiber,1-6; 4-6; 7-6(6); 6-4; 6-4,R128,231,7,2,110,166,68,110,30,56,9,15,24,98,166,6,7,99,170,70,99,38,71,13,18,25,108,170
2011-01-17 00:00:00.000,Australian Open Australia Grand Slams,HARD,3,Adrian Mannarino,Ryan Harrison,Adrian Mannarino,6-4; 6-3; 6-4,R128,106,4,3,47,79,39,47,17,32,3,4,14,56,79,9,2,60,93,36,60,18,33,5,10,15,54,93
2011-01-17 00:00:00.000,Australian Open Australia Grand Slams,HARD,3,Richard Gasquet,Frank Dancevic,Richard Gasquet,6-3; 6-4; 6-4,R128,121,5,2,50,80,36,50,19,30,1,4,15,55,80,2,0,61,96,35,61,17,35,8,14,14,52,96
2011-01-17 00:00:00.000,Australian Open Australia Grand Slams,HARD,3,Florian Mayer,Nikolay Davydenko,Florian Mayer,6-3; 4-6; 7-6(4); 6-4,R128,185,3,2,92,137,63,92,28,45,10,13,20,91,137,4,6,95,149,69,95,23,54,9,14,21,92,149
2011-01-17 00:00:00.000,Australian Open Australia Grand Slams,HARD,3,Kei Nishikori,Fabio Fognini,Kei Nishikori,6-1; 6-4; 6-7(4); 6-4,R128,188,6,3,89,129,61,89,20,40,11,14,19,81,129,3,5,80,134,52,80,22,54,7,15,20,74,134
2011-01-17 00:00:00.000,Australian Open Australia Grand Slams,HARD,3,Janko Tipsarevic,Mischa Zverev,Janko Tipsarevic,6-3; 6-1; 6-4,R128,132,13,4,51,88,43,51,17,37,3,3,13,60,88,7,6,66,101,42,66,12,35,11,16,13,54,101
2011-01-17 00:00:00.000,Australian Open Australia Grand Slams,HARD,3,Fernando Verdasco,Rainer Schuettler,Fernando Verdasco,6-1; 6-3; 6-2,R128,104,8,1,41,68,35,41,16,27,1,1,12,51,68,5,5,48,89,31,48,15,41,8,14,12,46,89
2011-01-17 00:00:00.000,Australian Open Australia Grand Slams,HARD,3,Nicolas Almagro,Stephane Robert,Nicolas Almagro,6-4; 6-3; 6-7(4); 7-5,R128,157,22,4,84,141,67,84,31,57,6,8,22,98,141,7,5,80,132,58,80,25,52,5,10,21,83,132
2011-01-17 00:00:00.000,Australian Open Australia Grand Slams,HARD,3,Igor Andreev,Filippo Volandri,Igor Andreev,6-3; 7-6(3); 6-3,R128,153,6,4,62,107,45,62,17,45,8,14,16,62,107,0,8,62,110,36,62,17,48,10,18,14,53,110
2011-01-17 00:00:00.000,Australian Open Australia Grand Slams,HARD,3,Benoit Paire,Flavio Cipolla,Benoit Paire,6-1; 7-5; 6-1,R128,102,8,3,45,81,38,45,19,36,1,1,13,57,81,2,4,63,95,38,63,13,32,10,16,13,51,95
2011-01-17 00:00:00.000,Australian Open Australia Grand Slams,HARD,3,Ivan Ljubicic,Peter Luczak,Ivan Ljubicic,6-3; 6-3; 7-6(2),R128,152,19,1,58,92,50,58,21,34,5,5,15,71,92,8,2,70,117,50,70,20,47,9,12,15,70,117
2011-01-17 00:00:00.000,Australian Open Australia Grand Slams,HARD,3,Viktor Troicki,Dmitry Tursunov,Viktor Troicki,6-2; 3-6; 6-2; 6-0,R128,142,10,1,54,93,39,54,23,39,4,6,15,62,93,8,4,65,111,37,65,20,46,10,18,16,57,111
2011-01-17 00:00:00.000,Australian Open Australia Grand Slams,HARD,3,Nicolas Mahut,Brian Dabul,Nicolas Mahut,6-3; 6-4; 6-4,R128,111,7,3,57,92,48,57,16,35,3,4,15,64,92,1,0,45,76,26,45,22,31,4,8,14,48,76
2011-01-17 00:00:00.000,Australian Open Australia Grand Slams,HARD,3,Ivan Dodig,Ivo Karlovic,Ivan Dodig,6-4; 3-6; 6-7(5); 6-4; 6-4,R128,177,10,7,85,132,71,85,33,47,2,3,25,104,132,48,6,106,152,85,106,25,46,5,8,26,110,152
2011-01-17 00:00:00.000,Australian Open Australia Grand Slams,HARD,3,Novak Djokovic,Marcel Granollers,Novak Djokovic,6-1; 6-3; 6-1,R128,91,7,1,45,66,34,45,14,21,1,2,12,48,66,3,3,31,65,21,31,8,34,5,12,11,29,65
2011-01-17 00:00:00.000,Australian Open Australia Grand Slams,HARD,3,Andy Roddick,Jan Hajek,Andy Roddick,6-1; 6-2; 6-2,R128,100,18,2,50,74,40,50,13,24,5,5,12,53,74,2,3,43,74,25,43,11,31,7,13,11,36,74
2011-01-17 00:00:00.000,Australian Open Australia Grand Slams,HARD,3,Igor Kunitsyn,Michal Przysiezny,Igor Kunitsyn,6-7(1); 6-4; 6-4; 7-6(6),R128,203,8,1,80,135,53,80,31,55,3,8,22,84,135,16,7,93,159,61,93,28,66,9,16,22,89,159
2011-01-17 00:00:00.000,Australian Open Australia Grand Slams,HARD,3,Robin Haase,Carlos Berlocq,Robin Haase,6-4; 6-3; 7-6(5),R128,148,4,5,60,105,44,60,27,45,4,6,15,71,105,4,3,49,99,35,49,23,50,3,8,16,58,99
2011-01-17 00:00:00.000,Australian Open Australia Grand Slams,HARD,3,Juan Monaco,Simon Greul,Juan Monaco,7-6(5); 7-6(4); 6-2,R128,179,5,1,76,105,51,76,14,29,5,10,16,65,105,4,7,75,128,43,75,22,53,14,21,16,65,128
2011-01-17 00:00:00.000,Australian Open Australia Grand Slams,HARD,3,Stanislas Wawrinka,Teymuraz Gabashvili,Stanislas Wawrinka,7-6(3); 6-4; 6-4,R128,147,11,5,60,111,48,60,27,51,1,2,16,75,111,4,4,58,107,39,58,27,49,7,10,16,66,107
2011-01-17 00:00:00.000,Australian Open Australia Grand Slams,HARD,3,Grigor Dimitrov,Andrey Golubev,Grigor Dimitrov,6-1; 6-4; 6-2,R128,93,2,2,40,70,31,40,23,30,3,3,13,54,70,2,2,52,87,30,52,15,35,8,13,12,45,87
2011-01-17 00:00:00.000,Australian Open Australia Grand Slams,HARD,3,Frederico Gil,Pablo Cuevas,Frederico Gil,6-4; 6-7(7); 4-6; 6-3; 9-7,R128,264,4,3,120,192,81,120,37,72,12,18,29,118,192,20,7,106,190,70,106,40,84,8,16,28,110,190
2011-01-17 00:00:00.000,Australian Open Australia Grand Slams,HARD,3,Gael Monfils,Thiemo de Bakker,Gael Monfils,6-7(5); 2-6; 7-5; 6-2; 6-1,R128,218,13,4,84,131,64,84,23,47,4,9,23,87,131,14,5,123,191,79,123,25,68,19,28,24,104,191
2011-01-17 00:00:00.000,Australian Open Australia Grand Slams,HARD,3,Mardy Fish,Victor Hanescu,Mardy Fish,2-6; 4-6; 6-3; 7-5; 6-3,R128,212,12,3,79,138,60,79,30,59,7,12,24,90,138,10,1,109,146,74,109,19,37,7,13,24,93,146
2011-01-17 00:00:00.000,Australian Open Australia Grand Slams,HARD,3,Tommy Robredo,Somdev Devvarman,Tommy Robredo,7-6(4); 6-3; 6-4,R128,157,9,0,64,104,47,64,24,40,6,8,16,71,104,6,2,71,107,49,71,15,36,8,12,15,64,107
2011-01-17 00:00:00.000,Australian Open Australia Grand Slams,HARD,3,Sergiy Stakhovsky,Daniel Brands,Sergiy Stakhovsky,6-2; 6-3; 6-4,R128,91,7,1,52,77,40,52,13,25,0,2,14,53,77,5,3,48,74,34,48,5,26,4,10,13,39,74
2011-01-17 00:00:00.000,Australian Open Australia Grand Slams,HARD,3,Lukasz Kubot,Sam Querrey,Lukasz Kubot,5-7; 6-2; 3-6; 6-1; 8-6,R128,200,7,8,110,161,83,110,21,51,8,12,25,104,161,19,4,115,172,72,115,29,57,6,13,25,101,172
2011-01-17 00:00:00.000,Australian Open Australia Grand Slams,HARD,3,Albert Montanes,Dustin Brown,Albert Montanes,6-4; 6-2; 3-6; 2-6; 7-5,R128,158,1,3,78,134,53,78,39,56,9,12,23,92,134,29,7,118,172,90,118,17,54,9,13,24,107,172
2011-01-17 00:00:00.000,Australian Open Australia Grand Slams,HARD,3,Xavier Malisse,Pablo Andujar,Xavier Malisse,6-1; 6-2; 7-6(3),R128,121,1,3,49,84,33,49,23,35,1,3,14,56,84,1,0,51,77,27,51,14,26,3,9,13,41,77
2011-01-17 00:00:00.000,Australian Open Australia Grand Slams,HARD,3,Gilles Simon,Yen-Hsun Lu,Gilles Simon,6-7(3); 6-2; 6-4; 6-2,R128,217,6,2,59,123,45,59,38,64,5,6,19,83,123,3,4,75,126,48,75,25,51,5,11,19,73,126
2011-01-17 00:00:00.000,Australian Open Australia Grand Slams,HARD,3,Roger Federer,Lukas Lacko,Roger Federer,6-1; 6-1; 6-3,R128,84,8,1,38,59,33,38,14,21,0,1,12,47,59,3,1,56,83,33,56,6,27,7,14,11,39,83
2011-01-17 00:00:00.000,Australian Open Australia Grand Slams,HARD,3,Rafael Nadal,Ryan Sweeting,Rafael Nadal,6-2; 6-1; 6-1,R64,102,7,4,41,64,34,41,12,23,1,2,11,46,64,2,5,58,78,26,58,8,20,7,15,11,34,78
2011-01-17 00:00:00.000,Australian Open Australia Grand Slams,HARD,3,Bernard Tomic,Feliciano Lopez,Bernard Tomic,7-6(4); 7-6(3); 6-3,R64,129,10,3,65,103,53,65,21,38,6,8,17,74,103,20,1,55,91,39,55,22,36,2,5,16,61,91
2011-01-17 00:00:00.000,Australian Open Australia Grand Slams,HARD,3,John Isner,Radek Stepanek,John Isner,4-6; 6-4; 6-2; 6-1,R64,129,20,5,75,99,59,75,15,24,7,8,18,74,99,3,3,52,88,38,52,19,36,2,7,17,57,88
2011-01-17 00:00:00.000,Australian Open Australia Grand Slams,HARD,3,Marin Cilic,Santiago Giraldo,Marin Cilic,6-3; 7-6(1); 6-1,R64,120,13,7,48,103,40,48,33,55,11,12,15,73,103,2,2,48,71,31,48,12,23,1,5,13,43,71
2011-01-17 00:00:00.000,Australian Open Australia Grand Slams,HARD,3,Mikhail Youzhny,Blaz Kavcic,Mikhail Youzhny,6-3; 6-1; 5-7; 4-6; 6-1,R64,219,14,4,84,146,62,84,34,62,10,13,23,96,146,6,8,88,143,57,88,26,55,3,10,22,83,143
2011-01-17 00:00:00.000,Australian Open Australia Grand Slams,HARD,3,Milos Raonic,Michael Llodra,Milos Raonic,7-6(3); 6-3; 7-6(4),R64,138,21,1,62,95,55,62,22,33,1,2,17,77,95,10,2,66,108,51,66,21,42,4,6,16,72,108
2011-01-17 00:00:00.000,Australian Open Australia Grand Slams,HARD,3,Ricardas Berankis,David Nalbandian,Ricardas Berankis,6-1; 6-0; 2-0 RET,R64,59,8,1,25,43,21,25,13,18,1,1,8,34,43,0,3,29,46,13,29,4,17,6,12,8,17,46
2011-01-17 00:00:00.000,Australian Open Australia Grand Slams,HARD,3,David Ferrer,Michael Russell,David Ferrer,6-0; 6-1; 7-5,R64,109,8,3,39,63,32,39,17,24,0,0,12,49,63,4,4,47,82,31,47,10,35,7,14,13,41,82
2011-01-17 00:00:00.000,Australian Open Australia Grand Slams,HARD,3,Robin Soderling,Gilles Muller,Robin Soderling,6-3; 7-6(1); 6-1,R64,105,6,5,45,78,42,45,22,33,0,0,15,64,78,7,1,45,75,35,45,12,30,1,4,13,47,75
2011-01-17 00:00:00.000,Australian Open Australia Grand Slams,HARD,3,Jan Hernych,Thomaz Bellucci,Jan Hernych,6-2; 6-7(11); 6-4; 6-7(3); 8-6,R64,276,12,6,143,203,98,143,26,60,13,17,28,124,203,25,5,123,196,84,123,29,73,7,15,28,113,196
2011-01-17 00:00:00.000,Australian Open Australia Grand Slams,HARD,3,Alexandr Dolgopolov,Benjamin Becker,Alexandr Dolgopolov,6-3; 6-0; 3-6; 7-6(3),R64,137,18,2,50,93,43,50,31,43,0,1,18,74,93,9,3,63,115,44,63,25,52,5,9,18,69,115
2011-01-17 00:00:00.000,Australian Open Australia Grand Slams,HARD,3,Jo-Wilfried Tsonga,Andreas Seppi,Jo-Wilfried Tsonga,6-3; 7-6(1); 7-6(5),R64,150,20,4,78,121,62,78,19,43,6,8,17,81,121,8,3,55,96,42,55,20,41,3,6,16,62,96
2011-01-17 00:00:00.000,Australian Open Australia Grand Slams,HARD,3,Jurgen Melzer,Pere Riba,Jurgen Melzer,6-2; 6-4; 6-2,R64,103,9,2,49,73,38,49,12,24,0,1,13,50,73,5,6,42,83,27,42,16,41,4,10,13,43,83
2011-01-17 00:00:00.000,Australian Open Australia Grand Slams,HARD,3,Marcos Baghdatis,Juan Martin Del Potro,Marcos Baghdatis,6-1; 6-3; 4-6; 6-3,R64,162,15,5,51,103,45,51,25,52,3,5,18,70,103,9,3,76,109,46,76,17,33,6,12,17,63,109
2011-01-17 00:00:00.000,Australian Open Australia Grand Slams,HARD,3,Guillermo Garcia-Lopez,Eduardo Schwank,Guillermo Garcia-Lopez,6-4; 7-6(8); 6-1,R64,127,4,4,46,85,40,46,24,39,1,2,15,64,85,2,8,72,112,48,72,17,40,5,9,14,65,112
2011-01-17 00:00:00.000,Australian Open Australia Grand Slams,HARD,3,Andy Murray,Illya Marchenko,Andy Murray,6-1; 6-3; 6-3,R64,117,16,0,52,82,41,52,13,30,3,4,13,54,82,5,4,38,71,21,38,13,33,2,8,12,34,71
2011-01-17 00:00:00.000,Australian Open Australia Grand Slams,HARD,3,Tomas Berdych,Philipp Kohlschreiber,Tomas Berdych,4-6; 6-2; 6-3; 6-4,R64,183,10,6,70,121,59,70,25,51,2,3,19,84,121,13,5,74,120,54,74,17,46,5,9,18,71,120
2011-01-17 00:00:00.000,Australian Open Australia Grand Slams,HARD,3,Richard Gasquet,Adrian Mannarino,Richard Gasquet,6-3; 7-6(4); 6-4,R64,132,12,3,65,95,50,65,18,30,2,4,16,68,95,5,3,64,107,39,64,21,43,7,11,15,60,107
2011-01-17 00:00:00.000,Australian Open Australia Grand Slams,HARD,3,Kei Nishikori,Florian Mayer,Kei Nishikori,6-4; 6-3; 0-6; 6-3,R64,144,2,5,66,116,43,66,28,50,6,10,17,71,116,7,5,76,118,52,76,16,42,7,12,17,68,118
2011-01-17 00:00:00.000,Australian Open Australia Grand Slams,HARD,3,Fernando Verdasco,Janko Tipsarevic,Fernando Verdasco,2-6; 4-6; 6-4; 7-6(0); 6-0,R64,232,23,7,97,151,75,97,21,54,15,20,23,96,151,17,6,85,154,57,85,32,69,7,12,23,89,154
2011-01-17 00:00:00.000,Australian Open Australia Grand Slams,HARD,3,Nicolas Almagro,Igor Andreev,Nicolas Almagro,7-5; 2-6; 4-6; 7-6(10); 7-5,R64,234,10,5,87,163,68,87,40,76,6,12,27,108,163,21,5,116,175,86,116,28,59,8,13,27,114,175
2011-01-17 00:00:00.000,Australian Open Australia Grand Slams,HARD,3,Ivan Ljubicic,Benoit Paire,Ivan Ljubicic,6-3; 6-7(2); 6-4; 7-6(5),R64,185,8,1,79,128,53,79,30,49,0,3,21,83,128,13,5,76,145,55,76,32,69,10,16,22,87,145
2011-01-17 00:00:00.000,Australian Open Australia Grand Slams,HARD,3,Viktor Troicki,Nicolas Mahut,Viktor Troicki,6-4; 6-2; 1-6; 6-3,R64,162,12,4,63,118,51,63,18,55,10,15,17,69,118,7,4,78,116,49,78,14,38,10,17,17,63,116
2011-01-17 00:00:00.000,Australian Open Australia Grand Slams,HARD,3,Novak Djokovic,Ivan Dodig,Novak Djokovic,7-5; 6-7(8); 6-0; 6-2,R64,201,9,3,78,121,59,78,27,43,4,5,19,86,121,8,6,84,146,56,84,30,62,13,20,19,86,146
2011-01-17 00:00:00.000,Australian Open Australia Grand Slams,HARD,3,Andy Roddick,Igor Kunitsyn,Andy Roddick,7-6(7); 6-2; 6-3,R64,124,17,5,55,82,47,55,20,27,3,3,15,67,82,4,0,59,91,40,59,19,32,4,7,14,59,91
2011-01-17 00:00:00.000,Australian Open Australia Grand Slams,HARD,3,Robin Haase,Juan Monaco,Robin Haase,6-4; 6-4; 3-6; 6-2,R64,184,9,3,99,148,64,99,23,49,12,17,19,87,148,2,2,84,121,49,84,17,37,8,16,18,66,121
2011-01-17 00:00:00.000,Australian Open Australia Grand Slams,HARD,3,Stanislas Wawrinka,Grigor Dimitrov,Stanislas Wawrinka,7-5; 6-3; 6-3,R64,101,8,0,43,80,33,43,24,37,5,7,15,57,80,2,6,43,82,31,43,17,39,4,10,15,48,82
2011-01-17 00:00:00.000,Australian Open Australia Grand Slams,HARD,3,Gael Monfils,Frederico Gil,Gael Monfils,6-4; 6-3; 1-6; 6-2,R64,149,8,5,70,104,49,70,17,34,3,7,17,66,104,0,0,91,127,50,91,20,36,5,11,17,70,127
2011-01-17 00:00:00.000,Australian Open Australia Grand Slams,HARD,3,Tommy Robredo,Mardy Fish,Tommy Robredo,1-6; 6-3; 6-3; 6-3,R64,153,1,2,76,105,55,76,14,29,5,8,17,69,105,12,5,69,117,48,69,19,48,9,14,17,67,117
2011-01-17 00:00:00.000,Australian Open Australia Grand Slams,HARD,3,Sergiy Stakhovsky,Lukasz Kubot,Sergiy Stakhovsky,6-3; 6-4; 6-4,R64,127,9,5,57,85,38,57,12,28,3,8,15,50,85,5,8,60,92,34,60,10,32,6,14,14,44,92
2011-01-17 00:00:00.000,Australian Open Australia Grand Slams,HARD,3,Xavier Malisse,Albert Montanes,Xavier Malisse,6-4; 6-0; 6-1,R64,99,7,0,33,64,25,33,19,31,2,4,11,44,64,5,3,45,84,22,45,13,39,9,17,12,35,84
2011-01-17 00:00:00.000,Australian Open Australia Grand Slams,HARD,3,Roger Federer,Gilles Simon,Roger Federer,6-2; 6-3; 4-6; 4-6; 6-3,R64,193,11,1,77,126,61,77,21,49,4,9,23,82,126,8,5,88,155,49,88,37,67,10,18,23,86,155
2011-01-17 00:00:00.000,Australian Open Australia Grand Slams,HARD,3,Rafael Nadal,Bernard Tomic,Rafael Nadal,6-2; 7-5; 6-3,R32,150,4,4,56,97,38,56,22,41,6,8,14,60,97,11,3,70,103,42,70,13,33,12,19,15,55,103
2011-01-17 00:00:00.000,Australian Open Australia Grand Slams,HARD,3,Marin Cilic,John Isner,Marin Cilic,4-6; 6-2; 6-7(5); 7-6(2); 9-7,R32,273,22,8,106,186,81,106,54,80,10,11,29,135,186,26,5,128,185,97,128,31,57,6,9,29,128,185
2011-01-17 00:00:00.000,Australian Open Australia Grand Slams,HARD,3,Milos Raonic,Mikhail Youzhny,Milos Raonic,6-4; 7-5; 4-6; 6-4,R32,166,28,2,77,113,55,77,22,36,1,5,21,77,113,3,1,71,117,45,71,26,46,2,8,21,71,117
2011-01-17 00:00:00.000,Australian Open Australia Grand Slams,HARD,3,David Ferrer,Ricardas Berankis,David Ferrer,6-2; 6-2; 6-1,R32,91,5,1,33,57,29,33,14,24,0,1,11,43,57,1,5,52,91,26,52,13,39,11,19,12,39,91
2011-01-17 00:00:00.000,Australian Open Australia Grand Slams,HARD,3,Robin Soderling,Jan Hernych,Robin Soderling,6-3; 6-1; 6-4,R32,118,10,3,45,75,38,45,16,30,2,3,13,54,75,0,1,60,92,32,60,14,32,6,12,13,46,92
2011-01-17 00:00:00.000,Australian Open Australia Grand Slams,HARD,3,Alexandr Dolgopolov,Jo-Wilfried Tsonga,Alexandr Dolgopolov,3-6; 6-3; 3-6; 6-1; 6-1,R32,139,9,3,57,107,45,57,25,50,5,10,20,70,107,6,8,70,116,50,70,15,46,6,15,21,65,116
2011-01-17 00:00:00.000,Australian Open Australia Grand Slams,HARD,3,Jurgen Melzer,Marcos Baghdatis,Jurgen Melzer,6-7(5); 6-2; 6-1; 4-3 RET,R32,141,6,5,76,112,55,76,20,36,6,8,17,75,112,4,0,60,97,38,60,19,37,6,13,17,57,97
2011-01-17 00:00:00.000,Australian Open Australia Grand Slams,HARD,3,Andy Murray,Guillermo Garcia-Lopez,Andy Murray,6-1; 6-1; 6-2,R32,82,10,1,37,58,29,37,12,21,1,2,11,41,58,3,5,45,69,26,45,5,24,3,11,11,31,69
2011-01-17 00:00:00.000,Australian Open Australia Grand Slams,HARD,3,Tomas Berdych,Richard Gasquet,Tomas Berdych,6-2; 7-6(3); 6-2,R32,124,9,1,57,80,44,57,15,23,3,4,14,59,80,10,5,55,101,39,55,18,46,5,10,14,57,101
2011-01-17 00:00:00.000,Australian Open Australia Grand Slams,HARD,3,Fernando Verdasco,Kei Nishikori,Fernando Verdasco,6-2; 6-4; 6-3,R32,120,3,2,59,81,43,59,13,22,3,4,13,56,81,1,3,57,83,36,57,9,26,4,10,14,45,83
2011-01-17 00:00:00.000,Australian Open Australia Grand Slams,HARD,3,Nicolas Almagro,Ivan Ljubicic,Nicolas Almagro,6-4; 7-6(8); 6-3,R32,126,11,2,55,88,46,55,24,33,2,2,16,70,88,11,2,48,87,40,48,21,39,1,3,15,61,87
2011-01-17 00:00:00.000,Australian Open Australia Grand Slams,HARD,3,Novak Djokovic,Viktor Troicki,Novak Djokovic,6-2 RET,R32,40,1,0,17,22,10,17,4,5,0,1,4,14,22,2,1,23,38,15,23,2,15,3,6,4,17,38
2011-01-17 00:00:00.000,Australian Open Australia Grand Slams,HARD,3,Andy Roddick,Robin Haase,Andy Roddick,2-6; 7-6(2); 6-2; 6-2,R32,146,32,3,74,107,58,74,18,33,3,6,18,76,107,10,5,71,115,49,71,19,44,4,9,18,68,115
2011-01-17 00:00:00.000,Australian Open Australia Grand Slams,HARD,3,Stanislas Wawrinka,Gael Monfils,Stanislas Wawrinka,7-6(4); 6-2; 6-3,R32,155,11,2,60,95,45,60,19,35,4,6,14,64,95,3,7,69,120,42,69,22,51,15,21,15,64,120
2011-01-17 00:00:00.000,Australian Open Australia Grand Slams,HARD,3,Tommy Robredo,Sergiy Stakhovsky,Tommy Robredo,5-7; 6-2; 6-4; 6-2,R32,184,3,4,85,136,55,85,29,51,15,19,19,84,136,2,4,82,123,51,82,16,41,6,14,19,67,123
2011-01-17 00:00:00.000,Australian Open Australia Grand Slams,HARD,3,Roger Federer,Xavier Malisse,Roger Federer,6-3; 6-3; 6-1,R32,105,6,1,50,83,35,50,17,33,1,3,13,52,83,4,2,51,85,27,51,12,34,10,17,12,39,85
2011-01-17 00:00:00.000,Australian Open Australia Grand Slams,HARD,3,Rafael Nadal,Marin Cilic,Rafael Nadal,6-2; 6-4; 6-3,R16,151,3,3,62,85,49,62,11,23,2,2,13,60,85,8,4,55,100,42,55,15,45,9,14,14,57,100
2011-01-17 00:00:00.000,Australian Open Australia Grand Slams,HARD,3,David Ferrer,Milos Raonic,David Ferrer,4-6; 6-2; 6-3; 6-4,R16,156,3,1,80,113,62,80,18,33,7,9,19,80,113,15,2,77,127,50,77,26,50,9,14,18,76,127
2011-01-17 00:00:00.000,Australian Open Australia Grand Slams,HARD,3,Alexandr Dolgopolov,Robin Soderling,Alexandr Dolgopolov,1-6; 6-3; 6-1; 4-6; 6-2,R16,156,11,2,55,105,43,55,22,50,3,9,20,65,105,6,6,86,138,51,86,20,52,8,17,21,71,138
2011-01-17 00:00:00.000,Australian Open Australia Grand Slams,HARD,3,Andy Murray,Jurgen Melzer,Andy Murray,6-3; 6-1; 6-1,R16,104,13,3,40,70,33,40,17,30,7,8,12,50,70,1,1,47,72,24,47,8,25,7,14,11,32,72
2011-01-17 00:00:00.000,Australian Open Australia Grand Slams,HARD,3,Tomas Berdych,Fernando Verdasco,Tomas Berdych,6-4; 6-2; 6-3,R16,118,11,1,43,66,38,43,17,23,0,1,14,55,66,10,4,45,79,31,45,15,34,8,13,13,46,79
2011-01-17 00:00:00.000,Australian Open Australia Grand Slams,HARD,3,Novak Djokovic,Nicolas Almagro,Novak Djokovic,6-3; 6-4; 6-0,R16,104,12,4,56,75,48,56,9,19,3,3,13,57,75,5,2,46,78,28,46,14,32,8,13,12,42,78
2011-01-17 00:00:00.000,Australian Open Australia Grand Slams,HARD,3,Stanislas Wawrinka,Andy Roddick,Stanislas Wawrinka,6-3; 6-4; 6-4,R16,142,24,2,39,79,36,39,26,40,3,3,15,62,79,9,4,70,112,50,70,18,42,10,13,14,68,112
2011-01-17 00:00:00.000,Australian Open Australia Grand Slams,HARD,3,Roger Federer,Tommy Robredo,Roger Federer,6-3; 3-6; 6-3; 6-2,R16,145,11,1,73,105,58,73,19,32,1,2,18,77,105,7,1,68,109,49,68,20,41,6,10,17,69,109
2011-01-17 00:00:00.000,Australian Open Australia Grand Slams,HARD,3,David Ferrer,Rafael Nadal,David Ferrer,6-4; 6-2; 6-3,Q,153,8,2,50,73,36,50,13,23,6,8,14,49,73,2,1,69,104,38,69,13,35,8,15,13,51,104
2011-01-17 00:00:00.000,Australian Open Australia Grand Slams,HARD,3,Andy Murray,Alexandr Dolgopolov,Andy Murray,7-5; 6-3; 6-7(3); 6-3,Q,186,9,5,69,118,52,69,30,49,1,5,22,82,118,16,5,92,158,65,92,23,66,11,18,20,88,158
2011-01-17 00:00:00.000,Australian Open Australia Grand Slams,HARD,3,Novak Djokovic,Tomas Berdych,Novak Djokovic,6-1; 7-6(5); 6-1,Q,152,10,1,62,91,51,62,12,29,1,2,14,63,91,6,5,52,96,37,52,15,44,5,10,12,52,96
2011-01-17 00:00:00.000,Australian Open Australia Grand Slams,HARD,3,Roger Federer,Stanislas Wawrinka,Roger Federer,6-1; 6-3; 6-3,Q,107,5,0,58,75,42,58,13,17,1,1,13,55,75,1,0,47,81,27,47,19,34,2,6,12,46,81
2011-01-17 00:00:00.000,Australian Open Australia Grand Slams,HARD,3,Andy Murray,David Ferrer,Andy Murray,4-6; 7-6(2); 6-1; 7-6(2),S,226,9,3,91,151,68,91,22,60,13,18,21,90,151,5,2,94,142,57,94,23,48,5,11,20,80,142
2011-01-17 00:00:00.000,Australian Open Australia Grand Slams,HARD,3,Novak Djokovic,Roger Federer,Novak Djokovic,7-6(3); 7-5; 6-4,S,180,6,5,86,125,63,86,16,39,7,10,17,79,125,5,0,62,105,45,62,20,43,9,14,17,65,105
2011-01-17 00:00:00.000,Australian Open Australia Grand Slams,HARD,3,Novak Djokovic,Andy Murray,Novak Djokovic,6-4; 6-2; 6-3,F,159,5,0,48,75,35,48,15,27,1,4,14,50,75,6,4,59,109,37,59,16,50,11,18,13,53,109
2011-01-31 00:00:00.000,Johannesburg South Africa ATP World Tour 250,HARD,2,Frank Dancevic,Feliciano Lopez,Frank Dancevic,6-7(5); 6-2; 7-6(8),R32,129,22,4,72,115,56,72,26,43,10,10,16,82,115,28,2,62,97,51,62,20,35,2,4,16,71,97
2011-01-31 00:00:00.000,Johannesburg South Africa ATP World Tour 250,HARD,2,Fritz Wolmarans,Igor Sijsling,Fritz Wolmarans,4-6; 6-3; 6-4,R32,93,25,5,57,76,49,57,10,19,1,2,15,59,76,3,5,50,80,39,50,15,30,0,2,14,54,80
2011-01-31 00:00:00.000,Johannesburg South Africa ATP World Tour 250,HARD,2,Denis Gremelmayr,Nikala Scholtz,Denis Gremelmayr,6-4; 7-5,R32,82,7,5,33,58,33,33,14,25,2,2,11,47,58,9,1,37,65,30,37,14,28,3,5,11,44,65
2011-01-31 00:00:00.000,Johannesburg South Africa ATP World Tour 250,HARD,2,Adrian Mannarino,Yuri Schukin,Adrian Mannarino,7-6(4); 7-6(6),R32,134,8,3,40,77,33,40,25,37,2,4,12,58,77,4,5,54,106,39,54,28,52,9,11,12,67,106
2011-01-31 00:00:00.000,Johannesburg South Africa ATP World Tour 250,HARD,2,Kevin Anderson,Stephane Bohli,Kevin Anderson,4-6; 6-4; 6-2,R32,125,14,8,48,84,42,48,18,36,6,7,14,60,84,4,7,41,81,29,41,23,40,2,5,14,52,81
2011-01-31 00:00:00.000,Johannesburg South Africa ATP World Tour 250,HARD,2,Dudi Sela,Edouard Roger-Vasselin,Dudi Sela,1-6; 7-5; 6-4,R32,118,0,6,52,91,39,52,20,39,6,8,14,59,91,4,5,49,89,37,49,21,40,1,3,15,58,89
2011-01-31 00:00:00.000,Johannesburg South Africa ATP World Tour 250,HARD,2,Karol Beck,Brian Dabul,Karol Beck,7-5; 7-6(4),R32,102,5,4,48,81,35,48,19,33,2,3,12,54,81,2,1,38,67,27,38,20,29,1,3,12,47,67
2011-01-31 00:00:00.000,Johannesburg South Africa ATP World Tour 250,HARD,2,Go Soeda,Rainer Schuettler,Go Soeda,3-6; 6-4; 6-4,R32,137,7,5,40,99,30,40,34,59,4,6,14,64,99,5,4,59,95,40,59,21,36,8,11,15,61,95
2011-01-31 00:00:00.000,Johannesburg South Africa ATP World Tour 250,HARD,2,Michal Przysiezny,Martin Fischer,Michal Przysiezny,6-1; 6-2,R32,54,6,3,15,39,13,15,17,24,0,1,8,30,39,2,5,28,44,15,28,3,16,5,10,7,18,44
2011-01-31 00:00:00.000,Johannesburg South Africa ATP World Tour 250,HARD,2,Rik De Voest,Stefano Galvani,Rik De Voest,6-3; 5-7; 7-6(6),R32,160,5,1,59,114,45,59,30,55,6,9,17,75,114,1,6,64,115,41,64,31,51,6,9,16,72,115
2011-01-31 00:00:00.000,Johannesburg South Africa ATP World Tour 250,HARD,2,Somdev Devvarman,Raven Klaasen,Somdev Devvarman,6-4; 6-3,R32,83,1,0,37,50,27,37,12,13,1,1,9,39,50,2,2,45,68,29,45,11,23,6,9,10,40,68
2011-01-31 00:00:00.000,Johannesburg South Africa ATP World Tour 250,HARD,2,Jesse Huta Galung,Janko Tipsarevic,Jesse Huta Galung,6-7(4); 6-4; 7-6(4),R32,163,17,2,79,132,63,79,20,53,7,10,17,83,132,11,2,51,98,41,51,26,47,1,5,17,67,98
2011-01-31 00:00:00.000,Johannesburg South Africa ATP World Tour 250,HARD,2,Dustin Brown,Florent Serra,Dustin Brown,6-4; 6-4,R32,55,15,5,33,51,27,33,11,18,1,2,10,38,51,4,2,43,64,29,43,8,21,8,11,10,37,64
2011-01-31 00:00:00.000,Johannesburg South Africa ATP World Tour 250,HARD,2,Izak Van der Merwe,Stephane Robert,Izak Van der Merwe,6-3; 6-2,R32,66,5,7,30,56,24,30,16,26,1,1,9,40,56,1,6,21,51,16,21,10,30,2,5,8,26,51
2011-01-31 00:00:00.000,Johannesburg South Africa ATP World Tour 250,HARD,2,Simon Greul,Thiago Alves,Simon Greul,6-2; 7-5,R32,78,9,4,28,53,22,28,18,25,0,1,10,40,53,2,7,42,75,28,42,13,33,8,12,10,41,75
2011-01-31 00:00:00.000,Johannesburg South Africa ATP World Tour 250,HARD,2,Milos Raonic,Yen-Hsun Lu,Milos Raonic,6-3; 6-3,R32,76,14,1,27,42,24,27,12,15,0,0,9,36,42,1,5,28,62,21,28,15,34,0,3,9,36,62
2011-01-31 00:00:00.000,Johannesburg South Africa ATP World Tour 250,HARD,2,Frank Dancevic,Fritz Wolmarans,Frank Dancevic,7-6(4); 6-3,R16,96,6,5,44,75,35,44,14,31,1,2,11,49,75,9,3,42,64,28,42,13,22,5,7,10,41,64
2011-01-31 00:00:00.000,Johannesburg South Africa ATP World Tour 250,HARD,2,Adrian Mannarino,Denis Gremelmayr,Adrian Mannarino,6-7(2); 6-4; 6-4,R16,128,3,4,52,93,37,52,24,41,2,4,16,61,93,4,4,54,97,39,54,20,43,5,9,16,59,97
2011-01-31 00:00:00.000,Johannesburg South Africa ATP World Tour 250,HARD,2,Kevin Anderson,Dudi Sela,Kevin Anderson,6-2; 6-4,R16,69,13,2,35,49,27,35,8,14,0,1,9,35,49,1,5,31,51,21,31,4,20,1,5,9,25,51
2011-01-31 00:00:00.000,Johannesburg South Africa ATP World Tour 250,HARD,2,Karol Beck,Go Soeda,Karol Beck,3-6; 7-5; 6-0,R16,127,7,7,45,85,34,45,21,40,3,5,13,55,85,3,5,46,90,25,46,24,44,5,10,14,49,90
2011-01-31 00:00:00.000,Johannesburg South Africa ATP World Tour 250,HARD,2,Rik De Voest,Michal Przysiezny,Rik De Voest,6-3; 6-4,R16,82,4,0,36,67,28,36,17,31,7,8,10,45,67,2,2,25,53,17,25,14,28,3,6,9,31,53
2011-01-31 00:00:00.000,Johannesburg South Africa ATP World Tour 250,HARD,2,Somdev Devvarman,Jesse Huta Galung,Somdev Devvarman,6-3; 6-4,R16,89,3,0,50,72,31,50,16,22,5,6,10,47,72,4,2,31,67,22,31,16,36,3,6,9,38,67
2011-01-31 00:00:00.000,Johannesburg South Africa ATP World Tour 250,HARD,2,Izak Van der Merwe,Dustin Brown,Izak Van der Merwe,4-6; 7-5; 6-3,R16,119,4,14,55,107,40,55,23,52,9,13,16,63,107,9,5,49,90,33,49,22,41,8,13,15,55,90
2011-01-31 00:00:00.000,Johannesburg South Africa ATP World Tour 250,HARD,2,Simon Greul,Milos Raonic,Simon Greul,7-6(5); 6-4,R16,106,7,5,48,83,38,48,20,35,7,7,11,58,83,11,2,41,75,30,41,22,34,5,6,11,52,75
2011-01-31 00:00:00.000,Johannesburg South Africa ATP World Tour 250,HARD,2,Adrian Mannarino,Frank Dancevic,Adrian Mannarino,6-3; 6-2,Q,54,2,2,33,52,26,33,13,19,1,1,9,39,52,3,4,22,40,15,22,7,18,0,3,8,22,40
2011-01-31 00:00:00.000,Johannesburg South Africa ATP World Tour 250,HARD,2,Kevin Anderson,Karol Beck,Kevin Anderson,6-3; 6-1,Q,59,7,1,28,45,22,28,13,17,2,2,8,35,45,7,3,20,43,13,20,9,23,0,4,8,22,43
2011-01-31 00:00:00.000,Johannesburg South Africa ATP World Tour 250,HARD,2,Somdev Devvarman,Rik De Voest,Somdev Devvarman,3-6; 7-6(5); 6-1,Q,145,3,4,51,91,31,51,24,40,4,8,13,55,91,5,3,61,112,43,61,18,51,7,13,15,61,112
2011-01-31 00:00:00.000,Johannesburg South Africa ATP World Tour 250,HARD,2,Izak Van der Merwe,Simon Greul,Izak Van der Merwe,7-6(5); 6-2,Q,101,11,4,43,72,32,43,15,29,2,3,10,47,72,2,7,34,67,22,34,18,33,5,8,10,40,67
2011-01-31 00:00:00.000,Johannesburg South Africa ATP World Tour 250,HARD,2,Kevin Anderson,Adrian Mannarino,Kevin Anderson,6-7(3); 6-0; 6-4,S,124,19,4,47,73,40,47,15,26,1,2,14,55,73,3,2,50,90,32,50,19,40,3,8,14,51,90
2011-01-31 00:00:00.000,Johannesburg South Africa ATP World Tour 250,HARD,2,Somdev Devvarman,Izak Van der Merwe,Somdev Devvarman,6-2; 6-4,S,87,2,0,31,48,24,31,13,17,2,2,9,37,48,5,5,32,68,23,32,16,36,6,9,9,39,68
2011-01-31 00:00:00.000,Johannesburg South Africa ATP World Tour 250,HARD,2,Kevin Anderson,Somdev Devvarman,Kevin Anderson,4-6; 6-3; 6-2,F,139,11,3,60,95,46,60,16,35,7,9,14,62,95,7,1,52,83,35,52,12,31,6,10,13,47,83
2011-01-31 00:00:00.000,Santiago Chile ATP World Tour 250,CLAY,2,David Nalbandian,Carlos Berlocq,David Nalbandian,6-2; 2-6; 6-2,R32,117,2,10,48,95,34,48,22,47,8,11,12,56,95,4,1,40,67,27,40,12,27,3,8,12,39,67
2011-01-31 00:00:00.000,Santiago Chile ATP World Tour 250,CLAY,2,Horacio Zeballos,Ricardo Hocevar,Horacio Zeballos,7-6(2); 6-4,R32,108,7,1,44,72,33,44,17,28,4,5,11,50,72,6,2,47,78,36,47,13,31,1,3,11,49,78
2011-01-31 00:00:00.000,Santiago Chile ATP World Tour 250,CLAY,2,Pablo Andujar,Peter Luczak,Pablo Andujar,6-4; 6-4,R32,93,1,5,34,54,23,34,13,20,2,4,10,36,54,5,5,32,60,22,32,11,28,1,5,10,33,60
2011-01-31 00:00:00.000,Santiago Chile ATP World Tour 250,CLAY,2,Potito Starace,Paul Capdeville,Potito Starace,3-6; 6-3; 6-4,R32,130,5,2,63,89,39,63,14,26,8,11,14,53,89,4,5,48,90,32,48,21,42,6,10,14,53,90
2011-01-31 00:00:00.000,Santiago Chile ATP World Tour 250,CLAY,2,Juan Ignacio Chela,Jorge Aguilar,Juan Ignacio Chela,6-3; 7-5,R32,130,2,4,63,107,41,63,22,44,12,14,11,63,107,1,2,31,63,23,31,11,32,3,7,10,34,63
2011-01-31 00:00:00.000,Santiago Chile ATP World Tour 250,CLAY,2,Caio Zampieri,Nicolas Massu,Caio Zampieri,7-6(7); 7-5,R32,158,5,2,50,83,36,50,16,33,5,7,12,52,83,1,1,60,94,36,60,17,34,6,9,12,53,94
2011-01-31 00:00:00.000,Santiago Chile ATP World Tour 250,CLAY,2,Igor Andreev,Eduardo Schwank,Igor Andreev,6-3; 7-6(4),R32,102,5,1,47,70,35,47,17,23,0,0,11,52,70,3,3,49,68,35,49,10,19,3,4,10,45,68
2011-01-31 00:00:00.000,Santiago Chile ATP World Tour 250,CLAY,2,Santiago Giraldo,Facundo Bagnis,Santiago Giraldo,2-6; 6-3; 6-2,R32,99,2,3,40,74,29,40,19,34,2,5,13,48,74,3,11,31,66,23,31,15,35,2,6,12,38,66
2011-01-31 00:00:00.000,Santiago Chile ATP World Tour 250,CLAY,2,Fabio Fognini,Lukasz Kubot,Fabio Fognini,7-6(6); 6-2,R32,106,2,5,42,64,35,42,10,22,2,3,10,45,64,2,6,36,70,27,36,14,34,4,7,10,41,70
2011-01-31 00:00:00.000,Santiago Chile ATP World Tour 250,CLAY,2,Albert Ramos,Leonardo Mayer,Albert Ramos,6-4; 6-4,R32,86,0,1,30,56,25,30,17,26,3,3,10,42,56,1,5,36,60,26,36,14,24,6,8,10,40,60
2011-01-31 00:00:00.000,Santiago Chile ATP World Tour 250,CLAY,2,Rui Machado,Felipe Rios,Rui Machado,6-2; 6-0,R32,58,2,5,21,42,17,21,12,21,0,0,7,29,42,0,6,29,44,15,29,3,15,0,5,7,18,44
2011-01-31 00:00:00.000,Santiago Chile ATP World Tour 250,CLAY,2,Thomaz Bellucci,Filippo Volandri,Thomaz Bellucci,6-2; 6-2,R32,62,2,3,22,45,15,22,15,23,2,3,8,30,45,1,2,27,49,15,27,7,22,0,5,8,22,49
2011-01-31 00:00:00.000,Santiago Chile ATP World Tour 250,CLAY,2,Tommy Robredo,Frederico Gil,Tommy Robredo,2-6; 6-3; 6-4,R32,112,5,4,49,73,32,49,14,24,5,9,14,46,73,5,3,45,81,31,45,18,36,4,8,13,49,81
2011-01-31 00:00:00.000,Santiago Chile ATP World Tour 250,CLAY,2,Ricardo Mello,Ruben Ramirez Hidalgo,Ricardo Mello,6-4; 6-7(5); 7-6(6),R32,172,3,6,69,122,49,69,23,53,1,5,17,72,122,9,9,63,111,45,63,21,48,3,8,17,66,111
2011-01-31 00:00:00.000,Santiago Chile ATP World Tour 250,CLAY,2,Joao Souza,Pablo Cuevas,Joao Souza,6-4; 7-5,R32,109,5,1,45,77,30,45,13,32,1,4,11,43,77,5,0,45,81,26,45,17,36,5,10,11,43,81
2011-01-31 00:00:00.000,Santiago Chile ATP World Tour 250,CLAY,2,Maximo Gonzalez,Juan Monaco,Maximo Gonzalez,6-4; 3-6; 6-4,R32,164,1,4,57,105,33,57,25,48,7,12,15,58,105,6,6,65,98,43,65,12,33,5,10,14,55,98
2011-01-31 00:00:00.000,Santiago Chile ATP World Tour 250,CLAY,2,Horacio Zeballos,David Nalbandian,Horacio Zeballos,6-2; 7-5,R16,80,8,3,37,65,29,37,11,28,5,7,10,40,65,0,4,34,57,18,34,13,23,4,9,10,31,57
2011-01-31 00:00:00.000,Santiago Chile ATP World Tour 250,CLAY,2,Potito Starace,Pablo Andujar,Potito Starace,6-4; 6-1,R16,87,3,2,43,65,33,43,11,22,5,5,9,44,65,2,5,24,46,18,24,10,22,1,4,8,28,46
2011-01-31 00:00:00.000,Santiago Chile ATP World Tour 250,CLAY,2,Juan Ignacio Chela,Caio Zampieri,Juan Ignacio Chela,6-2; 6-3,R16,84,0,6,30,56,23,30,11,26,4,6,8,34,56,0,4,31,58,17,31,7,27,6,12,9,24,58
2011-01-31 00:00:00.000,Santiago Chile ATP World Tour 250,CLAY,2,Santiago Giraldo,Igor Andreev,Santiago Giraldo,7-6(7); 4-6; 6-2,R16,149,0,1,61,103,42,61,26,42,2,4,15,68,103,8,9,49,99,37,49,25,50,7,10,15,62,99
2011-01-31 00:00:00.000,Santiago Chile ATP World Tour 250,CLAY,2,Fabio Fognini,Albert Ramos,Fabio Fognini,3-6; 7-5; 6-4,R16,176,4,5,68,106,48,68,13,38,11,15,15,61,106,5,7,63,115,45,63,20,52,10,15,16,65,115
2011-01-31 00:00:00.000,Santiago Chile ATP World Tour 250,CLAY,2,Thomaz Bellucci,Rui Machado,Thomaz Bellucci,7-5; 1-6; 6-1,R16,114,3,2,40,75,30,40,20,35,4,6,13,50,75,1,2,58,82,38,58,13,24,5,8,13,51,82
2011-01-31 00:00:00.000,Santiago Chile ATP World Tour 250,CLAY,2,Tommy Robredo,Ricardo Mello,Tommy Robredo,6-0; 7-6(7),R16,85,2,3,31,58,26,31,14,27,4,5,9,40,58,0,4,29,62,21,29,14,33,4,8,9,35,62
2011-01-31 00:00:00.000,Santiago Chile ATP World Tour 250,CLAY,2,Maximo Gonzalez,Joao Souza,Maximo Gonzalez,4-6; 6-3; 6-1,R16,127,2,2,52,78,36,52,18,26,2,3,13,54,78,8,6,43,82,33,43,16,39,6,10,13,49,82
2011-01-31 00:00:00.000,Santiago Chile ATP World Tour 250,CLAY,2,Potito Starace,Horacio Zeballos,Potito Starace,6-7(9); 6-3; 7-6(2),Q,163,3,0,85,115,64,85,20,30,6,6,17,84,115,11,4,73,113,54,73,19,40,5,6,16,73,113
2011-01-31 00:00:00.000,Santiago Chile ATP World Tour 250,CLAY,2,Santiago Giraldo,Juan Ignacio Chela,Santiago Giraldo,6-4; 6-3,Q,86,6,0,38,66,26,38,16,28,4,5,9,42,66,1,3,37,60,23,37,12,23,6,10,10,35,60
2011-01-31 00:00:00.000,Santiago Chile ATP World Tour 250,CLAY,2,Fabio Fognini,Thomaz Bellucci,Fabio Fognini,1-6; 6-2; 7-6(0),Q,140,3,8,65,106,40,65,19,41,7,13,14,59,106,7,2,47,82,34,47,12,35,2,7,13,46,82
2011-01-31 00:00:00.000,Santiago Chile ATP World Tour 250,CLAY,2,Tommy Robredo,Maximo Gonzalez,Tommy Robredo,6-3; 6-1,Q,68,5,1,31,49,26,31,12,18,3,3,8,38,49,1,1,41,53,21,41,5,12,3,7,8,26,53
2011-01-31 00:00:00.000,Santiago Chile ATP World Tour 250,CLAY,2,Santiago Giraldo,Potito Starace,Santiago Giraldo,4-6; 7-6(2); 6-1,S,125,3,1,52,84,40,52,19,32,2,3,14,59,84,2,2,65,101,38,65,22,36,5,8,15,60,101
2011-01-31 00:00:00.000,Santiago Chile ATP World Tour 250,CLAY,2,Tommy Robredo,Fabio Fognini,Tommy Robredo,4-6; 6-2; 6-3,S,128,3,9,54,93,36,54,20,39,10,14,14,56,93,0,6,59,97,42,59,9,38,9,15,13,51,97
2011-01-31 00:00:00.000,Santiago Chile ATP World Tour 250,CLAY,2,Tommy Robredo,Santiago Giraldo,Tommy Robredo,6-2; 2-6; 7-6(5),F,137,3,9,52,97,37,52,20,45,5,9,14,57,97,5,2,43,90,32,43,22,47,3,7,14,54,90
2011-01-31 00:00:00.000,Zagreb Croatia ATP World Tour 250,HARD,2,Marin Cilic,N/A Bye,Marin Cilic,,R32,0,0,0,0,0,0,0,0,0,0,0,0,0,0,0,0,0,0,0,0,0,0,0,0,0,0,0
2011-01-31 00:00:00.000,Zagreb Croatia ATP World Tour 250,HARD,2,Igor Kunitsyn,Jaroslav Pospisil,Igor Kunitsyn,6-3; 6-2,R32,76,3,1,26,42,19,26,7,16,3,6,8,26,42,2,11,29,62,16,29,8,33,7,14,9,24,62
2011-01-31 00:00:00.000,Zagreb Croatia ATP World Tour 250,HARD,2,Radek Stepanek,Stefan Koubek,Radek Stepanek,6-3; 6-2,R32,58,1,1,24,43,15,24,15,19,0,1,8,30,43,0,2,37,50,19,37,4,13,1,6,9,23,50
2011-01-31 00:00:00.000,Zagreb Croatia ATP World Tour 250,HARD,2,Florian Mayer,Franko Skugor,Florian Mayer,3-6; 6-3; 7-6(6),R32,141,5,3,62,99,42,62,20,37,5,8,15,62,99,6,1,75,117,53,75,19,42,12,15,15,72,117
2011-01-31 00:00:00.000,Zagreb Croatia ATP World Tour 250,HARD,2,Richard Gasquet,N/A Bye,Richard Gasquet,,R32,0,0,0,0,0,0,0,0,0,0,0,0,0,0,0,0,0,0,0,0,0,0,0,0,0,0,0
2011-01-31 00:00:00.000,Zagreb Croatia ATP World Tour 250,HARD,2,Arnaud Clement,Mikhail Kukushkin,Arnaud Clement,6-4; 6-3,R32,102,5,3,35,63,25,35,16,28,4,5,9,41,63,2,1,39,68,26,39,12,29,5,9,10,38,68
2011-01-31 00:00:00.000,Zagreb Croatia ATP World Tour 250,HARD,2,Blaz Kavcic,Mischa Zverev,Blaz Kavcic,6-2; 7-5,R32,76,6,2,34,55,24,34,13,21,0,1,10,37,55,1,5,32,53,20,32,8,21,3,7,10,28,53
2011-01-31 00:00:00.000,Zagreb Croatia ATP World Tour 250,HARD,2,Michael Berrer,Nikola Mektic,Michael Berrer,7-5; 6-1,R32,73,8,2,36,56,27,36,14,20,0,0,10,41,56,5,0,33,54,22,33,11,21,1,4,9,33,54
2011-01-31 00:00:00.000,Zagreb Croatia ATP World Tour 250,HARD,2,Philipp Petzschner,Jan Hajek,Philipp Petzschner,6-3; 6-3,R32,72,8,3,23,55,19,23,20,32,1,1,9,39,55,3,2,43,66,24,43,15,23,8,11,9,39,66
2011-01-31 00:00:00.000,Zagreb Croatia ATP World Tour 250,HARD,2,Alex Bogomolov Jr.,Antonio Veic,Alex Bogomolov Jr.,2-6; 7-6(4); 7-6(2),R32,169,1,4,84,117,49,84,18,33,7,13,16,67,117,12,6,64,110,48,64,17,46,10,14,16,65,110
2011-01-31 00:00:00.000,Zagreb Croatia ATP World Tour 250,HARD,2,Lukas Lacko,Marsel Ilhan,Lukas Lacko,4-6; 6-4; 7-5,R32,126,10,8,57,99,44,57,24,42,5,7,16,68,99,8,5,67,101,49,67,16,34,3,6,16,65,101
2011-01-31 00:00:00.000,Zagreb Croatia ATP World Tour 250,HARD,2,Guillermo Garcia-Lopez,N/A Bye,Guillermo Garcia-Lopez,,R32,0,0,0,0,0,0,0,0,0,0,0,0,0,0,0,0,0,0,0,0,0,0,0,0,0,0,0
2011-01-31 00:00:00.000,Zagreb Croatia ATP World Tour 250,HARD,2,Ivan Dodig,Marcel Granollers,Ivan Dodig,6-3; 6-2,R32,66,10,3,26,47,22,26,13,21,2,3,9,35,47,0,2,25,44,15,25,7,19,1,5,8,22,44
2011-01-31 00:00:00.000,Zagreb Croatia ATP World Tour 250,HARD,2,Illya Marchenko,Dusan Lajovic,Illya Marchenko,7-5; 6-2,R32,78,5,2,31,51,21,31,12,20,1,3,10,33,51,3,2,45,68,24,45,7,23,6,11,10,31,68
2011-01-31 00:00:00.000,Zagreb Croatia ATP World Tour 250,HARD,2,Daniel Brands,Ivo Karlovic,Daniel Brands,7-5; 6-7(3); 7-6(1),R32,120,16,2,74,98,64,74,16,24,1,1,18,80,98,32,5,73,101,59,73,18,28,1,2,18,77,101
2011-01-31 00:00:00.000,Zagreb Croatia ATP World Tour 250,HARD,2,Ivan Ljubicic,N/A Bye,Ivan Ljubicic,,R32,0,0,0,0,0,0,0,0,0,0,0,0,0,0,0,0,0,0,0,0,0,0,0,0,0,0,0
2011-01-31 00:00:00.000,Zagreb Croatia ATP World Tour 250,HARD,2,Marin Cilic,Igor Kunitsyn,Marin Cilic,7-6(3); 6-2,R16,98,10,1,32,61,25,32,18,29,1,2,10,43,61,5,2,44,78,28,44,15,34,5,8,10,43,78
2011-01-31 00:00:00.000,Zagreb Croatia ATP World Tour 250,HARD,2,Florian Mayer,Radek Stepanek,Florian Mayer,7-6(3); 6-3,R16,103,3,2,55,82,40,55,17,27,5,5,10,57,82,2,5,48,77,34,48,14,29,4,6,11,48,77
2011-01-31 00:00:00.000,Zagreb Croatia ATP World Tour 250,HARD,2,Richard Gasquet,Arnaud Clement,Richard Gasquet,W/O,R16,0,0,0,0,0,0,0,0,0,0,0,0,0,0,0,0,0,0,0,0,0,0,0,0,0,0,0
2011-01-31 00:00:00.000,Zagreb Croatia ATP World Tour 250,HARD,2,Michael Berrer,Blaz Kavcic,Michael Berrer,6-4; 6-1,R16,71,6,1,31,41,22,31,7,10,1,2,8,29,41,5,2,43,68,23,43,12,25,8,13,9,35,68
2011-01-31 00:00:00.000,Zagreb Croatia ATP World Tour 250,HARD,2,Alex Bogomolov Jr.,Philipp Petzschner,Alex Bogomolov Jr.,6-1; 6-2,R16,53,1,3,34,47,28,34,7,13,1,1,8,35,47,7,3,23,44,12,23,8,21,4,8,7,20,44
2011-01-31 00:00:00.000,Zagreb Croatia ATP World Tour 250,HARD,2,Guillermo Garcia-Lopez,Lukas Lacko,Guillermo Garcia-Lopez,6-1; 2-6; 6-2,R16,87,6,6,36,71,27,36,17,35,5,9,12,44,71,3,1,39,69,22,39,11,30,2,8,11,33,69
2011-01-31 00:00:00.000,Zagreb Croatia ATP World Tour 250,HARD,2,Ivan Dodig,Illya Marchenko,Ivan Dodig,6-2; 6-3,R16,80,3,0,34,52,27,34,9,18,2,3,9,36,52,0,4,28,50,21,28,7,22,3,7,8,28,50
2011-01-31 00:00:00.000,Zagreb Croatia ATP World Tour 250,HARD,2,Ivan Ljubicic,Daniel Brands,Ivan Ljubicic,6-2; 6-3,R16,68,7,2,26,51,22,26,17,25,0,0,9,39,51,4,1,36,59,21,36,11,23,2,5,8,32,59
2011-01-31 00:00:00.000,Zagreb Croatia ATP World Tour 250,HARD,2,Florian Mayer,Marin Cilic,Florian Mayer,6-3; 6-4,Q,81,3,1,43,64,29,43,13,21,4,5,10,42,64,5,4,31,51,22,31,8,20,1,4,9,30,51
2011-01-31 00:00:00.000,Zagreb Croatia ATP World Tour 250,HARD,2,Michael Berrer,Richard Gasquet,Michael Berrer,5-2 RET,Q,34,1,1,13,22,11,13,5,9,2,2,3,16,22,3,0,23,34,13,23,4,11,4,6,4,17,34
2011-01-31 00:00:00.000,Zagreb Croatia ATP World Tour 250,HARD,2,Guillermo Garcia-Lopez,Alex Bogomolov Jr.,Guillermo Garcia-Lopez,6-2; 7-6(6),Q,99,12,3,47,79,36,47,15,32,9,11,10,51,79,2,2,54,68,34,54,5,14,2,6,10,39,68
2011-01-31 00:00:00.000,Zagreb Croatia ATP World Tour 250,HARD,2,Ivan Dodig,Ivan Ljubicic,Ivan Dodig,6-4; 6-4,Q,110,8,1,44,74,37,44,14,30,4,4,10,51,74,4,1,42,73,29,42,14,31,7,9,10,43,73
2011-01-31 00:00:00.000,Zagreb Croatia ATP World Tour 250,HARD,2,Michael Berrer,Florian Mayer,Michael Berrer,6-1; 6-4,S,59,7,1,32,47,28,32,10,15,1,1,9,38,47,1,1,42,60,22,42,9,18,5,8,8,31,60
2011-01-31 00:00:00.000,Zagreb Croatia ATP World Tour 250,HARD,2,Ivan Dodig,Guillermo Garcia-Lopez,Ivan Dodig,4-6; 7-6(5); 6-4,S,172,10,4,63,106,52,63,17,43,7,10,16,69,106,7,5,59,106,42,59,26,47,7,10,16,68,106
2011-01-31 00:00:00.000,Zagreb Croatia ATP World Tour 250,HARD,2,Ivan Dodig,Michael Berrer,Ivan Dodig,6-3; 6-4,F,98,16,7,55,83,45,55,8,28,7,7,10,53,83,2,1,40,55,29,40,6,15,1,3,9,35,55
2011-02-07 00:00:00.000,Costa Do Sauipe Brazil ATP World Tour 250,CLAY,2,Nicolas Almagro,N/A Bye,Nicolas Almagro,,R32,0,0,0,0,0,0,0,0,0,0,0,0,0,0,0,0,0,0,0,0,0,0,0,0,0,0,0
2011-02-07 00:00:00.000,Costa Do Sauipe Brazil ATP World Tour 250,CLAY,2,Joao Souza,Guilherme Clezar,Joao Souza,6-3; 6-2,R32,71,5,1,33,48,25,33,13,15,1,1,9,38,48,3,1,41,54,23,41,6,13,2,5,8,29,54
2011-02-07 00:00:00.000,Costa Do Sauipe Brazil ATP World Tour 250,CLAY,2,Rui Machado,Facundo Bagnis,Rui Machado,6-4; 6-2,R32,102,2,1,53,70,38,53,8,17,7,7,9,46,70,1,3,32,65,20,32,17,33,5,8,9,37,65
2011-02-07 00:00:00.000,Costa Do Sauipe Brazil ATP World Tour 250,CLAY,2,Filippo Volandri,Victor Hanescu,Filippo Volandri,7-5; 6-1,R32,88,0,2,55,72,38,55,8,17,2,3,10,46,72,0,1,37,53,21,37,6,16,1,5,9,27,53
2011-02-07 00:00:00.000,Costa Do Sauipe Brazil ATP World Tour 250,CLAY,2,Thomaz Bellucci,N/A Bye,Thomaz Bellucci,,R32,0,0,0,0,0,0,0,0,0,0,0,0,0,0,0,0,0,0,0,0,0,0,0,0,0,0,0
2011-02-07 00:00:00.000,Costa Do Sauipe Brazil ATP World Tour 250,CLAY,2,Carlos Berlocq,Andre Ghem,Carlos Berlocq,6-4; 6-3,R32,89,2,2,27,50,23,27,14,23,1,1,9,37,50,3,1,32,58,23,32,12,26,2,5,10,35,58
2011-02-07 00:00:00.000,Costa Do Sauipe Brazil ATP World Tour 250,CLAY,2,Lukasz Kubot,Eduardo Schwank,Lukasz Kubot,6-7(5); 7-5; 7-6(2),R32,189,6,5,66,118,52,66,25,52,4,7,18,77,118,4,2,76,119,48,76,28,43,7,11,18,76,119
2011-02-07 00:00:00.000,Costa Do Sauipe Brazil ATP World Tour 250,CLAY,2,Juan Ignacio Chela,Rogerio Dutra Silva,Juan Ignacio Chela,6-7(4); 7-6(4); 6-3,R32,177,2,1,75,100,56,75,14,25,1,2,16,70,100,6,1,75,117,55,75,19,42,5,8,17,74,117
2011-02-07 00:00:00.000,Costa Do Sauipe Brazil ATP World Tour 250,CLAY,2,Potito Starace,Pablo Cuevas,Potito Starace,6-4; 5-7; 6-4,R32,129,3,1,70,85,51,70,6,15,1,5,16,57,85,4,3,67,109,47,67,17,42,7,12,16,64,109
2011-02-07 00:00:00.000,Costa Do Sauipe Brazil ATP World Tour 250,CLAY,2,Leonardo Mayer,Igor Andreev,Leonardo Mayer,4-6; 6-4; 7-6(2),R32,154,4,5,55,96,42,55,23,41,6,8,16,65,96,5,2,54,104,44,54,24,50,5,7,16,68,104
2011-02-07 00:00:00.000,Costa Do Sauipe Brazil ATP World Tour 250,CLAY,2,Ruben Ramirez Hidalgo,Fernando Romboli,Ruben Ramirez Hidalgo,6-4; 6-2,R32,78,2,2,30,52,24,30,12,22,0,1,9,36,52,1,3,29,53,17,29,11,24,2,6,9,28,53
2011-02-07 00:00:00.000,Costa Do Sauipe Brazil ATP World Tour 250,CLAY,2,Alexandr Dolgopolov,N/A Bye,Alexandr Dolgopolov,,R32,0,0,0,0,0,0,0,0,0,0,0,0,0,0,0,0,0,0,0,0,0,0,0,0,0,0,0
2011-02-07 00:00:00.000,Costa Do Sauipe Brazil ATP World Tour 250,CLAY,2,Tommy Robredo,Fabio Fognini,Tommy Robredo,6-3; 6-7(4); 6-3,R32,151,9,1,57,91,43,57,23,34,3,5,16,66,91,2,2,58,103,37,58,25,45,9,13,14,62,103
2011-02-07 00:00:00.000,Costa Do Sauipe Brazil ATP World Tour 250,CLAY,2,Pablo Andujar,Daniel Gimeno-Traver,Pablo Andujar,6-3; 6-1,R32,78,0,0,37,50,25,37,9,13,1,1,8,34,50,1,6,38,65,21,38,13,27,4,8,8,34,65
2011-02-07 00:00:00.000,Costa Do Sauipe Brazil ATP World Tour 250,CLAY,2,Ricardo Mello,Santiago Giraldo,Ricardo Mello,6-4; 6-3,R32,73,2,0,37,62,29,37,14,25,5,6,10,43,62,5,1,30,49,21,30,9,19,4,7,9,30,49
2011-02-07 00:00:00.000,Costa Do Sauipe Brazil ATP World Tour 250,CLAY,2,Albert Montanes,N/A Bye,Albert Montanes,,R32,0,0,0,0,0,0,0,0,0,0,0,0,0,0,0,0,0,0,0,0,0,0,0,0,0,0,0
2011-02-07 00:00:00.000,Costa Do Sauipe Brazil ATP World Tour 250,CLAY,2,Nicolas Almagro,Joao Souza,Nicolas Almagro,6-2; 6-2,R16,71,7,1,21,51,18,21,17,30,1,1,8,35,51,3,1,28,48,18,28,7,20,4,8,8,25,48
2011-02-07 00:00:00.000,Costa Do Sauipe Brazil ATP World Tour 250,CLAY,2,Rui Machado,Filippo Volandri,Rui Machado,6-2; 6-1,R16,72,0,1,32,38,24,32,4,6,0,0,7,28,38,0,1,32,55,19,32,7,23,8,13,8,26,55
2011-02-07 00:00:00.000,Costa Do Sauipe Brazil ATP World Tour 250,CLAY,2,Thomaz Bellucci,Carlos Berlocq,Thomaz Bellucci,6-4; 7-5,R16,104,6,3,36,60,31,36,10,24,2,4,11,41,60,2,1,41,66,25,41,12,25,4,8,11,37,66
2011-02-07 00:00:00.000,Costa Do Sauipe Brazil ATP World Tour 250,CLAY,2,Juan Ignacio Chela,Lukasz Kubot,Juan Ignacio Chela,3-6; 7-5; 6-3,R16,164,1,1,61,98,39,61,17,37,7,12,15,56,98,4,6,69,104,44,69,13,35,6,12,15,57,104
2011-02-07 00:00:00.000,Costa Do Sauipe Brazil ATP World Tour 250,CLAY,2,Potito Starace,Leonardo Mayer,Potito Starace,6-4; 7-6(9),R16,109,2,0,61,79,43,61,11,18,1,1,11,54,79,3,1,55,74,41,55,9,19,2,3,11,50,74
2011-02-07 00:00:00.000,Costa Do Sauipe Brazil ATP World Tour 250,CLAY,2,Alexandr Dolgopolov,Ruben Ramirez Hidalgo,Alexandr Dolgopolov,7-5; 6-4,R16,97,14,1,39,66,31,39,17,27,2,2,11,48,66,5,1,40,70,30,40,14,30,4,6,11,44,70
2011-02-07 00:00:00.000,Costa Do Sauipe Brazil ATP World Tour 250,CLAY,2,Pablo Andujar,Tommy Robredo,Pablo Andujar,6-4; 5-7; 6-2,R16,152,1,2,77,109,47,77,19,32,8,11,15,66,109,4,2,48,82,32,48,20,34,3,8,15,52,82
2011-02-07 00:00:00.000,Costa Do Sauipe Brazil ATP World Tour 250,CLAY,2,Ricardo Mello,Albert Montanes,Ricardo Mello,6-3; 6-3,R16,66,2,0,27,43,24,27,12,16,0,0,9,36,43,1,4,33,59,24,33,11,26,3,6,9,35,59
2011-02-07 00:00:00.000,Costa Do Sauipe Brazil ATP World Tour 250,CLAY,2,Nicolas Almagro,Rui Machado,Nicolas Almagro,6-2; 6-4,Q,86,12,9,34,72,27,34,16,38,6,8,9,43,72,1,1,38,49,21,38,2,11,4,9,9,23,49
2011-02-07 00:00:00.000,Costa Do Sauipe Brazil ATP World Tour 250,CLAY,2,Juan Ignacio Chela,Thomaz Bellucci,Juan Ignacio Chela,6-1; 6-2,Q,81,0,1,34,53,24,34,12,19,3,3,8,36,53,4,3,24,40,13,24,7,16,4,8,7,20,40
2011-02-07 00:00:00.000,Costa Do Sauipe Brazil ATP World Tour 250,CLAY,2,Alexandr Dolgopolov,Potito Starace,Alexandr Dolgopolov,6-3; 6-4,Q,74,10,3,30,63,24,30,17,33,6,7,10,41,63,3,1,41,53,24,41,6,12,0,3,9,30,53
2011-02-07 00:00:00.000,Costa Do Sauipe Brazil ATP World Tour 250,CLAY,2,Ricardo Mello,Pablo Andujar,Ricardo Mello,6-1; 6-0,Q,59,4,0,29,43,21,29,10,14,1,1,7,31,43,1,4,18,33,7,18,3,15,0,5,6,10,33
2011-02-07 00:00:00.000,Costa Do Sauipe Brazil ATP World Tour 250,CLAY,2,Nicolas Almagro,Juan Ignacio Chela,Nicolas Almagro,1-6; 6-2; 6-4,S,99,4,0,45,69,33,45,14,24,2,4,12,47,69,4,0,48,69,31,48,13,21,5,8,13,44,69
2011-02-07 00:00:00.000,Costa Do Sauipe Brazil ATP World Tour 250,CLAY,2,Alexandr Dolgopolov,Ricardo Mello,Alexandr Dolgopolov,6-2; 6-1,S,59,4,2,28,46,23,28,10,18,3,3,7,33,46,0,1,26,47,14,26,7,21,4,9,8,21,47
2011-02-07 00:00:00.000,Costa Do Sauipe Brazil ATP World Tour 250,CLAY,2,Nicolas Almagro,Alexandr Dolgopolov,Nicolas Almagro,6-3; 7-6(3),F,89,3,1,39,71,30,39,20,32,0,0,11,50,71,5,1,31,56,24,31,17,25,4,5,10,41,56
2011-02-07 00:00:00.000,Rotterdam The Netherlands ATP World Tour 500,HARD,2,Robin Soderling,Robin Haase,Robin Soderling,6-3; 6-2,R32,53,8,0,29,42,26,29,10,13,0,0,9,36,42,11,1,31,48,20,31,8,17,7,10,8,28,48
2011-02-07 00:00:00.000,Rotterdam The Netherlands ATP World Tour 500,HARD,2,Philipp Kohlschreiber,Yen-Hsun Lu,Philipp Kohlschreiber,6-4; 7-6(5),R32,88,6,1,45,60,36,45,11,15,0,1,11,47,60,2,1,43,64,31,43,12,21,1,3,11,43,64
2011-02-07 00:00:00.000,Rotterdam The Netherlands ATP World Tour 500,HARD,2,Thiemo de Bakker,Philipp Petzschner,Thiemo de Bakker,6-4; 0-6; 6-1,R32,88,5,1,36,75,24,36,23,39,2,5,12,47,75,8,3,38,67,30,38,13,29,4,7,11,43,67
2011-02-07 00:00:00.000,Rotterdam The Netherlands ATP World Tour 500,HARD,2,Mikhail Youzhny,Marcel Granollers,Mikhail Youzhny,6-2; 7-6(6),R32,95,2,5,37,64,29,37,12,27,0,2,10,41,64,2,3,35,68,21,35,18,33,5,9,10,39,68
2011-02-07 00:00:00.000,Rotterdam The Netherlands ATP World Tour 500,HARD,2,Jarkko Nieminen,David Ferrer,Jarkko Nieminen,6-3; 6-4,R32,75,1,2,38,66,30,38,11,28,4,6,10,41,66,7,5,39,56,23,39,7,17,6,10,9,30,56
2011-02-07 00:00:00.000,Rotterdam The Netherlands ATP World Tour 500,HARD,2,Viktor Troicki,Thomas Schoorel,Viktor Troicki,6-2; 7-6(1),R32,78,13,2,35,58,33,35,13,23,2,2,10,46,58,5,2,47,72,32,47,11,25,5,7,10,43,72
2011-02-07 00:00:00.000,Rotterdam The Netherlands ATP World Tour 500,HARD,2,Marin Cilic,Mischa Zverev,Marin Cilic,6-2; 6-4,R32,63,5,1,34,47,30,34,8,13,0,0,9,38,47,0,1,33,54,19,33,13,21,5,8,9,32,54
2011-02-07 00:00:00.000,Rotterdam The Netherlands ATP World Tour 500,HARD,2,Jurgen Melzer,Jesse Huta Galung,Jurgen Melzer,6-4; 6-4,R32,78,6,1,39,61,24,39,15,22,0,1,10,39,61,11,4,30,55,21,30,13,25,3,6,10,34,55
2011-02-07 00:00:00.000,Rotterdam The Netherlands ATP World Tour 500,HARD,2,Jo-Wilfried Tsonga,Grigor Dimitrov,Jo-Wilfried Tsonga,6-4; 6-4,R32,75,11,2,36,57,30,36,14,21,0,0,10,44,57,4,6,35,64,28,35,13,29,4,6,10,41,64
2011-02-07 00:00:00.000,Rotterdam The Netherlands ATP World Tour 500,HARD,2,Michael Llodra,Nikolay Davydenko,Michael Llodra,6-3; 7-6(4),R32,94,12,2,50,71,41,50,10,21,2,2,11,51,71,1,1,47,69,32,47,12,22,5,6,10,44,69
2011-02-07 00:00:00.000,Rotterdam The Netherlands ATP World Tour 500,HARD,2,Dmitry Tursunov,Andrey Golubev,Dmitry Tursunov,6-4; 7-5,R32,87,6,3,41,64,35,41,12,23,4,4,11,47,64,8,2,34,67,27,34,15,33,1,3,11,42,67
2011-02-07 00:00:00.000,Rotterdam The Netherlands ATP World Tour 500,HARD,2,Tomas Berdych,Guillermo Garcia-Lopez,Tomas Berdych,6-1; 6-2,R32,55,3,0,25,38,23,25,9,13,0,0,8,32,38,3,3,25,48,14,25,8,23,1,5,7,22,48
2011-02-07 00:00:00.000,Rotterdam The Netherlands ATP World Tour 500,HARD,2,Ivan Ljubicic,Sergiy Stakhovsky,Ivan Ljubicic,7-6(3); 6-3,R32,103,5,2,38,72,30,38,21,34,0,1,11,51,72,5,1,54,81,36,54,14,27,5,7,10,50,81
2011-02-07 00:00:00.000,Rotterdam The Netherlands ATP World Tour 500,HARD,2,Benoit Paire,Gilles Simon,Benoit Paire,6-2; 2-6; 6-3,R32,98,5,1,51,100,37,51,19,49,10,14,13,56,100,2,1,40,68,27,40,10,28,2,7,12,37,68
2011-02-07 00:00:00.000,Rotterdam The Netherlands ATP World Tour 500,HARD,2,Feliciano Lopez,Florian Mayer,Feliciano Lopez,6-3; 6-4,R32,61,12,3,35,52,31,35,10,17,3,3,10,41,52,1,1,31,53,20,31,13,22,2,4,9,33,53
2011-02-07 00:00:00.000,Rotterdam The Netherlands ATP World Tour 500,HARD,2,Marcos Baghdatis,Andy Murray,Marcos Baghdatis,6-4; 6-1,R32,61,9,0,29,54,24,29,11,25,6,8,9,35,54,5,2,26,44,15,26,5,18,3,8,8,20,44
2011-02-07 00:00:00.000,Rotterdam The Netherlands ATP World Tour 500,HARD,2,Robin Soderling,Philipp Kohlschreiber,Robin Soderling,6-3; 5-7; 7-6(7),R16,142,16,2,63,96,49,63,21,33,1,4,17,70,96,12,3,66,113,47,66,23,47,5,8,16,70,113
2011-02-07 00:00:00.000,Rotterdam The Netherlands ATP World Tour 500,HARD,2,Mikhail Youzhny,Thiemo de Bakker,Mikhail Youzhny,6-4; 6-4,R16,75,5,3,27,51,21,27,17,24,2,3,10,38,51,5,2,29,55,20,29,15,26,1,4,10,35,55
2011-02-07 00:00:00.000,Rotterdam The Netherlands ATP World Tour 500,HARD,2,Viktor Troicki,Jarkko Nieminen,Viktor Troicki,7-6(4); 7-5,R16,88,6,0,40,73,34,40,19,33,1,2,12,53,73,3,0,49,72,30,49,16,23,0,2,12,46,72
2011-02-07 00:00:00.000,Rotterdam The Netherlands ATP World Tour 500,HARD,2,Marin Cilic,Jurgen Melzer,Marin Cilic,6-2; 6-4,R16,72,2,2,27,52,22,27,16,25,1,1,9,38,52,5,3,27,52,20,27,9,25,0,3,9,29,52
2011-02-07 00:00:00.000,Rotterdam The Netherlands ATP World Tour 500,HARD,2,Jo-Wilfried Tsonga,Michael Llodra,Jo-Wilfried Tsonga,4-6; 6-4; 6-4,R16,129,16,5,58,98,47,58,20,40,3,4,15,67,98,12,1,54,100,41,54,24,46,6,8,15,65,100
2011-02-07 00:00:00.000,Rotterdam The Netherlands ATP World Tour 500,HARD,2,Tomas Berdych,Dmitry Tursunov,Tomas Berdych,6-4; 4-6; 7-5,R16,125,16,2,50,72,45,50,15,22,0,1,16,60,72,13,5,63,98,47,63,18,35,5,7,16,65,98
2011-02-07 00:00:00.000,Rotterdam The Netherlands ATP World Tour 500,HARD,2,Ivan Ljubicic,Benoit Paire,Ivan Ljubicic,6-0; 6-4,R16,64,5,1,33,49,25,33,8,16,1,2,8,33,49,4,2,24,49,15,24,9,25,1,6,8,24,49
2011-02-07 00:00:00.000,Rotterdam The Netherlands ATP World Tour 500,HARD,2,Marcos Baghdatis,Feliciano Lopez,Marcos Baghdatis,7-6(3); 6-3,R16,80,10,1,37,66,34,37,16,29,0,0,11,50,66,12,1,33,55,29,33,12,22,1,2,10,41,55
2011-02-07 00:00:00.000,Rotterdam The Netherlands ATP World Tour 500,HARD,2,Robin Soderling,Mikhail Youzhny,Robin Soderling,6-4; 7-6(5),Q,114,13,5,50,87,39,50,18,37,5,5,11,57,87,7,2,42,73,31,42,17,31,5,6,11,48,73
2011-02-07 00:00:00.000,Rotterdam The Netherlands ATP World Tour 500,HARD,2,Viktor Troicki,Marin Cilic,Viktor Troicki,7-5; 6-3,Q,88,11,0,54,76,37,54,14,22,9,10,11,51,76,2,1,28,58,18,28,18,30,3,6,10,36,58
2011-02-07 00:00:00.000,Rotterdam The Netherlands ATP World Tour 500,HARD,2,Jo-Wilfried Tsonga,Tomas Berdych,Jo-Wilfried Tsonga,W/O,Q,0,0,0,0,0,0,0,0,0,0,0,0,0,0,0,0,0,0,0,0,0,0,0,0,0,0,0
2011-02-07 00:00:00.000,Rotterdam The Netherlands ATP World Tour 500,HARD,2,Ivan Ljubicic,Marcos Baghdatis,Ivan Ljubicic,6-4; 6-7(6); 7-6(4),Q,145,18,0,66,107,56,66,20,41,1,3,17,76,107,12,3,53,92,40,53,27,39,2,5,17,67,92
2011-02-07 00:00:00.000,Rotterdam The Netherlands ATP World Tour 500,HARD,2,Robin Soderling,Viktor Troicki,Robin Soderling,7-5; 6-4,S,74,13,1,38,55,32,38,9,17,1,2,11,41,55,11,0,47,69,29,47,12,22,5,8,11,41,69
2011-02-07 00:00:00.000,Rotterdam The Netherlands ATP World Tour 500,HARD,2,Jo-Wilfried Tsonga,Ivan Ljubicic,Jo-Wilfried Tsonga,6-4; 7-6(6),S,97,13,1,49,65,42,49,8,16,1,2,11,50,65,7,1,36,70,27,36,20,34,0,2,11,47,70
2011-02-07 00:00:00.000,Rotterdam The Netherlands ATP World Tour 500,HARD,2,Robin Soderling,Jo-Wilfried Tsonga,Robin Soderling,6-3; 3-6; 6-3,F,83,12,3,51,72,41,51,11,21,2,4,14,52,72,20,0,42,65,32,42,13,23,0,3,13,45,65
2011-02-07 00:00:00.000,San Jose CA; U.S.A. ATP World Tour 250,HARD,2,Fernando Verdasco,Rajeev Ram,Fernando Verdasco,6-3; 6-2,R32,61,8,1,25,43,22,25,14,18,0,0,9,36,43,5,2,38,58,25,38,7,20,5,8,8,32,58
2011-02-07 00:00:00.000,San Jose CA; U.S.A. ATP World Tour 250,HARD,2,Ivo Karlovic,Ryan Sweeting,Ivo Karlovic,6-4; 6-4,R32,70,19,1,42,58,36,42,7,16,1,1,10,43,58,1,2,34,54,27,34,10,20,2,4,10,37,54
2011-02-07 00:00:00.000,San Jose CA; U.S.A. ATP World Tour 250,HARD,2,Michael Russell,Alex Kuznetsov,Michael Russell,6-4; 6-2,R32,89,1,3,29,51,22,29,10,22,3,5,9,32,51,3,2,35,65,18,35,12,30,6,11,9,30,65
2011-02-07 00:00:00.000,San Jose CA; U.S.A. ATP World Tour 250,HARD,2,Denis Istomin,Roman Borvanov,Denis Istomin,6-3; 7-5,R32,77,7,1,42,56,34,42,9,14,2,2,10,43,56,7,5,40,65,30,40,9,25,4,7,11,39,65
2011-02-07 00:00:00.000,San Jose CA; U.S.A. ATP World Tour 250,HARD,2,Lukas Lacko,Sam Querrey,Lukas Lacko,7-6(6); 6-3,R32,77,10,2,43,75,33,43,17,32,1,2,11,50,75,12,2,33,58,26,33,12,25,1,3,10,38,58
2011-02-07 00:00:00.000,San Jose CA; U.S.A. ATP World Tour 250,HARD,2,Juan Martin Del Potro,Teymuraz Gabashvili,Juan Martin Del Potro,6-3; 6-2,R32,78,9,1,28,49,25,28,13,21,1,1,9,38,49,9,3,30,58,18,30,14,28,6,9,8,32,58
2011-02-07 00:00:00.000,San Jose CA; U.S.A. ATP World Tour 250,HARD,2,Brian Dabul,Alejandro Falla,Brian Dabul,6-4; 6-3,R32,88,1,1,24,53,19,24,14,29,0,2,10,33,53,1,1,30,64,19,30,17,34,5,9,9,36,64
2011-02-07 00:00:00.000,San Jose CA; U.S.A. ATP World Tour 250,HARD,2,Lleyton Hewitt,Bjorn Phau,Lleyton Hewitt,6-3; 6-3,R32,71,1,3,30,52,21,30,10,22,0,2,9,31,52,2,4,32,55,19,32,7,23,4,9,9,26,55
2011-02-07 00:00:00.000,San Jose CA; U.S.A. ATP World Tour 250,HARD,2,Ricardas Berankis,Benjamin Becker,Ricardas Berankis,6-3; 7-6(2),R32,98,7,3,41,72,36,41,17,31,7,7,10,53,72,6,2,45,80,33,45,16,35,1,3,11,49,80
2011-02-07 00:00:00.000,San Jose CA; U.S.A. ATP World Tour 250,HARD,2,Donald Young,Dustin Brown,Donald Young,7-6(2); 6-4,R32,75,4,5,43,69,33,43,17,26,4,5,11,50,69,5,1,41,74,29,41,16,33,2,4,11,45,74
2011-02-07 00:00:00.000,San Jose CA; U.S.A. ATP World Tour 250,HARD,2,James Blake,Jesse Levine,James Blake,7-5; 6-1,R32,74,3,2,30,55,25,30,14,25,0,1,10,39,55,1,2,52,72,26,52,10,20,7,11,9,36,72
2011-02-07 00:00:00.000,San Jose CA; U.S.A. ATP World Tour 250,HARD,2,Milos Raonic,Xavier Malisse,Milos Raonic,6-3; 6-4,R32,78,20,3,36,61,30,36,14,25,1,1,10,44,61,3,1,40,61,26,40,12,21,5,7,9,38,61
2011-02-07 00:00:00.000,San Jose CA; U.S.A. ATP World Tour 250,HARD,2,Kei Nishikori,Jan Hajek,Kei Nishikori,6-1; 7-6(6),R32,79,5,1,40,61,33,40,10,21,2,4,10,43,61,3,2,36,60,23,36,9,24,3,7,9,32,60
2011-02-07 00:00:00.000,San Jose CA; U.S.A. ATP World Tour 250,HARD,2,Tim Smyczek,Robert Farah,Tim Smyczek,7-5; 3-6; 6-3,R32,126,4,2,47,84,34,47,23,37,2,4,15,57,84,6,2,57,90,39,57,17,33,4,7,15,56,90
2011-02-07 00:00:00.000,San Jose CA; U.S.A. ATP World Tour 250,HARD,2,Robert Kendrick,Igor Kunitsyn,Robert Kendrick,7-5; 3-6; 6-4,R32,137,9,4,60,102,41,60,23,42,5,8,16,64,102,3,4,62,114,44,62,27,52,10,13,15,71,114
2011-02-07 00:00:00.000,San Jose CA; U.S.A. ATP World Tour 250,HARD,2,Gael Monfils,Bradley Klahn,Gael Monfils,6-3; 6-2,R32,62,10,4,27,49,25,27,13,22,1,1,9,38,49,1,4,29,50,18,29,9,21,2,5,8,27,50
2011-02-07 00:00:00.000,San Jose CA; U.S.A. ATP World Tour 250,HARD,2,Fernando Verdasco,Ivo Karlovic,Fernando Verdasco,7-5; 7-5,R16,91,3,1,40,59,32,40,16,19,0,0,12,48,59,14,1,49,69,36,49,11,20,0,2,12,47,69
2011-02-07 00:00:00.000,San Jose CA; U.S.A. ATP World Tour 250,HARD,2,Denis Istomin,Michael Russell,Denis Istomin,7-6(7); 7-6(4),R16,126,9,1,45,78,37,45,21,33,3,5,12,58,78,4,4,63,98,46,63,17,35,5,7,12,63,98
2011-02-07 00:00:00.000,San Jose CA; U.S.A. ATP World Tour 250,HARD,2,Juan Martin Del Potro,Lukas Lacko,Juan Martin Del Potro,6-1; 7-6(1),R16,100,9,4,35,67,31,35,17,32,4,5,10,48,67,3,1,32,61,19,32,13,29,5,8,9,32,61
2011-02-07 00:00:00.000,San Jose CA; U.S.A. ATP World Tour 250,HARD,2,Lleyton Hewitt,Brian Dabul,Lleyton Hewitt,3-6; 7-5; 6-3,R16,131,11,2,56,93,40,56,22,37,6,8,15,62,93,1,2,57,88,44,57,15,31,3,6,15,59,88
2011-02-07 00:00:00.000,San Jose CA; U.S.A. ATP World Tour 250,HARD,2,Ricardas Berankis,Donald Young,Ricardas Berankis,6-4; 5-7; 7-5,R16,143,8,3,49,100,38,49,30,51,5,8,17,68,100,5,6,73,131,51,73,26,58,12,16,17,77,131
2011-02-07 00:00:00.000,San Jose CA; U.S.A. ATP World Tour 250,HARD,2,Milos Raonic,James Blake,Milos Raonic,6-2; 7-6(4),R16,70,13,2,35,54,32,35,12,19,2,3,10,44,54,8,0,39,60,28,39,7,21,1,4,10,35,60
2011-02-07 00:00:00.000,San Jose CA; U.S.A. ATP World Tour 250,HARD,2,Tim Smyczek,Kei Nishikori,Tim Smyczek,6-4; 3-6; 6-1,R16,112,1,1,51,81,35,51,15,30,6,9,13,50,81,4,4,57,83,29,57,15,26,4,9,13,44,83
2011-02-07 00:00:00.000,San Jose CA; U.S.A. ATP World Tour 250,HARD,2,Gael Monfils,Robert Kendrick,Gael Monfils,6-2; 5-7; 6-4,R16,106,15,6,50,83,41,50,16,33,4,6,15,57,83,4,2,59,96,41,59,18,37,4,8,15,59,96
2011-02-07 00:00:00.000,San Jose CA; U.S.A. ATP World Tour 250,HARD,2,Fernando Verdasco,Denis Istomin,Fernando Verdasco,6-4; 6-4,Q,85,7,2,44,59,34,44,9,15,2,2,10,43,59,3,0,33,53,20,33,16,20,1,3,10,36,53
2011-02-07 00:00:00.000,San Jose CA; U.S.A. ATP World Tour 250,HARD,2,Juan Martin Del Potro,Lleyton Hewitt,Juan Martin Del Potro,6-2; 6-3,Q,76,7,1,32,46,26,32,8,14,3,3,8,34,46,3,5,44,74,28,44,9,30,7,11,9,37,74
2011-02-07 00:00:00.000,San Jose CA; U.S.A. ATP World Tour 250,HARD,2,Milos Raonic,Ricardas Berankis,Milos Raonic,6-4; 7-6(2),Q,84,12,1,40,61,35,40,14,21,1,1,11,49,61,7,7,40,72,33,40,15,32,2,3,11,48,72
2011-02-07 00:00:00.000,San Jose CA; U.S.A. ATP World Tour 250,HARD,2,Gael Monfils,Tim Smyczek,Gael Monfils,6-4; 7-6(6),Q,105,5,3,50,84,40,50,17,34,6,6,11,57,84,2,2,53,86,35,53,21,33,7,8,11,56,86
2011-02-07 00:00:00.000,San Jose CA; U.S.A. ATP World Tour 250,HARD,2,Fernando Verdasco,Juan Martin Del Potro,Fernando Verdasco,6-4; 6-4,S,97,5,1,34,56,28,34,14,22,0,1,10,42,56,8,0,40,60,25,40,13,20,3,6,10,38,60
2011-02-07 00:00:00.000,San Jose CA; U.S.A. ATP World Tour 250,HARD,2,Milos Raonic,Gael Monfils,Milos Raonic,W/O,S,0,0,0,0,0,0,0,0,0,0,0,0,0,0,0,0,0,0,0,0,0,0,0,0,0,0,0
2011-02-07 00:00:00.000,San Jose CA; U.S.A. ATP World Tour 250,HARD,2,Milos Raonic,Fernando Verdasco,Milos Raonic,7-6(6); 7-6(5),F,112,13,3,56,81,49,56,12,25,1,1,12,61,81,9,1,49,68,41,49,16,19,0,0,12,57,68
2011-02-14 00:00:00.000,Buenos Aires Argentina ATP World Tour 250,CLAY,2,Nicolas Almagro,Pablo Galdon,Nicolas Almagro,6-1; 6-2,R32,57,7,1,26,47,19,26,15,21,3,3,8,34,47,1,0,24,40,13,24,8,16,1,5,7,21,40
2011-02-14 00:00:00.000,Buenos Aires Argentina ATP World Tour 250,CLAY,2,Leonardo Mayer,Federico Delbonis,Leonardo Mayer,7-6(1); 7-5,R32,106,3,0,45,66,33,45,14,21,0,2,12,47,66,3,1,47,78,32,47,14,31,2,5,12,46,78
2011-02-14 00:00:00.000,Buenos Aires Argentina ATP World Tour 250,CLAY,2,Pablo Cuevas,Lukasz Kubot,Pablo Cuevas,5-7; 7-5; 6-3,R32,141,5,0,62,104,43,62,23,42,6,10,17,66,104,3,4,53,86,34,53,19,33,0,5,16,53,86
2011-02-14 00:00:00.000,Buenos Aires Argentina ATP World Tour 250,CLAY,2,Jose Acasuso,Alexandr Dolgopolov,Jose Acasuso,6-2; 6-4,R32,75,2,0,29,52,19,29,20,23,2,2,9,39,52,5,0,36,59,21,36,14,23,3,6,9,35,59
2011-02-14 00:00:00.000,Buenos Aires Argentina ATP World Tour 250,CLAY,2,David Nalbandian,Potito Starace,David Nalbandian,6-4; 6-4,R32,76,1,1,37,56,27,37,12,19,2,3,10,39,56,3,2,52,64,32,52,6,12,2,5,10,38,64
2011-02-14 00:00:00.000,Buenos Aires Argentina ATP World Tour 250,CLAY,2,Juan Pablo Brzezicki,Filippo Volandri,Juan Pablo Brzezicki,6-1; 6-3,R32,73,0,0,37,49,24,37,7,12,2,4,8,31,49,0,2,44,57,18,44,6,13,3,9,8,24,57
2011-02-14 00:00:00.000,Buenos Aires Argentina ATP World Tour 250,CLAY,2,Albert Ramos,Joao Souza,Albert Ramos,6-4; 6-0,R32,75,0,1,30,43,27,30,6,13,1,1,8,33,43,3,3,30,52,16,30,10,22,2,6,8,26,52
2011-02-14 00:00:00.000,Buenos Aires Argentina ATP World Tour 250,CLAY,2,Tommy Robredo,Maximo Gonzalez,Tommy Robredo,7-5; 6-2,R32,94,1,2,48,66,38,48,8,18,3,3,10,46,66,0,1,48,66,33,48,6,18,3,6,10,39,66
2011-02-14 00:00:00.000,Buenos Aires Argentina ATP World Tour 250,CLAY,2,Juan Ignacio Chela,Rui Machado,Juan Ignacio Chela,4-6; 6-2; 6-2,R32,120,1,0,53,80,31,53,20,27,2,4,13,51,80,2,1,69,88,41,69,8,19,5,10,13,49,88
2011-02-14 00:00:00.000,Buenos Aires Argentina ATP World Tour 250,CLAY,2,Horacio Zeballos,Pablo Andujar,Horacio Zeballos,7-6(3); 6-2,R32,103,3,0,44,71,31,44,17,27,5,6,10,48,71,0,3,37,64,22,37,16,27,4,7,10,38,64
2011-02-14 00:00:00.000,Buenos Aires Argentina ATP World Tour 250,CLAY,2,Fabio Fognini,Frederico Gil,Fabio Fognini,1-6; 6-2; 6-2,R32,109,2,5,42,72,27,42,18,30,5,7,11,45,72,2,2,62,89,37,62,14,27,8,12,12,51,89
2011-02-14 00:00:00.000,Buenos Aires Argentina ATP World Tour 250,CLAY,2,Albert Montanes,Ruben Ramirez Hidalgo,Albert Montanes,6-1; 7-6(0),R32,105,4,1,33,57,24,33,16,24,2,4,10,40,57,0,6,49,82,28,49,14,33,14,18,9,42,82
2011-02-14 00:00:00.000,Buenos Aires Argentina ATP World Tour 250,CLAY,2,Juan Monaco,Ivan Navarro,Juan Monaco,6-2; 7-6(2),R32,93,4,1,37,55,33,37,13,18,4,4,10,46,55,7,2,47,68,29,47,10,21,3,5,10,39,68
2011-02-14 00:00:00.000,Buenos Aires Argentina ATP World Tour 250,CLAY,2,Eduardo Schwank,Igor Andreev,Eduardo Schwank,6-4; 7-6(5),R32,92,4,4,41,64,32,41,14,23,0,1,11,46,64,3,2,37,67,30,37,16,30,5,7,11,46,67
2011-02-14 00:00:00.000,Buenos Aires Argentina ATP World Tour 250,CLAY,2,Victor Hanescu,Daniel Gimeno-Traver,Victor Hanescu,6-3; 7-6(2),R32,96,1,2,43,72,31,43,15,29,1,3,11,46,72,4,1,40,70,27,40,12,30,4,7,10,39,70
2011-02-14 00:00:00.000,Buenos Aires Argentina ATP World Tour 250,CLAY,2,Stanislas Wawrinka,Carlos Berlocq,Stanislas Wawrinka,6-4; 3-6; 6-3,R32,142,2,6,54,94,33,54,19,40,8,13,14,52,94,2,1,56,83,32,56,14,27,5,11,14,46,83
2011-02-14 00:00:00.000,Buenos Aires Argentina ATP World Tour 250,CLAY,2,Nicolas Almagro,Leonardo Mayer,Nicolas Almagro,6-7(3); 6-1; 6-3,R16,134,9,2,48,86,41,48,22,38,3,4,14,63,86,2,2,50,91,35,50,19,41,3,8,14,54,91
2011-02-14 00:00:00.000,Buenos Aires Argentina ATP World Tour 250,CLAY,2,Jose Acasuso,Pablo Cuevas,Jose Acasuso,6-7(2); 7-5; 6-1,R16,162,4,0,70,108,50,70,19,38,7,9,16,69,108,3,1,57,98,39,57,21,41,7,12,15,60,98
2011-02-14 00:00:00.000,Buenos Aires Argentina ATP World Tour 250,CLAY,2,David Nalbandian,Juan Pablo Brzezicki,David Nalbandian,6-1; 6-2,R16,69,0,2,31,39,20,31,4,8,1,3,7,24,39,0,1,49,66,16,49,7,17,7,14,8,23,66
2011-02-14 00:00:00.000,Buenos Aires Argentina ATP World Tour 250,CLAY,2,Tommy Robredo,Albert Ramos,Tommy Robredo,6-3; 7-5,R16,107,1,3,37,58,29,37,11,21,1,3,11,40,58,2,3,44,71,26,44,14,27,6,10,10,40,71
2011-02-14 00:00:00.000,Buenos Aires Argentina ATP World Tour 250,CLAY,2,Juan Ignacio Chela,Horacio Zeballos,Juan Ignacio Chela,7-5; 6-2,R16,86,1,1,34,54,26,34,15,20,3,3,10,41,54,3,0,45,63,32,45,6,18,3,6,10,38,63
2011-02-14 00:00:00.000,Buenos Aires Argentina ATP World Tour 250,CLAY,2,Albert Montanes,Fabio Fognini,Albert Montanes,6-2; 4-6; 6-4,R16,143,3,3,70,97,44,70,17,27,7,9,14,61,97,6,4,59,91,38,59,16,32,5,9,14,54,91
2011-02-14 00:00:00.000,Buenos Aires Argentina ATP World Tour 250,CLAY,2,Juan Monaco,Eduardo Schwank,Juan Monaco,7-6(5); 6-2,R16,113,2,3,47,64,31,47,8,17,3,6,10,39,64,2,0,50,81,26,50,17,31,8,13,10,43,81
2011-02-14 00:00:00.000,Buenos Aires Argentina ATP World Tour 250,CLAY,2,Stanislas Wawrinka,Victor Hanescu,Stanislas Wawrinka,6-7(2); 6-1; 7-6(4),R16,169,5,1,64,101,48,64,22,37,1,2,16,70,101,7,2,76,109,57,76,11,33,4,7,15,68,109
2011-02-14 00:00:00.000,Buenos Aires Argentina ATP World Tour 250,CLAY,2,Nicolas Almagro,Jose Acasuso,Nicolas Almagro,7-5; 6-3,Q,86,3,2,34,64,24,34,19,30,3,5,11,43,64,1,2,26,56,19,26,12,30,4,8,10,31,56
2011-02-14 00:00:00.000,Buenos Aires Argentina ATP World Tour 250,CLAY,2,Tommy Robredo,David Nalbandian,Tommy Robredo,6-4; 6-4,Q,89,6,2,51,72,36,51,10,21,1,2,10,46,72,1,1,34,54,20,34,13,20,5,8,10,33,54
2011-02-14 00:00:00.000,Buenos Aires Argentina ATP World Tour 250,CLAY,2,Juan Ignacio Chela,Albert Montanes,Juan Ignacio Chela,6-4; 3-6; 6-3,Q,145,3,1,59,93,30,59,20,34,3,9,14,50,93,0,3,52,98,27,52,22,46,7,14,14,49,98
2011-02-14 00:00:00.000,Buenos Aires Argentina ATP World Tour 250,CLAY,2,Stanislas Wawrinka,Juan Monaco,Stanislas Wawrinka,7-5; 6-3,Q,125,5,4,56,91,36,56,18,35,11,13,11,54,91,1,1,49,75,25,49,14,26,3,7,10,39,75
2011-02-14 00:00:00.000,Buenos Aires Argentina ATP World Tour 250,CLAY,2,Nicolas Almagro,Tommy Robredo,Nicolas Almagro,7-5; 6-1,S,84,5,0,33,46,30,33,10,13,0,0,10,40,46,3,0,39,65,24,39,13,26,5,8,9,37,65
2011-02-14 00:00:00.000,Buenos Aires Argentina ATP World Tour 250,CLAY,2,Juan Ignacio Chela,Stanislas Wawrinka,Juan Ignacio Chela,6-2; 6-2,S,57,2,0,28,42,24,28,8,14,0,0,8,32,42,2,0,26,42,14,26,5,16,0,4,8,19,42
2011-02-14 00:00:00.000,Buenos Aires Argentina ATP World Tour 250,CLAY,2,Nicolas Almagro,Juan Ignacio Chela,Nicolas Almagro,6-3; 3-6; 6-4,F,125,1,1,54,86,39,54,13,32,7,11,14,52,86,2,2,61,93,36,61,18,32,7,12,14,54,93
2011-02-14 00:00:00.000,Marseille France ATP World Tour 250,HARD,2,Robin Soderling,N/A Bye,Robin Soderling,,R32,0,0,0,0,0,0,0,0,0,0,0,0,0,0,0,0,0,0,0,0,0,0,0,0,0,0,0
2011-02-14 00:00:00.000,Marseille France ATP World Tour 250,HARD,2,Nicolas Mahut,Andrey Kumantsov,Nicolas Mahut,6-2; 6-0,R32,50,7,2,17,36,16,17,13,19,3,3,7,29,36,2,2,27,43,15,27,3,16,3,8,7,18,43
2011-02-14 00:00:00.000,Marseille France ATP World Tour 250,HARD,2,Tobias Kamke,Thomas Schoorel,Tobias Kamke,6-0; 6-2,R32,62,2,0,29,42,21,29,10,13,2,2,7,31,42,2,2,34,53,20,34,5,19,9,14,7,25,53
2011-02-14 00:00:00.000,Marseille France ATP World Tour 250,HARD,2,Michael Llodra,Julien Benneteau,Michael Llodra,6-4; 4-6; 6-3,R32,100,10,7,52,80,45,52,14,28,2,3,15,59,80,3,0,53,72,39,53,14,19,1,3,14,53,72
2011-02-14 00:00:00.000,Marseille France ATP World Tour 250,HARD,2,Jurgen Melzer,N/A Bye,Jurgen Melzer,,R32,0,0,0,0,0,0,0,0,0,0,0,0,0,0,0,0,0,0,0,0,0,0,0,0,0,0,0
2011-02-14 00:00:00.000,Marseille France ATP World Tour 250,HARD,2,Andreas Seppi,Robin Haase,Andreas Seppi,5-7; 6-4; 7-6(2),R32,150,3,2,68,113,46,68,29,45,4,6,17,75,113,19,2,59,110,46,59,24,51,4,6,17,70,110
2011-02-14 00:00:00.000,Marseille France ATP World Tour 250,HARD,2,Dmitry Tursunov,Grigor Dimitrov,Dmitry Tursunov,6-7(6); 7-5; 7-6(4),R32,160,12,8,69,123,57,69,30,54,4,4,18,87,123,17,3,59,105,52,59,27,46,1,2,18,79,105
2011-02-14 00:00:00.000,Marseille France ATP World Tour 250,HARD,2,Ivan Ljubicic,Andrey Golubev,Ivan Ljubicic,6-2; 6-4,R32,66,6,1,30,48,26,30,11,18,1,1,9,37,48,1,4,28,51,17,28,12,23,3,6,9,29,51
2011-02-14 00:00:00.000,Marseille France ATP World Tour 250,HARD,2,Jo-Wilfried Tsonga,Benoit Paire,Jo-Wilfried Tsonga,6-1; 6-2,R32,56,10,4,33,53,30,33,7,20,4,4,8,37,53,0,2,26,44,14,26,9,18,1,5,7,23,44
2011-02-14 00:00:00.000,Marseille France ATP World Tour 250,HARD,2,Sergiy Stakhovsky,Illya Marchenko,Sergiy Stakhovsky,6-4; 6-3,R32,78,4,0,30,53,22,30,15,23,1,3,10,37,53,3,4,26,48,16,26,8,22,0,4,9,24,48
2011-02-14 00:00:00.000,Marseille France ATP World Tour 250,HARD,2,Gilles Simon,Nikolay Davydenko,Gilles Simon,7-6(6); 6-4,R32,99,4,2,41,69,31,41,14,28,0,3,11,45,69,2,3,34,70,23,34,14,36,2,6,11,37,70
2011-02-14 00:00:00.000,Marseille France ATP World Tour 250,HARD,2,Mikhail Youzhny,N/A Bye,Mikhail Youzhny,,R32,0,0,0,0,0,0,0,0,0,0,0,0,0,0,0,0,0,0,0,0,0,0,0,0,0,0,0
2011-02-14 00:00:00.000,Marseille France ATP World Tour 250,HARD,2,Philipp Petzschner,Ernests Gulbis,Philipp Petzschner,7-6(2); 6-1,R32,75,11,3,29,60,28,29,17,31,3,3,10,45,60,11,4,48,66,33,48,8,18,9,11,9,41,66
2011-02-14 00:00:00.000,Marseille France ATP World Tour 250,HARD,2,Marin Cilic,Stephane Bohli,Marin Cilic,6-7(6); 6-3; 6-2,R32,121,16,2,46,81,42,46,24,35,0,0,15,66,81,7,1,52,87,38,52,19,35,4,7,14,57,87
2011-02-14 00:00:00.000,Marseille France ATP World Tour 250,HARD,2,Edouard Roger-Vasselin,Arnaud Clement,Edouard Roger-Vasselin,6-3; 6-2,R32,80,4,1,30,49,25,30,12,19,0,0,9,37,49,10,2,26,54,21,26,10,28,3,6,8,31,54
2011-02-14 00:00:00.000,Marseille France ATP World Tour 250,HARD,2,Tomas Berdych,N/A Bye,Tomas Berdych,,R32,0,0,0,0,0,0,0,0,0,0,0,0,0,0,0,0,0,0,0,0,0,0,0,0,0,0,0
2011-02-14 00:00:00.000,Marseille France ATP World Tour 250,HARD,2,Robin Soderling,Nicolas Mahut,Robin Soderling,7-6(8); 7-6(5),R16,101,12,4,52,80,43,52,15,28,2,3,12,58,80,10,1,54,77,42,54,14,23,1,2,12,56,77
2011-02-14 00:00:00.000,Marseille France ATP World Tour 250,HARD,2,Michael Llodra,Tobias Kamke,Michael Llodra,6-3; 6-4,R16,70,12,3,32,58,27,32,16,26,2,2,10,43,58,1,2,34,55,22,34,12,21,3,5,9,34,55
2011-02-14 00:00:00.000,Marseille France ATP World Tour 250,HARD,2,Jurgen Melzer,Andreas Seppi,Jurgen Melzer,7-5; 6-3,R16,86,11,1,41,67,29,41,15,26,6,7,10,44,67,2,0,37,64,19,37,18,27,8,12,11,37,64
2011-02-14 00:00:00.000,Marseille France ATP World Tour 250,HARD,2,Dmitry Tursunov,Ivan Ljubicic,Dmitry Tursunov,7-6(4); 6-3,R16,79,6,1,45,64,36,45,13,19,0,0,11,49,64,15,2,41,59,33,41,6,18,0,1,10,39,59
2011-02-14 00:00:00.000,Marseille France ATP World Tour 250,HARD,2,Jo-Wilfried Tsonga,Sergiy Stakhovsky,Jo-Wilfried Tsonga,5-7; 6-4; 6-2,R16,109,11,1,50,81,44,50,16,31,0,1,15,60,81,11,0,60,93,43,60,14,33,1,4,15,57,93
2011-02-14 00:00:00.000,Marseille France ATP World Tour 250,HARD,2,Mikhail Youzhny,Gilles Simon,Mikhail Youzhny,3-6; 6-3; 6-3,R16,113,5,2,43,68,30,43,14,25,2,5,13,44,68,12,3,42,90,36,42,17,48,6,11,14,53,90
2011-02-14 00:00:00.000,Marseille France ATP World Tour 250,HARD,2,Marin Cilic,Philipp Petzschner,Marin Cilic,7-6(3); 6-3,R16,102,6,1,33,73,23,33,26,40,3,4,11,49,73,1,3,37,76,27,37,19,39,4,6,10,46,76
2011-02-14 00:00:00.000,Marseille France ATP World Tour 250,HARD,2,Tomas Berdych,Edouard Roger-Vasselin,Tomas Berdych,6-3; 6-4,R16,74,11,3,38,55,34,38,8,17,0,0,10,42,55,2,0,36,52,22,36,11,16,6,8,9,33,52
2011-02-14 00:00:00.000,Marseille France ATP World Tour 250,HARD,2,Robin Soderling,Michael Llodra,Robin Soderling,6-1; 6-4,Q,63,13,3,45,63,34,45,10,18,5,5,9,44,63,4,3,36,51,20,36,8,15,3,6,8,28,51
2011-02-14 00:00:00.000,Marseille France ATP World Tour 250,HARD,2,Dmitry Tursunov,Jurgen Melzer,Dmitry Tursunov,6-4; 2-6; 6-1,Q,102,3,2,51,82,35,51,15,31,4,7,13,50,82,10,5,32,74,25,32,19,42,3,7,12,44,74
2011-02-14 00:00:00.000,Marseille France ATP World Tour 250,HARD,2,Mikhail Youzhny,Jo-Wilfried Tsonga,Mikhail Youzhny,6-4; 2-6; 6-4,Q,119,2,1,51,81,35,51,18,30,1,3,14,53,81,17,3,52,87,43,52,17,35,9,11,14,60,87
2011-02-14 00:00:00.000,Marseille France ATP World Tour 250,HARD,2,Marin Cilic,Tomas Berdych,Marin Cilic,6-3; 6-4,Q,82,4,2,28,49,24,28,14,21,1,1,9,38,49,8,1,39,59,27,39,10,20,3,6,10,37,59
2011-02-14 00:00:00.000,Marseille France ATP World Tour 250,HARD,2,Robin Soderling,Dmitry Tursunov,Robin Soderling,7-5; 6-1,S,75,11,2,30,53,26,30,16,23,0,0,10,42,53,5,6,28,56,20,28,11,28,3,6,9,31,56
2011-02-14 00:00:00.000,Marseille France ATP World Tour 250,HARD,2,Marin Cilic,Mikhail Youzhny,Marin Cilic,6-2; 1-6; 7-5,S,127,12,3,48,90,34,48,20,42,6,9,13,54,90,12,1,54,84,42,54,10,30,5,9,14,52,84
2011-02-14 00:00:00.000,Marseille France ATP World Tour 250,HARD,2,Robin Soderling,Marin Cilic,Robin Soderling,6-7(8); 6-3; 6-3,F,126,12,1,66,94,50,66,16,28,2,4,15,66,94,16,5,59,103,46,59,15,44,3,8,15,61,103
2011-02-14 00:00:00.000,Memphis TN; U.S.A. ATP World Tour 500,HARD,2,Andy Roddick,Ricardas Berankis,Andy Roddick,4-6; 6-2; 6-3,R32,92,23,4,44,76,38,44,16,32,1,2,14,54,76,5,5,28,74,21,28,27,46,3,6,13,48,74
2011-02-14 00:00:00.000,Memphis TN; U.S.A. ATP World Tour 500,HARD,2,Janko Tipsarevic,Ryan Sweeting,Janko Tipsarevic,6-0; 7-6(7),R32,77,6,2,27,60,23,27,20,33,3,4,9,43,60,2,4,34,59,20,34,11,25,4,8,9,31,59
2011-02-14 00:00:00.000,Memphis TN; U.S.A. ATP World Tour 500,HARD,2,Adrian Mannarino,Jan Hajek,Adrian Mannarino,6-2; 6-2,R32,60,4,2,27,47,21,27,12,20,3,4,8,33,47,4,1,26,44,15,26,6,18,2,7,8,21,44
2011-02-14 00:00:00.000,Memphis TN; U.S.A. ATP World Tour 500,HARD,2,Lleyton Hewitt,Yen-Hsun Lu,Lleyton Hewitt,6-4; 7-6(3),R32,88,5,3,37,66,29,37,17,29,0,1,11,46,66,5,6,40,66,26,40,16,26,3,5,11,42,66
2011-02-14 00:00:00.000,Memphis TN; U.S.A. ATP World Tour 500,HARD,2,Florent Serra,Xavier Malisse,Florent Serra,6-2; 1-0 RET,R32,41,4,1,17,23,12,17,3,6,0,1,4,15,23,3,0,20,37,10,20,6,17,5,9,5,16,37
2011-02-14 00:00:00.000,Memphis TN; U.S.A. ATP World Tour 500,HARD,2,Michael Russell,Ivo Karlovic,Michael Russell,6-1; 7-6(1),R32,65,5,2,31,47,29,31,11,16,0,0,9,40,47,8,2,40,64,28,40,10,24,5,8,10,38,64
2011-02-14 00:00:00.000,Memphis TN; U.S.A. ATP World Tour 500,HARD,2,Ivan Dodig,Rainer Schuettler,Ivan Dodig,3-6; 6-3; 6-4,R32,130,10,7,45,88,34,45,22,43,6,8,14,56,88,5,0,46,84,34,46,19,38,4,7,14,53,84
2011-02-14 00:00:00.000,Memphis TN; U.S.A. ATP World Tour 500,HARD,2,Juan Martin Del Potro,John Isner,Juan Martin Del Potro,6-4; 6-3,R32,74,8,1,33,52,27,33,11,19,3,3,9,38,52,12,4,33,62,23,33,13,29,1,4,10,36,62
2011-02-14 00:00:00.000,Memphis TN; U.S.A. ATP World Tour 500,HARD,2,Sam Querrey,Denis Istomin,Sam Querrey,6-7(5); 7-6(5); 6-4,R32,142,19,5,58,109,51,58,28,51,3,3,17,79,109,10,3,87,120,66,87,18,33,1,2,17,84,120
2011-02-14 00:00:00.000,Memphis TN; U.S.A. ATP World Tour 500,HARD,2,Brian Dabul,Michal Przysiezny,Brian Dabul,7-5; 6-4,R32,90,2,1,44,65,36,44,12,21,1,1,11,48,65,3,1,40,65,28,40,16,25,3,5,11,44,65
2011-02-14 00:00:00.000,Memphis TN; U.S.A. ATP World Tour 500,HARD,2,Lukas Lacko,Dudi Sela,Lukas Lacko,6-7(4); 7-5; 6-3,R32,138,5,2,64,123,44,64,35,59,9,12,17,79,123,3,3,67,101,47,67,16,34,6,11,16,63,101
2011-02-14 00:00:00.000,Memphis TN; U.S.A. ATP World Tour 500,HARD,2,Mardy Fish,Teymuraz Gabashvili,Mardy Fish,6-1; 7-5,R32,87,9,3,37,61,31,37,10,24,1,2,10,41,61,2,3,32,59,20,32,12,27,2,6,9,32,59
2011-02-14 00:00:00.000,Memphis TN; U.S.A. ATP World Tour 500,HARD,2,Robert Kendrick,Kevin Anderson,Robert Kendrick,5-7; 6-3; 7-6(4),R32,154,13,3,63,107,50,63,25,44,5,7,17,75,107,20,3,87,131,63,87,19,44,16,18,16,82,131
2011-02-14 00:00:00.000,Memphis TN; U.S.A. ATP World Tour 500,HARD,2,James Blake,Ricardo Mello,James Blake,6-4; 6-3,R32,66,3,3,31,60,22,31,17,29,4,5,9,39,60,0,3,39,62,24,39,10,23,2,6,10,34,62
2011-02-14 00:00:00.000,Memphis TN; U.S.A. ATP World Tour 500,HARD,2,Radek Stepanek,Benjamin Becker,Radek Stepanek,6-4; 6-2,R32,86,5,1,34,67,26,34,18,33,6,7,9,44,67,5,2,34,65,26,34,9,31,5,9,9,35,65
2011-02-14 00:00:00.000,Memphis TN; U.S.A. ATP World Tour 500,HARD,2,Milos Raonic,Fernando Verdasco,Milos Raonic,6-4; 3-6; 7-6(5),R32,122,16,4,59,85,49,59,14,26,1,2,15,63,85,12,4,70,107,53,70,21,37,9,10,16,74,107
2011-02-14 00:00:00.000,Memphis TN; U.S.A. ATP World Tour 500,HARD,2,Andy Roddick,Janko Tipsarevic,Andy Roddick,6-1; 7-6(8),R16,91,14,4,39,61,31,39,12,22,0,1,10,43,61,5,3,35,66,24,35,15,31,3,6,9,39,66
2011-02-14 00:00:00.000,Memphis TN; U.S.A. ATP World Tour 500,HARD,2,Lleyton Hewitt,Adrian Mannarino,Lleyton Hewitt,6-7(9); 7-5; 6-0,R16,158,12,3,62,107,44,62,25,45,8,11,15,69,107,9,4,58,119,39,58,25,61,10,17,15,64,119
2011-02-14 00:00:00.000,Memphis TN; U.S.A. ATP World Tour 500,HARD,2,Michael Russell,Florent Serra,Michael Russell,6-4; 6-4,R16,59,11,1,31,46,29,31,11,15,0,0,10,40,46,4,3,34,56,26,34,11,22,5,7,10,37,56
2011-02-14 00:00:00.000,Memphis TN; U.S.A. ATP World Tour 500,HARD,2,Juan Martin Del Potro,Ivan Dodig,Juan Martin Del Potro,6-4; 6-4,R16,85,4,2,33,56,28,33,13,23,1,1,10,41,56,6,0,24,53,18,24,17,29,2,4,10,35,53
2011-02-14 00:00:00.000,Memphis TN; U.S.A. ATP World Tour 500,HARD,2,Sam Querrey,Brian Dabul,Sam Querrey,6-3; 7-6(3),R16,80,8,6,35,64,31,35,15,29,2,3,11,46,64,5,2,45,62,29,45,10,17,2,4,10,39,62
2011-02-14 00:00:00.000,Memphis TN; U.S.A. ATP World Tour 500,HARD,2,Mardy Fish,Lukas Lacko,Mardy Fish,6-7(5); 6-4; 7-6(3),R16,160,11,6,60,107,45,60,29,47,2,4,17,74,107,5,4,68,122,48,68,28,54,11,14,17,76,122
2011-02-14 00:00:00.000,Memphis TN; U.S.A. ATP World Tour 500,HARD,2,Robert Kendrick,James Blake,Robert Kendrick,7-6(5); 6-3,R16,69,8,4,38,73,29,38,18,35,1,2,10,47,73,7,2,45,63,32,45,8,18,3,6,11,40,63
2011-02-14 00:00:00.000,Memphis TN; U.S.A. ATP World Tour 500,HARD,2,Milos Raonic,Radek Stepanek,Milos Raonic,6-4; 6-7(10); 7-6(1),R16,152,38,4,78,116,64,78,20,38,2,3,17,84,116,8,3,77,119,57,77,21,42,6,8,17,78,119
2011-02-14 00:00:00.000,Memphis TN; U.S.A. ATP World Tour 500,HARD,2,Andy Roddick,Lleyton Hewitt,Andy Roddick,4-6; 6-3; 6-4,Q,133,21,6,58,98,46,58,20,40,3,4,15,66,98,11,6,53,106,40,53,25,53,9,11,14,65,106
2011-02-14 00:00:00.000,Memphis TN; U.S.A. ATP World Tour 500,HARD,2,Juan Martin Del Potro,Michael Russell,Juan Martin Del Potro,6-4; 6-2,Q,88,7,0,30,53,25,30,14,23,0,0,9,39,53,2,5,33,57,23,33,9,24,2,5,9,32,57
2011-02-14 00:00:00.000,Memphis TN; U.S.A. ATP World Tour 500,HARD,2,Mardy Fish,Sam Querrey,Mardy Fish,6-3; 6-4,Q,79,8,0,37,61,25,37,17,24,3,4,10,42,61,4,4,33,60,25,33,9,27,2,5,9,34,60
2011-02-14 00:00:00.000,Memphis TN; U.S.A. ATP World Tour 500,HARD,2,Milos Raonic,Robert Kendrick,Milos Raonic,6-4; 3-6; 6-3,Q,113,20,4,62,94,48,62,14,32,8,9,14,62,94,4,1,43,78,36,43,18,35,3,5,14,54,78
2011-02-14 00:00:00.000,Memphis TN; U.S.A. ATP World Tour 500,HARD,2,Andy Roddick,Juan Martin Del Potro,Andy Roddick,6-3; 6-4,S,95,13,1,35,56,30,35,10,21,1,2,10,40,56,8,0,36,69,22,36,18,33,7,10,9,40,69
2011-02-14 00:00:00.000,Memphis TN; U.S.A. ATP World Tour 500,HARD,2,Milos Raonic,Mardy Fish,Milos Raonic,6-4; 4-6; 6-3,S,119,23,3,55,84,47,55,12,29,5,6,14,59,84,3,2,43,81,33,43,22,38,2,5,15,55,81
2011-02-14 00:00:00.000,Memphis TN; U.S.A. ATP World Tour 500,HARD,2,Andy Roddick,Milos Raonic,Andy Roddick,7-6(7); 6-7(11); 7-5,F,157,20,4,67,113,54,67,31,46,6,8,18,85,113,32,3,74,123,61,74,26,49,7,10,18,87,123
2011-02-21 00:00:00.000,Acapulco Mexico ATP World Tour 500,CLAY,2,David Ferrer,Adrian Ungur,David Ferrer,6-1; 6-3,R32,62,0,1,32,49,23,32,9,17,3,4,8,32,49,0,1,27,46,12,27,9,19,3,8,8,21,46
2011-02-21 00:00:00.000,Acapulco Mexico ATP World Tour 500,CLAY,2,Santiago Gonzalez,Daniel Garza,Santiago Gonzalez,6-2; 7-6(5),R32,94,8,4,40,69,32,40,13,29,0,1,10,45,69,1,2,50,75,32,50,11,25,7,10,10,43,75
2011-02-21 00:00:00.000,Acapulco Mexico ATP World Tour 500,CLAY,2,Pablo Cuevas,Potito Starace,Pablo Cuevas,6-4; 6-4,R32,81,2,1,27,52,21,27,17,25,3,4,10,38,52,1,5,50,74,29,50,12,24,7,10,10,41,74
2011-02-21 00:00:00.000,Acapulco Mexico ATP World Tour 500,CLAY,2,Juan Monaco,Horacio Zeballos,Juan Monaco,7-5; 7-6(3),R32,139,7,1,40,75,30,40,20,35,3,6,12,50,75,6,3,53,101,36,53,19,48,11,15,12,55,101
2011-02-21 00:00:00.000,Acapulco Mexico ATP World Tour 500,CLAY,2,Stanislas Wawrinka,Pablo Andujar,Stanislas Wawrinka,7-6(5); 3-6; 6-0,R32,123,3,3,58,98,38,58,22,40,9,13,13,60,98,2,4,57,82,37,57,11,25,5,11,14,48,82
2011-02-21 00:00:00.000,Acapulco Mexico ATP World Tour 500,CLAY,2,Fabio Fognini,Maximo Gonzalez,Fabio Fognini,6-3; 6-4,R32,92,1,4,42,80,25,42,20,38,7,10,10,45,80,0,1,35,50,17,35,8,15,2,7,9,25,50
2011-02-21 00:00:00.000,Acapulco Mexico ATP World Tour 500,CLAY,2,Carlos Berlocq,Daniel Munoz-De La Nava,Carlos Berlocq,6-3; 5-7; 6-1,R32,157,2,1,49,91,29,49,24,42,5,9,14,53,91,5,5,47,89,25,47,20,42,5,12,14,45,89
2011-02-21 00:00:00.000,Acapulco Mexico ATP World Tour 500,CLAY,2,Alexandr Dolgopolov,Paul Capdeville,Alexandr Dolgopolov,7-5; 6-2,R32,82,10,5,27,57,21,27,14,30,0,2,10,35,57,2,2,45,67,27,45,7,22,5,10,10,34,67
2011-02-21 00:00:00.000,Acapulco Mexico ATP World Tour 500,CLAY,2,Albert Montanes,Daniel Gimeno-Traver,Albert Montanes,6-2; 6-1,R32,69,2,3,26,50,22,26,11,24,4,5,8,33,50,2,7,20,49,11,20,9,29,5,10,7,20,49
2011-02-21 00:00:00.000,Acapulco Mexico ATP World Tour 500,CLAY,2,Santiago Giraldo,Albert Ramos,Santiago Giraldo,4-6; 7-5; 7-5,R32,158,3,1,68,103,48,68,14,35,7,11,17,62,103,3,2,65,111,41,65,24,46,4,9,17,65,111
2011-02-21 00:00:00.000,Acapulco Mexico ATP World Tour 500,CLAY,2,Filippo Volandri,Frederico Gil,Filippo Volandri,6-1; 3-6; 6-4,R32,132,0,3,64,93,34,64,15,29,11,16,13,49,93,1,3,45,78,27,45,11,33,5,12,13,38,78
2011-02-21 00:00:00.000,Acapulco Mexico ATP World Tour 500,CLAY,2,Nicolas Almagro,Victor Hanescu,Nicolas Almagro,6-3; 6-2,R32,81,5,0,36,66,26,36,16,30,1,2,9,42,66,2,1,34,51,18,34,7,17,2,6,8,25,51
2011-02-21 00:00:00.000,Acapulco Mexico ATP World Tour 500,CLAY,2,Eduardo Schwank,Juan Ignacio Chela,Eduardo Schwank,3-6; 6-5 RET,R32,80,4,4,37,64,24,37,13,27,2,5,10,37,64,1,2,35,51,26,35,9,16,0,2,10,35,51
2011-02-21 00:00:00.000,Acapulco Mexico ATP World Tour 500,CLAY,2,Lukasz Kubot,Ruben Ramirez Hidalgo,Lukasz Kubot,7-5; 6-0,R32,103,4,4,24,44,21,24,10,20,0,2,9,31,44,2,9,45,82,26,45,11,37,9,15,9,37,82
2011-02-21 00:00:00.000,Acapulco Mexico ATP World Tour 500,CLAY,2,Ivan Navarro,Manuel Sanchez,Ivan Navarro,6-1; 3-6; 6-1,R32,111,4,2,44,65,35,44,12,21,2,3,12,47,65,6,4,27,60,16,27,19,33,4,8,11,35,60
2011-02-21 00:00:00.000,Acapulco Mexico ATP World Tour 500,CLAY,2,Thomaz Bellucci,Fernando Verdasco,Thomaz Bellucci,6-2; 4-6; 6-3,R32,127,6,5,60,84,48,60,11,24,7,8,14,59,84,7,5,55,80,35,55,13,25,1,4,13,48,80
2011-02-21 00:00:00.000,Acapulco Mexico ATP World Tour 500,CLAY,2,David Ferrer,Santiago Gonzalez,David Ferrer,6-2; 6-2,R16,52,2,0,25,41,19,25,13,16,0,0,8,32,41,3,2,30,45,21,30,4,15,6,10,8,25,45
2011-02-21 00:00:00.000,Acapulco Mexico ATP World Tour 500,CLAY,2,Juan Monaco,Pablo Cuevas,Juan Monaco,6-3; 6-4,R16,106,3,2,45,76,34,45,13,31,5,6,10,47,76,0,1,33,54,17,33,14,21,1,4,9,31,54
2011-02-21 00:00:00.000,Acapulco Mexico ATP World Tour 500,CLAY,2,Stanislas Wawrinka,Fabio Fognini,Stanislas Wawrinka,5-7; 6-3; 7-5,R16,169,2,3,71,107,41,71,22,36,5,10,16,63,107,4,3,74,122,42,74,21,48,7,14,17,63,122
2011-02-21 00:00:00.000,Acapulco Mexico ATP World Tour 500,CLAY,2,Alexandr Dolgopolov,Carlos Berlocq,Alexandr Dolgopolov,6-4; 6-1,R16,72,4,0,21,41,18,21,15,20,0,0,8,33,41,4,5,36,60,21,36,8,24,2,6,9,29,60
2011-02-21 00:00:00.000,Acapulco Mexico ATP World Tour 500,CLAY,2,Santiago Giraldo,Albert Montanes,Santiago Giraldo,6-3; 6-4,R16,78,5,0,33,60,28,33,17,27,6,6,10,45,60,1,1,32,53,22,32,11,21,1,3,9,33,53
2011-02-21 00:00:00.000,Acapulco Mexico ATP World Tour 500,CLAY,2,Nicolas Almagro,Filippo Volandri,Nicolas Almagro,6-2; 6-2,R16,71,4,0,29,56,24,29,11,27,2,3,8,35,56,0,6,36,53,17,36,8,17,2,7,8,25,53
2011-02-21 00:00:00.000,Acapulco Mexico ATP World Tour 500,CLAY,2,Lukasz Kubot,Eduardo Schwank,Lukasz Kubot,6-7(8); 6-4; 6-4,R16,179,4,9,61,101,43,61,24,40,3,6,16,67,101,2,2,72,113,42,72,26,41,8,13,16,68,113
2011-02-21 00:00:00.000,Acapulco Mexico ATP World Tour 500,CLAY,2,Thomaz Bellucci,Ivan Navarro,Thomaz Bellucci,1-6; 6-4; 6-3,R16,140,4,1,50,81,35,50,19,31,1,3,13,54,81,3,5,44,91,31,44,26,47,4,6,13,57,91
2011-02-21 00:00:00.000,Acapulco Mexico ATP World Tour 500,CLAY,2,David Ferrer,Juan Monaco,David Ferrer,2-6; 7-5; 6-2,Q,164,1,6,63,100,39,63,18,37,10,14,14,57,100,1,1,50,92,31,50,21,42,2,7,14,52,92
2011-02-21 00:00:00.000,Acapulco Mexico ATP World Tour 500,CLAY,2,Alexandr Dolgopolov,Stanislas Wawrinka,Alexandr Dolgopolov,6-4; 7-6(6),Q,115,11,3,52,95,37,52,21,43,9,11,11,58,95,4,0,50,77,27,50,19,27,6,9,11,46,77
2011-02-21 00:00:00.000,Acapulco Mexico ATP World Tour 500,CLAY,2,Nicolas Almagro,Santiago Giraldo,Nicolas Almagro,7-6(0); 5-7; 6-4,Q,146,7,3,57,100,42,57,20,43,2,7,17,62,100,4,1,71,113,44,71,20,42,5,10,17,64,113
2011-02-21 00:00:00.000,Acapulco Mexico ATP World Tour 500,CLAY,2,Thomaz Bellucci,Lukasz Kubot,Thomaz Bellucci,6-7(5); 6-3; 6-4,Q,189,5,3,61,100,44,61,15,39,3,7,15,59,100,2,9,75,126,47,75,20,51,12,19,16,67,126
2011-02-21 00:00:00.000,Acapulco Mexico ATP World Tour 500,CLAY,2,David Ferrer,Alexandr Dolgopolov,David Ferrer,5-7; 6-1; 6-1,S,114,3,5,40,71,33,40,17,31,7,9,13,50,71,7,7,48,104,34,48,19,56,11,17,13,53,104
2011-02-21 00:00:00.000,Acapulco Mexico ATP World Tour 500,CLAY,2,Nicolas Almagro,Thomaz Bellucci,Nicolas Almagro,7-6(4); 6-4,S,104,9,1,43,75,32,43,20,32,3,3,11,52,75,5,3,38,65,31,38,15,27,1,2,11,46,65
2011-02-21 00:00:00.000,Acapulco Mexico ATP World Tour 500,CLAY,2,David Ferrer,Nicolas Almagro,David Ferrer,7-6(4); 6-7(2); 6-2,F,162,6,2,64,113,45,64,25,49,9,13,16,70,113,4,4,53,105,36,53,22,52,1,7,16,58,105
2011-02-21 00:00:00.000,Delray Beach FL; U.S.A. ATP World Tour 250,HARD,2,Dudi Sela,Marinko Matosevic,Dudi Sela,3-6; 6-1; 6-2,R32,95,2,4,41,74,28,41,20,33,7,9,12,48,74,2,2,38,66,21,38,15,28,3,8,12,36,66
2011-02-21 00:00:00.000,Delray Beach FL; U.S.A. ATP World Tour 250,HARD,2,Ivan Dodig,Igor Kunitsyn,Ivan Dodig,6-4; 2-6; 6-3,R32,133,18,6,58,109,40,58,23,51,7,10,14,63,109,6,0,35,68,27,35,17,33,2,5,13,44,68
2011-02-21 00:00:00.000,Delray Beach FL; U.S.A. ATP World Tour 250,HARD,2,Blaz Kavcic,Robert Farah,Blaz Kavcic,6-1; 6-4,R32,80,1,1,30,44,22,30,9,14,0,1,8,31,44,8,3,32,54,18,32,8,22,4,9,9,26,54
2011-02-21 00:00:00.000,Delray Beach FL; U.S.A. ATP World Tour 250,HARD,2,Janko Tipsarevic,Ivo Karlovic,Janko Tipsarevic,7-6(14); 7-6(1),R32,115,12,1,56,80,50,56,12,24,1,2,12,62,80,18,1,58,87,44,58,15,29,2,3,12,59,87
2011-02-21 00:00:00.000,Delray Beach FL; U.S.A. ATP World Tour 250,HARD,2,Sam Querrey,Dustin Brown,Sam Querrey,6-3; 5-7; 6-3,R32,88,4,7,64,87,46,64,11,23,4,7,15,57,87,10,2,56,83,41,56,10,27,2,7,15,51,83
2011-02-21 00:00:00.000,Delray Beach FL; U.S.A. ATP World Tour 250,HARD,2,Ryan Sweeting,Igor Andreev,Ryan Sweeting,6-2; 6-3,R32,64,2,1,37,52,26,37,10,15,1,2,9,36,52,4,4,32,50,21,32,5,18,2,6,8,26,50
2011-02-21 00:00:00.000,Delray Beach FL; U.S.A. ATP World Tour 250,HARD,2,Kei Nishikori,Brian Dabul,Kei Nishikori,6-2; 7-6(5),R32,99,5,2,38,68,30,38,13,30,2,4,10,43,68,1,2,35,65,24,35,11,30,2,6,10,35,65
2011-02-21 00:00:00.000,Delray Beach FL; U.S.A. ATP World Tour 250,HARD,2,James Blake,Benjamin Becker,James Blake,7-5; 6-4,R32,76,7,1,39,75,32,39,18,36,2,3,11,50,75,6,1,24,60,20,24,17,36,2,5,11,37,60
2011-02-21 00:00:00.000,Delray Beach FL; U.S.A. ATP World Tour 250,HARD,2,Kevin Anderson,Donald Young,Kevin Anderson,6-7(5); 7-6(4); 6-2,R32,151,22,2,89,122,69,89,16,33,10,10,16,85,122,6,8,54,100,41,54,29,46,2,4,16,70,100
2011-02-21 00:00:00.000,Delray Beach FL; U.S.A. ATP World Tour 250,HARD,2,Florent Serra,Ryan Harrison,Florent Serra,3-6; 6-3; 7-5,R32,116,5,0,66,91,49,66,15,25,4,5,15,64,91,11,6,58,102,44,58,20,44,9,11,15,64,102
2011-02-21 00:00:00.000,Delray Beach FL; U.S.A. ATP World Tour 250,HARD,2,Juan Martin Del Potro,Ricardas Berankis,Juan Martin Del Potro,6-4; 6-1,R32,77,2,2,34,62,27,34,13,28,7,8,9,40,62,1,3,26,47,19,26,6,21,1,5,8,25,47
2011-02-21 00:00:00.000,Delray Beach FL; U.S.A. ATP World Tour 250,HARD,2,Teymuraz Gabashvili,John Isner,Teymuraz Gabashvili,6-4; 5-7; 7-6(13),R32,151,7,5,60,97,50,60,25,37,0,2,17,75,97,21,4,85,110,68,85,10,25,3,5,17,78,110
2011-02-21 00:00:00.000,Delray Beach FL; U.S.A. ATP World Tour 250,HARD,2,Adrian Mannarino,Leonardo Mayer,Adrian Mannarino,1-6; 7-6(3); 6-4,R32,134,5,5,60,95,41,60,17,35,1,5,15,58,95,4,4,46,89,35,46,24,43,5,7,14,59,89
2011-02-21 00:00:00.000,Delray Beach FL; U.S.A. ATP World Tour 250,HARD,2,Alejandro Falla,Jan Hajek,Alejandro Falla,6-1; 2-0 RET,R32,27,0,0,15,23,11,15,6,8,0,0,4,17,23,0,2,17,28,5,17,5,11,2,6,5,10,28
2011-02-21 00:00:00.000,Delray Beach FL; U.S.A. ATP World Tour 250,HARD,2,Ricardo Mello,Rainer Schuettler,Ricardo Mello,2-6; 6-2; 6-3,R32,91,2,0,39,67,28,39,17,28,1,3,12,45,67,6,2,45,75,33,45,13,30,4,8,13,46,75
2011-02-21 00:00:00.000,Delray Beach FL; U.S.A. ATP World Tour 250,HARD,2,Mardy Fish,Bjorn Phau,Mardy Fish,5-0 RET,R32,20,2,0,10,14,8,10,4,4,0,0,3,12,14,2,0,8,12,2,8,2,4,0,2,2,4,12
2011-02-21 00:00:00.000,Delray Beach FL; U.S.A. ATP World Tour 250,HARD,2,Ivan Dodig,Dudi Sela,Ivan Dodig,2-6; 6-3; 6-2,R16,118,8,3,52,79,34,52,16,27,2,4,13,50,79,3,2,45,85,29,45,22,40,6,9,12,51,85
2011-02-21 00:00:00.000,Delray Beach FL; U.S.A. ATP World Tour 250,HARD,2,Janko Tipsarevic,Blaz Kavcic,Janko Tipsarevic,6-2; 6-7(8); 6-3,R16,163,15,4,60,105,45,60,27,45,13,15,15,72,105,5,3,69,110,45,69,20,41,10,15,14,65,110
2011-02-21 00:00:00.000,Delray Beach FL; U.S.A. ATP World Tour 250,HARD,2,Ryan Sweeting,Sam Querrey,Ryan Sweeting,7-6(5); 6-4,R16,85,7,3,47,71,35,47,14,24,5,6,11,49,71,5,4,49,82,32,49,18,33,6,8,11,50,82
2011-02-21 00:00:00.000,Delray Beach FL; U.S.A. ATP World Tour 250,HARD,2,Kei Nishikori,James Blake,Kei Nishikori,6-3; 6-4,R16,64,3,1,37,57,30,37,13,20,2,2,10,43,57,5,4,30,50,23,30,9,20,0,2,9,32,50
2011-02-21 00:00:00.000,Delray Beach FL; U.S.A. ATP World Tour 250,HARD,2,Kevin Anderson,Florent Serra,Kevin Anderson,6-1; 6-4,R16,55,6,2,33,45,29,33,8,12,1,1,9,37,45,1,2,17,44,13,17,11,27,1,4,8,24,44
2011-02-21 00:00:00.000,Delray Beach FL; U.S.A. ATP World Tour 250,HARD,2,Juan Martin Del Potro,Teymuraz Gabashvili,Juan Martin Del Potro,6-1; 6-1,R16,70,4,0,24,35,22,24,6,11,0,0,7,28,35,2,1,14,42,5,14,12,28,3,8,7,17,42
2011-02-21 00:00:00.000,Delray Beach FL; U.S.A. ATP World Tour 250,HARD,2,Alejandro Falla,Adrian Mannarino,Alejandro Falla,6-3; 6-2,R16,78,4,3,22,45,15,22,16,23,1,2,8,31,45,5,2,47,75,25,47,10,28,8,13,9,35,75
2011-02-21 00:00:00.000,Delray Beach FL; U.S.A. ATP World Tour 250,HARD,2,Mardy Fish,Ricardo Mello,Mardy Fish,6-2; 6-1,R16,55,8,2,24,36,20,24,8,12,0,0,7,28,36,1,5,20,45,10,20,10,25,3,8,8,20,45
2011-02-21 00:00:00.000,Delray Beach FL; U.S.A. ATP World Tour 250,HARD,2,Janko Tipsarevic,Ivan Dodig,Janko Tipsarevic,7-6(0); 6-1,Q,79,4,0,38,59,32,38,15,21,3,3,10,47,59,8,4,36,53,27,36,6,17,0,2,9,33,53
2011-02-21 00:00:00.000,Delray Beach FL; U.S.A. ATP World Tour 250,HARD,2,Kei Nishikori,Ryan Sweeting,Kei Nishikori,6-7(5); 6-2; 6-4,Q,131,5,3,60,92,47,60,18,32,3,3,15,65,92,8,3,58,101,41,58,22,43,4,7,15,63,101
2011-02-21 00:00:00.000,Delray Beach FL; U.S.A. ATP World Tour 250,HARD,2,Juan Martin Del Potro,Kevin Anderson,Juan Martin Del Potro,6-4; 6-4,Q,83,6,0,34,54,27,34,14,20,0,0,10,41,54,4,1,33,53,28,33,9,20,0,2,10,37,53
2011-02-21 00:00:00.000,Delray Beach FL; U.S.A. ATP World Tour 250,HARD,2,Mardy Fish,Alejandro Falla,Mardy Fish,6-1; 6-4,Q,86,6,2,35,63,27,35,17,28,3,3,9,44,63,1,4,36,60,21,36,12,24,8,11,8,33,60
2011-02-21 00:00:00.000,Delray Beach FL; U.S.A. ATP World Tour 250,HARD,2,Janko Tipsarevic,Kei Nishikori,Janko Tipsarevic,6-4; 6-4,S,86,5,0,29,52,25,29,16,23,1,1,10,41,52,1,6,43,63,34,43,5,20,0,2,10,39,63
2011-02-21 00:00:00.000,Delray Beach FL; U.S.A. ATP World Tour 250,HARD,2,Juan Martin Del Potro,Mardy Fish,Juan Martin Del Potro,6-1; 7-5,S,96,1,1,34,56,26,34,10,22,2,4,10,36,56,2,1,32,56,19,32,8,24,2,7,9,27,56
2011-02-21 00:00:00.000,Delray Beach FL; U.S.A. ATP World Tour 250,HARD,2,Juan Martin Del Potro,Janko Tipsarevic,Juan Martin Del Potro,6-4; 6-4,F,114,5,2,45,75,29,45,19,30,10,11,10,48,75,8,3,31,63,24,31,15,32,2,5,10,39,63
2011-02-21 00:00:00.000,Dubai U.A.E. ATP World Tour 500,HARD,2,Roger Federer,Somdev Devvarman,Roger Federer,6-3; 6-3,R32,76,4,4,36,54,30,36,10,18,2,2,9,40,54,2,3,38,69,24,38,14,31,4,7,9,38,69
2011-02-21 00:00:00.000,Dubai U.A.E. ATP World Tour 500,HARD,2,Marcel Granollers,Dmitry Tursunov,Marcel Granollers,6-1; 6-3,R32,72,4,1,29,44,23,29,10,15,0,0,8,33,44,5,2,36,57,21,36,9,21,9,13,8,30,57
2011-02-21 00:00:00.000,Dubai U.A.E. ATP World Tour 500,HARD,2,Sergiy Stakhovsky,Omar Awadhy,Sergiy Stakhovsky,6-4; 6-2,R32,55,3,4,38,56,27,38,9,18,0,2,9,36,56,0,6,42,77,22,42,14,35,6,11,9,36,77
2011-02-21 00:00:00.000,Dubai U.A.E. ATP World Tour 500,HARD,2,Ernests Gulbis,Michael Berrer,Ernests Gulbis,6-3; 6-4,R32,94,10,7,48,77,35,48,14,29,3,3,10,49,77,4,3,39,64,29,39,9,25,5,7,9,38,64
2011-02-21 00:00:00.000,Dubai U.A.E. ATP World Tour 500,HARD,2,Gilles Simon,Mikhail Youzhny,Gilles Simon,6-3; 7-5,R32,92,8,4,30,68,24,30,22,38,0,1,11,46,68,0,2,34,58,24,34,12,24,5,8,10,36,58
2011-02-21 00:00:00.000,Dubai U.A.E. ATP World Tour 500,HARD,2,Lukas Rosol,Karol Beck,Lukas Rosol,7-6(2); 6-3,R32,89,14,1,33,64,29,33,20,31,1,1,11,49,64,4,5,36,72,27,36,18,36,2,3,10,45,72
2011-02-21 00:00:00.000,Dubai U.A.E. ATP World Tour 500,HARD,2,Richard Gasquet,Grigor Dimitrov,Richard Gasquet,6-2; 6-4,R32,64,9,1,37,49,31,37,8,12,3,3,9,39,49,3,6,29,56,21,29,11,27,4,7,9,32,56
2011-02-21 00:00:00.000,Dubai U.A.E. ATP World Tour 500,HARD,2,Sergei Bubka,Ivan Ljubicic,Sergei Bubka,6-1; 0-1 RET,R32,41,1,2,10,25,9,10,9,15,0,0,4,18,25,3,0,15,32,10,15,7,17,2,4,4,17,32
2011-02-21 00:00:00.000,Dubai U.A.E. ATP World Tour 500,HARD,2,Philipp Kohlschreiber,Viktor Troicki,Philipp Kohlschreiber,6-1; 7-6(2),R32,83,4,2,35,64,25,35,19,29,2,3,10,44,64,5,4,28,63,20,28,17,35,4,7,9,37,63
2011-02-21 00:00:00.000,Dubai U.A.E. ATP World Tour 500,HARD,2,Philipp Petzschner,Andreas Seppi,Philipp Petzschner,3-6; 7-6(2); 6-2,R32,106,14,7,46,93,36,46,24,47,6,9,14,60,93,8,2,43,85,34,43,20,42,4,8,15,54,85
2011-02-21 00:00:00.000,Dubai U.A.E. ATP World Tour 500,HARD,2,Nikolay Davydenko,Guillermo Garcia-Lopez,Nikolay Davydenko,6-2; 6-0,R32,57,1,1,39,51,25,39,7,12,4,5,7,32,51,0,5,19,37,7,19,4,18,2,8,7,11,37
2011-02-21 00:00:00.000,Dubai U.A.E. ATP World Tour 500,HARD,2,Tomas Berdych,Jeremy Chardy,Tomas Berdych,6-2; 6-3,R32,66,4,2,20,39,15,20,15,19,1,2,8,30,39,5,2,28,55,13,28,12,27,3,8,9,25,55
2011-02-21 00:00:00.000,Dubai U.A.E. ATP World Tour 500,HARD,2,Andrey Golubev,Marcos Baghdatis,Andrey Golubev,4-0 RET,R32,25,1,0,3,9,3,3,5,6,0,0,2,8,9,3,5,14,30,10,14,3,16,9,11,2,13,30
2011-02-21 00:00:00.000,Dubai U.A.E. ATP World Tour 500,HARD,2,Florian Mayer,Jarkko Nieminen,Florian Mayer,6-4; 6-2,R32,65,6,0,35,58,25,35,12,23,5,7,9,37,58,0,3,32,57,19,32,8,25,5,10,9,27,57
2011-02-21 00:00:00.000,Dubai U.A.E. ATP World Tour 500,HARD,2,Feliciano Lopez,Yen-Hsun Lu,Feliciano Lopez,5-0 RET,R32,21,3,0,5,10,4,5,4,5,0,0,2,8,10,0,2,22,26,9,22,1,4,3,6,3,10,26
2011-02-21 00:00:00.000,Dubai U.A.E. ATP World Tour 500,HARD,2,Novak Djokovic,Michael Llodra,Novak Djokovic,6-3; 6-3,R32,64,4,1,33,51,26,33,13,18,3,3,9,39,51,1,0,34,52,20,34,10,18,1,4,9,30,52
2011-02-21 00:00:00.000,Dubai U.A.E. ATP World Tour 500,HARD,2,Roger Federer,Marcel Granollers,Roger Federer,6-3; 6-4,R16,70,4,3,35,61,28,35,15,26,2,2,10,43,61,3,2,33,53,21,33,14,20,6,8,9,35,53
2011-02-21 00:00:00.000,Dubai U.A.E. ATP World Tour 500,HARD,2,Sergiy Stakhovsky,Ernests Gulbis,Sergiy Stakhovsky,6-3; 5-7; 6-1,R16,117,11,1,47,75,40,47,14,28,3,5,14,54,75,7,9,60,100,40,60,16,40,9,14,14,56,100
2011-02-21 00:00:00.000,Dubai U.A.E. ATP World Tour 500,HARD,2,Gilles Simon,Lukas Rosol,Gilles Simon,6-2; 6-3,R16,54,6,1,23,47,18,23,13,24,0,2,9,31,47,2,5,27,45,16,27,3,18,2,7,8,19,45
2011-02-21 00:00:00.000,Dubai U.A.E. ATP World Tour 500,HARD,2,Richard Gasquet,Sergei Bubka,Richard Gasquet,6-2; 7-5,R16,79,6,3,31,59,24,31,16,28,2,3,10,40,59,6,3,24,55,19,24,12,31,2,6,10,31,55
2011-02-21 00:00:00.000,Dubai U.A.E. ATP World Tour 500,HARD,2,Philipp Petzschner,Philipp Kohlschreiber,Philipp Petzschner,6-0; 4-6; 6-2,R16,95,4,1,34,68,27,34,22,34,1,2,12,49,68,6,4,36,74,24,36,15,38,8,13,12,39,74
2011-02-21 00:00:00.000,Dubai U.A.E. ATP World Tour 500,HARD,2,Tomas Berdych,Nikolay Davydenko,Tomas Berdych,6-3; 7-6(5),R16,104,3,2,41,74,31,41,16,33,6,8,11,47,74,1,2,39,54,28,39,6,15,2,5,10,34,54
2011-02-21 00:00:00.000,Dubai U.A.E. ATP World Tour 500,HARD,2,Florian Mayer,Andrey Golubev,Florian Mayer,6-3; 6-4,R16,75,1,2,34,61,26,34,14,27,3,4,10,40,61,3,2,30,57,19,30,13,27,4,7,9,32,57
2011-02-21 00:00:00.000,Dubai U.A.E. ATP World Tour 500,HARD,2,Novak Djokovic,Feliciano Lopez,Novak Djokovic,6-3; 2-6; 6-4,R16,109,6,2,48,73,34,48,15,25,1,4,14,49,73,7,6,36,74,29,36,19,38,3,6,13,48,74
2011-02-21 00:00:00.000,Dubai U.A.E. ATP World Tour 500,HARD,2,Roger Federer,Sergiy Stakhovsky,Roger Federer,6-3; 6-4,Q,73,6,2,42,67,30,42,14,25,8,9,10,44,67,3,1,30,57,21,30,13,27,6,9,9,34,57
2011-02-21 00:00:00.000,Dubai U.A.E. ATP World Tour 500,HARD,2,Richard Gasquet,Gilles Simon,Richard Gasquet,5-7; 6-2; 6-4,Q,124,4,1,51,92,36,51,24,41,3,5,15,60,92,4,4,50,85,35,50,15,35,3,7,15,50,85
2011-02-21 00:00:00.000,Dubai U.A.E. ATP World Tour 500,HARD,2,Tomas Berdych,Philipp Petzschner,Tomas Berdych,7-5; 6-4,Q,107,6,1,43,77,30,43,16,34,6,8,11,46,77,11,1,31,65,19,31,18,34,6,10,11,37,65
2011-02-21 00:00:00.000,Dubai U.A.E. ATP World Tour 500,HARD,2,Novak Djokovic,Florian Mayer,Novak Djokovic,7-5; 6-1,Q,76,6,2,42,62,36,42,8,20,4,5,10,44,62,3,4,30,57,18,30,11,27,3,7,9,29,57
2011-02-21 00:00:00.000,Dubai U.A.E. ATP World Tour 500,HARD,2,Roger Federer,Richard Gasquet,Roger Federer,6-2; 7-5,S,74,6,1,38,57,30,38,9,19,1,2,10,39,57,7,4,45,67,24,45,12,22,4,8,10,36,67
2011-02-21 00:00:00.000,Dubai U.A.E. ATP World Tour 500,HARD,2,Novak Djokovic,Tomas Berdych,Novak Djokovic,6-7(5); 6-2; 4-2 RET,S,142,10,2,53,84,40,53,20,31,4,4,13,60,84,9,1,42,86,34,42,18,44,2,5,13,52,86
2011-02-21 00:00:00.000,Dubai U.A.E. ATP World Tour 500,HARD,2,Novak Djokovic,Roger Federer,Novak Djokovic,6-3; 6-3,F,72,5,0,33,49,27,33,9,16,1,2,9,36,49,5,1,35,58,22,35,9,23,6,10,9,31,58
2011-03-10 00:00:00.000,ATP World Tour Masters 1000 Indian Wells CA; U.S.A. ATP World Tour Masters 1000,HARD,2,Rafael Nadal,N/A Bye,Rafael Nadal,,R128,0,0,0,0,0,0,0,0,0,0,0,0,0,0,0,0,0,0,0,0,0,0,0,0,0,0,0
2011-03-10 00:00:00.000,ATP World Tour Masters 1000 Indian Wells CA; U.S.A. ATP World Tour Masters 1000,HARD,2,Rik De Voest,Pere Riba,Rik De Voest,6-4 RET,R128,43,2,0,19,30,16,19,6,11,0,0,5,22,30,1,1,15,34,8,15,12,19,1,2,5,20,34
2011-03-10 00:00:00.000,ATP World Tour Masters 1000 Indian Wells CA; U.S.A. ATP World Tour Masters 1000,HARD,2,Ryan Sweeting,Marcel Granollers,Ryan Sweeting,6-4; 6-1,R128,86,3,3,37,53,27,37,8,16,4,5,8,35,53,1,5,34,68,21,34,13,34,5,10,9,34,68
2011-03-10 00:00:00.000,ATP World Tour Masters 1000 Indian Wells CA; U.S.A. ATP World Tour Masters 1000,HARD,2,Juan Monaco,N/A Bye,Juan Monaco,,R128,0,0,0,0,0,0,0,0,0,0,0,0,0,0,0,0,0,0,0,0,0,0,0,0,0,0,0
2011-03-10 00:00:00.000,ATP World Tour Masters 1000 Indian Wells CA; U.S.A. ATP World Tour Masters 1000,HARD,2,Marcos Baghdatis,N/A Bye,Marcos Baghdatis,,R128,0,0,0,0,0,0,0,0,0,0,0,0,0,0,0,0,0,0,0,0,0,0,0,0,0,0,0
2011-03-10 00:00:00.000,ATP World Tour Masters 1000 Indian Wells CA; U.S.A. ATP World Tour Masters 1000,HARD,2,Somdev Devvarman,Adrian Mannarino,Somdev Devvarman,6-2; 6-3,R128,84,6,0,34,51,27,34,9,17,4,4,8,36,51,3,3,41,67,23,41,13,26,5,9,9,36,67
2011-03-10 00:00:00.000,ATP World Tour Masters 1000 Indian Wells CA; U.S.A. ATP World Tour Masters 1000,HARD,2,Xavier Malisse,Flavio Cipolla,Xavier Malisse,6-1; 6-4,R128,70,8,0,30,54,24,30,12,24,1,2,9,36,54,1,5,27,48,15,27,9,21,1,5,8,24,48
2011-03-10 00:00:00.000,ATP World Tour Masters 1000 Indian Wells CA; U.S.A. ATP World Tour Masters 1000,HARD,2,Jo-Wilfried Tsonga,N/A Bye,Jo-Wilfried Tsonga,,R128,0,0,0,0,0,0,0,0,0,0,0,0,0,0,0,0,0,0,0,0,0,0,0,0,0,0,0
2011-03-10 00:00:00.000,ATP World Tour Masters 1000 Indian Wells CA; U.S.A. ATP World Tour Masters 1000,HARD,2,Nicolas Almagro,N/A Bye,Nicolas Almagro,,R128,0,0,0,0,0,0,0,0,0,0,0,0,0,0,0,0,0,0,0,0,0,0,0,0,0,0,0
2011-03-10 00:00:00.000,ATP World Tour Masters 1000 Indian Wells CA; U.S.A. ATP World Tour Masters 1000,HARD,2,Michael Russell,Kevin Anderson,Michael Russell,6-7(4); 6-3; 6-4,R128,151,0,2,75,100,56,75,18,25,5,5,16,74,100,12,3,58,98,43,58,21,40,5,7,15,64,98
2011-03-10 00:00:00.000,ATP World Tour Masters 1000 Indian Wells CA; U.S.A. ATP World Tour Masters 1000,HARD,2,Jarkko Nieminen,Denis Istomin,Jarkko Nieminen,2-6; 7-5; 7-5,R128,137,1,7,66,108,43,66,12,42,6,14,16,55,108,6,3,69,97,39,69,11,28,8,16,16,50,97
2011-03-10 00:00:00.000,ATP World Tour Masters 1000 Indian Wells CA; U.S.A. ATP World Tour Masters 1000,HARD,2,Albert Montanes,N/A Bye,Albert Montanes,,R128,0,0,0,0,0,0,0,0,0,0,0,0,0,0,0,0,0,0,0,0,0,0,0,0,0,0,0
2011-03-10 00:00:00.000,ATP World Tour Masters 1000 Indian Wells CA; U.S.A. ATP World Tour Masters 1000,HARD,2,Gilles Simon,N/A Bye,Gilles Simon,,R128,0,0,0,0,0,0,0,0,0,0,0,0,0,0,0,0,0,0,0,0,0,0,0,0,0,0,0
2011-03-10 00:00:00.000,ATP World Tour Masters 1000 Indian Wells CA; U.S.A. ATP World Tour Masters 1000,HARD,2,Rainer Schuettler,Robin Haase,Rainer Schuettler,7-6(4); 7-5,R128,131,4,1,66,95,43,66,13,29,6,9,12,56,95,1,5,53,93,33,53,19,40,4,8,12,52,93
2011-03-10 00:00:00.000,ATP World Tour Masters 1000 Indian Wells CA; U.S.A. ATP World Tour Masters 1000,HARD,2,Ivo Karlovic,Marinko Matosevic,Ivo Karlovic,7-6(2); 6-7(3); 6-2,R128,128,17,2,61,93,52,61,16,32,0,1,16,68,93,6,2,59,103,45,59,21,44,3,6,16,66,103
2011-03-10 00:00:00.000,ATP World Tour Masters 1000 Indian Wells CA; U.S.A. ATP World Tour Masters 1000,HARD,2,David Ferrer,N/A Bye,David Ferrer,,R128,0,0,0,0,0,0,0,0,0,0,0,0,0,0,0,0,0,0,0,0,0,0,0,0,0,0,0
2011-03-10 00:00:00.000,ATP World Tour Masters 1000 Indian Wells CA; U.S.A. ATP World Tour Masters 1000,HARD,2,Robin Soderling,N/A Bye,Robin Soderling,,R128,0,0,0,0,0,0,0,0,0,0,0,0,0,0,0,0,0,0,0,0,0,0,0,0,0,0,0
2011-03-10 00:00:00.000,ATP World Tour Masters 1000 Indian Wells CA; U.S.A. ATP World Tour Masters 1000,HARD,2,Michael Berrer,Bjorn Phau,Michael Berrer,6-4; 4-6; 6-4,R128,128,5,11,65,95,48,65,10,30,4,7,15,58,95,3,7,59,92,42,59,15,33,2,6,15,57,92
2011-03-10 00:00:00.000,ATP World Tour Masters 1000 Indian Wells CA; U.S.A. ATP World Tour Masters 1000,HARD,2,Tim Smyczek,Illya Marchenko,Tim Smyczek,2-6; 6-3; 6-2,R128,132,3,2,40,76,27,40,20,36,3,6,13,47,76,4,5,50,91,30,50,21,41,10,14,12,51,91
2011-03-10 00:00:00.000,ATP World Tour Masters 1000 Indian Wells CA; U.S.A. ATP World Tour Masters 1000,HARD,2,Philipp Kohlschreiber,N/A Bye,Philipp Kohlschreiber,,R128,0,0,0,0,0,0,0,0,0,0,0,0,0,0,0,0,0,0,0,0,0,0,0,0,0,0,0
2011-03-10 00:00:00.000,ATP World Tour Masters 1000 Indian Wells CA; U.S.A. ATP World Tour Masters 1000,HARD,2,Alexandr Dolgopolov,N/A Bye,Alexandr Dolgopolov,,R128,0,0,0,0,0,0,0,0,0,0,0,0,0,0,0,0,0,0,0,0,0,0,0,0,0,0,0
2011-03-10 00:00:00.000,ATP World Tour Masters 1000 Indian Wells CA; U.S.A. ATP World Tour Masters 1000,HARD,2,Victor Hanescu,Andreas Seppi,Victor Hanescu,4-6; 7-6(5); 6-3,R128,123,8,1,51,82,41,51,19,31,0,2,15,60,82,8,4,54,102,42,54,24,48,7,10,16,66,102
2011-03-10 00:00:00.000,ATP World Tour Masters 1000 Indian Wells CA; U.S.A. ATP World Tour Masters 1000,HARD,2,Juan Martin Del Potro,Radek Stepanek,Juan Martin Del Potro,6-4; 6-0,R128,85,5,3,27,57,21,27,16,30,5,6,8,37,57,3,3,33,55,14,33,11,22,3,8,8,25,55
2011-03-10 00:00:00.000,ATP World Tour Masters 1000 Indian Wells CA; U.S.A. ATP World Tour Masters 1000,HARD,2,Ivan Ljubicic,N/A Bye,Ivan Ljubicic,,R128,0,0,0,0,0,0,0,0,0,0,0,0,0,0,0,0,0,0,0,0,0,0,0,0,0,0,0
2011-03-10 00:00:00.000,ATP World Tour Masters 1000 Indian Wells CA; U.S.A. ATP World Tour Masters 1000,HARD,2,Fernando Verdasco,N/A Bye,Fernando Verdasco,,R128,0,0,0,0,0,0,0,0,0,0,0,0,0,0,0,0,0,0,0,0,0,0,0,0,0,0,0
2011-03-10 00:00:00.000,ATP World Tour Masters 1000 Indian Wells CA; U.S.A. ATP World Tour Masters 1000,HARD,2,Ricardas Berankis,Alex Bogomolov Jr.,Ricardas Berankis,1-6; 6-3; 6-4,R128,113,4,4,30,74,21,30,23,44,3,7,13,44,74,5,4,62,85,40,62,10,23,5,9,13,50,85
2011-03-10 00:00:00.000,ATP World Tour Masters 1000 Indian Wells CA; U.S.A. ATP World Tour Masters 1000,HARD,2,Janko Tipsarevic,Tobias Kamke,Janko Tipsarevic,6-2; 6-0,R128,57,5,1,17,34,16,17,12,17,0,0,7,28,34,1,2,24,43,10,24,7,19,1,6,7,17,43
2011-03-10 00:00:00.000,ATP World Tour Masters 1000 Indian Wells CA; U.S.A. ATP World Tour Masters 1000,HARD,2,Sam Querrey,N/A Bye,Sam Querrey,,R128,0,0,0,0,0,0,0,0,0,0,0,0,0,0,0,0,0,0,0,0,0,0,0,0,0,0,0
2011-03-10 00:00:00.000,ATP World Tour Masters 1000 Indian Wells CA; U.S.A. ATP World Tour Masters 1000,HARD,2,Tommy Robredo,N/A Bye,Tommy Robredo,,R128,0,0,0,0,0,0,0,0,0,0,0,0,0,0,0,0,0,0,0,0,0,0,0,0,0,0,0
2011-03-10 00:00:00.000,ATP World Tour Masters 1000 Indian Wells CA; U.S.A. ATP World Tour Masters 1000,HARD,2,Mischa Zverev,Matthew Ebden,Mischa Zverev,6-4; 6-3,R128,68,2,0,35,49,30,35,8,14,2,2,9,38,49,3,3,44,67,26,44,14,23,4,7,10,40,67
2011-03-10 00:00:00.000,ATP World Tour Masters 1000 Indian Wells CA; U.S.A. ATP World Tour Masters 1000,HARD,2,Donald Young,Potito Starace,Donald Young,2-6; 6-3; 6-3,R128,119,3,4,45,96,27,45,29,51,9,12,13,56,96,2,0,41,71,25,41,19,30,2,6,13,44,71
2011-03-10 00:00:00.000,ATP World Tour Masters 1000 Indian Wells CA; U.S.A. ATP World Tour Masters 1000,HARD,2,Andy Murray,N/A Bye,Andy Murray,,R128,0,0,0,0,0,0,0,0,0,0,0,0,0,0,0,0,0,0,0,0,0,0,0,0,0,0,0
2011-03-10 00:00:00.000,ATP World Tour Masters 1000 Indian Wells CA; U.S.A. ATP World Tour Masters 1000,HARD,2,Andy Roddick,N/A Bye,Andy Roddick,,R128,0,0,0,0,0,0,0,0,0,0,0,0,0,0,0,0,0,0,0,0,0,0,0,0,0,0,0
2011-03-10 00:00:00.000,ATP World Tour Masters 1000 Indian Wells CA; U.S.A. ATP World Tour Masters 1000,HARD,2,James Blake,Chris Guccione,James Blake,3-6; 6-3; 6-2,R128,96,6,5,38,70,34,38,20,32,3,4,13,54,70,19,6,49,87,39,49,14,38,5,8,13,53,87
2011-03-10 00:00:00.000,ATP World Tour Masters 1000 Indian Wells CA; U.S.A. ATP World Tour Masters 1000,HARD,2,Ricardo Mello,Ruben Ramirez Hidalgo,Ricardo Mello,6-4; 6-3,R128,95,3,0,34,46,23,34,9,12,0,1,9,32,46,2,3,50,86,30,50,16,36,13,17,10,46,86
2011-03-10 00:00:00.000,ATP World Tour Masters 1000 Indian Wells CA; U.S.A. ATP World Tour Masters 1000,HARD,2,John Isner,N/A Bye,John Isner,,R128,0,0,0,0,0,0,0,0,0,0,0,0,0,0,0,0,0,0,0,0,0,0,0,0,0,0,0
2011-03-10 00:00:00.000,ATP World Tour Masters 1000 Indian Wells CA; U.S.A. ATP World Tour Masters 1000,HARD,2,Richard Gasquet,N/A Bye,Richard Gasquet,,R128,0,0,0,0,0,0,0,0,0,0,0,0,0,0,0,0,0,0,0,0,0,0,0,0,0,0,0
2011-03-10 00:00:00.000,ATP World Tour Masters 1000 Indian Wells CA; U.S.A. ATP World Tour Masters 1000,HARD,2,Pablo Cuevas,Pablo Andujar,Pablo Cuevas,7-5; 6-3,R128,79,1,3,34,59,28,34,17,25,0,0,11,45,59,0,3,37,59,25,37,14,22,1,3,10,39,59
2011-03-10 00:00:00.000,ATP World Tour Masters 1000 Indian Wells CA; U.S.A. ATP World Tour Masters 1000,HARD,2,Julien Benneteau,Feliciano Lopez,Julien Benneteau,6-4; 6-4,R128,85,7,3,45,72,33,45,16,27,4,4,10,49,72,6,2,29,55,22,29,16,26,4,6,10,38,55
2011-03-10 00:00:00.000,ATP World Tour Masters 1000 Indian Wells CA; U.S.A. ATP World Tour Masters 1000,HARD,2,Jurgen Melzer,N/A Bye,Jurgen Melzer,,R128,0,0,0,0,0,0,0,0,0,0,0,0,0,0,0,0,0,0,0,0,0,0,0,0,0,0,0
2011-03-10 00:00:00.000,ATP World Tour Masters 1000 Indian Wells CA; U.S.A. ATP World Tour Masters 1000,HARD,2,Viktor Troicki,N/A Bye,Viktor Troicki,,R128,0,0,0,0,0,0,0,0,0,0,0,0,0,0,0,0,0,0,0,0,0,0,0,0,0,0,0
2011-03-10 00:00:00.000,ATP World Tour Masters 1000 Indian Wells CA; U.S.A. ATP World Tour Masters 1000,HARD,2,Bernard Tomic,Rohan Bopanna,Bernard Tomic,6-7(5); 7-6(1); 6-4,R128,109,14,3,65,102,52,65,25,37,2,2,17,77,102,23,2,55,104,46,55,31,49,6,7,17,77,104
2011-03-10 00:00:00.000,ATP World Tour Masters 1000 Indian Wells CA; U.S.A. ATP World Tour Masters 1000,HARD,2,Santiago Giraldo,Daniel Gimeno-Traver,Santiago Giraldo,6-4; 6-7(5); 6-3,R128,149,4,4,63,107,45,63,24,44,1,3,16,69,107,5,6,55,106,38,55,25,51,6,10,15,63,106
2011-03-10 00:00:00.000,ATP World Tour Masters 1000 Indian Wells CA; U.S.A. ATP World Tour Masters 1000,HARD,2,Michael Llodra,N/A Bye,Michael Llodra,,R128,0,0,0,0,0,0,0,0,0,0,0,0,0,0,0,0,0,0,0,0,0,0,0,0,0,0,0
2011-03-10 00:00:00.000,ATP World Tour Masters 1000 Indian Wells CA; U.S.A. ATP World Tour Masters 1000,HARD,2,Ernests Gulbis,N/A Bye,Ernests Gulbis,,R128,0,0,0,0,0,0,0,0,0,0,0,0,0,0,0,0,0,0,0,0,0,0,0,0,0,0,0
2011-03-10 00:00:00.000,ATP World Tour Masters 1000 Indian Wells CA; U.S.A. ATP World Tour Masters 1000,HARD,2,Yen-Hsun Lu,Lleyton Hewitt,Yen-Hsun Lu,6-2; 6-3,R128,83,2,2,42,71,31,42,13,29,6,8,9,44,71,0,5,20,44,14,20,4,24,3,8,8,18,44
2011-03-10 00:00:00.000,ATP World Tour Masters 1000 Indian Wells CA; U.S.A. ATP World Tour Masters 1000,HARD,2,Andrey Golubev,Florian Mayer,Andrey Golubev,6-2; 6-1,R128,45,4,0,24,37,21,24,11,13,0,0,8,32,37,1,2,21,34,8,21,7,13,0,4,7,15,34
2011-03-10 00:00:00.000,ATP World Tour Masters 1000 Indian Wells CA; U.S.A. ATP World Tour Masters 1000,HARD,2,Novak Djokovic,N/A Bye,Novak Djokovic,,R128,0,0,0,0,0,0,0,0,0,0,0,0,0,0,0,0,0,0,0,0,0,0,0,0,0,0,0
2011-03-10 00:00:00.000,ATP World Tour Masters 1000 Indian Wells CA; U.S.A. ATP World Tour Masters 1000,HARD,2,Tomas Berdych,N/A Bye,Tomas Berdych,,R128,0,0,0,0,0,0,0,0,0,0,0,0,0,0,0,0,0,0,0,0,0,0,0,0,0,0,0
2011-03-10 00:00:00.000,ATP World Tour Masters 1000 Indian Wells CA; U.S.A. ATP World Tour Masters 1000,HARD,2,Lukasz Kubot,Mikhail Kukushkin,Lukasz Kubot,7-6(8); 6-4,R128,122,8,9,54,87,41,54,18,33,5,6,11,59,87,6,2,54,78,39,54,11,24,4,6,11,50,78
2011-03-10 00:00:00.000,ATP World Tour Masters 1000 Indian Wells CA; U.S.A. ATP World Tour Masters 1000,HARD,2,Benjamin Becker,Thiemo de Bakker,Benjamin Becker,6-2; 7-5,R128,86,11,2,28,53,25,28,16,25,0,0,10,41,53,7,2,35,68,24,35,17,33,4,7,10,41,68
2011-03-10 00:00:00.000,ATP World Tour Masters 1000 Indian Wells CA; U.S.A. ATP World Tour Masters 1000,HARD,2,Thomaz Bellucci,N/A Bye,Thomaz Bellucci,,R128,0,0,0,0,0,0,0,0,0,0,0,0,0,0,0,0,0,0,0,0,0,0,0,0,0,0,0
2011-03-10 00:00:00.000,ATP World Tour Masters 1000 Indian Wells CA; U.S.A. ATP World Tour Masters 1000,HARD,2,Marin Cilic,N/A Bye,Marin Cilic,,R128,0,0,0,0,0,0,0,0,0,0,0,0,0,0,0,0,0,0,0,0,0,0,0,0,0,0,0
2011-03-10 00:00:00.000,ATP World Tour Masters 1000 Indian Wells CA; U.S.A. ATP World Tour Masters 1000,HARD,2,Florent Serra,Teymuraz Gabashvili,Florent Serra,6-4; 6-7(1); 7-6(4),R128,166,5,2,64,119,44,64,24,55,7,11,17,68,119,7,5,49,100,38,49,25,51,8,13,17,63,100
2011-03-10 00:00:00.000,ATP World Tour Masters 1000 Indian Wells CA; U.S.A. ATP World Tour Masters 1000,HARD,2,Nikolay Davydenko,Fabio Fognini,Nikolay Davydenko,5-7; 6-2; 6-4,R128,128,0,5,63,90,38,63,17,27,4,8,15,55,90,4,5,59,104,39,59,15,45,10,16,15,54,104
2011-03-10 00:00:00.000,ATP World Tour Masters 1000 Indian Wells CA; U.S.A. ATP World Tour Masters 1000,HARD,2,Stanislas Wawrinka,N/A Bye,Stanislas Wawrinka,,R128,0,0,0,0,0,0,0,0,0,0,0,0,0,0,0,0,0,0,0,0,0,0,0,0,0,0,0
2011-03-10 00:00:00.000,ATP World Tour Masters 1000 Indian Wells CA; U.S.A. ATP World Tour Masters 1000,HARD,2,Mardy Fish,N/A Bye,Mardy Fish,,R128,0,0,0,0,0,0,0,0,0,0,0,0,0,0,0,0,0,0,0,0,0,0,0,0,0,0,0
2011-03-10 00:00:00.000,ATP World Tour Masters 1000 Indian Wells CA; U.S.A. ATP World Tour Masters 1000,HARD,2,Milos Raonic,Marsel Ilhan,Milos Raonic,6-2; 7-6(4),R128,85,10,3,28,61,24,28,21,33,2,3,10,45,61,3,2,46,71,25,46,16,25,4,7,10,41,71
2011-03-10 00:00:00.000,ATP World Tour Masters 1000 Indian Wells CA; U.S.A. ATP World Tour Masters 1000,HARD,2,Ryan Harrison,Jeremy Chardy,Ryan Harrison,6-7(5); 7-6(2); 6-3,R128,157,13,2,71,113,57,71,17,42,9,12,17,74,113,9,9,75,116,47,75,19,41,6,10,16,66,116
2011-03-10 00:00:00.000,ATP World Tour Masters 1000 Indian Wells CA; U.S.A. ATP World Tour Masters 1000,HARD,2,Guillermo Garcia-Lopez,N/A Bye,Guillermo Garcia-Lopez,,R128,0,0,0,0,0,0,0,0,0,0,0,0,0,0,0,0,0,0,0,0,0,0,0,0,0,0,0
2011-03-10 00:00:00.000,ATP World Tour Masters 1000 Indian Wells CA; U.S.A. ATP World Tour Masters 1000,HARD,2,Juan Ignacio Chela,N/A Bye,Juan Ignacio Chela,,R128,0,0,0,0,0,0,0,0,0,0,0,0,0,0,0,0,0,0,0,0,0,0,0,0,0,0,0
2011-03-10 00:00:00.000,ATP World Tour Masters 1000 Indian Wells CA; U.S.A. ATP World Tour Masters 1000,HARD,2,Philipp Petzschner,Dustin Brown,Philipp Petzschner,6-4; 7-5,R128,84,5,7,35,71,27,35,19,36,1,2,11,46,71,3,1,39,70,25,39,18,31,4,7,11,43,70
2011-03-10 00:00:00.000,ATP World Tour Masters 1000 Indian Wells CA; U.S.A. ATP World Tour Masters 1000,HARD,2,Igor Andreev,Kei Nishikori,Igor Andreev,6-4; 6-7(2); 6-4,R128,153,9,0,55,102,38,55,30,47,3,5,16,68,102,1,6,56,106,40,56,27,50,5,9,16,67,106
2011-03-10 00:00:00.000,ATP World Tour Masters 1000 Indian Wells CA; U.S.A. ATP World Tour Masters 1000,HARD,2,Roger Federer,N/A Bye,Roger Federer,,R128,0,0,0,0,0,0,0,0,0,0,0,0,0,0,0,0,0,0,0,0,0,0,0,0,0,0,0
2011-03-10 00:00:00.000,ATP World Tour Masters 1000 Indian Wells CA; U.S.A. ATP World Tour Masters 1000,HARD,2,Rafael Nadal,Rik De Voest,Rafael Nadal,6-0; 6-2,R64,60,1,3,16,34,16,16,12,18,0,0,7,28,34,1,2,28,48,15,28,7,20,3,8,7,22,48
2011-03-10 00:00:00.000,ATP World Tour Masters 1000 Indian Wells CA; U.S.A. ATP World Tour Masters 1000,HARD,2,Ryan Sweeting,Juan Monaco,Ryan Sweeting,6-1; 0-6; 6-1,R64,106,2,0,49,68,29,49,12,19,8,11,10,41,68,2,1,55,77,31,55,10,22,4,9,10,41,77
2011-03-10 00:00:00.000,ATP World Tour Masters 1000 Indian Wells CA; U.S.A. ATP World Tour Masters 1000,HARD,2,Somdev Devvarman,Marcos Baghdatis,Somdev Devvarman,7-5; 6-0,R64,73,0,1,27,46,23,27,13,19,2,3,9,36,46,5,6,26,57,18,26,11,31,3,8,9,29,57
2011-03-10 00:00:00.000,ATP World Tour Masters 1000 Indian Wells CA; U.S.A. ATP World Tour Masters 1000,HARD,2,Xavier Malisse,Jo-Wilfried Tsonga,Xavier Malisse,7-6(6); 7-5,R64,94,3,0,44,72,34,44,18,28,2,4,12,52,72,8,3,44,75,34,44,13,31,5,8,12,47,75
2011-03-10 00:00:00.000,ATP World Tour Masters 1000 Indian Wells CA; U.S.A. ATP World Tour Masters 1000,HARD,2,Nicolas Almagro,Michael Russell,Nicolas Almagro,6-4; 6-4,R64,79,9,3,39,57,32,39,10,18,2,3,10,42,57,1,4,49,69,33,49,8,20,8,11,10,41,69
2011-03-10 00:00:00.000,ATP World Tour Masters 1000 Indian Wells CA; U.S.A. ATP World Tour Masters 1000,HARD,2,Albert Montanes,Jarkko Nieminen,Albert Montanes,7-6(5); 2-6; 7-6(2),R64,147,4,8,68,112,51,68,20,44,6,10,16,71,112,6,1,76,115,51,76,23,39,6,8,16,74,115
2011-03-10 00:00:00.000,ATP World Tour Masters 1000 Indian Wells CA; U.S.A. ATP World Tour Masters 1000,HARD,2,Gilles Simon,Rainer Schuettler,Gilles Simon,6-3; 7-6(5),R64,100,4,4,36,68,27,36,18,32,2,4,11,45,68,2,2,38,68,25,38,15,30,3,6,10,40,68
2011-03-10 00:00:00.000,ATP World Tour Masters 1000 Indian Wells CA; U.S.A. ATP World Tour Masters 1000,HARD,2,Ivo Karlovic,David Ferrer,Ivo Karlovic,7-6(3); 6-3,R64,96,9,5,42,73,36,42,15,31,3,3,11,51,73,1,5,31,68,22,31,21,37,3,4,10,43,68
2011-03-10 00:00:00.000,ATP World Tour Masters 1000 Indian Wells CA; U.S.A. ATP World Tour Masters 1000,HARD,2,Robin Soderling,Michael Berrer,Robin Soderling,6-3; 7-6(4),R64,100,6,2,49,75,33,49,18,26,8,10,11,51,75,9,3,41,70,30,41,11,29,4,7,10,41,70
2011-03-10 00:00:00.000,ATP World Tour Masters 1000 Indian Wells CA; U.S.A. ATP World Tour Masters 1000,HARD,2,Philipp Kohlschreiber,Tim Smyczek,Philipp Kohlschreiber,2-6; 6-2; 7-6(6),R64,132,2,4,56,95,40,56,19,39,9,12,14,59,95,4,4,61,98,37,61,24,37,6,9,14,61,98
2011-03-10 00:00:00.000,ATP World Tour Masters 1000 Indian Wells CA; U.S.A. ATP World Tour Masters 1000,HARD,2,Alexandr Dolgopolov,Victor Hanescu,Alexandr Dolgopolov,6-4; 6-4,R64,73,7,2,30,58,23,30,19,28,2,3,10,42,58,2,3,49,64,32,49,6,15,2,5,10,38,64
2011-03-10 00:00:00.000,ATP World Tour Masters 1000 Indian Wells CA; U.S.A. ATP World Tour Masters 1000,HARD,2,Juan Martin Del Potro,Ivan Ljubicic,Juan Martin Del Potro,5-7; 6-4; 6-2,R64,158,8,2,47,87,38,47,25,40,4,5,15,63,87,8,3,46,99,35,46,26,53,4,7,15,61,99
2011-03-10 00:00:00.000,ATP World Tour Masters 1000 Indian Wells CA; U.S.A. ATP World Tour Masters 1000,HARD,2,Fernando Verdasco,Ricardas Berankis,Fernando Verdasco,7-5; 2-0 RET,R64,72,2,3,32,49,24,32,7,17,2,3,7,31,49,2,3,30,60,22,30,9,30,5,8,7,31,60
2011-03-10 00:00:00.000,ATP World Tour Masters 1000 Indian Wells CA; U.S.A. ATP World Tour Masters 1000,HARD,2,Sam Querrey,Janko Tipsarevic,Sam Querrey,6-4; 6-4,R64,82,11,1,40,59,34,40,9,19,2,2,10,43,59,2,4,41,68,30,41,12,27,6,8,10,42,68
2011-03-10 00:00:00.000,ATP World Tour Masters 1000 Indian Wells CA; U.S.A. ATP World Tour Masters 1000,HARD,2,Tommy Robredo,Mischa Zverev,Tommy Robredo,6-3; 3-6; 7-5,R64,138,8,6,43,83,28,43,25,40,2,6,15,53,83,4,1,79,119,50,79,15,40,15,20,15,65,119
2011-03-10 00:00:00.000,ATP World Tour Masters 1000 Indian Wells CA; U.S.A. ATP World Tour Masters 1000,HARD,2,Donald Young,Andy Murray,Donald Young,7-6(4); 6-3,R64,94,1,7,31,59,26,31,13,28,1,3,10,39,59,8,4,38,77,31,38,11,39,1,5,11,42,77
2011-03-10 00:00:00.000,ATP World Tour Masters 1000 Indian Wells CA; U.S.A. ATP World Tour Masters 1000,HARD,2,Andy Roddick,James Blake,Andy Roddick,6-3; 7-5,R64,90,13,0,32,57,30,32,14,25,4,5,11,44,57,4,5,44,86,23,44,24,42,12,15,10,47,86
2011-03-10 00:00:00.000,ATP World Tour Masters 1000 Indian Wells CA; U.S.A. ATP World Tour Masters 1000,HARD,2,John Isner,Ricardo Mello,John Isner,6-3; 7-6(2),R64,79,12,2,43,60,35,43,14,17,0,0,11,49,60,1,0,46,65,28,46,14,19,3,4,10,42,65
2011-03-10 00:00:00.000,ATP World Tour Masters 1000 Indian Wells CA; U.S.A. ATP World Tour Masters 1000,HARD,2,Richard Gasquet,Pablo Cuevas,Richard Gasquet,7-5; 6-3,R64,75,8,0,40,58,35,40,10,18,1,1,11,45,58,5,0,36,49,26,36,7,13,1,3,10,33,49
2011-03-10 00:00:00.000,ATP World Tour Masters 1000 Indian Wells CA; U.S.A. ATP World Tour Masters 1000,HARD,2,Jurgen Melzer,Julien Benneteau,Jurgen Melzer,1-6; 6-1; 6-4,R64,100,6,2,43,70,25,43,18,27,4,7,12,43,70,3,7,45,73,31,45,11,28,3,7,12,42,73
2011-03-10 00:00:00.000,ATP World Tour Masters 1000 Indian Wells CA; U.S.A. ATP World Tour Masters 1000,HARD,2,Viktor Troicki,Bernard Tomic,Viktor Troicki,6-4; 6-4,R64,94,10,3,33,72,28,33,17,39,5,6,10,45,72,3,4,37,75,24,37,18,38,5,8,10,42,75
2011-03-10 00:00:00.000,ATP World Tour Masters 1000 Indian Wells CA; U.S.A. ATP World Tour Masters 1000,HARD,2,Michael Llodra,Santiago Giraldo,Michael Llodra,7-6(6); 6-4,R64,89,11,2,39,63,30,39,17,24,2,3,11,47,63,2,0,53,76,34,53,15,23,5,7,11,49,76
2011-03-10 00:00:00.000,ATP World Tour Masters 1000 Indian Wells CA; U.S.A. ATP World Tour Masters 1000,HARD,2,Ernests Gulbis,Yen-Hsun Lu,Ernests Gulbis,6-7(1); 7-6(7); 6-1,R64,130,19,3,58,103,49,58,20,45,1,3,16,69,103,2,5,60,96,43,60,17,36,1,5,15,60,96
2011-03-10 00:00:00.000,ATP World Tour Masters 1000 Indian Wells CA; U.S.A. ATP World Tour Masters 1000,HARD,2,Novak Djokovic,Andrey Golubev,Novak Djokovic,6-0; 6-4,R64,60,0,2,23,36,18,23,11,13,0,1,8,29,36,3,2,22,43,12,22,8,21,1,6,8,20,43
2011-03-10 00:00:00.000,ATP World Tour Masters 1000 Indian Wells CA; U.S.A. ATP World Tour Masters 1000,HARD,2,Tomas Berdych,Lukasz Kubot,Tomas Berdych,6-4; 6-1,R64,74,8,2,24,42,22,24,11,18,0,1,9,33,42,7,7,38,58,24,38,6,20,3,7,8,30,58
2011-03-10 00:00:00.000,ATP World Tour Masters 1000 Indian Wells CA; U.S.A. ATP World Tour Masters 1000,HARD,2,Thomaz Bellucci,Benjamin Becker,Thomaz Bellucci,6-3; 7-6(5),R64,89,6,1,47,69,39,47,12,22,2,2,11,51,69,6,6,34,61,28,34,16,27,1,2,10,44,61
2011-03-10 00:00:00.000,ATP World Tour Masters 1000 Indian Wells CA; U.S.A. ATP World Tour Masters 1000,HARD,2,Marin Cilic,Florent Serra,Marin Cilic,6-1; 6-3,R64,55,11,1,26,43,24,26,10,17,2,2,8,34,43,3,3,32,48,19,32,6,16,3,7,8,25,48
2011-03-10 00:00:00.000,ATP World Tour Masters 1000 Indian Wells CA; U.S.A. ATP World Tour Masters 1000,HARD,2,Stanislas Wawrinka,Nikolay Davydenko,Stanislas Wawrinka,3-6; 7-6(5); 6-4,R64,161,3,4,63,103,43,63,18,40,7,12,15,61,103,0,5,81,104,51,81,9,23,5,10,16,60,104
2011-03-10 00:00:00.000,ATP World Tour Masters 1000 Indian Wells CA; U.S.A. ATP World Tour Masters 1000,HARD,2,Milos Raonic,Mardy Fish,Milos Raonic,7-5; 6-4,R64,121,10,3,52,90,37,52,22,38,8,8,11,59,90,6,0,34,67,29,34,14,33,0,2,11,43,67
2011-03-10 00:00:00.000,ATP World Tour Masters 1000 Indian Wells CA; U.S.A. ATP World Tour Masters 1000,HARD,2,Ryan Harrison,Guillermo Garcia-Lopez,Ryan Harrison,6-3; 7-6(4),R64,105,7,4,47,86,32,47,16,39,7,11,11,48,86,0,4,39,66,25,39,9,27,2,7,10,34,66
2011-03-10 00:00:00.000,ATP World Tour Masters 1000 Indian Wells CA; U.S.A. ATP World Tour Masters 1000,HARD,2,Juan Ignacio Chela,Philipp Petzschner,Juan Ignacio Chela,4-6; 7-5; 6-2,R64,144,3,0,59,79,44,59,11,20,3,6,15,55,79,12,5,60,117,43,60,21,57,9,14,15,64,117
2011-03-10 00:00:00.000,ATP World Tour Masters 1000 Indian Wells CA; U.S.A. ATP World Tour Masters 1000,HARD,2,Roger Federer,Igor Andreev,Roger Federer,7-5; 7-6(4),R64,95,4,4,37,69,34,37,17,32,0,1,12,51,69,2,0,43,74,33,43,15,31,3,5,12,48,74
2011-03-10 00:00:00.000,ATP World Tour Masters 1000 Indian Wells CA; U.S.A. ATP World Tour Masters 1000,HARD,2,Rafael Nadal,Ryan Sweeting,Rafael Nadal,6-3; 6-1,R32,69,3,0,21,37,20,21,12,16,0,0,8,32,37,3,4,31,57,19,31,10,26,3,7,8,29,57
2011-03-10 00:00:00.000,ATP World Tour Masters 1000 Indian Wells CA; U.S.A. ATP World Tour Masters 1000,HARD,2,Somdev Devvarman,Xavier Malisse,Somdev Devvarman,6-1; 3-6; 7-6(5),R32,121,5,0,49,84,37,49,22,35,1,2,14,59,84,6,2,44,87,32,44,27,43,2,4,14,59,87
2011-03-10 00:00:00.000,ATP World Tour Masters 1000 Indian Wells CA; U.S.A. ATP World Tour Masters 1000,HARD,2,Albert Montanes,Nicolas Almagro,Albert Montanes,4-6; 6-2; 6-4,R32,112,3,4,59,97,47,59,16,38,8,9,14,63,97,12,9,42,86,36,42,17,44,2,5,14,53,86
2011-03-10 00:00:00.000,ATP World Tour Masters 1000 Indian Wells CA; U.S.A. ATP World Tour Masters 1000,HARD,2,Ivo Karlovic,Gilles Simon,Ivo Karlovic,6-3; 6-3,R32,63,11,2,32,50,30,32,9,18,2,2,9,39,50,2,2,26,45,16,26,12,19,1,4,9,28,45
2011-03-10 00:00:00.000,ATP World Tour Masters 1000 Indian Wells CA; U.S.A. ATP World Tour Masters 1000,HARD,2,Philipp Kohlschreiber,Robin Soderling,Philipp Kohlschreiber,7-6(8); 6-4,R32,98,14,3,35,69,27,35,20,34,1,3,11,47,69,6,4,55,77,37,55,9,22,5,8,11,46,77
2011-03-10 00:00:00.000,ATP World Tour Masters 1000 Indian Wells CA; U.S.A. ATP World Tour Masters 1000,HARD,2,Juan Martin Del Potro,Alexandr Dolgopolov,Juan Martin Del Potro,7-6(3); 6-3,R32,98,5,2,31,66,24,31,16,35,1,3,10,40,66,8,7,41,80,30,41,14,39,2,6,11,44,80
2011-03-10 00:00:00.000,ATP World Tour Masters 1000 Indian Wells CA; U.S.A. ATP World Tour Masters 1000,HARD,2,Sam Querrey,Fernando Verdasco,Sam Querrey,7-5; 6-4,R32,95,8,3,48,75,39,48,13,27,8,8,11,52,75,7,3,46,64,32,46,8,18,3,5,11,40,64
2011-03-10 00:00:00.000,ATP World Tour Masters 1000 Indian Wells CA; U.S.A. ATP World Tour Masters 1000,HARD,2,Tommy Robredo,Donald Young,Tommy Robredo,6-0; 6-4,R32,69,2,1,28,42,23,28,7,14,1,2,8,30,42,1,7,36,57,19,36,8,21,6,11,8,27,57
2011-03-10 00:00:00.000,ATP World Tour Masters 1000 Indian Wells CA; U.S.A. ATP World Tour Masters 1000,HARD,2,Andy Roddick,John Isner,Andy Roddick,7-5; 6-2,R32,68,9,0,32,47,26,32,14,15,0,0,10,40,47,15,2,38,54,29,38,5,16,0,3,10,34,54
2011-03-10 00:00:00.000,ATP World Tour Masters 1000 Indian Wells CA; U.S.A. ATP World Tour Masters 1000,HARD,2,Richard Gasquet,Jurgen Melzer,Richard Gasquet,6-1; 6-3,R32,62,7,1,30,47,25,30,10,17,3,3,8,35,47,2,4,28,52,18,28,7,24,1,5,8,25,52
2011-03-10 00:00:00.000,ATP World Tour Masters 1000 Indian Wells CA; U.S.A. ATP World Tour Masters 1000,HARD,2,Viktor Troicki,Michael Llodra,Viktor Troicki,6-3; 6-3,R32,66,5,0,34,53,26,34,13,19,2,2,9,39,53,4,1,34,54,23,34,9,20,6,9,9,32,54
2011-03-10 00:00:00.000,ATP World Tour Masters 1000 Indian Wells CA; U.S.A. ATP World Tour Masters 1000,HARD,2,Novak Djokovic,Ernests Gulbis,Novak Djokovic,6-0; 6-1,R32,54,4,0,25,44,18,25,13,19,5,5,7,31,44,0,5,20,36,9,20,3,16,1,6,6,12,36
2011-03-10 00:00:00.000,ATP World Tour Masters 1000 Indian Wells CA; U.S.A. ATP World Tour Masters 1000,HARD,2,Tomas Berdych,Thomaz Bellucci,Tomas Berdych,6-3; 6-2,R32,75,2,1,28,48,25,28,13,20,2,2,9,38,48,3,2,35,50,21,35,6,15,5,8,8,27,50
2011-03-10 00:00:00.000,ATP World Tour Masters 1000 Indian Wells CA; U.S.A. ATP World Tour Masters 1000,HARD,2,Stanislas Wawrinka,Marin Cilic,Stanislas Wawrinka,7-5; 6-3,R32,99,3,1,38,58,28,38,15,20,1,2,11,43,58,2,0,31,68,19,31,21,37,7,10,10,40,68
2011-03-10 00:00:00.000,ATP World Tour Masters 1000 Indian Wells CA; U.S.A. ATP World Tour Masters 1000,HARD,2,Ryan Harrison,Milos Raonic,Ryan Harrison,7-6(1); 4-6; 6-4,R32,149,11,1,63,105,48,63,23,42,8,10,16,71,105,17,0,66,98,46,66,20,32,5,7,16,66,98
2011-03-10 00:00:00.000,ATP World Tour Masters 1000 Indian Wells CA; U.S.A. ATP World Tour Masters 1000,HARD,2,Roger Federer,Juan Ignacio Chela,Roger Federer,6-0; 6-2,R32,58,2,0,25,42,20,25,10,17,1,1,7,30,42,0,6,27,49,15,27,6,22,4,9,7,21,49
2011-03-10 00:00:00.000,ATP World Tour Masters 1000 Indian Wells CA; U.S.A. ATP World Tour Masters 1000,HARD,2,Rafael Nadal,Somdev Devvarman,Rafael Nadal,7-5; 6-4,R16,115,0,2,40,68,28,40,18,28,2,3,11,46,68,4,4,54,72,34,54,5,18,6,9,11,39,72
2011-03-10 00:00:00.000,ATP World Tour Masters 1000 Indian Wells CA; U.S.A. ATP World Tour Masters 1000,HARD,2,Ivo Karlovic,Albert Montanes,Ivo Karlovic,7-6(7); 6-2,R16,93,16,3,44,67,38,44,11,23,3,3,10,49,67,3,4,48,74,34,48,13,26,6,8,10,47,74
2011-03-10 00:00:00.000,ATP World Tour Masters 1000 Indian Wells CA; U.S.A. ATP World Tour Masters 1000,HARD,2,Juan Martin Del Potro,Philipp Kohlschreiber,Juan Martin Del Potro,7-6(3); 7-6(7),R16,142,13,2,48,88,40,48,21,40,2,4,12,61,88,11,5,50,95,33,50,26,45,6,8,12,59,95
2011-03-10 00:00:00.000,ATP World Tour Masters 1000 Indian Wells CA; U.S.A. ATP World Tour Masters 1000,HARD,2,Tommy Robredo,Sam Querrey,Tommy Robredo,6-1; 6-3,R16,83,1,1,38,53,26,38,11,15,3,3,8,37,53,3,6,29,57,19,29,11,28,8,12,8,30,57
2011-03-10 00:00:00.000,ATP World Tour Masters 1000 Indian Wells CA; U.S.A. ATP World Tour Masters 1000,HARD,2,Richard Gasquet,Andy Roddick,Richard Gasquet,6-3; 7-6(5),R16,106,8,2,44,69,34,44,15,25,4,5,11,49,69,7,1,49,77,33,49,15,28,5,7,10,48,77
2011-03-10 00:00:00.000,ATP World Tour Masters 1000 Indian Wells CA; U.S.A. ATP World Tour Masters 1000,HARD,2,Novak Djokovic,Viktor Troicki,Novak Djokovic,6-0; 6-1,R16,66,1,4,40,60,29,40,10,20,4,4,7,39,60,3,5,26,43,12,26,4,17,4,9,6,16,43
2011-03-10 00:00:00.000,ATP World Tour Masters 1000 Indian Wells CA; U.S.A. ATP World Tour Masters 1000,HARD,2,Stanislas Wawrinka,Tomas Berdych,Stanislas Wawrinka,3-6; 6-4; 6-4,R16,158,8,3,51,94,39,51,19,43,5,9,15,58,94,0,0,42,92,27,42,24,50,6,10,14,51,92
2011-03-10 00:00:00.000,ATP World Tour Masters 1000 Indian Wells CA; U.S.A. ATP World Tour Masters 1000,HARD,2,Roger Federer,Ryan Harrison,Roger Federer,7-6(4); 6-3,R16,85,10,3,42,68,33,42,14,26,6,8,11,47,68,4,3,36,65,25,36,12,29,4,7,10,37,65
2011-03-10 00:00:00.000,ATP World Tour Masters 1000 Indian Wells CA; U.S.A. ATP World Tour Masters 1000,HARD,2,Rafael Nadal,Ivo Karlovic,Rafael Nadal,5-7; 6-1; 7-6(7),Q,144,6,2,49,81,38,49,27,32,0,1,16,65,81,23,4,62,102,46,62,20,40,6,8,15,66,102
2011-03-10 00:00:00.000,ATP World Tour Masters 1000 Indian Wells CA; U.S.A. ATP World Tour Masters 1000,HARD,2,Juan Martin Del Potro,Tommy Robredo,Juan Martin Del Potro,W/O,Q,0,0,0,0,0,0,0,0,0,0,0,0,0,0,0,0,0,0,0,0,0,0,0,0,0,0,0
2011-03-10 00:00:00.000,ATP World Tour Masters 1000 Indian Wells CA; U.S.A. ATP World Tour Masters 1000,HARD,2,Novak Djokovic,Richard Gasquet,Novak Djokovic,6-2; 6-4,Q,95,2,1,31,54,26,31,9,23,1,3,9,35,54,2,2,49,72,26,49,9,23,7,12,9,35,72
2011-03-10 00:00:00.000,ATP World Tour Masters 1000 Indian Wells CA; U.S.A. ATP World Tour Masters 1000,HARD,2,Roger Federer,Stanislas Wawrinka,Roger Federer,6-3; 6-4,Q,64,2,2,29,52,26,29,15,23,2,2,10,41,52,0,1,32,50,25,32,8,18,1,3,9,33,50
2011-03-10 00:00:00.000,ATP World Tour Masters 1000 Indian Wells CA; U.S.A. ATP World Tour Masters 1000,HARD,2,Rafael Nadal,Juan Martin Del Potro,Rafael Nadal,6-4; 6-4,S,112,4,2,31,55,25,31,14,24,2,3,10,39,55,3,2,43,63,26,43,10,20,1,4,10,36,63
2011-03-10 00:00:00.000,ATP World Tour Masters 1000 Indian Wells CA; U.S.A. ATP World Tour Masters 1000,HARD,2,Novak Djokovic,Roger Federer,Novak Djokovic,6-3; 3-6; 6-2,S,127,3,4,57,85,36,57,15,28,6,9,13,51,85,1,2,48,85,33,48,15,37,5,10,13,48,85
2011-03-10 00:00:00.000,ATP World Tour Masters 1000 Indian Wells CA; U.S.A. ATP World Tour Masters 1000,HARD,2,Novak Djokovic,Rafael Nadal,Novak Djokovic,4-6; 6-3; 6-2,F,146,4,4,55,89,41,55,18,34,6,9,14,59,89,2,0,29,69,20,29,23,40,3,8,13,43,69
2011-03-23 00:00:00.000,ATP World Tour Masters 1000 Miami FL; U.S.A. ATP World Tour Masters 1000,HARD,2,Rafael Nadal,N/A Bye,Rafael Nadal,,R128,0,0,0,0,0,0,0,0,0,0,0,0,0,0,0,0,0,0,0,0,0,0,0,0,0,0,0
2011-03-23 00:00:00.000,ATP World Tour Masters 1000 Miami FL; U.S.A. ATP World Tour Masters 1000,HARD,2,Kei Nishikori,Jeremy Chardy,Kei Nishikori,7-6(5); 6-2,R128,95,3,1,53,68,37,53,12,15,2,2,10,49,68,11,11,42,84,38,42,14,42,5,7,10,52,84
2011-03-23 00:00:00.000,ATP World Tour Masters 1000 Miami FL; U.S.A. ATP World Tour Masters 1000,HARD,2,Feliciano Lopez,Ricardas Berankis,Feliciano Lopez,4-6; 7-6(5); 6-3,R128,146,19,8,47,100,44,47,24,53,6,8,15,68,100,9,5,58,116,39,58,33,58,6,9,16,72,116
2011-03-23 00:00:00.000,ATP World Tour Masters 1000 Miami FL; U.S.A. ATP World Tour Masters 1000,HARD,2,Juan Ignacio Chela,N/A Bye,Juan Ignacio Chela,,R128,0,0,0,0,0,0,0,0,0,0,0,0,0,0,0,0,0,0,0,0,0,0,0,0,0,0,0
2011-03-23 00:00:00.000,ATP World Tour Masters 1000 Miami FL; U.S.A. ATP World Tour Masters 1000,HARD,2,Alexandr Dolgopolov,N/A Bye,Alexandr Dolgopolov,,R128,0,0,0,0,0,0,0,0,0,0,0,0,0,0,0,0,0,0,0,0,0,0,0,0,0,0,0
2011-03-23 00:00:00.000,ATP World Tour Masters 1000 Miami FL; U.S.A. ATP World Tour Masters 1000,HARD,2,Andreas Seppi,Mischa Zverev,Andreas Seppi,6-2; 6-7(9); 6-1,R128,117,6,2,56,89,41,56,19,33,0,1,14,60,89,2,0,64,92,40,64,12,28,4,9,13,52,92
2011-03-23 00:00:00.000,ATP World Tour Masters 1000 Miami FL; U.S.A. ATP World Tour Masters 1000,HARD,2,Teymuraz Gabashvili,Daniel Brands,Teymuraz Gabashvili,6-2; 7-6(5),R128,106,4,7,37,63,29,37,12,26,3,5,10,41,63,5,10,57,89,35,57,10,32,6,10,10,45,89
2011-03-23 00:00:00.000,ATP World Tour Masters 1000 Miami FL; U.S.A. ATP World Tour Masters 1000,HARD,2,Jo-Wilfried Tsonga,N/A Bye,Jo-Wilfried Tsonga,,R128,0,0,0,0,0,0,0,0,0,0,0,0,0,0,0,0,0,0,0,0,0,0,0,0,0,0,0
2011-03-23 00:00:00.000,ATP World Tour Masters 1000 Miami FL; U.S.A. ATP World Tour Masters 1000,HARD,2,Nicolas Almagro,N/A Bye,Nicolas Almagro,,R128,0,0,0,0,0,0,0,0,0,0,0,0,0,0,0,0,0,0,0,0,0,0,0,0,0,0,0
2011-03-23 00:00:00.000,ATP World Tour Masters 1000 Miami FL; U.S.A. ATP World Tour Masters 1000,HARD,2,Frederico Gil,Paul Capdeville,Frederico Gil,6-1; 3-6; 7-6(6),R128,144,4,3,64,105,43,64,20,41,5,9,14,63,105,6,6,65,96,43,65,11,31,3,8,14,54,96
2011-03-23 00:00:00.000,ATP World Tour Masters 1000 Miami FL; U.S.A. ATP World Tour Masters 1000,HARD,2,Florian Mayer,Ivo Karlovic,Florian Mayer,6-4; 7-6(6),R128,75,2,1,32,57,29,32,20,25,0,0,11,49,57,10,0,44,67,35,44,13,23,1,2,11,48,67
2011-03-23 00:00:00.000,ATP World Tour Masters 1000 Miami FL; U.S.A. ATP World Tour Masters 1000,HARD,2,Albert Montanes,N/A Bye,Albert Montanes,,R128,0,0,0,0,0,0,0,0,0,0,0,0,0,0,0,0,0,0,0,0,0,0,0,0,0,0,0
2011-03-23 00:00:00.000,ATP World Tour Masters 1000 Miami FL; U.S.A. ATP World Tour Masters 1000,HARD,2,Ernests Gulbis,N/A Bye,Ernests Gulbis,,R128,0,0,0,0,0,0,0,0,0,0,0,0,0,0,0,0,0,0,0,0,0,0,0,0,0,0,0
2011-03-23 00:00:00.000,ATP World Tour Masters 1000 Miami FL; U.S.A. ATP World Tour Masters 1000,HARD,2,Carlos Berlocq,Jack Sock,Carlos Berlocq,7-5; 7-6(6),R128,141,4,5,48,89,34,48,19,41,10,13,12,53,89,4,4,39,80,20,39,25,41,3,7,12,45,80
2011-03-23 00:00:00.000,ATP World Tour Masters 1000 Miami FL; U.S.A. ATP World Tour Masters 1000,HARD,2,Ruben Ramirez Hidalgo,Adrian Mannarino,Ruben Ramirez Hidalgo,7-6(3); 6-7(3); 6-2,R128,161,3,5,49,115,37,49,33,66,6,9,16,70,115,2,7,62,104,46,62,15,42,3,8,16,61,104
2011-03-23 00:00:00.000,ATP World Tour Masters 1000 Miami FL; U.S.A. ATP World Tour Masters 1000,HARD,2,Tomas Berdych,N/A Bye,Tomas Berdych,,R128,0,0,0,0,0,0,0,0,0,0,0,0,0,0,0,0,0,0,0,0,0,0,0,0,0,0,0
2011-03-23 00:00:00.000,ATP World Tour Masters 1000 Miami FL; U.S.A. ATP World Tour Masters 1000,HARD,2,Roger Federer,N/A Bye,Roger Federer,,R128,0,0,0,0,0,0,0,0,0,0,0,0,0,0,0,0,0,0,0,0,0,0,0,0,0,0,0
2011-03-23 00:00:00.000,ATP World Tour Masters 1000 Miami FL; U.S.A. ATP World Tour Masters 1000,HARD,2,Radek Stepanek,Fabio Fognini,Radek Stepanek,6-3; 7-6(5),R128,87,1,1,41,68,28,41,17,27,1,3,11,45,68,2,9,35,65,26,35,11,30,1,4,10,37,65
2011-03-23 00:00:00.000,ATP World Tour Masters 1000 Miami FL; U.S.A. ATP World Tour Masters 1000,HARD,2,Sergiy Stakhovsky,Grigor Dimitrov,Sergiy Stakhovsky,6-2; 6-4,R128,68,4,2,29,52,21,29,14,23,2,3,9,35,52,1,2,32,62,19,32,14,30,5,9,9,33,62
2011-03-23 00:00:00.000,ATP World Tour Masters 1000 Miami FL; U.S.A. ATP World Tour Masters 1000,HARD,2,Juan Monaco,N/A Bye,Juan Monaco,,R128,0,0,0,0,0,0,0,0,0,0,0,0,0,0,0,0,0,0,0,0,0,0,0,0,0,0,0
2011-03-23 00:00:00.000,ATP World Tour Masters 1000 Miami FL; U.S.A. ATP World Tour Masters 1000,HARD,2,Marcos Baghdatis,N/A Bye,Marcos Baghdatis,,R128,0,0,0,0,0,0,0,0,0,0,0,0,0,0,0,0,0,0,0,0,0,0,0,0,0,0,0
2011-03-23 00:00:00.000,ATP World Tour Masters 1000 Miami FL; U.S.A. ATP World Tour Masters 1000,HARD,2,Olivier Rochus,Blaz Kavcic,Olivier Rochus,3-6; 6-4; 7-5,R128,190,2,8,57,117,36,57,29,60,8,14,16,65,117,10,8,67,116,42,67,20,49,10,16,15,62,116
2011-03-23 00:00:00.000,ATP World Tour Masters 1000 Miami FL; U.S.A. ATP World Tour Masters 1000,HARD,2,Yen-Hsun Lu,Pere Riba,Yen-Hsun Lu,6-3; 6-2,R128,61,3,1,23,42,20,23,11,19,4,5,8,31,42,4,7,23,52,12,23,13,29,3,8,9,25,52
2011-03-23 00:00:00.000,ATP World Tour Masters 1000 Miami FL; U.S.A. ATP World Tour Masters 1000,HARD,2,Mikhail Youzhny,N/A Bye,Mikhail Youzhny,,R128,0,0,0,0,0,0,0,0,0,0,0,0,0,0,0,0,0,0,0,0,0,0,0,0,0,0,0
2011-03-23 00:00:00.000,ATP World Tour Masters 1000 Miami FL; U.S.A. ATP World Tour Masters 1000,HARD,2,Jurgen Melzer,N/A Bye,Jurgen Melzer,,R128,0,0,0,0,0,0,0,0,0,0,0,0,0,0,0,0,0,0,0,0,0,0,0,0,0,0,0
2011-03-23 00:00:00.000,ATP World Tour Masters 1000 Miami FL; U.S.A. ATP World Tour Masters 1000,HARD,2,Philipp Petzschner,Florent Serra,Philipp Petzschner,6-1; 7-5,R128,70,6,1,18,49,13,18,15,31,2,5,9,28,49,2,1,30,58,14,30,11,28,5,12,10,25,58
2011-03-23 00:00:00.000,ATP World Tour Masters 1000 Miami FL; U.S.A. ATP World Tour Masters 1000,HARD,2,Janko Tipsarevic,Robin Haase,Janko Tipsarevic,6-4; 7-6(5),R128,103,4,1,38,68,31,38,16,30,1,2,11,47,68,10,5,52,88,35,52,17,36,7,9,11,52,88
2011-03-23 00:00:00.000,ATP World Tour Masters 1000 Miami FL; U.S.A. ATP World Tour Masters 1000,HARD,2,Marin Cilic,N/A Bye,Marin Cilic,,R128,0,0,0,0,0,0,0,0,0,0,0,0,0,0,0,0,0,0,0,0,0,0,0,0,0,0,0
2011-03-23 00:00:00.000,ATP World Tour Masters 1000 Miami FL; U.S.A. ATP World Tour Masters 1000,HARD,2,Gilles Simon,N/A Bye,Gilles Simon,,R128,0,0,0,0,0,0,0,0,0,0,0,0,0,0,0,0,0,0,0,0,0,0,0,0,0,0,0
2011-03-23 00:00:00.000,ATP World Tour Masters 1000 Miami FL; U.S.A. ATP World Tour Masters 1000,HARD,2,Rainer Schuettler,Ryan Harrison,Rainer Schuettler,7-5; 6-2,R128,86,3,3,43,64,29,43,13,21,3,4,10,42,64,2,5,31,58,19,31,14,27,2,6,10,33,58
2011-03-23 00:00:00.000,ATP World Tour Masters 1000 Miami FL; U.S.A. ATP World Tour Masters 1000,HARD,2,Pablo Cuevas,Michael Berrer,Pablo Cuevas,6-4; 7-6(2),R128,97,5,2,40,61,35,40,11,21,1,2,11,46,61,4,4,51,78,38,51,9,27,7,9,11,47,78
2011-03-23 00:00:00.000,ATP World Tour Masters 1000 Miami FL; U.S.A. ATP World Tour Masters 1000,HARD,2,Andy Roddick,N/A Bye,Andy Roddick,,R128,0,0,0,0,0,0,0,0,0,0,0,0,0,0,0,0,0,0,0,0,0,0,0,0,0,0,0
2011-03-23 00:00:00.000,ATP World Tour Masters 1000 Miami FL; U.S.A. ATP World Tour Masters 1000,HARD,2,David Ferrer,N/A Bye,David Ferrer,,R128,0,0,0,0,0,0,0,0,0,0,0,0,0,0,0,0,0,0,0,0,0,0,0,0,0,0,0
2011-03-23 00:00:00.000,ATP World Tour Masters 1000 Miami FL; U.S.A. ATP World Tour Masters 1000,HARD,2,Igor Kunitsyn,Robert Kendrick,Igor Kunitsyn,5-4 RET,R128,30,2,0,17,27,12,17,7,10,2,2,4,19,27,8,2,14,25,14,14,3,11,0,1,5,17,25
2011-03-23 00:00:00.000,ATP World Tour Masters 1000 Miami FL; U.S.A. ATP World Tour Masters 1000,HARD,2,Somdev Devvarman,Potito Starace,Somdev Devvarman,6-2; 6-4,R128,70,1,0,30,47,23,30,11,17,3,4,9,34,47,0,3,36,59,22,36,9,23,1,5,9,31,59
2011-03-23 00:00:00.000,ATP World Tour Masters 1000 Miami FL; U.S.A. ATP World Tour Masters 1000,HARD,2,Milos Raonic,N/A Bye,Milos Raonic,,R128,0,0,0,0,0,0,0,0,0,0,0,0,0,0,0,0,0,0,0,0,0,0,0,0,0,0,0
2011-03-23 00:00:00.000,ATP World Tour Masters 1000 Miami FL; U.S.A. ATP World Tour Masters 1000,HARD,2,Michael Llodra,N/A Bye,Michael Llodra,,R128,0,0,0,0,0,0,0,0,0,0,0,0,0,0,0,0,0,0,0,0,0,0,0,0,0,0,0
2011-03-23 00:00:00.000,ATP World Tour Masters 1000 Miami FL; U.S.A. ATP World Tour Masters 1000,HARD,2,Xavier Malisse,Ryan Sweeting,Xavier Malisse,7-6(3); 6-4,R128,90,9,1,50,74,38,50,13,24,4,6,11,51,74,5,5,44,75,33,44,12,31,4,7,11,45,75
2011-03-23 00:00:00.000,ATP World Tour Masters 1000 Miami FL; U.S.A. ATP World Tour Masters 1000,HARD,2,Marcel Granollers,Benjamin Becker,Marcel Granollers,6-4; 6-7(4); 6-4,R128,157,5,3,73,115,47,73,25,42,3,5,16,72,115,8,4,43,97,30,43,32,54,6,10,16,62,97
2011-03-23 00:00:00.000,ATP World Tour Masters 1000 Miami FL; U.S.A. ATP World Tour Masters 1000,HARD,2,Stanislas Wawrinka,N/A Bye,Stanislas Wawrinka,,R128,0,0,0,0,0,0,0,0,0,0,0,0,0,0,0,0,0,0,0,0,0,0,0,0,0,0,0
2011-03-23 00:00:00.000,ATP World Tour Masters 1000 Miami FL; U.S.A. ATP World Tour Masters 1000,HARD,2,Mardy Fish,N/A Bye,Mardy Fish,,R128,0,0,0,0,0,0,0,0,0,0,0,0,0,0,0,0,0,0,0,0,0,0,0,0,0,0,0
2011-03-23 00:00:00.000,ATP World Tour Masters 1000 Miami FL; U.S.A. ATP World Tour Masters 1000,HARD,2,Julien Benneteau,Daniel Gimeno-Traver,Julien Benneteau,6-4; 6-3,R128,78,2,3,41,68,31,41,11,27,6,8,10,42,68,5,3,29,52,22,29,6,23,2,6,9,28,52
2011-03-23 00:00:00.000,ATP World Tour Masters 1000 Miami FL; U.S.A. ATP World Tour Masters 1000,HARD,2,Paolo Lorenzi,Ivan Ljubicic,Paolo Lorenzi,7-6(7); 6-1,R128,104,0,4,44,62,33,44,8,18,3,5,10,41,62,4,3,35,72,21,35,18,37,6,10,9,39,72
2011-03-23 00:00:00.000,ATP World Tour Masters 1000 Miami FL; U.S.A. ATP World Tour Masters 1000,HARD,2,Richard Gasquet,N/A Bye,Richard Gasquet,,R128,0,0,0,0,0,0,0,0,0,0,0,0,0,0,0,0,0,0,0,0,0,0,0,0,0,0,0
2011-03-23 00:00:00.000,ATP World Tour Masters 1000 Miami FL; U.S.A. ATP World Tour Masters 1000,HARD,2,Philipp Kohlschreiber,N/A Bye,Philipp Kohlschreiber,,R128,0,0,0,0,0,0,0,0,0,0,0,0,0,0,0,0,0,0,0,0,0,0,0,0,0,0,0
2011-03-23 00:00:00.000,ATP World Tour Masters 1000 Miami FL; U.S.A. ATP World Tour Masters 1000,HARD,2,Juan Martin Del Potro,Ricardo Mello,Juan Martin Del Potro,6-4; 6-4,R128,82,3,1,35,50,28,35,6,15,0,2,10,34,50,1,1,32,58,20,32,12,26,1,5,10,32,58
2011-03-23 00:00:00.000,ATP World Tour Masters 1000 Miami FL; U.S.A. ATP World Tour Masters 1000,HARD,2,Ivan Dodig,Andrey Golubev,Ivan Dodig,6-7(7); 6-4; 6-0,R128,134,8,3,54,94,37,54,26,40,2,4,14,63,94,0,4,47,85,32,47,16,38,2,8,14,48,85
2011-03-23 00:00:00.000,ATP World Tour Masters 1000 Miami FL; U.S.A. ATP World Tour Masters 1000,HARD,2,Robin Soderling,N/A Bye,Robin Soderling,,R128,0,0,0,0,0,0,0,0,0,0,0,0,0,0,0,0,0,0,0,0,0,0,0,0,0,0,0
2011-03-23 00:00:00.000,ATP World Tour Masters 1000 Miami FL; U.S.A. ATP World Tour Masters 1000,HARD,2,Andy Murray,N/A Bye,Andy Murray,,R128,0,0,0,0,0,0,0,0,0,0,0,0,0,0,0,0,0,0,0,0,0,0,0,0,0,0,0
2011-03-23 00:00:00.000,ATP World Tour Masters 1000 Miami FL; U.S.A. ATP World Tour Masters 1000,HARD,2,Alex Bogomolov Jr.,Victor Hanescu,Alex Bogomolov Jr.,6-3; 4-6; 7-5,R128,142,2,6,73,111,52,73,14,38,8,12,15,66,111,5,4,56,95,37,56,15,39,6,12,16,52,95
2011-03-23 00:00:00.000,ATP World Tour Masters 1000 Miami FL; U.S.A. ATP World Tour Masters 1000,HARD,2,Igor Andreev,Santiago Giraldo,Igor Andreev,6-1; 2-6; 6-1,R128,91,3,4,40,70,31,40,13,30,3,5,11,44,70,4,4,43,76,27,43,14,33,5,10,11,41,76
2011-03-23 00:00:00.000,ATP World Tour Masters 1000 Miami FL; U.S.A. ATP World Tour Masters 1000,HARD,2,John Isner,N/A Bye,John Isner,,R128,0,0,0,0,0,0,0,0,0,0,0,0,0,0,0,0,0,0,0,0,0,0,0,0,0,0,0
2011-03-23 00:00:00.000,ATP World Tour Masters 1000 Miami FL; U.S.A. ATP World Tour Masters 1000,HARD,2,Guillermo Garcia-Lopez,N/A Bye,Guillermo Garcia-Lopez,,R128,0,0,0,0,0,0,0,0,0,0,0,0,0,0,0,0,0,0,0,0,0,0,0,0,0,0,0
2011-03-23 00:00:00.000,ATP World Tour Masters 1000 Miami FL; U.S.A. ATP World Tour Masters 1000,HARD,2,Kevin Anderson,Nikolay Davydenko,Kevin Anderson,6-4; 6-3,R128,78,5,2,32,46,27,32,10,14,0,0,9,37,46,4,2,39,56,25,39,7,17,0,3,10,32,56
2011-03-23 00:00:00.000,ATP World Tour Masters 1000 Miami FL; U.S.A. ATP World Tour Masters 1000,HARD,2,Pablo Andujar,Bernard Tomic,Pablo Andujar,6-4; 3-6; 7-5,R128,149,0,7,48,98,29,48,26,50,5,10,15,55,98,4,3,58,96,39,58,18,38,3,9,16,57,96
2011-03-23 00:00:00.000,ATP World Tour Masters 1000 Miami FL; U.S.A. ATP World Tour Masters 1000,HARD,2,Fernando Verdasco,N/A Bye,Fernando Verdasco,,R128,0,0,0,0,0,0,0,0,0,0,0,0,0,0,0,0,0,0,0,0,0,0,0,0,0,0,0
2011-03-23 00:00:00.000,ATP World Tour Masters 1000 Miami FL; U.S.A. ATP World Tour Masters 1000,HARD,2,Viktor Troicki,N/A Bye,Viktor Troicki,,R128,0,0,0,0,0,0,0,0,0,0,0,0,0,0,0,0,0,0,0,0,0,0,0,0,0,0,0
2011-03-23 00:00:00.000,ATP World Tour Masters 1000 Miami FL; U.S.A. ATP World Tour Masters 1000,HARD,2,Marsel Ilhan,Tobias Kamke,Marsel Ilhan,6-2; 6-1,R128,54,4,1,24,40,20,24,9,16,1,1,7,29,40,1,2,29,55,17,29,8,26,6,11,8,25,55
2011-03-23 00:00:00.000,ATP World Tour Masters 1000 Miami FL; U.S.A. ATP World Tour Masters 1000,HARD,2,Mikhail Kukushkin,Jarkko Nieminen,Mikhail Kukushkin,3-6; 6-3; 6-2,R128,114,6,2,45,95,31,45,27,50,11,13,13,58,95,5,4,45,75,31,45,15,30,3,7,13,46,75
2011-03-23 00:00:00.000,ATP World Tour Masters 1000 Miami FL; U.S.A. ATP World Tour Masters 1000,HARD,2,Sam Querrey,N/A Bye,Sam Querrey,,R128,0,0,0,0,0,0,0,0,0,0,0,0,0,0,0,0,0,0,0,0,0,0,0,0,0,0,0
2011-03-23 00:00:00.000,ATP World Tour Masters 1000 Miami FL; U.S.A. ATP World Tour Masters 1000,HARD,2,Thomaz Bellucci,N/A Bye,Thomaz Bellucci,,R128,0,0,0,0,0,0,0,0,0,0,0,0,0,0,0,0,0,0,0,0,0,0,0,0,0,0,0
2011-03-23 00:00:00.000,ATP World Tour Masters 1000 Miami FL; U.S.A. ATP World Tour Masters 1000,HARD,2,James Blake,Michael Russell,James Blake,3-6; 7-6(7); 7-6(3),R128,140,5,8,57,113,40,57,28,56,2,7,17,68,113,4,2,66,99,43,66,22,33,2,5,16,65,99
2011-03-23 00:00:00.000,ATP World Tour Masters 1000 Miami FL; U.S.A. ATP World Tour Masters 1000,HARD,2,Denis Istomin,Donald Young,Denis Istomin,6-4; 6-3,R128,67,6,3,40,59,31,40,11,19,3,4,10,42,59,1,3,26,49,18,26,12,23,3,6,9,30,49
2011-03-23 00:00:00.000,ATP World Tour Masters 1000 Miami FL; U.S.A. ATP World Tour Masters 1000,HARD,2,Novak Djokovic,N/A Bye,Novak Djokovic,,R128,0,0,0,0,0,0,0,0,0,0,0,0,0,0,0,0,0,0,0,0,0,0,0,0,0,0,0
2011-03-23 00:00:00.000,ATP World Tour Masters 1000 Miami FL; U.S.A. ATP World Tour Masters 1000,HARD,2,Rafael Nadal,Kei Nishikori,Rafael Nadal,6-4; 6-4,R64,109,2,2,37,63,28,37,18,26,4,4,10,46,63,2,2,38,61,29,38,10,23,4,6,10,39,61
2011-03-23 00:00:00.000,ATP World Tour Masters 1000 Miami FL; U.S.A. ATP World Tour Masters 1000,HARD,2,Feliciano Lopez,Juan Ignacio Chela,Feliciano Lopez,7-6(3); 3-6; 6-4,R64,127,18,11,45,94,37,45,24,49,2,5,16,61,94,2,7,59,99,42,59,22,40,7,9,15,64,99
2011-03-23 00:00:00.000,ATP World Tour Masters 1000 Miami FL; U.S.A. ATP World Tour Masters 1000,HARD,2,Alexandr Dolgopolov,Andreas Seppi,Alexandr Dolgopolov,6-1; 5-3 RET,R64,58,8,3,24,44,21,24,11,20,0,1,8,32,44,0,5,18,48,9,18,14,30,5,9,7,23,48
2011-03-23 00:00:00.000,ATP World Tour Masters 1000 Miami FL; U.S.A. ATP World Tour Masters 1000,HARD,2,Jo-Wilfried Tsonga,Teymuraz Gabashvili,Jo-Wilfried Tsonga,6-3; 6-7(3); 6-3,R64,129,15,1,56,97,46,56,17,41,6,9,16,63,97,4,6,52,84,36,52,12,32,1,6,14,48,84
2011-03-23 00:00:00.000,ATP World Tour Masters 1000 Miami FL; U.S.A. ATP World Tour Masters 1000,HARD,2,Nicolas Almagro,Frederico Gil,Nicolas Almagro,6-4; 3-6; 6-2,R64,113,11,6,35,78,28,35,25,43,4,5,13,53,78,8,2,56,82,38,56,16,26,6,9,14,54,82
2011-03-23 00:00:00.000,ATP World Tour Masters 1000 Miami FL; U.S.A. ATP World Tour Masters 1000,HARD,2,Florian Mayer,Albert Montanes,Florian Mayer,6-4; 3-1 RET,R64,50,3,0,19,33,16,19,13,14,0,0,7,29,33,0,2,29,43,17,29,9,14,0,2,7,26,43
2011-03-23 00:00:00.000,ATP World Tour Masters 1000 Miami FL; U.S.A. ATP World Tour Masters 1000,HARD,2,Carlos Berlocq,Ernests Gulbis,Carlos Berlocq,6-1; 2-6; 6-4,R64,110,5,6,42,74,33,42,13,32,2,5,13,46,74,9,4,44,79,31,44,14,35,3,7,12,45,79
2011-03-23 00:00:00.000,ATP World Tour Masters 1000 Miami FL; U.S.A. ATP World Tour Masters 1000,HARD,2,Tomas Berdych,Ruben Ramirez Hidalgo,Tomas Berdych,6-1; 6-7(4); 6-0,R64,132,8,0,34,68,28,34,20,34,6,8,12,48,68,1,9,51,100,30,51,18,49,8,16,13,48,100
2011-03-23 00:00:00.000,ATP World Tour Masters 1000 Miami FL; U.S.A. ATP World Tour Masters 1000,HARD,2,Roger Federer,Radek Stepanek,Roger Federer,6-3; 6-3,R64,62,7,1,33,47,27,33,10,14,1,1,9,37,47,4,3,28,44,21,28,4,16,0,3,9,25,44
2011-03-23 00:00:00.000,ATP World Tour Masters 1000 Miami FL; U.S.A. ATP World Tour Masters 1000,HARD,2,Juan Monaco,Sergiy Stakhovsky,Juan Monaco,6-4; 6-7(2); 6-4,R64,153,4,2,74,99,46,74,17,25,3,6,16,63,99,5,3,72,113,49,72,15,41,13,18,16,64,113
2011-03-23 00:00:00.000,ATP World Tour Masters 1000 Miami FL; U.S.A. ATP World Tour Masters 1000,HARD,2,Olivier Rochus,Marcos Baghdatis,Olivier Rochus,6-2; 4-6; 6-4,R64,131,2,2,54,81,34,54,11,27,3,8,14,45,81,9,7,38,90,28,38,18,52,5,12,14,46,90
2011-03-23 00:00:00.000,ATP World Tour Masters 1000 Miami FL; U.S.A. ATP World Tour Masters 1000,HARD,2,Mikhail Youzhny,Yen-Hsun Lu,Mikhail Youzhny,6-1; 6-0,R64,54,2,1,20,37,17,20,12,17,2,2,7,29,37,1,5,19,40,9,19,6,21,8,13,6,15,40
2011-03-23 00:00:00.000,ATP World Tour Masters 1000 Miami FL; U.S.A. ATP World Tour Masters 1000,HARD,2,Philipp Petzschner,Jurgen Melzer,Philipp Petzschner,6-3; 6-4,R64,86,3,3,32,67,23,32,21,35,5,6,10,44,67,5,3,40,63,26,40,10,23,7,10,9,36,63
2011-03-23 00:00:00.000,ATP World Tour Masters 1000 Miami FL; U.S.A. ATP World Tour Masters 1000,HARD,2,Janko Tipsarevic,Marin Cilic,Janko Tipsarevic,6-3; 7-6(4),R64,104,5,5,38,66,31,38,14,28,4,6,11,45,66,5,4,38,72,27,38,14,34,3,6,10,41,72
2011-03-23 00:00:00.000,ATP World Tour Masters 1000 Miami FL; U.S.A. ATP World Tour Masters 1000,HARD,2,Gilles Simon,Rainer Schuettler,Gilles Simon,6-4; 6-3,R64,77,6,2,31,61,23,31,16,30,2,4,10,39,61,0,3,36,59,18,36,12,23,2,6,9,30,59
2011-03-23 00:00:00.000,ATP World Tour Masters 1000 Miami FL; U.S.A. ATP World Tour Masters 1000,HARD,2,Pablo Cuevas,Andy Roddick,Pablo Cuevas,6-4; 7-6(4),R64,117,15,1,44,73,35,44,19,29,4,4,11,54,73,9,6,49,89,35,49,22,40,6,7,11,57,89
2011-03-23 00:00:00.000,ATP World Tour Masters 1000 Miami FL; U.S.A. ATP World Tour Masters 1000,HARD,2,David Ferrer,Igor Kunitsyn,David Ferrer,6-2; 6-1,R64,80,3,2,24,41,17,24,10,17,1,2,7,27,41,0,5,32,71,16,32,15,39,9,15,8,31,71
2011-03-23 00:00:00.000,ATP World Tour Masters 1000 Miami FL; U.S.A. ATP World Tour Masters 1000,HARD,2,Somdev Devvarman,Milos Raonic,Somdev Devvarman,7-6(5); 7-5,R64,121,6,2,50,91,39,50,19,41,5,8,12,58,91,12,7,40,79,29,40,15,39,1,5,12,44,79
2011-03-23 00:00:00.000,ATP World Tour Masters 1000 Miami FL; U.S.A. ATP World Tour Masters 1000,HARD,2,Michael Llodra,Xavier Malisse,Michael Llodra,6-2; 6-3,R64,67,7,1,33,56,25,33,13,23,2,3,9,38,56,1,5,26,49,18,26,6,23,6,10,8,24,49
2011-03-23 00:00:00.000,ATP World Tour Masters 1000 Miami FL; U.S.A. ATP World Tour Masters 1000,HARD,2,Marcel Granollers,Stanislas Wawrinka,Marcel Granollers,6-0; 6-7(4); 6-3,R64,135,5,1,66,96,55,66,13,30,6,6,14,68,96,3,3,54,92,39,54,15,38,3,7,13,54,92
2011-03-23 00:00:00.000,ATP World Tour Masters 1000 Miami FL; U.S.A. ATP World Tour Masters 1000,HARD,2,Mardy Fish,Julien Benneteau,Mardy Fish,6-4; 6-3,R64,80,8,1,34,56,28,34,15,22,2,2,10,43,56,2,1,33,47,20,33,10,14,3,5,9,30,47
2011-03-23 00:00:00.000,ATP World Tour Masters 1000 Miami FL; U.S.A. ATP World Tour Masters 1000,HARD,2,Richard Gasquet,Paolo Lorenzi,Richard Gasquet,6-2; 6-3,R64,70,8,1,39,54,32,39,7,15,1,1,9,39,54,2,3,28,46,18,28,7,18,4,7,8,25,46
2011-03-23 00:00:00.000,ATP World Tour Masters 1000 Miami FL; U.S.A. ATP World Tour Masters 1000,HARD,2,Juan Martin Del Potro,Philipp Kohlschreiber,Juan Martin Del Potro,6-7(3); 6-4; 7-5,R64,183,10,7,58,109,40,58,28,51,6,10,17,68,109,8,6,66,105,46,66,17,39,5,11,17,63,105
2011-03-23 00:00:00.000,ATP World Tour Masters 1000 Miami FL; U.S.A. ATP World Tour Masters 1000,HARD,2,Robin Soderling,Ivan Dodig,Robin Soderling,3-6; 6-2; 6-4,R64,119,3,2,50,85,32,50,18,35,3,7,14,50,85,9,5,37,80,25,37,21,43,6,11,13,46,80
2011-03-23 00:00:00.000,ATP World Tour Masters 1000 Miami FL; U.S.A. ATP World Tour Masters 1000,HARD,2,Alex Bogomolov Jr.,Andy Murray,Alex Bogomolov Jr.,6-1; 7-5,R64,95,0,0,31,50,17,31,12,19,2,5,9,29,50,3,3,32,62,17,32,10,30,4,11,10,27,62
2011-03-23 00:00:00.000,ATP World Tour Masters 1000 Miami FL; U.S.A. ATP World Tour Masters 1000,HARD,2,John Isner,Igor Andreev,John Isner,6-4; 5-7; 7-6(2),R64,138,13,6,74,108,54,74,17,34,3,6,17,71,108,6,5,58,103,43,58,23,45,3,6,17,66,103
2011-03-23 00:00:00.000,ATP World Tour Masters 1000 Miami FL; U.S.A. ATP World Tour Masters 1000,HARD,2,Kevin Anderson,Guillermo Garcia-Lopez,Kevin Anderson,6-3; 5-7; 6-4,R64,142,18,1,78,102,58,78,11,24,4,6,16,69,102,5,5,43,85,36,43,21,42,4,7,15,57,85
2011-03-23 00:00:00.000,ATP World Tour Masters 1000 Miami FL; U.S.A. ATP World Tour Masters 1000,HARD,2,Pablo Andujar,Fernando Verdasco,Pablo Andujar,3-6; 7-6(3); 6-4,R64,154,4,2,79,118,55,79,21,39,5,6,15,76,118,11,9,64,97,56,64,11,33,2,3,16,67,97
2011-03-23 00:00:00.000,ATP World Tour Masters 1000 Miami FL; U.S.A. ATP World Tour Masters 1000,HARD,2,Viktor Troicki,Marsel Ilhan,Viktor Troicki,6-3; 6-3,R64,64,4,0,33,51,26,33,11,18,2,3,9,37,51,0,0,33,48,19,33,6,15,1,5,9,25,48
2011-03-23 00:00:00.000,ATP World Tour Masters 1000 Miami FL; U.S.A. ATP World Tour Masters 1000,HARD,2,Sam Querrey,Mikhail Kukushkin,Sam Querrey,6-3; 6-2,R64,72,13,0,34,59,30,34,12,25,2,2,9,42,59,3,5,30,57,17,30,14,27,7,10,8,31,57
2011-03-23 00:00:00.000,ATP World Tour Masters 1000 Miami FL; U.S.A. ATP World Tour Masters 1000,HARD,2,James Blake,Thomaz Bellucci,James Blake,2-6; 6-4; 7-6(6),R64,120,3,4,59,96,46,59,19,37,3,5,15,65,96,14,3,49,91,42,49,27,42,1,2,15,69,91
2011-03-23 00:00:00.000,ATP World Tour Masters 1000 Miami FL; U.S.A. ATP World Tour Masters 1000,HARD,2,Novak Djokovic,Denis Istomin,Novak Djokovic,6-0; 6-1,R64,49,0,2,26,41,19,26,10,15,2,2,7,29,41,1,1,18,29,4,18,4,11,1,6,6,8,29
2011-03-23 00:00:00.000,ATP World Tour Masters 1000 Miami FL; U.S.A. ATP World Tour Masters 1000,HARD,2,Rafael Nadal,Feliciano Lopez,Rafael Nadal,6-3; 6-3,R32,78,2,1,30,45,27,30,9,15,0,0,9,36,45,7,1,24,51,19,24,11,27,3,6,9,30,51
2011-03-23 00:00:00.000,ATP World Tour Masters 1000 Miami FL; U.S.A. ATP World Tour Masters 1000,HARD,2,Alexandr Dolgopolov,Jo-Wilfried Tsonga,Alexandr Dolgopolov,6-7(2); 6-4; 7-5,R32,152,4,5,53,118,44,53,33,65,8,10,17,77,118,13,2,66,108,51,66,21,42,3,7,17,72,108
2011-03-23 00:00:00.000,ATP World Tour Masters 1000 Miami FL; U.S.A. ATP World Tour Masters 1000,HARD,2,Florian Mayer,Nicolas Almagro,Florian Mayer,6-1; 3-6; 6-1,R32,94,7,1,37,65,30,37,18,28,3,4,12,48,65,8,2,40,75,27,40,16,35,4,8,11,43,75
2011-03-23 00:00:00.000,ATP World Tour Masters 1000 Miami FL; U.S.A. ATP World Tour Masters 1000,HARD,2,Tomas Berdych,Carlos Berlocq,Tomas Berdych,7-6(8); 7-5,R32,135,7,5,44,80,35,44,17,36,5,8,12,52,80,8,6,65,96,44,65,12,31,4,8,12,56,96
2011-03-23 00:00:00.000,ATP World Tour Masters 1000 Miami FL; U.S.A. ATP World Tour Masters 1000,HARD,2,Roger Federer,Juan Monaco,Roger Federer,7-6(4); 6-4,R32,104,3,2,32,64,27,32,19,32,1,2,11,46,64,2,2,51,81,36,51,14,30,7,9,11,50,81
2011-03-23 00:00:00.000,ATP World Tour Masters 1000 Miami FL; U.S.A. ATP World Tour Masters 1000,HARD,2,Olivier Rochus,Mikhail Youzhny,Olivier Rochus,1-6; 6-3; 6-3,R32,126,4,2,53,83,35,53,14,30,9,12,12,49,83,6,2,45,84,29,45,20,39,6,10,13,49,84
2011-03-23 00:00:00.000,ATP World Tour Masters 1000 Miami FL; U.S.A. ATP World Tour Masters 1000,HARD,2,Janko Tipsarevic,Philipp Petzschner,Janko Tipsarevic,6-3; 6-3,R32,74,3,2,25,43,23,25,11,18,1,2,9,34,43,8,1,36,62,25,36,10,26,3,7,9,35,62
2011-03-23 00:00:00.000,ATP World Tour Masters 1000 Miami FL; U.S.A. ATP World Tour Masters 1000,HARD,2,Gilles Simon,Pablo Cuevas,Gilles Simon,4-6; 6-1; 6-2,R32,121,4,2,46,77,37,46,18,31,4,5,13,55,77,2,5,46,79,30,46,13,33,5,9,12,43,79
2011-03-23 00:00:00.000,ATP World Tour Masters 1000 Miami FL; U.S.A. ATP World Tour Masters 1000,HARD,2,David Ferrer,Somdev Devvarman,David Ferrer,6-4; 6-2,R32,102,2,3,33,59,19,33,15,26,2,5,9,34,59,2,1,31,68,16,31,14,37,8,14,9,30,68
2011-03-23 00:00:00.000,ATP World Tour Masters 1000 Miami FL; U.S.A. ATP World Tour Masters 1000,HARD,2,Marcel Granollers,Michael Llodra,Marcel Granollers,7-5; 3-6; 7-5,R32,155,6,2,59,102,42,59,21,43,6,10,16,63,102,3,6,78,122,50,78,20,44,15,20,17,70,122
2011-03-23 00:00:00.000,ATP World Tour Masters 1000 Miami FL; U.S.A. ATP World Tour Masters 1000,HARD,2,Mardy Fish,Richard Gasquet,Mardy Fish,6-4; 6-3,R32,92,8,4,21,57,18,21,23,36,2,3,10,41,57,2,1,28,54,18,28,13,26,2,5,9,31,54
2011-03-23 00:00:00.000,ATP World Tour Masters 1000 Miami FL; U.S.A. ATP World Tour Masters 1000,HARD,2,Juan Martin Del Potro,Robin Soderling,Juan Martin Del Potro,6-3; 6-2,R32,77,12,1,25,45,22,25,14,20,0,0,9,36,45,5,0,38,55,21,38,10,17,8,11,8,31,55
2011-03-23 00:00:00.000,ATP World Tour Masters 1000 Miami FL; U.S.A. ATP World Tour Masters 1000,HARD,2,John Isner,Alex Bogomolov Jr.,John Isner,6-2; 7-6(4),R32,82,11,2,35,53,31,35,13,18,0,0,10,44,53,0,2,43,68,29,43,13,25,2,4,10,42,68
2011-03-23 00:00:00.000,ATP World Tour Masters 1000 Miami FL; U.S.A. ATP World Tour Masters 1000,HARD,2,Kevin Anderson,Pablo Andujar,Kevin Anderson,6-2; 6-3,R32,75,8,0,31,44,29,31,8,13,0,0,9,37,44,0,2,23,49,16,23,11,26,3,6,8,27,49
2011-03-23 00:00:00.000,ATP World Tour Masters 1000 Miami FL; U.S.A. ATP World Tour Masters 1000,HARD,2,Viktor Troicki,Sam Querrey,Viktor Troicki,7-6(5); 3-6; 7-5,R32,155,7,4,72,118,50,72,26,46,6,9,16,76,118,17,2,64,111,45,64,28,47,6,9,17,73,111
2011-03-23 00:00:00.000,ATP World Tour Masters 1000 Miami FL; U.S.A. ATP World Tour Masters 1000,HARD,2,Novak Djokovic,James Blake,Novak Djokovic,6-2; 6-0,R32,53,5,1,27,37,24,27,5,10,0,0,7,29,37,2,4,24,48,14,24,7,24,3,8,7,21,48
2011-03-23 00:00:00.000,ATP World Tour Masters 1000 Miami FL; U.S.A. ATP World Tour Masters 1000,HARD,2,Rafael Nadal,Alexandr Dolgopolov,Rafael Nadal,6-1; 6-2,R16,60,3,0,29,42,25,29,7,13,0,0,8,32,42,4,4,21,43,13,21,6,22,3,7,7,19,43
2011-03-23 00:00:00.000,ATP World Tour Masters 1000 Miami FL; U.S.A. ATP World Tour Masters 1000,HARD,2,Tomas Berdych,Florian Mayer,Tomas Berdych,6-3; 2-6; 7-6(4),R16,144,9,8,53,101,43,53,24,48,2,4,15,67,101,8,3,51,87,43,51,19,36,1,2,14,62,87
2011-03-23 00:00:00.000,ATP World Tour Masters 1000 Miami FL; U.S.A. ATP World Tour Masters 1000,HARD,2,Roger Federer,Olivier Rochus,Roger Federer,6-3; 6-1,R16,53,6,1,25,37,22,25,10,12,0,0,8,32,37,1,3,32,56,21,32,8,24,7,11,8,29,56
2011-03-23 00:00:00.000,ATP World Tour Masters 1000 Miami FL; U.S.A. ATP World Tour Masters 1000,HARD,2,Gilles Simon,Janko Tipsarevic,Gilles Simon,4-6; 7-6(3); 6-2,R16,153,2,6,54,90,41,54,16,36,1,4,15,57,90,2,2,54,100,39,54,23,46,3,7,15,62,100
2011-03-23 00:00:00.000,ATP World Tour Masters 1000 Miami FL; U.S.A. ATP World Tour Masters 1000,HARD,2,David Ferrer,Marcel Granollers,David Ferrer,6-1; 6-2,R16,61,3,1,28,40,24,28,9,12,2,2,8,33,40,3,1,20,40,11,20,8,20,2,6,7,19,40
2011-03-23 00:00:00.000,ATP World Tour Masters 1000 Miami FL; U.S.A. ATP World Tour Masters 1000,HARD,2,Mardy Fish,Juan Martin Del Potro,Mardy Fish,7-5; 7-6(5),R16,145,10,3,51,85,43,51,15,34,5,6,12,58,85,6,3,53,85,36,53,18,32,6,8,12,54,85
2011-03-23 00:00:00.000,ATP World Tour Masters 1000 Miami FL; U.S.A. ATP World Tour Masters 1000,HARD,2,Kevin Anderson,John Isner,Kevin Anderson,6-3; 7-6(4),R16,102,6,2,42,62,37,42,13,20,3,3,11,50,62,12,0,37,61,29,37,13,24,0,1,10,42,61
2011-03-23 00:00:00.000,ATP World Tour Masters 1000 Miami FL; U.S.A. ATP World Tour Masters 1000,HARD,2,Novak Djokovic,Viktor Troicki,Novak Djokovic,6-3; 6-2,R16,84,3,2,42,67,30,42,15,25,2,2,9,45,67,3,2,29,49,15,29,12,20,3,6,8,27,49
2011-03-23 00:00:00.000,ATP World Tour Masters 1000 Miami FL; U.S.A. ATP World Tour Masters 1000,HARD,2,Rafael Nadal,Tomas Berdych,Rafael Nadal,6-2; 3-6; 6-3,Q,137,8,2,55,81,38,55,17,26,6,7,13,55,81,11,0,40,75,30,40,18,35,4,7,13,48,75
2011-03-23 00:00:00.000,ATP World Tour Masters 1000 Miami FL; U.S.A. ATP World Tour Masters 1000,HARD,2,Roger Federer,Gilles Simon,Roger Federer,3-0 RET,Q,11,0,0,3,5,2,3,2,2,0,0,1,4,5,0,0,6,9,1,6,0,3,0,2,2,1,9
2011-03-23 00:00:00.000,ATP World Tour Masters 1000 Miami FL; U.S.A. ATP World Tour Masters 1000,HARD,2,Mardy Fish,David Ferrer,Mardy Fish,7-5; 6-2,Q,82,4,2,33,51,30,33,11,18,2,2,10,41,51,3,5,39,61,25,39,12,22,1,4,10,37,61
2011-03-23 00:00:00.000,ATP World Tour Masters 1000 Miami FL; U.S.A. ATP World Tour Masters 1000,HARD,2,Novak Djokovic,Kevin Anderson,Novak Djokovic,6-4; 6-2,Q,108,6,2,42,64,34,42,10,22,5,5,9,44,64,4,2,40,62,24,40,10,22,1,4,9,34,62
2011-03-23 00:00:00.000,ATP World Tour Masters 1000 Miami FL; U.S.A. ATP World Tour Masters 1000,HARD,2,Rafael Nadal,Roger Federer,Rafael Nadal,6-3; 6-2,S,79,0,0,34,45,28,34,7,11,2,2,8,35,45,6,1,35,58,20,35,11,23,1,5,9,31,58
2011-03-23 00:00:00.000,ATP World Tour Masters 1000 Miami FL; U.S.A. ATP World Tour Masters 1000,HARD,2,Novak Djokovic,Mardy Fish,Novak Djokovic,6-3; 6-1,S,86,4,0,39,56,29,39,8,17,4,4,8,37,56,4,1,26,48,16,26,10,22,3,7,8,26,48
2011-03-23 00:00:00.000,ATP World Tour Masters 1000 Miami FL; U.S.A. ATP World Tour Masters 1000,HARD,2,Novak Djokovic,Rafael Nadal,Novak Djokovic,4-6; 6-3; 7-6(4),F,202,3,0,54,95,36,54,29,41,2,4,16,65,95,5,6,66,110,46,66,20,44,7,9,15,66,110
2011-04-04 00:00:00.000,Casablanca Morocco ATP World Tour 250,CLAY,2,Albert Montanes,N/A Bye,Albert Montanes,,R32,0,0,0,0,0,0,0,0,0,0,0,0,0,0,0,0,0,0,0,0,0,0,0,0,0,0,0
2011-04-04 00:00:00.000,Casablanca Morocco ATP World Tour 250,CLAY,2,Filippo Volandri,Julien Benneteau,Filippo Volandri,7-5; 6-3,R32,99,0,1,47,67,34,47,9,20,4,6,11,43,67,3,3,49,70,29,49,8,21,5,9,10,37,70
2011-04-04 00:00:00.000,Casablanca Morocco ATP World Tour 250,CLAY,2,Blaz Kavcic,Reda El Amrani,Blaz Kavcic,3-4 RET,R32,32,0,3,20,26,12,20,2,6,1,3,4,14,26,1,0,10,16,6,10,3,6,0,1,3,9,16
2011-04-04 00:00:00.000,Casablanca Morocco ATP World Tour 250,CLAY,2,Fabio Fognini,Gerard Granollers,Fabio Fognini,6-2; 4-6; 6-3,R32,136,5,10,48,100,31,48,25,52,8,13,14,56,100,0,3,59,89,29,59,15,30,8,15,13,44,89
2011-04-04 00:00:00.000,Casablanca Morocco ATP World Tour 250,CLAY,2,Andrey Golubev,N/A Bye,Andrey Golubev,,R32,0,0,0,0,0,0,0,0,0,0,0,0,0,0,0,0,0,0,0,0,0,0,0,0,0,0,0
2011-04-04 00:00:00.000,Casablanca Morocco ATP World Tour 250,CLAY,2,Pere Riba,Jesse Huta Galung,Pere Riba,6-3; 6-3,R32,64,2,1,30,48,23,30,13,18,0,0,9,36,48,7,3,31,50,23,31,7,19,0,3,9,30,50
2011-04-04 00:00:00.000,Casablanca Morocco ATP World Tour 250,CLAY,2,Pablo Andujar,Florent Serra,Pablo Andujar,6-1; 3-6; 6-2,R32,90,3,1,40,66,28,40,17,26,1,3,12,45,66,0,0,37,65,26,37,11,28,3,8,12,37,65
2011-04-04 00:00:00.000,Casablanca Morocco ATP World Tour 250,CLAY,2,Jeremy Chardy,Bjorn Phau,Jeremy Chardy,6-2; 7-5,R32,99,6,4,43,76,30,43,17,33,3,4,10,47,76,1,5,40,73,29,40,12,33,10,14,10,41,73
2011-04-04 00:00:00.000,Casablanca Morocco ATP World Tour 250,CLAY,2,Potito Starace,Daniel Brands,Potito Starace,7-5; 6-2,R32,76,1,0,43,53,35,43,8,10,1,1,10,43,53,8,2,39,63,27,39,12,24,4,7,10,39,63
2011-04-04 00:00:00.000,Casablanca Morocco ATP World Tour 250,CLAY,2,Ruben Ramirez Hidalgo,Rui Machado,Ruben Ramirez Hidalgo,7-5; 6-1,R32,93,2,0,31,57,20,31,19,26,1,2,10,39,57,0,4,19,49,12,19,15,30,4,8,9,27,49
2011-04-04 00:00:00.000,Casablanca Morocco ATP World Tour 250,CLAY,2,Frederico Gil,Simone Bolelli,Frederico Gil,6-3; 6-1,R32,71,2,0,23,42,19,23,13,19,0,0,8,32,42,1,1,39,57,21,39,8,18,4,8,8,29,57
2011-04-04 00:00:00.000,Casablanca Morocco ATP World Tour 250,CLAY,2,Gilles Simon,N/A Bye,Gilles Simon,,R32,0,0,0,0,0,0,0,0,0,0,0,0,0,0,0,0,0,0,0,0,0,0,0,0,0,0,0
2011-04-04 00:00:00.000,Casablanca Morocco ATP World Tour 250,CLAY,2,Victor Hanescu,Daniel Gimeno-Traver,Victor Hanescu,4-6; 6-4; 6-4,R32,150,0,6,58,111,41,58,25,53,13,17,15,66,111,5,5,53,99,36,53,19,46,5,10,15,55,99
2011-04-04 00:00:00.000,Casablanca Morocco ATP World Tour 250,CLAY,2,Michael Berrer,Nicolas Devilder,Michael Berrer,6-3; 6-3,R32,84,4,2,26,52,18,26,13,26,5,8,9,31,52,2,0,33,58,16,33,9,25,5,11,9,25,58
2011-04-04 00:00:00.000,Casablanca Morocco ATP World Tour 250,CLAY,2,Andrey Kuznetsov,Sergio Gutierrez-Ferrol,Andrey Kuznetsov,6-1; 7-6(5),R32,77,3,0,36,57,22,36,14,21,2,4,9,36,57,7,4,26,61,21,26,10,35,2,7,10,31,61
2011-04-04 00:00:00.000,Casablanca Morocco ATP World Tour 250,CLAY,2,Marcos Baghdatis,N/A Bye,Marcos Baghdatis,,R32,0,0,0,0,0,0,0,0,0,0,0,0,0,0,0,0,0,0,0,0,0,0,0,0,0,0,0
2011-04-04 00:00:00.000,Casablanca Morocco ATP World Tour 250,CLAY,2,Albert Montanes,Filippo Volandri,Albert Montanes,6-1; 6-4,R16,78,8,0,25,51,21,25,10,26,4,7,9,31,51,0,3,36,62,15,36,12,26,6,12,8,27,62
2011-04-04 00:00:00.000,Casablanca Morocco ATP World Tour 250,CLAY,2,Fabio Fognini,Blaz Kavcic,Fabio Fognini,1-6; 7-5; 7-5,R16,154,3,8,62,106,30,62,21,44,14,22,15,51,106,2,7,54,96,31,54,16,42,7,15,16,47,96
2011-04-04 00:00:00.000,Casablanca Morocco ATP World Tour 250,CLAY,2,Pere Riba,Andrey Golubev,Pere Riba,0-6; 6-1; 7-5,R16,96,3,4,32,70,22,32,21,38,7,12,13,43,70,1,3,37,67,24,37,15,30,3,8,12,39,67
2011-04-04 00:00:00.000,Casablanca Morocco ATP World Tour 250,CLAY,2,Pablo Andujar,Jeremy Chardy,Pablo Andujar,7-6(6); 6-1,R16,90,1,0,43,61,32,43,10,18,0,2,10,42,61,4,2,32,56,20,32,14,24,7,11,9,34,56
2011-04-04 00:00:00.000,Casablanca Morocco ATP World Tour 250,CLAY,2,Potito Starace,Ruben Ramirez Hidalgo,Potito Starace,6-4; 6-3,R16,91,0,2,31,48,23,31,12,17,2,3,9,35,48,1,5,36,70,24,36,14,34,4,8,10,38,70
2011-04-04 00:00:00.000,Casablanca Morocco ATP World Tour 250,CLAY,2,Gilles Simon,Frederico Gil,Gilles Simon,6-3; 6-4,R16,84,4,3,34,62,28,34,15,28,1,1,10,43,62,2,1,31,52,23,31,10,21,0,2,9,33,52
2011-04-04 00:00:00.000,Casablanca Morocco ATP World Tour 250,CLAY,2,Victor Hanescu,Michael Berrer,Victor Hanescu,6-4; 7-6(4),R16,101,6,3,40,66,31,40,16,26,3,4,11,47,66,3,6,38,73,30,38,18,35,4,6,11,48,73
2011-04-04 00:00:00.000,Casablanca Morocco ATP World Tour 250,CLAY,2,Andrey Kuznetsov,Marcos Baghdatis,Andrey Kuznetsov,6-4; 4-6; 6-4,R16,124,1,3,44,90,29,44,28,46,5,9,15,57,90,6,9,35,101,26,35,33,66,7,12,15,59,101
2011-04-04 00:00:00.000,Casablanca Morocco ATP World Tour 250,CLAY,2,Albert Montanes,Fabio Fognini,Albert Montanes,7-6(1); 6-1,Q,101,3,5,31,70,24,31,22,39,0,1,10,46,70,2,7,34,65,26,34,9,31,1,4,9,35,65
2011-04-04 00:00:00.000,Casablanca Morocco ATP World Tour 250,CLAY,2,Pablo Andujar,Pere Riba,Pablo Andujar,6-2; 6-2,Q,74,3,1,35,44,29,35,2,9,0,1,8,31,44,3,3,26,59,18,26,9,33,7,12,8,27,59
2011-04-04 00:00:00.000,Casablanca Morocco ATP World Tour 250,CLAY,2,Potito Starace,Gilles Simon,Potito Starace,6-4; 3-6; 6-4,Q,140,2,3,62,96,41,62,16,34,7,11,14,57,96,3,4,53,95,35,53,19,42,8,13,15,54,95
2011-04-04 00:00:00.000,Casablanca Morocco ATP World Tour 250,CLAY,2,Victor Hanescu,Andrey Kuznetsov,Victor Hanescu,6-7(1); 7-5; 6-2,Q,133,5,2,66,101,46,66,19,35,5,8,16,65,101,2,2,46,96,32,46,24,50,5,11,16,56,96
2011-04-04 00:00:00.000,Casablanca Morocco ATP World Tour 250,CLAY,2,Pablo Andujar,Albert Montanes,Pablo Andujar,6-4; 6-4,S,114,2,2,65,84,38,65,8,19,13,16,10,46,84,4,5,41,67,25,41,8,26,8,13,10,33,67
2011-04-04 00:00:00.000,Casablanca Morocco ATP World Tour 250,CLAY,2,Potito Starace,Victor Hanescu,Potito Starace,6-1; 6-7(3); 7-6(2),S,150,2,0,78,104,52,78,14,26,1,4,16,66,104,2,3,63,93,39,63,20,30,5,10,15,59,93
2011-04-04 00:00:00.000,Casablanca Morocco ATP World Tour 250,CLAY,2,Pablo Andujar,Potito Starace,Pablo Andujar,6-1; 6-2,F,75,0,2,31,54,25,31,12,23,2,2,8,37,54,2,0,33,47,17,33,7,14,4,8,7,24,47
2011-04-04 00:00:00.000,Houston TX; U.S.A. ATP World Tour 250,CLAY,2,Mardy Fish,N/A Bye,Mardy Fish,,R32,0,0,0,0,0,0,0,0,0,0,0,0,0,0,0,0,0,0,0,0,0,0,0,0,0,0,0
2011-04-04 00:00:00.000,Houston TX; U.S.A. ATP World Tour 250,CLAY,2,Albert Ramos,Brian Dabul,Albert Ramos,6-4; 7-5,R32,96,5,1,45,74,31,45,17,29,5,6,11,48,74,2,3,53,68,37,53,5,15,4,7,11,42,68
2011-04-04 00:00:00.000,Houston TX; U.S.A. ATP World Tour 250,CLAY,2,Igor Andreev,Michael Russell,Igor Andreev,6-2; 6-3,R32,73,3,1,37,55,26,37,12,18,2,3,9,38,55,2,6,24,52,16,24,11,28,4,8,8,27,52
2011-04-04 00:00:00.000,Houston TX; U.S.A. ATP World Tour 250,CLAY,2,Kei Nishikori,Franko Skugor,Kei Nishikori,6-3; 6-2,R32,75,2,1,38,61,27,38,15,23,2,2,9,42,61,1,2,30,50,21,30,6,20,3,6,8,27,50
2011-04-04 00:00:00.000,Houston TX; U.S.A. ATP World Tour 250,CLAY,2,Guillermo Garcia-Lopez,N/A Bye,Guillermo Garcia-Lopez,,R32,0,0,0,0,0,0,0,0,0,0,0,0,0,0,0,0,0,0,0,0,0,0,0,0,0,0,0
2011-04-04 00:00:00.000,Houston TX; U.S.A. ATP World Tour 250,CLAY,2,Somdev Devvarman,Robert Kendrick,Somdev Devvarman,6-2; 6-1,R32,62,1,1,32,48,22,32,10,16,3,4,8,32,48,1,4,30,57,15,30,9,27,9,14,7,24,57
2011-04-04 00:00:00.000,Houston TX; U.S.A. ATP World Tour 250,CLAY,2,James Blake,Carlos Berlocq,James Blake,6-7(3); 6-3; 6-4,R32,158,5,3,66,139,46,66,37,73,18,20,16,83,139,1,3,68,92,43,68,12,24,6,10,15,55,92
2011-04-04 00:00:00.000,Houston TX; U.S.A. ATP World Tour 250,CLAY,2,Pablo Cuevas,Ricardo Mello,Pablo Cuevas,6-2; 6-0,R32,53,3,1,17,34,16,17,12,17,0,0,7,28,34,0,1,24,43,10,24,7,19,4,9,7,17,43
2011-04-04 00:00:00.000,Houston TX; U.S.A. ATP World Tour 250,CLAY,2,Ivo Karlovic,Benjamin Becker,Ivo Karlovic,7-6(5); 6-4,R32,90,8,0,34,59,32,34,19,25,0,0,11,51,59,6,3,39,71,34,39,17,32,3,4,11,51,71
2011-04-04 00:00:00.000,Houston TX; U.S.A. ATP World Tour 250,CLAY,2,Igor Kunitsyn,Mischa Zverev,Igor Kunitsyn,7-6(1); 6-2,R32,122,1,3,34,69,21,34,19,35,6,10,10,40,69,0,2,46,78,19,46,16,32,8,14,10,35,78
2011-04-04 00:00:00.000,Houston TX; U.S.A. ATP World Tour 250,CLAY,2,Horacio Zeballos,Ryan Harrison,Horacio Zeballos,6-4; 6-3,R32,96,2,1,38,68,29,38,12,30,4,5,9,41,68,5,3,31,67,18,31,18,36,3,7,10,36,67
2011-04-04 00:00:00.000,Houston TX; U.S.A. ATP World Tour 250,CLAY,2,John Isner,N/A Bye,John Isner,,R32,0,0,0,0,0,0,0,0,0,0,0,0,0,0,0,0,0,0,0,0,0,0,0,0,0,0,0
2011-04-04 00:00:00.000,Houston TX; U.S.A. ATP World Tour 250,CLAY,2,Grigor Dimitrov,Rainer Schuettler,Grigor Dimitrov,6-0; 6-2,R32,64,2,1,25,43,21,25,7,18,4,5,7,28,43,0,7,23,54,12,23,11,31,7,13,7,23,54
2011-04-04 00:00:00.000,Houston TX; U.S.A. ATP World Tour 250,CLAY,2,Teymuraz Gabashvili,Paul Capdeville,Teymuraz Gabashvili,6-4; 7-6(4),R32,110,2,3,43,66,28,43,14,23,0,3,11,42,66,4,1,49,86,30,49,18,37,5,9,11,48,86
2011-04-04 00:00:00.000,Houston TX; U.S.A. ATP World Tour 250,CLAY,2,Ryan Sweeting,Tim Smyczek,Ryan Sweeting,6-2; 6-2,R32,70,3,0,32,48,23,32,11,16,3,4,8,34,48,0,5,28,47,15,28,5,19,3,8,8,20,47
2011-04-04 00:00:00.000,Houston TX; U.S.A. ATP World Tour 250,CLAY,2,Sam Querrey,N/A Bye,Sam Querrey,,R32,0,0,0,0,0,0,0,0,0,0,0,0,0,0,0,0,0,0,0,0,0,0,0,0,0,0,0
2011-04-04 00:00:00.000,Houston TX; U.S.A. ATP World Tour 250,CLAY,2,Mardy Fish,Albert Ramos,Mardy Fish,6-3; 6-4,R16,93,3,2,36,63,27,36,16,27,8,9,10,43,63,3,4,23,52,18,23,12,29,3,6,9,30,52
2011-04-04 00:00:00.000,Houston TX; U.S.A. ATP World Tour 250,CLAY,2,Kei Nishikori,Igor Andreev,Kei Nishikori,6-3; 6-3,R16,76,3,1,38,56,28,38,12,18,1,1,9,40,56,2,4,34,53,25,34,7,19,4,7,9,32,53
2011-04-04 00:00:00.000,Houston TX; U.S.A. ATP World Tour 250,CLAY,2,Guillermo Garcia-Lopez,Somdev Devvarman,Guillermo Garcia-Lopez,6-4; 6-1,R16,88,0,5,19,50,13,19,18,31,0,2,9,31,50,1,1,29,58,16,29,11,29,4,9,8,27,58
2011-04-04 00:00:00.000,Houston TX; U.S.A. ATP World Tour 250,CLAY,2,Pablo Cuevas,James Blake,Pablo Cuevas,7-5; 6-1,R16,70,8,1,35,49,31,35,10,14,2,2,10,41,49,2,4,38,67,28,38,10,29,5,8,9,38,67
2011-04-04 00:00:00.000,Houston TX; U.S.A. ATP World Tour 250,CLAY,2,Ivo Karlovic,Igor Kunitsyn,Ivo Karlovic,6-4; 6-1,R16,66,12,3,31,48,26,31,8,17,1,2,9,34,48,1,1,35,53,20,35,9,18,5,9,8,29,53
2011-04-04 00:00:00.000,Houston TX; U.S.A. ATP World Tour 250,CLAY,2,John Isner,Horacio Zeballos,John Isner,7-5; 6-3,R16,71,14,2,33,52,28,33,14,19,0,0,10,42,52,2,0,34,61,21,34,17,27,1,4,11,38,61
2011-04-04 00:00:00.000,Houston TX; U.S.A. ATP World Tour 250,CLAY,2,Teymuraz Gabashvili,Grigor Dimitrov,Teymuraz Gabashvili,7-6(4); 6-3,R16,138,0,10,46,85,30,46,18,39,8,12,11,48,85,4,7,36,83,23,36,20,47,6,11,10,43,83
2011-04-04 00:00:00.000,Houston TX; U.S.A. ATP World Tour 250,CLAY,2,Ryan Sweeting,Sam Querrey,Ryan Sweeting,3-6; 7-6(5); 6-3,R16,135,1,5,108,141,60,108,16,33,18,24,16,76,141,13,7,59,99,40,59,16,40,5,10,14,56,99
2011-04-04 00:00:00.000,Houston TX; U.S.A. ATP World Tour 250,CLAY,2,Kei Nishikori,Mardy Fish,Kei Nishikori,6-3; 6-2,Q,71,1,5,23,46,22,23,14,23,0,0,9,36,46,1,2,28,42,17,28,7,14,2,5,8,24,42
2011-04-04 00:00:00.000,Houston TX; U.S.A. ATP World Tour 250,CLAY,2,Pablo Cuevas,Guillermo Garcia-Lopez,Pablo Cuevas,1-6; 7-6(4); 6-3,Q,147,5,4,37,78,23,37,21,41,1,7,13,44,78,1,5,65,102,39,65,15,37,4,10,15,54,102
2011-04-04 00:00:00.000,Houston TX; U.S.A. ATP World Tour 250,CLAY,2,Ivo Karlovic,John Isner,Ivo Karlovic,7-6(2); 6-7(2); 7-6(9),Q,196,24,5,87,135,70,87,24,48,10,11,18,94,135,23,3,67,116,56,67,32,49,0,1,18,88,116
2011-04-04 00:00:00.000,Houston TX; U.S.A. ATP World Tour 250,CLAY,2,Ryan Sweeting,Teymuraz Gabashvili,Ryan Sweeting,3-6; 6-3; 6-1,Q,100,5,4,39,66,28,39,17,27,3,5,12,45,66,1,5,34,71,25,34,16,37,2,7,13,41,71
2011-04-04 00:00:00.000,Houston TX; U.S.A. ATP World Tour 250,CLAY,2,Kei Nishikori,Pablo Cuevas,Kei Nishikori,6-3; 7-5,S,104,2,3,34,71,24,34,18,37,6,9,11,42,71,2,1,33,58,18,33,11,25,4,9,10,29,58
2011-04-04 00:00:00.000,Houston TX; U.S.A. ATP World Tour 250,CLAY,2,Ryan Sweeting,Ivo Karlovic,Ryan Sweeting,7-6(3); 6-3,S,99,2,4,48,68,42,48,10,20,4,4,11,52,68,12,4,44,81,34,44,17,37,3,4,10,51,81
2011-04-04 00:00:00.000,Houston TX; U.S.A. ATP World Tour 250,CLAY,2,Ryan Sweeting,Kei Nishikori,Ryan Sweeting,6-4; 7-6(3),F,120,5,6,54,92,37,54,20,38,4,5,11,57,92,1,0,39,68,30,39,14,29,3,5,11,44,68
2011-04-10 00:00:00.000,ATP World Tour Masters 1000 Monte Carlo Monaco ATP World Tour Masters 1000,CLAY,2,Rafael Nadal,N/A Bye,Rafael Nadal,,R64,0,0,0,0,0,0,0,0,0,0,0,0,0,0,0,0,0,0,0,0,0,0,0,0,0,0,0
2011-04-10 00:00:00.000,ATP World Tour Masters 1000 Monte Carlo Monaco ATP World Tour Masters 1000,CLAY,2,Jarkko Nieminen,Julien Benneteau,Jarkko Nieminen,4-6; 6-3; 7-6(3),R64,144,5,3,74,97,51,74,11,23,5,9,16,62,97,5,1,77,107,48,77,14,30,7,11,15,62,107
2011-04-10 00:00:00.000,ATP World Tour Masters 1000 Monte Carlo Monaco ATP World Tour Masters 1000,CLAY,2,Guillermo Garcia-Lopez,Vincent Millot,Guillermo Garcia-Lopez,6-2; 6-4,R64,78,0,2,37,57,24,37,12,20,5,7,9,36,57,1,3,25,53,13,25,12,28,6,11,9,25,53
2011-04-10 00:00:00.000,ATP World Tour Masters 1000 Monte Carlo Monaco ATP World Tour Masters 1000,CLAY,2,Richard Gasquet,Denis Istomin,Richard Gasquet,5-7; 6-3; 6-4,R64,161,2,5,45,94,30,45,31,49,2,5,16,61,94,2,4,68,107,40,68,22,39,11,15,15,62,107
2011-04-10 00:00:00.000,ATP World Tour Masters 1000 Monte Carlo Monaco ATP World Tour Masters 1000,CLAY,2,Jo-Wilfried Tsonga,Juan Monaco,Jo-Wilfried Tsonga,4-6; 6-3; 6-2,R64,151,6,3,62,95,37,62,14,33,3,8,13,51,95,1,3,56,92,32,56,13,36,7,15,14,45,92
2011-04-10 00:00:00.000,ATP World Tour Masters 1000 Monte Carlo Monaco ATP World Tour Masters 1000,CLAY,2,Ivan Ljubicic,Jeremy Chardy,Ivan Ljubicic,6-1; 6-2,R64,64,5,3,35,54,27,35,9,19,3,3,8,36,54,2,5,23,41,13,23,5,18,3,7,7,18,41
2011-04-10 00:00:00.000,ATP World Tour Masters 1000 Monte Carlo Monaco ATP World Tour Masters 1000,CLAY,2,Olivier Rochus,Juan Ignacio Chela,Olivier Rochus,6-4; 5-7; 7-5,R64,185,3,4,69,110,37,69,22,41,8,15,17,59,110,4,2,73,119,40,73,22,46,9,17,17,62,119
2011-04-10 00:00:00.000,ATP World Tour Masters 1000 Monte Carlo Monaco ATP World Tour Masters 1000,CLAY,2,Tomas Berdych,N/A Bye,Tomas Berdych,,R64,0,0,0,0,0,0,0,0,0,0,0,0,0,0,0,0,0,0,0,0,0,0,0,0,0,0,0
2011-04-10 00:00:00.000,ATP World Tour Masters 1000 Monte Carlo Monaco ATP World Tour Masters 1000,CLAY,2,Andy Murray,N/A Bye,Andy Murray,,R64,0,0,0,0,0,0,0,0,0,0,0,0,0,0,0,0,0,0,0,0,0,0,0,0,0,0,0
2011-04-10 00:00:00.000,ATP World Tour Masters 1000 Monte Carlo Monaco ATP World Tour Masters 1000,CLAY,2,Radek Stepanek,Marcos Baghdatis,Radek Stepanek,3-6; 6-1; 7-6(7),R64,154,3,3,56,95,40,56,21,39,5,7,14,61,95,4,5,41,110,27,41,35,69,5,8,14,62,110
2011-04-10 00:00:00.000,ATP World Tour Masters 1000 Monte Carlo Monaco ATP World Tour Masters 1000,CLAY,2,Albert Montanes,Xavier Malisse,Albert Montanes,6-4; 6-2,R64,82,0,1,35,51,23,35,12,16,4,5,9,35,51,1,2,33,67,19,33,17,34,4,8,9,36,67
2011-04-10 00:00:00.000,ATP World Tour Masters 1000 Monte Carlo Monaco ATP World Tour Masters 1000,CLAY,2,Gilles Simon,Thomaz Bellucci,Gilles Simon,6-3; 6-2,R64,94,1,2,48,79,32,48,17,31,6,7,9,49,79,2,2,19,40,12,19,8,21,1,5,8,20,40
2011-04-10 00:00:00.000,ATP World Tour Masters 1000 Monte Carlo Monaco ATP World Tour Masters 1000,CLAY,2,Florian Mayer,Mikhail Youzhny,Florian Mayer,6-3; 2-6; 6-3,R64,124,4,6,43,88,27,43,21,45,5,11,13,48,88,1,4,43,83,23,43,18,40,6,13,13,41,83
2011-04-10 00:00:00.000,ATP World Tour Masters 1000 Monte Carlo Monaco ATP World Tour Masters 1000,CLAY,2,Frederico Gil,Sergiy Stakhovsky,Frederico Gil,6-1; 6-3,R64,68,1,1,36,50,25,36,7,14,3,4,8,32,50,1,3,33,49,17,33,4,16,5,10,8,21,49
2011-04-10 00:00:00.000,ATP World Tour Masters 1000 Monte Carlo Monaco ATP World Tour Masters 1000,CLAY,2,Daniel Gimeno-Traver,Santiago Giraldo,Daniel Gimeno-Traver,7-6(4); 7-5,R64,124,3,5,42,78,25,42,19,36,5,10,12,44,78,3,4,57,95,35,57,14,38,8,14,12,49,95
2011-04-10 00:00:00.000,ATP World Tour Masters 1000 Monte Carlo Monaco ATP World Tour Masters 1000,CLAY,2,Gael Monfils,N/A Bye,Gael Monfils,,R64,0,0,0,0,0,0,0,0,0,0,0,0,0,0,0,0,0,0,0,0,0,0,0,0,0,0,0
2011-04-10 00:00:00.000,ATP World Tour Masters 1000 Monte Carlo Monaco ATP World Tour Masters 1000,CLAY,2,Fernando Verdasco,N/A Bye,Fernando Verdasco,,R64,0,0,0,0,0,0,0,0,0,0,0,0,0,0,0,0,0,0,0,0,0,0,0,0,0,0,0
2011-04-10 00:00:00.000,ATP World Tour Masters 1000 Monte Carlo Monaco ATP World Tour Masters 1000,CLAY,2,Tommy Robredo,Ivan Dodig,Tommy Robredo,6-4; 6-2,R64,77,1,0,39,56,29,39,10,17,2,2,9,39,56,1,3,23,49,16,23,14,26,2,5,9,30,49
2011-04-10 00:00:00.000,ATP World Tour Masters 1000 Monte Carlo Monaco ATP World Tour Masters 1000,CLAY,2,Fabio Fognini,Kevin Anderson,Fabio Fognini,3-6; 6-2; 6-2,R64,114,1,3,29,60,18,29,21,31,0,3,12,39,60,6,1,53,78,33,53,7,25,5,11,13,40,78
2011-04-10 00:00:00.000,ATP World Tour Masters 1000 Monte Carlo Monaco ATP World Tour Masters 1000,CLAY,2,Viktor Troicki,Jean-Rene Lisnard,Viktor Troicki,7-6(4); 6-1,R64,121,3,2,45,78,31,45,18,33,4,6,10,49,78,0,2,38,76,22,38,17,38,4,8,9,39,76
2011-04-10 00:00:00.000,ATP World Tour Masters 1000 Monte Carlo Monaco ATP World Tour Masters 1000,CLAY,2,Ernests Gulbis,Alexandr Dolgopolov,Ernests Gulbis,6-1; 6-4,R64,70,9,3,26,50,19,26,17,24,1,2,9,36,50,1,4,25,59,17,25,12,34,4,8,8,29,59
2011-04-10 00:00:00.000,ATP World Tour Masters 1000 Monte Carlo Monaco ATP World Tour Masters 1000,CLAY,2,Milos Raonic,Michael Llodra,Milos Raonic,6-3; 0-6; 6-0,R64,79,5,2,44,67,36,44,5,23,6,9,10,41,67,4,5,32,61,22,32,10,29,2,7,11,32,61
2011-04-10 00:00:00.000,ATP World Tour Masters 1000 Monte Carlo Monaco ATP World Tour Masters 1000,CLAY,2,Feliciano Lopez,Janko Tipsarevic,Feliciano Lopez,4-6; 6-3; 7-6(4),R64,145,18,2,60,104,49,60,24,44,3,5,16,73,104,7,4,52,96,38,52,26,44,3,5,15,64,96
2011-04-10 00:00:00.000,ATP World Tour Masters 1000 Monte Carlo Monaco ATP World Tour Masters 1000,CLAY,2,David Ferrer,N/A Bye,David Ferrer,,R64,0,0,0,0,0,0,0,0,0,0,0,0,0,0,0,0,0,0,0,0,0,0,0,0,0,0,0
2011-04-10 00:00:00.000,ATP World Tour Masters 1000 Monte Carlo Monaco ATP World Tour Masters 1000,CLAY,2,Jurgen Melzer,N/A Bye,Jurgen Melzer,,R64,0,0,0,0,0,0,0,0,0,0,0,0,0,0,0,0,0,0,0,0,0,0,0,0,0,0,0
2011-04-10 00:00:00.000,ATP World Tour Masters 1000 Monte Carlo Monaco ATP World Tour Masters 1000,CLAY,2,Robin Haase,Nikolay Davydenko,Robin Haase,7-5; 4-6; 6-4,R64,165,5,1,72,120,48,72,20,48,12,17,16,68,120,0,4,79,114,43,79,18,35,13,19,16,61,114
2011-04-10 00:00:00.000,ATP World Tour Masters 1000 Monte Carlo Monaco ATP World Tour Masters 1000,CLAY,2,Maximo Gonzalez,Victor Hanescu,Maximo Gonzalez,3-6; 7-5; 6-1,R64,141,0,2,68,99,40,68,16,31,7,11,14,56,99,6,1,70,109,40,70,17,39,12,18,14,57,109
2011-04-10 00:00:00.000,ATP World Tour Masters 1000 Monte Carlo Monaco ATP World Tour Masters 1000,CLAY,2,Nicolas Almagro,Marcel Granollers,Nicolas Almagro,6-3; 6-3,R64,87,3,5,41,63,34,41,7,22,2,3,9,41,63,0,1,30,54,21,30,8,24,1,5,9,29,54
2011-04-10 00:00:00.000,ATP World Tour Masters 1000 Monte Carlo Monaco ATP World Tour Masters 1000,CLAY,2,Marin Cilic,Filippo Volandri,Marin Cilic,6-2; 6-1,R64,65,3,1,21,34,19,21,9,13,0,0,7,28,34,0,2,33,52,15,33,11,19,4,9,8,26,52
2011-04-10 00:00:00.000,ATP World Tour Masters 1000 Monte Carlo Monaco ATP World Tour Masters 1000,CLAY,2,Pere Riba,Potito Starace,Pere Riba,4-6; 6-3; 6-3,R64,131,2,5,49,90,32,49,23,41,7,10,14,55,90,1,3,76,100,43,76,11,24,12,17,14,54,100
2011-04-10 00:00:00.000,ATP World Tour Masters 1000 Monte Carlo Monaco ATP World Tour Masters 1000,CLAY,2,Philipp Kohlschreiber,Andrey Golubev,Philipp Kohlschreiber,5-7; 7-6(6); 6-4,R64,150,2,6,68,120,44,68,31,52,9,13,17,75,120,1,3,66,106,44,66,20,40,4,8,17,64,106
2011-04-10 00:00:00.000,ATP World Tour Masters 1000 Monte Carlo Monaco ATP World Tour Masters 1000,CLAY,2,Roger Federer,N/A Bye,Roger Federer,,R64,0,0,0,0,0,0,0,0,0,0,0,0,0,0,0,0,0,0,0,0,0,0,0,0,0,0,0
2011-04-10 00:00:00.000,ATP World Tour Masters 1000 Monte Carlo Monaco ATP World Tour Masters 1000,CLAY,2,Rafael Nadal,Jarkko Nieminen,Rafael Nadal,6-2; 6-2,R32,69,0,1,26,40,22,26,10,14,0,0,8,32,40,0,3,28,48,16,28,8,20,5,9,8,24,48
2011-04-10 00:00:00.000,ATP World Tour Masters 1000 Monte Carlo Monaco ATP World Tour Masters 1000,CLAY,2,Richard Gasquet,Guillermo Garcia-Lopez,Richard Gasquet,6-2; 6-1,R32,83,2,4,31,51,24,31,10,20,4,5,8,34,51,0,3,35,51,16,35,6,16,8,13,7,22,51
2011-04-10 00:00:00.000,ATP World Tour Masters 1000 Monte Carlo Monaco ATP World Tour Masters 1000,CLAY,2,Ivan Ljubicic,Jo-Wilfried Tsonga,Ivan Ljubicic,7-6(2); 6-4,R32,130,5,3,54,91,39,54,18,37,3,5,11,57,91,4,0,44,73,31,44,14,29,3,6,11,45,73
2011-04-10 00:00:00.000,ATP World Tour Masters 1000 Monte Carlo Monaco ATP World Tour Masters 1000,CLAY,2,Tomas Berdych,Olivier Rochus,Tomas Berdych,6-2; 6-3,R32,107,8,1,42,76,31,42,17,34,6,7,9,48,76,1,1,35,58,22,35,6,23,7,11,8,28,58
2011-04-10 00:00:00.000,ATP World Tour Masters 1000 Monte Carlo Monaco ATP World Tour Masters 1000,CLAY,2,Andy Murray,Radek Stepanek,Andy Murray,6-1; 6-4,R32,92,7,1,28,47,22,28,11,19,4,5,8,33,47,2,0,44,69,25,44,9,25,3,8,9,34,69
2011-04-10 00:00:00.000,ATP World Tour Masters 1000 Monte Carlo Monaco ATP World Tour Masters 1000,CLAY,2,Gilles Simon,Albert Montanes,Gilles Simon,6-3; 6-4,R32,93,1,0,33,66,21,33,19,33,7,9,10,40,66,2,3,38,69,21,38,15,31,4,8,9,36,69
2011-04-10 00:00:00.000,ATP World Tour Masters 1000 Monte Carlo Monaco ATP World Tour Masters 1000,CLAY,2,Frederico Gil,Florian Mayer,Frederico Gil,7-5; 6-1,R32,83,2,0,38,58,23,38,13,20,4,6,9,36,58,1,4,29,61,19,29,9,32,2,8,10,28,61
2011-04-10 00:00:00.000,ATP World Tour Masters 1000 Monte Carlo Monaco ATP World Tour Masters 1000,CLAY,2,Gael Monfils,Daniel Gimeno-Traver,Gael Monfils,7-5; 6-2,R32,93,1,3,39,55,28,39,8,16,5,7,10,36,55,4,3,38,73,21,38,18,35,9,14,10,39,73
2011-04-10 00:00:00.000,ATP World Tour Masters 1000 Monte Carlo Monaco ATP World Tour Masters 1000,CLAY,2,Tommy Robredo,Fernando Verdasco,Tommy Robredo,6-4; 6-3,R32,91,2,1,40,60,29,40,12,20,5,7,10,41,60,3,6,28,53,18,28,11,25,1,5,9,29,53
2011-04-10 00:00:00.000,ATP World Tour Masters 1000 Monte Carlo Monaco ATP World Tour Masters 1000,CLAY,2,Viktor Troicki,Fabio Fognini,Viktor Troicki,6-3; 4-6; 6-4,R32,129,2,0,53,89,30,53,16,36,5,12,14,46,89,0,2,58,90,31,58,12,32,6,15,15,43,90
2011-04-10 00:00:00.000,ATP World Tour Masters 1000 Monte Carlo Monaco ATP World Tour Masters 1000,CLAY,2,Milos Raonic,Ernests Gulbis,Milos Raonic,6-4; 7-5,R32,91,7,1,38,62,29,38,12,24,1,3,11,41,62,4,4,34,59,23,34,13,25,0,4,11,36,59
2011-04-10 00:00:00.000,ATP World Tour Masters 1000 Monte Carlo Monaco ATP World Tour Masters 1000,CLAY,2,David Ferrer,Feliciano Lopez,David Ferrer,6-2; 6-0,R32,56,5,1,24,36,21,24,8,12,1,1,7,29,36,2,6,32,50,16,32,6,18,5,10,7,22,50
2011-04-10 00:00:00.000,ATP World Tour Masters 1000 Monte Carlo Monaco ATP World Tour Masters 1000,CLAY,2,Jurgen Melzer,Robin Haase,Jurgen Melzer,3-6; 6-1; 6-2,R32,91,5,0,46,60,33,46,7,14,3,6,12,40,60,5,2,39,65,24,39,11,26,6,12,12,35,65
2011-04-10 00:00:00.000,ATP World Tour Masters 1000 Monte Carlo Monaco ATP World Tour Masters 1000,CLAY,2,Nicolas Almagro,Maximo Gonzalez,Nicolas Almagro,6-7(6); 7-5; 7-6(10),R32,180,10,5,63,115,45,63,27,52,6,10,18,72,115,3,1,88,129,56,88,20,41,10,15,18,76,129
2011-04-10 00:00:00.000,ATP World Tour Masters 1000 Monte Carlo Monaco ATP World Tour Masters 1000,CLAY,2,Marin Cilic,Pere Riba,Marin Cilic,5-2 RET,R32,36,4,0,10,14,9,10,3,4,0,0,3,12,14,0,0,19,32,9,19,7,13,6,8,4,16,32
2011-04-10 00:00:00.000,ATP World Tour Masters 1000 Monte Carlo Monaco ATP World Tour Masters 1000,CLAY,2,Roger Federer,Philipp Kohlschreiber,Roger Federer,6-2; 6-1,R32,50,5,2,33,46,29,33,6,13,1,1,8,35,46,3,2,29,41,15,29,5,12,3,7,7,20,41
2011-04-10 00:00:00.000,ATP World Tour Masters 1000 Monte Carlo Monaco ATP World Tour Masters 1000,CLAY,2,Rafael Nadal,Richard Gasquet,Rafael Nadal,6-2; 6-4,R16,94,3,2,33,50,25,33,11,17,0,1,9,36,50,1,0,32,63,18,32,15,31,5,9,9,33,63
2011-04-10 00:00:00.000,ATP World Tour Masters 1000 Monte Carlo Monaco ATP World Tour Masters 1000,CLAY,2,Ivan Ljubicic,Tomas Berdych,Ivan Ljubicic,6-4; 6-2,R16,81,5,1,32,54,27,32,12,22,1,1,9,39,54,1,0,26,45,19,26,10,19,1,4,9,29,45
2011-04-10 00:00:00.000,ATP World Tour Masters 1000 Monte Carlo Monaco ATP World Tour Masters 1000,CLAY,2,Andy Murray,Gilles Simon,Andy Murray,6-3; 6-3,R16,95,0,1,27,49,19,27,10,22,2,5,9,29,49,2,2,33,69,15,33,16,36,4,10,9,31,69
2011-04-10 00:00:00.000,ATP World Tour Masters 1000 Monte Carlo Monaco ATP World Tour Masters 1000,CLAY,2,Frederico Gil,Gael Monfils,Frederico Gil,7-6(6); 6-2,R16,121,1,1,49,78,36,49,17,29,3,3,10,53,78,2,4,45,69,28,45,10,24,3,5,10,38,69
2011-04-10 00:00:00.000,ATP World Tour Masters 1000 Monte Carlo Monaco ATP World Tour Masters 1000,CLAY,2,Viktor Troicki,Tommy Robredo,Viktor Troicki,3-6; 2-1 RET,R16,67,2,1,29,40,18,29,4,11,4,6,6,22,40,1,0,28,43,18,28,9,15,4,5,6,27,43
2011-04-10 00:00:00.000,ATP World Tour Masters 1000 Monte Carlo Monaco ATP World Tour Masters 1000,CLAY,2,David Ferrer,Milos Raonic,David Ferrer,6-1; 6-3,R16,77,0,1,24,45,16,24,13,21,1,2,8,29,45,1,2,26,55,15,26,11,29,5,10,8,26,55
2011-04-10 00:00:00.000,ATP World Tour Masters 1000 Monte Carlo Monaco ATP World Tour Masters 1000,CLAY,2,Jurgen Melzer,Nicolas Almagro,Jurgen Melzer,6-1; 6-4,R16,91,2,1,32,48,25,32,8,16,2,3,8,33,48,1,3,25,51,15,25,8,26,2,7,9,23,51
2011-04-10 00:00:00.000,ATP World Tour Masters 1000 Monte Carlo Monaco ATP World Tour Masters 1000,CLAY,2,Roger Federer,Marin Cilic,Roger Federer,6-4; 6-3,R16,72,0,0,38,54,30,38,12,16,1,1,10,42,54,3,2,26,52,19,26,15,26,2,4,9,34,52
2011-04-10 00:00:00.000,ATP World Tour Masters 1000 Monte Carlo Monaco ATP World Tour Masters 1000,CLAY,2,Rafael Nadal,Ivan Ljubicic,Rafael Nadal,6-1; 6-3,Q,80,0,1,32,46,24,32,8,14,5,6,8,32,46,3,0,32,47,13,32,7,15,2,7,8,20,47
2011-04-10 00:00:00.000,ATP World Tour Masters 1000 Monte Carlo Monaco ATP World Tour Masters 1000,CLAY,2,Andy Murray,Frederico Gil,Andy Murray,6-2; 6-1,Q,72,6,1,22,44,19,22,13,22,3,3,7,32,44,3,0,33,48,16,33,5,15,2,7,8,21,48
2011-04-10 00:00:00.000,ATP World Tour Masters 1000 Monte Carlo Monaco ATP World Tour Masters 1000,CLAY,2,David Ferrer,Viktor Troicki,David Ferrer,6-3; 6-3,Q,84,1,5,27,47,19,27,10,20,0,3,9,29,47,1,5,31,61,15,31,9,30,3,9,9,24,61
2011-04-10 00:00:00.000,ATP World Tour Masters 1000 Monte Carlo Monaco ATP World Tour Masters 1000,CLAY,2,Jurgen Melzer,Roger Federer,Jurgen Melzer,6-4; 6-4,Q,104,2,2,37,74,25,37,25,37,7,7,10,50,74,2,0,44,66,29,44,11,22,3,5,10,40,66
2011-04-10 00:00:00.000,ATP World Tour Masters 1000 Monte Carlo Monaco ATP World Tour Masters 1000,CLAY,2,Rafael Nadal,Andy Murray,Rafael Nadal,6-4; 2-6; 6-1,S,179,3,2,56,82,33,56,11,26,6,12,13,44,82,2,1,57,105,31,57,18,48,12,19,12,49,105
2011-04-10 00:00:00.000,ATP World Tour Masters 1000 Monte Carlo Monaco ATP World Tour Masters 1000,CLAY,2,David Ferrer,Jurgen Melzer,David Ferrer,6-3; 6-2,S,79,2,4,41,69,32,41,11,28,8,9,9,43,69,2,4,20,41,12,20,8,21,0,4,8,20,41
2011-04-10 00:00:00.000,ATP World Tour Masters 1000 Monte Carlo Monaco ATP World Tour Masters 1000,CLAY,2,Rafael Nadal,David Ferrer,Rafael Nadal,6-4; 7-5,F,137,0,3,51,83,33,51,18,32,5,7,11,51,83,0,2,36,70,25,36,15,34,7,11,11,40,70
2011-04-18 00:00:00.000,Barcelona Spain ATP World Tour 500,CLAY,2,Rafael Nadal,N/A Bye,Rafael Nadal,,R64,0,0,0,0,0,0,0,0,0,0,0,0,0,0,0,0,0,0,0,0,0,0,0,0,0,0,0
2011-04-18 00:00:00.000,Barcelona Spain ATP World Tour 500,CLAY,2,Daniel Gimeno-Traver,Potito Starace,Daniel Gimeno-Traver,4-6; 6-1; 2-0 RET,R64,72,6,0,30,57,25,30,15,27,2,3,10,40,57,1,1,42,48,24,42,4,6,3,6,9,28,48
2011-04-18 00:00:00.000,Barcelona Spain ATP World Tour 500,CLAY,2,Albert Ramos,Ruben Ramirez Hidalgo,Albert Ramos,4-6; 7-6(5); 7-5,R64,192,5,3,61,102,43,61,18,41,7,13,17,61,102,1,0,80,127,49,80,20,47,12,18,17,69,127
2011-04-18 00:00:00.000,Barcelona Spain ATP World Tour 500,CLAY,2,Santiago Giraldo,Thomaz Bellucci,Santiago Giraldo,7-5; 6-3,R64,106,3,1,58,91,39,58,12,33,7,10,11,51,91,2,1,34,59,21,34,10,25,3,8,10,31,59
2011-04-18 00:00:00.000,Barcelona Spain ATP World Tour 500,CLAY,2,Richard Gasquet,Juan Ignacio Chela,Richard Gasquet,2-6; 7-6(2); 6-4,R64,153,1,6,67,106,45,67,17,39,6,11,15,62,106,3,1,77,104,48,77,13,27,5,9,15,61,104
2011-04-18 00:00:00.000,Barcelona Spain ATP World Tour 500,CLAY,2,Blaz Kavcic,Tobias Kamke,Blaz Kavcic,6-2; 6-3,R64,84,3,1,42,53,30,42,6,11,3,4,8,36,53,1,0,40,60,20,40,9,20,1,6,9,29,60
2011-04-18 00:00:00.000,Barcelona Spain ATP World Tour 500,CLAY,2,Robin Haase,Flavio Cipolla,Robin Haase,6-4; 6-3,R64,90,2,2,38,66,23,38,17,28,8,10,10,40,66,1,1,42,63,22,42,9,21,4,8,9,31,63
2011-04-18 00:00:00.000,Barcelona Spain ATP World Tour 500,CLAY,2,Gael Monfils,N/A Bye,Gael Monfils,,R64,0,0,0,0,0,0,0,0,0,0,0,0,0,0,0,0,0,0,0,0,0,0,0,0,0,0,0
2011-04-18 00:00:00.000,Barcelona Spain ATP World Tour 500,CLAY,2,Robin Soderling,N/A Bye,Robin Soderling,,R64,0,0,0,0,0,0,0,0,0,0,0,0,0,0,0,0,0,0,0,0,0,0,0,0,0,0,0
2011-04-18 00:00:00.000,Barcelona Spain ATP World Tour 500,CLAY,2,Ivan Dodig,Vincent Millot,Ivan Dodig,6-2; 6-3,R64,85,2,0,38,64,23,38,15,26,5,7,9,38,64,1,1,35,54,14,35,10,19,4,9,8,24,54
2011-04-18 00:00:00.000,Barcelona Spain ATP World Tour 500,CLAY,2,Simon Greul,Robert Kendrick,Simon Greul,6-4; 6-4,R64,73,1,2,36,63,29,36,14,27,2,3,10,43,63,2,1,36,56,25,36,8,20,0,3,10,33,56
2011-04-18 00:00:00.000,Barcelona Spain ATP World Tour 500,CLAY,2,Milos Raonic,Radek Stepanek,Milos Raonic,6-4; 6-2,R64,73,7,1,28,49,25,28,11,21,0,0,9,36,49,2,2,35,56,23,35,10,21,4,7,9,33,56
2011-04-18 00:00:00.000,Barcelona Spain ATP World Tour 500,CLAY,2,Guillermo Garcia-Lopez,Denis Istomin,Guillermo Garcia-Lopez,7-6(6); 6-3,R64,94,1,5,42,63,29,42,8,21,3,7,11,37,63,1,1,48,64,27,48,4,16,3,8,10,31,64
2011-04-18 00:00:00.000,Barcelona Spain ATP World Tour 500,CLAY,2,Feliciano Lopez,Mikhail Kukushkin,Feliciano Lopez,6-2; 6-7(7); 6-4,R64,148,16,2,51,90,43,51,20,39,4,6,15,63,90,5,2,68,121,44,68,26,53,14,19,15,70,121
2011-04-18 00:00:00.000,Barcelona Spain ATP World Tour 500,CLAY,2,Kei Nishikori,Pere Riba,Kei Nishikori,6-2 RET,R64,37,0,1,13,23,9,13,7,10,2,3,4,16,23,0,1,13,26,6,13,4,13,1,4,4,10,26
2011-04-18 00:00:00.000,Barcelona Spain ATP World Tour 500,CLAY,2,Rui Machado,N/A Bye,Rui Machado,,R64,0,0,0,0,0,0,0,0,0,0,0,0,0,0,0,0,0,0,0,0,0,0,0,0,0,0,0
2011-04-18 00:00:00.000,Barcelona Spain ATP World Tour 500,CLAY,2,Jurgen Melzer,N/A Bye,Jurgen Melzer,,R64,0,0,0,0,0,0,0,0,0,0,0,0,0,0,0,0,0,0,0,0,0,0,0,0,0,0,0
2011-04-18 00:00:00.000,Barcelona Spain ATP World Tour 500,CLAY,2,Marcel Granollers,Daniel Brands,Marcel Granollers,7-5; 6-7(5); 6-1,R64,168,2,4,76,114,54,76,18,38,7,10,16,72,114,1,3,88,114,51,88,12,26,6,12,15,63,114
2011-04-18 00:00:00.000,Barcelona Spain ATP World Tour 500,CLAY,2,Benoit Paire,Pablo Carreno Busta,Benoit Paire,6-7(7); 6-3; 6-2,R64,129,5,4,49,106,38,49,28,57,3,6,14,66,106,2,3,60,100,38,60,17,40,4,11,15,55,100
2011-04-18 00:00:00.000,Barcelona Spain ATP World Tour 500,CLAY,2,Albert Montanes,Teymuraz Gabashvili,Albert Montanes,6-2; 6-2,R64,107,4,2,45,72,32,45,13,27,9,10,8,45,72,0,2,44,66,22,44,10,22,6,11,8,32,66
2011-04-18 00:00:00.000,Barcelona Spain ATP World Tour 500,CLAY,2,Kevin Anderson,Pablo Cuevas,Kevin Anderson,7-5; 3-6; 6-4,R64,140,6,2,68,91,51,68,13,23,6,8,16,64,91,5,1,68,103,47,68,19,35,8,10,15,66,103
2011-04-18 00:00:00.000,Barcelona Spain ATP World Tour 500,CLAY,2,Victor Hanescu,Andrey Golubev,Victor Hanescu,6-3; 6-2,R64,85,0,1,38,53,29,38,6,15,0,1,9,35,53,4,3,29,57,17,29,13,28,6,10,8,30,57
2011-04-18 00:00:00.000,Barcelona Spain ATP World Tour 500,CLAY,2,Carlos Berlocq,Jarkko Nieminen,Carlos Berlocq,6-4; 4-6; 6-2,R64,144,3,4,66,100,43,66,17,34,11,15,14,60,100,2,3,66,103,44,66,11,37,11,17,14,55,103
2011-04-18 00:00:00.000,Barcelona Spain ATP World Tour 500,CLAY,2,David Ferrer,N/A Bye,David Ferrer,,R64,0,0,0,0,0,0,0,0,0,0,0,0,0,0,0,0,0,0,0,0,0,0,0,0,0,0,0
2011-04-18 00:00:00.000,Barcelona Spain ATP World Tour 500,CLAY,2,Nicolas Almagro,N/A Bye,Nicolas Almagro,,R64,0,0,0,0,0,0,0,0,0,0,0,0,0,0,0,0,0,0,0,0,0,0,0,0,0,0,0
2011-04-18 00:00:00.000,Barcelona Spain ATP World Tour 500,CLAY,2,Pablo Andujar,Gerard Granollers,Pablo Andujar,6-0; 6-1,R64,58,5,2,28,44,25,28,7,16,0,0,7,32,44,1,1,30,41,13,30,3,11,3,8,6,16,41
2011-04-18 00:00:00.000,Barcelona Spain ATP World Tour 500,CLAY,2,Edouard Roger-Vasselin,Andrey Kuznetsov,Edouard Roger-Vasselin,6-2; 6-4,R64,77,1,0,31,47,22,31,11,16,1,2,9,33,47,0,2,34,68,20,34,16,34,4,8,9,36,68
2011-04-18 00:00:00.000,Barcelona Spain ATP World Tour 500,CLAY,2,Nikolay Davydenko,Alexandr Dolgopolov,Nikolay Davydenko,6-4; 7-6(6),R64,100,2,5,65,85,43,65,9,20,7,9,11,52,85,4,2,46,82,32,46,15,36,0,3,11,47,82
2011-04-18 00:00:00.000,Barcelona Spain ATP World Tour 500,CLAY,2,Juan Monaco,Grigor Dimitrov,Juan Monaco,6-4; 6-1,R64,78,1,1,40,56,26,40,9,16,7,8,8,35,56,0,2,28,47,17,28,6,19,0,5,9,23,47
2011-04-18 00:00:00.000,Barcelona Spain ATP World Tour 500,CLAY,2,Simone Vagnozzi,Fabio Fognini,Simone Vagnozzi,2-6; 4-2 RET,R64,62,0,2,26,41,19,26,3,15,3,7,7,22,41,3,0,30,50,18,30,7,20,3,6,7,25,50
2011-04-18 00:00:00.000,Barcelona Spain ATP World Tour 500,CLAY,2,Juan Carlos Ferrero,Xavier Malisse,Juan Carlos Ferrero,6-4; 6-2,R64,81,2,0,51,66,33,51,9,15,3,4,9,42,66,1,2,32,58,22,32,11,26,5,9,9,33,58
2011-04-18 00:00:00.000,Barcelona Spain ATP World Tour 500,CLAY,2,Mischa Zverev,N/A Bye,Mischa Zverev,,R64,0,0,0,0,0,0,0,0,0,0,0,0,0,0,0,0,0,0,0,0,0,0,0,0,0,0,0
2011-04-18 00:00:00.000,Barcelona Spain ATP World Tour 500,CLAY,2,Rafael Nadal,Daniel Gimeno-Traver,Rafael Nadal,6-1; 6-1,R32,66,2,0,24,39,20,24,9,15,0,0,7,29,39,4,1,25,43,16,25,2,18,4,9,7,18,43
2011-04-18 00:00:00.000,Barcelona Spain ATP World Tour 500,CLAY,2,Santiago Giraldo,Albert Ramos,Santiago Giraldo,6-3; 4-6; 6-3,R32,142,9,3,71,111,47,71,18,40,7,10,14,65,111,3,2,72,91,40,72,11,19,5,10,14,51,91
2011-04-18 00:00:00.000,Barcelona Spain ATP World Tour 500,CLAY,2,Richard Gasquet,Blaz Kavcic,Richard Gasquet,6-3; 4-6; 6-2,R32,118,1,0,50,73,38,50,15,23,4,7,14,53,73,4,2,69,89,38,69,13,20,5,10,13,51,89
2011-04-18 00:00:00.000,Barcelona Spain ATP World Tour 500,CLAY,2,Gael Monfils,Robin Haase,Gael Monfils,3-6; 7-6(3); 6-2,R32,124,4,4,53,91,30,53,21,38,4,9,15,51,91,3,0,77,94,43,77,9,17,9,14,14,52,94
2011-04-18 00:00:00.000,Barcelona Spain ATP World Tour 500,CLAY,2,Ivan Dodig,Robin Soderling,Ivan Dodig,6-2; 6-4,R32,83,9,1,39,63,27,39,12,24,7,9,9,39,63,0,4,30,50,15,30,10,20,2,7,9,25,50
2011-04-18 00:00:00.000,Barcelona Spain ATP World Tour 500,CLAY,2,Milos Raonic,Simon Greul,Milos Raonic,6-3; 4-6; 7-6(5),R32,140,10,2,59,91,49,59,12,32,7,9,15,61,91,6,2,79,111,51,79,19,32,8,11,16,70,111
2011-04-18 00:00:00.000,Barcelona Spain ATP World Tour 500,CLAY,2,Feliciano Lopez,Guillermo Garcia-Lopez,Feliciano Lopez,6-7(2); 6-3; 6-4,R32,125,13,3,55,94,39,55,25,39,2,3,16,64,94,4,1,54,84,40,54,19,30,1,4,15,59,84
2011-04-18 00:00:00.000,Barcelona Spain ATP World Tour 500,CLAY,2,Kei Nishikori,Rui Machado,Kei Nishikori,6-1; 6-4,R32,180,1,2,33,49,28,33,9,16,2,2,9,37,49,0,1,37,56,24,37,7,19,1,4,8,31,56
2011-04-18 00:00:00.000,Barcelona Spain ATP World Tour 500,CLAY,2,Jurgen Melzer,Marcel Granollers,Jurgen Melzer,6-1; 6-3,R32,83,2,3,37,59,25,37,11,22,2,3,8,36,59,2,4,29,51,13,29,8,22,4,9,8,21,51
2011-04-18 00:00:00.000,Barcelona Spain ATP World Tour 500,CLAY,2,Albert Montanes,Benoit Paire,Albert Montanes,6-7(3); 6-1; 6-4,R32,122,1,3,80,105,54,80,13,25,7,9,15,67,105,5,3,57,95,35,57,19,38,6,11,14,54,95
2011-04-18 00:00:00.000,Barcelona Spain ATP World Tour 500,CLAY,2,Victor Hanescu,Kevin Anderson,Victor Hanescu,6-4; 6-4,R32,90,4,0,35,47,31,35,9,12,0,0,10,40,47,6,2,57,82,37,57,12,25,10,12,10,49,82
2011-04-18 00:00:00.000,Barcelona Spain ATP World Tour 500,CLAY,2,David Ferrer,Carlos Berlocq,David Ferrer,6-2; 6-2,R32,91,1,1,38,58,26,38,14,20,4,4,8,40,58,1,5,37,65,25,37,8,28,3,7,8,33,65
2011-04-18 00:00:00.000,Barcelona Spain ATP World Tour 500,CLAY,2,Nicolas Almagro,Pablo Andujar,Nicolas Almagro,7-5; 7-6(1),R32,117,8,2,36,78,26,36,25,42,5,8,12,51,78,0,2,45,79,28,45,17,34,3,7,12,45,79
2011-04-18 00:00:00.000,Barcelona Spain ATP World Tour 500,CLAY,2,Nikolay Davydenko,Edouard Roger-Vasselin,Nikolay Davydenko,6-2; 7-6(11),R32,108,0,1,60,77,37,60,9,17,6,9,10,46,77,2,1,55,82,27,55,13,27,7,12,10,40,82
2011-04-18 00:00:00.000,Barcelona Spain ATP World Tour 500,CLAY,2,Simone Vagnozzi,Juan Monaco,Simone Vagnozzi,6-3; 6-2,R32,83,0,1,30,47,18,30,14,17,4,5,8,32,47,0,3,53,67,30,53,4,14,6,11,9,34,67
2011-04-18 00:00:00.000,Barcelona Spain ATP World Tour 500,CLAY,2,Juan Carlos Ferrero,Mischa Zverev,Juan Carlos Ferrero,6-4; 7-5,R32,100,3,1,53,72,35,53,11,19,2,4,11,46,72,0,0,39,62,22,39,13,23,4,8,11,35,62
2011-04-18 00:00:00.000,Barcelona Spain ATP World Tour 500,CLAY,2,Rafael Nadal,Santiago Giraldo,Rafael Nadal,6-3; 6-1,R16,83,1,2,34,53,24,34,10,19,2,3,8,34,53,2,2,33,54,16,33,9,21,6,11,8,25,54
2011-04-18 00:00:00.000,Barcelona Spain ATP World Tour 500,CLAY,2,Gael Monfils,Richard Gasquet,Gael Monfils,6-4; 7-6(7),R16,97,0,3,68,78,44,68,5,10,3,5,11,49,78,1,2,56,76,36,56,10,20,4,7,11,46,76
2011-04-18 00:00:00.000,Barcelona Spain ATP World Tour 500,CLAY,2,Ivan Dodig,Milos Raonic,Ivan Dodig,7-6(0); 4-6; 6-3,R16,150,9,3,82,114,57,82,15,32,8,11,16,72,114,5,0,69,102,50,69,12,33,5,8,15,62,102
2011-04-18 00:00:00.000,Barcelona Spain ATP World Tour 500,CLAY,2,Feliciano Lopez,Kei Nishikori,Feliciano Lopez,6-4; 7-6(5),R16,106,4,2,44,80,32,44,21,36,3,4,11,53,80,0,2,52,75,31,52,18,23,6,8,11,49,75
2011-04-18 00:00:00.000,Barcelona Spain ATP World Tour 500,CLAY,2,Jurgen Melzer,Albert Montanes,Jurgen Melzer,6-7(2); 6-3; 6-2,R16,124,7,2,77,111,52,77,17,34,13,15,15,69,111,6,2,54,85,33,54,19,31,4,9,14,52,85
2011-04-18 00:00:00.000,Barcelona Spain ATP World Tour 500,CLAY,2,David Ferrer,Victor Hanescu,David Ferrer,6-3; 6-2,R16,65,1,0,26,45,26,26,10,19,0,0,9,36,45,0,0,35,49,20,35,9,14,3,6,8,29,49
2011-04-18 00:00:00.000,Barcelona Spain ATP World Tour 500,CLAY,2,Nicolas Almagro,Nikolay Davydenko,Nicolas Almagro,7-6(2); 6-3,R16,98,6,1,48,77,29,48,21,29,4,6,11,50,77,1,1,43,64,26,43,10,21,3,6,10,36,64
2011-04-18 00:00:00.000,Barcelona Spain ATP World Tour 500,CLAY,2,Juan Carlos Ferrero,Simone Vagnozzi,Juan Carlos Ferrero,7-6(3); 4-6; 6-4,R16,163,1,0,83,114,46,83,16,31,13,20,16,62,114,0,1,84,109,42,84,16,25,7,14,16,58,109
2011-04-18 00:00:00.000,Barcelona Spain ATP World Tour 500,CLAY,2,Rafael Nadal,Gael Monfils,Rafael Nadal,6-2; 6-2,Q,75,1,1,23,40,18,23,14,17,0,0,8,32,40,0,0,52,62,29,52,3,10,5,9,8,32,62
2011-04-18 00:00:00.000,Barcelona Spain ATP World Tour 500,CLAY,2,Ivan Dodig,Feliciano Lopez,Ivan Dodig,6-4; 2-6; 6-4,Q,116,6,0,49,74,36,49,16,25,1,3,14,52,74,11,0,57,91,39,57,20,34,7,9,14,59,91
2011-04-18 00:00:00.000,Barcelona Spain ATP World Tour 500,CLAY,2,David Ferrer,Jurgen Melzer,David Ferrer,6-3; 6-3,Q,87,0,3,40,61,32,40,8,21,4,5,9,40,61,1,2,36,58,21,36,9,22,5,9,9,30,58
2011-04-18 00:00:00.000,Barcelona Spain ATP World Tour 500,CLAY,2,Nicolas Almagro,Juan Carlos Ferrero,Nicolas Almagro,6-3; 6-3,Q,65,6,1,22,47,17,22,14,25,3,5,9,31,47,2,1,42,62,21,42,9,20,11,16,9,30,62
2011-04-18 00:00:00.000,Barcelona Spain ATP World Tour 500,CLAY,2,Rafael Nadal,Ivan Dodig,Rafael Nadal,6-3; 6-2,S,88,1,0,35,49,24,35,7,14,2,4,8,31,49,2,2,23,48,12,23,7,25,2,8,9,19,48
2011-04-18 00:00:00.000,Barcelona Spain ATP World Tour 500,CLAY,2,David Ferrer,Nicolas Almagro,David Ferrer,6-3; 6-4,S,97,3,1,43,65,31,43,11,22,3,4,10,42,65,5,1,36,69,23,36,15,33,9,12,9,38,69
2011-04-18 00:00:00.000,Barcelona Spain ATP World Tour 500,CLAY,2,Rafael Nadal,David Ferrer,Rafael Nadal,6-2; 6-4,F,109,0,1,41,61,23,41,10,20,5,8,9,33,61,2,1,48,69,24,48,6,21,10,16,9,30,69
2011-04-24 00:00:00.000,Munich Germany ATP World Tour 250,CLAY,2,Mikhail Youzhny,Matthias Bachinger,Mikhail Youzhny,7-5; 6-2,R32,98,3,1,42,66,28,42,17,24,6,7,10,45,66,2,2,37,63,20,37,15,26,2,6,10,35,63
2011-04-24 00:00:00.000,Munich Germany ATP World Tour 250,CLAY,2,Philipp Petzschner,Ivan Dodig,Philipp Petzschner,6-1; 6-4,R32,69,3,2,22,49,18,22,17,27,1,2,9,35,49,0,0,30,45,17,30,6,15,1,5,8,23,45
2011-04-24 00:00:00.000,Munich Germany ATP World Tour 250,CLAY,2,Potito Starace,Jan Hajek,Potito Starace,3-6; 6-4; 6-0,R32,103,4,1,58,81,38,58,11,23,7,10,12,49,81,2,3,55,89,36,55,9,34,9,15,13,45,89
2011-04-24 00:00:00.000,Munich Germany ATP World Tour 250,CLAY,2,Sergiy Stakhovsky,Denis Istomin,Sergiy Stakhovsky,5-1 RET,R32,22,2,0,8,13,8,8,4,5,0,0,3,12,13,1,0,14,21,6,14,3,7,1,3,3,9,21
2011-04-24 00:00:00.000,Munich Germany ATP World Tour 250,CLAY,2,Marcos Baghdatis,Julien Benneteau,Marcos Baghdatis,7-6(2); 6-3,R32,101,12,0,34,59,27,34,16,25,1,2,10,43,59,4,3,56,84,35,56,14,28,6,9,11,49,84
2011-04-24 00:00:00.000,Munich Germany ATP World Tour 250,CLAY,2,Grigor Dimitrov,Andreas Beck,Grigor Dimitrov,6-1; 6-4,R32,64,7,1,32,45,27,32,9,13,0,0,9,36,45,1,0,30,47,18,30,8,17,5,8,8,26,47
2011-04-24 00:00:00.000,Munich Germany ATP World Tour 250,CLAY,2,Teymuraz Gabashvili,Rainer Schuettler,Teymuraz Gabashvili,3-6; 6-4; 6-3,R32,123,0,2,68,92,44,68,15,24,9,11,14,59,92,4,1,66,88,43,66,12,22,9,12,14,55,88
2011-04-24 00:00:00.000,Munich Germany ATP World Tour 250,CLAY,2,Florian Mayer,Steve Darcis,Florian Mayer,6-1; 6-2,R32,60,1,0,24,44,18,24,9,20,2,4,7,27,44,0,0,34,50,11,34,4,16,3,10,8,15,50
2011-04-24 00:00:00.000,Munich Germany ATP World Tour 250,CLAY,2,Nikolay Davydenko,Andrey Kuznetsov,Nikolay Davydenko,6-1; 7-6(4),R32,89,4,1,45,67,34,45,13,22,4,5,10,47,67,1,1,46,73,29,46,11,27,5,8,9,40,73
2011-04-24 00:00:00.000,Munich Germany ATP World Tour 250,CLAY,2,Julian Reister,Daniel Brands,Julian Reister,7-6(1); 6-1,R32,87,4,0,48,56,38,48,4,8,1,1,9,42,56,8,1,61,85,37,61,10,24,7,10,10,47,85
2011-04-24 00:00:00.000,Munich Germany ATP World Tour 250,CLAY,2,Horacio Zeballos,Robert Kendrick,Horacio Zeballos,6-4; 6-4,R32,73,13,2,40,50,35,40,7,10,0,0,10,42,50,4,1,44,74,30,44,14,30,8,10,10,44,74
2011-04-24 00:00:00.000,Munich Germany ATP World Tour 250,CLAY,2,Marin Cilic,Simone Bolelli,Marin Cilic,7-5; 7-6(4),R32,123,11,4,50,90,39,50,21,40,8,9,12,60,90,0,0,57,75,39,57,10,18,1,3,12,49,75
2011-04-24 00:00:00.000,Munich Germany ATP World Tour 250,CLAY,2,Philipp Kohlschreiber,Robert Farah,Philipp Kohlschreiber,6-3; 6-1,R32,68,3,0,24,41,18,24,11,17,3,5,8,29,41,3,2,34,51,16,34,6,17,5,11,8,22,51
2011-04-24 00:00:00.000,Munich Germany ATP World Tour 250,CLAY,2,Denis Gremelmayr,Robin Haase,Denis Gremelmayr,6-4; 4-6; 6-4,R32,125,3,3,61,97,35,61,19,36,5,10,15,54,97,6,2,63,99,37,63,17,36,5,11,15,54,99
2011-04-24 00:00:00.000,Munich Germany ATP World Tour 250,CLAY,2,Radek Stepanek,Andrey Golubev,Radek Stepanek,6-1; 4-6; 6-3,R32,107,4,3,60,82,37,60,12,22,3,6,13,49,82,5,6,51,82,32,51,11,31,3,9,13,43,82
2011-04-24 00:00:00.000,Munich Germany ATP World Tour 250,CLAY,2,Dustin Brown,Stanislas Wawrinka,Dustin Brown,6-7(6); 6-4; 7-5,R32,134,10,2,60,108,48,60,27,48,4,6,17,75,108,4,1,78,114,58,78,16,36,2,6,17,74,114
2011-04-24 00:00:00.000,Munich Germany ATP World Tour 250,CLAY,2,Philipp Petzschner,Mikhail Youzhny,Philipp Petzschner,7-6(5); 3-6; 6-2,R16,136,3,2,54,79,44,54,12,25,0,2,14,56,79,0,1,59,89,39,59,18,30,0,3,15,57,89
2011-04-24 00:00:00.000,Munich Germany ATP World Tour 250,CLAY,2,Potito Starace,Sergiy Stakhovsky,Potito Starace,6-4; 6-2,R16,73,2,1,44,51,33,44,6,7,3,3,9,39,51,2,2,35,59,24,35,10,24,7,10,9,34,59
2011-04-24 00:00:00.000,Munich Germany ATP World Tour 250,CLAY,2,Grigor Dimitrov,Marcos Baghdatis,Grigor Dimitrov,3-6; 7-6(6); 6-2,R16,131,8,1,59,93,42,59,22,34,3,4,14,64,93,8,2,39,84,32,39,27,45,0,2,15,59,84
2011-04-24 00:00:00.000,Munich Germany ATP World Tour 250,CLAY,2,Florian Mayer,Teymuraz Gabashvili,Florian Mayer,6-4; 7-6(1),R16,110,2,3,47,84,35,47,21,37,4,5,11,56,84,2,2,57,79,35,57,12,22,3,5,11,47,79
2011-04-24 00:00:00.000,Munich Germany ATP World Tour 250,CLAY,2,Nikolay Davydenko,Julian Reister,Nikolay Davydenko,3-6; 7-6(5); 6-1,R16,147,1,3,94,115,60,94,9,21,11,15,15,69,115,2,1,63,94,40,63,14,31,5,9,13,54,94
2011-04-24 00:00:00.000,Munich Germany ATP World Tour 250,CLAY,2,Marin Cilic,Horacio Zeballos,Marin Cilic,6-3; 7-6(7),R16,111,8,0,36,64,29,36,17,28,0,1,10,46,64,5,4,62,93,43,62,12,31,4,7,11,55,93
2011-04-24 00:00:00.000,Munich Germany ATP World Tour 250,CLAY,2,Philipp Kohlschreiber,Denis Gremelmayr,Philipp Kohlschreiber,6-3; 6-3,R16,69,2,1,39,58,32,39,9,19,4,4,9,41,58,8,0,31,51,22,31,10,20,3,6,9,32,51
2011-04-24 00:00:00.000,Munich Germany ATP World Tour 250,CLAY,2,Radek Stepanek,Dustin Brown,Radek Stepanek,7-6(6); 6-7(5); 6-3,R16,170,1,6,81,130,50,81,27,49,9,13,17,77,130,16,4,83,137,55,83,24,54,14,19,16,79,137
2011-04-24 00:00:00.000,Munich Germany ATP World Tour 250,CLAY,2,Philipp Petzschner,Potito Starace,Philipp Petzschner,7-6(3); 7-6(6),Q,107,7,1,54,76,45,54,14,22,2,2,12,59,76,1,1,70,89,50,70,9,19,2,2,12,59,89
2011-04-24 00:00:00.000,Munich Germany ATP World Tour 250,CLAY,2,Florian Mayer,Grigor Dimitrov,Florian Mayer,7-6(4); 3-6; 6-4,Q,143,3,3,76,118,50,76,24,42,9,12,16,74,118,8,4,61,92,45,61,19,31,4,6,15,64,92
2011-04-24 00:00:00.000,Munich Germany ATP World Tour 250,CLAY,2,Nikolay Davydenko,Marin Cilic,Nikolay Davydenko,7-5; 6-3,Q,109,3,2,54,77,38,54,12,23,6,7,11,50,77,6,3,36,66,25,36,14,30,4,7,10,39,66
2011-04-24 00:00:00.000,Munich Germany ATP World Tour 250,CLAY,2,Radek Stepanek,Philipp Kohlschreiber,Radek Stepanek,6-4; 6-0,Q,74,3,2,26,55,18,26,17,29,4,5,8,35,55,3,0,34,49,20,34,4,15,2,7,8,24,49
2011-04-24 00:00:00.000,Munich Germany ATP World Tour 250,CLAY,2,Florian Mayer,Philipp Petzschner,Florian Mayer,6-3; 6-4,S,73,6,1,38,58,30,38,10,20,5,6,10,40,58,2,0,41,60,27,41,9,19,5,8,9,36,60
2011-04-24 00:00:00.000,Munich Germany ATP World Tour 250,CLAY,2,Nikolay Davydenko,Radek Stepanek,Nikolay Davydenko,6-3; 4-0 RET,S,72,2,0,34,45,25,34,7,11,2,2,7,32,45,1,1,30,54,18,30,8,24,8,11,6,26,54
2011-04-24 00:00:00.000,Munich Germany ATP World Tour 250,CLAY,2,Nikolay Davydenko,Florian Mayer,Nikolay Davydenko,6-3; 3-6; 6-1,F,109,7,2,63,89,45,63,14,26,5,6,13,59,89,4,1,51,85,34,51,16,34,5,8,12,50,85
2011-04-25 00:00:00.000,Belgrade Serbia ATP World Tour 250,CLAY,2,Novak Djokovic,N/A Bye,Novak Djokovic,,R32,0,0,0,0,0,0,0,0,0,0,0,0,0,0,0,0,0,0,0,0,0,0,0,0,0,0,0
2011-04-25 00:00:00.000,Belgrade Serbia ATP World Tour 250,CLAY,2,Adrian Ungur,Ruben Ramirez Hidalgo,Adrian Ungur,6-7(2); 6-3; 6-4,R32,168,5,3,73,106,47,73,21,33,4,7,16,68,106,3,5,78,112,51,78,12,34,4,9,15,63,112
2011-04-25 00:00:00.000,Belgrade Serbia ATP World Tour 250,CLAY,2,Blaz Kavcic,Tobias Kamke,Blaz Kavcic,7-6(0); 6-1,R32,108,3,5,49,76,36,49,13,27,5,7,10,49,76,1,3,47,78,25,47,14,31,8,12,9,39,78
2011-04-25 00:00:00.000,Belgrade Serbia ATP World Tour 250,CLAY,2,Ricardo Mello,John Isner,Ricardo Mello,6-4; 7-6(4),R32,75,2,2,47,63,40,47,10,16,4,5,11,50,63,18,5,55,75,37,55,10,20,3,5,11,47,75
2011-04-25 00:00:00.000,Belgrade Serbia ATP World Tour 250,CLAY,2,Guillermo Garcia-Lopez,N/A Bye,Guillermo Garcia-Lopez,,R32,0,0,0,0,0,0,0,0,0,0,0,0,0,0,0,0,0,0,0,0,0,0,0,0,0,0,0
2011-04-25 00:00:00.000,Belgrade Serbia ATP World Tour 250,CLAY,2,Somdev Devvarman,Mikhail Kukushkin,Somdev Devvarman,1-6; 6-4; 6-2,R32,134,2,2,57,94,33,57,18,37,8,13,12,51,94,0,3,44,90,26,44,20,46,8,14,13,46,90
2011-04-25 00:00:00.000,Belgrade Serbia ATP World Tour 250,CLAY,2,Mischa Zverev,Dudi Sela,Mischa Zverev,7-6(4); 3-6; 6-3,R32,165,0,2,90,135,52,90,22,45,14,19,15,74,135,2,2,56,104,37,56,24,48,4,9,15,61,104
2011-04-25 00:00:00.000,Belgrade Serbia ATP World Tour 250,CLAY,2,Janko Tipsarevic,Kei Nishikori,Janko Tipsarevic,2-6; 6-2; 7-6(0),R32,138,6,3,52,93,35,52,24,41,5,8,14,59,93,1,6,54,92,39,54,16,38,7,10,14,55,92
2011-04-25 00:00:00.000,Belgrade Serbia ATP World Tour 250,CLAY,2,Feliciano Lopez,Juan Monaco,Feliciano Lopez,6-4; 7-5,R32,99,4,1,36,66,26,36,19,30,0,1,11,45,66,2,4,34,58,24,34,12,24,1,4,11,36,58
2011-04-25 00:00:00.000,Belgrade Serbia ATP World Tour 250,CLAY,2,Fernando Gonzalez,Martin Klizan,Fernando Gonzalez,6-2; 6-4,R32,76,4,2,26,57,19,26,15,31,6,9,9,34,57,2,6,32,55,16,32,8,23,5,11,9,24,55
2011-04-25 00:00:00.000,Belgrade Serbia ATP World Tour 250,CLAY,2,Michael Berrer,Alexander Peya,Michael Berrer,4-6; 6-3; 6-4,R32,146,1,5,59,90,43,59,15,31,7,10,14,58,90,1,6,92,120,58,92,11,28,10,15,15,69,120
2011-04-25 00:00:00.000,Belgrade Serbia ATP World Tour 250,CLAY,2,Albert Montanes,N/A Bye,Albert Montanes,,R32,0,0,0,0,0,0,0,0,0,0,0,0,0,0,0,0,0,0,0,0,0,0,0,0,0,0,0
2011-04-25 00:00:00.000,Belgrade Serbia ATP World Tour 250,CLAY,2,Illya Marchenko,Ernests Gulbis,Illya Marchenko,6-2; 6-4,R32,76,2,3,34,55,26,34,12,21,3,4,9,38,55,1,4,25,49,16,25,10,24,1,5,9,26,49
2011-04-25 00:00:00.000,Belgrade Serbia ATP World Tour 250,CLAY,2,Filippo Volandri,Dusan Lajovic,Filippo Volandri,6-1; 6-4,R32,93,1,5,61,85,33,61,12,24,15,18,8,45,85,1,4,25,54,13,25,8,29,4,11,9,21,54
2011-04-25 00:00:00.000,Belgrade Serbia ATP World Tour 250,CLAY,2,Marcel Granollers,Franko Skugor,Marcel Granollers,7-5; 6-1,R32,90,1,3,45,60,29,45,8,15,3,5,9,37,60,1,3,32,65,11,32,16,33,6,12,10,27,65
2011-04-25 00:00:00.000,Belgrade Serbia ATP World Tour 250,CLAY,2,Viktor Troicki,N/A Bye,Viktor Troicki,,R32,0,0,0,0,0,0,0,0,0,0,0,0,0,0,0,0,0,0,0,0,0,0,0,0,0,0,0
2011-04-25 00:00:00.000,Belgrade Serbia ATP World Tour 250,CLAY,2,Novak Djokovic,Adrian Ungur,Novak Djokovic,6-2; 6-3,R16,68,1,1,33,56,23,33,12,23,4,6,9,35,56,0,4,20,42,11,20,7,22,1,6,8,18,42
2011-04-25 00:00:00.000,Belgrade Serbia ATP World Tour 250,CLAY,2,Blaz Kavcic,Ricardo Mello,Blaz Kavcic,7-5; 6-3,R16,115,1,4,56,87,41,56,9,31,5,8,11,50,87,2,1,47,70,25,47,7,23,6,11,10,32,70
2011-04-25 00:00:00.000,Belgrade Serbia ATP World Tour 250,CLAY,2,Somdev Devvarman,Guillermo Garcia-Lopez,Somdev Devvarman,7-6(6); 2-6; 7-6(8),R16,194,4,1,83,126,55,83,18,43,10,16,16,73,126,4,6,58,110,39,58,30,52,1,5,16,69,110
2011-04-25 00:00:00.000,Belgrade Serbia ATP World Tour 250,CLAY,2,Janko Tipsarevic,Mischa Zverev,Janko Tipsarevic,6-2; 6-0,R16,53,0,1,22,39,17,22,12,17,0,0,7,29,39,1,0,28,38,12,28,3,10,4,9,7,15,38
2011-04-25 00:00:00.000,Belgrade Serbia ATP World Tour 250,CLAY,2,Feliciano Lopez,Fernando Gonzalez,Feliciano Lopez,6-4; 7-6(4),R16,91,6,4,46,77,41,46,13,31,5,6,11,54,77,3,3,36,68,29,36,20,32,3,5,11,49,68
2011-04-25 00:00:00.000,Belgrade Serbia ATP World Tour 250,CLAY,2,Albert Montanes,Michael Berrer,Albert Montanes,3-6; 6-2; 6-2,R16,90,6,0,41,71,29,41,22,30,2,3,12,51,71,1,2,57,79,36,57,10,22,2,6,13,46,79
2011-04-25 00:00:00.000,Belgrade Serbia ATP World Tour 250,CLAY,2,Filippo Volandri,Illya Marchenko,Filippo Volandri,6-3; 1-6; 6-3,R16,138,0,2,44,76,21,44,18,32,7,13,12,39,76,2,5,55,103,30,55,20,48,8,15,13,50,103
2011-04-25 00:00:00.000,Belgrade Serbia ATP World Tour 250,CLAY,2,Marcel Granollers,Viktor Troicki,Marcel Granollers,6-2; 6-3,R16,99,0,1,41,59,24,41,5,18,6,10,8,29,59,0,1,36,65,15,36,10,29,5,13,9,25,65
2011-04-25 00:00:00.000,Belgrade Serbia ATP World Tour 250,CLAY,2,Novak Djokovic,Blaz Kavcic,Novak Djokovic,6-3; 6-2,Q,86,2,3,36,59,26,36,12,23,1,2,9,38,59,0,5,24,47,11,24,13,23,1,5,8,24,47
2011-04-25 00:00:00.000,Belgrade Serbia ATP World Tour 250,CLAY,2,Janko Tipsarevic,Somdev Devvarman,Janko Tipsarevic,6-3; 3-6; 6-4,Q,159,5,4,37,82,27,37,25,45,4,7,14,52,82,2,1,51,96,30,51,24,45,2,6,14,54,96
2011-04-25 00:00:00.000,Belgrade Serbia ATP World Tour 250,CLAY,2,Feliciano Lopez,Albert Montanes,Feliciano Lopez,6-4; 6-4,Q,95,10,3,43,66,32,43,15,23,5,5,10,47,66,4,2,47,84,33,47,17,37,7,9,10,50,84
2011-04-25 00:00:00.000,Belgrade Serbia ATP World Tour 250,CLAY,2,Filippo Volandri,Marcel Granollers,Filippo Volandri,6-2; 6-4,Q,83,0,1,53,66,34,53,10,13,4,4,9,44,66,0,1,30,52,18,30,12,22,2,5,9,30,52
2011-04-25 00:00:00.000,Belgrade Serbia ATP World Tour 250,CLAY,2,Novak Djokovic,Janko Tipsarevic,Novak Djokovic,W/O,S,0,0,0,0,0,0,0,0,0,0,0,0,0,0,0,0,0,0,0,0,0,0,0,0,0,0,0
2011-04-25 00:00:00.000,Belgrade Serbia ATP World Tour 250,CLAY,2,Feliciano Lopez,Filippo Volandri,Feliciano Lopez,7-6(3); 6-2,S,96,5,4,45,75,35,45,12,30,9,11,10,47,75,1,4,38,61,24,38,10,23,0,4,10,34,61
2011-04-25 00:00:00.000,Belgrade Serbia ATP World Tour 250,CLAY,2,Novak Djokovic,Feliciano Lopez,Novak Djokovic,7-6(4); 6-2,F,116,4,6,46,78,37,46,16,32,7,7,10,53,78,6,2,42,67,29,42,13,25,2,4,10,42,67
2011-04-25 00:00:00.000,Estoril Portugal ATP World Tour 250,CLAY,2,Robin Soderling,N/A Bye,Robin Soderling,,R32,0,0,0,0,0,0,0,0,0,0,0,0,0,0,0,0,0,0,0,0,0,0,0,0,0,0,0
2011-04-25 00:00:00.000,Estoril Portugal ATP World Tour 250,CLAY,2,Jeremy Chardy,Adrian Mannarino,Jeremy Chardy,6-4; 6-3,R32,91,8,4,34,63,26,34,11,29,5,7,9,37,63,1,3,47,76,27,47,11,29,12,17,10,38,76
2011-04-25 00:00:00.000,Estoril Portugal ATP World Tour 250,CLAY,2,Alejandro Falla,Pablo Andujar,Alejandro Falla,4-6; 6-1; 4-4 RET,R32,122,2,0,39,65,27,39,22,26,2,4,13,49,65,2,3,46,78,29,46,15,32,5,8,12,44,78
2011-04-25 00:00:00.000,Estoril Portugal ATP World Tour 250,CLAY,2,Juan Martin Del Potro,Pedro Sousa,Juan Martin Del Potro,6-2; 3-6; 6-3,R32,112,4,2,47,74,34,47,14,27,1,3,13,48,74,6,1,51,81,35,51,10,30,3,7,13,45,81
2011-04-25 00:00:00.000,Estoril Portugal ATP World Tour 250,CLAY,2,Jo-Wilfried Tsonga,N/A Bye,Jo-Wilfried Tsonga,,R32,0,0,0,0,0,0,0,0,0,0,0,0,0,0,0,0,0,0,0,0,0,0,0,0,0,0,0
2011-04-25 00:00:00.000,Estoril Portugal ATP World Tour 250,CLAY,2,Pablo Cuevas,Pere Riba,Pablo Cuevas,6-2; 6-4,R32,68,4,1,29,44,27,29,9,15,0,0,9,36,44,2,5,38,69,26,38,12,31,4,7,9,38,69
2011-04-25 00:00:00.000,Estoril Portugal ATP World Tour 250,CLAY,2,Edouard Roger-Vasselin,Marcos Daniel,Edouard Roger-Vasselin,6-3; 6-1,R32,82,3,2,31,48,22,31,9,17,2,4,8,31,48,0,0,46,62,20,46,5,16,4,10,8,25,62
2011-04-25 00:00:00.000,Estoril Portugal ATP World Tour 250,CLAY,2,Thomaz Bellucci,Frederik Nielsen,Thomaz Bellucci,7-5; 6-1,R32,77,4,0,28,51,20,28,16,23,1,2,9,36,51,0,1,49,70,26,49,10,21,8,13,10,36,70
2011-04-25 00:00:00.000,Estoril Portugal ATP World Tour 250,CLAY,2,Milos Raonic,Igor Andreev,Milos Raonic,6-4; 6-4,R32,85,4,5,44,71,33,44,15,27,8,8,10,48,71,4,3,40,56,29,40,6,16,1,3,10,35,56
2011-04-25 00:00:00.000,Estoril Portugal ATP World Tour 250,CLAY,2,Joao Sousa,Gastao Elias,Joao Sousa,7-6(6); 3-6; 5-2 RET,R32,153,5,0,60,92,39,60,15,32,3,7,14,54,92,4,5,53,91,40,53,15,38,4,8,14,55,91
2011-04-25 00:00:00.000,Estoril Portugal ATP World Tour 250,CLAY,2,Carlos Berlocq,Daniel Gimeno-Traver,Carlos Berlocq,6-4; 6-3,R32,76,0,0,40,51,29,40,10,11,1,2,10,39,51,1,2,27,53,21,27,11,26,3,6,9,32,53
2011-04-25 00:00:00.000,Estoril Portugal ATP World Tour 250,CLAY,2,Gilles Simon,N/A Bye,Gilles Simon,,R32,0,0,0,0,0,0,0,0,0,0,0,0,0,0,0,0,0,0,0,0,0,0,0,0,0,0,0
2011-04-25 00:00:00.000,Estoril Portugal ATP World Tour 250,CLAY,2,Kevin Anderson,Thiemo de Bakker,Kevin Anderson,5-7; 6-3; 6-2,R32,146,2,0,58,81,39,58,16,23,4,7,15,55,81,4,1,58,91,35,58,17,33,5,10,14,52,91
2011-04-25 00:00:00.000,Estoril Portugal ATP World Tour 250,CLAY,2,Victor Hanescu,Rui Machado,Victor Hanescu,6-3; 6-3,R32,82,4,1,48,63,36,48,7,15,1,1,9,43,63,3,1,34,52,23,34,8,18,4,7,9,31,52
2011-04-25 00:00:00.000,Estoril Portugal ATP World Tour 250,CLAY,2,Frederico Gil,Flavio Cipolla,Frederico Gil,6-3; 6-2,R32,87,1,4,38,62,28,38,10,24,1,3,9,38,62,1,3,42,52,21,42,2,10,3,8,8,23,52
2011-04-25 00:00:00.000,Estoril Portugal ATP World Tour 250,CLAY,2,Fernando Verdasco,N/A Bye,Fernando Verdasco,,R32,0,0,0,0,0,0,0,0,0,0,0,0,0,0,0,0,0,0,0,0,0,0,0,0,0,0,0
2011-04-25 00:00:00.000,Estoril Portugal ATP World Tour 250,CLAY,2,Robin Soderling,Jeremy Chardy,Robin Soderling,6-1; 6-7(4); 6-1,R16,118,5,2,49,84,34,49,20,35,2,5,14,54,84,6,5,49,90,31,49,12,41,9,16,12,43,90
2011-04-25 00:00:00.000,Estoril Portugal ATP World Tour 250,CLAY,2,Juan Martin Del Potro,Alejandro Falla,Juan Martin Del Potro,6-2; 6-1,R16,71,3,0,23,38,20,23,12,15,0,0,8,32,38,2,3,36,57,19,36,9,21,3,7,7,28,57
2011-04-25 00:00:00.000,Estoril Portugal ATP World Tour 250,CLAY,2,Pablo Cuevas,Jo-Wilfried Tsonga,Pablo Cuevas,6-2; 7-6(0),R16,78,3,1,34,52,29,34,13,18,0,1,10,42,52,3,2,39,60,25,39,9,21,4,7,10,34,60
2011-04-25 00:00:00.000,Estoril Portugal ATP World Tour 250,CLAY,2,Thomaz Bellucci,Edouard Roger-Vasselin,Thomaz Bellucci,6-3; 5-7; 7-5,R16,178,6,3,71,113,49,71,21,42,6,9,17,70,113,5,1,78,106,50,78,14,28,9,13,16,64,106
2011-04-25 00:00:00.000,Estoril Portugal ATP World Tour 250,CLAY,2,Milos Raonic,Joao Sousa,Milos Raonic,6-3; 6-3,R16,71,6,2,29,44,20,29,11,15,1,3,9,31,44,1,2,31,56,18,31,9,25,1,6,9,27,56
2011-04-25 00:00:00.000,Estoril Portugal ATP World Tour 250,CLAY,2,Gilles Simon,Carlos Berlocq,Gilles Simon,6-2; 6-1,R16,84,1,3,40,58,30,40,10,18,5,5,8,40,58,1,1,31,51,17,31,7,20,6,10,7,24,51
2011-04-25 00:00:00.000,Estoril Portugal ATP World Tour 250,CLAY,2,Kevin Anderson,Victor Hanescu,Kevin Anderson,6-4; 6-2,R16,84,4,0,33,53,26,33,11,20,0,0,9,37,53,0,0,43,58,28,43,8,15,2,5,9,36,58
2011-04-25 00:00:00.000,Estoril Portugal ATP World Tour 250,CLAY,2,Fernando Verdasco,Frederico Gil,Fernando Verdasco,6-1; 7-6(5),R16,103,2,7,41,63,30,41,10,22,3,5,10,40,63,1,3,44,67,23,44,12,23,4,8,9,35,67
2011-04-25 00:00:00.000,Estoril Portugal ATP World Tour 250,CLAY,2,Juan Martin Del Potro,Robin Soderling,Juan Martin Del Potro,6-4; 7-5,Q,117,6,4,49,81,36,49,16,32,5,6,11,52,81,3,3,41,60,28,41,10,19,2,5,11,38,60
2011-04-25 00:00:00.000,Estoril Portugal ATP World Tour 250,CLAY,2,Pablo Cuevas,Thomaz Bellucci,Pablo Cuevas,6-4; 6-2,Q,80,5,1,29,52,24,29,14,23,2,2,9,38,52,1,0,30,49,20,30,8,19,2,5,9,28,49
2011-04-25 00:00:00.000,Estoril Portugal ATP World Tour 250,CLAY,2,Milos Raonic,Gilles Simon,Milos Raonic,7-6(4); 4-6; 6-3,Q,151,7,1,70,109,49,70,16,39,3,8,16,65,109,2,2,52,92,33,52,22,40,6,11,15,55,92
2011-04-25 00:00:00.000,Estoril Portugal ATP World Tour 250,CLAY,2,Fernando Verdasco,Kevin Anderson,Fernando Verdasco,6-7(2); 6-2; 6-3,Q,156,3,1,83,99,60,83,7,16,4,5,15,67,99,5,0,65,92,41,65,15,27,5,9,14,56,92
2011-04-25 00:00:00.000,Estoril Portugal ATP World Tour 250,CLAY,2,Juan Martin Del Potro,Pablo Cuevas,Juan Martin Del Potro,6-2; 7-6(6),S,109,4,0,37,60,31,37,14,23,0,0,10,45,60,3,0,41,75,28,41,19,34,11,13,10,47,75
2011-04-25 00:00:00.000,Estoril Portugal ATP World Tour 250,CLAY,2,Fernando Verdasco,Milos Raonic,Fernando Verdasco,6-4 RET,S,42,0,0,22,26,18,22,2,4,0,0,5,20,26,6,2,19,31,14,19,6,12,1,2,5,20,31
2011-04-25 00:00:00.000,Estoril Portugal ATP World Tour 250,CLAY,2,Juan Martin Del Potro,Fernando Verdasco,Juan Martin Del Potro,6-2; 6-2,F,76,2,2,35,48,26,35,7,13,2,3,8,33,48,2,3,31,46,15,31,5,15,1,6,8,20,46
2011-05-01 00:00:00.000,ATP World Tour Masters 1000 Madrid Spain ATP World Tour Masters 1000,CLAY,2,Rafael Nadal,N/A Bye,Rafael Nadal,,R64,0,0,0,0,0,0,0,0,0,0,0,0,0,0,0,0,0,0,0,0,0,0,0,0,0,0,0
2011-05-01 00:00:00.000,ATP World Tour Masters 1000 Madrid Spain ATP World Tour Masters 1000,CLAY,2,Marcos Baghdatis,Alejandro Falla,Marcos Baghdatis,6-3; 3-6; 7-6(5),R64,155,11,3,49,99,38,49,26,50,3,5,15,64,99,9,0,74,114,47,74,25,40,11,13,15,72,114
2011-05-01 00:00:00.000,ATP World Tour Masters 1000 Madrid Spain ATP World Tour Masters 1000,CLAY,2,Marin Cilic,Potito Starace,Marin Cilic,7-6(5); 6-4,R64,94,11,1,41,73,31,41,17,32,4,6,11,48,73,0,0,56,77,34,56,10,21,3,6,11,44,77
2011-05-01 00:00:00.000,ATP World Tour Masters 1000 Madrid Spain ATP World Tour Masters 1000,CLAY,2,Juan Martin Del Potro,Mikhail Youzhny,Juan Martin Del Potro,6-1; 3-6; 6-3,R64,127,8,3,57,79,42,57,13,22,4,5,13,55,79,5,1,43,74,28,43,16,31,7,10,12,44,74
2011-05-01 00:00:00.000,ATP World Tour Masters 1000 Madrid Spain ATP World Tour Masters 1000,CLAY,2,Flavio Cipolla,Andy Roddick,Flavio Cipolla,6-4; 6-7(7); 6-3,R64,183,3,3,78,114,51,78,23,36,8,10,16,74,114,5,2,77,113,49,77,20,36,6,10,15,69,113
2011-05-01 00:00:00.000,ATP World Tour Masters 1000 Madrid Spain ATP World Tour Masters 1000,CLAY,2,Michael Llodra,Sam Querrey,Michael Llodra,6-2; 6-3,R64,63,2,6,37,56,28,37,10,19,3,4,9,38,56,3,0,33,51,19,33,7,18,4,8,8,26,51
2011-05-01 00:00:00.000,ATP World Tour Masters 1000 Madrid Spain ATP World Tour Masters 1000,CLAY,2,Daniel Gimeno-Traver,Richard Gasquet,Daniel Gimeno-Traver,3-6; 6-4; 6-3,R64,135,3,1,57,88,40,57,13,31,8,12,14,53,88,3,4,74,110,45,74,15,36,7,12,14,60,110
2011-05-01 00:00:00.000,ATP World Tour Masters 1000 Madrid Spain ATP World Tour Masters 1000,CLAY,2,Jurgen Melzer,N/A Bye,Jurgen Melzer,,R64,0,0,0,0,0,0,0,0,0,0,0,0,0,0,0,0,0,0,0,0,0,0,0,0,0,0,0
2011-05-01 00:00:00.000,ATP World Tour Masters 1000 Madrid Spain ATP World Tour Masters 1000,CLAY,2,Roger Federer,N/A Bye,Roger Federer,,R64,0,0,0,0,0,0,0,0,0,0,0,0,0,0,0,0,0,0,0,0,0,0,0,0,0,0,0
2011-05-01 00:00:00.000,ATP World Tour Masters 1000 Madrid Spain ATP World Tour Masters 1000,CLAY,2,Feliciano Lopez,Milos Raonic,Feliciano Lopez,4-6; 7-6(2); 6-4,R64,124,12,0,63,97,51,63,19,34,1,2,16,70,97,23,1,65,91,53,65,13,26,2,3,16,66,91
2011-05-01 00:00:00.000,ATP World Tour Masters 1000 Madrid Spain ATP World Tour Masters 1000,CLAY,2,Xavier Malisse,Victor Hanescu,Xavier Malisse,3-6; 6-4; 7-5,R64,128,12,0,67,103,49,67,20,36,5,6,15,69,103,7,2,85,108,55,85,15,23,4,6,16,70,108
2011-05-01 00:00:00.000,ATP World Tour Masters 1000 Madrid Spain ATP World Tour Masters 1000,CLAY,2,Yen-Hsun Lu,Fernando Verdasco,Yen-Hsun Lu,7-6(7); 7-5,R64,124,4,4,60,86,44,60,12,26,5,6,12,56,86,3,4,64,81,46,64,8,17,3,5,12,54,81
2011-05-01 00:00:00.000,ATP World Tour Masters 1000 Madrid Spain ATP World Tour Masters 1000,CLAY,2,Jo-Wilfried Tsonga,Nicolas Almagro,Jo-Wilfried Tsonga,6-1; 6-3,R64,67,8,3,30,46,26,30,9,16,2,2,8,35,46,1,0,32,46,17,32,7,14,3,7,8,24,46
2011-05-01 00:00:00.000,ATP World Tour Masters 1000 Madrid Spain ATP World Tour Masters 1000,CLAY,2,Pere Riba,Kei Nishikori,Pere Riba,6-2; 6-4,R64,79,7,4,35,55,25,35,7,20,5,8,9,32,55,0,4,34,54,15,34,8,20,5,11,9,23,54
2011-05-01 00:00:00.000,ATP World Tour Masters 1000 Madrid Spain ATP World Tour Masters 1000,CLAY,2,Santiago Giraldo,Alexandr Dolgopolov,Santiago Giraldo,6-1; 7-5,R64,67,2,0,45,65,33,45,10,20,5,6,10,43,65,2,4,23,53,16,23,14,30,4,8,9,30,53
2011-05-01 00:00:00.000,ATP World Tour Masters 1000 Madrid Spain ATP World Tour Masters 1000,CLAY,2,Robin Soderling,N/A Bye,Robin Soderling,,R64,0,0,0,0,0,0,0,0,0,0,0,0,0,0,0,0,0,0,0,0,0,0,0,0,0,0,0
2011-05-01 00:00:00.000,ATP World Tour Masters 1000 Madrid Spain ATP World Tour Masters 1000,CLAY,2,Tomas Berdych,N/A Bye,Tomas Berdych,,R64,0,0,0,0,0,0,0,0,0,0,0,0,0,0,0,0,0,0,0,0,0,0,0,0,0,0,0
2011-05-01 00:00:00.000,ATP World Tour Masters 1000 Madrid Spain ATP World Tour Masters 1000,CLAY,2,Marcel Granollers,Nikolay Davydenko,Marcel Granollers,7-5; 6-2,R64,95,1,0,37,55,28,37,12,18,0,0,10,40,55,1,3,50,66,32,50,7,16,5,8,10,39,66
2011-05-01 00:00:00.000,ATP World Tour Masters 1000 Madrid Spain ATP World Tour Masters 1000,CLAY,2,Juan Monaco,Andrey Golubev,Juan Monaco,2-6; 6-2; 6-2,R64,98,0,0,40,55,27,40,10,15,0,3,12,37,55,6,1,41,77,25,41,14,36,5,10,12,39,77
2011-05-01 00:00:00.000,ATP World Tour Masters 1000 Madrid Spain ATP World Tour Masters 1000,CLAY,2,Gael Monfils,Ivo Karlovic,Gael Monfils,6-3; 7-6(6),R64,82,3,3,50,61,40,50,5,11,0,0,10,45,61,6,2,46,72,34,46,12,26,4,6,11,46,72
2011-05-01 00:00:00.000,ATP World Tour Masters 1000 Madrid Spain ATP World Tour Masters 1000,CLAY,2,Florian Mayer,Viktor Troicki,Florian Mayer,4-6; 7-5; 6-4,R64,143,1,5,67,104,49,67,12,37,8,12,16,61,104,5,1,54,97,35,54,22,43,10,15,16,57,97
2011-05-01 00:00:00.000,ATP World Tour Masters 1000 Madrid Spain ATP World Tour Masters 1000,CLAY,2,Thomaz Bellucci,Pablo Andujar,Thomaz Bellucci,6-4; 6-2,R64,91,4,1,35,56,24,35,13,21,2,3,9,37,56,1,4,40,69,22,40,15,29,8,12,9,37,69
2011-05-01 00:00:00.000,ATP World Tour Masters 1000 Madrid Spain ATP World Tour Masters 1000,CLAY,2,Gilles Simon,Ivan Ljubicic,Gilles Simon,7-5; 7-6(8),R64,116,5,1,40,71,32,40,23,31,0,0,12,55,71,8,3,50,90,38,50,20,40,3,4,12,58,90
2011-05-01 00:00:00.000,ATP World Tour Masters 1000 Madrid Spain ATP World Tour Masters 1000,CLAY,2,Andy Murray,N/A Bye,Andy Murray,,R64,0,0,0,0,0,0,0,0,0,0,0,0,0,0,0,0,0,0,0,0,0,0,0,0,0,0,0
2011-05-01 00:00:00.000,ATP World Tour Masters 1000 Madrid Spain ATP World Tour Masters 1000,CLAY,2,David Ferrer,N/A Bye,David Ferrer,,R64,0,0,0,0,0,0,0,0,0,0,0,0,0,0,0,0,0,0,0,0,0,0,0,0,0,0,0
2011-05-01 00:00:00.000,ATP World Tour Masters 1000 Madrid Spain ATP World Tour Masters 1000,CLAY,2,Adrian Mannarino,Juan Ignacio Chela,Adrian Mannarino,4-6; 6-4; 6-4,R64,144,13,1,64,102,42,64,16,38,5,10,15,58,102,4,2,79,115,48,79,13,36,5,11,15,61,115
2011-05-01 00:00:00.000,ATP World Tour Masters 1000 Madrid Spain ATP World Tour Masters 1000,CLAY,2,Sergiy Stakhovsky,Albert Montanes,Sergiy Stakhovsky,7-6(6); 3-6; 7-6(5),R64,144,7,1,69,113,50,69,24,44,2,4,16,74,113,2,4,67,109,53,67,22,42,2,3,17,75,109
2011-05-01 00:00:00.000,ATP World Tour Masters 1000 Madrid Spain ATP World Tour Masters 1000,CLAY,2,John Isner,Mardy Fish,John Isner,7-6(5); 4-6; 7-6(3),R64,174,13,1,78,111,56,78,23,33,3,4,17,79,111,6,2,91,123,67,91,19,32,6,6,17,86,123
2011-05-01 00:00:00.000,ATP World Tour Masters 1000 Madrid Spain ATP World Tour Masters 1000,CLAY,2,Guillermo Garcia-Lopez,Stanislas Wawrinka,Guillermo Garcia-Lopez,6-4; 5-7; 6-4,R64,165,3,2,57,111,42,57,29,54,5,7,16,71,111,5,2,69,105,50,69,14,36,5,8,16,64,105
2011-05-01 00:00:00.000,ATP World Tour Masters 1000 Madrid Spain ATP World Tour Masters 1000,CLAY,2,Thiemo de Bakker,Juan Carlos Ferrero,Thiemo de Bakker,2-6; 7-5; 6-4,R64,123,10,3,47,85,37,47,22,38,4,6,15,59,85,5,0,66,90,46,66,16,24,5,7,15,62,90
2011-05-01 00:00:00.000,ATP World Tour Masters 1000 Madrid Spain ATP World Tour Masters 1000,CLAY,2,Kevin Anderson,Olivier Rochus,Kevin Anderson,6-2; 6-4,R64,73,12,4,34,54,28,34,9,20,3,4,9,37,54,0,0,25,44,13,25,9,19,0,4,9,22,44
2011-05-01 00:00:00.000,ATP World Tour Masters 1000 Madrid Spain ATP World Tour Masters 1000,CLAY,2,Novak Djokovic,N/A Bye,Novak Djokovic,,R64,0,0,0,0,0,0,0,0,0,0,0,0,0,0,0,0,0,0,0,0,0,0,0,0,0,0,0
2011-05-01 00:00:00.000,ATP World Tour Masters 1000 Madrid Spain ATP World Tour Masters 1000,CLAY,2,Rafael Nadal,Marcos Baghdatis,Rafael Nadal,6-1; 6-3,R32,82,1,0,23,41,19,23,14,18,0,0,8,33,41,3,1,26,54,19,26,9,28,1,5,8,28,54
2011-05-01 00:00:00.000,ATP World Tour Masters 1000 Madrid Spain ATP World Tour Masters 1000,CLAY,2,Juan Martin Del Potro,Marin Cilic,Juan Martin Del Potro,6-3; 6-0,R32,64,2,1,23,35,21,23,7,12,0,0,7,28,35,2,2,23,44,13,23,6,21,1,6,8,19,44
2011-05-01 00:00:00.000,ATP World Tour Masters 1000 Madrid Spain ATP World Tour Masters 1000,CLAY,2,Michael Llodra,Flavio Cipolla,Michael Llodra,6-4; 6-2,R32,77,3,0,32,49,24,32,11,17,0,1,9,35,49,0,2,34,59,21,34,11,25,5,9,9,32,59
2011-05-01 00:00:00.000,ATP World Tour Masters 1000 Madrid Spain ATP World Tour Masters 1000,CLAY,2,Daniel Gimeno-Traver,Jurgen Melzer,Daniel Gimeno-Traver,7-6(8); 6-3,R32,95,5,1,41,62,25,41,10,21,3,7,10,35,62,4,2,57,80,32,57,7,23,4,10,11,39,80
2011-05-01 00:00:00.000,ATP World Tour Masters 1000 Madrid Spain ATP World Tour Masters 1000,CLAY,2,Roger Federer,Feliciano Lopez,Roger Federer,7-6(13); 6-7(1); 7-6(7),R32,176,25,3,93,136,75,93,28,43,4,5,18,103,136,23,1,89,130,73,89,23,41,5,6,18,96,130
2011-05-01 00:00:00.000,ATP World Tour Masters 1000 Madrid Spain ATP World Tour Masters 1000,CLAY,2,Xavier Malisse,Yen-Hsun Lu,Xavier Malisse,6-2; 6-2,R32,57,7,1,28,40,23,28,9,12,0,0,8,32,40,1,0,29,46,19,29,6,17,2,6,8,25,46
2011-05-01 00:00:00.000,ATP World Tour Masters 1000 Madrid Spain ATP World Tour Masters 1000,CLAY,2,Jo-Wilfried Tsonga,Pere Riba,Jo-Wilfried Tsonga,6-4; 6-2,R32,200,6,2,36,49,28,36,7,13,2,3,9,35,49,2,1,31,57,17,31,13,26,4,8,9,30,57
2011-05-01 00:00:00.000,ATP World Tour Masters 1000 Madrid Spain ATP World Tour Masters 1000,CLAY,2,Robin Soderling,Santiago Giraldo,Robin Soderling,6-3; 6-3,R32,80,9,2,30,52,25,30,10,22,2,3,9,35,52,3,1,40,74,27,40,12,34,6,10,9,39,74
2011-05-01 00:00:00.000,ATP World Tour Masters 1000 Madrid Spain ATP World Tour Masters 1000,CLAY,2,Tomas Berdych,Marcel Granollers,Tomas Berdych,6-4; 6-0,R32,76,1,0,27,41,19,27,9,14,2,4,8,28,41,0,0,40,54,15,40,8,14,3,9,8,23,54
2011-05-01 00:00:00.000,ATP World Tour Masters 1000 Madrid Spain ATP World Tour Masters 1000,CLAY,2,Juan Monaco,Gael Monfils,Juan Monaco,6-2; 3-0 RET,R32,64,0,0,24,31,16,24,6,7,3,3,5,22,31,2,3,34,51,18,34,5,17,4,8,6,23,51
2011-05-01 00:00:00.000,ATP World Tour Masters 1000 Madrid Spain ATP World Tour Masters 1000,CLAY,2,Thomaz Bellucci,Florian Mayer,Thomaz Bellucci,6-7(5); 6-3; 3-0 RET,R32,102,11,1,49,69,36,49,13,20,0,2,12,49,69,2,2,58,83,31,58,12,25,6,11,12,43,83
2011-05-01 00:00:00.000,ATP World Tour Masters 1000 Madrid Spain ATP World Tour Masters 1000,CLAY,2,Andy Murray,Gilles Simon,Andy Murray,6-4; 3-6; 6-0,R32,143,8,3,59,95,39,59,18,36,8,10,12,57,95,4,2,46,88,28,46,20,42,10,15,13,48,88
2011-05-01 00:00:00.000,ATP World Tour Masters 1000 Madrid Spain ATP World Tour Masters 1000,CLAY,2,David Ferrer,Adrian Mannarino,David Ferrer,7-5; 0-6; 6-0,R32,115,4,5,62,100,41,62,15,38,8,12,12,56,100,0,0,32,66,18,32,19,34,0,5,12,37,66
2011-05-01 00:00:00.000,ATP World Tour Masters 1000 Madrid Spain ATP World Tour Masters 1000,CLAY,2,Sergiy Stakhovsky,John Isner,Sergiy Stakhovsky,7-5; 4-6; 7-6(3),R32,136,5,1,70,103,53,70,21,33,3,4,17,74,103,7,2,69,103,49,69,21,34,1,2,17,70,103
2011-05-01 00:00:00.000,ATP World Tour Masters 1000 Madrid Spain ATP World Tour Masters 1000,CLAY,2,Guillermo Garcia-Lopez,Thiemo de Bakker,Guillermo Garcia-Lopez,6-2; 6-3,R32,73,1,1,21,50,20,21,18,29,1,1,9,38,50,1,1,25,50,15,25,14,25,3,6,8,29,50
2011-05-01 00:00:00.000,ATP World Tour Masters 1000 Madrid Spain ATP World Tour Masters 1000,CLAY,2,Novak Djokovic,Kevin Anderson,Novak Djokovic,6-3; 6-4,R32,101,2,2,39,55,32,39,9,16,2,2,10,41,55,7,0,39,64,28,39,11,25,4,6,9,39,64
2011-05-01 00:00:00.000,ATP World Tour Masters 1000 Madrid Spain ATP World Tour Masters 1000,CLAY,2,Rafael Nadal,Juan Martin Del Potro,Rafael Nadal,W/O,R16,0,0,0,0,0,0,0,0,0,0,0,0,0,0,0,0,0,0,0,0,0,0,0,0,0,0,0
2011-05-01 00:00:00.000,ATP World Tour Masters 1000 Madrid Spain ATP World Tour Masters 1000,CLAY,2,Michael Llodra,Daniel Gimeno-Traver,Michael Llodra,1-6; 6-4; 7-6(4),R16,138,7,2,80,120,57,80,17,40,13,16,15,74,120,5,0,58,87,41,58,21,29,2,3,14,62,87
2011-05-01 00:00:00.000,ATP World Tour Masters 1000 Madrid Spain ATP World Tour Masters 1000,CLAY,2,Roger Federer,Xavier Malisse,Roger Federer,6-4; 6-3,R16,71,5,0,32,52,24,32,14,20,1,2,10,38,52,6,1,28,55,21,28,11,27,3,6,9,32,55
2011-05-01 00:00:00.000,ATP World Tour Masters 1000 Madrid Spain ATP World Tour Masters 1000,CLAY,2,Robin Soderling,Jo-Wilfried Tsonga,Robin Soderling,7-6(8); 7-5,R16,133,5,2,49,77,40,49,17,28,3,3,12,57,77,13,0,63,96,49,63,15,33,5,6,12,64,96
2011-05-01 00:00:00.000,ATP World Tour Masters 1000 Madrid Spain ATP World Tour Masters 1000,CLAY,2,Tomas Berdych,Juan Monaco,Tomas Berdych,7-5; 6-3,R16,109,4,2,38,70,31,38,15,32,4,5,11,46,70,0,0,36,59,24,36,12,23,3,6,10,36,59
2011-05-01 00:00:00.000,ATP World Tour Masters 1000 Madrid Spain ATP World Tour Masters 1000,CLAY,2,Thomaz Bellucci,Andy Murray,Thomaz Bellucci,6-4; 6-2,R16,91,4,1,36,57,29,36,11,21,3,3,9,40,57,1,2,34,56,21,34,11,22,0,3,9,32,56
2011-05-01 00:00:00.000,ATP World Tour Masters 1000 Madrid Spain ATP World Tour Masters 1000,CLAY,2,David Ferrer,Sergiy Stakhovsky,David Ferrer,6-3; 7-6(3),R16,89,2,2,39,56,34,39,13,17,3,4,11,47,56,5,0,41,65,29,41,13,24,5,7,10,42,65
2011-05-01 00:00:00.000,ATP World Tour Masters 1000 Madrid Spain ATP World Tour Masters 1000,CLAY,2,Novak Djokovic,Guillermo Garcia-Lopez,Novak Djokovic,6-1; 6-2,R16,51,5,1,21,34,21,21,11,13,0,0,8,32,34,3,2,24,37,16,24,3,13,3,7,7,19,37
2011-05-01 00:00:00.000,ATP World Tour Masters 1000 Madrid Spain ATP World Tour Masters 1000,CLAY,2,Rafael Nadal,Michael Llodra,Rafael Nadal,6-2; 6-2,Q,75,1,0,30,41,25,30,8,11,0,0,8,33,41,4,1,44,72,28,44,8,28,8,12,8,36,72
2011-05-01 00:00:00.000,ATP World Tour Masters 1000 Madrid Spain ATP World Tour Masters 1000,CLAY,2,Roger Federer,Robin Soderling,Roger Federer,7-6(2); 6-4,Q,103,8,2,44,73,34,44,19,29,2,2,11,53,73,8,5,41,77,32,41,18,36,5,6,11,50,77
2011-05-01 00:00:00.000,ATP World Tour Masters 1000 Madrid Spain ATP World Tour Masters 1000,CLAY,2,Thomaz Bellucci,Tomas Berdych,Thomaz Bellucci,7-6(2); 6-3,Q,94,5,1,39,60,33,39,16,21,0,0,11,49,60,2,1,37,61,27,37,15,24,0,1,10,42,61
2011-05-01 00:00:00.000,ATP World Tour Masters 1000 Madrid Spain ATP World Tour Masters 1000,CLAY,2,Novak Djokovic,David Ferrer,Novak Djokovic,6-4; 4-6; 6-3,Q,148,6,1,56,85,43,56,12,29,3,6,14,55,85,1,2,58,93,36,58,15,35,6,11,15,51,93
2011-05-01 00:00:00.000,ATP World Tour Masters 1000 Madrid Spain ATP World Tour Masters 1000,CLAY,2,Rafael Nadal,Roger Federer,Rafael Nadal,5-7; 6-1; 6-3,S,156,1,0,82,101,55,82,10,19,9,11,14,65,101,0,1,63,103,41,63,16,40,7,12,14,57,103
2011-05-01 00:00:00.000,ATP World Tour Masters 1000 Madrid Spain ATP World Tour Masters 1000,CLAY,2,Novak Djokovic,Thomaz Bellucci,Novak Djokovic,4-6; 6-4; 6-1,S,130,6,1,51,80,35,51,18,29,1,3,14,53,80,5,1,48,75,30,48,16,27,4,8,13,46,75
2011-05-01 00:00:00.000,ATP World Tour Masters 1000 Madrid Spain ATP World Tour Masters 1000,CLAY,2,Novak Djokovic,Rafael Nadal,Novak Djokovic,7-5; 6-4,F,138,3,1,33,58,23,33,13,25,3,6,11,36,58,3,0,52,75,29,52,9,23,7,12,11,38,75
2011-05-08 00:00:00.000,ATP World Tour Masters 1000 Rome Italy ATP World Tour Masters 1000,CLAY,2,Rafael Nadal,N/A Bye,Rafael Nadal,,R64,0,0,0,0,0,0,0,0,0,0,0,0,0,0,0,0,0,0,0,0,0,0,0,0,0,0,0
2011-05-08 00:00:00.000,ATP World Tour Masters 1000 Rome Italy ATP World Tour Masters 1000,CLAY,2,Paolo Lorenzi,Thomaz Bellucci,Paolo Lorenzi,7-6(5); 6-3,R64,108,2,2,45,66,31,45,12,21,3,5,11,43,66,2,2,48,72,31,48,11,24,6,9,10,42,72
2011-05-08 00:00:00.000,ATP World Tour Masters 1000 Rome Italy ATP World Tour Masters 1000,CLAY,2,Feliciano Lopez,Michael Llodra,Feliciano Lopez,7-6(2); 6-1,R64,86,4,0,31,61,26,31,22,30,2,2,10,48,61,4,1,32,53,22,32,13,21,2,4,9,35,53
2011-05-08 00:00:00.000,ATP World Tour Masters 1000 Rome Italy ATP World Tour Masters 1000,CLAY,2,Philipp Kohlschreiber,Mikhail Youzhny,Philipp Kohlschreiber,6-4; 6-2,R64,94,3,4,47,70,34,47,12,23,7,7,9,46,70,3,3,37,52,27,37,6,15,0,3,9,33,52
2011-05-08 00:00:00.000,ATP World Tour Masters 1000 Rome Italy ATP World Tour Masters 1000,CLAY,2,Mardy Fish,Santiago Giraldo,Mardy Fish,4-6; 6-2; 6-2,R64,145,4,2,48,67,34,48,10,19,2,5,13,44,67,2,2,75,109,43,75,14,34,7,13,13,57,109
2011-05-08 00:00:00.000,ATP World Tour Masters 1000 Rome Italy ATP World Tour Masters 1000,CLAY,2,Ivan Ljubicic,Flavio Cipolla,Ivan Ljubicic,6-2; 6-3,R64,73,4,0,29,46,24,29,14,17,2,2,9,38,46,0,1,24,41,14,24,9,17,0,3,8,23,41
2011-05-08 00:00:00.000,ATP World Tour Masters 1000 Rome Italy ATP World Tour Masters 1000,CLAY,2,Marin Cilic,Ivo Karlovic,Marin Cilic,6-4; 1-0 RET,R64,62,3,3,17,24,15,17,2,7,0,1,5,17,24,5,3,35,49,20,35,4,14,7,10,6,24,49
2011-05-08 00:00:00.000,ATP World Tour Masters 1000 Rome Italy ATP World Tour Masters 1000,CLAY,2,Carlos Berlocq,N/A Bye,Carlos Berlocq,,R64,0,0,0,0,0,0,0,0,0,0,0,0,0,0,0,0,0,0,0,0,0,0,0,0,0,0,0
2011-05-08 00:00:00.000,ATP World Tour Masters 1000 Rome Italy ATP World Tour Masters 1000,CLAY,2,Roger Federer,N/A Bye,Roger Federer,,R64,0,0,0,0,0,0,0,0,0,0,0,0,0,0,0,0,0,0,0,0,0,0,0,0,0,0,0
2011-05-08 00:00:00.000,ATP World Tour Masters 1000 Rome Italy ATP World Tour Masters 1000,CLAY,2,Jo-Wilfried Tsonga,Marcos Baghdatis,Jo-Wilfried Tsonga,6-3; 6-2,R64,75,6,1,24,41,20,24,13,17,0,0,8,33,41,1,2,32,55,18,32,10,23,7,11,9,28,55
2011-05-08 00:00:00.000,ATP World Tour Masters 1000 Rome Italy ATP World Tour Masters 1000,CLAY,2,Igor Andreev,Pere Riba,Igor Andreev,6-4; 7-5,R64,99,1,1,45,60,27,45,10,15,2,5,11,37,60,0,1,39,65,20,39,14,26,6,11,11,34,65
2011-05-08 00:00:00.000,ATP World Tour Masters 1000 Rome Italy ATP World Tour Masters 1000,CLAY,2,Richard Gasquet,Albert Montanes,Richard Gasquet,6-2; 6-3,R64,73,7,1,38,57,29,38,9,19,1,2,9,38,57,3,2,23,44,15,23,9,21,3,7,8,24,44
2011-05-08 00:00:00.000,ATP World Tour Masters 1000 Rome Italy ATP World Tour Masters 1000,CLAY,2,Jarkko Nieminen,Adrian Mannarino,Jarkko Nieminen,7-5; 2-6; 6-3,R64,127,3,1,71,96,42,71,20,25,5,7,15,62,96,4,0,59,92,39,59,19,33,2,4,14,58,92
2011-05-08 00:00:00.000,ATP World Tour Masters 1000 Rome Italy ATP World Tour Masters 1000,CLAY,2,Sergiy Stakhovsky,Victor Hanescu,Sergiy Stakhovsky,6-3; 1-6; 7-6(6),R64,127,6,0,69,99,49,69,14,30,4,7,14,63,99,5,2,56,73,48,56,7,17,1,3,14,55,73
2011-05-08 00:00:00.000,ATP World Tour Masters 1000 Rome Italy ATP World Tour Masters 1000,CLAY,2,Juan Monaco,Andreas Seppi,Juan Monaco,6-1; 4-6; 6-2,R64,134,5,1,40,66,34,40,12,26,1,2,12,46,66,3,0,52,96,31,52,20,44,6,11,13,51,96
2011-05-08 00:00:00.000,ATP World Tour Masters 1000 Rome Italy ATP World Tour Masters 1000,CLAY,2,Tomas Berdych,N/A Bye,Tomas Berdych,,R64,0,0,0,0,0,0,0,0,0,0,0,0,0,0,0,0,0,0,0,0,0,0,0,0,0,0,0
2011-05-08 00:00:00.000,ATP World Tour Masters 1000 Rome Italy ATP World Tour Masters 1000,CLAY,2,Jurgen Melzer,N/A Bye,Jurgen Melzer,,R64,0,0,0,0,0,0,0,0,0,0,0,0,0,0,0,0,0,0,0,0,0,0,0,0,0,0,0
2011-05-08 00:00:00.000,ATP World Tour Masters 1000 Rome Italy ATP World Tour Masters 1000,CLAY,2,Florian Mayer,Andrey Golubev,Florian Mayer,6-4; 6-3,R64,79,2,0,37,53,25,37,10,16,1,2,9,35,53,1,5,42,70,25,42,12,28,3,7,10,37,70
2011-05-08 00:00:00.000,ATP World Tour Masters 1000 Rome Italy ATP World Tour Masters 1000,CLAY,2,Juan Ignacio Chela,John Isner,Juan Ignacio Chela,6-4; 6-1,R64,72,2,2,38,49,31,38,6,11,2,2,8,37,49,2,1,38,56,24,38,5,18,1,5,9,29,56
2011-05-08 00:00:00.000,ATP World Tour Masters 1000 Rome Italy ATP World Tour Masters 1000,CLAY,2,Gilles Simon,Andy Roddick,Gilles Simon,6-3; 6-3,R64,82,4,2,29,51,23,29,12,22,0,1,9,35,51,1,0,39,57,22,39,8,18,4,8,9,30,57
2011-05-08 00:00:00.000,ATP World Tour Masters 1000 Rome Italy ATP World Tour Masters 1000,CLAY,2,Viktor Troicki,Nikolay Davydenko,Viktor Troicki,6-4; 7-5,R64,100,6,0,50,73,37,50,13,23,4,4,11,50,73,1,1,49,67,33,49,10,18,4,6,11,43,67
2011-05-08 00:00:00.000,ATP World Tour Masters 1000 Rome Italy ATP World Tour Masters 1000,CLAY,2,Potito Starace,Alexandr Dolgopolov,Potito Starace,6-3; 6-3,R64,62,1,0,44,52,32,44,5,8,0,0,9,37,52,2,1,30,52,18,30,11,22,1,4,9,29,52
2011-05-08 00:00:00.000,ATP World Tour Masters 1000 Rome Italy ATP World Tour Masters 1000,CLAY,2,Xavier Malisse,Guillermo Garcia-Lopez,Xavier Malisse,7-5; 6-2,R64,97,4,2,32,55,29,32,11,23,2,3,10,40,55,1,6,40,71,28,40,10,31,6,10,10,38,71
2011-05-08 00:00:00.000,ATP World Tour Masters 1000 Rome Italy ATP World Tour Masters 1000,CLAY,2,Andy Murray,N/A Bye,Andy Murray,,R64,0,0,0,0,0,0,0,0,0,0,0,0,0,0,0,0,0,0,0,0,0,0,0,0,0,0,0
2011-05-08 00:00:00.000,ATP World Tour Masters 1000 Rome Italy ATP World Tour Masters 1000,CLAY,2,Robin Soderling,N/A Bye,Robin Soderling,,R64,0,0,0,0,0,0,0,0,0,0,0,0,0,0,0,0,0,0,0,0,0,0,0,0,0,0,0
2011-05-08 00:00:00.000,ATP World Tour Masters 1000 Rome Italy ATP World Tour Masters 1000,CLAY,2,Fernando Verdasco,Milos Raonic,Fernando Verdasco,6-4; 6-4,R64,99,1,2,46,60,38,46,6,14,2,2,10,44,60,5,1,42,76,29,42,16,34,8,10,10,45,76
2011-05-08 00:00:00.000,ATP World Tour Masters 1000 Rome Italy ATP World Tour Masters 1000,CLAY,2,Sam Querrey,Kevin Anderson,Sam Querrey,7-6(1); 1-0 RET,R64,81,5,6,27,56,24,27,15,29,7,7,7,39,56,3,2,18,41,14,18,14,23,3,3,6,28,41
2011-05-08 00:00:00.000,ATP World Tour Masters 1000 Rome Italy ATP World Tour Masters 1000,CLAY,2,Nicolas Almagro,Simone Bolelli,Nicolas Almagro,6-0; 7-5,R64,75,4,0,33,49,26,33,10,16,0,1,9,36,49,1,0,39,52,21,39,7,13,2,7,9,28,52
2011-05-08 00:00:00.000,ATP World Tour Masters 1000 Rome Italy ATP World Tour Masters 1000,CLAY,2,Stanislas Wawrinka,Fabio Fognini,Stanislas Wawrinka,6-7(5); 6-2; 6-4,R64,141,9,0,63,92,50,63,16,29,4,5,15,66,92,1,4,65,104,43,65,20,39,1,5,15,63,104
2011-05-08 00:00:00.000,ATP World Tour Masters 1000 Rome Italy ATP World Tour Masters 1000,CLAY,2,Filippo Volandri,Thiemo de Bakker,Filippo Volandri,6-1; 6-2,R64,64,0,0,39,49,26,39,8,10,2,2,8,34,49,1,2,24,46,15,24,6,22,5,9,7,21,46
2011-05-08 00:00:00.000,ATP World Tour Masters 1000 Rome Italy ATP World Tour Masters 1000,CLAY,2,Lukasz Kubot,Pablo Cuevas,Lukasz Kubot,7-6(1); 2-6; 6-2,R64,163,4,7,53,94,41,53,20,41,6,8,14,61,94,9,2,82,122,52,82,19,40,13,15,14,71,122
2011-05-08 00:00:00.000,ATP World Tour Masters 1000 Rome Italy ATP World Tour Masters 1000,CLAY,2,Novak Djokovic,N/A Bye,Novak Djokovic,,R64,0,0,0,0,0,0,0,0,0,0,0,0,0,0,0,0,0,0,0,0,0,0,0,0,0,0,0
2011-05-08 00:00:00.000,ATP World Tour Masters 1000 Rome Italy ATP World Tour Masters 1000,CLAY,2,Rafael Nadal,Paolo Lorenzi,Rafael Nadal,6-7(5); 6-4; 6-0,R32,157,2,3,57,80,43,57,11,23,1,3,14,54,80,4,1,66,99,43,66,13,33,7,13,14,56,99
2011-05-08 00:00:00.000,ATP World Tour Masters 1000 Rome Italy ATP World Tour Masters 1000,CLAY,2,Feliciano Lopez,Philipp Kohlschreiber,Feliciano Lopez,6-4; 3-6; 6-3,R32,146,12,2,52,84,40,52,16,32,2,4,14,56,84,7,3,60,101,40,60,22,41,10,13,14,62,101
2011-05-08 00:00:00.000,ATP World Tour Masters 1000 Rome Italy ATP World Tour Masters 1000,CLAY,2,Mardy Fish,Ivan Ljubicic,Mardy Fish,7-6(2); 5-7; 6-2,R32,179,10,1,58,99,46,58,22,41,5,8,16,68,99,13,1,58,104,40,58,25,46,6,10,16,65,104
2011-05-08 00:00:00.000,ATP World Tour Masters 1000 Rome Italy ATP World Tour Masters 1000,CLAY,2,Marin Cilic,Carlos Berlocq,Marin Cilic,6-4; 6-3,R32,84,0,0,25,51,17,25,17,26,4,6,9,34,51,2,2,32,50,19,32,6,18,3,8,10,25,50
2011-05-08 00:00:00.000,ATP World Tour Masters 1000 Rome Italy ATP World Tour Masters 1000,CLAY,2,Roger Federer,Jo-Wilfried Tsonga,Roger Federer,6-4; 6-2,R32,83,2,0,43,66,32,43,13,23,7,7,9,45,66,3,0,28,53,17,28,14,25,4,7,9,31,53
2011-05-08 00:00:00.000,ATP World Tour Masters 1000 Rome Italy ATP World Tour Masters 1000,CLAY,2,Richard Gasquet,Igor Andreev,Richard Gasquet,6-1; 6-2,R32,61,4,1,25,44,18,25,13,19,2,3,8,31,44,0,1,20,33,8,20,3,13,2,7,7,11,33
2011-05-08 00:00:00.000,ATP World Tour Masters 1000 Rome Italy ATP World Tour Masters 1000,CLAY,2,Jarkko Nieminen,Sergiy Stakhovsky,Jarkko Nieminen,6-7(3); 6-3; 6-4,R32,149,2,2,68,111,47,68,19,43,6,9,16,66,111,4,0,61,96,37,61,22,35,5,10,15,59,96
2011-05-08 00:00:00.000,ATP World Tour Masters 1000 Rome Italy ATP World Tour Masters 1000,CLAY,2,Tomas Berdych,Juan Monaco,Tomas Berdych,6-2; 6-2,R32,90,2,0,27,50,19,27,14,23,4,5,8,33,50,1,1,27,44,12,27,8,17,1,6,8,20,44
2011-05-08 00:00:00.000,ATP World Tour Masters 1000 Rome Italy ATP World Tour Masters 1000,CLAY,2,Florian Mayer,Jurgen Melzer,Florian Mayer,6-4 RET,R32,42,4,0,16,26,13,16,7,10,0,0,5,20,26,2,1,22,31,14,22,6,9,0,1,5,20,31
2011-05-08 00:00:00.000,ATP World Tour Masters 1000 Rome Italy ATP World Tour Masters 1000,CLAY,2,Juan Ignacio Chela,Gilles Simon,Juan Ignacio Chela,6-4; 6-2,R32,92,0,3,38,53,28,38,7,15,1,2,9,35,53,3,2,29,59,14,29,14,30,4,8,9,28,59
2011-05-08 00:00:00.000,ATP World Tour Masters 1000 Rome Italy ATP World Tour Masters 1000,CLAY,2,Potito Starace,Viktor Troicki,Potito Starace,6-4; 6-4,R32,106,0,0,59,72,36,59,7,13,8,10,10,43,72,3,1,43,74,29,43,12,31,4,8,10,41,74
2011-05-08 00:00:00.000,ATP World Tour Masters 1000 Rome Italy ATP World Tour Masters 1000,CLAY,2,Andy Murray,Xavier Malisse,Andy Murray,6-2; 2-6; 6-3,R32,119,9,2,47,92,33,47,18,45,8,13,13,51,92,3,1,54,80,30,54,10,26,3,9,12,40,80
2011-05-08 00:00:00.000,ATP World Tour Masters 1000 Rome Italy ATP World Tour Masters 1000,CLAY,2,Robin Soderling,Fernando Verdasco,Robin Soderling,2-6; 7-5; 6-4,R32,163,3,2,66,102,42,66,13,36,6,12,15,55,102,3,6,68,104,44,68,13,36,7,13,15,57,104
2011-05-08 00:00:00.000,ATP World Tour Masters 1000 Rome Italy ATP World Tour Masters 1000,CLAY,2,Nicolas Almagro,Sam Querrey,Nicolas Almagro,6-3; 7-6(4),R32,109,4,2,50,78,35,50,12,28,6,9,11,47,78,5,2,44,73,31,44,12,29,2,6,10,43,73
2011-05-08 00:00:00.000,ATP World Tour Masters 1000 Rome Italy ATP World Tour Masters 1000,CLAY,2,Stanislas Wawrinka,Filippo Volandri,Stanislas Wawrinka,6-1; 3-6; 6-2,R32,114,4,5,66,91,39,66,10,25,8,12,12,49,91,0,4,46,69,26,46,9,23,5,12,12,35,69
2011-05-08 00:00:00.000,ATP World Tour Masters 1000 Rome Italy ATP World Tour Masters 1000,CLAY,2,Novak Djokovic,Lukasz Kubot,Novak Djokovic,6-0; 6-3,R32,67,0,0,30,43,23,30,10,13,0,0,8,33,43,1,3,33,50,19,33,4,17,1,5,7,23,50
2011-05-08 00:00:00.000,ATP World Tour Masters 1000 Rome Italy ATP World Tour Masters 1000,CLAY,2,Rafael Nadal,Feliciano Lopez,Rafael Nadal,6-4; 6-2,R16,76,3,0,36,41,29,36,5,5,1,2,9,34,41,3,0,38,57,21,38,10,19,2,6,9,31,57
2011-05-08 00:00:00.000,ATP World Tour Masters 1000 Rome Italy ATP World Tour Masters 1000,CLAY,2,Marin Cilic,Mardy Fish,Marin Cilic,7-6(6); 6-3,R16,114,6,4,37,80,27,37,30,43,1,1,11,57,80,10,0,43,63,32,43,14,20,0,1,10,46,63
2011-05-08 00:00:00.000,ATP World Tour Masters 1000 Rome Italy ATP World Tour Masters 1000,CLAY,2,Richard Gasquet,Roger Federer,Richard Gasquet,4-6; 7-6(2); 7-6(4),R16,140,6,2,79,106,52,79,20,27,3,6,17,72,106,8,2,59,93,49,59,19,34,1,3,17,68,93
2011-05-08 00:00:00.000,ATP World Tour Masters 1000 Rome Italy ATP World Tour Masters 1000,CLAY,2,Tomas Berdych,Jarkko Nieminen,Tomas Berdych,6-2; 6-7(4); 6-2,R16,162,6,3,43,91,33,43,30,48,3,4,14,63,91,2,4,67,118,41,67,23,51,9,14,14,64,118
2011-05-08 00:00:00.000,ATP World Tour Masters 1000 Rome Italy ATP World Tour Masters 1000,CLAY,2,Florian Mayer,Juan Ignacio Chela,Florian Mayer,7-5; 6-4,R16,111,2,2,56,82,39,56,12,26,9,11,11,51,82,3,3,50,74,31,50,10,24,7,11,11,41,74
2011-05-08 00:00:00.000,ATP World Tour Masters 1000 Rome Italy ATP World Tour Masters 1000,CLAY,2,Andy Murray,Potito Starace,Andy Murray,6-2; 6-3,R16,67,3,1,32,45,26,32,8,13,0,1,9,34,45,0,1,41,49,24,41,1,8,5,9,8,25,49
2011-05-08 00:00:00.000,ATP World Tour Masters 1000 Rome Italy ATP World Tour Masters 1000,CLAY,2,Robin Soderling,Nicolas Almagro,Robin Soderling,6-3; 3-6; 6-4,R16,126,3,2,53,83,39,53,18,30,4,6,14,57,83,10,0,40,82,26,40,27,42,2,5,14,53,82
2011-05-08 00:00:00.000,ATP World Tour Masters 1000 Rome Italy ATP World Tour Masters 1000,CLAY,2,Novak Djokovic,Stanislas Wawrinka,Novak Djokovic,6-4; 6-1,R16,94,2,0,37,61,27,37,15,24,6,6,9,42,61,4,0,44,56,26,44,5,12,6,9,8,31,56
2011-05-08 00:00:00.000,ATP World Tour Masters 1000 Rome Italy ATP World Tour Masters 1000,CLAY,2,Rafael Nadal,Marin Cilic,Rafael Nadal,6-1; 6-3,Q,86,2,0,31,45,25,31,9,14,0,0,8,34,45,3,0,31,53,18,31,8,22,3,7,8,26,53
2011-05-08 00:00:00.000,ATP World Tour Masters 1000 Rome Italy ATP World Tour Masters 1000,CLAY,2,Richard Gasquet,Tomas Berdych,Richard Gasquet,4-6; 6-2; 6-4,Q,138,8,0,64,90,45,64,14,26,5,7,14,59,90,3,1,53,81,36,53,14,28,3,7,14,50,81
2011-05-08 00:00:00.000,ATP World Tour Masters 1000 Rome Italy ATP World Tour Masters 1000,CLAY,2,Andy Murray,Florian Mayer,Andy Murray,1-6; 6-1; 6-1,Q,96,1,1,36,66,22,36,16,30,3,7,11,38,66,0,1,43,62,22,43,5,19,7,13,10,27,62
2011-05-08 00:00:00.000,ATP World Tour Masters 1000 Rome Italy ATP World Tour Masters 1000,CLAY,2,Novak Djokovic,Robin Soderling,Novak Djokovic,6-3; 6-0,Q,77,4,1,31,50,20,31,13,19,3,4,8,33,50,2,1,30,46,16,30,3,16,4,9,7,19,46
2011-05-08 00:00:00.000,ATP World Tour Masters 1000 Rome Italy ATP World Tour Masters 1000,CLAY,2,Rafael Nadal,Richard Gasquet,Rafael Nadal,7-5; 6-1,S,94,4,0,40,54,31,40,8,14,4,4,9,39,54,1,1,32,56,19,32,11,24,1,5,10,30,56
2011-05-08 00:00:00.000,ATP World Tour Masters 1000 Rome Italy ATP World Tour Masters 1000,CLAY,2,Novak Djokovic,Andy Murray,Novak Djokovic,6-1; 3-6; 7-6(2),S,182,4,2,66,96,44,66,14,30,5,10,14,58,96,6,4,62,98,40,62,13,36,7,13,14,53,98
2011-05-08 00:00:00.000,ATP World Tour Masters 1000 Rome Italy ATP World Tour Masters 1000,CLAY,2,Novak Djokovic,Rafael Nadal,Novak Djokovic,6-4; 6-4,F,133,0,1,46,61,31,46,7,15,1,3,10,38,61,2,1,49,69,33,49,5,20,7,11,10,38,69
2011-05-15 00:00:00.000,Nice France ATP World Tour 250,CLAY,2,David Ferrer,N/A Bye,David Ferrer,,R32,0,0,0,0,0,0,0,0,0,0,0,0,0,0,0,0,0,0,0,0,0,0,0,0,0,0,0
2011-05-15 00:00:00.000,Nice France ATP World Tour 250,CLAY,2,Andreas Seppi,Edouard Roger-Vasselin,Andreas Seppi,3-6; 6-3; 6-2,R32,112,7,2,49,76,37,49,16,27,3,4,13,53,76,9,4,51,96,37,51,19,45,6,9,13,56,96
2011-05-15 00:00:00.000,Nice France ATP World Tour 250,CLAY,2,Pere Riba,Guillaume Rufin,Pere Riba,6-2; 6-2,R32,70,5,1,22,39,17,22,8,17,1,3,8,25,39,0,4,23,52,12,23,9,29,1,7,8,21,52
2011-05-15 00:00:00.000,Nice France ATP World Tour 250,CLAY,2,Alexandr Dolgopolov,Filippo Volandri,Alexandr Dolgopolov,7-5; 6-3,R32,81,3,4,30,69,22,30,23,39,7,9,11,45,69,0,0,50,66,28,50,7,16,8,12,10,35,66
2011-05-15 00:00:00.000,Nice France ATP World Tour 250,CLAY,2,Michael Russell,N/A Bye,Michael Russell,,R32,0,0,0,0,0,0,0,0,0,0,0,0,0,0,0,0,0,0,0,0,0,0,0,0,0,0,0
2011-05-15 00:00:00.000,Nice France ATP World Tour 250,CLAY,2,Victor Hanescu,Benoit Paire,Victor Hanescu,6-0; 6-1,R32,55,2,1,28,48,17,28,16,20,6,6,7,33,48,1,5,16,43,8,16,9,27,4,9,6,17,43
2011-05-15 00:00:00.000,Nice France ATP World Tour 250,CLAY,2,Robin Haase,Yen-Hsun Lu,Robin Haase,6-3; 6-4,R32,84,5,2,32,54,25,32,11,22,2,4,10,36,54,1,3,41,70,24,41,13,29,8,12,9,37,70
2011-05-15 00:00:00.000,Nice France ATP World Tour 250,CLAY,2,Sergiy Stakhovsky,Teymuraz Gabashvili,Sergiy Stakhovsky,7-6(5); 6-3,R32,108,6,3,45,70,34,45,12,25,3,4,10,46,70,1,7,61,87,37,61,11,26,5,8,11,48,87
2011-05-15 00:00:00.000,Nice France ATP World Tour 250,CLAY,2,Julien Benneteau,Marcos Baghdatis,Julien Benneteau,7-6(3); 6-2,R32,95,1,3,49,71,35,49,12,22,2,3,10,47,71,3,1,30,62,21,30,14,32,1,4,10,35,62
2011-05-15 00:00:00.000,Nice France ATP World Tour 250,CLAY,2,Pablo Andujar,Grigor Dimitrov,Pablo Andujar,5-0 RET,R32,19,2,0,5,11,4,5,4,6,0,0,2,8,11,0,0,10,18,4,10,1,8,1,4,3,5,18
2011-05-15 00:00:00.000,Nice France ATP World Tour 250,CLAY,2,Carlos Berlocq,Andreas Haider-Maurer,Carlos Berlocq,5-7; 6-3; 6-0,R32,125,3,0,41,70,28,41,21,29,4,6,13,49,70,3,4,42,86,26,42,22,44,4,10,14,48,86
2011-05-15 00:00:00.000,Nice France ATP World Tour 250,CLAY,2,Nicolas Almagro,N/A Bye,Nicolas Almagro,,R32,0,0,0,0,0,0,0,0,0,0,0,0,0,0,0,0,0,0,0,0,0,0,0,0,0,0,0
2011-05-15 00:00:00.000,Nice France ATP World Tour 250,CLAY,2,Ernests Gulbis,Fabio Fognini,Ernests Gulbis,3-6; 6-3; 6-3,R32,118,5,4,45,88,36,45,20,43,9,11,13,56,88,6,4,51,78,37,51,11,27,5,9,14,48,78
2011-05-15 00:00:00.000,Nice France ATP World Tour 250,CLAY,2,Denis Istomin,Olivier Rochus,Denis Istomin,6-2; 7-6(5),R32,100,10,4,43,72,32,43,13,29,3,5,10,45,72,0,3,39,71,23,39,15,32,4,8,10,38,71
2011-05-15 00:00:00.000,Nice France ATP World Tour 250,CLAY,2,Adrian Mannarino,Somdev Devvarman,Adrian Mannarino,6-3; 7-6(7),R32,116,2,1,45,92,29,45,28,47,5,7,11,57,92,2,1,36,66,25,36,16,30,4,7,10,41,66
2011-05-15 00:00:00.000,Nice France ATP World Tour 250,CLAY,2,Tomas Berdych,N/A Bye,Tomas Berdych,,R32,0,0,0,0,0,0,0,0,0,0,0,0,0,0,0,0,0,0,0,0,0,0,0,0,0,0,0
2011-05-15 00:00:00.000,Nice France ATP World Tour 250,CLAY,2,David Ferrer,Andreas Seppi,David Ferrer,6-3; 6-2,R16,71,6,2,23,45,22,23,14,22,0,0,9,36,45,2,2,26,55,21,26,10,29,6,9,8,31,55
2011-05-15 00:00:00.000,Nice France ATP World Tour 250,CLAY,2,Alexandr Dolgopolov,Pere Riba,Alexandr Dolgopolov,7-6(5); 7-6(5),R16,105,8,1,43,84,35,43,21,41,1,3,12,56,84,5,2,43,82,31,43,23,39,3,5,12,54,82
2011-05-15 00:00:00.000,Nice France ATP World Tour 250,CLAY,2,Victor Hanescu,Michael Russell,Victor Hanescu,7-5; 6-2,R16,76,4,2,40,53,35,40,5,13,0,1,10,40,53,1,4,36,56,22,36,8,20,2,6,10,30,56
2011-05-15 00:00:00.000,Nice France ATP World Tour 250,CLAY,2,Robin Haase,Sergiy Stakhovsky,Robin Haase,6-2; 6-4,R16,83,4,1,28,49,21,28,7,21,3,6,9,28,49,4,2,37,58,18,37,8,21,4,10,9,26,58
2011-05-15 00:00:00.000,Nice France ATP World Tour 250,CLAY,2,Pablo Andujar,Julien Benneteau,Pablo Andujar,6-3; 6-4,R16,90,3,1,42,69,31,42,16,27,3,3,10,47,69,4,3,32,49,21,32,11,17,2,4,9,32,49
2011-05-15 00:00:00.000,Nice France ATP World Tour 250,CLAY,2,Nicolas Almagro,Carlos Berlocq,Nicolas Almagro,6-7(5); 6-4; 6-3,R16,143,5,6,53,92,41,53,17,39,4,6,15,58,92,2,5,52,96,37,52,19,44,3,8,16,56,96
2011-05-15 00:00:00.000,Nice France ATP World Tour 250,CLAY,2,Ernests Gulbis,Denis Istomin,Ernests Gulbis,6-3; 4-6; 6-3,R16,125,3,2,47,85,36,47,24,38,2,3,14,60,85,9,3,61,94,43,61,14,33,5,8,14,57,94
2011-05-15 00:00:00.000,Nice France ATP World Tour 250,CLAY,2,Tomas Berdych,Adrian Mannarino,Tomas Berdych,6-1; 6-4,R16,64,3,2,35,49,28,35,10,14,1,1,9,38,49,2,2,29,47,18,29,8,18,2,5,8,26,47
2011-05-15 00:00:00.000,Nice France ATP World Tour 250,CLAY,2,Alexandr Dolgopolov,David Ferrer,Alexandr Dolgopolov,6-4; 1-6; 7-5,Q,112,6,3,46,88,30,46,25,42,3,7,14,55,88,2,3,52,83,34,52,20,31,5,9,15,54,83
2011-05-15 00:00:00.000,Nice France ATP World Tour 250,CLAY,2,Victor Hanescu,Robin Haase,Victor Hanescu,6-2; 2-0 RET,Q,56,2,0,21,29,18,21,3,8,0,0,5,21,29,3,2,33,49,18,33,5,16,6,9,5,23,49
2011-05-15 00:00:00.000,Nice France ATP World Tour 250,CLAY,2,Nicolas Almagro,Pablo Andujar,Nicolas Almagro,6-1; 6-4,Q,82,6,3,30,59,23,30,14,29,6,7,8,37,59,1,1,39,63,20,39,10,24,3,8,9,30,63
2011-05-15 00:00:00.000,Nice France ATP World Tour 250,CLAY,2,Tomas Berdych,Ernests Gulbis,Tomas Berdych,6-1; 6-4,Q,84,5,0,27,45,21,27,13,18,0,1,9,34,45,2,1,41,67,27,41,7,26,10,14,8,34,67
2011-05-15 00:00:00.000,Nice France ATP World Tour 250,CLAY,2,Victor Hanescu,Alexandr Dolgopolov,Victor Hanescu,6-3; 6-3,S,73,0,2,42,60,32,42,8,18,3,4,9,40,60,3,0,34,57,24,34,5,23,4,8,9,29,57
2011-05-15 00:00:00.000,Nice France ATP World Tour 250,CLAY,2,Nicolas Almagro,Tomas Berdych,Nicolas Almagro,6-4; 6-4,S,88,6,1,27,55,24,27,15,28,2,3,10,39,55,5,1,38,60,23,38,13,22,0,3,10,36,60
2011-05-15 00:00:00.000,Nice France ATP World Tour 250,CLAY,2,Nicolas Almagro,Victor Hanescu,Nicolas Almagro,6-7(5); 6-3; 6-3,F,139,10,4,42,88,31,42,23,46,4,8,15,54,88,2,1,72,106,42,72,15,34,9,16,15,57,106
2011-05-22 00:00:00.000,Roland Garros France Grand Slams,CLAY,3,Rafael Nadal,John Isner,Rafael Nadal,6-4; 6-7(2); 6-7(2); 6-2; 6-4,R128,241,8,1,97,134,79,97,26,37,0,1,26,105,134,13,3,112,165,76,112,31,53,10,15,26,107,165
2011-05-22 00:00:00.000,Roland Garros France Grand Slams,CLAY,3,Pablo Andujar,Santiago Giraldo,Pablo Andujar,7-6(5); 6-3; 6-3,R128,156,6,0,76,117,50,76,22,41,13,15,15,72,117,1,1,62,100,42,62,15,38,9,14,15,57,100
2011-05-22 00:00:00.000,Roland Garros France Grand Slams,CLAY,3,Antonio Veic,Pablo Cuevas,Antonio Veic,4-6; 6-3; 6-2; 3-1 RET,R128,117,11,3,58,89,45,58,19,31,6,8,16,64,89,10,2,47,89,28,47,21,42,1,6,15,49,89
2011-05-22 00:00:00.000,Roland Garros France Grand Slams,CLAY,3,Nikolay Davydenko,Denis Gremelmayr,Nikolay Davydenko,7-6(2); 6-1; 6-3,R128,129,4,3,70,101,49,70,20,31,9,10,14,69,101,0,0,48,84,28,48,20,36,7,12,14,48,84
2011-05-22 00:00:00.000,Roland Garros France Grand Slams,CLAY,3,Sam Querrey,Philipp Kohlschreiber,Sam Querrey,3-6; 6-1; 6-2; 6-4,R128,125,12,5,53,102,38,53,33,49,4,5,17,71,102,7,4,59,104,43,59,21,45,8,13,17,64,104
2011-05-22 00:00:00.000,Roland Garros France Grand Slams,CLAY,3,Ivan Ljubicic,Somdev Devvarman,Ivan Ljubicic,6-4; 6-3; 6-4,R128,122,10,0,51,84,39,51,23,33,3,4,15,62,84,4,1,59,93,40,59,16,34,5,9,14,56,93
2011-05-22 00:00:00.000,Roland Garros France Grand Slams,CLAY,3,Xavier Malisse,Dmitry Tursunov,Xavier Malisse,7-5; 3-6; 6-3; 3-6; 6-1,R128,180,15,2,85,142,64,85,26,57,6,10,23,90,142,11,5,93,145,59,93,28,52,7,13,23,87,145
2011-05-22 00:00:00.000,Roland Garros France Grand Slams,CLAY,3,Fernando Verdasco,Juan Monaco,Fernando Verdasco,6-2; 7-5; 4-6; 6-4,R128,207,7,9,86,140,65,86,24,54,8,11,20,89,140,0,2,75,126,41,75,31,51,6,12,20,72,126
2011-05-22 00:00:00.000,Roland Garros France Grand Slams,CLAY,3,Mardy Fish,Ricardo Mello,Mardy Fish,6-2; 6-7(11); 6-2; 6-4,R128,185,12,2,64,113,50,64,26,49,0,2,19,76,113,3,4,81,143,52,81,28,62,18,25,19,80,143
2011-05-22 00:00:00.000,Roland Garros France Grand Slams,CLAY,3,Robin Haase,Daniel Gimeno-Traver,Robin Haase,6-2; 7-6(3); 6-3,R128,115,7,1,64,95,51,64,17,31,5,6,15,68,95,3,3,60,101,39,60,22,41,9,13,14,61,101
2011-05-22 00:00:00.000,Roland Garros France Grand Slams,CLAY,3,Jeremy Chardy,Grigor Dimitrov,Jeremy Chardy,6-2; 6-4; 6-4,R128,95,4,4,43,75,36,43,19,32,1,2,14,55,75,4,6,42,73,28,42,16,31,2,7,14,44,73
2011-05-22 00:00:00.000,Roland Garros France Grand Slams,CLAY,3,Gilles Simon,Michael Russell,Gilles Simon,6-3; 4-6; 6-1; 6-0,R128,138,4,3,47,95,35,47,29,48,2,4,16,64,95,1,6,79,101,41,79,7,22,7,15,16,48,101
2011-05-22 00:00:00.000,Roland Garros France Grand Slams,CLAY,3,Marcos Baghdatis,Frederico Gil,Marcos Baghdatis,7-6(4); 6-2; 6-2,R128,144,8,1,60,102,47,60,23,42,9,10,14,70,102,1,3,65,113,43,65,19,48,10,15,14,62,113
2011-05-22 00:00:00.000,Roland Garros France Grand Slams,CLAY,3,Leonardo Mayer,Dustin Brown,Leonardo Mayer,3-6; 7-6(5); 6-2; 6-2,R128,154,6,3,75,115,52,75,27,40,4,6,18,79,115,5,4,64,126,48,64,29,62,5,10,19,77,126
2011-05-22 00:00:00.000,Roland Garros France Grand Slams,CLAY,3,Albert Ramos,Javier Marti,Albert Ramos,6-3; 6-7(5); 4-6; 6-1; 6-3,R128,267,9,7,113,187,67,113,38,74,20,28,24,105,187,3,11,132,178,74,132,15,46,19,31,23,89,178
2011-05-22 00:00:00.000,Roland Garros France Grand Slams,CLAY,3,Robin Soderling,Ryan Harrison,Robin Soderling,6-1; 6-7(5); 6-3; 7-5,R128,168,11,5,72,116,58,72,26,44,3,5,21,84,116,14,4,63,125,41,63,33,62,10,16,19,74,125
2011-05-22 00:00:00.000,Roland Garros France Grand Slams,CLAY,3,Andy Murray,Eric Prodon,Andy Murray,6-4; 6-1; 6-3,R128,104,12,2,45,77,39,45,14,32,3,5,13,53,77,0,3,47,80,23,47,16,33,4,11,13,39,80
2011-05-22 00:00:00.000,Roland Garros France Grand Slams,CLAY,3,Simone Bolelli,Frank Dancevic,Simone Bolelli,6-1; 6-3; 6-7(5); 6-2,R128,147,7,0,77,102,61,77,19,25,4,4,18,80,102,10,1,77,128,46,77,29,51,7,13,18,75,128
2011-05-22 00:00:00.000,Roland Garros France Grand Slams,CLAY,3,Arnaud Clement,Filippo Volandri,Arnaud Clement,6-3; 1-6; 7-6(9); 6-4,R128,201,6,4,64,126,50,64,27,62,3,8,19,77,126,3,3,97,134,65,97,17,37,6,11,19,82,134
2011-05-22 00:00:00.000,Roland Garros France Grand Slams,CLAY,3,Michael Berrer,Milos Raonic,Michael Berrer,6-4; 4-6; 6-3; 6-4,R128,150,5,2,74,119,53,74,29,45,6,8,20,82,119,7,4,57,101,40,57,27,44,1,5,19,67,101
2011-05-22 00:00:00.000,Roland Garros France Grand Slams,CLAY,3,Alexandr Dolgopolov,Rainer Schuettler,Alexandr Dolgopolov,6-3; 6-3; 6-1,R128,90,14,3,42,68,35,42,13,26,0,1,12,48,68,3,7,57,98,36,57,12,41,12,19,13,48,98
2011-05-22 00:00:00.000,Roland Garros France Grand Slams,CLAY,3,Andreas Haider-Maurer,Ryan Sweeting,Andreas Haider-Maurer,6-1; 6-7(5); 6-2; 6-0,R128,148,10,7,69,122,56,69,29,53,5,5,17,85,122,3,8,69,108,43,69,17,39,8,15,16,60,108
2011-05-22 00:00:00.000,Roland Garros France Grand Slams,CLAY,3,Tobias Kamke,Olivier Rochus,Tobias Kamke,6-7(5); 6-3; 6-3; 6-2,R128,171,14,2,69,131,47,69,33,62,6,9,19,80,131,5,4,79,123,52,79,16,44,10,18,19,68,123
2011-05-22 00:00:00.000,Roland Garros France Grand Slams,CLAY,3,Viktor Troicki,Julian Reister,Viktor Troicki,6-4; 6-3; 6-3,R128,114,20,1,53,86,46,53,15,33,6,7,14,61,86,1,0,58,88,35,58,15,30,5,10,14,50,88
2011-05-22 00:00:00.000,Roland Garros France Grand Slams,CLAY,3,Lukasz Kubot,Nicolas Almagro,Lukasz Kubot,3-6; 2-6; 7-6(3); 7-6(5); 6-4,R128,230,5,10,105,175,65,105,36,70,10,19,26,101,175,18,6,87,154,67,87,33,67,7,13,25,100,154
2011-05-22 00:00:00.000,Roland Garros France Grand Slams,CLAY,3,Carlos Berlocq,Bernard Tomic,Carlos Berlocq,7-5; 6-4; 6-2,R128,127,4,2,52,79,40,52,14,27,0,3,15,54,79,1,5,69,107,43,69,14,38,11,18,15,57,107
2011-05-22 00:00:00.000,Roland Garros France Grand Slams,CLAY,3,Alejandro Falla,Potito Starace,Alejandro Falla,7-6(2); 6-1; 6-1,R128,116,1,3,53,82,43,53,18,29,7,7,13,61,82,3,2,65,92,39,65,12,27,3,8,13,51,92
2011-05-22 00:00:00.000,Roland Garros France Grand Slams,CLAY,3,Florian Mayer,Igor Kunitsyn,Florian Mayer,6-3; 4-6; 6-4; 6-3,R128,177,6,1,72,129,52,72,24,57,7,12,19,76,129,2,0,76,129,46,76,25,53,7,15,19,71,129
2011-05-22 00:00:00.000,Roland Garros France Grand Slams,CLAY,3,Kevin Anderson,Nicolas Mahut,Kevin Anderson,6-4; 6-4; 6-7(6); 6-3,R128,186,22,3,80,123,64,80,25,43,5,7,21,89,123,9,6,111,154,74,111,21,43,12,17,20,95,154
2011-05-22 00:00:00.000,Roland Garros France Grand Slams,CLAY,3,Juan Ignacio Chela,Tim Smyczek,Juan Ignacio Chela,7-6(5); 6-1; 6-1,R128,104,1,2,63,78,45,63,7,15,2,5,13,52,78,0,1,57,85,24,57,14,28,5,13,13,38,85
2011-05-22 00:00:00.000,Roland Garros France Grand Slams,CLAY,3,Lukas Rosol,Edouard Roger-Vasselin,Lukas Rosol,3-6; 6-2; 6-4; 3-6; 7-5,R128,186,13,10,102,171,77,102,28,69,10,14,24,105,171,8,2,89,139,64,89,23,50,3,8,24,87,139
2011-05-22 00:00:00.000,Roland Garros France Grand Slams,CLAY,3,Jurgen Melzer,Andreas Beck,Jurgen Melzer,6-3; 6-4; 6-2,R128,118,6,2,48,84,35,48,23,36,7,8,14,58,84,2,3,55,85,34,55,13,30,6,11,13,47,85
2011-05-22 00:00:00.000,Roland Garros France Grand Slams,CLAY,3,David Ferrer,Jarkko Nieminen,David Ferrer,6-3; 6-3; 6-1,R128,85,4,0,42,61,37,42,15,19,0,0,13,52,61,3,2,46,72,27,46,13,26,5,10,12,40,72
2011-05-22 00:00:00.000,Roland Garros France Grand Slams,CLAY,3,Julien Benneteau,Rui Machado,Julien Benneteau,4-6; 6-1; 6-2; 6-0,R128,149,7,3,63,101,44,63,21,38,4,6,16,65,101,0,6,61,103,31,61,20,42,6,14,15,51,103
2011-05-22 00:00:00.000,Roland Garros France Grand Slams,CLAY,3,Kei Nishikori,Yen-Hsun Lu,Kei Nishikori,6-1; 6-3; 6-4,R128,145,1,5,71,106,46,71,16,35,12,15,13,62,106,0,6,72,115,39,72,15,43,21,29,13,54,115
2011-05-22 00:00:00.000,Roland Garros France Grand Slams,CLAY,3,Sergiy Stakhovsky,David Guez,Sergiy Stakhovsky,6-7(7); 6-3; 6-3; 6-3,R128,173,13,1,76,125,57,76,23,49,6,10,20,80,125,0,2,68,122,42,68,26,54,10,18,19,68,122
2011-05-22 00:00:00.000,Roland Garros France Grand Slams,CLAY,3,Steve Darcis,Michael Llodra,Steve Darcis,6-7(5); 6-3; 6-3; 6-3,R128,146,6,3,71,119,57,71,30,48,3,4,20,87,119,11,6,75,117,56,75,20,42,7,12,19,76,117
2011-05-22 00:00:00.000,Roland Garros France Grand Slams,CLAY,3,Philipp Petzschner,Mischa Zverev,Philipp Petzschner,7-6(3); 6-0; 6-4,R128,103,12,1,59,89,46,59,20,30,3,3,14,66,89,1,3,58,95,35,58,19,37,4,8,14,54,95
2011-05-22 00:00:00.000,Roland Garros France Grand Slams,CLAY,3,Guillaume Rufin,Adrian Mannarino,Guillaume Rufin,6-2; 6-3; 6-2,R128,91,11,2,40,67,33,40,18,27,1,2,13,51,67,2,1,47,72,28,47,10,25,4,10,12,38,72
2011-05-22 00:00:00.000,Roland Garros France Grand Slams,CLAY,3,Gael Monfils,Bjorn Phau,Gael Monfils,4-6; 6-3; 7-5; 6-0,R128,137,5,1,52,96,42,52,29,44,2,4,19,71,96,3,5,60,112,37,60,26,52,7,13,18,63,112
2011-05-22 00:00:00.000,Roland Garros France Grand Slams,CLAY,3,Stanislas Wawrinka,Augustin Gensse,Stanislas Wawrinka,4-6; 6-3; 6-4; 6-2,R128,147,6,4,76,120,55,76,27,44,7,9,19,82,120,0,2,81,108,54,81,9,27,5,10,18,63,108
2011-05-22 00:00:00.000,Roland Garros France Grand Slams,CLAY,3,Thomas Schoorel,Maximo Gonzalez,Thomas Schoorel,7-6(5); 6-3; 6-3,R128,143,9,2,61,92,45,61,22,31,2,2,15,67,92,2,0,81,103,49,81,15,22,7,10,15,64,103
2011-05-22 00:00:00.000,Roland Garros France Grand Slams,CLAY,3,Igor Andreev,Florent Serra,Igor Andreev,6-4; 6-1; 6-3,R128,92,6,0,39,63,33,39,14,24,2,4,13,47,63,3,1,51,92,32,51,13,41,4,11,13,45,92
2011-05-22 00:00:00.000,Roland Garros France Grand Slams,CLAY,3,Jo-Wilfried Tsonga,Jan Hajek,Jo-Wilfried Tsonga,6-3; 6-2; 6-2,R128,118,8,1,48,82,35,48,22,34,2,2,13,57,82,3,1,46,72,28,46,12,26,3,8,12,40,72
2011-05-22 00:00:00.000,Roland Garros France Grand Slams,CLAY,3,Janko Tipsarevic,Brian Dabul,Janko Tipsarevic,7-6(1); 6-1; 6-0,R128,125,9,2,44,85,35,44,21,41,1,3,13,56,85,2,9,45,80,24,45,12,35,5,12,12,36,80
2011-05-22 00:00:00.000,Roland Garros France Grand Slams,CLAY,3,Pere Riba,Ivan Dodig,Pere Riba,6-3; 3-6; 7-6(6); 6-4,R128,201,10,5,70,133,53,70,36,63,7,9,20,89,133,7,4,81,134,60,81,27,53,9,12,20,87,134
2011-05-22 00:00:00.000,Roland Garros France Grand Slams,CLAY,3,Maxime Teixeira,Vincent Millot,Maxime Teixeira,6-2; 5-7; 6-7(4); 6-4; 6-1,R128,232,5,1,138,182,84,138,21,44,12,19,25,105,182,2,6,93,172,60,93,29,79,8,19,24,89,172
2011-05-22 00:00:00.000,Roland Garros France Grand Slams,CLAY,3,Roger Federer,Feliciano Lopez,Roger Federer,6-3; 6-4; 7-6(3),R128,119,12,0,56,89,48,56,20,33,0,0,16,68,89,7,3,63,99,41,63,22,36,7,9,15,63,99
2011-05-22 00:00:00.000,Roland Garros France Grand Slams,CLAY,3,Stephane Robert,Tomas Berdych,Stephane Robert,3-6; 3-6; 6-2; 6-2; 9-7,R128,203,12,6,82,153,63,82,31,71,7,12,25,94,153,16,3,93,155,72,93,23,62,13,20,25,95,155
2011-05-22 00:00:00.000,Roland Garros France Grand Slams,CLAY,3,Fabio Fognini,Denis Istomin,Fabio Fognini,6-4; 6-2; 6-2,R128,103,1,7,45,83,35,45,18,38,6,8,13,53,83,1,3,45,79,26,45,14,34,3,10,13,40,79
2011-05-22 00:00:00.000,Roland Garros France Grand Slams,CLAY,3,Marsel Ilhan,Tommy Haas,Marsel Ilhan,6-4; 4-6; 7-6(1); 6-4,R128,177,25,1,79,116,65,79,17,37,4,8,21,82,116,15,7,82,137,55,82,28,55,10,15,21,83,137
2011-05-22 00:00:00.000,Roland Garros France Grand Slams,CLAY,3,Guillermo Garcia-Lopez,Robert Kendrick,Guillermo Garcia-Lopez,6-1; 7-5; 4-6; 6-3,R128,148,4,6,54,109,37,54,38,55,6,8,19,75,109,10,4,70,119,47,70,22,49,5,11,19,69,119
2011-05-22 00:00:00.000,Roland Garros France Grand Slams,CLAY,3,Ruben Ramirez Hidalgo,Marin Cilic,Ruben Ramirez Hidalgo,7-6(5); 6-4; 6-4,R128,173,1,3,61,109,44,61,24,48,3,6,16,68,109,9,1,62,112,44,62,19,50,6,11,16,63,112
2011-05-22 00:00:00.000,Roland Garros France Grand Slams,CLAY,3,Albert Montanes,Marc Gicquel,Albert Montanes,6-4; 6-4; 6-2,R128,105,10,2,47,89,37,47,24,42,2,3,14,61,89,1,3,38,78,24,38,21,40,3,8,14,45,78
2011-05-22 00:00:00.000,Roland Garros France Grand Slams,CLAY,3,Mikhail Kukushkin,Daniel Brands,Mikhail Kukushkin,6-2; 6-4; 6-4,R128,116,4,0,59,82,44,59,17,23,6,6,14,61,82,4,3,58,88,40,58,14,30,5,9,14,54,88
2011-05-22 00:00:00.000,Roland Garros France Grand Slams,CLAY,3,Mikhail Youzhny,Go Soeda,Mikhail Youzhny,7-5; 6-2; 6-4,R128,142,2,4,60,100,41,60,23,40,7,9,15,64,100,1,5,57,95,36,57,14,38,5,11,15,50,95
2011-05-22 00:00:00.000,Roland Garros France Grand Slams,CLAY,3,Richard Gasquet,Radek Stepanek,Richard Gasquet,7-5; 6-3; 6-0,R128,123,6,2,64,98,49,64,18,34,5,5,14,67,98,3,2,49,78,32,49,11,29,3,8,13,43,78
2011-05-22 00:00:00.000,Roland Garros France Grand Slams,CLAY,3,Marcel Granollers,Alex Bogomolov Jr.,Marcel Granollers,6-3; 3-6; 7-6(6); 6-2,R128,178,4,1,77,121,62,77,25,44,6,7,19,87,121,1,2,91,119,61,91,20,28,7,10,19,81,119
2011-05-22 00:00:00.000,Roland Garros France Grand Slams,CLAY,3,Andreas Seppi,Teymuraz Gabashvili,Andreas Seppi,6-3; 7-5; 7-5,R128,133,8,1,67,96,54,67,15,29,1,2,17,69,96,4,5,69,111,46,69,20,42,9,13,16,66,111
2011-05-22 00:00:00.000,Roland Garros France Grand Slams,CLAY,3,Thomaz Bellucci,Andrey Golubev,Thomaz Bellucci,6-4; 6-4; 6-7(4); 7-6(5),R128,199,7,2,78,129,63,78,33,51,3,5,22,96,129,10,7,98,151,73,98,26,53,7,11,22,99,151
2011-05-22 00:00:00.000,Roland Garros France Grand Slams,CLAY,3,Juan Martin Del Potro,Ivo Karlovic,Juan Martin Del Potro,6-7(7); 6-3; 7-5; 6-4,R128,193,11,4,85,128,70,85,29,43,5,5,22,99,128,22,4,99,147,79,99,20,48,13,16,21,99,147
2011-05-22 00:00:00.000,Roland Garros France Grand Slams,CLAY,3,Blaz Kavcic,Ernests Gulbis,Blaz Kavcic,6-1; 6-4; 6-2,R128,116,9,6,50,78,37,50,15,28,4,6,13,52,78,6,9,51,93,32,51,12,42,4,11,12,44,93
2011-05-22 00:00:00.000,Roland Garros France Grand Slams,CLAY,3,Victor Hanescu,Benoit Paire,Victor Hanescu,7-5; 4-6; 6-1; 7-6(4),R128,163,2,6,93,145,59,93,30,52,8,13,21,89,145,5,7,65,131,47,65,24,66,9,16,20,71,131
2011-05-22 00:00:00.000,Roland Garros France Grand Slams,CLAY,3,Novak Djokovic,Thiemo de Bakker,Novak Djokovic,6-2; 6-1; 6-3,R128,92,0,2,47,59,39,47,10,12,1,1,12,49,59,5,3,52,80,32,52,10,28,10,16,12,42,80
2011-05-22 00:00:00.000,Roland Garros France Grand Slams,CLAY,3,Rafael Nadal,Pablo Andujar,Rafael Nadal,7-5; 6-3; 7-6(4),R64,198,6,4,86,126,57,86,18,40,11,16,17,75,126,1,2,72,110,43,72,13,38,4,11,16,56,110
2011-05-22 00:00:00.000,Roland Garros France Grand Slams,CLAY,3,Antonio Veic,Nikolay Davydenko,Antonio Veic,3-6; 6-2; 7-5; 3-6; 6-1,R64,199,5,3,76,140,48,76,32,64,12,19,22,80,140,2,5,110,143,62,110,16,33,6,16,23,78,143
2011-05-22 00:00:00.000,Roland Garros France Grand Slams,CLAY,3,Ivan Ljubicic,Sam Querrey,Ivan Ljubicic,7-6(2); 6-4; 6-4,R64,125,11,0,50,94,45,50,25,44,1,1,16,70,94,8,2,47,90,31,47,31,43,1,3,16,62,90
2011-05-22 00:00:00.000,Roland Garros France Grand Slams,CLAY,3,Fernando Verdasco,Xavier Malisse,Fernando Verdasco,4-6; 6-3; 7-6(5); 6-1,R64,159,7,1,104,138,65,104,24,34,8,11,20,89,138,4,2,77,121,53,77,20,44,6,11,18,73,121
2011-05-22 00:00:00.000,Roland Garros France Grand Slams,CLAY,3,Mardy Fish,Robin Haase,Mardy Fish,7-6(1); 6-2; 6-1,R64,132,2,2,42,81,34,42,26,39,1,1,13,60,81,3,1,70,113,41,70,21,43,12,17,14,62,113
2011-05-22 00:00:00.000,Roland Garros France Grand Slams,CLAY,3,Gilles Simon,Jeremy Chardy,Gilles Simon,4-6; 6-4; 6-1; 6-4,R64,158,3,5,79,128,53,79,25,49,9,13,19,78,128,3,5,60,104,38,60,21,44,4,11,18,59,104
2011-05-22 00:00:00.000,Roland Garros France Grand Slams,CLAY,3,Leonardo Mayer,Marcos Baghdatis,Leonardo Mayer,7-5; 6-4; 7-6(6),R64,152,1,4,44,89,35,44,34,45,0,1,17,69,89,6,1,68,116,45,68,28,48,3,6,17,73,116
2011-05-22 00:00:00.000,Roland Garros France Grand Slams,CLAY,3,Robin Soderling,Albert Ramos,Robin Soderling,6-3; 6-4; 6-4,R64,116,7,7,48,82,40,48,20,34,0,1,15,60,82,8,2,57,89,38,57,17,32,3,7,14,55,89
2011-05-22 00:00:00.000,Roland Garros France Grand Slams,CLAY,3,Andy Murray,Simone Bolelli,Andy Murray,7-6(3); 6-4; 7-5,R64,171,10,7,72,109,50,72,18,37,9,13,17,68,109,2,1,68,103,38,68,18,35,8,14,17,56,103
2011-05-22 00:00:00.000,Roland Garros France Grand Slams,CLAY,3,Michael Berrer,Arnaud Clement,Michael Berrer,7-6(6); 3-6; 7-5; 6-4,R64,216,9,4,98,149,68,98,25,51,13,18,22,93,149,4,2,89,137,59,89,24,48,4,9,21,83,137
2011-05-22 00:00:00.000,Roland Garros France Grand Slams,CLAY,3,Alexandr Dolgopolov,Andreas Haider-Maurer,Alexandr Dolgopolov,6-2; 6-4; 6-2,R64,96,6,2,47,82,36,47,22,35,6,6,13,58,82,4,7,37,79,27,37,17,42,3,8,13,44,79
2011-05-22 00:00:00.000,Roland Garros France Grand Slams,CLAY,3,Viktor Troicki,Tobias Kamke,Viktor Troicki,6-2; 6-2; 7-6(4),R64,127,12,4,57,91,43,57,15,34,2,5,14,58,91,1,6,57,104,30,57,22,47,12,19,14,52,104
2011-05-22 00:00:00.000,Roland Garros France Grand Slams,CLAY,3,Lukasz Kubot,Carlos Berlocq,Lukasz Kubot,6-3; 7-6(4); 6-3,R64,169,5,7,71,108,54,71,18,37,6,9,16,72,108,2,5,63,95,39,63,15,32,1,6,14,54,95
2011-05-22 00:00:00.000,Roland Garros France Grand Slams,CLAY,3,Alejandro Falla,Florian Mayer,Alejandro Falla,4-6; 7-6(4); 6-1; 6-2,R64,178,4,3,81,129,57,81,24,48,8,11,19,81,129,6,3,80,142,52,80,26,62,8,14,18,78,142
2011-05-22 00:00:00.000,Roland Garros France Grand Slams,CLAY,3,Juan Ignacio Chela,Kevin Anderson,Juan Ignacio Chela,3-6; 6-3; 6-4; 4-6; 6-2,R64,201,3,1,133,147,90,133,8,14,13,16,23,98,147,12,3,104,150,66,104,27,46,11,16,23,93,150
2011-05-22 00:00:00.000,Roland Garros France Grand Slams,CLAY,3,Lukas Rosol,Jurgen Melzer,Lukas Rosol,6-7(4); 6-4; 4-6; 7-6(3); 6-4,R64,239,14,6,124,214,89,124,42,90,8,13,27,131,214,8,7,116,184,81,116,34,68,13,19,27,115,184
2011-05-22 00:00:00.000,Roland Garros France Grand Slams,CLAY,3,David Ferrer,Julien Benneteau,David Ferrer,6-3; 6-4; 6-2,R64,119,3,0,44,73,40,44,19,29,1,1,14,59,73,4,2,71,102,46,71,12,31,12,16,13,58,102
2011-05-22 00:00:00.000,Roland Garros France Grand Slams,CLAY,3,Sergiy Stakhovsky,Kei Nishikori,Sergiy Stakhovsky,6-1; 3-6; 6-3; 7-6(3),R64,168,9,2,69,114,50,69,27,45,2,5,19,77,114,1,7,83,130,50,83,24,47,7,12,18,74,130
2011-05-22 00:00:00.000,Roland Garros France Grand Slams,CLAY,3,Steve Darcis,Philipp Petzschner,Steve Darcis,7-5; 6-4; 6-4,R64,116,4,2,51,91,37,51,28,40,4,5,16,65,91,7,2,55,93,41,55,17,38,6,10,16,58,93
2011-05-22 00:00:00.000,Roland Garros France Grand Slams,CLAY,3,Gael Monfils,Guillaume Rufin,Gael Monfils,6-3; 1-6; 6-1; 6-3,R64,158,2,3,53,102,37,53,31,49,6,8,16,68,102,7,11,60,131,42,60,30,71,15,20,16,72,131
2011-05-22 00:00:00.000,Roland Garros France Grand Slams,CLAY,3,Stanislas Wawrinka,Thomas Schoorel,Stanislas Wawrinka,6-3; 6-2; 6-4,R64,98,10,3,51,88,39,51,23,37,3,3,14,62,88,4,1,53,80,35,53,12,27,5,9,13,47,80
2011-05-22 00:00:00.000,Roland Garros France Grand Slams,CLAY,3,Jo-Wilfried Tsonga,Igor Andreev,Jo-Wilfried Tsonga,6-3; 7-6(4); 6-3,R64,156,12,4,61,105,52,61,24,44,3,4,16,76,105,2,1,56,97,38,56,25,41,4,7,14,63,97
2011-05-22 00:00:00.000,Roland Garros France Grand Slams,CLAY,3,Janko Tipsarevic,Pere Riba,Janko Tipsarevic,6-1; 6-3; 6-0,R64,82,6,1,36,58,30,36,13,22,1,2,11,43,58,4,3,31,63,15,31,12,32,4,12,11,27,63
2011-05-22 00:00:00.000,Roland Garros France Grand Slams,CLAY,3,Roger Federer,Maxime Teixeira,Roger Federer,6-3; 6-0; 6-2,R64,84,7,0,44,63,36,44,12,19,0,1,12,48,63,0,3,39,73,20,39,14,34,6,13,11,34,73
2011-05-22 00:00:00.000,Roland Garros France Grand Slams,CLAY,3,Fabio Fognini,Stephane Robert,Fabio Fognini,6-2; 6-1; 6-0,R64,69,2,1,41,54,36,41,8,13,0,0,11,44,54,0,5,27,66,15,27,13,39,9,16,10,28,66
2011-05-22 00:00:00.000,Roland Garros France Grand Slams,CLAY,3,Guillermo Garcia-Lopez,Marsel Ilhan,Guillermo Garcia-Lopez,6-4; 1-6; 6-2; 4-6; 13-11,R64,238,13,17,95,171,77,95,38,76,10,14,29,115,171,24,3,103,176,83,103,34,73,9,14,30,117,176
2011-05-22 00:00:00.000,Roland Garros France Grand Slams,CLAY,3,Albert Montanes,Ruben Ramirez Hidalgo,Albert Montanes,6-7(5); 6-4; 6-1; 6-2,R64,190,13,8,61,113,49,61,28,52,6,9,19,77,113,8,8,85,141,55,85,19,56,11,19,18,74,141
2011-05-22 00:00:00.000,Roland Garros France Grand Slams,CLAY,3,Mikhail Youzhny,Mikhail Kukushkin,Mikhail Youzhny,6-3; 7-5; 6-4,R64,165,4,3,55,93,45,55,20,38,6,7,16,65,93,5,1,54,107,32,54,30,53,9,13,15,62,107
2011-05-22 00:00:00.000,Roland Garros France Grand Slams,CLAY,3,Richard Gasquet,Marcel Granollers,Richard Gasquet,4-6; 6-3; 6-2; 6-4,R64,179,4,2,62,106,47,62,28,44,3,5,19,75,106,3,2,86,127,53,86,21,41,10,15,18,74,127
2011-05-22 00:00:00.000,Roland Garros France Grand Slams,CLAY,3,Thomaz Bellucci,Andreas Seppi,Thomaz Bellucci,6-1; 6-2; 6-4,R64,90,10,2,40,67,35,40,19,27,2,2,13,54,67,3,4,37,71,23,37,14,34,0,5,12,37,71
2011-05-22 00:00:00.000,Roland Garros France Grand Slams,CLAY,3,Juan Martin Del Potro,Blaz Kavcic,Juan Martin Del Potro,6-3; 6-2; 6-4,R64,132,3,5,50,84,38,50,14,34,4,7,14,52,84,5,4,48,80,30,48,10,32,5,12,13,40,80
2011-05-22 00:00:00.000,Roland Garros France Grand Slams,CLAY,3,Novak Djokovic,Victor Hanescu,Novak Djokovic,6-4; 6-1; 2-3 RET,R64,89,2,0,40,54,35,40,11,14,0,0,11,46,54,3,0,46,74,29,46,15,28,5,8,11,44,74
2011-05-22 00:00:00.000,Roland Garros France Grand Slams,CLAY,3,Rafael Nadal,Antonio Veic,Rafael Nadal,6-1; 6-3; 6-0,R32,101,1,0,48,66,30,48,14,18,3,5,11,44,66,0,1,33,56,11,33,5,23,1,10,11,16,56
2011-05-22 00:00:00.000,Roland Garros France Grand Slams,CLAY,3,Ivan Ljubicic,Fernando Verdasco,Ivan Ljubicic,6-3; 7-6(6); 6-4,R32,134,11,2,63,95,55,63,14,32,0,2,16,69,95,3,4,69,95,41,69,17,26,3,7,15,58,95
2011-05-22 00:00:00.000,Roland Garros France Grand Slams,CLAY,3,Gilles Simon,Mardy Fish,Gilles Simon,6-3; 6-4; 6-2,R32,120,2,1,48,86,36,48,21,38,5,6,14,57,86,3,2,40,73,26,40,16,33,4,9,13,42,73
2011-05-22 00:00:00.000,Roland Garros France Grand Slams,CLAY,3,Robin Soderling,Leonardo Mayer,Robin Soderling,6-1; 6-4; 6-3,R32,109,6,0,50,81,36,50,17,31,1,3,13,53,81,6,1,57,81,31,57,10,24,4,11,13,41,81
2011-05-22 00:00:00.000,Roland Garros France Grand Slams,CLAY,3,Andy Murray,Michael Berrer,Andy Murray,6-2; 6-3; 6-2,R32,127,7,0,53,79,41,53,11,26,1,2,13,52,79,1,5,57,91,32,57,15,34,14,20,12,47,91
2011-05-22 00:00:00.000,Roland Garros France Grand Slams,CLAY,3,Viktor Troicki,Alexandr Dolgopolov,Viktor Troicki,6-4; 3-6; 6-3; 6-4,R32,166,12,2,65,107,50,65,24,42,4,7,19,74,107,12,3,82,148,55,82,33,66,13,18,19,88,148
2011-05-22 00:00:00.000,Roland Garros France Grand Slams,CLAY,3,Alejandro Falla,Lukasz Kubot,Alejandro Falla,6-7(4); 6-4; 7-5; 6-4,R32,227,5,1,79,131,53,79,31,52,3,7,22,84,131,8,7,104,162,71,104,23,58,11,18,22,94,162
2011-05-22 00:00:00.000,Roland Garros France Grand Slams,CLAY,3,Juan Ignacio Chela,Lukas Rosol,Juan Ignacio Chela,6-2; 6-4; 3-6; 7-6(5),R32,155,5,1,88,120,55,88,19,32,9,14,19,74,120,11,2,78,134,48,78,28,56,10,17,20,76,134
2011-05-22 00:00:00.000,Roland Garros France Grand Slams,CLAY,3,David Ferrer,Sergiy Stakhovsky,David Ferrer,6-1; 6-1; 6-3,R32,96,2,0,45,67,36,45,15,22,2,2,12,51,67,2,3,40,72,25,40,10,32,1,7,11,35,72
2011-05-22 00:00:00.000,Roland Garros France Grand Slams,CLAY,3,Gael Monfils,Steve Darcis,Gael Monfils,6-3; 6-4; 7-5,R32,122,7,2,68,106,49,68,20,38,7,9,16,69,106,1,1,58,89,38,58,12,31,4,9,15,50,89
2011-05-22 00:00:00.000,Roland Garros France Grand Slams,CLAY,3,Stanislas Wawrinka,Jo-Wilfried Tsonga,Stanislas Wawrinka,4-6; 6-7(3); 7-6(5); 6-2; 6-3,R32,243,7,2,113,177,79,113,37,64,8,12,26,116,177,10,0,106,149,77,106,22,43,5,11,25,99,149
2011-05-22 00:00:00.000,Roland Garros France Grand Slams,CLAY,3,Roger Federer,Janko Tipsarevic,Roger Federer,6-1; 6-4; 6-3,R32,90,10,2,51,76,43,51,14,25,1,1,13,57,76,1,1,36,71,28,36,13,35,1,6,13,41,71
2011-05-22 00:00:00.000,Roland Garros France Grand Slams,CLAY,3,Fabio Fognini,Guillermo Garcia-Lopez,Fabio Fognini,4-6; 6-3; 6-3; 6-1,R32,144,11,7,62,103,47,62,20,41,2,6,18,67,103,3,5,69,109,38,69,20,40,6,14,17,58,109
2011-05-22 00:00:00.000,Roland Garros France Grand Slams,CLAY,3,Albert Montanes,Mikhail Youzhny,Albert Montanes,6-1; 7-6(0); 6-1,R32,138,5,3,51,99,34,51,30,48,9,11,14,64,99,2,6,45,79,25,45,13,34,1,7,12,38,79
2011-05-22 00:00:00.000,Roland Garros France Grand Slams,CLAY,3,Richard Gasquet,Thomaz Bellucci,Richard Gasquet,6-2; 6-3; 3-6; 6-3,R32,164,10,1,70,107,50,70,21,37,2,5,18,71,107,3,3,66,112,41,66,20,46,10,16,17,61,112
2011-05-22 00:00:00.000,Roland Garros France Grand Slams,CLAY,3,Novak Djokovic,Juan Martin Del Potro,Novak Djokovic,6-3; 3-6; 6-3; 6-2,R32,176,6,2,57,96,44,57,25,39,3,5,18,69,96,5,3,66,113,43,66,21,47,7,12,17,64,113
2011-05-22 00:00:00.000,Roland Garros France Grand Slams,CLAY,3,Rafael Nadal,Ivan Ljubicic,Rafael Nadal,7-5; 6-3; 6-3,R16,146,2,1,49,72,40,49,15,23,2,4,15,55,72,9,2,56,109,40,56,18,53,14,20,15,58,109
2011-05-22 00:00:00.000,Roland Garros France Grand Slams,CLAY,3,Robin Soderling,Gilles Simon,Robin Soderling,6-2; 6-3; 7-6(5),R16,136,4,5,54,99,41,54,25,45,6,7,14,66,99,6,4,53,90,36,53,18,37,3,8,15,54,90
2011-05-22 00:00:00.000,Roland Garros France Grand Slams,CLAY,3,Andy Murray,Viktor Troicki,Andy Murray,4-6; 4-6; 6-3; 6-2; 7-5,R16,236,12,1,85,150,65,85,27,65,6,13,25,92,150,4,3,111,174,67,111,28,63,14,23,24,95,174
2011-05-22 00:00:00.000,Roland Garros France Grand Slams,CLAY,3,Juan Ignacio Chela,Alejandro Falla,Juan Ignacio Chela,4-6; 6-2; 1-6; 7-6(5); 6-2,R16,235,2,4,100,161,65,100,24,61,11,20,22,89,161,7,1,89,152,47,89,33,63,9,19,23,80,152
2011-05-22 00:00:00.000,Roland Garros France Grand Slams,CLAY,3,Gael Monfils,David Ferrer,Gael Monfils,6-4; 2-6; 7-5; 1-6; 8-6,R16,247,11,5,86,147,62,86,27,61,2,10,25,89,147,5,5,107,182,74,107,32,75,15,22,26,106,182
2011-05-22 00:00:00.000,Roland Garros France Grand Slams,CLAY,3,Roger Federer,Stanislas Wawrinka,Roger Federer,6-3; 6-2; 7-5,R16,106,8,2,49,77,40,49,18,28,1,2,15,58,77,5,1,59,83,38,59,11,24,1,6,14,49,83
2011-05-22 00:00:00.000,Roland Garros France Grand Slams,CLAY,3,Fabio Fognini,Albert Montanes,Fabio Fognini,4-6; 6-4; 3-6; 6-3; 11-9,R16,262,7,9,112,201,79,112,48,89,14,19,29,127,201,7,7,90,176,63,90,51,86,10,16,29,114,176
2011-05-22 00:00:00.000,Roland Garros France Grand Slams,CLAY,3,Novak Djokovic,Richard Gasquet,Novak Djokovic,6-4; 6-4; 6-2,R16,107,8,0,49,70,44,49,14,21,3,3,14,58,70,6,2,53,86,35,53,15,33,4,8,14,50,86
2011-05-22 00:00:00.000,Roland Garros France Grand Slams,CLAY,3,Rafael Nadal,Robin Soderling,Rafael Nadal,6-4; 6-1; 7-6(3),Q,155,4,0,69,90,44,69,15,21,4,6,14,59,90,5,3,54,94,37,54,14,40,5,11,15,51,94
2011-05-22 00:00:00.000,Roland Garros France Grand Slams,CLAY,3,Andy Murray,Juan Ignacio Chela,Andy Murray,7-6(2); 7-5; 6-2,Q,173,9,4,61,118,41,61,29,57,12,17,16,70,118,2,5,73,115,40,73,16,42,8,16,16,56,115
2011-05-22 00:00:00.000,Roland Garros France Grand Slams,CLAY,3,Roger Federer,Gael Monfils,Roger Federer,6-4; 6-3; 7-6(3),Q,154,4,3,47,88,36,47,25,41,1,4,16,61,88,4,11,87,133,54,87,19,46,11,16,15,73,133
2011-05-22 00:00:00.000,Roland Garros France Grand Slams,CLAY,3,Novak Djokovic,Fabio Fognini,Novak Djokovic,W/O,Q,0,0,0,0,0,0,0,0,0,0,0,0,0,0,0,0,0,0,0,0,0,0,0,0,0,0,0
2011-05-22 00:00:00.000,Roland Garros France Grand Slams,CLAY,3,Rafael Nadal,Andy Murray,Rafael Nadal,6-4; 7-5; 6-4,S,197,2,3,87,119,60,87,14,32,15,18,16,74,119,5,4,67,104,44,67,13,37,7,13,16,57,104
2011-05-22 00:00:00.000,Roland Garros France Grand Slams,CLAY,3,Roger Federer,Novak Djokovic,Roger Federer,7-6(5); 6-3; 3-6; 7-6(5),S,219,18,2,91,141,70,91,25,50,9,13,21,95,141,7,2,112,168,67,112,34,56,21,25,21,101,168
2011-05-22 00:00:00.000,Roland Garros France Grand Slams,CLAY,3,Rafael Nadal,Roger Federer,Rafael Nadal,7-5; 7-6(3); 5-7; 6-1,F,220,4,3,106,147,69,106,21,41,10,15,22,90,147,11,1,80,126,55,80,18,46,8,15,21,73,126
2011-06-06 00:00:00.000,Halle Germany ATP World Tour 250,GRASS,2,Lleyton Hewitt,Leonardo Mayer,Lleyton Hewitt,6-2; 6-3,R32,69,6,2,32,53,25,32,14,21,3,3,9,39,53,2,1,30,51,18,30,11,21,1,4,8,29,51
2011-06-06 00:00:00.000,Halle Germany ATP World Tour 250,GRASS,2,Andreas Seppi,Tommy Haas,Andreas Seppi,6-2; 6-7(6); 6-3,R32,126,5,2,65,103,47,65,21,38,7,9,15,68,103,4,6,60,89,40,60,13,29,7,12,14,53,89
2011-06-06 00:00:00.000,Halle Germany ATP World Tour 250,GRASS,2,Philipp Kohlschreiber,Cedrik-Marcel Stebe,Philipp Kohlschreiber,6-4; 3-6; 6-1,R32,129,5,4,47,76,36,47,15,29,3,5,13,51,76,4,3,56,92,39,56,13,36,8,12,13,52,92
2011-06-06 00:00:00.000,Halle Germany ATP World Tour 250,GRASS,2,Alexandr Dolgopolov,Robin Haase,Alexandr Dolgopolov,6-7(4); 6-4; 6-4,R32,111,9,4,49,80,41,49,17,31,0,3,16,58,80,12,4,64,103,46,64,17,39,3,8,16,63,103
2011-06-06 00:00:00.000,Halle Germany ATP World Tour 250,GRASS,2,Gael Monfils,Florent Serra,Gael Monfils,6-4; 6-3,R32,57,14,2,29,48,26,29,12,19,0,0,9,38,48,2,0,45,63,32,45,7,18,4,7,10,39,63
2011-06-06 00:00:00.000,Halle Germany ATP World Tour 250,GRASS,2,Ivan Dodig,Pere Riba,Ivan Dodig,7-6(4); 7-6(6),R32,106,13,2,57,78,44,57,13,21,1,1,12,57,78,13,6,65,108,50,65,19,43,7,7,12,69,108
2011-06-06 00:00:00.000,Halle Germany ATP World Tour 250,GRASS,2,Yen-Hsun Lu,Jarkko Nieminen,Yen-Hsun Lu,7-6(2); 6-3,R32,91,4,2,55,75,40,55,14,20,0,0,11,54,75,6,1,37,63,27,37,14,26,2,3,10,41,63
2011-06-06 00:00:00.000,Halle Germany ATP World Tour 250,GRASS,2,Florian Mayer,Dustin Brown,Florian Mayer,7-6(6); 2-6; 6-3,R32,80,7,1,58,79,47,58,13,21,1,3,15,60,79,20,6,55,85,49,55,10,30,1,2,14,59,85
2011-06-06 00:00:00.000,Halle Germany ATP World Tour 250,GRASS,2,Milos Raonic,Pablo Andujar,Milos Raonic,6-3; 6-1,R32,66,12,2,25,42,22,25,11,17,0,0,8,33,42,2,2,33,61,20,33,12,28,3,7,8,32,61
2011-06-06 00:00:00.000,Halle Germany ATP World Tour 250,GRASS,2,Tobias Kamke,Julian Reister,Tobias Kamke,4-3 RET,R32,30,2,3,10,22,6,10,6,12,1,2,3,12,22,0,3,15,26,9,15,4,11,2,4,4,13,26
2011-06-06 00:00:00.000,Halle Germany ATP World Tour 250,GRASS,2,Daniel Gimeno-Traver,Andrey Golubev,Daniel Gimeno-Traver,1-6; 7-6(5); 6-2,R32,113,10,3,44,72,35,44,17,28,2,4,13,52,72,1,3,46,88,30,46,26,42,5,7,14,56,88
2011-06-06 00:00:00.000,Halle Germany ATP World Tour 250,GRASS,2,Philipp Petzschner,Dominik Meffert,Philipp Petzschner,6-2; 7-6(5),R32,79,7,0,36,61,28,36,15,25,2,4,10,43,61,7,4,45,66,29,45,10,21,5,9,10,39,66
2011-06-06 00:00:00.000,Halle Germany ATP World Tour 250,GRASS,2,Viktor Troicki,Mischa Zverev,Viktor Troicki,6-2; 6-3,R32,52,4,3,36,54,28,36,12,18,3,3,9,40,54,1,0,31,43,18,31,8,12,0,3,8,26,43
2011-06-06 00:00:00.000,Halle Germany ATP World Tour 250,GRASS,2,Igor Andreev,Potito Starace,Igor Andreev,6-4; 6-4,R32,69,8,0,34,50,27,34,13,16,0,0,10,40,50,6,1,51,71,33,51,10,20,5,7,10,43,71
2011-06-06 00:00:00.000,Halle Germany ATP World Tour 250,GRASS,2,Jan Hernych,Sergiy Stakhovsky,Jan Hernych,6-3; 6-7(5); 7-6(8),R32,161,3,3,88,126,63,88,20,38,19,20,16,83,126,13,4,92,137,65,92,20,45,7,10,17,85,137
2011-06-06 00:00:00.000,Halle Germany ATP World Tour 250,GRASS,2,Tomas Berdych,Ruben Bemelmans,Tomas Berdych,5-7; 7-6(8); 6-4,R32,136,10,2,57,97,48,57,26,40,1,2,17,74,97,5,2,78,119,57,78,24,41,8,9,17,81,119
2011-06-06 00:00:00.000,Halle Germany ATP World Tour 250,GRASS,2,Lleyton Hewitt,Andreas Seppi,Lleyton Hewitt,6-4; 6-4,R16,81,3,2,32,56,27,32,12,24,1,2,10,39,56,9,0,36,60,27,36,9,24,1,4,10,36,60
2011-06-06 00:00:00.000,Halle Germany ATP World Tour 250,GRASS,2,Philipp Kohlschreiber,Alexandr Dolgopolov,Philipp Kohlschreiber,6-3; 7-6(5),R16,77,5,1,35,63,30,35,18,28,0,0,11,48,63,9,3,35,63,24,35,18,28,3,4,10,42,63
2011-06-06 00:00:00.000,Halle Germany ATP World Tour 250,GRASS,2,Gael Monfils,Ivan Dodig,Gael Monfils,6-2; 6-3,R16,52,2,2,25,40,21,25,9,15,1,2,8,30,40,1,1,32,52,18,32,8,20,0,5,9,26,52
2011-06-06 00:00:00.000,Halle Germany ATP World Tour 250,GRASS,2,Florian Mayer,Yen-Hsun Lu,Florian Mayer,7-6(4); 3-6; 6-4,R16,135,13,3,70,114,51,70,22,44,8,9,15,73,114,4,4,70,100,54,70,14,30,5,6,16,68,100
2011-06-06 00:00:00.000,Halle Germany ATP World Tour 250,GRASS,2,Milos Raonic,Tobias Kamke,Milos Raonic,7-6(2); 6-3,R16,72,14,0,42,56,38,42,11,14,1,1,11,49,56,3,1,31,55,24,31,16,24,0,1,10,40,55
2011-06-06 00:00:00.000,Halle Germany ATP World Tour 250,GRASS,2,Philipp Petzschner,Daniel Gimeno-Traver,Philipp Petzschner,6-2; 6-4,R16,72,7,0,32,52,24,32,13,20,2,3,9,37,52,4,2,44,63,26,44,7,19,3,7,9,33,63
2011-06-06 00:00:00.000,Halle Germany ATP World Tour 250,GRASS,2,Viktor Troicki,Igor Andreev,Viktor Troicki,6-3; 6-1,R16,53,5,4,24,42,19,24,10,18,1,2,8,29,42,1,4,27,46,13,27,7,19,1,6,8,20,46
2011-06-06 00:00:00.000,Halle Germany ATP World Tour 250,GRASS,2,Tomas Berdych,Jan Hernych,Tomas Berdych,6-3; 7-6(7),R16,107,11,1,54,87,40,54,17,33,6,7,11,57,87,6,0,64,88,39,64,13,24,8,10,10,52,88
2011-06-06 00:00:00.000,Halle Germany ATP World Tour 250,GRASS,2,Philipp Kohlschreiber,Lleyton Hewitt,Philipp Kohlschreiber,7-6(4); 6-3,Q,91,14,1,43,66,33,43,15,23,0,0,11,48,66,9,2,39,68,26,39,18,29,5,6,10,44,68
2011-06-06 00:00:00.000,Halle Germany ATP World Tour 250,GRASS,2,Gael Monfils,Florian Mayer,Gael Monfils,6-4; 6-4,Q,65,5,0,38,57,29,38,12,19,2,3,10,41,57,2,2,34,51,23,34,9,17,1,4,10,32,51
2011-06-06 00:00:00.000,Halle Germany ATP World Tour 250,GRASS,2,Philipp Petzschner,Milos Raonic,Philipp Petzschner,6-3; 6-7(6); 6-3,Q,114,8,3,60,99,49,60,24,39,3,3,16,73,99,8,4,61,94,46,61,17,33,5,7,14,63,94
2011-06-06 00:00:00.000,Halle Germany ATP World Tour 250,GRASS,2,Tomas Berdych,Viktor Troicki,Tomas Berdych,7-6(3); 6-1,Q,81,13,2,45,70,33,45,16,25,3,3,10,49,70,11,2,41,61,27,41,9,20,3,5,9,36,61
2011-06-06 00:00:00.000,Halle Germany ATP World Tour 250,GRASS,2,Philipp Kohlschreiber,Gael Monfils,Philipp Kohlschreiber,6-3; 6-3,S,78,1,2,27,52,24,27,13,25,0,0,9,37,52,0,6,39,64,22,39,14,25,5,8,9,36,64
2011-06-06 00:00:00.000,Halle Germany ATP World Tour 250,GRASS,2,Philipp Petzschner,Tomas Berdych,Philipp Petzschner,7-6(7); 2-6; 6-3,S,139,15,5,71,121,49,71,23,50,8,12,15,72,121,11,3,50,84,37,50,18,34,0,3,14,55,84
2011-06-06 00:00:00.000,Halle Germany ATP World Tour 250,GRASS,2,Philipp Kohlschreiber,Philipp Petzschner,Philipp Kohlschreiber,7-6(5); 2-0 RET,F,62,9,1,31,41,26,31,6,10,0,0,7,32,41,6,3,34,56,24,34,10,22,1,2,7,34,56
2011-06-06 00:00:00.000,London / Queen's Club Great Britain ATP World Tour 250,GRASS,2,Rafael Nadal,N/A Bye,Rafael Nadal,,R64,0,0,0,0,0,0,0,0,0,0,0,0,0,0,0,0,0,0,0,0,0,0,0,0,0,0,0
2011-06-06 00:00:00.000,London / Queen's Club Great Britain ATP World Tour 250,GRASS,2,Matthew Ebden,Somdev Devvarman,Matthew Ebden,7-5; 6-3,R64,97,4,1,58,77,43,58,9,19,10,11,11,52,77,2,0,42,57,25,42,8,15,2,5,10,33,57
2011-06-06 00:00:00.000,London / Queen's Club Great Britain ATP World Tour 250,GRASS,2,Radek Stepanek,Go Soeda,Radek Stepanek,6-1; 6-3,R64,66,4,3,30,43,25,30,8,13,2,2,8,33,43,1,2,20,55,14,20,13,35,4,8,8,27,55
2011-06-06 00:00:00.000,London / Queen's Club Great Britain ATP World Tour 250,GRASS,2,Ivan Ljubicic,Ryan Sweeting,Ivan Ljubicic,7-6(6); 6-2,R64,74,11,1,37,58,28,37,14,21,0,1,10,42,58,4,5,42,66,27,42,11,24,2,5,10,38,66
2011-06-06 00:00:00.000,London / Queen's Club Great Britain ATP World Tour 250,GRASS,2,Michael Llodra,Jaroslav Pospisil,Michael Llodra,6-3; 6-2,R64,62,5,2,40,56,30,40,10,16,2,2,9,40,56,0,2,25,46,21,25,5,21,1,4,8,26,46
2011-06-06 00:00:00.000,London / Queen's Club Great Britain ATP World Tour 250,GRASS,2,Julien Benneteau,Daniel Brands,Julien Benneteau,6-7(6); 6-1; 6-4,R64,110,15,2,66,87,52,66,12,21,1,2,15,64,87,11,4,66,96,43,66,13,30,4,8,14,56,96
2011-06-06 00:00:00.000,London / Queen's Club Great Britain ATP World Tour 250,GRASS,2,Michael Berrer,Ryan Harrison,Michael Berrer,7-6(7); 2-6; 7-5,R64,142,3,4,83,116,63,83,14,33,6,8,16,77,116,7,4,66,109,50,66,25,43,6,7,16,75,109
2011-06-06 00:00:00.000,London / Queen's Club Great Britain ATP World Tour 250,GRASS,2,Jo-Wilfried Tsonga,N/A Bye,Jo-Wilfried Tsonga,,R64,0,0,0,0,0,0,0,0,0,0,0,0,0,0,0,0,0,0,0,0,0,0,0,0,0,0,0
2011-06-06 00:00:00.000,London / Queen's Club Great Britain ATP World Tour 250,GRASS,2,Stanislas Wawrinka,N/A Bye,Stanislas Wawrinka,,R64,0,0,0,0,0,0,0,0,0,0,0,0,0,0,0,0,0,0,0,0,0,0,0,0,0,0,0
2011-06-06 00:00:00.000,London / Queen's Club Great Britain ATP World Tour 250,GRASS,2,James Ward,Daniel Cox,James Ward,6-3; 6-1,R64,61,8,1,26,41,21,26,12,15,0,0,8,33,41,2,4,33,59,18,33,12,26,3,7,8,30,59
2011-06-06 00:00:00.000,London / Queen's Club Great Britain ATP World Tour 250,GRASS,2,Rainer Schuettler,Bobby Reynolds,Rainer Schuettler,6-1; 6-1,R64,65,2,3,35,53,28,35,7,18,6,6,7,35,53,0,1,32,52,19,32,5,20,6,11,7,24,52
2011-06-06 00:00:00.000,London / Queen's Club Great Britain ATP World Tour 250,GRASS,2,Sam Querrey,Kei Nishikori,Sam Querrey,6-3; 6-4,R64,76,10,0,41,62,35,41,11,21,7,7,10,46,62,4,3,44,64,27,44,12,20,3,5,9,39,64
2011-06-06 00:00:00.000,London / Queen's Club Great Britain ATP World Tour 250,GRASS,2,Juan Martin Del Potro,Denis Istomin,Juan Martin Del Potro,6-4; 6-2,R64,82,5,1,33,47,27,33,9,14,0,1,9,36,47,6,2,50,68,26,50,9,18,5,9,9,35,68
2011-06-06 00:00:00.000,London / Queen's Club Great Britain ATP World Tour 250,GRASS,2,Igor Kunitsyn,Alex Bogomolov Jr.,Igor Kunitsyn,6-4; 6-6 RET,R64,100,7,0,38,69,27,38,22,31,5,6,11,49,69,3,0,66,82,38,66,10,16,9,11,11,48,82
2011-06-06 00:00:00.000,London / Queen's Club Great Britain ATP World Tour 250,GRASS,2,Adrian Mannarino,Ernests Gulbis,Adrian Mannarino,6-3; 6-3,R64,61,3,1,25,48,22,25,16,23,1,1,9,38,48,5,2,39,59,27,39,6,20,4,7,9,33,59
2011-06-06 00:00:00.000,London / Queen's Club Great Britain ATP World Tour 250,GRASS,2,Gilles Simon,N/A Bye,Gilles Simon,,R64,0,0,0,0,0,0,0,0,0,0,0,0,0,0,0,0,0,0,0,0,0,0,0,0,0,0,0
2011-06-06 00:00:00.000,London / Queen's Club Great Britain ATP World Tour 250,GRASS,2,Fernando Verdasco,N/A Bye,Fernando Verdasco,,R64,0,0,0,0,0,0,0,0,0,0,0,0,0,0,0,0,0,0,0,0,0,0,0,0,0,0,0
2011-06-06 00:00:00.000,London / Queen's Club Great Britain ATP World Tour 250,GRASS,2,Nicolas Mahut,Oliver Golding,Nicolas Mahut,6-3; 6-4,R64,70,9,1,41,57,34,41,11,16,3,3,10,45,57,5,5,35,61,27,35,11,26,3,5,9,38,61
2011-06-06 00:00:00.000,London / Queen's Club Great Britain ATP World Tour 250,GRASS,2,Ilija Bozoljac,Mikhail Kukushkin,Ilija Bozoljac,6-4; 6-4,R64,70,10,2,37,56,32,37,10,19,0,0,10,42,56,1,0,39,64,26,39,14,25,2,4,10,40,64
2011-06-06 00:00:00.000,London / Queen's Club Great Britain ATP World Tour 250,GRASS,2,David Nalbandian,Illya Marchenko,David Nalbandian,6-3; 6-4,R64,83,4,2,31,59,26,31,17,28,2,2,10,43,59,5,1,28,58,19,28,15,30,6,8,9,34,58
2011-06-06 00:00:00.000,London / Queen's Club Great Britain ATP World Tour 250,GRASS,2,Kevin Anderson,Ivo Karlovic,Kevin Anderson,6-4; 7-6(2),R64,91,11,1,44,64,36,44,14,20,1,1,11,50,64,18,5,49,73,41,49,9,24,1,2,11,50,73
2011-06-06 00:00:00.000,London / Queen's Club Great Britain ATP World Tour 250,GRASS,2,Donald Young,Andreas Haider-Maurer,Donald Young,6-4; 6-7(5); 6-2,R64,114,7,2,71,99,50,71,16,28,6,8,15,66,99,5,4,57,97,39,57,18,40,2,7,15,57,97
2011-06-06 00:00:00.000,London / Queen's Club Great Britain ATP World Tour 250,GRASS,2,Feliciano Lopez,Dmitry Tursunov,Feliciano Lopez,7-6(4); 6-3,R64,91,18,2,53,75,42,53,11,22,4,5,11,53,75,8,1,42,62,29,42,11,20,3,5,10,40,62
2011-06-06 00:00:00.000,London / Queen's Club Great Britain ATP World Tour 250,GRASS,2,Andy Roddick,N/A Bye,Andy Roddick,,R64,0,0,0,0,0,0,0,0,0,0,0,0,0,0,0,0,0,0,0,0,0,0,0,0,0,0,0
2011-06-06 00:00:00.000,London / Queen's Club Great Britain ATP World Tour 250,GRASS,2,Marin Cilic,N/A Bye,Marin Cilic,,R64,0,0,0,0,0,0,0,0,0,0,0,0,0,0,0,0,0,0,0,0,0,0,0,0,0,0,0
2011-06-06 00:00:00.000,London / Queen's Club Great Britain ATP World Tour 250,GRASS,2,Arnaud Clement,Benoit Paire,Arnaud Clement,7-5; 6-3,R64,82,4,1,42,59,35,42,8,17,1,2,10,43,59,10,4,44,74,30,44,11,30,3,7,11,41,74
2011-06-06 00:00:00.000,London / Queen's Club Great Britain ATP World Tour 250,GRASS,2,Marsel Ilhan,Jan Hajek,Marsel Ilhan,6-4; 6-4,R64,83,12,1,52,71,38,52,9,19,2,2,10,47,71,2,2,56,80,34,56,14,24,4,6,10,48,80
2011-06-06 00:00:00.000,London / Queen's Club Great Britain ATP World Tour 250,GRASS,2,Thomaz Bellucci,Grigor Dimitrov,Thomaz Bellucci,3-6; 7-6(8); 6-2,R64,114,4,0,62,91,46,62,16,29,3,4,14,62,91,12,2,75,103,56,75,11,28,5,7,15,67,103
2011-06-06 00:00:00.000,London / Queen's Club Great Britain ATP World Tour 250,GRASS,2,Janko Tipsarevic,Blaz Kavcic,Janko Tipsarevic,6-4; 6-4,R64,86,2,1,30,56,23,30,18,26,0,1,10,41,56,8,4,43,70,28,43,13,27,11,14,10,41,70
2011-06-06 00:00:00.000,London / Queen's Club Great Britain ATP World Tour 250,GRASS,2,Michael Russell,Denis Gremelmayr,Michael Russell,6-3; 7-5,R64,77,6,4,42,63,28,42,11,21,2,5,11,39,63,3,2,36,66,19,36,13,30,6,11,10,32,66
2011-06-06 00:00:00.000,London / Queen's Club Great Britain ATP World Tour 250,GRASS,2,Xavier Malisse,Matthias Bachinger,Xavier Malisse,6-4; 6-4,R64,65,8,1,34,55,29,34,12,21,2,3,10,41,55,3,2,34,54,23,34,10,20,2,5,10,33,54
2011-06-06 00:00:00.000,London / Queen's Club Great Britain ATP World Tour 250,GRASS,2,Andy Murray,N/A Bye,Andy Murray,,R64,0,0,0,0,0,0,0,0,0,0,0,0,0,0,0,0,0,0,0,0,0,0,0,0,0,0,0
2011-06-06 00:00:00.000,London / Queen's Club Great Britain ATP World Tour 250,GRASS,2,Rafael Nadal,Matthew Ebden,Rafael Nadal,6-4; 6-4,R32,75,6,2,36,58,29,36,13,22,1,1,10,42,58,7,2,32,55,26,32,10,23,1,3,10,36,55
2011-06-06 00:00:00.000,London / Queen's Club Great Britain ATP World Tour 250,GRASS,2,Radek Stepanek,Ivan Ljubicic,Radek Stepanek,0-6; 7-5; 6-4,R32,109,3,5,66,96,45,66,13,30,6,10,14,58,96,15,0,50,73,42,50,9,23,5,8,14,51,73
2011-06-06 00:00:00.000,London / Queen's Club Great Britain ATP World Tour 250,GRASS,2,Michael Llodra,Julien Benneteau,Michael Llodra,6-4; 7-5,R32,95,7,2,33,63,28,33,20,30,4,4,11,48,63,8,5,63,83,44,63,6,20,3,5,11,50,83
2011-06-06 00:00:00.000,London / Queen's Club Great Britain ATP World Tour 250,GRASS,2,Jo-Wilfried Tsonga,Michael Berrer,Jo-Wilfried Tsonga,6-0; 6-1,R32,47,6,3,26,43,21,26,10,17,2,2,7,31,43,1,4,17,32,6,17,6,15,2,7,6,12,32
2011-06-06 00:00:00.000,London / Queen's Club Great Britain ATP World Tour 250,GRASS,2,James Ward,Stanislas Wawrinka,James Ward,7-6(3); 6-3,R32,77,8,2,42,71,34,42,20,29,3,3,11,54,71,6,2,44,71,32,44,15,27,5,6,10,47,71
2011-06-06 00:00:00.000,London / Queen's Club Great Britain ATP World Tour 250,GRASS,2,Sam Querrey,Rainer Schuettler,Sam Querrey,7-6(6); 5-7; 6-3,R32,139,15,1,65,106,53,65,23,41,2,4,17,76,106,7,6,97,139,68,97,18,42,14,16,16,86,139
2011-06-06 00:00:00.000,London / Queen's Club Great Britain ATP World Tour 250,GRASS,2,Juan Martin Del Potro,Igor Kunitsyn,Juan Martin Del Potro,6-4; 6-4,R32,68,9,2,38,52,33,38,8,14,2,2,10,41,52,2,1,33,54,23,33,13,21,1,3,10,36,54
2011-06-06 00:00:00.000,London / Queen's Club Great Britain ATP World Tour 250,GRASS,2,Adrian Mannarino,Gilles Simon,Adrian Mannarino,6-7(4); 6-4; 3-0 RET,R32,127,0,1,55,89,36,55,12,34,4,9,13,48,89,3,3,50,96,31,50,16,46,11,18,12,47,96
2011-06-06 00:00:00.000,London / Queen's Club Great Britain ATP World Tour 250,GRASS,2,Fernando Verdasco,Nicolas Mahut,Fernando Verdasco,6-2; 6-3,R32,63,6,3,37,56,27,37,11,19,4,5,9,38,56,1,3,31,52,17,31,8,21,3,7,8,25,52
2011-06-06 00:00:00.000,London / Queen's Club Great Britain ATP World Tour 250,GRASS,2,David Nalbandian,Ilija Bozoljac,David Nalbandian,6-4; 6-4,R32,72,6,2,37,58,28,37,12,21,2,3,10,40,58,6,6,32,67,22,32,15,35,6,9,10,37,67
2011-06-06 00:00:00.000,London / Queen's Club Great Britain ATP World Tour 250,GRASS,2,Kevin Anderson,Donald Young,Kevin Anderson,6-2; 6-4,R32,72,9,2,44,62,35,44,7,18,2,2,9,42,62,4,3,41,60,26,41,9,19,4,7,9,35,60
2011-06-06 00:00:00.000,London / Queen's Club Great Britain ATP World Tour 250,GRASS,2,Andy Roddick,Feliciano Lopez,Andy Roddick,7-6(2); 6-7(5); 6-4,R32,133,15,4,73,98,62,73,13,25,3,4,17,75,98,35,10,78,114,62,78,13,36,4,6,17,75,114
2011-06-06 00:00:00.000,London / Queen's Club Great Britain ATP World Tour 250,GRASS,2,Marin Cilic,Arnaud Clement,Marin Cilic,6-4; 6-4,R32,90,11,3,35,62,27,35,14,27,3,5,10,41,62,2,2,35,63,25,35,10,28,4,8,10,35,63
2011-06-06 00:00:00.000,London / Queen's Club Great Britain ATP World Tour 250,GRASS,2,Thomaz Bellucci,Marsel Ilhan,Thomaz Bellucci,6-2; 6-7(3); 7-6(5),R32,144,9,3,80,119,49,80,25,39,5,8,16,74,119,10,6,67,115,47,67,20,48,7,12,16,67,115
2011-06-06 00:00:00.000,London / Queen's Club Great Britain ATP World Tour 250,GRASS,2,Janko Tipsarevic,Michael Russell,Janko Tipsarevic,7-6(3); 7-6(5),R32,116,6,3,52,82,43,52,14,30,2,3,12,57,82,3,3,57,84,44,57,13,27,4,5,12,57,84
2011-06-06 00:00:00.000,London / Queen's Club Great Britain ATP World Tour 250,GRASS,2,Andy Murray,Xavier Malisse,Andy Murray,6-3; 5-7; 6-3,R32,108,12,1,55,89,38,55,25,34,5,6,15,63,89,10,2,65,88,45,65,11,23,4,7,15,56,88
2011-06-06 00:00:00.000,London / Queen's Club Great Britain ATP World Tour 250,GRASS,2,Rafael Nadal,Radek Stepanek,Rafael Nadal,6-3; 5-7; 6-1,R16,144,7,4,65,102,40,65,21,37,13,16,14,61,102,1,2,60,91,38,60,10,31,9,15,14,48,91
2011-06-06 00:00:00.000,London / Queen's Club Great Britain ATP World Tour 250,GRASS,2,Jo-Wilfried Tsonga,Michael Llodra,Jo-Wilfried Tsonga,4-3 RET,R16,23,2,1,19,23,16,19,1,4,0,0,4,17,23,0,0,11,15,10,11,3,4,0,0,3,13,15
2011-06-06 00:00:00.000,London / Queen's Club Great Britain ATP World Tour 250,GRASS,2,James Ward,Sam Querrey,James Ward,3-6; 6-3; 6-4,R16,95,13,4,53,86,43,53,18,33,3,4,14,61,86,4,1,60,80,41,60,14,20,1,3,14,55,80
2011-06-06 00:00:00.000,London / Queen's Club Great Britain ATP World Tour 250,GRASS,2,Adrian Mannarino,Juan Martin Del Potro,Adrian Mannarino,7-6(3); 7-6(7),R16,121,5,1,68,98,42,68,21,30,8,10,12,63,98,16,2,52,77,40,52,11,25,0,2,12,51,77
2011-06-06 00:00:00.000,London / Queen's Club Great Britain ATP World Tour 250,GRASS,2,Fernando Verdasco,David Nalbandian,Fernando Verdasco,7-5; 6-1,R16,74,9,3,39,59,31,39,14,20,4,4,10,45,59,2,2,32,58,21,32,13,26,4,7,9,34,58
2011-06-06 00:00:00.000,London / Queen's Club Great Britain ATP World Tour 250,GRASS,2,Andy Roddick,Kevin Anderson,Andy Roddick,6-4; 6-4,R16,79,8,2,45,62,35,45,9,17,3,3,10,44,62,13,0,39,54,28,39,9,15,1,3,10,37,54
2011-06-06 00:00:00.000,London / Queen's Club Great Britain ATP World Tour 250,GRASS,2,Marin Cilic,Thomaz Bellucci,Marin Cilic,7-6(3); 0-6; 6-3,R16,114,3,5,55,85,42,55,14,30,5,9,14,56,85,9,0,59,86,43,59,13,27,1,3,13,56,86
2011-06-06 00:00:00.000,London / Queen's Club Great Britain ATP World Tour 250,GRASS,2,Andy Murray,Janko Tipsarevic,Andy Murray,6-4; 7-6(3),R16,126,11,1,45,65,33,45,12,20,1,3,11,45,65,3,1,44,71,25,44,17,27,3,6,11,42,71
2011-06-06 00:00:00.000,London / Queen's Club Great Britain ATP World Tour 250,GRASS,2,Jo-Wilfried Tsonga,Rafael Nadal,Jo-Wilfried Tsonga,6-7(3); 6-4; 6-1,Q,122,25,4,51,82,44,51,16,31,4,5,14,60,82,6,2,66,92,38,66,18,26,6,11,15,56,92
2011-06-06 00:00:00.000,London / Queen's Club Great Britain ATP World Tour 250,GRASS,2,James Ward,Adrian Mannarino,James Ward,6-2; 6-7(14); 6-4,Q,128,7,5,65,99,50,65,14,34,2,4,15,64,99,2,1,70,102,47,70,14,32,6,11,15,61,102
2011-06-06 00:00:00.000,London / Queen's Club Great Britain ATP World Tour 250,GRASS,2,Andy Roddick,Fernando Verdasco,Andy Roddick,6-2; 6-2,Q,65,3,2,33,50,24,33,11,17,0,0,8,35,50,5,3,30,52,18,30,9,22,7,11,8,27,52
2011-06-06 00:00:00.000,London / Queen's Club Great Britain ATP World Tour 250,GRASS,2,Andy Murray,Marin Cilic,Andy Murray,W/O,Q,0,0,0,0,0,0,0,0,0,0,0,0,0,0,0,0,0,0,0,0,0,0,0,0,0,0,0
2011-06-06 00:00:00.000,London / Queen's Club Great Britain ATP World Tour 250,GRASS,2,Jo-Wilfried Tsonga,James Ward,Jo-Wilfried Tsonga,6-3; 7-6(7),S,82,14,6,45,65,41,45,9,20,2,3,11,50,65,7,0,46,73,34,46,14,27,4,6,10,48,73
2011-06-06 00:00:00.000,London / Queen's Club Great Britain ATP World Tour 250,GRASS,2,Andy Murray,Andy Roddick,Andy Murray,6-3; 6-1,S,59,13,0,22,41,18,22,14,19,0,0,8,32,41,3,1,38,46,20,38,4,8,2,6,8,24,46
2011-06-06 00:00:00.000,London / Queen's Club Great Britain ATP World Tour 250,GRASS,2,Andy Murray,Jo-Wilfried Tsonga,Andy Murray,3-6; 7-6(2); 6-4,F,146,11,3,54,85,45,54,17,31,2,3,15,62,85,10,1,69,113,52,69,22,44,9,10,16,74,113
2011-06-12 00:00:00.000,Eastbourne Great Britain ATP World Tour 250,GRASS,2,Jo-Wilfried Tsonga,Denis Istomin,Jo-Wilfried Tsonga,6-2; 7-5,R32,91,8,0,38,61,28,38,13,23,5,6,10,41,61,7,3,52,75,36,52,6,23,14,18,10,42,75
2011-06-12 00:00:00.000,Eastbourne Great Britain ATP World Tour 250,GRASS,2,Radek Stepanek,Colin Fleming,Radek Stepanek,6-3; 6-4,R32,85,3,2,44,63,26,44,12,19,5,7,9,38,63,3,0,43,65,28,43,6,22,6,11,10,34,65
2011-06-12 00:00:00.000,Eastbourne Great Britain ATP World Tour 250,GRASS,2,Kei Nishikori,Evgeny Kirillov,Kei Nishikori,7-5; 6-1,R32,59,5,1,34,58,25,34,18,24,4,4,10,43,58,4,0,29,50,19,29,11,21,2,5,9,30,50
2011-06-12 00:00:00.000,Eastbourne Great Britain ATP World Tour 250,GRASS,2,Rainer Schuettler,Sergiy Stakhovsky,Rainer Schuettler,6-3; 6-2,R32,58,1,0,36,54,29,36,11,18,1,1,9,40,54,2,0,25,41,18,25,6,16,3,6,8,24,41
2011-06-12 00:00:00.000,Eastbourne Great Britain ATP World Tour 250,GRASS,2,Janko Tipsarevic,James Ward,Janko Tipsarevic,6-3; 4-6; 6-2,R32,111,4,1,49,85,36,49,24,36,5,6,14,60,85,10,6,57,89,39,57,14,32,7,10,13,53,89
2011-06-12 00:00:00.000,Eastbourne Great Britain ATP World Tour 250,GRASS,2,Mikhail Kukushkin,Yen-Hsun Lu,Mikhail Kukushkin,6-3; 6-3,R32,74,0,0,26,45,18,26,11,19,1,3,9,29,45,2,2,49,69,25,49,8,20,8,13,9,33,69
2011-06-12 00:00:00.000,Eastbourne Great Britain ATP World Tour 250,GRASS,2,Grigor Dimitrov,Daniel Evans,Grigor Dimitrov,2-6; 7-6(5); 6-4,R32,100,11,6,68,103,53,68,15,35,6,9,15,68,103,4,6,56,85,44,56,18,29,2,4,15,62,85
2011-06-12 00:00:00.000,Eastbourne Great Britain ATP World Tour 250,GRASS,2,Kevin Anderson,Alexander Slabinsky,Kevin Anderson,7-5; 6-3,R32,75,16,1,34,50,31,34,13,16,0,0,11,44,50,7,3,37,65,32,37,10,28,4,6,10,42,65
2011-06-12 00:00:00.000,Eastbourne Great Britain ATP World Tour 250,GRASS,2,Igor Kunitsyn,Pablo Andujar,Igor Kunitsyn,7-5; 6-1,R32,78,3,0,43,56,30,43,9,13,2,3,10,39,56,0,1,33,60,20,33,11,27,6,10,9,31,60
2011-06-12 00:00:00.000,Eastbourne Great Britain ATP World Tour 250,GRASS,2,Illya Marchenko,Frederico Gil,Illya Marchenko,6-1; 6-3,R32,59,6,1,30,47,21,30,14,17,3,3,8,35,47,1,0,30,46,15,30,9,16,2,6,8,24,46
2011-06-12 00:00:00.000,Eastbourne Great Britain ATP World Tour 250,GRASS,2,Julien Benneteau,Ryan Sweeting,Julien Benneteau,6-2; 7-6(4),R32,81,4,2,41,60,29,41,12,19,1,2,10,41,60,4,5,38,68,26,38,13,30,7,10,10,39,68
2011-06-12 00:00:00.000,Eastbourne Great Britain ATP World Tour 250,GRASS,2,Somdev Devvarman,Guillermo Garcia-Lopez,Somdev Devvarman,6-3; 6-4,R32,89,7,1,43,76,31,43,17,33,9,10,10,48,76,3,2,29,54,20,29,11,25,0,3,9,31,54
2011-06-12 00:00:00.000,Eastbourne Great Britain ATP World Tour 250,GRASS,2,Donald Young,Daniel Cox,Donald Young,6-1; 7-5,R32,71,6,3,48,64,36,48,9,16,3,3,10,45,64,3,8,40,65,26,40,11,25,5,8,9,37,65
2011-06-12 00:00:00.000,Eastbourne Great Britain ATP World Tour 250,GRASS,2,Andreas Seppi,Tobias Kamke,Andreas Seppi,3-6; 6-1; 6-4,R32,85,0,1,50,72,37,50,15,22,2,3,13,52,72,1,4,42,69,35,42,10,27,3,6,13,45,69
2011-06-12 00:00:00.000,Eastbourne Great Britain ATP World Tour 250,GRASS,2,Olivier Rochus,Lleyton Hewitt,Olivier Rochus,6-2; 3-0 RET,R32,48,2,1,16,26,12,16,8,10,0,0,5,20,26,3,2,24,45,13,24,7,21,7,11,6,20,45
2011-06-12 00:00:00.000,Eastbourne Great Britain ATP World Tour 250,GRASS,2,Carlos Berlocq,Alexandr Dolgopolov,Carlos Berlocq,7-5; 6-2,R32,72,6,1,41,64,29,41,13,23,2,4,10,42,64,5,2,35,63,23,35,10,28,5,10,10,33,63
2011-06-12 00:00:00.000,Eastbourne Great Britain ATP World Tour 250,GRASS,2,Radek Stepanek,Jo-Wilfried Tsonga,Radek Stepanek,6-2; 6-3,R16,60,3,1,35,46,28,35,5,11,0,0,8,33,46,4,0,37,58,20,37,12,21,2,6,9,32,58
2011-06-12 00:00:00.000,Eastbourne Great Britain ATP World Tour 250,GRASS,2,Kei Nishikori,Rainer Schuettler,Kei Nishikori,6-4; 4-6; 6-2,R16,106,3,2,51,80,35,51,19,29,0,2,14,54,80,3,3,56,84,35,56,13,28,5,9,14,48,84
2011-06-12 00:00:00.000,Eastbourne Great Britain ATP World Tour 250,GRASS,2,Janko Tipsarevic,Mikhail Kukushkin,Janko Tipsarevic,6-3; 7-6(2),R16,107,6,3,28,62,24,28,25,34,4,4,11,49,62,4,1,45,78,28,45,20,33,7,8,10,48,78
2011-06-12 00:00:00.000,Eastbourne Great Britain ATP World Tour 250,GRASS,2,Grigor Dimitrov,Kevin Anderson,Grigor Dimitrov,6-3; 6-2,R16,61,8,5,27,49,23,27,14,22,0,0,9,37,49,8,1,36,50,21,36,8,14,4,7,8,29,50
2011-06-12 00:00:00.000,Eastbourne Great Britain ATP World Tour 250,GRASS,2,Igor Kunitsyn,Illya Marchenko,Igor Kunitsyn,6-3; 1-6; 6-2,R16,92,3,2,42,68,29,42,12,26,6,10,12,41,68,7,4,36,61,26,36,11,25,0,5,12,37,61
2011-06-12 00:00:00.000,Eastbourne Great Britain ATP World Tour 250,GRASS,2,Julien Benneteau,Somdev Devvarman,Julien Benneteau,7-6(1); 6-7(6); 6-3,R16,154,3,2,70,95,49,70,18,25,5,7,16,67,95,7,2,71,118,49,71,22,47,6,10,17,71,118
2011-06-12 00:00:00.000,Eastbourne Great Britain ATP World Tour 250,GRASS,2,Andreas Seppi,Donald Young,Andreas Seppi,7-6(1); 6-3,R16,72,8,1,49,71,38,49,13,22,3,4,11,51,71,4,2,42,51,31,42,4,9,0,2,10,35,51
2011-06-12 00:00:00.000,Eastbourne Great Britain ATP World Tour 250,GRASS,2,Olivier Rochus,Carlos Berlocq,Olivier Rochus,3-6; 7-6(5); 7-6(3),R16,186,1,3,77,105,55,77,18,28,5,8,16,73,105,27,3,76,115,61,76,18,39,4,6,17,79,115
2011-06-12 00:00:00.000,Eastbourne Great Britain ATP World Tour 250,GRASS,2,Kei Nishikori,Radek Stepanek,Kei Nishikori,6-2; 6-3,Q,86,2,4,41,69,26,41,14,28,9,11,9,40,69,0,4,35,58,19,35,8,23,5,10,8,27,58
2011-06-12 00:00:00.000,Eastbourne Great Britain ATP World Tour 250,GRASS,2,Janko Tipsarevic,Grigor Dimitrov,Janko Tipsarevic,6-3; 7-6(2),Q,88,3,1,44,69,28,44,14,25,6,9,10,42,69,4,8,41,70,26,41,10,29,1,6,11,36,70
2011-06-12 00:00:00.000,Eastbourne Great Britain ATP World Tour 250,GRASS,2,Igor Kunitsyn,Julien Benneteau,Igor Kunitsyn,6-3; 6-2,Q,75,4,2,34,56,26,34,14,22,2,2,9,40,56,2,3,25,49,16,25,12,24,2,5,8,28,49
2011-06-12 00:00:00.000,Eastbourne Great Britain ATP World Tour 250,GRASS,2,Andreas Seppi,Olivier Rochus,Andreas Seppi,6-2; 6-7(5); 6-3,Q,116,10,2,53,91,43,53,23,38,2,2,15,66,91,2,1,51,86,34,51,19,35,2,5,14,53,86
2011-06-12 00:00:00.000,Eastbourne Great Britain ATP World Tour 250,GRASS,2,Janko Tipsarevic,Kei Nishikori,Janko Tipsarevic,6-2; 6-4,S,78,3,0,31,50,26,31,12,19,1,1,9,38,50,4,3,39,57,25,39,9,18,3,6,9,34,57
2011-06-12 00:00:00.000,Eastbourne Great Britain ATP World Tour 250,GRASS,2,Andreas Seppi,Igor Kunitsyn,Andreas Seppi,6-4; 2-6; 6-4,S,126,8,6,59,96,42,59,15,37,9,13,14,57,96,8,2,71,98,41,71,15,27,8,12,14,56,98
2011-06-12 00:00:00.000,Eastbourne Great Britain ATP World Tour 250,GRASS,2,Andreas Seppi,Janko Tipsarevic,Andreas Seppi,7-6(5); 3-6; 5-3 RET,F,155,4,1,58,91,43,58,13,33,2,7,14,56,91,6,3,71,109,44,71,19,38,5,10,15,63,109
2011-06-12 00:00:00.000,s-Hertogenbosch The Netherlands ATP World Tour 250,GRASS,2,Michael Berrer,Nicolas Almagro,Michael Berrer,3-6; 7-6(5); 6-4,R32,98,7,2,56,88,45,56,23,32,2,3,15,68,88,15,4,48,87,41,48,27,39,3,4,16,68,87
2011-06-12 00:00:00.000,s-Hertogenbosch The Netherlands ATP World Tour 250,GRASS,2,Santiago Giraldo,Michael Russell,Santiago Giraldo,7-6(4); 6-3,R32,91,0,1,44,67,33,44,14,23,1,2,11,47,67,5,1,45,70,31,45,11,25,2,4,10,42,70
2011-06-12 00:00:00.000,s-Hertogenbosch The Netherlands ATP World Tour 250,GRASS,2,Dmitry Tursunov,Robert Kendrick,Dmitry Tursunov,6-2; 7-6(3),R32,70,6,3,35,57,30,35,11,22,0,1,10,41,57,7,3,34,59,21,34,14,25,3,6,10,35,59
2011-06-12 00:00:00.000,s-Hertogenbosch The Netherlands ATP World Tour 250,GRASS,2,Nicolas Mahut,Adrian Mannarino,Nicolas Mahut,7-6(2); 6-3,R32,81,6,3,39,61,26,39,12,22,0,2,10,38,61,1,5,39,65,26,39,11,26,1,5,11,37,65
2011-06-12 00:00:00.000,s-Hertogenbosch The Netherlands ATP World Tour 250,GRASS,2,Xavier Malisse,Alejandro Falla,Xavier Malisse,6-3; 6-1,R32,56,3,0,28,42,19,28,9,14,0,1,8,28,42,0,2,25,47,13,25,8,22,6,11,8,21,47
2011-06-12 00:00:00.000,s-Hertogenbosch The Netherlands ATP World Tour 250,GRASS,2,Jesse Huta Galung,Julian Reister,Jesse Huta Galung,6-2; 3-6; 7-5,R32,126,4,4,48,90,35,48,23,42,5,7,14,58,90,4,2,68,97,47,68,12,29,3,7,15,59,97
2011-06-12 00:00:00.000,s-Hertogenbosch The Netherlands ATP World Tour 250,GRASS,2,Filippo Volandri,Ricardo Mello,Filippo Volandri,6-4; 7-6(5),R32,93,4,3,49,68,34,49,11,19,2,4,11,45,68,4,2,59,95,33,59,21,36,6,9,11,54,95
2011-06-12 00:00:00.000,s-Hertogenbosch The Netherlands ATP World Tour 250,GRASS,2,Alex Bogomolov Jr.,Jeremy Chardy,Alex Bogomolov Jr.,3-6; 6-4; 7-6(7),R32,145,3,3,90,115,60,90,10,25,6,9,16,70,115,9,4,62,117,40,62,32,55,9,11,15,72,117
2011-06-12 00:00:00.000,s-Hertogenbosch The Netherlands ATP World Tour 250,GRASS,2,Javier Marti,Daniel Gimeno-Traver,Javier Marti,6-3; 7-6(4),R32,89,0,1,49,70,38,49,12,21,2,3,11,50,70,8,2,40,70,31,40,13,30,3,5,10,44,70
2011-06-12 00:00:00.000,s-Hertogenbosch The Netherlands ATP World Tour 250,GRASS,2,Teymuraz Gabashvili,Konstantin Kravchuk,Teymuraz Gabashvili,6-4; 1-6; 6-4,R32,121,1,3,48,73,35,48,11,25,1,4,13,46,73,9,4,56,90,40,56,17,34,6,9,14,57,90
2011-06-12 00:00:00.000,s-Hertogenbosch The Netherlands ATP World Tour 250,GRASS,2,Andreas Haider-Maurer,Blaz Kavcic,Andreas Haider-Maurer,6-4; 6-7(3); 6-4,R32,126,9,4,52,88,48,52,20,36,0,0,16,68,88,6,7,61,99,47,61,22,38,4,6,16,69,99
2011-06-12 00:00:00.000,s-Hertogenbosch The Netherlands ATP World Tour 250,GRASS,2,Ivan Dodig,Victor Hanescu,Ivan Dodig,6-4; 7-5,R32,98,10,1,62,85,44,62,13,23,7,7,11,57,85,2,2,40,66,30,40,14,26,3,5,11,44,66
2011-06-12 00:00:00.000,s-Hertogenbosch The Netherlands ATP World Tour 250,GRASS,2,Jarkko Nieminen,Maximo Gonzalez,Jarkko Nieminen,7-5; 6-1,R32,70,1,0,44,55,28,44,8,11,2,4,10,36,55,2,3,44,58,21,44,5,14,3,8,9,26,58
2011-06-12 00:00:00.000,s-Hertogenbosch The Netherlands ATP World Tour 250,GRASS,2,Denis Gremelmayr,Ludovic Walter,Denis Gremelmayr,6-3; 7-6(5),R32,72,8,1,39,63,34,39,16,24,2,2,11,50,63,11,2,37,54,33,37,10,17,0,1,10,43,54
2011-06-12 00:00:00.000,s-Hertogenbosch The Netherlands ATP World Tour 250,GRASS,2,Robin Haase,Mischa Zverev,Robin Haase,6-3; 6-4,R32,67,7,2,32,57,26,32,14,25,2,3,10,40,57,1,3,38,64,26,38,12,26,7,10,9,38,64
2011-06-12 00:00:00.000,s-Hertogenbosch The Netherlands ATP World Tour 250,GRASS,2,Marcos Baghdatis,Arnaud Clement,Marcos Baghdatis,7-6(4); 6-3,R32,95,7,1,43,73,36,43,12,30,4,6,11,48,73,3,4,35,67,28,35,13,32,5,8,10,41,67
2011-06-12 00:00:00.000,s-Hertogenbosch The Netherlands ATP World Tour 250,GRASS,2,Santiago Giraldo,Michael Berrer,Santiago Giraldo,7-6(6); 6-3,R16,103,1,0,60,79,41,60,11,19,6,8,11,52,79,2,2,40,72,28,40,15,32,7,10,10,43,72
2011-06-12 00:00:00.000,s-Hertogenbosch The Netherlands ATP World Tour 250,GRASS,2,Dmitry Tursunov,Nicolas Mahut,Dmitry Tursunov,7-6(2); 3-6; 6-3,R16,149,11,2,59,102,43,59,24,43,7,9,15,67,102,12,1,63,107,45,63,22,44,7,9,15,67,107
2011-06-12 00:00:00.000,s-Hertogenbosch The Netherlands ATP World Tour 250,GRASS,2,Xavier Malisse,Jesse Huta Galung,Xavier Malisse,7-6(2); 6-4,R16,97,7,1,41,72,33,41,16,31,7,8,11,49,72,11,5,42,80,32,42,16,38,5,7,11,48,80
2011-06-12 00:00:00.000,s-Hertogenbosch The Netherlands ATP World Tour 250,GRASS,2,Alex Bogomolov Jr.,Filippo Volandri,Alex Bogomolov Jr.,7-6(2); 6-2,R16,84,2,2,39,59,29,39,14,20,3,4,10,43,59,1,8,48,74,32,48,11,26,7,10,10,43,74
2011-06-12 00:00:00.000,s-Hertogenbosch The Netherlands ATP World Tour 250,GRASS,2,Teymuraz Gabashvili,Javier Marti,Teymuraz Gabashvili,7-6(6); 6-3,R16,102,1,1,39,62,29,39,12,23,0,3,11,41,62,4,3,45,78,26,45,17,33,6,10,10,43,78
2011-06-12 00:00:00.000,s-Hertogenbosch The Netherlands ATP World Tour 250,GRASS,2,Ivan Dodig,Andreas Haider-Maurer,Ivan Dodig,6-4; 6-3,R16,84,5,2,36,56,26,36,11,20,2,3,9,37,56,4,3,39,64,24,39,9,25,2,6,10,33,64
2011-06-12 00:00:00.000,s-Hertogenbosch The Netherlands ATP World Tour 250,GRASS,2,Denis Gremelmayr,Jarkko Nieminen,Denis Gremelmayr,7-6(3); 2-6; 7-6(5),R16,140,7,5,70,129,47,70,28,59,5,11,16,75,129,8,0,74,107,47,74,18,33,2,6,16,65,107
2011-06-12 00:00:00.000,s-Hertogenbosch The Netherlands ATP World Tour 250,GRASS,2,Marcos Baghdatis,Robin Haase,Marcos Baghdatis,7-5; 6-4,R16,80,5,4,38,67,33,38,15,29,3,3,11,48,67,10,3,43,66,33,43,11,23,0,2,11,44,66
2011-06-12 00:00:00.000,s-Hertogenbosch The Netherlands ATP World Tour 250,GRASS,2,Dmitry Tursunov,Santiago Giraldo,Dmitry Tursunov,6-3; 4-6; 6-4,Q,118,9,2,61,91,47,61,13,30,2,5,15,60,91,5,1,68,86,46,68,8,18,3,7,14,54,86
2011-06-12 00:00:00.000,s-Hertogenbosch The Netherlands ATP World Tour 250,GRASS,2,Xavier Malisse,Alex Bogomolov Jr.,Xavier Malisse,6-2; 6-4,Q,83,5,3,34,65,28,34,12,31,10,12,9,40,65,0,3,35,56,18,35,8,21,1,6,9,26,56
2011-06-12 00:00:00.000,s-Hertogenbosch The Netherlands ATP World Tour 250,GRASS,2,Ivan Dodig,Teymuraz Gabashvili,Ivan Dodig,2-6; 6-1; 6-2,Q,118,16,3,51,79,39,51,12,28,5,7,12,51,79,1,1,51,87,31,51,18,36,5,9,11,49,87
2011-06-12 00:00:00.000,s-Hertogenbosch The Netherlands ATP World Tour 250,GRASS,2,Marcos Baghdatis,Denis Gremelmayr,Marcos Baghdatis,6-1; 6-0,Q,47,4,2,21,35,19,21,7,14,2,2,6,26,35,4,0,33,45,14,33,2,12,8,14,7,16,45
2011-06-12 00:00:00.000,s-Hertogenbosch The Netherlands ATP World Tour 250,GRASS,2,Dmitry Tursunov,Xavier Malisse,Dmitry Tursunov,6-3; 7-6(1),S,104,2,8,37,63,25,37,9,26,0,3,10,34,63,5,2,41,74,30,41,17,33,3,5,11,47,74
2011-06-12 00:00:00.000,s-Hertogenbosch The Netherlands ATP World Tour 250,GRASS,2,Ivan Dodig,Marcos Baghdatis,Ivan Dodig,7-6(4); 6-1,S,89,4,2,43,67,30,43,15,24,2,3,9,45,67,1,4,40,62,26,40,10,22,0,4,10,36,62
2011-06-12 00:00:00.000,s-Hertogenbosch The Netherlands ATP World Tour 250,GRASS,2,Dmitry Tursunov,Ivan Dodig,Dmitry Tursunov,6-3; 6-2,F,76,2,3,41,60,31,41,10,19,3,3,9,41,60,7,1,33,51,20,33,8,18,4,7,8,28,51
2011-06-20 00:00:00.000,Wimbledon Great Britain Grand Slams,GRASS,3,Rafael Nadal,Michael Russell,Rafael Nadal,6-4; 6-2; 6-2,R128,118,4,2,47,70,36,47,13,23,1,3,13,49,70,2,2,56,82,28,56,13,26,3,10,13,41,82
2011-06-20 00:00:00.000,Wimbledon Great Britain Grand Slams,GRASS,3,Ryan Sweeting,Pablo Andujar,Ryan Sweeting,3-6; 4-6; 6-1; 7-6(1); 6-1,R128,224,3,8,81,142,56,81,31,61,10,16,23,87,142,1,8,101,169,62,101,29,68,10,18,22,91,169
2011-06-20 00:00:00.000,Wimbledon Great Britain Grand Slams,GRASS,3,Gilles Muller,Tommy Haas,Gilles Muller,7-6(5); 7-6(3); 3-6; 6-3,R128,162,37,2,100,131,78,100,19,31,5,7,21,97,131,16,3,94,135,66,94,31,41,5,7,21,97,135
2011-06-20 00:00:00.000,Wimbledon Great Britain Grand Slams,GRASS,3,Milos Raonic,Marc Gicquel,Milos Raonic,6-3; 7-6(3); 6-3,R128,96,25,0,57,87,49,57,21,30,1,1,16,70,87,5,2,55,86,39,55,18,31,1,3,14,57,86
2011-06-20 00:00:00.000,Wimbledon Great Britain Grand Slams,GRASS,3,Juan Martin Del Potro,Flavio Cipolla,Juan Martin Del Potro,6-1; 6-4; 6-3,R128,99,14,1,46,67,41,46,10,21,2,3,13,51,67,1,5,49,75,29,49,10,26,3,9,13,39,75
2011-06-20 00:00:00.000,Wimbledon Great Britain Grand Slams,GRASS,3,Olivier Rochus,Kenny De Schepper,Olivier Rochus,6-7(6); 3-6; 6-3; 6-1; 6-4,R128,189,4,7,87,153,65,87,38,66,4,6,24,103,153,35,14,91,147,77,91,19,56,9,14,23,96,147
2011-06-20 00:00:00.000,Wimbledon Great Britain Grand Slams,GRASS,3,Dudi Sela,Frederico Gil,Dudi Sela,6-4; 6-1; 6-4,R128,112,4,3,54,86,46,54,14,32,2,3,14,60,86,0,0,63,93,39,63,13,30,7,12,13,52,93
2011-06-20 00:00:00.000,Wimbledon Great Britain Grand Slams,GRASS,3,Gilles Simon,Edouard Roger-Vasselin,Gilles Simon,4-6; 6-4; 6-3; 7-6(3),R128,179,7,1,72,135,54,72,36,63,7,10,21,90,135,2,4,95,141,65,95,19,46,13,17,20,84,141
2011-06-20 00:00:00.000,Wimbledon Great Britain Grand Slams,GRASS,3,Mardy Fish,Marcel Granollers,Mardy Fish,7-6(3); 7-6(5); 6-4,R128,142,26,1,69,95,58,69,18,26,0,0,17,76,95,2,1,74,124,59,74,22,50,2,3,17,81,124
2011-06-20 00:00:00.000,Wimbledon Great Britain Grand Slams,GRASS,3,Denis Istomin,Philipp Kohlschreiber,Denis Istomin,4-6; 6-3; 6-3; 6-3,R128,145,18,3,70,107,61,70,18,37,3,4,19,79,107,7,4,71,121,50,71,26,50,3,7,18,76,121
2011-06-20 00:00:00.000,Wimbledon Great Britain Grand Slams,GRASS,3,Robin Haase,Pere Riba,Robin Haase,6-4; 6-4; 6-4,R128,90,25,1,63,86,52,63,12,23,4,5,15,64,86,9,9,65,101,49,65,10,36,5,9,15,59,101
2011-06-20 00:00:00.000,Wimbledon Great Britain Grand Slams,GRASS,3,Fernando Verdasco,Radek Stepanek,Fernando Verdasco,2-6; 4-6; 6-3; 7-6(6); 9-7,R128,236,12,8,125,190,95,125,27,65,12,17,28,122,190,6,4,111,159,87,111,23,48,1,5,27,110,159
2011-06-20 00:00:00.000,Wimbledon Great Britain Grand Slams,GRASS,3,Juan Ignacio Chela,Marinko Matosevic,Juan Ignacio Chela,6-4; 6-4; 6-7(6); 6-2,R128,163,3,2,66,121,45,66,34,55,6,11,20,79,121,7,3,97,147,59,97,19,50,10,19,20,78,147
2011-06-20 00:00:00.000,Wimbledon Great Britain Grand Slams,GRASS,3,Alex Bogomolov Jr.,Donald Young,Alex Bogomolov Jr.,7-5; 4-6; 6-3; 6-1,R128,170,7,5,93,117,66,93,12,24,6,9,19,78,117,10,8,86,142,54,86,23,56,11,18,19,77,142
2011-06-20 00:00:00.000,Wimbledon Great Britain Grand Slams,GRASS,3,Julien Benneteau,Ruben Bemelmans,Julien Benneteau,6-4; 6-2; 3-6; 4-6; 6-1,R128,160,22,4,88,124,72,88,18,36,4,6,22,90,124,7,5,85,136,64,85,25,51,8,13,22,89,136
2011-06-20 00:00:00.000,Wimbledon Great Britain Grand Slams,GRASS,3,Tomas Berdych,Filippo Volandri,Tomas Berdych,6-2; 6-2; 6-1,R128,94,12,1,33,62,29,33,19,29,0,0,12,48,62,1,8,47,84,27,47,15,37,8,14,11,42,84
2011-06-20 00:00:00.000,Wimbledon Great Britain Grand Slams,GRASS,3,Andy Murray,Daniel Gimeno-Traver,Andy Murray,4-6; 6-3; 6-0; 6-0,R128,128,13,1,59,84,53,59,12,25,2,3,16,65,84,2,2,54,101,30,54,21,47,8,15,15,51,101
2011-06-20 00:00:00.000,Wimbledon Great Britain Grand Slams,GRASS,3,Tobias Kamke,Blaz Kavcic,Tobias Kamke,6-3; 7-6(4); 5-7; 6-1,R128,172,5,7,93,153,67,93,26,60,8,13,21,93,153,2,12,66,118,43,66,21,52,5,12,19,64,118
2011-06-20 00:00:00.000,Wimbledon Great Britain Grand Slams,GRASS,3,Sergiy Stakhovsky,Daniel Cox,Sergiy Stakhovsky,6-2; 6-4; 6-4,R128,95,6,2,45,74,36,45,21,29,0,0,14,57,74,2,3,49,81,30,49,20,32,10,14,14,50,81
2011-06-20 00:00:00.000,Wimbledon Great Britain Grand Slams,GRASS,3,Ivan Ljubicic,Marin Cilic,Ivan Ljubicic,7-6(2); 3-6; 6-3; 6-4,R128,165,21,2,69,122,56,69,28,53,9,12,20,84,122,9,3,61,109,45,61,28,48,2,6,20,73,109
2011-06-20 00:00:00.000,Wimbledon Great Britain Grand Slams,GRASS,3,Richard Gasquet,Santiago Giraldo,Richard Gasquet,7-5; 6-3; 7-6(3),R128,123,13,3,73,108,48,73,19,35,8,12,17,67,108,9,1,72,100,41,72,14,28,6,12,16,55,100
2011-06-20 00:00:00.000,Wimbledon Great Britain Grand Slams,GRASS,3,Igor Kunitsyn,Igor Sijsling,Igor Kunitsyn,6-3; 6-4; 6-2,R128,98,4,1,55,88,47,55,15,33,3,3,14,62,88,16,3,47,75,37,47,9,28,5,9,13,46,75
2011-06-20 00:00:00.000,Wimbledon Great Britain Grand Slams,GRASS,3,Simone Bolelli,Martin Fischer,Simone Bolelli,7-5; 6-4; 6-4,R128,138,7,2,63,97,47,63,19,34,7,9,16,66,97,2,1,72,103,43,72,15,31,3,8,16,58,103
2011-06-20 00:00:00.000,Wimbledon Great Britain Grand Slams,GRASS,3,Stanislas Wawrinka,Potito Starace,Stanislas Wawrinka,6-3; 6-4; 6-4,R128,102,11,1,47,78,40,47,21,31,0,0,15,61,78,1,2,73,106,47,73,14,33,13,16,14,61,106
2011-06-20 00:00:00.000,Wimbledon Great Britain Grand Slams,GRASS,3,Gael Monfils,Matthias Bachinger,Gael Monfils,6-4; 7-6(3); 6-3,R128,110,14,5,71,99,55,71,12,28,3,6,16,67,99,5,4,65,98,42,65,14,33,6,11,15,56,98
2011-06-20 00:00:00.000,Wimbledon Great Britain Grand Slams,GRASS,3,Grega Zemlja,Lukas Lacko,Grega Zemlja,6-4; 3-6; 7-6(8); 6-4,R128,158,10,1,91,124,64,91,22,33,1,3,20,86,124,2,4,97,157,61,97,37,60,8,11,21,98,157
2011-06-20 00:00:00.000,Wimbledon Great Britain Grand Slams,GRASS,3,Lukasz Kubot,Arnaud Clement,Lukasz Kubot,6-4; 6-2; 3-6; 5-7; 6-4,R128,209,6,2,87,130,66,87,25,43,6,10,24,91,130,12,2,81,147,58,81,36,66,4,10,25,94,147
2011-06-20 00:00:00.000,Wimbledon Great Britain Grand Slams,GRASS,3,Ivo Karlovic,Janko Tipsarevic,Ivo Karlovic,7-5; 3-1 RET,R128,59,14,1,27,43,25,27,9,16,0,0,8,34,43,1,0,31,51,20,31,10,20,2,4,8,30,51
2011-06-20 00:00:00.000,Wimbledon Great Britain Grand Slams,GRASS,3,Rainer Schuettler,Thomaz Bellucci,Rainer Schuettler,7-6(3); 6-4; 6-2,R128,131,2,1,62,95,44,62,21,33,4,6,15,65,95,9,1,63,106,40,63,19,43,5,10,15,59,106
2011-06-20 00:00:00.000,Wimbledon Great Britain Grand Slams,GRASS,3,Feliciano Lopez,Michael Berrer,Feliciano Lopez,6-4; 7-5; 6-3,R128,108,16,2,44,75,39,44,23,31,0,0,15,62,75,7,3,65,100,48,65,14,35,5,9,16,62,100
2011-06-20 00:00:00.000,Wimbledon Great Britain Grand Slams,GRASS,3,Victor Hanescu,Jaroslav Pospisil,Victor Hanescu,6-4; 6-3; 6-2,R128,106,18,0,49,71,42,49,8,22,2,4,13,50,71,4,8,42,80,28,42,14,38,4,11,14,42,80
2011-06-20 00:00:00.000,Wimbledon Great Britain Grand Slams,GRASS,3,Andy Roddick,Andreas Beck,Andy Roddick,6-4; 7-6(6); 6-3,R128,135,30,1,65,90,55,65,11,25,1,1,15,66,90,2,1,74,110,46,74,20,36,4,7,16,66,110
2011-06-20 00:00:00.000,Wimbledon Great Britain Grand Slams,GRASS,3,David Ferrer,Benoit Paire,David Ferrer,6-4; 6-4; 6-4,R128,115,3,4,53,86,44,53,16,33,4,6,15,60,86,6,7,53,101,38,53,17,48,3,8,15,55,101
2011-06-20 00:00:00.000,Wimbledon Great Britain Grand Slams,GRASS,3,Ryan Harrison,Ivan Dodig,Ryan Harrison,7-6(5); 6-0; 7-5,R128,134,7,4,57,86,47,57,17,29,3,4,15,64,86,8,4,66,105,46,66,15,39,4,9,15,61,105
2011-06-20 00:00:00.000,Wimbledon Great Britain Grand Slams,GRASS,3,Karol Beck,Carlos Berlocq,Karol Beck,4-6; 7-6(6); 4-6; 6-2; 6-4,R128,243,14,6,101,170,79,101,35,69,11,15,25,114,170,12,3,109,164,78,109,26,55,9,14,25,104,164
2011-06-20 00:00:00.000,Wimbledon Great Britain Grand Slams,GRASS,3,Guillermo Garcia-Lopez,Andrey Golubev,Guillermo Garcia-Lopez,6-3; 6-3 RET,R128,71,3,2,35,50,25,35,6,15,0,2,9,31,50,1,0,34,54,21,34,5,20,3,8,9,26,54
2011-06-20 00:00:00.000,Wimbledon Great Britain Grand Slams,GRASS,3,Fernando Gonzalez,Alexandr Dolgopolov,Fernando Gonzalez,6-3; 6-7(6); 7-6(3); 6-4,R128,138,25,1,82,126,66,82,30,44,2,3,22,96,126,18,7,81,136,67,81,24,55,5,8,21,91,136
2011-06-20 00:00:00.000,Wimbledon Great Britain Grand Slams,GRASS,3,Rik De Voest,Ruben Ramirez Hidalgo,Rik De Voest,6-2; 6-3; 6-2,R128,127,10,0,69,106,48,69,23,37,9,9,13,71,106,4,7,53,101,27,53,25,48,11,16,12,52,101
2011-06-20 00:00:00.000,Wimbledon Great Britain Grand Slams,GRASS,3,Grigor Dimitrov,Cedrik-Marcel Stebe,Grigor Dimitrov,7-5; 7-5; 7-6(5),R128,160,3,3,87,121,59,87,20,34,6,9,18,79,121,3,3,79,117,51,79,18,38,5,10,18,69,117
2011-06-20 00:00:00.000,Wimbledon Great Britain Grand Slams,GRASS,3,Jo-Wilfried Tsonga,Go Soeda,Jo-Wilfried Tsonga,6-3; 7-6(4); 6-2,R128,132,18,5,63,99,50,63,19,36,12,13,15,69,99,4,6,59,110,41,59,22,51,6,10,14,63,110
2011-06-20 00:00:00.000,Wimbledon Great Britain Grand Slams,GRASS,3,Nicolas Almagro,Jarkko Nieminen,Nicolas Almagro,6-7(5); 6-3; 6-4; 6-4,R128,143,18,1,75,119,60,75,28,44,2,3,21,88,119,7,7,83,124,59,83,25,41,6,10,20,84,124
2011-06-20 00:00:00.000,Wimbledon Great Britain Grand Slams,GRASS,3,John Isner,Nicolas Mahut,John Isner,7-6(4); 6-2; 7-6(6),R128,123,8,2,66,97,52,66,20,31,1,2,16,72,97,8,6,68,104,48,68,21,36,2,5,16,69,104
2011-06-20 00:00:00.000,Wimbledon Great Britain Grand Slams,GRASS,3,Somdev Devvarman,Denis Gremelmayr,Somdev Devvarman,6-4; 4-2 RET,R128,65,9,0,34,54,25,34,13,20,4,4,8,38,54,2,1,33,53,20,33,13,20,6,8,8,33,53
2011-06-20 00:00:00.000,Wimbledon Great Britain Grand Slams,GRASS,3,Mikhail Youzhny,Juan Monaco,Mikhail Youzhny,4-6; 6-2; 6-2; 4-6; 6-4,R128,193,4,2,88,135,63,88,26,47,2,6,23,89,135,6,2,103,136,61,103,21,33,9,16,23,82,136
2011-06-20 00:00:00.000,Wimbledon Great Britain Grand Slams,GRASS,3,David Nalbandian,Julian Reister,David Nalbandian,7-5; 6-2; 6-3,R128,106,9,3,55,81,42,55,17,26,2,4,15,59,81,7,8,66,103,43,66,12,37,4,10,14,55,103
2011-06-20 00:00:00.000,Wimbledon Great Britain Grand Slams,GRASS,3,Andreas Haider-Maurer,Florent Serra,Andreas Haider-Maurer,7-6(5); 6-3; 6-3,R128,111,39,7,72,107,64,72,13,35,3,3,15,77,107,8,7,60,99,43,60,20,39,5,8,15,63,99
2011-06-20 00:00:00.000,Wimbledon Great Britain Grand Slams,GRASS,3,Adrian Mannarino,Conor Niland,Adrian Mannarino,4-6; 6-4; 7-6(7); 4-6; 6-4,R128,240,4,5,116,184,77,116,35,68,12,19,26,112,184,10,8,122,184,79,122,31,62,13,20,26,110,184
2011-06-20 00:00:00.000,Wimbledon Great Britain Grand Slams,GRASS,3,Roger Federer,Mikhail Kukushkin,Roger Federer,7-6(2); 6-4; 6-2,R128,102,12,1,57,80,51,57,17,23,3,3,15,68,80,4,1,61,93,41,61,18,32,4,7,15,59,93
2011-06-20 00:00:00.000,Wimbledon Great Britain Grand Slams,GRASS,3,Robin Soderling,Philipp Petzschner,Robin Soderling,6-4; 6-4; 2-6; 7-6(5),R128,194,8,6,97,169,69,97,31,72,16,21,20,100,169,6,3,85,128,61,85,20,43,6,11,20,81,128
2011-06-20 00:00:00.000,Wimbledon Great Britain Grand Slams,GRASS,3,Lleyton Hewitt,Kei Nishikori,Lleyton Hewitt,6-1; 7-6(4); 6-7(7); 6-3,R128,187,5,7,88,140,64,88,28,52,5,7,20,92,140,2,6,76,132,50,76,29,56,4,10,20,79,132
2011-06-20 00:00:00.000,Wimbledon Great Britain Grand Slams,GRASS,3,Igor Andreev,Teymuraz Gabashvili,Igor Andreev,6-4; 7-6(5); 6-7(4); 4-6; 6-3,R128,218,19,6,110,167,88,110,29,57,5,8,27,117,167,10,5,103,163,75,103,36,60,10,14,26,111,163
2011-06-20 00:00:00.000,Wimbledon Great Britain Grand Slams,GRASS,3,Bernard Tomic,Nikolay Davydenko,Bernard Tomic,7-5; 6-3; 7-5,R128,112,6,1,73,92,57,73,13,19,2,3,17,70,92,4,6,72,107,47,72,16,35,11,15,16,63,107
2011-06-20 00:00:00.000,Wimbledon Great Britain Grand Slams,GRASS,3,Florian Mayer,Daniel Evans,Florian Mayer,7-6(5); 7-6(1); 3-6; 6-4,R128,173,12,2,92,128,66,92,19,36,2,7,21,85,128,11,14,92,149,64,92,26,57,9,14,22,90,149
2011-06-20 00:00:00.000,Wimbledon Great Britain Grand Slams,GRASS,3,Xavier Malisse,Mischa Zverev,Xavier Malisse,6-2; 6-3; 6-2,R128,87,7,3,56,82,42,56,14,26,5,6,13,56,82,5,1,54,76,27,54,11,22,4,10,12,38,76
2011-06-20 00:00:00.000,Wimbledon Great Britain Grand Slams,GRASS,3,Dmitry Tursunov,Ernests Gulbis,Dmitry Tursunov,6-3; 3-6; 7-6(12); 7-6(1),R128,167,10,6,87,137,65,87,35,50,7,9,21,100,137,24,5,105,138,81,105,17,33,5,7,21,98,138
2011-06-20 00:00:00.000,Wimbledon Great Britain Grand Slams,GRASS,3,Jurgen Melzer,Alejandro Falla,Jurgen Melzer,3-6; 7-6(5); 6-2; 6-2,R128,159,8,3,88,137,65,88,26,49,4,5,18,91,137,5,2,89,128,61,89,22,39,13,17,19,83,128
2011-06-20 00:00:00.000,Wimbledon Great Britain Grand Slams,GRASS,3,Viktor Troicki,Maximo Gonzalez,Viktor Troicki,3-6; 6-0; 7-6(3); 6-3,R128,133,28,7,78,120,58,78,24,42,6,8,19,82,120,0,4,68,102,47,68,16,34,5,9,17,63,102
2011-06-20 00:00:00.000,Wimbledon Great Britain Grand Slams,GRASS,3,Yen-Hsun Lu,Tommy Robredo,Yen-Hsun Lu,6-4; 6-4; 6-1,R128,97,6,2,44,70,36,44,17,26,1,1,13,53,70,2,2,44,77,28,44,18,33,1,6,14,46,77
2011-06-20 00:00:00.000,Wimbledon Great Britain Grand Slams,GRASS,3,Ricardo Mello,Frank Dancevic,Ricardo Mello,3-6; 3-6; 6-4; 7-6(6); 6-2,R128,168,2,4,103,156,67,103,33,53,8,13,24,100,156,23,7,86,145,62,86,34,59,7,12,24,96,145
2011-06-20 00:00:00.000,Wimbledon Great Britain Grand Slams,GRASS,3,Michael Llodra,James Ward,Michael Llodra,6-3; 7-6(4); 6-3,R128,117,10,4,77,105,64,77,12,28,5,5,16,76,105,6,10,50,98,41,50,21,48,3,5,14,62,98
2011-06-20 00:00:00.000,Wimbledon Great Britain Grand Slams,GRASS,3,Marcos Baghdatis,James Blake,Marcos Baghdatis,6-4; 6-2; 6-7(5); 4-6; 6-4,R128,168,17,3,90,143,69,90,31,53,3,6,25,100,143,6,5,117,170,80,117,24,53,5,11,25,104,170
2011-06-20 00:00:00.000,Wimbledon Great Britain Grand Slams,GRASS,3,Andreas Seppi,Albert Montanes,Andreas Seppi,6-4; 6-4; 7-5,R128,107,12,3,65,98,49,65,18,33,4,6,16,67,98,9,7,59,104,43,59,20,45,4,9,16,63,104
2011-06-20 00:00:00.000,Wimbledon Great Britain Grand Slams,GRASS,3,Kevin Anderson,Illya Marchenko,Kevin Anderson,6-7(5); 7-6(7); 6-4; 4-6; 6-1,R128,232,18,4,111,150,85,111,26,39,6,8,26,111,150,6,7,100,167,74,100,36,67,6,10,25,110,167
2011-06-20 00:00:00.000,Wimbledon Great Britain Grand Slams,GRASS,3,Novak Djokovic,Jeremy Chardy,Novak Djokovic,6-4; 6-1; 6-1,R128,80,9,1,45,61,38,45,12,16,1,1,12,50,61,9,2,44,75,30,44,8,31,4,10,12,38,75
2011-06-20 00:00:00.000,Wimbledon Great Britain Grand Slams,GRASS,3,Rafael Nadal,Ryan Sweeting,Rafael Nadal,6-3; 6-2; 6-4,R64,127,9,0,54,77,42,54,15,23,1,2,14,57,77,4,10,61,102,40,61,15,41,9,14,13,55,102
2011-06-20 00:00:00.000,Wimbledon Great Britain Grand Slams,GRASS,3,Gilles Muller,Milos Raonic,Gilles Muller,2-3 RET,R64,24,5,0,13,15,10,13,0,2,2,3,3,10,15,5,0,11,14,6,11,3,3,1,1,2,9,14
2011-06-20 00:00:00.000,Wimbledon Great Britain Grand Slams,GRASS,3,Juan Martin Del Potro,Olivier Rochus,Juan Martin Del Potro,6-7(7); 6-1; 6-0; 6-4,R64,158,30,3,67,96,60,67,20,29,2,2,18,80,96,1,7,81,137,53,81,23,56,10,16,17,76,137
2011-06-20 00:00:00.000,Wimbledon Great Britain Grand Slams,GRASS,3,Gilles Simon,Dudi Sela,Gilles Simon,7-6(3); 6-4; 7-5,R64,124,3,1,54,98,44,54,22,44,3,6,17,66,98,3,0,76,111,47,76,19,35,9,14,17,66,111
2011-06-20 00:00:00.000,Wimbledon Great Britain Grand Slams,GRASS,3,Mardy Fish,Denis Istomin,Mardy Fish,7-6(6); 6-4; 6-4,R64,136,13,2,61,100,50,61,23,39,4,5,16,73,100,13,3,76,106,56,76,12,30,3,6,16,68,106
2011-06-20 00:00:00.000,Wimbledon Great Britain Grand Slams,GRASS,3,Robin Haase,Fernando Verdasco,Robin Haase,6-3; 6-4; 4-6; 6-2,R64,152,12,3,67,115,53,67,24,48,4,6,19,77,115,12,11,93,149,61,93,23,56,16,21,18,84,149
2011-06-20 00:00:00.000,Wimbledon Great Britain Grand Slams,GRASS,3,Alex Bogomolov Jr.,Juan Ignacio Chela,Alex Bogomolov Jr.,6-0; 6-3; 6-4,R64,92,5,3,55,74,43,55,11,19,1,1,13,54,74,2,3,68,90,38,68,9,22,9,14,12,47,90
2011-06-20 00:00:00.000,Wimbledon Great Britain Grand Slams,GRASS,3,Tomas Berdych,Julien Benneteau,Tomas Berdych,6-1; 6-4; 6-2,R64,97,10,1,38,65,34,38,16,27,0,1,13,50,65,7,4,52,74,32,52,4,22,2,8,12,36,74
2011-06-20 00:00:00.000,Wimbledon Great Britain Grand Slams,GRASS,3,Andy Murray,Tobias Kamke,Andy Murray,6-3; 6-3; 7-5,R64,117,6,3,45,84,38,45,24,39,1,1,15,62,84,0,5,49,86,34,49,20,37,4,8,15,54,86
2011-06-20 00:00:00.000,Wimbledon Great Britain Grand Slams,GRASS,3,Ivan Ljubicic,Sergiy Stakhovsky,Ivan Ljubicic,6-4; 6-4; 6-2,R64,114,10,1,54,83,42,54,14,29,5,6,14,56,83,7,1,61,86,40,61,10,25,4,9,14,50,86
2011-06-20 00:00:00.000,Wimbledon Great Britain Grand Slams,GRASS,3,Richard Gasquet,Igor Kunitsyn,Richard Gasquet,6-1; 6-4; 6-4,R64,98,10,1,48,78,38,48,17,30,0,2,14,55,78,4,1,44,76,28,44,13,32,2,8,13,41,76
2011-06-20 00:00:00.000,Wimbledon Great Britain Grand Slams,GRASS,3,Simone Bolelli,Stanislas Wawrinka,Simone Bolelli,7-6(5); 6-3; 7-6(4),R64,153,4,0,86,129,58,86,24,43,12,15,17,82,129,13,2,58,97,46,58,18,39,4,8,16,64,97
2011-06-20 00:00:00.000,Wimbledon Great Britain Grand Slams,GRASS,3,Gael Monfils,Grega Zemlja,Gael Monfils,4-6; 6-3; 6-3; 7-6(7),R64,134,15,2,84,121,63,84,22,37,6,9,20,85,121,4,1,88,125,61,88,19,37,5,10,20,80,125
2011-06-20 00:00:00.000,Wimbledon Great Britain Grand Slams,GRASS,3,Lukasz Kubot,Ivo Karlovic,Lukasz Kubot,7-6(2); 6-3; 6-3,R64,123,5,3,65,94,55,65,18,29,4,4,15,73,94,19,2,62,86,46,62,11,24,5,8,15,57,86
2011-06-20 00:00:00.000,Wimbledon Great Britain Grand Slams,GRASS,3,Feliciano Lopez,Rainer Schuettler,Feliciano Lopez,7-6(3); 6-7(3); 6-2; 6-2,R64,172,28,6,80,123,68,80,23,43,7,8,20,91,123,8,6,86,155,58,86,34,69,9,14,20,92,155
2011-06-20 00:00:00.000,Wimbledon Great Britain Grand Slams,GRASS,3,Andy Roddick,Victor Hanescu,Andy Roddick,6-4; 6-3; 6-4,R64,112,15,0,43,66,40,43,17,23,1,1,14,57,66,8,2,65,95,43,65,15,30,6,10,15,58,95
2011-06-20 00:00:00.000,Wimbledon Great Britain Grand Slams,GRASS,3,David Ferrer,Ryan Harrison,David Ferrer,6-7(6); 6-1; 4-6; 6-3; 6-2,R64,210,7,3,89,126,71,89,18,37,0,3,23,89,126,10,8,99,166,67,99,28,67,17,25,23,95,166
2011-06-20 00:00:00.000,Wimbledon Great Britain Grand Slams,GRASS,3,Karol Beck,Guillermo Garcia-Lopez,Karol Beck,7-6(5); 6-4; 3-6; 6-4,R64,183,9,7,80,129,59,80,25,49,8,12,20,84,129,1,2,80,125,56,80,23,45,3,8,21,79,125
2011-06-20 00:00:00.000,Wimbledon Great Britain Grand Slams,GRASS,3,Fernando Gonzalez,Rik De Voest,Fernando Gonzalez,6-4; 6-4; 6-4,R64,105,6,1,44,80,35,44,25,36,3,4,15,60,80,7,2,70,102,44,70,16,32,4,8,15,60,102
2011-06-20 00:00:00.000,Wimbledon Great Britain Grand Slams,GRASS,3,Jo-Wilfried Tsonga,Grigor Dimitrov,Jo-Wilfried Tsonga,6-7(4); 6-4; 6-4; 7-6(8),R64,213,19,8,103,166,75,103,32,63,14,16,22,107,166,3,5,118,170,78,118,25,52,8,12,22,103,170
2011-06-20 00:00:00.000,Wimbledon Great Britain Grand Slams,GRASS,3,Nicolas Almagro,John Isner,Nicolas Almagro,7-6(3); 7-6(5); 6-7(5); 6-3,R64,159,25,2,90,140,80,90,30,50,0,0,23,110,140,28,2,103,142,86,103,19,39,3,4,22,105,142
2011-06-20 00:00:00.000,Wimbledon Great Britain Grand Slams,GRASS,3,Mikhail Youzhny,Somdev Devvarman,Mikhail Youzhny,6-2; 6-4; 6-4,R64,117,4,1,60,90,46,60,17,30,6,6,14,63,90,3,0,59,85,39,59,10,26,4,8,14,49,85
2011-06-20 00:00:00.000,Wimbledon Great Britain Grand Slams,GRASS,3,David Nalbandian,Andreas Haider-Maurer,David Nalbandian,6-3; 3-6; 6-4; 6-4,R64,157,7,9,62,116,47,62,32,54,6,8,19,79,116,13,7,72,129,55,72,26,57,14,18,19,81,129
2011-06-20 00:00:00.000,Wimbledon Great Britain Grand Slams,GRASS,3,Roger Federer,Adrian Mannarino,Roger Federer,6-2; 6-3; 6-2,R64,88,11,0,41,64,35,41,18,23,3,3,13,53,64,0,1,44,75,24,44,15,31,5,10,12,39,75
2011-06-20 00:00:00.000,Wimbledon Great Britain Grand Slams,GRASS,3,Robin Soderling,Lleyton Hewitt,Robin Soderling,6-7(5); 3-6; 7-5; 6-4; 6-4,R64,234,28,5,101,154,82,101,24,53,5,7,26,106,154,15,1,85,166,62,85,50,81,2,6,27,112,166
2011-06-20 00:00:00.000,Wimbledon Great Britain Grand Slams,GRASS,3,Bernard Tomic,Igor Andreev,Bernard Tomic,4-6; 5-7; 6-3; 6-4; 6-1,R64,164,10,1,106,146,74,106,23,40,7,10,24,97,146,11,8,80,141,56,80,30,61,2,8,24,86,141
2011-06-20 00:00:00.000,Wimbledon Great Britain Grand Slams,GRASS,3,Xavier Malisse,Florian Mayer,Xavier Malisse,1-6; 6-3; 6-2; 6-2,R64,95,7,0,49,88,40,49,20,39,3,5,16,60,88,8,5,49,89,38,49,16,40,2,7,16,54,89
2011-06-20 00:00:00.000,Wimbledon Great Britain Grand Slams,GRASS,3,Jurgen Melzer,Dmitry Tursunov,Jurgen Melzer,6-3; 2-6; 7-6(5); 7-6(1),R64,188,9,3,85,140,58,85,30,55,6,11,20,88,140,12,9,99,152,66,99,23,53,9,14,21,89,152
2011-06-20 00:00:00.000,Wimbledon Great Britain Grand Slams,GRASS,3,Yen-Hsun Lu,Viktor Troicki,Yen-Hsun Lu,7-6(5); 6-4; 6-4,R64,134,3,3,63,96,49,63,19,33,5,6,16,68,96,17,8,56,107,47,56,21,51,3,6,16,68,107
2011-06-20 00:00:00.000,Wimbledon Great Britain Grand Slams,GRASS,3,Michael Llodra,Ricardo Mello,Michael Llodra,6-2; 4-6; 6-2; 6-3,R64,133,23,1,69,103,57,69,20,34,3,4,18,77,103,4,2,91,132,56,91,17,41,10,15,17,73,132
2011-06-20 00:00:00.000,Wimbledon Great Britain Grand Slams,GRASS,3,Marcos Baghdatis,Andreas Seppi,Marcos Baghdatis,6-4; 7-6(4); 7-5,R64,147,14,3,57,114,46,57,31,57,7,10,17,77,114,9,2,70,109,48,70,20,39,6,11,17,68,109
2011-06-20 00:00:00.000,Wimbledon Great Britain Grand Slams,GRASS,3,Novak Djokovic,Kevin Anderson,Novak Djokovic,6-3; 6-4; 6-2,R64,114,7,4,64,87,48,64,12,23,5,6,14,60,87,8,3,50,72,30,50,9,22,4,9,13,39,72
2011-06-20 00:00:00.000,Wimbledon Great Britain Grand Slams,GRASS,3,Rafael Nadal,Gilles Muller,Rafael Nadal,7-6(6); 7-6(5); 6-0,R32,144,7,1,66,93,55,66,18,27,2,2,15,73,93,17,6,70,96,57,70,11,26,3,6,15,68,96
2011-06-20 00:00:00.000,Wimbledon Great Britain Grand Slams,GRASS,3,Juan Martin Del Potro,Gilles Simon,Juan Martin Del Potro,7-6(8); 7-6(5); 7-5,R32,166,12,0,72,112,58,72,25,40,5,6,18,83,112,11,0,87,127,60,87,21,40,5,7,18,81,127
2011-06-20 00:00:00.000,Wimbledon Great Britain Grand Slams,GRASS,3,Mardy Fish,Robin Haase,Mardy Fish,6-3; 6-7(5); 6-2; 1-1 RET,R32,154,11,3,58,99,48,58,25,41,3,3,16,73,99,10,7,107,155,66,107,23,48,17,20,15,89,155
2011-06-20 00:00:00.000,Wimbledon Great Britain Grand Slams,GRASS,3,Tomas Berdych,Alex Bogomolov Jr.,Tomas Berdych,6-2; 6-4; 6-3,R32,103,16,1,36,69,32,36,23,33,0,0,13,55,69,2,4,59,84,37,59,10,25,4,9,14,47,84
2011-06-20 00:00:00.000,Wimbledon Great Britain Grand Slams,GRASS,3,Andy Murray,Ivan Ljubicic,Andy Murray,6-4; 4-6; 6-1; 7-6(4),R32,176,15,7,73,120,57,73,21,47,3,6,20,78,120,9,4,83,122,58,83,15,39,7,12,19,73,122
2011-06-20 00:00:00.000,Wimbledon Great Britain Grand Slams,GRASS,3,Richard Gasquet,Simone Bolelli,Richard Gasquet,6-3; 6-2; 6-4,R32,105,12,1,60,84,46,60,14,24,3,4,14,60,84,0,0,47,78,26,47,17,31,4,9,13,43,78
2011-06-20 00:00:00.000,Wimbledon Great Britain Grand Slams,GRASS,3,Lukasz Kubot,Gael Monfils,Lukasz Kubot,6-3; 3-6; 6-3; 6-3,R32,136,4,6,73,123,48,73,27,50,6,9,18,75,123,17,6,64,101,50,64,13,37,3,9,18,63,101
2011-06-20 00:00:00.000,Wimbledon Great Britain Grand Slams,GRASS,3,Feliciano Lopez,Andy Roddick,Feliciano Lopez,7-6(2); 7-6(2); 6-4,R32,138,28,3,70,106,57,70,20,36,3,4,17,77,106,23,6,69,109,54,69,20,40,4,6,17,74,109
2011-06-20 00:00:00.000,Wimbledon Great Britain Grand Slams,GRASS,3,David Ferrer,Karol Beck,David Ferrer,6-4; 6-3; 6-3,R32,123,3,1,60,86,43,60,17,26,5,6,14,60,86,4,3,53,98,35,53,19,45,6,11,14,54,98
2011-06-20 00:00:00.000,Wimbledon Great Britain Grand Slams,GRASS,3,Jo-Wilfried Tsonga,Fernando Gonzalez,Jo-Wilfried Tsonga,6-3; 6-4; 6-3,R32,84,29,3,56,72,50,56,9,16,3,3,14,59,72,3,0,46,76,35,46,14,30,4,8,14,49,76
2011-06-20 00:00:00.000,Wimbledon Great Britain Grand Slams,GRASS,3,Mikhail Youzhny,Nicolas Almagro,Mikhail Youzhny,4-6; 6-3; 7-6(3); 6-3,R32,163,18,3,92,128,78,92,18,36,10,11,21,96,128,8,4,68,122,55,68,26,54,5,7,19,81,122
2011-06-20 00:00:00.000,Wimbledon Great Britain Grand Slams,GRASS,3,Roger Federer,David Nalbandian,Roger Federer,6-4; 6-2; 6-4,R32,106,14,0,63,89,49,63,14,26,2,3,14,63,89,5,3,52,85,34,52,16,33,2,7,14,50,85
2011-06-20 00:00:00.000,Wimbledon Great Britain Grand Slams,GRASS,3,Bernard Tomic,Robin Soderling,Bernard Tomic,6-1; 6-4; 7-5,R32,112,13,1,69,100,53,69,18,31,5,5,15,71,100,10,0,48,78,36,48,11,30,3,7,14,47,78
2011-06-20 00:00:00.000,Wimbledon Great Britain Grand Slams,GRASS,3,Xavier Malisse,Jurgen Melzer,Xavier Malisse,7-6(5); 6-3; 6-0,R32,96,19,0,51,78,42,51,14,27,5,6,13,56,78,7,1,57,87,35,57,13,30,1,7,14,48,87
2011-06-20 00:00:00.000,Wimbledon Great Britain Grand Slams,GRASS,3,Michael Llodra,Yen-Hsun Lu,Michael Llodra,6-3; 6-3; 6-1,R32,103,19,3,52,74,43,52,12,22,3,3,13,55,74,3,4,51,86,32,51,13,35,7,12,12,45,86
2011-06-20 00:00:00.000,Wimbledon Great Britain Grand Slams,GRASS,3,Novak Djokovic,Marcos Baghdatis,Novak Djokovic,6-4; 4-6; 6-3; 6-4,R32,195,10,4,80,122,60,80,24,42,4,5,20,84,122,14,4,70,132,51,70,33,62,8,11,19,84,132
2011-06-20 00:00:00.000,Wimbledon Great Britain Grand Slams,GRASS,3,Rafael Nadal,Juan Martin Del Potro,Rafael Nadal,7-6(6); 3-6; 7-6(4); 6-4,R16,232,13,1,94,129,74,94,19,35,2,3,21,93,129,11,4,100,142,76,100,21,42,4,5,22,97,142
2011-06-20 00:00:00.000,Wimbledon Great Britain Grand Slams,GRASS,3,Mardy Fish,Tomas Berdych,Mardy Fish,7-6(5); 6-4; 6-4,R16,142,23,2,58,93,53,58,18,35,2,2,16,71,93,7,3,62,110,46,62,27,48,5,7,16,73,110
2011-06-20 00:00:00.000,Wimbledon Great Britain Grand Slams,GRASS,3,Andy Murray,Richard Gasquet,Andy Murray,7-6(3); 6-3; 6-2,R16,124,14,2,56,93,45,56,22,37,2,2,15,67,93,2,2,62,84,43,62,11,22,2,5,14,54,84
2011-06-20 00:00:00.000,Wimbledon Great Britain Grand Slams,GRASS,3,Feliciano Lopez,Lukasz Kubot,Feliciano Lopez,3-6; 6-7(5); 7-6(7); 7-5; 7-5,R16,258,28,6,94,177,75,94,41,83,5,8,28,116,177,27,8,127,184,95,127,24,57,6,10,29,119,184
2011-06-20 00:00:00.000,Wimbledon Great Britain Grand Slams,GRASS,3,Jo-Wilfried Tsonga,David Ferrer,Jo-Wilfried Tsonga,6-3; 6-4; 7-6(1),R16,123,12,2,54,82,50,54,15,28,2,2,15,65,82,7,5,61,101,42,61,24,40,6,9,16,66,101
2011-06-20 00:00:00.000,Wimbledon Great Britain Grand Slams,GRASS,3,Roger Federer,Mikhail Youzhny,Roger Federer,6-7(5); 6-3; 6-3; 6-3,R16,182,14,1,71,114,60,71,22,43,6,7,19,82,114,6,6,89,140,58,89,22,51,8,14,20,80,140
2011-06-20 00:00:00.000,Wimbledon Great Britain Grand Slams,GRASS,3,Bernard Tomic,Xavier Malisse,Bernard Tomic,6-1; 7-5; 6-4,R16,81,10,0,61,83,44,61,20,22,2,2,15,64,83,13,6,47,81,34,47,16,34,7,11,14,50,81
2011-06-20 00:00:00.000,Wimbledon Great Britain Grand Slams,GRASS,3,Novak Djokovic,Michael Llodra,Novak Djokovic,6-3; 6-3; 6-3,R16,101,9,1,50,72,42,50,16,22,0,0,14,58,72,8,7,44,82,32,44,16,38,7,11,13,48,82
2011-06-20 00:00:00.000,Wimbledon Great Britain Grand Slams,GRASS,3,Rafael Nadal,Mardy Fish,Rafael Nadal,6-3; 6-3; 5-7; 6-4,Q,173,5,1,71,105,55,71,20,34,4,7,20,75,105,12,0,65,123,49,65,23,58,6,12,20,72,123
2011-06-20 00:00:00.000,Wimbledon Great Britain Grand Slams,GRASS,3,Andy Murray,Feliciano Lopez,Andy Murray,6-3; 6-4; 6-4,Q,121,13,3,47,84,40,47,24,37,2,2,15,64,84,7,5,63,98,48,63,11,35,7,10,14,59,98
2011-06-20 00:00:00.000,Wimbledon Great Britain Grand Slams,GRASS,3,Jo-Wilfried Tsonga,Roger Federer,Jo-Wilfried Tsonga,3-6; 6-7(3); 6-4; 6-4; 6-4,Q,188,18,4,102,145,74,102,29,43,0,1,25,103,145,17,1,103,137,80,103,24,34,6,9,26,104,137
2011-06-20 00:00:00.000,Wimbledon Great Britain Grand Slams,GRASS,3,Novak Djokovic,Bernard Tomic,Novak Djokovic,6-2; 3-6; 6-3; 7-5,Q,161,14,4,69,109,54,69,18,40,2,5,19,72,109,7,2,94,144,59,94,24,50,9,15,19,83,144
2011-06-20 00:00:00.000,Wimbledon Great Britain Grand Slams,GRASS,3,Rafael Nadal,Andy Murray,Rafael Nadal,5-7; 6-2; 6-2; 6-4,S,179,6,1,70,103,57,70,19,33,3,4,19,76,103,15,5,66,113,48,66,23,47,3,8,19,71,113
2011-06-20 00:00:00.000,Wimbledon Great Britain Grand Slams,GRASS,3,Novak Djokovic,Jo-Wilfried Tsonga,Novak Djokovic,7-6(4); 6-2; 6-7(9); 6-3,S,187,5,1,79,120,61,79,28,41,2,5,21,89,120,12,5,90,133,61,90,20,43,6,12,20,81,133
2011-06-20 00:00:00.000,Wimbledon Great Britain Grand Slams,GRASS,3,Novak Djokovic,Rafael Nadal,Novak Djokovic,6-4; 6-1; 1-6; 6-3,F,148,7,1,69,95,50,69,14,26,3,6,17,64,95,5,1,64,82,43,64,8,18,1,6,16,51,82
2011-07-04 00:00:00.000,Newport RI; U.S.A. ATP World Tour 250,GRASS,2,John Isner,Karol Beck,John Isner,6-3; 6-2,R32,64,10,2,33,51,26,33,13,18,2,2,9,39,51,2,10,21,51,13,21,14,30,3,6,8,27,51
2011-07-04 00:00:00.000,Newport RI; U.S.A. ATP World Tour 250,GRASS,2,Arnaud Clement,Ryan Harrison,Arnaud Clement,6-4; 6-1,R32,75,1,0,32,58,23,32,16,26,0,0,9,39,58,6,6,27,51,17,27,11,24,5,8,8,28,51
2011-07-04 00:00:00.000,Newport RI; U.S.A. ATP World Tour 250,GRASS,2,Ruben Bemelmans,Denis Gremelmayr,Ruben Bemelmans,6-4; 6-2,R32,66,2,6,28,61,22,28,17,33,5,6,9,39,61,2,3,33,61,19,33,13,28,7,11,9,32,61
2011-07-04 00:00:00.000,Newport RI; U.S.A. ATP World Tour 250,GRASS,2,Alex Bogomolov Jr.,Mischa Zverev,Alex Bogomolov Jr.,4-6; 6-3; 6-1,R32,94,1,3,51,81,35,51,16,30,5,7,13,51,81,2,1,40,74,27,40,12,34,3,8,13,39,74
2011-07-04 00:00:00.000,Newport RI; U.S.A. ATP World Tour 250,GRASS,2,Jimmy Wang,Igor Kunitsyn,Jimmy Wang,4-6; 7-5; 6-2,R32,151,4,2,55,95,39,55,18,40,4,9,15,57,95,4,5,51,97,29,51,20,46,5,12,15,49,97
2011-07-04 00:00:00.000,Newport RI; U.S.A. ATP World Tour 250,GRASS,2,Edouard Roger-Vasselin,Richard Bloomfield,Edouard Roger-Vasselin,6-4; 6-0,R32,72,3,2,21,38,19,21,10,17,0,1,8,29,38,7,10,21,60,14,21,15,39,6,11,8,29,60
2011-07-04 00:00:00.000,Newport RI; U.S.A. ATP World Tour 250,GRASS,2,Donald Young,Paul Capdeville,Donald Young,6-2; 6-1,R32,52,3,2,25,39,21,25,8,14,0,1,8,29,39,0,5,38,66,18,38,11,28,6,11,7,29,66
2011-07-04 00:00:00.000,Newport RI; U.S.A. ATP World Tour 250,GRASS,2,Tobias Kamke,Alex Bogdanovic,Tobias Kamke,7-6(3); 6-3,R32,97,5,6,44,86,29,44,22,42,11,14,11,51,86,2,4,35,65,22,35,12,30,0,4,10,34,65
2011-07-04 00:00:00.000,Newport RI; U.S.A. ATP World Tour 250,GRASS,2,Olivier Rochus,Greg Jones,Olivier Rochus,6-4; 3-6; 6-3,R32,100,7,4,49,80,38,49,21,31,0,1,14,59,80,15,1,43,71,36,43,16,28,2,4,14,52,71
2011-07-04 00:00:00.000,Newport RI; U.S.A. ATP World Tour 250,GRASS,2,Nicolas Mahut,Sebastian Decoud,Nicolas Mahut,6-1; 6-0,R32,52,8,2,20,34,18,20,11,14,1,1,7,29,34,1,2,29,52,11,29,10,23,6,11,6,21,52
2011-07-04 00:00:00.000,Newport RI; U.S.A. ATP World Tour 250,GRASS,2,Matthias Bachinger,Dustin Brown,Matthias Bachinger,7-6(7); 6-7(5); 6-1,R32,111,11,3,51,97,45,51,30,46,2,2,16,75,97,12,8,50,98,38,50,29,48,2,4,15,67,98
2011-07-04 00:00:00.000,Newport RI; U.S.A. ATP World Tour 250,GRASS,2,Matthew Ebden,Ryan Sweeting,Matthew Ebden,6-4; 6-2,R32,73,8,3,36,57,28,36,8,21,4,6,9,36,57,1,8,38,70,22,38,13,32,6,11,9,35,70
2011-07-04 00:00:00.000,Newport RI; U.S.A. ATP World Tour 250,GRASS,2,Tommy Haas,Michael Berrer,Tommy Haas,7-6(9); 6-4,R32,93,8,3,48,77,36,48,14,29,4,5,11,50,77,3,5,39,69,29,39,17,30,4,6,11,46,69
2011-07-04 00:00:00.000,Newport RI; U.S.A. ATP World Tour 250,GRASS,2,Michael Yani,Dudi Sela,Michael Yani,7-6(5); 6-3,R32,97,4,6,42,80,30,42,19,38,3,5,10,49,80,2,7,39,78,26,39,15,39,3,7,11,41,78
2011-07-04 00:00:00.000,Newport RI; U.S.A. ATP World Tour 250,GRASS,2,Denis Kudla,Ivo Karlovic,Denis Kudla,7-6(4); 4-6; 6-4,R32,130,11,5,55,113,38,55,38,58,4,6,16,76,113,24,7,57,90,45,57,22,33,1,3,16,67,90
2011-07-04 00:00:00.000,Newport RI; U.S.A. ATP World Tour 250,GRASS,2,Grigor Dimitrov,Brian Dabul,Grigor Dimitrov,6-2; 6-4,R32,63,8,2,26,52,23,26,15,26,3,3,9,38,52,2,2,38,51,23,38,8,13,3,6,9,31,51
2011-07-04 00:00:00.000,Newport RI; U.S.A. ATP World Tour 250,GRASS,2,John Isner,Arnaud Clement,John Isner,7-6(6); 6-4,R16,111,11,4,45,65,36,45,12,20,0,1,11,48,65,2,9,47,94,33,47,24,47,10,12,11,57,94
2011-07-04 00:00:00.000,Newport RI; U.S.A. ATP World Tour 250,GRASS,2,Alex Bogomolov Jr.,Ruben Bemelmans,Alex Bogomolov Jr.,2-6; 6-0; 6-1,R16,73,0,1,54,71,33,54,11,17,5,7,11,44,71,4,5,37,61,25,37,9,24,3,8,10,34,61
2011-07-04 00:00:00.000,Newport RI; U.S.A. ATP World Tour 250,GRASS,2,Edouard Roger-Vasselin,Jimmy Wang,Edouard Roger-Vasselin,7-5; 6-4,R16,90,1,4,39,59,25,39,11,20,2,5,11,36,59,0,2,43,76,25,43,14,33,9,14,11,39,76
2011-07-04 00:00:00.000,Newport RI; U.S.A. ATP World Tour 250,GRASS,2,Tobias Kamke,Donald Young,Tobias Kamke,7-6(3); 6-4,R16,98,2,7,35,76,21,35,25,41,3,6,11,46,76,0,4,46,85,29,46,17,39,8,12,11,46,85
2011-07-04 00:00:00.000,Newport RI; U.S.A. ATP World Tour 250,GRASS,2,Olivier Rochus,Nicolas Mahut,Olivier Rochus,6-4; 7-6(3),R16,118,0,4,56,100,37,56,25,44,16,18,11,62,100,7,6,37,67,26,37,13,30,1,4,11,39,67
2011-07-04 00:00:00.000,Newport RI; U.S.A. ATP World Tour 250,GRASS,2,Matthew Ebden,Matthias Bachinger,Matthew Ebden,2-6; 6-4; 6-4,R16,110,8,8,46,83,32,46,18,37,5,9,14,50,83,5,2,48,87,34,48,16,39,3,7,14,50,87
2011-07-04 00:00:00.000,Newport RI; U.S.A. ATP World Tour 250,GRASS,2,Michael Yani,Tommy Haas,Michael Yani,5-2 RET,R16,34,0,1,8,17,4,8,5,9,0,1,3,9,17,1,4,14,31,6,14,7,17,4,7,4,13,31
2011-07-04 00:00:00.000,Newport RI; U.S.A. ATP World Tour 250,GRASS,2,Denis Kudla,Grigor Dimitrov,Denis Kudla,6-1; 6-4,R16,62,4,1,31,64,23,31,19,33,6,7,9,42,64,2,2,30,45,17,30,7,15,2,6,8,24,45
2011-07-04 00:00:00.000,Newport RI; U.S.A. ATP World Tour 250,GRASS,2,John Isner,Alex Bogomolov Jr.,John Isner,7-6(5); 6-4,Q,94,21,1,51,67,40,51,9,16,0,0,11,49,67,0,5,54,82,37,54,15,28,2,3,11,52,82
2011-07-04 00:00:00.000,Newport RI; U.S.A. ATP World Tour 250,GRASS,2,Tobias Kamke,Edouard Roger-Vasselin,Tobias Kamke,3-6; 6-1; 6-3,Q,99,1,5,41,73,30,41,17,32,3,4,12,47,73,3,2,51,84,36,51,15,33,9,13,13,51,84
2011-07-04 00:00:00.000,Newport RI; U.S.A. ATP World Tour 250,GRASS,2,Olivier Rochus,Matthew Ebden,Olivier Rochus,7-6(5); 6-3,Q,87,2,1,33,70,28,33,23,37,2,2,11,51,70,5,4,39,62,28,39,14,23,0,1,10,42,62
2011-07-04 00:00:00.000,Newport RI; U.S.A. ATP World Tour 250,GRASS,2,Michael Yani,Denis Kudla,Michael Yani,6-3; 6-7(5); 7-5,Q,131,7,5,64,112,37,64,23,48,3,8,16,60,112,3,8,56,109,31,56,25,53,5,13,17,56,109
2011-07-04 00:00:00.000,Newport RI; U.S.A. ATP World Tour 250,GRASS,2,John Isner,Tobias Kamke,John Isner,7-5; 7-6(4),S,98,12,3,49,65,42,49,11,16,1,1,12,53,65,4,8,41,90,32,41,26,49,5,6,12,58,90
2011-07-04 00:00:00.000,Newport RI; U.S.A. ATP World Tour 250,GRASS,2,Olivier Rochus,Michael Yani,Olivier Rochus,6-2; 6-4,S,73,3,1,32,48,27,32,10,16,0,0,9,37,48,8,2,43,64,29,43,9,21,3,6,9,38,64
2011-07-04 00:00:00.000,Newport RI; U.S.A. ATP World Tour 250,GRASS,2,John Isner,Olivier Rochus,John Isner,6-3; 7-6(6),F,103,22,1,42,64,38,42,14,22,1,1,11,52,64,1,1,47,84,31,47,21,37,9,10,10,52,84
2011-07-11 00:00:00.000,Bsstad Sweden ATP World Tour 250,CLAY,2,Robin Soderling,N/A Bye,Robin Soderling,,R32,0,0,0,0,0,0,0,0,0,0,0,0,0,0,0,0,0,0,0,0,0,0,0,0,0,0,0
2011-07-11 00:00:00.000,Bsstad Sweden ATP World Tour 250,CLAY,2,Diego Junqueira,Igor Andreev,Diego Junqueira,7-6(3); 3-6; 6-4,R32,141,0,1,70,90,48,70,10,20,6,10,16,58,90,4,4,59,95,43,59,17,36,8,11,15,60,95
2011-07-11 00:00:00.000,Bsstad Sweden ATP World Tour 250,CLAY,2,Jonathan Dasnieres de Veigy,Andreas Vinciguerra,Jonathan Dasnieres de Veigy,6-1; 1-6; 6-3,R32,101,3,7,46,69,34,46,9,23,2,5,12,43,69,1,2,61,82,39,61,7,21,6,10,11,46,82
2011-07-11 00:00:00.000,Bsstad Sweden ATP World Tour 250,CLAY,2,Potito Starace,Julian Reister,Potito Starace,7-6(6); 6-3,R32,88,0,0,51,67,34,51,12,16,2,4,11,46,67,5,4,37,61,24,37,14,24,4,7,10,38,61
2011-07-11 00:00:00.000,Bsstad Sweden ATP World Tour 250,CLAY,2,Tomas Berdych,N/A Bye,Tomas Berdych,,R32,0,0,0,0,0,0,0,0,0,0,0,0,0,0,0,0,0,0,0,0,0,0,0,0,0,0,0
2011-07-11 00:00:00.000,Bsstad Sweden ATP World Tour 250,CLAY,2,Teymuraz Gabashvili,Michael Yani,Teymuraz Gabashvili,6-3; 3-6; 6-3,R32,129,3,5,52,93,36,52,24,41,0,1,14,60,93,7,1,60,90,41,60,14,30,9,11,13,55,90
2011-07-11 00:00:00.000,Bsstad Sweden ATP World Tour 250,CLAY,2,Blaz Kavcic,Julien Benneteau,Blaz Kavcic,6-4; 4-6; 7-5,R32,174,4,2,80,110,47,80,13,30,8,14,16,60,110,5,4,69,103,45,69,8,34,3,10,16,53,103
2011-07-11 00:00:00.000,Bsstad Sweden ATP World Tour 250,CLAY,2,Juan Monaco,Carlos Berlocq,Juan Monaco,6-7(5); 7-6(7); 6-2,R32,212,0,3,97,145,63,97,27,48,16,18,16,90,145,3,2,72,116,48,72,22,44,4,8,16,70,116
2011-07-11 00:00:00.000,Bsstad Sweden ATP World Tour 250,CLAY,2,Ruben Ramirez Hidalgo,Andrey Golubev,Ruben Ramirez Hidalgo,6-7(4); 6-1; 6-2,R32,131,1,3,50,95,30,50,25,45,7,10,13,55,95,2,7,48,88,30,48,12,40,1,9,14,42,88
2011-07-11 00:00:00.000,Bsstad Sweden ATP World Tour 250,CLAY,2,Michael Ryderstedt,Maximo Gonzalez,Michael Ryderstedt,6-4; 2-6; 6-2,R32,125,6,0,53,77,36,53,15,24,1,3,13,51,77,4,3,55,90,35,55,19,35,4,7,13,54,90
2011-07-11 00:00:00.000,Bsstad Sweden ATP World Tour 250,CLAY,2,Guillermo Olaso,Antonio Veic,Guillermo Olaso,6-4; 6-1,R32,76,2,4,35,61,26,35,12,26,5,6,8,38,61,2,4,35,55,19,35,9,20,5,10,9,28,55
2011-07-11 00:00:00.000,Bsstad Sweden ATP World Tour 250,CLAY,2,Nicolas Almagro,N/A Bye,Nicolas Almagro,,R32,0,0,0,0,0,0,0,0,0,0,0,0,0,0,0,0,0,0,0,0,0,0,0,0,0,0,0
2011-07-11 00:00:00.000,Bsstad Sweden ATP World Tour 250,CLAY,2,Filippo Volandri,Tommy Robredo,Filippo Volandri,7-5; 5-5 RET,R32,110,0,2,48,64,29,48,9,16,1,5,11,38,64,1,1,45,80,25,45,18,35,6,11,11,43,80
2011-07-11 00:00:00.000,Bsstad Sweden ATP World Tour 250,CLAY,2,Andreas Haider-Maurer,Mikhail Kukushkin,Andreas Haider-Maurer,7-5; 6-2,R32,86,11,3,42,74,30,42,12,32,5,8,10,42,74,0,1,28,48,14,28,8,20,2,8,10,22,48
2011-07-11 00:00:00.000,Bsstad Sweden ATP World Tour 250,CLAY,2,Pere Riba,Christian Lindell,Pere Riba,6-4; 6-2,R32,89,3,1,30,54,23,30,13,24,2,4,9,36,54,1,1,35,57,16,35,11,22,2,7,9,27,57
2011-07-11 00:00:00.000,Bsstad Sweden ATP World Tour 250,CLAY,2,David Ferrer,N/A Bye,David Ferrer,,R32,0,0,0,0,0,0,0,0,0,0,0,0,0,0,0,0,0,0,0,0,0,0,0,0,0,0,0
2011-07-11 00:00:00.000,Bsstad Sweden ATP World Tour 250,CLAY,2,Robin Soderling,Diego Junqueira,Robin Soderling,6-0; 6-1,R16,47,3,1,25,35,19,25,7,10,0,1,7,26,35,1,1,22,32,5,22,2,10,1,7,6,7,32
2011-07-11 00:00:00.000,Bsstad Sweden ATP World Tour 250,CLAY,2,Potito Starace,Jonathan Dasnieres de Veigy,Potito Starace,6-0; 6-7(5); 6-2,R16,134,0,1,68,87,46,68,10,19,5,7,13,56,87,3,3,71,100,43,71,8,29,9,16,13,51,100
2011-07-11 00:00:00.000,Bsstad Sweden ATP World Tour 250,CLAY,2,Tomas Berdych,Teymuraz Gabashvili,Tomas Berdych,6-2; 6-2,R16,86,9,2,34,54,24,34,13,20,1,1,8,37,54,0,1,25,56,16,25,13,31,2,6,8,29,56
2011-07-11 00:00:00.000,Bsstad Sweden ATP World Tour 250,CLAY,2,Blaz Kavcic,Juan Monaco,Blaz Kavcic,W/O,R16,0,0,0,0,0,0,0,0,0,0,0,0,0,0,0,0,0,0,0,0,0,0,0,0,0,0,0
2011-07-11 00:00:00.000,Bsstad Sweden ATP World Tour 250,CLAY,2,Michael Ryderstedt,Ruben Ramirez Hidalgo,Michael Ryderstedt,6-4; 6-2,R16,91,6,4,44,64,33,44,8,20,6,7,9,41,64,0,0,35,55,19,35,12,20,2,6,9,31,55
2011-07-11 00:00:00.000,Bsstad Sweden ATP World Tour 250,CLAY,2,Nicolas Almagro,Guillermo Olaso,Nicolas Almagro,6-2; 6-3,R16,56,3,5,30,55,25,30,12,25,2,2,8,37,55,3,2,29,52,17,29,12,23,2,6,9,29,52
2011-07-11 00:00:00.000,Bsstad Sweden ATP World Tour 250,CLAY,2,Andreas Haider-Maurer,Filippo Volandri,Andreas Haider-Maurer,6-3; 7-6(7),R16,95,5,5,44,78,38,44,12,34,3,5,11,50,78,0,1,48,65,30,48,8,17,1,4,10,38,65
2011-07-11 00:00:00.000,Bsstad Sweden ATP World Tour 250,CLAY,2,David Ferrer,Pere Riba,David Ferrer,6-2; 7-6(4),R16,125,1,3,34,72,27,34,24,38,4,4,10,51,72,3,4,49,91,36,49,16,42,6,8,10,52,91
2011-07-11 00:00:00.000,Bsstad Sweden ATP World Tour 250,CLAY,2,Robin Soderling,Potito Starace,Robin Soderling,6-3; 6-4,Q,72,6,3,25,50,22,25,18,25,0,0,10,40,50,4,1,40,61,25,40,10,21,2,4,9,35,61
2011-07-11 00:00:00.000,Bsstad Sweden ATP World Tour 250,CLAY,2,Tomas Berdych,Blaz Kavcic,Tomas Berdych,6-1; 6-4,Q,79,2,3,31,54,23,31,14,23,0,0,9,37,54,1,1,31,49,17,31,11,18,3,6,8,28,49
2011-07-11 00:00:00.000,Bsstad Sweden ATP World Tour 250,CLAY,2,Nicolas Almagro,Michael Ryderstedt,Nicolas Almagro,6-4; 7-6(4),Q,83,11,5,38,67,28,38,16,29,1,4,11,44,67,3,3,43,72,30,43,14,29,5,9,11,44,72
2011-07-11 00:00:00.000,Bsstad Sweden ATP World Tour 250,CLAY,2,David Ferrer,Andreas Haider-Maurer,David Ferrer,6-1; 6-1,Q,56,2,0,19,37,13,19,16,18,2,2,7,29,37,2,0,20,40,9,20,7,20,4,9,7,16,40
2011-07-11 00:00:00.000,Bsstad Sweden ATP World Tour 250,CLAY,2,Robin Soderling,Tomas Berdych,Robin Soderling,6-1; 6-0,S,71,3,0,29,47,20,29,11,18,4,4,7,31,47,2,2,32,56,14,32,10,24,6,11,6,24,56
2011-07-11 00:00:00.000,Bsstad Sweden ATP World Tour 250,CLAY,2,David Ferrer,Nicolas Almagro,David Ferrer,6-1; 6-3,S,64,5,2,34,51,24,34,9,17,2,3,8,33,51,3,1,25,46,10,25,9,21,1,6,8,19,46
2011-07-11 00:00:00.000,Bsstad Sweden ATP World Tour 250,CLAY,2,Robin Soderling,David Ferrer,Robin Soderling,6-2; 6-2,F,67,4,3,21,41,18,21,11,20,0,1,8,29,41,3,2,32,59,16,32,11,27,6,11,8,27,59
2011-07-11 00:00:00.000,Stuttgart Germany ATP World Tour 250,CLAY,2,Victor Hanescu,Gael Monfils,Victor Hanescu,2-6; 7-6(7); 6-4,R32,137,2,2,57,99,36,57,24,42,1,5,15,60,99,13,8,59,102,43,59,21,43,4,7,15,64,102
2011-07-11 00:00:00.000,Stuttgart Germany ATP World Tour 250,CLAY,2,Pavol Cervenak,Mischa Zverev,Pavol Cervenak,6-4; 4-6; 6-2,R32,121,4,4,46,85,34,46,19,39,4,7,14,53,85,1,2,41,74,26,41,17,33,1,6,14,43,74
2011-07-11 00:00:00.000,Stuttgart Germany ATP World Tour 250,CLAY,2,Sergiy Stakhovsky,Jaroslav Pospisil,Sergiy Stakhovsky,4-6; 6-2; 7-6(5),R32,160,8,0,49,93,39,49,29,44,5,6,15,68,93,2,9,63,122,44,63,32,59,13,15,15,76,122
2011-07-11 00:00:00.000,Stuttgart Germany ATP World Tour 250,CLAY,2,Federico Delbonis,Florian Mayer,Federico Delbonis,6-2; 6-3,R32,70,2,5,27,54,24,27,15,27,5,5,9,39,54,2,7,31,64,19,31,15,33,3,6,8,34,64
2011-07-11 00:00:00.000,Stuttgart Germany ATP World Tour 250,CLAY,2,Mikhail Youzhny,Philipp Petzschner,Mikhail Youzhny,6-3; 6-3,R32,71,4,3,33,52,27,33,10,19,1,2,9,37,52,4,2,33,56,18,33,12,23,3,7,9,30,56
2011-07-11 00:00:00.000,Stuttgart Germany ATP World Tour 250,CLAY,2,Juan Carlos Ferrero,Bastian Knittel,Juan Carlos Ferrero,6-2; 6-4,R32,82,3,4,26,54,19,26,17,28,5,7,9,36,54,3,10,40,71,23,40,10,31,6,11,9,33,71
2011-07-11 00:00:00.000,Stuttgart Germany ATP World Tour 250,CLAY,2,Benoit Paire,Evgeny Donskoy,Benoit Paire,6-7(3); 6-4; 6-2,R32,127,8,5,60,118,45,60,29,58,12,14,15,74,118,3,5,48,100,38,48,22,52,3,8,15,60,100
2011-07-11 00:00:00.000,Stuttgart Germany ATP World Tour 250,CLAY,2,Marcel Granollers,Andreas Seppi,Marcel Granollers,6-3; 3-6; 6-1,R32,195,3,5,50,82,33,50,17,32,6,9,13,50,82,2,4,41,86,26,41,21,45,4,9,12,47,86
2011-07-11 00:00:00.000,Stuttgart Germany ATP World Tour 250,CLAY,2,Cedrik-Marcel Stebe,Nikolay Davydenko,Cedrik-Marcel Stebe,3-6; 6-1; 6-4,R32,123,2,5,47,86,29,47,17,39,6,11,13,46,86,1,6,59,82,34,59,8,23,8,15,13,42,82
2011-07-11 00:00:00.000,Stuttgart Germany ATP World Tour 250,CLAY,2,Fabio Fognini,Robin Kern,Fabio Fognini,6-4; 6-1,R32,64,1,5,19,50,16,19,16,31,3,4,8,32,50,3,5,32,67,21,32,13,35,7,12,9,34,67
2011-07-11 00:00:00.000,Stuttgart Germany ATP World Tour 250,CLAY,2,Pablo Andujar,Victor Crivoi,Pablo Andujar,6-2; 6-1,R32,72,1,3,33,50,19,33,9,17,6,8,7,28,50,0,1,29,45,13,29,3,16,1,8,8,16,45
2011-07-11 00:00:00.000,Stuttgart Germany ATP World Tour 250,CLAY,2,Albert Montanes,Gilles Simon,Albert Montanes,4-6; 7-6(5); 6-2,R32,119,4,10,48,93,33,48,23,45,8,13,15,56,93,5,4,51,89,32,51,20,38,3,9,15,52,89
2011-07-11 00:00:00.000,Stuttgart Germany ATP World Tour 250,CLAY,2,Guillermo Garcia-Lopez,Radek Stepanek,Guillermo Garcia-Lopez,6-1; 6-3,R32,76,3,4,29,54,22,29,13,25,4,4,8,35,54,3,7,30,55,20,30,8,25,4,8,8,28,55
2011-07-11 00:00:00.000,Stuttgart Germany ATP World Tour 250,CLAY,2,Lukasz Kubot,Daniel Gimeno-Traver,Lukasz Kubot,7-6(2); 3-6; 6-2,R32,122,4,7,53,88,43,53,18,35,5,7,14,61,88,13,3,44,77,34,44,18,33,0,3,15,52,77
2011-07-11 00:00:00.000,Stuttgart Germany ATP World Tour 250,CLAY,2,Jeremy Chardy,Tobias Kamke,Jeremy Chardy,7-6(1); 6-1,R32,77,8,3,38,73,31,38,18,35,2,3,10,49,73,2,5,30,56,18,30,13,26,3,6,9,31,56
2011-07-11 00:00:00.000,Stuttgart Germany ATP World Tour 250,CLAY,2,Santiago Giraldo,Jurgen Melzer,Santiago Giraldo,6-4; 7-5,R32,89,7,0,34,59,27,34,14,25,3,5,11,41,59,6,4,34,64,24,34,13,30,6,10,11,37,64
2011-07-11 00:00:00.000,Stuttgart Germany ATP World Tour 250,CLAY,2,Pavol Cervenak,Victor Hanescu,Pavol Cervenak,6-3; 7-6(6),R16,88,4,4,45,73,33,45,15,28,4,6,11,48,73,2,2,39,61,24,39,11,22,1,4,10,35,61
2011-07-11 00:00:00.000,Stuttgart Germany ATP World Tour 250,CLAY,2,Federico Delbonis,Sergiy Stakhovsky,Federico Delbonis,6-4; 6-3,R16,77,3,3,39,63,26,39,13,24,4,6,9,39,63,1,1,40,58,26,40,5,18,5,10,10,31,58
2011-07-11 00:00:00.000,Stuttgart Germany ATP World Tour 250,CLAY,2,Juan Carlos Ferrero,Mikhail Youzhny,Juan Carlos Ferrero,6-7(6); 6-2; 6-2,R16,136,5,0,58,94,42,58,22,36,3,5,14,64,94,5,6,53,101,31,53,26,48,5,11,14,57,101
2011-07-11 00:00:00.000,Stuttgart Germany ATP World Tour 250,CLAY,2,Marcel Granollers,Benoit Paire,Marcel Granollers,6-4; 7-5,R16,104,0,1,55,73,36,55,9,18,5,7,11,45,73,1,1,35,74,26,35,17,39,5,9,11,43,74
2011-07-11 00:00:00.000,Stuttgart Germany ATP World Tour 250,CLAY,2,Cedrik-Marcel Stebe,Fabio Fognini,Cedrik-Marcel Stebe,7-6(5); 6-4,R16,147,1,6,50,102,24,50,28,52,11,16,11,52,102,2,3,55,96,32,55,16,41,6,12,11,48,96
2011-07-11 00:00:00.000,Stuttgart Germany ATP World Tour 250,CLAY,2,Pablo Andujar,Albert Montanes,Pablo Andujar,2-6; 6-4; 6-3,R16,129,3,4,42,85,29,42,20,43,6,10,13,49,85,4,8,51,98,38,51,16,47,8,13,14,54,98
2011-07-11 00:00:00.000,Stuttgart Germany ATP World Tour 250,CLAY,2,Lukasz Kubot,Guillermo Garcia-Lopez,Lukasz Kubot,4-6; 6-4; 6-3,R16,145,2,6,57,88,41,57,17,31,2,5,15,58,88,5,5,41,79,25,41,23,38,2,6,14,48,79
2011-07-11 00:00:00.000,Stuttgart Germany ATP World Tour 250,CLAY,2,Santiago Giraldo,Jeremy Chardy,Santiago Giraldo,1-6; 7-5; 6-4,R16,121,4,2,57,96,38,57,21,39,7,11,15,59,96,1,9,47,90,35,47,21,43,3,6,14,56,90
2011-07-11 00:00:00.000,Stuttgart Germany ATP World Tour 250,CLAY,2,Federico Delbonis,Pavol Cervenak,Federico Delbonis,6-1; 6-2,Q,71,2,1,25,50,17,25,18,25,1,1,8,35,50,1,4,27,49,17,27,7,22,9,13,7,24,49
2011-07-11 00:00:00.000,Stuttgart Germany ATP World Tour 250,CLAY,2,Juan Carlos Ferrero,Marcel Granollers,Juan Carlos Ferrero,6-4; 6-3,Q,88,1,3,34,60,20,34,15,26,5,8,10,35,60,2,2,38,53,19,38,4,15,5,10,9,23,53
2011-07-11 00:00:00.000,Stuttgart Germany ATP World Tour 250,CLAY,2,Pablo Andujar,Cedrik-Marcel Stebe,Pablo Andujar,6-2; 6-1,Q,67,0,2,29,44,21,29,8,15,2,3,7,29,44,1,4,16,41,8,16,7,25,0,6,8,15,41
2011-07-11 00:00:00.000,Stuttgart Germany ATP World Tour 250,CLAY,2,Lukasz Kubot,Santiago Giraldo,Lukasz Kubot,7-5; 5-7; 6-3,Q,148,4,4,62,104,39,62,25,42,6,9,16,64,104,5,0,70,105,46,70,18,35,5,10,17,64,105
2011-07-11 00:00:00.000,Stuttgart Germany ATP World Tour 250,CLAY,2,Juan Carlos Ferrero,Federico Delbonis,Juan Carlos Ferrero,3-6; 6-4; 6-4,S,125,1,1,55,96,33,55,27,41,9,11,14,60,96,3,3,44,81,31,44,22,37,3,6,15,53,81
2011-07-11 00:00:00.000,Stuttgart Germany ATP World Tour 250,CLAY,2,Pablo Andujar,Lukasz Kubot,Pablo Andujar,6-4; 3-6; 6-4,S,144,3,5,50,88,33,50,20,38,7,11,14,53,88,4,9,56,96,38,56,17,40,4,9,15,55,96
2011-07-11 00:00:00.000,Stuttgart Germany ATP World Tour 250,CLAY,2,Juan Carlos Ferrero,Pablo Andujar,Juan Carlos Ferrero,6-4; 6-0,F,79,3,0,25,45,19,25,11,20,0,1,8,30,45,1,7,31,59,17,31,10,28,5,10,8,27,59
2011-07-18 00:00:00.000,Atlanta GA; USA ATP World Tour 250,HARD,2,Mardy Fish,N/A Bye,Mardy Fish,,R32,0,0,0,0,0,0,0,0,0,0,0,0,0,0,0,0,0,0,0,0,0,0,0,0,0,0,0
2011-07-18 00:00:00.000,Atlanta GA; USA ATP World Tour 250,HARD,2,Nicolas Mahut,Ricardas Berankis,Nicolas Mahut,7-6(5); 6-2,R32,93,6,5,28,68,22,28,21,40,4,6,10,43,68,5,5,33,74,22,33,17,41,3,7,10,39,74
2011-07-18 00:00:00.000,Atlanta GA; USA ATP World Tour 250,HARD,2,Tatsuma Ito,Michael Berrer,Tatsuma Ito,7-6(6); 6-4,R32,98,4,3,49,80,42,49,14,31,1,1,11,56,80,10,4,40,72,32,40,18,32,1,2,11,50,72
2011-07-18 00:00:00.000,Atlanta GA; USA ATP World Tour 250,HARD,2,Somdev Devvarman,Ryan Sweeting,Somdev Devvarman,6-4; 3-6; 6-4,R32,144,5,7,59,101,44,59,15,42,6,11,14,59,101,3,12,60,101,39,60,18,41,6,12,15,57,101
2011-07-18 00:00:00.000,Atlanta GA; USA ATP World Tour 250,HARD,2,Xavier Malisse,N/A Bye,Xavier Malisse,,R32,0,0,0,0,0,0,0,0,0,0,0,0,0,0,0,0,0,0,0,0,0,0,0,0,0,0,0
2011-07-18 00:00:00.000,Atlanta GA; USA ATP World Tour 250,HARD,2,Ryan Harrison,Yuichi Sugita,Ryan Harrison,6-1; 7-6(5),R32,97,4,3,39,64,34,39,12,25,1,1,10,46,64,1,3,43,76,28,43,16,33,11,13,9,44,76
2011-07-18 00:00:00.000,Atlanta GA; USA ATP World Tour 250,HARD,2,Lleyton Hewitt,Phillip Simmonds,Lleyton Hewitt,6-4; 6-4,R32,94,5,3,28,52,25,28,14,24,1,2,10,39,52,7,6,37,67,26,37,13,30,2,5,10,39,67
2011-07-18 00:00:00.000,Atlanta GA; USA ATP World Tour 250,HARD,2,Rajeev Ram,Grigor Dimitrov,Rajeev Ram,6-4; 6-4,R32,74,5,1,35,49,32,35,8,14,0,0,10,40,49,5,3,38,67,24,38,18,29,4,6,10,42,67
2011-07-18 00:00:00.000,Atlanta GA; USA ATP World Tour 250,HARD,2,Marinko Matosevic,Igor Kunitsyn,Marinko Matosevic,6-7(3); 6-2; 7-5,R32,170,10,5,58,98,46,58,19,40,2,5,16,65,98,4,4,60,111,43,60,23,51,6,12,16,66,111
2011-07-18 00:00:00.000,Atlanta GA; USA ATP World Tour 250,HARD,2,Yen-Hsun Lu,Matthias Bachinger,Yen-Hsun Lu,7-5; 7-6(4),R32,106,0,7,34,65,28,34,18,31,1,4,12,46,65,10,7,46,90,34,46,19,44,5,9,12,53,90
2011-07-18 00:00:00.000,Atlanta GA; USA ATP World Tour 250,HARD,2,James Blake,Ernests Gulbis,James Blake,5-7; 7-6(5); 6-2,R32,159,8,7,65,132,50,65,30,67,17,20,16,80,132,17,5,61,101,46,61,16,40,5,9,16,62,101
2011-07-18 00:00:00.000,Atlanta GA; USA ATP World Tour 250,HARD,2,John Isner,N/A Bye,John Isner,,R32,0,0,0,0,0,0,0,0,0,0,0,0,0,0,0,0,0,0,0,0,0,0,0,0,0,0,0
2011-07-18 00:00:00.000,Atlanta GA; USA ATP World Tour 250,HARD,2,Gilles Muller,Alex Bogomolov Jr.,Gilles Muller,6-3; 7-6(6),R32,95,17,4,30,62,25,30,20,32,0,1,11,45,62,6,3,54,82,30,54,17,28,4,6,10,47,82
2011-07-18 00:00:00.000,Atlanta GA; USA ATP World Tour 250,HARD,2,Robby Ginepri,Tommy Haas,Robby Ginepri,6-4; 7-5,R32,105,9,2,57,82,37,57,12,25,6,8,11,49,82,5,5,44,77,30,44,13,33,10,14,11,43,77
2011-07-18 00:00:00.000,Atlanta GA; USA ATP World Tour 250,HARD,2,Michael Russell,Donald Young,Michael Russell,6-0; 6-3,R32,92,2,2,35,48,26,35,7,13,0,1,8,33,48,0,2,25,47,14,25,6,22,2,7,7,20,47
2011-07-18 00:00:00.000,Atlanta GA; USA ATP World Tour 250,HARD,2,Kevin Anderson,N/A Bye,Kevin Anderson,,R32,0,0,0,0,0,0,0,0,0,0,0,0,0,0,0,0,0,0,0,0,0,0,0,0,0,0,0
2011-07-18 00:00:00.000,Atlanta GA; USA ATP World Tour 250,HARD,2,Mardy Fish,Nicolas Mahut,Mardy Fish,6-3; 6-3,R16,83,6,2,39,53,30,39,8,14,4,5,9,38,53,1,6,31,60,18,31,10,29,8,12,9,28,60
2011-07-18 00:00:00.000,Atlanta GA; USA ATP World Tour 250,HARD,2,Somdev Devvarman,Tatsuma Ito,Somdev Devvarman,6-1; 6-3,R16,61,4,0,21,35,21,21,11,14,0,0,8,32,35,1,4,20,47,11,20,12,27,4,8,8,23,47
2011-07-18 00:00:00.000,Atlanta GA; USA ATP World Tour 250,HARD,2,Ryan Harrison,Xavier Malisse,Ryan Harrison,6-7(3); 6-4; 6-4,R16,139,7,7,54,96,45,54,21,42,2,4,16,66,96,6,3,51,102,38,51,28,51,4,8,16,66,102
2011-07-18 00:00:00.000,Atlanta GA; USA ATP World Tour 250,HARD,2,Rajeev Ram,Lleyton Hewitt,Rajeev Ram,7-5; 2-6; 6-2,R16,118,8,4,47,78,36,47,11,31,3,7,14,47,78,7,9,46,84,34,46,17,38,5,10,14,51,84
2011-07-18 00:00:00.000,Atlanta GA; USA ATP World Tour 250,HARD,2,Yen-Hsun Lu,Marinko Matosevic,Yen-Hsun Lu,3-6; 6-1; 6-2,R16,128,4,7,41,84,25,41,25,43,8,11,12,50,84,4,5,45,78,27,45,12,33,2,8,12,39,78
2011-07-18 00:00:00.000,Atlanta GA; USA ATP World Tour 250,HARD,2,John Isner,James Blake,John Isner,7-6(8); 6-7(3); 7-5,R16,170,30,7,87,131,70,87,22,44,7,8,18,92,131,7,6,64,114,54,64,26,50,1,3,18,80,114
2011-07-18 00:00:00.000,Atlanta GA; USA ATP World Tour 250,HARD,2,Gilles Muller,Robby Ginepri,Gilles Muller,7-6(6); 2-6; 6-2,R16,116,15,3,48,91,38,48,25,43,5,7,14,63,91,8,1,43,82,31,43,26,39,0,2,14,57,82
2011-07-18 00:00:00.000,Atlanta GA; USA ATP World Tour 250,HARD,2,Kevin Anderson,Michael Russell,Kevin Anderson,6-1; 7-5,R16,85,10,0,34,50,26,34,12,16,0,1,10,38,50,2,7,33,56,23,33,6,23,4,8,9,29,56
2011-07-18 00:00:00.000,Atlanta GA; USA ATP World Tour 250,HARD,2,Mardy Fish,Somdev Devvarman,Mardy Fish,6-4; 6-3,Q,93,4,0,37,51,30,37,5,14,2,4,10,35,51,0,2,45,72,24,45,13,27,8,12,9,37,72
2011-07-18 00:00:00.000,Atlanta GA; USA ATP World Tour 250,HARD,2,Ryan Harrison,Rajeev Ram,Ryan Harrison,4-6; 6-1; 7-6(5),Q,137,10,3,57,95,41,57,23,38,4,6,15,64,95,3,2,47,88,30,47,25,41,2,5,14,55,88
2011-07-18 00:00:00.000,Atlanta GA; USA ATP World Tour 250,HARD,2,John Isner,Yen-Hsun Lu,John Isner,6-1; 6-2,Q,56,8,1,33,42,29,33,4,9,1,1,8,33,42,2,5,24,39,13,24,5,15,2,6,7,18,39
2011-07-18 00:00:00.000,Atlanta GA; USA ATP World Tour 250,HARD,2,Gilles Muller,Kevin Anderson,Gilles Muller,7-6(3); 7-6(3),Q,127,14,4,57,88,45,57,15,31,6,7,12,60,88,12,4,47,75,39,47,13,28,3,4,12,52,75
2011-07-18 00:00:00.000,Atlanta GA; USA ATP World Tour 250,HARD,2,Mardy Fish,Ryan Harrison,Mardy Fish,6-2; 6-4,S,79,2,1,24,50,18,24,19,26,1,1,9,37,50,3,2,28,54,17,28,13,26,3,6,9,30,54
2011-07-18 00:00:00.000,Atlanta GA; USA ATP World Tour 250,HARD,2,John Isner,Gilles Muller,John Isner,7-5; 6-7(3); 6-1,S,148,28,0,66,92,51,66,20,26,2,2,16,71,92,16,4,62,104,46,62,22,42,5,8,15,68,104
2011-07-18 00:00:00.000,Atlanta GA; USA ATP World Tour 250,HARD,2,Mardy Fish,John Isner,Mardy Fish,3-6; 7-6(6); 6-2,F,136,13,1,45,74,39,45,19,29,3,5,14,58,74,15,6,65,94,46,65,13,29,3,6,15,59,94
2011-07-18 00:00:00.000,Hamburg Germany ATP World Tour 500,CLAY,2,Gael Monfils,N/A Bye,Gael Monfils,,R64,0,0,0,0,0,0,0,0,0,0,0,0,0,0,0,0,0,0,0,0,0,0,0,0,0,0,0
2011-07-18 00:00:00.000,Hamburg Germany ATP World Tour 500,CLAY,2,Albert Ramos,Adrian Mannarino,Albert Ramos,6-2; 6-4,R64,69,4,1,32,50,27,32,9,18,2,3,9,36,50,2,2,26,48,18,26,9,22,2,6,9,27,48
2011-07-18 00:00:00.000,Hamburg Germany ATP World Tour 500,CLAY,2,Radek Stepanek,Andreas Beck,Radek Stepanek,7-5; 7-6(2),R64,115,8,2,65,93,47,65,17,28,4,4,12,64,93,3,0,48,76,32,48,19,28,0,1,12,51,76
2011-07-18 00:00:00.000,Hamburg Germany ATP World Tour 500,CLAY,2,Andreas Seppi,N/A Bye,Andreas Seppi,,R64,0,0,0,0,0,0,0,0,0,0,0,0,0,0,0,0,0,0,0,0,0,0,0,0,0,0,0
2011-07-18 00:00:00.000,Hamburg Germany ATP World Tour 500,CLAY,2,Alexandr Dolgopolov,N/A Bye,Alexandr Dolgopolov,,R64,0,0,0,0,0,0,0,0,0,0,0,0,0,0,0,0,0,0,0,0,0,0,0,0,0,0,0
2011-07-18 00:00:00.000,Hamburg Germany ATP World Tour 500,CLAY,2,Jarkko Nieminen,Santiago Giraldo,Jarkko Nieminen,6-4; 6-3,R64,73,2,2,38,53,29,38,9,15,2,3,10,38,53,5,1,38,63,23,38,12,25,1,4,9,35,63
2011-07-18 00:00:00.000,Hamburg Germany ATP World Tour 500,CLAY,2,Sergiy Stakhovsky,Maximo Gonzalez,Sergiy Stakhovsky,6-2; 6-3,R64,64,1,0,32,51,21,32,15,19,2,3,9,36,51,0,1,29,44,16,29,7,15,1,5,8,23,44
2011-07-18 00:00:00.000,Hamburg Germany ATP World Tour 500,CLAY,2,Gilles Simon,N/A Bye,Gilles Simon,,R64,0,0,0,0,0,0,0,0,0,0,0,0,0,0,0,0,0,0,0,0,0,0,0,0,0,0,0
2011-07-18 00:00:00.000,Hamburg Germany ATP World Tour 500,CLAY,2,Mikhail Youzhny,N/A Bye,Mikhail Youzhny,,R64,0,0,0,0,0,0,0,0,0,0,0,0,0,0,0,0,0,0,0,0,0,0,0,0,0,0,0
2011-07-18 00:00:00.000,Hamburg Germany ATP World Tour 500,CLAY,2,Carlos Berlocq,Robin Haase,Carlos Berlocq,6-2; 6-2,R64,85,3,1,30,51,22,30,10,21,1,3,8,32,51,2,0,26,58,15,26,9,32,5,11,8,24,58
2011-07-18 00:00:00.000,Hamburg Germany ATP World Tour 500,CLAY,2,Julian Reister,Denis Istomin,Julian Reister,6-3; 6-4,R64,74,0,3,30,55,21,30,17,25,1,2,10,38,55,4,1,37,57,22,37,10,20,2,5,9,32,57
2011-07-18 00:00:00.000,Hamburg Germany ATP World Tour 500,CLAY,2,Guillermo Garcia-Lopez,N/A Bye,Guillermo Garcia-Lopez,,R64,0,0,0,0,0,0,0,0,0,0,0,0,0,0,0,0,0,0,0,0,0,0,0,0,0,0,0
2011-07-18 00:00:00.000,Hamburg Germany ATP World Tour 500,CLAY,2,Marin Cilic,N/A Bye,Marin Cilic,,R64,0,0,0,0,0,0,0,0,0,0,0,0,0,0,0,0,0,0,0,0,0,0,0,0,0,0,0
2011-07-18 00:00:00.000,Hamburg Germany ATP World Tour 500,CLAY,2,Bastian Knittel,Ivan Dodig,Bastian Knittel,6-4; 6-3,R64,83,0,4,35,57,26,35,10,22,4,6,10,36,57,2,2,26,49,17,26,7,23,1,5,9,24,49
2011-07-18 00:00:00.000,Hamburg Germany ATP World Tour 500,CLAY,2,Tobias Kamke,Pere Riba,Tobias Kamke,6-1; 6-1,R64,75,0,2,35,50,26,35,8,15,1,1,7,34,50,1,4,29,58,16,29,9,29,10,15,7,25,58
2011-07-18 00:00:00.000,Hamburg Germany ATP World Tour 500,CLAY,2,Juan Ignacio Chela,N/A Bye,Juan Ignacio Chela,,R64,0,0,0,0,0,0,0,0,0,0,0,0,0,0,0,0,0,0,0,0,0,0,0,0,0,0,0
2011-07-18 00:00:00.000,Hamburg Germany ATP World Tour 500,CLAY,2,Florian Mayer,N/A Bye,Florian Mayer,,R64,0,0,0,0,0,0,0,0,0,0,0,0,0,0,0,0,0,0,0,0,0,0,0,0,0,0,0
2011-07-18 00:00:00.000,Hamburg Germany ATP World Tour 500,CLAY,2,Marsel Ilhan,Philipp Petzschner,Marsel Ilhan,6-2; 4-6; 7-6(5),R64,137,8,1,72,110,46,72,22,38,9,12,15,68,110,5,5,51,92,37,51,20,41,1,5,15,57,92
2011-07-18 00:00:00.000,Hamburg Germany ATP World Tour 500,CLAY,2,Juan Monaco,Simone Bolelli,Juan Monaco,6-3; 7-5,R64,102,1,0,43,60,32,43,9,17,0,2,11,41,60,3,1,41,65,25,41,10,24,5,9,10,35,65
2011-07-18 00:00:00.000,Hamburg Germany ATP World Tour 500,CLAY,2,Janko Tipsarevic,N/A Bye,Janko Tipsarevic,,R64,0,0,0,0,0,0,0,0,0,0,0,0,0,0,0,0,0,0,0,0,0,0,0,0,0,0,0
2011-07-18 00:00:00.000,Hamburg Germany ATP World Tour 500,CLAY,2,Albert Montanes,N/A Bye,Albert Montanes,,R64,0,0,0,0,0,0,0,0,0,0,0,0,0,0,0,0,0,0,0,0,0,0,0,0,0,0,0
2011-07-18 00:00:00.000,Hamburg Germany ATP World Tour 500,CLAY,2,Philipp Kohlschreiber,Andrey Golubev,Philipp Kohlschreiber,7-5; 6-3,R64,97,3,4,32,63,24,32,19,31,3,4,10,43,63,3,1,36,72,24,36,18,36,6,10,11,42,72
2011-07-18 00:00:00.000,Hamburg Germany ATP World Tour 500,CLAY,2,Lukas Rosol,Potito Starace,Lukas Rosol,7-6(5); 6-1,R64,71,4,1,37,60,30,37,10,23,3,4,9,40,60,4,1,60,76,35,60,7,16,5,9,10,42,76
2011-07-18 00:00:00.000,Hamburg Germany ATP World Tour 500,CLAY,2,Nicolas Almagro,N/A Bye,Nicolas Almagro,,R64,0,0,0,0,0,0,0,0,0,0,0,0,0,0,0,0,0,0,0,0,0,0,0,0,0,0,0
2011-07-18 00:00:00.000,Hamburg Germany ATP World Tour 500,CLAY,2,Fernando Verdasco,N/A Bye,Fernando Verdasco,,R64,0,0,0,0,0,0,0,0,0,0,0,0,0,0,0,0,0,0,0,0,0,0,0,0,0,0,0
2011-07-18 00:00:00.000,Hamburg Germany ATP World Tour 500,CLAY,2,Pablo Andujar,Julien Benneteau,Pablo Andujar,6-2; 6-2,R64,80,2,1,34,53,24,34,12,19,2,2,8,36,53,2,4,40,56,24,40,4,16,4,8,8,28,56
2011-07-18 00:00:00.000,Hamburg Germany ATP World Tour 500,CLAY,2,Cedrik-Marcel Stebe,Juan Carlos Ferrero,Cedrik-Marcel Stebe,6-3; 6-2,R64,76,3,1,31,53,22,31,14,22,4,5,9,36,53,2,1,37,56,20,37,7,19,4,8,8,27,56
2011-07-18 00:00:00.000,Hamburg Germany ATP World Tour 500,CLAY,2,Nikolay Davydenko,N/A Bye,Nikolay Davydenko,,R64,0,0,0,0,0,0,0,0,0,0,0,0,0,0,0,0,0,0,0,0,0,0,0,0,0,0,0
2011-07-18 00:00:00.000,Hamburg Germany ATP World Tour 500,CLAY,2,Fabio Fognini,N/A Bye,Fabio Fognini,,R64,0,0,0,0,0,0,0,0,0,0,0,0,0,0,0,0,0,0,0,0,0,0,0,0,0,0,0
2011-07-18 00:00:00.000,Hamburg Germany ATP World Tour 500,CLAY,2,Victor Crivoi,Guillermo Olaso,Victor Crivoi,6-4; 6-3,R64,77,12,0,37,51,31,37,6,14,0,0,9,37,51,3,5,41,70,31,41,8,29,4,7,10,39,70
2011-07-18 00:00:00.000,Hamburg Germany ATP World Tour 500,CLAY,2,Daniel Gimeno-Traver,Marcel Granollers,Daniel Gimeno-Traver,6-3 RET,R64,34,1,0,13,25,11,13,9,12,0,0,5,20,25,0,0,25,28,16,25,2,3,3,4,4,18,28
2011-07-18 00:00:00.000,Hamburg Germany ATP World Tour 500,CLAY,2,Jurgen Melzer,N/A Bye,Jurgen Melzer,,R64,0,0,0,0,0,0,0,0,0,0,0,0,0,0,0,0,0,0,0,0,0,0,0,0,0,0,0
2011-07-18 00:00:00.000,Hamburg Germany ATP World Tour 500,CLAY,2,Gael Monfils,Albert Ramos,Gael Monfils,6-4; 6-2,R32,73,5,1,32,55,27,32,14,23,5,5,9,41,55,2,2,36,58,22,36,10,22,2,5,9,32,58
2011-07-18 00:00:00.000,Hamburg Germany ATP World Tour 500,CLAY,2,Radek Stepanek,Andreas Seppi,Radek Stepanek,6-1; 7-5,R32,88,2,4,36,63,24,36,16,27,3,5,10,40,63,5,1,37,60,16,37,11,23,0,5,9,27,60
2011-07-18 00:00:00.000,Hamburg Germany ATP World Tour 500,CLAY,2,Jarkko Nieminen,Alexandr Dolgopolov,Jarkko Nieminen,6-3; 1-6; 6-4,R32,86,3,1,41,69,25,41,16,28,1,5,13,41,69,12,3,45,81,31,45,15,36,3,7,13,46,81
2011-07-18 00:00:00.000,Hamburg Germany ATP World Tour 500,CLAY,2,Gilles Simon,Sergiy Stakhovsky,Gilles Simon,6-2; 6-1,R32,63,0,1,20,36,14,20,8,16,0,2,7,22,36,0,1,43,64,18,43,8,21,4,11,8,26,64
2011-07-18 00:00:00.000,Hamburg Germany ATP World Tour 500,CLAY,2,Mikhail Youzhny,Carlos Berlocq,Mikhail Youzhny,7-5; 7-6(7),R32,139,6,1,40,74,32,40,20,34,1,2,12,52,74,5,6,52,86,38,52,13,34,7,9,12,51,86
2011-07-18 00:00:00.000,Hamburg Germany ATP World Tour 500,CLAY,2,Julian Reister,Guillermo Garcia-Lopez,Julian Reister,7-6(5); 6-2,R32,107,2,2,51,76,37,51,12,25,8,10,10,49,76,3,6,40,68,27,40,9,28,3,7,10,36,68
2011-07-18 00:00:00.000,Hamburg Germany ATP World Tour 500,CLAY,2,Marin Cilic,Bastian Knittel,Marin Cilic,6-3; 6-7(4); 6-4,R32,180,16,5,69,122,54,69,26,53,10,12,16,80,122,3,6,77,119,52,77,16,42,10,14,15,68,119
2011-07-18 00:00:00.000,Hamburg Germany ATP World Tour 500,CLAY,2,Tobias Kamke,Juan Ignacio Chela,Tobias Kamke,6-1; 6-4,R32,91,0,2,36,54,27,36,10,18,2,3,9,37,54,0,1,48,71,26,48,10,23,8,12,8,36,71
2011-07-18 00:00:00.000,Hamburg Germany ATP World Tour 500,CLAY,2,Florian Mayer,Marsel Ilhan,Florian Mayer,6-4; 7-6(5),R32,88,8,1,29,59,21,29,16,30,0,3,11,37,59,2,1,56,81,38,56,6,25,5,9,11,44,81
2011-07-18 00:00:00.000,Hamburg Germany ATP World Tour 500,CLAY,2,Juan Monaco,Janko Tipsarevic,Juan Monaco,6-2; 6-4,R32,95,4,1,36,51,29,36,10,15,4,4,9,39,51,6,4,46,74,30,46,12,28,9,12,9,42,74
2011-07-18 00:00:00.000,Hamburg Germany ATP World Tour 500,CLAY,2,Philipp Kohlschreiber,Albert Montanes,Philipp Kohlschreiber,6-1; 3-2 RET,R32,46,5,1,17,31,13,17,11,14,0,0,6,24,31,0,2,33,44,21,33,2,11,8,11,6,23,44
2011-07-18 00:00:00.000,Hamburg Germany ATP World Tour 500,CLAY,2,Nicolas Almagro,Lukas Rosol,Nicolas Almagro,6-4; 6-4,R32,67,7,2,29,60,23,29,17,31,3,4,10,40,60,10,1,36,54,27,36,7,18,1,4,10,34,54
2011-07-18 00:00:00.000,Hamburg Germany ATP World Tour 500,CLAY,2,Fernando Verdasco,Pablo Andujar,Fernando Verdasco,6-2; 6-3,R32,86,1,2,45,56,23,45,6,11,3,7,9,29,56,1,1,40,62,18,40,7,22,8,15,8,25,62
2011-07-18 00:00:00.000,Hamburg Germany ATP World Tour 500,CLAY,2,Cedrik-Marcel Stebe,Nikolay Davydenko,Cedrik-Marcel Stebe,6-3; 7-6(5),R32,112,5,0,49,82,32,49,14,33,6,9,10,46,82,0,3,52,71,28,52,7,19,3,8,11,35,71
2011-07-18 00:00:00.000,Hamburg Germany ATP World Tour 500,CLAY,2,Fabio Fognini,Victor Crivoi,Fabio Fognini,6-1; 7-5,R32,81,6,2,43,56,30,43,6,13,4,6,9,36,56,3,2,38,65,21,38,8,27,3,9,10,29,65
2011-07-18 00:00:00.000,Hamburg Germany ATP World Tour 500,CLAY,2,Jurgen Melzer,Daniel Gimeno-Traver,Jurgen Melzer,6-3; 5-7; 6-1,R32,110,3,1,57,83,38,57,14,26,5,8,14,52,83,1,3,40,77,22,40,21,37,0,6,14,43,77
2011-07-18 00:00:00.000,Hamburg Germany ATP World Tour 500,CLAY,2,Gael Monfils,Radek Stepanek,Gael Monfils,6-4; 6-4,R16,83,10,3,36,66,27,36,16,30,5,6,10,43,66,2,1,38,62,26,38,11,24,5,8,10,37,62
2011-07-18 00:00:00.000,Hamburg Germany ATP World Tour 500,CLAY,2,Gilles Simon,Jarkko Nieminen,Gilles Simon,7-6(4); 3-6; 6-4,R16,140,6,1,62,97,42,62,14,35,10,16,16,56,97,1,3,61,103,39,61,20,42,4,9,15,59,103
2011-07-18 00:00:00.000,Hamburg Germany ATP World Tour 500,CLAY,2,Mikhail Youzhny,Julian Reister,Mikhail Youzhny,6-3; 6-3,R16,85,1,0,31,49,27,31,12,18,0,0,9,39,49,7,2,49,71,30,49,9,22,4,7,9,39,71
2011-07-18 00:00:00.000,Hamburg Germany ATP World Tour 500,CLAY,2,Marin Cilic,Tobias Kamke,Marin Cilic,3-6; 6-3; 6-2,R16,124,7,3,48,85,35,48,19,37,2,4,13,54,85,2,0,49,78,27,49,19,29,1,5,13,46,78
2011-07-18 00:00:00.000,Hamburg Germany ATP World Tour 500,CLAY,2,Florian Mayer,Juan Monaco,Florian Mayer,7-5; 7-5,R16,108,1,2,52,79,33,52,14,27,4,7,12,47,79,1,1,53,75,29,53,10,22,5,10,12,39,75
2011-07-18 00:00:00.000,Hamburg Germany ATP World Tour 500,CLAY,2,Nicolas Almagro,Philipp Kohlschreiber,Nicolas Almagro,6-3; 7-5,R16,85,7,1,34,54,28,34,13,20,0,1,11,41,54,6,1,30,67,22,30,17,37,8,11,10,39,67
2011-07-18 00:00:00.000,Hamburg Germany ATP World Tour 500,CLAY,2,Fernando Verdasco,Cedrik-Marcel Stebe,Fernando Verdasco,7-5; 6-2,R16,93,2,2,50,57,35,50,2,7,1,3,10,37,57,4,5,38,63,24,38,9,25,2,7,10,33,63
2011-07-18 00:00:00.000,Hamburg Germany ATP World Tour 500,CLAY,2,Jurgen Melzer,Fabio Fognini,Jurgen Melzer,6-2; 6-3,R16,71,0,0,35,49,25,35,8,14,0,0,8,33,49,0,4,33,55,22,33,6,22,2,6,9,28,55
2011-07-18 00:00:00.000,Hamburg Germany ATP World Tour 500,CLAY,2,Gilles Simon,Gael Monfils,Gilles Simon,6-4; 3-6; 6-0,Q,125,2,0,55,87,38,55,15,32,4,6,12,53,87,2,3,53,82,32,53,12,29,2,7,13,44,82
2011-07-18 00:00:00.000,Hamburg Germany ATP World Tour 500,CLAY,2,Mikhail Youzhny,Marin Cilic,Mikhail Youzhny,4-6; 6-3; 7-6(6),Q,181,2,2,79,120,51,79,21,41,2,5,16,72,120,7,3,61,100,43,61,17,39,6,9,15,60,100
2011-07-18 00:00:00.000,Hamburg Germany ATP World Tour 500,CLAY,2,Nicolas Almagro,Florian Mayer,Nicolas Almagro,7-6(5); 7-6(3),Q,108,13,1,61,86,41,61,16,25,0,1,12,57,86,5,4,64,95,48,64,13,31,5,6,12,61,95
2011-07-18 00:00:00.000,Hamburg Germany ATP World Tour 500,CLAY,2,Fernando Verdasco,Jurgen Melzer,Fernando Verdasco,6-3; 2-6; 6-4,Q,129,1,1,78,91,43,78,9,13,8,12,14,52,91,3,4,66,89,42,66,11,23,4,8,13,53,89
2011-07-18 00:00:00.000,Hamburg Germany ATP World Tour 500,CLAY,2,Gilles Simon,Mikhail Youzhny,Gilles Simon,3-6; 6-3; 6-1,S,124,6,2,50,82,35,50,14,32,10,13,12,49,82,1,0,51,74,31,51,7,23,0,6,13,38,74
2011-07-18 00:00:00.000,Hamburg Germany ATP World Tour 500,CLAY,2,Nicolas Almagro,Fernando Verdasco,Nicolas Almagro,6-4; 6-1,S,84,7,0,35,50,29,35,9,15,1,1,9,38,50,0,1,46,68,25,46,11,22,2,5,8,36,68
2011-07-18 00:00:00.000,Hamburg Germany ATP World Tour 500,CLAY,2,Gilles Simon,Nicolas Almagro,Gilles Simon,6-4; 4-6; 6-4,F,158,6,1,73,124,50,73,23,51,15,18,15,73,124,9,1,61,105,42,61,21,44,11,15,15,63,105
2011-07-25 00:00:00.000,Gstaad Switzerland ATP World Tour 250,CLAY,2,Nicolas Almagro,N/A Bye,Nicolas Almagro,,R32,0,0,0,0,0,0,0,0,0,0,0,0,0,0,0,0,0,0,0,0,0,0,0,0,0,0,0
2011-07-25 00:00:00.000,Gstaad Switzerland ATP World Tour 250,CLAY,2,Jarkko Nieminen,Victor Hanescu,Jarkko Nieminen,7-5; 6-2,R32,73,2,2,35,60,25,35,15,25,0,1,10,40,60,7,2,43,65,29,43,6,22,7,11,10,35,65
2011-07-25 00:00:00.000,Gstaad Switzerland ATP World Tour 250,CLAY,2,Daniel Gimeno-Traver,Steve Darcis,Daniel Gimeno-Traver,6-4; 5-7; 7-5,R32,148,10,4,69,110,49,69,22,41,9,12,17,71,110,4,5,61,116,38,61,30,55,12,16,17,68,116
2011-07-25 00:00:00.000,Gstaad Switzerland ATP World Tour 250,CLAY,2,Feliciano Lopez,Michael Lammer,Feliciano Lopez,6-4; 6-7(4); 6-3,R32,143,18,6,51,98,40,51,26,47,5,6,16,66,98,1,3,61,96,40,61,19,35,3,6,15,59,96
2011-07-25 00:00:00.000,Gstaad Switzerland ATP World Tour 250,CLAY,2,Fernando Verdasco,N/A Bye,Fernando Verdasco,,R32,0,0,0,0,0,0,0,0,0,0,0,0,0,0,0,0,0,0,0,0,0,0,0,0,0,0,0
2011-07-25 00:00:00.000,Gstaad Switzerland ATP World Tour 250,CLAY,2,Frederico Gil,Joao Souza,Frederico Gil,4-6; 6-3; 6-4,R32,139,4,5,53,85,35,53,14,32,4,8,15,49,85,18,4,69,108,45,69,16,39,7,12,14,61,108
2011-07-25 00:00:00.000,Gstaad Switzerland ATP World Tour 250,CLAY,2,Julien Benneteau,Lukas Rosol,Julien Benneteau,6-2; 6-7(6); 6-3,R32,123,9,3,62,104,51,62,20,42,8,8,15,71,104,7,7,62,106,44,62,21,44,5,8,14,65,106
2011-07-25 00:00:00.000,Gstaad Switzerland ATP World Tour 250,CLAY,2,Matthias Bachinger,Pablo Andujar,Matthias Bachinger,6-1; 6-4,R32,67,9,2,36,61,31,36,13,25,2,2,9,44,61,0,3,22,43,12,22,12,21,1,4,8,24,43
2011-07-25 00:00:00.000,Gstaad Switzerland ATP World Tour 250,CLAY,2,Santiago Giraldo,Guillermo Garcia-Lopez,Santiago Giraldo,5-7; 6-2; 6-1,R32,99,3,1,51,75,38,51,14,24,0,2,14,52,75,7,2,48,68,34,48,7,20,3,8,13,41,68
2011-07-25 00:00:00.000,Gstaad Switzerland ATP World Tour 250,CLAY,2,Andreas Haider-Maurer,Yann Marti,Andreas Haider-Maurer,6-1; 6-4,R32,63,6,1,35,50,29,35,9,15,4,4,9,38,50,3,4,31,55,23,31,9,24,4,7,8,32,55
2011-07-25 00:00:00.000,Gstaad Switzerland ATP World Tour 250,CLAY,2,Denis Istomin,Martin Fischer,Denis Istomin,6-3; 3-6; 6-4,R32,124,5,4,58,100,39,58,19,42,12,16,14,58,100,3,1,54,90,29,54,21,36,6,11,14,50,90
2011-07-25 00:00:00.000,Gstaad Switzerland ATP World Tour 250,CLAY,2,Mikhail Youzhny,N/A Bye,Mikhail Youzhny,,R32,0,0,0,0,0,0,0,0,0,0,0,0,0,0,0,0,0,0,0,0,0,0,0,0,0,0,0
2011-07-25 00:00:00.000,Gstaad Switzerland ATP World Tour 250,CLAY,2,Marcel Granollers,Stephane Bohli,Marcel Granollers,6-1; 6-0,R32,60,3,0,21,35,17,21,7,14,1,2,6,24,35,1,3,27,50,16,27,1,23,2,9,7,17,50
2011-07-25 00:00:00.000,Gstaad Switzerland ATP World Tour 250,CLAY,2,Igor Andreev,Mischa Zverev,Igor Andreev,6-3; 6-2,R32,70,3,2,30,59,23,30,18,29,0,0,9,41,59,3,2,35,55,20,35,10,20,6,9,8,30,55
2011-07-25 00:00:00.000,Gstaad Switzerland ATP World Tour 250,CLAY,2,Peter Luczak,Alexander Sadecky,Peter Luczak,3-6; 6-3; 7-6(4),R32,135,1,5,61,102,42,61,22,41,3,7,15,64,102,14,7,61,95,46,61,12,34,4,8,15,58,95
2011-07-25 00:00:00.000,Gstaad Switzerland ATP World Tour 250,CLAY,2,Stanislas Wawrinka,N/A Bye,Stanislas Wawrinka,,R32,0,0,0,0,0,0,0,0,0,0,0,0,0,0,0,0,0,0,0,0,0,0,0,0,0,0,0
2011-07-25 00:00:00.000,Gstaad Switzerland ATP World Tour 250,CLAY,2,Nicolas Almagro,Jarkko Nieminen,Nicolas Almagro,7-6(3); 6-3,R16,61,12,3,34,61,30,34,20,27,1,1,11,50,61,4,2,39,61,31,39,10,22,2,3,10,41,61
2011-07-25 00:00:00.000,Gstaad Switzerland ATP World Tour 250,CLAY,2,Feliciano Lopez,Daniel Gimeno-Traver,Feliciano Lopez,6-3; 6-4,R16,73,7,3,41,62,32,41,9,21,1,2,10,41,62,4,2,47,67,32,47,7,20,8,11,9,39,67
2011-07-25 00:00:00.000,Gstaad Switzerland ATP World Tour 250,CLAY,2,Fernando Verdasco,Frederico Gil,Fernando Verdasco,6-3; 6-2,R16,77,4,2,41,57,28,41,10,16,5,5,8,38,57,4,2,49,72,28,49,10,23,10,14,9,38,72
2011-07-25 00:00:00.000,Gstaad Switzerland ATP World Tour 250,CLAY,2,Julien Benneteau,Matthias Bachinger,Julien Benneteau,6-4; 6-4,R16,82,2,3,36,62,28,36,14,26,7,8,10,42,62,9,4,42,70,27,42,15,28,8,11,10,42,70
2011-07-25 00:00:00.000,Gstaad Switzerland ATP World Tour 250,CLAY,2,Andreas Haider-Maurer,Santiago Giraldo,Andreas Haider-Maurer,3-6; 6-2; 6-4,R16,111,7,6,55,88,39,55,18,33,4,6,14,57,88,6,2,60,85,36,60,15,25,3,6,13,51,85
2011-07-25 00:00:00.000,Gstaad Switzerland ATP World Tour 250,CLAY,2,Mikhail Youzhny,Denis Istomin,Mikhail Youzhny,6-3; 6-2,R16,74,0,3,29,50,20,29,14,21,2,3,9,34,50,5,2,31,58,15,31,13,27,9,13,8,28,58
2011-07-25 00:00:00.000,Gstaad Switzerland ATP World Tour 250,CLAY,2,Marcel Granollers,Igor Andreev,Marcel Granollers,6-1; 6-3,R16,78,3,3,32,55,27,32,11,23,3,3,8,38,55,2,2,22,44,12,22,9,22,0,4,8,21,44
2011-07-25 00:00:00.000,Gstaad Switzerland ATP World Tour 250,CLAY,2,Stanislas Wawrinka,Peter Luczak,Stanislas Wawrinka,6-3; 7-5,R16,83,9,4,27,58,22,27,21,31,1,2,11,43,58,1,0,40,61,28,40,6,21,4,7,10,34,61
2011-07-25 00:00:00.000,Gstaad Switzerland ATP World Tour 250,CLAY,2,Nicolas Almagro,Feliciano Lopez,Nicolas Almagro,6-4; 7-5,Q,72,8,2,37,61,34,37,15,24,3,3,11,49,61,4,2,34,60,24,34,15,26,1,3,11,39,60
2011-07-25 00:00:00.000,Gstaad Switzerland ATP World Tour 250,CLAY,2,Fernando Verdasco,Julien Benneteau,Fernando Verdasco,6-4; 5-7; 6-1,Q,132,8,4,68,89,47,68,12,21,6,8,14,59,89,5,9,51,95,35,51,19,44,4,9,15,54,95
2011-07-25 00:00:00.000,Gstaad Switzerland ATP World Tour 250,CLAY,2,Mikhail Youzhny,Andreas Haider-Maurer,Mikhail Youzhny,6-4; 5-7; 6-4,Q,140,2,2,65,96,45,65,17,31,2,5,16,62,96,3,4,53,92,39,53,21,39,5,9,16,60,92
2011-07-25 00:00:00.000,Gstaad Switzerland ATP World Tour 250,CLAY,2,Marcel Granollers,Stanislas Wawrinka,Marcel Granollers,6-3; 6-2,Q,70,1,1,27,39,22,27,6,12,0,1,8,28,39,2,0,33,54,19,33,8,21,2,7,9,27,54
2011-07-25 00:00:00.000,Gstaad Switzerland ATP World Tour 250,CLAY,2,Fernando Verdasco,Nicolas Almagro,Fernando Verdasco,6-7(2); 7-6(2); 6-3,S,130,13,8,69,112,50,69,25,43,4,5,16,75,112,10,6,64,106,54,64,18,42,3,6,17,72,106
2011-07-25 00:00:00.000,Gstaad Switzerland ATP World Tour 250,CLAY,2,Marcel Granollers,Mikhail Youzhny,Marcel Granollers,6-3; 3-6; 6-2,S,126,5,0,50,77,34,50,15,27,4,8,13,49,77,1,1,73,90,38,73,8,17,9,15,13,46,90
2011-07-25 00:00:00.000,Gstaad Switzerland ATP World Tour 250,CLAY,2,Marcel Granollers,Fernando Verdasco,Marcel Granollers,6-4; 3-6; 6-3,F,144,5,3,50,82,42,50,17,32,4,5,14,59,82,2,3,61,92,41,61,18,31,6,8,14,59,92
2011-07-25 00:00:00.000,Los Angeles CA; U.S.A. ATP World Tour 250,HARD,2,Mardy Fish,N/A Bye,Mardy Fish,,R32,0,0,0,0,0,0,0,0,0,0,0,0,0,0,0,0,0,0,0,0,0,0,0,0,0,0,0
2011-07-25 00:00:00.000,Los Angeles CA; U.S.A. ATP World Tour 250,HARD,2,Gilles Muller,Steve Johnson,Gilles Muller,2-6; 6-3; 6-4,R32,117,16,5,54,90,39,54,19,36,5,7,14,58,90,8,6,46,78,37,46,16,32,5,7,13,53,78
2011-07-25 00:00:00.000,Los Angeles CA; U.S.A. ATP World Tour 250,HARD,2,Ryan Sweeting,Somdev Devvarman,Ryan Sweeting,6-4; 7-6(6),R32,112,0,9,44,80,25,44,16,36,4,9,11,41,80,1,1,40,64,20,40,13,24,1,7,11,33,64
2011-07-25 00:00:00.000,Los Angeles CA; U.S.A. ATP World Tour 250,HARD,2,Igor Kunitsyn,Fernando Gonzalez,Igor Kunitsyn,6-4; 6-3,R32,92,4,3,29,63,23,29,20,34,5,5,9,43,63,8,5,49,87,36,49,14,38,10,13,10,50,87
2011-07-25 00:00:00.000,Los Angeles CA; U.S.A. ATP World Tour 250,HARD,2,Marcos Baghdatis,N/A Bye,Marcos Baghdatis,,R32,0,0,0,0,0,0,0,0,0,0,0,0,0,0,0,0,0,0,0,0,0,0,0,0,0,0,0
2011-07-25 00:00:00.000,Los Angeles CA; U.S.A. ATP World Tour 250,HARD,2,Yen-Hsun Lu,Robby Ginepri,Yen-Hsun Lu,6-4; 7-5,R32,97,4,3,45,69,31,45,17,24,5,6,11,48,69,3,1,43,75,27,43,17,32,9,12,11,44,75
2011-07-25 00:00:00.000,Los Angeles CA; U.S.A. ATP World Tour 250,HARD,2,Ryan Harrison,Ricardas Berankis,Ryan Harrison,6-7(4); 7-5; 6-3,R32,133,9,4,57,89,47,57,17,32,0,2,16,64,89,6,6,58,110,40,58,26,52,4,9,17,66,110
2011-07-25 00:00:00.000,Los Angeles CA; U.S.A. ATP World Tour 250,HARD,2,Michael Russell,Dmitry Tursunov,Michael Russell,6-7(5); 6-0; 6-2,R32,112,5,3,57,80,44,57,12,23,2,4,13,56,80,0,2,64,95,31,64,16,31,12,19,13,47,95
2011-07-25 00:00:00.000,Los Angeles CA; U.S.A. ATP World Tour 250,HARD,2,Grigor Dimitrov,Tommy Haas,Grigor Dimitrov,6-3; 6-2,R32,66,4,7,23,52,19,23,9,29,3,6,8,28,52,2,5,28,56,14,28,9,28,4,11,9,23,56
2011-07-25 00:00:00.000,Los Angeles CA; U.S.A. ATP World Tour 250,HARD,2,Alex Bogomolov Jr.,Greg Jones,Alex Bogomolov Jr.,4-6; 6-1; 6-1,R32,97,5,2,46,69,36,46,10,23,5,7,12,46,69,5,6,53,86,33,53,10,33,8,14,12,43,86
2011-07-25 00:00:00.000,Los Angeles CA; U.S.A. ATP World Tour 250,HARD,2,Alejandro Falla,Laurynas Grigelis,Alejandro Falla,6-2; 6-4,R32,67,1,2,24,55,19,24,21,31,1,1,9,40,55,0,4,31,55,19,31,11,24,3,6,9,30,55
2011-07-25 00:00:00.000,Los Angeles CA; U.S.A. ATP World Tour 250,HARD,2,Thomaz Bellucci,N/A Bye,Thomaz Bellucci,,R32,0,0,0,0,0,0,0,0,0,0,0,0,0,0,0,0,0,0,0,0,0,0,0,0,0,0,0
2011-07-25 00:00:00.000,Los Angeles CA; U.S.A. ATP World Tour 250,HARD,2,Ernests Gulbis,Xavier Malisse,Ernests Gulbis,2-6; 6-3; 7-6(5),R32,120,13,5,58,94,45,58,19,36,3,5,15,64,94,6,4,50,88,41,50,19,38,4,5,14,60,88
2011-07-25 00:00:00.000,Los Angeles CA; U.S.A. ATP World Tour 250,HARD,2,Daniel Kosakowski,Tim Smyczek,Daniel Kosakowski,2-6; 6-1; 6-3,R32,124,5,3,49,92,34,49,19,43,7,10,12,53,92,1,3,41,70,25,41,15,29,4,9,12,40,70
2011-07-25 00:00:00.000,Los Angeles CA; U.S.A. ATP World Tour 250,HARD,2,James Blake,Michael Berrer,James Blake,6-2; 6-3,R32,62,1,2,37,59,28,37,11,22,5,6,9,39,59,1,1,32,42,15,32,5,10,0,4,8,20,42
2011-07-25 00:00:00.000,Los Angeles CA; U.S.A. ATP World Tour 250,HARD,2,Juan Martin Del Potro,N/A Bye,Juan Martin Del Potro,,R32,0,0,0,0,0,0,0,0,0,0,0,0,0,0,0,0,0,0,0,0,0,0,0,0,0,0,0
2011-07-25 00:00:00.000,Los Angeles CA; U.S.A. ATP World Tour 250,HARD,2,Mardy Fish,Gilles Muller,Mardy Fish,7-6(1); 6-1,R16,79,6,1,42,64,34,42,12,22,3,4,10,46,64,6,4,27,56,18,27,12,29,1,4,9,30,56
2011-07-25 00:00:00.000,Los Angeles CA; U.S.A. ATP World Tour 250,HARD,2,Igor Kunitsyn,Ryan Sweeting,Igor Kunitsyn,7-6(4); 7-6(6),R16,122,4,2,39,82,25,39,23,43,1,5,12,48,82,2,8,46,88,33,46,17,42,5,9,12,50,88
2011-07-25 00:00:00.000,Los Angeles CA; U.S.A. ATP World Tour 250,HARD,2,Yen-Hsun Lu,Marcos Baghdatis,Yen-Hsun Lu,6-3; 6-4,R16,74,3,3,31,56,26,31,15,25,0,0,10,41,56,7,2,23,45,18,23,12,22,1,3,9,30,45
2011-07-25 00:00:00.000,Los Angeles CA; U.S.A. ATP World Tour 250,HARD,2,Ryan Harrison,Michael Russell,Ryan Harrison,6-3; 6-4,R16,82,7,1,33,52,27,33,11,19,1,2,10,38,52,1,2,36,61,23,36,11,25,6,9,9,34,61
2011-07-25 00:00:00.000,Los Angeles CA; U.S.A. ATP World Tour 250,HARD,2,Alex Bogomolov Jr.,Grigor Dimitrov,Alex Bogomolov Jr.,6-4; 6-3,R16,82,0,4,41,58,27,41,9,17,2,4,10,36,58,3,3,35,60,20,35,12,25,3,7,9,32,60
2011-07-25 00:00:00.000,Los Angeles CA; U.S.A. ATP World Tour 250,HARD,2,Thomaz Bellucci,Alejandro Falla,Thomaz Bellucci,6-0; 6-1,R16,53,1,3,24,37,19,24,7,13,2,2,6,26,37,0,4,35,55,18,35,3,20,10,16,7,21,55
2011-07-25 00:00:00.000,Los Angeles CA; U.S.A. ATP World Tour 250,HARD,2,Ernests Gulbis,Daniel Kosakowski,Ernests Gulbis,6-2; 6-4,R16,78,8,1,32,53,28,32,12,21,2,2,9,40,53,3,3,29,55,17,29,14,26,2,5,9,31,55
2011-07-25 00:00:00.000,Los Angeles CA; U.S.A. ATP World Tour 250,HARD,2,Juan Martin Del Potro,James Blake,Juan Martin Del Potro,6-4; 7-6(3),R16,103,6,5,40,72,34,40,15,32,1,2,11,49,72,4,2,44,80,33,44,13,36,4,6,11,46,80
2011-07-25 00:00:00.000,Los Angeles CA; U.S.A. ATP World Tour 250,HARD,2,Mardy Fish,Igor Kunitsyn,Mardy Fish,6-2; 6-4,Q,74,6,1,29,49,22,29,11,20,2,4,9,33,49,1,1,27,53,14,27,11,26,1,6,9,25,53
2011-07-25 00:00:00.000,Los Angeles CA; U.S.A. ATP World Tour 250,HARD,2,Ryan Harrison,Yen-Hsun Lu,Ryan Harrison,3-6; 6-3; 6-4,Q,144,8,4,71,114,47,71,22,43,10,12,14,69,114,2,6,45,78,30,45,20,33,2,5,14,50,78
2011-07-25 00:00:00.000,Los Angeles CA; U.S.A. ATP World Tour 250,HARD,2,Alex Bogomolov Jr.,Thomaz Bellucci,Alex Bogomolov Jr.,1-6; 6-4; 6-1,Q,122,3,2,56,81,34,56,12,25,6,10,12,46,81,6,4,47,82,32,47,12,35,7,12,12,44,82
2011-07-25 00:00:00.000,Los Angeles CA; U.S.A. ATP World Tour 250,HARD,2,Ernests Gulbis,Juan Martin Del Potro,Ernests Gulbis,6-2; 6-4,Q,97,8,1,32,54,24,32,13,22,2,3,9,37,54,2,3,34,60,18,34,12,26,2,6,9,30,60
2011-07-25 00:00:00.000,Los Angeles CA; U.S.A. ATP World Tour 250,HARD,2,Mardy Fish,Ryan Harrison,Mardy Fish,6-0; 4-6; 7-6(3),S,131,7,2,41,81,31,41,26,40,1,3,14,57,81,6,8,49,85,31,49,18,36,2,6,14,49,85
2011-07-25 00:00:00.000,Los Angeles CA; U.S.A. ATP World Tour 250,HARD,2,Ernests Gulbis,Alex Bogomolov Jr.,Ernests Gulbis,6-2; 7-6(4),S,112,11,0,35,64,29,35,17,29,0,0,10,46,64,3,0,63,81,39,63,8,18,7,9,10,47,81
2011-07-25 00:00:00.000,Los Angeles CA; U.S.A. ATP World Tour 250,HARD,2,Ernests Gulbis,Mardy Fish,Ernests Gulbis,5-7; 6-4; 6-4,F,163,10,7,60,103,43,60,24,43,3,5,16,67,103,14,1,56,93,38,56,24,37,3,6,16,62,93
2011-07-25 00:00:00.000,Umag Croatia ATP World Tour 250,CLAY,2,Juan Ignacio Chela,N/A Bye,Juan Ignacio Chela,,R32,0,0,0,0,0,0,0,0,0,0,0,0,0,0,0,0,0,0,0,0,0,0,0,0,0,0,0
2011-07-25 00:00:00.000,Umag Croatia ATP World Tour 250,CLAY,2,Potito Starace,Thiemo de Bakker,Potito Starace,6-7(5); 6-2; 6-1,R32,117,7,2,61,84,44,61,16,23,3,4,14,60,84,3,7,35,87,25,35,22,52,4,9,13,47,87
2011-07-25 00:00:00.000,Umag Croatia ATP World Tour 250,CLAY,2,Olivier Rochus,Sergiy Stakhovsky,Olivier Rochus,6-4; 6-4,R32,105,2,2,45,71,31,45,17,26,5,5,10,48,71,5,3,44,75,31,44,14,31,5,7,10,45,75
2011-07-25 00:00:00.000,Umag Croatia ATP World Tour 250,CLAY,2,Fabio Fognini,Rui Machado,Fabio Fognini,6-4; 6-3,R32,87,3,1,28,55,18,28,12,27,1,4,9,30,55,0,5,48,74,24,48,12,26,5,11,10,36,74
2011-07-25 00:00:00.000,Umag Croatia ATP World Tour 250,CLAY,2,Marin Cilic,N/A Bye,Marin Cilic,,R32,0,0,0,0,0,0,0,0,0,0,0,0,0,0,0,0,0,0,0,0,0,0,0,0,0,0,0
2011-07-25 00:00:00.000,Umag Croatia ATP World Tour 250,CLAY,2,Robin Haase,Simone Vagnozzi,Robin Haase,3-6; 6-3; 6-1,R32,122,5,3,61,100,40,61,14,39,13,18,12,54,100,0,2,59,79,30,59,8,20,1,9,13,38,79
2011-07-25 00:00:00.000,Umag Croatia ATP World Tour 250,CLAY,2,Diego Junqueira,Antonio Veic,Diego Junqueira,6-4; 7-5,R32,113,0,1,58,79,33,58,10,21,7,11,11,43,79,2,7,30,68,21,30,12,38,0,6,11,33,68
2011-07-25 00:00:00.000,Umag Croatia ATP World Tour 250,CLAY,2,Andreas Seppi,Dusan Lajovic,Andreas Seppi,6-4; 6-2,R32,84,2,1,35,57,27,35,10,22,1,2,9,37,57,2,3,49,78,27,49,13,29,8,12,9,40,78
2011-07-25 00:00:00.000,Umag Croatia ATP World Tour 250,CLAY,2,Tommy Robredo,Ruben Ramirez Hidalgo,Tommy Robredo,6-3; 6-2,R32,79,4,4,32,60,27,32,15,28,0,0,9,42,60,1,7,28,51,20,28,7,23,6,9,8,27,51
2011-07-25 00:00:00.000,Umag Croatia ATP World Tour 250,CLAY,2,Carlos Berlocq,Blaz Kavcic,Carlos Berlocq,6-4; 6-7(7); 6-4,R32,221,4,8,56,103,41,56,25,47,8,11,16,66,103,2,8,68,126,42,68,29,58,11,16,16,71,126
2011-07-25 00:00:00.000,Umag Croatia ATP World Tour 250,CLAY,2,Juan Carlos Ferrero,Maximo Gonzalez,Juan Carlos Ferrero,3-6; 6-3; 1-1 RET,R32,87,6,0,30,48,21,30,13,18,0,2,10,34,48,2,4,43,73,30,43,13,30,6,8,10,43,73
2011-07-25 00:00:00.000,Umag Croatia ATP World Tour 250,CLAY,2,Ivan Ljubicic,N/A Bye,Ivan Ljubicic,,R32,0,0,0,0,0,0,0,0,0,0,0,0,0,0,0,0,0,0,0,0,0,0,0,0,0,0,0
2011-07-25 00:00:00.000,Umag Croatia ATP World Tour 250,CLAY,2,Albert Ramos,Ivan Dodig,Albert Ramos,6-4; 3-6; 6-2,R32,156,1,2,43,81,31,43,19,38,4,7,13,50,81,6,6,51,98,40,51,15,47,8,13,14,55,98
2011-07-25 00:00:00.000,Umag Croatia ATP World Tour 250,CLAY,2,Gianluca Naso,Mate Delic,Gianluca Naso,6-4; 6-2,R32,76,4,4,22,52,22,22,16,30,4,4,9,38,52,3,0,41,68,25,41,12,27,5,8,9,37,68
2011-07-25 00:00:00.000,Umag Croatia ATP World Tour 250,CLAY,2,Filippo Volandri,Mate Pavic,Filippo Volandri,6-4; 6-0,R32,69,0,0,30,45,21,30,9,15,2,3,8,30,45,0,2,28,55,15,28,9,27,2,7,8,24,55
2011-07-25 00:00:00.000,Umag Croatia ATP World Tour 250,CLAY,2,Alexandr Dolgopolov,N/A Bye,Alexandr Dolgopolov,,R32,0,0,0,0,0,0,0,0,0,0,0,0,0,0,0,0,0,0,0,0,0,0,0,0,0,0,0
2011-07-25 00:00:00.000,Umag Croatia ATP World Tour 250,CLAY,2,Potito Starace,Juan Ignacio Chela,Potito Starace,6-4; 4-6; 7-5,R16,148,5,3,72,110,48,72,18,38,5,9,16,66,110,1,7,63,104,41,63,19,41,5,10,16,60,104
2011-07-25 00:00:00.000,Umag Croatia ATP World Tour 250,CLAY,2,Fabio Fognini,Olivier Rochus,Fabio Fognini,6-4; 6-1,R16,76,1,4,34,58,24,34,10,24,6,8,8,34,58,0,0,33,60,15,33,12,27,5,11,9,27,60
2011-07-25 00:00:00.000,Umag Croatia ATP World Tour 250,CLAY,2,Marin Cilic,Robin Haase,Marin Cilic,4-6; 6-4; 6-3,R16,142,9,2,36,92,31,36,29,56,7,9,14,60,92,5,3,58,102,40,58,20,44,6,10,15,60,102
2011-07-25 00:00:00.000,Umag Croatia ATP World Tour 250,CLAY,2,Andreas Seppi,Diego Junqueira,Andreas Seppi,7-5; 6-1,R16,89,3,4,37,72,30,37,17,35,5,6,10,47,72,0,1,45,65,23,45,12,20,9,13,9,35,65
2011-07-25 00:00:00.000,Umag Croatia ATP World Tour 250,CLAY,2,Carlos Berlocq,Tommy Robredo,Carlos Berlocq,W/O,R16,0,0,0,0,0,0,0,0,0,0,0,0,0,0,0,0,0,0,0,0,0,0,0,0,0,0,0
2011-07-25 00:00:00.000,Umag Croatia ATP World Tour 250,CLAY,2,Juan Carlos Ferrero,Ivan Ljubicic,Juan Carlos Ferrero,1-6; 6-3; 6-4,R16,115,0,2,49,75,31,49,15,26,5,9,13,46,75,7,2,27,75,18,27,26,48,6,10,13,44,75
2011-07-25 00:00:00.000,Umag Croatia ATP World Tour 250,CLAY,2,Albert Ramos,Gianluca Naso,Albert Ramos,6-1; 6-3,R16,73,4,2,29,46,22,29,12,17,4,4,8,34,46,2,1,27,53,21,27,8,26,8,12,8,29,53
2011-07-25 00:00:00.000,Umag Croatia ATP World Tour 250,CLAY,2,Alexandr Dolgopolov,Filippo Volandri,Alexandr Dolgopolov,6-1; 6-2,R16,55,5,2,16,50,13,16,22,34,5,5,8,35,50,0,3,18,37,12,18,6,19,2,6,7,18,37
2011-07-25 00:00:00.000,Umag Croatia ATP World Tour 250,CLAY,2,Fabio Fognini,Potito Starace,Fabio Fognini,3-6; 6-3; 6-1,Q,106,4,3,49,84,35,49,18,35,4,6,12,53,84,1,2,51,77,34,51,12,26,4,9,13,46,77
2011-07-25 00:00:00.000,Umag Croatia ATP World Tour 250,CLAY,2,Marin Cilic,Andreas Seppi,Marin Cilic,6-1; 6-3,Q,72,1,1,29,46,24,29,10,17,1,1,8,34,46,1,1,34,53,17,34,9,19,5,9,8,26,53
2011-07-25 00:00:00.000,Umag Croatia ATP World Tour 250,CLAY,2,Juan Carlos Ferrero,Carlos Berlocq,Juan Carlos Ferrero,6-1; 7-6(5),Q,84,0,1,38,53,21,38,6,15,2,6,9,27,53,0,2,38,58,17,38,4,20,4,11,10,21,58
2011-07-25 00:00:00.000,Umag Croatia ATP World Tour 250,CLAY,2,Alexandr Dolgopolov,Albert Ramos,Alexandr Dolgopolov,6-3; 7-5,Q,85,5,0,28,70,20,28,28,42,1,2,11,48,70,2,3,43,61,27,43,9,18,2,5,10,36,61
2011-07-25 00:00:00.000,Umag Croatia ATP World Tour 250,CLAY,2,Marin Cilic,Fabio Fognini,Marin Cilic,6-2; 6-2,S,74,2,2,29,50,22,29,11,21,2,3,8,33,50,0,8,29,57,15,29,10,28,3,8,8,25,57
2011-07-25 00:00:00.000,Umag Croatia ATP World Tour 250,CLAY,2,Alexandr Dolgopolov,Juan Carlos Ferrero,Alexandr Dolgopolov,6-4; 6-4,S,86,9,3,28,67,24,28,19,39,1,2,10,43,67,0,1,42,65,22,42,16,23,7,10,10,38,65
2011-07-25 00:00:00.000,Umag Croatia ATP World Tour 250,CLAY,2,Alexandr Dolgopolov,Marin Cilic,Alexandr Dolgopolov,6-4; 3-6; 6-3,F,134,6,1,32,74,28,32,24,42,2,4,14,52,74,4,5,52,106,35,52,27,54,9,12,14,62,106
2011-07-31 00:00:00.000,Kitzbnhel Austria ATP World Tour 250,CLAY,2,Juan Ignacio Chela,N/A Bye,Juan Ignacio Chela,,R32,0,0,0,0,0,0,0,0,0,0,0,0,0,0,0,0,0,0,0,0,0,0,0,0,0,0,0
2011-07-31 00:00:00.000,Kitzbnhel Austria ATP World Tour 250,CLAY,2,Daniel Gimeno-Traver,Dominic Thiem,Daniel Gimeno-Traver,6-4; 6-2,R32,66,2,2,24,43,22,24,11,19,0,1,9,33,43,2,5,19,53,15,19,12,34,3,7,9,27,53
2011-07-31 00:00:00.000,Kitzbnhel Austria ATP World Tour 250,CLAY,2,Antonio Veic,Andreas Haider-Maurer,Antonio Veic,6-7(3); 6-4; 6-2,R32,143,5,1,51,89,34,51,23,38,5,9,15,57,89,7,8,57,104,36,57,21,47,8,15,15,57,104
2011-07-31 00:00:00.000,Kitzbnhel Austria ATP World Tour 250,CLAY,2,Marcel Granollers,Filippo Volandri,Marcel Granollers,6-4; 6-2,R32,87,3,1,28,53,25,28,12,25,1,2,9,37,53,0,1,33,54,17,33,12,21,1,5,9,29,54
2011-07-31 00:00:00.000,Kitzbnhel Austria ATP World Tour 250,CLAY,2,Fabio Fognini,N/A Bye,Fabio Fognini,,R32,0,0,0,0,0,0,0,0,0,0,0,0,0,0,0,0,0,0,0,0,0,0,0,0,0,0,0
2011-07-31 00:00:00.000,Kitzbnhel Austria ATP World Tour 250,CLAY,2,Santiago Giraldo,Daniel Brands,Santiago Giraldo,6-3; 6-3,R32,69,4,0,40,62,33,40,12,22,6,6,9,45,62,1,3,36,54,26,36,7,18,3,6,9,33,54
2011-07-31 00:00:00.000,Kitzbnhel Austria ATP World Tour 250,CLAY,2,Albert Montanes,Javier Marti,Albert Montanes,6-3; 6-2,R32,70,1,4,34,49,27,34,6,15,2,4,9,33,49,2,4,32,55,14,32,11,23,2,7,8,25,55
2011-07-31 00:00:00.000,Kitzbnhel Austria ATP World Tour 250,CLAY,2,Philipp Kohlschreiber,Thomas Muster,Philipp Kohlschreiber,6-3; 6-0,R32,66,8,4,32,52,23,32,11,20,3,4,7,34,52,1,2,29,57,15,29,8,28,7,13,8,23,57
2011-07-31 00:00:00.000,Kitzbnhel Austria ATP World Tour 250,CLAY,2,Pablo Andujar,Lukas Rosol,Pablo Andujar,3-6; 6-3; 6-3,R32,122,6,6,59,96,39,59,19,37,9,12,13,58,96,9,4,54,90,36,54,16,36,7,12,14,52,90
2011-07-31 00:00:00.000,Kitzbnhel Austria ATP World Tour 250,CLAY,2,Albert Ramos,Igor Andreev,Albert Ramos,6-0; 6-7(2); 6-4,R32,146,6,8,59,101,44,59,18,42,9,11,14,62,101,1,4,52,91,32,52,17,39,7,13,14,49,91
2011-07-31 00:00:00.000,Kitzbnhel Austria ATP World Tour 250,CLAY,2,Joao Souza,Jerzy Janowicz,Joao Souza,6-3; 4-6; 7-6(3),R32,142,8,5,57,87,46,57,19,30,1,2,15,65,87,8,8,72,106,55,72,16,34,9,11,16,71,106
2011-07-31 00:00:00.000,Kitzbnhel Austria ATP World Tour 250,CLAY,2,Diego Junqueira,N/A Bye,Diego Junqueira,,R32,0,0,0,0,0,0,0,0,0,0,0,0,0,0,0,0,0,0,0,0,0,0,0,0,0,0,0
2011-07-31 00:00:00.000,Kitzbnhel Austria ATP World Tour 250,CLAY,2,Andreas Seppi,Denis Istomin,Andreas Seppi,6-2; 6-2,R32,61,2,2,25,48,21,25,14,23,2,2,8,35,48,1,4,33,53,19,33,7,20,7,11,8,26,53
2011-07-31 00:00:00.000,Kitzbnhel Austria ATP World Tour 250,CLAY,2,Pere Riba,Victor Hanescu,Pere Riba,7-6(3); 6-4,R32,100,9,4,46,75,34,46,14,29,6,8,11,48,75,2,3,43,68,28,43,14,25,5,8,11,42,68
2011-07-31 00:00:00.000,Kitzbnhel Austria ATP World Tour 250,CLAY,2,Robin Haase,Potito Starace,Robin Haase,6-3; 2-0 RET,R32,43,6,1,17,31,15,17,9,14,0,0,6,24,31,1,0,21,29,13,21,3,8,1,3,5,16,29
2011-07-31 00:00:00.000,Kitzbnhel Austria ATP World Tour 250,CLAY,2,Feliciano Lopez,N/A Bye,Feliciano Lopez,,R32,0,0,0,0,0,0,0,0,0,0,0,0,0,0,0,0,0,0,0,0,0,0,0,0,0,0,0
2011-07-31 00:00:00.000,Kitzbnhel Austria ATP World Tour 250,CLAY,2,Juan Ignacio Chela,Daniel Gimeno-Traver,Juan Ignacio Chela,6-4; 3-6; 6-3,R16,135,2,5,49,84,33,49,19,35,4,7,14,52,84,8,1,44,91,31,44,21,47,5,9,14,52,91
2011-07-31 00:00:00.000,Kitzbnhel Austria ATP World Tour 250,CLAY,2,Marcel Granollers,Antonio Veic,Marcel Granollers,6-0; 3-6; 6-4,R16,125,3,1,37,65,24,37,17,28,0,3,12,41,65,3,1,45,78,26,45,14,33,5,11,13,40,78
2011-07-31 00:00:00.000,Kitzbnhel Austria ATP World Tour 250,CLAY,2,Santiago Giraldo,Fabio Fognini,Santiago Giraldo,6-3; 6-4,R16,85,3,1,37,58,23,37,10,21,1,4,10,33,58,3,3,40,72,23,40,11,32,4,9,9,34,72
2011-07-31 00:00:00.000,Kitzbnhel Austria ATP World Tour 250,CLAY,2,Albert Montanes,Philipp Kohlschreiber,Albert Montanes,6-4; 7-5,R16,81,8,6,45,65,35,45,5,20,3,5,11,40,65,3,3,28,61,19,28,16,33,2,6,11,35,61
2011-07-31 00:00:00.000,Kitzbnhel Austria ATP World Tour 250,CLAY,2,Pablo Andujar,Albert Ramos,Pablo Andujar,6-2; 6-1,R16,79,0,2,31,48,20,31,12,17,2,3,8,32,48,4,0,27,53,15,27,9,26,4,9,7,24,53
2011-07-31 00:00:00.000,Kitzbnhel Austria ATP World Tour 250,CLAY,2,Joao Souza,Diego Junqueira,Joao Souza,6-2; 6-2,R16,85,4,2,30,44,23,30,10,14,1,1,8,33,44,2,2,30,49,19,30,7,19,2,6,8,26,49
2011-07-31 00:00:00.000,Kitzbnhel Austria ATP World Tour 250,CLAY,2,Andreas Seppi,Pere Riba,Andreas Seppi,7-5; 6-4,R16,91,5,5,39,69,27,39,13,30,2,5,11,40,69,2,3,28,61,19,28,13,33,3,8,11,32,61
2011-07-31 00:00:00.000,Kitzbnhel Austria ATP World Tour 250,CLAY,2,Robin Haase,Feliciano Lopez,Robin Haase,1-6; 6-4; 6-3,R16,114,5,3,34,73,21,34,26,39,0,3,13,47,73,9,3,45,71,35,45,14,26,3,6,13,49,71
2011-07-31 00:00:00.000,Kitzbnhel Austria ATP World Tour 250,CLAY,2,Juan Ignacio Chela,Marcel Granollers,Juan Ignacio Chela,6-3; 6-4,Q,96,0,1,35,50,28,35,8,15,1,2,9,36,50,3,2,46,69,30,46,8,23,6,10,10,38,69
2011-07-31 00:00:00.000,Kitzbnhel Austria ATP World Tour 250,CLAY,2,Albert Montanes,Santiago Giraldo,Albert Montanes,6-1; 7-6(0),Q,80,6,3,40,65,31,40,12,25,1,3,10,43,65,7,0,35,58,24,35,6,23,7,11,9,30,58
2011-07-31 00:00:00.000,Kitzbnhel Austria ATP World Tour 250,CLAY,2,Joao Souza,Pablo Andujar,Joao Souza,6-3; 6-4,Q,83,8,5,31,55,27,31,11,24,0,2,10,38,55,1,0,25,52,17,25,11,27,3,7,9,28,52
2011-07-31 00:00:00.000,Kitzbnhel Austria ATP World Tour 250,CLAY,2,Robin Haase,Andreas Seppi,Robin Haase,6-4; 6-2,Q,93,6,1,42,78,27,42,15,36,3,7,9,42,78,2,6,27,57,14,27,8,30,4,11,9,22,57
2011-07-31 00:00:00.000,Kitzbnhel Austria ATP World Tour 250,CLAY,2,Albert Montanes,Juan Ignacio Chela,Albert Montanes,6-2; 7-5,S,92,1,4,34,56,27,34,9,22,2,5,10,36,56,1,2,58,75,28,58,8,17,8,14,10,36,75
2011-07-31 00:00:00.000,Kitzbnhel Austria ATP World Tour 250,CLAY,2,Robin Haase,Joao Souza,Robin Haase,6-1; 6-7(3); 6-4,S,130,14,0,40,74,34,40,23,34,1,2,14,57,74,7,3,59,99,41,59,18,40,5,10,15,59,99
2011-07-31 00:00:00.000,Kitzbnhel Austria ATP World Tour 250,CLAY,2,Robin Haase,Albert Montanes,Robin Haase,6-4; 4-6; 6-1,F,121,4,4,43,93,30,43,26,50,7,10,14,56,93,3,3,34,73,24,34,18,39,5,10,13,42,73
2011-07-31 00:00:00.000,Washington DC; USA ATP World Tour 500,HARD,2,Gael Monfils,N/A Bye,Gael Monfils,,R64,0,0,0,0,0,0,0,0,0,0,0,0,0,0,0,0,0,0,0,0,0,0,0,0,0,0,0
2011-07-31 00:00:00.000,Washington DC; USA ATP World Tour 500,HARD,2,Ryan Sweeting,Alex Bogomolov Jr.,Ryan Sweeting,6-2; 6-4,R64,81,7,2,35,57,24,35,12,22,1,3,9,36,57,4,3,29,57,18,29,9,28,2,7,9,27,57
2011-07-31 00:00:00.000,Washington DC; USA ATP World Tour 500,HARD,2,Flavio Cipolla,Marsel Ilhan,Flavio Cipolla,7-5; 6-0,R64,89,0,2,35,54,22,35,12,19,2,4,9,34,54,0,2,27,58,14,27,13,31,3,9,9,27,58
2011-07-31 00:00:00.000,Washington DC; USA ATP World Tour 500,HARD,2,Dmitry Tursunov,N/A Bye,Dmitry Tursunov,,R64,0,0,0,0,0,0,0,0,0,0,0,0,0,0,0,0,0,0,0,0,0,0,0,0,0,0,0
2011-07-31 00:00:00.000,Washington DC; USA ATP World Tour 500,HARD,2,Michael Llodra,N/A Bye,Michael Llodra,,R64,0,0,0,0,0,0,0,0,0,0,0,0,0,0,0,0,0,0,0,0,0,0,0,0,0,0,0
2011-07-31 00:00:00.000,Washington DC; USA ATP World Tour 500,HARD,2,Grigor Dimitrov,Tim Smyczek,Grigor Dimitrov,4-6; 7-6(3); 7-6(3),R64,159,12,7,70,111,49,70,24,41,3,6,17,73,111,2,1,109,140,69,109,15,31,13,15,17,84,140
2011-07-31 00:00:00.000,Washington DC; USA ATP World Tour 500,HARD,2,Michael Berrer,Paolo Lorenzi,Michael Berrer,7-5; 6-1,R64,78,3,2,38,54,28,38,7,16,2,4,10,35,54,1,4,35,59,20,35,8,24,2,7,9,28,59
2011-07-31 00:00:00.000,Washington DC; USA ATP World Tour 500,HARD,2,Janko Tipsarevic,N/A Bye,Janko Tipsarevic,,R64,0,0,0,0,0,0,0,0,0,0,0,0,0,0,0,0,0,0,0,0,0,0,0,0,0,0,0
2011-07-31 00:00:00.000,Washington DC; USA ATP World Tour 500,HARD,2,Viktor Troicki,N/A Bye,Viktor Troicki,,R64,0,0,0,0,0,0,0,0,0,0,0,0,0,0,0,0,0,0,0,0,0,0,0,0,0,0,0
2011-07-31 00:00:00.000,Washington DC; USA ATP World Tour 500,HARD,2,Ryan Harrison,Mischa Zverev,Ryan Harrison,6-4; 1-6; 6-1,R64,94,2,10,41,76,28,41,19,35,1,4,12,47,76,3,3,57,86,39,57,10,29,8,12,12,49,86
2011-07-31 00:00:00.000,Washington DC; USA ATP World Tour 500,HARD,2,Chris Guccione,Alejandro Falla,Chris Guccione,7-6(3); 6-3,R64,70,11,1,36,56,35,36,12,20,3,3,10,47,56,4,5,38,67,30,38,14,29,0,2,11,44,67
2011-07-31 00:00:00.000,Washington DC; USA ATP World Tour 500,HARD,2,Kevin Anderson,N/A Bye,Kevin Anderson,,R64,0,0,0,0,0,0,0,0,0,0,0,0,0,0,0,0,0,0,0,0,0,0,0,0,0,0,0
2011-07-31 00:00:00.000,Washington DC; USA ATP World Tour 500,HARD,2,John Isner,N/A Bye,John Isner,,R64,0,0,0,0,0,0,0,0,0,0,0,0,0,0,0,0,0,0,0,0,0,0,0,0,0,0,0
2011-07-31 00:00:00.000,Washington DC; USA ATP World Tour 500,HARD,2,Tobias Kamke,Denis Kudla,Tobias Kamke,6-4; 6-2,R64,70,4,0,29,47,25,29,10,18,2,3,9,35,47,2,4,33,65,20,33,14,32,3,7,9,34,65
2011-07-31 00:00:00.000,Washington DC; USA ATP World Tour 500,HARD,2,James Blake,Tatsuma Ito,James Blake,6-3; 6-3,R64,57,3,1,34,55,25,34,14,21,5,6,9,39,55,1,3,29,56,15,29,13,27,1,5,9,28,56
2011-07-31 00:00:00.000,Washington DC; USA ATP World Tour 500,HARD,2,David Nalbandian,N/A Bye,David Nalbandian,,R64,0,0,0,0,0,0,0,0,0,0,0,0,0,0,0,0,0,0,0,0,0,0,0,0,0,0,0
2011-07-31 00:00:00.000,Washington DC; USA ATP World Tour 500,HARD,2,Marcos Baghdatis,N/A Bye,Marcos Baghdatis,,R64,0,0,0,0,0,0,0,0,0,0,0,0,0,0,0,0,0,0,0,0,0,0,0,0,0,0,0
2011-07-31 00:00:00.000,Washington DC; USA ATP World Tour 500,HARD,2,Somdev Devvarman,Denis Gremelmayr,Somdev Devvarman,6-2; 6-3,R64,59,7,3,28,48,26,28,9,20,2,3,9,35,48,1,3,15,43,8,15,12,28,0,4,8,20,43
2011-07-31 00:00:00.000,Washington DC; USA ATP World Tour 500,HARD,2,Tommy Haas,Amer Delic,Tommy Haas,6-2; 6-3,R64,63,6,3,26,48,24,26,13,22,1,1,9,37,48,8,1,32,57,20,32,12,25,3,6,8,32,57
2011-07-31 00:00:00.000,Washington DC; USA ATP World Tour 500,HARD,2,Thomaz Bellucci,N/A Bye,Thomaz Bellucci,,R64,0,0,0,0,0,0,0,0,0,0,0,0,0,0,0,0,0,0,0,0,0,0,0,0,0,0,0
2011-07-31 00:00:00.000,Washington DC; USA ATP World Tour 500,HARD,2,Xavier Malisse,N/A Bye,Xavier Malisse,,R64,0,0,0,0,0,0,0,0,0,0,0,0,0,0,0,0,0,0,0,0,0,0,0,0,0,0,0
2011-07-31 00:00:00.000,Washington DC; USA ATP World Tour 500,HARD,2,Michael Russell,Ivo Karlovic,Michael Russell,6-4; 7-6(4),R64,94,3,5,39,76,32,39,23,37,1,1,11,55,76,10,3,42,61,36,42,11,19,2,3,11,47,61
2011-07-31 00:00:00.000,Washington DC; USA ATP World Tour 500,HARD,2,Donald Young,Artem Sitak,Donald Young,6-0; 6-3,R64,64,3,1,24,35,23,24,9,11,0,0,8,32,35,2,2,24,60,12,24,15,36,7,11,7,27,60
2011-07-31 00:00:00.000,Washington DC; USA ATP World Tour 500,HARD,2,Jurgen Melzer,N/A Bye,Jurgen Melzer,,R64,0,0,0,0,0,0,0,0,0,0,0,0,0,0,0,0,0,0,0,0,0,0,0,0,0,0,0
2011-07-31 00:00:00.000,Washington DC; USA ATP World Tour 500,HARD,2,Fernando Verdasco,N/A Bye,Fernando Verdasco,,R64,0,0,0,0,0,0,0,0,0,0,0,0,0,0,0,0,0,0,0,0,0,0,0,0,0,0,0
2011-07-31 00:00:00.000,Washington DC; USA ATP World Tour 500,HARD,2,Marinko Matosevic,Ricardas Berankis,Marinko Matosevic,7-6(3); 3-6; 6-1,R64,115,3,6,42,78,35,42,16,36,2,5,14,51,78,16,9,46,107,31,46,28,61,8,12,14,59,107
2011-07-31 00:00:00.000,Washington DC; USA ATP World Tour 500,HARD,2,Matthew Ebden,Rajeev Ram,Matthew Ebden,6-1; 3-2 RET,R64,48,2,2,19,31,17,19,6,12,0,1,6,23,31,0,1,30,50,16,30,7,20,2,6,6,23,50
2011-07-31 00:00:00.000,Washington DC; USA ATP World Tour 500,HARD,2,Nikolay Davydenko,N/A Bye,Nikolay Davydenko,,R64,0,0,0,0,0,0,0,0,0,0,0,0,0,0,0,0,0,0,0,0,0,0,0,0,0,0,0
2011-07-31 00:00:00.000,Washington DC; USA ATP World Tour 500,HARD,2,Jarkko Nieminen,N/A Bye,Jarkko Nieminen,,R64,0,0,0,0,0,0,0,0,0,0,0,0,0,0,0,0,0,0,0,0,0,0,0,0,0,0,0
2011-07-31 00:00:00.000,Washington DC; USA ATP World Tour 500,HARD,2,Igor Kunitsyn,Gilles Muller,Igor Kunitsyn,6-4; 3-6; 7-6(5),R64,114,10,2,49,84,42,49,21,35,1,2,15,63,84,18,2,54,91,42,54,24,37,0,1,16,66,91
2011-07-31 00:00:00.000,Washington DC; USA ATP World Tour 500,HARD,2,Radek Stepanek,Philipp Petzschner,Radek Stepanek,6-7(2); 6-4; 6-0,R64,132,5,5,48,78,41,48,19,30,1,1,14,60,78,10,7,42,108,34,42,30,66,7,11,14,64,108
2011-07-31 00:00:00.000,Washington DC; USA ATP World Tour 500,HARD,2,Wayne Odesnik,N/A Bye,Wayne Odesnik,,R64,0,0,0,0,0,0,0,0,0,0,0,0,0,0,0,0,0,0,0,0,0,0,0,0,0,0,0
2011-07-31 00:00:00.000,Washington DC; USA ATP World Tour 500,HARD,2,Gael Monfils,Ryan Sweeting,Gael Monfils,6-3; 7-6(3),R32,85,17,3,47,66,39,47,8,19,1,2,11,47,66,2,4,41,75,25,41,20,34,3,5,10,45,75
2011-07-31 00:00:00.000,Washington DC; USA ATP World Tour 500,HARD,2,Dmitry Tursunov,Flavio Cipolla,Dmitry Tursunov,6-1; 6-4,R32,77,3,5,26,49,22,26,13,23,1,2,9,35,49,0,2,21,53,12,21,15,32,6,10,8,27,53
2011-07-31 00:00:00.000,Washington DC; USA ATP World Tour 500,HARD,2,Grigor Dimitrov,Michael Llodra,Grigor Dimitrov,4-3 RET,R32,31,2,1,12,26,6,12,10,14,3,3,3,16,26,1,2,11,21,6,11,7,10,0,1,4,13,21
2011-07-31 00:00:00.000,Washington DC; USA ATP World Tour 500,HARD,2,Janko Tipsarevic,Michael Berrer,Janko Tipsarevic,6-3; 6-4,R32,83,6,3,32,53,25,32,15,21,0,0,10,40,53,7,1,45,73,30,45,12,28,8,10,9,42,73
2011-07-31 00:00:00.000,Washington DC; USA ATP World Tour 500,HARD,2,Viktor Troicki,Ryan Harrison,Viktor Troicki,7-5; 6-2,R32,77,13,3,34,66,26,34,19,32,3,4,10,45,66,0,3,29,51,17,29,11,22,2,6,10,28,51
2011-07-31 00:00:00.000,Washington DC; USA ATP World Tour 500,HARD,2,Kevin Anderson,Chris Guccione,Kevin Anderson,3-6; 6-2; 7-6(0),R32,124,13,1,61,93,47,61,18,32,0,2,15,65,93,9,4,51,95,37,51,22,44,6,8,14,59,95
2011-07-31 00:00:00.000,Washington DC; USA ATP World Tour 500,HARD,2,John Isner,Tobias Kamke,John Isner,6-1; 6-3,R32,66,6,1,29,45,26,29,8,16,3,3,8,34,45,0,3,32,56,18,32,10,24,10,14,8,28,56
2011-07-31 00:00:00.000,Washington DC; USA ATP World Tour 500,HARD,2,James Blake,David Nalbandian,James Blake,6-2; 6-4,R32,73,7,3,39,62,31,39,12,23,3,3,9,43,62,1,3,31,63,23,31,12,32,4,7,9,35,63
2011-07-31 00:00:00.000,Washington DC; USA ATP World Tour 500,HARD,2,Marcos Baghdatis,Somdev Devvarman,Marcos Baghdatis,6-2; 0-6; 7-5,R32,123,6,6,41,87,29,41,23,46,7,11,13,52,87,1,1,49,93,32,49,21,44,9,13,13,53,93
2011-07-31 00:00:00.000,Washington DC; USA ATP World Tour 500,HARD,2,Thomaz Bellucci,Tommy Haas,Thomaz Bellucci,7-6(3); 3-6; 6-3,R32,147,9,8,73,116,52,73,12,43,10,16,15,64,116,4,7,58,99,36,58,20,41,5,11,15,56,99
2011-07-31 00:00:00.000,Washington DC; USA ATP World Tour 500,HARD,2,Michael Russell,Xavier Malisse,Michael Russell,7-6(4); 2-3 RET,R32,73,5,3,31,49,24,31,8,18,0,2,8,32,49,4,2,28,63,20,28,20,35,4,6,9,40,63
2011-07-31 00:00:00.000,Washington DC; USA ATP World Tour 500,HARD,2,Donald Young,Jurgen Melzer,Donald Young,6-7(6); 6-4; 3-1 RET,R32,117,8,6,57,85,39,57,16,28,4,6,13,55,85,1,5,50,91,31,50,21,41,6,10,13,52,91
2011-07-31 00:00:00.000,Washington DC; USA ATP World Tour 500,HARD,2,Fernando Verdasco,Marinko Matosevic,Fernando Verdasco,6-4; 6-4,R32,88,3,6,36,54,28,36,11,18,3,4,10,39,54,2,1,47,79,28,47,16,32,3,6,10,44,79
2011-07-31 00:00:00.000,Washington DC; USA ATP World Tour 500,HARD,2,Nikolay Davydenko,Matthew Ebden,Nikolay Davydenko,6-3; 7-5,R32,90,3,6,46,65,36,46,11,19,3,4,11,47,65,4,4,38,66,24,38,15,28,2,5,10,39,66
2011-07-31 00:00:00.000,Washington DC; USA ATP World Tour 500,HARD,2,Jarkko Nieminen,Igor Kunitsyn,Jarkko Nieminen,7-5; 6-4,R32,91,4,3,40,64,27,40,14,24,2,4,11,41,64,4,4,35,70,18,35,18,35,2,6,11,36,70
2011-07-31 00:00:00.000,Washington DC; USA ATP World Tour 500,HARD,2,Radek Stepanek,Wayne Odesnik,Radek Stepanek,6-1; 6-1,R32,57,1,1,24,35,22,24,6,11,0,0,7,28,35,2,2,28,40,14,28,2,12,2,7,7,16,40
2011-07-31 00:00:00.000,Washington DC; USA ATP World Tour 500,HARD,2,Gael Monfils,Dmitry Tursunov,Gael Monfils,6-2; 7-6(9),R16,100,8,1,40,66,32,40,17,26,3,4,10,49,66,3,4,45,74,32,45,12,29,4,7,10,44,74
2011-07-31 00:00:00.000,Washington DC; USA ATP World Tour 500,HARD,2,Janko Tipsarevic,Grigor Dimitrov,Janko Tipsarevic,6-4; 6-2,R16,75,2,0,23,46,20,23,15,23,1,2,9,35,46,1,4,31,60,18,31,14,29,3,7,9,32,60
2011-07-31 00:00:00.000,Washington DC; USA ATP World Tour 500,HARD,2,Viktor Troicki,Kevin Anderson,Viktor Troicki,6-3; 6-3,R16,68,5,3,29,51,25,29,11,22,3,4,9,36,51,4,0,35,53,21,35,8,18,2,6,9,29,53
2011-07-31 00:00:00.000,Washington DC; USA ATP World Tour 500,HARD,2,John Isner,James Blake,John Isner,7-6(0); 1-6; 7-6(4),R16,133,13,7,71,110,47,71,23,39,5,8,15,70,110,11,7,57,105,46,57,26,48,4,5,16,72,105
2011-07-31 00:00:00.000,Washington DC; USA ATP World Tour 500,HARD,2,Marcos Baghdatis,Thomaz Bellucci,Marcos Baghdatis,3-6; 6-3; 6-2,R16,99,15,2,40,70,33,40,18,30,2,4,13,51,70,4,6,50,81,34,50,11,31,4,8,13,45,81
2011-07-31 00:00:00.000,Washington DC; USA ATP World Tour 500,HARD,2,Donald Young,Michael Russell,Donald Young,6-3; 6-3,R16,81,2,2,30,50,21,30,13,20,3,4,9,34,50,1,3,32,57,20,32,9,25,1,5,9,29,57
2011-07-31 00:00:00.000,Washington DC; USA ATP World Tour 500,HARD,2,Fernando Verdasco,Nikolay Davydenko,Fernando Verdasco,6-4; 7-5,R16,93,4,3,44,73,32,44,15,29,7,8,11,47,73,0,5,39,63,28,39,10,24,1,4,11,38,63
2011-07-31 00:00:00.000,Washington DC; USA ATP World Tour 500,HARD,2,Radek Stepanek,Jarkko Nieminen,Radek Stepanek,6-4; 3-6; 6-2,R16,127,9,2,59,85,40,59,13,26,9,12,13,53,85,3,6,55,97,35,55,20,42,9,14,14,55,97
2011-07-31 00:00:00.000,Washington DC; USA ATP World Tour 500,HARD,2,Gael Monfils,Janko Tipsarevic,Gael Monfils,6-4; 6-4,Q,94,4,6,35,62,31,35,12,27,1,2,10,43,62,0,3,39,77,23,39,18,38,3,6,10,41,77
2011-07-31 00:00:00.000,Washington DC; USA ATP World Tour 500,HARD,2,John Isner,Viktor Troicki,John Isner,7-6(5); 3-6; 6-1,Q,106,10,2,63,80,51,63,8,17,1,3,14,59,80,10,4,42,82,33,42,24,40,2,5,14,57,82
2011-07-31 00:00:00.000,Washington DC; USA ATP World Tour 500,HARD,2,Donald Young,Marcos Baghdatis,Donald Young,6-3; 7-6(4),Q,87,2,3,45,69,34,45,9,24,3,5,11,43,69,4,1,21,56,17,21,17,35,0,3,10,34,56
2011-07-31 00:00:00.000,Washington DC; USA ATP World Tour 500,HARD,2,Radek Stepanek,Fernando Verdasco,Radek Stepanek,6-4; 6-4,Q,111,1,4,35,72,24,35,21,37,7,8,10,45,72,8,5,52,75,33,52,8,23,7,10,10,41,75
2011-07-31 00:00:00.000,Washington DC; USA ATP World Tour 500,HARD,2,Gael Monfils,John Isner,Gael Monfils,6-4; 3-6; 7-6(6),S,147,12,3,61,96,46,61,23,35,1,2,15,69,96,19,0,74,111,55,74,22,37,5,6,16,77,111
2011-07-31 00:00:00.000,Washington DC; USA ATP World Tour 500,HARD,2,Radek Stepanek,Donald Young,Radek Stepanek,6-3; 6-3,S,79,3,0,29,55,23,29,18,26,2,2,9,41,55,1,0,31,48,20,31,8,17,1,4,9,28,48
2011-07-31 00:00:00.000,Washington DC; USA ATP World Tour 500,HARD,2,Radek Stepanek,Gael Monfils,Radek Stepanek,6-4; 6-4,F,93,2,2,21,56,19,21,22,35,0,0,10,41,56,8,4,34,52,26,34,10,18,0,2,10,36,52
2011-08-08 00:00:00.000,ATP World Tour Masters 1000 Canada Montreal; Canada ATP World Tour Masters 1000,HARD,2,Novak Djokovic,N/A Bye,Novak Djokovic,,R64,0,0,0,0,0,0,0,0,0,0,0,0,0,0,0,0,0,0,0,0,0,0,0,0,0,0,0
2011-08-08 00:00:00.000,ATP World Tour Masters 1000 Canada Montreal; Canada ATP World Tour Masters 1000,HARD,2,Nikolay Davydenko,Flavio Cipolla,Nikolay Davydenko,6-3; 6-3,R64,94,2,5,47,66,30,47,9,19,3,5,9,39,66,0,3,38,60,19,38,9,22,2,7,9,28,60
2011-08-08 00:00:00.000,ATP World Tour Masters 1000 Canada Montreal; Canada ATP World Tour Masters 1000,HARD,2,Marin Cilic,Andreas Seppi,Marin Cilic,7-5; 6-4,R64,92,8,4,32,60,27,32,15,28,0,2,11,42,60,3,7,40,81,25,40,19,41,6,10,11,44,81
2011-08-08 00:00:00.000,ATP World Tour Masters 1000 Canada Montreal; Canada ATP World Tour Masters 1000,HARD,2,Juan Martin Del Potro,Jarkko Nieminen,Juan Martin Del Potro,6-4; 6-0,R64,69,13,3,33,49,26,33,10,16,3,3,8,36,49,3,2,22,49,12,22,11,27,3,7,8,23,49
2011-08-08 00:00:00.000,ATP World Tour Masters 1000 Canada Montreal; Canada ATP World Tour Masters 1000,HARD,2,Viktor Troicki,Michael Yani,Viktor Troicki,2-6; 6-3; 6-1,R64,84,11,2,40,72,34,40,15,32,2,4,12,49,72,4,4,45,71,27,45,13,26,4,8,12,40,71
2011-08-08 00:00:00.000,ATP World Tour Masters 1000 Canada Montreal; Canada ATP World Tour Masters 1000,HARD,2,John Isner,Marcos Baghdatis,John Isner,6-3; 6-4,R64,73,8,0,38,53,32,38,9,15,0,0,10,41,53,4,1,24,49,18,24,14,25,1,3,9,32,49
2011-08-08 00:00:00.000,ATP World Tour Masters 1000 Canada Montreal; Canada ATP World Tour Masters 1000,HARD,2,Alex Bogomolov Jr.,Adrian Mannarino,Alex Bogomolov Jr.,6-2; 7-6(4),R64,81,8,1,40,54,36,40,9,14,1,1,10,45,54,3,3,44,72,32,44,12,28,2,4,10,44,72
2011-08-08 00:00:00.000,ATP World Tour Masters 1000 Canada Montreal; Canada ATP World Tour Masters 1000,HARD,2,Gael Monfils,N/A Bye,Gael Monfils,,R64,0,0,0,0,0,0,0,0,0,0,0,0,0,0,0,0,0,0,0,0,0,0,0,0,0,0,0
2011-08-08 00:00:00.000,ATP World Tour Masters 1000 Canada Montreal; Canada ATP World Tour Masters 1000,HARD,2,Roger Federer,N/A Bye,Roger Federer,,R64,0,0,0,0,0,0,0,0,0,0,0,0,0,0,0,0,0,0,0,0,0,0,0,0,0,0,0
2011-08-08 00:00:00.000,ATP World Tour Masters 1000 Canada Montreal; Canada ATP World Tour Masters 1000,HARD,2,Vasek Pospisil,Juan Ignacio Chela,Vasek Pospisil,4-6; 6-3; 6-4,R64,143,7,5,49,99,38,49,24,50,5,7,15,62,99,0,5,42,82,32,42,21,40,2,5,14,53,82
2011-08-08 00:00:00.000,ATP World Tour Masters 1000 Canada Montreal; Canada ATP World Tour Masters 1000,HARD,2,Bernard Tomic,Yen-Hsun Lu,Bernard Tomic,7-6(5); 6-3,R64,103,7,2,55,92,42,55,14,37,8,10,11,56,92,5,4,39,72,25,39,16,33,1,4,10,41,72
2011-08-08 00:00:00.000,ATP World Tour Masters 1000 Canada Montreal; Canada ATP World Tour Masters 1000,HARD,2,Jo-Wilfried Tsonga,Fabio Fognini,Jo-Wilfried Tsonga,6-4; 7-6(0),R64,95,5,3,29,57,21,29,19,28,1,3,11,40,57,3,5,40,75,26,40,16,35,6,9,11,42,75
2011-08-08 00:00:00.000,ATP World Tour Masters 1000 Canada Montreal; Canada ATP World Tour Masters 1000,HARD,2,Richard Gasquet,Florian Mayer,Richard Gasquet,6-3; 6-2,R64,70,6,2,33,62,27,33,15,29,5,5,9,42,62,2,2,19,43,12,19,11,24,3,6,8,23,43
2011-08-08 00:00:00.000,ATP World Tour Masters 1000 Canada Montreal; Canada ATP World Tour Masters 1000,HARD,2,Thomaz Bellucci,Andrey Golubev,Thomaz Bellucci,7-5; 7-6(6),R64,107,11,2,47,75,38,47,14,28,5,7,12,52,75,3,7,52,89,34,52,18,37,5,8,12,52,89
2011-08-08 00:00:00.000,ATP World Tour Masters 1000 Canada Montreal; Canada ATP World Tour Masters 1000,HARD,2,Sergiy Stakhovsky,Philipp Kohlschreiber,Sergiy Stakhovsky,6-2; 7-5,R64,99,15,5,43,74,37,43,12,31,6,6,10,49,74,6,4,39,82,25,39,21,43,7,10,10,46,82
2011-08-08 00:00:00.000,ATP World Tour Masters 1000 Canada Montreal; Canada ATP World Tour Masters 1000,HARD,2,Nicolas Almagro,N/A Bye,Nicolas Almagro,,R64,0,0,0,0,0,0,0,0,0,0,0,0,0,0,0,0,0,0,0,0,0,0,0,0,0,0,0
2011-08-08 00:00:00.000,ATP World Tour Masters 1000 Canada Montreal; Canada ATP World Tour Masters 1000,HARD,2,Mardy Fish,N/A Bye,Mardy Fish,,R64,0,0,0,0,0,0,0,0,0,0,0,0,0,0,0,0,0,0,0,0,0,0,0,0,0,0,0
2011-08-08 00:00:00.000,ATP World Tour Masters 1000 Canada Montreal; Canada ATP World Tour Masters 1000,HARD,2,Feliciano Lopez,Radek Stepanek,Feliciano Lopez,6-4; 4-6; 6-4,R64,131,7,4,52,94,42,52,19,42,9,11,15,61,94,2,3,43,80,31,43,23,37,1,4,15,54,80
2011-08-08 00:00:00.000,ATP World Tour Masters 1000 Canada Montreal; Canada ATP World Tour Masters 1000,HARD,2,Ernests Gulbis,Juan Carlos Ferrero,Ernests Gulbis,3-6; 6-1; 7-5,R64,134,13,5,56,89,44,56,18,33,4,5,14,62,89,2,3,57,94,37,57,21,37,2,5,14,58,94
2011-08-08 00:00:00.000,ATP World Tour Masters 1000 Canada Montreal; Canada ATP World Tour Masters 1000,HARD,2,Michael Llodra,Mikhail Youzhny,Michael Llodra,3-6; 6-3; 7-6(4),R64,128,10,2,60,94,45,60,22,34,3,5,15,67,94,8,5,61,101,45,61,23,40,5,7,15,68,101
2011-08-08 00:00:00.000,ATP World Tour Masters 1000 Canada Montreal; Canada ATP World Tour Masters 1000,HARD,2,Stanislas Wawrinka,David Nalbandian,Stanislas Wawrinka,6-1; 6-4,R64,69,8,3,21,45,17,21,16,24,1,2,9,33,45,1,5,23,53,16,23,11,30,4,8,8,27,53
2011-08-08 00:00:00.000,ATP World Tour Masters 1000 Canada Montreal; Canada ATP World Tour Masters 1000,HARD,2,Michael Russell,Albert Montanes,Michael Russell,7-5; 6-2,R64,79,3,4,36,57,27,36,10,21,0,2,10,37,57,1,4,32,64,19,32,12,32,7,12,10,31,64
2011-08-08 00:00:00.000,ATP World Tour Masters 1000 Canada Montreal; Canada ATP World Tour Masters 1000,HARD,2,Kevin Anderson,Pablo Andujar,Kevin Anderson,6-4; 6-4,R64,92,11,3,36,58,24,36,15,22,4,5,10,39,58,0,4,35,62,26,35,10,27,2,5,10,36,62
2011-08-08 00:00:00.000,ATP World Tour Masters 1000 Canada Montreal; Canada ATP World Tour Masters 1000,HARD,2,Andy Murray,N/A Bye,Andy Murray,,R64,0,0,0,0,0,0,0,0,0,0,0,0,0,0,0,0,0,0,0,0,0,0,0,0,0,0,0
2011-08-08 00:00:00.000,ATP World Tour Masters 1000 Canada Montreal; Canada ATP World Tour Masters 1000,HARD,2,Tomas Berdych,N/A Bye,Tomas Berdych,,R64,0,0,0,0,0,0,0,0,0,0,0,0,0,0,0,0,0,0,0,0,0,0,0,0,0,0,0
2011-08-08 00:00:00.000,ATP World Tour Masters 1000 Canada Montreal; Canada ATP World Tour Masters 1000,HARD,2,Alexandr Dolgopolov,Erik Chvojka,Alexandr Dolgopolov,6-3; 5-7; 6-4,R64,133,12,4,43,86,36,43,25,43,1,3,16,61,86,7,7,75,116,57,75,12,41,14,17,15,69,116
2011-08-08 00:00:00.000,ATP World Tour Masters 1000 Canada Montreal; Canada ATP World Tour Masters 1000,HARD,2,Ivo Karlovic,Juan Monaco,Ivo Karlovic,6-7(2); 6-3; 7-6(5),R64,154,15,2,68,101,55,68,20,33,0,1,17,75,101,2,2,80,112,60,80,18,32,7,9,16,78,112
2011-08-08 00:00:00.000,ATP World Tour Masters 1000 Canada Montreal; Canada ATP World Tour Masters 1000,HARD,2,Philipp Petzschner,Gilles Simon,Philipp Petzschner,7-5; 6-2,R64,90,5,2,33,58,27,33,13,25,7,8,10,40,58,2,5,32,70,21,32,17,38,5,9,10,38,70
2011-08-08 00:00:00.000,ATP World Tour Masters 1000 Canada Montreal; Canada ATP World Tour Masters 1000,HARD,2,Fernando Verdasco,Tobias Kamke,Fernando Verdasco,5-7; 6-3; 6-3,R64,126,3,5,64,92,47,64,16,28,5,6,15,63,92,2,5,59,98,43,59,18,39,6,9,15,61,98
2011-08-08 00:00:00.000,ATP World Tour Masters 1000 Canada Montreal; Canada ATP World Tour Masters 1000,HARD,2,Janko Tipsarevic,Alejandro Falla,Janko Tipsarevic,7-5; 6-1,R64,78,5,3,29,58,24,29,18,29,0,0,10,42,58,1,5,28,65,20,28,17,37,7,10,9,37,65
2011-08-08 00:00:00.000,ATP World Tour Masters 1000 Canada Montreal; Canada ATP World Tour Masters 1000,HARD,2,Ivan Dodig,Jeremy Chardy,Ivan Dodig,6-3; 6-4,R64,82,11,4,32,56,27,32,15,24,0,0,10,42,56,9,4,29,56,23,29,11,27,1,3,9,34,56
2011-08-08 00:00:00.000,ATP World Tour Masters 1000 Canada Montreal; Canada ATP World Tour Masters 1000,HARD,2,Rafael Nadal,N/A Bye,Rafael Nadal,,R64,0,0,0,0,0,0,0,0,0,0,0,0,0,0,0,0,0,0,0,0,0,0,0,0,0,0,0
2011-08-08 00:00:00.000,ATP World Tour Masters 1000 Canada Montreal; Canada ATP World Tour Masters 1000,HARD,2,Novak Djokovic,Nikolay Davydenko,Novak Djokovic,7-5; 6-1,R32,96,2,3,38,60,20,38,12,22,4,8,10,32,60,1,4,51,67,24,51,4,16,7,14,9,28,67
2011-08-08 00:00:00.000,ATP World Tour Masters 1000 Canada Montreal; Canada ATP World Tour Masters 1000,HARD,2,Marin Cilic,Juan Martin Del Potro,Marin Cilic,6-3; 6-4,R32,84,4,4,28,51,26,28,15,23,0,0,10,41,51,5,0,28,48,21,28,11,20,0,2,9,32,48
2011-08-08 00:00:00.000,ATP World Tour Masters 1000 Canada Montreal; Canada ATP World Tour Masters 1000,HARD,2,Viktor Troicki,John Isner,Viktor Troicki,6-4; 3-6; 6-2,R32,107,9,3,46,79,36,46,18,33,8,10,13,54,79,4,4,57,83,36,57,12,26,1,5,14,48,83
2011-08-08 00:00:00.000,ATP World Tour Masters 1000 Canada Montreal; Canada ATP World Tour Masters 1000,HARD,2,Gael Monfils,Alex Bogomolov Jr.,Gael Monfils,6-2; 7-6(5),R32,96,6,2,30,65,28,30,19,35,0,0,10,47,65,5,3,35,65,26,35,17,30,3,5,10,43,65
2011-08-08 00:00:00.000,ATP World Tour Masters 1000 Canada Montreal; Canada ATP World Tour Masters 1000,HARD,2,Roger Federer,Vasek Pospisil,Roger Federer,7-5; 6-3,R32,78,4,0,30,52,25,30,19,22,0,0,11,44,52,8,4,35,64,24,35,15,29,0,2,10,39,64
2011-08-08 00:00:00.000,ATP World Tour Masters 1000 Canada Montreal; Canada ATP World Tour Masters 1000,HARD,2,Jo-Wilfried Tsonga,Bernard Tomic,Jo-Wilfried Tsonga,6-3; 7-6(1),R32,78,15,4,33,60,30,33,17,27,1,2,11,47,60,0,1,48,71,33,48,10,23,5,7,10,43,71
2011-08-08 00:00:00.000,ATP World Tour Masters 1000 Canada Montreal; Canada ATP World Tour Masters 1000,HARD,2,Richard Gasquet,Thomaz Bellucci,Richard Gasquet,6-1; 6-4,R32,79,4,2,27,52,22,27,16,25,3,3,9,38,52,1,1,36,61,23,36,10,25,4,7,8,33,61
2011-08-08 00:00:00.000,ATP World Tour Masters 1000 Canada Montreal; Canada ATP World Tour Masters 1000,HARD,2,Nicolas Almagro,Sergiy Stakhovsky,Nicolas Almagro,6-2; 7-6(5),R32,86,7,0,36,57,30,36,15,21,2,3,10,45,57,5,5,39,78,26,39,18,39,7,10,10,44,78
2011-08-08 00:00:00.000,ATP World Tour Masters 1000 Canada Montreal; Canada ATP World Tour Masters 1000,HARD,2,Mardy Fish,Feliciano Lopez,Mardy Fish,6-2; 6-3,R32,67,9,1,32,54,27,32,13,22,2,2,9,40,54,4,2,28,51,17,28,12,23,7,10,8,29,51
2011-08-08 00:00:00.000,ATP World Tour Masters 1000 Canada Montreal; Canada ATP World Tour Masters 1000,HARD,2,Ernests Gulbis,Michael Llodra,Ernests Gulbis,6-4; 1-0 RET,R32,51,2,1,14,24,13,14,7,10,0,0,5,20,24,3,5,36,57,24,36,7,21,9,11,6,31,57
2011-08-08 00:00:00.000,ATP World Tour Masters 1000 Canada Montreal; Canada ATP World Tour Masters 1000,HARD,2,Stanislas Wawrinka,Michael Russell,Stanislas Wawrinka,6-3; 6-2,R32,72,4,3,32,61,26,32,17,29,2,2,9,43,61,1,9,20,48,15,20,10,28,3,6,8,25,48
2011-08-08 00:00:00.000,ATP World Tour Masters 1000 Canada Montreal; Canada ATP World Tour Masters 1000,HARD,2,Kevin Anderson,Andy Murray,Kevin Anderson,6-3; 6-1,R32,70,5,2,30,46,26,30,9,16,2,2,8,35,46,3,5,22,46,15,22,8,24,1,5,8,23,46
2011-08-08 00:00:00.000,ATP World Tour Masters 1000 Canada Montreal; Canada ATP World Tour Masters 1000,HARD,2,Tomas Berdych,Alexandr Dolgopolov,Tomas Berdych,4-6; 6-2; 6-3,R32,103,9,6,51,84,39,51,15,33,4,6,14,54,84,11,4,34,75,25,34,22,41,2,6,13,47,75
2011-08-08 00:00:00.000,ATP World Tour Masters 1000 Canada Montreal; Canada ATP World Tour Masters 1000,HARD,2,Ivo Karlovic,Philipp Petzschner,Ivo Karlovic,6-7(0); 7-6(2); 7-6(6),R32,175,17,2,71,114,60,71,24,43,4,5,18,84,114,9,7,62,131,47,62,42,69,1,2,18,89,131
2011-08-08 00:00:00.000,ATP World Tour Masters 1000 Canada Montreal; Canada ATP World Tour Masters 1000,HARD,2,Janko Tipsarevic,Fernando Verdasco,Janko Tipsarevic,6-4; 6-7(5); 6-3,R32,178,4,12,67,120,48,67,20,53,1,5,16,68,120,4,15,82,124,53,82,13,42,16,22,15,66,124
2011-08-08 00:00:00.000,ATP World Tour Masters 1000 Canada Montreal; Canada ATP World Tour Masters 1000,HARD,2,Ivan Dodig,Rafael Nadal,Ivan Dodig,1-6; 7-6(5); 7-6(5),R32,189,19,3,67,116,46,67,23,49,6,11,15,69,116,7,2,56,107,42,56,28,51,1,4,16,70,107
2011-08-08 00:00:00.000,ATP World Tour Masters 1000 Canada Montreal; Canada ATP World Tour Masters 1000,HARD,2,Novak Djokovic,Marin Cilic,Novak Djokovic,7-5; 6-2,R16,95,1,1,48,66,37,48,9,18,3,3,10,46,66,6,4,34,57,21,34,14,23,4,7,10,35,57
2011-08-08 00:00:00.000,ATP World Tour Masters 1000 Canada Montreal; Canada ATP World Tour Masters 1000,HARD,2,Gael Monfils,Viktor Troicki,Gael Monfils,3-6; 7-6(0); 7-6(5),R16,156,3,2,73,122,49,73,31,49,8,12,17,80,122,3,4,58,95,49,58,17,37,2,4,16,66,95
2011-08-08 00:00:00.000,ATP World Tour Masters 1000 Canada Montreal; Canada ATP World Tour Masters 1000,HARD,2,Jo-Wilfried Tsonga,Roger Federer,Jo-Wilfried Tsonga,7-6(3); 4-6; 6-1,R16,134,7,2,52,91,40,52,25,39,3,4,15,65,91,10,2,58,93,43,58,16,35,7,9,14,59,93
2011-08-08 00:00:00.000,ATP World Tour Masters 1000 Canada Montreal; Canada ATP World Tour Masters 1000,HARD,2,Nicolas Almagro,Richard Gasquet,Nicolas Almagro,7-6(5); 6-3,R16,106,6,2,42,83,27,42,23,41,11,13,11,50,83,5,6,40,70,27,40,12,30,3,6,10,39,70
2011-08-08 00:00:00.000,ATP World Tour Masters 1000 Canada Montreal; Canada ATP World Tour Masters 1000,HARD,2,Mardy Fish,Ernests Gulbis,Mardy Fish,4-6; 6-3; 6-4,R16,142,5,3,53,96,41,53,22,43,3,5,15,63,96,12,4,56,91,40,56,17,35,9,12,14,57,91
2011-08-08 00:00:00.000,ATP World Tour Masters 1000 Canada Montreal; Canada ATP World Tour Masters 1000,HARD,2,Stanislas Wawrinka,Kevin Anderson,Stanislas Wawrinka,6-4; 4-6; 6-4,R16,144,3,4,50,82,42,50,17,32,1,2,15,59,82,6,4,54,96,42,54,21,42,6,8,15,63,96
2011-08-08 00:00:00.000,ATP World Tour Masters 1000 Canada Montreal; Canada ATP World Tour Masters 1000,HARD,2,Tomas Berdych,Ivo Karlovic,Tomas Berdych,6-3; 7-6(2),R16,103,10,1,46,79,38,46,16,33,4,4,11,54,79,12,4,49,67,38,49,4,18,4,5,10,42,67
2011-08-08 00:00:00.000,ATP World Tour Masters 1000 Canada Montreal; Canada ATP World Tour Masters 1000,HARD,2,Janko Tipsarevic,Ivan Dodig,Janko Tipsarevic,6-1; 6-4,R16,70,4,2,26,47,25,26,11,21,0,0,9,36,47,7,2,29,50,20,29,8,21,5,8,8,28,50
2011-08-08 00:00:00.000,ATP World Tour Masters 1000 Canada Montreal; Canada ATP World Tour Masters 1000,HARD,2,Novak Djokovic,Gael Monfils,Novak Djokovic,6-2; 6-1,Q,74,1,0,41,56,28,41,10,15,3,3,8,38,56,3,3,19,39,13,19,5,20,5,9,7,18,39
2011-08-08 00:00:00.000,ATP World Tour Masters 1000 Canada Montreal; Canada ATP World Tour Masters 1000,HARD,2,Jo-Wilfried Tsonga,Nicolas Almagro,Jo-Wilfried Tsonga,6-4; 6-4,Q,88,10,1,33,60,25,33,17,27,3,3,10,42,60,6,2,35,53,25,35,9,18,1,3,10,34,53
2011-08-08 00:00:00.000,ATP World Tour Masters 1000 Canada Montreal; Canada ATP World Tour Masters 1000,HARD,2,Mardy Fish,Stanislas Wawrinka,Mardy Fish,6-3; 6-7(8); 6-0,Q,141,6,2,51,93,36,51,18,42,10,15,13,54,93,1,1,44,86,22,44,14,42,3,13,14,36,86
2011-08-08 00:00:00.000,ATP World Tour Masters 1000 Canada Montreal; Canada ATP World Tour Masters 1000,HARD,2,Janko Tipsarevic,Tomas Berdych,Janko Tipsarevic,6-4; 6-4,Q,88,10,3,38,66,31,38,16,28,4,4,10,47,66,5,2,30,54,23,30,14,24,1,3,10,37,54
2011-08-08 00:00:00.000,ATP World Tour Masters 1000 Canada Montreal; Canada ATP World Tour Masters 1000,HARD,2,Novak Djokovic,Jo-Wilfried Tsonga,Novak Djokovic,6-4; 3-0 RET,S,59,1,0,28,39,22,28,8,11,0,0,7,30,39,4,2,26,39,17,26,5,13,3,5,6,22,39
2011-08-08 00:00:00.000,ATP World Tour Masters 1000 Canada Montreal; Canada ATP World Tour Masters 1000,HARD,2,Mardy Fish,Janko Tipsarevic,Mardy Fish,6-3; 6-4,S,76,6,1,34,55,29,34,9,21,0,1,10,38,55,2,3,29,48,18,29,11,19,1,4,9,29,48
2011-08-08 00:00:00.000,ATP World Tour Masters 1000 Canada Montreal; Canada ATP World Tour Masters 1000,HARD,2,Novak Djokovic,Mardy Fish,Novak Djokovic,6-2; 3-6; 6-4,F,144,4,2,61,96,43,61,18,35,8,10,14,61,96,8,3,43,83,31,43,19,40,5,8,13,50,83
2011-08-14 00:00:00.000,ATP World Tour Masters 1000 Cincinnati OH; U.S.A. ATP World Tour Masters 1000,HARD,2,Novak Djokovic,N/A Bye,Novak Djokovic,,R64,0,0,0,0,0,0,0,0,0,0,0,0,0,0,0,0,0,0,0,0,0,0,0,0,0,0,0
2011-08-14 00:00:00.000,ATP World Tour Masters 1000 Cincinnati OH; U.S.A. ATP World Tour Masters 1000,HARD,2,Ryan Harrison,Juan Ignacio Chela,Ryan Harrison,6-3; 6-3,R64,72,2,1,23,47,18,23,11,24,1,4,9,29,47,0,3,27,52,15,27,7,25,3,9,9,22,52
2011-08-14 00:00:00.000,ATP World Tour Masters 1000 Cincinnati OH; U.S.A. ATP World Tour Masters 1000,HARD,2,Radek Stepanek,John Isner,Radek Stepanek,7-5; 5-7; 7-6(4),R64,166,7,10,73,119,56,73,27,46,3,4,18,83,119,21,3,82,107,66,82,11,25,3,4,18,77,107
2011-08-14 00:00:00.000,ATP World Tour Masters 1000 Cincinnati OH; U.S.A. ATP World Tour Masters 1000,HARD,2,Andrey Golubev,Stanislas Wawrinka,Andrey Golubev,3-6; 6-4; 6-1,R64,105,8,6,47,83,35,47,18,36,6,8,13,53,83,2,3,50,72,34,50,11,22,1,5,13,45,72
2011-08-14 00:00:00.000,ATP World Tour Masters 1000 Cincinnati OH; U.S.A. ATP World Tour Masters 1000,HARD,2,Philipp Kohlschreiber,Andy Roddick,Philipp Kohlschreiber,6-7(5); 7-5; 6-1,R64,135,12,1,62,103,48,62,25,41,10,11,16,73,103,17,6,54,83,41,54,16,29,4,8,15,57,83
2011-08-14 00:00:00.000,ATP World Tour Masters 1000 Cincinnati OH; U.S.A. ATP World Tour Masters 1000,HARD,2,Feliciano Lopez,Juan Carlos Ferrero,Feliciano Lopez,4-6; 6-3; 6-4,R64,115,19,3,52,82,43,52,16,30,2,3,15,59,82,1,3,52,85,33,52,24,33,6,8,14,57,85
2011-08-14 00:00:00.000,ATP World Tour Masters 1000 Cincinnati OH; U.S.A. ATP World Tour Masters 1000,HARD,2,Ivan Dodig,Ernests Gulbis,Ivan Dodig,6-3; 7-6(3),R64,100,3,1,32,65,22,32,26,33,3,4,11,48,65,3,2,30,60,23,30,15,30,2,4,10,38,60
2011-08-14 00:00:00.000,ATP World Tour Masters 1000 Cincinnati OH; U.S.A. ATP World Tour Masters 1000,HARD,2,Gael Monfils,N/A Bye,Gael Monfils,,R64,0,0,0,0,0,0,0,0,0,0,0,0,0,0,0,0,0,0,0,0,0,0,0,0,0,0,0
2011-08-14 00:00:00.000,ATP World Tour Masters 1000 Cincinnati OH; U.S.A. ATP World Tour Masters 1000,HARD,2,Roger Federer,N/A Bye,Roger Federer,,R64,0,0,0,0,0,0,0,0,0,0,0,0,0,0,0,0,0,0,0,0,0,0,0,0,0,0,0
2011-08-14 00:00:00.000,ATP World Tour Masters 1000 Cincinnati OH; U.S.A. ATP World Tour Masters 1000,HARD,2,Juan Martin Del Potro,Andreas Seppi,Juan Martin Del Potro,4-1 RET,R64,27,2,0,7,9,6,7,2,2,0,0,2,8,9,0,2,13,21,8,13,1,8,3,5,3,9,21
2011-08-14 00:00:00.000,ATP World Tour Masters 1000 Cincinnati OH; U.S.A. ATP World Tour Masters 1000,HARD,2,James Blake,Marcos Baghdatis,James Blake,3-6; 6-3; 6-2,R64,108,3,1,50,92,33,50,23,42,7,9,13,56,92,6,5,45,85,33,45,17,40,7,11,13,50,85
2011-08-14 00:00:00.000,ATP World Tour Masters 1000 Cincinnati OH; U.S.A. ATP World Tour Masters 1000,HARD,2,Fabio Fognini,Viktor Troicki,Fabio Fognini,6-4; 6-1,R64,80,1,1,34,58,25,34,12,24,3,4,9,37,58,3,3,33,64,19,33,13,31,5,9,8,32,64
2011-08-14 00:00:00.000,ATP World Tour Masters 1000 Cincinnati OH; U.S.A. ATP World Tour Masters 1000,HARD,2,Nicolas Almagro,Albert Montanes,Nicolas Almagro,7-6(5); 6-4,R64,76,8,3,26,60,26,26,23,34,0,0,11,49,60,3,4,40,70,32,40,16,30,3,4,11,48,70
2011-08-14 00:00:00.000,ATP World Tour Masters 1000 Cincinnati OH; U.S.A. ATP World Tour Masters 1000,HARD,2,Ivo Karlovic,Florian Mayer,Ivo Karlovic,6-1; 6-3,R64,57,19,0,30,38,28,30,4,8,0,0,8,32,38,1,4,36,63,20,36,12,27,7,11,8,32,63
2011-08-14 00:00:00.000,ATP World Tour Masters 1000 Cincinnati OH; U.S.A. ATP World Tour Masters 1000,HARD,2,Juan Monaco,Tommy Haas,Juan Monaco,6-7(5); 6-4; 6-3,R64,132,3,2,65,96,45,65,22,31,1,1,15,67,96,6,3,67,97,51,67,16,30,3,6,16,67,97
2011-08-14 00:00:00.000,ATP World Tour Masters 1000 Cincinnati OH; U.S.A. ATP World Tour Masters 1000,HARD,2,Tomas Berdych,N/A Bye,Tomas Berdych,,R64,0,0,0,0,0,0,0,0,0,0,0,0,0,0,0,0,0,0,0,0,0,0,0,0,0,0,0
2011-08-14 00:00:00.000,ATP World Tour Masters 1000 Cincinnati OH; U.S.A. ATP World Tour Masters 1000,HARD,2,David Ferrer,N/A Bye,David Ferrer,,R64,0,0,0,0,0,0,0,0,0,0,0,0,0,0,0,0,0,0,0,0,0,0,0,0,0,0,0
2011-08-14 00:00:00.000,ATP World Tour Masters 1000 Cincinnati OH; U.S.A. ATP World Tour Masters 1000,HARD,2,Grigor Dimitrov,Marsel Ilhan,Grigor Dimitrov,6-3; 7-5,R64,72,7,2,35,54,32,35,12,19,0,0,11,44,54,1,1,32,58,22,32,15,26,2,4,10,37,58
2011-08-14 00:00:00.000,ATP World Tour Masters 1000 Cincinnati OH; U.S.A. ATP World Tour Masters 1000,HARD,2,Janko Tipsarevic,Edouard Roger-Vasselin,Janko Tipsarevic,6-0; 3-6; 7-6(5),R64,149,9,4,44,89,38,44,24,45,7,8,13,62,89,7,4,73,110,53,73,14,37,5,8,14,67,110
2011-08-14 00:00:00.000,ATP World Tour Masters 1000 Cincinnati OH; U.S.A. ATP World Tour Masters 1000,HARD,2,Gilles Simon,Jurgen Melzer,Gilles Simon,6-7(3); 6-3; 7-5,R64,140,10,4,39,88,31,39,33,49,0,1,16,64,88,7,3,65,108,49,65,22,43,7,11,17,71,108
2011-08-14 00:00:00.000,ATP World Tour Masters 1000 Cincinnati OH; U.S.A. ATP World Tour Masters 1000,HARD,2,Jo-Wilfried Tsonga,Marin Cilic,Jo-Wilfried Tsonga,6-3; 6-4,R64,78,9,1,28,46,27,28,13,18,0,0,10,40,46,3,6,23,63,18,23,21,40,3,5,9,39,63
2011-08-14 00:00:00.000,ATP World Tour Masters 1000 Cincinnati OH; U.S.A. ATP World Tour Masters 1000,HARD,2,Alex Bogomolov Jr.,Robby Ginepri,Alex Bogomolov Jr.,6-4; 6-3,R64,94,4,3,45,75,31,45,16,30,10,11,10,47,75,3,2,25,50,18,25,10,25,0,3,9,28,50
2011-08-14 00:00:00.000,ATP World Tour Masters 1000 Cincinnati OH; U.S.A. ATP World Tour Masters 1000,HARD,2,David Nalbandian,Kei Nishikori,David Nalbandian,6-4; 6-4,R64,96,1,7,30,59,24,30,15,29,2,3,10,39,59,1,4,42,79,27,42,17,37,8,11,10,44,79
2011-08-14 00:00:00.000,ATP World Tour Masters 1000 Cincinnati OH; U.S.A. ATP World Tour Masters 1000,HARD,2,Andy Murray,N/A Bye,Andy Murray,,R64,0,0,0,0,0,0,0,0,0,0,0,0,0,0,0,0,0,0,0,0,0,0,0,0,0,0,0
2011-08-14 00:00:00.000,ATP World Tour Masters 1000 Cincinnati OH; U.S.A. ATP World Tour Masters 1000,HARD,2,Mardy Fish,N/A Bye,Mardy Fish,,R64,0,0,0,0,0,0,0,0,0,0,0,0,0,0,0,0,0,0,0,0,0,0,0,0,0,0,0
2011-08-14 00:00:00.000,ATP World Tour Masters 1000 Cincinnati OH; U.S.A. ATP World Tour Masters 1000,HARD,2,Nikolay Davydenko,Sergiy Stakhovsky,Nikolay Davydenko,6-2; 7-6(5),R64,119,0,2,45,64,33,45,12,19,4,5,10,45,64,4,1,36,64,24,36,12,28,0,3,10,36,64
2011-08-14 00:00:00.000,ATP World Tour Masters 1000 Cincinnati OH; U.S.A. ATP World Tour Masters 1000,HARD,2,Kevin Anderson,Xavier Malisse,Kevin Anderson,6-3; 7-6(6),R64,84,13,1,50,63,43,50,8,13,1,1,11,51,63,5,2,32,71,27,32,21,39,4,5,10,48,71
2011-08-14 00:00:00.000,ATP World Tour Masters 1000 Cincinnati OH; U.S.A. ATP World Tour Masters 1000,HARD,2,Richard Gasquet,Alexandr Dolgopolov,Richard Gasquet,6-1; 7-6(4),R64,71,6,3,41,66,34,41,16,25,1,1,10,50,66,6,2,32,54,23,32,11,22,3,5,9,34,54
2011-08-14 00:00:00.000,ATP World Tour Masters 1000 Cincinnati OH; U.S.A. ATP World Tour Masters 1000,HARD,2,Michael Llodra,Mikhail Youzhny,Michael Llodra,7-5; 3-6; 7-6(4),R64,131,19,5,72,106,57,72,14,34,9,12,16,71,106,6,0,71,96,44,71,18,25,2,5,17,62,96
2011-08-14 00:00:00.000,ATP World Tour Masters 1000 Cincinnati OH; U.S.A. ATP World Tour Masters 1000,HARD,2,Fernando Verdasco,Thomaz Bellucci,Fernando Verdasco,6-3; 7-6(4),R64,107,4,4,50,75,36,50,16,25,6,7,11,52,75,7,0,52,77,33,52,15,25,7,9,10,48,77
2011-08-14 00:00:00.000,ATP World Tour Masters 1000 Cincinnati OH; U.S.A. ATP World Tour Masters 1000,HARD,2,Julien Benneteau,Guillermo Garcia-Lopez,Julien Benneteau,6-3; 1-0 RET,R64,36,4,2,12,22,12,12,8,10,0,0,5,20,22,3,9,16,36,11,16,9,20,2,4,5,20,36
2011-08-14 00:00:00.000,ATP World Tour Masters 1000 Cincinnati OH; U.S.A. ATP World Tour Masters 1000,HARD,2,Rafael Nadal,N/A Bye,Rafael Nadal,,R64,0,0,0,0,0,0,0,0,0,0,0,0,0,0,0,0,0,0,0,0,0,0,0,0,0,0,0
2011-08-14 00:00:00.000,ATP World Tour Masters 1000 Cincinnati OH; U.S.A. ATP World Tour Masters 1000,HARD,2,Novak Djokovic,Ryan Harrison,Novak Djokovic,6-2; 6-3,R32,77,3,1,33,52,24,33,10,19,1,3,9,34,52,6,1,26,53,13,26,11,27,7,12,8,24,53
2011-08-14 00:00:00.000,ATP World Tour Masters 1000 Cincinnati OH; U.S.A. ATP World Tour Masters 1000,HARD,2,Radek Stepanek,Andrey Golubev,Radek Stepanek,6-3; 7-6(2),R32,97,0,3,42,68,32,42,15,26,0,1,11,47,68,5,2,38,65,28,38,11,27,2,4,10,39,65
2011-08-14 00:00:00.000,ATP World Tour Masters 1000 Cincinnati OH; U.S.A. ATP World Tour Masters 1000,HARD,2,Philipp Kohlschreiber,Feliciano Lopez,Philipp Kohlschreiber,6-1; 6-4,R32,67,5,3,24,44,21,24,15,20,0,0,9,36,44,11,4,23,46,17,23,9,23,1,4,8,26,46
2011-08-14 00:00:00.000,ATP World Tour Masters 1000 Cincinnati OH; U.S.A. ATP World Tour Masters 1000,HARD,2,Gael Monfils,Ivan Dodig,Gael Monfils,4-6; 6-3; 4-0 RET,R32,119,3,1,59,85,39,59,14,26,9,10,11,53,85,1,4,41,72,26,41,17,31,4,8,12,43,72
2011-08-14 00:00:00.000,ATP World Tour Masters 1000 Cincinnati OH; U.S.A. ATP World Tour Masters 1000,HARD,2,Roger Federer,Juan Martin Del Potro,Roger Federer,6-3; 7-5,R32,92,12,1,46,61,38,46,7,15,1,1,11,45,61,7,2,44,77,31,44,14,33,6,8,10,45,77
2011-08-14 00:00:00.000,ATP World Tour Masters 1000 Cincinnati OH; U.S.A. ATP World Tour Masters 1000,HARD,2,James Blake,Fabio Fognini,James Blake,6-4; 6-2,R32,59,7,2,37,51,30,37,9,14,1,1,9,39,51,3,4,30,57,21,30,10,27,2,5,9,31,57
2011-08-14 00:00:00.000,ATP World Tour Masters 1000 Cincinnati OH; U.S.A. ATP World Tour Masters 1000,HARD,2,Nicolas Almagro,Ivo Karlovic,Nicolas Almagro,6-3; 5-7; 7-6(2),R32,119,16,5,52,87,45,52,23,35,0,1,16,68,87,21,4,69,104,55,69,13,35,6,8,17,68,104
2011-08-14 00:00:00.000,ATP World Tour Masters 1000 Cincinnati OH; U.S.A. ATP World Tour Masters 1000,HARD,2,Tomas Berdych,Juan Monaco,Tomas Berdych,7-6(2); 6-0,R32,96,9,2,35,63,29,35,14,28,3,4,9,43,63,2,2,45,66,23,45,10,21,7,11,9,33,66
2011-08-14 00:00:00.000,ATP World Tour Masters 1000 Cincinnati OH; U.S.A. ATP World Tour Masters 1000,HARD,2,David Ferrer,Grigor Dimitrov,David Ferrer,4-6; 6-1; 7-5,R32,143,4,8,57,104,42,57,22,47,5,7,14,64,104,5,6,57,99,40,57,18,42,9,14,15,58,99
2011-08-14 00:00:00.000,ATP World Tour Masters 1000 Cincinnati OH; U.S.A. ATP World Tour Masters 1000,HARD,2,Gilles Simon,Janko Tipsarevic,Gilles Simon,6-7(3); 6-2; 6-3,R32,177,6,3,44,91,35,44,23,47,3,5,14,58,91,4,5,58,112,42,58,20,54,6,12,15,62,112
2011-08-14 00:00:00.000,ATP World Tour Masters 1000 Cincinnati OH; U.S.A. ATP World Tour Masters 1000,HARD,2,Alex Bogomolov Jr.,Jo-Wilfried Tsonga,Alex Bogomolov Jr.,6-3; 6-4,R32,72,1,2,35,54,28,35,14,19,0,0,10,42,54,5,3,34,56,26,34,9,22,4,6,9,35,56
2011-08-14 00:00:00.000,ATP World Tour Masters 1000 Cincinnati OH; U.S.A. ATP World Tour Masters 1000,HARD,2,Andy Murray,David Nalbandian,Andy Murray,6-4; 6-1,R32,77,5,2,24,47,17,24,11,23,1,4,9,28,47,0,5,33,59,15,33,9,26,10,16,8,24,59
2011-08-14 00:00:00.000,ATP World Tour Masters 1000 Cincinnati OH; U.S.A. ATP World Tour Masters 1000,HARD,2,Mardy Fish,Nikolay Davydenko,Mardy Fish,6-0; 6-2,R32,62,9,2,23,42,21,23,10,19,1,1,7,31,42,0,3,33,46,15,33,4,13,2,7,7,19,46
2011-08-14 00:00:00.000,ATP World Tour Masters 1000 Cincinnati OH; U.S.A. ATP World Tour Masters 1000,HARD,2,Richard Gasquet,Kevin Anderson,Richard Gasquet,7-6(4); 6-4,R32,100,5,1,46,65,35,46,11,19,1,2,11,46,65,12,1,50,79,35,50,14,29,2,4,11,49,79
2011-08-14 00:00:00.000,ATP World Tour Masters 1000 Cincinnati OH; U.S.A. ATP World Tour Masters 1000,HARD,2,Fernando Verdasco,Michael Llodra,Fernando Verdasco,6-4; 6-4,R32,80,1,3,47,64,31,47,13,17,3,4,10,44,64,2,4,44,63,28,44,9,19,3,6,10,37,63
2011-08-14 00:00:00.000,ATP World Tour Masters 1000 Cincinnati OH; U.S.A. ATP World Tour Masters 1000,HARD,2,Rafael Nadal,Julien Benneteau,Rafael Nadal,6-4; 7-5,R32,93,9,1,34,55,29,34,13,21,1,2,11,42,55,1,3,29,61,21,29,17,32,0,3,11,38,61
2011-08-14 00:00:00.000,ATP World Tour Masters 1000 Cincinnati OH; U.S.A. ATP World Tour Masters 1000,HARD,2,Novak Djokovic,Radek Stepanek,Novak Djokovic,6-3; 6-3,R16,82,3,1,24,51,17,24,14,27,1,4,9,31,51,3,1,35,54,13,35,10,19,6,12,9,23,54
2011-08-14 00:00:00.000,ATP World Tour Masters 1000 Cincinnati OH; U.S.A. ATP World Tour Masters 1000,HARD,2,Gael Monfils,Philipp Kohlschreiber,Gael Monfils,6-2; 6-2,R16,65,6,1,32,47,27,32,7,15,0,0,8,34,47,2,2,26,52,16,26,11,26,2,6,8,27,52
2011-08-14 00:00:00.000,ATP World Tour Masters 1000 Cincinnati OH; U.S.A. ATP World Tour Masters 1000,HARD,2,Roger Federer,James Blake,Roger Federer,6-4; 6-1,R16,55,4,1,22,41,18,22,12,19,0,1,8,30,41,4,5,37,59,22,37,8,22,9,14,9,30,59
2011-08-14 00:00:00.000,ATP World Tour Masters 1000 Cincinnati OH; U.S.A. ATP World Tour Masters 1000,HARD,2,Tomas Berdych,Nicolas Almagro,Tomas Berdych,6-2; 6-2,R16,65,11,2,23,48,22,23,14,25,1,1,8,36,48,4,4,19,46,15,19,9,27,1,5,8,24,46
2011-08-14 00:00:00.000,ATP World Tour Masters 1000 Cincinnati OH; U.S.A. ATP World Tour Masters 1000,HARD,2,Gilles Simon,David Ferrer,Gilles Simon,6-4; 6-7(3); 6-4,R16,188,7,2,66,103,47,66,19,37,5,7,16,66,103,5,3,70,123,48,70,25,53,10,14,16,73,123
2011-08-14 00:00:00.000,ATP World Tour Masters 1000 Cincinnati OH; U.S.A. ATP World Tour Masters 1000,HARD,2,Andy Murray,Alex Bogomolov Jr.,Andy Murray,6-2; 7-5,R16,102,11,6,33,59,26,33,11,26,3,5,10,37,59,0,6,47,75,24,47,13,28,6,11,10,37,75
2011-08-14 00:00:00.000,ATP World Tour Masters 1000 Cincinnati OH; U.S.A. ATP World Tour Masters 1000,HARD,2,Mardy Fish,Richard Gasquet,Mardy Fish,7-5; 7-5,R16,103,8,2,44,70,35,44,15,26,1,1,12,50,70,3,2,45,66,34,45,11,21,0,2,12,45,66
2011-08-14 00:00:00.000,ATP World Tour Masters 1000 Cincinnati OH; U.S.A. ATP World Tour Masters 1000,HARD,2,Rafael Nadal,Fernando Verdasco,Rafael Nadal,7-6(5); 6-7(4); 7-6(9),R16,218,5,2,87,123,58,87,18,36,6,10,18,76,123,8,7,101,128,68,101,13,27,2,6,18,81,128
2011-08-14 00:00:00.000,ATP World Tour Masters 1000 Cincinnati OH; U.S.A. ATP World Tour Masters 1000,HARD,2,Novak Djokovic,Gael Monfils,Novak Djokovic,3-6; 6-4; 6-3,Q,153,2,4,58,93,41,58,17,35,2,5,14,58,93,12,7,60,105,44,60,16,45,9,13,14,60,105
2011-08-14 00:00:00.000,ATP World Tour Masters 1000 Cincinnati OH; U.S.A. ATP World Tour Masters 1000,HARD,2,Tomas Berdych,Roger Federer,Tomas Berdych,6-2; 7-6(3),Q,92,10,1,36,57,31,36,12,21,0,0,10,43,57,11,2,53,81,40,53,7,28,5,7,10,47,81
2011-08-14 00:00:00.000,ATP World Tour Masters 1000 Cincinnati OH; U.S.A. ATP World Tour Masters 1000,HARD,2,Andy Murray,Gilles Simon,Andy Murray,6-3; 6-3,Q,96,8,2,41,64,31,41,10,23,3,4,9,41,64,2,3,29,62,17,29,15,33,7,11,9,32,62
2011-08-14 00:00:00.000,ATP World Tour Masters 1000 Cincinnati OH; U.S.A. ATP World Tour Masters 1000,HARD,2,Mardy Fish,Rafael Nadal,Mardy Fish,6-3; 6-4,Q,100,12,2,33,62,27,33,18,29,4,4,10,45,62,1,2,47,63,30,47,7,16,2,4,9,37,63
2011-08-14 00:00:00.000,ATP World Tour Masters 1000 Cincinnati OH; U.S.A. ATP World Tour Masters 1000,HARD,2,Novak Djokovic,Tomas Berdych,Novak Djokovic,7-5 RET,S,53,4,3,20,30,16,20,5,10,1,2,6,21,30,4,2,26,42,17,26,6,16,2,4,6,23,42
2011-08-14 00:00:00.000,ATP World Tour Masters 1000 Cincinnati OH; U.S.A. ATP World Tour Masters 1000,HARD,2,Andy Murray,Mardy Fish,Andy Murray,6-3; 7-6(8),S,139,5,4,40,78,30,40,18,38,6,9,11,48,78,7,2,46,88,29,46,19,42,11,15,10,48,88
2011-08-14 00:00:00.000,ATP World Tour Masters 1000 Cincinnati OH; U.S.A. ATP World Tour Masters 1000,HARD,2,Andy Murray,Novak Djokovic,Andy Murray,6-4; 3-0 RET,F,72,1,0,19,34,16,19,8,15,1,2,6,24,34,0,1,33,50,18,33,5,17,2,6,7,23,50
2011-08-21 00:00:00.000,Winston-Salem NC; U.S.A. ATP World Tour 250,HARD,2,Andy Roddick,N/A Bye,Andy Roddick,,R64,0,0,0,0,0,0,0,0,0,0,0,0,0,0,0,0,0,0,0,0,0,0,0,0,0,0,0
2011-08-21 00:00:00.000,Winston-Salem NC; U.S.A. ATP World Tour 250,HARD,2,Edouard Roger-Vasselin,Lukas Rosol,Edouard Roger-Vasselin,7-6(5); 2-6; 7-6(4),R64,129,6,3,68,101,46,68,17,33,1,6,16,63,101,12,5,59,109,45,59,22,50,3,6,16,67,109
2011-08-21 00:00:00.000,Winston-Salem NC; U.S.A. ATP World Tour 250,HARD,2,Blaz Kavcic,Lleyton Hewitt,Blaz Kavcic,6-4; 7-6(3),R64,100,6,4,51,77,34,51,11,26,4,7,11,45,77,7,5,47,77,32,47,11,30,4,8,11,43,77
2011-08-21 00:00:00.000,Winston-Salem NC; U.S.A. ATP World Tour 250,HARD,2,Santiago Giraldo,N/A Bye,Santiago Giraldo,,R64,0,0,0,0,0,0,0,0,0,0,0,0,0,0,0,0,0,0,0,0,0,0,0,0,0,0,0
2011-08-21 00:00:00.000,Winston-Salem NC; U.S.A. ATP World Tour 250,HARD,2,Pablo Andujar,N/A Bye,Pablo Andujar,,R64,0,0,0,0,0,0,0,0,0,0,0,0,0,0,0,0,0,0,0,0,0,0,0,0,0,0,0
2011-08-21 00:00:00.000,Winston-Salem NC; U.S.A. ATP World Tour 250,HARD,2,Kei Nishikori,Gilles Muller,Kei Nishikori,1-6; 6-4; 7-6(5),R64,133,8,3,61,95,43,61,16,34,5,8,14,59,95,26,3,45,85,40,45,21,40,2,4,15,61,85
2011-08-21 00:00:00.000,Winston-Salem NC; U.S.A. ATP World Tour 250,HARD,2,Tobias Kamke,Alejandro Falla,Tobias Kamke,6-1; 6-0,R64,59,5,2,24,49,16,24,16,25,2,2,6,32,49,1,5,17,43,10,17,6,26,3,9,7,16,43
2011-08-21 00:00:00.000,Winston-Salem NC; U.S.A. ATP World Tour 250,HARD,2,Juan Monaco,N/A Bye,Juan Monaco,,R64,0,0,0,0,0,0,0,0,0,0,0,0,0,0,0,0,0,0,0,0,0,0,0,0,0,0,0
2011-08-21 00:00:00.000,Winston-Salem NC; U.S.A. ATP World Tour 250,HARD,2,John Isner,N/A Bye,John Isner,,R64,0,0,0,0,0,0,0,0,0,0,0,0,0,0,0,0,0,0,0,0,0,0,0,0,0,0,0
2011-08-21 00:00:00.000,Winston-Salem NC; U.S.A. ATP World Tour 250,HARD,2,Dudi Sela,Filippo Volandri,Dudi Sela,6-3; 6-2,R64,68,9,1,28,49,21,28,12,21,3,4,8,33,49,0,5,30,63,16,30,14,33,7,12,9,30,63
2011-08-21 00:00:00.000,Winston-Salem NC; U.S.A. ATP World Tour 250,HARD,2,Denis Istomin,Matthias Bachinger,Denis Istomin,7-6(1); 6-1,R64,68,8,2,31,60,23,31,22,29,0,1,10,45,60,3,5,30,57,19,30,13,27,1,4,9,32,57
2011-08-21 00:00:00.000,Winston-Salem NC; U.S.A. ATP World Tour 250,HARD,2,Jarkko Nieminen,N/A Bye,Jarkko Nieminen,,R64,0,0,0,0,0,0,0,0,0,0,0,0,0,0,0,0,0,0,0,0,0,0,0,0,0,0,0
2011-08-21 00:00:00.000,Winston-Salem NC; U.S.A. ATP World Tour 250,HARD,2,Dmitry Tursunov,N/A Bye,Dmitry Tursunov,,R64,0,0,0,0,0,0,0,0,0,0,0,0,0,0,0,0,0,0,0,0,0,0,0,0,0,0,0
2011-08-21 00:00:00.000,Winston-Salem NC; U.S.A. ATP World Tour 250,HARD,2,Steve Darcis,Frederico Gil,Steve Darcis,3-6; 6-3; 6-4,R64,119,3,4,47,85,36,47,20,38,0,1,14,56,85,1,1,61,86,43,61,14,25,4,6,14,57,86
2011-08-21 00:00:00.000,Winston-Salem NC; U.S.A. ATP World Tour 250,HARD,2,Ryan Sweeting,Olivier Rochus,Ryan Sweeting,6-3; 7-5,R64,96,7,3,41,75,26,41,21,34,4,6,11,47,75,1,5,32,64,22,32,12,32,6,10,10,34,64
2011-08-21 00:00:00.000,Winston-Salem NC; U.S.A. ATP World Tour 250,HARD,2,Marcos Baghdatis,N/A Bye,Marcos Baghdatis,,R64,0,0,0,0,0,0,0,0,0,0,0,0,0,0,0,0,0,0,0,0,0,0,0,0,0,0,0
2011-08-21 00:00:00.000,Winston-Salem NC; U.S.A. ATP World Tour 250,HARD,2,Pierre-Ludovic Duclos,N/A Bye,Pierre-Ludovic Duclos,,R64,0,0,0,0,0,0,0,0,0,0,0,0,0,0,0,0,0,0,0,0,0,0,0,0,0,0,0
2011-08-21 00:00:00.000,Winston-Salem NC; U.S.A. ATP World Tour 250,HARD,2,Ryan Harrison,Victor Hanescu,Ryan Harrison,1-6; 6-3; 6-4,R64,93,5,14,33,83,27,33,23,50,1,4,13,50,83,4,3,39,63,32,39,11,24,0,3,13,43,63
2011-08-21 00:00:00.000,Winston-Salem NC; U.S.A. ATP World Tour 250,HARD,2,James Blake,Mikhail Kukushkin,James Blake,7-5; 6-1,R64,75,7,2,38,67,29,38,13,29,2,4,10,42,67,1,4,26,55,15,26,11,29,5,10,9,26,55
2011-08-21 00:00:00.000,Winston-Salem NC; U.S.A. ATP World Tour 250,HARD,2,Robin Haase,N/A Bye,Robin Haase,,R64,0,0,0,0,0,0,0,0,0,0,0,0,0,0,0,0,0,0,0,0,0,0,0,0,0,0,0
2011-08-21 00:00:00.000,Winston-Salem NC; U.S.A. ATP World Tour 250,HARD,2,Grigor Dimitrov,N/A Bye,Grigor Dimitrov,,R64,0,0,0,0,0,0,0,0,0,0,0,0,0,0,0,0,0,0,0,0,0,0,0,0,0,0,0
2011-08-21 00:00:00.000,Winston-Salem NC; U.S.A. ATP World Tour 250,HARD,2,Donald Young,Michael Berrer,Donald Young,6-3; 6-4,R64,68,4,3,30,55,22,30,18,25,2,3,10,40,55,2,5,33,52,23,33,8,19,1,4,9,31,52
2011-08-21 00:00:00.000,Winston-Salem NC; U.S.A. ATP World Tour 250,HARD,2,Carlos Berlocq,Andreas Haider-Maurer,Carlos Berlocq,7-5; 4-1 RET,R64,95,1,2,26,48,20,26,13,22,5,6,8,33,48,2,8,35,78,25,35,17,43,11,15,9,42,78
2011-08-21 00:00:00.000,Winston-Salem NC; U.S.A. ATP World Tour 250,HARD,2,Alexandr Dolgopolov,N/A Bye,Alexandr Dolgopolov,,R64,0,0,0,0,0,0,0,0,0,0,0,0,0,0,0,0,0,0,0,0,0,0,0,0,0,0,0
2011-08-21 00:00:00.000,Winston-Salem NC; U.S.A. ATP World Tour 250,HARD,2,Nikolay Davydenko,N/A Bye,Nikolay Davydenko,,R64,0,0,0,0,0,0,0,0,0,0,0,0,0,0,0,0,0,0,0,0,0,0,0,0,0,0,0
2011-08-21 00:00:00.000,Winston-Salem NC; U.S.A. ATP World Tour 250,HARD,2,Michael Russell,Adrian Mannarino,Michael Russell,6-4; 6-7(3); 6-2,R64,138,4,15,68,112,48,68,20,44,6,9,15,68,112,4,9,38,82,26,38,20,44,2,8,15,46,82
2011-08-21 00:00:00.000,Winston-Salem NC; U.S.A. ATP World Tour 250,HARD,2,Andrey Golubev,Maximo Gonzalez,Andrey Golubev,6-2; 4-6; 6-4,R64,117,7,3,45,75,31,45,15,30,2,6,14,46,75,1,3,72,118,44,72,17,46,13,19,14,61,118
2011-08-21 00:00:00.000,Winston-Salem NC; U.S.A. ATP World Tour 250,HARD,2,Sergiy Stakhovsky,N/A Bye,Sergiy Stakhovsky,,R64,0,0,0,0,0,0,0,0,0,0,0,0,0,0,0,0,0,0,0,0,0,0,0,0,0,0,0
2011-08-21 00:00:00.000,Winston-Salem NC; U.S.A. ATP World Tour 250,HARD,2,Igor Kunitsyn,N/A Bye,Igor Kunitsyn,,R64,0,0,0,0,0,0,0,0,0,0,0,0,0,0,0,0,0,0,0,0,0,0,0,0,0,0,0
2011-08-21 00:00:00.000,Winston-Salem NC; U.S.A. ATP World Tour 250,HARD,2,Julien Benneteau,Ricardo Mello,Julien Benneteau,6-1; 6-3,R64,50,4,0,25,40,22,25,10,15,0,0,8,32,40,3,2,24,39,11,24,8,15,0,4,8,19,39
2011-08-21 00:00:00.000,Winston-Salem NC; U.S.A. ATP World Tour 250,HARD,2,Igor Andreev,Bernard Tomic,Igor Andreev,6-7(5); 6-3; 6-4,R64,126,12,3,64,112,52,64,28,48,9,9,16,80,112,10,1,59,90,45,59,18,31,3,5,15,63,90
2011-08-21 00:00:00.000,Winston-Salem NC; U.S.A. ATP World Tour 250,HARD,2,Jurgen Melzer,N/A Bye,Jurgen Melzer,,R64,0,0,0,0,0,0,0,0,0,0,0,0,0,0,0,0,0,0,0,0,0,0,0,0,0,0,0
2011-08-21 00:00:00.000,Winston-Salem NC; U.S.A. ATP World Tour 250,HARD,2,Andy Roddick,Edouard Roger-Vasselin,Andy Roddick,6-2; 6-4,R32,73,11,1,33,50,27,33,12,17,0,0,9,39,50,5,1,34,53,19,34,12,19,4,7,9,31,53
2011-08-21 00:00:00.000,Winston-Salem NC; U.S.A. ATP World Tour 250,HARD,2,Santiago Giraldo,Blaz Kavcic,Santiago Giraldo,6-2; 6-3,R32,62,3,2,29,44,25,29,8,15,0,0,8,33,44,4,4,32,58,22,32,10,26,3,7,9,32,58
2011-08-21 00:00:00.000,Winston-Salem NC; U.S.A. ATP World Tour 250,HARD,2,Kei Nishikori,Pablo Andujar,Kei Nishikori,7-6(3); 6-2,R32,110,2,1,43,65,33,43,13,22,1,2,10,46,65,0,7,36,75,25,36,17,39,11,14,10,42,75
2011-08-21 00:00:00.000,Winston-Salem NC; U.S.A. ATP World Tour 250,HARD,2,Juan Monaco,Tobias Kamke,Juan Monaco,7-5; 6-0,R32,83,4,2,37,50,24,37,6,13,0,2,9,30,50,0,2,41,68,19,41,12,27,7,13,9,31,68
2011-08-21 00:00:00.000,Winston-Salem NC; U.S.A. ATP World Tour 250,HARD,2,John Isner,Dudi Sela,John Isner,7-6(3); 6-2,R32,77,17,2,45,66,37,45,12,21,4,4,10,49,66,1,7,33,64,22,33,19,31,4,6,10,41,64
2011-08-21 00:00:00.000,Winston-Salem NC; U.S.A. ATP World Tour 250,HARD,2,Jarkko Nieminen,Denis Istomin,Jarkko Nieminen,3-6; 6-4; 6-4,R32,109,4,1,65,99,45,65,16,34,5,8,15,61,99,6,3,49,79,33,49,19,30,5,8,14,52,79
2011-08-21 00:00:00.000,Winston-Salem NC; U.S.A. ATP World Tour 250,HARD,2,Steve Darcis,Dmitry Tursunov,Steve Darcis,3-6; 6-1; 6-3,R32,102,8,9,45,84,32,45,22,39,8,10,12,54,84,7,3,48,85,32,48,16,37,8,13,13,48,85
2011-08-21 00:00:00.000,Winston-Salem NC; U.S.A. ATP World Tour 250,HARD,2,Marcos Baghdatis,Ryan Sweeting,Marcos Baghdatis,7-5; 6-1,R32,77,7,4,21,56,17,21,22,35,4,5,9,39,56,2,6,32,53,21,32,6,21,0,5,10,27,53
2011-08-21 00:00:00.000,Winston-Salem NC; U.S.A. ATP World Tour 250,HARD,2,Pierre-Ludovic Duclos,Ryan Harrison,Pierre-Ludovic Duclos,7-5; 7-5,R32,94,1,0,45,66,30,45,16,21,4,6,12,46,66,2,8,42,85,27,42,21,43,8,12,12,48,85
2011-08-21 00:00:00.000,Winston-Salem NC; U.S.A. ATP World Tour 250,HARD,2,Robin Haase,James Blake,Robin Haase,6-4; 6-1,R32,62,6,3,23,51,16,23,19,28,9,10,8,35,51,6,6,32,62,23,32,9,30,3,8,9,32,62
2011-08-21 00:00:00.000,Winston-Salem NC; U.S.A. ATP World Tour 250,HARD,2,Grigor Dimitrov,Donald Young,Grigor Dimitrov,6-4; 2-6; 7-6(2),R32,124,11,7,56,90,35,56,18,34,1,6,15,53,90,3,6,65,101,46,65,14,36,8,12,15,60,101
2011-08-21 00:00:00.000,Winston-Salem NC; U.S.A. ATP World Tour 250,HARD,2,Alexandr Dolgopolov,Carlos Berlocq,Alexandr Dolgopolov,6-4; 6-4,R32,85,8,3,30,65,22,30,22,35,2,3,10,44,65,2,1,34,57,23,34,12,23,4,7,10,35,57
2011-08-21 00:00:00.000,Winston-Salem NC; U.S.A. ATP World Tour 250,HARD,2,Nikolay Davydenko,Michael Russell,Nikolay Davydenko,6-2; 6-2,R32,75,0,4,44,62,28,44,9,18,5,6,8,37,62,2,5,33,54,18,33,7,21,5,10,8,25,54
2011-08-21 00:00:00.000,Winston-Salem NC; U.S.A. ATP World Tour 250,HARD,2,Sergiy Stakhovsky,Andrey Golubev,Sergiy Stakhovsky,6-1; 2-6; 6-4,R32,90,10,2,39,71,27,39,18,32,3,7,13,45,71,1,4,41,72,25,41,15,31,3,8,12,40,72
2011-08-21 00:00:00.000,Winston-Salem NC; U.S.A. ATP World Tour 250,HARD,2,Julien Benneteau,Igor Kunitsyn,Julien Benneteau,6-3; 6-1,R32,72,3,7,25,49,19,25,14,24,1,2,8,33,49,1,1,24,49,14,24,8,25,3,8,8,22,49
2011-08-21 00:00:00.000,Winston-Salem NC; U.S.A. ATP World Tour 250,HARD,2,Igor Andreev,Jurgen Melzer,Igor Andreev,7-5; 6-3,R32,95,8,1,39,68,30,39,18,29,3,4,11,48,68,6,1,55,74,31,55,11,19,2,5,10,42,74
2011-08-21 00:00:00.000,Winston-Salem NC; U.S.A. ATP World Tour 250,HARD,2,Andy Roddick,Santiago Giraldo,Andy Roddick,6-1; 6-3,R16,67,5,0,24,40,19,24,13,16,0,0,8,32,40,1,1,25,53,17,25,10,28,2,6,8,27,53
2011-08-21 00:00:00.000,Winston-Salem NC; U.S.A. ATP World Tour 250,HARD,2,Juan Monaco,Kei Nishikori,Juan Monaco,6-0; 6-3,R16,71,1,3,27,53,20,27,14,26,8,9,7,34,53,0,0,28,49,13,28,7,21,4,10,8,20,49
2011-08-21 00:00:00.000,Winston-Salem NC; U.S.A. ATP World Tour 250,HARD,2,John Isner,Jarkko Nieminen,John Isner,7-6(4); 6-2,R16,64,10,2,35,51,30,35,14,16,0,0,10,44,51,6,1,33,58,25,33,14,25,2,4,10,39,58
2011-08-21 00:00:00.000,Winston-Salem NC; U.S.A. ATP World Tour 250,HARD,2,Marcos Baghdatis,Steve Darcis,Marcos Baghdatis,7-5; 6-0,R16,74,9,5,24,55,21,24,16,31,1,2,9,37,55,2,7,24,59,17,24,11,35,6,11,9,28,59
2011-08-21 00:00:00.000,Winston-Salem NC; U.S.A. ATP World Tour 250,HARD,2,Robin Haase,Pierre-Ludovic Duclos,Robin Haase,6-4; 7-5,R16,114,3,2,33,74,22,33,23,41,7,9,11,45,74,5,9,42,80,28,42,16,38,7,11,11,44,80
2011-08-21 00:00:00.000,Winston-Salem NC; U.S.A. ATP World Tour 250,HARD,2,Alexandr Dolgopolov,Grigor Dimitrov,Alexandr Dolgopolov,6-4; 1-6; 7-6(7),R16,133,9,6,38,93,32,38,28,55,5,8,14,60,93,10,5,59,105,43,59,26,46,7,9,15,69,105
2011-08-21 00:00:00.000,Winston-Salem NC; U.S.A. ATP World Tour 250,HARD,2,Sergiy Stakhovsky,Nikolay Davydenko,Sergiy Stakhovsky,6-4; 6-4,R16,78,6,3,32,56,26,32,13,24,2,3,10,39,56,2,4,47,64,28,47,9,17,4,7,10,37,64
2011-08-21 00:00:00.000,Winston-Salem NC; U.S.A. ATP World Tour 250,HARD,2,Julien Benneteau,Igor Andreev,Julien Benneteau,2-6; 6-1; 7-6(5),R16,154,6,4,62,102,41,62,22,40,4,7,14,63,102,8,7,51,100,36,51,20,49,5,8,13,56,100
2011-08-21 00:00:00.000,Winston-Salem NC; U.S.A. ATP World Tour 250,HARD,2,Andy Roddick,Juan Monaco,Andy Roddick,6-1; 6-4,Q,67,9,1,32,45,26,32,10,13,0,0,9,36,45,1,5,32,55,17,32,14,23,2,5,8,31,55
2011-08-21 00:00:00.000,Winston-Salem NC; U.S.A. ATP World Tour 250,HARD,2,John Isner,Marcos Baghdatis,John Isner,1-6; 6-3; 6-4,Q,111,12,4,50,78,37,50,12,28,0,3,13,49,78,6,5,26,69,21,26,26,43,6,9,13,47,69
2011-08-21 00:00:00.000,Winston-Salem NC; U.S.A. ATP World Tour 250,HARD,2,Robin Haase,Alexandr Dolgopolov,Robin Haase,6-4; 6-4,Q,60,3,5,29,56,20,29,18,27,1,2,10,38,56,15,6,35,59,26,35,9,24,5,8,10,35,59
2011-08-21 00:00:00.000,Winston-Salem NC; U.S.A. ATP World Tour 250,HARD,2,Julien Benneteau,Sergiy Stakhovsky,Julien Benneteau,3-6; 7-6(9); 6-2,Q,141,10,5,57,93,42,57,21,36,3,5,14,63,93,12,9,57,113,45,57,26,56,11,14,15,71,113
2011-08-21 00:00:00.000,Winston-Salem NC; U.S.A. ATP World Tour 250,HARD,2,John Isner,Andy Roddick,John Isner,7-6(7); 6-4,S,95,8,1,41,69,35,41,17,28,1,2,11,52,69,10,2,47,67,42,47,6,20,1,3,11,48,67
2011-08-21 00:00:00.000,Winston-Salem NC; U.S.A. ATP World Tour 250,HARD,2,Julien Benneteau,Robin Haase,Julien Benneteau,3-6; 7-6(7); 7-6(6),S,152,11,10,68,117,49,68,23,49,2,6,16,72,117,10,5,65,106,49,65,21,41,5,8,17,70,106
2011-08-21 00:00:00.000,Winston-Salem NC; U.S.A. ATP World Tour 250,HARD,2,John Isner,Julien Benneteau,John Isner,4-6; 6-3; 6-4,F,121,19,5,61,85,51,61,10,24,2,3,15,61,85,6,1,47,78,36,47,20,31,4,6,14,56,78
2011-08-29 00:00:00.000,US Open NY; U.S.A. Grand Slams,HARD,3,Novak Djokovic,Conor Niland,Novak Djokovic,6-0; 5-1 RET,R128,44,3,1,22,30,19,22,5,8,0,0,6,24,30,1,2,15,30,6,15,2,15,1,6,6,8,30
2011-08-29 00:00:00.000,US Open NY; U.S.A. Grand Slams,HARD,3,Carlos Berlocq,Pere Riba,Carlos Berlocq,7-5; 6-0; 6-1,R128,114,8,7,48,77,41,48,12,29,2,3,12,53,77,2,6,41,85,22,41,15,44,7,15,13,37,85
2011-08-29 00:00:00.000,US Open NY; U.S.A. Grand Slams,HARD,3,Potito Starace,Michael Berrer,Potito Starace,6-4; 4-6; 6-3; 6-2,R128,159,6,4,82,119,60,82,21,37,11,12,18,81,119,9,5,78,130,55,78,24,52,14,19,19,79,130
2011-08-29 00:00:00.000,US Open NY; U.S.A. Grand Slams,HARD,3,Nikolay Davydenko,Ivan Dodig,Nikolay Davydenko,6-7(6); 6-3; 6-0; 2-6; 6-2,R128,242,2,7,126,163,87,126,16,37,12,16,22,103,163,9,8,80,148,50,80,31,68,8,15,21,81,148
2011-08-29 00:00:00.000,US Open NY; U.S.A. Grand Slams,HARD,3,Alexandr Dolgopolov,Frederico Gil,Alexandr Dolgopolov,6-4; 6-2; 7-5,R128,118,10,7,41,102,32,41,34,61,7,9,15,66,102,1,7,58,94,35,58,16,36,4,10,15,51,94
2011-08-29 00:00:00.000,US Open NY; U.S.A. Grand Slams,HARD,3,Flavio Cipolla,Kei Nishikori,Flavio Cipolla,6-4; 6-2 RET,R128,75,2,3,30,50,24,30,11,20,1,2,9,35,50,3,5,31,51,20,31,7,20,3,7,9,27,51
2011-08-29 00:00:00.000,US Open NY; U.S.A. Grand Slams,HARD,3,Ivo Karlovic,Fernando Gonzalez,Ivo Karlovic,6-4; 6-4; 7-6(3),R128,116,23,3,60,90,52,60,19,30,1,1,16,71,90,3,3,51,98,37,51,29,47,4,6,16,66,98
2011-08-29 00:00:00.000,US Open NY; U.S.A. Grand Slams,HARD,3,Richard Gasquet,Sergiy Stakhovsky,Richard Gasquet,6-4; 6-4; 6-0,R128,113,8,1,51,79,39,51,16,28,4,5,13,55,79,3,5,51,81,29,51,14,30,7,13,13,43,81
2011-08-29 00:00:00.000,US Open NY; U.S.A. Grand Slams,HARD,3,Tomas Berdych,Romain Jouan,Tomas Berdych,6-2; 7-6(4); 6-1,R128,116,7,5,48,81,41,48,20,33,2,3,14,61,81,0,3,36,81,21,36,23,45,4,9,13,44,81
2011-08-29 00:00:00.000,US Open NY; U.S.A. Grand Slams,HARD,3,Fabio Fognini,Horacio Zeballos,Fabio Fognini,5-7; 6-4; 7-6(5); 6-4,R128,189,11,7,80,139,61,80,33,59,3,7,22,94,139,6,12,74,138,58,74,30,64,5,10,22,88,138
2011-08-29 00:00:00.000,US Open NY; U.S.A. Grand Slams,HARD,3,Philipp Petzschner,Albert Ramos,Philipp Petzschner,7-5; 6-7(2); 6-3; 6-7(5); 6-3,R128,264,12,7,109,194,82,109,42,85,6,7,26,124,194,10,7,112,179,82,112,34,67,10,16,28,116,179
2011-08-29 00:00:00.000,US Open NY; U.S.A. Grand Slams,HARD,3,Janko Tipsarevic,Augustin Gensse,Janko Tipsarevic,6-2; 7-5; 6-0,R128,118,5,4,35,77,32,35,26,42,4,4,13,58,77,4,3,67,96,38,67,12,29,8,14,13,50,96
2011-08-29 00:00:00.000,US Open NY; U.S.A. Grand Slams,HARD,3,Marcel Granollers,Xavier Malisse,Marcel Granollers,6-4; 6-4; 6-4,R128,121,2,3,46,81,37,46,17,35,2,5,15,54,81,7,1,56,93,37,56,14,37,4,10,15,51,93
2011-08-29 00:00:00.000,US Open NY; U.S.A. Grand Slams,HARD,3,Mikhail Kukushkin,Albert Montanes,Mikhail Kukushkin,7-5; 6-2; 3-6; 7-6(5),R128,181,9,3,69,130,53,69,33,61,6,9,21,86,130,3,7,69,127,52,69,29,58,6,10,20,81,127
2011-08-29 00:00:00.000,US Open NY; U.S.A. Grand Slams,HARD,3,Juan Carlos Ferrero,Pablo Andujar,Juan Carlos Ferrero,1-6; 7-5; 5-7; 6-1; 6-3,R128,212,10,6,96,163,57,96,36,67,17,23,23,93,163,5,5,95,162,61,95,32,67,8,16,24,93,162
2011-08-29 00:00:00.000,US Open NY; U.S.A. Grand Slams,HARD,3,Gael Monfils,Grigor Dimitrov,Gael Monfils,7-6(4); 6-3; 6-4,R128,159,2,3,64,111,43,64,27,47,7,10,16,70,111,3,5,68,117,43,68,22,49,8,13,15,65,117
2011-08-29 00:00:00.000,US Open NY; U.S.A. Grand Slams,HARD,3,Roger Federer,Santiago Giraldo,Roger Federer,6-4; 6-3; 6-2,R128,106,5,3,51,83,36,51,15,32,0,3,14,51,83,2,2,52,98,32,52,15,46,11,18,13,47,98
2011-08-29 00:00:00.000,US Open NY; U.S.A. Grand Slams,HARD,3,Dudi Sela,Thomaz Bellucci,Dudi Sela,4-6; 2-6; 6-4; 6-3; 6-0,R128,207,9,10,64,136,46,64,36,72,6,12,22,82,136,9,6,75,134,50,75,27,59,7,13,21,77,134
2011-08-29 00:00:00.000,US Open NY; U.S.A. Grand Slams,HARD,3,Bernard Tomic,Michael Yani,Bernard Tomic,6-3; 6-4; 6-4,R128,110,9,3,63,105,49,63,19,42,4,5,15,68,105,4,1,47,81,33,47,17,34,3,7,14,50,81
2011-08-29 00:00:00.000,US Open NY; U.S.A. Grand Slams,HARD,3,Marin Cilic,Ryan Harrison,Marin Cilic,6-2; 7-5; 7-6(6),R128,146,2,4,43,95,29,43,33,52,3,7,16,62,95,1,7,41,96,21,41,29,55,2,9,16,50,96
2011-08-29 00:00:00.000,US Open NY; U.S.A. Grand Slams,HARD,3,Radek Stepanek,Philipp Kohlschreiber,Radek Stepanek,6-4; 6-1; 6-3,R128,120,3,5,46,85,37,46,22,39,2,2,13,59,85,6,3,40,81,28,40,19,41,4,9,13,47,81
2011-08-29 00:00:00.000,US Open NY; U.S.A. Grand Slams,HARD,3,Juan Monaco,Andreas Seppi,Juan Monaco,7-6(1); 6-2; 6-2,R128,118,3,3,53,89,37,53,16,36,4,8,14,53,89,6,6,51,85,29,51,8,34,3,11,14,37,85
2011-08-29 00:00:00.000,US Open NY; U.S.A. Grand Slams,HARD,3,Tommy Haas,Jonathan Dasnieres de Veigy,Tommy Haas,6-3; 6-4; 6-7(5); 6-1,R128,170,18,9,81,125,59,81,25,44,8,10,20,84,125,5,2,78,119,54,78,12,41,4,10,18,66,119
2011-08-29 00:00:00.000,US Open NY; U.S.A. Grand Slams,HARD,3,Alejandro Falla,Viktor Troicki,Alejandro Falla,3-6; 6-3; 4-6; 7-5; 7-5,R128,220,3,3,81,158,59,81,44,77,8,13,26,103,158,13,5,108,172,82,108,23,64,16,22,26,105,172
2011-08-29 00:00:00.000,US Open NY; U.S.A. Grand Slams,HARD,3,Jo-Wilfried Tsonga,Yen-Hsun Lu,Jo-Wilfried Tsonga,6-4; 6-4; 6-4,R128,129,6,5,53,89,40,53,23,36,3,4,15,63,89,6,3,45,80,32,45,19,35,5,9,15,51,80
2011-08-29 00:00:00.000,US Open NY; U.S.A. Grand Slams,HARD,3,Sergei Bubka,Andreas Haider-Maurer,Sergei Bubka,6-3; 6-2; 3-6; 6-4,R128,134,25,2,67,97,56,67,17,30,2,3,18,73,97,14,10,63,118,47,63,28,55,5,9,18,75,118
2011-08-29 00:00:00.000,US Open NY; U.S.A. Grand Slams,HARD,3,Marsel Ilhan,Frank Dancevic,Marsel Ilhan,6-3; 6-2; 1-0 RET,R128,76,7,2,31,56,27,31,13,25,2,2,10,40,56,4,2,25,49,17,25,10,24,3,7,9,27,49
2011-08-29 00:00:00.000,US Open NY; U.S.A. Grand Slams,HARD,3,Fernando Verdasco,Jarkko Nieminen,Fernando Verdasco,3-6; 6-4; 6-1; 6-4,R128,156,8,1,74,112,59,74,16,38,4,7,18,75,112,2,6,65,118,45,65,23,53,10,16,18,68,118
2011-08-29 00:00:00.000,US Open NY; U.S.A. Grand Slams,HARD,3,Michael Llodra,Victor Hanescu,Michael Llodra,6-2; 4-6; 4-6; 6-3; 6-2,R128,169,11,8,75,126,59,75,27,51,1,4,23,86,126,2,5,53,121,41,53,37,68,7,13,22,78,121
2011-08-29 00:00:00.000,US Open NY; U.S.A. Grand Slams,HARD,3,Kevin Anderson,Go Soeda,Kevin Anderson,6-1; 6-3; 6-0,R128,98,9,1,40,59,33,40,16,19,0,0,11,49,59,0,3,49,84,27,49,13,35,6,13,11,40,84
2011-08-29 00:00:00.000,US Open NY; U.S.A. Grand Slams,HARD,3,Malek Jaziri,Thiemo de Bakker,Malek Jaziri,4-6; 6-1; 6-4; 6-2,R128,163,9,4,57,100,47,57,23,43,5,7,18,70,100,12,8,68,129,52,68,22,61,11,17,17,74,129
2011-08-29 00:00:00.000,US Open NY; U.S.A. Grand Slams,HARD,3,Mardy Fish,Tobias Kamke,Mardy Fish,6-2; 6-2; 6-1,R128,103,4,4,43,73,37,43,15,30,5,6,12,52,73,0,7,41,75,21,41,15,34,1,8,11,36,75
2011-08-29 00:00:00.000,US Open NY; U.S.A. Grand Slams,HARD,3,Rogerio Dutra Silva,Louk Sorensen,Rogerio Dutra Silva,6-0; 3-6; 6-4; 1-0 RET,R128,135,1,1,43,85,33,43,24,42,4,5,13,57,85,6,1,55,85,35,55,17,30,7,11,14,52,85
2011-08-29 00:00:00.000,US Open NY; U.S.A. Grand Slams,HARD,3,Alex Bogomolov Jr.,Steve Johnson,Alex Bogomolov Jr.,4-6; 4-6; 6-3; 7-6(3); 6-3,R128,220,8,8,106,157,77,106,32,51,7,11,26,109,157,23,7,110,176,80,110,30,66,10,14,24,110,176
2011-08-29 00:00:00.000,US Open NY; U.S.A. Grand Slams,HARD,3,Robby Ginepri,Joao Souza,Robby Ginepri,6-3; 6-4; 6-7(5); 6-1,R128,177,8,3,85,141,52,85,36,56,12,14,20,88,141,10,5,72,114,48,72,17,42,4,10,18,65,114
2011-08-29 00:00:00.000,US Open NY; U.S.A. Grand Slams,HARD,3,John Isner,Marcos Baghdatis,John Isner,7-6(2); 7-6(11); 2-6; 6-4,R128,192,14,3,100,138,76,100,22,38,3,5,21,98,138,11,5,65,138,55,65,42,73,4,5,21,97,138
2011-08-29 00:00:00.000,US Open NY; U.S.A. Grand Slams,HARD,3,Juan Martin Del Potro,Filippo Volandri,Juan Martin Del Potro,6-3; 6-1; 6-1,R128,88,18,3,38,56,34,38,11,18,0,0,11,45,56,0,5,39,77,23,39,14,38,7,14,12,37,77
2011-08-29 00:00:00.000,US Open NY; U.S.A. Grand Slams,HARD,3,Diego Junqueira,Karol Beck,Diego Junqueira,6-2 RET,R128,32,0,2,12,21,10,12,6,9,0,0,4,16,21,0,5,20,32,11,20,4,12,1,3,4,15,32
2011-08-29 00:00:00.000,US Open NY; U.S.A. Grand Slams,HARD,3,Guillermo Garcia-Lopez,Daniel Gimeno-Traver,Guillermo Garcia-Lopez,6-3; 1-6; 7-6(1); 4-6; 7-6(4),R128,237,8,13,76,167,57,76,42,91,15,23,25,99,167,8,10,93,174,65,93,39,81,17,23,25,104,174
2011-08-29 00:00:00.000,US Open NY; U.S.A. Grand Slams,HARD,3,Gilles Simon,Ricardo Mello,Gilles Simon,3-6; 6-3; 6-4; 3-6; 6-4,R128,212,9,8,82,155,64,82,36,73,4,6,23,100,155,2,4,103,168,69,103,38,65,12,15,24,107,168
2011-08-29 00:00:00.000,US Open NY; U.S.A. Grand Slams,HARD,3,Stanislas Wawrinka,Maximo Gonzalez,Stanislas Wawrinka,3-6; 6-4; 6-1; 6-3,R128,148,10,5,53,98,42,53,26,45,3,6,18,68,98,4,3,69,116,35,69,28,47,10,16,17,63,116
2011-08-29 00:00:00.000,US Open NY; U.S.A. Grand Slams,HARD,3,Donald Young,Lukas Lacko,Donald Young,6-4; 6-2; 6-4,R128,133,0,1,51,76,37,51,18,25,3,5,14,55,76,7,7,70,121,40,70,23,51,11,17,14,63,121
2011-08-29 00:00:00.000,US Open NY; U.S.A. Grand Slams,HARD,3,Steve Darcis,Dmitry Tursunov,Steve Darcis,6-7(4); 4-6; 7-5; 6-1; 7-6(0),R128,231,20,13,92,169,71,92,38,77,5,11,27,109,169,7,12,91,171,60,91,39,80,10,18,26,99,171
2011-08-29 00:00:00.000,US Open NY; U.S.A. Grand Slams,HARD,3,Juan Ignacio Chela,Marinko Matosevic,Juan Ignacio Chela,3-1 RET,R128,27,0,2,13,20,8,13,4,7,3,3,2,12,20,0,1,7,11,3,7,2,4,0,1,2,5,11
2011-08-29 00:00:00.000,US Open NY; U.S.A. Grand Slams,HARD,3,Feliciano Lopez,Tatsuma Ito,Feliciano Lopez,6-2; 6-4; 6-4,R128,118,18,3,49,87,40,49,23,38,5,5,14,63,87,3,6,52,94,34,52,20,42,3,7,14,54,94
2011-08-29 00:00:00.000,US Open NY; U.S.A. Grand Slams,HARD,3,Vasek Pospisil,Lukas Rosol,Vasek Pospisil,6-1; 6-2; 6-1,R128,82,13,6,43,77,35,43,18,34,6,6,11,53,77,3,7,33,68,20,33,10,35,6,13,11,30,68
2011-08-29 00:00:00.000,US Open NY; U.S.A. Grand Slams,HARD,3,Robin Haase,Rui Machado,Robin Haase,6-0; 6-4; 6-4,R128,92,7,2,44,68,36,44,15,24,0,1,13,51,68,1,3,41,80,24,41,17,39,3,9,13,41,80
2011-08-29 00:00:00.000,US Open NY; U.S.A. Grand Slams,HARD,3,Andy Murray,Somdev Devvarman,Andy Murray,7-6(5); 6-2; 6-3,R128,147,8,3,54,89,42,54,17,35,5,8,14,59,89,1,4,77,115,42,77,17,38,7,14,15,59,115
2011-08-29 00:00:00.000,US Open NY; U.S.A. Grand Slams,HARD,3,David Ferrer,Igor Andreev,David Ferrer,2-6; 6-3; 6-0; 6-4,R128,145,4,6,59,103,46,59,23,44,2,4,17,69,103,3,3,56,99,38,56,20,43,1,6,16,58,99
2011-08-29 00:00:00.000,US Open NY; U.S.A. Grand Slams,HARD,3,James Blake,Jesse Huta Galung,James Blake,6-4; 6-2; 4-6; 6-4,R128,141,12,8,65,109,52,65,20,44,6,10,19,72,109,7,6,52,115,35,52,28,63,6,13,19,63,115
2011-08-29 00:00:00.000,US Open NY; U.S.A. Grand Slams,HARD,3,Jean-Rene Lisnard,Olivier Rochus,Jean-Rene Lisnard,7-6(5); 6-2; 6-4,R128,171,7,4,70,123,45,70,24,53,10,15,15,69,123,5,6,71,117,44,71,17,46,9,17,15,61,117
2011-08-29 00:00:00.000,US Open NY; U.S.A. Grand Slams,HARD,3,Florian Mayer,Adrian Mannarino,Florian Mayer,6-2; 6-0; 6-1,R128,76,3,1,32,54,29,32,13,22,2,2,10,42,54,1,6,30,69,15,30,14,39,6,14,11,29,69
2011-08-29 00:00:00.000,US Open NY; U.S.A. Grand Slams,HARD,3,Andy Roddick,Michael Russell,Andy Roddick,6-2; 6-4; 4-6; 7-5,R128,177,14,4,81,118,56,81,22,37,3,6,20,78,118,0,8,68,113,42,68,24,45,4,10,20,66,113
2011-08-29 00:00:00.000,US Open NY; U.S.A. Grand Slams,HARD,3,Jack Sock,Marc Gicquel,Jack Sock,6-4; 6-3; 1-6; 6-4,R128,147,13,6,61,107,47,61,24,46,3,6,18,71,107,7,8,54,111,44,54,27,57,4,8,18,71,111
2011-08-29 00:00:00.000,US Open NY; U.S.A. Grand Slams,HARD,3,Denis Istomin,Ryan Sweeting,Denis Istomin,3-6; 7-5; 6-4; 7-6(4),R128,167,9,0,78,137,53,78,32,59,5,11,22,85,137,3,10,77,140,53,77,29,63,12,18,21,82,140
2011-08-29 00:00:00.000,US Open NY; U.S.A. Grand Slams,HARD,3,Julien Benneteau,Nicolas Almagro,Julien Benneteau,6-2; 6-4; 6-3,R128,124,5,3,61,100,44,61,19,39,12,13,13,63,100,12,2,41,82,28,41,18,41,4,10,14,46,82
2011-08-29 00:00:00.000,US Open NY; U.S.A. Grand Slams,HARD,3,Ernests Gulbis,Mikhail Youzhny,Ernests Gulbis,6-2; 6-4; 6-4,R128,140,14,5,62,99,48,62,18,37,10,10,14,66,99,4,3,44,86,31,44,19,42,3,7,14,50,86
2011-08-29 00:00:00.000,US Open NY; U.S.A. Grand Slams,HARD,3,Gilles Muller,Edouard Roger-Vasselin,Gilles Muller,7-6(5); 6-4; 6-4,R128,154,23,8,57,110,50,57,24,53,6,8,16,74,110,4,4,61,112,39,61,28,51,7,11,16,67,112
2011-08-29 00:00:00.000,US Open NY; U.S.A. Grand Slams,HARD,3,Igor Kunitsyn,Matthias Bachinger,Igor Kunitsyn,2-6; 1-6; 6-1; 6-4; 6-4,R128,205,8,4,88,149,54,88,31,61,6,12,21,85,149,12,5,81,151,57,81,29,70,7,13,21,86,151
2011-08-29 00:00:00.000,US Open NY; U.S.A. Grand Slams,HARD,3,Jurgen Melzer,Eric Prodon,Jurgen Melzer,6-2; 7-6(4); 6-2,R128,114,13,2,60,91,46,60,12,31,2,5,14,58,91,4,10,45,97,28,45,19,52,9,15,14,47,97
2011-08-29 00:00:00.000,US Open NY; U.S.A. Grand Slams,HARD,3,Ivan Ljubicic,Blaz Kavcic,Ivan Ljubicic,7-6(5); 3-6; 6-1; 7-5,R128,175,23,2,63,120,55,63,34,57,5,6,20,89,120,4,11,82,137,63,82,25,55,8,11,20,88,137
2011-08-29 00:00:00.000,US Open NY; U.S.A. Grand Slams,HARD,3,David Nalbandian,Bobby Reynolds,David Nalbandian,4-6; 6-3; 6-4; 6-3,R128,180,10,8,65,130,48,65,39,65,10,11,19,87,130,11,8,78,135,52,78,29,57,9,13,19,81,135
2011-08-29 00:00:00.000,US Open NY; U.S.A. Grand Slams,HARD,3,Nicolas Mahut,Robert Farah,Nicolas Mahut,3-6; 6-7(4); 6-2; 6-4; 6-0,R128,190,14,9,80,137,60,80,32,57,8,11,22,92,137,5,8,72,147,48,72,38,75,12,20,23,86,147
2011-08-29 00:00:00.000,US Open NY; U.S.A. Grand Slams,HARD,3,Rafael Nadal,Andrey Golubev,Rafael Nadal,6-3; 7-6(1); 7-5,R128,169,6,4,60,94,40,60,16,34,4,10,17,56,94,7,7,62,122,35,62,24,60,14,22,16,59,122
2011-08-29 00:00:00.000,US Open NY; U.S.A. Grand Slams,HARD,3,Novak Djokovic,Carlos Berlocq,Novak Djokovic,6-0; 6-0; 6-2,R64,90,5,0,37,56,25,37,12,19,2,4,10,37,56,2,6,44,67,17,44,5,23,10,20,10,22,67
2011-08-29 00:00:00.000,US Open NY; U.S.A. Grand Slams,HARD,3,Nikolay Davydenko,Potito Starace,Nikolay Davydenko,6-2; 6-4; 7-5,R64,126,0,5,65,88,46,65,13,23,5,8,15,59,88,5,4,63,110,37,63,20,47,13,20,15,57,110
2011-08-29 00:00:00.000,US Open NY; U.S.A. Grand Slams,HARD,3,Alexandr Dolgopolov,Flavio Cipolla,Alexandr Dolgopolov,6-0; 7-5; 2-6; 5-7; 6-4,R64,200,13,11,68,158,52,68,39,90,7,15,24,91,158,0,12,89,152,46,89,33,63,6,16,24,79,152
2011-08-29 00:00:00.000,US Open NY; U.S.A. Grand Slams,HARD,3,Ivo Karlovic,Richard Gasquet,Ivo Karlovic,6-4; 6-2; 2-6; 7-6(4),R64,157,29,1,84,118,65,84,15,34,4,7,19,80,118,8,4,63,113,49,63,26,50,2,6,19,75,113
2011-08-29 00:00:00.000,US Open NY; U.S.A. Grand Slams,HARD,3,Tomas Berdych,Fabio Fognini,Tomas Berdych,7-5; 6-0; 6-0,R64,103,10,0,37,71,34,37,18,34,2,2,12,52,71,5,5,42,78,23,42,16,36,4,11,12,39,78
2011-08-29 00:00:00.000,US Open NY; U.S.A. Grand Slams,HARD,3,Janko Tipsarevic,Philipp Petzschner,Janko Tipsarevic,6-0; 6-3; 3-6; 6-3,R64,133,12,5,57,99,41,57,29,42,4,5,17,70,99,10,5,41,88,34,41,23,47,5,10,16,57,88
2011-08-29 00:00:00.000,US Open NY; U.S.A. Grand Slams,HARD,3,Marcel Granollers,Mikhail Kukushkin,Marcel Granollers,7-5; 6-3; 6-4,R64,140,6,7,55,92,41,55,17,37,1,4,16,58,92,2,5,44,92,29,44,22,48,7,13,15,51,92
2011-08-29 00:00:00.000,US Open NY; U.S.A. Grand Slams,HARD,3,Juan Carlos Ferrero,Gael Monfils,Juan Carlos Ferrero,7-6(5); 5-7; 6-7(5); 6-4; 6-4,R64,288,1,8,100,181,68,100,48,81,6,9,28,116,181,20,10,108,188,77,108,42,80,11,16,28,119,188
2011-08-29 00:00:00.000,US Open NY; U.S.A. Grand Slams,HARD,3,Roger Federer,Dudi Sela,Roger Federer,6-3; 6-2; 6-2,R64,77,6,1,43,60,38,43,14,17,0,0,13,52,60,0,1,43,71,25,43,15,28,6,11,12,40,71
2011-08-29 00:00:00.000,US Open NY; U.S.A. Grand Slams,HARD,3,Marin Cilic,Bernard Tomic,Marin Cilic,6-1; 6-0; 6-2,R64,80,8,1,29,54,21,29,21,25,5,5,10,42,54,5,4,42,75,22,42,9,33,4,12,11,31,75
2011-08-29 00:00:00.000,US Open NY; U.S.A. Grand Slams,HARD,3,Juan Monaco,Radek Stepanek,Juan Monaco,6-4; 6-1; 2-0 RET,R64,103,0,1,40,54,27,40,9,14,3,4,9,36,54,3,4,43,78,27,43,11,35,6,12,10,38,78
2011-08-29 00:00:00.000,US Open NY; U.S.A. Grand Slams,HARD,3,Tommy Haas,Alejandro Falla,Tommy Haas,7-6(5); 6-1; 7-5,R64,136,5,6,55,96,43,55,22,41,3,5,15,65,96,9,3,55,111,35,55,27,56,5,11,16,62,111
2011-08-29 00:00:00.000,US Open NY; U.S.A. Grand Slams,HARD,3,Jo-Wilfried Tsonga,Sergei Bubka,Jo-Wilfried Tsonga,6-3; 7-5; 6-2,R64,105,5,4,48,90,38,48,23,42,1,2,15,61,90,4,1,42,75,32,42,12,33,2,7,14,44,75
2011-08-29 00:00:00.000,US Open NY; U.S.A. Grand Slams,HARD,3,Fernando Verdasco,Marsel Ilhan,Fernando Verdasco,6-4; 6-3; 6-1,R64,99,10,3,38,63,33,38,17,25,0,1,13,50,63,3,3,54,87,34,54,13,33,4,10,13,47,87
2011-08-29 00:00:00.000,US Open NY; U.S.A. Grand Slams,HARD,3,Kevin Anderson,Michael Llodra,Kevin Anderson,6-1; 6-2; 6-2,R64,93,14,1,53,63,42,53,8,10,1,1,12,50,63,2,6,39,82,23,39,16,43,7,13,11,39,82
2011-08-29 00:00:00.000,US Open NY; U.S.A. Grand Slams,HARD,3,Mardy Fish,Malek Jaziri,Mardy Fish,6-2; 6-2; 6-4,R64,113,7,3,44,84,33,44,26,40,2,2,13,59,84,4,7,50,95,30,50,21,45,11,16,13,51,95
2011-08-29 00:00:00.000,US Open NY; U.S.A. Grand Slams,HARD,3,Alex Bogomolov Jr.,Rogerio Dutra Silva,Alex Bogomolov Jr.,6-4; 6-3; 7-5,R64,158,0,3,83,107,57,83,11,24,5,7,16,68,107,3,1,46,101,29,46,28,55,7,12,15,57,101
2011-08-29 00:00:00.000,US Open NY; U.S.A. Grand Slams,HARD,3,John Isner,Robby Ginepri,John Isner,6-4; 6-3; 6-4,R64,108,20,0,58,85,50,58,16,27,2,2,15,66,85,4,4,43,76,29,43,21,33,1,4,14,50,76
2011-08-29 00:00:00.000,US Open NY; U.S.A. Grand Slams,HARD,3,Juan Martin Del Potro,Diego Junqueira,Juan Martin Del Potro,6-2; 6-1; 7-5,R64,131,9,2,55,80,40,55,15,25,2,4,14,55,80,0,1,73,92,32,73,12,19,7,14,13,44,92
2011-08-29 00:00:00.000,US Open NY; U.S.A. Grand Slams,HARD,3,Gilles Simon,Guillermo Garcia-Lopez,Gilles Simon,6-4; 6-7(4); 7-5; 6-3,R64,219,11,3,75,134,57,75,31,59,4,6,21,88,134,2,9,78,142,52,78,30,64,6,13,22,82,142
2011-08-29 00:00:00.000,US Open NY; U.S.A. Grand Slams,HARD,3,Donald Young,Stanislas Wawrinka,Donald Young,7-6(7); 3-6; 2-6; 6-3; 7-6(1),R64,260,0,9,102,170,63,102,34,68,10,20,25,97,170,8,7,108,181,71,108,31,73,7,15,25,102,181
2011-08-29 00:00:00.000,US Open NY; U.S.A. Grand Slams,HARD,3,Juan Ignacio Chela,Steve Darcis,Juan Ignacio Chela,6-2; 6-4; 6-4,R64,115,3,0,40,76,32,40,24,36,2,3,14,56,76,4,3,48,95,34,48,21,47,7,12,14,55,95
2011-08-29 00:00:00.000,US Open NY; U.S.A. Grand Slams,HARD,3,Feliciano Lopez,Vasek Pospisil,Feliciano Lopez,5-7; 6-4; 7-6(3); 7-6(5),R64,202,21,7,84,146,71,84,32,62,4,7,23,103,146,19,8,84,158,61,84,44,74,8,11,23,105,158
2011-08-29 00:00:00.000,US Open NY; U.S.A. Grand Slams,HARD,3,Andy Murray,Robin Haase,Andy Murray,6-7(5); 2-6; 6-2; 6-0; 6-4,R64,203,21,8,80,145,62,80,26,65,14,20,22,88,145,6,7,88,148,54,88,25,60,6,16,22,79,148
2011-08-29 00:00:00.000,US Open NY; U.S.A. Grand Slams,HARD,3,David Ferrer,James Blake,David Ferrer,6-4; 6-3; 6-4,R64,114,0,1,60,91,41,60,19,31,7,9,15,60,91,1,5,51,89,37,51,16,38,7,13,14,53,89
2011-08-29 00:00:00.000,US Open NY; U.S.A. Grand Slams,HARD,3,Florian Mayer,Jean-Rene Lisnard,Florian Mayer,6-2; 7-5; 6-2,R64,111,6,5,42,81,34,42,21,39,5,7,14,55,81,3,5,37,87,26,37,18,50,8,15,14,44,87
2011-08-29 00:00:00.000,US Open NY; U.S.A. Grand Slams,HARD,3,Andy Roddick,Jack Sock,Andy Roddick,6-3; 6-3; 6-4,R64,120,11,1,60,84,44,60,16,24,6,7,14,60,84,9,2,46,79,31,46,13,33,0,5,14,44,79
2011-08-29 00:00:00.000,US Open NY; U.S.A. Grand Slams,HARD,3,Julien Benneteau,Denis Istomin,Julien Benneteau,6-4; 6-4; 6-4,R64,136,3,8,61,99,43,61,17,38,3,6,15,60,99,7,2,53,94,36,53,18,41,5,11,15,54,94
2011-08-29 00:00:00.000,US Open NY; U.S.A. Grand Slams,HARD,3,Gilles Muller,Ernests Gulbis,Gilles Muller,3-6; 7-6(4); 6-4; 7-6(5),R64,228,19,10,84,158,69,84,35,74,10,14,22,104,158,19,14,84,140,69,84,25,56,5,8,21,94,140
2011-08-29 00:00:00.000,US Open NY; U.S.A. Grand Slams,HARD,3,Igor Kunitsyn,Jurgen Melzer,Igor Kunitsyn,3-6; 6-3; 1-6; 6-2; 7-6(5),R64,207,6,4,94,167,59,94,32,73,13,21,23,91,167,8,9,66,135,48,66,31,69,5,12,22,79,135
2011-08-29 00:00:00.000,US Open NY; U.S.A. Grand Slams,HARD,3,David Nalbandian,Ivan Ljubicic,David Nalbandian,6-4; 1-6; 6-3; 6-2,R64,144,5,6,55,93,37,55,23,38,2,6,17,60,93,15,8,51,115,42,51,22,64,10,16,17,64,115
2011-08-29 00:00:00.000,US Open NY; U.S.A. Grand Slams,HARD,3,Rafael Nadal,Nicolas Mahut,Rafael Nadal,6-2; 6-2 RET,R64,81,3,1,34,49,28,34,8,15,4,4,8,36,49,2,5,36,65,21,36,11,29,2,6,9,32,65
2011-08-29 00:00:00.000,US Open NY; U.S.A. Grand Slams,HARD,3,Novak Djokovic,Nikolay Davydenko,Novak Djokovic,6-3; 6-4; 6-2,R32,127,4,0,49,80,37,49,20,31,1,2,14,57,80,1,2,59,81,33,59,10,22,7,12,13,43,81
2011-08-29 00:00:00.000,US Open NY; U.S.A. Grand Slams,HARD,3,Alexandr Dolgopolov,Ivo Karlovic,Alexandr Dolgopolov,6-7(4); 6-2; 6-4; 6-4,R32,161,22,1,58,110,48,58,30,52,3,5,20,78,110,23,4,80,129,62,80,19,49,8,14,20,81,129
2011-08-29 00:00:00.000,US Open NY; U.S.A. Grand Slams,HARD,3,Janko Tipsarevic,Tomas Berdych,Janko Tipsarevic,6-4; 5-0 RET,R32,70,4,1,25,45,17,25,13,20,0,0,7,30,45,0,3,23,45,13,23,9,22,0,4,8,22,45
2011-08-29 00:00:00.000,US Open NY; U.S.A. Grand Slams,HARD,3,Juan Carlos Ferrero,Marcel Granollers,Juan Carlos Ferrero,6-1; 4-3 RET,R32,51,3,1,31,41,25,31,5,10,1,1,7,30,41,1,1,26,39,16,26,5,13,1,4,7,21,39
2011-08-29 00:00:00.000,US Open NY; U.S.A. Grand Slams,HARD,3,Roger Federer,Marin Cilic,Roger Federer,6-3; 4-6; 6-4; 6-2,R32,160,6,3,63,108,47,63,28,45,7,9,19,75,108,12,5,57,119,39,57,32,62,8,14,18,71,119
2011-08-29 00:00:00.000,US Open NY; U.S.A. Grand Slams,HARD,3,Juan Monaco,Tommy Haas,Juan Monaco,6-7(3); 6-3; 6-2; 6-3,R32,189,6,4,84,125,61,84,24,41,2,4,19,85,125,7,6,80,139,57,80,22,59,10,17,19,79,139
2011-08-29 00:00:00.000,US Open NY; U.S.A. Grand Slams,HARD,3,Jo-Wilfried Tsonga,Fernando Verdasco,Jo-Wilfried Tsonga,6-3; 7-5; 6-4,R32,126,11,2,54,91,44,54,19,37,2,4,16,63,91,4,3,65,81,44,65,4,16,3,8,15,48,81
2011-08-29 00:00:00.000,US Open NY; U.S.A. Grand Slams,HARD,3,Mardy Fish,Kevin Anderson,Mardy Fish,6-4; 7-6(4); 7-6(3),R32,200,12,2,69,127,48,69,35,58,7,9,17,83,127,6,4,75,121,45,75,28,46,10,13,17,73,121
2011-08-29 00:00:00.000,US Open NY; U.S.A. Grand Slams,HARD,3,John Isner,Alex Bogomolov Jr.,John Isner,7-6(9); 6-4; 6-4,R32,153,19,3,72,101,61,72,17,29,8,8,16,78,101,3,6,76,114,56,76,20,38,6,8,16,76,114
2011-08-29 00:00:00.000,US Open NY; U.S.A. Grand Slams,HARD,3,Gilles Simon,Juan Martin Del Potro,Gilles Simon,4-6; 7-6(5); 6-2; 7-6(3),R32,237,11,4,90,151,70,90,31,61,12,14,21,101,151,3,5,89,152,64,89,32,63,9,12,21,96,152
2011-08-29 00:00:00.000,US Open NY; U.S.A. Grand Slams,HARD,3,Donald Young,Juan Ignacio Chela,Donald Young,7-5; 6-4; 6-3,R32,135,4,3,63,89,47,63,16,26,5,7,16,63,89,1,1,64,107,38,64,22,43,5,10,15,60,107
2011-08-29 00:00:00.000,US Open NY; U.S.A. Grand Slams,HARD,3,Andy Murray,Feliciano Lopez,Andy Murray,6-1; 6-4; 6-2,R32,114,3,0,55,74,41,55,15,19,2,2,13,56,74,5,8,36,81,24,36,18,45,8,13,12,42,81
2011-08-29 00:00:00.000,US Open NY; U.S.A. Grand Slams,HARD,3,David Ferrer,Florian Mayer,David Ferrer,6-1; 6-2; 7-6(2),R32,107,5,4,52,93,40,52,24,41,3,4,14,64,93,6,3,44,76,31,44,13,32,3,8,13,44,76
2011-08-29 00:00:00.000,US Open NY; U.S.A. Grand Slams,HARD,3,Andy Roddick,Julien Benneteau,Andy Roddick,6-1; 6-4; 7-6(5),R32,128,21,0,60,91,49,60,21,31,3,3,15,70,91,17,4,60,97,44,60,18,37,9,12,14,62,97
2011-08-29 00:00:00.000,US Open NY; U.S.A. Grand Slams,HARD,3,Gilles Muller,Igor Kunitsyn,Gilles Muller,6-1; 6-4; 6-4,R32,115,22,4,45,86,39,45,24,41,4,4,14,63,86,2,4,38,81,28,38,20,43,5,9,13,48,81
2011-08-29 00:00:00.000,US Open NY; U.S.A. Grand Slams,HARD,3,Rafael Nadal,David Nalbandian,Rafael Nadal,7-6(5); 6-1; 7-5,R32,159,2,4,79,102,55,79,10,23,5,8,15,65,102,6,7,48,91,30,48,17,43,4,10,16,47,91
2011-08-29 00:00:00.000,US Open NY; U.S.A. Grand Slams,HARD,3,Novak Djokovic,Alexandr Dolgopolov,Novak Djokovic,7-6(14); 6-4; 6-2,R16,146,2,3,69,105,52,69,19,36,4,6,15,71,105,5,5,41,94,32,41,22,53,2,7,15,54,94
2011-08-29 00:00:00.000,US Open NY; U.S.A. Grand Slams,HARD,3,Janko Tipsarevic,Juan Carlos Ferrero,Janko Tipsarevic,7-5; 6-7(3); 7-5; 6-2,R16,223,20,3,81,128,61,81,35,47,2,2,22,96,128,8,8,86,152,63,86,33,66,6,10,22,96,152
2011-08-29 00:00:00.000,US Open NY; U.S.A. Grand Slams,HARD,3,Roger Federer,Juan Monaco,Roger Federer,6-1; 6-2; 6-0,R16,82,14,1,39,59,33,39,13,20,0,0,11,46,59,1,2,45,68,18,45,11,23,7,14,10,29,68
2011-08-29 00:00:00.000,US Open NY; U.S.A. Grand Slams,HARD,3,Jo-Wilfried Tsonga,Mardy Fish,Jo-Wilfried Tsonga,6-4; 6-7(5); 3-6; 6-4; 6-2,R16,225,12,3,95,164,70,95,41,69,6,8,25,111,164,3,4,85,138,62,85,31,53,2,6,24,93,138
2011-08-29 00:00:00.000,US Open NY; U.S.A. Grand Slams,HARD,3,John Isner,Gilles Simon,John Isner,7-6(2); 3-6; 7-6(2); 7-6(4),R16,219,26,5,100,158,67,100,34,58,7,12,22,101,158,6,1,102,148,74,102,24,46,5,9,23,98,148
2011-08-29 00:00:00.000,US Open NY; U.S.A. Grand Slams,HARD,3,Andy Murray,Donald Young,Andy Murray,6-2; 6-3; 6-3,R16,118,5,3,35,74,24,35,22,39,2,5,13,46,74,2,5,46,78,22,46,12,32,3,11,13,34,78
2011-08-29 00:00:00.000,US Open NY; U.S.A. Grand Slams,HARD,3,Andy Roddick,David Ferrer,Andy Roddick,6-3; 6-4; 3-6; 6-3,R16,160,19,2,77,112,55,77,24,35,7,9,19,79,112,12,4,58,104,41,58,26,46,3,7,18,67,104
2011-08-29 00:00:00.000,US Open NY; U.S.A. Grand Slams,HARD,3,Rafael Nadal,Gilles Muller,Rafael Nadal,7-6(1); 6-1; 6-2,R16,128,5,4,54,74,44,54,11,20,0,2,14,55,74,11,1,50,92,33,50,14,42,6,12,13,47,92
2011-08-29 00:00:00.000,US Open NY; U.S.A. Grand Slams,HARD,3,Novak Djokovic,Janko Tipsarevic,Novak Djokovic,7-6(2); 6-7(3); 6-0; 3-0 RET,Q,207,8,2,82,126,53,82,22,44,9,13,17,75,126,10,5,71,108,46,71,8,37,5,13,17,54,108
2011-08-29 00:00:00.000,US Open NY; U.S.A. Grand Slams,HARD,3,Roger Federer,Jo-Wilfried Tsonga,Roger Federer,6-4; 6-3; 6-3,Q,113,5,2,61,86,47,61,11,25,1,3,14,58,86,5,2,45,85,31,45,16,40,7,13,14,47,85
2011-08-29 00:00:00.000,US Open NY; U.S.A. Grand Slams,HARD,3,Andy Murray,John Isner,Andy Murray,7-5; 6-4; 3-6; 7-6(2),Q,204,14,2,87,128,68,87,26,41,5,6,21,94,128,17,5,91,135,67,91,22,44,3,5,22,89,135
2011-08-29 00:00:00.000,US Open NY; U.S.A. Grand Slams,HARD,3,Rafael Nadal,Andy Roddick,Rafael Nadal,6-2; 6-1; 6-3,Q,113,6,1,46,67,38,46,12,21,4,4,12,50,67,9,3,40,68,25,40,9,28,1,7,12,34,68
2011-08-29 00:00:00.000,US Open NY; U.S.A. Grand Slams,HARD,3,Novak Djokovic,Roger Federer,Novak Djokovic,6-7(7); 4-6; 6-3; 6-2; 7-5,S,231,8,6,82,140,68,82,32,58,2,5,26,100,140,11,4,101,164,68,101,35,63,6,12,25,103,164
2011-08-29 00:00:00.000,US Open NY; U.S.A. Grand Slams,HARD,3,Rafael Nadal,Andy Murray,Rafael Nadal,6-4; 6-2; 3-6; 6-2,S,204,3,1,75,111,54,75,20,36,8,10,17,74,111,8,2,65,121,43,65,26,56,12,18,18,69,121
2011-08-29 00:00:00.000,US Open NY; U.S.A. Grand Slams,HARD,3,Novak Djokovic,Rafael Nadal,Novak Djokovic,6-2; 6-4; 6-7(3); 6-1,F,250,7,1,84,127,55,84,19,43,8,14,19,74,127,2,3,96,141,50,96,19,45,15,27,18,69,141
2011-09-19 00:00:00.000,Bucharest Romania ATP World Tour 250,CLAY,2,Juan Ignacio Chela,N/A Bye,Juan Ignacio Chela,,R32,0,0,0,0,0,0,0,0,0,0,0,0,0,0,0,0,0,0,0,0,0,0,0,0,0,0,0
2011-09-19 00:00:00.000,Bucharest Romania ATP World Tour 250,CLAY,2,Florent Serra,Gianluca Naso,Florent Serra,6-2; 6-4,R32,70,2,1,38,52,31,38,9,14,1,1,9,40,52,7,2,36,53,24,36,7,17,0,3,9,31,53
2011-09-19 00:00:00.000,Bucharest Romania ATP World Tour 250,CLAY,2,Igor Andreev,Peter Torebko,Igor Andreev,5-7; 6-4; 7-5,R32,153,1,5,69,102,48,69,14,33,3,7,17,62,102,12,4,56,100,38,56,22,44,4,9,17,60,100
2011-09-19 00:00:00.000,Bucharest Romania ATP World Tour 250,CLAY,2,Andreas Seppi,Eric Prodon,Andreas Seppi,6-1; 4-6; 6-1,R32,102,3,1,55,86,34,55,19,31,10,12,12,53,86,3,4,48,80,29,48,11,32,7,13,12,40,80
2011-09-19 00:00:00.000,Bucharest Romania ATP World Tour 250,CLAY,2,Pablo Andujar,N/A Bye,Pablo Andujar,,R32,0,0,0,0,0,0,0,0,0,0,0,0,0,0,0,0,0,0,0,0,0,0,0,0,0,0,0
2011-09-19 00:00:00.000,Bucharest Romania ATP World Tour 250,CLAY,2,Marius Copil,Victor Crivoi,Marius Copil,6-3; 6-3,R32,76,7,1,30,52,25,30,12,22,0,0,9,37,52,1,1,44,58,27,44,5,14,8,11,9,32,58
2011-09-19 00:00:00.000,Bucharest Romania ATP World Tour 250,CLAY,2,Frederico Gil,Jeremy Chardy,Frederico Gil,2-6; 6-4; 6-3,R32,135,5,4,65,86,45,65,11,21,1,3,14,56,86,5,7,63,96,46,63,15,33,8,10,13,61,96
2011-09-19 00:00:00.000,Bucharest Romania ATP World Tour 250,CLAY,2,Alessandro Giannessi,Albert Montanes,Alessandro Giannessi,7-5; 6-4,R32,108,2,2,48,73,31,48,12,25,7,10,11,43,73,2,5,38,72,21,38,17,34,4,9,11,38,72
2011-09-19 00:00:00.000,Bucharest Romania ATP World Tour 250,CLAY,2,Joao Souza,Tommy Robredo,Joao Souza,6-4; 7-6(5),R32,123,5,2,52,81,40,52,13,29,5,7,11,53,81,5,2,45,71,30,45,15,26,5,8,11,45,71
2011-09-19 00:00:00.000,Bucharest Romania ATP World Tour 250,CLAY,2,Adrian Ungur,Lukas Rosol,Adrian Ungur,6-4; 6-1,R32,66,3,4,34,51,26,34,10,17,3,3,8,36,51,2,4,34,66,19,34,16,32,9,13,9,35,66
2011-09-19 00:00:00.000,Bucharest Romania ATP World Tour 250,CLAY,2,Filippo Volandri,Rui Machado,Filippo Volandri,6-3; 6-3,R32,86,0,4,36,53,28,36,8,17,3,5,9,36,53,0,3,41,61,20,41,9,20,5,10,9,29,61
2011-09-19 00:00:00.000,Bucharest Romania ATP World Tour 250,CLAY,2,Marcel Granollers,N/A Bye,Marcel Granollers,,R32,0,0,0,0,0,0,0,0,0,0,0,0,0,0,0,0,0,0,0,0,0,0,0,0,0,0,0
2011-09-19 00:00:00.000,Bucharest Romania ATP World Tour 250,CLAY,2,Pere Riba,Potito Starace,Pere Riba,6-1; 3-2 RET,R32,59,3,0,33,50,26,33,7,17,2,2,6,33,50,1,2,22,34,13,22,3,12,2,5,6,16,34
2011-09-19 00:00:00.000,Bucharest Romania ATP World Tour 250,CLAY,2,Albert Ramos,Victor Hanescu,Albert Ramos,6-4; 6-3,R32,79,3,1,30,50,24,30,12,20,4,5,9,36,50,1,0,39,56,22,39,9,17,2,6,10,31,56
2011-09-19 00:00:00.000,Bucharest Romania ATP World Tour 250,CLAY,2,Carlos Berlocq,Andreas Haider-Maurer,Carlos Berlocq,6-2; 6-1,R32,78,2,0,19,32,16,19,12,13,0,0,7,28,32,0,3,29,60,12,29,14,31,7,12,8,26,60
2011-09-19 00:00:00.000,Bucharest Romania ATP World Tour 250,CLAY,2,Florian Mayer,N/A Bye,Florian Mayer,,R32,0,0,0,0,0,0,0,0,0,0,0,0,0,0,0,0,0,0,0,0,0,0,0,0,0,0,0
2011-09-19 00:00:00.000,Bucharest Romania ATP World Tour 250,CLAY,2,Juan Ignacio Chela,Florent Serra,Juan Ignacio Chela,6-1; 6-0,R16,62,2,1,30,38,24,30,3,8,5,5,6,27,38,1,0,32,54,12,32,9,22,5,11,7,21,54
2011-09-19 00:00:00.000,Bucharest Romania ATP World Tour 250,CLAY,2,Andreas Seppi,Igor Andreev,Andreas Seppi,6-2; 3-6; 6-1,R16,106,4,0,49,80,35,49,21,31,9,10,12,56,80,3,3,48,76,28,48,15,28,2,6,12,43,76
2011-09-19 00:00:00.000,Bucharest Romania ATP World Tour 250,CLAY,2,Pablo Andujar,Marius Copil,Pablo Andujar,6-2; 6-3,R16,76,1,0,34,48,22,34,11,14,3,4,8,33,48,5,4,32,49,17,32,4,17,2,7,9,21,49
2011-09-19 00:00:00.000,Bucharest Romania ATP World Tour 250,CLAY,2,Alessandro Giannessi,Frederico Gil,Alessandro Giannessi,7-6(2); 0-6; 6-3,R16,145,0,6,71,107,48,71,14,36,8,13,14,62,107,6,0,43,71,30,43,15,28,1,4,13,45,71
2011-09-19 00:00:00.000,Bucharest Romania ATP World Tour 250,CLAY,2,Joao Souza,Adrian Ungur,Joao Souza,4-6; 7-6(6); 6-1,R16,165,13,3,64,98,43,64,19,34,6,9,15,62,98,3,3,80,125,46,80,24,45,12,16,14,70,125
2011-09-19 00:00:00.000,Bucharest Romania ATP World Tour 250,CLAY,2,Filippo Volandri,Marcel Granollers,Filippo Volandri,6-1; 6-3,R16,76,0,2,37,49,24,37,8,12,3,4,8,32,49,2,0,31,51,16,31,8,20,3,8,8,24,51
2011-09-19 00:00:00.000,Bucharest Romania ATP World Tour 250,CLAY,2,Albert Ramos,Pere Riba,Albert Ramos,2-6; 6-4; 7-5,R16,175,7,6,66,100,48,66,15,34,9,12,15,63,100,3,2,55,101,40,55,21,46,7,10,15,61,101
2011-09-19 00:00:00.000,Bucharest Romania ATP World Tour 250,CLAY,2,Florian Mayer,Carlos Berlocq,Florian Mayer,6-2; 0-6; 6-4,R16,112,1,1,44,70,27,44,12,26,4,9,12,39,70,4,1,53,78,34,53,9,25,7,12,12,43,78
2011-09-19 00:00:00.000,Bucharest Romania ATP World Tour 250,CLAY,2,Juan Ignacio Chela,Andreas Seppi,Juan Ignacio Chela,7-5; 6-3,Q,113,5,2,50,78,26,50,17,28,6,10,11,43,78,2,2,40,70,22,40,9,30,5,11,10,31,70
2011-09-19 00:00:00.000,Bucharest Romania ATP World Tour 250,CLAY,2,Pablo Andujar,Alessandro Giannessi,Pablo Andujar,6-3; 6-4,Q,96,3,2,58,73,42,58,5,15,9,10,10,47,73,1,4,31,50,21,31,7,19,0,3,9,28,50
2011-09-19 00:00:00.000,Bucharest Romania ATP World Tour 250,CLAY,2,Filippo Volandri,Joao Souza,Filippo Volandri,6-2; 6-0,Q,61,1,0,36,45,22,36,4,9,2,4,7,26,45,0,1,26,36,6,26,2,10,4,11,7,8,36
2011-09-19 00:00:00.000,Bucharest Romania ATP World Tour 250,CLAY,2,Florian Mayer,Albert Ramos,Florian Mayer,6-1; 6-2,Q,67,3,3,34,49,27,34,8,15,2,2,8,35,49,0,1,24,46,11,24,10,22,6,10,7,21,46
2011-09-19 00:00:00.000,Bucharest Romania ATP World Tour 250,CLAY,2,Pablo Andujar,Juan Ignacio Chela,Pablo Andujar,6-4; 7-5,S,112,3,1,50,66,34,50,7,16,7,10,11,41,66,0,1,62,75,31,62,6,13,7,12,11,37,75
2011-09-19 00:00:00.000,Bucharest Romania ATP World Tour 250,CLAY,2,Florian Mayer,Filippo Volandri,Florian Mayer,7-6(3); 6-2,S,98,7,0,38,70,28,38,16,32,7,9,10,44,70,0,2,50,67,28,50,6,17,6,10,10,34,67
2011-09-19 00:00:00.000,Bucharest Romania ATP World Tour 250,CLAY,2,Florian Mayer,Pablo Andujar,Florian Mayer,6-3; 6-1,F,71,0,1,27,48,20,27,11,21,2,3,8,31,48,1,2,37,51,20,37,4,14,2,7,8,24,51
2011-09-19 00:00:00.000,Metz France ATP World Tour 250,HARD,2,Jo-Wilfried Tsonga,N/A Bye,Jo-Wilfried Tsonga,,R32,0,0,0,0,0,0,0,0,0,0,0,0,0,0,0,0,0,0,0,0,0,0,0,0,0,0,0
2011-09-19 00:00:00.000,Metz France ATP World Tour 250,HARD,2,Mathieu Rodrigues,Mikhail Kukushkin,Mathieu Rodrigues,6-2; 3-6; 6-4,R32,141,1,4,48,95,33,48,22,47,6,10,14,55,95,4,3,47,90,30,47,22,43,9,14,13,52,90
2011-09-19 00:00:00.000,Metz France ATP World Tour 250,HARD,2,Nicolas Mahut,Diego Junqueira,Nicolas Mahut,6-3; 6-2,R32,61,7,2,27,42,25,27,11,15,0,0,9,36,42,1,0,34,48,21,34,6,14,3,6,8,27,48
2011-09-19 00:00:00.000,Metz France ATP World Tour 250,HARD,2,Arnaud Clement,Michael Llodra,Arnaud Clement,6-3; 6-4,R32,80,3,1,29,62,20,29,22,33,3,4,10,42,62,7,3,41,56,28,41,6,15,3,6,9,34,56
2011-09-19 00:00:00.000,Metz France ATP World Tour 250,HARD,2,Alexandr Dolgopolov,N/A Bye,Alexandr Dolgopolov,,R32,0,0,0,0,0,0,0,0,0,0,0,0,0,0,0,0,0,0,0,0,0,0,0,0,0,0,0
2011-09-19 00:00:00.000,Metz France ATP World Tour 250,HARD,2,Marcos Baghdatis,Matthias Bachinger,Marcos Baghdatis,7-5; 6-2,R32,76,3,0,32,55,28,32,14,23,1,1,10,42,55,5,2,38,61,26,38,10,23,4,7,10,36,61
2011-09-19 00:00:00.000,Metz France ATP World Tour 250,HARD,2,Igor Kunitsyn,Kenny De Schepper,Igor Kunitsyn,7-5; 5-7; 6-4,R32,143,1,0,64,98,47,64,19,34,0,2,17,66,98,15,7,67,118,49,67,22,51,11,14,17,71,118
2011-09-19 00:00:00.000,Metz France ATP World Tour 250,HARD,2,Xavier Malisse,Michael Berrer,Xavier Malisse,6-4; 3-6; 6-4,R32,102,12,1,46,80,36,46,22,34,1,2,14,58,80,8,3,49,83,39,49,20,34,5,7,15,59,83
2011-09-19 00:00:00.000,Metz France ATP World Tour 250,HARD,2,Philipp Kohlschreiber,Jonathan Dasnieres de Veigy,Philipp Kohlschreiber,6-4; 7-6(4),R32,86,10,5,45,79,35,45,21,34,5,5,11,56,79,3,0,38,53,34,38,9,15,0,1,11,43,53
2011-09-19 00:00:00.000,Metz France ATP World Tour 250,HARD,2,Igor Sijsling,Grigor Dimitrov,Igor Sijsling,6-2; 6-2,R32,54,10,2,24,42,22,24,11,18,2,2,8,33,42,1,2,35,46,20,35,4,11,2,6,8,24,46
2011-09-19 00:00:00.000,Metz France ATP World Tour 250,HARD,2,Nicolas Renavand,Tobias Kamke,Nicolas Renavand,7-5; 6-4,R32,89,8,2,49,70,32,49,10,21,7,10,11,42,70,4,6,35,78,21,35,19,43,2,7,11,40,78
2011-09-19 00:00:00.000,Metz France ATP World Tour 250,HARD,2,Ivan Ljubicic,N/A Bye,Ivan Ljubicic,,R32,0,0,0,0,0,0,0,0,0,0,0,0,0,0,0,0,0,0,0,0,0,0,0,0,0,0,0
2011-09-19 00:00:00.000,Metz France ATP World Tour 250,HARD,2,Gilles Muller,Philipp Petzschner,Gilles Muller,7-6(2); 7-6(5),R32,105,8,2,54,93,46,54,16,39,5,6,12,62,93,5,0,46,67,36,46,15,21,0,1,12,51,67
2011-09-19 00:00:00.000,Metz France ATP World Tour 250,HARD,2,Benoit Paire,Andrey Golubev,Benoit Paire,7-5; 6-2,R32,70,8,2,26,50,22,26,16,24,0,1,10,38,50,2,1,46,70,24,46,12,24,6,10,10,36,70
2011-09-19 00:00:00.000,Metz France ATP World Tour 250,HARD,2,Olivier Rochus,Stephane Robert,Olivier Rochus,6-1; 6-3,R32,72,0,0,37,58,29,37,10,21,5,5,8,39,58,0,0,18,47,12,18,12,29,1,5,8,24,47
2011-09-19 00:00:00.000,Metz France ATP World Tour 250,HARD,2,Richard Gasquet,N/A Bye,Richard Gasquet,,R32,0,0,0,0,0,0,0,0,0,0,0,0,0,0,0,0,0,0,0,0,0,0,0,0,0,0,0
2011-09-19 00:00:00.000,Metz France ATP World Tour 250,HARD,2,Jo-Wilfried Tsonga,Mathieu Rodrigues,Jo-Wilfried Tsonga,6-3; 6-4,R16,76,10,1,35,54,30,35,8,19,0,1,10,38,54,4,2,37,70,25,37,14,33,9,12,9,39,70
2011-09-19 00:00:00.000,Metz France ATP World Tour 250,HARD,2,Nicolas Mahut,Arnaud Clement,Nicolas Mahut,3-6; 7-5; 6-3,R16,153,15,3,59,89,45,59,14,30,3,5,15,59,89,11,5,68,114,49,68,19,46,9,12,15,68,114
2011-09-19 00:00:00.000,Metz France ATP World Tour 250,HARD,2,Alexandr Dolgopolov,Marcos Baghdatis,Alexandr Dolgopolov,6-7(5); 7-5; 6-3,R16,141,10,6,61,116,48,61,30,55,6,7,17,78,116,4,2,48,92,35,48,27,44,3,6,16,62,92
2011-09-19 00:00:00.000,Metz France ATP World Tour 250,HARD,2,Xavier Malisse,Igor Kunitsyn,Xavier Malisse,6-4; 6-2,R16,77,5,1,24,48,20,24,9,24,3,5,9,29,48,3,2,38,62,21,38,9,24,3,8,9,30,62
2011-09-19 00:00:00.000,Metz France ATP World Tour 250,HARD,2,Igor Sijsling,Philipp Kohlschreiber,Igor Sijsling,6-4; 7-5,R16,79,10,3,39,63,35,39,12,24,1,1,11,47,63,7,2,31,63,23,31,19,32,5,7,11,42,63
2011-09-19 00:00:00.000,Metz France ATP World Tour 250,HARD,2,Ivan Ljubicic,Nicolas Renavand,Ivan Ljubicic,7-5; 7-5,R16,79,13,0,33,57,29,33,19,24,0,0,12,48,57,4,0,42,66,31,42,12,24,0,2,12,43,66
2011-09-19 00:00:00.000,Metz France ATP World Tour 250,HARD,2,Gilles Muller,Benoit Paire,Gilles Muller,7-6(5); 6-4,R16,92,12,2,42,68,37,42,13,26,0,0,11,50,68,7,3,30,64,22,30,21,34,0,1,11,43,64
2011-09-19 00:00:00.000,Metz France ATP World Tour 250,HARD,2,Richard Gasquet,Olivier Rochus,Richard Gasquet,6-2; 6-1,R16,65,10,3,31,49,28,31,8,18,1,1,8,36,49,0,1,27,47,11,27,12,20,2,6,7,23,47
2011-09-19 00:00:00.000,Metz France ATP World Tour 250,HARD,2,Jo-Wilfried Tsonga,Nicolas Mahut,Jo-Wilfried Tsonga,4-6; 6-3; 7-5,Q,123,20,3,54,84,45,54,19,30,3,4,16,64,84,7,3,57,89,40,57,17,32,1,3,15,57,89
2011-09-19 00:00:00.000,Metz France ATP World Tour 250,HARD,2,Alexandr Dolgopolov,Xavier Malisse,Alexandr Dolgopolov,6-3; 1-0 RET,Q,36,7,0,15,27,14,15,7,12,0,0,5,21,27,0,0,10,25,5,10,9,15,2,4,5,14,25
2011-09-19 00:00:00.000,Metz France ATP World Tour 250,HARD,2,Ivan Ljubicic,Igor Sijsling,Ivan Ljubicic,6-4; 6-3,Q,74,13,0,34,59,26,34,17,25,1,1,10,43,59,6,3,26,52,20,26,14,26,5,7,9,34,52
2011-09-19 00:00:00.000,Metz France ATP World Tour 250,HARD,2,Gilles Muller,Richard Gasquet,Gilles Muller,6-3; 6-4,Q,71,11,2,34,59,28,34,17,25,6,6,10,45,59,4,0,36,47,29,36,3,11,2,4,9,32,47
2011-09-19 00:00:00.000,Metz France ATP World Tour 250,HARD,2,Jo-Wilfried Tsonga,Alexandr Dolgopolov,Jo-Wilfried Tsonga,6-4; 6-4,S,77,6,0,31,52,27,31,12,21,0,1,10,39,52,2,0,31,59,23,31,12,28,0,3,10,35,59
2011-09-19 00:00:00.000,Metz France ATP World Tour 250,HARD,2,Ivan Ljubicic,Gilles Muller,Ivan Ljubicic,7-6(3); 7-6(5),S,111,26,2,51,81,45,51,16,30,1,1,12,61,81,18,2,47,73,42,47,13,26,0,0,12,55,73
2011-09-19 00:00:00.000,Metz France ATP World Tour 250,HARD,2,Jo-Wilfried Tsonga,Ivan Ljubicic,Jo-Wilfried Tsonga,6-3; 6-7(4); 6-3,F,156,14,4,43,80,37,43,17,37,2,4,14,54,80,12,5,55,110,38,55,26,55,7,13,16,64,110
2011-09-26 00:00:00.000,Bangkok Thailand ATP World Tour 250,HARD,2,Andy Murray,N/A Bye,Andy Murray,,R32,0,0,0,0,0,0,0,0,0,0,0,0,0,0,0,0,0,0,0,0,0,0,0,0,0,0,0
2011-09-26 00:00:00.000,Bangkok Thailand ATP World Tour 250,HARD,2,Michael Berrer,Marco Chiudinelli,Michael Berrer,7-6(4); 6-3,R32,93,7,1,48,70,36,48,12,22,7,8,11,48,70,3,2,43,62,29,43,10,19,0,2,10,39,62
2011-09-26 00:00:00.000,Bangkok Thailand ATP World Tour 250,HARD,2,Simone Bolelli,Ernests Gulbis,Simone Bolelli,7-6(5); 7-6(5),R32,116,10,0,52,73,40,52,13,21,1,3,12,53,73,19,4,62,88,45,62,11,26,3,5,12,56,88
2011-09-26 00:00:00.000,Bangkok Thailand ATP World Tour 250,HARD,2,Grigor Dimitrov,Ivan Dodig,Grigor Dimitrov,6-2; 7-5,R32,92,4,2,41,59,32,41,11,18,3,4,10,43,59,3,1,36,61,22,36,12,25,5,9,10,34,61
2011-09-26 00:00:00.000,Bangkok Thailand ATP World Tour 250,HARD,2,Gilles Simon,N/A Bye,Gilles Simon,,R32,0,0,0,0,0,0,0,0,0,0,0,0,0,0,0,0,0,0,0,0,0,0,0,0,0,0,0
2011-09-26 00:00:00.000,Bangkok Thailand ATP World Tour 250,HARD,2,Yen-Hsun Lu,Joao Souza,Yen-Hsun Lu,6-2; 7-5,R32,80,8,2,36,60,27,36,18,24,3,3,10,45,60,11,1,47,60,28,47,5,13,2,5,10,33,60
2011-09-26 00:00:00.000,Bangkok Thailand ATP World Tour 250,HARD,2,Matthias Bachinger,Greg Jones,Matthias Bachinger,7-5; 6-4,R32,96,9,1,43,53,39,43,5,10,0,0,11,44,53,9,0,59,92,39,59,17,33,12,14,11,56,92
2011-09-26 00:00:00.000,Bangkok Thailand ATP World Tour 250,HARD,2,Danai Udomchoke,Fabio Fognini,Danai Udomchoke,6-4; 3-6; 6-2,R32,118,4,3,44,74,31,44,17,30,3,6,13,48,74,4,7,54,88,34,54,16,34,3,8,14,50,88
2011-09-26 00:00:00.000,Bangkok Thailand ATP World Tour 250,HARD,2,Tobias Kamke,Pablo Andujar,Tobias Kamke,6-0; 6-1,R32,56,0,1,25,42,19,25,10,17,0,0,7,29,42,0,3,25,39,11,25,5,14,2,7,6,16,39
2011-09-26 00:00:00.000,Bangkok Thailand ATP World Tour 250,HARD,2,Go Soeda,Karol Beck,Go Soeda,3-6; 7-6(0); 7-6(4),R32,176,1,5,72,121,51,72,21,49,7,10,16,72,121,11,4,65,113,46,65,25,48,5,7,17,71,113
2011-09-26 00:00:00.000,Bangkok Thailand ATP World Tour 250,HARD,2,Donald Young,Igor Andreev,Donald Young,7-6(6); 2-1 RET,R32,83,0,1,45,62,29,45,7,17,2,4,7,36,62,3,2,39,62,20,39,13,23,4,7,8,33,62
2011-09-26 00:00:00.000,Bangkok Thailand ATP World Tour 250,HARD,2,Guillermo Garcia-Lopez,N/A Bye,Guillermo Garcia-Lopez,,R32,0,0,0,0,0,0,0,0,0,0,0,0,0,0,0,0,0,0,0,0,0,0,0,0,0,0,0
2011-09-26 00:00:00.000,Bangkok Thailand ATP World Tour 250,HARD,2,Robin Haase,Kittipong Wachiramanowong,Robin Haase,6-3; 7-6(1),R32,84,9,2,35,61,29,35,12,26,1,3,10,41,61,3,0,48,72,28,48,12,24,7,11,11,40,72
2011-09-26 00:00:00.000,Bangkok Thailand ATP World Tour 250,HARD,2,Jarkko Nieminen,Dominic Thiem,Jarkko Nieminen,6-1; 4-6; 7-5,R32,118,5,3,62,93,41,62,19,31,1,4,15,60,93,3,2,42,85,28,42,19,43,2,7,14,47,85
2011-09-26 00:00:00.000,Bangkok Thailand ATP World Tour 250,HARD,2,Santiago Giraldo,Dudi Sela,Santiago Giraldo,6-2; 6-3,R32,72,7,0,31,49,21,31,14,18,2,3,9,35,49,0,2,39,56,21,39,7,17,3,7,8,28,56
2011-09-26 00:00:00.000,Bangkok Thailand ATP World Tour 250,HARD,2,Gael Monfils,N/A Bye,Gael Monfils,,R32,0,0,0,0,0,0,0,0,0,0,0,0,0,0,0,0,0,0,0,0,0,0,0,0,0,0,0
2011-09-26 00:00:00.000,Bangkok Thailand ATP World Tour 250,HARD,2,Andy Murray,Michael Berrer,Andy Murray,6-4; 6-2,R16,71,3,0,35,53,26,35,14,18,2,2,9,40,53,3,1,36,47,26,36,3,11,4,7,9,29,47
2011-09-26 00:00:00.000,Bangkok Thailand ATP World Tour 250,HARD,2,Grigor Dimitrov,Simone Bolelli,Grigor Dimitrov,7-6(8); 6-1,R16,99,11,3,33,54,29,33,11,21,0,0,9,40,54,1,0,62,79,34,62,8,17,4,7,10,42,79
2011-09-26 00:00:00.000,Bangkok Thailand ATP World Tour 250,HARD,2,Gilles Simon,Yen-Hsun Lu,Gilles Simon,6-7(4); 7-5; 6-4,R16,174,12,1,68,116,47,68,26,48,1,3,17,73,116,11,5,72,116,55,72,18,44,5,9,17,73,116
2011-09-26 00:00:00.000,Bangkok Thailand ATP World Tour 250,HARD,2,Matthias Bachinger,Danai Udomchoke,Matthias Bachinger,7-6(5); 6-3,R16,101,8,1,42,66,30,42,11,24,3,6,10,41,66,0,3,59,85,34,59,9,26,6,11,11,43,85
2011-09-26 00:00:00.000,Bangkok Thailand ATP World Tour 250,HARD,2,Go Soeda,Tobias Kamke,Go Soeda,6-2; 7-6(7),R16,92,3,1,34,66,23,34,20,32,2,4,10,43,66,1,2,38,62,23,38,11,24,2,6,10,34,62
2011-09-26 00:00:00.000,Bangkok Thailand ATP World Tour 250,HARD,2,Donald Young,Guillermo Garcia-Lopez,Donald Young,6-1; 6-7(0); 7-5,R16,159,2,2,63,100,42,63,24,37,4,6,16,66,100,9,0,64,108,37,64,25,44,7,12,15,62,108
2011-09-26 00:00:00.000,Bangkok Thailand ATP World Tour 250,HARD,2,Jarkko Nieminen,Robin Haase,Jarkko Nieminen,7-6(5); 7-6(4),R16,97,3,1,59,80,40,59,11,21,0,3,12,51,80,11,4,49,77,38,49,11,28,1,4,12,49,77
2011-09-26 00:00:00.000,Bangkok Thailand ATP World Tour 250,HARD,2,Gael Monfils,Santiago Giraldo,Gael Monfils,6-4; 4-6; 6-1,R16,119,11,5,52,86,39,52,20,34,5,6,13,59,86,2,3,59,98,35,59,22,39,5,9,14,57,98
2011-09-26 00:00:00.000,Bangkok Thailand ATP World Tour 250,HARD,2,Andy Murray,Grigor Dimitrov,Andy Murray,6-4; 6-4,Q,89,2,0,31,59,23,31,20,28,3,3,10,43,59,4,3,36,58,26,36,11,22,1,3,10,37,58
2011-09-26 00:00:00.000,Bangkok Thailand ATP World Tour 250,HARD,2,Gilles Simon,Matthias Bachinger,Gilles Simon,3-6; 6-3; 6-2,Q,96,2,4,60,92,45,60,15,32,6,7,13,60,92,12,5,48,77,37,48,12,29,3,6,13,49,77
2011-09-26 00:00:00.000,Bangkok Thailand ATP World Tour 250,HARD,2,Donald Young,Go Soeda,Donald Young,6-1; 6-2,Q,56,4,0,35,40,28,35,4,5,0,0,8,32,40,5,1,22,43,9,22,10,21,4,8,7,19,43
2011-09-26 00:00:00.000,Bangkok Thailand ATP World Tour 250,HARD,2,Gael Monfils,Jarkko Nieminen,Gael Monfils,7-5; 7-6(4),Q,97,8,3,60,73,44,60,4,13,0,2,12,48,73,2,0,53,83,34,53,16,30,4,7,12,50,83
2011-09-26 00:00:00.000,Bangkok Thailand ATP World Tour 250,HARD,2,Andy Murray,Gilles Simon,Andy Murray,6-2; 3-6; 6-2,S,113,7,0,42,64,32,42,11,22,0,2,12,43,64,5,1,49,79,28,49,17,30,5,10,13,45,79
2011-09-26 00:00:00.000,Bangkok Thailand ATP World Tour 250,HARD,2,Donald Young,Gael Monfils,Donald Young,4-6; 7-6(5); 7-6(5),S,167,0,3,80,110,48,80,16,30,5,10,17,64,110,13,8,76,127,46,76,29,51,6,10,17,75,127
2011-09-26 00:00:00.000,Bangkok Thailand ATP World Tour 250,HARD,2,Andy Murray,Donald Young,Andy Murray,6-2; 6-0,F,48,5,0,28,37,23,28,6,9,0,0,7,29,37,0,1,25,34,8,25,4,9,0,5,7,12,34
2011-09-26 00:00:00.000,Kuala Lumpur Malaysia ATP World Tour 250,HARD,2,Nicolas Almagro,N/A Bye,Nicolas Almagro,,R32,0,0,0,0,0,0,0,0,0,0,0,0,0,0,0,0,0,0,0,0,0,0,0,0,0,0,0
2011-09-26 00:00:00.000,Kuala Lumpur Malaysia ATP World Tour 250,HARD,2,Albert Ramos,Mikhail Kukushkin,Albert Ramos,4-6; 6-3; 4-2 RET,R32,130,4,4,46,81,33,46,21,35,4,6,13,54,81,4,2,53,87,35,53,16,34,5,8,12,51,87
2011-09-26 00:00:00.000,Kuala Lumpur Malaysia ATP World Tour 250,HARD,2,Philipp Petzschner,Mischa Zverev,Philipp Petzschner,7-5; 6-3,R32,73,4,3,29,54,21,29,16,25,3,5,10,37,54,2,3,49,77,28,49,10,28,3,8,11,38,77
2011-09-26 00:00:00.000,Kuala Lumpur Malaysia ATP World Tour 250,HARD,2,Kei Nishikori,Teymuraz Gabashvili,Kei Nishikori,3-6; 6-4; 6-1,R32,132,2,1,50,86,33,50,18,36,7,11,13,51,86,4,6,48,82,29,48,14,34,7,13,13,43,82
2011-09-26 00:00:00.000,Kuala Lumpur Malaysia ATP World Tour 250,HARD,2,Janko Tipsarevic,N/A Bye,Janko Tipsarevic,,R32,0,0,0,0,0,0,0,0,0,0,0,0,0,0,0,0,0,0,0,0,0,0,0,0,0,0,0
2011-09-26 00:00:00.000,Kuala Lumpur Malaysia ATP World Tour 250,HARD,2,Flavio Cipolla,Bernard Tomic,Flavio Cipolla,6-2; 6-2,R32,73,0,3,41,54,29,41,7,13,5,6,8,36,54,3,3,30,47,17,30,5,17,3,8,8,22,47
2011-09-26 00:00:00.000,Kuala Lumpur Malaysia ATP World Tour 250,HARD,2,Lukasz Kubot,Lukas Rosol,Lukasz Kubot,6-3; 6-3,R32,78,4,6,31,53,26,31,11,22,4,5,9,37,53,3,4,33,63,21,33,14,30,4,8,9,35,63
2011-09-26 00:00:00.000,Kuala Lumpur Malaysia ATP World Tour 250,HARD,2,Nikolay Davydenko,Ryan Harrison,Nikolay Davydenko,6-3; 6-2,R32,89,1,5,38,63,20,38,13,25,9,12,8,33,63,2,3,37,59,14,37,10,22,4,11,9,24,59
2011-09-26 00:00:00.000,Kuala Lumpur Malaysia ATP World Tour 250,HARD,2,Marcos Baghdatis,Alex Bogomolov Jr.,Marcos Baghdatis,7-6(3); 6-4,R32,105,6,3,35,69,26,35,24,34,2,2,11,50,69,2,1,49,65,34,49,10,16,2,3,11,44,65
2011-09-26 00:00:00.000,Kuala Lumpur Malaysia ATP World Tour 250,HARD,2,Somdev Devvarman,Mikhail Ledovskikh,Somdev Devvarman,7-6(5); 6-4,R32,100,5,1,36,60,30,36,16,24,0,1,11,46,60,8,3,47,81,36,47,14,34,4,6,11,50,81
2011-09-26 00:00:00.000,Kuala Lumpur Malaysia ATP World Tour 250,HARD,2,Rik De Voest,Ryan Sweeting,Rik De Voest,4-6; 6-3; 6-3,R32,133,1,2,69,102,49,69,14,33,8,11,14,63,102,5,11,47,85,35,47,14,38,3,8,14,49,85
2011-09-26 00:00:00.000,Kuala Lumpur Malaysia ATP World Tour 250,HARD,2,Jurgen Melzer,N/A Bye,Jurgen Melzer,,R32,0,0,0,0,0,0,0,0,0,0,0,0,0,0,0,0,0,0,0,0,0,0,0,0,0,0,0
2011-09-26 00:00:00.000,Kuala Lumpur Malaysia ATP World Tour 250,HARD,2,Dmitry Tursunov,Paul Capdeville,Dmitry Tursunov,6-2; 2-6; 6-1,R32,134,7,4,57,96,37,57,20,39,4,6,12,57,96,8,5,58,88,36,58,12,30,10,14,11,48,88
2011-09-26 00:00:00.000,Kuala Lumpur Malaysia ATP World Tour 250,HARD,2,David Goffin,Matthew Ebden,David Goffin,6-4; 7-6(4),R32,96,2,2,36,71,28,36,20,35,3,4,11,48,71,8,1,42,63,33,42,9,21,1,3,11,42,63
2011-09-26 00:00:00.000,Kuala Lumpur Malaysia ATP World Tour 250,HARD,2,Denis Istomin,Marinko Matosevic,Denis Istomin,6-3; 6-2,R32,74,4,1,38,60,32,38,10,22,1,1,9,42,60,6,4,43,63,29,43,5,20,7,10,8,34,63
2011-09-26 00:00:00.000,Kuala Lumpur Malaysia ATP World Tour 250,HARD,2,Viktor Troicki,N/A Bye,Viktor Troicki,,R32,0,0,0,0,0,0,0,0,0,0,0,0,0,0,0,0,0,0,0,0,0,0,0,0,0,0,0
2011-09-26 00:00:00.000,Kuala Lumpur Malaysia ATP World Tour 250,HARD,2,Nicolas Almagro,Albert Ramos,Nicolas Almagro,7-6(2); 7-6(4),R16,103,5,4,42,87,35,42,23,45,1,3,12,58,87,5,2,52,86,33,52,21,34,1,3,12,54,86
2011-09-26 00:00:00.000,Kuala Lumpur Malaysia ATP World Tour 250,HARD,2,Kei Nishikori,Philipp Petzschner,Kei Nishikori,6-3; 4-6; 7-5,R16,139,6,5,68,108,44,68,20,40,3,7,16,64,108,5,1,48,89,37,48,14,41,1,6,15,51,89
2011-09-26 00:00:00.000,Kuala Lumpur Malaysia ATP World Tour 250,HARD,2,Janko Tipsarevic,Flavio Cipolla,Janko Tipsarevic,6-2; 6-4,R16,94,5,1,25,45,22,25,11,20,1,2,9,33,45,0,0,59,73,32,59,6,14,13,17,9,38,73
2011-09-26 00:00:00.000,Kuala Lumpur Malaysia ATP World Tour 250,HARD,2,Nikolay Davydenko,Lukasz Kubot,Nikolay Davydenko,6-3; 7-6(2),R16,96,2,4,46,65,32,46,9,19,0,3,11,41,65,5,6,44,70,28,44,8,26,2,6,10,36,70
2011-09-26 00:00:00.000,Kuala Lumpur Malaysia ATP World Tour 250,HARD,2,Marcos Baghdatis,Somdev Devvarman,Marcos Baghdatis,7-5; 6-4,R16,105,6,3,43,79,33,43,15,36,10,12,11,48,79,3,1,49,74,28,49,13,25,2,6,11,41,74
2011-09-26 00:00:00.000,Kuala Lumpur Malaysia ATP World Tour 250,HARD,2,Jurgen Melzer,Rik De Voest,Jurgen Melzer,6-0; 6-4,R16,64,4,0,37,49,32,37,5,12,1,1,8,37,49,2,1,35,52,22,35,7,17,4,8,8,29,52
2011-09-26 00:00:00.000,Kuala Lumpur Malaysia ATP World Tour 250,HARD,2,Dmitry Tursunov,David Goffin,Dmitry Tursunov,6-3; 6-3,R16,84,8,4,44,73,32,44,16,29,10,10,9,48,73,6,4,31,54,24,31,8,23,3,6,9,32,54
2011-09-26 00:00:00.000,Kuala Lumpur Malaysia ATP World Tour 250,HARD,2,Viktor Troicki,Denis Istomin,Viktor Troicki,6-1; 6-4,R16,78,4,1,28,54,22,28,16,26,3,3,8,38,54,2,0,45,67,26,45,10,22,7,11,9,36,67
2011-09-26 00:00:00.000,Kuala Lumpur Malaysia ATP World Tour 250,HARD,2,Kei Nishikori,Nicolas Almagro,Kei Nishikori,6-7(5); 6-4; 6-4,Q,135,5,4,66,109,45,66,25,43,3,5,16,70,109,2,5,53,97,38,53,24,44,2,6,16,62,97
2011-09-26 00:00:00.000,Kuala Lumpur Malaysia ATP World Tour 250,HARD,2,Janko Tipsarevic,Nikolay Davydenko,Janko Tipsarevic,3-1 RET,Q,22,1,1,4,8,3,4,1,4,0,1,2,4,8,0,0,10,11,3,10,0,1,1,3,2,3,11
2011-09-26 00:00:00.000,Kuala Lumpur Malaysia ATP World Tour 250,HARD,2,Marcos Baghdatis,Jurgen Melzer,Marcos Baghdatis,6-3; 7-6(3),Q,89,13,2,40,67,34,40,17,27,4,4,11,51,67,4,1,38,63,25,38,17,25,5,6,10,42,63
2011-09-26 00:00:00.000,Kuala Lumpur Malaysia ATP World Tour 250,HARD,2,Viktor Troicki,Dmitry Tursunov,Viktor Troicki,6-4; 6-4,Q,77,8,3,33,57,26,33,9,24,1,4,10,35,57,3,1,34,51,18,34,7,17,2,7,10,25,51
2011-09-26 00:00:00.000,Kuala Lumpur Malaysia ATP World Tour 250,HARD,2,Janko Tipsarevic,Kei Nishikori,Janko Tipsarevic,6-4; 6-3,S,110,4,2,40,60,33,40,10,20,6,6,9,43,60,3,1,33,59,23,33,14,26,1,4,10,37,59
2011-09-26 00:00:00.000,Kuala Lumpur Malaysia ATP World Tour 250,HARD,2,Marcos Baghdatis,Viktor Troicki,Marcos Baghdatis,6-3; 6-1,S,84,3,0,29,61,18,29,17,32,5,7,8,35,61,1,2,23,48,13,23,4,25,1,7,8,17,48
2011-09-26 00:00:00.000,Kuala Lumpur Malaysia ATP World Tour 250,HARD,2,Janko Tipsarevic,Marcos Baghdatis,Janko Tipsarevic,6-4; 7-5,F,126,9,0,40,79,27,40,21,39,8,11,11,48,79,9,2,35,75,25,35,15,40,6,11,11,40,75
2011-10-03 00:00:00.000,Beijing China ATP World Tour 500,HARD,2,Jo-Wilfried Tsonga,Grigor Dimitrov,Jo-Wilfried Tsonga,7-6(5); 7-5,R32,108,9,3,50,79,38,50,19,29,2,3,12,57,79,7,0,43,64,32,43,16,21,2,4,12,48,64
2011-10-03 00:00:00.000,Beijing China ATP World Tour 500,HARD,2,Ze Zhang,Zhe Li,Ze Zhang,6-1; 6-3,R32,74,3,4,27,46,24,27,10,19,2,2,8,34,46,2,3,43,57,26,43,4,14,5,9,8,30,57
2011-10-03 00:00:00.000,Beijing China ATP World Tour 500,HARD,2,Juan Carlos Ferrero,Thomaz Bellucci,Juan Carlos Ferrero,6-1; 7-6(4),R32,84,2,3,34,62,34,34,14,28,4,4,10,48,62,6,1,39,63,29,39,10,24,2,4,9,39,63
2011-10-03 00:00:00.000,Beijing China ATP World Tour 500,HARD,2,Marcel Granollers,Gilles Simon,Marcel Granollers,6-3; 6-1,R32,69,1,0,29,44,21,29,10,15,2,3,8,31,44,1,7,19,47,12,19,9,28,0,5,8,21,47
2011-10-03 00:00:00.000,Beijing China ATP World Tour 500,HARD,2,Tomas Berdych,Jurgen Melzer,Tomas Berdych,7-5; 7-5,R32,97,5,2,36,68,28,36,24,32,3,3,12,52,68,4,3,46,68,33,46,11,22,1,3,12,44,68
2011-10-03 00:00:00.000,Beijing China ATP World Tour 500,HARD,2,Philipp Kohlschreiber,Tommy Robredo,Philipp Kohlschreiber,6-3; 7-6(0),R32,93,1,3,38,68,30,38,17,30,3,4,10,47,68,5,4,35,65,26,35,10,30,0,3,11,36,65
2011-10-03 00:00:00.000,Beijing China ATP World Tour 500,HARD,2,Fernando Verdasco,Michael Llodra,Fernando Verdasco,6-2; 6-4,R32,72,3,1,36,42,33,36,3,6,0,0,9,36,42,4,4,34,65,28,34,9,31,7,10,9,37,65
2011-10-03 00:00:00.000,Beijing China ATP World Tour 500,HARD,2,Flavio Cipolla,Alexandr Dolgopolov,Flavio Cipolla,6-1; 1-6; 6-0,R32,95,1,3,42,72,28,42,17,30,5,7,10,45,72,3,7,30,68,20,30,16,38,7,12,10,36,68
2011-10-03 00:00:00.000,Beijing China ATP World Tour 500,HARD,2,Ivan Ljubicic,Teymuraz Gabashvili,Ivan Ljubicic,7-5; 7-5,R32,98,14,3,37,56,30,37,10,19,0,3,12,40,56,4,6,41,75,25,41,15,34,3,8,12,40,75
2011-10-03 00:00:00.000,Beijing China ATP World Tour 500,HARD,2,Florian Mayer,Albert Ramos,Florian Mayer,6-2; 6-4,R32,72,1,3,33,54,27,33,12,21,4,4,9,39,54,2,3,39,65,25,39,11,26,7,10,9,36,65
2011-10-03 00:00:00.000,Beijing China ATP World Tour 500,HARD,2,Feliciano Lopez,Marsel Ilhan,Feliciano Lopez,6-2; 7-6(6),R32,99,10,3,37,65,33,37,18,28,3,3,10,51,65,11,4,42,77,30,42,21,35,3,5,10,51,77
2011-10-03 00:00:00.000,Beijing China ATP World Tour 500,HARD,2,Mikhail Youzhny,Nicolas Almagro,Mikhail Youzhny,6-3; 6-2,R32,69,3,3,25,49,20,25,12,24,4,5,8,32,49,7,2,26,57,21,26,7,31,5,10,9,28,57
2011-10-03 00:00:00.000,Beijing China ATP World Tour 500,HARD,2,Kevin Anderson,Andy Roddick,Kevin Anderson,6-4; 7-5,R32,102,8,1,39,62,32,39,11,23,4,6,11,43,62,5,1,46,64,30,46,7,18,6,10,11,37,64
2011-10-03 00:00:00.000,Beijing China ATP World Tour 500,HARD,2,Albert Montanes,Paul Capdeville,Albert Montanes,6-3; 6-3,R32,53,12,1,25,47,24,25,13,22,1,1,9,37,47,5,4,25,54,14,25,18,29,2,5,9,32,54
2011-10-03 00:00:00.000,Beijing China ATP World Tour 500,HARD,2,Marin Cilic,Di Wu,Marin Cilic,6-2; 6-0,R32,55,3,3,17,33,15,17,9,16,0,1,7,24,33,0,1,28,44,11,28,5,16,3,9,7,16,44
2011-10-03 00:00:00.000,Beijing China ATP World Tour 500,HARD,2,Fabio Fognini,Grega Zemlja,Fabio Fognini,6-4; 6-1,R32,68,4,3,33,50,25,33,10,17,1,1,8,35,50,1,5,36,60,21,36,11,24,5,9,9,32,60
2011-10-03 00:00:00.000,Beijing China ATP World Tour 500,HARD,2,Jo-Wilfried Tsonga,Ze Zhang,Jo-Wilfried Tsonga,6-3; 6-4,R16,76,8,1,34,57,28,34,13,23,3,4,10,41,57,4,5,37,60,24,37,9,23,4,7,9,33,60
2011-10-03 00:00:00.000,Beijing China ATP World Tour 500,HARD,2,Juan Carlos Ferrero,Marcel Granollers,Juan Carlos Ferrero,6-4; 6-4,R16,98,5,4,33,62,27,33,18,29,3,3,10,45,62,6,2,34,61,26,34,13,27,2,4,10,39,61
2011-10-03 00:00:00.000,Beijing China ATP World Tour 500,HARD,2,Tomas Berdych,Philipp Kohlschreiber,Tomas Berdych,6-2; 6-0,R16,63,4,3,17,38,14,17,13,21,1,2,7,27,38,3,2,26,54,14,26,7,28,7,13,7,21,54
2011-10-03 00:00:00.000,Beijing China ATP World Tour 500,HARD,2,Fernando Verdasco,Flavio Cipolla,Fernando Verdasco,2-6; 6-1; 6-2,R16,104,2,2,52,65,36,52,6,13,2,5,12,42,65,0,2,51,70,28,51,9,19,3,8,11,37,70
2011-10-03 00:00:00.000,Beijing China ATP World Tour 500,HARD,2,Ivan Ljubicic,Florian Mayer,Ivan Ljubicic,6-0; 2-6; 6-3,R16,113,13,1,30,64,28,30,17,34,2,4,12,45,64,6,2,35,67,24,35,15,32,4,8,11,39,67
2011-10-03 00:00:00.000,Beijing China ATP World Tour 500,HARD,2,Mikhail Youzhny,Feliciano Lopez,Mikhail Youzhny,6-7(5); 6-2; 7-5,R16,144,4,8,59,105,43,59,22,46,7,10,16,65,105,20,10,55,100,41,55,20,45,4,10,16,61,100
2011-10-03 00:00:00.000,Beijing China ATP World Tour 500,HARD,2,Kevin Anderson,Albert Montanes,Kevin Anderson,7-6(3); 7-6(4),R16,129,13,5,57,89,45,57,11,32,3,6,12,56,89,3,10,46,89,30,46,21,43,5,8,12,51,89
2011-10-03 00:00:00.000,Beijing China ATP World Tour 500,HARD,2,Marin Cilic,Fabio Fognini,Marin Cilic,6-2; 6-7(1); 6-3,R16,114,8,3,38,70,31,38,16,32,0,3,14,47,70,0,9,59,101,36,59,16,42,6,13,15,52,101
2011-10-03 00:00:00.000,Beijing China ATP World Tour 500,HARD,2,Jo-Wilfried Tsonga,Juan Carlos Ferrero,Jo-Wilfried Tsonga,6-3; 6-4,Q,71,10,3,36,58,32,36,11,22,0,0,10,43,58,0,1,33,45,23,33,7,12,0,2,9,30,45
2011-10-03 00:00:00.000,Beijing China ATP World Tour 500,HARD,2,Tomas Berdych,Fernando Verdasco,Tomas Berdych,6-1; 6-0,Q,66,1,1,25,41,17,25,11,16,0,1,7,28,41,0,5,27,45,11,27,4,18,2,8,6,15,45
2011-10-03 00:00:00.000,Beijing China ATP World Tour 500,HARD,2,Ivan Ljubicic,Mikhail Youzhny,Ivan Ljubicic,7-6(4); 6-7(4); 6-2,Q,172,17,4,55,103,45,55,23,48,4,7,16,68,103,1,9,70,129,43,70,30,59,15,20,16,73,129
2011-10-03 00:00:00.000,Beijing China ATP World Tour 500,HARD,2,Marin Cilic,Kevin Anderson,Marin Cilic,7-6(4); 4-6; 6-1,Q,144,6,4,51,93,38,51,21,42,3,6,15,59,93,7,5,63,100,46,63,13,37,6,10,14,59,100
2011-10-03 00:00:00.000,Beijing China ATP World Tour 500,HARD,2,Tomas Berdych,Jo-Wilfried Tsonga,Tomas Berdych,6-4; 4-6; 6-1,S,127,8,4,48,77,42,48,14,29,0,1,14,56,77,10,2,52,86,38,52,14,34,6,9,13,52,86
2011-10-03 00:00:00.000,Beijing China ATP World Tour 500,HARD,2,Marin Cilic,Ivan Ljubicic,Marin Cilic,6-4; 6-3,S,98,13,1,34,61,28,34,14,27,7,7,9,42,61,9,2,34,66,24,34,14,32,6,9,10,38,66
2011-10-03 00:00:00.000,Beijing China ATP World Tour 500,HARD,2,Tomas Berdych,Marin Cilic,Tomas Berdych,3-6; 6-4; 6-1,F,121,7,1,52,84,37,52,18,32,3,5,13,55,84,7,1,37,71,21,37,23,34,1,5,13,44,71
2011-10-03 00:00:00.000,Tokyo Japan ATP World Tour 500,HARD,2,Rafael Nadal,Go Soeda,Rafael Nadal,6-3; 6-2,R32,91,3,0,44,52,30,44,5,8,3,3,8,35,52,0,0,34,60,15,34,16,26,4,8,9,31,60
2011-10-03 00:00:00.000,Tokyo Japan ATP World Tour 500,HARD,2,Milos Raonic,Yuichi Sugita,Milos Raonic,6-7(4); 6-3; 7-6(1),R32,132,16,2,78,102,63,78,10,24,1,2,17,73,102,3,3,68,95,52,68,12,27,3,5,16,64,95
2011-10-03 00:00:00.000,Tokyo Japan ATP World Tour 500,HARD,2,Santiago Giraldo,Robin Haase,Santiago Giraldo,6-3; 7-6(5),R32,84,4,1,54,78,44,54,14,24,4,4,11,58,78,8,1,40,62,32,40,11,22,0,1,10,43,62
2011-10-03 00:00:00.000,Tokyo Japan ATP World Tour 500,HARD,2,Dmitry Tursunov,Janko Tipsarevic,Dmitry Tursunov,7-6(6); 6-7(3); 7-5,R32,181,14,5,76,124,50,76,26,48,5,9,18,76,124,13,4,72,108,50,72,19,36,1,6,18,69,108
2011-10-03 00:00:00.000,Tokyo Japan ATP World Tour 500,HARD,2,Mardy Fish,Ryan Harrison,Mardy Fish,6-4; 3-6; 7-5,R32,164,2,2,70,108,46,70,21,38,11,15,16,67,108,7,4,59,99,37,59,20,40,7,11,15,57,99
2011-10-03 00:00:00.000,Tokyo Japan ATP World Tour 500,HARD,2,Ernests Gulbis,Lukasz Kubot,Ernests Gulbis,6-3; 3-6; 7-5,R32,150,16,3,56,90,46,56,19,34,3,4,15,65,90,2,2,65,105,49,65,17,40,7,9,15,66,105
2011-10-03 00:00:00.000,Tokyo Japan ATP World Tour 500,HARD,2,Tatsuma Ito,Dudi Sela,Tatsuma Ito,6-4; 3-6; 6-3,R32,132,2,1,52,78,33,52,15,26,3,7,14,48,78,3,1,62,99,36,62,20,37,10,15,14,56,99
2011-10-03 00:00:00.000,Tokyo Japan ATP World Tour 500,HARD,2,Bernard Tomic,Viktor Troicki,Bernard Tomic,7-6(6); 7-6(1),R32,103,2,2,53,75,41,53,15,22,4,5,12,56,75,7,2,49,83,40,49,15,34,5,6,12,55,83
2011-10-03 00:00:00.000,Tokyo Japan ATP World Tour 500,HARD,2,Radek Stepanek,Somdev Devvarman,Radek Stepanek,6-4; 6-3,R32,92,2,1,36,56,25,36,13,20,5,7,10,38,56,1,0,42,60,22,42,11,18,4,8,9,33,60
2011-10-03 00:00:00.000,Tokyo Japan ATP World Tour 500,HARD,2,Marco Chiudinelli,Guillermo Garcia-Lopez,Marco Chiudinelli,6-1; 4-6; 6-4,R32,148,6,1,74,100,47,74,11,26,7,10,14,58,100,3,4,35,80,21,35,24,45,3,8,13,45,80
2011-10-03 00:00:00.000,Tokyo Japan ATP World Tour 500,HARD,2,Matthew Ebden,Pablo Andujar,Matthew Ebden,6-7(4); 6-4; 6-4,R32,147,8,4,72,107,53,72,19,35,7,8,16,72,107,0,5,65,104,49,65,18,39,5,8,16,67,104
2011-10-03 00:00:00.000,Tokyo Japan ATP World Tour 500,HARD,2,David Ferrer,Kei Nishikori,David Ferrer,6-4; 6-3,R32,89,1,2,43,67,32,43,10,24,5,7,10,42,67,4,2,39,59,23,39,9,20,6,10,9,32,59
2011-10-03 00:00:00.000,Tokyo Japan ATP World Tour 500,HARD,2,Ivan Dodig,Juan Monaco,Ivan Dodig,6-2; 2-6; 7-6(1),R32,163,8,3,52,99,40,52,22,47,6,9,14,62,99,0,3,55,88,34,55,21,33,3,6,14,55,88
2011-10-03 00:00:00.000,Tokyo Japan ATP World Tour 500,HARD,2,David Nalbandian,Lukas Rosol,David Nalbandian,6-1; 6-1,R32,49,5,1,20,34,17,20,11,14,0,0,7,28,34,5,2,32,53,17,32,7,21,12,17,7,24,53
2011-10-03 00:00:00.000,Tokyo Japan ATP World Tour 500,HARD,2,Alex Bogomolov Jr.,Jarkko Nieminen,Alex Bogomolov Jr.,6-4; 6-4,R32,93,3,1,44,53,31,44,6,9,2,3,10,37,53,2,1,55,78,31,55,14,23,7,10,10,45,78
2011-10-03 00:00:00.000,Tokyo Japan ATP World Tour 500,HARD,2,Andy Murray,Marcos Baghdatis,Andy Murray,7-6(4); 2-6; 6-4,R32,153,8,1,51,93,38,51,21,42,4,8,15,59,93,6,3,69,117,47,69,21,48,6,9,15,68,117
2011-10-03 00:00:00.000,Tokyo Japan ATP World Tour 500,HARD,2,Rafael Nadal,Milos Raonic,Rafael Nadal,7-5; 6-3,R16,91,2,1,43,56,33,43,12,13,0,0,11,45,56,8,1,28,50,24,28,11,22,0,2,10,35,50
2011-10-03 00:00:00.000,Tokyo Japan ATP World Tour 500,HARD,2,Santiago Giraldo,Dmitry Tursunov,Santiago Giraldo,6-4; 7-6(4),R16,118,6,1,46,71,32,46,17,25,1,2,11,49,71,9,4,52,73,34,52,13,21,5,7,11,47,73
2011-10-03 00:00:00.000,Tokyo Japan ATP World Tour 500,HARD,2,Mardy Fish,Ernests Gulbis,Mardy Fish,6-2; 6-4,R16,77,4,0,29,51,25,29,13,22,3,3,9,38,51,7,3,37,57,26,37,7,20,3,6,9,33,57
2011-10-03 00:00:00.000,Tokyo Japan ATP World Tour 500,HARD,2,Bernard Tomic,Tatsuma Ito,Bernard Tomic,6-7(4); 6-1; 7-5,R16,144,15,1,72,99,52,72,13,27,7,9,15,65,99,10,5,61,114,38,61,25,53,13,19,16,63,114
2011-10-03 00:00:00.000,Tokyo Japan ATP World Tour 500,HARD,2,Radek Stepanek,Marco Chiudinelli,Radek Stepanek,7-5; 6-7(5); 6-1,R16,148,10,3,78,105,59,78,11,27,7,9,16,70,105,3,3,64,102,42,64,16,38,7,12,15,58,102
2011-10-03 00:00:00.000,Tokyo Japan ATP World Tour 500,HARD,2,David Ferrer,Matthew Ebden,David Ferrer,4-6; 6-2; 6-2,R16,116,6,4,44,72,28,44,16,28,2,5,13,44,72,4,3,47,85,30,47,14,38,2,8,13,44,85
2011-10-03 00:00:00.000,Tokyo Japan ATP World Tour 500,HARD,2,David Nalbandian,Ivan Dodig,David Nalbandian,7-6(2); 6-2,R16,115,2,3,34,70,24,34,19,36,3,6,10,43,70,14,4,47,82,29,47,11,35,7,12,10,40,82
2011-10-03 00:00:00.000,Tokyo Japan ATP World Tour 500,HARD,2,Andy Murray,Alex Bogomolov Jr.,Andy Murray,6-1; 6-2,R16,58,11,0,22,35,21,22,7,13,0,0,7,28,35,0,2,33,47,16,33,4,14,3,8,8,20,47
2011-10-03 00:00:00.000,Tokyo Japan ATP World Tour 500,HARD,2,Rafael Nadal,Santiago Giraldo,Rafael Nadal,7-6(6); 6-3,Q,123,5,0,48,70,37,48,15,22,3,4,11,52,70,2,0,41,66,24,41,17,25,2,4,10,41,66
2011-10-03 00:00:00.000,Tokyo Japan ATP World Tour 500,HARD,2,Mardy Fish,Bernard Tomic,Mardy Fish,6-7(5); 6-4; 6-1,Q,131,10,2,51,85,41,51,14,34,3,5,14,55,85,7,5,65,103,44,65,12,38,3,9,15,56,103
2011-10-03 00:00:00.000,Tokyo Japan ATP World Tour 500,HARD,2,David Ferrer,Radek Stepanek,David Ferrer,6-2; 7-6(3),Q,104,3,3,49,82,34,49,20,33,5,6,10,54,82,3,1,44,64,27,44,10,20,3,6,10,37,64
2011-10-03 00:00:00.000,Tokyo Japan ATP World Tour 500,HARD,2,Andy Murray,David Nalbandian,Andy Murray,6-4; 7-5,Q,99,9,3,33,60,28,33,14,27,1,3,11,42,60,3,2,48,71,33,48,6,23,4,8,11,39,71
2011-10-03 00:00:00.000,Tokyo Japan ATP World Tour 500,HARD,2,Rafael Nadal,Mardy Fish,Rafael Nadal,7-5; 6-1,S,96,2,1,28,48,20,28,17,20,0,0,9,37,48,5,0,37,63,24,37,13,26,2,6,10,37,63
2011-10-03 00:00:00.000,Tokyo Japan ATP World Tour 500,HARD,2,Andy Murray,David Ferrer,Andy Murray,6-2; 6-3,S,81,4,0,25,48,21,25,14,23,1,1,8,35,48,2,3,36,57,17,36,11,21,2,6,9,28,57
2011-10-03 00:00:00.000,Tokyo Japan ATP World Tour 500,HARD,2,Andy Murray,Rafael Nadal,Andy Murray,3-6; 6-2; 6-0,F,136,6,1,39,64,31,39,16,25,5,6,11,47,64,3,0,53,77,23,53,17,24,4,9,12,40,77
2011-10-09 00:00:00.000,ATP World Tour Masters 1000 Shanghai Shanghai; China ATP World Tour Masters 1000,HARD,2,Rafael Nadal,N/A Bye,Rafael Nadal,,R64,0,0,0,0,0,0,0,0,0,0,0,0,0,0,0,0,0,0,0,0,0,0,0,0,0,0,0
2011-10-09 00:00:00.000,ATP World Tour Masters 1000 Shanghai Shanghai; China ATP World Tour Masters 1000,HARD,2,Guillermo Garcia-Lopez,Somdev Devvarman,Guillermo Garcia-Lopez,6-4; 6-3,R64,87,2,4,26,66,20,26,22,40,6,7,10,42,66,2,1,24,53,20,24,11,29,2,5,9,31,53
2011-10-09 00:00:00.000,ATP World Tour Masters 1000 Shanghai Shanghai; China ATP World Tour Masters 1000,HARD,2,David Nalbandian,Ernests Gulbis,David Nalbandian,7-5; 6-4,R64,92,6,3,36,67,30,36,17,31,2,3,11,47,67,10,9,38,69,31,38,11,31,9,12,11,42,69
2011-10-09 00:00:00.000,ATP World Tour Masters 1000 Shanghai Shanghai; China ATP World Tour Masters 1000,HARD,2,Florian Mayer,Fabio Fognini,Florian Mayer,6-0; 6-2,R64,48,4,0,19,35,18,19,11,16,0,0,7,29,35,1,3,26,41,12,26,4,15,1,6,7,16,41
2011-10-09 00:00:00.000,ATP World Tour Masters 1000 Shanghai Shanghai; China ATP World Tour Masters 1000,HARD,2,Feliciano Lopez,Janko Tipsarevic,Feliciano Lopez,7-6(2); 7-6(3),R64,123,12,3,37,78,30,37,24,41,2,4,12,54,78,7,4,48,84,29,48,23,36,4,6,12,52,84
2011-10-09 00:00:00.000,ATP World Tour Masters 1000 Shanghai Shanghai; China ATP World Tour Masters 1000,HARD,2,Alex Bogomolov Jr.,Marcel Granollers,Alex Bogomolov Jr.,6-2; 6-3,R64,82,1,0,39,55,25,39,13,16,6,6,8,38,55,1,5,31,57,20,31,10,26,2,6,9,30,57
2011-10-09 00:00:00.000,ATP World Tour Masters 1000 Shanghai Shanghai; China ATP World Tour Masters 1000,HARD,2,Radek Stepanek,Ze Zhang,Radek Stepanek,6-3; 6-3,R64,69,5,1,38,56,28,38,12,18,2,3,9,40,56,3,4,35,53,22,35,6,18,4,8,9,28,53
2011-10-09 00:00:00.000,ATP World Tour Masters 1000 Shanghai Shanghai; China ATP World Tour Masters 1000,HARD,2,Tomas Berdych,N/A Bye,Tomas Berdych,,R64,0,0,0,0,0,0,0,0,0,0,0,0,0,0,0,0,0,0,0,0,0,0,0,0,0,0,0
2011-10-09 00:00:00.000,ATP World Tour Masters 1000 Shanghai Shanghai; China ATP World Tour Masters 1000,HARD,2,David Ferrer,N/A Bye,David Ferrer,,R64,0,0,0,0,0,0,0,0,0,0,0,0,0,0,0,0,0,0,0,0,0,0,0,0,0,0,0
2011-10-09 00:00:00.000,ATP World Tour Masters 1000 Shanghai Shanghai; China ATP World Tour Masters 1000,HARD,2,Milos Raonic,Michael Llodra,Milos Raonic,6-7(2); 6-2; 7-6(5),R64,138,11,1,71,108,52,71,22,37,7,8,16,74,108,3,8,73,117,53,73,23,44,11,14,16,76,117
2011-10-09 00:00:00.000,ATP World Tour Masters 1000 Shanghai Shanghai; China ATP World Tour Masters 1000,HARD,2,Juan Carlos Ferrero,Mikhail Youzhny,Juan Carlos Ferrero,7-6(4); 6-4,R64,112,4,0,38,65,30,38,21,27,3,3,11,51,65,6,5,61,102,45,61,19,41,13,14,11,64,102
2011-10-09 00:00:00.000,ATP World Tour Masters 1000 Shanghai Shanghai; China ATP World Tour Masters 1000,HARD,2,Fernando Verdasco,Zhe Li,Fernando Verdasco,6-2; 6-2,R64,75,6,0,35,53,27,35,9,18,1,1,8,36,53,5,2,29,50,20,29,6,21,2,6,8,26,50
2011-10-09 00:00:00.000,ATP World Tour Masters 1000 Shanghai Shanghai; China ATP World Tour Masters 1000,HARD,2,Andy Roddick,Yen-Hsun Lu,Andy Roddick,6-2; 3-6; 6-2,R64,112,10,2,41,71,32,41,18,30,4,5,12,50,71,7,7,49,87,35,49,16,38,7,11,13,51,87
2011-10-09 00:00:00.000,ATP World Tour Masters 1000 Shanghai Shanghai; China ATP World Tour Masters 1000,HARD,2,Grigor Dimitrov,Marsel Ilhan,Grigor Dimitrov,2-6; 6-1; 6-4,R64,104,11,7,46,84,36,46,16,38,6,9,13,52,84,1,5,51,92,32,51,20,41,8,12,12,52,92
2011-10-09 00:00:00.000,ATP World Tour Masters 1000 Shanghai Shanghai; China ATP World Tour Masters 1000,HARD,2,Tommy Robredo,Stephane Bohli,Tommy Robredo,7-6(3); 7-6(4),R64,122,4,4,60,88,40,60,17,28,6,8,12,57,88,3,1,48,83,37,48,16,35,5,7,12,53,83
2011-10-09 00:00:00.000,ATP World Tour Masters 1000 Shanghai Shanghai; China ATP World Tour Masters 1000,HARD,2,Nicolas Almagro,N/A Bye,Nicolas Almagro,,R64,0,0,0,0,0,0,0,0,0,0,0,0,0,0,0,0,0,0,0,0,0,0,0,0,0,0,0
2011-10-09 00:00:00.000,ATP World Tour Masters 1000 Shanghai Shanghai; China ATP World Tour Masters 1000,HARD,2,Mardy Fish,N/A Bye,Mardy Fish,,R64,0,0,0,0,0,0,0,0,0,0,0,0,0,0,0,0,0,0,0,0,0,0,0,0,0,0,0
2011-10-09 00:00:00.000,ATP World Tour Masters 1000 Shanghai Shanghai; China ATP World Tour Masters 1000,HARD,2,Bernard Tomic,Kevin Anderson,Bernard Tomic,7-6(5); 6-7(4); 6-3,R64,157,7,1,74,110,57,74,25,36,2,2,17,82,110,25,3,83,133,68,83,20,50,11,12,16,88,133
2011-10-09 00:00:00.000,ATP World Tour Masters 1000 Shanghai Shanghai; China ATP World Tour Masters 1000,HARD,2,Albert Ramos,Marin Cilic,Albert Ramos,6-3; 6-4,R64,86,3,0,31,61,24,31,17,30,1,2,10,41,61,5,3,30,57,22,30,12,27,3,6,9,34,57
2011-10-09 00:00:00.000,ATP World Tour Masters 1000 Shanghai Shanghai; China ATP World Tour Masters 1000,HARD,2,Alexandr Dolgopolov,Lukasz Kubot,Alexandr Dolgopolov,6-4; 7-6(6),R64,100,8,2,22,65,14,22,28,43,0,2,11,42,65,5,2,46,78,31,46,15,32,7,10,11,46,78
2011-10-09 00:00:00.000,ATP World Tour Masters 1000 Shanghai Shanghai; China ATP World Tour Masters 1000,HARD,2,Jurgen Melzer,Ivan Ljubicic,Jurgen Melzer,6-4; 6-2,R64,76,4,1,27,47,23,27,13,20,2,3,9,36,47,5,4,31,60,18,31,14,29,4,8,9,32,60
2011-10-09 00:00:00.000,ATP World Tour Masters 1000 Shanghai Shanghai; China ATP World Tour Masters 1000,HARD,2,Santiago Giraldo,Ivan Dodig,Santiago Giraldo,1-6; 6-3; 6-4,R64,120,3,0,44,85,32,44,23,41,2,4,13,55,85,8,7,42,76,36,42,16,34,3,5,13,52,76
2011-10-09 00:00:00.000,ATP World Tour Masters 1000 Shanghai Shanghai; China ATP World Tour Masters 1000,HARD,2,Kei Nishikori,Robin Haase,Kei Nishikori,0-6; 7-5; 7-6(5),R64,133,4,7,55,99,36,55,20,44,5,11,15,56,99,8,7,48,99,35,48,24,51,4,8,15,59,99
2011-10-09 00:00:00.000,ATP World Tour Masters 1000 Shanghai Shanghai; China ATP World Tour Masters 1000,HARD,2,Jo-Wilfried Tsonga,N/A Bye,Jo-Wilfried Tsonga,,R64,0,0,0,0,0,0,0,0,0,0,0,0,0,0,0,0,0,0,0,0,0,0,0,0,0,0,0
2011-10-09 00:00:00.000,ATP World Tour Masters 1000 Shanghai Shanghai; China ATP World Tour Masters 1000,HARD,2,Gilles Simon,N/A Bye,Gilles Simon,,R64,0,0,0,0,0,0,0,0,0,0,0,0,0,0,0,0,0,0,0,0,0,0,0,0,0,0,0
2011-10-09 00:00:00.000,ATP World Tour Masters 1000 Shanghai Shanghai; China ATP World Tour Masters 1000,HARD,2,Albert Montanes,Mikhail Kukushkin,Albert Montanes,6-2; 5-7; 7-6(5),R64,132,3,9,69,113,52,69,18,44,9,13,16,70,113,12,7,48,102,36,48,25,54,4,9,16,61,102
2011-10-09 00:00:00.000,ATP World Tour Masters 1000 Shanghai Shanghai; China ATP World Tour Masters 1000,HARD,2,Matthew Ebden,Pablo Andujar,Matthew Ebden,6-4; 6-4,R64,71,4,2,23,50,19,23,21,27,0,0,10,40,50,4,1,43,62,28,43,13,19,3,5,10,41,62
2011-10-09 00:00:00.000,ATP World Tour Masters 1000 Shanghai Shanghai; China ATP World Tour Masters 1000,HARD,2,Ryan Harrison,Viktor Troicki,Ryan Harrison,6-3; 6-3,R64,82,1,3,38,64,26,38,11,26,4,6,9,37,64,5,3,34,59,21,34,8,25,4,9,9,29,59
2011-10-09 00:00:00.000,ATP World Tour Masters 1000 Shanghai Shanghai; China ATP World Tour Masters 1000,HARD,2,Stanislas Wawrinka,Juan Monaco,Stanislas Wawrinka,3-6; 6-3; 6-3,R64,127,6,6,49,89,32,49,18,40,4,9,14,50,89,1,4,34,75,22,34,17,41,5,11,13,39,75
2011-10-09 00:00:00.000,ATP World Tour Masters 1000 Shanghai Shanghai; China ATP World Tour Masters 1000,HARD,2,Donald Young,Mao-Xin Gong,Donald Young,6-1; 6-4,R64,74,2,1,35,54,25,35,15,19,6,6,9,40,54,0,1,32,52,17,32,10,20,2,5,8,27,52
2011-10-09 00:00:00.000,ATP World Tour Masters 1000 Shanghai Shanghai; China ATP World Tour Masters 1000,HARD,2,Dmitry Tursunov,Thomaz Bellucci,Dmitry Tursunov,6-7(5); 6-4; 7-5,R64,166,10,4,60,111,42,60,28,51,4,7,17,70,111,9,6,66,110,45,66,21,44,6,11,17,66,110
2011-10-09 00:00:00.000,ATP World Tour Masters 1000 Shanghai Shanghai; China ATP World Tour Masters 1000,HARD,2,Andy Murray,N/A Bye,Andy Murray,,R64,0,0,0,0,0,0,0,0,0,0,0,0,0,0,0,0,0,0,0,0,0,0,0,0,0,0,0
2011-10-09 00:00:00.000,ATP World Tour Masters 1000 Shanghai Shanghai; China ATP World Tour Masters 1000,HARD,2,Rafael Nadal,Guillermo Garcia-Lopez,Rafael Nadal,6-3; 6-2,R32,105,1,1,29,44,23,29,10,15,0,1,9,33,44,3,8,44,77,26,44,12,33,11,15,8,38,77
2011-10-09 00:00:00.000,ATP World Tour Masters 1000 Shanghai Shanghai; China ATP World Tour Masters 1000,HARD,2,Florian Mayer,David Nalbandian,Florian Mayer,6-3; 6-4,R32,74,5,2,29,50,24,29,10,21,1,2,9,34,50,4,5,34,62,25,34,8,28,3,7,10,33,62
2011-10-09 00:00:00.000,ATP World Tour Masters 1000 Shanghai Shanghai; China ATP World Tour Masters 1000,HARD,2,Feliciano Lopez,Alex Bogomolov Jr.,Feliciano Lopez,7-6(4); 3-6; 6-3,R32,152,8,14,65,120,49,65,25,55,14,16,15,74,120,4,0,78,108,55,78,14,30,6,8,15,69,108
2011-10-09 00:00:00.000,ATP World Tour Masters 1000 Shanghai Shanghai; China ATP World Tour Masters 1000,HARD,2,Tomas Berdych,Radek Stepanek,Tomas Berdych,6-4; 6-3,R32,78,6,1,30,48,27,30,11,18,2,3,10,38,48,2,2,34,58,24,34,10,24,3,6,9,34,58
2011-10-09 00:00:00.000,ATP World Tour Masters 1000 Shanghai Shanghai; China ATP World Tour Masters 1000,HARD,2,David Ferrer,Milos Raonic,David Ferrer,7-5; 7-6(7),R32,104,5,1,48,76,35,48,17,28,2,4,12,52,76,11,0,49,77,38,49,11,28,1,4,12,49,77
2011-10-09 00:00:00.000,ATP World Tour Masters 1000 Shanghai Shanghai; China ATP World Tour Masters 1000,HARD,2,Juan Carlos Ferrero,Fernando Verdasco,Juan Carlos Ferrero,4-6; 6-3; 6-2,R32,127,3,2,68,97,44,68,15,29,8,11,13,59,97,6,6,49,74,31,49,11,25,1,7,14,42,74
2011-10-09 00:00:00.000,ATP World Tour Masters 1000 Shanghai Shanghai; China ATP World Tour Masters 1000,HARD,2,Andy Roddick,Grigor Dimitrov,Andy Roddick,7-6(3); 7-5,R32,122,7,2,46,73,35,46,13,27,3,6,12,48,73,6,7,53,87,35,53,13,34,3,7,12,48,87
2011-10-09 00:00:00.000,ATP World Tour Masters 1000 Shanghai Shanghai; China ATP World Tour Masters 1000,HARD,2,Nicolas Almagro,Tommy Robredo,Nicolas Almagro,7-5; 6-3,R32,81,4,2,39,69,31,39,19,30,3,3,11,50,69,1,2,34,59,26,34,11,25,6,8,10,37,59
2011-10-09 00:00:00.000,ATP World Tour Masters 1000 Shanghai Shanghai; China ATP World Tour Masters 1000,HARD,2,Bernard Tomic,Mardy Fish,Bernard Tomic,4-6; 6-1; 6-4,R32,118,3,2,49,78,37,49,19,29,0,1,14,56,78,9,2,51,91,34,51,20,40,5,8,13,54,91
2011-10-09 00:00:00.000,ATP World Tour Masters 1000 Shanghai Shanghai; China ATP World Tour Masters 1000,HARD,2,Alexandr Dolgopolov,Albert Ramos,Alexandr Dolgopolov,5-7; 6-3; 6-2,R32,107,8,1,39,79,31,39,25,40,2,3,14,56,79,4,8,60,95,43,60,14,35,6,10,15,57,95
2011-10-09 00:00:00.000,ATP World Tour Masters 1000 Shanghai Shanghai; China ATP World Tour Masters 1000,HARD,2,Santiago Giraldo,Jurgen Melzer,Santiago Giraldo,4-6; 6-4; 7-6(5),R32,144,5,3,78,116,53,78,22,38,7,9,16,75,116,3,2,64,98,49,64,17,34,0,2,16,66,98
2011-10-09 00:00:00.000,ATP World Tour Masters 1000 Shanghai Shanghai; China ATP World Tour Masters 1000,HARD,2,Kei Nishikori,Jo-Wilfried Tsonga,Kei Nishikori,6-7(1); 6-4; 6-4,R32,148,4,2,58,97,40,58,22,39,1,3,16,62,97,11,5,50,96,37,50,24,46,5,9,16,61,96
2011-10-09 00:00:00.000,ATP World Tour Masters 1000 Shanghai Shanghai; China ATP World Tour Masters 1000,HARD,2,Gilles Simon,Albert Montanes,Gilles Simon,6-1; 6-1,R32,57,8,1,28,51,22,28,12,23,6,6,7,34,51,0,4,21,40,8,21,8,19,3,8,7,16,40
2011-10-09 00:00:00.000,ATP World Tour Masters 1000 Shanghai Shanghai; China ATP World Tour Masters 1000,HARD,2,Matthew Ebden,Ryan Harrison,Matthew Ebden,6-4; 6-2,R32,72,5,2,43,66,32,43,10,23,5,6,9,42,66,5,2,28,50,15,28,12,22,2,6,9,27,50
2011-10-09 00:00:00.000,ATP World Tour Masters 1000 Shanghai Shanghai; China ATP World Tour Masters 1000,HARD,2,Stanislas Wawrinka,Donald Young,Stanislas Wawrinka,6-7(5); 7-6(2); 6-2,R32,145,9,6,64,102,48,64,22,38,6,8,16,70,102,2,2,71,113,39,71,29,42,6,10,16,68,113
2011-10-09 00:00:00.000,ATP World Tour Masters 1000 Shanghai Shanghai; China ATP World Tour Masters 1000,HARD,2,Andy Murray,Dmitry Tursunov,Andy Murray,W/O,R32,0,0,0,0,0,0,0,0,0,0,0,0,0,0,0,0,0,0,0,0,0,0,0,0,0,0,0
2011-10-09 00:00:00.000,ATP World Tour Masters 1000 Shanghai Shanghai; China ATP World Tour Masters 1000,HARD,2,Florian Mayer,Rafael Nadal,Florian Mayer,7-6(5); 6-3,R16,108,5,1,37,64,33,37,15,27,0,0,10,48,64,2,0,53,72,37,53,11,19,2,4,11,48,72
2011-10-09 00:00:00.000,ATP World Tour Masters 1000 Shanghai Shanghai; China ATP World Tour Masters 1000,HARD,2,Feliciano Lopez,Tomas Berdych,Feliciano Lopez,6-4; 6-4,R16,81,7,0,32,52,26,32,15,20,0,0,10,41,52,7,1,39,59,29,39,10,20,1,3,10,39,59
2011-10-09 00:00:00.000,ATP World Tour Masters 1000 Shanghai Shanghai; China ATP World Tour Masters 1000,HARD,2,David Ferrer,Juan Carlos Ferrero,David Ferrer,1-6; 7-5; 6-2,R16,120,11,5,40,84,29,40,25,44,6,9,14,54,84,2,0,43,74,27,43,19,31,4,7,13,46,74
2011-10-09 00:00:00.000,ATP World Tour Masters 1000 Shanghai Shanghai; China ATP World Tour Masters 1000,HARD,2,Andy Roddick,Nicolas Almagro,Andy Roddick,6-3; 6-4,R16,72,11,0,35,48,32,35,8,13,0,0,10,40,48,4,2,32,50,23,32,9,18,0,2,9,32,50
2011-10-09 00:00:00.000,ATP World Tour Masters 1000 Shanghai Shanghai; China ATP World Tour Masters 1000,HARD,2,Alexandr Dolgopolov,Bernard Tomic,Alexandr Dolgopolov,5-7; 6-1; 6-0,R16,79,11,2,32,69,26,32,18,37,5,8,12,44,69,3,6,46,76,27,46,8,30,4,12,13,35,76
2011-10-09 00:00:00.000,ATP World Tour Masters 1000 Shanghai Shanghai; China ATP World Tour Masters 1000,HARD,2,Kei Nishikori,Santiago Giraldo,Kei Nishikori,7-6(6); 4-6; 6-3,R16,158,4,4,60,111,43,60,26,51,9,12,16,69,111,3,5,55,106,41,55,26,51,9,12,15,67,106
2011-10-09 00:00:00.000,ATP World Tour Masters 1000 Shanghai Shanghai; China ATP World Tour Masters 1000,HARD,2,Matthew Ebden,Gilles Simon,Matthew Ebden,6-2; 2-6; 7-6(8),R16,128,7,3,58,99,42,58,21,41,6,9,14,63,99,14,4,52,97,37,52,24,45,6,9,14,61,97
2011-10-09 00:00:00.000,ATP World Tour Masters 1000 Shanghai Shanghai; China ATP World Tour Masters 1000,HARD,2,Andy Murray,Stanislas Wawrinka,Andy Murray,6-4; 3-6; 6-3,R16,132,4,3,55,86,40,55,13,31,4,7,14,53,86,5,2,44,78,30,44,17,34,1,5,14,47,78
2011-10-09 00:00:00.000,ATP World Tour Masters 1000 Shanghai Shanghai; China ATP World Tour Masters 1000,HARD,2,Feliciano Lopez,Florian Mayer,Feliciano Lopez,6-2; 6-4,Q,69,10,2,24,49,19,24,19,25,1,1,9,38,49,2,3,36,59,21,36,12,23,3,6,9,33,59
2011-10-09 00:00:00.000,ATP World Tour Masters 1000 Shanghai Shanghai; China ATP World Tour Masters 1000,HARD,2,David Ferrer,Andy Roddick,David Ferrer,6-7(5); 6-2; 7-6(2),Q,154,11,5,69,114,56,69,26,45,5,5,16,82,114,11,2,63,105,49,63,21,42,2,4,16,70,105
2011-10-09 00:00:00.000,ATP World Tour Masters 1000 Shanghai Shanghai; China ATP World Tour Masters 1000,HARD,2,Kei Nishikori,Alexandr Dolgopolov,Kei Nishikori,6-4; 6-3,Q,87,1,0,29,52,22,29,13,23,6,7,9,35,52,9,3,36,77,24,36,15,41,5,9,10,39,77
2011-10-09 00:00:00.000,ATP World Tour Masters 1000 Shanghai Shanghai; China ATP World Tour Masters 1000,HARD,2,Andy Murray,Matthew Ebden,Andy Murray,6-3; 6-2,Q,85,7,2,26,44,20,26,14,18,1,1,8,34,44,0,5,37,71,26,37,10,34,7,11,9,36,71
2011-10-09 00:00:00.000,ATP World Tour Masters 1000 Shanghai Shanghai; China ATP World Tour Masters 1000,HARD,2,David Ferrer,Feliciano Lopez,David Ferrer,6-7(5); 6-3; 6-3,S,131,11,6,54,89,44,54,24,35,2,2,15,68,89,12,5,57,101,40,57,24,44,2,5,15,64,101
2011-10-09 00:00:00.000,ATP World Tour Masters 1000 Shanghai Shanghai; China ATP World Tour Masters 1000,HARD,2,Andy Murray,Kei Nishikori,Andy Murray,6-3; 6-0,S,57,7,1,23,35,22,23,7,12,0,0,7,29,35,0,3,29,47,17,29,4,18,4,9,8,21,47
2011-10-09 00:00:00.000,ATP World Tour Masters 1000 Shanghai Shanghai; China ATP World Tour Masters 1000,HARD,2,Andy Murray,David Ferrer,Andy Murray,7-5; 6-4,F,106,7,4,37,59,32,37,9,22,2,4,11,41,59,1,4,35,80,24,35,20,45,5,9,11,44,80
2011-10-17 00:00:00.000,Moscow Russia ATP World Tour 250,HARD,2,Janko Tipsarevic,N/A Bye,Janko Tipsarevic,,R32,0,0,0,0,0,0,0,0,0,0,0,0,0,0,0,0,0,0,0,0,0,0,0,0,0,0,0
2011-10-17 00:00:00.000,Moscow Russia ATP World Tour 250,HARD,2,Igor Kunitsyn,Andrey Kuznetsov,Igor Kunitsyn,7-5; 4-6; 6-3,R32,137,4,1,68,118,49,68,24,50,9,12,16,73,118,8,2,52,85,36,52,17,33,1,5,15,53,85
2011-10-17 00:00:00.000,Moscow Russia ATP World Tour 250,HARD,2,Julien Benneteau,Evgeny Donskoy,Julien Benneteau,6-4; 6-3,R32,69,5,0,29,45,23,29,13,16,0,0,9,36,45,5,0,45,61,30,45,7,16,1,4,10,37,61
2011-10-17 00:00:00.000,Moscow Russia ATP World Tour 250,HARD,2,Dmitry Tursunov,Albert Ramos,Dmitry Tursunov,7-6(5); 6-4,R32,91,4,5,36,64,31,36,15,28,3,5,11,46,64,9,2,48,73,35,48,11,25,6,9,11,46,73
2011-10-17 00:00:00.000,Moscow Russia ATP World Tour 250,HARD,2,Nikolay Davydenko,N/A Bye,Nikolay Davydenko,,R32,0,0,0,0,0,0,0,0,0,0,0,0,0,0,0,0,0,0,0,0,0,0,0,0,0,0,0
2011-10-17 00:00:00.000,Moscow Russia ATP World Tour 250,HARD,2,Teymuraz Gabashvili,Karol Beck,Teymuraz Gabashvili,6-2; 6-4,R32,93,2,1,47,69,27,47,15,22,8,9,9,42,69,3,3,26,60,19,26,14,34,3,7,9,33,60
2011-10-17 00:00:00.000,Moscow Russia ATP World Tour 250,HARD,2,Michael Berrer,Sergiy Stakhovsky,Michael Berrer,6-2; 6-4,R32,74,5,1,34,54,26,34,14,20,4,4,9,40,54,2,1,42,60,27,42,8,18,6,9,9,35,60
2011-10-17 00:00:00.000,Moscow Russia ATP World Tour 250,HARD,2,Andreas Seppi,Igor Andreev,Andreas Seppi,2-6; 6-3; 7-6(4),R32,125,6,1,57,92,44,57,18,35,6,9,15,62,92,7,2,52,91,39,52,21,39,3,5,14,60,91
2011-10-17 00:00:00.000,Moscow Russia ATP World Tour 250,HARD,2,Gilles Muller,Konstantin Kravchuk,Gilles Muller,7-6(5); 6-4,R32,90,19,1,47,69,39,47,14,22,3,3,11,53,69,11,2,39,62,31,39,15,23,0,1,11,46,62
2011-10-17 00:00:00.000,Moscow Russia ATP World Tour 250,HARD,2,Philipp Kohlschreiber,Carlos Berlocq,Philipp Kohlschreiber,7-5; 6-3,R32,91,2,1,37,61,27,37,16,24,3,4,10,43,61,5,2,45,65,30,45,7,20,2,6,11,37,65
2011-10-17 00:00:00.000,Moscow Russia ATP World Tour 250,HARD,2,Jeremy Chardy,Potito Starace,Jeremy Chardy,6-3; 6-7(5); 7-6(2),R32,125,23,3,61,105,55,61,26,44,3,3,17,81,105,9,3,69,104,56,69,18,35,3,4,16,74,104
2011-10-17 00:00:00.000,Moscow Russia ATP World Tour 250,HARD,2,Alexandr Dolgopolov,N/A Bye,Alexandr Dolgopolov,,R32,0,0,0,0,0,0,0,0,0,0,0,0,0,0,0,0,0,0,0,0,0,0,0,0,0,0,0
2011-10-17 00:00:00.000,Moscow Russia ATP World Tour 250,HARD,2,Alex Bogomolov Jr.,Dusan Lajovic,Alex Bogomolov Jr.,3-6; 6-3; 6-4,R32,118,4,4,69,93,48,69,11,24,6,9,14,59,93,6,1,60,87,40,60,11,27,6,10,14,51,87
2011-10-17 00:00:00.000,Moscow Russia ATP World Tour 250,HARD,2,Mikhail Kukushkin,Lukas Rosol,Mikhail Kukushkin,7-6(5); 7-5,R32,107,7,1,53,81,34,53,18,28,2,4,12,52,81,7,3,59,94,36,59,18,35,3,6,12,54,94
2011-10-17 00:00:00.000,Moscow Russia ATP World Tour 250,HARD,2,Pere Riba,Andreas Haider-Maurer,Pere Riba,6-2; 6-7(1); 6-3,R32,131,7,3,55,103,42,55,29,48,4,4,15,71,103,16,2,60,96,43,60,16,36,9,12,14,59,96
2011-10-17 00:00:00.000,Moscow Russia ATP World Tour 250,HARD,2,Viktor Troicki,N/A Bye,Viktor Troicki,,R32,0,0,0,0,0,0,0,0,0,0,0,0,0,0,0,0,0,0,0,0,0,0,0,0,0,0,0
2011-10-17 00:00:00.000,Moscow Russia ATP World Tour 250,HARD,2,Janko Tipsarevic,Igor Kunitsyn,Janko Tipsarevic,6-7(5); 6-1; 6-0,R16,115,8,1,44,81,37,44,18,37,1,2,13,55,81,5,1,42,81,27,42,18,39,3,9,12,45,81
2011-10-17 00:00:00.000,Moscow Russia ATP World Tour 250,HARD,2,Dmitry Tursunov,Julien Benneteau,Dmitry Tursunov,6-3; 7-6(1),R16,100,7,2,46,76,40,46,13,30,8,9,11,53,76,8,1,42,60,29,42,8,18,3,5,10,37,60
2011-10-17 00:00:00.000,Moscow Russia ATP World Tour 250,HARD,2,Nikolay Davydenko,Teymuraz Gabashvili,Nikolay Davydenko,7-5; 6-2,R16,91,3,2,36,56,25,36,10,20,3,5,10,35,56,3,2,36,63,22,36,9,27,2,7,10,31,63
2011-10-17 00:00:00.000,Moscow Russia ATP World Tour 250,HARD,2,Michael Berrer,Andreas Seppi,Michael Berrer,4-6; 6-3; 6-2,R16,96,6,3,60,85,43,60,15,25,5,6,14,58,85,4,4,48,73,34,48,12,25,1,4,13,46,73
2011-10-17 00:00:00.000,Moscow Russia ATP World Tour 250,HARD,2,Philipp Kohlschreiber,Gilles Muller,Philipp Kohlschreiber,7-6(4); 6-3,R16,81,12,1,45,61,39,45,12,16,2,2,11,51,61,9,2,41,65,32,41,14,24,4,5,10,46,65
2011-10-17 00:00:00.000,Moscow Russia ATP World Tour 250,HARD,2,Jeremy Chardy,Alexandr Dolgopolov,Jeremy Chardy,6-3; 7-6(6),R16,85,7,3,45,66,39,45,10,21,1,2,11,49,66,13,2,37,75,28,37,19,38,5,7,10,47,75
2011-10-17 00:00:00.000,Moscow Russia ATP World Tour 250,HARD,2,Alex Bogomolov Jr.,Mikhail Kukushkin,Alex Bogomolov Jr.,6-4; 3-6; 6-4,R16,137,1,1,77,101,55,77,9,24,12,14,15,64,101,4,2,51,94,37,51,23,43,3,5,14,60,94
2011-10-17 00:00:00.000,Moscow Russia ATP World Tour 250,HARD,2,Viktor Troicki,Pere Riba,Viktor Troicki,6-4; 6-4,R16,83,11,3,40,61,35,40,9,21,2,2,10,44,61,2,4,37,70,26,37,15,33,2,4,10,41,70
2011-10-17 00:00:00.000,Moscow Russia ATP World Tour 250,HARD,2,Janko Tipsarevic,Dmitry Tursunov,Janko Tipsarevic,6-4; 6-2,Q,76,7,1,29,47,26,29,13,18,3,3,9,39,47,3,3,42,60,26,42,7,18,8,11,9,33,60
2011-10-17 00:00:00.000,Moscow Russia ATP World Tour 250,HARD,2,Nikolay Davydenko,Michael Berrer,Nikolay Davydenko,6-3; 6-2,Q,81,1,5,49,69,34,49,10,20,4,5,9,44,69,3,1,34,51,22,34,4,17,1,5,8,26,51
2011-10-17 00:00:00.000,Moscow Russia ATP World Tour 250,HARD,2,Jeremy Chardy,Philipp Kohlschreiber,Jeremy Chardy,6-4; 6-3,Q,86,11,5,48,81,37,48,15,33,10,10,10,52,81,3,3,20,50,16,20,16,30,2,4,9,32,50
2011-10-17 00:00:00.000,Moscow Russia ATP World Tour 250,HARD,2,Viktor Troicki,Alex Bogomolov Jr.,Viktor Troicki,7-6(6); 6-7(1); 7-6(1),Q,218,23,5,83,137,60,83,26,54,6,10,18,86,137,2,2,117,151,72,117,17,34,14,18,18,89,151
2011-10-17 00:00:00.000,Moscow Russia ATP World Tour 250,HARD,2,Janko Tipsarevic,Nikolay Davydenko,Janko Tipsarevic,6-2; 7-5,S,99,6,0,40,69,29,40,16,29,6,7,10,45,69,0,4,38,60,26,38,6,22,1,5,10,32,60
2011-10-17 00:00:00.000,Moscow Russia ATP World Tour 250,HARD,2,Viktor Troicki,Jeremy Chardy,Viktor Troicki,6-4; 6-4,S,71,12,1,44,55,36,44,6,11,1,1,10,42,55,4,3,35,60,29,35,12,25,3,5,10,41,60
2011-10-17 00:00:00.000,Moscow Russia ATP World Tour 250,HARD,2,Janko Tipsarevic,Viktor Troicki,Janko Tipsarevic,6-4; 6-2,F,88,3,1,21,47,19,21,15,26,0,1,9,34,47,9,1,47,73,32,47,6,26,8,12,9,38,73
2011-10-17 00:00:00.000,Stockholm Sweden ATP World Tour 250,HARD,2,Gael Monfils,N/A Bye,Gael Monfils,,R32,0,0,0,0,0,0,0,0,0,0,0,0,0,0,0,0,0,0,0,0,0,0,0,0,0,0,0
2011-10-17 00:00:00.000,Stockholm Sweden ATP World Tour 250,HARD,2,Bernard Tomic,Jurgen Zopp,Bernard Tomic,7-6(5); 4-6; 6-0,R32,108,8,0,77,101,58,77,10,24,6,8,14,68,101,6,4,49,89,32,49,23,40,5,9,14,55,89
2011-10-17 00:00:00.000,Stockholm Sweden ATP World Tour 250,HARD,2,Tommy Haas,Somdev Devvarman,Tommy Haas,7-6(4); 6-4,R32,86,7,2,34,62,30,34,17,28,3,4,11,47,62,5,1,42,69,30,42,15,27,5,7,11,45,69
2011-10-17 00:00:00.000,Stockholm Sweden ATP World Tour 250,HARD,2,Kevin Anderson,Guillermo Garcia-Lopez,Kevin Anderson,7-6(1); 7-6(4),R32,128,9,3,57,80,42,57,11,23,3,6,12,53,80,4,7,61,106,37,61,23,45,10,13,12,60,106
2011-10-17 00:00:00.000,Stockholm Sweden ATP World Tour 250,HARD,2,Juan Ignacio Chela,N/A Bye,Juan Ignacio Chela,,R32,0,0,0,0,0,0,0,0,0,0,0,0,0,0,0,0,0,0,0,0,0,0,0,0,0,0,0
2011-10-17 00:00:00.000,Stockholm Sweden ATP World Tour 250,HARD,2,Grigor Dimitrov,Ryan Sweeting,Grigor Dimitrov,6-3; 6-1,R32,73,6,2,31,53,25,31,11,22,1,1,8,36,53,2,1,44,61,24,44,6,17,8,12,8,30,61
2011-10-17 00:00:00.000,Stockholm Sweden ATP World Tour 250,HARD,2,Philipp Petzschner,Lukasz Kubot,Philipp Petzschner,6-2; 7-5,R32,78,2,3,35,62,28,35,17,27,3,3,10,45,62,3,3,38,57,25,38,10,19,2,5,10,35,57
2011-10-17 00:00:00.000,Stockholm Sweden ATP World Tour 250,HARD,2,Milos Raonic,Marcos Baghdatis,Milos Raonic,7-6(5); 6-7(4); 6-4,R32,143,22,4,84,115,69,84,15,31,1,1,17,84,115,6,4,58,105,52,58,28,47,4,5,17,80,105
2011-10-17 00:00:00.000,Stockholm Sweden ATP World Tour 250,HARD,2,Tobias Kamke,Tommy Robredo,Tobias Kamke,6-2; 6-3,R32,63,2,4,28,52,24,28,11,24,2,3,9,35,52,1,1,25,45,13,25,10,20,3,7,8,23,45
2011-10-17 00:00:00.000,Stockholm Sweden ATP World Tour 250,HARD,2,Sebastian Rieschick,Michael Ryderstedt,Sebastian Rieschick,6-4; 3-6; 6-3,R32,99,12,1,51,74,40,51,14,23,3,4,14,54,74,13,5,59,88,42,59,17,29,4,6,14,59,88
2011-10-17 00:00:00.000,Stockholm Sweden ATP World Tour 250,HARD,2,Jarkko Nieminen,Marius Copil,Jarkko Nieminen,6-3; 7-6(4),R32,89,0,0,41,76,32,41,22,35,3,3,11,54,76,10,0,27,54,22,27,18,27,1,2,10,40,54
2011-10-17 00:00:00.000,Stockholm Sweden ATP World Tour 250,HARD,2,Stanislas Wawrinka,N/A Bye,Stanislas Wawrinka,,R32,0,0,0,0,0,0,0,0,0,0,0,0,0,0,0,0,0,0,0,0,0,0,0,0,0,0,0
2011-10-17 00:00:00.000,Stockholm Sweden ATP World Tour 250,HARD,2,Ivan Dodig,Adrian Mannarino,Ivan Dodig,7-6(5); 7-6(6),R32,129,19,4,58,86,46,58,14,28,3,4,12,60,86,1,1,79,120,51,79,21,41,7,8,12,72,120
2011-10-17 00:00:00.000,Stockholm Sweden ATP World Tour 250,HARD,2,David Nalbandian,Xavier Malisse,David Nalbandian,4-6; 7-6(6); 7-6(3),R32,161,8,7,67,119,48,67,27,52,2,6,17,75,119,16,3,76,124,55,76,21,48,7,10,17,76,124
2011-10-17 00:00:00.000,Stockholm Sweden ATP World Tour 250,HARD,2,James Blake,Olivier Rochus,James Blake,7-6(6); 6-3,R32,85,17,2,47,79,40,47,13,32,3,4,11,53,79,2,1,46,70,35,46,10,24,8,10,10,45,70
2011-10-17 00:00:00.000,Stockholm Sweden ATP World Tour 250,HARD,2,Juan Martin Del Potro,N/A Bye,Juan Martin Del Potro,,R32,0,0,0,0,0,0,0,0,0,0,0,0,0,0,0,0,0,0,0,0,0,0,0,0,0,0,0
2011-10-17 00:00:00.000,Stockholm Sweden ATP World Tour 250,HARD,2,Gael Monfils,Bernard Tomic,Gael Monfils,6-4; 6-7(4); 6-4,R16,111,18,3,74,102,53,74,17,28,8,9,16,70,102,4,1,80,109,54,80,15,29,7,10,16,69,109
2011-10-17 00:00:00.000,Stockholm Sweden ATP World Tour 250,HARD,2,Kevin Anderson,Tommy Haas,Kevin Anderson,6-7(3); 6-4; 6-4,R16,121,20,0,73,90,59,73,9,17,0,0,16,68,90,14,1,56,83,40,56,20,27,0,2,16,60,83
2011-10-17 00:00:00.000,Stockholm Sweden ATP World Tour 250,HARD,2,Grigor Dimitrov,Juan Ignacio Chela,Grigor Dimitrov,6-2; 5-7; 6-1,R16,109,5,1,54,79,38,54,13,25,1,4,14,51,79,0,2,40,70,26,40,10,30,4,10,13,36,70
2011-10-17 00:00:00.000,Stockholm Sweden ATP World Tour 250,HARD,2,Milos Raonic,Philipp Petzschner,Milos Raonic,6-3; 6-3,R16,73,7,0,32,46,28,32,8,14,0,0,9,36,46,4,2,30,69,20,30,19,39,4,7,9,39,69
2011-10-17 00:00:00.000,Stockholm Sweden ATP World Tour 250,HARD,2,Tobias Kamke,Sebastian Rieschick,Tobias Kamke,6-3; 6-1,R16,58,3,3,27,46,22,27,11,19,0,0,8,33,46,3,3,31,52,17,31,11,21,2,6,8,28,52
2011-10-17 00:00:00.000,Stockholm Sweden ATP World Tour 250,HARD,2,Jarkko Nieminen,Stanislas Wawrinka,Jarkko Nieminen,6-3; 6-4,R16,71,1,2,36,57,25,36,14,21,1,2,10,39,57,6,2,36,48,24,36,6,12,2,5,9,30,48
2011-10-17 00:00:00.000,Stockholm Sweden ATP World Tour 250,HARD,2,David Nalbandian,Ivan Dodig,David Nalbandian,6-1; 6-1,R16,59,2,0,24,37,21,24,8,13,1,1,7,29,37,2,0,24,49,10,24,11,25,5,10,7,21,49
2011-10-17 00:00:00.000,Stockholm Sweden ATP World Tour 250,HARD,2,James Blake,Juan Martin Del Potro,James Blake,6-4; 6-4,R16,87,3,1,34,56,28,34,13,22,0,0,10,41,56,4,0,39,64,25,39,14,25,2,4,10,39,64
2011-10-17 00:00:00.000,Stockholm Sweden ATP World Tour 250,HARD,2,Gael Monfils,Kevin Anderson,Gael Monfils,7-5; 7-5,Q,92,6,0,55,78,32,55,16,23,5,8,12,48,78,5,1,49,70,32,49,5,21,1,6,12,37,70
2011-10-17 00:00:00.000,Stockholm Sweden ATP World Tour 250,HARD,2,Milos Raonic,Grigor Dimitrov,Milos Raonic,7-5; 6-4,Q,78,14,1,39,54,33,39,11,15,0,0,11,44,54,3,1,35,64,24,35,17,29,2,4,11,41,64
2011-10-17 00:00:00.000,Stockholm Sweden ATP World Tour 250,HARD,2,Jarkko Nieminen,Tobias Kamke,Jarkko Nieminen,3-6; 7-5; 6-1,Q,122,2,5,68,95,42,68,15,27,7,11,14,57,95,2,2,45,80,25,45,15,35,2,8,14,40,80
2011-10-17 00:00:00.000,Stockholm Sweden ATP World Tour 250,HARD,2,James Blake,David Nalbandian,James Blake,W/O,Q,0,0,0,0,0,0,0,0,0,0,0,0,0,0,0,0,0,0,0,0,0,0,0,0,0,0,0
2011-10-17 00:00:00.000,Stockholm Sweden ATP World Tour 250,HARD,2,Gael Monfils,Milos Raonic,Gael Monfils,6-7(6); 6-4; 6-3,S,130,4,3,69,103,51,69,20,34,2,3,16,71,103,9,2,64,97,48,64,15,33,6,9,15,63,97
2011-10-17 00:00:00.000,Stockholm Sweden ATP World Tour 250,HARD,2,Jarkko Nieminen,James Blake,Jarkko Nieminen,7-6(5); 5-7; 6-2,S,124,5,1,66,86,44,66,14,20,4,8,16,58,86,6,7,76,135,57,76,19,59,9,14,16,76,135
2011-10-17 00:00:00.000,Stockholm Sweden ATP World Tour 250,HARD,2,Gael Monfils,Jarkko Nieminen,Gael Monfils,7-5; 3-6; 6-2,F,112,13,1,54,75,38,54,9,21,3,7,14,47,75,1,4,61,96,35,61,18,35,11,17,15,53,96
2011-10-24 00:00:00.000,St. Petersburg Russia ATP World Tour 250,HARD,2,Adrian Mannarino,Gilles Simon,Adrian Mannarino,2-6; 6-4; 6-4,R32,131,1,1,58,94,35,58,19,36,9,13,14,54,94,3,3,53,90,29,53,21,37,2,6,14,50,90
2011-10-24 00:00:00.000,St. Petersburg Russia ATP World Tour 250,HARD,2,Lukas Rosol,Ernests Gulbis,Lukas Rosol,6-3; 6-4,R32,85,4,4,32,63,22,32,22,31,1,1,10,44,63,3,8,37,64,24,37,14,27,6,8,9,38,64
2011-10-24 00:00:00.000,St. Petersburg Russia ATP World Tour 250,HARD,2,Julien Benneteau,Pere Riba,Julien Benneteau,6-2; 6-1,R32,56,5,4,31,43,28,31,6,12,3,3,8,34,43,1,5,18,42,10,18,10,24,5,9,7,20,42
2011-10-24 00:00:00.000,St. Petersburg Russia ATP World Tour 250,HARD,2,Mikhail Youzhny,Sergiy Stakhovsky,Mikhail Youzhny,6-3; 7-6(7),R32,97,1,3,41,74,26,41,22,33,0,2,11,48,74,7,2,31,59,21,31,13,28,1,4,10,34,59
2011-10-24 00:00:00.000,St. Petersburg Russia ATP World Tour 250,HARD,2,Marin Cilic,Sergei Bubka,Marin Cilic,6-4; 7-6(1),R32,111,6,1,39,78,29,39,24,39,5,6,11,53,78,4,2,52,80,37,52,11,28,6,8,11,48,80
2011-10-24 00:00:00.000,St. Petersburg Russia ATP World Tour 250,HARD,2,Somdev Devvarman,Karol Beck,Somdev Devvarman,6-2; 6-3,R32,68,2,2,29,48,24,29,8,19,1,2,8,32,48,3,4,26,54,18,26,8,28,1,6,9,26,54
2011-10-24 00:00:00.000,St. Petersburg Russia ATP World Tour 250,HARD,2,Andreas Seppi,Vasek Pospisil,Andreas Seppi,7-5; 7-6(4),R32,121,3,1,50,88,37,50,21,38,5,7,12,58,88,5,3,39,85,28,39,21,46,2,5,12,49,85
2011-10-24 00:00:00.000,St. Petersburg Russia ATP World Tour 250,HARD,2,Igor Andreev,Marcel Granollers,Igor Andreev,3-6; 6-4; 7-6(4),R32,170,2,5,69,118,49,69,24,49,11,15,16,73,118,9,2,63,98,46,63,16,35,4,7,15,62,98
2011-10-24 00:00:00.000,St. Petersburg Russia ATP World Tour 250,HARD,2,Alex Bogomolov Jr.,Igor Kunitsyn,Alex Bogomolov Jr.,6-3; 6-1,R32,66,4,0,36,45,26,36,7,9,1,1,8,33,45,6,0,45,60,26,45,4,15,4,8,8,30,60
2011-10-24 00:00:00.000,St. Petersburg Russia ATP World Tour 250,HARD,2,Philipp Kohlschreiber,Carlos Berlocq,Philipp Kohlschreiber,6-7(4); 6-3; 6-1,R32,135,2,2,57,98,41,57,23,41,9,11,14,64,98,2,2,45,79,26,45,21,34,1,7,14,47,79
2011-10-24 00:00:00.000,St. Petersburg Russia ATP World Tour 250,HARD,2,Dusan Lajovic,Jeremy Chardy,Dusan Lajovic,6-4; 6-4,R32,73,0,0,34,53,26,34,15,19,0,0,10,41,53,4,0,43,66,32,43,10,23,3,5,10,42,66
2011-10-24 00:00:00.000,St. Petersburg Russia ATP World Tour 250,HARD,2,Dudi Sela,Alexandr Dolgopolov,Dudi Sela,6-2; 6-2,R32,60,0,2,27,49,20,27,15,22,2,2,8,35,49,3,2,21,50,15,21,13,29,2,6,8,28,50
2011-10-24 00:00:00.000,St. Petersburg Russia ATP World Tour 250,HARD,2,Dmitry Tursunov,Teymuraz Gabashvili,Dmitry Tursunov,7-5; 6-3,R32,89,6,3,28,55,25,28,13,27,4,6,10,38,55,2,3,46,69,24,46,12,23,4,9,11,36,69
2011-10-24 00:00:00.000,St. Petersburg Russia ATP World Tour 250,HARD,2,Potito Starace,Ivan Nedelko,Potito Starace,6-0; 6-1,R32,45,3,0,26,43,22,26,10,17,5,5,7,32,43,1,1,10,27,3,10,4,17,0,5,6,7,27
2011-10-24 00:00:00.000,St. Petersburg Russia ATP World Tour 250,HARD,2,Michael Berrer,Mikhail Kukushkin,Michael Berrer,6-1; 4-6; 6-4,R32,139,3,3,58,88,38,58,13,30,5,9,13,51,88,4,8,54,104,33,54,19,50,9,16,14,52,104
2011-10-24 00:00:00.000,St. Petersburg Russia ATP World Tour 250,HARD,2,Janko Tipsarevic,Olivier Rochus,Janko Tipsarevic,6-2; 7-5,R32,95,10,3,32,72,22,32,22,40,5,7,10,44,72,0,6,27,54,18,27,10,27,0,5,10,28,54
2011-10-24 00:00:00.000,St. Petersburg Russia ATP World Tour 250,HARD,2,Adrian Mannarino,Lukas Rosol,Adrian Mannarino,6-2; 7-6(5),R16,91,4,3,40,66,27,40,19,26,2,3,10,46,66,5,3,45,81,31,45,15,36,5,8,10,46,81
2011-10-24 00:00:00.000,St. Petersburg Russia ATP World Tour 250,HARD,2,Mikhail Youzhny,Julien Benneteau,Mikhail Youzhny,6-4; 3-6; 6-2,R16,127,3,5,46,88,28,46,24,42,6,10,14,52,88,6,2,48,75,29,48,12,27,3,8,13,41,75
2011-10-24 00:00:00.000,St. Petersburg Russia ATP World Tour 250,HARD,2,Marin Cilic,Somdev Devvarman,Marin Cilic,5-7; 6-1; 6-3,R16,136,13,1,53,89,41,53,17,36,1,3,14,58,89,2,2,66,96,39,66,16,30,7,12,14,55,96
2011-10-24 00:00:00.000,St. Petersburg Russia ATP World Tour 250,HARD,2,Andreas Seppi,Igor Andreev,Andreas Seppi,3-6; 6-2; 6-4,R16,120,3,2,38,80,28,38,25,42,4,6,13,53,80,2,4,44,82,28,44,19,38,2,6,14,47,82
2011-10-24 00:00:00.000,St. Petersburg Russia ATP World Tour 250,HARD,2,Alex Bogomolov Jr.,Philipp Kohlschreiber,Alex Bogomolov Jr.,6-4; 3-6; 7-5,R16,150,0,3,78,101,50,78,8,23,3,7,15,58,101,8,4,59,107,36,59,24,48,7,12,16,60,107
2011-10-24 00:00:00.000,St. Petersburg Russia ATP World Tour 250,HARD,2,Dusan Lajovic,Dudi Sela,Dusan Lajovic,2-6; 6-2; 6-1,R16,98,2,1,45,62,30,45,8,17,3,6,11,38,62,1,4,55,88,29,55,13,33,7,13,12,42,88
2011-10-24 00:00:00.000,St. Petersburg Russia ATP World Tour 250,HARD,2,Potito Starace,Dmitry Tursunov,Potito Starace,6-2; 6-4,R16,78,4,1,41,54,31,41,9,13,1,1,9,40,54,5,5,29,58,20,29,14,29,5,8,9,34,58
2011-10-24 00:00:00.000,St. Petersburg Russia ATP World Tour 250,HARD,2,Janko Tipsarevic,Michael Berrer,Janko Tipsarevic,6-3; 2-0 RET,R16,54,0,2,17,29,13,17,8,12,0,1,6,21,29,1,2,24,36,12,24,4,12,3,6,5,16,36
2011-10-24 00:00:00.000,St. Petersburg Russia ATP World Tour 250,HARD,2,Mikhail Youzhny,Adrian Mannarino,Mikhail Youzhny,6-2; 6-3,Q,79,3,1,35,55,27,35,11,20,2,3,9,38,55,3,0,42,56,23,42,5,14,5,9,8,28,56
2011-10-24 00:00:00.000,St. Petersburg Russia ATP World Tour 250,HARD,2,Marin Cilic,Andreas Seppi,Marin Cilic,4-6; 7-6(8); 6-4,Q,148,13,2,61,98,51,61,21,37,1,2,16,72,98,5,4,62,107,49,62,26,45,3,4,16,75,107
2011-10-24 00:00:00.000,St. Petersburg Russia ATP World Tour 250,HARD,2,Alex Bogomolov Jr.,Dusan Lajovic,Alex Bogomolov Jr.,6-2; 6-1,Q,85,0,0,36,45,26,36,6,9,3,3,7,32,45,2,4,54,84,29,54,11,30,10,15,8,40,84
2011-10-24 00:00:00.000,St. Petersburg Russia ATP World Tour 250,HARD,2,Janko Tipsarevic,Potito Starace,Janko Tipsarevic,6-7(6); 6-2; 6-1,Q,146,12,2,42,81,35,42,28,39,2,2,14,63,81,2,4,59,103,34,59,23,44,5,9,13,57,103
2011-10-24 00:00:00.000,St. Petersburg Russia ATP World Tour 250,HARD,2,Marin Cilic,Mikhail Youzhny,Marin Cilic,6-3; 6-4,S,83,5,1,30,55,24,30,13,25,3,5,10,37,55,1,2,43,63,27,43,6,20,2,6,9,33,63
2011-10-24 00:00:00.000,St. Petersburg Russia ATP World Tour 250,HARD,2,Janko Tipsarevic,Alex Bogomolov Jr.,Janko Tipsarevic,6-2; 6-1,S,77,6,1,24,41,17,24,13,17,2,3,8,30,41,1,3,34,51,22,34,1,17,4,9,7,23,51
2011-10-24 00:00:00.000,St. Petersburg Russia ATP World Tour 250,HARD,2,Marin Cilic,Janko Tipsarevic,Marin Cilic,6-3; 3-6; 6-2,F,138,3,2,49,85,34,49,22,36,4,5,13,56,85,4,2,47,77,35,47,14,30,5,8,13,49,77
2011-10-24 00:00:00.000,Vienna Austria ATP World Tour 250,HARD,2,Jo-Wilfried Tsonga,N/A Bye,Jo-Wilfried Tsonga,,R32,0,0,0,0,0,0,0,0,0,0,0,0,0,0,0,0,0,0,0,0,0,0,0,0,0,0,0
2011-10-24 00:00:00.000,Vienna Austria ATP World Tour 250,HARD,2,Jarkko Nieminen,Robin Haase,Jarkko Nieminen,7-6(3); 6-4,R32,85,2,2,55,73,41,55,11,18,1,1,11,52,73,12,1,42,64,34,42,10,22,1,2,11,44,64
2011-10-24 00:00:00.000,Vienna Austria ATP World Tour 250,HARD,2,Xavier Malisse,Albert Ramos,Xavier Malisse,6-1; 6-4,R32,63,5,2,25,47,23,25,13,22,0,0,9,36,47,1,2,27,49,16,27,12,22,5,8,8,28,49
2011-10-24 00:00:00.000,Vienna Austria ATP World Tour 250,HARD,2,Fabio Fognini,Tommy Robredo,Fabio Fognini,7-6(7); 5-7; 2-1 RET,R32,129,3,3,63,91,48,63,16,28,2,3,14,64,91,5,1,49,85,35,49,24,36,1,1,13,59,85
2011-10-24 00:00:00.000,Vienna Austria ATP World Tour 250,HARD,2,Radek Stepanek,N/A Bye,Radek Stepanek,,R32,0,0,0,0,0,0,0,0,0,0,0,0,0,0,0,0,0,0,0,0,0,0,0,0,0,0,0
2011-10-24 00:00:00.000,Vienna Austria ATP World Tour 250,HARD,2,Daniel Brands,Martin Fischer,Daniel Brands,6-7(3); 6-2; 7-6(6),R32,144,14,2,82,115,59,82,20,33,8,9,16,79,115,3,0,75,103,53,75,15,28,6,9,16,68,103
2011-10-24 00:00:00.000,Vienna Austria ATP World Tour 250,HARD,2,Dominic Thiem,Thomas Muster,Dominic Thiem,6-2; 6-3,R32,64,5,3,30,51,24,30,8,21,2,3,8,32,51,5,4,40,57,24,40,5,17,1,6,9,29,57
2011-10-24 00:00:00.000,Vienna Austria ATP World Tour 250,HARD,2,Steve Darcis,Nikolay Davydenko,Steve Darcis,3-6; 6-0; 7-6(2),R32,126,7,0,59,88,41,59,10,29,6,11,13,51,88,0,2,67,86,32,67,10,19,5,12,14,42,86
2011-10-24 00:00:00.000,Vienna Austria ATP World Tour 250,HARD,2,Kevin Anderson,Andreas Haider-Maurer,Kevin Anderson,6-4; 6-4,R32,94,10,0,35,58,29,35,15,23,5,5,10,44,58,8,3,52,78,36,52,10,26,7,9,10,46,78
2011-10-24 00:00:00.000,Vienna Austria ATP World Tour 250,HARD,2,Marcos Baghdatis,Ryan Sweeting,Marcos Baghdatis,6-4; 6-2,R32,72,10,2,29,55,23,29,14,26,3,4,9,37,55,3,2,34,53,20,34,9,19,2,6,9,29,53
2011-10-24 00:00:00.000,Vienna Austria ATP World Tour 250,HARD,2,Guillermo Garcia-Lopez,James Blake,Guillermo Garcia-Lopez,6-2; 5-7; 6-4,R32,105,10,6,50,89,39,50,19,39,3,6,15,58,89,7,4,52,85,34,52,18,33,10,15,15,52,85
2011-10-24 00:00:00.000,Vienna Austria ATP World Tour 250,HARD,2,Jurgen Melzer,N/A Bye,Jurgen Melzer,,R32,0,0,0,0,0,0,0,0,0,0,0,0,0,0,0,0,0,0,0,0,0,0,0,0,0,0,0
2011-10-24 00:00:00.000,Vienna Austria ATP World Tour 250,HARD,2,Tommy Haas,Juan Ignacio Chela,Tommy Haas,6-7(3); 6-3; 7-6(5),R32,152,10,1,67,100,50,67,20,33,1,2,16,70,100,5,4,69,117,49,69,26,48,3,6,17,75,117
2011-10-24 00:00:00.000,Vienna Austria ATP World Tour 250,HARD,2,Aljaz Bedene,Ivo Karlovic,Aljaz Bedene,7-6(4) RET,R32,64,6,1,31,45,26,31,7,14,0,0,6,33,45,9,1,23,37,18,23,9,14,0,0,6,27,37
2011-10-24 00:00:00.000,Vienna Austria ATP World Tour 250,HARD,2,Philipp Petzschner,Pablo Andujar,Philipp Petzschner,6-2; 6-2,R32,61,5,1,21,40,15,21,14,19,2,3,8,29,40,0,1,23,51,13,23,11,28,4,9,8,24,51
2011-10-24 00:00:00.000,Vienna Austria ATP World Tour 250,HARD,2,Juan Martin Del Potro,N/A Bye,Juan Martin Del Potro,,R32,0,0,0,0,0,0,0,0,0,0,0,0,0,0,0,0,0,0,0,0,0,0,0,0,0,0,0
2011-10-24 00:00:00.000,Vienna Austria ATP World Tour 250,HARD,2,Jo-Wilfried Tsonga,Jarkko Nieminen,Jo-Wilfried Tsonga,3-6; 6-1; 3-1 RET,R16,65,14,1,38,52,28,38,9,14,0,1,10,37,52,1,1,35,60,22,35,12,25,1,4,10,34,60
2011-10-24 00:00:00.000,Vienna Austria ATP World Tour 250,HARD,2,Xavier Malisse,Fabio Fognini,Xavier Malisse,6-7(3); 6-3; 6-3,R16,120,9,3,48,83,43,48,17,35,0,1,15,60,83,5,5,59,108,38,59,25,49,6,10,15,63,108
2011-10-24 00:00:00.000,Vienna Austria ATP World Tour 250,HARD,2,Daniel Brands,Radek Stepanek,Daniel Brands,6-4; 7-6(4),R16,80,7,1,53,67,42,53,11,14,1,1,11,53,67,4,3,35,59,28,35,18,24,1,2,11,46,59
2011-10-24 00:00:00.000,Vienna Austria ATP World Tour 250,HARD,2,Steve Darcis,Dominic Thiem,Steve Darcis,6-2; 6-2,R16,65,4,1,31,43,24,31,8,12,0,0,8,32,43,6,1,26,54,20,26,9,28,5,9,8,29,54
2011-10-24 00:00:00.000,Vienna Austria ATP World Tour 250,HARD,2,Kevin Anderson,Marcos Baghdatis,Kevin Anderson,6-2; 7-6(5),R16,91,12,4,42,67,29,42,12,25,2,5,10,41,67,5,1,36,66,23,36,12,30,5,10,10,35,66
2011-10-24 00:00:00.000,Vienna Austria ATP World Tour 250,HARD,2,Jurgen Melzer,Guillermo Garcia-Lopez,Jurgen Melzer,7-5; 6-1,R16,83,7,1,48,73,32,48,17,25,5,5,10,49,73,2,6,24,51,15,24,14,27,1,4,9,29,51
2011-10-24 00:00:00.000,Vienna Austria ATP World Tour 250,HARD,2,Tommy Haas,Aljaz Bedene,Tommy Haas,4-6; 6-4; 6-1,R16,103,10,3,49,78,39,49,16,29,4,6,14,55,78,12,4,35,68,28,35,16,33,3,7,13,44,68
2011-10-24 00:00:00.000,Vienna Austria ATP World Tour 250,HARD,2,Juan Martin Del Potro,Philipp Petzschner,Juan Martin Del Potro,6-3; 6-4,R16,87,6,3,39,64,29,39,16,25,4,4,10,45,64,8,4,31,54,23,31,9,23,2,4,9,32,54
2011-10-24 00:00:00.000,Vienna Austria ATP World Tour 250,HARD,2,Jo-Wilfried Tsonga,Xavier Malisse,Jo-Wilfried Tsonga,4-6; 7-6(4); 6-4,Q,120,20,3,64,108,53,64,25,44,5,6,16,78,108,10,4,56,95,48,56,22,39,2,3,16,70,95
2011-10-24 00:00:00.000,Vienna Austria ATP World Tour 250,HARD,2,Daniel Brands,Steve Darcis,Daniel Brands,6-3; 6-4,Q,72,11,3,38,58,31,38,11,20,0,1,10,42,58,5,1,39,58,25,39,9,19,3,6,9,34,58
2011-10-24 00:00:00.000,Vienna Austria ATP World Tour 250,HARD,2,Kevin Anderson,Jurgen Melzer,Kevin Anderson,6-3; 6-3,Q,63,11,2,29,44,26,29,10,15,0,0,9,36,44,4,2,31,48,22,31,8,17,1,4,9,30,48
2011-10-24 00:00:00.000,Vienna Austria ATP World Tour 250,HARD,2,Juan Martin Del Potro,Tommy Haas,Juan Martin Del Potro,6-2; 6-4,Q,80,10,0,33,43,29,33,7,10,0,0,9,36,43,6,3,33,59,22,33,11,26,5,8,9,33,59
2011-10-24 00:00:00.000,Vienna Austria ATP World Tour 250,HARD,2,Jo-Wilfried Tsonga,Daniel Brands,Jo-Wilfried Tsonga,6-2; 7-6(4),S,84,13,1,40,59,34,40,12,19,0,0,10,46,59,4,3,52,71,36,52,8,19,7,9,10,44,71
2011-10-24 00:00:00.000,Vienna Austria ATP World Tour 250,HARD,2,Juan Martin Del Potro,Kevin Anderson,Juan Martin Del Potro,6-4; 3-6; 6-4,S,133,18,0,56,83,42,56,15,27,2,4,14,57,83,17,3,55,77,40,55,11,22,1,4,15,51,77
2011-10-24 00:00:00.000,Vienna Austria ATP World Tour 250,HARD,2,Jo-Wilfried Tsonga,Juan Martin Del Potro,Jo-Wilfried Tsonga,6-7(5); 6-3; 6-4,F,148,25,5,55,96,45,55,24,41,3,4,16,69,96,7,2,66,103,46,66,19,37,4,7,15,65,103
2011-10-31 00:00:00.000,Basel Switzerland ATP World Tour 500,HARD,2,Novak Djokovic,Xavier Malisse,Novak Djokovic,6-2; 4-6; 7-5,R32,133,8,7,47,84,38,47,21,37,6,8,15,59,84,7,3,45,94,32,45,27,49,6,10,15,59,94
2011-10-31 00:00:00.000,Basel Switzerland ATP World Tour 500,HARD,2,Lukasz Kubot,Tobias Kamke,Lukasz Kubot,5-7; 7-5; 6-2,R32,178,7,7,81,134,49,81,27,53,21,26,16,76,134,1,3,56,95,32,56,17,39,2,9,16,49,95
2011-10-31 00:00:00.000,Basel Switzerland ATP World Tour 500,HARD,2,Michael Lammer,Mikhail Youzhny,Michael Lammer,6-4; 6-3,R32,59,6,2,30,46,24,30,9,16,1,2,9,33,46,1,3,33,55,20,33,11,22,1,5,10,31,55
2011-10-31 00:00:00.000,Basel Switzerland ATP World Tour 500,HARD,2,Marcos Baghdatis,Viktor Troicki,Marcos Baghdatis,4-6; 7-6(8); 6-2,R32,163,6,2,60,115,43,60,28,55,7,11,15,71,115,4,4,41,105,31,41,31,64,2,7,15,62,105
2011-10-31 00:00:00.000,Basel Switzerland ATP World Tour 500,HARD,2,Kei Nishikori,Tomas Berdych,Kei Nishikori,3-6; 6-3; 6-2,R32,124,1,3,40,68,33,40,18,28,0,1,13,51,68,4,5,48,93,37,48,19,45,7,10,13,56,93
2011-10-31 00:00:00.000,Basel Switzerland ATP World Tour 500,HARD,2,Andreas Seppi,Gilles Muller,Andreas Seppi,7-6(4); 6-7(5); 6-2,R32,143,13,2,52,105,43,52,31,53,2,3,16,74,105,23,2,62,110,49,62,23,48,7,10,16,72,110
2011-10-31 00:00:00.000,Basel Switzerland ATP World Tour 500,HARD,2,Mikhail Kukushkin,Donald Young,Mikhail Kukushkin,6-4; 6-2,R32,87,1,2,38,69,26,38,14,31,9,12,9,40,69,2,1,35,56,20,35,5,21,3,9,9,25,56
2011-10-31 00:00:00.000,Basel Switzerland ATP World Tour 500,HARD,2,James Blake,Mardy Fish,James Blake,0-1 RET,R32,12,0,0,1,1,1,1,0,0,0,0,0,1,1,0,1,1,8,1,1,4,7,0,0,1,5,8
2011-10-31 00:00:00.000,Basel Switzerland ATP World Tour 500,HARD,2,Andy Roddick,Tommy Haas,Andy Roddick,6-3; 6-4,R32,71,12,1,35,52,30,35,11,17,0,0,10,41,52,4,4,30,53,21,30,11,23,3,5,9,32,53
2011-10-31 00:00:00.000,Basel Switzerland ATP World Tour 500,HARD,2,Radek Stepanek,Santiago Giraldo,Radek Stepanek,6-1; 6-3,R32,62,4,1,28,51,21,28,16,23,2,2,8,37,51,2,1,31,49,18,31,7,18,3,7,8,25,49
2011-10-31 00:00:00.000,Basel Switzerland ATP World Tour 500,HARD,2,Jarkko Nieminen,Thomaz Bellucci,Jarkko Nieminen,6-7(5); 6-4; 6-3,R32,127,9,3,70,100,51,70,17,30,6,7,15,68,100,7,7,65,106,45,65,20,41,3,7,16,65,106
2011-10-31 00:00:00.000,Basel Switzerland ATP World Tour 500,HARD,2,Roger Federer,Potito Starace,Roger Federer,7-6(3); 6-4,R32,79,4,5,43,65,38,43,12,22,1,1,11,50,65,7,2,40,65,32,40,13,25,2,3,11,45,65
2011-10-31 00:00:00.000,Basel Switzerland ATP World Tour 500,HARD,2,Florian Mayer,Janko Tipsarevic,Florian Mayer,5-1 RET,R32,30,0,1,5,15,5,5,7,10,0,0,3,12,15,2,1,13,29,7,13,6,16,1,3,3,13,29
2011-10-31 00:00:00.000,Basel Switzerland ATP World Tour 500,HARD,2,Ivan Ljubicic,Michael Llodra,Ivan Ljubicic,7-5; 6-4,R32,81,9,0,31,64,26,31,20,33,1,1,11,46,64,6,4,34,57,28,34,11,23,1,3,11,39,57
2011-10-31 00:00:00.000,Basel Switzerland ATP World Tour 500,HARD,2,Stanislas Wawrinka,Ivan Dodig,Stanislas Wawrinka,6-4; 6-4,R32,87,6,1,32,55,26,32,16,23,1,1,10,42,55,6,3,25,56,16,25,20,31,2,4,10,36,56
2011-10-31 00:00:00.000,Basel Switzerland ATP World Tour 500,HARD,2,Robin Haase,Marco Chiudinelli,Robin Haase,6-2; 7-6(7),R32,88,12,6,35,66,30,35,16,31,1,2,10,46,66,1,2,37,63,22,37,14,26,2,5,10,36,63
2011-10-31 00:00:00.000,Basel Switzerland ATP World Tour 500,HARD,2,Novak Djokovic,Lukasz Kubot,Novak Djokovic,6-1; 6-2,R16,55,8,2,27,43,22,27,11,16,0,0,8,33,43,0,4,23,43,15,23,6,20,3,7,7,21,43
2011-10-31 00:00:00.000,Basel Switzerland ATP World Tour 500,HARD,2,Marcos Baghdatis,Michael Lammer,Marcos Baghdatis,7-6(2); 6-7(2); 6-3,R16,160,9,7,55,118,44,55,40,63,4,4,17,84,118,1,1,50,96,40,50,31,46,4,5,16,71,96
2011-10-31 00:00:00.000,Basel Switzerland ATP World Tour 500,HARD,2,Kei Nishikori,Andreas Seppi,Kei Nishikori,6-3; 7-6(4),R16,106,2,2,40,80,29,40,22,40,2,4,11,51,80,5,1,32,56,21,32,13,24,2,5,10,34,56
2011-10-31 00:00:00.000,Basel Switzerland ATP World Tour 500,HARD,2,Mikhail Kukushkin,James Blake,Mikhail Kukushkin,6-3; 6-4,R16,77,6,0,33,53,26,33,12,20,0,1,10,38,53,3,3,38,69,26,38,11,31,7,10,9,37,69
2011-10-31 00:00:00.000,Basel Switzerland ATP World Tour 500,HARD,2,Andy Roddick,Radek Stepanek,Andy Roddick,2-6; 6-3; 6-3,R16,104,10,3,46,69,33,46,14,23,5,8,13,47,69,8,8,37,74,30,37,14,37,1,5,13,44,74
2011-10-31 00:00:00.000,Basel Switzerland ATP World Tour 500,HARD,2,Roger Federer,Jarkko Nieminen,Roger Federer,6-1; 4-6; 6-3,R16,95,10,4,42,78,37,42,15,36,3,5,13,52,78,2,6,45,82,31,45,15,37,2,7,13,46,82
2011-10-31 00:00:00.000,Basel Switzerland ATP World Tour 500,HARD,2,Florian Mayer,Ivan Ljubicic,Florian Mayer,6-3; 6-1,R16,59,4,3,30,49,25,30,8,19,3,4,8,33,49,5,2,28,49,17,28,5,21,0,5,8,22,49
2011-10-31 00:00:00.000,Basel Switzerland ATP World Tour 500,HARD,2,Stanislas Wawrinka,Robin Haase,Stanislas Wawrinka,4-6; 6-1; 6-2,R16,128,8,1,42,75,34,42,19,33,1,2,13,53,75,1,4,60,110,33,60,25,50,13,17,12,58,110
2011-10-31 00:00:00.000,Basel Switzerland ATP World Tour 500,HARD,2,Novak Djokovic,Marcos Baghdatis,Novak Djokovic,2-6; 6-2; 6-3,Q,99,4,2,50,75,35,50,16,25,1,3,13,51,75,12,7,40,71,29,40,15,31,0,3,12,44,71
2011-10-31 00:00:00.000,Basel Switzerland ATP World Tour 500,HARD,2,Kei Nishikori,Mikhail Kukushkin,Kei Nishikori,6-4; 5-7; 6-4,Q,159,2,3,48,98,32,48,24,50,4,10,16,56,98,4,1,50,106,27,50,29,56,9,16,16,56,106
2011-10-31 00:00:00.000,Basel Switzerland ATP World Tour 500,HARD,2,Roger Federer,Andy Roddick,Roger Federer,6-3; 6-2,Q,64,5,1,25,47,21,25,16,22,0,0,9,37,47,3,1,15,42,11,15,13,27,1,4,8,24,42
2011-10-31 00:00:00.000,Basel Switzerland ATP World Tour 500,HARD,2,Stanislas Wawrinka,Florian Mayer,Stanislas Wawrinka,6-2; 6-2,Q,64,7,3,16,41,15,16,17,25,0,0,8,32,41,0,2,17,53,8,17,18,36,5,9,8,26,53
2011-10-31 00:00:00.000,Basel Switzerland ATP World Tour 500,HARD,2,Kei Nishikori,Novak Djokovic,Kei Nishikori,2-6; 7-6(4); 6-0,S,136,4,2,38,82,28,38,22,44,3,7,13,50,82,6,4,61,91,41,61,10,30,2,7,13,51,91
2011-10-31 00:00:00.000,Basel Switzerland ATP World Tour 500,HARD,2,Roger Federer,Stanislas Wawrinka,Roger Federer,7-6(5); 6-2,S,88,3,3,37,62,28,37,13,25,0,1,10,41,62,3,0,41,67,28,41,9,26,2,5,10,37,67
2011-10-31 00:00:00.000,Basel Switzerland ATP World Tour 500,HARD,2,Roger Federer,Kei Nishikori,Roger Federer,6-1; 6-3,F,72,5,0,25,39,22,25,11,14,1,1,8,33,39,0,4,30,65,16,30,18,35,9,13,8,34,65
2011-10-31 00:00:00.000,Valencia Spain ATP World Tour 500,HARD,2,David Ferrer,Fernando Verdasco,David Ferrer,6-3; 6-2,R32,83,1,1,34,60,25,34,16,26,1,1,9,41,60,1,5,38,57,21,38,9,19,5,8,8,30,57
2011-10-31 00:00:00.000,Valencia Spain ATP World Tour 500,HARD,2,Vasek Pospisil,John Isner,Vasek Pospisil,6-3; 3-6; 7-6(9),R32,133,6,3,61,93,51,61,19,32,1,2,15,70,93,19,6,70,94,60,70,10,24,2,3,15,70,94
2011-10-31 00:00:00.000,Valencia Spain ATP World Tour 500,HARD,2,Nicolas Mahut,Guillermo Garcia-Lopez,Nicolas Mahut,7-6(5); 6-2,R32,99,5,3,46,72,38,46,12,26,1,1,10,50,72,4,1,34,62,25,34,16,28,4,6,10,41,62
2011-10-31 00:00:00.000,Valencia Spain ATP World Tour 500,HARD,2,Nikolay Davydenko,Gilles Simon,Nikolay Davydenko,6-4; 4-6; 6-3,R32,135,2,5,67,88,52,67,6,21,5,7,14,58,88,3,2,58,96,36,58,20,38,7,11,15,56,96
2011-10-31 00:00:00.000,Valencia Spain ATP World Tour 500,HARD,2,Juan Monaco,Nicolas Almagro,Juan Monaco,6-4; 3-6; 6-4,R32,144,2,5,56,90,39,56,20,34,9,11,14,59,90,7,3,48,93,30,48,29,45,9,12,15,59,93
2011-10-31 00:00:00.000,Valencia Spain ATP World Tour 500,HARD,2,Fabio Fognini,Daniel Gimeno-Traver,Fabio Fognini,6-4; 6-3,R32,71,1,3,35,57,27,35,9,22,0,2,10,36,57,3,4,22,54,15,22,14,32,1,5,9,29,54
2011-10-31 00:00:00.000,Valencia Spain ATP World Tour 500,HARD,2,Juan Carlos Ferrero,Igor Kunitsyn,Juan Carlos Ferrero,6-4; 7-6(2),R32,98,6,0,44,70,36,44,13,26,6,7,11,49,70,5,2,45,75,32,45,11,30,7,9,11,43,75
2011-10-31 00:00:00.000,Valencia Spain ATP World Tour 500,HARD,2,Alex Bogomolov Jr.,Feliciano Lopez,Alex Bogomolov Jr.,4-6; 6-4; 7-6(2),R32,138,5,5,81,103,55,81,11,22,8,11,16,66,103,15,4,53,103,41,53,23,50,5,8,16,64,103
2011-10-31 00:00:00.000,Valencia Spain ATP World Tour 500,HARD,2,Marcel Granollers,Alexandr Dolgopolov,Marcel Granollers,6-3; 6-4,R32,70,1,3,36,54,30,36,11,18,0,0,10,41,54,5,6,28,61,21,28,16,33,3,5,9,37,61
2011-10-31 00:00:00.000,Valencia Spain ATP World Tour 500,HARD,2,Marin Cilic,Milos Raonic,Marin Cilic,6-4; 6-4,R32,92,6,2,29,67,23,29,24,38,2,2,10,47,67,8,4,39,63,32,39,9,24,5,7,10,41,63
2011-10-31 00:00:00.000,Valencia Spain ATP World Tour 500,HARD,2,Pablo Andujar,Juan Ignacio Chela,Pablo Andujar,6-0; 7-6(7),R32,85,2,2,34,55,27,34,14,21,0,1,9,41,55,3,3,36,64,25,36,11,28,1,5,9,36,64
2011-10-31 00:00:00.000,Valencia Spain ATP World Tour 500,HARD,2,Gael Monfils,Albert Montanes,Gael Monfils,6-3; 6-1,R32,61,13,2,33,42,28,33,5,9,1,1,8,33,42,1,4,37,62,23,37,8,25,4,8,8,31,62
2011-10-31 00:00:00.000,Valencia Spain ATP World Tour 500,HARD,2,Juan Martin Del Potro,Dmitry Tursunov,Juan Martin Del Potro,6-4; 6-1,R32,76,10,0,30,48,21,30,14,18,1,1,8,35,48,3,3,23,54,15,23,13,31,4,8,9,28,54
2011-10-31 00:00:00.000,Valencia Spain ATP World Tour 500,HARD,2,Kevin Anderson,Martin Klizan,Kevin Anderson,6-1; 6-4,R32,63,9,2,37,50,26,37,9,13,3,4,9,35,50,1,5,29,46,16,29,6,17,0,4,8,22,46
2011-10-31 00:00:00.000,Valencia Spain ATP World Tour 500,HARD,2,Sam Querrey,Ernests Gulbis,Sam Querrey,6-3; 6-4,R32,72,10,2,34,56,31,34,10,22,0,0,10,41,56,4,3,40,63,27,40,13,23,6,8,9,40,63
2011-10-31 00:00:00.000,Valencia Spain ATP World Tour 500,HARD,2,Jo-Wilfried Tsonga,Javier Marti,Jo-Wilfried Tsonga,4-6; 7-5; 6-2,R32,137,10,3,57,94,46,57,18,37,4,6,15,64,94,5,6,45,88,30,45,25,43,3,7,15,55,88
2011-10-31 00:00:00.000,Valencia Spain ATP World Tour 500,HARD,2,David Ferrer,Vasek Pospisil,David Ferrer,6-3; 6-3,R16,91,2,1,45,64,28,45,13,19,5,6,9,41,64,2,2,34,60,19,34,11,26,2,6,9,30,60
2011-10-31 00:00:00.000,Valencia Spain ATP World Tour 500,HARD,2,Nikolay Davydenko,Nicolas Mahut,Nikolay Davydenko,W/O,R16,0,0,0,0,0,0,0,0,0,0,0,0,0,0,0,0,0,0,0,0,0,0,0,0,0,0,0
2011-10-31 00:00:00.000,Valencia Spain ATP World Tour 500,HARD,2,Juan Monaco,Fabio Fognini,Juan Monaco,6-3; 6-1,R16,67,1,1,24,45,19,24,11,21,2,3,8,30,45,1,5,37,58,15,37,13,21,3,8,8,28,58
2011-10-31 00:00:00.000,Valencia Spain ATP World Tour 500,HARD,2,Juan Carlos Ferrero,Alex Bogomolov Jr.,Juan Carlos Ferrero,7-6(3); 4-6; 6-2,R16,171,5,4,67,105,39,67,22,38,8,14,15,61,105,2,3,74,108,43,74,13,34,10,17,15,56,108
2011-10-31 00:00:00.000,Valencia Spain ATP World Tour 500,HARD,2,Marcel Granollers,Marin Cilic,Marcel Granollers,3-6; 6-3; 7-5,R16,134,10,0,63,96,43,63,21,33,4,6,15,64,96,10,2,48,84,39,48,19,36,2,5,15,58,84
2011-10-31 00:00:00.000,Valencia Spain ATP World Tour 500,HARD,2,Gael Monfils,Pablo Andujar,Gael Monfils,6-2; 7-6(5),R16,101,10,1,47,73,36,47,12,26,3,4,10,48,73,1,4,55,87,33,55,16,32,9,12,10,49,87
2011-10-31 00:00:00.000,Valencia Spain ATP World Tour 500,HARD,2,Juan Martin Del Potro,Kevin Anderson,Juan Martin Del Potro,6-4; 6-4,R16,91,4,2,29,51,23,29,14,22,0,1,10,37,51,4,2,32,58,20,32,16,26,3,6,10,36,58
2011-10-31 00:00:00.000,Valencia Spain ATP World Tour 500,HARD,2,Sam Querrey,Jo-Wilfried Tsonga,Sam Querrey,7-6(5); 6-2,R16,77,7,3,31,67,24,31,25,36,2,2,10,49,67,7,3,35,62,27,35,14,27,2,4,10,41,62
2011-10-31 00:00:00.000,Valencia Spain ATP World Tour 500,HARD,2,David Ferrer,Nikolay Davydenko,David Ferrer,6-3; 6-4,Q,82,4,1,36,55,29,36,11,19,2,3,10,40,55,1,5,37,62,23,37,12,25,2,5,9,35,62
2011-10-31 00:00:00.000,Valencia Spain ATP World Tour 500,HARD,2,Juan Monaco,Juan Carlos Ferrero,Juan Monaco,6-3; 6-3,Q,96,3,3,44,62,32,44,10,18,2,2,9,42,62,1,0,33,53,22,33,10,20,2,5,9,32,53
2011-10-31 00:00:00.000,Valencia Spain ATP World Tour 500,HARD,2,Marcel Granollers,Gael Monfils,Marcel Granollers,7-6(12); 3-6; 6-4,Q,146,4,1,55,91,39,55,21,36,2,6,15,60,91,10,8,64,107,49,64,20,43,3,7,16,69,107
2011-10-31 00:00:00.000,Valencia Spain ATP World Tour 500,HARD,2,Juan Martin Del Potro,Sam Querrey,Juan Martin Del Potro,6-2; 7-5,Q,78,7,2,31,48,27,31,13,17,0,0,10,40,48,4,1,43,66,26,43,12,23,4,7,10,38,66
2011-10-31 00:00:00.000,Valencia Spain ATP World Tour 500,HARD,2,Juan Monaco,David Ferrer,Juan Monaco,7-5; 1-6; 6-3,S,136,1,1,71,101,46,71,11,30,7,12,14,57,101,2,6,32,73,24,32,21,41,2,7,14,45,73
2011-10-31 00:00:00.000,Valencia Spain ATP World Tour 500,HARD,2,Marcel Granollers,Juan Martin Del Potro,Marcel Granollers,6-4; 7-6(4),S,113,4,0,36,66,29,36,20,30,2,3,11,49,66,3,2,42,73,28,42,19,31,4,6,11,47,73
2011-10-31 00:00:00.000,Valencia Spain ATP World Tour 500,HARD,2,Marcel Granollers,Juan Monaco,Marcel Granollers,6-2; 4-6; 7-6(3),F,180,7,1,60,97,43,60,20,37,6,9,15,63,97,1,1,74,98,48,74,9,24,6,10,15,57,98
2011-11-07 00:00:00.000,ATP World Tour Masters 1000 Paris France ATP World Tour Masters 1000,HARD,2,Novak Djokovic,N/A Bye,Novak Djokovic,,R64,0,0,0,0,0,0,0,0,0,0,0,0,0,0,0,0,0,0,0,0,0,0,0,0,0,0,0
2011-11-07 00:00:00.000,ATP World Tour Masters 1000 Paris France ATP World Tour Masters 1000,HARD,2,Ivan Dodig,Fabio Fognini,Ivan Dodig,4-6; 6-1; 6-3,R64,121,9,5,41,87,31,41,22,46,5,8,13,53,87,3,5,47,87,30,47,18,40,7,13,13,48,87
2011-11-07 00:00:00.000,ATP World Tour Masters 1000 Paris France ATP World Tour Masters 1000,HARD,2,Sergiy Stakhovsky,Kei Nishikori,Sergiy Stakhovsky,6-4; 6-3,R64,92,5,2,49,75,36,49,10,26,12,14,10,46,75,4,1,38,67,22,38,12,29,5,9,9,34,67
2011-11-07 00:00:00.000,ATP World Tour Masters 1000 Paris France ATP World Tour Masters 1000,HARD,2,Viktor Troicki,N/A Bye,Viktor Troicki,,R64,0,0,0,0,0,0,0,0,0,0,0,0,0,0,0,0,0,0,0,0,0,0,0,0,0,0,0
2011-11-07 00:00:00.000,ATP World Tour Masters 1000 Paris France ATP World Tour Masters 1000,HARD,2,Nicolas Almagro,N/A Bye,Nicolas Almagro,,R64,0,0,0,0,0,0,0,0,0,0,0,0,0,0,0,0,0,0,0,0,0,0,0,0,0,0,0
2011-11-07 00:00:00.000,ATP World Tour Masters 1000 Paris France ATP World Tour Masters 1000,HARD,2,Andreas Seppi,Nikolay Davydenko,Andreas Seppi,7-6(2); 7-5,R64,107,4,2,45,82,35,45,20,37,5,7,12,55,82,5,6,48,79,33,48,15,31,3,6,12,48,79
2011-11-07 00:00:00.000,ATP World Tour Masters 1000 Paris France ATP World Tour Masters 1000,HARD,2,Guillermo Garcia-Lopez,Santiago Giraldo,Guillermo Garcia-Lopez,6-4; 1-6; 6-4,R64,134,4,7,39,77,25,39,20,38,3,7,13,45,77,4,3,78,114,49,78,16,36,8,12,14,65,114
2011-11-07 00:00:00.000,ATP World Tour Masters 1000 Paris France ATP World Tour Masters 1000,HARD,2,Jo-Wilfried Tsonga,N/A Bye,Jo-Wilfried Tsonga,,R64,0,0,0,0,0,0,0,0,0,0,0,0,0,0,0,0,0,0,0,0,0,0,0,0,0,0,0
2011-11-07 00:00:00.000,ATP World Tour Masters 1000 Paris France ATP World Tour Masters 1000,HARD,2,David Ferrer,N/A Bye,David Ferrer,,R64,0,0,0,0,0,0,0,0,0,0,0,0,0,0,0,0,0,0,0,0,0,0,0,0,0,0,0
2011-11-07 00:00:00.000,ATP World Tour Masters 1000 Paris France ATP World Tour Masters 1000,HARD,2,Nicolas Mahut,Juan Carlos Ferrero,Nicolas Mahut,6-2; 6-3,R64,73,11,4,32,62,24,32,14,30,4,6,9,38,62,2,1,30,50,17,30,8,20,4,9,8,25,50
2011-11-07 00:00:00.000,ATP World Tour Masters 1000 Paris France ATP World Tour Masters 1000,HARD,2,Philipp Kohlschreiber,Mikhail Youzhny,Philipp Kohlschreiber,6-4; 6-2,R64,76,8,5,24,53,19,24,16,29,5,7,9,35,53,2,6,35,72,23,35,13,37,7,12,9,36,72
2011-11-07 00:00:00.000,ATP World Tour Masters 1000 Paris France ATP World Tour Masters 1000,HARD,2,Alexandr Dolgopolov,N/A Bye,Alexandr Dolgopolov,,R64,0,0,0,0,0,0,0,0,0,0,0,0,0,0,0,0,0,0,0,0,0,0,0,0,0,0,0
2011-11-07 00:00:00.000,ATP World Tour Masters 1000 Paris France ATP World Tour Masters 1000,HARD,2,Igor Kunitsyn,N/A Bye,Igor Kunitsyn,,R64,0,0,0,0,0,0,0,0,0,0,0,0,0,0,0,0,0,0,0,0,0,0,0,0,0,0,0
2011-11-07 00:00:00.000,ATP World Tour Masters 1000 Paris France ATP World Tour Masters 1000,HARD,2,John Isner,Stanislas Wawrinka,John Isner,6-7(3); 7-5; 7-6(5),R64,176,20,4,80,111,62,80,18,31,3,4,18,80,111,12,3,84,133,58,84,29,49,8,10,18,87,133
2011-11-07 00:00:00.000,ATP World Tour Masters 1000 Paris France ATP World Tour Masters 1000,HARD,2,Feliciano Lopez,Michael Llodra,Feliciano Lopez,7-6(7); 6-3,R64,98,7,4,44,77,29,44,20,33,3,5,11,49,77,5,3,39,76,27,39,18,37,9,12,10,45,76
2011-11-07 00:00:00.000,ATP World Tour Masters 1000 Paris France ATP World Tour Masters 1000,HARD,2,Gael Monfils,N/A Bye,Gael Monfils,,R64,0,0,0,0,0,0,0,0,0,0,0,0,0,0,0,0,0,0,0,0,0,0,0,0,0,0,0
2011-11-07 00:00:00.000,ATP World Tour Masters 1000 Paris France ATP World Tour Masters 1000,HARD,2,Mardy Fish,N/A Bye,Mardy Fish,,R64,0,0,0,0,0,0,0,0,0,0,0,0,0,0,0,0,0,0,0,0,0,0,0,0,0,0,0
2011-11-07 00:00:00.000,ATP World Tour Masters 1000 Paris France ATP World Tour Masters 1000,HARD,2,Florian Mayer,Radek Stepanek,Florian Mayer,7-5; 6-3,R64,81,1,2,34,61,26,34,13,27,1,3,10,39,61,3,4,41,70,27,41,10,29,4,9,11,37,70
2011-11-07 00:00:00.000,ATP World Tour Masters 1000 Paris France ATP World Tour Masters 1000,HARD,2,Juan Monaco,Donald Young,Juan Monaco,6-4; 6-2,R64,79,2,0,40,58,29,40,12,18,4,4,9,41,58,3,3,36,61,23,36,11,25,4,7,9,34,61
2011-11-07 00:00:00.000,ATP World Tour Masters 1000 Paris France ATP World Tour Masters 1000,HARD,2,Gilles Simon,N/A Bye,Gilles Simon,,R64,0,0,0,0,0,0,0,0,0,0,0,0,0,0,0,0,0,0,0,0,0,0,0,0,0,0,0
2011-11-07 00:00:00.000,ATP World Tour Masters 1000 Paris France ATP World Tour Masters 1000,HARD,2,Richard Gasquet,N/A Bye,Richard Gasquet,,R64,0,0,0,0,0,0,0,0,0,0,0,0,0,0,0,0,0,0,0,0,0,0,0,0,0,0,0
2011-11-07 00:00:00.000,ATP World Tour Masters 1000 Paris France ATP World Tour Masters 1000,HARD,2,Kevin Anderson,Gilles Muller,Kevin Anderson,6-3; 4-6; 6-4,R64,111,13,0,47,71,40,47,17,24,1,2,15,57,71,8,3,47,86,38,47,20,39,4,6,14,58,86
2011-11-07 00:00:00.000,ATP World Tour Masters 1000 Paris France ATP World Tour Masters 1000,HARD,2,Adrian Mannarino,Dmitry Tursunov,Adrian Mannarino,6-2; 6-2,R64,67,7,2,31,48,28,31,7,17,2,2,8,35,48,4,5,32,51,16,32,9,19,1,5,8,25,51
2011-11-07 00:00:00.000,ATP World Tour Masters 1000 Paris France ATP World Tour Masters 1000,HARD,2,Roger Federer,N/A Bye,Roger Federer,,R64,0,0,0,0,0,0,0,0,0,0,0,0,0,0,0,0,0,0,0,0,0,0,0,0,0,0,0
2011-11-07 00:00:00.000,ATP World Tour Masters 1000 Paris France ATP World Tour Masters 1000,HARD,2,Tomas Berdych,N/A Bye,Tomas Berdych,,R64,0,0,0,0,0,0,0,0,0,0,0,0,0,0,0,0,0,0,0,0,0,0,0,0,0,0,0
2011-11-07 00:00:00.000,ATP World Tour Masters 1000 Paris France ATP World Tour Masters 1000,HARD,2,Fernando Verdasco,Marin Cilic,Fernando Verdasco,3-6; 6-2; 6-3,R64,113,6,6,53,82,38,53,18,29,2,3,13,56,82,5,5,36,76,29,36,18,40,2,5,13,47,76
2011-11-07 00:00:00.000,ATP World Tour Masters 1000 Paris France ATP World Tour Masters 1000,HARD,2,Alex Bogomolov Jr.,Thomaz Bellucci,Alex Bogomolov Jr.,4-6; 7-6(4); 6-2,R64,133,4,6,44,88,37,44,23,44,2,4,15,60,88,7,7,48,103,36,48,28,55,7,10,15,64,103
2011-11-07 00:00:00.000,ATP World Tour Masters 1000 Paris France ATP World Tour Masters 1000,HARD,2,Janko Tipsarevic,N/A Bye,Janko Tipsarevic,,R64,0,0,0,0,0,0,0,0,0,0,0,0,0,0,0,0,0,0,0,0,0,0,0,0,0,0,0
2011-11-07 00:00:00.000,ATP World Tour Masters 1000 Paris France ATP World Tour Masters 1000,HARD,2,Andy Roddick,N/A Bye,Andy Roddick,,R64,0,0,0,0,0,0,0,0,0,0,0,0,0,0,0,0,0,0,0,0,0,0,0,0,0,0,0
2011-11-07 00:00:00.000,ATP World Tour Masters 1000 Paris France ATP World Tour Masters 1000,HARD,2,Julien Benneteau,Milos Raonic,Julien Benneteau,6-7(5); 7-6(5); 6-4,R64,146,11,1,76,113,61,76,20,37,1,1,17,81,113,22,3,70,103,61,70,17,33,2,3,17,78,103
2011-11-07 00:00:00.000,ATP World Tour Masters 1000 Paris France ATP World Tour Masters 1000,HARD,2,Jeremy Chardy,Marcel Granollers,Jeremy Chardy,6-3 RET,R64,28,7,1,15,24,15,15,5,9,0,0,5,20,24,1,3,13,22,9,13,5,9,0,1,4,14,22
2011-11-07 00:00:00.000,ATP World Tour Masters 1000 Paris France ATP World Tour Masters 1000,HARD,2,Andy Murray,N/A Bye,Andy Murray,,R64,0,0,0,0,0,0,0,0,0,0,0,0,0,0,0,0,0,0,0,0,0,0,0,0,0,0,0
2011-11-07 00:00:00.000,ATP World Tour Masters 1000 Paris France ATP World Tour Masters 1000,HARD,2,Novak Djokovic,Ivan Dodig,Novak Djokovic,6-4; 6-3,R32,91,3,2,29,53,26,29,15,24,0,0,10,41,53,6,4,30,61,22,30,14,31,3,5,9,36,61
2011-11-07 00:00:00.000,ATP World Tour Masters 1000 Paris France ATP World Tour Masters 1000,HARD,2,Viktor Troicki,Sergiy Stakhovsky,Viktor Troicki,6-4; 6-4,R32,87,5,2,31,61,23,31,15,30,2,4,10,38,61,1,4,33,65,20,33,16,32,5,9,10,36,65
2011-11-07 00:00:00.000,ATP World Tour Masters 1000 Paris France ATP World Tour Masters 1000,HARD,2,Andreas Seppi,Nicolas Almagro,Andreas Seppi,6-3; 7-5,R32,82,7,1,42,67,30,42,14,25,1,3,11,44,67,7,1,36,65,25,36,11,29,4,8,10,36,65
2011-11-07 00:00:00.000,ATP World Tour Masters 1000 Paris France ATP World Tour Masters 1000,HARD,2,Jo-Wilfried Tsonga,Guillermo Garcia-Lopez,Jo-Wilfried Tsonga,6-3; 6-4,R32,100,9,0,42,76,30,42,18,34,5,6,10,48,76,0,3,30,50,22,30,7,20,1,4,9,29,50
2011-11-07 00:00:00.000,ATP World Tour Masters 1000 Paris France ATP World Tour Masters 1000,HARD,2,David Ferrer,Nicolas Mahut,David Ferrer,6-4; 6-4,R32,87,2,3,27,59,19,27,22,32,2,2,10,41,59,1,3,30,62,25,30,14,32,3,5,10,39,62
2011-11-07 00:00:00.000,ATP World Tour Masters 1000 Paris France ATP World Tour Masters 1000,HARD,2,Alexandr Dolgopolov,Philipp Kohlschreiber,Alexandr Dolgopolov,6-3; 7-6(6),R32,86,11,2,34,73,27,34,24,39,2,3,11,51,73,6,4,43,78,31,43,15,35,8,10,10,46,78
2011-11-07 00:00:00.000,ATP World Tour Masters 1000 Paris France ATP World Tour Masters 1000,HARD,2,John Isner,Igor Kunitsyn,John Isner,6-4; 6-4,R32,70,7,0,40,58,30,40,10,18,2,3,10,40,58,2,0,25,51,18,25,14,26,2,5,10,32,51
2011-11-07 00:00:00.000,ATP World Tour Masters 1000 Paris France ATP World Tour Masters 1000,HARD,2,Feliciano Lopez,Gael Monfils,Feliciano Lopez,6-3; 6-4,R32,81,5,4,29,63,23,29,22,34,5,5,10,45,63,12,3,31,55,21,31,14,24,1,3,9,35,55
2011-11-07 00:00:00.000,ATP World Tour Masters 1000 Paris France ATP World Tour Masters 1000,HARD,2,Mardy Fish,Florian Mayer,Mardy Fish,6-1; 6-2,R32,56,7,0,25,41,23,25,10,16,0,0,8,33,41,1,3,25,46,14,25,7,21,4,8,7,21,46
2011-11-07 00:00:00.000,ATP World Tour Masters 1000 Paris France ATP World Tour Masters 1000,HARD,2,Juan Monaco,Gilles Simon,Juan Monaco,6-4; 6-0,R32,73,0,1,27,41,25,27,7,14,0,0,8,32,41,2,1,25,52,15,25,11,27,5,9,8,26,52
2011-11-07 00:00:00.000,ATP World Tour Masters 1000 Paris France ATP World Tour Masters 1000,HARD,2,Richard Gasquet,Kevin Anderson,Richard Gasquet,6-4; 7-6(4),R32,112,3,6,38,78,31,38,23,40,2,3,11,54,78,13,1,44,70,31,44,16,26,1,3,11,47,70
2011-11-07 00:00:00.000,ATP World Tour Masters 1000 Paris France ATP World Tour Masters 1000,HARD,2,Roger Federer,Adrian Mannarino,Roger Federer,6-2; 6-3,R32,56,4,0,26,40,23,26,13,14,0,0,9,36,40,1,3,22,43,15,22,10,21,2,5,8,25,43
2011-11-07 00:00:00.000,ATP World Tour Masters 1000 Paris France ATP World Tour Masters 1000,HARD,2,Tomas Berdych,Fernando Verdasco,Tomas Berdych,6-3; 7-5,R32,105,3,1,37,72,28,37,16,35,3,6,11,44,72,2,4,38,63,24,38,9,25,5,10,10,33,63
2011-11-07 00:00:00.000,ATP World Tour Masters 1000 Paris France ATP World Tour Masters 1000,HARD,2,Janko Tipsarevic,Alex Bogomolov Jr.,Janko Tipsarevic,6-1; 6-0,R32,51,8,1,22,39,19,22,9,17,2,2,6,28,39,2,5,20,44,9,20,6,24,3,9,7,15,44
2011-11-07 00:00:00.000,ATP World Tour Masters 1000 Paris France ATP World Tour Masters 1000,HARD,2,Andy Roddick,Julien Benneteau,Andy Roddick,6-4; 6-4,R32,83,9,1,39,60,25,39,13,21,1,3,10,38,60,7,3,36,63,26,36,8,27,4,8,10,34,63
2011-11-07 00:00:00.000,ATP World Tour Masters 1000 Paris France ATP World Tour Masters 1000,HARD,2,Andy Murray,Jeremy Chardy,Andy Murray,6-2; 6-4,R32,79,3,0,28,50,21,28,17,22,0,0,9,38,50,2,2,38,64,26,38,9,26,3,6,9,35,64
2011-11-07 00:00:00.000,ATP World Tour Masters 1000 Paris France ATP World Tour Masters 1000,HARD,2,Novak Djokovic,Viktor Troicki,Novak Djokovic,4-6; 6-3; 6-1,R16,116,3,4,62,95,41,62,15,33,11,14,13,56,95,7,3,41,78,28,41,12,37,5,11,13,40,78
2011-11-07 00:00:00.000,ATP World Tour Masters 1000 Paris France ATP World Tour Masters 1000,HARD,2,Jo-Wilfried Tsonga,Andreas Seppi,Jo-Wilfried Tsonga,6-3; 6-4,R16,76,13,1,39,63,34,39,10,24,2,2,10,44,63,2,2,31,47,20,31,11,16,1,3,9,31,47
2011-11-07 00:00:00.000,ATP World Tour Masters 1000 Paris France ATP World Tour Masters 1000,HARD,2,David Ferrer,Alexandr Dolgopolov,David Ferrer,6-3; 6-2,R16,74,2,2,32,46,24,32,7,14,2,3,8,31,46,1,4,30,70,19,30,13,40,8,13,9,32,70
2011-11-07 00:00:00.000,ATP World Tour Masters 1000 Paris France ATP World Tour Masters 1000,HARD,2,John Isner,Feliciano Lopez,John Isner,6-4; 6-2,R16,72,11,1,42,60,33,42,9,18,1,1,9,42,60,3,5,23,53,19,23,12,30,1,4,9,31,53
2011-11-07 00:00:00.000,ATP World Tour Masters 1000 Paris France ATP World Tour Masters 1000,HARD,2,Juan Monaco,Mardy Fish,Juan Monaco,1-6; 7-6(6); 1-2 RET,R16,102,0,1,39,60,28,39,12,21,1,4,10,40,60,5,0,39,69,29,39,21,30,1,2,12,50,69
2011-11-07 00:00:00.000,ATP World Tour Masters 1000 Paris France ATP World Tour Masters 1000,HARD,2,Roger Federer,Richard Gasquet,Roger Federer,6-2; 6-4,R16,66,3,1,33,44,27,33,8,11,2,3,9,35,44,2,3,33,55,22,33,7,22,2,6,9,29,55
2011-11-07 00:00:00.000,ATP World Tour Masters 1000 Paris France ATP World Tour Masters 1000,HARD,2,Tomas Berdych,Janko Tipsarevic,Tomas Berdych,7-5; 6-4,R16,102,8,4,48,75,35,48,10,27,4,7,11,45,75,4,4,32,68,21,32,16,36,4,9,11,37,68
2011-11-07 00:00:00.000,ATP World Tour Masters 1000 Paris France ATP World Tour Masters 1000,HARD,2,Andy Murray,Andy Roddick,Andy Murray,6-2; 6-2,R16,62,7,2,24,42,20,24,12,18,0,0,8,32,42,1,0,25,41,14,25,6,16,2,6,8,20,41
2011-11-07 00:00:00.000,ATP World Tour Masters 1000 Paris France ATP World Tour Masters 1000,HARD,2,Jo-Wilfried Tsonga,Novak Djokovic,Jo-Wilfried Tsonga,W/O,Q,0,0,0,0,0,0,0,0,0,0,0,0,0,0,0,0,0,0,0,0,0,0,0,0,0,0,0
2011-11-07 00:00:00.000,ATP World Tour Masters 1000 Paris France ATP World Tour Masters 1000,HARD,2,John Isner,David Ferrer,John Isner,6-3; 3-6; 6-3,Q,107,12,4,62,87,45,62,14,25,4,5,14,59,87,3,3,43,70,31,43,17,27,1,3,13,48,70
2011-11-07 00:00:00.000,ATP World Tour Masters 1000 Paris France ATP World Tour Masters 1000,HARD,2,Roger Federer,Juan Monaco,Roger Federer,6-3; 7-5,Q,85,7,0,43,70,35,43,12,27,1,2,11,47,70,4,2,38,61,26,38,11,23,3,6,10,37,61
2011-11-07 00:00:00.000,ATP World Tour Masters 1000 Paris France ATP World Tour Masters 1000,HARD,2,Tomas Berdych,Andy Murray,Tomas Berdych,4-6; 7-6(5); 6-4,Q,193,6,2,67,118,51,67,25,51,15,17,16,76,118,6,4,62,123,48,62,29,61,12,14,16,77,123
2011-11-07 00:00:00.000,ATP World Tour Masters 1000 Paris France ATP World Tour Masters 1000,HARD,2,Jo-Wilfried Tsonga,John Isner,Jo-Wilfried Tsonga,3-6; 7-6(1); 7-6(3),S,178,12,5,68,120,57,68,29,52,8,9,16,86,120,10,3,80,117,61,80,19,37,7,7,17,80,117
2011-11-07 00:00:00.000,ATP World Tour Masters 1000 Paris France ATP World Tour Masters 1000,HARD,2,Roger Federer,Tomas Berdych,Roger Federer,6-4; 6-3,S,80,5,3,32,46,29,32,7,14,0,0,9,36,46,10,6,37,67,28,37,10,30,3,6,10,38,67
2011-11-07 00:00:00.000,ATP World Tour Masters 1000 Paris France ATP World Tour Masters 1000,HARD,2,Roger Federer,Jo-Wilfried Tsonga,Roger Federer,6-1; 7-6(3),F,86,4,1,43,70,38,43,14,27,4,4,10,52,70,7,2,37,61,28,37,12,24,3,5,9,40,61
