event_time,event_name,surface,num_of_sets,playerA,playerB,winner,score,round,duration_minutes,a_aces,a_double_faults,a_first_serve_hits,a_first_serve_total,a_first_serve_won,a_first_serve_played,a_second_serve_won,a_second_serve_played,a_break_points_saved,a_break_points_total,a_service_games,a_service_points_won,a_service_points_total,b_aces,b_double_faults,b_first_serve_hits,b_first_serve_total,b_first_serve_won,b_first_serve_played,b_second_serve_won,b_second_serve_played,b_break_points_saved,b_break_points_total,b_service_games,b_service_points_won,b_service_points_total
2009-01-04 00:00:00.000,Brisbane Australia ATP World Tour 250,HARD,2,Ernests Gulbis,Novak Djokovic,Ernests Gulbis,6-4; 6-4,R32,90,4,2,38,61,28,38,11,23,2,4,10,39,61,3,4,31,65,21,31,14,34,9,13,10,35,65
2009-01-04 00:00:00.000,Brisbane Australia ATP World Tour 250,HARD,2,Paul-Henri Mathieu,Teymuraz Gabashvili,Paul-Henri Mathieu,6-3; 6-3,R32,73,9,2,28,48,26,28,9,20,2,3,9,35,48,3,4,25,50,17,25,10,25,5,9,9,27,50
2009-01-04 00:00:00.000,Brisbane Australia ATP World Tour 250,HARD,2,Kei Nishikori,Bobby Reynolds,Kei Nishikori,6-3; 6-2,R32,59,5,4,23,45,19,23,14,22,0,1,9,33,45,5,1,29,53,18,29,8,24,4,8,8,26,53
2009-01-04 00:00:00.000,Brisbane Australia ATP World Tour 250,HARD,2,Tomas Berdych,Brydan Klein,Tomas Berdych,6-0; 6-4,R32,67,5,2,33,50,28,33,6,17,4,5,8,34,50,0,2,27,51,15,27,7,24,3,8,8,22,51
2009-01-04 00:00:00.000,Brisbane Australia ATP World Tour 250,HARD,2,Fernando Verdasco,Bernard Tomic,Fernando Verdasco,6-4; 6-2,R32,65,1,2,39,50,31,39,5,11,3,4,9,36,50,3,1,34,56,19,34,9,22,9,13,9,28,56
2009-01-04 00:00:00.000,Brisbane Australia ATP World Tour 250,HARD,2,Mario Ancic,Amer Delic,Mario Ancic,7-6(2); 6-7(4); 7-6(6),R32,172,23,3,72,122,56,72,32,50,2,2,18,88,122,21,3,87,129,63,87,26,42,3,3,18,89,129
2009-01-04 00:00:00.000,Brisbane Australia ATP World Tour 250,HARD,2,Florent Serra,Juan Carlos Ferrero,Florent Serra,6-3; 7-6(3),R32,84,6,2,47,77,39,47,15,30,2,3,11,54,77,7,2,41,67,31,41,11,26,8,10,10,42,67
2009-01-04 00:00:00.000,Brisbane Australia ATP World Tour 250,HARD,2,Jurgen Melzer,Mardy Fish,Jurgen Melzer,6-4; 4-6; 7-6(4),R32,143,12,4,74,114,59,74,16,40,8,10,16,75,114,20,2,53,106,41,53,30,53,8,10,16,71,106
2009-01-04 00:00:00.000,Brisbane Australia ATP World Tour 250,HARD,2,Radek Stepanek,Igor Kunitsyn,Radek Stepanek,6-2; 6-2,R32,66,6,1,23,43,19,23,13,20,0,0,8,32,43,1,2,27,47,18,27,6,20,7,11,8,24,47
2009-01-04 00:00:00.000,Brisbane Australia ATP World Tour 250,HARD,2,Michael Llodra,Joseph Sirianni,Michael Llodra,5-7; 7-6(3); 6-2,R32,145,13,3,70,101,57,70,12,31,3,5,16,69,101,9,0,41,94,31,41,28,53,4,7,16,59,94
2009-01-04 00:00:00.000,Brisbane Australia ATP World Tour 250,HARD,2,Julien Benneteau,Robby Ginepri,Julien Benneteau,3-6; 6-3; 7-5,R32,127,10,9,62,99,41,62,17,37,2,6,15,58,99,8,2,53,88,32,53,21,35,4,9,15,53,88
2009-01-04 00:00:00.000,Brisbane Australia ATP World Tour 250,HARD,2,Robin Soderling,Sam Querrey,Robin Soderling,6-3; 6-3,R32,55,7,2,30,52,26,30,13,22,0,0,9,39,52,4,3,27,49,20,27,9,22,2,5,9,29,49
2009-01-04 00:00:00.000,Brisbane Australia ATP World Tour 250,HARD,2,Richard Gasquet,Marc Gicquel,Richard Gasquet,4-6; 6-2; 6-2,R32,133,6,5,42,91,29,42,26,49,3,5,13,55,91,7,6,45,100,30,45,23,55,13,18,13,53,100
2009-01-04 00:00:00.000,Brisbane Australia ATP World Tour 250,HARD,2,Taylor Dent,Steve Darcis,Taylor Dent,7-6(0); 6-2,R32,86,8,5,37,68,31,37,13,31,6,8,10,44,68,4,2,46,70,24,46,14,24,1,5,10,38,70
2009-01-04 00:00:00.000,Brisbane Australia ATP World Tour 250,HARD,2,Jarkko Nieminen,Marcos Baghdatis,Jarkko Nieminen,5-7; 6-1; 6-4,R32,124,2,2,64,89,42,64,15,25,2,5,15,57,89,5,11,45,91,34,45,18,46,6,11,14,52,91
2009-01-04 00:00:00.000,Brisbane Australia ATP World Tour 250,HARD,2,Jo-Wilfried Tsonga,Agustin Calleri,Jo-Wilfried Tsonga,6-2; 7-5,R32,93,3,1,38,56,28,38,12,18,0,1,10,40,56,2,7,41,82,24,41,20,41,7,11,10,44,82
2009-01-04 00:00:00.000,Brisbane Australia ATP World Tour 250,HARD,2,Paul-Henri Mathieu,Ernests Gulbis,Paul-Henri Mathieu,6-3; 6-4,R16,81,6,3,28,61,22,28,23,33,4,4,10,45,61,9,1,34,49,26,34,6,15,1,3,9,32,49
2009-01-04 00:00:00.000,Brisbane Australia ATP World Tour 250,HARD,2,Kei Nishikori,Tomas Berdych,Kei Nishikori,7-6(7); 6-3,R16,100,5,1,39,72,30,39,21,33,4,5,11,51,72,6,1,44,72,29,44,16,28,2,4,10,45,72
2009-01-04 00:00:00.000,Brisbane Australia ATP World Tour 250,HARD,2,Fernando Verdasco,Mario Ancic,Fernando Verdasco,6-2; 6-3,R16,79,6,1,39,53,33,39,8,14,5,5,9,41,53,2,0,33,55,20,33,11,22,2,5,8,31,55
2009-01-04 00:00:00.000,Brisbane Australia ATP World Tour 250,HARD,2,Florent Serra,Jurgen Melzer,Florent Serra,6-4; 6-3,R16,71,4,2,32,63,21,32,20,31,4,5,10,41,63,7,3,28,53,20,28,11,25,1,4,9,31,53
2009-01-04 00:00:00.000,Brisbane Australia ATP World Tour 250,HARD,2,Radek Stepanek,Michael Llodra,Radek Stepanek,7-6(2); 6-3,R16,93,6,3,38,71,35,38,18,33,2,2,11,53,71,5,3,43,67,33,43,10,24,3,4,10,43,67
2009-01-04 00:00:00.000,Brisbane Australia ATP World Tour 250,HARD,2,Robin Soderling,Julien Benneteau,Robin Soderling,6-3; 6-3,R16,66,6,1,25,48,21,25,14,23,3,4,9,35,48,4,2,36,55,20,36,8,19,2,6,9,28,55
2009-01-04 00:00:00.000,Brisbane Australia ATP World Tour 250,HARD,2,Richard Gasquet,Taylor Dent,Richard Gasquet,7-5; 6-4,R16,80,9,2,39,60,32,39,11,21,4,5,11,43,60,4,7,41,70,31,41,10,29,2,5,11,41,70
2009-01-04 00:00:00.000,Brisbane Australia ATP World Tour 250,HARD,2,Jo-Wilfried Tsonga,Jarkko Nieminen,Jo-Wilfried Tsonga,0-6; 7-6(1); 7-6(5),R16,135,9,2,62,95,45,62,15,33,1,5,15,60,95,0,0,69,101,44,69,19,32,5,6,15,63,101
2009-01-04 00:00:00.000,Brisbane Australia ATP World Tour 250,HARD,2,Paul-Henri Mathieu,Kei Nishikori,Paul-Henri Mathieu,6-3; 6-4,Q,87,6,3,43,63,29,43,13,20,4,5,10,42,63,4,4,34,64,21,34,16,30,2,5,9,37,64
2009-01-04 00:00:00.000,Brisbane Australia ATP World Tour 250,HARD,2,Fernando Verdasco,Florent Serra,Fernando Verdasco,4-6; 6-0; 6-3,Q,114,7,2,66,79,49,66,7,13,6,7,13,56,79,3,4,56,85,34,56,13,29,5,9,12,47,85
2009-01-04 00:00:00.000,Brisbane Australia ATP World Tour 250,HARD,2,Radek Stepanek,Robin Soderling,Radek Stepanek,2-6; 6-4; 6-3,Q,106,6,4,38,72,31,38,14,34,2,7,14,45,72,9,4,43,78,30,43,13,35,8,13,13,43,78
2009-01-04 00:00:00.000,Brisbane Australia ATP World Tour 250,HARD,2,Richard Gasquet,Jo-Wilfried Tsonga,Richard Gasquet,1-6; 6-4; 6-2,Q,98,3,3,37,68,30,37,17,31,3,5,12,47,68,8,4,45,76,35,45,13,31,3,6,13,48,76
2009-01-04 00:00:00.000,Brisbane Australia ATP World Tour 250,HARD,2,Fernando Verdasco,Paul-Henri Mathieu,Fernando Verdasco,6-2; 6-1,S,76,4,2,38,50,28,38,5,12,3,4,8,33,50,0,3,32,60,19,32,7,28,3,8,7,26,60
2009-01-04 00:00:00.000,Brisbane Australia ATP World Tour 250,HARD,2,Radek Stepanek,Richard Gasquet,Radek Stepanek,2-6; 6-2; 6-4,S,132,5,1,48,78,31,48,15,30,5,9,13,46,78,6,5,61,111,37,61,22,50,14,19,13,59,111
2009-01-04 00:00:00.000,Brisbane Australia ATP World Tour 250,HARD,2,Radek Stepanek,Fernando Verdasco,Radek Stepanek,3-6; 6-3; 6-4,F,138,3,1,41,81,31,41,25,40,6,8,14,56,81,1,1,75,87,48,75,5,12,2,5,14,53,87
2009-01-05 00:00:00.000,Chennai India ATP World Tour 250,HARD,2,Nikolay Davydenko,Daniel Koellerer,Nikolay Davydenko,6-2; 6-3,R32,71,8,0,31,48,25,31,11,17,0,0,9,36,48,0,1,27,49,16,27,13,22,6,9,8,29,49
2009-01-05 00:00:00.000,Chennai India ATP World Tour 250,HARD,2,Lukas Dlouhy,Go Soeda,Lukas Dlouhy,3-6; 6-2; 6-4,R32,114,6,5,57,83,38,57,13,26,4,7,14,51,83,1,1,61,98,37,61,18,37,10,14,13,55,98
2009-01-05 00:00:00.000,Chennai India ATP World Tour 250,HARD,2,Andreas Beck,Roko Karanusic,Andreas Beck,6-1; 6-0,R32,39,3,0,25,31,19,25,5,6,0,0,6,24,31,2,4,36,45,16,36,1,9,3,9,7,17,45
2009-01-05 00:00:00.000,Chennai India ATP World Tour 250,HARD,2,Marcel Granollers,Hyung-Taik Lee,Marcel Granollers,6-4; 7-5,R32,113,7,4,37,74,26,37,20,37,4,6,11,46,74,0,3,45,81,27,45,18,36,7,11,11,45,81
2009-01-05 00:00:00.000,Chennai India ATP World Tour 250,HARD,2,Marin Cilic,Alberto Martin,Marin Cilic,6-4; 6-4,R32,92,4,3,35,69,27,35,20,34,5,5,10,47,69,0,3,36,63,23,36,17,27,1,3,10,40,63
2009-01-05 00:00:00.000,Chennai India ATP World Tour 250,HARD,2,Denis Istomin,Rohan Bopanna,Denis Istomin,6-4; 7-6(3),R32,86,3,1,50,70,39,50,12,20,2,3,11,51,70,9,2,41,77,30,41,17,36,2,4,11,47,77
2009-01-05 00:00:00.000,Chennai India ATP World Tour 250,HARD,2,Dudi Sela,Ruben Ramirez Hidalgo,Dudi Sela,4-6; 7-6(3); 6-1,R32,144,4,1,50,81,38,50,14,31,4,8,14,52,81,5,9,70,121,43,70,21,51,11,17,15,64,121
2009-01-05 00:00:00.000,Chennai India ATP World Tour 250,HARD,2,Janko Tipsarevic,Pablo Andujar,Janko Tipsarevic,6-3; 6-2,R32,80,4,0,34,57,25,34,12,23,1,2,9,37,57,3,5,41,55,23,41,6,14,2,6,8,29,55
2009-01-05 00:00:00.000,Chennai India ATP World Tour 250,HARD,2,Carlos Moya,Danai Udomchoke,Carlos Moya,6-3; 7-6(4),R32,81,5,0,41,64,31,41,16,23,0,1,11,47,64,2,5,40,65,30,40,10,25,4,6,10,40,65
2009-01-05 00:00:00.000,Chennai India ATP World Tour 250,HARD,2,Somdev Devvarman,Kevin Kim,Somdev Devvarman,6-3; 6-3,R32,75,10,3,34,57,23,34,14,23,2,3,9,37,57,0,1,33,60,22,33,10,27,4,8,9,32,60
2009-01-05 00:00:00.000,Chennai India ATP World Tour 250,HARD,2,Ivo Minar,Wayne Odesnik,Ivo Minar,6-3; 6-0,R32,60,4,3,25,44,20,25,10,19,1,2,7,30,44,1,1,36,54,16,36,5,18,2,8,8,21,54
2009-01-05 00:00:00.000,Chennai India ATP World Tour 250,HARD,2,Ivo Karlovic,Rajeev Ram,Ivo Karlovic,6-4; 6-3,R32,66,10,1,29,46,27,29,13,17,0,0,10,40,46,0,2,34,55,25,34,10,21,6,8,9,35,55
2009-01-05 00:00:00.000,Chennai India ATP World Tour 250,HARD,2,Rainer Schuettler,Prakash Amritraj,Rainer Schuettler,6-2; 4-6; 6-1,R32,85,3,2,42,68,32,42,18,26,1,2,13,50,68,2,0,45,61,27,45,9,16,1,5,12,36,61
2009-01-05 00:00:00.000,Chennai India ATP World Tour 250,HARD,2,Simon Greul,Daniel Gimeno-Traver,Simon Greul,6-3; 6-4,R32,68,5,3,33,58,28,33,15,25,1,1,10,43,58,0,1,34,48,22,34,8,14,0,2,9,30,48
2009-01-05 00:00:00.000,Chennai India ATP World Tour 250,HARD,2,Bjorn Phau,Santiago Ventura,Bjorn Phau,6-2; 7-5,R32,80,5,2,30,64,22,30,19,34,3,5,10,41,64,2,7,31,56,19,31,7,25,1,6,10,26,56
2009-01-05 00:00:00.000,Chennai India ATP World Tour 250,HARD,2,Flavio Cipolla,Stanislas Wawrinka,Flavio Cipolla,6-4; 6-1,R32,94,0,3,57,72,39,57,7,15,6,7,9,46,72,3,3,25,53,16,25,12,28,5,9,8,28,53
2009-01-05 00:00:00.000,Chennai India ATP World Tour 250,HARD,2,Lukas Dlouhy,Nikolay Davydenko,Lukas Dlouhy,W/O,R16,0,0,0,0,0,0,0,0,0,0,0,0,0,0,0,0,0,0,0,0,0,0,0,0,0,0,0
2009-01-05 00:00:00.000,Chennai India ATP World Tour 250,HARD,2,Marcel Granollers,Andreas Beck,Marcel Granollers,6-4; 6-1,R16,60,7,2,28,49,23,28,10,21,3,4,8,33,49,1,6,40,70,23,40,11,30,10,15,9,34,70
2009-01-05 00:00:00.000,Chennai India ATP World Tour 250,HARD,2,Marin Cilic,Denis Istomin,Marin Cilic,6-0; 6-4,R16,64,5,4,23,41,21,23,11,18,0,0,8,32,41,2,1,44,60,23,44,8,16,5,9,8,31,60
2009-01-05 00:00:00.000,Chennai India ATP World Tour 250,HARD,2,Janko Tipsarevic,Dudi Sela,Janko Tipsarevic,7-6(3); 6-4,R16,124,6,4,45,85,36,45,19,40,4,5,11,55,85,3,1,38,67,27,38,16,29,3,5,11,43,67
2009-01-05 00:00:00.000,Chennai India ATP World Tour 250,HARD,2,Somdev Devvarman,Carlos Moya,Somdev Devvarman,4-6; 7-5; 6-4,R16,134,10,2,54,93,43,54,22,39,6,8,16,65,93,3,4,56,96,45,56,19,40,7,10,16,64,96
2009-01-05 00:00:00.000,Chennai India ATP World Tour 250,HARD,2,Ivo Karlovic,Ivo Minar,Ivo Karlovic,6-1; 6-4,R16,53,16,0,26,46,23,26,14,20,2,2,9,37,46,3,1,29,39,21,29,3,10,2,5,8,24,39
2009-01-05 00:00:00.000,Chennai India ATP World Tour 250,HARD,2,Rainer Schuettler,Simon Greul,Rainer Schuettler,6-4; 6-2,R16,82,3,2,39,56,28,39,11,17,5,6,9,39,56,1,2,33,59,20,33,10,26,0,4,9,30,59
2009-01-05 00:00:00.000,Chennai India ATP World Tour 250,HARD,2,Bjorn Phau,Flavio Cipolla,Bjorn Phau,6-1; 6-2,R16,49,5,2,24,41,19,24,13,17,0,0,8,32,41,0,3,30,37,15,30,3,7,2,6,7,18,37
2009-01-05 00:00:00.000,Chennai India ATP World Tour 250,HARD,2,Marcel Granollers,Lukas Dlouhy,Marcel Granollers,7-5; 2-6; 6-4,Q,120,3,3,45,88,37,45,19,43,0,3,15,56,88,3,5,56,90,41,56,17,34,4,7,15,58,90
2009-01-05 00:00:00.000,Chennai India ATP World Tour 250,HARD,2,Marin Cilic,Janko Tipsarevic,Marin Cilic,6-4; 0-6; 6-4,Q,121,10,4,50,86,39,50,16,36,9,12,13,55,86,1,3,55,81,39,55,15,26,2,4,13,54,81
2009-01-05 00:00:00.000,Chennai India ATP World Tour 250,HARD,2,Somdev Devvarman,Ivo Karlovic,Somdev Devvarman,7-6(4); 6-4,Q,86,7,1,47,66,37,47,14,19,0,0,11,51,66,10,0,45,60,39,45,8,15,1,2,11,47,60
2009-01-05 00:00:00.000,Chennai India ATP World Tour 250,HARD,2,Rainer Schuettler,Bjorn Phau,Rainer Schuettler,6-2; 7-5,Q,97,3,3,51,68,28,51,9,17,3,6,10,37,68,2,0,30,65,17,30,14,35,3,9,10,31,65
2009-01-05 00:00:00.000,Chennai India ATP World Tour 250,HARD,2,Marin Cilic,Marcel Granollers,Marin Cilic,6-4; 6-3,S,72,6,1,25,44,21,25,12,19,0,1,9,33,44,2,0,37,59,23,37,11,22,1,5,10,34,59
2009-01-05 00:00:00.000,Chennai India ATP World Tour 250,HARD,2,Somdev Devvarman,Rainer Schuettler,Somdev Devvarman,W/O,S,0,0,0,0,0,0,0,0,0,0,0,0,0,0,0,0,0,0,0,0,0,0,0,0,0,0,0
2009-01-05 00:00:00.000,Chennai India ATP World Tour 250,HARD,2,Marin Cilic,Somdev Devvarman,Marin Cilic,6-4; 7-6(3),F,120,9,1,42,81,31,42,23,39,9,10,11,54,81,1,3,41,71,31,41,13,30,2,4,11,44,71
2009-01-05 00:00:00.000,Doha Qatar ATP World Tour 250,HARD,2,Rafael Nadal,Fabrice Santoro,Rafael Nadal,6-0; 6-1,R32,47,1,0,20,27,19,20,5,7,0,0,6,24,27,2,1,19,39,8,19,4,20,3,9,7,12,39
2009-01-05 00:00:00.000,Doha Qatar ATP World Tour 250,HARD,2,Karol Beck,Michal Przysiezny,Karol Beck,4-6; 6-4; 7-5,R32,128,3,4,55,90,45,55,20,35,1,3,16,65,90,9,1,57,96,41,57,22,39,4,7,16,63,96
2009-01-05 00:00:00.000,Doha Qatar ATP World Tour 250,HARD,2,Nicolas Devilder,Abdulla Hajji,Nicolas Devilder,6-0; 6-3,R32,46,6,1,18,31,17,18,11,13,0,0,7,28,31,0,0,35,54,19,35,4,19,2,7,8,23,54
2009-01-05 00:00:00.000,Doha Qatar ATP World Tour 250,HARD,2,Gael Monfils,Jan Hernych,Gael Monfils,6-2; 6-2,R32,55,9,2,35,50,27,35,6,15,2,3,8,33,50,1,2,26,41,15,26,2,15,1,6,8,17,41
2009-01-05 00:00:00.000,Doha Qatar ATP World Tour 250,HARD,2,Andy Roddick,Ivan Navarro,Andy Roddick,6-1; 6-3,R32,62,8,0,34,46,26,34,9,12,1,1,8,35,46,3,8,20,52,16,20,10,32,6,10,8,26,52
2009-01-05 00:00:00.000,Doha Qatar ATP World Tour 250,HARD,2,Arnaud Clement,Diego Junqueira,Arnaud Clement,6-1; 6-2,R32,69,4,1,34,46,28,34,6,12,1,1,8,34,46,0,0,34,56,20,34,7,22,5,9,7,27,56
2009-01-05 00:00:00.000,Doha Qatar ATP World Tour 250,HARD,2,Victor Hanescu,Viktor Troicki,Victor Hanescu,6-4; 6-2,R32,70,1,1,37,49,28,37,8,12,3,4,9,36,49,8,3,33,58,20,33,11,25,7,11,9,31,58
2009-01-05 00:00:00.000,Doha Qatar ATP World Tour 250,HARD,2,Mikhail Youzhny,Igor Andreev,Mikhail Youzhny,4-6; 6-3; 6-4,R32,121,4,0,64,86,43,64,16,22,1,3,15,59,86,2,4,46,85,36,46,18,39,5,8,14,54,85
2009-01-05 00:00:00.000,Doha Qatar ATP World Tour 250,HARD,2,Alexander Peya,Dmitry Tursunov,Alexander Peya,2-6; 6-3; 6-4,R32,115,4,5,60,101,45,60,19,41,8,10,14,64,101,8,3,53,90,33,53,23,37,8,10,13,56,90
2009-01-05 00:00:00.000,Doha Qatar ATP World Tour 250,HARD,2,Sergiy Stakhovsky,Christophe Rochus,Sergiy Stakhovsky,2-6; 6-3; 7-6(3),R32,126,14,4,63,95,47,63,15,32,1,4,15,62,95,0,7,53,97,39,53,21,44,3,5,14,60,97
2009-01-05 00:00:00.000,Doha Qatar ATP World Tour 250,HARD,2,Philipp Petzschner,Jeremy Chardy,Philipp Petzschner,7-6(2); 6-3,R32,88,4,3,35,64,31,35,18,29,5,6,11,49,64,5,2,48,70,30,48,12,22,2,4,10,42,70
2009-01-05 00:00:00.000,Doha Qatar ATP World Tour 250,HARD,2,Andy Murray,Albert Montanes,Andy Murray,6-2; 6-4,R32,75,3,3,35,59,27,35,12,24,4,5,9,39,59,3,5,40,71,26,40,13,31,11,15,9,39,71
2009-01-05 00:00:00.000,Doha Qatar ATP World Tour 250,HARD,2,Philipp Kohlschreiber,Marco Chiudinelli,Philipp Kohlschreiber,6-4; 6-3,R32,75,3,0,38,51,27,38,11,13,0,0,9,38,51,3,2,41,59,26,41,12,18,1,4,10,38,59
2009-01-05 00:00:00.000,Doha Qatar ATP World Tour 250,HARD,2,Kristof Vliegen,Oscar Hernandez,Kristof Vliegen,6-1; 6-7(4); 7-6(5),R32,158,7,1,69,107,50,69,21,38,7,9,16,71,107,2,4,78,120,48,78,23,42,10,14,15,71,120
2009-01-05 00:00:00.000,Doha Qatar ATP World Tour 250,HARD,2,Andreas Seppi,Denis Gremelmayr,Andreas Seppi,6-4; 6-2,R32,69,0,1,40,57,31,40,6,17,2,4,9,37,57,1,2,32,61,18,32,12,29,8,13,9,30,61
2009-01-05 00:00:00.000,Doha Qatar ATP World Tour 250,HARD,2,Roger Federer,Potito Starace,Roger Federer,6-2; 6-2,R32,49,5,1,25,39,22,25,10,14,0,0,8,32,39,4,1,33,49,20,33,5,16,1,5,8,25,49
2009-01-05 00:00:00.000,Doha Qatar ATP World Tour 250,HARD,2,Rafael Nadal,Karol Beck,Rafael Nadal,6-1; 6-2,R16,61,2,3,20,35,18,20,8,15,1,2,7,26,35,1,2,33,49,14,33,5,16,3,9,8,19,49
2009-01-05 00:00:00.000,Doha Qatar ATP World Tour 250,HARD,2,Gael Monfils,Nicolas Devilder,Gael Monfils,7-5; 7-6(4),R16,127,9,0,48,79,36,48,16,31,2,4,12,52,79,0,2,70,112,45,70,18,42,10,13,12,63,112
2009-01-05 00:00:00.000,Doha Qatar ATP World Tour 250,HARD,2,Andy Roddick,Arnaud Clement,Andy Roddick,6-3; 7-5,R16,103,11,0,41,59,31,41,11,18,3,5,11,42,59,3,0,42,77,20,42,20,35,5,9,10,40,77
2009-01-05 00:00:00.000,Doha Qatar ATP World Tour 250,HARD,2,Victor Hanescu,Mikhail Youzhny,Victor Hanescu,6-2; 6-4,R16,90,3,0,31,45,23,31,13,14,0,0,9,36,45,3,1,60,83,36,60,10,23,5,8,9,46,83
2009-01-05 00:00:00.000,Doha Qatar ATP World Tour 250,HARD,2,Sergiy Stakhovsky,Alexander Peya,Sergiy Stakhovsky,7-5; 6-3,R16,86,6,1,46,65,34,46,10,19,1,2,11,44,65,2,2,40,72,25,40,15,32,4,7,10,40,72
2009-01-05 00:00:00.000,Doha Qatar ATP World Tour 250,HARD,2,Andy Murray,Philipp Petzschner,Andy Murray,6-2; 6-4,R16,71,6,0,31,43,27,31,9,12,0,0,9,36,43,3,3,36,65,24,36,12,29,5,8,9,36,65
2009-01-05 00:00:00.000,Doha Qatar ATP World Tour 250,HARD,2,Philipp Kohlschreiber,Kristof Vliegen,Philipp Kohlschreiber,6-4; 6-7(4); 6-4,R16,139,8,1,70,105,52,70,21,35,4,6,16,73,105,6,2,68,105,49,68,15,37,4,8,16,64,105
2009-01-05 00:00:00.000,Doha Qatar ATP World Tour 250,HARD,2,Roger Federer,Andreas Seppi,Roger Federer,6-3; 6-3,R16,80,4,2,38,66,27,38,16,28,3,4,9,43,66,0,3,40,65,25,40,10,25,6,10,9,35,65
2009-01-05 00:00:00.000,Doha Qatar ATP World Tour 250,HARD,2,Gael Monfils,Rafael Nadal,Gael Monfils,6-4; 6-4,Q,89,7,0,40,57,33,40,6,17,0,1,10,39,57,0,2,46,63,29,46,7,17,4,7,10,36,63
2009-01-05 00:00:00.000,Doha Qatar ATP World Tour 250,HARD,2,Andy Roddick,Victor Hanescu,Andy Roddick,6-3; 6-2,Q,67,13,0,42,50,32,42,6,8,1,1,9,38,50,5,1,46,61,26,46,7,15,9,12,8,33,61
2009-01-05 00:00:00.000,Doha Qatar ATP World Tour 250,HARD,2,Andy Murray,Sergiy Stakhovsky,Andy Murray,6-4; 6-2,Q,76,4,0,32,53,23,32,11,21,2,4,9,34,53,1,2,34,59,19,34,8,25,4,9,9,27,59
2009-01-05 00:00:00.000,Doha Qatar ATP World Tour 250,HARD,2,Roger Federer,Philipp Kohlschreiber,Roger Federer,6-2; 7-6(6),Q,86,4,0,42,60,29,42,11,18,1,3,10,40,60,1,2,54,74,33,54,6,20,3,7,10,39,74
2009-01-05 00:00:00.000,Doha Qatar ATP World Tour 250,HARD,2,Andy Roddick,Gael Monfils,Andy Roddick,7-6(1); 3-6; 6-3,S,122,8,1,69,94,55,69,8,25,5,8,15,63,94,11,2,57,86,42,57,15,29,2,5,15,57,86
2009-01-05 00:00:00.000,Doha Qatar ATP World Tour 250,HARD,2,Andy Murray,Roger Federer,Andy Murray,6-7(6); 6-2; 6-2,S,125,7,1,57,87,49,57,15,30,3,3,14,64,87,7,4,61,95,42,61,18,34,2,6,14,60,95
2009-01-05 00:00:00.000,Doha Qatar ATP World Tour 250,HARD,2,Andy Murray,Andy Roddick,Andy Murray,6-4; 6-2,F,71,5,1,35,50,28,35,9,15,1,1,9,37,50,3,0,32,46,21,32,6,14,0,3,9,27,46
2009-01-12 00:00:00.000,Auckland New Zealand ATP World Tour 250,HARD,2,Juan Martin Del Potro,N/A Bye,Juan Martin Del Potro,,R32,0,0,0,0,0,0,0,0,0,0,0,0,0,0,0,0,0,0,0,0,0,0,0,0,0,0,0
2009-01-12 00:00:00.000,Auckland New Zealand ATP World Tour 250,HARD,2,Ernests Gulbis,Marcel Granollers,Ernests Gulbis,6-4; 6-7(5); 6-1,R32,117,13,6,64,103,48,64,20,39,5,7,15,68,103,4,3,53,87,36,53,16,34,4,9,14,52,87
2009-01-12 00:00:00.000,Auckland New Zealand ATP World Tour 250,HARD,2,Viktor Troicki,Igor Kunitsyn,Viktor Troicki,6-1; 6-2,R32,54,11,2,29,47,25,29,9,18,4,4,8,34,47,0,0,19,37,10,19,8,18,0,4,7,18,37
2009-01-12 00:00:00.000,Auckland New Zealand ATP World Tour 250,HARD,2,Juan Monaco,Victor Hanescu,Juan Monaco,6-3; 6-4,R32,90,3,2,32,56,25,32,10,24,0,2,9,35,56,0,3,44,71,25,44,12,27,6,11,10,37,71
2009-01-12 00:00:00.000,Auckland New Zealand ATP World Tour 250,HARD,2,Robin Soderling,N/A Bye,Robin Soderling,,R32,0,0,0,0,0,0,0,0,0,0,0,0,0,0,0,0,0,0,0,0,0,0,0,0,0,0,0
2009-01-12 00:00:00.000,Auckland New Zealand ATP World Tour 250,HARD,2,Bobby Reynolds,Oscar Hernandez,Bobby Reynolds,7-6(4); 5-7; 6-2,R32,163,9,2,54,95,46,54,24,41,3,4,16,70,95,10,8,74,130,50,74,28,56,10,12,16,78,130
2009-01-12 00:00:00.000,Auckland New Zealand ATP World Tour 250,HARD,2,Robby Ginepri,Jose (Rubin) Statham,Robby Ginepri,6-2; 6-3,R32,73,1,1,33,55,23,33,13,22,4,5,9,36,55,5,4,47,76,28,47,11,29,11,15,8,39,76
2009-01-12 00:00:00.000,Auckland New Zealand ATP World Tour 250,HARD,2,John Isner,Albert Montanes,John Isner,7-6(4); 7-5,R32,90,12,1,48,68,37,48,14,20,2,3,12,51,68,4,6,49,83,34,49,20,34,3,5,12,54,83
2009-01-12 00:00:00.000,Auckland New Zealand ATP World Tour 250,HARD,2,Sam Querrey,Daniel King-Turner,Sam Querrey,6-4; 7-5,R32,74,8,6,37,63,28,37,17,26,0,1,11,45,63,1,9,27,71,21,27,21,44,1,4,11,42,71
2009-01-12 00:00:00.000,Auckland New Zealand ATP World Tour 250,HARD,2,Gilles Muller,Florent Serra,Gilles Muller,6-3; 6-4,R32,64,12,3,28,52,24,28,15,24,0,1,10,39,52,6,3,29,53,20,29,11,24,2,5,9,31,53
2009-01-12 00:00:00.000,Auckland New Zealand ATP World Tour 250,HARD,2,Yen-Hsun Lu,Steve Darcis,Yen-Hsun Lu,7-6(5); 6-2,R32,113,4,3,49,82,32,49,17,33,7,9,10,49,82,3,3,50,88,29,50,17,38,11,15,10,46,88
2009-01-12 00:00:00.000,Auckland New Zealand ATP World Tour 250,HARD,2,Nicolas Almagro,N/A Bye,Nicolas Almagro,,R32,0,0,0,0,0,0,0,0,0,0,0,0,0,0,0,0,0,0,0,0,0,0,0,0,0,0,0
2009-01-12 00:00:00.000,Auckland New Zealand ATP World Tour 250,HARD,2,Philipp Kohlschreiber,Dominik Hrbaty,Philipp Kohlschreiber,6-1; 6-2,R32,52,3,0,28,42,25,28,8,14,0,0,8,33,42,0,4,20,38,13,20,5,18,2,6,7,18,38
2009-01-12 00:00:00.000,Auckland New Zealand ATP World Tour 250,HARD,2,Juan Carlos Ferrero,Kei Nishikori,Juan Carlos Ferrero,5-3 RET,R32,33,3,0,16,24,11,16,3,8,0,1,4,14,24,3,2,16,31,8,16,7,15,2,4,4,15,31
2009-01-12 00:00:00.000,Auckland New Zealand ATP World Tour 250,HARD,2,Marc Gicquel,Agustin Calleri,Marc Gicquel,3-6; 6-4; 6-4,R32,117,4,7,59,96,41,59,21,37,5,8,15,62,96,9,2,39,86,29,39,26,47,5,8,14,55,86
2009-01-12 00:00:00.000,Auckland New Zealand ATP World Tour 250,HARD,2,David Ferrer,N/A Bye,David Ferrer,,R32,0,0,0,0,0,0,0,0,0,0,0,0,0,0,0,0,0,0,0,0,0,0,0,0,0,0,0
2009-01-12 00:00:00.000,Auckland New Zealand ATP World Tour 250,HARD,2,Juan Martin Del Potro,Ernests Gulbis,Juan Martin Del Potro,4-6; 6-4; 6-1,R16,103,4,1,40,66,31,40,13,26,1,4,13,44,66,8,5,49,74,33,49,9,25,2,8,14,42,74
2009-01-12 00:00:00.000,Auckland New Zealand ATP World Tour 250,HARD,2,Viktor Troicki,Juan Monaco,Viktor Troicki,3-6; 6-4; 6-2,R16,148,14,3,54,93,39,54,13,39,8,13,14,52,93,3,5,52,95,31,52,16,43,8,14,13,47,95
2009-01-12 00:00:00.000,Auckland New Zealand ATP World Tour 250,HARD,2,Robin Soderling,Bobby Reynolds,Robin Soderling,6-3; 4-6; 6-2,R16,96,8,2,57,80,44,57,11,23,8,11,14,55,80,12,2,51,81,32,51,14,30,2,7,13,46,81
2009-01-12 00:00:00.000,Auckland New Zealand ATP World Tour 250,HARD,2,John Isner,Robby Ginepri,John Isner,6-4; 6-7(1); 7-6(5),R16,144,17,1,86,126,56,86,24,40,9,11,17,80,126,12,2,69,103,55,69,18,34,2,5,17,73,103
2009-01-12 00:00:00.000,Auckland New Zealand ATP World Tour 250,HARD,2,Sam Querrey,Gilles Muller,Sam Querrey,3-6; 6-3; 6-4,R16,100,9,4,49,89,41,49,19,40,6,7,14,60,89,8,3,47,81,35,47,20,34,3,5,14,55,81
2009-01-12 00:00:00.000,Auckland New Zealand ATP World Tour 250,HARD,2,Nicolas Almagro,Yen-Hsun Lu,Nicolas Almagro,6-7(4); 6-3; 6-2,R16,119,11,1,50,87,38,50,21,37,1,3,15,59,87,5,4,45,89,31,45,23,44,2,7,14,54,89
2009-01-12 00:00:00.000,Auckland New Zealand ATP World Tour 250,HARD,2,Philipp Kohlschreiber,Juan Carlos Ferrero,Philipp Kohlschreiber,6-4; 4-6; 7-6(5),R16,132,5,5,66,105,44,66,25,39,4,6,16,69,105,9,3,66,98,49,66,18,32,1,3,16,67,98
2009-01-12 00:00:00.000,Auckland New Zealand ATP World Tour 250,HARD,2,David Ferrer,Marc Gicquel,David Ferrer,6-7(3); 6-4; 6-4,R16,156,5,5,63,114,45,63,26,51,8,10,16,71,114,5,5,60,112,44,60,25,52,6,10,16,69,112
2009-01-12 00:00:00.000,Auckland New Zealand ATP World Tour 250,HARD,2,Juan Martin Del Potro,Viktor Troicki,Juan Martin Del Potro,6-3; 6-2,Q,83,1,3,39,54,28,39,7,15,3,4,9,35,54,4,4,29,62,17,29,15,33,5,9,8,32,62
2009-01-12 00:00:00.000,Auckland New Zealand ATP World Tour 250,HARD,2,Robin Soderling,John Isner,Robin Soderling,6-4; 6-4,Q,59,11,2,30,47,28,30,12,17,0,0,10,40,47,8,0,43,60,26,43,12,17,0,2,10,38,60
2009-01-12 00:00:00.000,Auckland New Zealand ATP World Tour 250,HARD,2,Sam Querrey,Nicolas Almagro,Sam Querrey,6-3; 6-2,Q,63,10,0,29,42,25,29,7,13,0,0,8,32,42,4,3,34,63,22,34,12,29,3,7,9,34,63
2009-01-12 00:00:00.000,Auckland New Zealand ATP World Tour 250,HARD,2,David Ferrer,Philipp Kohlschreiber,David Ferrer,W/O,Q,0,0,0,0,0,0,0,0,0,0,0,0,0,0,0,0,0,0,0,0,0,0,0,0,0,0,0
2009-01-12 00:00:00.000,Auckland New Zealand ATP World Tour 250,HARD,2,Juan Martin Del Potro,Robin Soderling,Juan Martin Del Potro,6-4; 6-3,S,77,7,0,27,45,22,27,14,18,0,0,9,36,45,2,8,42,71,33,42,6,29,3,6,10,39,71
2009-01-12 00:00:00.000,Auckland New Zealand ATP World Tour 250,HARD,2,Sam Querrey,David Ferrer,Sam Querrey,3-6; 6-3; 7-6(4),S,127,10,4,54,101,45,54,16,47,5,9,15,61,101,1,4,58,105,38,58,24,47,6,10,15,62,105
2009-01-12 00:00:00.000,Auckland New Zealand ATP World Tour 250,HARD,2,Juan Martin Del Potro,Sam Querrey,Juan Martin Del Potro,6-4; 6-4,F,85,9,2,46,66,32,46,11,20,3,4,10,43,66,10,3,34,62,27,34,10,28,5,8,10,37,62
2009-01-12 00:00:00.000,Sydney Australia ATP World Tour 250,HARD,2,Novak Djokovic,N/A Bye,Novak Djokovic,,R32,0,0,0,0,0,0,0,0,0,0,0,0,0,0,0,0,0,0,0,0,0,0,0,0,0,0,0
2009-01-12 00:00:00.000,Sydney Australia ATP World Tour 250,HARD,2,Paul-Henri Mathieu,Andreas Seppi,Paul-Henri Mathieu,6-2; 2-6; 6-3,R32,118,8,3,68,111,43,68,23,43,11,13,13,66,111,7,1,36,64,25,36,17,28,1,4,12,42,64
2009-01-12 00:00:00.000,Sydney Australia ATP World Tour 250,HARD,2,Mario Ancic,Xavier Malisse,Mario Ancic,4-6; 7-6(5); 6-3,R32,145,7,1,53,85,37,53,20,32,3,6,15,57,85,6,2,71,116,46,71,23,45,9,13,16,69,116
2009-01-12 00:00:00.000,Sydney Australia ATP World Tour 250,HARD,2,Tommy Robredo,Jurgen Melzer,Tommy Robredo,6-3; 6-4,R32,90,3,1,45,80,30,45,22,35,7,7,10,52,80,2,0,34,56,20,34,14,22,4,6,9,34,56
2009-01-12 00:00:00.000,Sydney Australia ATP World Tour 250,HARD,2,Jo-Wilfried Tsonga,N/A Bye,Jo-Wilfried Tsonga,,R32,0,0,0,0,0,0,0,0,0,0,0,0,0,0,0,0,0,0,0,0,0,0,0,0,0,0,0
2009-01-12 00:00:00.000,Sydney Australia ATP World Tour 250,HARD,2,Simone Bolelli,Potito Starace,Simone Bolelli,7-6(1); 6-4,R32,102,5,1,40,65,32,40,17,25,4,5,11,49,65,4,5,65,83,40,65,10,18,6,8,11,50,83
2009-01-12 00:00:00.000,Sydney Australia ATP World Tour 250,HARD,2,Jarkko Nieminen,Feliciano Lopez,Jarkko Nieminen,6-2; 7-6(9),R32,84,3,2,42,64,34,42,12,22,3,4,10,46,64,5,4,27,60,18,27,16,33,1,4,10,34,60
2009-01-12 00:00:00.000,Sydney Australia ATP World Tour 250,HARD,2,Chris Guccione,Tomas Berdych,Chris Guccione,6-3; 6-4,R32,66,10,0,36,61,30,36,14,25,2,2,10,44,61,2,0,24,43,18,24,12,19,0,2,9,30,43
2009-01-12 00:00:00.000,Sydney Australia ATP World Tour 250,HARD,2,Janko Tipsarevic,Mardy Fish,Janko Tipsarevic,6-4; 3-6; 6-4,R32,121,2,2,43,84,32,43,22,41,4,7,14,54,84,17,4,33,83,30,33,23,50,3,7,15,53,83
2009-01-12 00:00:00.000,Sydney Australia ATP World Tour 250,HARD,2,Lleyton Hewitt,Julien Benneteau,Lleyton Hewitt,5-7; 6-2; 6-4,R32,125,7,6,49,89,40,49,19,40,4,7,15,59,89,6,5,59,89,38,59,13,30,6,11,15,51,89
2009-01-12 00:00:00.000,Sydney Australia ATP World Tour 250,HARD,2,Michael Llodra,Denis Gremelmayr,Michael Llodra,6-0; 6-2,R32,46,7,2,25,35,22,25,6,10,0,0,7,28,35,0,3,17,39,9,17,7,22,1,6,7,16,39
2009-01-12 00:00:00.000,Sydney Australia ATP World Tour 250,HARD,2,David Nalbandian,N/A Bye,David Nalbandian,,R32,0,0,0,0,0,0,0,0,0,0,0,0,0,0,0,0,0,0,0,0,0,0,0,0,0,0,0
2009-01-12 00:00:00.000,Sydney Australia ATP World Tour 250,HARD,2,Igor Andreev,Frank Dancevic,Igor Andreev,7-6(2); 6-3,R32,77,11,1,38,58,34,38,10,20,0,1,10,44,58,2,1,48,75,27,48,17,27,1,4,11,44,75
2009-01-12 00:00:00.000,Sydney Australia ATP World Tour 250,HARD,2,Jeremy Chardy,Radek Stepanek,Jeremy Chardy,6-4; 3-0 RET,R32,73,2,1,25,47,21,25,11,22,2,2,6,32,47,5,8,36,66,25,36,9,30,11,14,7,34,66
2009-01-12 00:00:00.000,Sydney Australia ATP World Tour 250,HARD,2,Richard Gasquet,Dmitry Tursunov,Richard Gasquet,7-6(4); 6-4,R32,86,6,1,38,66,32,38,19,28,1,1,11,51,66,4,1,33,65,24,33,24,32,1,2,11,48,65
2009-01-12 00:00:00.000,Sydney Australia ATP World Tour 250,HARD,2,Gilles Simon,N/A Bye,Gilles Simon,,R32,0,0,0,0,0,0,0,0,0,0,0,0,0,0,0,0,0,0,0,0,0,0,0,0,0,0,0
2009-01-12 00:00:00.000,Sydney Australia ATP World Tour 250,HARD,2,Novak Djokovic,Paul-Henri Mathieu,Novak Djokovic,6-1; 6-2,R16,55,4,1,31,42,24,31,10,11,1,1,8,34,42,1,2,23,39,15,23,3,16,3,7,7,18,39
2009-01-12 00:00:00.000,Sydney Australia ATP World Tour 250,HARD,2,Mario Ancic,Tommy Robredo,Mario Ancic,6-2; 6-1,R16,63,5,1,32,48,23,32,11,16,2,2,8,34,48,1,4,26,40,12,26,8,14,1,5,7,20,40
2009-01-12 00:00:00.000,Sydney Australia ATP World Tour 250,HARD,2,Jo-Wilfried Tsonga,Simone Bolelli,Jo-Wilfried Tsonga,6-4; 6-1,R16,65,11,3,36,46,30,36,5,10,3,3,8,35,46,3,0,34,55,18,34,12,21,2,6,9,30,55
2009-01-12 00:00:00.000,Sydney Australia ATP World Tour 250,HARD,2,Jarkko Nieminen,Chris Guccione,Jarkko Nieminen,7-6(8); 6-3,R16,82,0,2,43,70,32,43,16,27,3,5,11,48,70,7,5,47,75,31,47,12,28,6,9,10,43,75
2009-01-12 00:00:00.000,Sydney Australia ATP World Tour 250,HARD,2,Lleyton Hewitt,Janko Tipsarevic,Lleyton Hewitt,7-5; 6-4,R16,97,4,5,24,59,19,24,22,35,2,4,11,41,59,8,5,37,70,30,37,12,33,3,7,11,42,70
2009-01-12 00:00:00.000,Sydney Australia ATP World Tour 250,HARD,2,David Nalbandian,Michael Llodra,David Nalbandian,6-1; 6-3,R16,58,6,1,28,44,22,28,10,16,0,0,8,32,44,3,4,23,46,15,23,8,23,4,8,8,23,46
2009-01-12 00:00:00.000,Sydney Australia ATP World Tour 250,HARD,2,Jeremy Chardy,Igor Andreev,Jeremy Chardy,6-4; 4-6; 6-4,R16,116,11,3,54,82,44,54,14,28,4,6,15,58,82,7,5,51,93,38,51,19,42,4,7,15,57,93
2009-01-12 00:00:00.000,Sydney Australia ATP World Tour 250,HARD,2,Richard Gasquet,Gilles Simon,Richard Gasquet,6-4; 6-4,R16,94,3,5,20,58,13,20,22,38,3,6,10,35,58,5,10,35,84,28,35,14,49,10,15,10,42,84
2009-01-12 00:00:00.000,Sydney Australia ATP World Tour 250,HARD,2,Novak Djokovic,Mario Ancic,Novak Djokovic,6-3; 6-4,Q,80,2,3,49,82,35,49,16,33,14,15,10,51,82,2,1,28,45,19,28,11,17,2,5,9,30,45
2009-01-12 00:00:00.000,Sydney Australia ATP World Tour 250,HARD,2,Jarkko Nieminen,Jo-Wilfried Tsonga,Jarkko Nieminen,W/O,Q,0,0,0,0,0,0,0,0,0,0,0,0,0,0,0,0,0,0,0,0,0,0,0,0,0,0,0
2009-01-12 00:00:00.000,Sydney Australia ATP World Tour 250,HARD,2,David Nalbandian,Lleyton Hewitt,David Nalbandian,7-6(3); 7-5,Q,108,7,1,49,78,32,49,16,29,3,6,12,48,78,3,4,37,79,23,37,24,42,1,5,12,47,79
2009-01-12 00:00:00.000,Sydney Australia ATP World Tour 250,HARD,2,Richard Gasquet,Jeremy Chardy,Richard Gasquet,6-2; 7-6(4),Q,83,5,2,32,60,27,32,14,28,1,2,10,41,60,6,3,42,68,25,42,15,26,0,3,10,40,68
2009-01-12 00:00:00.000,Sydney Australia ATP World Tour 250,HARD,2,Jarkko Nieminen,Novak Djokovic,Jarkko Nieminen,6-4; 7-6(3),S,100,2,3,50,77,36,50,18,27,5,5,11,54,77,2,1,54,70,39,54,7,16,4,5,11,46,70
2009-01-12 00:00:00.000,Sydney Australia ATP World Tour 250,HARD,2,David Nalbandian,Richard Gasquet,David Nalbandian,6-4; 6-3,S,74,6,2,23,52,19,23,17,29,0,1,9,36,52,4,5,36,66,26,36,10,30,3,7,10,36,66
2009-01-12 00:00:00.000,Sydney Australia ATP World Tour 250,HARD,2,David Nalbandian,Jarkko Nieminen,David Nalbandian,6-3; 6-7(9); 6-2,F,136,6,4,61,110,46,61,22,49,7,9,15,68,110,2,4,74,101,48,74,9,27,6,11,14,57,101
2009-01-19 00:00:00.000,Australian Open Australia Grand Slams,HARD,3,Rafael Nadal,Christophe Rochus,Rafael Nadal,6-0; 6-2; 6-2,R128,76,10,2,35,51,32,35,12,16,0,0,11,44,51,1,2,48,72,28,48,5,24,4,11,11,33,72
2009-01-19 00:00:00.000,Australian Open Australia Grand Slams,HARD,3,Roko Karanusic,Florent Serra,Roko Karanusic,6-3; 1-6; 6-3; 3-6; 6-3,R128,152,8,5,83,131,60,83,21,48,8,14,22,81,131,5,1,86,126,55,86,21,40,4,10,21,76,126
2009-01-19 00:00:00.000,Australian Open Australia Grand Slams,HARD,3,Tommy Haas,Eduardo Schwank,Tommy Haas,6-3; 6-3; 6-4,R128,119,11,5,42,89,37,42,23,47,5,7,14,60,89,2,4,55,92,33,55,17,37,7,13,14,50,92
2009-01-19 00:00:00.000,Australian Open Australia Grand Slams,HARD,3,Flavio Cipolla,Dmitry Tursunov,Flavio Cipolla,4-6; 6-2; 7-6(7); 7-5,R128,194,3,6,118,173,77,118,26,55,13,17,21,103,173,11,4,81,144,55,81,31,63,10,16,21,86,144
2009-01-19 00:00:00.000,Australian Open Australia Grand Slams,HARD,3,Richard Gasquet,Diego Junqueira,Richard Gasquet,6-7(5); 7-6(3); 6-3; 6-4,R128,204,14,4,80,138,63,80,34,58,7,10,21,97,138,3,4,104,158,73,104,23,54,14,19,21,96,158
2009-01-19 00:00:00.000,Australian Open Australia Grand Slams,HARD,3,Denis Istomin,Vincent Spadea,Denis Istomin,6-2; 7-5; 6-4,R128,98,10,5,47,79,37,47,16,32,1,4,15,53,79,3,7,62,95,34,62,13,33,6,13,15,47,95
2009-01-19 00:00:00.000,Australian Open Australia Grand Slams,HARD,3,Guillermo Canas,Dieter Kindlmann,Guillermo Canas,3-6; 7-5; 5-7; 6-0; 7-5,R128,215,21,4,73,143,57,73,35,70,6,12,25,92,143,3,6,106,166,64,106,27,60,13,22,26,91,166
2009-01-19 00:00:00.000,Australian Open Australia Grand Slams,HARD,3,Fernando Gonzalez,Lleyton Hewitt,Fernando Gonzalez,5-7; 6-2; 6-2; 3-6; 6-3,R128,184,12,4,75,132,60,75,29,57,7,11,23,89,132,9,11,69,134,43,69,35,65,7,14,23,78,134
2009-01-19 00:00:00.000,Australian Open Australia Grand Slams,HARD,3,Gael Monfils,Martin Vassallo Arguello,Gael Monfils,6-1; 6-3; 7-5,R128,145,9,8,47,92,39,47,19,45,6,9,14,58,92,0,6,76,116,41,76,16,40,13,21,14,57,116
2009-01-19 00:00:00.000,Australian Open Australia Grand Slams,HARD,3,Stefan Koubek,Mikhail Youzhny,Stefan Koubek,6-3; 6-2; 6-2,R128,95,4,4,43,79,34,43,18,36,4,6,13,52,79,4,5,52,82,22,52,16,30,9,16,12,38,82
2009-01-19 00:00:00.000,Australian Open Australia Grand Slams,HARD,3,Fabio Fognini,Andrey Golubev,Fabio Fognini,3-6; 7-6(7); 6-4; 6-2,R128,169,4,7,72,129,57,72,30,57,6,8,19,87,129,6,7,75,134,49,75,36,59,8,12,20,85,134
2009-01-19 00:00:00.000,Australian Open Australia Grand Slams,HARD,3,Nicolas Almagro,Nicolas Massu,Nicolas Almagro,6-4; 6-4; 3-6; 5-7; 6-3,R128,210,31,4,87,138,70,87,29,51,4,7,24,99,138,9,7,86,139,64,86,31,53,5,9,25,95,139
2009-01-19 00:00:00.000,Australian Open Australia Grand Slams,HARD,3,Ivo Karlovic,Daniel Gimeno-Traver,Ivo Karlovic,6-3; 6-4; 6-4,R128,107,13,2,45,82,39,45,24,37,2,2,15,63,82,1,1,73,87,49,73,6,14,7,10,14,55,87
2009-01-19 00:00:00.000,Australian Open Australia Grand Slams,HARD,3,Mario Ancic,Wayne Odesnik,Mario Ancic,7-5; 6-4; 4-6; 6-2,R128,174,12,2,74,108,58,74,19,34,0,2,20,77,108,1,4,87,131,56,87,24,44,6,11,20,80,131
2009-01-19 00:00:00.000,Australian Open Australia Grand Slams,HARD,3,Chris Guccione,Nicolas Devilder,Chris Guccione,6-4; 6-2; 6-4,R128,115,12,4,46,75,37,46,17,29,1,2,14,54,75,4,4,59,97,32,59,21,38,8,13,14,53,97
2009-01-19 00:00:00.000,Australian Open Australia Grand Slams,HARD,3,Gilles Simon,Pablo Andujar,Gilles Simon,6-4; 6-1; 6-1,R128,114,8,3,46,95,30,46,27,49,7,9,12,57,95,1,5,55,95,27,55,17,40,9,17,12,44,95
2009-01-19 00:00:00.000,Australian Open Australia Grand Slams,HARD,3,Andy Murray,Andrei Pavel,Andy Murray,6-2; 3-1 RET,R128,45,2,3,20,31,20,20,5,11,2,2,6,25,31,0,3,22,39,13,22,5,17,1,4,6,18,39
2009-01-19 00:00:00.000,Australian Open Australia Grand Slams,HARD,3,Marcel Granollers,Teymuraz Gabashvili,Marcel Granollers,6-4; 7-6(3); 4-6; 6-0,R128,183,12,3,70,112,51,70,21,42,6,10,19,72,112,6,10,64,131,44,64,29,67,7,14,19,73,131
2009-01-19 00:00:00.000,Australian Open Australia Grand Slams,HARD,3,Andreas Beck,Colin Ebelthite,Andreas Beck,7-5; 6-1; 6-0,R128,96,1,2,46,67,32,46,14,21,3,5,12,46,67,3,5,48,84,28,48,10,36,8,17,13,38,84
2009-01-19 00:00:00.000,Australian Open Australia Grand Slams,HARD,3,Jurgen Melzer,Kei Nishikori,Jurgen Melzer,7-5; 6-2; 6-1,R128,102,6,2,47,78,39,47,16,31,5,7,14,55,78,3,6,53,93,27,53,18,40,4,11,13,45,93
2009-01-19 00:00:00.000,Australian Open Australia Grand Slams,HARD,3,Radek Stepanek,Nicolas Lapentti,Radek Stepanek,3-6; 6-3; 6-4; 6-4,R128,174,9,3,74,110,52,74,24,36,1,3,19,76,110,9,5,75,130,48,75,32,55,9,13,19,80,130
2009-01-19 00:00:00.000,Australian Open Australia Grand Slams,HARD,3,Michael Berrer,Carsten Ball,Michael Berrer,6-2; 6-4; 6-3,R128,105,8,3,42,80,33,42,20,38,5,8,13,53,80,12,6,68,116,39,68,16,48,18,26,14,55,116
2009-01-19 00:00:00.000,Australian Open Australia Grand Slams,HARD,3,Arnaud Clement,Sergiy Stakhovsky,Arnaud Clement,6-3; 2-6; 4-6; 6-2; 6-1,R128,207,2,2,63,150,45,63,41,87,8,14,21,86,150,9,4,84,135,51,84,24,51,10,19,21,75,135
2009-01-19 00:00:00.000,Australian Open Australia Grand Slams,HARD,3,Fernando Verdasco,Adrian Mannarino,Fernando Verdasco,6-0; 6-2; 6-2,R128,87,7,4,50,69,40,50,10,19,2,2,11,50,69,2,4,27,62,15,27,11,35,5,12,11,26,62
2009-01-19 00:00:00.000,Australian Open Australia Grand Slams,HARD,3,James Blake,Frank Dancevic,James Blake,6-4; 6-3; 7-5,R128,114,7,5,59,90,47,59,14,31,9,12,16,61,90,8,3,59,107,41,59,18,48,9,15,15,59,107
2009-01-19 00:00:00.000,Australian Open Australia Grand Slams,HARD,3,Sebastien De Chaunac,Steve Darcis,Sebastien De Chaunac,2-6; 6-3; 0-6; 6-2; 6-2,R128,162,12,5,56,111,42,56,26,55,2,8,20,68,111,5,2,50,108,31,50,31,58,1,7,19,62,108
2009-01-19 00:00:00.000,Australian Open Australia Grand Slams,HARD,3,Ernests Gulbis,Albert Montanes,Ernests Gulbis,6-3; 6-2; 6-3,R128,86,11,1,47,74,39,47,16,27,1,1,13,55,74,2,2,37,68,26,37,17,31,1,6,13,43,68
2009-01-19 00:00:00.000,Australian Open Australia Grand Slams,HARD,3,Igor Andreev,Peter Polansky,Igor Andreev,5-7; 3-6; 6-4; 6-3; 6-4,R128,0,0,0,0,0,0,0,0,0,0,0,0,0,0,0,1,0,1,0,0,0,1,0,0,0,0,1
2009-01-19 00:00:00.000,Australian Open Australia Grand Slams,HARD,3,Dudi Sela,Rainer Schuettler,Dudi Sela,1-6; 6-2; 6-4; 6-4,R128,163,2,3,77,107,53,77,12,30,5,10,17,65,107,2,3,100,127,57,100,11,27,12,19,18,68,127
2009-01-19 00:00:00.000,Australian Open Australia Grand Slams,HARD,3,Victor Hanescu,Jan Hernych,Victor Hanescu,3-6; 3-6; 7-6(7); 7-6(4); 8-6,R128,252,9,4,131,182,81,131,27,51,7,16,28,108,182,6,8,142,197,93,142,24,55,14,21,28,117,197
2009-01-19 00:00:00.000,Australian Open Australia Grand Slams,HARD,3,Ivan Ljubicic,Igor Kunitsyn,Ivan Ljubicic,4-6; 7-6(3); 7-6(7); 5-7; 6-3,R128,242,26,4,112,164,79,112,24,52,2,10,28,103,164,10,6,146,189,96,146,16,43,8,15,27,112,189
2009-01-19 00:00:00.000,Australian Open Australia Grand Slams,HARD,3,Jo-Wilfried Tsonga,Juan Monaco,Jo-Wilfried Tsonga,6-4; 6-4; 6-0,R128,99,5,2,32,66,27,32,21,34,1,3,13,48,66,1,2,47,74,25,47,11,27,3,10,13,36,74
2009-01-19 00:00:00.000,Australian Open Australia Grand Slams,HARD,3,Andy Roddick,Bjorn Rehnquist,Andy Roddick,6-0; 6-2; 6-2,R128,104,9,1,33,63,25,33,21,30,0,0,11,46,63,0,2,37,65,19,37,9,28,3,10,11,28,65
2009-01-19 00:00:00.000,Australian Open Australia Grand Slams,HARD,3,Xavier Malisse,Michael Llodra,Xavier Malisse,7-6(8); 6-1; 6-1,R128,150,5,2,57,82,45,57,13,25,8,8,13,58,82,8,1,63,101,37,63,20,38,13,18,13,57,101
2009-01-19 00:00:00.000,Australian Open Australia Grand Slams,HARD,3,Fabrice Santoro,Juan Carlos Ferrero,Fabrice Santoro,6-3; 6-2; 6-7(5); 6-2,R128,151,17,3,54,115,45,54,29,61,4,7,19,74,115,3,2,61,105,41,61,18,44,0,8,18,59,105
2009-01-19 00:00:00.000,Australian Open Australia Grand Slams,HARD,3,Philipp Kohlschreiber,Sam Querrey,Philipp Kohlschreiber,7-6(6); 6-3; 6-2,R128,113,8,5,66,103,51,66,20,37,3,3,15,71,103,9,1,45,82,33,45,23,37,2,5,14,56,82
2009-01-19 00:00:00.000,Australian Open Australia Grand Slams,HARD,3,Tommy Robredo,Bobby Reynolds,Tommy Robredo,6-2; 7-5; 6-1,R128,182,10,1,42,61,34,42,18,19,0,0,13,52,61,7,5,45,76,30,45,11,31,4,10,14,41,76
2009-01-19 00:00:00.000,Australian Open Australia Grand Slams,HARD,3,Viktor Troicki,Alberto Martin,Viktor Troicki,6-3; 3-6; 6-2; 6-4,R128,280,12,1,59,97,46,59,21,38,5,8,18,67,97,3,6,60,106,40,60,23,46,5,11,18,63,106
2009-01-19 00:00:00.000,Australian Open Australia Grand Slams,HARD,3,Yen-Hsun Lu,Thomaz Bellucci,Yen-Hsun Lu,6-3; 7-5; 6-4,R128,185,8,3,61,112,49,61,27,51,12,13,16,76,112,9,5,41,71,31,41,16,30,0,4,15,47,71
2009-01-19 00:00:00.000,Australian Open Australia Grand Slams,HARD,3,David Nalbandian,Marc Gicquel,David Nalbandian,6-1; 4-6; 6-2; 6-3,R128,210,4,8,74,129,52,74,26,55,8,10,16,78,129,8,2,50,103,32,50,24,53,8,15,17,56,103
2009-01-19 00:00:00.000,Australian Open Australia Grand Slams,HARD,3,Robin Soderling,Robert Kendrick,Robin Soderling,5-7; 6-4; 6-4; 7-5,R128,150,11,2,78,114,65,78,26,36,5,6,22,91,114,20,6,78,127,63,78,23,49,4,7,22,86,127
2009-01-19 00:00:00.000,Australian Open Australia Grand Slams,HARD,3,Marcos Baghdatis,Julien Benneteau,Marcos Baghdatis,6-3; 7-6(5); 6-2,R128,250,7,2,44,104,34,44,32,60,7,8,14,66,104,4,7,68,113,45,68,18,45,7,12,15,63,113
2009-01-19 00:00:00.000,Australian Open Australia Grand Slams,HARD,3,Simone Bolelli,Kristof Vliegen,Simone Bolelli,7-6(5); 7-6(3); 7-5,R128,284,3,1,60,111,47,60,35,51,1,2,18,82,111,10,2,54,102,40,54,34,48,3,5,18,74,102
2009-01-19 00:00:00.000,Australian Open Australia Grand Slams,HARD,3,Mardy Fish,Samuel Groth,Mardy Fish,6-7(3); 6-4; 7-5; 6-0,R128,191,19,6,57,105,50,57,26,48,0,2,20,76,105,14,10,73,128,47,73,25,55,8,15,20,72,128
2009-01-19 00:00:00.000,Australian Open Australia Grand Slams,HARD,3,Paul-Henri Mathieu,Jarkko Nieminen,Paul-Henri Mathieu,6-2; 4-1 RET,R128,49,6,2,25,43,20,25,12,18,0,0,7,32,43,3,1,16,31,9,16,9,15,2,5,6,18,31
2009-01-19 00:00:00.000,Australian Open Australia Grand Slams,HARD,3,Amer Delic,Taylor Dent,Amer Delic,6-4; 3-6; 4-6; 6-3; 6-4,R128,250,21,5,106,144,81,106,18,38,3,5,24,99,144,8,10,91,133,73,91,20,42,4,7,24,93,133
2009-01-19 00:00:00.000,Australian Open Australia Grand Slams,HARD,3,Jeremy Chardy,Marcos Daniel,Jeremy Chardy,6-4; 6-4; 6-1,R128,252,18,3,44,71,35,44,17,27,0,1,13,52,71,8,8,54,98,35,54,15,44,9,15,14,50,98
2009-01-19 00:00:00.000,Australian Open Australia Grand Slams,HARD,3,Novak Djokovic,Andrea Stoppini,Novak Djokovic,6-2; 6-3; 7-5,R128,115,8,1,51,74,34,51,14,23,3,6,14,48,74,6,6,59,110,33,59,21,51,11,19,15,54,110
2009-01-19 00:00:00.000,Australian Open Australia Grand Slams,HARD,3,Juan Martin Del Potro,Mischa Zverev,Juan Martin Del Potro,6-3; 6-4; 6-2,R128,225,7,4,54,83,38,54,19,29,4,6,14,57,83,5,2,59,96,33,59,16,37,8,14,13,49,96
2009-01-19 00:00:00.000,Australian Open Australia Grand Slams,HARD,3,Florian Mayer,Lamine Ouahab,Florian Mayer,6-2; 6-1; 6-2,R128,83,4,1,40,69,31,40,19,29,0,1,12,50,69,0,4,37,72,23,37,9,35,7,14,11,32,72
2009-01-19 00:00:00.000,Australian Open Australia Grand Slams,HARD,3,Bernard Tomic,Potito Starace,Bernard Tomic,7-6(5); 1-6; 7-6(5); 7-6(6),R128,281,10,1,98,147,64,98,30,49,5,10,21,94,147,14,6,112,169,84,112,26,57,10,13,22,110,169
2009-01-19 00:00:00.000,Australian Open Australia Grand Slams,HARD,3,Gilles Muller,Feliciano Lopez,Gilles Muller,6-3; 7-6(5); 4-6; 4-6; 16-14,R128,262,0,0,194,194,148,194,0,0,4,6,36,148,194,0,0,196,196,145,196,0,0,4,6,35,145,196
2009-01-19 00:00:00.000,Australian Open Australia Grand Slams,HARD,3,Marin Cilic,Kevin Anderson,Marin Cilic,6-3; 6-2; 6-7(4); 6-3,R128,307,16,8,64,125,56,64,29,61,7,9,20,85,125,8,7,70,117,47,70,21,47,8,14,18,68,117
2009-01-19 00:00:00.000,Australian Open Australia Grand Slams,HARD,3,Janko Tipsarevic,Oscar Hernandez,Janko Tipsarevic,4-6; 6-1; 6-3; 4-6; 6-0,R128,210,15,4,88,153,68,88,29,65,15,18,21,97,153,13,11,79,142,52,79,24,63,7,15,21,76,142
2009-01-19 00:00:00.000,Australian Open Australia Grand Slams,HARD,3,Dominik Hrbaty,John Isner,Dominik Hrbaty,7-6(4); 2-6; 6-2; 7-5,R128,166,6,5,80,119,59,80,23,39,1,3,20,82,119,39,8,88,138,68,88,20,50,6,9,20,88,138
2009-01-19 00:00:00.000,Australian Open Australia Grand Slams,HARD,3,David Ferrer,Denis Gremelmayr,David Ferrer,6-1; 6-7(6); 6-1; 6-7(4); 6-4,R128,237,7,8,95,172,68,95,42,77,9,12,25,110,172,5,7,100,183,64,100,37,83,11,19,23,101,183
2009-01-19 00:00:00.000,Australian Open Australia Grand Slams,HARD,3,Stanislas Wawrinka,Ivo Minar,Stanislas Wawrinka,6-1; 2-6; 7-5; 7-6(9),R128,150,4,6,74,126,50,74,25,52,8,14,20,75,126,7,5,65,110,43,65,19,45,3,10,19,62,110
2009-01-19 00:00:00.000,Australian Open Australia Grand Slams,HARD,3,Brydan Klein,Bjorn Phau,Brydan Klein,6-4; 6-3; 4-6; 6-3,R128,307,14,6,66,106,50,66,17,40,3,7,19,67,106,3,7,53,113,39,53,27,60,7,14,19,66,113
2009-01-19 00:00:00.000,Australian Open Australia Grand Slams,HARD,3,Brian Dabul,Philipp Petzschner,Brian Dabul,6-1; 6-2; 6-4,R128,100,6,0,61,76,47,61,9,15,2,3,13,56,76,5,8,54,80,35,54,5,26,4,10,12,40,80
2009-01-19 00:00:00.000,Australian Open Australia Grand Slams,HARD,3,Tomas Berdych,Robby Ginepri,Tomas Berdych,6-4; 6-4; 6-3,R128,110,9,4,52,81,43,52,16,29,4,5,14,59,81,6,3,67,103,43,67,14,36,9,14,15,57,103
2009-01-19 00:00:00.000,Australian Open Australia Grand Slams,HARD,3,Marat Safin,Ivan Navarro,Marat Safin,6-3; 6-3; 6-4,R128,145,8,3,42,82,34,42,25,40,1,1,14,59,82,6,2,51,91,37,51,18,40,2,6,14,55,91
2009-01-19 00:00:00.000,Australian Open Australia Grand Slams,HARD,3,Guillermo Garcia-Lopez,Agustin Calleri,Guillermo Garcia-Lopez,3-6; 7-6(5); 6-2; 6-0,R128,284,4,5,69,113,44,69,24,44,6,12,18,68,113,10,12,62,108,41,62,15,46,7,16,17,56,108
2009-01-19 00:00:00.000,Australian Open Australia Grand Slams,HARD,3,Evgeny Korolev,Carlos Moya,Evgeny Korolev,6-3; 6-1; 7-6(7),R128,111,9,3,49,82,44,49,16,33,1,2,14,60,82,10,11,40,91,32,40,17,51,6,11,14,49,91
2009-01-19 00:00:00.000,Australian Open Australia Grand Slams,HARD,3,Roger Federer,Andreas Seppi,Roger Federer,6-1; 7-6(4); 7-5,R128,280,9,5,76,115,56,76,23,39,10,10,16,79,115,1,6,70,109,48,70,18,39,7,10,15,66,109
2009-01-19 00:00:00.000,Australian Open Australia Grand Slams,HARD,3,Rafael Nadal,Roko Karanusic,Rafael Nadal,6-2; 6-3; 6-2,R64,96,3,2,50,77,37,50,17,27,6,6,12,54,77,2,2,42,64,29,42,6,22,1,7,13,35,64
2009-01-19 00:00:00.000,Australian Open Australia Grand Slams,HARD,3,Tommy Haas,Flavio Cipolla,Tommy Haas,6-1; 6-2; 6-1,R64,96,7,2,34,61,26,34,17,27,1,2,11,43,61,0,4,71,89,37,71,2,18,11,19,11,39,89
2009-01-19 00:00:00.000,Australian Open Australia Grand Slams,HARD,3,Richard Gasquet,Denis Istomin,Richard Gasquet,6-3; 6-4; 6-4,R64,120,7,4,46,87,36,46,26,41,4,6,15,62,87,5,2,56,95,37,56,14,39,11,16,14,51,95
2009-01-19 00:00:00.000,Australian Open Australia Grand Slams,HARD,3,Fernando Gonzalez,Guillermo Canas,Fernando Gonzalez,7-5; 6-3; 6-4,R64,137,12,3,59,87,49,59,15,28,0,1,16,64,87,9,5,63,118,41,63,29,55,16,20,15,70,118
2009-01-19 00:00:00.000,Australian Open Australia Grand Slams,HARD,3,Gael Monfils,Stefan Koubek,Gael Monfils,6-4; 6-4; 3-6; 6-2,R64,125,17,6,65,105,48,65,25,40,4,6,18,73,105,2,3,56,104,38,56,30,48,4,9,19,68,104
2009-01-19 00:00:00.000,Australian Open Australia Grand Slams,HARD,3,Nicolas Almagro,Fabio Fognini,Nicolas Almagro,6-2; 7-5; 6-0,R64,103,8,4,44,80,35,44,18,36,1,3,13,53,80,3,5,38,73,23,38,10,35,2,10,13,33,73
2009-01-19 00:00:00.000,Australian Open Australia Grand Slams,HARD,3,Mario Ancic,Ivo Karlovic,Mario Ancic,5-7; 7-5; 4-6; 6-4; 6-3,R64,211,8,1,84,131,66,84,32,47,3,6,26,98,131,25,2,101,155,79,101,25,54,5,10,27,104,155
2009-01-19 00:00:00.000,Australian Open Australia Grand Slams,HARD,3,Gilles Simon,Chris Guccione,Gilles Simon,6-7(5); 6-4; 6-1; 6-2,R64,140,14,2,63,117,53,63,33,54,7,7,19,86,117,13,3,77,122,50,77,26,45,6,11,18,76,122
2009-01-19 00:00:00.000,Australian Open Australia Grand Slams,HARD,3,Andy Murray,Marcel Granollers,Andy Murray,6-4; 6-2; 6-2,R64,109,4,1,45,79,33,45,22,34,1,2,13,55,79,2,1,48,93,27,48,21,45,10,16,13,48,93
2009-01-19 00:00:00.000,Australian Open Australia Grand Slams,HARD,3,Jurgen Melzer,Andreas Beck,Jurgen Melzer,5-7; 7-6(7); 6-4; 6-3,R64,193,21,2,78,142,55,78,33,64,10,14,21,88,142,5,10,81,146,49,81,37,65,6,12,22,86,146
2009-01-19 00:00:00.000,Australian Open Australia Grand Slams,HARD,3,Radek Stepanek,Michael Berrer,Radek Stepanek,6-3; 6-2; 6-7(3); 7-5,R64,182,14,6,94,140,73,94,20,46,4,6,21,93,140,4,8,89,134,58,89,21,45,6,12,20,79,134
2009-01-19 00:00:00.000,Australian Open Australia Grand Slams,HARD,3,Fernando Verdasco,Arnaud Clement,Fernando Verdasco,6-1; 6-1; 6-2,R64,93,6,1,47,56,39,47,7,9,3,3,11,46,56,2,3,50,79,23,50,12,29,6,13,11,35,79
2009-01-19 00:00:00.000,Australian Open Australia Grand Slams,HARD,3,James Blake,Sebastien De Chaunac,James Blake,6-3; 6-2; 6-3,R64,128,4,5,52,81,44,52,15,29,4,4,13,59,81,9,7,52,107,33,52,24,55,13,18,13,57,107
2009-01-19 00:00:00.000,Australian Open Australia Grand Slams,HARD,3,Igor Andreev,Ernests Gulbis,Igor Andreev,6-4; 6-4; 5-7; 3-6; 6-4,R64,231,10,7,95,162,68,95,37,67,9,12,25,105,162,14,8,122,190,82,122,34,68,13,17,26,116,190
2009-01-19 00:00:00.000,Australian Open Australia Grand Slams,HARD,3,Dudi Sela,Victor Hanescu,Dudi Sela,6-3; 6-3; 6-2,R64,114,5,3,63,94,49,63,15,31,12,12,13,64,94,1,3,61,86,40,61,8,25,7,12,13,48,86
2009-01-19 00:00:00.000,Australian Open Australia Grand Slams,HARD,3,Jo-Wilfried Tsonga,Ivan Ljubicic,Jo-Wilfried Tsonga,6-7(4); 7-6(8); 7-6(7); 6-2,R64,193,18,1,91,137,76,91,27,46,0,1,22,103,137,17,1,89,146,68,89,35,57,8,11,22,103,146
2009-01-19 00:00:00.000,Australian Open Australia Grand Slams,HARD,3,Andy Roddick,Xavier Malisse,Andy Roddick,4-6; 6-2; 7-6(1); 6-2,R64,160,19,2,70,101,58,70,18,31,1,3,19,76,101,11,2,77,128,51,77,25,51,8,13,19,76,128
2009-01-19 00:00:00.000,Australian Open Australia Grand Slams,HARD,3,Fabrice Santoro,Philipp Kohlschreiber,Fabrice Santoro,5-7; 7-5; 3-6; 7-5; 6-3,R64,242,3,3,94,173,63,94,41,79,12,19,27,104,173,4,4,122,182,71,122,34,60,21,29,27,105,182
2009-01-19 00:00:00.000,Australian Open Australia Grand Slams,HARD,3,Tommy Robredo,Viktor Troicki,Tommy Robredo,6-1; 6-3; 6-0,R64,82,7,1,45,56,35,45,10,11,0,0,11,45,56,4,3,43,76,25,43,8,33,9,16,11,33,76
2009-01-19 00:00:00.000,Australian Open Australia Grand Slams,HARD,3,Yen-Hsun Lu,David Nalbandian,Yen-Hsun Lu,6-4; 5-7; 4-6; 6-4; 6-2,R64,231,9,3,102,161,72,102,31,59,11,17,25,103,161,5,8,77,155,51,77,40,78,6,14,25,91,155
2009-01-19 00:00:00.000,Australian Open Australia Grand Slams,HARD,3,Marcos Baghdatis,Robin Soderling,Marcos Baghdatis,3-6; 7-5; 6-3; 6-3,R64,175,13,7,69,120,45,69,29,51,7,12,19,74,120,7,4,76,128,49,76,20,52,7,15,20,69,128
2009-01-19 00:00:00.000,Australian Open Australia Grand Slams,HARD,3,Mardy Fish,Simone Bolelli,Mardy Fish,6-4; 6-1; 7-5,R64,118,16,2,49,95,41,49,23,46,2,3,15,64,95,5,2,50,80,33,50,11,30,5,10,14,44,80
2009-01-19 00:00:00.000,Australian Open Australia Grand Slams,HARD,3,Amer Delic,Paul-Henri Mathieu,Amer Delic,1-6; 3-6; 6-3; 7-6(3); 9-7,R64,202,33,5,95,161,66,95,42,66,5,10,27,108,161,11,4,101,150,74,101,31,49,8,11,26,105,150
2009-01-19 00:00:00.000,Australian Open Australia Grand Slams,HARD,3,Novak Djokovic,Jeremy Chardy,Novak Djokovic,7-5; 6-1; 6-3,R64,102,7,1,54,75,41,54,14,21,1,2,14,55,75,3,0,52,75,30,52,11,23,0,6,14,41,75
2009-01-19 00:00:00.000,Australian Open Australia Grand Slams,HARD,3,Juan Martin Del Potro,Florian Mayer,Juan Martin Del Potro,6-1; 7-5; 6-2,R64,112,7,0,54,82,36,54,19,28,4,5,13,55,82,3,1,47,76,25,47,14,29,4,11,14,39,76
2009-01-19 00:00:00.000,Australian Open Australia Grand Slams,HARD,3,Gilles Muller,Bernard Tomic,Gilles Muller,3-6; 6-1; 6-4; 6-2,R64,118,27,4,64,96,53,64,17,32,5,6,17,70,96,5,6,65,116,42,65,24,51,12,17,17,66,116
2009-01-19 00:00:00.000,Australian Open Australia Grand Slams,HARD,3,Marin Cilic,Janko Tipsarevic,Marin Cilic,6-2; 6-3; 4-6; 6-3,R64,195,4,0,10,11,8,10,0,1,0,0,2,8,11,0,0,8,19,4,8,7,11,3,4,2,11,19
2009-01-19 00:00:00.000,Australian Open Australia Grand Slams,HARD,3,David Ferrer,Dominik Hrbaty,David Ferrer,6-2; 6-2; 6-1,R64,90,1,0,12,18,11,12,3,6,0,0,0,14,18,0,0,7,16,4,7,4,9,0,2,4,8,16
2009-01-19 00:00:00.000,Australian Open Australia Grand Slams,HARD,3,Stanislas Wawrinka,Brydan Klein,Stanislas Wawrinka,6-3; 6-4; 6-4,R64,0,0,0,0,0,0,0,0,0,0,0,0,0,0,0,0,0,0,0,0,0,0,0,0,0,0,0
2009-01-19 00:00:00.000,Australian Open Australia Grand Slams,HARD,3,Tomas Berdych,Brian Dabul,Tomas Berdych,6-1; 6-1; 6-3,R64,101,11,1,45,72,33,45,21,27,3,3,12,54,72,2,3,65,93,38,65,7,28,12,18,11,45,93
2009-01-19 00:00:00.000,Australian Open Australia Grand Slams,HARD,3,Marat Safin,Guillermo Garcia-Lopez,Marat Safin,7-5; 6-2; 6-2,R64,101,18,3,40,76,34,40,24,36,2,2,13,58,76,1,6,56,85,35,56,14,29,7,12,14,49,85
2009-01-19 00:00:00.000,Australian Open Australia Grand Slams,HARD,3,Roger Federer,Evgeny Korolev,Roger Federer,6-2; 6-3; 6-1,R64,85,8,3,41,68,28,41,20,27,0,1,12,48,68,2,3,41,80,22,41,17,39,5,12,12,39,80
2009-01-19 00:00:00.000,Australian Open Australia Grand Slams,HARD,3,Rafael Nadal,Tommy Haas,Rafael Nadal,6-4; 6-2; 6-2,R32,122,4,0,43,62,35,43,15,19,0,1,13,50,62,6,0,61,98,35,61,15,37,12,18,13,50,98
2009-01-19 00:00:00.000,Australian Open Australia Grand Slams,HARD,3,Fernando Gonzalez,Richard Gasquet,Fernando Gonzalez,3-6; 3-6; 7-6(10); 6-2; 12-10,R32,245,14,7,145,203,104,145,27,58,8,14,30,131,203,11,8,125,179,97,125,22,54,8,14,30,119,179
2009-01-19 00:00:00.000,Australian Open Australia Grand Slams,HARD,3,Gael Monfils,Nicolas Almagro,Gael Monfils,6-4; 6-3; 7-5,R32,129,12,0,67,101,51,67,16,34,4,5,15,67,101,10,2,67,96,43,67,14,29,5,10,16,57,96
2009-01-19 00:00:00.000,Australian Open Australia Grand Slams,HARD,3,Gilles Simon,Mario Ancic,Gilles Simon,7-6(2); 6-4; 6-2,R32,154,0,1,71,118,50,71,25,47,10,12,15,75,118,6,3,51,96,34,51,21,45,5,10,15,55,96
2009-01-19 00:00:00.000,Australian Open Australia Grand Slams,HARD,3,Andy Murray,Jurgen Melzer,Andy Murray,7-5; 6-0; 6-3,R32,99,8,0,49,82,38,49,17,33,6,8,14,55,82,2,1,55,79,32,55,6,24,7,14,13,38,79
2009-01-19 00:00:00.000,Australian Open Australia Grand Slams,HARD,3,Fernando Verdasco,Radek Stepanek,Fernando Verdasco,6-4; 6-0; 6-0,R32,108,1,2,56,69,40,56,6,13,8,10,11,46,69,2,5,49,85,21,49,11,36,11,20,11,32,85
2009-01-19 00:00:00.000,Australian Open Australia Grand Slams,HARD,3,James Blake,Igor Andreev,James Blake,6-3; 6-2; 3-6; 6-1,R32,127,5,0,64,102,49,64,25,38,4,5,17,74,102,5,2,56,96,40,56,15,40,5,10,16,55,96
2009-01-19 00:00:00.000,Australian Open Australia Grand Slams,HARD,3,Jo-Wilfried Tsonga,Dudi Sela,Jo-Wilfried Tsonga,6-4; 6-2; 1-6; 6-1,R32,140,5,2,62,100,43,62,21,38,8,11,16,64,100,0,2,55,102,35,55,22,47,10,16,16,57,102
2009-01-19 00:00:00.000,Australian Open Australia Grand Slams,HARD,3,Andy Roddick,Fabrice Santoro,Andy Roddick,6-3; 6-4; 6-2,R32,97,22,1,55,73,46,55,12,18,3,3,14,58,73,4,2,45,79,31,45,16,34,7,11,13,47,79
2009-01-19 00:00:00.000,Australian Open Australia Grand Slams,HARD,3,Tommy Robredo,Yen-Hsun Lu,Tommy Robredo,6-1; 6-3; 6-2,R32,108,7,1,53,71,39,53,10,18,3,4,12,49,71,1,2,45,71,26,45,8,26,4,11,12,34,71
2009-01-19 00:00:00.000,Australian Open Australia Grand Slams,HARD,3,Marcos Baghdatis,Mardy Fish,Marcos Baghdatis,6-2; 6-4; 6-4,R32,132,5,4,45,83,36,45,18,38,1,3,14,54,83,10,4,60,111,36,60,24,51,8,14,14,60,111
2009-01-19 00:00:00.000,Australian Open Australia Grand Slams,HARD,3,Novak Djokovic,Amer Delic,Novak Djokovic,6-2; 4-6; 6-3; 7-6(4),R32,183,11,4,84,131,67,84,24,47,8,9,20,91,131,16,6,77,131,59,77,24,54,5,8,19,83,131
2009-01-19 00:00:00.000,Australian Open Australia Grand Slams,HARD,3,Juan Martin Del Potro,Gilles Muller,Juan Martin Del Potro,6-7(5); 7-5; 6-3; 7-5,R32,203,11,3,93,126,77,93,20,33,2,3,23,97,126,22,9,116,179,80,116,28,63,20,24,22,108,179
2009-01-19 00:00:00.000,Australian Open Australia Grand Slams,HARD,3,Marin Cilic,David Ferrer,Marin Cilic,7-6(5); 6-3; 6-4,R32,134,7,0,64,107,44,64,25,43,2,4,16,69,107,0,3,61,89,35,61,20,28,5,9,15,55,89
2009-01-19 00:00:00.000,Australian Open Australia Grand Slams,HARD,3,Tomas Berdych,Stanislas Wawrinka,Tomas Berdych,4-6; 6-1; 6-3; 6-4,R32,195,10,3,77,122,59,77,20,45,6,7,18,79,122,9,2,68,133,45,68,31,65,15,20,18,76,133
2009-01-19 00:00:00.000,Australian Open Australia Grand Slams,HARD,3,Roger Federer,Marat Safin,Roger Federer,6-3; 6-2; 7-6(5),R32,110,9,1,54,89,46,54,22,35,0,0,15,68,89,14,2,44,88,30,44,24,44,1,4,14,54,88
2009-01-19 00:00:00.000,Australian Open Australia Grand Slams,HARD,3,Rafael Nadal,Fernando Gonzalez,Rafael Nadal,6-3; 6-2; 6-4,R16,113,4,0,49,73,38,49,15,24,5,7,14,53,73,6,2,61,89,36,61,10,28,7,13,13,46,89
2009-01-19 00:00:00.000,Australian Open Australia Grand Slams,HARD,3,Gilles Simon,Gael Monfils,Gilles Simon,6-4; 2-6; 6-1 RET,R16,119,3,4,49,77,35,49,10,28,5,9,13,45,77,1,3,50,89,30,50,16,39,5,10,12,46,89
2009-01-19 00:00:00.000,Australian Open Australia Grand Slams,HARD,3,Fernando Verdasco,Andy Murray,Fernando Verdasco,2-6; 6-1; 1-6; 6-3; 6-4,R16,189,10,6,100,135,69,100,12,35,8,13,21,81,135,7,3,85,140,54,85,30,55,12,17,20,84,140
2009-01-19 00:00:00.000,Australian Open Australia Grand Slams,HARD,3,Jo-Wilfried Tsonga,James Blake,Jo-Wilfried Tsonga,6-4; 6-4; 7-6(3),R16,143,12,3,66,104,55,66,18,38,3,4,16,73,104,4,5,56,104,37,56,29,48,3,6,16,66,104
2009-01-19 00:00:00.000,Australian Open Australia Grand Slams,HARD,3,Andy Roddick,Tommy Robredo,Andy Roddick,7-5; 6-1; 6-3,R16,106,13,2,49,78,41,49,17,29,1,1,14,58,78,0,2,54,80,34,54,13,26,2,7,14,47,80
2009-01-19 00:00:00.000,Australian Open Australia Grand Slams,HARD,3,Novak Djokovic,Marcos Baghdatis,Novak Djokovic,6-1; 7-6(1); 6-7(5); 6-2,R16,193,3,3,81,129,60,81,27,48,4,5,20,87,129,12,2,74,136,48,74,28,62,12,17,19,76,136
2009-01-19 00:00:00.000,Australian Open Australia Grand Slams,HARD,3,Juan Martin Del Potro,Marin Cilic,Juan Martin Del Potro,5-7; 6-4; 6-4; 6-2,R16,182,8,3,92,138,64,92,25,46,7,10,20,89,138,10,1,56,113,40,56,30,57,4,10,20,70,113
2009-01-19 00:00:00.000,Australian Open Australia Grand Slams,HARD,3,Roger Federer,Tomas Berdych,Roger Federer,4-6; 6-7(4); 6-4; 6-4; 6-2,R16,205,20,5,108,159,76,108,24,51,7,12,25,100,159,7,2,93,151,65,93,27,58,4,12,25,92,151
2009-01-19 00:00:00.000,Australian Open Australia Grand Slams,HARD,3,Rafael Nadal,Gilles Simon,Rafael Nadal,6-2; 7-5; 7-5,Q,146,5,2,63,94,46,63,18,31,4,7,16,64,94,4,4,52,94,37,52,16,42,5,12,16,53,94
2009-01-19 00:00:00.000,Australian Open Australia Grand Slams,HARD,3,Fernando Verdasco,Jo-Wilfried Tsonga,Fernando Verdasco,7-6(2); 3-6; 6-3; 6-2,Q,164,7,3,103,133,71,103,18,30,11,13,19,89,133,9,3,71,110,51,71,19,39,0,4,19,70,110
2009-01-19 00:00:00.000,Australian Open Australia Grand Slams,HARD,3,Andy Roddick,Novak Djokovic,Andy Roddick,6-7(3); 6-4; 6-2; 2-1 RET,Q,150,16,5,62,87,54,62,11,25,0,1,16,65,87,8,5,72,115,46,72,20,43,7,12,17,66,115
2009-01-19 00:00:00.000,Australian Open Australia Grand Slams,HARD,3,Roger Federer,Juan Martin Del Potro,Roger Federer,6-3; 6-0; 6-0,Q,80,12,0,37,53,32,37,12,16,0,0,11,44,53,5,2,39,66,18,39,9,27,4,11,10,27,66
2009-01-19 00:00:00.000,Australian Open Australia Grand Slams,HARD,3,Rafael Nadal,Fernando Verdasco,Rafael Nadal,6-7(4); 6-4; 7-6(2); 6-7(1); 6-4,S,310,12,3,128,173,92,128,28,45,2,4,28,120,173,21,4,148,212,104,148,35,64,16,20,28,139,212
2009-01-19 00:00:00.000,Australian Open Australia Grand Slams,HARD,3,Roger Federer,Andy Roddick,Roger Federer,6-2; 7-5; 7-5,S,125,16,0,63,96,52,63,19,33,3,3,16,71,96,8,2,61,94,43,61,17,33,9,13,16,60,94
2009-01-19 00:00:00.000,Australian Open Australia Grand Slams,HARD,3,Rafael Nadal,Roger Federer,Rafael Nadal,7-5; 3-6; 7-6(3); 3-6; 6-2,F,259,4,4,112,175,74,112,30,63,13,19,24,104,175,11,6,89,172,65,89,38,83,9,16,26,103,172
2009-02-02 00:00:00.000,Johannesburg South Africa ATP World Tour 250,HARD,2,Jo-Wilfried Tsonga,Thiago Alves,Jo-Wilfried Tsonga,6-4; 6-1,R32,56,11,6,24,51,21,24,16,27,0,0,9,37,51,2,2,23,46,15,23,13,23,2,5,8,28,46
2009-02-02 00:00:00.000,Johannesburg South Africa ATP World Tour 250,HARD,2,Denis Istomin,Santiago Ventura,Denis Istomin,4-6; 6-4; 7-6(3),R32,129,8,10,57,95,43,57,19,38,3,6,16,62,95,2,6,36,89,27,36,31,53,2,5,16,58,89
2009-02-02 00:00:00.000,Johannesburg South Africa ATP World Tour 250,HARD,2,Ivo Minar,Kevin Anderson,Ivo Minar,7-6(4); 6-4,R32,84,8,2,39,68,32,39,15,29,3,4,11,47,68,10,2,47,64,33,47,11,17,1,3,11,44,64
2009-02-02 00:00:00.000,Johannesburg South Africa ATP World Tour 250,HARD,2,Kristof Vliegen,Ross Hutchins,Kristof Vliegen,7-6(3); 6-4,R32,90,8,3,27,57,24,27,26,30,1,1,11,50,57,6,3,47,79,34,47,17,32,2,3,11,51,79
2009-02-02 00:00:00.000,Johannesburg South Africa ATP World Tour 250,HARD,2,Guillermo Garcia-Lopez,Bjorn Phau,Guillermo Garcia-Lopez,6-4; 6-3,R32,69,3,5,30,56,24,30,15,26,1,3,10,39,56,3,7,29,59,19,29,12,30,6,10,9,31,59
2009-02-02 00:00:00.000,Johannesburg South Africa ATP World Tour 250,HARD,2,Leonardo Mayer,Sergio Roitman,Leonardo Mayer,6-2; 6-4,R32,77,8,4,29,51,26,29,10,22,0,1,9,36,51,2,6,35,65,22,35,13,30,5,9,9,35,65
2009-02-02 00:00:00.000,Johannesburg South Africa ATP World Tour 250,HARD,2,Frederico Gil,Daniel Koellerer,Frederico Gil,6-4; 6-0,R32,63,5,5,27,43,24,27,6,16,0,1,8,30,43,1,3,46,70,28,46,6,24,7,12,8,34,70
2009-02-02 00:00:00.000,Johannesburg South Africa ATP World Tour 250,HARD,2,Rik De Voest,Ivan Navarro,Rik De Voest,6-3; 6-4,R32,80,5,2,30,62,25,30,16,32,1,2,10,41,62,7,6,29,56,21,29,12,27,4,7,9,33,56
2009-02-02 00:00:00.000,Johannesburg South Africa ATP World Tour 250,HARD,2,Jeremy Chardy,Jiri Vanek,Jeremy Chardy,6-0; 6-4,R32,62,9,0,23,41,18,23,13,18,1,2,8,31,41,4,7,32,67,19,32,13,35,8,13,8,32,67
2009-02-02 00:00:00.000,Johannesburg South Africa ATP World Tour 250,HARD,2,Marco Chiudinelli,Flavio Cipolla,Marco Chiudinelli,7-5; 1-6; 6-4,R32,148,5,3,52,103,34,52,25,51,7,12,15,59,103,4,9,55,85,38,55,13,30,5,9,14,51,85
2009-02-02 00:00:00.000,Johannesburg South Africa ATP World Tour 250,HARD,2,Izak Van der Merwe,Benjamin Becker,Izak Van der Merwe,7-6(4); 7-6(3),R32,93,10,4,37,67,29,37,19,30,0,2,12,48,67,3,3,37,77,26,37,21,40,0,2,12,47,77
2009-02-02 00:00:00.000,Johannesburg South Africa ATP World Tour 250,HARD,2,Sebastien De Chaunac,Marcel Granollers,Sebastien De Chaunac,7-5; 7-6(3),R32,118,3,6,35,80,28,35,26,45,5,6,12,54,80,8,3,49,85,38,49,17,36,8,10,12,55,85
2009-02-02 00:00:00.000,Johannesburg South Africa ATP World Tour 250,HARD,2,Marcos Baghdatis,Andrew Anderson,Marcos Baghdatis,6-4; 6-2,R32,88,3,7,39,74,29,39,14,35,7,9,9,43,74,1,2,41,62,22,41,9,21,5,10,9,31,62
2009-02-02 00:00:00.000,Johannesburg South Africa ATP World Tour 250,HARD,2,Raven Klaasen,Ruben Ramirez Hidalgo,Raven Klaasen,6-3; 7-5,R32,92,6,0,51,82,38,51,17,31,8,8,11,55,82,4,7,29,58,24,29,11,29,0,2,10,35,58
2009-02-02 00:00:00.000,Johannesburg South Africa ATP World Tour 250,HARD,2,Simon Greul,Victor Crivoi,Simon Greul,6-2; 6-4,R32,62,8,2,21,45,19,21,15,24,1,2,9,34,45,1,5,32,56,19,32,10,24,6,10,9,29,56
2009-02-02 00:00:00.000,Johannesburg South Africa ATP World Tour 250,HARD,2,David Ferrer,Dudi Sela,David Ferrer,6-2; 6-0,R32,58,2,2,22,38,16,22,10,16,3,4,7,26,38,1,3,20,45,9,20,7,25,4,10,7,16,45
2009-02-02 00:00:00.000,Johannesburg South Africa ATP World Tour 250,HARD,2,Jo-Wilfried Tsonga,Denis Istomin,Jo-Wilfried Tsonga,6-1; 6-4,R16,63,4,3,28,50,25,28,12,22,0,0,9,37,50,2,4,22,49,15,22,11,27,0,3,8,26,49
2009-02-02 00:00:00.000,Johannesburg South Africa ATP World Tour 250,HARD,2,Kristof Vliegen,Ivo Minar,Kristof Vliegen,6-4; 6-1,R16,60,7,1,27,42,25,27,7,15,0,0,8,32,42,8,2,31,55,20,31,8,24,4,8,9,28,55
2009-02-02 00:00:00.000,Johannesburg South Africa ATP World Tour 250,HARD,2,Guillermo Garcia-Lopez,Leonardo Mayer,Guillermo Garcia-Lopez,6-4; 7-5,R16,104,1,6,42,74,33,42,18,32,6,7,11,51,74,4,3,42,70,28,42,13,28,0,3,11,41,70
2009-02-02 00:00:00.000,Johannesburg South Africa ATP World Tour 250,HARD,2,Frederico Gil,Rik De Voest,Frederico Gil,4-6; 7-5; 6-4,R16,147,2,0,56,103,39,56,22,47,10,15,16,61,103,6,4,47,97,34,47,17,50,4,10,16,51,97
2009-02-02 00:00:00.000,Johannesburg South Africa ATP World Tour 250,HARD,2,Jeremy Chardy,Marco Chiudinelli,Jeremy Chardy,6-4; 6-4,R16,74,6,2,34,59,27,34,14,25,2,3,10,41,59,3,1,31,56,23,31,13,25,6,9,10,36,56
2009-02-02 00:00:00.000,Johannesburg South Africa ATP World Tour 250,HARD,2,Sebastien De Chaunac,Izak Van der Merwe,Sebastien De Chaunac,6-7(3); 7-5; 7-6(5),R16,169,5,3,68,118,53,68,30,50,7,9,18,83,118,14,5,72,118,58,72,21,46,7,10,18,79,118
2009-02-02 00:00:00.000,Johannesburg South Africa ATP World Tour 250,HARD,2,Marcos Baghdatis,Raven Klaasen,Marcos Baghdatis,6-3; 7-5,R16,90,12,2,39,62,32,39,13,23,4,4,10,45,62,2,6,48,74,30,48,13,26,4,7,11,43,74
2009-02-02 00:00:00.000,Johannesburg South Africa ATP World Tour 250,HARD,2,David Ferrer,Simon Greul,David Ferrer,6-3; 6-4,R16,70,3,2,28,44,22,28,12,16,2,3,9,34,44,1,8,32,69,21,32,16,37,7,11,10,37,69
2009-02-02 00:00:00.000,Johannesburg South Africa ATP World Tour 250,HARD,2,Jo-Wilfried Tsonga,Kristof Vliegen,Jo-Wilfried Tsonga,6-4; 6-1,Q,73,9,3,29,53,26,29,10,24,4,5,9,36,53,5,2,24,55,16,24,12,31,5,9,8,28,55
2009-02-02 00:00:00.000,Johannesburg South Africa ATP World Tour 250,HARD,2,Frederico Gil,Guillermo Garcia-Lopez,Frederico Gil,7-6(6); 6-3,Q,114,2,3,43,82,33,43,23,39,10,11,11,56,82,3,4,46,78,34,46,15,32,4,6,10,49,78
2009-02-02 00:00:00.000,Johannesburg South Africa ATP World Tour 250,HARD,2,Jeremy Chardy,Sebastien De Chaunac,Jeremy Chardy,7-6(4); 6-3,Q,93,7,4,38,70,35,38,17,32,6,6,11,52,70,6,4,39,65,31,39,13,26,2,3,10,44,65
2009-02-02 00:00:00.000,Johannesburg South Africa ATP World Tour 250,HARD,2,David Ferrer,Marcos Baghdatis,David Ferrer,7-5; 6-2,Q,77,1,2,30,58,24,30,18,28,1,1,10,42,58,6,6,31,57,25,31,11,26,0,3,10,36,57
2009-02-02 00:00:00.000,Johannesburg South Africa ATP World Tour 250,HARD,2,Jo-Wilfried Tsonga,Frederico Gil,Jo-Wilfried Tsonga,6-3; 6-4,S,64,6,1,32,52,27,32,12,20,2,3,10,39,52,0,2,25,48,17,25,11,23,1,4,9,28,48
2009-02-02 00:00:00.000,Johannesburg South Africa ATP World Tour 250,HARD,2,Jeremy Chardy,David Ferrer,Jeremy Chardy,1-6; 7-6(9); 7-6(4),S,154,11,3,63,114,46,63,28,51,4,7,15,74,114,9,5,66,117,51,66,29,51,3,4,16,80,117
2009-02-02 00:00:00.000,Johannesburg South Africa ATP World Tour 250,HARD,2,Jo-Wilfried Tsonga,Jeremy Chardy,Jo-Wilfried Tsonga,6-4; 7-6(5),F,109,16,7,37,84,31,37,27,47,8,8,11,58,84,11,2,44,77,36,44,16,33,4,5,11,52,77
2009-02-02 00:00:00.000,Vi±a del Mar Chile ATP World Tour 250,CLAY,2,Fernando Gonzalez,N/A Bye,Fernando Gonzalez,,R32,0,0,0,0,0,0,0,0,0,0,0,0,0,0,0,0,0,0,0,0,0,0,0,0,0,0,0
2009-02-02 00:00:00.000,Vi±a del Mar Chile ATP World Tour 250,CLAY,2,Maximo Gonzalez,Boris Pashanski,Maximo Gonzalez,6-3; 6-2,R32,71,3,2,28,46,25,28,8,18,0,1,9,33,46,1,7,30,56,16,30,9,26,4,8,8,25,56
2009-02-02 00:00:00.000,Vi±a del Mar Chile ATP World Tour 250,CLAY,2,Potito Starace,Marcos Daniel,Potito Starace,6-4; 6-4,R32,77,6,1,35,44,32,35,5,9,0,1,10,37,44,3,6,40,71,27,40,13,31,6,9,10,40,71
2009-02-02 00:00:00.000,Vi±a del Mar Chile ATP World Tour 250,CLAY,2,Juan Monaco,Nicolas Devilder,Juan Monaco,6-2; 6-4,R32,83,1,3,36,57,26,36,13,21,3,3,9,39,57,2,2,36,64,21,36,13,28,5,8,9,34,64
2009-02-02 00:00:00.000,Vi±a del Mar Chile ATP World Tour 250,CLAY,2,Albert Montanes,N/A Bye,Albert Montanes,,R32,0,0,0,0,0,0,0,0,0,0,0,0,0,0,0,0,0,0,0,0,0,0,0,0,0,0,0
2009-02-02 00:00:00.000,Vi±a del Mar Chile ATP World Tour 250,CLAY,2,Pablo Cuevas,Nicolas Lapentti,Pablo Cuevas,6-3; 3-6; 7-5,R32,134,11,4,57,93,42,57,19,36,3,5,15,61,93,6,1,46,79,37,46,16,33,3,6,15,53,79
2009-02-02 00:00:00.000,Vi±a del Mar Chile ATP World Tour 250,CLAY,2,Daniel Gimeno-Traver,Alberto Martin,Daniel Gimeno-Traver,6-3; 6-7(2); 6-6 RET,R32,157,3,1,75,114,53,75,23,39,6,8,17,76,114,4,0,75,94,55,75,11,19,0,3,16,66,94
2009-02-02 00:00:00.000,Vi±a del Mar Chile ATP World Tour 250,CLAY,2,Paul Capdeville,Eduardo Schwank,Paul Capdeville,6-3; 6-4,R32,96,2,2,34,48,30,34,7,14,0,1,10,37,48,3,1,49,83,33,49,13,34,8,11,9,46,83
2009-02-02 00:00:00.000,Vi±a del Mar Chile ATP World Tour 250,CLAY,2,Agustin Calleri,Nicolas Massu,Agustin Calleri,7-6(4); 6-1,R32,100,3,0,44,65,34,44,7,21,1,3,10,41,65,1,2,39,63,21,39,12,24,3,7,9,33,63
2009-02-02 00:00:00.000,Vi±a del Mar Chile ATP World Tour 250,CLAY,2,Sebastian Decoud,Fabio Fognini,Sebastian Decoud,6-3; 7-5,R32,96,2,1,42,67,30,42,15,25,3,5,11,45,67,6,2,33,61,25,33,9,28,2,6,10,34,61
2009-02-02 00:00:00.000,Vi±a del Mar Chile ATP World Tour 250,CLAY,2,Thomaz Bellucci,Juan Pablo Brzezicki,Thomaz Bellucci,6-2; 6-3,R32,90,5,1,36,60,29,36,12,24,9,9,8,41,60,1,0,48,68,25,48,11,20,8,12,9,36,68
2009-02-02 00:00:00.000,Vi±a del Mar Chile ATP World Tour 250,CLAY,2,Jose Acasuso,N/A Bye,Jose Acasuso,,R32,0,0,0,0,0,0,0,0,0,0,0,0,0,0,0,0,0,0,0,0,0,0,0,0,0,0,0
2009-02-02 00:00:00.000,Vi±a del Mar Chile ATP World Tour 250,CLAY,2,Martin Vassallo Arguello,Oscar Hernandez,Martin Vassallo Arguello,6-3; 7-6(1),R32,104,0,2,42,63,31,42,12,21,1,3,11,43,63,0,1,39,61,25,39,11,22,5,8,10,36,61
2009-02-02 00:00:00.000,Vi±a del Mar Chile ATP World Tour 250,CLAY,2,Juan Ignacio Chela,Pablo Andujar,Juan Ignacio Chela,6-0; 3-6; 6-1,R32,130,0,1,61,92,37,61,16,31,8,11,11,53,92,1,2,53,74,24,53,9,21,5,12,11,33,74
2009-02-02 00:00:00.000,Vi±a del Mar Chile ATP World Tour 250,CLAY,2,Brian Dabul,Diego Junqueira,Brian Dabul,6-2; 6-7(2); 6-1,R32,137,2,2,69,102,49,69,16,33,5,6,14,65,102,0,3,59,83,35,59,11,24,2,7,13,46,83
2009-02-02 00:00:00.000,Vi±a del Mar Chile ATP World Tour 250,CLAY,2,Tommy Robredo,N/A Bye,Tommy Robredo,,R32,0,0,0,0,0,0,0,0,0,0,0,0,0,0,0,0,0,0,0,0,0,0,0,0,0,0,0
2009-02-02 00:00:00.000,Vi±a del Mar Chile ATP World Tour 250,CLAY,2,Fernando Gonzalez,Maximo Gonzalez,Fernando Gonzalez,7-5; 7-6(7),R16,127,8,2,58,78,46,58,7,20,6,8,12,53,78,2,4,80,112,46,80,18,32,13,16,12,64,112
2009-02-02 00:00:00.000,Vi±a del Mar Chile ATP World Tour 250,CLAY,2,Juan Monaco,Potito Starace,Juan Monaco,6-3; 6-3,R16,74,2,2,31,48,23,31,10,17,0,1,9,33,48,2,1,41,52,22,41,7,11,5,9,9,29,52
2009-02-02 00:00:00.000,Vi±a del Mar Chile ATP World Tour 250,CLAY,2,Pablo Cuevas,Albert Montanes,Pablo Cuevas,7-6(2); 6-4,R16,98,5,1,50,74,37,50,15,24,2,3,11,52,74,1,3,48,71,30,48,12,23,2,4,11,42,71
2009-02-02 00:00:00.000,Vi±a del Mar Chile ATP World Tour 250,CLAY,2,Paul Capdeville,Daniel Gimeno-Traver,Paul Capdeville,6-4; 6-3,R16,84,2,0,33,58,24,33,19,25,5,5,10,43,58,1,1,34,57,23,34,14,23,2,4,9,37,57
2009-02-02 00:00:00.000,Vi±a del Mar Chile ATP World Tour 250,CLAY,2,Sebastian Decoud,Agustin Calleri,Sebastian Decoud,7-6(3); 7-5,R16,102,2,4,56,76,42,56,9,20,3,5,12,51,76,6,2,45,78,30,45,16,33,3,6,12,46,78
2009-02-02 00:00:00.000,Vi±a del Mar Chile ATP World Tour 250,CLAY,2,Jose Acasuso,Thomaz Bellucci,Jose Acasuso,7-6(3); 6-3,R16,119,2,1,42,83,35,42,18,41,4,5,11,53,83,7,2,53,84,36,53,14,31,9,11,10,50,84
2009-02-02 00:00:00.000,Vi±a del Mar Chile ATP World Tour 250,CLAY,2,Juan Ignacio Chela,Martin Vassallo Arguello,Juan Ignacio Chela,6-4; 7-6(4),R16,114,4,2,44,63,35,44,12,19,4,5,11,47,63,1,2,44,70,29,44,14,26,1,3,11,43,70
2009-02-02 00:00:00.000,Vi±a del Mar Chile ATP World Tour 250,CLAY,2,Tommy Robredo,Brian Dabul,Tommy Robredo,6-3; 7-6(5),R16,106,4,3,46,75,33,46,15,29,4,6,11,48,75,2,3,44,65,29,44,7,21,1,4,10,36,65
2009-02-02 00:00:00.000,Vi±a del Mar Chile ATP World Tour 250,CLAY,2,Fernando Gonzalez,Juan Monaco,Fernando Gonzalez,6-0; 6-2,Q,56,1,0,31,36,26,31,2,5,0,0,7,28,36,0,0,38,47,18,38,2,9,4,9,7,20,47
2009-02-02 00:00:00.000,Vi±a del Mar Chile ATP World Tour 250,CLAY,2,Pablo Cuevas,Paul Capdeville,Pablo Cuevas,7-5; 7-5,Q,97,5,0,53,73,43,53,12,20,5,6,12,55,73,1,1,45,67,30,45,12,22,2,5,12,42,67
2009-02-02 00:00:00.000,Vi±a del Mar Chile ATP World Tour 250,CLAY,2,Jose Acasuso,Sebastian Decoud,Jose Acasuso,6-4; 6-2,Q,88,4,1,28,52,23,28,14,24,1,2,9,37,52,1,1,41,53,25,41,3,12,3,7,9,28,53
2009-02-02 00:00:00.000,Vi±a del Mar Chile ATP World Tour 250,CLAY,2,Tommy Robredo,Juan Ignacio Chela,Tommy Robredo,0-6; 6-3; 6-4,Q,129,1,2,57,96,35,57,20,39,4,8,13,55,96,2,3,54,78,37,54,11,24,4,7,12,48,78
2009-02-02 00:00:00.000,Vi±a del Mar Chile ATP World Tour 250,CLAY,2,Fernando Gonzalez,Pablo Cuevas,Fernando Gonzalez,6-3; 6-2,S,120,1,0,32,42,28,32,8,10,0,0,9,36,42,0,3,42,61,27,42,7,19,8,11,8,34,61
2009-02-02 00:00:00.000,Vi±a del Mar Chile ATP World Tour 250,CLAY,2,Jose Acasuso,Tommy Robredo,Jose Acasuso,5-7; 6-2; 6-4,S,157,1,4,48,85,36,48,21,37,3,5,15,57,85,1,0,64,86,44,64,10,22,4,8,15,54,86
2009-02-02 00:00:00.000,Vi±a del Mar Chile ATP World Tour 250,CLAY,2,Fernando Gonzalez,Jose Acasuso,Fernando Gonzalez,6-1; 6-3,F,56,2,0,34,41,27,34,5,7,0,0,8,32,41,2,3,28,49,16,28,7,21,4,8,8,23,49
2009-02-02 00:00:00.000,Zagreb Croatia ATP World Tour 250,HARD,2,Ivan Dodig,Igor Andreev,Ivan Dodig,6-1; 6-4,R32,75,5,5,25,52,22,25,17,27,0,0,9,39,52,2,3,32,56,20,32,11,24,1,4,8,31,56
2009-02-02 00:00:00.000,Zagreb Croatia ATP World Tour 250,HARD,2,Ernests Gulbis,Dmitry Tursunov,Ernests Gulbis,4-6; 6-4; 6-4,R32,116,8,3,55,88,49,55,13,33,2,3,15,62,88,14,5,61,101,44,61,21,40,7,9,15,65,101
2009-02-02 00:00:00.000,Zagreb Croatia ATP World Tour 250,HARD,2,Teymuraz Gabashvili,Mikhail Youzhny,Teymuraz Gabashvili,6-3; 6-4,R32,92,4,2,35,68,28,35,18,33,7,7,10,46,68,3,1,38,54,26,38,7,16,2,4,9,33,54
2009-02-02 00:00:00.000,Zagreb Croatia ATP World Tour 250,HARD,2,Mario Ancic,Lukas Lacko,Mario Ancic,6-4; 6-7(6); 7-5,R32,142,20,2,64,93,53,64,21,29,4,5,17,74,93,7,1,76,117,51,76,24,41,6,9,17,75,117
2009-02-02 00:00:00.000,Zagreb Croatia ATP World Tour 250,HARD,2,Paul-Henri Mathieu,Roko Karanusic,Paul-Henri Mathieu,6-7(6); 6-1; 7-6(3),R32,141,6,5,63,104,44,63,24,41,6,8,16,68,104,7,1,60,114,41,60,25,54,8,12,15,66,114
2009-02-02 00:00:00.000,Zagreb Croatia ATP World Tour 250,HARD,2,Jan Hernych,Nikola Mektic,Jan Hernych,6-3; 7-5,R32,81,2,1,47,68,34,47,12,21,6,7,11,46,68,4,2,39,66,25,39,12,27,3,6,10,37,66
2009-02-02 00:00:00.000,Zagreb Croatia ATP World Tour 250,HARD,2,Victor Hanescu,Lovro Zovko,Victor Hanescu,6-3; 7-5,R32,90,4,0,44,58,35,44,10,14,0,0,11,45,58,4,4,44,62,34,44,6,18,6,8,10,40,62
2009-02-02 00:00:00.000,Zagreb Croatia ATP World Tour 250,HARD,2,Mischa Zverev,Andreas Seppi,Mischa Zverev,7-6(4); 3-6; 6-2,R32,121,5,2,70,103,45,70,14,33,3,9,15,59,103,4,2,45,84,28,45,20,39,4,10,14,48,84
2009-02-02 00:00:00.000,Zagreb Croatia ATP World Tour 250,HARD,2,Viktor Troicki,Simone Bolelli,Viktor Troicki,6-3; 6-4,R32,84,4,2,31,53,27,31,9,22,0,2,10,36,53,1,2,37,66,21,37,13,29,8,12,9,34,66
2009-02-02 00:00:00.000,Zagreb Croatia ATP World Tour 250,HARD,2,Ivan Ljubicic,Christophe Rochus,Ivan Ljubicic,6-4; 6-1,R32,58,18,4,25,50,23,25,13,25,2,3,9,36,50,1,5,39,65,21,39,11,26,5,9,8,32,65
2009-02-02 00:00:00.000,Zagreb Croatia ATP World Tour 250,HARD,2,Sergiy Stakhovsky,Dominik Hrbaty,Sergiy Stakhovsky,6-2; 4-6; 6-1,R32,109,9,3,61,85,49,61,9,24,5,6,13,58,85,1,2,45,85,26,45,21,40,7,11,12,47,85
2009-02-02 00:00:00.000,Zagreb Croatia ATP World Tour 250,HARD,2,Ivo Karlovic,Philipp Petzschner,Ivo Karlovic,6-3; 6-4,R32,62,15,2,33,49,29,33,11,16,0,0,10,40,49,2,3,31,56,24,31,10,25,1,3,9,34,56
2009-02-02 00:00:00.000,Zagreb Croatia ATP World Tour 250,HARD,2,Evgeny Korolev,Jurgen Melzer,Evgeny Korolev,6-4; 6-0,R32,56,2,2,31,46,25,31,6,15,1,2,8,31,46,4,4,25,47,15,25,5,22,2,7,8,20,47
2009-02-02 00:00:00.000,Zagreb Croatia ATP World Tour 250,HARD,2,Antonio Veic,Guillermo Canas,Antonio Veic,4-6; 6-4; 6-2,R32,121,12,2,48,81,34,48,19,33,5,8,14,53,81,4,8,56,107,37,56,22,51,7,12,14,59,107
2009-02-02 00:00:00.000,Zagreb Croatia ATP World Tour 250,HARD,2,Florent Serra,Marc Gicquel,Florent Serra,6-2; 4-6; 7-6(2),R32,114,5,4,68,95,53,68,16,27,5,6,15,69,95,10,9,57,94,47,57,15,37,2,4,15,62,94
2009-02-02 00:00:00.000,Zagreb Croatia ATP World Tour 250,HARD,2,Marin Cilic,Arnaud Clement,Marin Cilic,6-4; 6-3,R32,87,12,2,28,53,25,28,14,25,3,3,9,39,53,2,2,38,67,26,38,12,29,3,6,10,38,67
2009-02-02 00:00:00.000,Zagreb Croatia ATP World Tour 250,HARD,2,Ivan Dodig,Ernests Gulbis,Ivan Dodig,7-6(3); 6-4,R16,105,8,1,43,74,30,43,19,31,3,4,11,49,74,9,6,47,80,32,47,16,33,3,5,11,48,80
2009-02-02 00:00:00.000,Zagreb Croatia ATP World Tour 250,HARD,2,Mario Ancic,Teymuraz Gabashvili,Mario Ancic,6-1; 6-1,R16,68,6,2,18,42,15,18,16,24,0,0,7,31,42,3,5,28,50,16,28,5,22,4,9,7,21,50
2009-02-02 00:00:00.000,Zagreb Croatia ATP World Tour 250,HARD,2,Jan Hernych,Paul-Henri Mathieu,Jan Hernych,6-7(7); 6-4; 6-2,R16,141,2,4,60,97,46,60,22,37,5,6,15,68,97,3,0,52,103,38,52,26,51,4,8,15,64,103
2009-02-02 00:00:00.000,Zagreb Croatia ATP World Tour 250,HARD,2,Mischa Zverev,Victor Hanescu,Mischa Zverev,6-4; 5-7; 7-6(7),R16,157,7,1,92,129,60,92,18,37,14,17,17,78,129,4,1,90,119,55,90,19,29,6,9,17,74,119
2009-02-02 00:00:00.000,Zagreb Croatia ATP World Tour 250,HARD,2,Viktor Troicki,Ivan Ljubicic,Viktor Troicki,6-4; 5-7; 6-4,R16,139,7,0,73,101,50,73,15,28,8,11,16,65,101,19,1,59,99,45,59,14,40,5,9,16,59,99
2009-02-02 00:00:00.000,Zagreb Croatia ATP World Tour 250,HARD,2,Sergiy Stakhovsky,Ivo Karlovic,Sergiy Stakhovsky,6-4; 3-6; 6-3,R16,93,6,0,42,66,38,42,15,24,1,2,14,53,66,12,4,51,79,43,51,14,28,4,6,14,57,79
2009-02-02 00:00:00.000,Zagreb Croatia ATP World Tour 250,HARD,2,Antonio Veic,Evgeny Korolev,Antonio Veic,3-6; 7-6(5); 6-4,R16,150,4,5,64,113,44,64,27,49,6,8,15,71,113,7,4,49,97,41,49,24,48,5,7,16,65,97
2009-02-02 00:00:00.000,Zagreb Croatia ATP World Tour 250,HARD,2,Marin Cilic,Florent Serra,Marin Cilic,6-2; 7-5,R16,83,13,2,35,65,29,35,14,30,2,3,10,43,65,1,3,37,70,20,37,18,33,7,11,10,38,70
2009-02-02 00:00:00.000,Zagreb Croatia ATP World Tour 250,HARD,2,Mario Ancic,Ivan Dodig,Mario Ancic,6-1; 6-3,Q,83,6,0,33,45,25,33,9,12,2,2,8,34,45,5,4,31,56,18,31,11,25,3,7,8,29,56
2009-02-02 00:00:00.000,Zagreb Croatia ATP World Tour 250,HARD,2,Jan Hernych,Mischa Zverev,Jan Hernych,5-4 RET,Q,35,0,0,14,19,12,14,4,5,0,0,4,16,19,1,0,16,33,10,16,10,17,4,5,5,20,33
2009-02-02 00:00:00.000,Zagreb Croatia ATP World Tour 250,HARD,2,Viktor Troicki,Sergiy Stakhovsky,Viktor Troicki,6-3; 6-2,Q,67,5,1,35,51,27,35,9,16,3,3,8,36,51,3,0,47,65,29,47,6,18,4,8,9,35,65
2009-02-02 00:00:00.000,Zagreb Croatia ATP World Tour 250,HARD,2,Marin Cilic,Antonio Veic,Marin Cilic,6-2; 7-6(6),Q,98,4,1,31,64,26,31,19,33,0,1,10,45,64,3,4,42,78,29,42,16,36,10,13,10,45,78
2009-02-02 00:00:00.000,Zagreb Croatia ATP World Tour 250,HARD,2,Mario Ancic,Jan Hernych,Mario Ancic,6-7(4); 6-3; 7-6(9),S,187,12,0,84,124,67,84,14,40,8,11,17,81,124,4,4,83,118,54,83,17,35,3,7,16,71,118
2009-02-02 00:00:00.000,Zagreb Croatia ATP World Tour 250,HARD,2,Marin Cilic,Viktor Troicki,Marin Cilic,6-2; 7-5,S,86,6,1,25,47,22,25,18,22,0,0,10,40,47,3,1,52,80,31,52,14,28,7,10,10,45,80
2009-02-02 00:00:00.000,Zagreb Croatia ATP World Tour 250,HARD,2,Marin Cilic,Mario Ancic,Marin Cilic,6-3; 6-4,F,91,5,2,29,69,18,29,26,40,10,12,10,44,69,4,1,34,54,19,34,10,20,2,6,9,29,54
2009-02-09 00:00:00.000,Costa Do Sauipe Brazil ATP World Tour 250,CLAY,2,Nicolas Almagro,Ricardo Hocevar,Nicolas Almagro,7-6(4); 7-5,R32,103,11,3,33,64,31,33,20,31,0,0,12,51,64,12,3,39,79,25,39,27,40,4,5,12,52,79
2009-02-09 00:00:00.000,Costa Do Sauipe Brazil ATP World Tour 250,CLAY,2,Martin Vassallo Arguello,Nicolas Massu,Martin Vassallo Arguello,7-6(4); 2-6; 6-4,R32,186,2,4,78,115,50,78,17,37,6,11,15,67,115,2,6,55,109,37,55,27,54,11,15,15,64,109
2009-02-09 00:00:00.000,Costa Do Sauipe Brazil ATP World Tour 250,CLAY,2,Frederico Gil,Pablo Andujar,Frederico Gil,3-6; 6-4; 6-3,R32,154,4,3,48,92,29,48,27,44,6,9,14,56,92,2,2,60,82,38,60,13,22,1,5,14,51,82
2009-02-09 00:00:00.000,Costa Do Sauipe Brazil ATP World Tour 250,CLAY,2,Marcel Granollers,Flavio Saretta,Marcel Granollers,6-2; 2-6; 6-1,R32,122,3,2,40,78,28,40,18,38,6,9,11,46,78,2,3,39,70,21,39,15,31,4,10,12,36,70
2009-02-09 00:00:00.000,Costa Do Sauipe Brazil ATP World Tour 250,CLAY,2,Juan Carlos Ferrero,Albert Montanes,Juan Carlos Ferrero,6-7(4); 6-2; 6-2,R32,131,5,4,71,101,50,71,15,30,8,11,14,65,101,4,5,44,95,26,44,23,51,7,14,14,49,95
2009-02-09 00:00:00.000,Costa Do Sauipe Brazil ATP World Tour 250,CLAY,2,Brian Dabul,Paul Capdeville,Brian Dabul,6-1 RET,R32,31,2,1,15,19,14,15,2,4,0,0,4,16,19,0,1,13,18,6,13,2,5,0,2,3,8,18
2009-02-09 00:00:00.000,Costa Do Sauipe Brazil ATP World Tour 250,CLAY,2,Lukasz Kubot,Daniel Gimeno-Traver,Lukasz Kubot,7-6(7); 1-6; 6-3,R32,148,2,4,61,100,39,61,21,39,7,11,14,60,100,10,3,71,106,52,71,15,35,10,13,14,67,106
2009-02-09 00:00:00.000,Costa Do Sauipe Brazil ATP World Tour 250,CLAY,2,Thomaz Bellucci,Potito Starace,Thomaz Bellucci,6-3; 6-4,R32,83,7,5,29,56,26,29,14,27,0,1,10,40,56,0,1,40,64,24,40,11,24,6,9,9,35,64
2009-02-09 00:00:00.000,Costa Do Sauipe Brazil ATP World Tour 250,CLAY,2,Eduardo Schwank,Diego Junqueira,Eduardo Schwank,6-1; 7-5,R32,91,3,2,37,58,24,37,15,21,0,1,10,39,58,0,4,52,78,29,52,11,26,9,13,9,40,78
2009-02-09 00:00:00.000,Costa Do Sauipe Brazil ATP World Tour 250,CLAY,2,Rui Machado,Ivan Navarro,Rui Machado,6-4; 6-1,R32,102,1,0,32,48,22,32,12,16,1,1,8,34,48,2,7,34,73,22,34,14,39,8,12,9,36,73
2009-02-09 00:00:00.000,Costa Do Sauipe Brazil ATP World Tour 250,CLAY,2,Pablo Cuevas,Oscar Hernandez,Pablo Cuevas,4-6; 6-4; 6-1,R32,126,8,1,53,80,38,53,17,27,2,4,14,55,80,1,2,39,71,27,39,17,32,1,5,13,44,71
2009-02-09 00:00:00.000,Costa Do Sauipe Brazil ATP World Tour 250,CLAY,2,Jose Acasuso,Juan Monaco,Jose Acasuso,7-6(3); 6-4,R32,117,2,1,38,73,31,38,22,35,4,5,11,53,73,0,2,47,86,29,47,24,39,7,9,11,53,86
2009-02-09 00:00:00.000,Costa Do Sauipe Brazil ATP World Tour 250,CLAY,2,Nicolas Devilder,Daniel Dutra da Silva,Nicolas Devilder,7-6(5); 6-2,R32,111,2,3,52,75,35,52,14,23,7,9,10,49,75,0,3,38,72,24,38,16,34,5,9,10,40,72
2009-02-09 00:00:00.000,Costa Do Sauipe Brazil ATP World Tour 250,CLAY,2,Alberto Martin,Nicolas Lapentti,Alberto Martin,6-4; 7-5,R32,94,2,0,39,61,32,39,11,22,2,3,11,43,61,2,3,36,65,24,36,16,29,2,5,11,40,65
2009-02-09 00:00:00.000,Costa Do Sauipe Brazil ATP World Tour 250,CLAY,2,Fabio Fognini,Caio Zampieri,Fabio Fognini,0-6; 7-6(5); 6-2,R32,114,3,2,39,81,24,39,22,42,2,7,13,46,81,3,2,47,82,31,47,19,35,2,6,13,50,82
2009-02-09 00:00:00.000,Costa Do Sauipe Brazil ATP World Tour 250,CLAY,2,Tommy Robredo,Thiago Alves,Tommy Robredo,6-4; 6-2,R32,73,5,1,29,42,25,29,11,13,0,0,9,36,42,2,0,38,63,22,38,14,25,1,4,9,36,63
2009-02-09 00:00:00.000,Costa Do Sauipe Brazil ATP World Tour 250,CLAY,2,Nicolas Almagro,Martin Vassallo Arguello,Nicolas Almagro,6-4; 6-4,R16,93,5,2,36,66,26,36,14,30,4,6,10,40,66,4,1,41,58,29,41,3,17,4,8,10,32,58
2009-02-09 00:00:00.000,Costa Do Sauipe Brazil ATP World Tour 250,CLAY,2,Frederico Gil,Marcel Granollers,Frederico Gil,7-5; 3-6; 6-3,R16,157,0,2,61,97,41,61,19,36,4,7,15,60,97,8,4,63,99,44,63,16,36,6,10,15,60,99
2009-02-09 00:00:00.000,Costa Do Sauipe Brazil ATP World Tour 250,CLAY,2,Juan Carlos Ferrero,Brian Dabul,Juan Carlos Ferrero,6-1; 6-2,R16,73,3,0,28,45,21,28,12,17,1,1,8,33,45,0,2,31,45,16,31,6,14,4,8,7,22,45
2009-02-09 00:00:00.000,Costa Do Sauipe Brazil ATP World Tour 250,CLAY,2,Thomaz Bellucci,Lukasz Kubot,Thomaz Bellucci,5-7; 6-4; 6-4,R16,149,18,2,49,91,35,49,27,42,3,6,16,62,91,1,8,59,95,41,59,17,36,1,5,16,58,95
2009-02-09 00:00:00.000,Costa Do Sauipe Brazil ATP World Tour 250,CLAY,2,Eduardo Schwank,Rui Machado,Eduardo Schwank,2-6; 7-6(4); 7-6(6),R16,188,5,5,68,117,42,68,20,49,3,10,16,62,117,3,5,83,120,49,83,17,37,5,10,16,66,120
2009-02-09 00:00:00.000,Costa Do Sauipe Brazil ATP World Tour 250,CLAY,2,Jose Acasuso,Pablo Cuevas,Jose Acasuso,6-3; 6-2,R16,77,2,0,32,52,24,32,14,20,2,2,9,38,52,5,2,23,48,17,23,11,25,4,7,8,28,48
2009-02-09 00:00:00.000,Costa Do Sauipe Brazil ATP World Tour 250,CLAY,2,Alberto Martin,Nicolas Devilder,Alberto Martin,6-2; 7-6(4),R16,109,1,3,53,82,35,53,18,29,9,9,10,53,82,2,2,34,68,24,34,19,34,6,8,10,43,68
2009-02-09 00:00:00.000,Costa Do Sauipe Brazil ATP World Tour 250,CLAY,2,Tommy Robredo,Fabio Fognini,Tommy Robredo,6-2; 6-2,R16,64,3,2,31,47,27,31,7,16,4,4,8,34,47,1,3,31,51,18,31,6,20,4,8,8,24,51
2009-02-09 00:00:00.000,Costa Do Sauipe Brazil ATP World Tour 250,CLAY,2,Frederico Gil,Nicolas Almagro,Frederico Gil,7-6(5); 7-6(4),Q,125,6,3,63,92,50,63,10,29,9,11,12,60,92,11,5,53,84,38,53,15,31,0,2,12,53,84
2009-02-09 00:00:00.000,Costa Do Sauipe Brazil ATP World Tour 250,CLAY,2,Thomaz Bellucci,Juan Carlos Ferrero,Thomaz Bellucci,7-6(5); 1-6; 6-3,Q,146,13,7,71,107,53,71,13,36,7,11,14,66,107,3,2,58,84,36,58,18,26,5,8,14,54,84
2009-02-09 00:00:00.000,Costa Do Sauipe Brazil ATP World Tour 250,CLAY,2,Jose Acasuso,Eduardo Schwank,Jose Acasuso,6-4; 6-3,Q,100,4,1,31,60,20,31,15,29,7,9,9,35,60,0,1,34,57,17,34,12,23,3,8,10,29,57
2009-02-09 00:00:00.000,Costa Do Sauipe Brazil ATP World Tour 250,CLAY,2,Tommy Robredo,Alberto Martin,Tommy Robredo,6-2; 6-2,Q,61,2,0,26,41,22,26,12,15,2,2,8,34,41,0,0,33,50,18,33,7,17,3,7,8,25,50
2009-02-09 00:00:00.000,Costa Do Sauipe Brazil ATP World Tour 250,CLAY,2,Thomaz Bellucci,Frederico Gil,Thomaz Bellucci,7-6(3); 7-6(4),S,136,3,1,41,71,35,41,19,30,3,4,12,54,71,2,2,50,77,37,50,13,27,1,2,12,50,77
2009-02-09 00:00:00.000,Costa Do Sauipe Brazil ATP World Tour 250,CLAY,2,Tommy Robredo,Jose Acasuso,Tommy Robredo,6-2; 6-1,S,63,6,1,33,46,26,33,8,13,2,2,8,34,46,3,5,25,47,16,25,7,22,7,11,7,23,47
2009-02-09 00:00:00.000,Costa Do Sauipe Brazil ATP World Tour 250,CLAY,2,Tommy Robredo,Thomaz Bellucci,Tommy Robredo,6-3; 3-6; 6-4,F,133,1,4,47,82,32,47,22,35,3,5,14,54,82,7,2,56,87,38,56,15,31,2,5,14,53,87
2009-02-09 00:00:00.000,Rotterdam The Netherlands ATP World Tour 500,HARD,2,Rafael Nadal,Simone Bolelli,Rafael Nadal,4-6; 6-2; 7-5,R32,146,9,2,50,81,41,50,18,31,0,1,15,59,81,7,1,67,106,49,67,17,39,12,15,15,66,106
2009-02-09 00:00:00.000,Rotterdam The Netherlands ATP World Tour 500,HARD,2,Grigor Dimitrov,Tomas Berdych,Grigor Dimitrov,4-6; 6-3; 6-4,R32,128,10,1,64,102,48,64,19,38,9,10,15,67,102,9,3,49,80,40,49,15,31,3,5,14,55,80
2009-02-09 00:00:00.000,Rotterdam The Netherlands ATP World Tour 500,HARD,2,Dmitry Tursunov,Arnaud Clement,Dmitry Tursunov,6-0; 6-3,R32,66,8,3,25,46,22,25,12,21,3,3,8,34,46,2,7,24,48,17,24,6,24,6,10,7,23,48
2009-02-09 00:00:00.000,Rotterdam The Netherlands ATP World Tour 500,HARD,2,Jo-Wilfried Tsonga,Jesse Huta Galung,Jo-Wilfried Tsonga,7-6(4); 7-6(4),R32,111,15,5,43,75,39,43,18,32,2,2,12,57,75,8,4,51,88,40,51,21,37,4,4,12,61,88
2009-02-09 00:00:00.000,Rotterdam The Netherlands ATP World Tour 500,HARD,2,Nikolay Davydenko,Igor Andreev,Nikolay Davydenko,6-3; 6-2,R32,68,3,1,30,53,22,30,16,23,1,1,9,38,53,1,0,33,43,21,33,5,10,1,4,8,26,43
2009-02-09 00:00:00.000,Rotterdam The Netherlands ATP World Tour 500,HARD,2,Julien Benneteau,Feliciano Lopez,Julien Benneteau,6-4; 5-7; 6-2,R32,109,12,2,55,75,44,55,14,20,1,2,15,58,75,8,7,47,88,40,47,18,41,6,9,15,58,88
2009-02-09 00:00:00.000,Rotterdam The Netherlands ATP World Tour 500,HARD,2,Michael Llodra,Ivo Karlovic,Michael Llodra,4-6; 6-3; 6-4,R32,102,5,10,50,83,43,50,16,33,2,4,15,59,83,25,2,53,84,43,53,11,31,2,5,14,54,84
2009-02-09 00:00:00.000,Rotterdam The Netherlands ATP World Tour 500,HARD,2,Gael Monfils,Stephane Bohli,Gael Monfils,6-4; 1-0 RET,R32,42,2,2,16,36,13,16,10,20,1,1,5,23,36,5,0,16,29,12,16,7,13,1,3,6,19,29
2009-02-09 00:00:00.000,Rotterdam The Netherlands ATP World Tour 500,HARD,2,David Ferrer,Jurgen Melzer,David Ferrer,3-6; 7-6(4); 7-5,R32,137,2,7,56,98,42,56,19,42,3,8,17,61,98,7,4,70,114,50,70,18,44,3,7,16,68,114
2009-02-09 00:00:00.000,Rotterdam The Netherlands ATP World Tour 500,HARD,2,Mikhail Youzhny,Laurent Recouderc,Mikhail Youzhny,6-4; 6-4,R32,84,2,3,31,59,28,31,14,28,2,2,10,42,59,7,2,37,67,28,37,13,30,3,5,10,41,67
2009-02-09 00:00:00.000,Rotterdam The Netherlands ATP World Tour 500,HARD,2,Mario Ancic,Rainer Schuettler,Mario Ancic,7-5; 6-2,R32,84,6,1,25,51,21,25,15,26,1,3,10,36,51,0,4,31,65,19,31,14,34,8,13,10,33,65
2009-02-09 00:00:00.000,Rotterdam The Netherlands ATP World Tour 500,HARD,2,Gilles Simon,Philipp Kohlschreiber,Gilles Simon,7-5; 7-6(1),R32,110,8,1,43,82,39,43,17,39,6,7,12,56,82,3,5,44,83,30,44,21,39,4,6,12,51,83
2009-02-09 00:00:00.000,Rotterdam The Netherlands ATP World Tour 500,HARD,2,Marc Gicquel,Evgeny Korolev,Marc Gicquel,3-6; 6-3; 6-2,R32,91,5,3,44,84,37,44,19,40,10,11,13,56,84,14,5,42,72,36,42,11,30,3,6,13,47,72
2009-02-09 00:00:00.000,Rotterdam The Netherlands ATP World Tour 500,HARD,2,Paul-Henri Mathieu,Richard Gasquet,Paul-Henri Mathieu,3-6; 7-6(4); 6-3,R32,141,15,3,61,113,42,61,23,52,5,10,16,65,113,14,5,43,95,36,43,21,52,6,10,14,57,95
2009-02-09 00:00:00.000,Rotterdam The Netherlands ATP World Tour 500,HARD,2,Andreas Seppi,Thiemo de Bakker,Andreas Seppi,6-7(5); 6-2; 7-6(1),R32,119,10,2,51,88,44,51,23,37,1,2,16,67,88,13,3,54,103,42,54,23,49,8,11,16,65,103
2009-02-09 00:00:00.000,Rotterdam The Netherlands ATP World Tour 500,HARD,2,Andy Murray,Ivan Ljubicic,Andy Murray,6-3; 6-2,R32,74,7,2,27,54,20,27,17,27,2,3,9,37,54,7,7,24,55,16,24,11,31,2,6,8,27,55
2009-02-09 00:00:00.000,Rotterdam The Netherlands ATP World Tour 500,HARD,2,Rafael Nadal,Grigor Dimitrov,Rafael Nadal,7-5; 3-6; 6-2,R16,146,3,1,51,84,37,51,22,33,7,9,14,59,84,9,6,52,92,37,52,19,40,4,8,15,56,92
2009-02-09 00:00:00.000,Rotterdam The Netherlands ATP World Tour 500,HARD,2,Jo-Wilfried Tsonga,Dmitry Tursunov,Jo-Wilfried Tsonga,7-6(6); 6-2,R16,90,13,4,57,81,41,57,13,24,4,4,10,54,81,7,2,35,63,24,35,15,28,4,6,10,39,63
2009-02-09 00:00:00.000,Rotterdam The Netherlands ATP World Tour 500,HARD,2,Julien Benneteau,Nikolay Davydenko,Julien Benneteau,6-3; 6-2,R16,72,5,0,36,58,27,36,12,22,2,3,9,39,58,2,4,26,48,17,26,5,22,2,6,8,22,48
2009-02-09 00:00:00.000,Rotterdam The Netherlands ATP World Tour 500,HARD,2,Gael Monfils,Michael Llodra,Gael Monfils,6-4; 6-4,R16,72,7,1,40,57,31,40,11,17,1,1,10,42,57,4,4,31,60,26,31,14,29,3,5,10,40,60
2009-02-09 00:00:00.000,Rotterdam The Netherlands ATP World Tour 500,HARD,2,Mikhail Youzhny,David Ferrer,Mikhail Youzhny,6-2; 3-6; 6-2,R16,105,3,3,34,67,27,34,19,33,3,5,12,46,67,4,0,44,78,26,44,17,34,2,7,13,43,78
2009-02-09 00:00:00.000,Rotterdam The Netherlands ATP World Tour 500,HARD,2,Mario Ancic,Gilles Simon,Mario Ancic,6-4; 3-6; 6-3,R16,148,9,2,63,103,49,63,20,40,6,7,14,69,103,6,2,52,103,41,52,26,51,5,7,14,67,103
2009-02-09 00:00:00.000,Rotterdam The Netherlands ATP World Tour 500,HARD,2,Marc Gicquel,Paul-Henri Mathieu,Marc Gicquel,6-4; 6-3,R16,77,3,5,27,57,23,27,17,30,3,3,9,40,57,4,2,29,61,20,29,17,32,2,5,10,37,61
2009-02-09 00:00:00.000,Rotterdam The Netherlands ATP World Tour 500,HARD,2,Andy Murray,Andreas Seppi,Andy Murray,7-6(4); 7-5,R16,107,8,4,50,75,38,50,12,25,4,7,12,50,75,5,2,48,83,32,48,17,35,6,10,12,49,83
2009-02-09 00:00:00.000,Rotterdam The Netherlands ATP World Tour 500,HARD,2,Rafael Nadal,Jo-Wilfried Tsonga,Rafael Nadal,6-4; 6-7(5); 6-4,Q,160,4,2,63,94,48,63,20,31,1,2,16,68,94,26,7,73,111,54,73,15,38,5,8,16,69,111
2009-02-09 00:00:00.000,Rotterdam The Netherlands ATP World Tour 500,HARD,2,Gael Monfils,Julien Benneteau,Gael Monfils,7-6(4); 6-1,Q,77,7,2,40,60,30,40,11,20,1,2,10,41,60,5,2,32,50,22,32,9,18,2,5,9,31,50
2009-02-09 00:00:00.000,Rotterdam The Netherlands ATP World Tour 500,HARD,2,Mario Ancic,Mikhail Youzhny,Mario Ancic,6-4; 6-2,Q,101,9,1,38,64,30,38,14,26,7,7,9,44,64,4,2,23,55,17,23,15,32,5,8,9,32,55
2009-02-09 00:00:00.000,Rotterdam The Netherlands ATP World Tour 500,HARD,2,Andy Murray,Marc Gicquel,Andy Murray,7-6(2); 4-6; 3-0 RET,Q,114,9,1,30,74,23,30,31,44,1,2,12,54,74,8,4,49,85,39,49,16,36,4,6,13,55,85
2009-02-09 00:00:00.000,Rotterdam The Netherlands ATP World Tour 500,HARD,2,Rafael Nadal,Gael Monfils,Rafael Nadal,6-4; 6-4,S,102,1,1,45,63,35,45,8,18,6,7,10,43,63,10,2,37,64,26,37,11,27,3,6,10,37,64
2009-02-09 00:00:00.000,Rotterdam The Netherlands ATP World Tour 500,HARD,2,Andy Murray,Mario Ancic,Andy Murray,6-1; 6-2,S,61,8,1,26,53,22,26,16,27,3,3,8,38,53,1,1,22,37,10,22,7,15,2,6,7,17,37
2009-02-09 00:00:00.000,Rotterdam The Netherlands ATP World Tour 500,HARD,2,Andy Murray,Rafael Nadal,Andy Murray,6-3; 4-6; 6-0,F,111,11,4,36,74,29,36,15,38,3,7,13,44,74,2,3,33,66,18,33,11,33,5,12,12,29,66
2009-02-09 00:00:00.000,San Jose CA; U.S.A. ATP World Tour 250,HARD,2,Andy Roddick,Michael Ryderstedt,Andy Roddick,6-0; 7-6(3),R32,63,7,2,33,52,29,33,14,19,3,3,9,43,52,9,3,32,52,22,32,9,20,0,3,9,31,52
2009-02-09 00:00:00.000,San Jose CA; U.S.A. ATP World Tour 250,HARD,2,Ernests Gulbis,Ricardo Mello,Ernests Gulbis,7-6(4); 6-4,R32,85,9,3,43,69,34,43,15,26,3,3,11,49,69,1,3,46,79,35,46,16,33,4,5,11,51,79
2009-02-09 00:00:00.000,San Jose CA; U.S.A. ATP World Tour 250,HARD,2,Tommy Haas,Lars Poerschke,Tommy Haas,6-1; 7-6(8),R32,75,10,2,37,63,30,37,18,26,0,0,10,48,63,12,6,42,72,32,42,14,30,2,4,9,46,72
2009-02-09 00:00:00.000,San Jose CA; U.S.A. ATP World Tour 250,HARD,2,Christophe Rochus,Igor Kunitsyn,Christophe Rochus,6-2; 7-6(7),R32,102,1,2,29,60,26,29,19,31,1,2,10,45,60,4,0,50,89,27,50,24,39,5,8,10,51,89
2009-02-09 00:00:00.000,San Jose CA; U.S.A. ATP World Tour 250,HARD,2,Radek Stepanek,Dominik Meffert,Radek Stepanek,5-7; 6-3; 6-1,R32,114,5,3,54,83,40,54,17,29,8,10,14,57,83,5,4,58,88,35,58,17,30,8,13,14,52,88
2009-02-09 00:00:00.000,San Jose CA; U.S.A. ATP World Tour 250,HARD,2,Chris Guccione,Guillermo Canas,Chris Guccione,7-6(7); 7-5,R32,94,16,3,46,74,38,46,13,28,1,2,12,51,74,8,2,42,77,34,42,16,35,4,6,12,50,77
2009-02-09 00:00:00.000,San Jose CA; U.S.A. ATP World Tour 250,HARD,2,Taylor Dent,Bobby Reynolds,Taylor Dent,6-3; 6-4,R32,69,9,1,31,51,27,31,14,20,2,2,10,41,51,3,2,29,57,25,29,12,28,4,6,9,37,57
2009-02-09 00:00:00.000,San Jose CA; U.S.A. ATP World Tour 250,HARD,2,Todd Widom,Robby Ginepri,Todd Widom,3-6; 7-6(2); 6-4,R32,126,8,1,82,113,58,82,17,31,8,9,15,75,113,8,1,57,93,45,57,21,36,1,2,16,66,93
2009-02-09 00:00:00.000,San Jose CA; U.S.A. ATP World Tour 250,HARD,2,Sam Querrey,Marcos Baghdatis,Sam Querrey,6-3; 5-7; 7-6(5),R32,118,16,2,63,98,51,63,19,35,5,7,17,70,98,8,2,44,92,35,44,28,48,0,2,16,63,92
2009-02-09 00:00:00.000,San Jose CA; U.S.A. ATP World Tour 250,HARD,2,Denis Gremelmayr,Roko Karanusic,Denis Gremelmayr,3-6; 7-6(4); 6-2,R32,121,3,2,63,106,39,63,24,43,10,14,15,63,106,4,0,68,100,37,68,23,32,8,12,14,60,100
2009-02-09 00:00:00.000,San Jose CA; U.S.A. ATP World Tour 250,HARD,2,Florent Serra,Jarkko Nieminen,Florent Serra,7-5; 6-7(1); 6-4,R32,136,8,2,70,120,47,70,25,50,8,11,17,72,120,10,2,58,109,38,58,29,51,6,11,17,67,109
2009-02-09 00:00:00.000,San Jose CA; U.S.A. ATP World Tour 250,HARD,2,James Blake,Vincent Spadea,James Blake,6-3; 6-4,R32,50,13,2,41,63,34,41,11,22,1,1,10,45,63,3,5,25,46,18,25,11,21,0,2,9,29,46
2009-02-09 00:00:00.000,San Jose CA; U.S.A. ATP World Tour 250,HARD,2,Mardy Fish,Lleyton Hewitt,Mardy Fish,7-6(5); 6-3,R32,94,19,5,44,87,35,44,22,43,10,11,11,57,87,7,3,33,61,25,33,16,28,3,5,10,41,61
2009-02-09 00:00:00.000,San Jose CA; U.S.A. ATP World Tour 250,HARD,2,John Isner,Ramon Delgado,John Isner,7-6(9); 6-4,R32,87,22,1,60,78,41,60,11,18,0,1,11,52,78,5,1,42,65,34,42,9,23,0,2,11,43,65
2009-02-09 00:00:00.000,San Jose CA; U.S.A. ATP World Tour 250,HARD,2,Kei Nishikori,Gilles Muller,Kei Nishikori,7-5; 6-2,R32,63,3,2,30,52,26,30,12,22,2,3,10,38,52,3,4,28,52,17,28,13,24,2,6,10,30,52
2009-02-09 00:00:00.000,San Jose CA; U.S.A. ATP World Tour 250,HARD,2,Juan Martin Del Potro,Andrea Stoppini,Juan Martin Del Potro,7-6(5); 7-6(5),R32,106,10,1,44,76,39,44,19,32,1,1,12,58,76,5,3,44,84,33,44,25,40,3,3,12,58,84
2009-02-09 00:00:00.000,San Jose CA; U.S.A. ATP World Tour 250,HARD,2,Andy Roddick,Ernests Gulbis,Andy Roddick,6-3; 7-6(3),R16,81,10,1,48,74,38,48,15,26,5,5,11,53,74,11,6,43,66,33,43,10,23,5,6,10,43,66
2009-02-09 00:00:00.000,San Jose CA; U.S.A. ATP World Tour 250,HARD,2,Tommy Haas,Christophe Rochus,Tommy Haas,6-2; 7-5,R16,74,18,5,30,59,27,30,16,29,0,0,10,43,59,1,3,46,72,32,46,12,26,5,8,10,44,72
2009-02-09 00:00:00.000,San Jose CA; U.S.A. ATP World Tour 250,HARD,2,Radek Stepanek,Chris Guccione,Radek Stepanek,6-2; 7-6(1),R16,75,11,3,36,60,28,36,15,24,3,4,10,43,60,8,2,45,67,33,45,7,22,5,8,10,40,67
2009-02-09 00:00:00.000,San Jose CA; U.S.A. ATP World Tour 250,HARD,2,Todd Widom,Taylor Dent,Todd Widom,6-7(5); 6-3; 6-2,R16,121,5,2,70,104,53,70,16,34,2,3,15,69,104,13,1,47,80,38,47,15,33,2,6,14,53,80
2009-02-09 00:00:00.000,San Jose CA; U.S.A. ATP World Tour 250,HARD,2,Sam Querrey,Denis Gremelmayr,Sam Querrey,6-3; 6-2,R16,53,12,1,36,50,29,36,9,14,1,1,9,38,50,0,1,33,50,17,33,11,17,3,6,8,28,50
2009-02-09 00:00:00.000,San Jose CA; U.S.A. ATP World Tour 250,HARD,2,James Blake,Florent Serra,James Blake,6-4; 6-3,R16,67,13,1,46,77,39,46,11,31,5,5,10,50,77,8,2,34,58,24,34,10,24,1,3,9,34,58
2009-02-09 00:00:00.000,San Jose CA; U.S.A. ATP World Tour 250,HARD,2,Mardy Fish,John Isner,Mardy Fish,6-2; 6-7(4); 7-5,R16,139,13,4,50,94,44,50,26,44,2,2,16,70,94,15,2,70,115,51,70,22,45,5,8,16,73,115
2009-02-09 00:00:00.000,San Jose CA; U.S.A. ATP World Tour 250,HARD,2,Juan Martin Del Potro,Kei Nishikori,Juan Martin Del Potro,6-2; 6-2,R16,75,8,1,29,52,21,29,13,23,5,6,8,34,52,1,2,22,51,14,22,7,29,4,9,8,21,51
2009-02-09 00:00:00.000,San Jose CA; U.S.A. ATP World Tour 250,HARD,2,Andy Roddick,Tommy Haas,Andy Roddick,7-5; 6-4,Q,98,8,1,39,63,31,39,15,24,0,0,11,46,63,5,4,47,80,31,47,17,33,6,8,11,48,80
2009-02-09 00:00:00.000,San Jose CA; U.S.A. ATP World Tour 250,HARD,2,Radek Stepanek,Todd Widom,Radek Stepanek,5-7; 6-0; 6-0,Q,88,9,1,46,59,36,46,10,13,0,1,12,46,59,1,1,45,69,27,45,7,24,3,9,12,34,69
2009-02-09 00:00:00.000,San Jose CA; U.S.A. ATP World Tour 250,HARD,2,James Blake,Sam Querrey,James Blake,7-6(9); 6-3,Q,67,5,3,44,72,34,44,19,28,2,3,11,53,72,16,1,38,63,31,38,13,25,4,6,10,44,63
2009-02-09 00:00:00.000,San Jose CA; U.S.A. ATP World Tour 250,HARD,2,Mardy Fish,Juan Martin Del Potro,Mardy Fish,6-3; 6-4,Q,88,19,1,39,68,30,39,18,29,4,4,10,48,68,6,3,44,67,30,44,11,23,5,7,9,41,67
2009-02-09 00:00:00.000,San Jose CA; U.S.A. ATP World Tour 250,HARD,2,Radek Stepanek,Andy Roddick,Radek Stepanek,3-6; 7-6(5); 6-4,S,133,12,4,57,104,43,57,30,47,10,11,15,73,104,19,1,78,100,63,78,9,22,3,4,16,72,100
2009-02-09 00:00:00.000,San Jose CA; U.S.A. ATP World Tour 250,HARD,2,Mardy Fish,James Blake,Mardy Fish,6-3; 6-2,S,60,16,2,29,43,27,29,9,14,0,0,9,36,43,4,2,24,52,14,24,14,28,1,4,8,28,52
2009-02-09 00:00:00.000,San Jose CA; U.S.A. ATP World Tour 250,HARD,2,Radek Stepanek,Mardy Fish,Radek Stepanek,3-6; 6-4; 6-2,F,111,5,3,58,81,46,58,9,23,2,3,13,55,81,16,0,52,84,37,52,16,32,3,6,14,53,84
2009-02-16 00:00:00.000,Buenos Aires Argentina ATP World Tour 250,CLAY,2,David Nalbandian,Nicolas Lapentti,David Nalbandian,6-3; 6-3,R32,73,3,1,21,43,17,21,16,22,0,1,9,33,43,1,2,31,54,20,31,9,23,1,5,9,29,54
2009-02-16 00:00:00.000,Buenos Aires Argentina ATP World Tour 250,CLAY,2,Daniel Gimeno-Traver,Gaston Gaudio,Daniel Gimeno-Traver,6-2; 4-6; 6-2,R32,118,3,1,73,98,44,73,12,25,9,13,13,56,98,1,11,50,69,32,50,3,19,6,13,13,35,69
2009-02-16 00:00:00.000,Buenos Aires Argentina ATP World Tour 250,CLAY,2,Juan Carlos Ferrero,Agustin Calleri,Juan Carlos Ferrero,6-3; 6-4,R32,78,1,0,41,53,31,41,11,12,0,0,10,42,53,6,3,39,67,30,39,11,28,2,4,9,41,67
2009-02-16 00:00:00.000,Buenos Aires Argentina ATP World Tour 250,CLAY,2,Marcel Granollers,Thomaz Bellucci,Marcel Granollers,7-5; 7-5,R32,117,2,4,39,78,29,39,20,39,4,7,12,49,78,1,3,37,66,25,37,13,29,4,9,12,38,66
2009-02-16 00:00:00.000,Buenos Aires Argentina ATP World Tour 250,CLAY,2,Maximo Gonzalez,Carlos Moya,Maximo Gonzalez,6-4; 6-4,R32,78,1,3,36,59,27,36,11,23,1,3,10,38,59,4,3,30,54,20,30,11,24,4,8,10,31,54
2009-02-16 00:00:00.000,Buenos Aires Argentina ATP World Tour 250,CLAY,2,Brian Dabul,Nicolas Devilder,Brian Dabul,5-7; 7-5; 6-4,R32,155,2,1,80,108,55,80,16,28,12,15,17,71,108,4,7,65,100,47,65,15,35,5,9,17,62,100
2009-02-16 00:00:00.000,Buenos Aires Argentina ATP World Tour 250,CLAY,2,Juan Monaco,Sergio Roitman,Juan Monaco,6-0; 6-0,R32,59,1,2,12,36,10,12,17,24,4,4,6,27,36,0,2,19,42,6,19,8,23,4,10,6,14,42
2009-02-16 00:00:00.000,Buenos Aires Argentina ATP World Tour 250,CLAY,2,Martin Vassallo Arguello,Albert Montanes,Martin Vassallo Arguello,6-2; 6-3,R32,74,0,3,25,54,18,25,21,29,0,0,9,39,54,1,0,36,50,23,36,6,14,2,5,8,29,50
2009-02-16 00:00:00.000,Buenos Aires Argentina ATP World Tour 250,CLAY,2,Pablo Cuevas,Eduardo Schwank,Pablo Cuevas,6-3; 6-7(4); 6-0,R32,152,8,4,49,81,39,49,20,32,2,4,14,59,81,2,4,57,94,32,57,18,37,6,12,13,50,94
2009-02-16 00:00:00.000,Buenos Aires Argentina ATP World Tour 250,CLAY,2,Franco Ferreiro,Ivan Navarro,Franco Ferreiro,1-6; 6-4; 6-2,R32,126,1,8,56,94,39,56,16,38,5,8,13,55,94,4,2,33,65,23,33,19,32,0,3,12,42,65
2009-02-16 00:00:00.000,Buenos Aires Argentina ATP World Tour 250,CLAY,2,Juan Ignacio Chela,Alberto Martin,Juan Ignacio Chela,6-3; 6-2,R32,69,0,2,38,57,27,38,12,19,3,4,9,39,57,1,1,25,41,13,25,6,16,4,8,8,19,41
2009-02-16 00:00:00.000,Buenos Aires Argentina ATP World Tour 250,CLAY,2,Tommy Robredo,Potito Starace,Tommy Robredo,5-7; 6-3; 6-3,R32,112,6,1,60,81,47,60,14,21,2,3,15,61,81,1,3,60,87,41,60,16,27,2,5,15,57,87
2009-02-16 00:00:00.000,Buenos Aires Argentina ATP World Tour 250,CLAY,2,Jose Acasuso,Daniel Munoz-De La Nava,Jose Acasuso,6-2; 7-6(4),R32,110,5,3,39,68,24,39,17,29,2,5,10,41,68,1,2,33,61,23,33,11,28,2,7,10,34,61
2009-02-16 00:00:00.000,Buenos Aires Argentina ATP World Tour 250,CLAY,2,Fabio Fognini,Pablo Andujar,Fabio Fognini,6-3; 6-2,R32,77,4,6,34,58,27,34,10,24,8,9,8,37,58,1,1,36,50,19,36,6,14,0,5,9,25,50
2009-02-16 00:00:00.000,Buenos Aires Argentina ATP World Tour 250,CLAY,2,Diego Junqueira,Nicolas Massu,Diego Junqueira,3-6; 6-4; 6-4,R32,165,3,3,56,88,34,56,20,32,2,6,15,54,88,5,6,63,105,39,63,19,42,9,13,14,58,105
2009-02-16 00:00:00.000,Buenos Aires Argentina ATP World Tour 250,CLAY,2,Oscar Hernandez,Nicolas Almagro,Oscar Hernandez,6-2; 1-6; 6-3,R32,112,2,2,57,79,38,57,13,22,3,5,12,51,79,2,3,49,74,36,49,11,25,2,5,12,47,74
2009-02-16 00:00:00.000,Buenos Aires Argentina ATP World Tour 250,CLAY,2,David Nalbandian,Daniel Gimeno-Traver,David Nalbandian,7-5; 6-2,R16,84,2,4,29,65,24,29,19,36,1,2,10,43,65,2,3,47,63,29,47,5,16,4,8,10,34,63
2009-02-16 00:00:00.000,Buenos Aires Argentina ATP World Tour 250,CLAY,2,Juan Carlos Ferrero,Marcel Granollers,Juan Carlos Ferrero,6-7(7); 6-0; 6-3,R16,147,1,1,65,91,41,65,17,26,1,3,14,58,91,3,2,43,84,28,43,16,41,5,11,13,44,84
2009-02-16 00:00:00.000,Buenos Aires Argentina ATP World Tour 250,CLAY,2,Maximo Gonzalez,Brian Dabul,Maximo Gonzalez,6-3; 6-1,R16,65,2,2,21,39,19,21,13,18,0,0,8,32,39,1,3,36,52,20,36,8,16,5,9,8,28,52
2009-02-16 00:00:00.000,Buenos Aires Argentina ATP World Tour 250,CLAY,2,Juan Monaco,Martin Vassallo Arguello,Juan Monaco,6-4; 2-6; 6-2,R16,134,1,4,39,67,29,39,16,28,0,3,13,45,67,2,3,53,93,33,53,20,40,10,14,13,53,93
2009-02-16 00:00:00.000,Buenos Aires Argentina ATP World Tour 250,CLAY,2,Franco Ferreiro,Pablo Cuevas,Franco Ferreiro,6-2; 6-4,R16,84,0,4,40,67,28,40,17,27,6,6,9,45,67,4,3,36,54,25,36,6,18,2,5,9,31,54
2009-02-16 00:00:00.000,Buenos Aires Argentina ATP World Tour 250,CLAY,2,Tommy Robredo,Juan Ignacio Chela,Tommy Robredo,6-2; 3-6; 6-4,R16,121,3,3,40,74,27,40,19,34,6,10,13,46,74,0,4,61,93,39,61,9,32,10,16,14,48,93
2009-02-16 00:00:00.000,Buenos Aires Argentina ATP World Tour 250,CLAY,2,Jose Acasuso,Fabio Fognini,Jose Acasuso,6-4; 6-3,R16,108,2,2,34,64,23,34,21,30,2,2,10,44,64,4,2,46,75,33,46,11,29,5,7,9,44,75
2009-02-16 00:00:00.000,Buenos Aires Argentina ATP World Tour 250,CLAY,2,Oscar Hernandez,Diego Junqueira,Oscar Hernandez,3-6; 7-6(5); 6-0,R16,139,1,2,70,96,45,70,8,26,5,10,14,53,96,1,4,60,84,31,60,13,24,7,13,13,44,84
2009-02-16 00:00:00.000,Buenos Aires Argentina ATP World Tour 250,CLAY,2,David Nalbandian,Juan Carlos Ferrero,David Nalbandian,6-3; 3-0 RET,Q,57,2,0,20,39,14,20,11,19,2,3,6,25,39,0,0,25,37,12,25,4,12,6,10,6,16,37
2009-02-16 00:00:00.000,Buenos Aires Argentina ATP World Tour 250,CLAY,2,Juan Monaco,Maximo Gonzalez,Juan Monaco,6-2; 6-3,Q,77,1,4,41,57,27,41,7,16,2,4,9,34,57,0,1,30,50,17,30,5,20,2,7,8,22,50
2009-02-16 00:00:00.000,Buenos Aires Argentina ATP World Tour 250,CLAY,2,Tommy Robredo,Franco Ferreiro,Tommy Robredo,6-4; 7-6(4),Q,111,0,2,53,79,33,53,14,26,5,8,11,47,79,1,3,55,82,36,55,10,27,4,8,11,46,82
2009-02-16 00:00:00.000,Buenos Aires Argentina ATP World Tour 250,CLAY,2,Jose Acasuso,Oscar Hernandez,Jose Acasuso,6-1; 6-2,Q,73,2,0,18,36,17,18,12,18,0,0,7,29,36,0,3,35,52,19,35,5,17,5,10,8,24,52
2009-02-16 00:00:00.000,Buenos Aires Argentina ATP World Tour 250,CLAY,2,Juan Monaco,David Nalbandian,Juan Monaco,2-6; 7-5; 7-6(2),S,161,3,2,81,107,51,81,13,26,3,8,16,64,107,1,4,60,104,39,60,26,44,6,10,16,65,104
2009-02-16 00:00:00.000,Buenos Aires Argentina ATP World Tour 250,CLAY,2,Tommy Robredo,Jose Acasuso,Tommy Robredo,6-4; 7-6(3),S,122,2,1,80,98,53,80,10,18,9,10,11,63,98,3,1,43,69,34,43,11,26,3,5,11,45,69
2009-02-16 00:00:00.000,Buenos Aires Argentina ATP World Tour 250,CLAY,2,Tommy Robredo,Juan Monaco,Tommy Robredo,7-5; 2-6; 7-6(5),F,165,1,3,76,101,43,76,13,25,3,8,16,56,101,0,2,91,121,56,91,12,30,8,12,16,68,121
2009-02-16 00:00:00.000,Marseille France ATP World Tour 250,HARD,2,Novak Djokovic,Jeremy Chardy,Novak Djokovic,7-6(4); 6-4,R32,87,11,3,47,68,42,47,9,21,1,1,11,51,68,13,3,43,67,34,43,14,24,3,4,11,48,67
2009-02-16 00:00:00.000,Marseille France ATP World Tour 250,HARD,2,Jan Hernych,Kristof Vliegen,Jan Hernych,6-3; 3-6; 6-4,R32,122,2,1,57,88,47,57,15,31,9,10,14,62,88,10,3,49,89,36,49,24,40,3,5,14,60,89
2009-02-16 00:00:00.000,Marseille France ATP World Tour 250,HARD,2,Mischa Zverev,Illya Marchenko,Mischa Zverev,6-7(5); 6-3; 6-4,R32,133,7,1,69,98,51,69,17,29,6,7,15,68,98,3,7,54,100,43,54,19,46,4,8,16,62,100
2009-02-16 00:00:00.000,Marseille France ATP World Tour 250,HARD,2,Arnaud Clement,Marat Safin,Arnaud Clement,4-6; 6-3; 6-2,R32,115,3,3,42,73,36,42,17,31,1,3,14,53,73,18,0,41,80,30,41,16,39,5,9,13,46,80
2009-02-16 00:00:00.000,Marseille France ATP World Tour 250,HARD,2,Jo-Wilfried Tsonga,Andrey Golubev,Jo-Wilfried Tsonga,7-6(5); 6-2,R32,80,7,3,37,62,26,37,18,25,1,2,10,44,62,7,3,35,64,28,35,11,29,5,8,10,39,64
2009-02-16 00:00:00.000,Marseille France ATP World Tour 250,HARD,2,Simone Bolelli,Richard Bloomfield,Simone Bolelli,7-6(5); 7-6(1),R32,101,7,1,56,77,47,56,13,21,1,1,12,60,77,14,1,43,73,38,43,17,30,0,0,12,55,73
2009-02-16 00:00:00.000,Marseille France ATP World Tour 250,HARD,2,Dmitry Tursunov,Teymuraz Gabashvili,Dmitry Tursunov,3-6; 6-2; 6-2,R32,101,11,1,46,70,32,46,14,24,0,3,13,46,70,4,5,35,70,20,35,17,35,0,5,12,37,70
2009-02-16 00:00:00.000,Marseille France ATP World Tour 250,HARD,2,Feliciano Lopez,Ivan Ljubicic,Feliciano Lopez,3-6; 6-4; 7-5,R32,131,13,2,51,86,35,51,22,35,3,5,15,57,86,12,1,60,108,40,60,26,48,6,9,16,66,108
2009-02-16 00:00:00.000,Marseille France ATP World Tour 250,HARD,2,Mikhail Youzhny,Tomas Berdych,Mikhail Youzhny,6-4; 6-7(2); 6-1,R32,142,10,3,43,97,34,43,34,54,1,1,15,68,97,7,5,52,90,43,52,17,38,3,6,14,60,90
2009-02-16 00:00:00.000,Marseille France ATP World Tour 250,HARD,2,Andreas Seppi,Jerzy Janowicz,Andreas Seppi,7-6(5); 3-6; 7-6(3),R32,140,2,1,61,96,46,61,23,35,5,7,16,69,96,14,2,73,115,55,73,23,42,8,9,17,78,115
2009-02-16 00:00:00.000,Marseille France ATP World Tour 250,HARD,2,Michael Llodra,Rik De Voest,Michael Llodra,7-6(2); 6-1,R32,78,11,0,44,58,37,44,8,14,0,0,10,45,58,3,3,53,72,32,53,11,19,10,12,9,43,72
2009-02-16 00:00:00.000,Marseille France ATP World Tour 250,HARD,2,Paul-Henri Mathieu,Gael Monfils,Paul-Henri Mathieu,4-6; 6-4; 7-5,R32,130,4,1,68,112,44,68,29,44,10,11,16,73,112,26,6,47,89,43,47,20,42,1,3,16,63,89
2009-02-16 00:00:00.000,Marseille France ATP World Tour 250,HARD,2,George Bastl,Marc Gicquel,George Bastl,6-4; 6-3,R32,67,8,4,36,67,26,36,15,31,1,3,10,41,67,2,3,33,69,22,33,15,36,1,5,9,37,69
2009-02-16 00:00:00.000,Marseille France ATP World Tour 250,HARD,2,Julien Benneteau,Fabrice Santoro,Julien Benneteau,4-6; 6-4; 6-2,R32,135,11,5,41,78,33,41,23,37,4,6,14,56,78,4,1,53,107,34,53,27,54,7,11,14,61,107
2009-02-16 00:00:00.000,Marseille France ATP World Tour 250,HARD,2,Rainer Schuettler,Laurent Recouderc,Rainer Schuettler,6-1; 6-4,R32,67,8,3,32,56,26,32,13,24,2,2,9,39,56,1,1,17,44,12,17,11,27,1,4,8,23,44
2009-02-16 00:00:00.000,Marseille France ATP World Tour 250,HARD,2,Gilles Simon,Grigor Dimitrov,Gilles Simon,4-6; 6-3; 7-5,R32,129,7,1,43,93,35,43,28,50,7,10,16,63,93,3,2,57,99,39,57,20,42,6,10,15,59,99
2009-02-16 00:00:00.000,Marseille France ATP World Tour 250,HARD,2,Novak Djokovic,Jan Hernych,Novak Djokovic,7-5; 6-4,R16,93,5,1,47,70,31,47,13,23,5,7,11,44,70,2,4,46,72,30,46,10,26,3,7,11,40,72
2009-02-16 00:00:00.000,Marseille France ATP World Tour 250,HARD,2,Mischa Zverev,Arnaud Clement,Mischa Zverev,6-4; 5-7; 6-2,R16,144,15,4,63,94,45,63,17,31,7,9,15,62,94,4,2,66,102,45,66,15,36,6,10,15,60,102
2009-02-16 00:00:00.000,Marseille France ATP World Tour 250,HARD,2,Jo-Wilfried Tsonga,Simone Bolelli,Jo-Wilfried Tsonga,6-3; 6-2,R16,60,10,1,31,44,27,31,9,13,0,0,9,36,44,2,1,28,49,18,28,9,21,3,6,8,27,49
2009-02-16 00:00:00.000,Marseille France ATP World Tour 250,HARD,2,Feliciano Lopez,Dmitry Tursunov,Feliciano Lopez,7-6(4); 7-6(1),R16,101,18,3,48,80,42,48,19,32,2,2,12,61,80,8,1,45,74,35,45,21,29,2,2,12,56,74
2009-02-16 00:00:00.000,Marseille France ATP World Tour 250,HARD,2,Mikhail Youzhny,Andreas Seppi,Mikhail Youzhny,7-6(2); 6-3,R16,104,4,3,47,74,33,47,14,27,4,6,10,47,74,6,1,42,78,27,42,15,36,7,11,11,42,78
2009-02-16 00:00:00.000,Marseille France ATP World Tour 250,HARD,2,Michael Llodra,Paul-Henri Mathieu,Michael Llodra,6-3; 7-6(1),R16,82,19,3,37,57,29,37,14,20,0,1,11,43,57,4,5,42,69,28,42,11,27,1,3,10,39,69
2009-02-16 00:00:00.000,Marseille France ATP World Tour 250,HARD,2,Julien Benneteau,George Bastl,Julien Benneteau,6-1; 2-6; 6-1,R16,100,12,5,42,78,31,42,17,36,9,11,11,48,78,3,5,30,59,20,30,10,29,2,7,11,30,59
2009-02-16 00:00:00.000,Marseille France ATP World Tour 250,HARD,2,Gilles Simon,Rainer Schuettler,Gilles Simon,6-4; 4-6; 6-2,R16,120,8,2,42,79,31,42,20,37,4,8,14,51,79,4,4,51,94,32,51,18,43,10,16,14,50,94
2009-02-16 00:00:00.000,Marseille France ATP World Tour 250,HARD,2,Novak Djokovic,Mischa Zverev,Novak Djokovic,6-3; 6-3,Q,69,6,1,32,52,24,32,14,20,0,0,9,38,52,3,2,35,60,21,35,12,25,1,4,9,33,60
2009-02-16 00:00:00.000,Marseille France ATP World Tour 250,HARD,2,Jo-Wilfried Tsonga,Feliciano Lopez,Jo-Wilfried Tsonga,6-2; 6-7(1); 6-4,Q,105,18,0,58,79,47,58,15,21,0,0,15,62,79,11,1,72,99,54,72,10,27,5,8,15,64,99
2009-02-16 00:00:00.000,Marseille France ATP World Tour 250,HARD,2,Michael Llodra,Mikhail Youzhny,Michael Llodra,7-6(4); 7-6(3),Q,116,12,5,47,87,40,47,20,40,8,9,12,60,87,4,1,43,77,38,43,14,34,0,1,12,52,77
2009-02-16 00:00:00.000,Marseille France ATP World Tour 250,HARD,2,Gilles Simon,Julien Benneteau,Gilles Simon,6-2; 6-4,Q,80,4,1,28,58,25,28,17,30,3,3,9,42,58,6,5,36,64,25,36,9,28,7,10,9,34,64
2009-02-16 00:00:00.000,Marseille France ATP World Tour 250,HARD,2,Jo-Wilfried Tsonga,Novak Djokovic,Jo-Wilfried Tsonga,6-4; 7-6(1),S,86,9,1,47,67,38,47,12,20,5,5,11,50,67,8,0,49,67,35,49,11,18,2,3,11,46,67
2009-02-16 00:00:00.000,Marseille France ATP World Tour 250,HARD,2,Michael Llodra,Gilles Simon,Michael Llodra,7-6(5); 6-2,S,77,12,2,46,66,41,46,10,20,2,2,10,51,66,6,3,30,58,20,30,20,28,0,2,10,40,58
2009-02-16 00:00:00.000,Marseille France ATP World Tour 250,HARD,2,Jo-Wilfried Tsonga,Michael Llodra,Jo-Wilfried Tsonga,7-5; 7-6(3),F,104,11,0,46,69,40,46,11,23,1,2,12,51,69,7,4,46,80,34,46,17,34,4,6,12,51,80
2009-02-16 00:00:00.000,Memphis TN; U.S.A. ATP World Tour 500,HARD,2,Andy Roddick,Steve Darcis,Andy Roddick,7-6(1); 6-2,R32,67,20,0,39,51,36,39,8,12,0,0,10,44,51,7,1,34,64,25,34,15,30,4,6,10,40,64
2009-02-16 00:00:00.000,Memphis TN; U.S.A. ATP World Tour 500,HARD,2,Robby Ginepri,Simon Greul,Robby Ginepri,6-4; 6-4,R32,81,6,3,43,70,33,43,12,27,8,9,10,45,70,5,5,37,67,25,37,11,30,3,6,10,36,67
2009-02-16 00:00:00.000,Memphis TN; U.S.A. ATP World Tour 500,HARD,2,Marcos Baghdatis,Kei Nishikori,Marcos Baghdatis,7-5; 6-3,R32,83,7,1,27,57,22,27,15,30,4,7,11,37,57,1,3,40,65,22,40,11,25,3,8,10,33,65
2009-02-16 00:00:00.000,Memphis TN; U.S.A. ATP World Tour 500,HARD,2,Sam Querrey,Tommy Haas,Sam Querrey,7-6(4); 6-4,R32,79,11,6,33,58,31,33,13,25,2,4,11,44,58,8,5,50,79,32,50,15,29,5,8,11,47,79
2009-02-16 00:00:00.000,Memphis TN; U.S.A. ATP World Tour 500,HARD,2,Lleyton Hewitt,James Blake,Lleyton Hewitt,3-6; 6-1; 6-4,R32,126,7,3,46,104,37,46,31,58,10,11,13,68,104,9,4,51,87,36,51,17,36,6,9,13,53,87
2009-02-16 00:00:00.000,Memphis TN; U.S.A. ATP World Tour 500,HARD,2,Chris Guccione,Vincent Spadea,Chris Guccione,7-6(1); 7-6(5),R32,78,19,4,51,80,49,51,12,29,3,3,12,61,80,10,2,38,71,31,38,24,33,1,1,12,55,71
2009-02-16 00:00:00.000,Memphis TN; U.S.A. ATP World Tour 500,HARD,2,Christophe Rochus,Donald Young,Christophe Rochus,6-4; 6-3,R32,65,4,3,33,56,25,33,14,23,1,2,10,39,56,4,3,34,59,23,34,9,25,4,7,9,32,59
2009-02-16 00:00:00.000,Memphis TN; U.S.A. ATP World Tour 500,HARD,2,Mardy Fish,Yen-Hsun Lu,Mardy Fish,6-1; 7-5,R32,74,8,1,29,54,26,29,13,25,0,1,10,39,54,2,4,34,52,19,34,9,18,4,8,9,28,52
2009-02-16 00:00:00.000,Memphis TN; U.S.A. ATP World Tour 500,HARD,2,Igor Kunitsyn,Igor Andreev,Igor Kunitsyn,1-6; 6-4; 6-3,R32,105,4,1,50,83,37,50,17,33,3,5,13,54,83,10,2,53,81,40,53,12,28,3,5,13,52,81
2009-02-16 00:00:00.000,Memphis TN; U.S.A. ATP World Tour 500,HARD,2,Philipp Petzschner,Jarkko Nieminen,Philipp Petzschner,6-3; 6-4,R32,64,9,3,37,66,28,37,17,29,5,5,10,45,66,2,0,33,51,26,33,9,18,6,8,9,35,51
2009-02-16 00:00:00.000,Memphis TN; U.S.A. ATP World Tour 500,HARD,2,Dudi Sela,Bobby Reynolds,Dudi Sela,7-6(4); 6-2,R32,97,3,5,43,82,27,43,18,39,2,5,10,45,82,6,6,35,70,23,35,13,35,6,11,10,36,70
2009-02-16 00:00:00.000,Memphis TN; U.S.A. ATP World Tour 500,HARD,2,Florent Serra,Robin Soderling,Florent Serra,6-4; 6-7(1); 6-2,R32,107,12,1,63,89,50,63,13,26,2,3,15,63,89,20,4,63,98,49,63,14,35,6,10,15,63,98
2009-02-16 00:00:00.000,Memphis TN; U.S.A. ATP World Tour 500,HARD,2,Radek Stepanek,Kevin Kim,Radek Stepanek,6-4; 6-2,R32,62,2,5,34,49,25,34,6,15,2,4,9,31,49,6,3,38,64,22,38,8,26,7,12,9,30,64
2009-02-16 00:00:00.000,Memphis TN; U.S.A. ATP World Tour 500,HARD,2,Stefan Koubek,Guillermo Garcia-Lopez,Stefan Koubek,6-2; 6-2,R32,66,0,3,25,49,17,25,11,24,0,2,8,28,49,2,8,24,51,13,24,6,27,2,8,8,19,51
2009-02-16 00:00:00.000,Memphis TN; U.S.A. ATP World Tour 500,HARD,2,Ernests Gulbis,Taylor Dent,Ernests Gulbis,6-4; 3-6; 6-2,R32,95,11,5,50,82,37,50,12,32,7,11,13,49,82,7,7,44,74,29,44,12,30,3,9,14,41,74
2009-02-16 00:00:00.000,Memphis TN; U.S.A. ATP World Tour 500,HARD,2,Juan Martin Del Potro,Guillermo Canas,Juan Martin Del Potro,6-3; 7-6(5),R32,101,11,2,52,71,36,52,16,19,1,1,11,52,71,9,2,34,72,25,34,20,38,3,4,10,45,72
2009-02-16 00:00:00.000,Memphis TN; U.S.A. ATP World Tour 500,HARD,2,Andy Roddick,Robby Ginepri,Andy Roddick,6-2; 6-3,R16,62,11,0,35,44,27,35,7,9,0,1,9,34,44,4,1,35,57,21,35,7,22,8,12,8,28,57
2009-02-16 00:00:00.000,Memphis TN; U.S.A. ATP World Tour 500,HARD,2,Sam Querrey,Marcos Baghdatis,Sam Querrey,6-1; 6-2,R16,52,8,2,28,47,24,28,11,19,2,2,8,35,47,5,2,22,45,15,22,7,23,2,6,7,22,45
2009-02-16 00:00:00.000,Memphis TN; U.S.A. ATP World Tour 500,HARD,2,Lleyton Hewitt,Chris Guccione,Lleyton Hewitt,6-2; 7-6(4),R16,64,10,0,34,54,30,34,16,20,0,0,10,46,54,12,2,38,58,30,38,8,20,2,4,10,38,58
2009-02-16 00:00:00.000,Memphis TN; U.S.A. ATP World Tour 500,HARD,2,Christophe Rochus,Mardy Fish,Christophe Rochus,6-2; 6-4,R16,64,4,3,36,51,27,36,8,15,3,4,9,35,51,14,2,26,58,19,26,14,32,9,13,9,33,58
2009-02-16 00:00:00.000,Memphis TN; U.S.A. ATP World Tour 500,HARD,2,Igor Kunitsyn,Philipp Petzschner,Igor Kunitsyn,3-6; 6-4; 6-4,R16,123,3,1,44,80,31,44,21,36,5,8,14,52,80,7,4,58,108,42,58,20,50,8,12,15,62,108
2009-02-16 00:00:00.000,Memphis TN; U.S.A. ATP World Tour 500,HARD,2,Dudi Sela,Florent Serra,Dudi Sela,7-6(4); 7-6(4),R16,103,4,3,54,92,36,54,21,38,5,8,12,57,92,3,2,51,88,34,51,19,37,2,5,12,53,88
2009-02-16 00:00:00.000,Memphis TN; U.S.A. ATP World Tour 500,HARD,2,Radek Stepanek,Stefan Koubek,Radek Stepanek,6-2; 6-4,R16,65,7,4,31,53,27,31,10,22,5,6,9,37,53,0,2,29,51,17,29,11,22,2,6,9,28,51
2009-02-16 00:00:00.000,Memphis TN; U.S.A. ATP World Tour 500,HARD,2,Juan Martin Del Potro,Ernests Gulbis,Juan Martin Del Potro,6-3; 6-4,R16,72,5,1,26,46,18,26,13,20,1,3,9,31,46,3,4,31,58,18,31,12,27,3,8,10,30,58
2009-02-16 00:00:00.000,Memphis TN; U.S.A. ATP World Tour 500,HARD,2,Andy Roddick,Sam Querrey,Andy Roddick,6-4; 3-6; 6-3,Q,103,11,1,64,82,49,64,9,18,1,2,14,58,82,15,4,48,84,36,48,20,36,4,6,14,56,84
2009-02-16 00:00:00.000,Memphis TN; U.S.A. ATP World Tour 500,HARD,2,Lleyton Hewitt,Christophe Rochus,Lleyton Hewitt,6-2; 6-3,Q,75,6,1,25,45,20,25,12,20,2,3,8,32,45,3,5,42,71,24,42,12,29,3,8,9,36,71
2009-02-16 00:00:00.000,Memphis TN; U.S.A. ATP World Tour 500,HARD,2,Dudi Sela,Igor Kunitsyn,Dudi Sela,4-6; 6-4; 6-2,Q,123,2,0,45,88,31,45,25,43,6,9,14,56,88,6,2,44,83,28,44,20,39,8,13,14,48,83
2009-02-16 00:00:00.000,Memphis TN; U.S.A. ATP World Tour 500,HARD,2,Radek Stepanek,Juan Martin Del Potro,Radek Stepanek,7-6(7); 6-4,Q,128,11,6,56,90,44,56,14,34,5,6,11,58,90,11,3,58,86,41,58,12,28,5,7,11,53,86
2009-02-16 00:00:00.000,Memphis TN; U.S.A. ATP World Tour 500,HARD,2,Andy Roddick,Lleyton Hewitt,Andy Roddick,2-6; 7-6(4); 6-4,S,131,16,3,76,103,57,76,13,27,5,7,15,70,103,14,2,53,95,44,53,23,42,8,9,15,67,95
2009-02-16 00:00:00.000,Memphis TN; U.S.A. ATP World Tour 500,HARD,2,Radek Stepanek,Dudi Sela,Radek Stepanek,6-3; 6-1,S,57,8,0,26,40,23,26,9,14,0,0,8,32,40,2,0,27,44,15,27,8,17,3,7,8,23,44
2009-02-16 00:00:00.000,Memphis TN; U.S.A. ATP World Tour 500,HARD,2,Andy Roddick,Radek Stepanek,Andy Roddick,7-5; 7-5,F,104,8,1,53,78,37,53,13,25,3,4,12,50,78,7,3,38,67,28,38,15,29,1,4,12,43,67
2009-02-23 00:00:00.000,Acapulco Mexico ATP World Tour 500,CLAY,2,Daniel Koellerer,David Nalbandian,Daniel Koellerer,1-6; 6-3; 6-4,R32,140,2,3,52,86,33,52,16,34,8,13,13,49,86,3,5,50,88,30,50,20,38,4,9,13,50,88
2009-02-23 00:00:00.000,Acapulco Mexico ATP World Tour 500,CLAY,2,Alberto Martin,Marcos Daniel,Alberto Martin,6-4; 7-5,R32,101,2,3,45,73,36,45,12,28,7,8,11,48,73,8,7,41,66,30,41,10,25,1,4,11,40,66
2009-02-23 00:00:00.000,Acapulco Mexico ATP World Tour 500,CLAY,2,Martin Vassallo Arguello,Ivan Navarro,Martin Vassallo Arguello,6-3; 5-7; 7-6(3),R32,172,5,2,71,104,56,71,17,33,4,6,17,73,104,8,7,56,111,42,56,28,55,10,12,16,70,111
2009-02-23 00:00:00.000,Acapulco Mexico ATP World Tour 500,CLAY,2,Marcel Granollers,Fabio Fognini,Marcel Granollers,7-6(3); 7-5,R32,143,3,5,51,94,35,51,22,43,4,7,12,57,94,3,3,48,89,27,48,21,41,6,10,12,48,89
2009-02-23 00:00:00.000,Acapulco Mexico ATP World Tour 500,CLAY,2,Nicolas Almagro,Santiago Gonzalez,Nicolas Almagro,6-4; 6-2,R32,63,10,0,27,46,23,27,14,19,0,0,9,37,46,3,2,35,57,24,35,7,22,5,8,9,31,57
2009-02-23 00:00:00.000,Acapulco Mexico ATP World Tour 500,CLAY,2,Potito Starace,Oscar Hernandez,Potito Starace,6-4; 6-2,R32,84,1,1,44,57,33,44,7,13,5,6,9,40,57,0,3,39,53,22,39,7,14,2,6,9,29,53
2009-02-23 00:00:00.000,Acapulco Mexico ATP World Tour 500,CLAY,2,Daniel Gimeno-Traver,Nicolas Lapentti,Daniel Gimeno-Traver,6-4; 5-7; 6-3,R32,148,0,4,68,102,43,68,17,34,6,10,16,60,102,2,2,61,97,39,61,18,36,5,10,15,57,97
2009-02-23 00:00:00.000,Acapulco Mexico ATP World Tour 500,CLAY,2,Albert Montanes,Bruno Echagaray,Albert Montanes,6-1; 6-4,R32,83,3,3,32,57,23,32,13,25,2,4,8,36,57,1,1,40,56,19,40,6,16,1,7,9,25,56
2009-02-23 00:00:00.000,Acapulco Mexico ATP World Tour 500,CLAY,2,Jose Acasuso,Brian Dabul,Jose Acasuso,6-3; 7-5,R32,90,10,1,50,72,40,50,9,22,6,7,11,49,72,3,2,30,53,20,30,11,23,2,5,10,31,53
2009-02-23 00:00:00.000,Acapulco Mexico ATP World Tour 500,CLAY,2,Juan Ignacio Chela,Pablo Cuevas,Juan Ignacio Chela,2-6; 6-3; 6-2,R32,127,0,6,57,88,40,57,14,31,6,9,13,54,88,8,2,47,75,32,47,13,28,3,7,12,45,75
2009-02-23 00:00:00.000,Acapulco Mexico ATP World Tour 500,CLAY,2,Kevin Kim,Juan Monaco,Kevin Kim,1-6; 3-0 RET,R32,33,0,0,15,30,10,15,4,15,0,3,5,14,30,0,1,14,27,9,14,5,13,0,2,5,14,27
2009-02-23 00:00:00.000,Acapulco Mexico ATP World Tour 500,CLAY,2,Tommy Robredo,Ruben Ramirez Hidalgo,Tommy Robredo,6-4; 3-6; 6-3,R32,122,8,1,50,83,37,50,15,33,5,8,14,52,83,1,6,45,89,32,45,21,44,9,13,14,53,89
2009-02-23 00:00:00.000,Acapulco Mexico ATP World Tour 500,CLAY,2,Carlos Moya,Pablo Andujar,Carlos Moya,6-4; 6-7(2); 6-2,R32,128,5,5,53,100,38,53,23,47,7,9,15,61,100,3,3,60,79,41,60,8,19,4,9,15,49,79
2009-02-23 00:00:00.000,Acapulco Mexico ATP World Tour 500,CLAY,2,Leonardo Mayer,Diego Junqueira,Leonardo Mayer,7-6(1); 6-3,R32,90,12,2,43,73,35,43,14,30,2,4,11,49,73,0,1,41,60,22,41,10,19,0,3,10,32,60
2009-02-23 00:00:00.000,Acapulco Mexico ATP World Tour 500,CLAY,2,Thomaz Bellucci,Nicolas Devilder,Thomaz Bellucci,3-6; 6-4; 6-4,R32,162,6,3,63,94,41,63,12,31,7,11,14,53,94,4,5,72,109,41,72,21,37,13,18,15,62,109
2009-02-23 00:00:00.000,Acapulco Mexico ATP World Tour 500,CLAY,2,Gael Monfils,Olivier Patience,Gael Monfils,7-6(4); 6-4,R32,103,17,2,32,62,31,32,18,30,2,3,11,49,62,3,1,46,87,34,46,21,41,6,8,11,55,87
2009-02-23 00:00:00.000,Acapulco Mexico ATP World Tour 500,CLAY,2,Daniel Koellerer,Alberto Martin,Daniel Koellerer,6-4; 5-7; 7-6(4),R16,177,3,1,71,102,50,71,16,31,3,7,17,66,102,1,6,58,107,41,58,25,49,8,12,17,66,107
2009-02-23 00:00:00.000,Acapulco Mexico ATP World Tour 500,CLAY,2,Martin Vassallo Arguello,Marcel Granollers,Martin Vassallo Arguello,6-4; 6-3,R16,100,1,1,42,57,32,42,9,15,1,2,10,41,57,2,2,43,69,27,43,10,26,5,8,9,37,69
2009-02-23 00:00:00.000,Acapulco Mexico ATP World Tour 500,CLAY,2,Nicolas Almagro,Potito Starace,Nicolas Almagro,7-6(1); 6-7(5); 6-3,R16,154,18,3,67,108,53,67,26,41,2,3,17,79,108,3,0,82,106,60,82,14,24,3,5,16,74,106
2009-02-23 00:00:00.000,Acapulco Mexico ATP World Tour 500,CLAY,2,Daniel Gimeno-Traver,Albert Montanes,Daniel Gimeno-Traver,7-6(5); 7-6(5),R16,110,2,1,57,82,42,57,13,25,4,6,12,55,82,4,3,56,78,41,56,10,22,3,5,12,51,78
2009-02-23 00:00:00.000,Acapulco Mexico ATP World Tour 500,CLAY,2,Jose Acasuso,Juan Ignacio Chela,Jose Acasuso,7-5; 6-3,R16,117,2,0,43,78,34,43,15,35,6,7,11,49,78,2,4,41,62,27,41,9,21,5,8,10,36,62
2009-02-23 00:00:00.000,Acapulco Mexico ATP World Tour 500,CLAY,2,Tommy Robredo,Kevin Kim,Tommy Robredo,6-2; 6-0,R16,80,2,0,23,32,21,23,7,9,0,0,7,28,32,4,2,30,47,17,30,2,17,2,7,7,19,47
2009-02-23 00:00:00.000,Acapulco Mexico ATP World Tour 500,CLAY,2,Leonardo Mayer,Carlos Moya,Leonardo Mayer,6-4; 7-5,R16,101,3,0,45,67,35,45,14,22,4,4,11,49,67,4,4,36,72,23,36,23,36,4,6,11,46,72
2009-02-23 00:00:00.000,Acapulco Mexico ATP World Tour 500,CLAY,2,Gael Monfils,Thomaz Bellucci,Gael Monfils,7-6(4); 6-7(5); 6-1,R16,144,6,2,62,97,50,62,21,35,2,3,16,71,97,3,2,55,99,38,55,24,44,7,10,15,62,99
2009-02-23 00:00:00.000,Acapulco Mexico ATP World Tour 500,CLAY,2,Martin Vassallo Arguello,Daniel Koellerer,Martin Vassallo Arguello,6-3; 7-6(6),Q,119,7,0,49,71,39,49,10,22,1,2,11,49,71,0,1,50,62,32,50,7,12,2,4,10,39,62
2009-02-23 00:00:00.000,Acapulco Mexico ATP World Tour 500,CLAY,2,Nicolas Almagro,Daniel Gimeno-Traver,Nicolas Almagro,6-2; 7-6(2),Q,74,14,2,38,52,35,38,8,14,0,0,10,43,52,1,2,47,61,34,47,3,14,0,2,10,37,61
2009-02-23 00:00:00.000,Acapulco Mexico ATP World Tour 500,CLAY,2,Jose Acasuso,Tommy Robredo,Jose Acasuso,7-5; 6-2,Q,87,5,1,42,61,33,42,12,19,1,1,10,45,61,2,1,34,52,25,34,9,18,4,7,10,34,52
2009-02-23 00:00:00.000,Acapulco Mexico ATP World Tour 500,CLAY,2,Gael Monfils,Leonardo Mayer,Gael Monfils,6-3; 6-7(4); 4-1 RET,Q,126,8,4,56,90,42,56,22,34,3,3,14,64,90,3,2,47,85,37,47,17,38,9,11,12,54,85
2009-02-23 00:00:00.000,Acapulco Mexico ATP World Tour 500,CLAY,2,Nicolas Almagro,Martin Vassallo Arguello,Nicolas Almagro,6-4; 6-4,S,100,6,4,36,73,25,36,21,37,4,5,10,46,73,1,1,40,59,24,40,12,19,3,6,10,36,59
2009-02-23 00:00:00.000,Acapulco Mexico ATP World Tour 500,CLAY,2,Gael Monfils,Jose Acasuso,Gael Monfils,6-3; 6-4,S,85,11,2,38,59,34,38,11,21,4,4,10,45,59,4,0,36,61,27,36,10,25,4,6,9,37,61
2009-02-23 00:00:00.000,Acapulco Mexico ATP World Tour 500,CLAY,2,Nicolas Almagro,Gael Monfils,Nicolas Almagro,6-4; 6-4,F,77,5,2,29,51,23,29,15,22,0,1,10,38,51,7,2,35,59,27,35,9,24,5,8,10,36,59
2009-02-23 00:00:00.000,Delray Beach FL; U.S.A. ATP World Tour 250,HARD,2,Mardy Fish,Frank Dancevic,Mardy Fish,7-5; 6-3,R32,81,11,1,44,72,35,44,14,28,4,5,11,49,72,2,1,34,65,25,34,15,31,6,9,10,40,65
2009-02-23 00:00:00.000,Delray Beach FL; U.S.A. ATP World Tour 250,HARD,2,Vincent Spadea,Denis Gremelmayr,Vincent Spadea,2-6; 7-5; 6-1,R32,98,8,1,35,80,28,35,21,45,10,15,14,49,80,3,2,38,79,24,38,18,41,6,12,13,42,79
2009-02-23 00:00:00.000,Delray Beach FL; U.S.A. ATP World Tour 250,HARD,2,Mischa Zverev,Taylor Dent,Mischa Zverev,6-4; 6-3,R32,66,3,0,31,55,23,31,12,24,0,2,9,35,55,3,8,47,66,26,47,9,19,4,9,10,35,66
2009-02-23 00:00:00.000,Delray Beach FL; U.S.A. ATP World Tour 250,HARD,2,Florent Serra,Jarkko Nieminen,Florent Serra,6-3; 7-6(5),R32,83,3,1,46,70,29,46,14,24,2,5,11,43,70,3,2,37,71,19,37,17,34,1,5,10,36,71
2009-02-23 00:00:00.000,Delray Beach FL; U.S.A. ATP World Tour 250,HARD,2,Marcos Baghdatis,Ernests Gulbis,Marcos Baghdatis,7-5; 6-2,R32,73,13,1,30,60,25,30,16,30,6,7,10,41,60,5,1,40,66,19,40,17,26,6,10,10,36,66
2009-02-23 00:00:00.000,Delray Beach FL; U.S.A. ATP World Tour 250,HARD,2,Dudi Sela,Philipp Petzschner,Dudi Sela,6-3; 4-1 RET,R32,37,2,1,23,35,18,23,8,12,1,2,7,26,35,2,2,26,38,14,26,3,12,0,4,7,17,38
2009-02-23 00:00:00.000,Delray Beach FL; U.S.A. ATP World Tour 250,HARD,2,Andrey Golubev,Evan King,Andrey Golubev,6-2; 6-4,R32,69,2,2,27,49,22,27,12,22,0,1,9,34,49,0,3,31,63,16,31,18,32,7,11,9,34,63
2009-02-23 00:00:00.000,Delray Beach FL; U.S.A. ATP World Tour 250,HARD,2,Jeremy Chardy,Tommy Haas,Jeremy Chardy,7-6(7); 6-3,R32,89,8,1,44,64,35,44,14,20,4,5,11,49,64,3,4,49,81,33,49,15,32,3,5,10,48,81
2009-02-23 00:00:00.000,Delray Beach FL; U.S.A. ATP World Tour 250,HARD,2,Guillermo Garcia-Lopez,Steve Darcis,Guillermo Garcia-Lopez,6-3; 6-3,R32,77,1,2,31,55,22,31,14,24,3,4,9,36,55,2,4,27,61,17,27,15,34,5,9,9,32,61
2009-02-23 00:00:00.000,Delray Beach FL; U.S.A. ATP World Tour 250,HARD,2,Gilles Muller,Ryan Sweeting,Gilles Muller,7-6(5); 6-2,R32,88,16,4,42,72,35,42,12,30,4,5,10,47,72,6,7,39,67,29,39,9,28,4,7,10,38,67
2009-02-23 00:00:00.000,Delray Beach FL; U.S.A. ATP World Tour 250,HARD,2,Robert Kendrick,Paul Capdeville,Robert Kendrick,4-6; 6-2; 6-1,R32,89,19,0,52,77,38,52,12,25,3,6,13,50,77,1,3,38,69,23,38,10,31,2,8,12,33,69
2009-02-23 00:00:00.000,Delray Beach FL; U.S.A. ATP World Tour 250,HARD,2,Evgeny Korolev,Igor Kunitsyn,Evgeny Korolev,6-4; 7-6(3),R32,93,3,4,40,65,28,40,14,25,2,5,11,42,65,6,4,65,83,40,65,6,18,5,9,11,46,83
2009-02-23 00:00:00.000,Delray Beach FL; U.S.A. ATP World Tour 250,HARD,2,Yen-Hsun Lu,Lleyton Hewitt,Yen-Hsun Lu,7-5; 2-6; 6-2,R32,118,3,4,65,98,47,65,10,33,6,10,14,57,98,8,4,41,75,28,41,18,34,4,9,14,46,75
2009-02-23 00:00:00.000,Delray Beach FL; U.S.A. ATP World Tour 250,HARD,2,Stefan Koubek,Bobby Reynolds,Stefan Koubek,6-4; 6-3,R32,60,7,5,33,59,26,33,13,26,0,1,10,39,59,2,3,29,51,21,29,9,22,0,3,9,30,51
2009-02-23 00:00:00.000,Delray Beach FL; U.S.A. ATP World Tour 250,HARD,2,Christophe Rochus,Roko Karanusic,Christophe Rochus,6-3; 6-4,R32,65,3,4,41,63,29,41,10,22,0,2,10,39,63,7,1,35,54,20,35,8,19,5,9,9,28,54
2009-02-23 00:00:00.000,Delray Beach FL; U.S.A. ATP World Tour 250,HARD,2,Sam Querrey,Guillermo Canas,Sam Querrey,7-6(3); 6-4,R32,99,13,3,37,68,29,37,15,31,1,3,11,44,68,2,5,36,84,24,36,23,48,7,10,11,47,84
2009-02-23 00:00:00.000,Delray Beach FL; U.S.A. ATP World Tour 250,HARD,2,Mardy Fish,Vincent Spadea,Mardy Fish,6-4; 6-1,R16,68,6,3,30,59,22,30,14,29,4,6,9,36,59,3,0,35,48,17,35,6,13,3,8,8,23,48
2009-02-23 00:00:00.000,Delray Beach FL; U.S.A. ATP World Tour 250,HARD,2,Florent Serra,Mischa Zverev,Florent Serra,6-3; 4-6; 6-4,R16,114,3,3,56,82,38,56,9,26,1,7,15,47,82,5,4,54,92,33,54,14,38,10,17,14,47,92
2009-02-23 00:00:00.000,Delray Beach FL; U.S.A. ATP World Tour 250,HARD,2,Marcos Baghdatis,Dudi Sela,Marcos Baghdatis,7-6(7); 6-3,R16,83,4,1,33,66,20,33,22,33,2,5,11,42,66,0,4,42,66,24,42,13,24,0,4,10,37,66
2009-02-23 00:00:00.000,Delray Beach FL; U.S.A. ATP World Tour 250,HARD,2,Jeremy Chardy,Andrey Golubev,Jeremy Chardy,7-6(4); 7-5,R16,101,6,1,44,70,34,44,15,26,0,1,12,49,70,4,2,62,106,41,62,20,44,10,12,12,61,106
2009-02-23 00:00:00.000,Delray Beach FL; U.S.A. ATP World Tour 250,HARD,2,Guillermo Garcia-Lopez,Gilles Muller,Guillermo Garcia-Lopez,5-7; 6-3; 6-3,R16,128,3,7,51,95,42,51,22,44,4,7,15,64,95,13,1,59,89,39,59,13,30,5,10,15,52,89
2009-02-23 00:00:00.000,Delray Beach FL; U.S.A. ATP World Tour 250,HARD,2,Evgeny Korolev,Robert Kendrick,Evgeny Korolev,3-6; 6-3; 7-5,R16,101,3,6,55,96,38,55,20,41,7,11,15,58,96,10,6,45,80,35,45,15,35,2,7,15,50,80
2009-02-23 00:00:00.000,Delray Beach FL; U.S.A. ATP World Tour 250,HARD,2,Stefan Koubek,Yen-Hsun Lu,Stefan Koubek,6-4; 6-3,R16,66,5,3,36,61,31,36,11,25,4,5,10,42,61,1,1,34,56,23,34,11,22,5,8,9,34,56
2009-02-23 00:00:00.000,Delray Beach FL; U.S.A. ATP World Tour 250,HARD,2,Christophe Rochus,Sam Querrey,Christophe Rochus,6-4; 6-1,R16,52,1,0,26,40,19,26,9,14,0,1,8,28,40,7,1,25,51,15,25,12,26,4,9,9,27,51
2009-02-23 00:00:00.000,Delray Beach FL; U.S.A. ATP World Tour 250,HARD,2,Mardy Fish,Florent Serra,Mardy Fish,7-6(2); 7-6(4),Q,89,9,0,41,70,35,41,19,29,0,1,12,54,70,8,2,54,77,39,54,13,23,2,3,12,52,77
2009-02-23 00:00:00.000,Delray Beach FL; U.S.A. ATP World Tour 250,HARD,2,Jeremy Chardy,Marcos Baghdatis,Jeremy Chardy,7-6(7); 7-6(3),Q,109,3,4,52,83,41,52,17,31,4,6,12,58,83,3,3,43,80,35,43,21,37,3,5,12,56,80
2009-02-23 00:00:00.000,Delray Beach FL; U.S.A. ATP World Tour 250,HARD,2,Evgeny Korolev,Guillermo Garcia-Lopez,Evgeny Korolev,6-2; 6-2,Q,55,7,0,22,40,17,22,12,18,0,1,8,29,40,1,4,32,47,16,32,4,15,4,9,8,20,47
2009-02-23 00:00:00.000,Delray Beach FL; U.S.A. ATP World Tour 250,HARD,2,Christophe Rochus,Stefan Koubek,Christophe Rochus,6-3; 7-6(6),Q,91,1,6,49,77,37,49,12,28,5,7,11,49,77,5,3,27,66,21,27,20,39,2,5,10,41,66
2009-02-23 00:00:00.000,Delray Beach FL; U.S.A. ATP World Tour 250,HARD,2,Mardy Fish,Jeremy Chardy,Mardy Fish,6-4; 6-1,S,77,9,1,30,53,24,30,13,23,2,3,9,37,53,2,2,30,59,18,30,10,29,4,8,8,28,59
2009-02-23 00:00:00.000,Delray Beach FL; U.S.A. ATP World Tour 250,HARD,2,Evgeny Korolev,Christophe Rochus,Evgeny Korolev,6-1; 7-5,S,80,7,2,29,53,22,29,11,24,1,3,9,33,53,1,3,48,77,27,48,10,29,8,14,10,37,77
2009-02-23 00:00:00.000,Delray Beach FL; U.S.A. ATP World Tour 250,HARD,2,Mardy Fish,Evgeny Korolev,Mardy Fish,7-5; 6-3,F,93,6,2,43,81,32,43,18,38,5,7,11,50,81,1,1,34,60,21,34,14,26,5,9,10,35,60
2009-02-23 00:00:00.000,Dubai U.A.E. ATP World Tour 500,HARD,2,Novak Djokovic,Flavio Cipolla,Novak Djokovic,6-3; 6-2,R32,79,5,1,44,71,31,44,12,27,4,6,9,43,71,1,3,29,54,14,29,11,25,6,11,8,25,54
2009-02-23 00:00:00.000,Dubai U.A.E. ATP World Tour 500,HARD,2,Jan Hernych,Mikhail Youzhny,Jan Hernych,4-6; 6-1; 6-4,R32,112,3,0,67,83,45,67,9,16,7,9,13,54,83,2,4,68,88,44,68,6,20,4,9,14,50,88
2009-02-23 00:00:00.000,Dubai U.A.E. ATP World Tour 500,HARD,2,Julien Benneteau,Jurgen Melzer,Julien Benneteau,1-6; 6-3; 6-3,R32,101,3,1,52,79,36,52,14,27,6,8,12,50,79,6,6,39,69,29,39,17,30,2,5,13,46,69
2009-02-23 00:00:00.000,Dubai U.A.E. ATP World Tour 500,HARD,2,Marin Cilic,Janko Tipsarevic,Marin Cilic,2-6; 7-6(3); 6-4,R32,141,13,2,63,84,51,63,11,21,3,5,15,62,84,6,2,69,105,51,69,20,36,6,7,15,71,105
2009-02-23 00:00:00.000,Dubai U.A.E. ATP World Tour 500,HARD,2,Gilles Simon,Mohammad Ghareeb,Gilles Simon,5-7; 6-4; 6-4,R32,127,6,2,49,81,40,49,19,32,4,7,16,59,81,9,6,72,117,48,72,19,45,9,13,16,67,117
2009-02-23 00:00:00.000,Dubai U.A.E. ATP World Tour 500,HARD,2,Teymuraz Gabashvili,Laurent Recouderc,Teymuraz Gabashvili,5-7; 7-6(4); 6-3,R32,142,12,3,53,101,47,53,27,48,5,6,17,74,101,11,5,56,111,44,56,30,55,7,8,16,74,111
2009-02-23 00:00:00.000,Dubai U.A.E. ATP World Tour 500,HARD,2,Fabrice Santoro,Victor Hanescu,Fabrice Santoro,6-4; 6-2,R32,66,2,0,28,43,24,28,12,15,0,0,9,36,43,5,1,39,57,27,39,6,18,0,3,9,33,57
2009-02-23 00:00:00.000,Dubai U.A.E. ATP World Tour 500,HARD,2,Marco Chiudinelli,Ivo Karlovic,Marco Chiudinelli,7-6(4); 4-6; 7-6(7),R32,156,3,0,82,116,62,82,19,34,4,5,17,81,116,19,2,65,104,60,65,19,39,4,4,17,79,104
2009-02-23 00:00:00.000,Dubai U.A.E. ATP World Tour 500,HARD,2,Igor Andreev,Rik De Voest,Igor Andreev,6-4; 6-0,R32,61,1,1,30,45,26,30,8,15,1,1,8,34,45,2,0,24,51,15,24,12,27,4,8,8,27,51
2009-02-23 00:00:00.000,Dubai U.A.E. ATP World Tour 500,HARD,2,Dmitry Tursunov,Andreas Seppi,Dmitry Tursunov,6-1; 6-4,R32,77,2,1,37,60,30,37,11,23,4,4,9,41,60,2,3,29,48,21,29,7,19,5,8,8,28,48
2009-02-23 00:00:00.000,Dubai U.A.E. ATP World Tour 500,HARD,2,Philipp Kohlschreiber,Michael Lammer,Philipp Kohlschreiber,6-1; 6-1,R32,62,4,1,29,42,23,29,8,13,2,2,7,31,42,0,2,24,45,11,24,8,21,6,11,7,19,45
2009-02-23 00:00:00.000,Dubai U.A.E. ATP World Tour 500,HARD,2,David Ferrer,Ivan Ljubicic,David Ferrer,3-6; 6-2; 6-1,R32,106,4,2,46,69,35,46,14,23,2,3,12,49,69,8,3,43,80,32,43,14,37,8,12,12,46,80
2009-02-23 00:00:00.000,Dubai U.A.E. ATP World Tour 500,HARD,2,Richard Gasquet,Marat Safin,Richard Gasquet,6-3; 5-7; 6-3,R32,115,10,3,51,85,37,51,26,34,3,4,15,63,85,10,1,46,85,34,46,21,39,5,8,15,55,85
2009-02-23 00:00:00.000,Dubai U.A.E. ATP World Tour 500,HARD,2,Simone Bolelli,Viktor Troicki,Simone Bolelli,6-3; 6-4,R32,79,3,1,32,52,26,32,14,20,0,0,10,40,52,3,4,31,66,25,31,14,35,1,3,9,39,66
2009-02-23 00:00:00.000,Dubai U.A.E. ATP World Tour 500,HARD,2,Arnaud Clement,Rainer Schuettler,Arnaud Clement,1-6; 6-3; 6-3,R32,139,3,2,47,94,33,47,18,47,6,11,13,51,94,4,2,48,79,28,48,15,31,6,11,12,43,79
2009-02-23 00:00:00.000,Dubai U.A.E. ATP World Tour 500,HARD,2,Andy Murray,Sergiy Stakhovsky,Andy Murray,6-7(3); 6-3; 5-3 RET,R32,123,5,4,53,84,42,53,15,31,0,3,15,57,84,1,2,58,84,39,58,9,26,9,14,14,48,84
2009-02-23 00:00:00.000,Dubai U.A.E. ATP World Tour 500,HARD,2,Novak Djokovic,Jan Hernych,Novak Djokovic,6-3; 3-6; 6-4,R16,127,5,3,51,92,38,51,20,41,6,8,14,58,92,2,2,69,95,46,69,15,26,7,10,14,61,95
2009-02-23 00:00:00.000,Dubai U.A.E. ATP World Tour 500,HARD,2,Marin Cilic,Julien Benneteau,Marin Cilic,6-3; 4-6; 7-5,R16,143,9,4,45,84,36,45,25,39,3,4,15,61,84,15,6,79,119,53,79,20,40,7,10,16,73,119
2009-02-23 00:00:00.000,Dubai U.A.E. ATP World Tour 500,HARD,2,Gilles Simon,Teymuraz Gabashvili,Gilles Simon,6-1; 6-2,R16,54,2,1,35,44,28,35,5,9,0,0,8,33,44,1,4,30,45,18,30,3,15,3,7,7,21,45
2009-02-23 00:00:00.000,Dubai U.A.E. ATP World Tour 500,HARD,2,Fabrice Santoro,Marco Chiudinelli,Fabrice Santoro,3-6; 6-1; 7-6(1),R16,148,14,1,54,83,41,54,16,29,4,7,14,57,83,1,4,69,110,38,69,23,41,6,10,14,61,110
2009-02-23 00:00:00.000,Dubai U.A.E. ATP World Tour 500,HARD,2,Igor Andreev,Dmitry Tursunov,Igor Andreev,5-7; 6-4; 6-3,R16,133,13,5,54,85,42,54,15,31,3,5,15,57,85,8,8,62,103,45,62,19,41,7,11,16,64,103
2009-02-23 00:00:00.000,Dubai U.A.E. ATP World Tour 500,HARD,2,David Ferrer,Philipp Kohlschreiber,David Ferrer,6-4; 6-2,R16,77,5,2,42,56,32,42,7,14,3,3,9,39,56,3,4,40,59,24,40,9,19,4,7,9,33,59
2009-02-23 00:00:00.000,Dubai U.A.E. ATP World Tour 500,HARD,2,Richard Gasquet,Simone Bolelli,Richard Gasquet,6-7(4); 6-3; 7-6(5),R16,183,18,1,72,113,56,72,24,41,5,5,16,80,113,12,1,76,121,50,76,31,45,8,10,17,81,121
2009-02-23 00:00:00.000,Dubai U.A.E. ATP World Tour 500,HARD,2,Andy Murray,Arnaud Clement,Andy Murray,6-2; 6-3,R16,84,8,0,38,54,30,38,7,16,3,3,8,37,54,3,1,41,61,24,41,8,20,9,13,9,32,61
2009-02-23 00:00:00.000,Dubai U.A.E. ATP World Tour 500,HARD,2,Novak Djokovic,Marin Cilic,Novak Djokovic,6-3; 6-4,Q,98,7,3,45,71,37,45,12,26,6,6,10,49,71,5,1,40,69,28,40,11,29,5,7,9,39,69
2009-02-23 00:00:00.000,Dubai U.A.E. ATP World Tour 500,HARD,2,Gilles Simon,Fabrice Santoro,Gilles Simon,7-6(3); 6-1,Q,94,1,2,30,67,19,30,24,37,5,7,9,43,67,3,2,39,74,21,39,15,35,5,10,10,36,74
2009-02-23 00:00:00.000,Dubai U.A.E. ATP World Tour 500,HARD,2,David Ferrer,Igor Andreev,David Ferrer,7-5; 6-1,Q,109,0,5,28,52,24,28,9,24,3,5,9,33,52,5,4,46,86,27,46,14,40,10,16,10,41,86
2009-02-23 00:00:00.000,Dubai U.A.E. ATP World Tour 500,HARD,2,Richard Gasquet,Andy Murray,Richard Gasquet,W/O,Q,0,0,0,0,0,0,0,0,0,0,0,0,0,0,0,0,0,0,0,0,0,0,0,0,0,0,0
2009-02-23 00:00:00.000,Dubai U.A.E. ATP World Tour 500,HARD,2,Novak Djokovic,Gilles Simon,Novak Djokovic,3-6; 7-5; 7-5,S,165,12,3,67,109,44,67,25,42,1,3,16,69,109,4,2,63,118,47,63,26,55,9,12,17,73,118
2009-02-23 00:00:00.000,Dubai U.A.E. ATP World Tour 500,HARD,2,David Ferrer,Richard Gasquet,David Ferrer,6-2; 6-2,S,76,2,1,35,61,23,35,16,26,6,6,8,39,61,2,1,25,48,16,25,9,23,5,9,8,25,48
2009-02-23 00:00:00.000,Dubai U.A.E. ATP World Tour 500,HARD,2,Novak Djokovic,David Ferrer,Novak Djokovic,7-5; 6-3,F,97,3,0,45,63,30,45,9,18,1,4,11,39,63,4,3,35,59,18,35,13,24,2,7,10,31,59
2009-03-12 00:00:00.000,ATP World Tour Masters 1000 Indian Wells CA; U.S.A. ATP World Tour Masters 1000,HARD,2,Rafael Nadal,N/A Bye,Rafael Nadal,,R128,0,0,0,0,0,0,0,0,0,0,0,0,0,0,0,0,0,0,0,0,0,0,0,0,0,0,0
2009-03-12 00:00:00.000,ATP World Tour Masters 1000 Indian Wells CA; U.S.A. ATP World Tour Masters 1000,HARD,2,Michael Berrer,Kevin Anderson,Michael Berrer,6-3; 6-3,R128,72,6,7,30,52,25,30,11,22,1,2,9,36,52,4,7,34,57,22,34,7,23,3,7,9,29,57
2009-03-12 00:00:00.000,ATP World Tour Masters 1000 Indian Wells CA; U.S.A. ATP World Tour Masters 1000,HARD,2,Michael Russell,Guillermo Garcia-Lopez,Michael Russell,7-5; 6-2,R128,107,3,0,45,64,24,45,12,19,3,6,10,36,64,2,5,41,64,23,41,6,23,1,7,10,29,64
2009-03-12 00:00:00.000,ATP World Tour Masters 1000 Indian Wells CA; U.S.A. ATP World Tour Masters 1000,HARD,2,Dmitry Tursunov,N/A Bye,Dmitry Tursunov,,R128,0,0,0,0,0,0,0,0,0,0,0,0,0,0,0,0,0,0,0,0,0,0,0,0,0,0,0
2009-03-12 00:00:00.000,ATP World Tour Masters 1000 Indian Wells CA; U.S.A. ATP World Tour Masters 1000,HARD,2,Tomas Berdych,N/A Bye,Tomas Berdych,,R128,0,0,0,0,0,0,0,0,0,0,0,0,0,0,0,0,0,0,0,0,0,0,0,0,0,0,0
2009-03-12 00:00:00.000,ATP World Tour Masters 1000 Indian Wells CA; U.S.A. ATP World Tour Masters 1000,HARD,2,Viktor Troicki,Mikhail Youzhny,Viktor Troicki,7-5; 2-1 RET,R128,73,7,2,39,61,26,39,10,22,10,11,7,36,61,0,2,27,45,17,27,9,18,1,4,8,26,45
2009-03-12 00:00:00.000,ATP World Tour Masters 1000 Indian Wells CA; U.S.A. ATP World Tour Masters 1000,HARD,2,Robert Kendrick,Bjorn Phau,Robert Kendrick,7-5; 6-2,R128,78,13,4,38,69,27,38,12,31,5,8,10,39,69,1,4,27,61,15,27,14,34,7,13,10,29,61
2009-03-12 00:00:00.000,ATP World Tour Masters 1000 Indian Wells CA; U.S.A. ATP World Tour Masters 1000,HARD,2,David Nalbandian,N/A Bye,David Nalbandian,,R128,0,0,0,0,0,0,0,0,0,0,0,0,0,0,0,0,0,0,0,0,0,0,0,0,0,0,0
2009-03-12 00:00:00.000,ATP World Tour Masters 1000 Indian Wells CA; U.S.A. ATP World Tour Masters 1000,HARD,2,Gael Monfils,N/A Bye,Gael Monfils,,R128,0,0,0,0,0,0,0,0,0,0,0,0,0,0,0,0,0,0,0,0,0,0,0,0,0,0,0
2009-03-12 00:00:00.000,ATP World Tour Masters 1000 Indian Wells CA; U.S.A. ATP World Tour Masters 1000,HARD,2,John Isner,Christophe Rochus,John Isner,6-1; 6-4,R128,62,14,2,33,51,23,33,11,18,2,3,8,34,51,4,2,37,60,21,37,8,23,1,6,9,29,60
2009-03-12 00:00:00.000,ATP World Tour Masters 1000 Indian Wells CA; U.S.A. ATP World Tour Masters 1000,HARD,2,Nicolas Massu,Eduardo Schwank,Nicolas Massu,7-6(1); 6-7(5); 6-4,R128,201,2,2,86,128,61,86,24,42,11,12,17,85,128,4,8,80,134,55,80,31,54,11,13,17,86,134
2009-03-12 00:00:00.000,ATP World Tour Masters 1000 Indian Wells CA; U.S.A. ATP World Tour Masters 1000,HARD,2,Marat Safin,N/A Bye,Marat Safin,,R128,0,0,0,0,0,0,0,0,0,0,0,0,0,0,0,0,0,0,0,0,0,0,0,0,0,0,0
2009-03-12 00:00:00.000,ATP World Tour Masters 1000 Indian Wells CA; U.S.A. ATP World Tour Masters 1000,HARD,2,Jurgen Melzer,N/A Bye,Jurgen Melzer,,R128,0,0,0,0,0,0,0,0,0,0,0,0,0,0,0,0,0,0,0,0,0,0,0,0,0,0,0
2009-03-12 00:00:00.000,ATP World Tour Masters 1000 Indian Wells CA; U.S.A. ATP World Tour Masters 1000,HARD,2,Taylor Dent,Diego Junqueira,Taylor Dent,6-1; 7-6(3),R128,67,11,4,35,54,32,35,9,19,1,2,10,41,54,0,2,30,49,20,30,9,19,1,4,9,29,49
2009-03-12 00:00:00.000,ATP World Tour Masters 1000 Indian Wells CA; U.S.A. ATP World Tour Masters 1000,HARD,2,Ryan Sweeting,Wayne Odesnik,Ryan Sweeting,1-6; 6-4; 7-6(5),R128,134,6,12,75,114,52,75,13,39,13,19,15,65,114,7,1,60,104,39,60,23,44,8,12,14,62,104
2009-03-12 00:00:00.000,ATP World Tour Masters 1000 Indian Wells CA; U.S.A. ATP World Tour Masters 1000,HARD,2,Juan Martin Del Potro,N/A Bye,Juan Martin Del Potro,,R128,0,0,0,0,0,0,0,0,0,0,0,0,0,0,0,0,0,0,0,0,0,0,0,0,0,0,0
2009-03-12 00:00:00.000,ATP World Tour Masters 1000 Indian Wells CA; U.S.A. ATP World Tour Masters 1000,HARD,2,Novak Djokovic,N/A Bye,Novak Djokovic,,R128,0,0,0,0,0,0,0,0,0,0,0,0,0,0,0,0,0,0,0,0,0,0,0,0,0,0,0
2009-03-12 00:00:00.000,ATP World Tour Masters 1000 Indian Wells CA; U.S.A. ATP World Tour Masters 1000,HARD,2,Martin Vassallo Arguello,Rik De Voest,Martin Vassallo Arguello,7-5; 7-6(3),R128,105,4,3,48,70,34,48,12,22,2,4,12,46,70,0,2,61,88,37,61,12,27,3,6,12,49,88
2009-03-12 00:00:00.000,ATP World Tour Masters 1000 Indian Wells CA; U.S.A. ATP World Tour Masters 1000,HARD,2,Tommy Haas,Oscar Hernandez,Tommy Haas,6-3; 6-3,R128,71,5,1,24,44,20,24,15,20,0,1,9,35,44,3,2,37,61,23,37,9,24,7,11,9,32,61
2009-03-12 00:00:00.000,ATP World Tour Masters 1000 Indian Wells CA; U.S.A. ATP World Tour Masters 1000,HARD,2,Rainer Schuettler,N/A Bye,Rainer Schuettler,,R128,0,0,0,0,0,0,0,0,0,0,0,0,0,0,0,0,0,0,0,0,0,0,0,0,0,0,0
2009-03-12 00:00:00.000,ATP World Tour Masters 1000 Indian Wells CA; U.S.A. ATP World Tour Masters 1000,HARD,2,Radek Stepanek,N/A Bye,Radek Stepanek,,R128,0,0,0,0,0,0,0,0,0,0,0,0,0,0,0,0,0,0,0,0,0,0,0,0,0,0,0
2009-03-12 00:00:00.000,ATP World Tour Masters 1000 Indian Wells CA; U.S.A. ATP World Tour Masters 1000,HARD,2,Sam Querrey,Guillermo Canas,Sam Querrey,7-6(2); 6-2,R128,81,8,2,37,58,32,37,16,21,3,3,10,48,58,2,2,34,67,25,34,18,33,5,7,10,43,67
2009-03-12 00:00:00.000,ATP World Tour Masters 1000 Indian Wells CA; U.S.A. ATP World Tour Masters 1000,HARD,2,Andreas Seppi,Juan Ignacio Chela,Andreas Seppi,6-2; 4-1 RET,R128,58,2,2,30,43,21,30,5,13,2,3,6,26,43,0,5,21,41,13,21,5,20,3,8,7,18,41
2009-03-12 00:00:00.000,ATP World Tour Masters 1000 Indian Wells CA; U.S.A. ATP World Tour Masters 1000,HARD,2,Stanislas Wawrinka,N/A Bye,Stanislas Wawrinka,,R128,0,0,0,0,0,0,0,0,0,0,0,0,0,0,0,0,0,0,0,0,0,0,0,0,0,0,0
2009-03-12 00:00:00.000,ATP World Tour Masters 1000 Indian Wells CA; U.S.A. ATP World Tour Masters 1000,HARD,2,David Ferrer,N/A Bye,David Ferrer,,R128,0,0,0,0,0,0,0,0,0,0,0,0,0,0,0,0,0,0,0,0,0,0,0,0,0,0,0
2009-03-12 00:00:00.000,ATP World Tour Masters 1000 Indian Wells CA; U.S.A. ATP World Tour Masters 1000,HARD,2,Todd Widom,Ivan Navarro,Todd Widom,6-4; 7-6(4),R128,125,3,2,47,80,34,47,15,33,4,7,11,49,80,3,4,43,75,30,43,13,32,5,9,11,43,75
2009-03-12 00:00:00.000,ATP World Tour Masters 1000 Indian Wells CA; U.S.A. ATP World Tour Masters 1000,HARD,2,Jeremy Chardy,Victor Hanescu,Jeremy Chardy,6-4; 3-6; 6-2,R128,117,8,4,59,104,42,59,24,45,7,8,13,66,104,0,2,52,77,37,52,14,25,3,6,14,51,77
2009-03-12 00:00:00.000,ATP World Tour Masters 1000 Indian Wells CA; U.S.A. ATP World Tour Masters 1000,HARD,2,Mardy Fish,N/A Bye,Mardy Fish,,R128,0,0,0,0,0,0,0,0,0,0,0,0,0,0,0,0,0,0,0,0,0,0,0,0,0,0,0
2009-03-12 00:00:00.000,ATP World Tour Masters 1000 Indian Wells CA; U.S.A. ATP World Tour Masters 1000,HARD,2,Nicolas Kiefer,N/A Bye,Nicolas Kiefer,,R128,0,0,0,0,0,0,0,0,0,0,0,0,0,0,0,0,0,0,0,0,0,0,0,0,0,0,0
2009-03-12 00:00:00.000,ATP World Tour Masters 1000 Indian Wells CA; U.S.A. ATP World Tour Masters 1000,HARD,2,Bobby Reynolds,Fabio Fognini,Bobby Reynolds,4-6; 6-0; 6-2,R128,84,9,3,34,59,29,34,18,25,0,1,12,47,59,5,11,48,82,33,48,11,34,4,9,12,44,82
2009-03-12 00:00:00.000,ATP World Tour Masters 1000 Indian Wells CA; U.S.A. ATP World Tour Masters 1000,HARD,2,Daniel Koellerer,Mischa Zverev,Daniel Koellerer,2-6; 7-5; 6-2,R128,134,2,4,64,93,43,64,14,29,6,9,14,57,93,8,5,53,90,36,53,19,37,8,12,14,55,90
2009-03-12 00:00:00.000,ATP World Tour Masters 1000 Indian Wells CA; U.S.A. ATP World Tour Masters 1000,HARD,2,Andy Roddick,N/A Bye,Andy Roddick,,R128,0,0,0,0,0,0,0,0,0,0,0,0,0,0,0,0,0,0,0,0,0,0,0,0,0,0,0
2009-03-12 00:00:00.000,ATP World Tour Masters 1000 Indian Wells CA; U.S.A. ATP World Tour Masters 1000,HARD,2,Gilles Simon,N/A Bye,Gilles Simon,,R128,0,0,0,0,0,0,0,0,0,0,0,0,0,0,0,0,0,0,0,0,0,0,0,0,0,0,0
2009-03-12 00:00:00.000,ATP World Tour Masters 1000 Indian Wells CA; U.S.A. ATP World Tour Masters 1000,HARD,2,Yen-Hsun Lu,Michael Lammer,Yen-Hsun Lu,7-5; 6-2,R128,87,1,2,43,56,30,43,7,13,3,5,10,37,56,5,4,36,68,20,36,15,32,8,13,10,35,68
2009-03-12 00:00:00.000,ATP World Tour Masters 1000 Indian Wells CA; U.S.A. ATP World Tour Masters 1000,HARD,2,Ivan Ljubicic,Kei Nishikori,Ivan Ljubicic,6-3; 6-3,R128,65,6,1,34,52,29,34,5,18,2,3,9,34,52,0,4,26,48,14,26,11,22,0,4,9,25,48
2009-03-12 00:00:00.000,ATP World Tour Masters 1000 Indian Wells CA; U.S.A. ATP World Tour Masters 1000,HARD,2,Mario Ancic,N/A Bye,Mario Ancic,,R128,0,0,0,0,0,0,0,0,0,0,0,0,0,0,0,0,0,0,0,0,0,0,0,0,0,0,0
2009-03-12 00:00:00.000,ATP World Tour Masters 1000 Indian Wells CA; U.S.A. ATP World Tour Masters 1000,HARD,2,Igor Andreev,N/A Bye,Igor Andreev,,R128,0,0,0,0,0,0,0,0,0,0,0,0,0,0,0,0,0,0,0,0,0,0,0,0,0,0,0
2009-03-12 00:00:00.000,ATP World Tour Masters 1000 Indian Wells CA; U.S.A. ATP World Tour Masters 1000,HARD,2,Ernests Gulbis,Kevin Kim,Ernests Gulbis,6-3; 6-4,R128,69,5,2,40,62,31,40,12,22,1,2,10,43,62,5,3,41,67,29,41,8,26,8,11,9,37,67
2009-03-12 00:00:00.000,ATP World Tour Masters 1000 Indian Wells CA; U.S.A. ATP World Tour Masters 1000,HARD,2,Teymuraz Gabashvili,Jose Acasuso,Teymuraz Gabashvili,6-2; 4-6; 6-3,R128,118,9,6,40,71,34,40,16,31,3,5,13,50,71,8,3,59,104,37,59,18,45,7,12,14,55,104
2009-03-12 00:00:00.000,ATP World Tour Masters 1000 Indian Wells CA; U.S.A. ATP World Tour Masters 1000,HARD,2,Jo-Wilfried Tsonga,N/A Bye,Jo-Wilfried Tsonga,,R128,0,0,0,0,0,0,0,0,0,0,0,0,0,0,0,0,0,0,0,0,0,0,0,0,0,0,0
2009-03-12 00:00:00.000,ATP World Tour Masters 1000 Indian Wells CA; U.S.A. ATP World Tour Masters 1000,HARD,2,Tommy Robredo,N/A Bye,Tommy Robredo,,R128,0,0,0,0,0,0,0,0,0,0,0,0,0,0,0,0,0,0,0,0,0,0,0,0,0,0,0
2009-03-12 00:00:00.000,ATP World Tour Masters 1000 Indian Wells CA; U.S.A. ATP World Tour Masters 1000,HARD,2,Igor Kunitsyn,Vincent Spadea,Igor Kunitsyn,6-3; 6-4,R128,73,2,0,38,59,28,38,13,21,3,4,9,41,59,2,5,24,56,17,24,16,32,1,5,10,33,56
2009-03-12 00:00:00.000,ATP World Tour Masters 1000 Indian Wells CA; U.S.A. ATP World Tour Masters 1000,HARD,2,Steve Darcis,Marcel Granollers,Steve Darcis,5-0 RET,R128,15,1,0,7,13,6,7,6,6,0,0,3,12,13,0,1,4,10,1,4,1,6,1,3,2,2,10
2009-03-12 00:00:00.000,ATP World Tour Masters 1000 Indian Wells CA; U.S.A. ATP World Tour Masters 1000,HARD,2,Marin Cilic,N/A Bye,Marin Cilic,,R128,0,0,0,0,0,0,0,0,0,0,0,0,0,0,0,0,0,0,0,0,0,0,0,0,0,0,0
2009-03-12 00:00:00.000,ATP World Tour Masters 1000 Indian Wells CA; U.S.A. ATP World Tour Masters 1000,HARD,2,Paul-Henri Mathieu,N/A Bye,Paul-Henri Mathieu,,R128,0,0,0,0,0,0,0,0,0,0,0,0,0,0,0,0,0,0,0,0,0,0,0,0,0,0,0
2009-03-12 00:00:00.000,ATP World Tour Masters 1000 Indian Wells CA; U.S.A. ATP World Tour Masters 1000,HARD,2,Potito Starace,Denis Gremelmayr,Potito Starace,7-6(6); 6-1,R128,79,2,4,51,69,38,51,8,18,5,6,9,46,69,4,9,43,78,27,43,14,35,5,9,10,41,78
2009-03-12 00:00:00.000,ATP World Tour Masters 1000 Indian Wells CA; U.S.A. ATP World Tour Masters 1000,HARD,2,Albert Montanes,Florent Serra,Albert Montanes,6-3; 6-0,R128,55,4,2,17,35,15,17,11,18,2,3,7,26,35,2,2,33,59,14,33,11,26,5,11,8,25,59
2009-03-12 00:00:00.000,ATP World Tour Masters 1000 Indian Wells CA; U.S.A. ATP World Tour Masters 1000,HARD,2,Andy Murray,N/A Bye,Andy Murray,,R128,0,0,0,0,0,0,0,0,0,0,0,0,0,0,0,0,0,0,0,0,0,0,0,0,0,0,0
2009-03-12 00:00:00.000,ATP World Tour Masters 1000 Indian Wells CA; U.S.A. ATP World Tour Masters 1000,HARD,2,Olivier Patience,N/A Bye,Olivier Patience,,R128,0,0,0,0,0,0,0,0,0,0,0,0,0,0,0,0,0,0,0,0,0,0,0,0,0,0,0
2009-03-12 00:00:00.000,ATP World Tour Masters 1000 Indian Wells CA; U.S.A. ATP World Tour Masters 1000,HARD,2,Philipp Kohlschreiber,Julien Benneteau,Philipp Kohlschreiber,6-3; 6-2,R128,75,1,2,36,53,22,36,8,17,1,4,9,30,53,1,3,28,56,13,28,10,28,2,8,8,23,56
2009-03-12 00:00:00.000,ATP World Tour Masters 1000 Indian Wells CA; U.S.A. ATP World Tour Masters 1000,HARD,2,Nicolas Lapentti,Santiago Giraldo,Nicolas Lapentti,4-6; 6-1; 7-5,R128,148,9,4,52,97,35,52,27,45,7,10,15,62,97,6,0,55,98,31,55,22,43,10,15,14,53,98
2009-03-12 00:00:00.000,ATP World Tour Masters 1000 Indian Wells CA; U.S.A. ATP World Tour Masters 1000,HARD,2,Robin Soderling,N/A Bye,Robin Soderling,,R128,0,0,0,0,0,0,0,0,0,0,0,0,0,0,0,0,0,0,0,0,0,0,0,0,0,0,0
2009-03-12 00:00:00.000,ATP World Tour Masters 1000 Indian Wells CA; U.S.A. ATP World Tour Masters 1000,HARD,2,Richard Gasquet,N/A Bye,Richard Gasquet,,R128,0,0,0,0,0,0,0,0,0,0,0,0,0,0,0,0,0,0,0,0,0,0,0,0,0,0,0
2009-03-12 00:00:00.000,ATP World Tour Masters 1000 Indian Wells CA; U.S.A. ATP World Tour Masters 1000,HARD,2,Michael Llodra,Feliciano Lopez,Michael Llodra,6-4; 6-3,R128,76,3,1,36,59,25,36,17,23,4,5,10,42,59,3,3,37,59,23,37,10,22,5,8,9,33,59
2009-03-12 00:00:00.000,ATP World Tour Masters 1000 Indian Wells CA; U.S.A. ATP World Tour Masters 1000,HARD,2,Thomaz Bellucci,Janko Tipsarevic,Thomaz Bellucci,5-7; 7-5; 6-2,R128,133,12,2,57,94,40,57,20,37,4,7,16,60,94,1,2,56,92,33,56,21,36,5,10,16,54,92
2009-03-12 00:00:00.000,ATP World Tour Masters 1000 Indian Wells CA; U.S.A. ATP World Tour Masters 1000,HARD,2,Fernando Verdasco,N/A Bye,Fernando Verdasco,,R128,0,0,0,0,0,0,0,0,0,0,0,0,0,0,0,0,0,0,0,0,0,0,0,0,0,0,0
2009-03-12 00:00:00.000,ATP World Tour Masters 1000 Indian Wells CA; U.S.A. ATP World Tour Masters 1000,HARD,2,James Blake,N/A Bye,James Blake,,R128,0,0,0,0,0,0,0,0,0,0,0,0,0,0,0,0,0,0,0,0,0,0,0,0,0,0,0
2009-03-12 00:00:00.000,ATP World Tour Masters 1000 Indian Wells CA; U.S.A. ATP World Tour Masters 1000,HARD,2,Jarkko Nieminen,Nicolas Devilder,Jarkko Nieminen,7-6(6); 6-1,R128,90,3,4,61,89,45,61,13,28,3,3,10,58,89,8,1,41,60,29,41,10,19,3,5,9,39,60
2009-03-12 00:00:00.000,ATP World Tour Masters 1000 Indian Wells CA; U.S.A. ATP World Tour Masters 1000,HARD,2,Lleyton Hewitt,Jan Hernych,Lleyton Hewitt,7-6(3); 6-3,R128,83,2,2,29,57,25,29,21,28,1,1,10,46,57,4,3,49,77,28,49,18,28,6,8,11,46,77
2009-03-12 00:00:00.000,ATP World Tour Masters 1000 Indian Wells CA; U.S.A. ATP World Tour Masters 1000,HARD,2,Fernando Gonzalez,N/A Bye,Fernando Gonzalez,,R128,0,0,0,0,0,0,0,0,0,0,0,0,0,0,0,0,0,0,0,0,0,0,0,0,0,0,0
2009-03-12 00:00:00.000,ATP World Tour Masters 1000 Indian Wells CA; U.S.A. ATP World Tour Masters 1000,HARD,2,Ivo Karlovic,N/A Bye,Ivo Karlovic,,R128,0,0,0,0,0,0,0,0,0,0,0,0,0,0,0,0,0,0,0,0,0,0,0,0,0,0,0
2009-03-12 00:00:00.000,ATP World Tour Masters 1000 Indian Wells CA; U.S.A. ATP World Tour Masters 1000,HARD,2,Sergiy Stakhovsky,Brendan Evans,Sergiy Stakhovsky,2-6; 6-3; 6-0,R128,77,8,1,45,63,28,45,12,18,2,6,12,40,63,2,0,43,67,22,43,10,24,4,10,11,32,67
2009-03-12 00:00:00.000,ATP World Tour Masters 1000 Indian Wells CA; U.S.A. ATP World Tour Masters 1000,HARD,2,Marc Gicquel,Simone Bolelli,Marc Gicquel,7-5; 6-3,R128,83,4,1,21,56,17,21,29,35,2,2,11,46,56,3,0,37,59,26,37,12,22,0,2,10,38,59
2009-03-12 00:00:00.000,ATP World Tour Masters 1000 Indian Wells CA; U.S.A. ATP World Tour Masters 1000,HARD,2,Roger Federer,N/A Bye,Roger Federer,,R128,0,0,0,0,0,0,0,0,0,0,0,0,0,0,0,0,0,0,0,0,0,0,0,0,0,0,0
2009-03-12 00:00:00.000,ATP World Tour Masters 1000 Indian Wells CA; U.S.A. ATP World Tour Masters 1000,HARD,2,Rafael Nadal,Michael Berrer,Rafael Nadal,6-2; 6-1,R64,68,0,1,16,33,13,16,15,17,0,0,7,28,33,1,0,36,59,21,36,7,23,9,14,8,28,59
2009-03-12 00:00:00.000,ATP World Tour Masters 1000 Indian Wells CA; U.S.A. ATP World Tour Masters 1000,HARD,2,Dmitry Tursunov,Michael Russell,Dmitry Tursunov,7-6(5); 4-6; 6-3,R64,149,8,8,66,108,47,66,15,42,10,16,16,62,108,2,3,76,104,46,76,11,28,6,12,15,57,104
2009-03-12 00:00:00.000,ATP World Tour Masters 1000 Indian Wells CA; U.S.A. ATP World Tour Masters 1000,HARD,2,Viktor Troicki,Tomas Berdych,Viktor Troicki,6-3; 6-1,R64,65,6,2,33,55,25,33,13,22,4,4,8,38,55,2,5,23,47,15,23,10,24,6,10,8,25,47
2009-03-12 00:00:00.000,ATP World Tour Masters 1000 Indian Wells CA; U.S.A. ATP World Tour Masters 1000,HARD,2,David Nalbandian,Robert Kendrick,David Nalbandian,6-4; 6-4,R64,64,10,1,32,49,27,32,13,17,0,0,10,40,49,7,4,29,59,22,29,17,30,0,2,10,39,59
2009-03-12 00:00:00.000,ATP World Tour Masters 1000 Indian Wells CA; U.S.A. ATP World Tour Masters 1000,HARD,2,John Isner,Gael Monfils,John Isner,6-7(5); 6-1; 6-4,R64,118,10,4,46,83,39,46,27,37,0,0,15,66,83,8,5,60,94,45,60,16,34,6,9,14,61,94
2009-03-12 00:00:00.000,ATP World Tour Masters 1000 Indian Wells CA; U.S.A. ATP World Tour Masters 1000,HARD,2,Marat Safin,Nicolas Massu,Marat Safin,6-3; 7-6(2),R64,102,5,1,34,64,29,34,16,30,0,2,11,45,64,7,4,47,74,33,47,11,27,9,12,10,44,74
2009-03-12 00:00:00.000,ATP World Tour Masters 1000 Indian Wells CA; U.S.A. ATP World Tour Masters 1000,HARD,2,Jurgen Melzer,Taylor Dent,Jurgen Melzer,7-5; 6-2,R64,73,1,1,33,53,23,33,15,20,1,2,10,38,53,6,4,35,62,25,35,10,27,6,10,10,35,62
2009-03-12 00:00:00.000,ATP World Tour Masters 1000 Indian Wells CA; U.S.A. ATP World Tour Masters 1000,HARD,2,Juan Martin Del Potro,Ryan Sweeting,Juan Martin Del Potro,6-7(6); 6-3; 6-1,R64,135,8,3,65,94,41,65,13,29,3,8,14,54,94,7,10,58,100,35,58,12,42,6,15,14,47,100
2009-03-12 00:00:00.000,ATP World Tour Masters 1000 Indian Wells CA; U.S.A. ATP World Tour Masters 1000,HARD,2,Novak Djokovic,Martin Vassallo Arguello,Novak Djokovic,7-5; 6-4,R64,104,2,2,35,58,25,35,15,23,0,2,11,40,58,1,1,45,72,28,45,14,27,4,8,11,42,72
2009-03-12 00:00:00.000,ATP World Tour Masters 1000 Indian Wells CA; U.S.A. ATP World Tour Masters 1000,HARD,2,Tommy Haas,Rainer Schuettler,Tommy Haas,6-7(4); 6-2; 6-4,R64,155,7,2,68,97,46,68,18,29,6,9,15,64,97,5,3,57,112,38,57,27,55,9,15,15,65,112
2009-03-12 00:00:00.000,ATP World Tour Masters 1000 Indian Wells CA; U.S.A. ATP World Tour Masters 1000,HARD,2,Sam Querrey,Radek Stepanek,Sam Querrey,6-4; 6-3,R64,81,11,3,43,68,32,43,14,25,1,1,10,46,68,2,3,41,61,26,41,11,20,2,4,9,37,61
2009-03-12 00:00:00.000,ATP World Tour Masters 1000 Indian Wells CA; U.S.A. ATP World Tour Masters 1000,HARD,2,Stanislas Wawrinka,Andreas Seppi,Stanislas Wawrinka,6-1; 6-3,R64,79,6,4,34,70,28,34,17,36,9,9,8,45,70,1,4,26,51,13,26,11,25,3,7,8,24,51
2009-03-12 00:00:00.000,ATP World Tour Masters 1000 Indian Wells CA; U.S.A. ATP World Tour Masters 1000,HARD,2,David Ferrer,Todd Widom,David Ferrer,6-4; 7-5,R64,123,4,1,42,67,29,42,12,25,1,3,11,41,67,0,2,48,95,29,48,23,47,14,18,11,52,95
2009-03-12 00:00:00.000,ATP World Tour Masters 1000 Indian Wells CA; U.S.A. ATP World Tour Masters 1000,HARD,2,Jeremy Chardy,Mardy Fish,Jeremy Chardy,7-6(4); 7-6(1),R64,119,7,5,56,90,44,56,13,34,2,4,12,57,90,13,1,47,81,37,47,15,34,5,7,12,52,81
2009-03-12 00:00:00.000,ATP World Tour Masters 1000 Indian Wells CA; U.S.A. ATP World Tour Masters 1000,HARD,2,Nicolas Kiefer,Bobby Reynolds,Nicolas Kiefer,6-4; 6-2,R64,74,6,0,30,52,26,30,13,22,1,1,9,39,52,9,0,35,54,22,35,11,19,1,4,9,33,54
2009-03-12 00:00:00.000,ATP World Tour Masters 1000 Indian Wells CA; U.S.A. ATP World Tour Masters 1000,HARD,2,Andy Roddick,Daniel Koellerer,Andy Roddick,6-1; 7-6(3),R64,98,16,1,41,58,33,41,12,17,0,1,10,45,58,1,0,47,62,30,47,7,15,6,9,9,37,62
2009-03-12 00:00:00.000,ATP World Tour Masters 1000 Indian Wells CA; U.S.A. ATP World Tour Masters 1000,HARD,2,Gilles Simon,Yen-Hsun Lu,Gilles Simon,5-7; 6-4; 6-4,R64,136,3,5,51,95,41,51,25,44,3,5,16,66,95,1,8,63,101,47,63,18,38,3,6,16,65,101
2009-03-12 00:00:00.000,ATP World Tour Masters 1000 Indian Wells CA; U.S.A. ATP World Tour Masters 1000,HARD,2,Ivan Ljubicic,Mario Ancic,Ivan Ljubicic,3-3 RET,R64,27,2,1,6,15,6,6,6,9,0,0,3,12,15,3,2,7,19,6,7,7,12,0,0,3,13,19
2009-03-12 00:00:00.000,ATP World Tour Masters 1000 Indian Wells CA; U.S.A. ATP World Tour Masters 1000,HARD,2,Igor Andreev,Ernests Gulbis,Igor Andreev,6-4; 6-4,R64,72,6,4,27,53,23,27,12,26,1,3,10,35,53,3,4,29,60,19,29,12,31,6,10,10,31,60
2009-03-12 00:00:00.000,ATP World Tour Masters 1000 Indian Wells CA; U.S.A. ATP World Tour Masters 1000,HARD,2,Jo-Wilfried Tsonga,Teymuraz Gabashvili,Jo-Wilfried Tsonga,7-5; 6-3,R64,80,6,0,38,53,36,38,8,15,0,0,11,44,53,5,2,30,58,22,30,15,28,2,4,10,37,58
2009-03-12 00:00:00.000,ATP World Tour Masters 1000 Indian Wells CA; U.S.A. ATP World Tour Masters 1000,HARD,2,Tommy Robredo,Igor Kunitsyn,Tommy Robredo,6-1; 6-4,R64,57,3,1,29,46,25,29,11,17,0,0,9,36,46,1,0,35,42,21,35,4,7,0,3,8,25,42
2009-03-12 00:00:00.000,ATP World Tour Masters 1000 Indian Wells CA; U.S.A. ATP World Tour Masters 1000,HARD,2,Marin Cilic,Steve Darcis,Marin Cilic,6-7(4); 6-2; 6-1,R64,123,11,5,50,86,38,50,19,36,6,8,14,57,86,5,4,57,93,36,57,12,36,7,13,13,48,93
2009-03-12 00:00:00.000,ATP World Tour Masters 1000 Indian Wells CA; U.S.A. ATP World Tour Masters 1000,HARD,2,Paul-Henri Mathieu,Potito Starace,Paul-Henri Mathieu,6-4; 6-7(11); 6-4,R64,150,14,4,53,109,40,53,31,56,2,4,16,71,109,7,2,82,115,54,82,14,33,3,7,16,68,115
2009-03-12 00:00:00.000,ATP World Tour Masters 1000 Indian Wells CA; U.S.A. ATP World Tour Masters 1000,HARD,2,Andy Murray,Albert Montanes,Andy Murray,7-5; 6-3,R64,96,8,3,42,77,29,42,21,35,5,6,11,50,77,5,5,36,63,24,36,11,27,3,6,10,35,63
2009-03-12 00:00:00.000,ATP World Tour Masters 1000 Indian Wells CA; U.S.A. ATP World Tour Masters 1000,HARD,2,Philipp Kohlschreiber,Olivier Patience,Philipp Kohlschreiber,6-7(5); 6-3; 6-3,R64,116,5,0,61,82,45,61,12,21,1,4,15,57,82,3,2,53,94,31,53,21,41,1,7,15,52,94
2009-03-12 00:00:00.000,ATP World Tour Masters 1000 Indian Wells CA; U.S.A. ATP World Tour Masters 1000,HARD,2,Nicolas Lapentti,Robin Soderling,Nicolas Lapentti,6-4; 7-6(7),R64,121,5,0,51,84,36,51,19,33,5,6,11,55,84,7,3,46,78,35,46,14,32,8,10,11,49,78
2009-03-12 00:00:00.000,ATP World Tour Masters 1000 Indian Wells CA; U.S.A. ATP World Tour Masters 1000,HARD,2,Richard Gasquet,Michael Llodra,Richard Gasquet,6-4; 6-0,R64,68,4,3,34,59,23,34,14,25,7,8,8,37,59,4,3,23,43,13,23,6,20,3,8,8,19,43
2009-03-12 00:00:00.000,ATP World Tour Masters 1000 Indian Wells CA; U.S.A. ATP World Tour Masters 1000,HARD,2,Fernando Verdasco,Thomaz Bellucci,Fernando Verdasco,7-5; 6-1,R64,86,4,1,44,55,38,44,4,11,0,0,10,42,55,6,2,43,65,25,43,10,22,2,5,9,35,65
2009-03-12 00:00:00.000,ATP World Tour Masters 1000 Indian Wells CA; U.S.A. ATP World Tour Masters 1000,HARD,2,James Blake,Jarkko Nieminen,James Blake,6-3; 6-7(6); 6-3,R64,133,14,6,74,127,59,74,22,53,11,12,16,81,127,5,2,67,104,42,67,20,37,8,11,14,62,104
2009-03-12 00:00:00.000,ATP World Tour Masters 1000 Indian Wells CA; U.S.A. ATP World Tour Masters 1000,HARD,2,Fernando Gonzalez,Lleyton Hewitt,Fernando Gonzalez,4-6; 6-2; 6-3,R64,121,8,6,67,103,45,67,18,36,14,17,14,63,103,3,7,43,86,27,43,19,43,6,11,13,46,86
2009-03-12 00:00:00.000,ATP World Tour Masters 1000 Indian Wells CA; U.S.A. ATP World Tour Masters 1000,HARD,2,Ivo Karlovic,Sergiy Stakhovsky,Ivo Karlovic,6-4; 6-2,R64,65,7,2,28,46,27,28,10,18,1,1,9,37,46,4,1,34,59,22,34,12,25,4,7,9,34,59
2009-03-12 00:00:00.000,ATP World Tour Masters 1000 Indian Wells CA; U.S.A. ATP World Tour Masters 1000,HARD,2,Roger Federer,Marc Gicquel,Roger Federer,7-6(4); 6-4,R64,84,12,2,36,59,33,36,15,23,0,0,11,48,59,8,3,52,88,36,52,20,36,2,3,11,56,88
2009-03-12 00:00:00.000,ATP World Tour Masters 1000 Indian Wells CA; U.S.A. ATP World Tour Masters 1000,HARD,2,Rafael Nadal,Dmitry Tursunov,Rafael Nadal,6-3; 6-3,R32,79,3,3,30,52,27,30,11,22,1,1,9,38,52,7,2,34,60,23,34,12,26,4,7,9,35,60
2009-03-12 00:00:00.000,ATP World Tour Masters 1000 Indian Wells CA; U.S.A. ATP World Tour Masters 1000,HARD,2,David Nalbandian,Viktor Troicki,David Nalbandian,6-4; 6-2,R32,82,0,2,26,48,20,26,15,22,1,2,9,35,48,11,5,37,70,24,37,13,33,2,6,9,37,70
2009-03-12 00:00:00.000,ATP World Tour Masters 1000 Indian Wells CA; U.S.A. ATP World Tour Masters 1000,HARD,2,John Isner,Marat Safin,John Isner,6-4; 6-4,R32,75,5,1,34,55,26,34,12,21,2,3,10,38,55,4,3,33,57,24,33,11,24,3,6,10,35,57
2009-03-12 00:00:00.000,ATP World Tour Masters 1000 Indian Wells CA; U.S.A. ATP World Tour Masters 1000,HARD,2,Juan Martin Del Potro,Jurgen Melzer,Juan Martin Del Potro,6-2; 2-6; 7-6(2),R32,120,6,3,58,87,37,58,18,29,3,7,14,55,87,4,2,43,77,34,43,15,34,5,9,14,49,77
2009-03-12 00:00:00.000,ATP World Tour Masters 1000 Indian Wells CA; U.S.A. ATP World Tour Masters 1000,HARD,2,Novak Djokovic,Tommy Haas,Novak Djokovic,6-2; 7-6(1),R32,107,8,1,44,61,34,44,9,17,3,4,10,43,61,2,6,48,79,30,48,13,31,8,11,10,43,79
2009-03-12 00:00:00.000,ATP World Tour Masters 1000 Indian Wells CA; U.S.A. ATP World Tour Masters 1000,HARD,2,Stanislas Wawrinka,Sam Querrey,Stanislas Wawrinka,2-6; 7-5; 7-6(8),R32,142,4,2,52,105,42,52,31,53,2,4,16,73,105,14,2,67,97,54,67,18,30,0,1,16,72,97
2009-03-12 00:00:00.000,ATP World Tour Masters 1000 Indian Wells CA; U.S.A. ATP World Tour Masters 1000,HARD,2,David Ferrer,Jeremy Chardy,David Ferrer,3-6; 6-4; 6-4,R32,114,5,6,56,84,42,56,18,28,7,9,15,60,84,10,3,58,98,48,58,14,40,6,8,14,62,98
2009-03-12 00:00:00.000,ATP World Tour Masters 1000 Indian Wells CA; U.S.A. ATP World Tour Masters 1000,HARD,2,Andy Roddick,Nicolas Kiefer,Andy Roddick,6-4; 7-6(4),R32,106,8,2,49,67,39,49,12,18,3,3,11,51,67,5,3,37,73,29,37,19,36,2,3,11,48,73
2009-03-12 00:00:00.000,ATP World Tour Masters 1000 Indian Wells CA; U.S.A. ATP World Tour Masters 1000,HARD,2,Ivan Ljubicic,Gilles Simon,Ivan Ljubicic,6-3; 7-6(3),R32,84,13,1,33,57,31,33,18,24,0,0,11,49,57,6,1,37,69,28,37,16,32,4,5,10,44,69
2009-03-12 00:00:00.000,ATP World Tour Masters 1000 Indian Wells CA; U.S.A. ATP World Tour Masters 1000,HARD,2,Igor Andreev,Jo-Wilfried Tsonga,Igor Andreev,7-5; 6-4,R32,98,3,3,32,74,23,32,23,42,2,3,11,46,74,6,1,35,63,28,35,14,28,5,8,11,42,63
2009-03-12 00:00:00.000,ATP World Tour Masters 1000 Indian Wells CA; U.S.A. ATP World Tour Masters 1000,HARD,2,Tommy Robredo,Marin Cilic,Tommy Robredo,7-5; 7-6(2),R32,109,4,2,51,79,32,51,14,28,5,9,12,46,79,6,1,43,78,27,43,16,35,6,11,12,43,78
2009-03-12 00:00:00.000,ATP World Tour Masters 1000 Indian Wells CA; U.S.A. ATP World Tour Masters 1000,HARD,2,Andy Murray,Paul-Henri Mathieu,Andy Murray,6-3; 6-2,R32,77,6,3,25,48,21,25,11,23,3,4,8,32,48,1,2,32,56,19,32,7,24,1,6,9,26,56
2009-03-12 00:00:00.000,ATP World Tour Masters 1000 Indian Wells CA; U.S.A. ATP World Tour Masters 1000,HARD,2,Philipp Kohlschreiber,Nicolas Lapentti,Philipp Kohlschreiber,6-2; 3-6; 6-3,R32,131,8,4,64,87,46,64,11,23,5,7,13,57,87,5,3,53,86,33,53,19,33,5,9,13,52,86
2009-03-12 00:00:00.000,ATP World Tour Masters 1000 Indian Wells CA; U.S.A. ATP World Tour Masters 1000,HARD,2,Fernando Verdasco,Richard Gasquet,Fernando Verdasco,6-3; 6-2,R32,68,2,0,29,40,21,29,9,11,1,2,8,30,40,2,6,26,52,16,26,9,26,3,8,9,25,52
2009-03-12 00:00:00.000,ATP World Tour Masters 1000 Indian Wells CA; U.S.A. ATP World Tour Masters 1000,HARD,2,Fernando Gonzalez,James Blake,Fernando Gonzalez,7-5; 6-1,R32,65,5,2,26,44,21,26,13,18,2,3,9,34,44,4,1,36,68,24,36,11,32,3,8,10,35,68
2009-03-12 00:00:00.000,ATP World Tour Masters 1000 Indian Wells CA; U.S.A. ATP World Tour Masters 1000,HARD,2,Roger Federer,Ivo Karlovic,Roger Federer,7-6(4); 6-3,R32,74,1,2,36,59,34,36,15,23,0,0,11,49,59,13,2,37,61,30,37,13,24,1,2,10,43,61
2009-03-12 00:00:00.000,ATP World Tour Masters 1000 Indian Wells CA; U.S.A. ATP World Tour Masters 1000,HARD,2,Rafael Nadal,David Nalbandian,Rafael Nadal,3-6; 7-6(5); 6-0,R16,175,1,1,62,93,39,62,19,31,11,14,13,58,93,3,8,55,110,35,55,26,55,9,14,14,61,110
2009-03-12 00:00:00.000,ATP World Tour Masters 1000 Indian Wells CA; U.S.A. ATP World Tour Masters 1000,HARD,2,Juan Martin Del Potro,John Isner,Juan Martin Del Potro,7-6(4); 7-6(3),R16,121,9,1,49,77,43,49,16,28,3,3,12,59,77,14,4,58,88,42,58,17,30,4,4,12,59,88
2009-03-12 00:00:00.000,ATP World Tour Masters 1000 Indian Wells CA; U.S.A. ATP World Tour Masters 1000,HARD,2,Novak Djokovic,Stanislas Wawrinka,Novak Djokovic,7-6(7); 7-6(6),R16,148,5,2,62,96,42,62,21,34,4,6,12,63,96,8,0,51,89,40,51,19,38,6,8,12,59,89
2009-03-12 00:00:00.000,ATP World Tour Masters 1000 Indian Wells CA; U.S.A. ATP World Tour Masters 1000,HARD,2,Andy Roddick,David Ferrer,Andy Roddick,7-6(5); 3-6; 6-3,R16,140,10,3,66,95,48,66,17,29,6,8,15,65,95,8,2,59,99,44,59,22,40,5,7,15,66,99
2009-03-12 00:00:00.000,ATP World Tour Masters 1000 Indian Wells CA; U.S.A. ATP World Tour Masters 1000,HARD,2,Ivan Ljubicic,Igor Andreev,Ivan Ljubicic,4-6; 7-6(5); 7-6(4),R16,186,14,7,75,129,63,75,23,54,14,15,17,86,129,17,5,65,114,58,65,22,49,4,4,17,80,114
2009-03-12 00:00:00.000,ATP World Tour Masters 1000 Indian Wells CA; U.S.A. ATP World Tour Masters 1000,HARD,2,Andy Murray,Tommy Robredo,Andy Murray,6-2; 3-0 RET,R16,50,0,3,23,39,18,23,7,16,3,4,6,25,39,2,3,22,34,9,22,4,12,3,7,5,13,34
2009-03-12 00:00:00.000,ATP World Tour Masters 1000 Indian Wells CA; U.S.A. ATP World Tour Masters 1000,HARD,2,Fernando Verdasco,Philipp Kohlschreiber,Fernando Verdasco,6-4; 3-6; 6-1,R16,101,2,1,44,60,35,44,7,16,1,4,13,42,60,2,2,46,77,30,46,13,31,6,11,13,43,77
2009-03-12 00:00:00.000,ATP World Tour Masters 1000 Indian Wells CA; U.S.A. ATP World Tour Masters 1000,HARD,2,Roger Federer,Fernando Gonzalez,Roger Federer,6-3; 5-7; 6-2,R16,110,3,3,44,86,36,44,25,42,1,2,15,61,86,6,2,47,86,35,47,20,39,2,5,14,55,86
2009-03-12 00:00:00.000,ATP World Tour Masters 1000 Indian Wells CA; U.S.A. ATP World Tour Masters 1000,HARD,2,Rafael Nadal,Juan Martin Del Potro,Rafael Nadal,6-2; 6-4,Q,110,2,1,44,62,32,44,9,18,4,5,9,41,62,2,2,47,71,26,47,11,24,9,13,9,37,71
2009-03-12 00:00:00.000,ATP World Tour Masters 1000 Indian Wells CA; U.S.A. ATP World Tour Masters 1000,HARD,2,Andy Roddick,Novak Djokovic,Andy Roddick,6-3; 6-2,Q,69,5,0,35,43,27,35,6,8,2,2,8,33,43,2,4,32,56,18,32,11,24,1,5,9,29,56
2009-03-12 00:00:00.000,ATP World Tour Masters 1000 Indian Wells CA; U.S.A. ATP World Tour Masters 1000,HARD,2,Andy Murray,Ivan Ljubicic,Andy Murray,7-5; 7-6(6),Q,126,6,2,52,79,41,52,12,27,4,6,12,53,79,6,0,35,74,27,35,20,39,3,6,12,47,74
2009-03-12 00:00:00.000,ATP World Tour Masters 1000 Indian Wells CA; U.S.A. ATP World Tour Masters 1000,HARD,2,Roger Federer,Fernando Verdasco,Roger Federer,6-3; 7-6(5),Q,92,4,3,42,67,32,42,10,25,5,7,10,42,67,2,4,61,77,35,61,10,16,4,8,11,45,77
2009-03-12 00:00:00.000,ATP World Tour Masters 1000 Indian Wells CA; U.S.A. ATP World Tour Masters 1000,HARD,2,Rafael Nadal,Andy Roddick,Rafael Nadal,6-4; 7-6(4),S,110,5,2,50,75,37,50,12,25,3,5,11,49,75,9,1,45,66,34,45,8,21,3,6,11,42,66
2009-03-12 00:00:00.000,ATP World Tour Masters 1000 Indian Wells CA; U.S.A. ATP World Tour Masters 1000,HARD,2,Andy Murray,Roger Federer,Andy Murray,6-3; 4-6; 6-1,S,108,6,3,49,82,35,49,19,33,8,10,13,54,82,3,0,42,74,27,42,15,32,1,6,13,42,74
2009-03-12 00:00:00.000,ATP World Tour Masters 1000 Indian Wells CA; U.S.A. ATP World Tour Masters 1000,HARD,2,Rafael Nadal,Andy Murray,Rafael Nadal,6-1; 6-2,F,81,0,1,26,43,21,26,11,17,0,0,8,32,43,0,0,34,50,19,34,6,16,1,5,7,25,50
2009-03-25 00:00:00.000,ATP World Tour Masters 1000 Miami FL; U.S.A. ATP World Tour Masters 1000,HARD,2,Rafael Nadal,N/A Bye,Rafael Nadal,,R128,0,0,0,0,0,0,0,0,0,0,0,0,0,0,0,0,0,0,0,0,0,0,0,0,0,0,0
2009-03-25 00:00:00.000,ATP World Tour Masters 1000 Miami FL; U.S.A. ATP World Tour Masters 1000,HARD,2,Teymuraz Gabashvili,Simone Bolelli,Teymuraz Gabashvili,6-4; 4-6; 6-4,R128,153,8,14,57,123,45,57,28,66,12,15,15,73,123,2,1,60,88,42,60,13,28,6,10,15,55,88
2009-03-25 00:00:00.000,ATP World Tour Masters 1000 Miami FL; U.S.A. ATP World Tour Masters 1000,HARD,2,Frederico Gil,Mischa Zverev,Frederico Gil,7-6(7); 6-2,R128,78,4,1,48,65,38,48,10,17,5,5,10,48,65,4,0,45,69,28,45,14,24,2,4,10,42,69
2009-03-25 00:00:00.000,ATP World Tour Masters 1000 Miami FL; U.S.A. ATP World Tour Masters 1000,HARD,2,Ivo Karlovic,N/A Bye,Ivo Karlovic,,R128,0,0,0,0,0,0,0,0,0,0,0,0,0,0,0,0,0,0,0,0,0,0,0,0,0,0,0
2009-03-25 00:00:00.000,ATP World Tour Masters 1000 Miami FL; U.S.A. ATP World Tour Masters 1000,HARD,2,Igor Andreev,N/A Bye,Igor Andreev,,R128,0,0,0,0,0,0,0,0,0,0,0,0,0,0,0,0,0,0,0,0,0,0,0,0,0,0,0
2009-03-25 00:00:00.000,ATP World Tour Masters 1000 Miami FL; U.S.A. ATP World Tour Masters 1000,HARD,2,Yen-Hsun Lu,Eduardo Schwank,Yen-Hsun Lu,6-2; 6-2,R128,74,0,2,31,51,26,31,9,20,1,1,8,35,51,2,4,25,52,13,25,11,27,2,6,8,24,52
2009-03-25 00:00:00.000,ATP World Tour Masters 1000 Miami FL; U.S.A. ATP World Tour Masters 1000,HARD,2,Andreas Seppi,Guillermo Garcia-Lopez,Andreas Seppi,7-6(6); 6-1,R128,90,0,1,45,73,35,45,14,28,4,5,10,49,73,0,6,36,68,25,36,12,32,3,6,9,37,68
2009-03-25 00:00:00.000,ATP World Tour Masters 1000 Miami FL; U.S.A. ATP World Tour Masters 1000,HARD,2,Stanislas Wawrinka,N/A Bye,Stanislas Wawrinka,,R128,0,0,0,0,0,0,0,0,0,0,0,0,0,0,0,0,0,0,0,0,0,0,0,0,0,0,0
2009-03-25 00:00:00.000,ATP World Tour Masters 1000 Miami FL; U.S.A. ATP World Tour Masters 1000,HARD,2,David Ferrer,N/A Bye,David Ferrer,,R128,0,0,0,0,0,0,0,0,0,0,0,0,0,0,0,0,0,0,0,0,0,0,0,0,0,0,0
2009-03-25 00:00:00.000,ATP World Tour Masters 1000 Miami FL; U.S.A. ATP World Tour Masters 1000,HARD,2,John Isner,Sergiy Stakhovsky,John Isner,6-4; 6-4,R128,74,12,3,37,57,30,37,14,20,1,1,10,44,57,3,3,37,68,24,37,17,31,7,9,10,41,68
2009-03-25 00:00:00.000,ATP World Tour Masters 1000 Miami FL; U.S.A. ATP World Tour Masters 1000,HARD,2,Amer Delic,Steve Darcis,Amer Delic,6-4; 7-6(2),R128,84,17,0,40,66,34,40,17,26,3,3,11,51,66,3,3,49,83,38,49,15,34,5,6,11,53,83
2009-03-25 00:00:00.000,ATP World Tour Masters 1000 Miami FL; U.S.A. ATP World Tour Masters 1000,HARD,2,Marin Cilic,N/A Bye,Marin Cilic,,R128,0,0,0,0,0,0,0,0,0,0,0,0,0,0,0,0,0,0,0,0,0,0,0,0,0,0,0
2009-03-25 00:00:00.000,ATP World Tour Masters 1000 Miami FL; U.S.A. ATP World Tour Masters 1000,HARD,2,Jurgen Melzer,N/A Bye,Jurgen Melzer,,R128,0,0,0,0,0,0,0,0,0,0,0,0,0,0,0,0,0,0,0,0,0,0,0,0,0,0,0
2009-03-25 00:00:00.000,ATP World Tour Masters 1000 Miami FL; U.S.A. ATP World Tour Masters 1000,HARD,2,Janko Tipsarevic,Jose Acasuso,Janko Tipsarevic,6-4; 4-6; 6-3,R128,121,9,1,40,78,33,40,21,38,0,2,14,54,78,8,4,43,85,32,43,21,42,1,5,15,53,85
2009-03-25 00:00:00.000,ATP World Tour Masters 1000 Miami FL; U.S.A. ATP World Tour Masters 1000,HARD,2,Martin Vassallo Arguello,Potito Starace,Martin Vassallo Arguello,7-6(9); 6-4,R128,98,6,2,49,71,37,49,16,22,1,2,11,53,71,2,1,47,70,37,47,10,23,1,3,11,47,70
2009-03-25 00:00:00.000,ATP World Tour Masters 1000 Miami FL; U.S.A. ATP World Tour Masters 1000,HARD,2,Juan Martin Del Potro,N/A Bye,Juan Martin Del Potro,,R128,0,0,0,0,0,0,0,0,0,0,0,0,0,0,0,0,0,0,0,0,0,0,0,0,0,0,0
2009-03-25 00:00:00.000,ATP World Tour Masters 1000 Miami FL; U.S.A. ATP World Tour Masters 1000,HARD,2,Andy Murray,N/A Bye,Andy Murray,,R128,0,0,0,0,0,0,0,0,0,0,0,0,0,0,0,0,0,0,0,0,0,0,0,0,0,0,0
2009-03-25 00:00:00.000,ATP World Tour Masters 1000 Miami FL; U.S.A. ATP World Tour Masters 1000,HARD,2,Juan Monaco,Marc Gicquel,Juan Monaco,6-0; 6-4,R128,77,3,3,32,48,25,32,10,16,1,1,8,35,48,1,1,42,74,25,42,12,32,10,14,8,37,74
2009-03-25 00:00:00.000,ATP World Tour Masters 1000 Miami FL; U.S.A. ATP World Tour Masters 1000,HARD,2,Nicolas Massu,Ryan Sweeting,Nicolas Massu,6-4; 7-6(2),R128,101,3,7,53,79,34,53,13,26,6,10,11,47,79,4,10,33,62,21,33,9,29,1,6,11,30,62
2009-03-25 00:00:00.000,ATP World Tour Masters 1000 Miami FL; U.S.A. ATP World Tour Masters 1000,HARD,2,Mardy Fish,N/A Bye,Mardy Fish,,R128,0,0,0,0,0,0,0,0,0,0,0,0,0,0,0,0,0,0,0,0,0,0,0,0,0,0,0
2009-03-25 00:00:00.000,ATP World Tour Masters 1000 Miami FL; U.S.A. ATP World Tour Masters 1000,HARD,2,Bjorn Phau,N/A Bye,Bjorn Phau,,R128,0,0,0,0,0,0,0,0,0,0,0,0,0,0,0,0,0,0,0,0,0,0,0,0,0,0,0
2009-03-25 00:00:00.000,ATP World Tour Masters 1000 Miami FL; U.S.A. ATP World Tour Masters 1000,HARD,2,Albert Montanes,Stefan Koubek,Albert Montanes,6-4; 7-6(2),R128,80,3,2,40,65,35,40,12,25,2,3,11,47,65,4,1,46,69,29,46,14,23,0,2,11,43,69
2009-03-25 00:00:00.000,ATP World Tour Masters 1000 Miami FL; U.S.A. ATP World Tour Masters 1000,HARD,2,Viktor Troicki,Nicolas Devilder,Viktor Troicki,6-2; 6-3,R128,65,7,1,22,50,17,22,15,28,4,5,8,32,50,1,4,30,53,15,30,11,23,1,6,9,26,53
2009-03-25 00:00:00.000,ATP World Tour Masters 1000 Miami FL; U.S.A. ATP World Tour Masters 1000,HARD,2,David Nalbandian,N/A Bye,David Nalbandian,,R128,0,0,0,0,0,0,0,0,0,0,0,0,0,0,0,0,0,0,0,0,0,0,0,0,0,0,0
2009-03-25 00:00:00.000,ATP World Tour Masters 1000 Miami FL; U.S.A. ATP World Tour Masters 1000,HARD,2,Fernando Gonzalez,N/A Bye,Fernando Gonzalez,,R128,0,0,0,0,0,0,0,0,0,0,0,0,0,0,0,0,0,0,0,0,0,0,0,0,0,0,0
2009-03-25 00:00:00.000,ATP World Tour Masters 1000 Miami FL; U.S.A. ATP World Tour Masters 1000,HARD,2,Igor Kunitsyn,Guillermo Canas,Igor Kunitsyn,7-6(2); 5-7; 6-3,R128,180,2,0,73,110,49,73,18,37,5,9,17,67,110,3,6,61,105,45,61,18,44,8,12,16,63,105
2009-03-25 00:00:00.000,ATP World Tour Masters 1000 Miami FL; U.S.A. ATP World Tour Masters 1000,HARD,2,Bobby Reynolds,Juan Ignacio Chela,Bobby Reynolds,0-6; 7-5; 6-4,R128,130,11,2,55,93,33,55,14,38,9,16,14,47,93,4,4,51,88,31,51,17,37,3,9,14,48,88
2009-03-25 00:00:00.000,ATP World Tour Masters 1000 Miami FL; U.S.A. ATP World Tour Masters 1000,HARD,2,Radek Stepanek,N/A Bye,Radek Stepanek,,R128,0,0,0,0,0,0,0,0,0,0,0,0,0,0,0,0,0,0,0,0,0,0,0,0,0,0,0
2009-03-25 00:00:00.000,ATP World Tour Masters 1000 Miami FL; U.S.A. ATP World Tour Masters 1000,HARD,2,Feliciano Lopez,N/A Bye,Feliciano Lopez,,R128,0,0,0,0,0,0,0,0,0,0,0,0,0,0,0,0,0,0,0,0,0,0,0,0,0,0,0
2009-03-25 00:00:00.000,ATP World Tour Masters 1000 Miami FL; U.S.A. ATP World Tour Masters 1000,HARD,2,Sam Querrey,Gilles Muller,Sam Querrey,6-4; 6-3,R128,66,9,2,22,49,19,22,19,27,2,2,9,38,49,2,3,31,61,22,31,13,30,2,5,10,35,61
2009-03-25 00:00:00.000,ATP World Tour Masters 1000 Miami FL; U.S.A. ATP World Tour Masters 1000,HARD,2,Benjamin Becker,Jesse Levine,Benjamin Becker,6-4; 6-3,R128,64,7,1,27,52,20,27,16,25,2,3,9,36,52,5,3,28,50,15,28,15,22,1,5,10,30,50
2009-03-25 00:00:00.000,ATP World Tour Masters 1000 Miami FL; U.S.A. ATP World Tour Masters 1000,HARD,2,Fernando Verdasco,N/A Bye,Fernando Verdasco,,R128,0,0,0,0,0,0,0,0,0,0,0,0,0,0,0,0,0,0,0,0,0,0,0,0,0,0,0
2009-03-25 00:00:00.000,ATP World Tour Masters 1000 Miami FL; U.S.A. ATP World Tour Masters 1000,HARD,2,Gilles Simon,N/A Bye,Gilles Simon,,R128,0,0,0,0,0,0,0,0,0,0,0,0,0,0,0,0,0,0,0,0,0,0,0,0,0,0,0
2009-03-25 00:00:00.000,ATP World Tour Masters 1000 Miami FL; U.S.A. ATP World Tour Masters 1000,HARD,2,Lleyton Hewitt,Dudi Sela,Lleyton Hewitt,3-6; 6-4; 6-3,R128,118,4,6,39,77,25,39,19,38,6,11,14,44,77,0,2,54,93,29,54,20,39,5,11,14,49,93
2009-03-25 00:00:00.000,ATP World Tour Masters 1000 Miami FL; U.S.A. ATP World Tour Masters 1000,HARD,2,Jarkko Nieminen,Ivan Navarro,Jarkko Nieminen,6-3; 6-3,R128,80,1,1,37,58,27,37,14,21,4,4,9,41,58,8,4,46,66,30,46,7,20,2,5,9,37,66
2009-03-25 00:00:00.000,ATP World Tour Masters 1000 Miami FL; U.S.A. ATP World Tour Masters 1000,HARD,2,Rainer Schuettler,N/A Bye,Rainer Schuettler,,R128,0,0,0,0,0,0,0,0,0,0,0,0,0,0,0,0,0,0,0,0,0,0,0,0,0,0,0
2009-03-25 00:00:00.000,ATP World Tour Masters 1000 Miami FL; U.S.A. ATP World Tour Masters 1000,HARD,2,Robin Soderling,N/A Bye,Robin Soderling,,R128,0,0,0,0,0,0,0,0,0,0,0,0,0,0,0,0,0,0,0,0,0,0,0,0,0,0,0
2009-03-25 00:00:00.000,ATP World Tour Masters 1000 Miami FL; U.S.A. ATP World Tour Masters 1000,HARD,2,Robert Kendrick,Arnaud Clement,Robert Kendrick,6-3; 7-6(5),R128,94,13,1,40,75,34,40,19,35,3,4,11,53,75,2,6,41,71,30,41,15,30,4,6,10,45,71
2009-03-25 00:00:00.000,ATP World Tour Masters 1000 Miami FL; U.S.A. ATP World Tour Masters 1000,HARD,2,Agustin Calleri,Christophe Rochus,Agustin Calleri,6-4; 3-6; 6-3,R128,101,11,10,41,87,34,41,21,46,9,12,14,55,87,5,2,41,83,28,41,21,42,3,7,14,49,83
2009-03-25 00:00:00.000,ATP World Tour Masters 1000 Miami FL; U.S.A. ATP World Tour Masters 1000,HARD,2,Jo-Wilfried Tsonga,N/A Bye,Jo-Wilfried Tsonga,,R128,0,0,0,0,0,0,0,0,0,0,0,0,0,0,0,0,0,0,0,0,0,0,0,0,0,0,0
2009-03-25 00:00:00.000,ATP World Tour Masters 1000 Miami FL; U.S.A. ATP World Tour Masters 1000,HARD,2,James Blake,N/A Bye,James Blake,,R128,0,0,0,0,0,0,0,0,0,0,0,0,0,0,0,0,0,0,0,0,0,0,0,0,0,0,0
2009-03-25 00:00:00.000,ATP World Tour Masters 1000 Miami FL; U.S.A. ATP World Tour Masters 1000,HARD,2,Julien Benneteau,Florent Serra,Julien Benneteau,3-6; 6-3; 6-4,R128,129,7,9,60,112,36,60,27,52,10,14,14,63,112,5,2,55,90,37,55,14,35,6,11,14,51,90
2009-03-25 00:00:00.000,ATP World Tour Masters 1000 Miami FL; U.S.A. ATP World Tour Masters 1000,HARD,2,Mikhail Youzhny,Jeremy Chardy,Mikhail Youzhny,6-4; 3-6; 6-3,R128,119,4,6,50,95,38,50,24,45,11,13,14,62,95,10,3,40,87,28,40,27,47,4,7,14,55,87
2009-03-25 00:00:00.000,ATP World Tour Masters 1000 Miami FL; U.S.A. ATP World Tour Masters 1000,HARD,2,Tomas Berdych,N/A Bye,Tomas Berdych,,R128,0,0,0,0,0,0,0,0,0,0,0,0,0,0,0,0,0,0,0,0,0,0,0,0,0,0,0
2009-03-25 00:00:00.000,ATP World Tour Masters 1000 Miami FL; U.S.A. ATP World Tour Masters 1000,HARD,2,Paul-Henri Mathieu,N/A Bye,Paul-Henri Mathieu,,R128,0,0,0,0,0,0,0,0,0,0,0,0,0,0,0,0,0,0,0,0,0,0,0,0,0,0,0
2009-03-25 00:00:00.000,ATP World Tour Masters 1000 Miami FL; U.S.A. ATP World Tour Masters 1000,HARD,2,Marcos Baghdatis,Ernests Gulbis,Marcos Baghdatis,6-2; 6-2,R128,70,7,3,33,64,23,33,20,31,3,3,8,43,64,1,4,32,52,18,32,7,20,2,6,8,25,52
2009-03-25 00:00:00.000,ATP World Tour Masters 1000 Miami FL; U.S.A. ATP World Tour Masters 1000,HARD,2,Frank Dancevic,Philipp Kohlschreiber,Frank Dancevic,6-4; 7-6(2),R128,80,6,2,34,70,28,34,21,36,1,2,11,49,70,5,1,46,65,33,46,10,19,2,4,11,43,65
2009-03-25 00:00:00.000,ATP World Tour Masters 1000 Miami FL; U.S.A. ATP World Tour Masters 1000,HARD,2,Novak Djokovic,N/A Bye,Novak Djokovic,,R128,0,0,0,0,0,0,0,0,0,0,0,0,0,0,0,0,0,0,0,0,0,0,0,0,0,0,0
2009-03-25 00:00:00.000,ATP World Tour Masters 1000 Miami FL; U.S.A. ATP World Tour Masters 1000,HARD,2,Andy Roddick,N/A Bye,Andy Roddick,,R128,0,0,0,0,0,0,0,0,0,0,0,0,0,0,0,0,0,0,0,0,0,0,0,0,0,0,0
2009-03-25 00:00:00.000,ATP World Tour Masters 1000 Miami FL; U.S.A. ATP World Tour Masters 1000,HARD,2,Diego Junqueira,Yuki Bhambri,Diego Junqueira,6-4; 6-3,R128,82,0,1,41,58,28,41,11,17,6,7,9,39,58,0,6,34,65,21,34,15,31,4,8,10,36,65
2009-03-25 00:00:00.000,ATP World Tour Masters 1000 Miami FL; U.S.A. ATP World Tour Masters 1000,HARD,2,Mikhail Kukushkin,Tommy Haas,Mikhail Kukushkin,6-4; 6-4,R128,84,2,0,32,56,21,32,17,24,0,1,10,38,56,8,8,33,69,26,33,13,36,2,5,10,39,69
2009-03-25 00:00:00.000,ATP World Tour Masters 1000 Miami FL; U.S.A. ATP World Tour Masters 1000,HARD,2,Dmitry Tursunov,N/A Bye,Dmitry Tursunov,,R128,0,0,0,0,0,0,0,0,0,0,0,0,0,0,0,0,0,0,0,0,0,0,0,0,0,0,0
2009-03-25 00:00:00.000,ATP World Tour Masters 1000 Miami FL; U.S.A. ATP World Tour Masters 1000,HARD,2,Marat Safin,N/A Bye,Marat Safin,,R128,0,0,0,0,0,0,0,0,0,0,0,0,0,0,0,0,0,0,0,0,0,0,0,0,0,0,0
2009-03-25 00:00:00.000,ATP World Tour Masters 1000 Miami FL; U.S.A. ATP World Tour Masters 1000,HARD,2,Oscar Hernandez,Ivan Ljubicic,Oscar Hernandez,6-4; 6-4,R128,105,3,3,40,68,28,40,18,28,4,4,10,46,68,7,3,40,71,31,40,13,31,3,5,10,44,71
2009-03-25 00:00:00.000,ATP World Tour Masters 1000 Miami FL; U.S.A. ATP World Tour Masters 1000,HARD,2,Michael Russell,Victor Hanescu,Michael Russell,7-6(4); 6-3,R128,102,1,5,41,66,32,41,13,25,2,2,10,45,66,6,2,48,75,31,48,15,27,4,6,11,46,75
2009-03-25 00:00:00.000,ATP World Tour Masters 1000 Miami FL; U.S.A. ATP World Tour Masters 1000,HARD,2,Gael Monfils,N/A Bye,Gael Monfils,,R128,0,0,0,0,0,0,0,0,0,0,0,0,0,0,0,0,0,0,0,0,0,0,0,0,0,0,0
2009-03-25 00:00:00.000,ATP World Tour Masters 1000 Miami FL; U.S.A. ATP World Tour Masters 1000,HARD,2,Tommy Robredo,N/A Bye,Tommy Robredo,,R128,0,0,0,0,0,0,0,0,0,0,0,0,0,0,0,0,0,0,0,0,0,0,0,0,0,0,0
2009-03-25 00:00:00.000,ATP World Tour Masters 1000 Miami FL; U.S.A. ATP World Tour Masters 1000,HARD,2,Jan Hernych,Brendan Evans,Jan Hernych,6-4; 6-3,R128,76,2,6,27,57,23,27,17,30,4,4,9,40,57,10,3,48,79,33,48,12,31,4,7,10,45,79
2009-03-25 00:00:00.000,ATP World Tour Masters 1000 Miami FL; U.S.A. ATP World Tour Masters 1000,HARD,2,Taylor Dent,Ricardo Mello,Taylor Dent,6-1; 6-3,R128,69,3,3,36,64,27,36,15,28,3,3,8,42,64,1,3,32,54,20,32,8,22,2,6,8,28,54
2009-03-25 00:00:00.000,ATP World Tour Masters 1000 Miami FL; U.S.A. ATP World Tour Masters 1000,HARD,2,Nicolas Almagro,N/A Bye,Nicolas Almagro,,R128,0,0,0,0,0,0,0,0,0,0,0,0,0,0,0,0,0,0,0,0,0,0,0,0,0,0,0
2009-03-25 00:00:00.000,ATP World Tour Masters 1000 Miami FL; U.S.A. ATP World Tour Masters 1000,HARD,2,Nicolas Kiefer,N/A Bye,Nicolas Kiefer,,R128,0,0,0,0,0,0,0,0,0,0,0,0,0,0,0,0,0,0,0,0,0,0,0,0,0,0,0
2009-03-25 00:00:00.000,ATP World Tour Masters 1000 Miami FL; U.S.A. ATP World Tour Masters 1000,HARD,2,Fabrice Santoro,Thomaz Bellucci,Fabrice Santoro,6-4; 4-6; 6-1,R128,132,4,2,50,88,32,50,21,38,2,6,14,53,88,4,4,44,77,28,44,12,33,3,9,13,40,77
2009-03-25 00:00:00.000,ATP World Tour Masters 1000 Miami FL; U.S.A. ATP World Tour Masters 1000,HARD,2,Kevin Kim,Michael Llodra,Kevin Kim,3-6 RET,R128,29,2,1,14,21,11,14,3,7,0,1,4,14,21,6,0,22,31,18,22,4,9,2,2,5,22,31
2009-03-25 00:00:00.000,ATP World Tour Masters 1000 Miami FL; U.S.A. ATP World Tour Masters 1000,HARD,2,Roger Federer,N/A Bye,Roger Federer,,R128,0,0,0,0,0,0,0,0,0,0,0,0,0,0,0,0,0,0,0,0,0,0,0,0,0,0,0
2009-03-25 00:00:00.000,ATP World Tour Masters 1000 Miami FL; U.S.A. ATP World Tour Masters 1000,HARD,2,Rafael Nadal,Teymuraz Gabashvili,Rafael Nadal,6-2; 6-2,R64,83,3,0,26,41,21,26,9,15,2,3,8,30,41,4,2,38,58,22,38,5,20,4,9,8,27,58
2009-03-25 00:00:00.000,ATP World Tour Masters 1000 Miami FL; U.S.A. ATP World Tour Masters 1000,HARD,2,Frederico Gil,Ivo Karlovic,Frederico Gil,6-4; 6-4,R64,90,1,3,39,66,28,39,15,27,4,5,10,43,66,16,4,44,74,32,44,11,30,9,12,10,43,74
2009-03-25 00:00:00.000,ATP World Tour Masters 1000 Miami FL; U.S.A. ATP World Tour Masters 1000,HARD,2,Igor Andreev,Yen-Hsun Lu,Igor Andreev,7-6(4); 6-3,R64,116,9,4,43,87,33,43,23,44,3,3,11,56,87,2,5,39,65,29,39,14,26,4,5,10,43,65
2009-03-25 00:00:00.000,ATP World Tour Masters 1000 Miami FL; U.S.A. ATP World Tour Masters 1000,HARD,2,Stanislas Wawrinka,Andreas Seppi,Stanislas Wawrinka,7-5; 7-5,R64,113,12,3,42,88,31,42,23,46,10,12,12,54,88,5,4,37,71,27,37,17,34,1,5,12,44,71
2009-03-25 00:00:00.000,ATP World Tour Masters 1000 Miami FL; U.S.A. ATP World Tour Masters 1000,HARD,2,David Ferrer,John Isner,David Ferrer,6-3; 3-6; 6-2,R64,108,2,3,43,74,31,43,21,31,8,10,13,52,74,16,2,53,80,39,53,9,27,2,6,13,48,80
2009-03-25 00:00:00.000,ATP World Tour Masters 1000 Miami FL; U.S.A. ATP World Tour Masters 1000,HARD,2,Marin Cilic,Amer Delic,Marin Cilic,6-3; 6-7(7); 6-3,R64,149,5,3,46,101,37,46,30,55,1,3,16,67,101,7,5,54,111,42,54,22,57,11,15,14,64,111
2009-03-25 00:00:00.000,ATP World Tour Masters 1000 Miami FL; U.S.A. ATP World Tour Masters 1000,HARD,2,Janko Tipsarevic,Jurgen Melzer,Janko Tipsarevic,6-4; 6-3,R64,79,4,1,27,48,20,27,15,21,2,3,9,35,48,3,4,31,57,19,31,13,26,2,6,10,32,57
2009-03-25 00:00:00.000,ATP World Tour Masters 1000 Miami FL; U.S.A. ATP World Tour Masters 1000,HARD,2,Juan Martin Del Potro,Martin Vassallo Arguello,Juan Martin Del Potro,6-2; 6-2,R64,80,5,2,23,41,20,23,12,18,0,0,8,32,41,0,4,25,48,15,25,9,23,3,7,8,24,48
2009-03-25 00:00:00.000,ATP World Tour Masters 1000 Miami FL; U.S.A. ATP World Tour Masters 1000,HARD,2,Andy Murray,Juan Monaco,Andy Murray,4-6; 6-3; 6-2,R64,135,9,4,68,99,41,68,17,31,9,12,14,58,99,3,2,56,81,36,56,8,25,5,10,13,44,81
2009-03-25 00:00:00.000,ATP World Tour Masters 1000 Miami FL; U.S.A. ATP World Tour Masters 1000,HARD,2,Nicolas Massu,Mardy Fish,Nicolas Massu,5-7; 7-6(4); 6-2,R64,142,10,4,61,101,48,61,23,40,2,3,16,71,101,14,3,57,93,43,57,22,36,4,6,16,65,93
2009-03-25 00:00:00.000,ATP World Tour Masters 1000 Miami FL; U.S.A. ATP World Tour Masters 1000,HARD,2,Bjorn Phau,Albert Montanes,Bjorn Phau,6-4; 2-0 RET,R64,58,2,2,16,42,11,16,13,26,3,5,6,24,42,2,1,21,40,14,21,3,19,2,6,6,17,40
2009-03-25 00:00:00.000,ATP World Tour Masters 1000 Miami FL; U.S.A. ATP World Tour Masters 1000,HARD,2,Viktor Troicki,David Nalbandian,Viktor Troicki,6-1; 6-3,R64,74,7,5,32,64,27,32,15,32,6,6,8,42,64,2,3,14,46,8,14,16,32,2,6,8,24,46
2009-03-25 00:00:00.000,ATP World Tour Masters 1000 Miami FL; U.S.A. ATP World Tour Masters 1000,HARD,2,Fernando Gonzalez,Igor Kunitsyn,Fernando Gonzalez,6-4; 6-4,R64,70,5,4,38,63,27,38,17,25,5,5,10,44,63,0,1,54,63,35,54,5,9,3,5,10,40,63
2009-03-25 00:00:00.000,ATP World Tour Masters 1000 Miami FL; U.S.A. ATP World Tour Masters 1000,HARD,2,Radek Stepanek,Bobby Reynolds,Radek Stepanek,7-5; 6-7(3); 6-2,R64,139,11,7,61,103,43,61,25,42,6,7,16,68,103,9,7,56,100,46,56,18,44,2,6,16,64,100
2009-03-25 00:00:00.000,ATP World Tour Masters 1000 Miami FL; U.S.A. ATP World Tour Masters 1000,HARD,2,Feliciano Lopez,Sam Querrey,Feliciano Lopez,6-7(5); 7-5; 6-2,R64,126,15,3,61,98,50,61,22,37,3,3,16,72,98,6,5,47,101,34,47,30,54,4,7,16,64,101
2009-03-25 00:00:00.000,ATP World Tour Masters 1000 Miami FL; U.S.A. ATP World Tour Masters 1000,HARD,2,Fernando Verdasco,Benjamin Becker,Fernando Verdasco,6-3; 6-4,R64,79,1,6,38,58,26,38,8,20,3,6,10,34,58,4,2,31,55,22,31,5,24,3,8,9,27,55
2009-03-25 00:00:00.000,ATP World Tour Masters 1000 Miami FL; U.S.A. ATP World Tour Masters 1000,HARD,2,Gilles Simon,Lleyton Hewitt,Gilles Simon,6-1; 6-2,R64,86,7,3,29,62,21,29,16,33,8,10,8,37,62,1,6,25,62,10,25,14,37,8,14,7,24,62
2009-03-25 00:00:00.000,ATP World Tour Masters 1000 Miami FL; U.S.A. ATP World Tour Masters 1000,HARD,2,Rainer Schuettler,Jarkko Nieminen,Rainer Schuettler,4-6; 6-2; 6-3,R64,107,1,3,50,84,31,50,17,34,4,9,14,48,84,2,1,59,83,32,59,9,24,6,13,13,41,83
2009-03-25 00:00:00.000,ATP World Tour Masters 1000 Miami FL; U.S.A. ATP World Tour Masters 1000,HARD,2,Robert Kendrick,Robin Soderling,Robert Kendrick,6-4; 6-2,R64,66,5,1,28,54,22,28,17,26,2,3,9,39,54,7,4,34,59,22,34,11,25,3,7,9,33,59
2009-03-25 00:00:00.000,ATP World Tour Masters 1000 Miami FL; U.S.A. ATP World Tour Masters 1000,HARD,2,Jo-Wilfried Tsonga,Agustin Calleri,Jo-Wilfried Tsonga,6-1; 6-1,R64,55,5,1,22,35,21,22,8,13,1,1,7,29,35,1,3,21,47,12,21,8,26,1,6,7,20,47
2009-03-25 00:00:00.000,ATP World Tour Masters 1000 Miami FL; U.S.A. ATP World Tour Masters 1000,HARD,2,James Blake,Julien Benneteau,James Blake,6-4; 6-4,R64,69,8,1,27,53,20,27,21,26,3,4,10,41,53,2,1,34,56,21,34,13,22,3,6,10,34,56
2009-03-25 00:00:00.000,ATP World Tour Masters 1000 Miami FL; U.S.A. ATP World Tour Masters 1000,HARD,2,Tomas Berdych,Mikhail Youzhny,Tomas Berdych,6-3; 3-6; 6-4,R64,132,4,2,48,81,35,48,19,33,2,5,14,54,81,6,2,59,104,38,59,22,45,6,10,14,60,104
2009-03-25 00:00:00.000,ATP World Tour Masters 1000 Miami FL; U.S.A. ATP World Tour Masters 1000,HARD,2,Paul-Henri Mathieu,Marcos Baghdatis,Paul-Henri Mathieu,6-3; 2-6; 6-2,R64,105,3,0,50,77,39,50,12,27,5,7,13,51,77,8,1,31,65,25,31,17,34,2,5,12,42,65
2009-03-25 00:00:00.000,ATP World Tour Masters 1000 Miami FL; U.S.A. ATP World Tour Masters 1000,HARD,2,Novak Djokovic,Frank Dancevic,Novak Djokovic,6-3; 6-2,R64,71,4,2,39,59,30,39,13,20,6,6,9,43,59,1,3,32,52,22,32,8,20,2,5,8,30,52
2009-03-25 00:00:00.000,ATP World Tour Masters 1000 Miami FL; U.S.A. ATP World Tour Masters 1000,HARD,2,Andy Roddick,Diego Junqueira,Andy Roddick,6-1; 6-1,R64,57,5,0,23,36,22,23,6,13,0,0,7,28,36,0,2,29,42,11,29,6,13,4,9,7,17,42
2009-03-25 00:00:00.000,ATP World Tour Masters 1000 Miami FL; U.S.A. ATP World Tour Masters 1000,HARD,2,Dmitry Tursunov,Mikhail Kukushkin,Dmitry Tursunov,3-6; 7-6(4); 6-3,R64,138,7,4,61,101,44,61,19,40,5,10,16,63,101,4,5,51,95,31,51,24,44,5,9,14,55,95
2009-03-25 00:00:00.000,ATP World Tour Masters 1000 Miami FL; U.S.A. ATP World Tour Masters 1000,HARD,2,Marat Safin,Oscar Hernandez,Marat Safin,6-4; 2-6; 6-1,R64,110,5,2,39,68,31,39,14,29,3,5,12,45,68,5,3,47,85,34,47,16,38,7,11,13,50,85
2009-03-25 00:00:00.000,ATP World Tour Masters 1000 Miami FL; U.S.A. ATP World Tour Masters 1000,HARD,2,Gael Monfils,Michael Russell,Gael Monfils,6-2; 6-7(5); 6-3,R64,107,9,6,49,86,46,49,21,37,5,5,15,67,86,1,2,58,85,43,58,14,27,2,5,14,57,85
2009-03-25 00:00:00.000,ATP World Tour Masters 1000 Miami FL; U.S.A. ATP World Tour Masters 1000,HARD,2,Tommy Robredo,Jan Hernych,Tommy Robredo,6-4; 6-4,R64,85,6,1,33,64,30,33,16,31,2,2,10,46,64,1,0,43,66,28,43,13,23,4,6,10,41,66
2009-03-25 00:00:00.000,ATP World Tour Masters 1000 Miami FL; U.S.A. ATP World Tour Masters 1000,HARD,2,Taylor Dent,Nicolas Almagro,Taylor Dent,2-6; 6-2; 7-6(7),R64,108,10,6,54,92,40,54,21,38,2,5,14,61,92,7,2,52,89,39,52,20,37,3,6,14,59,89
2009-03-25 00:00:00.000,ATP World Tour Masters 1000 Miami FL; U.S.A. ATP World Tour Masters 1000,HARD,2,Nicolas Kiefer,Fabrice Santoro,Nicolas Kiefer,5-7; 7-6(5); 6-2,R64,152,6,5,38,90,26,38,35,52,2,5,16,61,90,6,9,53,106,37,53,25,53,6,10,16,62,106
2009-03-25 00:00:00.000,ATP World Tour Masters 1000 Miami FL; U.S.A. ATP World Tour Masters 1000,HARD,2,Roger Federer,Kevin Kim,Roger Federer,6-3; 6-2,R64,65,4,1,35,58,27,35,13,23,5,5,9,40,58,5,2,29,62,24,29,11,33,2,5,8,35,62
2009-03-25 00:00:00.000,ATP World Tour Masters 1000 Miami FL; U.S.A. ATP World Tour Masters 1000,HARD,2,Rafael Nadal,Frederico Gil,Rafael Nadal,7-5; 6-3,R32,95,5,1,41,58,31,41,7,17,4,6,10,38,58,4,0,41,67,24,41,13,26,1,6,11,37,67
2009-03-25 00:00:00.000,ATP World Tour Masters 1000 Miami FL; U.S.A. ATP World Tour Masters 1000,HARD,2,Stanislas Wawrinka,Igor Andreev,Stanislas Wawrinka,4-6; 6-3; 6-3,R32,151,9,4,61,107,47,61,22,46,8,9,14,69,107,3,5,52,96,37,52,23,44,9,12,14,60,96
2009-03-25 00:00:00.000,ATP World Tour Masters 1000 Miami FL; U.S.A. ATP World Tour Masters 1000,HARD,2,David Ferrer,Marin Cilic,David Ferrer,3-6; 6-3; 6-4,R32,127,2,6,47,79,35,47,17,32,8,11,14,52,79,8,3,45,85,32,45,18,40,9,13,14,50,85
2009-03-25 00:00:00.000,ATP World Tour Masters 1000 Miami FL; U.S.A. ATP World Tour Masters 1000,HARD,2,Juan Martin Del Potro,Janko Tipsarevic,Juan Martin Del Potro,6-4; 6-1,R32,68,7,3,26,43,24,26,9,17,2,2,8,33,43,1,4,28,47,16,28,9,19,1,5,9,25,47
2009-03-25 00:00:00.000,ATP World Tour Masters 1000 Miami FL; U.S.A. ATP World Tour Masters 1000,HARD,2,Andy Murray,Nicolas Massu,Andy Murray,6-4; 6-4,R32,107,4,5,37,63,25,37,13,26,5,8,10,38,63,5,6,34,68,22,34,11,34,2,7,10,33,68
2009-03-25 00:00:00.000,ATP World Tour Masters 1000 Miami FL; U.S.A. ATP World Tour Masters 1000,HARD,2,Viktor Troicki,Bjorn Phau,Viktor Troicki,6-4; 6-3,R32,76,12,3,36,59,29,36,11,23,6,7,9,40,59,3,8,35,70,21,35,16,35,3,7,10,37,70
2009-03-25 00:00:00.000,ATP World Tour Masters 1000 Miami FL; U.S.A. ATP World Tour Masters 1000,HARD,2,Radek Stepanek,Fernando Gonzalez,Radek Stepanek,7-6(1); 6-4,R32,91,4,2,41,65,33,41,13,24,0,1,11,46,65,5,1,45,71,33,45,10,26,3,5,11,43,71
2009-03-25 00:00:00.000,ATP World Tour Masters 1000 Miami FL; U.S.A. ATP World Tour Masters 1000,HARD,2,Fernando Verdasco,Feliciano Lopez,Fernando Verdasco,3-6; 6-3; 6-4,R32,125,3,5,57,76,41,57,11,19,0,2,14,52,76,13,7,55,98,41,55,16,43,7,10,14,57,98
2009-03-25 00:00:00.000,ATP World Tour Masters 1000 Miami FL; U.S.A. ATP World Tour Masters 1000,HARD,2,Gilles Simon,Rainer Schuettler,Gilles Simon,3-6; 6-1; 6-1,R32,96,5,3,32,67,22,32,21,35,7,10,11,43,67,1,4,41,70,21,41,10,29,4,11,12,31,70
2009-03-25 00:00:00.000,ATP World Tour Masters 1000 Miami FL; U.S.A. ATP World Tour Masters 1000,HARD,2,Jo-Wilfried Tsonga,Robert Kendrick,Jo-Wilfried Tsonga,7-5; 6-4,R32,92,11,1,43,63,37,43,10,20,0,0,11,47,63,3,4,40,80,30,40,20,40,2,4,11,50,80
2009-03-25 00:00:00.000,ATP World Tour Masters 1000 Miami FL; U.S.A. ATP World Tour Masters 1000,HARD,2,Tomas Berdych,James Blake,Tomas Berdych,6-4; 6-7(3); 6-3,R32,142,6,4,53,107,42,53,31,54,4,5,16,73,107,7,4,65,108,45,65,21,43,9,12,15,66,108
2009-03-25 00:00:00.000,ATP World Tour Masters 1000 Miami FL; U.S.A. ATP World Tour Masters 1000,HARD,2,Novak Djokovic,Paul-Henri Mathieu,Novak Djokovic,6-4; 6-1,R32,76,4,2,28,42,23,28,11,14,3,3,8,34,42,1,11,29,64,17,29,17,35,3,7,9,34,64
2009-03-25 00:00:00.000,ATP World Tour Masters 1000 Miami FL; U.S.A. ATP World Tour Masters 1000,HARD,2,Andy Roddick,Dmitry Tursunov,Andy Roddick,7-6(9); 6-2,R32,110,11,1,42,60,32,42,12,18,0,1,10,44,60,4,3,43,80,32,43,15,37,7,10,10,47,80
2009-03-25 00:00:00.000,ATP World Tour Masters 1000 Miami FL; U.S.A. ATP World Tour Masters 1000,HARD,2,Gael Monfils,Marat Safin,Gael Monfils,5-7; 7-5; 7-6(3),R32,173,13,2,59,110,42,59,28,51,8,12,18,70,110,9,7,63,127,46,63,30,64,3,7,18,76,127
2009-03-25 00:00:00.000,ATP World Tour Masters 1000 Miami FL; U.S.A. ATP World Tour Masters 1000,HARD,2,Taylor Dent,Tommy Robredo,Taylor Dent,7-5; 6-3,R32,76,5,4,35,67,26,35,20,32,1,2,11,46,67,2,1,37,52,21,37,10,15,0,3,10,31,52
2009-03-25 00:00:00.000,ATP World Tour Masters 1000 Miami FL; U.S.A. ATP World Tour Masters 1000,HARD,2,Roger Federer,Nicolas Kiefer,Roger Federer,6-4; 6-1,R32,71,5,1,35,44,26,35,6,9,0,0,8,32,44,5,3,32,59,24,32,7,27,2,6,9,31,59
2009-03-25 00:00:00.000,ATP World Tour Masters 1000 Miami FL; U.S.A. ATP World Tour Masters 1000,HARD,2,Rafael Nadal,Stanislas Wawrinka,Rafael Nadal,7-6(2); 7-6(4),R16,163,0,0,54,83,40,54,19,29,4,5,12,59,83,7,2,58,103,44,58,21,45,11,12,12,65,103
2009-03-25 00:00:00.000,ATP World Tour Masters 1000 Miami FL; U.S.A. ATP World Tour Masters 1000,HARD,2,Juan Martin Del Potro,David Ferrer,Juan Martin Del Potro,6-3; 6-2,R16,80,4,2,24,46,19,24,12,22,1,2,8,31,46,3,3,32,59,21,32,7,27,7,12,9,28,59
2009-03-25 00:00:00.000,ATP World Tour Masters 1000 Miami FL; U.S.A. ATP World Tour Masters 1000,HARD,2,Andy Murray,Viktor Troicki,Andy Murray,6-1; 6-0,R16,58,2,3,29,41,24,29,6,12,0,0,7,30,41,5,5,16,48,11,16,9,32,6,11,6,20,48
2009-03-25 00:00:00.000,ATP World Tour Masters 1000 Miami FL; U.S.A. ATP World Tour Masters 1000,HARD,2,Fernando Verdasco,Radek Stepanek,Fernando Verdasco,6-2; 6-2,R16,71,2,2,35,47,27,35,9,12,2,2,8,36,47,0,3,25,51,13,25,12,26,3,7,8,25,51
2009-03-25 00:00:00.000,ATP World Tour Masters 1000 Miami FL; U.S.A. ATP World Tour Masters 1000,HARD,2,Jo-Wilfried Tsonga,Gilles Simon,Jo-Wilfried Tsonga,6-7(4); 6-3; 6-2,R16,131,9,3,59,101,50,59,22,42,5,5,15,72,101,4,4,35,78,28,35,26,43,2,5,14,54,78
2009-03-25 00:00:00.000,ATP World Tour Masters 1000 Miami FL; U.S.A. ATP World Tour Masters 1000,HARD,2,Novak Djokovic,Tomas Berdych,Novak Djokovic,6-3; 6-2,R16,73,1,2,23,43,19,23,11,20,0,1,8,30,43,3,1,33,57,18,33,9,24,6,11,9,27,57
2009-03-25 00:00:00.000,ATP World Tour Masters 1000 Miami FL; U.S.A. ATP World Tour Masters 1000,HARD,2,Andy Roddick,Gael Monfils,Andy Roddick,7-6(2); 6-4,R16,97,5,1,42,63,37,42,11,21,0,1,11,48,63,10,5,47,76,34,47,12,29,3,5,11,46,76
2009-03-25 00:00:00.000,ATP World Tour Masters 1000 Miami FL; U.S.A. ATP World Tour Masters 1000,HARD,2,Roger Federer,Taylor Dent,Roger Federer,6-3; 6-2,R16,86,5,4,41,68,34,41,13,27,8,8,9,47,68,3,5,45,81,30,45,15,36,8,11,8,45,81
2009-03-25 00:00:00.000,ATP World Tour Masters 1000 Miami FL; U.S.A. ATP World Tour Masters 1000,HARD,2,Juan Martin Del Potro,Rafael Nadal,Juan Martin Del Potro,6-4; 3-6; 7-6(3),Q,180,8,4,58,97,41,58,18,39,4,8,15,59,97,8,2,65,103,45,65,18,38,9,13,16,63,103
2009-03-25 00:00:00.000,ATP World Tour Masters 1000 Miami FL; U.S.A. ATP World Tour Masters 1000,HARD,2,Andy Murray,Fernando Verdasco,Andy Murray,6-1; 6-2,Q,76,3,3,30,55,20,30,14,25,7,8,8,34,55,2,2,32,44,16,32,4,12,2,7,7,20,44
2009-03-25 00:00:00.000,ATP World Tour Masters 1000 Miami FL; U.S.A. ATP World Tour Masters 1000,HARD,2,Novak Djokovic,Jo-Wilfried Tsonga,Novak Djokovic,6-3; 6-4,Q,116,0,1,32,67,23,32,23,35,4,4,10,46,67,4,3,34,67,27,34,13,33,5,7,9,40,67
2009-03-25 00:00:00.000,ATP World Tour Masters 1000 Miami FL; U.S.A. ATP World Tour Masters 1000,HARD,2,Roger Federer,Andy Roddick,Roger Federer,6-3; 4-6; 6-4,Q,123,7,5,51,80,36,51,20,29,2,3,14,56,80,6,4,71,101,48,71,16,30,4,7,15,64,101
2009-03-25 00:00:00.000,ATP World Tour Masters 1000 Miami FL; U.S.A. ATP World Tour Masters 1000,HARD,2,Andy Murray,Juan Martin Del Potro,Andy Murray,6-1; 5-7; 6-2,S,137,6,3,48,74,35,48,17,26,0,2,14,52,74,4,3,51,86,34,51,15,35,6,11,13,49,86
2009-03-25 00:00:00.000,ATP World Tour Masters 1000 Miami FL; U.S.A. ATP World Tour Masters 1000,HARD,2,Novak Djokovic,Roger Federer,Novak Djokovic,3-6; 6-2; 6-3,S,106,4,4,51,73,35,51,12,22,2,6,13,47,73,4,4,48,80,28,48,13,32,4,10,13,41,80
2009-03-25 00:00:00.000,ATP World Tour Masters 1000 Miami FL; U.S.A. ATP World Tour Masters 1000,HARD,2,Andy Murray,Novak Djokovic,Andy Murray,6-2; 7-5,F,103,8,0,36,61,27,36,13,25,3,5,10,40,61,2,5,45,73,24,45,12,28,6,11,10,36,73
2009-04-06 00:00:00.000,Casablanca Morocco ATP World Tour 250,CLAY,2,Igor Andreev,Rabie Chaki,Igor Andreev,3-6; 6-3; 7-5,R32,122,4,3,57,82,42,57,13,25,5,8,15,55,82,3,3,77,105,47,77,16,28,8,12,15,63,105
2009-04-06 00:00:00.000,Casablanca Morocco ATP World Tour 250,CLAY,2,Nicolas Devilder,Daniel Koellerer,Nicolas Devilder,6-3; 6-4,R32,71,6,1,36,56,25,36,14,20,0,1,10,39,56,0,3,33,55,22,33,10,22,5,8,9,32,55
2009-04-06 00:00:00.000,Casablanca Morocco ATP World Tour 250,CLAY,2,Mischa Zverev,Flavio Cipolla,Mischa Zverev,6-2; 3-6; 6-3,R32,97,5,4,53,76,37,53,12,23,6,9,13,49,76,1,3,49,71,27,49,13,22,1,6,13,40,71
2009-04-06 00:00:00.000,Casablanca Morocco ATP World Tour 250,CLAY,2,Marc Gicquel,Kristof Vliegen,Marc Gicquel,7-5; 6-3,R32,68,1,1,21,45,18,21,16,24,1,3,10,34,45,2,2,35,59,18,35,12,24,0,5,11,30,59
2009-04-06 00:00:00.000,Casablanca Morocco ATP World Tour 250,CLAY,2,Victor Hanescu,Steve Darcis,Victor Hanescu,6-4; 7-5,R32,96,1,2,47,73,28,47,18,26,6,8,11,46,73,2,2,28,58,21,28,13,30,2,6,11,34,58
2009-04-06 00:00:00.000,Casablanca Morocco ATP World Tour 250,CLAY,2,Ivan Navarro,Sergiy Stakhovsky,Ivan Navarro,7-5; 4-2 RET,R32,99,4,1,31,50,22,31,9,19,2,4,9,31,50,3,3,32,66,20,32,14,34,7,11,9,34,66
2009-04-06 00:00:00.000,Casablanca Morocco ATP World Tour 250,CLAY,2,Potito Starace,Oscar Hernandez,Potito Starace,4-6; 6-3; 6-3,R32,107,2,1,48,69,36,48,15,21,1,3,14,51,69,5,5,52,95,32,52,24,43,9,13,14,56,95
2009-04-06 00:00:00.000,Casablanca Morocco ATP World Tour 250,CLAY,2,Juan Carlos Ferrero,Christophe Rochus,Juan Carlos Ferrero,6-2; 6-3,R32,61,9,1,32,43,23,32,7,11,1,2,8,30,43,1,1,34,63,21,34,9,29,6,11,9,30,63
2009-04-06 00:00:00.000,Casablanca Morocco ATP World Tour 250,CLAY,2,Ivan Ljubicic,Arnaud Clement,Ivan Ljubicic,7-6(6); 5-7; 6-4,R32,178,16,1,64,111,50,64,25,47,3,5,17,75,111,5,1,65,110,47,65,25,45,7,9,17,72,110
2009-04-06 00:00:00.000,Casablanca Morocco ATP World Tour 250,CLAY,2,Frederico Gil,Alberto Martin,Frederico Gil,6-3; 3-6; 7-6(4),R32,142,3,4,52,101,35,52,22,49,4,9,15,57,101,5,5,49,98,35,49,25,49,6,11,15,60,98
2009-04-06 00:00:00.000,Casablanca Morocco ATP World Tour 250,CLAY,2,Santiago Ventura,Oliver Marach,Santiago Ventura,6-1; 6-1,R32,42,5,1,30,40,26,30,4,10,1,1,7,30,40,3,7,26,45,15,26,5,19,1,6,7,20,45
2009-04-06 00:00:00.000,Casablanca Morocco ATP World Tour 250,CLAY,2,Albert Montanes,Reda El Amrani,Albert Montanes,6-2; 7-5,R32,85,2,1,33,54,27,33,14,21,2,2,10,41,54,1,5,40,79,23,40,19,39,7,10,10,42,79
2009-04-06 00:00:00.000,Casablanca Morocco ATP World Tour 250,CLAY,2,Florent Serra,Thomaz Bellucci,Florent Serra,6-3; 6-3,R32,77,5,1,35,57,25,35,12,22,3,4,9,37,57,3,2,40,58,22,40,9,18,1,5,9,31,58
2009-04-06 00:00:00.000,Casablanca Morocco ATP World Tour 250,CLAY,2,Olivier Rochus,Mehdi Ziadi,Olivier Rochus,4-6; 6-2; 6-1,R32,115,1,0,53,78,39,53,13,25,8,10,13,52,78,7,4,39,68,26,39,14,29,1,6,12,40,68
2009-04-06 00:00:00.000,Casablanca Morocco ATP World Tour 250,CLAY,2,Teymuraz Gabashvili,Fabio Fognini,Teymuraz Gabashvili,6-2; 6-1,R32,45,5,2,23,44,18,23,14,21,1,1,7,32,44,0,2,21,53,11,21,13,32,4,9,8,24,53
2009-04-06 00:00:00.000,Casablanca Morocco ATP World Tour 250,CLAY,2,Ruben Ramirez Hidalgo,Rainer Schuettler,Ruben Ramirez Hidalgo,6-4; 7-6(5),R32,135,2,1,46,85,35,46,20,39,3,4,11,55,85,2,2,39,64,29,39,12,25,1,3,11,41,64
2009-04-06 00:00:00.000,Casablanca Morocco ATP World Tour 250,CLAY,2,Igor Andreev,Nicolas Devilder,Igor Andreev,6-7(11); 7-6(5); 6-4,R16,197,3,1,74,121,51,74,31,47,4,5,17,82,121,9,10,75,144,53,75,37,69,14,16,17,90,144
2009-04-06 00:00:00.000,Casablanca Morocco ATP World Tour 250,CLAY,2,Marc Gicquel,Mischa Zverev,Marc Gicquel,6-4; 7-5,R16,98,1,0,46,79,32,46,15,33,7,9,11,47,79,5,3,40,69,30,40,10,29,6,10,11,40,69
2009-04-06 00:00:00.000,Casablanca Morocco ATP World Tour 250,CLAY,2,Victor Hanescu,Ivan Navarro,Victor Hanescu,6-1; 6-0,R16,48,6,1,22,35,19,22,9,13,0,0,7,28,35,1,1,16,36,8,16,4,20,2,7,6,12,36
2009-04-06 00:00:00.000,Casablanca Morocco ATP World Tour 250,CLAY,2,Juan Carlos Ferrero,Potito Starace,Juan Carlos Ferrero,6-4; 7-6(1),R16,110,3,1,59,79,39,59,10,20,7,10,11,49,79,1,1,50,73,29,50,11,23,6,10,11,40,73
2009-04-06 00:00:00.000,Casablanca Morocco ATP World Tour 250,CLAY,2,Frederico Gil,Ivan Ljubicic,Frederico Gil,6-7(2); 7-5; 6-4,R16,175,5,4,62,116,49,62,27,54,5,6,17,76,116,9,4,58,106,45,58,25,48,4,7,17,70,106
2009-04-06 00:00:00.000,Casablanca Morocco ATP World Tour 250,CLAY,2,Albert Montanes,Santiago Ventura,Albert Montanes,5-7; 6-3; 7-5,R16,135,0,7,68,115,45,68,20,47,8,14,17,65,115,4,5,47,88,33,47,14,41,4,11,16,47,88
2009-04-06 00:00:00.000,Casablanca Morocco ATP World Tour 250,CLAY,2,Florent Serra,Olivier Rochus,Florent Serra,6-3; 6-3,R16,86,3,1,32,58,22,32,14,26,3,5,9,36,58,3,3,54,79,31,54,7,25,8,13,9,38,79
2009-04-06 00:00:00.000,Casablanca Morocco ATP World Tour 250,CLAY,2,Teymuraz Gabashvili,Ruben Ramirez Hidalgo,Teymuraz Gabashvili,6-4; 6-4,R16,107,4,6,49,87,37,49,18,38,7,7,10,55,87,6,4,42,71,30,42,13,29,3,5,10,43,71
2009-04-06 00:00:00.000,Casablanca Morocco ATP World Tour 250,CLAY,2,Igor Andreev,Marc Gicquel,Igor Andreev,6-1; 6-3,Q,53,5,1,27,37,24,27,8,10,0,0,8,32,37,1,3,24,50,18,24,9,26,4,8,8,27,50
2009-04-06 00:00:00.000,Casablanca Morocco ATP World Tour 250,CLAY,2,Juan Carlos Ferrero,Victor Hanescu,Juan Carlos Ferrero,6-3; 7-5,Q,93,3,0,42,51,31,42,7,9,0,1,10,38,51,5,1,59,84,35,59,12,25,8,12,11,47,84
2009-04-06 00:00:00.000,Casablanca Morocco ATP World Tour 250,CLAY,2,Albert Montanes,Frederico Gil,Albert Montanes,7-6(5); 6-4,Q,102,6,6,34,66,25,34,18,32,0,2,11,43,66,3,3,48,85,31,48,19,37,6,9,11,50,85
2009-04-06 00:00:00.000,Casablanca Morocco ATP World Tour 250,CLAY,2,Florent Serra,Teymuraz Gabashvili,Florent Serra,6-0; 6-4,Q,64,2,1,23,45,17,23,13,22,0,1,8,30,45,1,6,24,55,14,24,11,31,6,11,8,25,55
2009-04-06 00:00:00.000,Casablanca Morocco ATP World Tour 250,CLAY,2,Juan Carlos Ferrero,Igor Andreev,Juan Carlos Ferrero,7-6(9); 6-3,S,125,0,1,53,80,38,53,14,27,1,3,11,52,80,1,2,51,76,34,51,10,25,7,10,10,44,76
2009-04-06 00:00:00.000,Casablanca Morocco ATP World Tour 250,CLAY,2,Florent Serra,Albert Montanes,Florent Serra,6-4; 6-4,S,89,4,2,39,71,26,39,20,32,3,4,10,46,71,4,3,26,57,20,26,14,31,2,5,10,34,57
2009-04-06 00:00:00.000,Casablanca Morocco ATP World Tour 250,CLAY,2,Juan Carlos Ferrero,Florent Serra,Juan Carlos Ferrero,6-4; 7-5,F,97,5,3,42,59,29,42,5,17,3,7,11,34,59,0,2,47,78,25,47,14,31,6,12,11,39,78
2009-04-06 00:00:00.000,Houston TX; U.S.A. ATP World Tour 250,CLAY,2,Guillermo Canas,James Blake,Guillermo Canas,6-4; 6-4,R32,92,7,2,35,64,31,35,9,29,4,6,10,40,64,0,3,30,59,19,30,13,29,1,5,10,32,59
2009-04-06 00:00:00.000,Houston TX; U.S.A. ATP World Tour 250,CLAY,2,Taylor Dent,Marcos Daniel,Taylor Dent,4-6; 6-3; 6-2,R32,100,11,4,50,82,39,50,14,32,4,7,14,53,82,7,2,56,83,36,56,11,27,5,10,13,47,83
2009-04-06 00:00:00.000,Houston TX; U.S.A. ATP World Tour 250,CLAY,2,Evgeny Korolev,Leonardo Mayer,Evgeny Korolev,7-6(2); 2-6; 7-5,R32,152,3,7,63,117,49,63,22,54,10,14,16,71,117,6,3,60,100,42,60,20,40,2,5,16,62,100
2009-04-06 00:00:00.000,Houston TX; U.S.A. ATP World Tour 250,CLAY,2,Daniel Gimeno-Traver,Maximo Gonzalez,Daniel Gimeno-Traver,6-4; 3-6; 6-1,R32,130,1,1,53,92,34,53,24,39,5,7,13,58,92,0,4,70,104,43,70,15,34,9,13,13,58,104
2009-04-06 00:00:00.000,Houston TX; U.S.A. ATP World Tour 250,CLAY,2,Jeremy Chardy,Jesse Levine,Jeremy Chardy,6-3; 6-0,R32,61,6,1,25,45,20,25,14,20,1,1,8,34,45,3,2,25,51,14,25,11,26,5,9,7,25,51
2009-04-06 00:00:00.000,Houston TX; U.S.A. ATP World Tour 250,CLAY,2,Guillermo Garcia-Lopez,Giovanni Lapentti,Guillermo Garcia-Lopez,1-6; 6-0; 6-2,R32,100,2,4,34,62,22,34,16,28,3,6,10,38,62,0,1,43,68,22,43,9,25,7,13,11,31,68
2009-04-06 00:00:00.000,Houston TX; U.S.A. ATP World Tour 250,CLAY,2,Sergio Roitman,Agustin Calleri,Sergio Roitman,6-3; 6-3,R32,61,5,1,39,46,30,39,3,7,2,3,9,33,46,0,3,33,50,16,33,11,17,2,6,9,27,50
2009-04-06 00:00:00.000,Houston TX; U.S.A. ATP World Tour 250,CLAY,2,Lleyton Hewitt,Diego Junqueira,Lleyton Hewitt,6-0; 6-2,R32,65,4,0,22,41,20,22,10,19,2,2,7,30,41,1,2,40,58,18,40,8,18,12,17,7,26,58
2009-04-06 00:00:00.000,Houston TX; U.S.A. ATP World Tour 250,CLAY,2,Paul Capdeville,Amer Delic,Paul Capdeville,6-7(5); 7-6(5); 6-1,R32,139,1,4,74,107,54,74,22,33,2,3,16,76,107,6,3,70,114,43,70,29,44,10,13,15,72,114
2009-04-06 00:00:00.000,Houston TX; U.S.A. ATP World Tour 250,CLAY,2,John Isner,Michael Russell,John Isner,4-6; 6-3; 6-2,R32,128,10,4,52,83,45,52,13,31,4,5,14,58,83,0,1,71,92,42,71,13,21,4,7,13,55,92
2009-04-06 00:00:00.000,Houston TX; U.S.A. ATP World Tour 250,CLAY,2,Wayne Odesnik,Kevin Anderson,Wayne Odesnik,7-6(2); 6-4,R32,101,3,1,37,67,25,37,24,30,1,1,11,49,67,3,2,52,68,37,52,7,16,1,2,11,44,68
2009-04-06 00:00:00.000,Houston TX; U.S.A. ATP World Tour 250,CLAY,2,Jurgen Melzer,Robert Kendrick,Jurgen Melzer,6-1; 7-5,R32,67,2,3,33,53,24,33,9,20,2,4,9,33,53,3,5,37,59,20,37,8,22,3,9,10,28,59
2009-04-06 00:00:00.000,Houston TX; U.S.A. ATP World Tour 250,CLAY,2,Marcel Granollers,Brian Dabul,Marcel Granollers,2-6; 6-4; 6-1,R32,120,4,3,51,90,34,51,20,39,5,8,13,54,90,0,2,47,73,30,47,13,26,8,12,12,43,73
2009-04-06 00:00:00.000,Houston TX; U.S.A. ATP World Tour 250,CLAY,2,Tommy Haas,Denis Gremelmayr,Tommy Haas,6-3; 6-3,R32,82,3,2,35,54,26,35,10,19,4,6,9,36,54,0,5,34,61,19,34,9,27,5,10,9,28,61
2009-04-06 00:00:00.000,Houston TX; U.S.A. ATP World Tour 250,CLAY,2,Scoville Jenkins,Alexander Peya,Scoville Jenkins,0-6; 6-4; 6-3,R32,116,0,7,46,80,26,46,17,34,7,12,13,43,80,5,2,54,82,30,54,17,28,5,9,12,47,82
2009-04-06 00:00:00.000,Houston TX; U.S.A. ATP World Tour 250,CLAY,2,Bjorn Phau,Mardy Fish,Bjorn Phau,6-3; 5-7; 6-3,R32,121,7,1,39,81,32,39,27,42,4,6,15,59,81,6,1,52,84,36,52,18,32,2,6,15,54,84
2009-04-06 00:00:00.000,Houston TX; U.S.A. ATP World Tour 250,CLAY,2,Guillermo Canas,Taylor Dent,Guillermo Canas,6-2; 6-2,R16,61,4,2,26,43,22,26,10,17,3,4,8,32,43,0,3,25,50,15,25,9,25,6,11,8,24,50
2009-04-06 00:00:00.000,Houston TX; U.S.A. ATP World Tour 250,CLAY,2,Evgeny Korolev,Daniel Gimeno-Traver,Evgeny Korolev,6-3; 7-6(4),R16,80,2,2,33,60,28,33,14,27,0,2,11,42,60,8,3,36,63,25,36,14,27,3,6,10,39,63
2009-04-06 00:00:00.000,Houston TX; U.S.A. ATP World Tour 250,CLAY,2,Guillermo Garcia-Lopez,Jeremy Chardy,Guillermo Garcia-Lopez,6-1; 6-0,R16,56,2,2,22,40,16,22,9,18,2,3,6,25,40,1,5,19,39,5,19,5,20,6,13,7,10,39
2009-04-06 00:00:00.000,Houston TX; U.S.A. ATP World Tour 250,CLAY,2,Lleyton Hewitt,Sergio Roitman,Lleyton Hewitt,6-1; 6-3,R16,57,5,4,22,43,16,22,10,21,1,4,8,26,43,0,2,31,42,11,31,1,11,0,7,8,12,42
2009-04-06 00:00:00.000,Houston TX; U.S.A. ATP World Tour 250,CLAY,2,John Isner,Paul Capdeville,John Isner,4-6; 7-6(1); 7-6(5),R16,160,24,5,90,132,72,90,20,42,6,7,17,92,132,9,5,60,102,47,60,30,42,3,3,17,77,102
2009-04-06 00:00:00.000,Houston TX; U.S.A. ATP World Tour 250,CLAY,2,Wayne Odesnik,Jurgen Melzer,Wayne Odesnik,6-4; 6-0,R16,62,5,1,27,43,19,27,15,16,2,2,8,34,43,1,3,24,47,14,24,9,23,3,7,8,23,47
2009-04-06 00:00:00.000,Houston TX; U.S.A. ATP World Tour 250,CLAY,2,Tommy Haas,Marcel Granollers,Tommy Haas,4-6; 6-2; 6-3,R16,115,6,4,51,81,36,51,18,30,2,4,14,54,81,2,2,50,79,32,50,17,29,4,8,13,49,79
2009-04-06 00:00:00.000,Houston TX; U.S.A. ATP World Tour 250,CLAY,2,Bjorn Phau,Scoville Jenkins,Bjorn Phau,6-4; 7-6(2),R16,108,1,2,29,67,24,29,23,38,2,3,11,47,67,4,2,45,79,33,45,15,34,5,7,11,48,79
2009-04-06 00:00:00.000,Houston TX; U.S.A. ATP World Tour 250,CLAY,2,Evgeny Korolev,Guillermo Canas,Evgeny Korolev,2-6; 6-3; 6-4,Q,121,4,2,38,69,26,38,14,31,2,7,13,40,69,4,3,49,87,33,49,14,38,5,11,14,47,87
2009-04-06 00:00:00.000,Houston TX; U.S.A. ATP World Tour 250,CLAY,2,Lleyton Hewitt,Guillermo Garcia-Lopez,Lleyton Hewitt,6-3; 6-4,Q,104,8,6,39,73,29,39,16,34,7,9,10,45,73,2,3,34,67,23,34,12,33,8,12,9,35,67
2009-04-06 00:00:00.000,Houston TX; U.S.A. ATP World Tour 250,CLAY,2,Wayne Odesnik,John Isner,Wayne Odesnik,7-5; 3-6; 7-6(5),Q,158,9,1,48,92,38,48,32,44,4,5,16,70,92,14,3,56,96,42,56,28,40,2,3,17,70,96
2009-04-06 00:00:00.000,Houston TX; U.S.A. ATP World Tour 250,CLAY,2,Bjorn Phau,Tommy Haas,Bjorn Phau,6-3; 3-6; 6-3,Q,116,5,6,41,78,27,41,23,37,2,5,13,50,78,8,7,50,94,38,50,17,44,5,10,14,55,94
2009-04-06 00:00:00.000,Houston TX; U.S.A. ATP World Tour 250,CLAY,2,Lleyton Hewitt,Evgeny Korolev,Lleyton Hewitt,7-6(4); 6-4,S,93,3,3,38,68,31,38,19,30,0,0,11,50,68,4,1,43,71,30,43,16,28,2,3,11,46,71
2009-04-06 00:00:00.000,Houston TX; U.S.A. ATP World Tour 250,CLAY,2,Wayne Odesnik,Bjorn Phau,Wayne Odesnik,6-4; 6-3,S,103,7,1,43,66,30,43,10,23,4,6,10,40,66,3,2,28,68,17,28,19,40,4,8,9,36,68
2009-04-06 00:00:00.000,Houston TX; U.S.A. ATP World Tour 250,CLAY,2,Lleyton Hewitt,Wayne Odesnik,Lleyton Hewitt,6-2; 7-5,F,124,3,7,22,65,18,22,17,43,2,6,10,35,65,4,2,40,80,19,40,15,40,9,16,10,34,80
2009-04-12 00:00:00.000,ATP World Tour Masters 1000 Monte Carlo Monaco ATP World Tour Masters 1000,CLAY,2,Rafael Nadal,N/A Bye,Rafael Nadal,,R64,0,0,0,0,0,0,0,0,0,0,0,0,0,0,0,0,0,0,0,0,0,0,0,0,0,0,0
2009-04-12 00:00:00.000,ATP World Tour Masters 1000 Monte Carlo Monaco ATP World Tour Masters 1000,CLAY,2,Juan Ignacio Chela,Igor Kunitsyn,Juan Ignacio Chela,6-4; 2-6; 7-5,R64,143,1,4,66,106,38,66,20,40,11,17,15,58,106,0,0,81,98,47,81,9,17,13,19,15,56,98
2009-04-12 00:00:00.000,ATP World Tour Masters 1000 Monte Carlo Monaco ATP World Tour Masters 1000,CLAY,2,Marat Safin,Lleyton Hewitt,Marat Safin,6-4; 7-5,R64,96,10,3,42,66,30,42,11,24,4,6,11,41,66,2,4,27,62,20,27,17,35,4,8,11,37,62
2009-04-12 00:00:00.000,ATP World Tour Masters 1000 Monte Carlo Monaco ATP World Tour Masters 1000,CLAY,2,Nicolas Lapentti,Radek Stepanek,Nicolas Lapentti,6-3; 1-6; 6-3,R64,114,1,4,45,78,29,45,17,33,4,8,13,46,78,6,6,48,74,34,48,9,26,3,7,12,43,74
2009-04-12 00:00:00.000,ATP World Tour Masters 1000 Monte Carlo Monaco ATP World Tour Masters 1000,CLAY,2,Janko Tipsarevic,Gael Monfils,Janko Tipsarevic,6-3; 6-1,R64,67,0,3,19,48,12,19,19,29,1,2,8,31,48,2,4,26,52,14,26,9,26,3,8,8,23,52
2009-04-12 00:00:00.000,ATP World Tour Masters 1000 Monte Carlo Monaco ATP World Tour Masters 1000,CLAY,2,Simone Bolelli,Robin Soderling,Simone Bolelli,6-4; 1-6; 6-3,R64,124,6,2,43,83,31,43,20,40,1,4,13,51,83,3,6,39,87,27,39,24,48,8,11,13,51,87
2009-04-12 00:00:00.000,ATP World Tour Masters 1000 Monte Carlo Monaco ATP World Tour Masters 1000,CLAY,2,Ivan Ljubicic,Kristof Vliegen,Ivan Ljubicic,6-4; 6-7(5); 6-4,R64,150,4,3,60,98,43,60,20,38,1,4,16,63,98,8,6,64,114,46,64,23,50,7,12,16,69,114
2009-04-12 00:00:00.000,ATP World Tour Masters 1000 Monte Carlo Monaco ATP World Tour Masters 1000,CLAY,2,Juan Martin Del Potro,N/A Bye,Juan Martin Del Potro,,R64,0,0,0,0,0,0,0,0,0,0,0,0,0,0,0,0,0,0,0,0,0,0,0,0,0,0,0
2009-04-12 00:00:00.000,ATP World Tour Masters 1000 Monte Carlo Monaco ATP World Tour Masters 1000,CLAY,2,Andy Murray,N/A Bye,Andy Murray,,R64,0,0,0,0,0,0,0,0,0,0,0,0,0,0,0,0,0,0,0,0,0,0,0,0,0,0,0
2009-04-12 00:00:00.000,ATP World Tour Masters 1000 Monte Carlo Monaco ATP World Tour Masters 1000,CLAY,2,Victor Hanescu,Alberto Martin,Victor Hanescu,6-2; 6-3,R64,77,2,2,38,64,24,38,14,26,2,4,9,38,64,1,3,27,48,14,27,7,21,1,6,8,21,48
2009-04-12 00:00:00.000,ATP World Tour Masters 1000 Monte Carlo Monaco ATP World Tour Masters 1000,CLAY,2,Fabio Fognini,Tomas Berdych,Fabio Fognini,1-6; 6-3; 6-3,R64,119,4,5,38,81,22,38,23,43,5,10,13,45,81,2,0,45,70,29,45,8,25,5,10,12,37,70
2009-04-12 00:00:00.000,ATP World Tour Masters 1000 Monte Carlo Monaco ATP World Tour Masters 1000,CLAY,2,Marin Cilic,Flavio Cipolla,Marin Cilic,6-3; 6-2,R64,84,4,3,25,57,18,25,14,32,6,9,8,32,57,0,6,46,65,22,46,5,19,11,18,9,27,65
2009-04-12 00:00:00.000,ATP World Tour Masters 1000 Monte Carlo Monaco ATP World Tour Masters 1000,CLAY,2,David Nalbandian,Paul-Henri Mathieu,David Nalbandian,6-4; 3-6; 6-3,R64,120,9,10,38,80,29,38,20,42,3,7,14,49,80,1,4,70,107,37,70,21,37,6,11,14,58,107
2009-04-12 00:00:00.000,ATP World Tour Masters 1000 Monte Carlo Monaco ATP World Tour Masters 1000,CLAY,2,Marcel Granollers,Jose Acasuso,Marcel Granollers,7-6(4); 7-6(2),R64,135,2,3,56,90,40,56,14,34,4,8,12,54,90,2,9,45,94,26,45,25,49,5,9,12,51,94
2009-04-12 00:00:00.000,ATP World Tour Masters 1000 Monte Carlo Monaco ATP World Tour Masters 1000,CLAY,2,Ivo Karlovic,Florent Serra,Ivo Karlovic,6-4; 6-4,R64,78,11,1,33,52,29,33,12,19,0,0,10,41,52,2,2,57,88,41,57,10,31,10,12,10,51,88
2009-04-12 00:00:00.000,ATP World Tour Masters 1000 Monte Carlo Monaco ATP World Tour Masters 1000,CLAY,2,Nikolay Davydenko,N/A Bye,Nikolay Davydenko,,R64,0,0,0,0,0,0,0,0,0,0,0,0,0,0,0,0,0,0,0,0,0,0,0,0,0,0,0
2009-04-12 00:00:00.000,ATP World Tour Masters 1000 Monte Carlo Monaco ATP World Tour Masters 1000,CLAY,2,Fernando Verdasco,N/A Bye,Fernando Verdasco,,R64,0,0,0,0,0,0,0,0,0,0,0,0,0,0,0,0,0,0,0,0,0,0,0,0,0,0,0
2009-04-12 00:00:00.000,ATP World Tour Masters 1000 Monte Carlo Monaco ATP World Tour Masters 1000,CLAY,2,Philipp Kohlschreiber,Ernests Gulbis,Philipp Kohlschreiber,6-1; 6-3,R64,63,0,0,35,51,25,35,9,16,0,1,8,34,51,2,2,21,42,11,21,7,21,1,6,8,18,42
2009-04-12 00:00:00.000,ATP World Tour Masters 1000 Monte Carlo Monaco ATP World Tour Masters 1000,CLAY,2,Marc Gicquel,Eduardo Schwank,Marc Gicquel,3-6; 6-1; 7-6(2),R64,144,6,5,60,106,45,60,20,46,8,11,14,65,106,6,4,48,95,32,48,22,47,10,14,14,54,95
2009-04-12 00:00:00.000,ATP World Tour Masters 1000 Monte Carlo Monaco ATP World Tour Masters 1000,CLAY,2,David Ferrer,Feliciano Lopez,David Ferrer,6-2; 6-3,R64,69,1,1,35,53,25,35,13,18,1,2,9,38,53,0,1,25,43,17,25,5,18,0,4,8,22,43
2009-04-12 00:00:00.000,ATP World Tour Masters 1000 Monte Carlo Monaco ATP World Tour Masters 1000,CLAY,2,Albert Montanes,Nicolas Almagro,Albert Montanes,7-6(6); 4-6; 7-6(5),R64,150,1,10,63,121,42,63,30,58,5,10,17,72,121,12,2,54,106,41,54,28,52,5,9,17,69,106
2009-04-12 00:00:00.000,ATP World Tour Masters 1000 Monte Carlo Monaco ATP World Tour Masters 1000,CLAY,2,Jean-Rene Lisnard,Christophe Rochus,Jean-Rene Lisnard,6-2; 6-2,R64,71,5,1,23,53,18,23,17,30,2,3,8,35,53,0,2,17,52,10,17,14,35,6,11,8,24,52
2009-04-12 00:00:00.000,ATP World Tour Masters 1000 Monte Carlo Monaco ATP World Tour Masters 1000,CLAY,2,Oscar Hernandez,Julien Benneteau,Oscar Hernandez,6-4; 6-4,R64,99,2,2,33,52,23,33,11,19,1,3,10,34,52,2,9,42,64,31,42,4,22,3,7,10,35,64
2009-04-12 00:00:00.000,ATP World Tour Masters 1000 Monte Carlo Monaco ATP World Tour Masters 1000,CLAY,2,Novak Djokovic,N/A Bye,Novak Djokovic,,R64,0,0,0,0,0,0,0,0,0,0,0,0,0,0,0,0,0,0,0,0,0,0,0,0,0,0,0
2009-04-12 00:00:00.000,ATP World Tour Masters 1000 Monte Carlo Monaco ATP World Tour Masters 1000,CLAY,2,Gilles Simon,N/A Bye,Gilles Simon,,R64,0,0,0,0,0,0,0,0,0,0,0,0,0,0,0,0,0,0,0,0,0,0,0,0,0,0,0
2009-04-12 00:00:00.000,ATP World Tour Masters 1000 Monte Carlo Monaco ATP World Tour Masters 1000,CLAY,2,Andreas Beck,Nicolas Kiefer,Andreas Beck,1-6; 7-6(1); 6-4,R64,149,8,1,60,96,45,60,15,36,7,10,14,60,96,11,11,53,109,40,53,28,56,10,12,15,68,109
2009-04-12 00:00:00.000,ATP World Tour Masters 1000 Monte Carlo Monaco ATP World Tour Masters 1000,CLAY,2,Juan Monaco,Jeremy Chardy,Juan Monaco,6-2; 7-5,R64,100,1,6,34,64,25,34,18,30,3,4,10,43,64,6,3,46,85,28,46,17,39,9,13,10,45,85
2009-04-12 00:00:00.000,ATP World Tour Masters 1000 Monte Carlo Monaco ATP World Tour Masters 1000,CLAY,2,Tommy Robredo,Rainer Schuettler,Tommy Robredo,6-1; 6-4,R64,71,0,4,30,47,24,30,8,17,2,3,8,32,47,1,3,35,58,18,35,10,23,5,10,9,28,58
2009-04-12 00:00:00.000,ATP World Tour Masters 1000 Monte Carlo Monaco ATP World Tour Masters 1000,CLAY,2,Stanislas Wawrinka,Viktor Troicki,Stanislas Wawrinka,6-2; 6-3,R64,65,0,1,25,44,19,25,12,19,1,3,9,31,44,4,3,20,51,11,20,11,31,3,8,8,22,51
2009-04-12 00:00:00.000,ATP World Tour Masters 1000 Monte Carlo Monaco ATP World Tour Masters 1000,CLAY,2,Martin Vassallo Arguello,Igor Andreev,Martin Vassallo Arguello,2-6; 7-6(5); 6-2,R64,142,2,5,63,93,41,63,14,30,2,6,14,55,93,3,3,63,100,36,63,22,37,3,7,14,58,100
2009-04-12 00:00:00.000,ATP World Tour Masters 1000 Monte Carlo Monaco ATP World Tour Masters 1000,CLAY,2,Andreas Seppi,Jurgen Melzer,Andreas Seppi,6-2; 6-0,R64,63,4,2,27,40,20,27,9,13,0,0,7,29,40,4,2,24,57,11,24,14,33,7,12,7,25,57
2009-04-12 00:00:00.000,ATP World Tour Masters 1000 Monte Carlo Monaco ATP World Tour Masters 1000,CLAY,2,Roger Federer,N/A Bye,Roger Federer,,R64,0,0,0,0,0,0,0,0,0,0,0,0,0,0,0,0,0,0,0,0,0,0,0,0,0,0,0
2009-04-12 00:00:00.000,ATP World Tour Masters 1000 Monte Carlo Monaco ATP World Tour Masters 1000,CLAY,2,Rafael Nadal,Juan Ignacio Chela,Rafael Nadal,6-2; 6-3,R32,86,2,3,31,55,22,31,13,24,5,7,9,35,55,0,5,23,47,13,23,10,24,4,9,8,23,47
2009-04-12 00:00:00.000,ATP World Tour Masters 1000 Monte Carlo Monaco ATP World Tour Masters 1000,CLAY,2,Nicolas Lapentti,Marat Safin,Nicolas Lapentti,7-6(6); 2-6; 7-6(6),R32,209,3,3,77,129,51,77,23,52,13,19,16,74,129,9,4,59,114,44,59,22,55,6,10,16,66,114
2009-04-12 00:00:00.000,ATP World Tour Masters 1000 Monte Carlo Monaco ATP World Tour Masters 1000,CLAY,2,Simone Bolelli,Janko Tipsarevic,Simone Bolelli,7-5; 6-3,R32,102,4,0,40,65,31,40,15,25,4,4,11,46,65,8,3,31,66,23,31,16,35,5,7,10,39,66
2009-04-12 00:00:00.000,ATP World Tour Masters 1000 Monte Carlo Monaco ATP World Tour Masters 1000,CLAY,2,Ivan Ljubicic,Juan Martin Del Potro,Ivan Ljubicic,4-6; 6-1; 6-4,R32,147,14,1,55,93,44,55,14,38,7,10,14,58,93,6,6,47,100,28,47,26,53,8,13,13,54,100
2009-04-12 00:00:00.000,ATP World Tour Masters 1000 Monte Carlo Monaco ATP World Tour Masters 1000,CLAY,2,Andy Murray,Victor Hanescu,Andy Murray,6-3; 6-2,R32,86,2,1,38,62,28,38,10,24,4,6,9,38,62,1,2,32,52,16,32,7,20,5,10,8,23,52
2009-04-12 00:00:00.000,ATP World Tour Masters 1000 Monte Carlo Monaco ATP World Tour Masters 1000,CLAY,2,Fabio Fognini,Marin Cilic,Fabio Fognini,6-2; 6-0,R32,67,1,5,17,43,15,17,13,26,2,3,7,28,43,0,2,29,53,11,29,9,24,7,13,7,20,53
2009-04-12 00:00:00.000,ATP World Tour Masters 1000 Monte Carlo Monaco ATP World Tour Masters 1000,CLAY,2,David Nalbandian,Marcel Granollers,David Nalbandian,4-6; 6-3; 6-1,R32,128,1,3,41,78,26,41,20,37,3,7,13,46,78,1,3,50,99,28,50,18,49,13,20,13,46,99
2009-04-12 00:00:00.000,ATP World Tour Masters 1000 Monte Carlo Monaco ATP World Tour Masters 1000,CLAY,2,Nikolay Davydenko,Ivo Karlovic,Nikolay Davydenko,6-4; 6-3,R32,82,0,4,36,53,25,36,12,17,7,8,9,37,53,8,3,38,63,27,38,9,25,12,16,10,36,63
2009-04-12 00:00:00.000,ATP World Tour Masters 1000 Monte Carlo Monaco ATP World Tour Masters 1000,CLAY,2,Fernando Verdasco,Philipp Kohlschreiber,Fernando Verdasco,6-3; 6-4,R32,83,0,5,44,63,34,44,11,19,2,2,10,45,63,2,1,34,49,22,34,10,15,1,3,9,32,49
2009-04-12 00:00:00.000,ATP World Tour Masters 1000 Monte Carlo Monaco ATP World Tour Masters 1000,CLAY,2,David Ferrer,Marc Gicquel,David Ferrer,6-1; 6-0,R32,49,1,1,18,37,14,18,14,19,0,0,7,28,37,1,4,18,32,6,18,4,14,2,7,6,10,32
2009-04-12 00:00:00.000,ATP World Tour Masters 1000 Monte Carlo Monaco ATP World Tour Masters 1000,CLAY,2,Albert Montanes,Jean-Rene Lisnard,Albert Montanes,6-2; 6-4,R32,81,1,4,26,48,20,26,11,22,0,2,9,31,48,2,3,28,64,24,28,8,36,8,13,9,32,64
2009-04-12 00:00:00.000,ATP World Tour Masters 1000 Monte Carlo Monaco ATP World Tour Masters 1000,CLAY,2,Novak Djokovic,Oscar Hernandez,Novak Djokovic,6-1; 6-2,R32,79,1,1,26,43,21,26,9,17,1,2,8,30,43,0,2,37,59,20,37,7,22,9,14,7,27,59
2009-04-12 00:00:00.000,ATP World Tour Masters 1000 Monte Carlo Monaco ATP World Tour Masters 1000,CLAY,2,Andreas Beck,Gilles Simon,Andreas Beck,7-5; 6-1,R32,81,0,7,26,55,18,26,16,29,3,5,9,34,55,2,5,23,64,14,23,16,41,4,10,10,30,64
2009-04-12 00:00:00.000,ATP World Tour Masters 1000 Monte Carlo Monaco ATP World Tour Masters 1000,CLAY,2,Juan Monaco,Tommy Robredo,Juan Monaco,6-2; 6-4,R32,86,1,1,49,61,31,49,5,12,4,6,9,36,61,1,4,25,50,10,25,16,25,1,6,9,26,50
2009-04-12 00:00:00.000,ATP World Tour Masters 1000 Monte Carlo Monaco ATP World Tour Masters 1000,CLAY,2,Stanislas Wawrinka,Martin Vassallo Arguello,Stanislas Wawrinka,2-6; 7-5; 6-2,R32,158,0,1,54,92,37,54,18,38,5,9,14,55,92,1,6,48,84,29,48,18,36,5,10,14,47,84
2009-04-12 00:00:00.000,ATP World Tour Masters 1000 Monte Carlo Monaco ATP World Tour Masters 1000,CLAY,2,Roger Federer,Andreas Seppi,Roger Federer,6-4; 6-4,R32,83,4,0,30,64,26,30,20,34,3,3,10,46,64,1,4,35,65,24,35,17,30,3,5,10,41,65
2009-04-12 00:00:00.000,ATP World Tour Masters 1000 Monte Carlo Monaco ATP World Tour Masters 1000,CLAY,2,Rafael Nadal,Nicolas Lapentti,Rafael Nadal,6-3; 6-0,R16,92,1,1,30,43,18,30,6,13,2,4,7,24,43,1,2,38,63,21,38,3,25,7,14,8,24,63
2009-04-12 00:00:00.000,ATP World Tour Masters 1000 Monte Carlo Monaco ATP World Tour Masters 1000,CLAY,2,Ivan Ljubicic,Simone Bolelli,Ivan Ljubicic,7-5; 7-6(2),R16,118,14,0,47,85,37,47,20,38,5,6,12,57,85,2,3,47,73,33,47,15,26,4,6,12,48,73
2009-04-12 00:00:00.000,ATP World Tour Masters 1000 Monte Carlo Monaco ATP World Tour Masters 1000,CLAY,2,Andy Murray,Fabio Fognini,Andy Murray,7-6(11); 6-4,R16,122,3,1,58,83,36,58,14,25,6,9,11,50,83,1,4,56,85,31,56,15,29,8,12,11,46,85
2009-04-12 00:00:00.000,ATP World Tour Masters 1000 Monte Carlo Monaco ATP World Tour Masters 1000,CLAY,2,Nikolay Davydenko,David Nalbandian,Nikolay Davydenko,6-4; 5-7; 6-3,R16,152,1,5,64,95,38,64,15,31,8,14,16,53,95,5,6,55,110,35,55,21,55,12,19,15,56,110
2009-04-12 00:00:00.000,ATP World Tour Masters 1000 Monte Carlo Monaco ATP World Tour Masters 1000,CLAY,2,Fernando Verdasco,David Ferrer,Fernando Verdasco,6-2; 6-1,R16,62,0,3,31,39,23,31,2,8,0,1,7,25,39,0,0,23,49,12,23,8,26,4,10,8,20,49
2009-04-12 00:00:00.000,ATP World Tour Masters 1000 Monte Carlo Monaco ATP World Tour Masters 1000,CLAY,2,Novak Djokovic,Albert Montanes,Novak Djokovic,6-1; 6-7(4); 6-0,R16,105,5,1,53,77,40,53,8,24,0,2,13,48,77,4,5,52,86,31,52,10,34,10,17,12,41,86
2009-04-12 00:00:00.000,ATP World Tour Masters 1000 Monte Carlo Monaco ATP World Tour Masters 1000,CLAY,2,Andreas Beck,Juan Monaco,Andreas Beck,3-6; 6-2; 7-5,R16,127,2,4,57,98,38,57,19,41,4,9,15,57,98,3,4,59,82,37,59,8,23,3,9,14,45,82
2009-04-12 00:00:00.000,ATP World Tour Masters 1000 Monte Carlo Monaco ATP World Tour Masters 1000,CLAY,2,Stanislas Wawrinka,Roger Federer,Stanislas Wawrinka,6-4; 7-5,R16,110,0,1,48,77,33,48,17,29,3,4,11,50,77,2,1,44,85,29,44,21,41,11,14,11,50,85
2009-04-12 00:00:00.000,ATP World Tour Masters 1000 Monte Carlo Monaco ATP World Tour Masters 1000,CLAY,2,Rafael Nadal,Ivan Ljubicic,Rafael Nadal,6-3; 6-3,Q,73,2,1,37,52,29,37,7,15,0,1,9,36,52,4,0,22,43,17,22,8,21,2,6,9,25,43
2009-04-12 00:00:00.000,ATP World Tour Masters 1000 Monte Carlo Monaco ATP World Tour Masters 1000,CLAY,2,Andy Murray,Nikolay Davydenko,Andy Murray,7-6(1); 6-4,Q,129,4,2,43,84,29,43,20,41,6,9,11,49,84,0,1,68,86,37,68,9,18,5,9,11,46,86
2009-04-12 00:00:00.000,ATP World Tour Masters 1000 Monte Carlo Monaco ATP World Tour Masters 1000,CLAY,2,Novak Djokovic,Fernando Verdasco,Novak Djokovic,6-2; 4-6; 6-3,Q,138,4,5,54,87,42,54,17,33,4,6,14,59,87,2,5,56,82,34,56,14,26,6,10,13,48,82
2009-04-12 00:00:00.000,ATP World Tour Masters 1000 Monte Carlo Monaco ATP World Tour Masters 1000,CLAY,2,Stanislas Wawrinka,Andreas Beck,Stanislas Wawrinka,6-2; 6-4,Q,89,6,4,33,51,27,33,9,18,3,4,9,36,51,2,3,39,70,26,39,10,31,7,11,9,36,70
2009-04-12 00:00:00.000,ATP World Tour Masters 1000 Monte Carlo Monaco ATP World Tour Masters 1000,CLAY,2,Rafael Nadal,Andy Murray,Rafael Nadal,6-2; 7-6(4),S,129,0,1,40,65,27,40,14,25,2,4,10,41,65,1,0,37,74,24,37,14,37,5,9,10,38,74
2009-04-12 00:00:00.000,ATP World Tour Masters 1000 Monte Carlo Monaco ATP World Tour Masters 1000,CLAY,2,Novak Djokovic,Stanislas Wawrinka,Novak Djokovic,4-6; 6-1; 6-3,S,147,1,4,46,81,35,46,17,35,4,6,13,52,81,1,3,60,97,36,60,16,37,9,14,13,52,97
2009-04-12 00:00:00.000,ATP World Tour Masters 1000 Monte Carlo Monaco ATP World Tour Masters 1000,CLAY,2,Rafael Nadal,Novak Djokovic,Rafael Nadal,6-3; 2-6; 6-1,F,163,2,1,57,87,35,57,14,30,6,11,12,49,87,4,3,54,87,30,54,11,33,7,14,12,41,87
2009-04-20 00:00:00.000,Barcelona Spain ATP World Tour 500,CLAY,2,Rafael Nadal,N/A Bye,Rafael Nadal,,R64,0,0,0,0,0,0,0,0,0,0,0,0,0,0,0,0,0,0,0,0,0,0,0,0,0,0,0
2009-04-20 00:00:00.000,Barcelona Spain ATP World Tour 500,CLAY,2,Frederico Gil,Yen-Hsun Lu,Frederico Gil,6-2; 6-1,R64,62,0,2,25,42,20,25,12,17,0,0,8,32,42,2,1,27,42,15,27,6,15,0,4,7,21,42
2009-04-20 00:00:00.000,Barcelona Spain ATP World Tour 500,CLAY,2,Christophe Rochus,Nicolas Devilder,Christophe Rochus,6-4; 6-4,R64,94,4,0,38,72,28,38,18,34,5,6,10,46,72,6,2,38,65,23,38,15,27,9,12,10,38,65
2009-04-20 00:00:00.000,Barcelona Spain ATP World Tour 500,CLAY,2,Richard Gasquet,Jan Hernych,Richard Gasquet,4-6; 6-3; 6-2,R64,110,7,3,51,80,37,51,17,29,1,3,14,54,80,6,2,47,72,30,47,14,25,3,7,13,44,72
2009-04-20 00:00:00.000,Barcelona Spain ATP World Tour 500,CLAY,2,Nicolas Almagro,Victor Hanescu,Nicolas Almagro,3-6; 7-6(7); 2-2 RET,R64,122,8,3,46,78,37,46,16,32,4,5,12,53,78,5,1,67,95,46,67,16,28,6,6,13,62,95
2009-04-20 00:00:00.000,Barcelona Spain ATP World Tour 500,CLAY,2,Juan Ignacio Chela,Thomaz Bellucci,Juan Ignacio Chela,6-2; 3-6; 6-4,R64,126,2,2,53,78,40,53,13,25,4,6,13,53,78,3,0,49,77,30,49,17,28,1,5,14,47,77
2009-04-20 00:00:00.000,Barcelona Spain ATP World Tour 500,CLAY,2,Igor Kunitsyn,Juan Carlos Ferrero,Igor Kunitsyn,7-5; 7-6(3),R64,115,4,0,72,83,42,72,7,11,5,8,12,49,83,2,1,66,89,39,66,9,23,8,12,12,48,89
2009-04-20 00:00:00.000,Barcelona Spain ATP World Tour 500,CLAY,2,David Nalbandian,N/A Bye,David Nalbandian,,R64,0,0,0,0,0,0,0,0,0,0,0,0,0,0,0,0,0,0,0,0,0,0,0,0,0,0,0
2009-04-20 00:00:00.000,Barcelona Spain ATP World Tour 500,CLAY,2,Nikolay Davydenko,N/A Bye,Nikolay Davydenko,,R64,0,0,0,0,0,0,0,0,0,0,0,0,0,0,0,0,0,0,0,0,0,0,0,0,0,0,0
2009-04-20 00:00:00.000,Barcelona Spain ATP World Tour 500,CLAY,2,Arnaud Clement,Guillermo Canas,Arnaud Clement,7-6(0); 6-3,R64,113,5,1,44,60,36,44,6,16,2,4,10,42,60,2,2,41,76,24,41,16,35,6,10,11,40,76
2009-04-20 00:00:00.000,Barcelona Spain ATP World Tour 500,CLAY,2,Santiago Ventura,Marcel Granollers,Santiago Ventura,7-6(3); 6-3,R64,116,5,0,38,76,29,38,22,38,5,7,11,51,76,4,2,50,80,33,50,13,30,7,10,10,46,80
2009-04-20 00:00:00.000,Barcelona Spain ATP World Tour 500,CLAY,2,Feliciano Lopez,Jarkko Nieminen,Feliciano Lopez,6-2; 6-1,R64,52,8,3,23,40,19,23,11,17,2,2,7,30,40,3,2,28,44,15,28,5,16,1,6,8,20,44
2009-04-20 00:00:00.000,Barcelona Spain ATP World Tour 500,CLAY,2,Radek Stepanek,Guillermo Garcia-Lopez,Radek Stepanek,6-4; 2-6; 6-4,R64,125,3,4,66,94,48,66,15,28,11,13,14,63,94,2,5,56,91,36,56,21,35,7,9,14,57,91
2009-04-20 00:00:00.000,Barcelona Spain ATP World Tour 500,CLAY,2,Janko Tipsarevic,Albert Montanes,Janko Tipsarevic,6-4; 7-6(1),R64,123,7,1,48,84,35,48,18,36,7,9,11,53,84,3,2,44,76,29,44,14,32,6,9,11,43,76
2009-04-20 00:00:00.000,Barcelona Spain ATP World Tour 500,CLAY,2,Mikhail Youzhny,Viktor Troicki,Mikhail Youzhny,6-7(5); 7-6(6); 6-3,R64,164,1,1,90,121,61,90,13,31,3,7,17,74,121,13,2,78,121,53,78,20,43,9,14,16,73,121
2009-04-20 00:00:00.000,Barcelona Spain ATP World Tour 500,CLAY,2,Stanislas Wawrinka,N/A Bye,Stanislas Wawrinka,,R64,0,0,0,0,0,0,0,0,0,0,0,0,0,0,0,0,0,0,0,0,0,0,0,0,0,0,0
2009-04-20 00:00:00.000,Barcelona Spain ATP World Tour 500,CLAY,2,Tommy Robredo,N/A Bye,Tommy Robredo,,R64,0,0,0,0,0,0,0,0,0,0,0,0,0,0,0,0,0,0,0,0,0,0,0,0,0,0,0
2009-04-20 00:00:00.000,Barcelona Spain ATP World Tour 500,CLAY,2,Gaston Gaudio,Diego Junqueira,Gaston Gaudio,6-4; 3-6; 6-4,R64,134,5,2,62,100,36,62,20,38,6,11,14,56,100,3,3,50,83,31,50,15,33,1,7,15,46,83
2009-04-20 00:00:00.000,Barcelona Spain ATP World Tour 500,CLAY,2,Alberto Martin,Marc Gicquel,Alberto Martin,6-3; 6-4,R64,83,4,3,37,60,26,37,12,23,5,8,10,38,60,1,0,48,70,25,48,8,22,8,13,9,33,70
2009-04-20 00:00:00.000,Barcelona Spain ATP World Tour 500,CLAY,2,Igor Andreev,Andreas Seppi,Igor Andreev,6-3; 3-6; 7-5,R64,131,9,5,56,98,35,56,22,42,5,9,15,57,98,4,1,63,87,41,63,11,24,3,8,15,52,87
2009-04-20 00:00:00.000,Barcelona Spain ATP World Tour 500,CLAY,2,Robin Soderling,Teymuraz Gabashvili,Robin Soderling,6-1; 6-4,R64,61,7,2,33,50,25,33,11,17,1,2,9,36,50,3,2,27,47,15,27,9,20,4,8,8,24,47
2009-04-20 00:00:00.000,Barcelona Spain ATP World Tour 500,CLAY,2,Potito Starace,Ernests Gulbis,Potito Starace,4-6; 6-3; 6-3,R64,105,1,1,51,74,34,51,17,23,5,8,14,51,74,1,4,59,91,36,59,15,32,4,9,14,51,91
2009-04-20 00:00:00.000,Barcelona Spain ATP World Tour 500,CLAY,2,Mikhail Kukushkin,Pere Riba,Mikhail Kukushkin,6-2; 7-6(5),R64,94,5,1,47,74,33,47,14,27,5,6,10,47,74,6,1,29,59,24,29,13,30,1,4,10,37,59
2009-04-20 00:00:00.000,Barcelona Spain ATP World Tour 500,CLAY,2,David Ferrer,N/A Bye,David Ferrer,,R64,0,0,0,0,0,0,0,0,0,0,0,0,0,0,0,0,0,0,0,0,0,0,0,0,0,0,0
2009-04-20 00:00:00.000,Barcelona Spain ATP World Tour 500,CLAY,2,Fernando Gonzalez,N/A Bye,Fernando Gonzalez,,R64,0,0,0,0,0,0,0,0,0,0,0,0,0,0,0,0,0,0,0,0,0,0,0,0,0,0,0
2009-04-20 00:00:00.000,Barcelona Spain ATP World Tour 500,CLAY,2,Jose Acasuso,Dudi Sela,Jose Acasuso,6-4; 7-5,R64,98,4,2,39,70,26,39,19,31,3,5,11,45,70,0,1,42,67,27,42,11,25,2,6,11,38,67
2009-04-20 00:00:00.000,Barcelona Spain ATP World Tour 500,CLAY,2,Daniel Gimeno-Traver,Fabio Fognini,Daniel Gimeno-Traver,6-1; 6-3,R64,65,3,0,33,50,21,33,10,17,1,3,8,31,50,2,3,33,47,12,33,5,14,3,9,8,17,47
2009-04-20 00:00:00.000,Barcelona Spain ATP World Tour 500,CLAY,2,Juan Monaco,Marat Safin,Juan Monaco,6-4; 6-1,R64,66,2,1,41,52,33,41,6,11,2,2,9,39,52,1,0,20,45,12,20,15,25,2,5,8,27,45
2009-04-20 00:00:00.000,Barcelona Spain ATP World Tour 500,CLAY,2,Tomas Berdych,Martin Vassallo Arguello,Tomas Berdych,5-2 RET,R64,40,1,1,18,24,13,18,4,6,1,1,4,17,24,0,1,15,22,10,15,2,7,1,2,3,12,22
2009-04-20 00:00:00.000,Barcelona Spain ATP World Tour 500,CLAY,2,Oscar Hernandez,Eduardo Schwank,Oscar Hernandez,6-2; 6-4,R64,78,5,0,34,49,22,34,11,15,0,2,9,33,49,1,3,33,54,17,33,8,21,6,11,9,25,54
2009-04-20 00:00:00.000,Barcelona Spain ATP World Tour 500,CLAY,2,Nicolas Lapentti,Paul-Henri Mathieu,Nicolas Lapentti,6-4; 2-6; 6-2,R64,124,6,0,50,76,35,50,17,26,5,7,13,52,76,2,1,50,80,33,50,15,30,4,7,13,48,80
2009-04-20 00:00:00.000,Barcelona Spain ATP World Tour 500,CLAY,2,Fernando Verdasco,N/A Bye,Fernando Verdasco,,R64,0,0,0,0,0,0,0,0,0,0,0,0,0,0,0,0,0,0,0,0,0,0,0,0,0,0,0
2009-04-20 00:00:00.000,Barcelona Spain ATP World Tour 500,CLAY,2,Rafael Nadal,Frederico Gil,Rafael Nadal,6-2; 6-2,R32,90,1,0,34,51,23,34,12,17,3,3,8,35,51,3,3,38,57,20,38,10,19,3,7,8,30,57
2009-04-20 00:00:00.000,Barcelona Spain ATP World Tour 500,CLAY,2,Christophe Rochus,Richard Gasquet,Christophe Rochus,6-1; 6-7(2); 6-3,R32,137,6,1,73,113,53,73,18,40,7,9,15,71,113,14,3,46,85,31,46,18,39,2,7,13,49,85
2009-04-20 00:00:00.000,Barcelona Spain ATP World Tour 500,CLAY,2,Nicolas Almagro,Juan Ignacio Chela,Nicolas Almagro,3-6; 7-6(4); 6-3,R32,144,11,0,56,96,39,56,19,40,5,11,16,58,96,2,4,66,107,38,66,22,41,7,12,14,60,107
2009-04-20 00:00:00.000,Barcelona Spain ATP World Tour 500,CLAY,2,David Nalbandian,Igor Kunitsyn,David Nalbandian,7-5; 6-4,R32,87,1,4,30,62,21,30,13,32,2,6,11,34,62,1,1,53,64,26,53,5,11,6,12,11,31,64
2009-04-20 00:00:00.000,Barcelona Spain ATP World Tour 500,CLAY,2,Nikolay Davydenko,Arnaud Clement,Nikolay Davydenko,7-6(2); 6-2,R32,117,5,1,50,68,40,50,9,18,2,2,10,49,68,1,3,44,85,24,44,24,41,9,11,10,48,85
2009-04-20 00:00:00.000,Barcelona Spain ATP World Tour 500,CLAY,2,Feliciano Lopez,Santiago Ventura,Feliciano Lopez,2-6; 6-4; 6-3,R32,117,3,0,57,95,38,57,21,38,6,9,14,59,95,4,3,42,73,28,42,18,31,6,9,13,46,73
2009-04-20 00:00:00.000,Barcelona Spain ATP World Tour 500,CLAY,2,Radek Stepanek,Janko Tipsarevic,Radek Stepanek,7-6(2); 6-0,R32,94,4,1,30,53,24,30,15,23,2,3,9,39,53,5,1,26,64,17,26,15,38,4,8,9,32,64
2009-04-20 00:00:00.000,Barcelona Spain ATP World Tour 500,CLAY,2,Stanislas Wawrinka,Mikhail Youzhny,Stanislas Wawrinka,7-5; 6-1,R32,88,6,1,45,71,31,45,16,26,9,10,10,47,71,2,1,30,57,21,30,9,27,3,7,9,30,57
2009-04-20 00:00:00.000,Barcelona Spain ATP World Tour 500,CLAY,2,Tommy Robredo,Gaston Gaudio,Tommy Robredo,7-6(6); 6-1,R32,91,2,2,37,65,27,37,13,28,4,6,10,40,65,0,3,43,68,25,43,10,25,4,8,9,35,68
2009-04-20 00:00:00.000,Barcelona Spain ATP World Tour 500,CLAY,2,Igor Andreev,Alberto Martin,Igor Andreev,6-2; 6-2,R32,63,1,0,28,41,24,28,9,13,1,1,8,33,41,0,5,26,54,14,26,14,28,3,7,8,28,54
2009-04-20 00:00:00.000,Barcelona Spain ATP World Tour 500,CLAY,2,Potito Starace,Robin Soderling,Potito Starace,7-6(5); 2-6; 6-2,R32,123,5,0,73,99,52,73,11,26,8,11,14,63,99,5,4,44,90,31,44,26,46,4,7,14,57,90
2009-04-20 00:00:00.000,Barcelona Spain ATP World Tour 500,CLAY,2,David Ferrer,Mikhail Kukushkin,David Ferrer,6-3; 3-6; 6-1,R32,120,2,0,56,82,37,56,15,26,6,8,13,52,82,1,1,42,76,23,42,21,34,3,7,12,44,76
2009-04-20 00:00:00.000,Barcelona Spain ATP World Tour 500,CLAY,2,Fernando Gonzalez,Jose Acasuso,Fernando Gonzalez,6-4; 6-4,R32,72,3,2,39,56,32,39,10,17,4,4,10,42,56,1,0,39,59,25,39,11,20,3,5,10,36,59
2009-04-20 00:00:00.000,Barcelona Spain ATP World Tour 500,CLAY,2,Juan Monaco,Daniel Gimeno-Traver,Juan Monaco,7-5; 6-4,R32,85,1,0,50,65,33,50,8,15,5,7,11,41,65,1,1,40,58,23,40,10,18,1,5,11,33,58
2009-04-20 00:00:00.000,Barcelona Spain ATP World Tour 500,CLAY,2,Tomas Berdych,Oscar Hernandez,Tomas Berdych,6-2; 4-6; 6-3,R32,122,8,1,48,89,35,48,20,41,5,8,14,55,89,0,4,54,75,35,54,8,21,1,6,13,43,75
2009-04-20 00:00:00.000,Barcelona Spain ATP World Tour 500,CLAY,2,Fernando Verdasco,Nicolas Lapentti,Fernando Verdasco,7-5; 6-3,R32,99,1,3,53,69,35,53,8,16,4,6,11,43,69,3,2,35,61,21,35,12,26,1,5,10,33,61
2009-04-20 00:00:00.000,Barcelona Spain ATP World Tour 500,CLAY,2,Rafael Nadal,Christophe Rochus,Rafael Nadal,6-2; 6-0,R16,56,3,1,31,40,21,31,8,9,0,0,7,29,40,0,3,22,42,12,22,6,20,2,7,7,18,42
2009-04-20 00:00:00.000,Barcelona Spain ATP World Tour 500,CLAY,2,David Nalbandian,Nicolas Almagro,David Nalbandian,6-3; 6-4,R16,64,3,1,32,57,25,32,13,25,3,5,10,38,57,8,2,29,47,18,29,8,18,0,4,9,26,47
2009-04-20 00:00:00.000,Barcelona Spain ATP World Tour 500,CLAY,2,Nikolay Davydenko,Feliciano Lopez,Nikolay Davydenko,7-6(8); 3-6; 6-4,R16,162,4,1,76,109,56,76,20,33,7,9,16,76,109,6,5,61,112,45,61,29,51,8,9,15,74,112
2009-04-20 00:00:00.000,Barcelona Spain ATP World Tour 500,CLAY,2,Radek Stepanek,Stanislas Wawrinka,Radek Stepanek,6-4; 1-6; 7-5,R16,139,2,4,61,97,38,61,16,36,7,11,14,54,97,5,0,74,96,47,74,9,22,5,9,15,56,96
2009-04-20 00:00:00.000,Barcelona Spain ATP World Tour 500,CLAY,2,Tommy Robredo,Igor Andreev,Tommy Robredo,4-6; 6-2; 6-3,R16,122,2,4,53,92,40,53,21,39,5,6,14,61,92,0,6,49,76,36,49,12,27,3,6,13,48,76
2009-04-20 00:00:00.000,Barcelona Spain ATP World Tour 500,CLAY,2,David Ferrer,Potito Starace,David Ferrer,4-6; 7-5; 6-2,R16,132,4,2,62,98,40,62,23,36,6,9,15,63,98,3,0,66,88,42,66,9,22,7,12,15,51,88
2009-04-20 00:00:00.000,Barcelona Spain ATP World Tour 500,CLAY,2,Fernando Gonzalez,Juan Monaco,Fernando Gonzalez,7-6(6); 6-3,R16,87,8,1,44,71,33,44,16,27,1,2,11,49,71,0,2,44,59,31,44,5,15,1,3,10,36,59
2009-04-20 00:00:00.000,Barcelona Spain ATP World Tour 500,CLAY,2,Fernando Verdasco,Tomas Berdych,Fernando Verdasco,7-5; 5-7; 6-4,R16,137,3,1,76,91,51,76,13,15,6,9,17,64,91,7,2,65,102,47,65,19,37,9,13,17,66,102
2009-04-20 00:00:00.000,Barcelona Spain ATP World Tour 500,CLAY,2,Rafael Nadal,David Nalbandian,Rafael Nadal,W/O,Q,0,0,0,0,0,0,0,0,0,0,0,0,0,0,0,0,0,0,0,0,0,0,0,0,0,0,0
2009-04-20 00:00:00.000,Barcelona Spain ATP World Tour 500,CLAY,2,Nikolay Davydenko,Radek Stepanek,Nikolay Davydenko,6-7(4); 6-2; 6-2,Q,138,5,2,63,93,47,63,15,30,4,5,14,62,93,7,5,60,98,42,60,14,38,11,16,14,56,98
2009-04-20 00:00:00.000,Barcelona Spain ATP World Tour 500,CLAY,2,David Ferrer,Tommy Robredo,David Ferrer,6-3; 6-4,Q,82,3,2,40,61,31,40,12,21,2,2,10,43,61,2,2,30,56,20,30,15,26,1,3,9,35,56
2009-04-20 00:00:00.000,Barcelona Spain ATP World Tour 500,CLAY,2,Fernando Gonzalez,Fernando Verdasco,Fernando Gonzalez,6-3; 4-6; 6-4,Q,137,7,1,67,106,51,67,15,39,4,7,15,66,106,0,1,65,88,41,65,13,23,6,10,14,54,88
2009-04-20 00:00:00.000,Barcelona Spain ATP World Tour 500,CLAY,2,Rafael Nadal,Nikolay Davydenko,Rafael Nadal,6-3; 6-2,S,106,1,2,45,67,33,45,10,22,6,6,8,43,67,3,1,51,61,28,51,5,10,5,9,9,33,61
2009-04-20 00:00:00.000,Barcelona Spain ATP World Tour 500,CLAY,2,David Ferrer,Fernando Gonzalez,David Ferrer,2-6; 6-2; 7-6(5),S,133,1,2,67,94,45,67,15,27,5,8,14,60,94,3,1,66,94,44,66,15,28,2,5,14,59,94
2009-04-20 00:00:00.000,Barcelona Spain ATP World Tour 500,CLAY,2,Rafael Nadal,David Ferrer,Rafael Nadal,6-2; 7-5,F,106,1,1,38,65,24,38,15,27,4,7,10,39,65,1,4,33,60,16,33,12,27,7,13,10,28,60
2009-04-27 00:00:00.000,ATP World Tour Masters 1000 Rome Italy ATP World Tour Masters 1000,CLAY,2,Rafael Nadal,N/A Bye,Rafael Nadal,,R64,0,0,0,0,0,0,0,0,0,0,0,0,0,0,0,0,0,0,0,0,0,0,0,0,0,0,0
2009-04-27 00:00:00.000,ATP World Tour Masters 1000 Rome Italy ATP World Tour Masters 1000,CLAY,2,Andreas Seppi,Sam Querrey,Andreas Seppi,3-6; 6-4; 6-3,R64,124,4,3,42,81,28,42,18,39,0,5,14,46,81,10,4,60,108,38,60,18,48,6,12,14,56,108
2009-04-27 00:00:00.000,ATP World Tour Masters 1000 Rome Italy ATP World Tour Masters 1000,CLAY,2,Robin Soderling,Marcel Granollers,Robin Soderling,6-3; 6-0,R64,62,3,0,29,45,21,29,11,16,1,2,8,32,45,3,2,32,50,15,32,6,18,5,10,7,21,50
2009-04-27 00:00:00.000,ATP World Tour Masters 1000 Rome Italy ATP World Tour Masters 1000,CLAY,2,Victor Crivoi,James Blake,Victor Crivoi,7-5; 6-3,R64,73,4,1,40,64,28,40,12,24,1,4,11,40,64,7,2,29,60,19,29,11,31,5,10,10,30,60
2009-04-27 00:00:00.000,ATP World Tour Masters 1000 Rome Italy ATP World Tour Masters 1000,CLAY,2,Richard Gasquet,Jo-Wilfried Tsonga,Richard Gasquet,7-6(2); 6-4,R64,109,2,2,46,78,35,46,21,32,7,7,11,56,78,2,2,44,70,29,44,17,26,3,4,11,46,70
2009-04-27 00:00:00.000,ATP World Tour Masters 1000 Rome Italy ATP World Tour Masters 1000,CLAY,2,Ernests Gulbis,Nicolas Almagro,Ernests Gulbis,3-6; 7-6(5); 6-2,R64,129,11,5,62,108,42,62,26,46,9,11,14,68,108,13,1,62,110,45,62,20,48,6,9,15,65,110
2009-04-27 00:00:00.000,ATP World Tour Masters 1000 Rome Italy ATP World Tour Masters 1000,CLAY,2,Mardy Fish,Igor Andreev,Mardy Fish,6-3; 4-6; 7-6(2),R64,142,8,2,57,103,42,57,25,46,7,9,15,67,103,8,5,64,97,46,64,16,33,5,8,16,62,97
2009-04-27 00:00:00.000,ATP World Tour Masters 1000 Rome Italy ATP World Tour Masters 1000,CLAY,2,Fernando Verdasco,N/A Bye,Fernando Verdasco,,R64,0,0,0,0,0,0,0,0,0,0,0,0,0,0,0,0,0,0,0,0,0,0,0,0,0,0,0
2009-04-27 00:00:00.000,ATP World Tour Masters 1000 Rome Italy ATP World Tour Masters 1000,CLAY,2,Andy Murray,N/A Bye,Andy Murray,,R64,0,0,0,0,0,0,0,0,0,0,0,0,0,0,0,0,0,0,0,0,0,0,0,0,0,0,0
2009-04-27 00:00:00.000,ATP World Tour Masters 1000 Rome Italy ATP World Tour Masters 1000,CLAY,2,Juan Monaco,Nicolas Kiefer,Juan Monaco,6-2; 6-3,R64,74,2,2,28,46,19,28,12,18,2,3,8,31,46,7,4,31,63,18,31,11,32,4,9,9,29,63
2009-04-27 00:00:00.000,ATP World Tour Masters 1000 Rome Italy ATP World Tour Masters 1000,CLAY,2,Christophe Rochus,Juan Ignacio Chela,Christophe Rochus,6-1; 6-2,R64,60,2,2,22,44,15,22,15,22,1,2,8,30,44,1,6,22,48,13,22,7,26,6,11,7,20,48
2009-04-27 00:00:00.000,ATP World Tour Masters 1000 Rome Italy ATP World Tour Masters 1000,CLAY,2,Marin Cilic,Flavio Cipolla,Marin Cilic,6-2; 6-2,R64,81,5,1,30,52,24,30,13,22,3,3,8,37,52,0,5,35,61,18,35,11,26,6,10,8,29,61
2009-04-27 00:00:00.000,ATP World Tour Masters 1000 Rome Italy ATP World Tour Masters 1000,CLAY,2,Fernando Gonzalez,Jeremy Chardy,Fernando Gonzalez,6-4; 6-1,R64,64,2,2,32,51,23,32,12,19,3,4,9,35,51,1,3,29,53,18,29,10,24,5,9,8,28,53
2009-04-27 00:00:00.000,ATP World Tour Masters 1000 Rome Italy ATP World Tour Masters 1000,CLAY,2,Janko Tipsarevic,Jose Acasuso,Janko Tipsarevic,6-3; 6-4,R64,90,8,2,20,62,16,20,26,42,4,5,10,42,62,6,3,32,60,23,32,11,28,6,9,9,34,60
2009-04-27 00:00:00.000,ATP World Tour Masters 1000 Rome Italy ATP World Tour Masters 1000,CLAY,2,Jurgen Melzer,Julien Benneteau,Jurgen Melzer,3-6; 6-2; 6-3,R64,129,3,2,50,87,32,50,16,37,3,7,13,48,87,2,7,48,79,27,48,11,31,2,8,13,38,79
2009-04-27 00:00:00.000,ATP World Tour Masters 1000 Rome Italy ATP World Tour Masters 1000,CLAY,2,Nikolay Davydenko,N/A Bye,Nikolay Davydenko,,R64,0,0,0,0,0,0,0,0,0,0,0,0,0,0,0,0,0,0,0,0,0,0,0,0,0,0,0
2009-04-27 00:00:00.000,ATP World Tour Masters 1000 Rome Italy ATP World Tour Masters 1000,CLAY,2,Juan Martin Del Potro,N/A Bye,Juan Martin Del Potro,,R64,0,0,0,0,0,0,0,0,0,0,0,0,0,0,0,0,0,0,0,0,0,0,0,0,0,0,0
2009-04-27 00:00:00.000,ATP World Tour Masters 1000 Rome Italy ATP World Tour Masters 1000,CLAY,2,Viktor Troicki,Victor Hanescu,Viktor Troicki,6-3; 6-3,R64,78,6,2,32,61,22,32,16,29,4,6,9,38,61,0,4,22,45,15,22,7,23,2,7,9,22,45
2009-04-27 00:00:00.000,ATP World Tour Masters 1000 Rome Italy ATP World Tour Masters 1000,CLAY,2,Mikhail Youzhny,Daniel Gimeno-Traver,Mikhail Youzhny,7-5; 6-4,R64,139,2,0,55,82,35,55,17,27,1,2,11,52,82,1,2,54,86,32,54,15,32,8,11,11,47,86
2009-04-27 00:00:00.000,ATP World Tour Masters 1000 Rome Italy ATP World Tour Masters 1000,CLAY,2,Stanislas Wawrinka,Igor Kunitsyn,Stanislas Wawrinka,6-3; 6-4,R64,83,5,4,41,68,28,41,16,27,5,6,10,44,68,0,0,54,68,31,54,6,14,7,10,9,37,68
2009-04-27 00:00:00.000,ATP World Tour Masters 1000 Rome Italy ATP World Tour Masters 1000,CLAY,2,Tommy Robredo,Marat Safin,Tommy Robredo,2-6; 7-6(5); 6-2,R64,133,4,1,67,105,42,67,20,38,6,10,14,62,105,8,4,40,80,33,40,17,40,1,5,14,50,80
2009-04-27 00:00:00.000,ATP World Tour Masters 1000 Rome Italy ATP World Tour Masters 1000,CLAY,2,Philipp Kohlschreiber,Simone Bolelli,Philipp Kohlschreiber,4-6; 6-1; 6-0,R64,114,3,2,52,76,34,52,14,24,5,8,12,48,76,0,2,47,76,22,47,13,29,6,13,11,35,76
2009-04-27 00:00:00.000,ATP World Tour Masters 1000 Rome Italy ATP World Tour Masters 1000,CLAY,2,Albert Montanes,Potito Starace,Albert Montanes,7-6(8); 6-4,R64,133,2,3,59,95,44,59,20,36,5,5,11,64,95,2,4,78,96,52,78,8,18,5,6,11,60,96
2009-04-27 00:00:00.000,ATP World Tour Masters 1000 Rome Italy ATP World Tour Masters 1000,CLAY,2,Novak Djokovic,N/A Bye,Novak Djokovic,,R64,0,0,0,0,0,0,0,0,0,0,0,0,0,0,0,0,0,0,0,0,0,0,0,0,0,0,0
2009-04-27 00:00:00.000,ATP World Tour Masters 1000 Rome Italy ATP World Tour Masters 1000,CLAY,2,Gilles Simon,N/A Bye,Gilles Simon,,R64,0,0,0,0,0,0,0,0,0,0,0,0,0,0,0,0,0,0,0,0,0,0,0,0,0,0,0
2009-04-27 00:00:00.000,ATP World Tour Masters 1000 Rome Italy ATP World Tour Masters 1000,CLAY,2,Fabio Fognini,Filippo Volandri,Fabio Fognini,6-7(3); 6-1; 7-6(4),R64,165,3,6,67,117,42,67,23,50,6,11,16,65,117,0,5,91,111,49,91,9,20,12,19,15,58,111
2009-04-27 00:00:00.000,ATP World Tour Masters 1000 Rome Italy ATP World Tour Masters 1000,CLAY,2,Mischa Zverev,Tomas Berdych,Mischa Zverev,4-6; 6-2; 7-5,R64,146,4,3,65,103,50,65,13,38,6,10,15,63,103,1,3,60,98,38,60,16,38,6,12,15,54,98
2009-04-27 00:00:00.000,ATP World Tour Masters 1000 Rome Italy ATP World Tour Masters 1000,CLAY,2,Paul-Henri Mathieu,David Ferrer,Paul-Henri Mathieu,6-3; 2-6; 6-2,R64,145,3,3,48,85,32,48,21,37,5,8,13,53,85,2,5,38,72,27,38,14,34,2,6,12,41,72
2009-04-27 00:00:00.000,ATP World Tour Masters 1000 Rome Italy ATP World Tour Masters 1000,CLAY,2,Radek Stepanek,Florent Serra,Radek Stepanek,7-6(1); 4-6; 7-5,R64,147,5,6,63,103,50,63,19,40,2,5,17,69,103,4,6,74,126,54,74,21,52,11,14,17,75,126
2009-04-27 00:00:00.000,ATP World Tour Masters 1000 Rome Italy ATP World Tour Masters 1000,CLAY,2,Feliciano Lopez,Thomaz Bellucci,Feliciano Lopez,6-4; 6-2,R64,82,5,1,35,56,25,35,11,21,3,4,9,36,56,5,2,37,52,21,37,7,15,3,7,9,28,52
2009-04-27 00:00:00.000,ATP World Tour Masters 1000 Rome Italy ATP World Tour Masters 1000,CLAY,2,Ivo Karlovic,Jan Hernych,Ivo Karlovic,4-6; 6-4; 6-2,R64,119,16,6,42,77,34,42,19,35,1,3,14,53,77,2,3,44,74,30,44,18,30,3,7,14,48,74
2009-04-27 00:00:00.000,ATP World Tour Masters 1000 Rome Italy ATP World Tour Masters 1000,CLAY,2,Roger Federer,N/A Bye,Roger Federer,,R64,0,0,0,0,0,0,0,0,0,0,0,0,0,0,0,0,0,0,0,0,0,0,0,0,0,0,0
2009-04-27 00:00:00.000,ATP World Tour Masters 1000 Rome Italy ATP World Tour Masters 1000,CLAY,2,Rafael Nadal,Andreas Seppi,Rafael Nadal,6-2; 6-3,R32,80,1,0,30,44,24,30,10,14,2,3,9,34,44,2,2,33,50,21,33,5,17,3,7,8,26,50
2009-04-27 00:00:00.000,ATP World Tour Masters 1000 Rome Italy ATP World Tour Masters 1000,CLAY,2,Robin Soderling,Victor Crivoi,Robin Soderling,6-1; 6-7(2); 6-1,R32,104,8,1,44,85,32,44,26,41,11,13,14,58,85,5,0,41,79,25,41,17,38,6,12,12,42,79
2009-04-27 00:00:00.000,ATP World Tour Masters 1000 Rome Italy ATP World Tour Masters 1000,CLAY,2,Richard Gasquet,Ernests Gulbis,Richard Gasquet,6-2; 1-6; 6-4,R32,114,5,4,53,78,32,53,11,25,1,6,13,43,78,7,8,59,93,36,59,14,34,11,16,12,50,93
2009-04-27 00:00:00.000,ATP World Tour Masters 1000 Rome Italy ATP World Tour Masters 1000,CLAY,2,Fernando Verdasco,Mardy Fish,Fernando Verdasco,6-4; 5-7; 6-3,R32,142,4,2,55,79,41,55,15,24,0,2,15,56,79,10,6,50,109,36,50,31,59,10,14,16,67,109
2009-04-27 00:00:00.000,ATP World Tour Masters 1000 Rome Italy ATP World Tour Masters 1000,CLAY,2,Juan Monaco,Andy Murray,Juan Monaco,1-6; 6-3; 7-5,R32,160,0,2,76,91,43,76,5,15,7,13,14,48,91,3,2,55,92,35,55,15,37,8,14,14,50,92
2009-04-27 00:00:00.000,ATP World Tour Masters 1000 Rome Italy ATP World Tour Masters 1000,CLAY,2,Marin Cilic,Christophe Rochus,Marin Cilic,6-0; 5-7; 6-2,R32,121,11,3,43,71,34,43,16,28,1,3,13,50,71,1,4,68,105,37,68,16,37,11,17,13,53,105
2009-04-27 00:00:00.000,ATP World Tour Masters 1000 Rome Italy ATP World Tour Masters 1000,CLAY,2,Fernando Gonzalez,Janko Tipsarevic,Fernando Gonzalez,6-4; 6-4,R32,89,10,2,39,73,36,39,14,34,4,4,10,50,73,0,5,26,54,23,26,13,28,0,2,10,36,54
2009-04-27 00:00:00.000,ATP World Tour Masters 1000 Rome Italy ATP World Tour Masters 1000,CLAY,2,Jurgen Melzer,Nikolay Davydenko,Jurgen Melzer,7-5; 7-6(5),R32,95,2,3,54,72,42,54,9,18,2,3,12,51,72,1,4,51,71,37,51,8,20,1,3,12,45,71
2009-04-27 00:00:00.000,ATP World Tour Masters 1000 Rome Italy ATP World Tour Masters 1000,CLAY,2,Juan Martin Del Potro,Viktor Troicki,Juan Martin Del Potro,6-3; 1-6; 6-3,R32,137,5,1,59,97,38,59,20,38,7,9,13,58,97,1,1,45,78,36,45,14,33,7,9,12,50,78
2009-04-27 00:00:00.000,ATP World Tour Masters 1000 Rome Italy ATP World Tour Masters 1000,CLAY,2,Stanislas Wawrinka,Mikhail Youzhny,Stanislas Wawrinka,6-3; 7-6(5),R32,105,1,2,36,61,24,36,18,25,2,4,10,42,61,0,3,50,79,28,50,18,29,4,8,11,46,79
2009-04-27 00:00:00.000,ATP World Tour Masters 1000 Rome Italy ATP World Tour Masters 1000,CLAY,2,Tommy Robredo,Philipp Kohlschreiber,Tommy Robredo,6-2; 7-6(5),R32,133,2,2,60,84,37,60,13,24,8,10,10,50,84,1,2,49,74,30,49,11,25,4,8,10,41,74
2009-04-27 00:00:00.000,ATP World Tour Masters 1000 Rome Italy ATP World Tour Masters 1000,CLAY,2,Novak Djokovic,Albert Montanes,Novak Djokovic,7-6(5); 6-0,R32,98,4,5,32,64,24,32,14,32,2,4,9,38,64,0,2,34,73,20,34,14,39,5,10,9,34,73
2009-04-27 00:00:00.000,ATP World Tour Masters 1000 Rome Italy ATP World Tour Masters 1000,CLAY,2,Gilles Simon,Fabio Fognini,Gilles Simon,6-7(6); 6-2; 6-3,R32,129,3,2,45,87,34,45,23,42,2,4,14,57,87,1,6,54,95,32,54,22,41,6,12,15,54,95
2009-04-27 00:00:00.000,ATP World Tour Masters 1000 Rome Italy ATP World Tour Masters 1000,CLAY,2,Mischa Zverev,Paul-Henri Mathieu,Mischa Zverev,3-6; 7-6(5); 6-0,R32,131,4,1,63,98,42,63,19,35,7,9,13,61,98,4,0,44,80,26,44,21,36,1,5,14,47,80
2009-04-27 00:00:00.000,ATP World Tour Masters 1000 Rome Italy ATP World Tour Masters 1000,CLAY,2,Radek Stepanek,Feliciano Lopez,Radek Stepanek,6-2; 6-1,R32,71,3,3,31,54,24,31,13,23,5,5,8,37,54,3,0,23,52,16,23,10,29,4,8,7,26,52
2009-04-27 00:00:00.000,ATP World Tour Masters 1000 Rome Italy ATP World Tour Masters 1000,CLAY,2,Roger Federer,Ivo Karlovic,Roger Federer,6-4; 6-4,R32,69,1,2,33,58,25,33,18,25,3,3,10,43,58,15,4,34,53,27,34,8,19,2,4,10,35,53
2009-04-27 00:00:00.000,ATP World Tour Masters 1000 Rome Italy ATP World Tour Masters 1000,CLAY,2,Rafael Nadal,Robin Soderling,Rafael Nadal,6-1; 6-0,R16,84,1,2,29,51,18,29,15,22,5,5,6,33,51,3,2,27,52,11,27,8,25,2,8,7,19,52
2009-04-27 00:00:00.000,ATP World Tour Masters 1000 Rome Italy ATP World Tour Masters 1000,CLAY,2,Fernando Verdasco,Richard Gasquet,Fernando Verdasco,7-5; 6-4,R16,109,3,4,61,80,40,61,10,19,6,8,11,50,80,0,2,53,72,32,53,10,19,4,8,11,42,72
2009-04-27 00:00:00.000,ATP World Tour Masters 1000 Rome Italy ATP World Tour Masters 1000,CLAY,2,Juan Monaco,Marin Cilic,Juan Monaco,6-4; 6-4,R16,90,0,0,39,49,32,39,8,10,0,0,10,40,49,5,3,36,66,25,36,17,30,8,10,10,42,66
2009-04-27 00:00:00.000,ATP World Tour Masters 1000 Rome Italy ATP World Tour Masters 1000,CLAY,2,Fernando Gonzalez,Jurgen Melzer,Fernando Gonzalez,3-6; 6-3; 7-5,R16,114,3,2,55,88,42,55,20,33,4,5,15,62,88,7,4,59,100,38,59,26,41,6,8,15,64,100
2009-04-27 00:00:00.000,ATP World Tour Masters 1000 Rome Italy ATP World Tour Masters 1000,CLAY,2,Juan Martin Del Potro,Stanislas Wawrinka,Juan Martin Del Potro,6-2; 6-7(5); 6-3,R16,170,7,1,46,88,40,46,23,42,6,7,15,63,88,4,3,66,101,41,66,18,35,10,14,14,59,101
2009-04-27 00:00:00.000,ATP World Tour Masters 1000 Rome Italy ATP World Tour Masters 1000,CLAY,2,Novak Djokovic,Tommy Robredo,Novak Djokovic,6-1; 6-1,R16,64,3,4,32,51,22,32,10,19,3,4,7,32,51,0,1,29,47,11,29,5,18,3,9,7,16,47
2009-04-27 00:00:00.000,ATP World Tour Masters 1000 Rome Italy ATP World Tour Masters 1000,CLAY,2,Mischa Zverev,Gilles Simon,Mischa Zverev,6-4; 6-1,R16,63,1,1,22,40,19,22,13,18,0,0,8,32,40,1,2,29,58,17,29,14,29,4,8,9,31,58
2009-04-27 00:00:00.000,ATP World Tour Masters 1000 Rome Italy ATP World Tour Masters 1000,CLAY,2,Roger Federer,Radek Stepanek,Roger Federer,6-4; 6-1,R16,68,5,2,21,49,18,21,17,28,4,5,9,35,49,1,2,28,53,17,28,11,25,3,7,8,28,53
2009-04-27 00:00:00.000,ATP World Tour Masters 1000 Rome Italy ATP World Tour Masters 1000,CLAY,2,Rafael Nadal,Fernando Verdasco,Rafael Nadal,6-3; 6-3,Q,111,0,0,42,60,27,42,11,18,5,6,9,38,60,0,5,36,55,20,36,9,19,2,6,9,29,55
2009-04-27 00:00:00.000,ATP World Tour Masters 1000 Rome Italy ATP World Tour Masters 1000,CLAY,2,Fernando Gonzalez,Juan Monaco,Fernando Gonzalez,2-6; 6-3; 6-4,Q,128,2,6,55,92,35,55,20,37,2,5,14,55,92,1,3,61,81,41,61,11,20,1,4,13,52,81
2009-04-27 00:00:00.000,ATP World Tour Masters 1000 Rome Italy ATP World Tour Masters 1000,CLAY,2,Novak Djokovic,Juan Martin Del Potro,Novak Djokovic,6-3; 6-4,Q,97,4,3,41,64,27,41,15,23,2,3,10,42,64,2,3,29,55,20,29,11,26,3,6,9,31,55
2009-04-27 00:00:00.000,ATP World Tour Masters 1000 Rome Italy ATP World Tour Masters 1000,CLAY,2,Roger Federer,Mischa Zverev,Roger Federer,7-6(3); 6-2,Q,88,2,0,36,55,31,36,13,19,0,0,10,44,55,4,1,54,83,37,54,12,29,8,10,10,49,83
2009-04-27 00:00:00.000,ATP World Tour Masters 1000 Rome Italy ATP World Tour Masters 1000,CLAY,2,Rafael Nadal,Fernando Gonzalez,Rafael Nadal,6-3; 6-3,S,75,1,0,34,46,27,34,6,12,0,1,9,33,46,2,2,31,51,22,31,6,20,3,7,9,28,51
2009-04-27 00:00:00.000,ATP World Tour Masters 1000 Rome Italy ATP World Tour Masters 1000,CLAY,2,Novak Djokovic,Roger Federer,Novak Djokovic,4-6; 6-3; 6-3,S,131,3,6,50,100,32,50,28,50,8,11,14,60,100,6,3,40,81,29,40,17,41,3,8,14,46,81
2009-04-27 00:00:00.000,ATP World Tour Masters 1000 Rome Italy ATP World Tour Masters 1000,CLAY,2,Rafael Nadal,Novak Djokovic,Rafael Nadal,7-6(2); 6-2,F,123,0,1,50,70,34,50,11,20,2,4,10,45,70,0,2,39,66,23,39,13,27,1,5,10,36,66
2009-05-03 00:00:00.000,Estoril Portugal ATP World Tour 250,CLAY,2,Gilles Simon,Robert Kendrick,Gilles Simon,6-3; 7-6(7),R32,93,4,1,43,78,25,43,22,35,5,8,11,47,78,0,4,43,81,29,43,14,38,5,9,10,43,81
2009-05-03 00:00:00.000,Estoril Portugal ATP World Tour 250,CLAY,2,Fabio Fognini,Gaston Gaudio,Fabio Fognini,6-3; 6-4,R32,79,2,2,30,64,22,30,20,34,1,2,10,42,64,0,5,34,57,25,34,9,23,4,7,9,34,57
2009-05-03 00:00:00.000,Estoril Portugal ATP World Tour 250,CLAY,2,Simon Greul,Ricardo Hocevar,Simon Greul,6-1; 6-4,R32,77,0,3,33,54,25,33,13,21,1,1,9,38,54,1,3,20,54,15,20,16,34,7,10,8,31,54
2009-05-03 00:00:00.000,Estoril Portugal ATP World Tour 250,CLAY,2,Albert Montanes,Ryan Sweeting,Albert Montanes,6-1; 7-6(4),R32,74,1,5,31,59,22,31,14,28,5,8,9,36,59,0,2,53,66,24,53,5,13,6,12,10,29,66
2009-05-03 00:00:00.000,Estoril Portugal ATP World Tour 250,CLAY,2,David Ferrer,Daniel Gimeno-Traver,David Ferrer,6-4; 6-1,R32,72,2,2,25,49,21,25,12,24,0,2,9,33,49,1,3,24,49,13,24,8,25,2,7,8,21,49
2009-05-03 00:00:00.000,Estoril Portugal ATP World Tour 250,CLAY,2,Oscar Hernandez,Rui Machado,Oscar Hernandez,7-5; 1-6; 7-5,R32,148,1,6,65,96,41,65,11,31,6,11,16,52,96,0,5,63,93,42,63,14,30,2,6,15,56,93
2009-05-03 00:00:00.000,Estoril Portugal ATP World Tour 250,CLAY,2,Maximo Gonzalez,Guillermo Garcia-Lopez,Maximo Gonzalez,6-4; 6-3,R32,98,1,3,33,59,25,33,13,26,4,5,9,38,59,2,8,47,79,30,47,12,32,13,17,10,42,79
2009-05-03 00:00:00.000,Estoril Portugal ATP World Tour 250,CLAY,2,Paul Capdeville,David Nalbandian,Paul Capdeville,6-2; 6-2,R32,53,0,3,19,39,16,19,14,20,0,1,8,30,39,2,1,16,43,8,16,12,27,1,6,8,20,43
2009-05-03 00:00:00.000,Estoril Portugal ATP World Tour 250,CLAY,2,Florent Serra,Diego Junqueira,Florent Serra,6-4; 2-6; 6-3,R32,129,4,6,55,99,33,55,23,44,9,13,13,56,99,2,1,53,90,35,53,18,37,7,12,14,53,90
2009-05-03 00:00:00.000,Estoril Portugal ATP World Tour 250,CLAY,2,Juan Monaco,Pablo Cuevas,Juan Monaco,6-2; 6-4,R32,74,0,2,33,52,23,33,13,19,2,3,9,36,52,1,0,29,56,14,29,15,27,6,10,9,29,56
2009-05-03 00:00:00.000,Estoril Portugal ATP World Tour 250,CLAY,2,Marc Gicquel,Pablo Andujar,Marc Gicquel,7-6(6); 6-4,R32,107,6,2,38,70,30,38,22,32,0,0,11,52,70,3,2,53,78,35,53,18,25,7,8,11,53,78
2009-05-03 00:00:00.000,Estoril Portugal ATP World Tour 250,CLAY,2,James Blake,Frederico Gil,James Blake,5-7; 6-4; 6-2,R32,116,2,2,47,93,39,47,25,46,7,8,15,64,93,4,2,52,92,35,52,25,40,5,8,15,60,92
2009-05-03 00:00:00.000,Estoril Portugal ATP World Tour 250,CLAY,2,Mardy Fish,Teymuraz Gabashvili,Mardy Fish,6-3; 6-4,R32,108,8,3,39,70,26,39,14,31,2,5,10,40,70,3,7,49,87,33,49,11,38,7,12,9,44,87
2009-05-03 00:00:00.000,Estoril Portugal ATP World Tour 250,CLAY,2,Ivan Navarro,Alberto Martin,Ivan Navarro,7-5; 6-4,R32,89,4,1,56,71,40,56,5,15,4,6,11,45,71,0,3,30,61,19,30,17,31,1,5,11,36,61
2009-05-03 00:00:00.000,Estoril Portugal ATP World Tour 250,CLAY,2,Juan Carlos Ferrero,Mikhail Kukushkin,Juan Carlos Ferrero,7-6(4); 6-3,R32,95,5,1,47,70,31,47,15,23,2,3,10,46,70,6,3,33,70,22,33,17,37,1,4,11,39,70
2009-05-03 00:00:00.000,Estoril Portugal ATP World Tour 250,CLAY,2,Nikolay Davydenko,Andrey Golubev,Nikolay Davydenko,6-1; 7-6(4),R32,96,1,3,43,63,28,43,10,20,1,3,9,38,63,0,6,46,71,25,46,9,25,5,10,10,34,71
2009-05-03 00:00:00.000,Estoril Portugal ATP World Tour 250,CLAY,2,Gilles Simon,Fabio Fognini,Gilles Simon,6-0; 7-5,R16,74,1,1,29,50,17,29,13,21,2,4,9,30,50,0,4,36,65,19,36,9,29,5,11,9,28,65
2009-05-03 00:00:00.000,Estoril Portugal ATP World Tour 250,CLAY,2,Albert Montanes,Simon Greul,Albert Montanes,6-2; 6-2,R16,71,2,4,32,52,27,32,8,20,6,7,8,35,52,1,4,25,58,12,25,15,33,8,13,8,27,58
2009-05-03 00:00:00.000,Estoril Portugal ATP World Tour 250,CLAY,2,Oscar Hernandez,David Ferrer,Oscar Hernandez,6-2; 6-4,R16,100,3,2,45,69,32,45,10,24,10,12,9,42,69,1,5,29,55,15,29,10,26,5,10,9,25,55
2009-05-03 00:00:00.000,Estoril Portugal ATP World Tour 250,CLAY,2,Paul Capdeville,Maximo Gonzalez,Paul Capdeville,2-6; 6-2; 6-3,R16,140,3,4,61,100,39,61,15,39,5,10,13,54,100,0,0,65,97,37,65,11,32,12,18,12,48,97
2009-05-03 00:00:00.000,Estoril Portugal ATP World Tour 250,CLAY,2,Florent Serra,Juan Monaco,Florent Serra,6-3; 1-6; 6-3,R16,123,4,2,51,107,30,51,30,56,8,11,13,60,107,4,1,54,77,37,54,11,23,2,5,12,48,77
2009-05-03 00:00:00.000,Estoril Portugal ATP World Tour 250,CLAY,2,James Blake,Marc Gicquel,James Blake,7-6(6); 6-2,R16,77,5,1,40,64,31,40,16,24,1,1,10,47,64,9,1,45,74,33,45,14,29,6,8,10,47,74
2009-05-03 00:00:00.000,Estoril Portugal ATP World Tour 250,CLAY,2,Mardy Fish,Ivan Navarro,Mardy Fish,2-6; 6-1; 6-4,R16,117,6,1,39,85,27,39,25,46,5,8,13,52,85,5,2,48,74,34,48,9,26,3,7,12,43,74
2009-05-03 00:00:00.000,Estoril Portugal ATP World Tour 250,CLAY,2,Nikolay Davydenko,Juan Carlos Ferrero,Nikolay Davydenko,7-5; 6-2,R16,89,5,2,37,52,29,37,9,15,0,1,10,38,52,3,3,48,73,29,48,10,25,3,7,10,39,73
2009-05-03 00:00:00.000,Estoril Portugal ATP World Tour 250,CLAY,2,Albert Montanes,Gilles Simon,Albert Montanes,5-7; 6-4; 7-6(4),Q,178,3,4,58,121,40,58,29,63,4,10,17,69,121,2,2,61,119,36,61,30,58,9,15,17,66,119
2009-05-03 00:00:00.000,Estoril Portugal ATP World Tour 250,CLAY,2,Paul Capdeville,Oscar Hernandez,Paul Capdeville,4-6; 6-1; 6-4,Q,132,3,4,46,85,30,46,23,39,3,6,14,53,85,4,2,64,84,39,64,8,20,7,12,13,47,84
2009-05-03 00:00:00.000,Estoril Portugal ATP World Tour 250,CLAY,2,James Blake,Florent Serra,James Blake,6-4; 6-1,Q,48,7,2,25,46,19,25,12,21,2,4,9,31,46,0,2,32,47,15,32,7,15,3,8,8,22,47
2009-05-03 00:00:00.000,Estoril Portugal ATP World Tour 250,CLAY,2,Nikolay Davydenko,Mardy Fish,Nikolay Davydenko,6-4; 6-3,Q,85,0,2,43,57,31,43,7,14,4,5,9,38,57,5,2,31,54,20,31,7,23,2,6,10,27,54
2009-05-03 00:00:00.000,Estoril Portugal ATP World Tour 250,CLAY,2,Albert Montanes,Paul Capdeville,Albert Montanes,6-3; 6-4,S,77,5,2,30,56,21,30,13,26,2,5,10,34,56,1,0,33,57,19,33,8,24,1,6,9,27,57
2009-05-03 00:00:00.000,Estoril Portugal ATP World Tour 250,CLAY,2,James Blake,Nikolay Davydenko,James Blake,6-7(3); 7-6(2); 6-3,S,146,4,3,69,129,43,69,32,60,7,12,17,75,129,1,3,68,108,41,68,20,40,5,11,16,61,108
2009-05-03 00:00:00.000,Estoril Portugal ATP World Tour 250,CLAY,2,Albert Montanes,James Blake,Albert Montanes,5-7; 7-6(6); 6-0,F,133,8,3,46,93,36,46,29,47,6,8,15,65,93,5,7,65,119,45,65,25,54,5,9,15,70,119
2009-05-03 00:00:00.000,Munich Germany ATP World Tour 250,CLAY,2,Julien Benneteau,Alexander Peya,Julien Benneteau,2-6; 7-6(5); 7-5,R32,152,3,3,68,98,45,68,13,30,3,8,16,58,98,3,2,67,102,42,67,18,35,5,9,16,60,102
2009-05-03 00:00:00.000,Munich Germany ATP World Tour 250,CLAY,2,Daniel Brands,Stefan Koubek,Daniel Brands,6-3; 7-6(2),R32,76,6,1,45,60,37,45,11,15,6,6,10,48,60,3,2,41,68,32,41,12,27,1,3,11,44,68
2009-05-03 00:00:00.000,Munich Germany ATP World Tour 250,CLAY,2,Simone Bolelli,Stephane Bohli,Simone Bolelli,3-6; 6-2; 6-3,R32,138,3,3,64,95,46,64,15,31,8,9,13,61,95,5,4,60,103,40,60,21,43,12,15,13,61,103
2009-05-03 00:00:00.000,Munich Germany ATP World Tour 250,CLAY,2,Potito Starace,Igor Kunitsyn,Potito Starace,7-5; 5-7; 6-3,R32,131,2,1,81,98,55,81,8,17,6,10,17,63,98,1,0,75,98,46,75,11,23,4,9,16,57,98
2009-05-03 00:00:00.000,Munich Germany ATP World Tour 250,CLAY,2,Nicolas Almagro,Jan Hernych,Nicolas Almagro,6-3; 6-4,R32,74,3,0,40,55,29,40,9,15,2,3,9,38,55,0,2,44,66,27,44,10,22,5,9,10,37,66
2009-05-03 00:00:00.000,Munich Germany ATP World Tour 250,CLAY,2,Mikhail Youzhny,Ivo Minar,Mikhail Youzhny,6-3; 7-6(5),R32,95,0,1,37,60,24,37,11,23,0,3,10,35,60,5,2,52,88,36,52,11,36,6,11,11,47,88
2009-05-03 00:00:00.000,Munich Germany ATP World Tour 250,CLAY,2,Denis Gremelmayr,Martin Vassallo Arguello,Denis Gremelmayr,5-1 RET,R32,30,1,1,9,15,7,9,5,6,0,0,3,12,15,0,1,10,15,5,10,2,5,1,3,3,7,15
2009-05-03 00:00:00.000,Munich Germany ATP World Tour 250,CLAY,2,Paul-Henri Mathieu,Lamine Ouahab,Paul-Henri Mathieu,6-3; 6-2,R32,66,4,1,30,47,27,30,9,17,0,0,9,36,47,2,5,25,54,15,25,14,29,4,7,8,29,54
2009-05-03 00:00:00.000,Munich Germany ATP World Tour 250,CLAY,2,Thiemo de Bakker,Rainer Schuettler,Thiemo de Bakker,6-3; 6-3,R32,69,5,0,47,60,31,47,8,13,2,3,9,39,60,3,4,37,55,24,37,5,18,3,7,9,29,55
2009-05-03 00:00:00.000,Munich Germany ATP World Tour 250,CLAY,2,Lleyton Hewitt,Philipp Petzschner,Lleyton Hewitt,6-2; 6-7(2); 7-6(8),R32,157,2,5,60,123,40,60,34,63,7,11,16,74,123,6,5,59,113,37,59,27,54,7,13,16,64,113
2009-05-03 00:00:00.000,Munich Germany ATP World Tour 250,CLAY,2,Andreas Beck,Mischa Zverev,Andreas Beck,6-3; 6-4,R32,87,1,1,30,57,21,30,15,27,2,4,10,36,57,1,2,33,66,16,33,19,33,6,10,9,35,66
2009-05-03 00:00:00.000,Munich Germany ATP World Tour 250,CLAY,2,Tomas Berdych,Sascha Kloer,Tomas Berdych,7-6(0); 6-4,R32,91,6,1,44,66,32,44,17,22,3,4,11,49,66,2,4,61,93,38,61,16,32,8,10,11,54,93
2009-05-03 00:00:00.000,Munich Germany ATP World Tour 250,CLAY,2,Nicolas Kiefer,Ernests Gulbis,Nicolas Kiefer,2-6; 6-3; 6-2,R32,93,7,5,40,80,30,40,18,40,4,7,13,48,80,7,3,39,69,29,39,13,30,1,5,12,42,69
2009-05-03 00:00:00.000,Munich Germany ATP World Tour 250,CLAY,2,Jeremy Chardy,Evgeny Korolev,Jeremy Chardy,6-3; 6-3,R32,57,6,1,27,43,23,27,13,16,0,0,9,36,43,4,0,37,57,24,37,9,20,5,8,9,33,57
2009-05-03 00:00:00.000,Munich Germany ATP World Tour 250,CLAY,2,Philipp Kohlschreiber,Bjorn Phau,Philipp Kohlschreiber,6-2; 2-1 RET,R32,45,3,2,28,38,19,28,6,10,2,3,6,25,38,0,2,14,32,8,14,7,18,1,4,5,15,32
2009-05-03 00:00:00.000,Munich Germany ATP World Tour 250,CLAY,2,Marin Cilic,Dieter Kindlmann,Marin Cilic,6-3; 6-2,R32,75,4,1,25,44,22,25,11,19,0,0,8,33,44,0,4,42,70,24,42,13,28,4,8,9,37,70
2009-05-03 00:00:00.000,Munich Germany ATP World Tour 250,CLAY,2,Daniel Brands,Julien Benneteau,Daniel Brands,6-4; 3-6; 7-6(6),R16,135,3,3,58,90,39,58,15,32,3,8,15,54,90,3,6,75,104,47,75,14,29,6,11,16,61,104
2009-05-03 00:00:00.000,Munich Germany ATP World Tour 250,CLAY,2,Potito Starace,Simone Bolelli,Potito Starace,6-4; 7-6(5),R16,114,3,1,61,71,45,61,4,10,2,3,11,49,71,5,2,56,88,38,56,17,32,6,8,11,55,88
2009-05-03 00:00:00.000,Munich Germany ATP World Tour 250,CLAY,2,Mikhail Youzhny,Nicolas Almagro,Mikhail Youzhny,7-6(2); 6-4,R16,86,4,0,41,64,33,41,16,23,2,3,11,49,64,7,3,42,66,29,42,14,24,2,4,11,43,66
2009-05-03 00:00:00.000,Munich Germany ATP World Tour 250,CLAY,2,Paul-Henri Mathieu,Denis Gremelmayr,Paul-Henri Mathieu,6-1; 6-4,R16,75,5,0,39,61,26,39,14,22,2,3,9,40,61,0,3,34,55,19,34,7,21,5,9,8,26,55
2009-05-03 00:00:00.000,Munich Germany ATP World Tour 250,CLAY,2,Lleyton Hewitt,Thiemo de Bakker,Lleyton Hewitt,6-3; 6-4,R16,94,7,2,42,65,33,42,8,23,3,5,10,41,65,2,1,52,83,28,52,15,31,8,12,9,43,83
2009-05-03 00:00:00.000,Munich Germany ATP World Tour 250,CLAY,2,Tomas Berdych,Andreas Beck,Tomas Berdych,1-6; 6-4; 7-6(4),R16,151,7,4,52,96,42,52,21,44,5,8,14,63,96,10,5,59,108,40,59,30,49,11,13,15,70,108
2009-05-03 00:00:00.000,Munich Germany ATP World Tour 250,CLAY,2,Jeremy Chardy,Nicolas Kiefer,Jeremy Chardy,6-4; 7-6(8),R16,95,7,2,42,71,33,42,18,29,3,4,11,51,71,13,4,28,72,22,28,26,44,2,4,11,48,72
2009-05-03 00:00:00.000,Munich Germany ATP World Tour 250,CLAY,2,Marin Cilic,Philipp Kohlschreiber,Marin Cilic,6-0; 6-4,R16,77,3,2,36,59,27,36,12,23,3,3,8,39,59,1,2,31,47,14,31,10,16,1,5,8,24,47
2009-05-03 00:00:00.000,Munich Germany ATP World Tour 250,CLAY,2,Daniel Brands,Potito Starace,Daniel Brands,6-4; 1-1 RET,Q,36,5,1,20,29,18,20,6,9,0,0,6,24,29,3,1,33,38,23,33,2,5,4,5,6,25,38
2009-05-03 00:00:00.000,Munich Germany ATP World Tour 250,CLAY,2,Mikhail Youzhny,Paul-Henri Mathieu,Mikhail Youzhny,7-5; 3-6; 6-3,Q,138,10,3,52,86,41,52,20,34,4,5,15,61,86,3,1,58,97,40,58,22,39,2,4,15,62,97
2009-05-03 00:00:00.000,Munich Germany ATP World Tour 250,CLAY,2,Tomas Berdych,Lleyton Hewitt,Tomas Berdych,4-6; 6-3; 7-6(4),Q,138,8,4,73,109,51,73,19,36,4,7,16,70,109,7,4,58,95,42,58,20,37,3,6,15,62,95
2009-05-03 00:00:00.000,Munich Germany ATP World Tour 250,CLAY,2,Jeremy Chardy,Marin Cilic,Jeremy Chardy,3-6; 7-5; 6-4,Q,118,3,1,59,85,48,59,14,26,4,5,15,62,85,9,1,47,86,37,47,26,39,4,6,16,63,86
2009-05-03 00:00:00.000,Munich Germany ATP World Tour 250,CLAY,2,Mikhail Youzhny,Daniel Brands,Mikhail Youzhny,3-6; 6-3; 6-4,S,117,1,2,62,83,51,62,10,21,6,7,14,61,83,6,2,65,89,52,65,6,24,5,7,14,58,89
2009-05-03 00:00:00.000,Munich Germany ATP World Tour 250,CLAY,2,Tomas Berdych,Jeremy Chardy,Tomas Berdych,6-1; 5-7; 6-2,S,105,10,1,59,91,46,59,16,32,4,5,14,62,91,5,2,42,72,29,42,18,30,3,7,13,47,72
2009-05-03 00:00:00.000,Munich Germany ATP World Tour 250,CLAY,2,Tomas Berdych,Mikhail Youzhny,Tomas Berdych,6-4; 4-6; 7-6(5),F,154,7,7,58,93,49,58,14,35,2,5,16,63,93,7,1,68,112,53,68,17,44,9,12,16,70,112
2009-05-04 00:00:00.000,Belgrade Serbia ATP World Tour 250,CLAY,2,Novak Djokovic,N/A Bye,Novak Djokovic,,R32,0,0,0,0,0,0,0,0,0,0,0,0,0,0,0,0,0,0,0,0,0,0,0,0,0,0,0
2009-05-04 00:00:00.000,Belgrade Serbia ATP World Tour 250,CLAY,2,Janko Tipsarevic,Sergio Roitman,Janko Tipsarevic,7-5; 6-2,R32,89,5,0,34,52,26,34,11,18,1,3,10,37,52,0,3,49,72,25,49,11,23,7,12,10,36,72
2009-05-04 00:00:00.000,Belgrade Serbia ATP World Tour 250,CLAY,2,Marcel Granollers,Filip Krajinovic,Marcel Granollers,6-0; 2-6; 6-2,R32,88,0,5,29,64,15,29,21,35,3,7,11,36,64,1,1,36,61,20,36,9,25,5,12,11,29,61
2009-05-04 00:00:00.000,Belgrade Serbia ATP World Tour 250,CLAY,2,Viktor Troicki,Sam Querrey,Viktor Troicki,4-6; 6-4; 6-3,R32,117,4,5,61,98,47,61,16,37,9,12,15,63,98,3,3,46,82,31,46,19,36,2,6,14,50,82
2009-05-04 00:00:00.000,Belgrade Serbia ATP World Tour 250,CLAY,2,Andreas Seppi,N/A Bye,Andreas Seppi,,R32,0,0,0,0,0,0,0,0,0,0,0,0,0,0,0,0,0,0,0,0,0,0,0,0,0,0,0
2009-05-04 00:00:00.000,Belgrade Serbia ATP World Tour 250,CLAY,2,Leonardo Mayer,Wayne Odesnik,Leonardo Mayer,6-3; 6-2,R32,73,5,3,31,50,25,31,10,19,2,2,8,35,50,2,3,25,48,17,25,9,23,1,5,9,26,48
2009-05-04 00:00:00.000,Belgrade Serbia ATP World Tour 250,CLAY,2,Marcos Daniel,Guillermo Canas,Marcos Daniel,3-6; 6-1; 6-4,R32,140,3,1,50,72,39,50,11,22,0,1,13,50,72,6,3,55,99,44,55,17,44,7,10,13,61,99
2009-05-04 00:00:00.000,Belgrade Serbia ATP World Tour 250,CLAY,2,Ivan Ljubicic,Victor Crivoi,Ivan Ljubicic,7-6(2); 3-6; 6-4,R32,143,17,3,60,113,45,60,28,53,11,13,15,73,113,11,0,80,98,56,80,9,18,7,9,16,65,98
2009-05-04 00:00:00.000,Belgrade Serbia ATP World Tour 250,CLAY,2,Christophe Rochus,Nicolas Devilder,Christophe Rochus,6-3; 6-7(7); 7-5,R32,180,2,2,64,135,45,64,35,71,11,16,17,80,135,7,8,78,142,52,78,26,64,14,21,16,78,142
2009-05-04 00:00:00.000,Belgrade Serbia ATP World Tour 250,CLAY,2,Kristof Vliegen,Dominik Hrbaty,Kristof Vliegen,2-6; 6-2; 6-2,R32,95,6,1,37,64,29,37,15,27,1,3,12,44,64,1,4,57,86,36,57,11,29,4,8,12,47,86
2009-05-04 00:00:00.000,Belgrade Serbia ATP World Tour 250,CLAY,2,Lukasz Kubot,Arsenije Zlatanovic,Lukasz Kubot,6-3; 7-5,R32,100,3,3,36,62,22,36,18,26,1,3,10,40,62,7,2,36,67,22,36,13,31,2,7,11,35,67
2009-05-04 00:00:00.000,Belgrade Serbia ATP World Tour 250,CLAY,2,Igor Andreev,N/A Bye,Igor Andreev,,R32,0,0,0,0,0,0,0,0,0,0,0,0,0,0,0,0,0,0,0,0,0,0,0,0,0,0,0
2009-05-04 00:00:00.000,Belgrade Serbia ATP World Tour 250,CLAY,2,Arnaud Clement,Santiago Ventura,Arnaud Clement,6-1; 6-4,R32,82,1,1,45,55,30,45,4,10,4,6,9,34,55,3,2,42,54,20,42,4,12,3,8,8,24,54
2009-05-04 00:00:00.000,Belgrade Serbia ATP World Tour 250,CLAY,2,Flavio Cipolla,Marcos Baghdatis,Flavio Cipolla,1-6; 6-3; 6-1,R32,126,0,4,76,94,42,76,10,18,14,18,12,52,94,3,1,77,101,40,77,12,24,15,20,11,52,101
2009-05-04 00:00:00.000,Belgrade Serbia ATP World Tour 250,CLAY,2,Brian Dabul,Nicolas Massu,Brian Dabul,6-2; 6-1,R32,75,4,0,39,54,29,39,8,15,3,3,8,37,54,2,0,28,50,15,28,10,22,8,12,7,25,50
2009-05-04 00:00:00.000,Belgrade Serbia ATP World Tour 250,CLAY,2,Ivo Karlovic,N/A Bye,Ivo Karlovic,,R32,0,0,0,0,0,0,0,0,0,0,0,0,0,0,0,0,0,0,0,0,0,0,0,0,0,0,0
2009-05-04 00:00:00.000,Belgrade Serbia ATP World Tour 250,CLAY,2,Novak Djokovic,Janko Tipsarevic,Novak Djokovic,6-2; 4-6; 6-0,R16,121,6,3,40,63,31,40,12,23,2,4,12,43,63,5,2,50,96,31,50,17,46,13,19,12,48,96
2009-05-04 00:00:00.000,Belgrade Serbia ATP World Tour 250,CLAY,2,Viktor Troicki,Marcel Granollers,Viktor Troicki,6-3; 6-4,R16,88,2,0,36,57,26,36,14,21,1,2,10,40,57,0,2,32,62,18,32,17,30,7,10,9,35,62
2009-05-04 00:00:00.000,Belgrade Serbia ATP World Tour 250,CLAY,2,Andreas Seppi,Leonardo Mayer,Andreas Seppi,6-4; 6-1,R16,72,0,2,28,50,20,28,12,22,0,1,8,32,50,0,3,34,56,19,34,9,22,4,9,9,28,56
2009-05-04 00:00:00.000,Belgrade Serbia ATP World Tour 250,CLAY,2,Marcos Daniel,Ivan Ljubicic,Marcos Daniel,6-4; 6-3,R16,78,5,2,39,56,28,39,11,17,1,2,10,39,56,5,0,29,51,22,29,9,22,3,6,9,31,51
2009-05-04 00:00:00.000,Belgrade Serbia ATP World Tour 250,CLAY,2,Kristof Vliegen,Christophe Rochus,Kristof Vliegen,3-6; 6-4; 6-3,R16,93,8,2,47,78,29,47,19,31,3,7,14,48,78,1,2,35,78,22,35,24,43,1,6,14,46,78
2009-05-04 00:00:00.000,Belgrade Serbia ATP World Tour 250,CLAY,2,Lukasz Kubot,Igor Andreev,Lukasz Kubot,3-2 RET,R16,36,1,0,10,18,9,10,4,8,0,0,3,13,18,0,0,17,25,10,17,5,8,5,5,2,15,25
2009-05-04 00:00:00.000,Belgrade Serbia ATP World Tour 250,CLAY,2,Flavio Cipolla,Arnaud Clement,Flavio Cipolla,1-6; 6-4; 6-2,R16,118,1,5,57,76,34,57,11,19,4,7,12,45,76,2,2,43,80,31,43,17,37,4,8,13,48,80
2009-05-04 00:00:00.000,Belgrade Serbia ATP World Tour 250,CLAY,2,Ivo Karlovic,Brian Dabul,Ivo Karlovic,6-4; 7-6(5),R16,106,19,5,60,80,47,60,9,20,9,9,11,56,80,2,2,52,75,40,52,12,23,5,6,11,52,75
2009-05-04 00:00:00.000,Belgrade Serbia ATP World Tour 250,CLAY,2,Novak Djokovic,Viktor Troicki,Novak Djokovic,6-3; 6-2,Q,70,2,0,34,49,26,34,7,15,2,3,9,33,49,1,1,25,44,15,25,7,19,0,4,8,22,44
2009-05-04 00:00:00.000,Belgrade Serbia ATP World Tour 250,CLAY,2,Andreas Seppi,Marcos Daniel,Andreas Seppi,6-4; 7-5,Q,119,2,2,51,74,32,51,15,23,3,6,11,47,74,1,2,49,86,31,49,14,37,6,11,11,45,86
2009-05-04 00:00:00.000,Belgrade Serbia ATP World Tour 250,CLAY,2,Lukasz Kubot,Kristof Vliegen,Lukasz Kubot,7-6(6); 6-3,Q,108,1,2,48,77,28,48,13,29,6,10,10,41,77,5,3,40,68,22,40,12,28,3,9,11,34,68
2009-05-04 00:00:00.000,Belgrade Serbia ATP World Tour 250,CLAY,2,Ivo Karlovic,Flavio Cipolla,Ivo Karlovic,6-3; 6-3,Q,72,13,3,33,51,29,33,9,18,1,1,9,38,51,0,3,42,56,24,42,6,14,3,6,9,30,56
2009-05-04 00:00:00.000,Belgrade Serbia ATP World Tour 250,CLAY,2,Novak Djokovic,Andreas Seppi,Novak Djokovic,4-6; 6-1; 6-2,S,137,1,3,59,97,41,59,19,38,6,8,13,60,97,3,7,62,89,40,62,7,27,6,11,12,47,89
2009-05-04 00:00:00.000,Belgrade Serbia ATP World Tour 250,CLAY,2,Lukasz Kubot,Ivo Karlovic,Lukasz Kubot,7-6(0); 6-2,S,97,2,3,37,66,29,37,18,29,4,4,10,47,66,14,1,35,56,28,35,10,21,3,5,10,38,56
2009-05-04 00:00:00.000,Belgrade Serbia ATP World Tour 250,CLAY,2,Novak Djokovic,Lukasz Kubot,Novak Djokovic,6-3; 7-6(0),F,110,6,2,46,69,32,46,14,23,6,9,11,46,69,2,1,40,61,26,40,7,21,3,7,10,33,61
2009-05-10 00:00:00.000,ATP World Tour Masters 1000 Madrid Spain ATP World Tour Masters 1000,CLAY,2,Rafael Nadal,N/A Bye,Rafael Nadal,,R64,0,0,0,0,0,0,0,0,0,0,0,0,0,0,0,0,0,0,0,0,0,0,0,0,0,0,0
2009-05-10 00:00:00.000,ATP World Tour Masters 1000 Madrid Spain ATP World Tour Masters 1000,CLAY,2,Jurgen Melzer,Albert Montanes,Jurgen Melzer,4-6; 7-5; 6-3,R64,120,10,4,46,82,38,46,20,36,1,3,16,58,82,3,3,51,91,35,51,26,40,3,6,15,61,91
2009-05-10 00:00:00.000,ATP World Tour Masters 1000 Madrid Spain ATP World Tour Masters 1000,CLAY,2,Philipp Kohlschreiber,Nicolas Almagro,Philipp Kohlschreiber,6-3; 6-4,R64,92,2,1,44,63,33,44,12,19,3,3,10,45,63,7,0,36,69,29,36,13,33,7,9,9,42,69
2009-05-10 00:00:00.000,ATP World Tour Masters 1000 Madrid Spain ATP World Tour Masters 1000,CLAY,2,Marin Cilic,Marcel Granollers,Marin Cilic,6-2; 6-7(4); 6-1,R64,149,3,3,57,108,38,57,31,51,8,9,14,69,108,0,4,45,79,26,45,21,34,5,10,13,47,79
2009-05-10 00:00:00.000,ATP World Tour Masters 1000 Madrid Spain ATP World Tour Masters 1000,CLAY,2,David Ferrer,Guillermo Canas,David Ferrer,6-2; 6-2,R64,84,0,1,23,41,18,23,13,18,1,2,8,31,41,2,2,26,66,14,26,18,40,7,12,8,32,66
2009-05-10 00:00:00.000,ATP World Tour Masters 1000 Madrid Spain ATP World Tour Masters 1000,CLAY,2,Juan Monaco,Feliciano Lopez,Juan Monaco,6-4; 7-5,R64,130,0,1,52,74,35,52,15,22,6,6,11,50,74,5,1,44,93,31,44,25,49,12,14,11,56,93
2009-05-10 00:00:00.000,ATP World Tour Masters 1000 Madrid Spain ATP World Tour Masters 1000,CLAY,2,Juan Carlos Ferrero,Igor Kunitsyn,Juan Carlos Ferrero,6-3; 4-6; 6-4,R64,131,1,3,63,98,37,63,21,35,4,8,15,58,98,1,1,61,85,36,61,11,24,5,10,14,47,85
2009-05-10 00:00:00.000,ATP World Tour Masters 1000 Madrid Spain ATP World Tour Masters 1000,CLAY,2,Fernando Verdasco,N/A Bye,Fernando Verdasco,,R64,0,0,0,0,0,0,0,0,0,0,0,0,0,0,0,0,0,0,0,0,0,0,0,0,0,0,0
2009-05-10 00:00:00.000,ATP World Tour Masters 1000 Madrid Spain ATP World Tour Masters 1000,CLAY,2,Novak Djokovic,N/A Bye,Novak Djokovic,,R64,0,0,0,0,0,0,0,0,0,0,0,0,0,0,0,0,0,0,0,0,0,0,0,0,0,0,0
2009-05-10 00:00:00.000,ATP World Tour Masters 1000 Madrid Spain ATP World Tour Masters 1000,CLAY,2,Oscar Hernandez,Martin Vassallo Arguello,Oscar Hernandez,6-3; 6-3,R64,91,2,1,38,51,30,38,8,13,1,1,9,38,51,1,0,49,75,31,49,8,26,7,10,9,39,75
2009-05-10 00:00:00.000,ATP World Tour Masters 1000 Madrid Spain ATP World Tour Masters 1000,CLAY,2,Andreas Seppi,Eduardo Schwank,Andreas Seppi,7-5; 6-4,R64,107,2,0,54,80,33,54,16,26,9,11,11,49,80,1,4,34,59,21,34,15,25,0,4,11,36,59
2009-05-10 00:00:00.000,ATP World Tour Masters 1000 Madrid Spain ATP World Tour Masters 1000,CLAY,2,Sam Querrey,Radek Stepanek,Sam Querrey,7-6(2); 5-2 RET,R64,78,10,0,33,56,29,33,13,23,1,1,9,42,56,4,4,37,64,24,37,16,27,4,6,10,40,64
2009-05-10 00:00:00.000,ATP World Tour Masters 1000 Madrid Spain ATP World Tour Masters 1000,CLAY,2,Jo-Wilfried Tsonga,Marat Safin,Jo-Wilfried Tsonga,6-4; 7-5,R64,90,2,2,36,60,30,36,15,24,1,1,11,45,60,9,0,30,68,25,30,19,38,4,6,11,44,68
2009-05-10 00:00:00.000,ATP World Tour Masters 1000 Madrid Spain ATP World Tour Masters 1000,CLAY,2,Ivan Ljubicic,Teymuraz Gabashvili,Ivan Ljubicic,6-3; 6-2,R64,68,5,0,23,44,22,23,12,21,0,1,9,34,44,1,4,25,46,14,25,9,21,2,6,8,23,46
2009-05-10 00:00:00.000,ATP World Tour Masters 1000 Madrid Spain ATP World Tour Masters 1000,CLAY,2,Fabio Fognini,Paul-Henri Mathieu,Fabio Fognini,6-7(5); 6-4; 3-0 RET,R64,119,7,2,53,82,33,53,18,29,4,7,13,51,82,8,1,42,83,29,42,18,41,6,11,12,47,83
2009-05-10 00:00:00.000,ATP World Tour Masters 1000 Madrid Spain ATP World Tour Masters 1000,CLAY,2,Gilles Simon,N/A Bye,Gilles Simon,,R64,0,0,0,0,0,0,0,0,0,0,0,0,0,0,0,0,0,0,0,0,0,0,0,0,0,0,0
2009-05-10 00:00:00.000,ATP World Tour Masters 1000 Madrid Spain ATP World Tour Masters 1000,CLAY,2,Juan Martin Del Potro,N/A Bye,Juan Martin Del Potro,,R64,0,0,0,0,0,0,0,0,0,0,0,0,0,0,0,0,0,0,0,0,0,0,0,0,0,0,0
2009-05-10 00:00:00.000,ATP World Tour Masters 1000 Madrid Spain ATP World Tour Masters 1000,CLAY,2,Tomas Berdych,Guillermo Garcia-Lopez,Tomas Berdych,6-0; 7-6(5),R64,109,4,3,41,73,28,41,17,32,8,10,9,45,73,0,4,43,68,27,43,6,25,5,10,9,33,68
2009-05-10 00:00:00.000,ATP World Tour Masters 1000 Madrid Spain ATP World Tour Masters 1000,CLAY,2,Jeremy Chardy,Jose Acasuso,Jeremy Chardy,6-3; 6-2,R64,65,6,2,29,56,22,29,17,27,0,0,9,39,56,0,3,26,46,20,26,6,20,0,3,8,26,46
2009-05-10 00:00:00.000,ATP World Tour Masters 1000 Madrid Spain ATP World Tour Masters 1000,CLAY,2,Stanislas Wawrinka,Marco Crugnola,Stanislas Wawrinka,6-2; 6-0,R64,59,2,2,25,38,18,25,9,13,4,5,7,27,38,0,5,28,46,13,28,5,18,4,10,7,18,46
2009-05-10 00:00:00.000,ATP World Tour Masters 1000 Madrid Spain ATP World Tour Masters 1000,CLAY,2,Tommy Robredo,Nicolas Kiefer,Tommy Robredo,3-6; 6-2; 6-2,R64,119,5,2,49,77,33,49,17,28,5,7,12,50,77,5,6,42,79,30,42,14,37,1,6,13,44,79
2009-05-10 00:00:00.000,ATP World Tour Masters 1000 Madrid Spain ATP World Tour Masters 1000,CLAY,2,Mardy Fish,Janko Tipsarevic,Mardy Fish,7-6(3); 6-4,R64,125,10,1,39,67,29,39,19,28,1,2,11,48,67,7,2,43,72,28,43,17,29,3,5,11,45,72
2009-05-10 00:00:00.000,ATP World Tour Masters 1000 Madrid Spain ATP World Tour Masters 1000,CLAY,2,Simone Bolelli,Juan Ignacio Chela,Simone Bolelli,7-5; 7-6(3),R64,117,4,1,43,76,33,43,23,33,3,3,12,56,76,1,2,43,73,31,43,19,30,3,4,12,50,73
2009-05-10 00:00:00.000,ATP World Tour Masters 1000 Madrid Spain ATP World Tour Masters 1000,CLAY,2,Andy Murray,N/A Bye,Andy Murray,,R64,0,0,0,0,0,0,0,0,0,0,0,0,0,0,0,0,0,0,0,0,0,0,0,0,0,0,0
2009-05-10 00:00:00.000,ATP World Tour Masters 1000 Madrid Spain ATP World Tour Masters 1000,CLAY,2,Andy Roddick,N/A Bye,Andy Roddick,,R64,0,0,0,0,0,0,0,0,0,0,0,0,0,0,0,0,0,0,0,0,0,0,0,0,0,0,0
2009-05-10 00:00:00.000,ATP World Tour Masters 1000 Madrid Spain ATP World Tour Masters 1000,CLAY,2,Tommy Haas,Ernests Gulbis,Tommy Haas,6-2; 5-7; 7-5,R64,138,7,6,52,92,37,52,19,40,1,5,16,56,92,6,2,65,112,42,65,18,47,10,16,16,60,112
2009-05-10 00:00:00.000,ATP World Tour Masters 1000 Madrid Spain ATP World Tour Masters 1000,CLAY,2,Florent Serra,Rainer Schuettler,Florent Serra,6-2; 6-4,R64,64,2,2,41,57,32,41,8,16,3,3,9,40,57,1,3,31,53,18,31,12,22,0,3,9,30,53
2009-05-10 00:00:00.000,ATP World Tour Masters 1000 Madrid Spain ATP World Tour Masters 1000,CLAY,2,Nikolay Davydenko,Viktor Troicki,Nikolay Davydenko,6-2; 6-2,R64,79,2,2,48,61,32,48,6,13,4,5,8,38,61,5,1,22,50,13,22,10,28,2,7,8,23,50
2009-05-10 00:00:00.000,ATP World Tour Masters 1000 Madrid Spain ATP World Tour Masters 1000,CLAY,2,James Blake,Victor Hanescu,James Blake,6-2; 6-4,R64,68,3,1,29,53,23,29,12,24,1,2,9,35,53,7,3,41,59,25,41,6,18,6,10,9,31,59
2009-05-10 00:00:00.000,ATP World Tour Masters 1000 Madrid Spain ATP World Tour Masters 1000,CLAY,2,Ivo Karlovic,Julien Benneteau,Ivo Karlovic,3-6; 7-6(5); 6-4,R64,132,21,1,60,96,47,60,20,36,3,4,15,67,96,8,6,66,97,55,66,13,31,3,4,16,68,97
2009-05-10 00:00:00.000,ATP World Tour Masters 1000 Madrid Spain ATP World Tour Masters 1000,CLAY,2,Robin Soderling,Ivan Navarro,Robin Soderling,6-4; 6-2,R64,71,6,2,29,55,22,29,15,26,2,3,9,37,55,5,3,30,49,20,30,6,19,0,4,9,26,49
2009-05-10 00:00:00.000,ATP World Tour Masters 1000 Madrid Spain ATP World Tour Masters 1000,CLAY,2,Roger Federer,N/A Bye,Roger Federer,,R64,0,0,0,0,0,0,0,0,0,0,0,0,0,0,0,0,0,0,0,0,0,0,0,0,0,0,0
2009-05-10 00:00:00.000,ATP World Tour Masters 1000 Madrid Spain ATP World Tour Masters 1000,CLAY,2,Rafael Nadal,Jurgen Melzer,Rafael Nadal,6-3; 6-1,R32,62,1,0,24,41,21,24,11,17,0,0,8,32,41,3,4,22,41,15,22,7,19,0,4,8,22,41
2009-05-10 00:00:00.000,ATP World Tour Masters 1000 Madrid Spain ATP World Tour Masters 1000,CLAY,2,Philipp Kohlschreiber,Marin Cilic,Philipp Kohlschreiber,6-1; 6-7(5); 7-6(2),R32,175,4,2,85,122,57,85,22,37,7,8,16,79,122,7,3,71,123,48,71,24,52,15,18,15,72,123
2009-05-10 00:00:00.000,ATP World Tour Masters 1000 Madrid Spain ATP World Tour Masters 1000,CLAY,2,Juan Monaco,David Ferrer,Juan Monaco,6-4; 6-4,R32,90,1,2,44,55,30,44,7,11,3,5,10,37,55,2,4,42,70,26,42,12,28,6,10,10,38,70
2009-05-10 00:00:00.000,ATP World Tour Masters 1000 Madrid Spain ATP World Tour Masters 1000,CLAY,2,Fernando Verdasco,Juan Carlos Ferrero,Fernando Verdasco,6-3; 6-2,R32,96,4,1,52,67,32,52,7,15,5,7,9,39,67,2,0,35,54,20,35,5,19,1,6,8,25,54
2009-05-10 00:00:00.000,ATP World Tour Masters 1000 Madrid Spain ATP World Tour Masters 1000,CLAY,2,Novak Djokovic,Oscar Hernandez,Novak Djokovic,6-3; 6-3,R32,99,3,3,38,56,31,38,8,18,0,0,9,39,56,3,3,54,77,29,54,12,23,9,12,9,41,77
2009-05-10 00:00:00.000,ATP World Tour Masters 1000 Madrid Spain ATP World Tour Masters 1000,CLAY,2,Andreas Seppi,Sam Querrey,Andreas Seppi,6-3; 4-6; 6-4,R32,117,6,1,60,98,42,60,20,38,8,10,14,62,98,10,1,59,89,42,59,14,30,8,12,15,56,89
2009-05-10 00:00:00.000,ATP World Tour Masters 1000 Madrid Spain ATP World Tour Masters 1000,CLAY,2,Ivan Ljubicic,Jo-Wilfried Tsonga,Ivan Ljubicic,6-4; 7-5,R32,100,6,3,43,77,37,43,16,34,5,6,11,53,77,8,3,35,63,27,35,13,28,3,6,11,40,63
2009-05-10 00:00:00.000,ATP World Tour Masters 1000 Madrid Spain ATP World Tour Masters 1000,CLAY,2,Gilles Simon,Fabio Fognini,Gilles Simon,6-3; 6-2,R32,71,2,0,37,59,25,37,13,22,2,4,9,38,59,1,7,28,55,16,28,10,27,3,8,8,26,55
2009-05-10 00:00:00.000,ATP World Tour Masters 1000 Madrid Spain ATP World Tour Masters 1000,CLAY,2,Juan Martin Del Potro,Tomas Berdych,Juan Martin Del Potro,6-2; 4-1 RET,R32,69,3,0,21,30,16,21,8,9,0,0,6,24,30,1,0,36,59,22,36,6,23,6,10,7,28,59
2009-05-10 00:00:00.000,ATP World Tour Masters 1000 Madrid Spain ATP World Tour Masters 1000,CLAY,2,Stanislas Wawrinka,Jeremy Chardy,Stanislas Wawrinka,6-4; 7-5,R32,98,12,0,39,63,29,39,17,24,2,3,11,46,63,4,3,49,77,31,49,15,28,8,11,11,46,77
2009-05-10 00:00:00.000,ATP World Tour Masters 1000 Madrid Spain ATP World Tour Masters 1000,CLAY,2,Tommy Robredo,Mardy Fish,Tommy Robredo,3-6; 7-6(5); 6-2,R32,134,2,0,67,92,48,67,14,25,2,4,14,62,92,6,3,53,88,40,53,20,35,1,4,15,60,88
2009-05-10 00:00:00.000,ATP World Tour Masters 1000 Madrid Spain ATP World Tour Masters 1000,CLAY,2,Andy Murray,Simone Bolelli,Andy Murray,7-6(9); 6-4,R32,128,4,2,38,77,29,38,25,39,4,4,11,54,77,6,0,54,83,37,54,17,29,2,3,11,54,83
2009-05-10 00:00:00.000,ATP World Tour Masters 1000 Madrid Spain ATP World Tour Masters 1000,CLAY,2,Andy Roddick,Tommy Haas,Andy Roddick,1-6; 7-6(9); 6-4,R32,143,9,2,70,97,51,70,15,27,0,2,14,66,97,14,5,62,112,49,62,27,50,11,12,15,76,112
2009-05-10 00:00:00.000,ATP World Tour Masters 1000 Madrid Spain ATP World Tour Masters 1000,CLAY,2,Nikolay Davydenko,Florent Serra,Nikolay Davydenko,7-5; 6-3,R32,87,7,2,48,66,32,48,9,18,4,6,11,41,66,2,0,47,71,32,47,7,24,3,7,10,39,71
2009-05-10 00:00:00.000,ATP World Tour Masters 1000 Madrid Spain ATP World Tour Masters 1000,CLAY,2,James Blake,Ivo Karlovic,James Blake,6-7(4); 6-4; 7-6(4),R32,124,4,4,70,108,58,70,25,38,1,1,17,83,108,26,4,65,97,58,65,18,32,0,1,17,76,97
2009-05-10 00:00:00.000,ATP World Tour Masters 1000 Madrid Spain ATP World Tour Masters 1000,CLAY,2,Roger Federer,Robin Soderling,Roger Federer,6-1; 7-5,R32,70,11,1,27,54,23,27,17,27,0,1,10,40,54,4,5,34,57,21,34,9,23,3,7,9,30,57
2009-05-10 00:00:00.000,ATP World Tour Masters 1000 Madrid Spain ATP World Tour Masters 1000,CLAY,2,Rafael Nadal,Philipp Kohlschreiber,Rafael Nadal,W/O,R16,0,0,0,0,0,0,0,0,0,0,0,0,0,0,0,0,0,0,0,0,0,0,0,0,0,0,0
2009-05-10 00:00:00.000,ATP World Tour Masters 1000 Madrid Spain ATP World Tour Masters 1000,CLAY,2,Fernando Verdasco,Juan Monaco,Fernando Verdasco,7-5; 6-2,R16,108,2,1,51,71,31,51,11,20,2,4,10,42,71,0,1,52,68,24,52,8,16,5,10,10,32,68
2009-05-10 00:00:00.000,ATP World Tour Masters 1000 Madrid Spain ATP World Tour Masters 1000,CLAY,2,Novak Djokovic,Andreas Seppi,Novak Djokovic,6-4; 6-4,R16,98,3,2,37,57,29,37,11,20,1,2,10,40,57,3,1,56,77,33,56,11,21,8,11,10,44,77
2009-05-10 00:00:00.000,ATP World Tour Masters 1000 Madrid Spain ATP World Tour Masters 1000,CLAY,2,Ivan Ljubicic,Gilles Simon,Ivan Ljubicic,3-6; 6-4; 6-3,R16,130,5,3,58,101,39,58,23,43,10,12,14,62,101,11,1,43,74,35,43,17,31,2,5,14,52,74
2009-05-10 00:00:00.000,ATP World Tour Masters 1000 Madrid Spain ATP World Tour Masters 1000,CLAY,2,Juan Martin Del Potro,Stanislas Wawrinka,Juan Martin Del Potro,4-6; 6-4; 6-4,R16,176,5,3,55,110,40,55,26,55,9,13,15,66,110,8,1,59,92,40,59,13,33,4,9,15,53,92
2009-05-10 00:00:00.000,ATP World Tour Masters 1000 Madrid Spain ATP World Tour Masters 1000,CLAY,2,Andy Murray,Tommy Robredo,Andy Murray,7-5; 6-1,R16,104,0,2,39,60,29,39,13,21,2,2,9,42,60,1,2,47,70,28,47,10,23,8,12,10,38,70
2009-05-10 00:00:00.000,ATP World Tour Masters 1000 Madrid Spain ATP World Tour Masters 1000,CLAY,2,Andy Roddick,Nikolay Davydenko,Andy Roddick,W/O,R16,0,0,0,0,0,0,0,0,0,0,0,0,0,0,0,0,0,0,0,0,0,0,0,0,0,0,0
2009-05-10 00:00:00.000,ATP World Tour Masters 1000 Madrid Spain ATP World Tour Masters 1000,CLAY,2,Roger Federer,James Blake,Roger Federer,6-2; 6-4,R16,62,5,0,31,54,27,31,13,23,1,1,9,40,54,1,5,28,54,17,28,16,26,1,4,9,33,54
2009-05-10 00:00:00.000,ATP World Tour Masters 1000 Madrid Spain ATP World Tour Masters 1000,CLAY,2,Rafael Nadal,Fernando Verdasco,Rafael Nadal,6-4; 7-5,Q,119,1,1,59,76,37,59,10,17,3,5,11,47,76,5,7,44,62,26,44,7,18,5,9,11,33,62
2009-05-10 00:00:00.000,ATP World Tour Masters 1000 Madrid Spain ATP World Tour Masters 1000,CLAY,2,Novak Djokovic,Ivan Ljubicic,Novak Djokovic,6-4; 6-4,Q,105,5,1,39,61,30,39,14,22,2,2,10,44,61,3,0,34,72,23,34,23,38,5,7,10,46,72
2009-05-10 00:00:00.000,ATP World Tour Masters 1000 Madrid Spain ATP World Tour Masters 1000,CLAY,2,Juan Martin Del Potro,Andy Murray,Juan Martin Del Potro,7-6(4); 6-3,Q,112,5,2,42,76,30,42,23,34,4,5,11,53,76,11,1,36,62,24,36,15,26,2,4,10,39,62
2009-05-10 00:00:00.000,ATP World Tour Masters 1000 Madrid Spain ATP World Tour Masters 1000,CLAY,2,Roger Federer,Andy Roddick,Roger Federer,7-5; 6-7(5); 6-1,Q,131,15,2,56,97,49,56,20,41,2,3,16,69,97,9,1,61,91,42,61,16,30,5,9,15,58,91
2009-05-10 00:00:00.000,ATP World Tour Masters 1000 Madrid Spain ATP World Tour Masters 1000,CLAY,2,Rafael Nadal,Novak Djokovic,Rafael Nadal,3-6; 7-6(5); 7-6(9),S,243,4,4,101,133,72,101,16,32,6,8,16,88,133,7,3,69,112,56,69,24,43,1,2,17,80,112
2009-05-10 00:00:00.000,ATP World Tour Masters 1000 Madrid Spain ATP World Tour Masters 1000,CLAY,2,Roger Federer,Juan Martin Del Potro,Roger Federer,6-3; 6-4,S,81,8,1,39,60,32,39,11,21,4,4,10,43,60,3,2,35,59,25,35,11,24,4,6,9,36,59
2009-05-10 00:00:00.000,ATP World Tour Masters 1000 Madrid Spain ATP World Tour Masters 1000,CLAY,2,Roger Federer,Rafael Nadal,Roger Federer,6-4; 6-4,F,86,6,3,42,67,29,42,17,25,4,4,10,46,67,1,1,43,54,32,43,5,11,0,2,10,37,54
2009-05-17 00:00:00.000,Kitzbnhel Austria ATP World Tour 250,CLAY,2,Diego Junqueira,Paul Capdeville,Diego Junqueira,6-3; 6-2,R32,51,7,3,28,53,24,28,12,25,1,2,9,36,53,0,0,31,41,16,31,6,10,0,4,8,22,41
2009-05-17 00:00:00.000,Kitzbnhel Austria ATP World Tour 250,CLAY,2,Daniel Koellerer,Thomaz Bellucci,Daniel Koellerer,6-4; 6-4,R32,107,1,1,54,73,34,54,9,19,2,4,10,43,73,7,3,39,62,25,39,9,23,6,10,10,34,62
2009-05-17 00:00:00.000,Kitzbnhel Austria ATP World Tour 250,CLAY,2,Nicolas Massu,Robin Vik,Nicolas Massu,6-4; 6-2,R32,108,2,3,48,84,32,48,18,36,8,9,9,50,84,0,3,33,46,20,33,5,13,1,5,9,25,46
2009-05-17 00:00:00.000,Kitzbnhel Austria ATP World Tour 250,CLAY,2,Julien Benneteau,Dudi Sela,Julien Benneteau,7-5; 6-1,R32,81,5,2,36,59,28,36,13,23,3,4,10,41,59,1,2,30,60,18,30,13,30,2,6,9,31,60
2009-05-17 00:00:00.000,Kitzbnhel Austria ATP World Tour 250,CLAY,2,Oscar Hernandez,Fabrice Santoro,Oscar Hernandez,6-2; 6-3,R32,59,1,1,31,39,26,31,6,8,0,0,8,32,39,1,1,29,48,15,29,10,19,0,4,9,25,48
2009-05-17 00:00:00.000,Kitzbnhel Austria ATP World Tour 250,CLAY,2,Andreas Beck,Jan Hernych,Andreas Beck,5-7; 6-3; 7-5,R32,137,3,5,44,92,32,44,28,48,3,5,16,60,92,2,4,61,102,37,61,23,41,5,9,17,60,102
2009-05-17 00:00:00.000,Kitzbnhel Austria ATP World Tour 250,CLAY,2,Ruben Ramirez Hidalgo,Mario Ancic,Ruben Ramirez Hidalgo,6-4; 6-3,R32,89,2,3,30,51,26,30,13,21,4,4,9,39,51,4,1,38,61,25,38,12,23,3,6,10,37,61
2009-05-17 00:00:00.000,Kitzbnhel Austria ATP World Tour 250,CLAY,2,Juan Ignacio Chela,Marc Gicquel,Juan Ignacio Chela,5-7; 6-3; 6-0,R32,133,4,2,58,91,37,58,16,33,6,11,14,53,91,2,4,51,94,29,51,14,43,5,13,13,43,94
2009-05-17 00:00:00.000,Kitzbnhel Austria ATP World Tour 250,CLAY,2,Martin Vassallo Arguello,Christophe Rochus,Martin Vassallo Arguello,6-2; 6-4,R32,80,5,1,34,55,23,34,13,21,2,3,9,36,55,0,3,21,52,15,21,12,31,5,9,9,27,52
2009-05-17 00:00:00.000,Kitzbnhel Austria ATP World Tour 250,CLAY,2,Guillermo Garcia-Lopez,Bjorn Phau,Guillermo Garcia-Lopez,6-3; 6-2,R32,80,2,1,29,39,24,29,6,10,2,3,8,30,39,1,6,40,74,23,40,12,34,5,10,9,35,74
2009-05-17 00:00:00.000,Kitzbnhel Austria ATP World Tour 250,CLAY,2,Marcel Granollers,Teymuraz Gabashvili,Marcel Granollers,7-6(11); 6-3,R32,134,3,4,45,87,33,45,21,42,7,9,11,54,87,2,9,39,82,24,39,19,43,3,6,10,43,82
2009-05-17 00:00:00.000,Kitzbnhel Austria ATP World Tour 250,CLAY,2,Victor Hanescu,Nicolas Lapentti,Victor Hanescu,6-7(6); 6-3; 7-5,R32,166,5,2,63,90,49,63,19,27,2,3,16,68,90,2,4,76,123,50,76,25,47,10,14,17,75,123
2009-05-17 00:00:00.000,Kitzbnhel Austria ATP World Tour 250,CLAY,2,Mikhail Youzhny,Daniel Gimeno-Traver,Mikhail Youzhny,6-2; 7-6(7),R32,94,5,1,50,70,36,50,15,20,5,5,10,51,70,4,6,56,81,36,56,12,25,5,7,10,48,81
2009-05-17 00:00:00.000,Kitzbnhel Austria ATP World Tour 250,CLAY,2,Stefan Koubek,Philipp Petzschner,Stefan Koubek,7-6(8); 6-4,R32,92,3,5,30,68,23,30,25,38,0,1,11,48,68,6,1,35,86,29,35,24,51,4,6,11,53,86
2009-05-17 00:00:00.000,Kitzbnhel Austria ATP World Tour 250,CLAY,2,Agustin Calleri,Yen-Hsun Lu,Agustin Calleri,3-6; 7-5; 0-1 RET,R32,98,5,7,42,79,29,42,19,37,7,10,11,48,79,8,4,37,68,30,37,14,31,2,4,11,44,68
2009-05-17 00:00:00.000,Kitzbnhel Austria ATP World Tour 250,CLAY,2,Jurgen Melzer,Frederico Gil,Jurgen Melzer,6-3; 6-0,R32,54,5,2,20,37,16,20,13,17,1,2,8,29,37,1,1,37,54,13,37,10,17,5,10,7,23,54
2009-05-17 00:00:00.000,Kitzbnhel Austria ATP World Tour 250,CLAY,2,Daniel Koellerer,Diego Junqueira,Daniel Koellerer,6-1; 6-2,R16,63,2,0,25,40,23,25,10,15,1,1,8,33,40,1,4,30,50,16,30,9,20,4,8,7,25,50
2009-05-17 00:00:00.000,Kitzbnhel Austria ATP World Tour 250,CLAY,2,Julien Benneteau,Nicolas Massu,Julien Benneteau,6-1; 6-7(4); 7-6(7),R16,187,13,8,80,118,55,80,16,38,5,9,16,71,118,2,3,76,110,46,76,13,34,9,15,15,59,110
2009-05-17 00:00:00.000,Kitzbnhel Austria ATP World Tour 250,CLAY,2,Oscar Hernandez,Andreas Beck,Oscar Hernandez,7-5; 6-4,R16,128,6,5,47,77,35,47,16,30,7,8,11,51,77,4,1,47,76,32,47,14,29,9,12,11,46,76
2009-05-17 00:00:00.000,Kitzbnhel Austria ATP World Tour 250,CLAY,2,Juan Ignacio Chela,Ruben Ramirez Hidalgo,Juan Ignacio Chela,6-3; 6-2,R16,102,2,4,30,47,29,30,7,17,0,0,9,36,47,1,7,50,86,30,50,15,36,11,14,8,45,86
2009-05-17 00:00:00.000,Kitzbnhel Austria ATP World Tour 250,CLAY,2,Guillermo Garcia-Lopez,Martin Vassallo Arguello,Guillermo Garcia-Lopez,4-6; 6-4; 6-3,R16,186,0,2,50,90,39,50,25,40,5,6,15,64,90,2,2,54,83,36,54,18,29,5,7,14,54,83
2009-05-17 00:00:00.000,Kitzbnhel Austria ATP World Tour 250,CLAY,2,Victor Hanescu,Marcel Granollers,Victor Hanescu,6-1; 7-6(2),R16,84,5,0,40,62,28,40,18,22,2,2,10,46,62,3,2,29,58,22,29,13,29,0,2,9,35,58
2009-05-17 00:00:00.000,Kitzbnhel Austria ATP World Tour 250,CLAY,2,Mikhail Youzhny,Stefan Koubek,Mikhail Youzhny,6-2; 6-4,R16,89,4,2,23,49,18,23,16,26,4,5,9,34,49,2,1,25,68,21,25,15,43,6,10,9,36,68
2009-05-17 00:00:00.000,Kitzbnhel Austria ATP World Tour 250,CLAY,2,Jurgen Melzer,Agustin Calleri,Jurgen Melzer,6-4; 7-5,R16,87,5,5,39,65,31,39,13,26,3,4,11,44,65,3,3,38,71,24,38,18,33,8,11,11,42,71
2009-05-17 00:00:00.000,Kitzbnhel Austria ATP World Tour 250,CLAY,2,Julien Benneteau,Daniel Koellerer,Julien Benneteau,6-2; 6-7(5); 6-0,Q,151,9,4,62,91,49,62,12,29,4,4,13,61,91,3,3,74,96,44,74,11,22,7,12,13,55,96
2009-05-17 00:00:00.000,Kitzbnhel Austria ATP World Tour 250,CLAY,2,Oscar Hernandez,Juan Ignacio Chela,Oscar Hernandez,6-4; 6-4,Q,95,2,0,44,57,32,44,9,13,1,1,10,41,57,2,3,53,73,38,53,7,20,7,9,10,45,73
2009-05-17 00:00:00.000,Kitzbnhel Austria ATP World Tour 250,CLAY,2,Guillermo Garcia-Lopez,Victor Hanescu,Guillermo Garcia-Lopez,6-2; 6-2,Q,81,0,3,32,55,24,32,12,23,5,6,8,36,55,2,1,33,48,19,33,3,15,3,8,8,22,48
2009-05-17 00:00:00.000,Kitzbnhel Austria ATP World Tour 250,CLAY,2,Mikhail Youzhny,Jurgen Melzer,Mikhail Youzhny,6-4; 6-4,Q,88,5,2,38,63,31,38,11,25,0,1,10,42,63,3,2,32,59,21,32,13,27,1,4,10,34,59
2009-05-17 00:00:00.000,Kitzbnhel Austria ATP World Tour 250,CLAY,2,Julien Benneteau,Oscar Hernandez,Julien Benneteau,6-3; 6-4,S,89,4,6,40,66,30,40,14,26,4,5,10,44,66,4,0,35,48,24,35,6,13,2,5,9,30,48
2009-05-17 00:00:00.000,Kitzbnhel Austria ATP World Tour 250,CLAY,2,Guillermo Garcia-Lopez,Mikhail Youzhny,Guillermo Garcia-Lopez,6-3; 1-6; 7-6(5),S,143,1,7,65,95,46,65,17,30,2,4,14,63,95,5,2,56,87,44,56,17,31,1,2,14,61,87
2009-05-17 00:00:00.000,Kitzbnhel Austria ATP World Tour 250,CLAY,2,Guillermo Garcia-Lopez,Julien Benneteau,Guillermo Garcia-Lopez,3-6; 7-6(1); 6-3,F,190,0,8,73,103,46,73,13,30,4,8,14,59,103,6,9,84,119,54,84,11,35,13,18,16,65,119
2009-05-25 00:00:00.000,Roland Garros France Grand Slams,CLAY,3,Rafael Nadal,Marcos Daniel,Rafael Nadal,7-5; 6-4; 6-3,R128,143,3,0,62,82,42,62,13,20,4,7,15,55,82,4,1,52,93,32,52,17,41,4,11,16,49,93
2009-05-25 00:00:00.000,Roland Garros France Grand Slams,CLAY,3,Teymuraz Gabashvili,Igor Kunitsyn,Teymuraz Gabashvili,6-7(6); 7-6(5); 6-3; 6-1,R128,191,12,4,87,128,54,87,25,41,3,7,20,79,128,3,1,86,129,47,86,23,43,4,12,20,70,129
2009-05-25 00:00:00.000,Roland Garros France Grand Slams,CLAY,3,Andrey Golubev,Denis Gremelmayr,Andrey Golubev,6-3; 6-3; 6-2,R128,98,7,4,40,71,33,40,21,31,2,3,13,54,71,4,3,54,83,32,54,10,29,1,7,13,42,83
2009-05-25 00:00:00.000,Roland Garros France Grand Slams,CLAY,3,Lleyton Hewitt,Ivo Karlovic,Lleyton Hewitt,6-7(1); 6-7(4); 7-6(4); 6-4; 6-3,R128,236,19,6,93,173,76,93,49,80,5,6,27,125,173,55,4,124,169,102,124,20,45,4,8,28,122,169
2009-05-25 00:00:00.000,Roland Garros France Grand Slams,CLAY,3,Robin Soderling,Kevin Kim,Robin Soderling,7-6(4); 7-6(4); 6-2,R128,137,11,4,52,99,41,52,25,47,3,7,16,66,99,10,3,56,112,40,56,23,56,7,13,16,63,112
2009-05-25 00:00:00.000,Roland Garros France Grand Slams,CLAY,3,Denis Istomin,Santiago Giraldo,Denis Istomin,6-3; 6-7(2); 6-3; 7-6(4),R128,205,21,2,96,142,74,96,23,46,1,3,22,97,142,5,2,86,158,60,86,40,72,11,15,20,100,158
2009-05-25 00:00:00.000,Roland Garros France Grand Slams,CLAY,3,Nicolas Kiefer,Ilija Bozoljac,Nicolas Kiefer,7-6(4); 3-6; 7-5; 6-4,R128,193,16,3,64,124,53,64,34,60,5,7,21,87,124,22,10,76,144,59,76,32,68,8,11,22,91,144
2009-05-25 00:00:00.000,Roland Garros France Grand Slams,CLAY,3,David Ferrer,Frederico Gil,David Ferrer,6-2; 6-4; 6-4,R128,127,3,1,51,85,36,51,22,34,2,4,14,58,85,2,2,54,91,33,54,15,37,3,9,14,48,91
2009-05-25 00:00:00.000,Roland Garros France Grand Slams,CLAY,3,Nikolay Davydenko,Stefan Koubek,Nikolay Davydenko,6-2; 6-1; 6-4,R128,100,3,4,40,66,32,40,16,26,1,2,12,48,66,2,3,51,92,25,51,21,41,10,17,13,46,92
2009-05-25 00:00:00.000,Roland Garros France Grand Slams,CLAY,3,Diego Junqueira,Paul Capdeville,Diego Junqueira,3-6; 7-5; 6-1; 6-3,R128,155,2,3,84,114,57,84,13,30,5,10,18,70,114,7,7,75,117,47,75,17,42,4,13,19,64,117
2009-05-25 00:00:00.000,Roland Garros France Grand Slams,CLAY,3,Nicolas Massu,Daniel Koellerer,Nicolas Massu,6-3; 6-4; 1-6; 2-6; 6-3,R128,223,5,5,92,155,63,92,32,63,11,16,22,95,155,6,5,78,117,55,78,23,39,6,10,21,78,117
2009-05-25 00:00:00.000,Roland Garros France Grand Slams,CLAY,3,Stanislas Wawrinka,Nicolas Devilder,Stanislas Wawrinka,6-3; 5-7; 2-6; 6-4; 6-4,R128,239,6,3,94,133,69,94,15,39,6,13,24,84,133,2,5,113,180,71,113,28,67,15,23,25,99,180
2009-05-25 00:00:00.000,Roland Garros France Grand Slams,CLAY,3,Nicolas Almagro,Agustin Calleri,Nicolas Almagro,6-4; 6-1; 6-3,R128,89,11,1,35,62,31,35,21,27,0,0,13,52,62,5,4,33,69,26,33,15,36,4,9,13,41,69
2009-05-25 00:00:00.000,Roland Garros France Grand Slams,CLAY,3,Ernests Gulbis,Sam Querrey,Ernests Gulbis,7-6(1); 6-1; 3-6; 6-1,R128,106,26,0,59,90,52,59,21,31,0,1,18,73,90,15,3,65,97,47,65,15,32,2,6,17,62,97
2009-05-25 00:00:00.000,Roland Garros France Grand Slams,CLAY,3,Philipp Petzschner,Peter Polansky,Philipp Petzschner,5-7; 6-2; 7-6(4); 4-6; 6-3,R128,222,10,7,96,168,68,96,44,72,7,11,26,112,168,10,10,99,167,74,99,32,68,6,11,25,106,167
2009-05-25 00:00:00.000,Roland Garros France Grand Slams,CLAY,3,Fernando Verdasco,Florent Serra,Fernando Verdasco,6-2; 6-1; 6-4,R128,131,15,2,60,84,45,60,12,24,6,7,13,57,84,2,1,70,112,42,70,14,42,22,28,12,56,112
2009-05-25 00:00:00.000,Roland Garros France Grand Slams,CLAY,3,Andy Murray,Juan Ignacio Chela,Andy Murray,6-2; 6-2; 6-1,R128,103,10,3,48,84,34,48,20,36,8,10,12,54,84,1,4,42,73,19,42,11,31,8,16,11,30,73
2009-05-25 00:00:00.000,Roland Garros France Grand Slams,CLAY,3,Potito Starace,Mischa Zverev,Potito Starace,6-7(5); 7-5; 1-0 RET,R128,129,3,2,64,81,41,64,11,17,2,4,13,52,81,5,2,57,87,37,57,13,30,9,12,12,50,87
2009-05-25 00:00:00.000,Roland Garros France Grand Slams,CLAY,3,Janko Tipsarevic,Albert Montanes,Janko Tipsarevic,3-6; 7-6(3); 7-6(5); 6-4,R128,220,18,2,86,135,65,86,29,49,0,3,22,94,135,16,4,85,146,69,85,29,61,9,11,21,98,146
2009-05-25 00:00:00.000,Roland Garros France Grand Slams,CLAY,3,Feliciano Lopez,Franco Ferreiro,Feliciano Lopez,6-7(3); 4-6; 7-6(4); 7-5; 6-2,R128,258,30,1,110,174,83,110,41,64,7,9,27,124,174,11,5,137,186,96,137,28,49,6,10,27,124,186
2009-05-25 00:00:00.000,Roland Garros France Grand Slams,CLAY,3,Radek Stepanek,Gaston Gaudio,Radek Stepanek,6-3; 6-4; 6-1,R128,112,5,3,43,76,34,43,18,33,0,1,13,52,76,4,2,57,83,33,57,12,26,5,11,13,45,83
2009-05-25 00:00:00.000,Roland Garros France Grand Slams,CLAY,3,Mathieu Montcourt,Yen-Hsun Lu,Mathieu Montcourt,6-2 RET,R128,40,1,3,14,28,8,14,9,14,1,2,4,17,28,0,2,17,31,7,17,6,14,4,7,4,13,31
2009-05-25 00:00:00.000,Roland Garros France Grand Slams,CLAY,3,Dudi Sela,Jean-Rene Lisnard,Dudi Sela,6-4; 6-3; 4-6; 6-3,R128,172,9,1,77,109,52,77,21,32,5,8,19,73,109,6,8,70,128,49,70,28,58,8,14,19,77,128
2009-05-25 00:00:00.000,Roland Garros France Grand Slams,CLAY,3,Marin Cilic,Jan Hernych,Marin Cilic,6-0; 6-4; 6-3,R128,154,6,3,43,80,34,43,23,37,5,6,13,57,80,4,3,82,133,48,82,19,51,21,27,12,67,133
2009-05-25 00:00:00.000,Roland Garros France Grand Slams,CLAY,3,Fernando Gonzalez,Jiri Vanek,Fernando Gonzalez,6-3; 6-2; 6-3,R128,85,18,0,34,62,30,34,24,28,1,1,13,54,62,4,6,51,88,34,51,13,37,6,11,13,47,88
2009-05-25 00:00:00.000,Roland Garros France Grand Slams,CLAY,3,Rui Machado,Kristof Vliegen,Rui Machado,6-2; 6-4; 4-6; 2-6; 6-3,R128,201,3,3,104,151,71,104,26,47,12,16,23,97,151,10,5,80,139,57,80,29,59,10,15,22,86,139
2009-05-25 00:00:00.000,Roland Garros France Grand Slams,CLAY,3,Josselin Ouanna,Marcel Granollers,Josselin Ouanna,7-5; 2-6; 3-6; 7-6(2); 6-1,R128,222,13,3,98,152,70,98,28,54,7,11,23,98,152,3,5,106,149,74,106,21,43,6,11,25,95,149
2009-05-25 00:00:00.000,Roland Garros France Grand Slams,CLAY,3,Marat Safin,Alexandre Sidorenko,Marat Safin,6-4; 6-4; 6-4,R128,137,6,2,52,92,38,52,24,40,5,7,15,62,92,4,5,54,108,39,54,20,54,7,12,15,59,108
2009-05-25 00:00:00.000,Roland Garros France Grand Slams,CLAY,3,Victor Hanescu,Steve Darcis,Victor Hanescu,7-6(8); 7-6(5); 7-6(3),R128,177,11,3,96,140,73,96,23,44,12,14,18,96,140,9,7,77,138,60,77,26,61,12,14,18,86,138
2009-05-25 00:00:00.000,Roland Garros France Grand Slams,CLAY,3,Mikhail Youzhny,Gilles Muller,Mikhail Youzhny,7-6(2); 6-1; 6-4,R128,112,6,2,53,77,47,53,18,24,0,0,15,65,77,9,1,57,90,38,57,17,33,5,8,14,55,90
2009-05-25 00:00:00.000,Roland Garros France Grand Slams,CLAY,3,Robert Kendrick,Daniel Brands,Robert Kendrick,6-7(7); 7-5; 7-6(11); 4-6; 6-3,R128,227,35,6,117,198,98,117,44,81,8,9,28,142,198,22,6,115,175,94,115,33,60,5,7,27,127,175
2009-05-25 00:00:00.000,Roland Garros France Grand Slams,CLAY,3,Gilles Simon,Wayne Odesnik,Gilles Simon,3-6; 7-5; 6-2; 4-6; 6-3,R128,223,14,2,77,145,55,77,42,68,10,13,24,97,145,7,0,110,150,70,110,24,40,9,14,24,94,150
2009-05-25 00:00:00.000,Roland Garros France Grand Slams,CLAY,3,Juan Martin Del Potro,Michael Llodra,Juan Martin Del Potro,6-3; 6-3; 6-1,R128,91,7,1,44,64,38,44,12,20,0,0,12,50,64,3,2,59,84,31,59,12,25,4,10,13,43,84
2009-05-25 00:00:00.000,Roland Garros France Grand Slams,CLAY,3,Viktor Troicki,Lukasz Kubot,Viktor Troicki,3-6; 6-3; 6-4; 6-7(4); 6-3,R128,238,13,4,107,166,80,107,27,59,11,14,25,107,166,5,3,105,170,73,105,34,65,15,20,24,107,170
2009-05-25 00:00:00.000,Roland Garros France Grand Slams,CLAY,3,Martin Vassallo Arguello,Thomaz Bellucci,Martin Vassallo Arguello,6-4; 6-7(4); 5-5 RET,R128,160,2,1,81,104,55,81,14,23,7,9,16,69,104,6,2,58,94,40,58,22,36,3,6,16,62,94
2009-05-25 00:00:00.000,Roland Garros France Grand Slams,CLAY,3,Igor Andreev,Fabio Fognini,Igor Andreev,1-6; 6-3; 6-1; 3-6; 7-5,R128,192,4,4,90,133,63,90,23,43,7,13,22,86,133,6,11,87,145,57,87,26,58,6,13,22,83,145
2009-05-25 00:00:00.000,Roland Garros France Grand Slams,CLAY,3,Arnaud Clement,Dmitry Tursunov,Arnaud Clement,6-3; 3-6; 6-4; 6-1,R128,175,10,3,68,123,48,68,26,55,13,17,17,74,123,9,9,73,127,47,73,18,54,9,17,18,65,127
2009-05-25 00:00:00.000,Roland Garros France Grand Slams,CLAY,3,Christophe Rochus,Fabrice Santoro,Christophe Rochus,6-3; 6-1; 3-6; 6-4,R128,162,1,0,95,128,63,95,12,33,9,14,18,75,128,11,4,59,113,36,59,22,54,7,15,17,58,113
2009-05-25 00:00:00.000,Roland Garros France Grand Slams,CLAY,3,Juan Monaco,Marcos Baghdatis,Juan Monaco,6-3; 6-2; 6-4,R128,116,2,1,63,83,41,63,14,20,1,3,14,55,83,4,2,37,82,24,37,20,45,5,11,13,44,82
2009-05-25 00:00:00.000,Roland Garros France Grand Slams,CLAY,3,Jo-Wilfried Tsonga,Julien Benneteau,Jo-Wilfried Tsonga,6-4; 3-6; 6-3; 6-4,R128,163,6,2,81,109,57,81,16,28,3,6,19,73,109,2,2,92,123,59,92,14,31,6,11,19,73,123
2009-05-25 00:00:00.000,Roland Garros France Grand Slams,CLAY,3,Tommy Robredo,Adrian Mannarino,Tommy Robredo,6-2; 6-1; 6-2,R128,98,5,3,44,71,28,44,15,27,5,8,11,43,71,1,7,44,85,23,44,9,41,13,23,12,32,85
2009-05-25 00:00:00.000,Roland Garros France Grand Slams,CLAY,3,Daniel Gimeno-Traver,Evgeny Korolev,Daniel Gimeno-Traver,6-4 RET,R128,36,5,0,22,30,19,22,3,8,4,4,5,22,30,0,1,17,31,13,17,6,14,1,2,5,19,31
2009-05-25 00:00:00.000,Roland Garros France Grand Slams,CLAY,3,Andreas Seppi,Guillermo Garcia-Lopez,Andreas Seppi,6-3; 6-3; 6-1,R128,108,6,0,48,71,38,48,8,23,4,6,12,46,71,2,1,59,86,27,59,13,27,7,15,13,40,86
2009-05-25 00:00:00.000,Roland Garros France Grand Slams,CLAY,3,Maximo Gonzalez,Mardy Fish,Maximo Gonzalez,6-3; 1-6; 6-4; 7-6(4),R128,167,1,1,73,112,49,73,22,39,6,11,19,71,112,10,2,71,123,49,71,26,52,8,13,19,75,123
2009-05-25 00:00:00.000,Roland Garros France Grand Slams,CLAY,3,Philipp Kohlschreiber,Bernard Tomic,Philipp Kohlschreiber,6-1; 6-2; 6-2,R128,72,5,1,40,60,32,40,12,20,2,3,11,44,60,1,5,38,66,15,38,11,28,5,13,12,26,66
2009-05-25 00:00:00.000,Roland Garros France Grand Slams,CLAY,3,Juan Carlos Ferrero,Ivan Ljubicic,Juan Carlos Ferrero,2-6; 6-4; 6-4; 3-6; 6-3,R128,197,5,3,112,138,75,112,15,26,8,12,23,90,138,19,2,77,136,59,77,30,59,6,10,23,89,136
2009-05-25 00:00:00.000,Roland Garros France Grand Slams,CLAY,3,Sergiy Stakhovsky,Brian Dabul,Sergiy Stakhovsky,4-6; 7-5; 7-6(2); 6-3,R128,187,13,4,78,133,55,78,36,55,2,5,21,91,133,2,2,109,137,74,109,12,28,5,10,22,86,137
2009-05-25 00:00:00.000,Roland Garros France Grand Slams,CLAY,3,Novak Djokovic,Nicolas Lapentti,Novak Djokovic,6-3; 3-1 RET,R128,78,1,0,28,42,23,28,9,14,0,0,7,32,42,0,1,38,58,23,38,8,20,5,7,6,31,58
2009-05-25 00:00:00.000,Roland Garros France Grand Slams,CLAY,3,Andy Roddick,Romain Jouan,Andy Roddick,6-2; 6-4; 6-2,R128,94,11,1,48,62,41,48,11,14,0,0,13,52,62,7,0,41,74,25,41,18,33,4,9,13,43,74
2009-05-25 00:00:00.000,Roland Garros France Grand Slams,CLAY,3,Ivo Minar,Oscar Hernandez,Ivo Minar,6-3; 7-6(4); 6-3,R128,125,9,4,58,104,47,58,26,46,6,7,16,73,104,10,0,68,98,44,68,17,30,6,9,14,61,98
2009-05-25 00:00:00.000,Roland Garros France Grand Slams,CLAY,3,Andreas Beck,Ivan Navarro,Andreas Beck,7-6(9); 6-4; 6-1,R128,138,2,0,51,80,44,51,23,29,1,1,14,67,80,10,1,71,107,50,71,16,36,3,7,15,66,107
2009-05-25 00:00:00.000,Roland Garros France Grand Slams,CLAY,3,Marc Gicquel,Rainer Schuettler,Marc Gicquel,6-0; 6-0; 6-4,R128,98,5,1,38,65,28,38,17,27,6,7,11,45,65,0,3,50,84,27,50,11,34,3,11,11,38,84
2009-05-25 00:00:00.000,Roland Garros France Grand Slams,CLAY,3,Jurgen Melzer,Sergio Roitman,Jurgen Melzer,6-4; 7-6(4); 6-0,R128,137,10,3,58,95,42,58,25,37,4,5,14,67,95,3,0,74,112,46,74,17,38,10,15,14,63,112
2009-05-25 00:00:00.000,Roland Garros France Grand Slams,CLAY,3,Guillaume Rufin,Eduardo Schwank,Guillaume Rufin,6-1; 6-3; 6-3,R128,113,7,2,47,78,36,47,19,31,2,2,13,55,78,1,4,44,76,27,44,13,32,3,8,12,40,76
2009-05-25 00:00:00.000,Roland Garros France Grand Slams,CLAY,3,Victor Crivoi,Simon Greul,Victor Crivoi,6-1; 7-6(1); 6-2,R128,107,6,1,49,81,44,49,15,32,0,1,14,59,81,8,1,64,90,38,64,10,26,8,13,13,48,90
2009-05-25 00:00:00.000,Roland Garros France Grand Slams,CLAY,3,Gael Monfils,Bobby Reynolds,Gael Monfils,6-2; 6-3; 6-1,R128,89,5,0,42,67,35,42,17,25,2,2,12,52,67,2,3,55,80,29,55,11,25,0,6,12,40,80
2009-05-25 00:00:00.000,Roland Garros France Grand Slams,CLAY,3,Leonardo Mayer,James Blake,Leonardo Mayer,7-6(6); 7-5; 6-2,R128,128,5,2,58,87,51,58,22,29,4,4,16,73,87,3,2,66,127,49,66,30,61,13,16,16,79,127
2009-05-25 00:00:00.000,Roland Garros France Grand Slams,CLAY,3,Tommy Haas,Andrei Pavel,Tommy Haas,6-1; 6-4; 6-4,R128,97,9,3,54,76,48,54,10,22,2,2,14,58,76,3,1,64,94,35,64,19,30,11,15,13,54,94
2009-05-25 00:00:00.000,Roland Garros France Grand Slams,CLAY,3,Jeremy Chardy,Thiago Alves,Jeremy Chardy,6-2; 7-6(10); 6-3,R128,115,21,5,58,90,47,58,16,32,3,6,15,63,90,1,4,59,86,36,59,15,27,4,10,14,51,86
2009-05-25 00:00:00.000,Roland Garros France Grand Slams,CLAY,3,Simone Bolelli,Tomas Berdych,Simone Bolelli,6-4; 6-4; 5-7; 4-6; 6-3,R128,210,10,3,95,141,68,95,28,46,2,6,25,96,141,18,4,86,143,62,86,31,57,1,7,26,93,143
2009-05-25 00:00:00.000,Roland Garros France Grand Slams,CLAY,3,Paul-Henri Mathieu,Laurent Recouderc,Paul-Henri Mathieu,6-4; 6-4; 6-1,R128,116,9,1,40,74,35,40,18,34,0,1,13,53,74,4,4,33,86,22,33,25,53,6,12,14,47,86
2009-05-25 00:00:00.000,Roland Garros France Grand Slams,CLAY,3,Pablo Andujar,Robby Ginepri,Pablo Andujar,6-4; 7-6(7); 7-6(3),R128,189,4,7,70,131,50,70,33,61,8,11,17,83,131,3,3,76,125,47,76,24,49,4,8,17,71,125
2009-05-25 00:00:00.000,Roland Garros France Grand Slams,CLAY,3,Jose Acasuso,Santiago Ventura,Jose Acasuso,3-6; 7-6(5); 6-0; 6-3,R128,161,14,4,64,98,47,64,18,34,4,7,17,65,98,6,4,78,140,51,78,25,62,8,15,19,76,140
2009-05-25 00:00:00.000,Roland Garros France Grand Slams,CLAY,3,Roger Federer,Alberto Martin,Roger Federer,6-4; 6-3; 6-2,R128,103,10,0,51,75,40,51,16,24,0,1,14,56,75,0,3,56,87,34,56,13,31,5,10,13,47,87
2009-05-25 00:00:00.000,Roland Garros France Grand Slams,CLAY,3,Rafael Nadal,Teymuraz Gabashvili,Rafael Nadal,6-1; 6-4; 6-2,R64,137,2,1,50,77,37,50,19,27,4,4,13,56,77,2,3,52,85,34,52,12,33,8,13,12,46,85
2009-05-25 00:00:00.000,Roland Garros France Grand Slams,CLAY,3,Lleyton Hewitt,Andrey Golubev,Lleyton Hewitt,6-4; 6-3; 6-1,R64,114,2,1,45,80,35,45,23,35,8,8,13,58,80,4,5,51,93,32,51,17,42,5,10,13,49,93
2009-05-25 00:00:00.000,Roland Garros France Grand Slams,CLAY,3,Robin Soderling,Denis Istomin,Robin Soderling,6-4; 7-6(4); 6-4,R64,121,6,1,56,95,46,56,23,39,3,4,16,69,95,16,2,70,106,48,70,17,36,4,7,16,65,106
2009-05-25 00:00:00.000,Roland Garros France Grand Slams,CLAY,3,David Ferrer,Nicolas Kiefer,David Ferrer,6-3; 5-7; 6-4; 3-6; 6-2,R64,245,6,3,117,163,81,117,24,46,8,11,24,105,163,15,10,90,174,65,90,40,84,14,19,24,105,174
2009-05-25 00:00:00.000,Roland Garros France Grand Slams,CLAY,3,Nikolay Davydenko,Diego Junqueira,Nikolay Davydenko,4-6; 6-3; 6-0; 6-2,R64,164,2,1,63,86,43,63,14,23,5,9,16,57,86,0,1,85,123,43,85,17,38,13,23,17,60,123
2009-05-25 00:00:00.000,Roland Garros France Grand Slams,CLAY,3,Stanislas Wawrinka,Nicolas Massu,Stanislas Wawrinka,6-1; 6-1; 6-2,R64,74,11,2,33,53,31,33,14,20,0,0,11,45,53,0,1,37,61,19,37,9,24,4,11,11,28,61
2009-05-25 00:00:00.000,Roland Garros France Grand Slams,CLAY,3,Nicolas Almagro,Ernests Gulbis,Nicolas Almagro,6-7(4); 7-6(5); 6-3; 6-2,R64,162,15,1,73,120,61,73,29,47,1,1,20,90,120,10,1,82,127,65,82,21,45,6,10,21,86,127
2009-05-25 00:00:00.000,Roland Garros France Grand Slams,CLAY,3,Fernando Verdasco,Philipp Petzschner,Fernando Verdasco,6-1; 6-2; 6-3,R64,75,1,0,46,56,37,46,9,10,0,1,12,46,56,3,6,35,67,18,35,12,32,2,9,12,30,67
2009-05-25 00:00:00.000,Roland Garros France Grand Slams,CLAY,3,Andy Murray,Potito Starace,Andy Murray,6-3; 2-6; 7-5; 6-4,R64,160,8,0,75,118,57,75,19,43,9,13,19,76,118,1,0,92,123,57,92,17,31,5,11,20,74,123
2009-05-25 00:00:00.000,Roland Garros France Grand Slams,CLAY,3,Janko Tipsarevic,Feliciano Lopez,Janko Tipsarevic,6-7(9); 6-4; 7-6(4); 6-3,R64,235,9,4,92,161,66,92,42,69,11,13,22,108,161,17,2,93,151,69,93,29,58,7,11,21,98,151
2009-05-25 00:00:00.000,Roland Garros France Grand Slams,CLAY,3,Radek Stepanek,Mathieu Montcourt,Radek Stepanek,6-4; 4-6; 6-4; 6-4,R64,187,5,3,77,125,52,77,27,48,4,8,20,79,125,1,6,67,121,46,67,25,54,4,10,20,71,121
2009-05-25 00:00:00.000,Roland Garros France Grand Slams,CLAY,3,Marin Cilic,Dudi Sela,Marin Cilic,6-0; 6-3; 6-1,R64,83,7,1,40,68,34,40,15,28,2,2,11,49,68,0,1,42,65,20,42,11,23,6,13,11,31,65
2009-05-25 00:00:00.000,Roland Garros France Grand Slams,CLAY,3,Fernando Gonzalez,Rui Machado,Fernando Gonzalez,6-3; 6-2; 6-3,R64,88,4,2,46,63,40,46,12,17,0,0,13,52,63,2,0,62,86,36,62,11,24,9,14,13,47,86
2009-05-25 00:00:00.000,Roland Garros France Grand Slams,CLAY,3,Josselin Ouanna,Marat Safin,Josselin Ouanna,7-6(2); 7-6(4); 4-6; 3-6; 10-8,R64,274,4,8,118,187,85,118,39,69,7,12,30,124,187,19,4,122,215,92,122,44,93,19,23,31,136,215
2009-05-25 00:00:00.000,Roland Garros France Grand Slams,CLAY,3,Victor Hanescu,Mikhail Youzhny,Victor Hanescu,7-5; 7-5; 7-5,R64,181,3,1,77,109,57,77,19,32,8,10,18,76,109,2,5,76,134,51,76,26,58,10,15,18,77,134
2009-05-25 00:00:00.000,Roland Garros France Grand Slams,CLAY,3,Gilles Simon,Robert Kendrick,Gilles Simon,7-5; 6-0; 6-1,R64,94,6,2,33,72,27,33,28,39,3,3,13,55,72,5,4,51,90,32,51,14,39,9,15,12,46,90
2009-05-25 00:00:00.000,Roland Garros France Grand Slams,CLAY,3,Juan Martin Del Potro,Viktor Troicki,Juan Martin Del Potro,6-3; 7-5; 6-0,R64,123,7,3,41,77,32,41,16,36,1,4,14,48,77,3,0,57,86,26,57,13,29,6,14,13,39,86
2009-05-25 00:00:00.000,Roland Garros France Grand Slams,CLAY,3,Igor Andreev,Martin Vassallo Arguello,Igor Andreev,1-6; 7-5; 5-7; 6-3; 6-4,R64,240,5,3,132,180,83,132,25,48,14,20,25,108,180,2,2,150,198,91,150,23,48,13,19,25,114,198
2009-05-25 00:00:00.000,Roland Garros France Grand Slams,CLAY,3,Christophe Rochus,Arnaud Clement,Christophe Rochus,6-1; 7-5; 4-6; 6-3,R64,225,8,2,71,116,55,71,24,45,10,12,19,79,116,14,4,103,160,66,103,24,57,16,22,19,90,160
2009-05-25 00:00:00.000,Roland Garros France Grand Slams,CLAY,3,Jo-Wilfried Tsonga,Juan Monaco,Jo-Wilfried Tsonga,7-5; 2-6; 6-1; 7-6(8),R64,189,11,2,85,134,68,85,21,49,12,16,20,89,134,1,0,100,128,62,100,19,28,8,13,19,81,128
2009-05-25 00:00:00.000,Roland Garros France Grand Slams,CLAY,3,Tommy Robredo,Daniel Gimeno-Traver,Tommy Robredo,6-4; 6-4; 6-3,R64,122,2,5,60,88,47,60,15,28,5,5,14,62,88,1,4,60,93,40,60,15,33,3,7,15,55,93
2009-05-25 00:00:00.000,Roland Garros France Grand Slams,CLAY,3,Maximo Gonzalez,Andreas Seppi,Maximo Gonzalez,7-6(8); 6-3; 6-3,R64,178,7,2,94,129,61,94,20,35,17,19,15,81,129,0,4,59,106,38,59,22,47,8,13,15,60,106
2009-05-25 00:00:00.000,Roland Garros France Grand Slams,CLAY,3,Philipp Kohlschreiber,Juan Carlos Ferrero,Philipp Kohlschreiber,6-4; 2-6; 6-4; 6-7(3); 6-3,R64,213,7,1,113,159,66,113,22,46,8,17,25,88,159,3,0,109,143,60,109,16,34,5,15,24,76,143
2009-05-25 00:00:00.000,Roland Garros France Grand Slams,CLAY,3,Novak Djokovic,Sergiy Stakhovsky,Novak Djokovic,6-3; 6-4; 6-1,R64,124,5,2,53,77,36,53,15,24,3,5,13,51,77,6,3,62,107,38,62,16,45,11,18,13,54,107
2009-05-25 00:00:00.000,Roland Garros France Grand Slams,CLAY,3,Andy Roddick,Ivo Minar,Andy Roddick,6-2; 6-2; 7-6(2),R64,111,15,1,62,81,53,62,10,19,4,4,14,63,81,4,2,49,101,32,49,26,52,12,16,14,58,101
2009-05-25 00:00:00.000,Roland Garros France Grand Slams,CLAY,3,Marc Gicquel,Andreas Beck,Marc Gicquel,6-4; 6-7(6); 7-6(3); 7-5,R64,224,17,1,93,156,71,93,39,63,7,8,23,110,156,7,6,94,157,66,94,37,63,10,13,23,103,157
2009-05-25 00:00:00.000,Roland Garros France Grand Slams,CLAY,3,Jurgen Melzer,Guillaume Rufin,Jurgen Melzer,6-2; 7-5; 6-4,R64,135,12,3,65,100,49,65,17,35,3,5,15,66,100,2,7,49,100,35,49,19,51,3,9,15,54,100
2009-05-25 00:00:00.000,Roland Garros France Grand Slams,CLAY,3,Gael Monfils,Victor Crivoi,Gael Monfils,6-4; 6-3; 6-3,R64,105,4,0,59,86,45,59,17,27,2,2,14,62,86,2,1,62,89,39,62,14,27,3,7,14,53,89
2009-05-25 00:00:00.000,Roland Garros France Grand Slams,CLAY,3,Tommy Haas,Leonardo Mayer,Tommy Haas,6-3; 7-6(2); 3-6; 4-6; 6-3,R64,208,13,5,103,155,78,103,27,52,8,11,24,105,155,18,4,85,142,67,85,30,57,3,7,25,97,142
2009-05-25 00:00:00.000,Roland Garros France Grand Slams,CLAY,3,Jeremy Chardy,Simone Bolelli,Jeremy Chardy,6-2; 6-3; 4-6; 4-6; 6-1,R64,176,14,3,84,139,60,84,30,55,6,10,22,90,139,1,2,90,130,57,90,21,40,10,18,22,78,130
2009-05-25 00:00:00.000,Roland Garros France Grand Slams,CLAY,3,Paul-Henri Mathieu,Pablo Andujar,Paul-Henri Mathieu,6-2; 6-3; 6-4,R64,141,5,0,59,99,43,59,22,40,8,9,14,65,99,1,4,48,81,29,48,15,33,3,8,13,44,81
2009-05-25 00:00:00.000,Roland Garros France Grand Slams,CLAY,3,Roger Federer,Jose Acasuso,Roger Federer,7-6(8); 5-7; 7-6(2); 6-2,R64,205,11,0,101,142,75,101,22,41,5,10,22,97,142,5,2,96,154,59,96,31,58,6,12,22,90,154
2009-05-25 00:00:00.000,Roland Garros France Grand Slams,CLAY,3,Rafael Nadal,Lleyton Hewitt,Rafael Nadal,6-1; 6-3; 6-1,R32,111,7,0,50,66,38,50,10,16,2,3,12,48,66,2,2,46,75,26,46,9,29,6,13,11,35,75
2009-05-25 00:00:00.000,Roland Garros France Grand Slams,CLAY,3,Robin Soderling,David Ferrer,Robin Soderling,6-7(5); 7-5; 6-2; 7-6(5),R32,216,6,3,87,151,69,87,28,64,9,12,22,97,151,4,4,98,153,64,98,25,55,11,17,22,89,153
2009-05-25 00:00:00.000,Roland Garros France Grand Slams,CLAY,3,Nikolay Davydenko,Stanislas Wawrinka,Nikolay Davydenko,6-3; 4-6; 6-3; 6-2,R32,177,2,3,70,109,53,70,25,39,1,2,18,78,109,7,3,58,113,38,58,30,55,4,9,18,68,113
2009-05-25 00:00:00.000,Roland Garros France Grand Slams,CLAY,3,Fernando Verdasco,Nicolas Almagro,Fernando Verdasco,6-2; 7-6(4); 7-6(8),R32,167,3,4,97,110,73,97,3,13,0,2,16,76,110,5,2,60,126,41,60,34,66,5,9,16,75,126
2009-05-25 00:00:00.000,Roland Garros France Grand Slams,CLAY,3,Andy Murray,Janko Tipsarevic,Andy Murray,7-6(3); 6-3 RET,R32,111,6,0,35,69,25,35,17,34,2,6,10,42,69,6,2,42,78,26,42,13,36,2,8,11,39,78
2009-05-25 00:00:00.000,Roland Garros France Grand Slams,CLAY,3,Marin Cilic,Radek Stepanek,Marin Cilic,6-1; 7-6(4); 6-3,R32,126,8,5,49,90,36,49,24,41,0,2,15,60,90,0,4,59,91,31,59,16,32,9,14,13,47,91
2009-05-25 00:00:00.000,Roland Garros France Grand Slams,CLAY,3,Fernando Gonzalez,Josselin Ouanna,Fernando Gonzalez,7-5; 6-3; 7-5,R32,114,11,4,60,79,50,60,9,19,0,2,16,59,79,1,4,68,115,48,68,17,47,6,12,17,65,115
2009-05-25 00:00:00.000,Roland Garros France Grand Slams,CLAY,3,Victor Hanescu,Gilles Simon,Victor Hanescu,6-4; 6-4; 6-2,R32,142,6,3,67,100,53,67,16,33,6,6,14,69,100,7,4,64,116,46,64,20,52,11,15,14,66,116
2009-05-25 00:00:00.000,Roland Garros France Grand Slams,CLAY,3,Juan Martin Del Potro,Igor Andreev,Juan Martin Del Potro,6-4; 7-5; 6-4,R32,142,6,5,55,98,45,55,21,43,2,4,16,66,98,1,0,63,91,39,63,17,28,3,8,16,56,91
2009-05-25 00:00:00.000,Roland Garros France Grand Slams,CLAY,3,Jo-Wilfried Tsonga,Christophe Rochus,Jo-Wilfried Tsonga,6-2; 6-2; 6-2,R32,84,8,2,44,64,37,44,13,20,1,1,12,50,64,0,1,42,60,22,42,8,18,0,6,12,30,60
2009-05-25 00:00:00.000,Roland Garros France Grand Slams,CLAY,3,Tommy Robredo,Maximo Gonzalez,Tommy Robredo,4-6; 7-5; 6-1; 6-0,R32,146,4,5,53,99,38,53,31,46,2,4,18,69,99,0,2,74,105,40,74,17,31,4,11,17,57,105
2009-05-25 00:00:00.000,Roland Garros France Grand Slams,CLAY,3,Philipp Kohlschreiber,Novak Djokovic,Philipp Kohlschreiber,6-4; 6-4; 6-4,R32,141,1,1,65,98,42,65,21,33,4,6,15,63,98,3,3,58,90,38,58,13,32,5,10,15,51,90
2009-05-25 00:00:00.000,Roland Garros France Grand Slams,CLAY,3,Andy Roddick,Marc Gicquel,Andy Roddick,6-1; 6-4; 6-4,R32,104,7,0,55,81,46,55,15,26,3,3,14,61,81,7,4,38,77,24,38,21,39,3,7,13,45,77
2009-05-25 00:00:00.000,Roland Garros France Grand Slams,CLAY,3,Gael Monfils,Jurgen Melzer,Gael Monfils,6-2; 4-6; 6-3; 6-1,R32,137,12,1,72,112,53,72,19,40,6,8,17,72,112,2,0,62,97,42,62,12,35,4,11,17,54,97
2009-05-25 00:00:00.000,Roland Garros France Grand Slams,CLAY,3,Tommy Haas,Jeremy Chardy,Tommy Haas,7-5; 6-3; 4-6; 6-4,R32,157,16,1,76,116,59,76,20,40,6,10,21,79,116,5,3,79,128,47,79,26,49,6,12,20,73,128
2009-05-25 00:00:00.000,Roland Garros France Grand Slams,CLAY,3,Roger Federer,Paul-Henri Mathieu,Roger Federer,4-6; 6-1; 6-4; 6-4,R32,166,14,3,65,110,53,65,22,45,5,7,19,75,110,8,3,75,126,49,75,24,51,11,16,18,73,126
2009-05-25 00:00:00.000,Roland Garros France Grand Slams,CLAY,3,Robin Soderling,Rafael Nadal,Robin Soderling,6-2; 6-7(2); 6-4; 7-6(2),R16,210,9,0,91,143,62,91,32,52,2,4,21,94,143,3,2,99,128,66,99,13,29,1,6,21,79,128
2009-05-25 00:00:00.000,Roland Garros France Grand Slams,CLAY,3,Nikolay Davydenko,Fernando Verdasco,Nikolay Davydenko,6-2; 6-2; 6-4,R16,122,4,2,58,75,48,58,9,17,3,3,13,57,75,4,1,49,83,27,49,17,34,4,9,13,44,83
2009-05-25 00:00:00.000,Roland Garros France Grand Slams,CLAY,3,Andy Murray,Marin Cilic,Andy Murray,7-5; 7-6(4); 6-1,R16,151,10,1,56,106,42,56,26,50,1,4,16,68,106,4,5,60,104,39,60,18,44,6,12,15,57,104
2009-05-25 00:00:00.000,Roland Garros France Grand Slams,CLAY,3,Fernando Gonzalez,Victor Hanescu,Fernando Gonzalez,6-2; 6-4; 6-2,R16,87,6,0,35,67,30,35,23,32,0,0,13,53,67,2,2,52,75,33,52,10,23,3,8,13,43,75
2009-05-25 00:00:00.000,Roland Garros France Grand Slams,CLAY,3,Juan Martin Del Potro,Jo-Wilfried Tsonga,Juan Martin Del Potro,6-1; 6-7(5); 6-1; 6-4,R16,161,9,4,69,100,56,69,22,31,0,1,19,78,100,7,2,61,113,37,61,29,52,7,13,17,66,113
2009-05-25 00:00:00.000,Roland Garros France Grand Slams,CLAY,3,Tommy Robredo,Philipp Kohlschreiber,Tommy Robredo,6-4; 5-7; 7-6(4); 6-2,R16,196,7,2,75,122,63,75,28,47,5,6,21,91,122,2,2,73,133,47,73,42,60,7,10,21,89,133
2009-05-25 00:00:00.000,Roland Garros France Grand Slams,CLAY,3,Gael Monfils,Andy Roddick,Gael Monfils,6-4; 6-2; 6-3,R16,111,17,3,49,83,37,49,20,34,9,10,13,57,83,4,1,60,84,35,60,11,24,5,11,14,46,84
2009-05-25 00:00:00.000,Roland Garros France Grand Slams,CLAY,3,Roger Federer,Tommy Haas,Roger Federer,6-7(4); 5-7; 6-4; 6-0; 6-2,R16,187,16,1,82,130,70,82,29,48,3,5,24,99,130,11,3,93,145,63,93,28,52,8,15,24,91,145
2009-05-25 00:00:00.000,Roland Garros France Grand Slams,CLAY,3,Robin Soderling,Nikolay Davydenko,Robin Soderling,6-1; 6-3; 6-1,Q,101,4,3,45,70,35,45,18,25,2,2,12,53,70,1,5,62,80,31,62,8,18,8,14,11,39,80
2009-05-25 00:00:00.000,Roland Garros France Grand Slams,CLAY,3,Fernando Gonzalez,Andy Murray,Fernando Gonzalez,6-3; 3-6; 6-0; 6-4,Q,135,4,1,69,99,51,69,17,30,4,6,17,68,99,3,2,74,103,44,74,14,29,6,12,17,58,103
2009-05-25 00:00:00.000,Roland Garros France Grand Slams,CLAY,3,Juan Martin Del Potro,Tommy Robredo,Juan Martin Del Potro,6-3; 6-4; 6-2,Q,127,14,1,51,94,46,51,20,43,7,7,14,66,94,3,4,50,81,35,50,12,31,6,10,13,47,81
2009-05-25 00:00:00.000,Roland Garros France Grand Slams,CLAY,3,Roger Federer,Gael Monfils,Roger Federer,7-6(6); 6-2; 6-4,Q,130,8,1,54,94,43,54,26,40,4,4,15,69,94,7,1,61,105,41,61,22,44,2,5,15,63,105
2009-05-25 00:00:00.000,Roland Garros France Grand Slams,CLAY,3,Robin Soderling,Fernando Gonzalez,Robin Soderling,6-3; 7-5; 5-7; 4-6; 6-4,S,208,16,2,98,148,70,98,33,50,3,7,27,103,148,22,3,119,176,80,119,29,57,13,18,26,109,176
2009-05-25 00:00:00.000,Roland Garros France Grand Slams,CLAY,3,Roger Federer,Juan Martin Del Potro,Roger Federer,3-6; 7-6(2); 2-6; 6-1; 6-4,S,209,5,1,92,142,67,92,26,50,8,13,24,93,142,16,6,98,168,72,98,30,70,8,12,22,102,168
2009-05-25 00:00:00.000,Roland Garros France Grand Slams,CLAY,3,Roger Federer,Robin Soderling,Roger Federer,6-1; 7-6(1); 6-4,F,115,16,2,52,79,44,52,18,27,2,2,14,62,79,2,3,55,91,35,55,20,36,2,6,15,55,91
2009-06-08 00:00:00.000,Halle Germany ATP World Tour 250,GRASS,2,Lukas Lacko,Harel Levy,Lukas Lacko,7-6(6); 6-2,R32,74,2,3,44,68,32,44,10,24,3,5,10,42,68,6,1,46,72,29,46,10,26,5,9,10,39,72
2009-06-08 00:00:00.000,Halle Germany ATP World Tour 250,GRASS,2,Andreas Beck,Christophe Rochus,Andreas Beck,6-3; 6-1,R32,61,5,5,33,56,26,33,12,23,5,5,8,38,56,1,1,28,47,15,28,9,19,1,5,8,24,47
2009-06-08 00:00:00.000,Halle Germany ATP World Tour 250,GRASS,2,Philipp Kohlschreiber,Bjorn Phau,Philipp Kohlschreiber,6-4; 6-2,R32,64,6,4,39,60,34,39,9,21,3,3,9,43,60,4,2,24,45,17,24,11,21,1,4,9,28,45
2009-06-08 00:00:00.000,Halle Germany ATP World Tour 250,GRASS,2,Dmitry Tursunov,Igor Kunitsyn,Dmitry Tursunov,7-5; 6-4,R32,83,4,2,47,77,38,47,14,30,8,9,11,52,77,5,2,24,55,19,24,19,31,2,5,11,38,55
2009-06-08 00:00:00.000,Halle Germany ATP World Tour 250,GRASS,2,Jo-Wilfried Tsonga,Fabrice Santoro,Jo-Wilfried Tsonga,7-5; 6-2,R32,69,8,2,33,48,31,33,9,15,0,0,10,40,48,2,1,38,67,26,38,14,29,6,9,10,40,67
2009-06-08 00:00:00.000,Halle Germany ATP World Tour 250,GRASS,2,Tommy Haas,Stefan Koubek,Tommy Haas,6-2; 6-2,R32,59,1,1,35,53,24,35,14,18,2,2,8,38,53,2,2,30,56,17,30,11,26,3,7,8,28,56
2009-06-08 00:00:00.000,Halle Germany ATP World Tour 250,GRASS,2,Mischa Zverev,Joseph Sirianni,Mischa Zverev,6-2; 6-4,R32,81,8,1,42,62,30,42,10,20,4,5,9,40,62,2,2,46,76,30,46,10,30,6,10,9,40,76
2009-06-08 00:00:00.000,Halle Germany ATP World Tour 250,GRASS,2,Tomas Berdych,Jan Hernych,Tomas Berdych,6-4; 7-5,R32,89,10,2,39,68,31,39,16,29,4,6,11,47,68,2,4,47,82,26,47,18,35,3,7,11,44,82
2009-06-08 00:00:00.000,Halle Germany ATP World Tour 250,GRASS,2,Rainer Schuettler,Marc Gicquel,Rainer Schuettler,6-3; 6-4,R32,80,5,1,58,84,41,58,10,26,10,11,10,51,84,4,2,32,59,25,32,9,27,5,8,9,34,59
2009-06-08 00:00:00.000,Halle Germany ATP World Tour 250,GRASS,2,Benjamin Becker,Victor Hanescu,Benjamin Becker,6-4; 6-4,R32,59,7,0,31,43,29,31,8,12,1,2,10,37,43,6,3,47,60,33,47,4,13,3,6,10,37,60
2009-06-08 00:00:00.000,Halle Germany ATP World Tour 250,GRASS,2,Olivier Rochus,Fernando Vicente,Olivier Rochus,6-0; 6-0,R32,56,0,0,26,36,18,26,8,10,1,1,6,26,36,1,2,23,37,7,23,4,14,1,7,6,11,37
2009-06-08 00:00:00.000,Halle Germany ATP World Tour 250,GRASS,2,Philipp Petzschner,Fernando Verdasco,Philipp Petzschner,3-6; 7-6(5); 6-4,R32,106,5,5,52,94,38,52,21,42,3,7,15,59,94,9,5,58,89,43,58,17,31,3,7,16,60,89
2009-06-08 00:00:00.000,Halle Germany ATP World Tour 250,GRASS,2,Jurgen Melzer,Arnaud Clement,Jurgen Melzer,1-6; 6-3; 6-2,R32,111,8,2,42,81,34,42,18,39,1,3,12,52,81,3,2,38,77,23,38,24,39,4,7,12,47,77
2009-06-08 00:00:00.000,Halle Germany ATP World Tour 250,GRASS,2,Nicolas Kiefer,Viktor Troicki,Nicolas Kiefer,6-2; 6-1,R32,75,5,3,30,59,25,30,12,29,5,6,8,37,59,2,6,28,52,17,28,5,24,3,8,7,22,52
2009-06-08 00:00:00.000,Halle Germany ATP World Tour 250,GRASS,2,Florent Serra,Dudi Sela,Florent Serra,1-6; 6-4; 6-2,R32,83,2,3,52,83,37,52,11,31,6,10,12,48,83,6,1,45,73,28,45,15,28,5,10,13,43,73
2009-06-08 00:00:00.000,Halle Germany ATP World Tour 250,GRASS,2,Novak Djokovic,Simone Bolelli,Novak Djokovic,7-5; 6-2,R32,84,8,2,44,61,33,44,10,17,2,2,10,43,61,2,1,55,78,35,55,9,23,7,10,10,44,78
2009-06-08 00:00:00.000,Halle Germany ATP World Tour 250,GRASS,2,Andreas Beck,Lukas Lacko,Andreas Beck,7-5; 7-6(5),R16,90,9,1,40,61,34,40,18,21,0,0,12,52,61,5,2,50,88,38,50,19,38,5,6,12,57,88
2009-06-08 00:00:00.000,Halle Germany ATP World Tour 250,GRASS,2,Philipp Kohlschreiber,Dmitry Tursunov,Philipp Kohlschreiber,6-4; 7-6(6),R16,93,10,0,36,61,29,36,19,25,0,1,11,48,61,5,1,48,78,33,48,17,30,7,9,11,50,78
2009-06-08 00:00:00.000,Halle Germany ATP World Tour 250,GRASS,2,Tommy Haas,Jo-Wilfried Tsonga,Tommy Haas,6-3; 7-6(3),R16,79,7,5,40,64,35,40,16,24,3,3,11,51,64,12,2,45,70,34,45,13,25,5,6,10,47,70
2009-06-08 00:00:00.000,Halle Germany ATP World Tour 250,GRASS,2,Mischa Zverev,Tomas Berdych,Mischa Zverev,3-6; 6-2; 7-6(8),R16,153,0,4,74,110,51,74,14,36,10,14,14,65,110,6,3,63,108,40,63,21,45,3,8,15,61,108
2009-06-08 00:00:00.000,Halle Germany ATP World Tour 250,GRASS,2,Benjamin Becker,Rainer Schuettler,Benjamin Becker,6-4; 2-6; 6-4,R16,122,12,5,42,96,31,42,20,54,8,14,14,51,96,6,3,52,84,33,52,16,32,8,14,14,49,84
2009-06-08 00:00:00.000,Halle Germany ATP World Tour 250,GRASS,2,Olivier Rochus,Philipp Petzschner,Olivier Rochus,5-7; 7-5; 6-2,R16,127,0,1,58,90,44,58,18,32,5,7,16,62,90,10,2,43,93,35,43,25,50,4,8,16,60,93
2009-06-08 00:00:00.000,Halle Germany ATP World Tour 250,GRASS,2,Jurgen Melzer,Nicolas Kiefer,Jurgen Melzer,6-1 RET,R16,31,3,0,10,15,8,10,4,5,0,0,3,12,15,2,1,14,24,6,14,2,10,0,3,4,8,24
2009-06-08 00:00:00.000,Halle Germany ATP World Tour 250,GRASS,2,Novak Djokovic,Florent Serra,Novak Djokovic,5-7; 7-5; 6-1,R16,125,14,1,46,87,36,46,24,41,11,13,15,60,87,7,3,67,107,43,67,20,40,6,11,16,63,107
2009-06-08 00:00:00.000,Halle Germany ATP World Tour 250,GRASS,2,Philipp Kohlschreiber,Andreas Beck,Philipp Kohlschreiber,3-6; 6-3; 6-3,Q,117,17,4,69,93,52,69,10,24,8,9,13,62,93,9,7,49,88,36,49,19,39,2,5,14,55,88
2009-06-08 00:00:00.000,Halle Germany ATP World Tour 250,GRASS,2,Tommy Haas,Mischa Zverev,Tommy Haas,7-6(5); 6-2,Q,76,9,1,44,63,33,44,13,19,4,5,10,46,63,1,3,39,59,29,39,9,20,3,6,10,38,59
2009-06-08 00:00:00.000,Halle Germany ATP World Tour 250,GRASS,2,Olivier Rochus,Benjamin Becker,Olivier Rochus,6-7(4); 6-3; 6-3,Q,124,2,3,52,82,44,52,20,30,0,0,15,64,82,17,2,54,98,40,54,23,44,5,8,15,63,98
2009-06-08 00:00:00.000,Halle Germany ATP World Tour 250,GRASS,2,Novak Djokovic,Jurgen Melzer,Novak Djokovic,6-1; 6-4,Q,67,6,1,37,49,30,37,5,12,1,2,9,35,49,5,3,29,62,18,29,12,33,3,7,8,30,62
2009-06-08 00:00:00.000,Halle Germany ATP World Tour 250,GRASS,2,Tommy Haas,Philipp Kohlschreiber,Tommy Haas,2-6; 7-6(5); 7-6(3),S,132,15,9,70,110,60,70,14,40,6,9,16,74,110,6,0,67,95,51,67,17,28,2,3,16,68,95
2009-06-08 00:00:00.000,Halle Germany ATP World Tour 250,GRASS,2,Novak Djokovic,Olivier Rochus,Novak Djokovic,7-6(7); 6-4,S,115,10,2,48,73,39,48,11,25,2,3,11,50,73,2,1,40,72,29,40,17,32,4,6,11,46,72
2009-06-08 00:00:00.000,Halle Germany ATP World Tour 250,GRASS,2,Tommy Haas,Novak Djokovic,Tommy Haas,6-3; 6-7(4); 6-1,F,132,10,6,57,103,47,57,26,46,4,4,15,73,103,4,3,46,86,29,46,24,40,7,10,13,53,86
2009-06-08 00:00:00.000,London / Queen's Club Great Britain ATP World Tour 250,GRASS,2,Andy Murray,N/A Bye,Andy Murray,,R64,0,0,0,0,0,0,0,0,0,0,0,0,0,0,0,0,0,0,0,0,0,0,0,0,0,0,0
2009-06-08 00:00:00.000,London / Queen's Club Great Britain ATP World Tour 250,GRASS,2,Andreas Seppi,Robby Ginepri,Andreas Seppi,5-7; 7-6(4); 6-3,R64,111,7,1,65,99,52,65,20,34,2,4,17,72,99,4,3,67,99,55,67,11,32,1,3,16,66,99
2009-06-08 00:00:00.000,London / Queen's Club Great Britain ATP World Tour 250,GRASS,2,Gilles Muller,Josh Goodall,Gilles Muller,6-3; 7-6(7),R64,83,22,5,50,69,43,50,10,19,4,4,11,53,69,7,3,36,67,28,36,20,31,1,2,10,48,67
2009-06-08 00:00:00.000,London / Queen's Club Great Britain ATP World Tour 250,GRASS,2,Guillermo Garcia-Lopez,Yen-Hsun Lu,Guillermo Garcia-Lopez,6-1; 6-1,R64,46,4,3,24,34,22,24,6,10,0,0,7,28,34,2,3,32,42,17,32,1,10,0,5,7,18,42
2009-06-08 00:00:00.000,London / Queen's Club Great Britain ATP World Tour 250,GRASS,2,Feliciano Lopez,Robert Kendrick,Feliciano Lopez,7-6(3); 7-6(3),R64,88,14,2,49,82,39,49,19,33,3,4,12,58,82,10,2,43,74,33,43,16,31,0,1,12,49,74
2009-06-08 00:00:00.000,London / Queen's Club Great Britain ATP World Tour 250,GRASS,2,Denis Istomin,Ivo Minar,Denis Istomin,3-6; 6-1; 6-2,R64,68,11,4,45,65,35,45,12,20,1,2,12,47,65,5,2,46,74,30,46,14,28,6,10,12,44,74
2009-06-08 00:00:00.000,London / Queen's Club Great Britain ATP World Tour 250,GRASS,2,Michael Llodra,Evgeny Korolev,Michael Llodra,6-3; 6-4,R64,63,16,4,38,56,30,38,10,18,2,3,10,40,56,5,2,37,57,23,37,9,20,1,4,9,32,57
2009-06-08 00:00:00.000,London / Queen's Club Great Britain ATP World Tour 250,GRASS,2,Mardy Fish,N/A Bye,Mardy Fish,,R64,0,0,0,0,0,0,0,0,0,0,0,0,0,0,0,0,0,0,0,0,0,0,0,0,0,0,0
2009-06-08 00:00:00.000,London / Queen's Club Great Britain ATP World Tour 250,GRASS,2,Gael Monfils,N/A Bye,Gael Monfils,,R64,0,0,0,0,0,0,0,0,0,0,0,0,0,0,0,0,0,0,0,0,0,0,0,0,0,0,0
2009-06-08 00:00:00.000,London / Queen's Club Great Britain ATP World Tour 250,GRASS,2,Andrey Golubev,Bobby Reynolds,Andrey Golubev,6-2; 4-6; 7-6(3),R64,100,6,5,51,87,40,51,20,36,3,5,15,60,87,3,6,66,99,43,66,19,33,9,12,15,62,99
2009-06-08 00:00:00.000,London / Queen's Club Great Britain ATP World Tour 250,GRASS,2,Steve Darcis,Paul Capdeville,Steve Darcis,3-6; 6-3; 6-4,R64,101,3,1,51,79,38,51,18,28,2,3,14,56,79,3,3,52,90,38,52,18,38,6,8,14,56,90
2009-06-08 00:00:00.000,London / Queen's Club Great Britain ATP World Tour 250,GRASS,2,Alberto Martin,Ernests Gulbis,Alberto Martin,7-6(9); 6-4,R64,96,5,3,48,79,33,48,19,31,4,5,11,52,79,18,6,60,91,47,60,10,31,9,11,11,57,91
2009-06-08 00:00:00.000,London / Queen's Club Great Britain ATP World Tour 250,GRASS,2,Paul-Henri Mathieu,Andrei Pavel,Paul-Henri Mathieu,6-4; 7-6(6),R64,85,8,1,38,67,31,38,17,29,0,1,11,48,67,7,2,41,66,31,41,11,25,0,2,11,42,66
2009-06-08 00:00:00.000,London / Queen's Club Great Britain ATP World Tour 250,GRASS,2,Juan Carlos Ferrero,Sebastien Grosjean,Juan Carlos Ferrero,6-2; 2-1 RET,R64,41,2,1,16,28,11,16,9,12,0,0,5,20,28,3,1,25,39,16,25,6,14,3,6,6,22,39
2009-06-08 00:00:00.000,London / Queen's Club Great Britain ATP World Tour 250,GRASS,2,Xavier Malisse,Pablo Andujar,Xavier Malisse,5-0 RET,R64,23,2,0,8,11,7,8,1,3,0,0,2,8,11,1,2,15,30,8,15,4,15,3,6,3,12,30
2009-06-08 00:00:00.000,London / Queen's Club Great Britain ATP World Tour 250,GRASS,2,Rik De Voest,N/A Bye,Rik De Voest,,R64,0,0,0,0,0,0,0,0,0,0,0,0,0,0,0,0,0,0,0,0,0,0,0,0,0,0,0
2009-06-08 00:00:00.000,London / Queen's Club Great Britain ATP World Tour 250,GRASS,2,James Blake,N/A Bye,James Blake,,R64,0,0,0,0,0,0,0,0,0,0,0,0,0,0,0,0,0,0,0,0,0,0,0,0,0,0,0
2009-06-08 00:00:00.000,London / Queen's Club Great Britain ATP World Tour 250,GRASS,2,Ivan Ljubicic,Sergiy Stakhovsky,Ivan Ljubicic,4-6; 6-4; 6-4,R64,105,17,2,55,74,49,55,9,19,3,4,15,58,74,7,3,55,91,43,55,18,36,3,5,15,61,91
2009-06-08 00:00:00.000,London / Queen's Club Great Britain ATP World Tour 250,GRASS,2,Kevin Anderson,Fabio Fognini,Kevin Anderson,6-3; 7-6(3),R64,93,6,1,52,71,41,52,12,19,3,3,11,53,71,5,2,51,78,38,51,13,27,4,5,10,51,78
2009-06-08 00:00:00.000,London / Queen's Club Great Britain ATP World Tour 250,GRASS,2,Sam Querrey,Jeremy Chardy,Sam Querrey,7-6(10); 6-4,R64,83,13,1,40,67,37,40,17,27,3,3,11,54,67,12,7,51,85,39,51,18,34,5,6,11,57,85
2009-06-08 00:00:00.000,London / Queen's Club Great Britain ATP World Tour 250,GRASS,2,Mikhail Youzhny,Oscar Hernandez,Mikhail Youzhny,6-4; 6-2,R64,63,1,1,28,43,25,28,11,15,0,0,9,36,43,2,3,41,63,29,41,8,22,2,5,9,37,63
2009-06-08 00:00:00.000,London / Queen's Club Great Britain ATP World Tour 250,GRASS,2,Marcos Baghdatis,James Ward,Marcos Baghdatis,6-2; 6-3,R64,54,6,4,21,41,20,21,16,20,0,0,9,36,41,4,4,21,44,16,21,9,23,4,7,8,25,44
2009-06-08 00:00:00.000,London / Queen's Club Great Britain ATP World Tour 250,GRASS,2,Grigor Dimitrov,Ivan Navarro,Grigor Dimitrov,6-4; 4-6; 6-3,R64,97,8,3,51,79,46,51,11,28,1,2,15,57,79,11,2,53,83,40,53,15,30,5,7,14,55,83
2009-06-08 00:00:00.000,London / Queen's Club Great Britain ATP World Tour 250,GRASS,2,Gilles Simon,N/A Bye,Gilles Simon,,R64,0,0,0,0,0,0,0,0,0,0,0,0,0,0,0,0,0,0,0,0,0,0,0,0,0,0,0
2009-06-08 00:00:00.000,London / Queen's Club Great Britain ATP World Tour 250,GRASS,2,Marin Cilic,N/A Bye,Marin Cilic,,R64,0,0,0,0,0,0,0,0,0,0,0,0,0,0,0,0,0,0,0,0,0,0,0,0,0,0,0
2009-06-08 00:00:00.000,London / Queen's Club Great Britain ATP World Tour 250,GRASS,2,Nicolas Mahut,Janko Tipsarevic,Nicolas Mahut,6-0; 6-4,R64,62,8,2,31,47,29,31,5,16,1,1,8,34,47,3,2,25,45,17,25,7,20,1,5,8,24,45
2009-06-08 00:00:00.000,London / Queen's Club Great Britain ATP World Tour 250,GRASS,2,Julien Benneteau,Daniel Koellerer,Julien Benneteau,6-3; 6-4,R64,60,8,2,46,58,36,46,7,12,4,4,10,43,58,3,3,39,55,26,39,8,16,4,6,9,34,55
2009-06-08 00:00:00.000,London / Queen's Club Great Britain ATP World Tour 250,GRASS,2,Ivo Karlovic,Teymuraz Gabashvili,Ivo Karlovic,6-3; 7-6(11),R64,88,28,3,61,77,54,61,5,16,8,8,11,59,77,8,1,45,66,37,45,10,21,0,1,10,47,66
2009-06-08 00:00:00.000,London / Queen's Club Great Britain ATP World Tour 250,GRASS,2,Lleyton Hewitt,Eduardo Schwank,Lleyton Hewitt,6-1; 6-0,R64,44,2,1,23,36,19,23,7,13,1,1,6,26,36,0,1,26,37,7,26,3,11,2,8,7,10,37
2009-06-08 00:00:00.000,London / Queen's Club Great Britain ATP World Tour 250,GRASS,2,Frederico Gil,Daniel Gimeno-Traver,Frederico Gil,6-1; 6-3,R64,55,1,0,36,49,29,36,7,13,2,2,8,36,49,8,9,32,60,22,32,8,28,6,10,8,30,60
2009-06-08 00:00:00.000,London / Queen's Club Great Britain ATP World Tour 250,GRASS,2,Kristof Vliegen,Leonardo Mayer,Kristof Vliegen,7-6(3); 6-4,R64,94,3,4,45,71,37,45,16,26,6,6,11,53,71,4,0,47,78,34,47,16,31,7,8,11,50,78
2009-06-08 00:00:00.000,London / Queen's Club Great Britain ATP World Tour 250,GRASS,2,Andy Roddick,N/A Bye,Andy Roddick,,R64,0,0,0,0,0,0,0,0,0,0,0,0,0,0,0,0,0,0,0,0,0,0,0,0,0,0,0
2009-06-08 00:00:00.000,London / Queen's Club Great Britain ATP World Tour 250,GRASS,2,Andy Murray,Andreas Seppi,Andy Murray,6-1; 6-4,R32,59,2,1,26,43,19,26,12,17,0,1,8,31,43,0,3,35,53,19,35,6,18,2,7,9,25,53
2009-06-08 00:00:00.000,London / Queen's Club Great Britain ATP World Tour 250,GRASS,2,Guillermo Garcia-Lopez,Gilles Muller,Guillermo Garcia-Lopez,7-6(3); 6-3,R32,88,4,5,37,63,30,37,14,26,2,4,11,44,63,4,3,44,75,32,44,12,31,7,10,10,44,75
2009-06-08 00:00:00.000,London / Queen's Club Great Britain ATP World Tour 250,GRASS,2,Feliciano Lopez,Denis Istomin,Feliciano Lopez,7-6(3); 4-6; 7-6(5),R32,122,17,5,66,108,55,66,23,42,4,5,17,78,108,15,2,70,96,53,70,21,26,0,0,17,74,96
2009-06-08 00:00:00.000,London / Queen's Club Great Britain ATP World Tour 250,GRASS,2,Mardy Fish,Michael Llodra,Mardy Fish,5-7; 7-6(5); 6-3,R32,112,8,1,73,98,53,73,18,25,2,3,17,71,98,9,1,63,94,50,63,17,31,7,8,16,67,94
2009-06-08 00:00:00.000,London / Queen's Club Great Britain ATP World Tour 250,GRASS,2,Gael Monfils,Andrey Golubev,Gael Monfils,6-3; 3-6; 7-6(5),R32,112,4,3,63,89,49,63,16,26,3,5,15,65,89,3,8,59,109,44,59,26,50,7,9,15,70,109
2009-06-08 00:00:00.000,London / Queen's Club Great Britain ATP World Tour 250,GRASS,2,Steve Darcis,Alberto Martin,Steve Darcis,6-2; 6-4,R32,63,3,0,32,47,28,32,10,15,0,0,9,38,47,2,2,34,57,23,34,10,23,7,10,9,33,57
2009-06-08 00:00:00.000,London / Queen's Club Great Britain ATP World Tour 250,GRASS,2,Juan Carlos Ferrero,Paul-Henri Mathieu,Juan Carlos Ferrero,6-4; 6-4,R32,84,15,4,42,67,31,42,13,25,5,6,10,44,67,7,1,41,74,27,41,17,33,5,8,10,44,74
2009-06-08 00:00:00.000,London / Queen's Club Great Britain ATP World Tour 250,GRASS,2,Xavier Malisse,Rik De Voest,Xavier Malisse,7-6(6); 7-6(8),R32,119,4,1,43,79,32,43,26,36,2,4,12,58,79,1,2,56,91,39,56,19,35,5,7,12,58,91
2009-06-08 00:00:00.000,London / Queen's Club Great Britain ATP World Tour 250,GRASS,2,James Blake,Ivan Ljubicic,James Blake,6-2; 7-6(4),R32,75,3,1,48,72,35,48,15,24,3,3,10,50,72,10,3,32,60,24,32,16,28,1,3,10,40,60
2009-06-08 00:00:00.000,London / Queen's Club Great Britain ATP World Tour 250,GRASS,2,Sam Querrey,Kevin Anderson,Sam Querrey,7-5; 6-3,R32,88,13,0,43,63,37,43,10,20,0,0,11,47,63,8,2,42,60,31,42,7,18,3,5,10,38,60
2009-06-08 00:00:00.000,London / Queen's Club Great Britain ATP World Tour 250,GRASS,2,Mikhail Youzhny,Marcos Baghdatis,Mikhail Youzhny,6-4; 7-6(3),R32,116,1,0,43,73,27,43,21,30,8,10,11,48,73,7,1,45,83,33,45,16,38,7,10,11,49,83
2009-06-08 00:00:00.000,London / Queen's Club Great Britain ATP World Tour 250,GRASS,2,Gilles Simon,Grigor Dimitrov,Gilles Simon,7-6(7); 7-6(5),R32,110,4,2,64,106,51,64,19,42,3,4,12,70,106,1,1,59,87,42,59,16,28,0,1,12,58,87
2009-06-08 00:00:00.000,London / Queen's Club Great Britain ATP World Tour 250,GRASS,2,Nicolas Mahut,Marin Cilic,Nicolas Mahut,7-6(1); 7-6(4),R32,108,9,0,51,87,41,51,23,36,4,4,12,64,87,11,1,48,75,40,48,16,27,0,0,12,56,75
2009-06-08 00:00:00.000,London / Queen's Club Great Britain ATP World Tour 250,GRASS,2,Ivo Karlovic,Julien Benneteau,Ivo Karlovic,7-6(7); 6-7(4); 6-2,R32,122,33,1,65,92,59,65,16,27,0,0,16,75,92,1,2,59,102,45,59,30,43,1,3,16,75,102
2009-06-08 00:00:00.000,London / Queen's Club Great Britain ATP World Tour 250,GRASS,2,Lleyton Hewitt,Frederico Gil,Lleyton Hewitt,3-6; 6-2; 6-2,R32,81,8,4,40,70,29,40,18,30,1,4,13,47,70,6,0,36,62,23,36,11,26,1,6,12,34,62
2009-06-08 00:00:00.000,London / Queen's Club Great Britain ATP World Tour 250,GRASS,2,Andy Roddick,Kristof Vliegen,Andy Roddick,6-1; 6-4,R32,56,11,0,29,45,26,29,10,16,0,0,9,36,45,2,3,21,43,15,21,10,22,0,3,8,25,43
2009-06-08 00:00:00.000,London / Queen's Club Great Britain ATP World Tour 250,GRASS,2,Andy Murray,Guillermo Garcia-Lopez,Andy Murray,6-4; 6-4,R16,70,9,0,27,51,24,27,16,24,0,0,10,40,51,3,2,36,53,26,36,9,17,0,2,10,35,53
2009-06-08 00:00:00.000,London / Queen's Club Great Britain ATP World Tour 250,GRASS,2,Mardy Fish,Feliciano Lopez,Mardy Fish,6-1; 6-4,R16,52,12,0,29,36,27,29,5,7,0,0,8,32,36,5,5,38,54,25,38,4,16,5,9,9,29,54
2009-06-08 00:00:00.000,London / Queen's Club Great Britain ATP World Tour 250,GRASS,2,Steve Darcis,Gael Monfils,Steve Darcis,W/O,R16,0,0,0,0,0,0,0,0,0,0,0,0,0,0,0,0,0,0,0,0,0,0,0,0,0,0,0
2009-06-08 00:00:00.000,London / Queen's Club Great Britain ATP World Tour 250,GRASS,2,Juan Carlos Ferrero,Xavier Malisse,Juan Carlos Ferrero,6-4; 7-6(4),R16,105,9,3,41,75,34,41,20,34,4,4,11,54,75,6,2,41,82,34,41,19,41,5,6,11,53,82
2009-06-08 00:00:00.000,London / Queen's Club Great Britain ATP World Tour 250,GRASS,2,James Blake,Sam Querrey,James Blake,6-4; 4-6; 6-3,R16,94,9,1,51,81,43,51,15,30,1,3,15,58,81,14,2,42,87,30,42,24,45,4,7,14,54,87
2009-06-08 00:00:00.000,London / Queen's Club Great Britain ATP World Tour 250,GRASS,2,Mikhail Youzhny,Gilles Simon,Mikhail Youzhny,6-1; 2-6; 6-2,R16,92,1,1,37,69,26,37,18,32,2,4,12,44,69,2,1,30,61,21,30,14,31,3,7,11,35,61
2009-06-08 00:00:00.000,London / Queen's Club Great Britain ATP World Tour 250,GRASS,2,Ivo Karlovic,Nicolas Mahut,Ivo Karlovic,6-3; 6-4,R16,72,19,0,37,60,28,37,15,23,2,2,10,43,60,1,1,43,58,29,43,7,15,4,6,9,36,58
2009-06-08 00:00:00.000,London / Queen's Club Great Britain ATP World Tour 250,GRASS,2,Andy Roddick,Lleyton Hewitt,Andy Roddick,7-6(2); 7-6(4),R16,100,18,3,47,80,42,47,18,33,1,1,12,60,80,7,4,46,72,40,46,13,26,0,0,12,53,72
2009-06-08 00:00:00.000,London / Queen's Club Great Britain ATP World Tour 250,GRASS,2,Andy Murray,Mardy Fish,Andy Murray,7-5; 6-3,Q,70,11,0,31,45,30,31,10,14,0,0,10,40,45,9,3,43,68,33,43,8,25,3,6,11,41,68
2009-06-08 00:00:00.000,London / Queen's Club Great Britain ATP World Tour 250,GRASS,2,Juan Carlos Ferrero,Steve Darcis,Juan Carlos Ferrero,4-6; 6-3; 6-4,Q,108,9,0,62,86,49,62,12,24,1,2,15,61,86,8,3,51,89,39,51,18,38,4,6,14,57,89
2009-06-08 00:00:00.000,London / Queen's Club Great Britain ATP World Tour 250,GRASS,2,James Blake,Mikhail Youzhny,James Blake,7-6(5); 6-3,Q,76,5,2,34,59,26,34,17,25,1,2,10,43,59,0,2,44,66,26,44,13,22,0,3,11,39,66
2009-06-08 00:00:00.000,London / Queen's Club Great Britain ATP World Tour 250,GRASS,2,Andy Roddick,Ivo Karlovic,Andy Roddick,7-6(4); 7-6(5),Q,82,24,2,56,72,50,56,11,16,0,0,12,61,72,26,0,53,74,48,53,12,21,2,2,12,60,74
2009-06-08 00:00:00.000,London / Queen's Club Great Britain ATP World Tour 250,GRASS,2,Andy Murray,Juan Carlos Ferrero,Andy Murray,6-2; 6-4,S,72,9,2,29,51,25,29,13,22,0,0,9,38,51,2,0,34,66,22,34,14,32,6,9,9,36,66
2009-06-08 00:00:00.000,London / Queen's Club Great Britain ATP World Tour 250,GRASS,2,James Blake,Andy Roddick,James Blake,4-4 RET,S,32,3,0,11,20,10,11,7,9,0,0,4,17,20,4,0,14,26,12,14,6,12,3,3,4,18,26
2009-06-08 00:00:00.000,London / Queen's Club Great Britain ATP World Tour 250,GRASS,2,Andy Murray,James Blake,Andy Murray,7-5; 6-4,F,68,7,3,34,59,28,34,15,25,1,2,11,43,59,1,1,31,55,21,31,16,24,0,3,11,37,55
2009-06-14 00:00:00.000,Eastbourne Great Britain ATP World Tour 250,GRASS,2,Frank Dancevic,Igor Andreev,Frank Dancevic,7-6(6); 6-2,R32,88,11,1,41,58,34,41,12,17,1,1,10,46,58,6,1,47,72,32,47,13,25,5,7,10,45,72
2009-06-14 00:00:00.000,Eastbourne Great Britain ATP World Tour 250,GRASS,2,James Ward,Victor Crivoi,James Ward,6-1; 6-3,R32,52,9,2,19,43,16,19,15,24,1,2,8,31,43,1,0,32,51,12,32,11,19,4,9,8,23,51
2009-06-14 00:00:00.000,Eastbourne Great Britain ATP World Tour 250,GRASS,2,Leonardo Mayer,Eduardo Schwank,Leonardo Mayer,6-4; 6-2,R32,74,7,1,26,45,22,26,14,19,0,0,9,36,45,1,5,29,72,25,29,17,43,9,12,9,42,72
2009-06-14 00:00:00.000,Eastbourne Great Britain ATP World Tour 250,GRASS,2,Julien Benneteau,Mikhail Youzhny,Julien Benneteau,4-6; 6-4; 6-4,R32,136,5,1,65,95,41,65,13,30,1,6,15,54,95,5,4,79,116,42,79,20,37,9,15,15,62,116
2009-06-14 00:00:00.000,Eastbourne Great Britain ATP World Tour 250,GRASS,2,Fabrice Santoro,Robert Kendrick,Fabrice Santoro,6-3; 6-2,R32,62,1,2,32,59,26,32,17,27,4,4,9,43,59,1,5,33,56,22,33,8,23,4,7,8,30,56
2009-06-14 00:00:00.000,Eastbourne Great Britain ATP World Tour 250,GRASS,2,Robby Ginepri,Andrey Golubev,Robby Ginepri,6-3; 6-4,R32,61,1,1,35,55,28,35,11,20,2,3,10,39,55,6,4,27,50,21,27,8,23,1,4,9,29,50
2009-06-14 00:00:00.000,Eastbourne Great Britain ATP World Tour 250,GRASS,2,Josh Goodall,Tatsuma Ito,Josh Goodall,6-4; 6-1,R32,61,5,2,20,49,17,20,16,29,0,1,8,33,49,2,4,27,50,16,27,7,23,1,6,9,23,50
2009-06-14 00:00:00.000,Eastbourne Great Britain ATP World Tour 250,GRASS,2,Ivan Ljubicic,Andreas Seppi,Ivan Ljubicic,7-6(4); 7-5,R32,94,9,2,49,73,35,49,16,24,3,4,12,51,73,2,3,44,73,32,44,14,29,6,8,12,46,73
2009-06-14 00:00:00.000,Eastbourne Great Britain ATP World Tour 250,GRASS,2,Guillermo Garcia-Lopez,Evgeny Korolev,Guillermo Garcia-Lopez,6-2; 6-7(3); 6-2,R32,121,13,3,54,79,43,54,13,25,1,3,14,56,79,2,2,58,101,41,58,16,43,7,13,14,57,101
2009-06-14 00:00:00.000,Eastbourne Great Britain ATP World Tour 250,GRASS,2,Yen-Hsun Lu,Colin Fleming,Yen-Hsun Lu,7-6(2); 1-6; 6-3,R32,125,6,7,65,102,46,65,17,37,8,11,14,63,102,8,5,51,86,42,51,13,35,2,4,14,55,86
2009-06-14 00:00:00.000,Eastbourne Great Britain ATP World Tour 250,GRASS,2,Brydan Klein,Teymuraz Gabashvili,Brydan Klein,6-3; 5-7; 6-1,R32,111,5,7,41,75,28,41,21,34,2,5,14,49,75,5,2,54,91,35,54,15,37,6,12,14,50,91
2009-06-14 00:00:00.000,Eastbourne Great Britain ATP World Tour 250,GRASS,2,Janko Tipsarevic,Paul-Henri Mathieu,Janko Tipsarevic,6-4; 6-2,R32,87,8,5,31,58,28,31,13,27,2,2,9,41,58,8,3,36,77,26,36,16,41,14,17,9,42,77
2009-06-14 00:00:00.000,Eastbourne Great Britain ATP World Tour 250,GRASS,2,Sam Querrey,Paul Capdeville,Sam Querrey,6-2; 7-5,R32,51,19,2,40,54,32,40,9,14,0,0,10,41,54,2,1,43,56,29,43,5,13,0,3,10,34,56
2009-06-14 00:00:00.000,Eastbourne Great Britain ATP World Tour 250,GRASS,2,Denis Istomin,Kevin Kim,Denis Istomin,7-6(5); 7-5,R32,81,10,3,51,77,40,51,15,26,2,3,12,55,77,0,6,49,76,33,49,17,27,7,9,12,50,76
2009-06-14 00:00:00.000,Eastbourne Great Britain ATP World Tour 250,GRASS,2,Alex Bogdanovic,Ivo Minar,Alex Bogdanovic,6-4; 7-6(3),R32,75,8,1,36,57,35,36,10,21,0,1,11,45,57,9,2,46,78,33,46,15,32,5,7,11,48,78
2009-06-14 00:00:00.000,Eastbourne Great Britain ATP World Tour 250,GRASS,2,Dmitry Tursunov,Fabio Fognini,Dmitry Tursunov,6-3; 4-6; 6-4,R32,119,3,5,55,99,40,55,21,44,0,3,15,61,99,6,5,49,85,35,49,16,36,4,8,14,51,85
2009-06-14 00:00:00.000,Eastbourne Great Britain ATP World Tour 250,GRASS,2,Frank Dancevic,James Ward,Frank Dancevic,7-6(6); 6-4,R16,89,7,0,45,74,36,45,14,29,5,7,11,50,74,10,4,38,70,31,38,15,32,5,8,11,46,70
2009-06-14 00:00:00.000,Eastbourne Great Britain ATP World Tour 250,GRASS,2,Leonardo Mayer,Julien Benneteau,Leonardo Mayer,6-4; 6-4,R16,84,7,0,37,64,27,37,17,27,5,6,10,44,64,4,3,45,67,29,45,9,22,5,8,10,38,67
2009-06-14 00:00:00.000,Eastbourne Great Britain ATP World Tour 250,GRASS,2,Fabrice Santoro,Robby Ginepri,Fabrice Santoro,4-6; 6-4; 6-1,R16,115,0,2,40,83,29,40,24,43,6,8,13,53,83,6,6,58,98,41,58,13,40,7,12,14,54,98
2009-06-14 00:00:00.000,Eastbourne Great Britain ATP World Tour 250,GRASS,2,Ivan Ljubicic,Josh Goodall,Ivan Ljubicic,6-3; 7-5,R16,75,12,1,34,56,27,34,18,22,0,0,11,45,56,3,1,33,62,26,33,14,29,3,5,10,40,62
2009-06-14 00:00:00.000,Eastbourne Great Britain ATP World Tour 250,GRASS,2,Guillermo Garcia-Lopez,Yen-Hsun Lu,Guillermo Garcia-Lopez,6-4; 6-7(0); 7-6(3),R16,165,13,6,72,113,55,72,18,41,5,7,17,73,113,2,6,77,119,55,77,20,42,10,13,17,75,119
2009-06-14 00:00:00.000,Eastbourne Great Britain ATP World Tour 250,GRASS,2,Janko Tipsarevic,Brydan Klein,Janko Tipsarevic,7-6(5); 6-1,R16,79,11,2,37,62,31,37,13,25,1,2,10,44,62,4,1,33,54,26,33,8,21,3,6,9,34,54
2009-06-14 00:00:00.000,Eastbourne Great Britain ATP World Tour 250,GRASS,2,Denis Istomin,Sam Querrey,Denis Istomin,3-6; 7-6(3); 6-4,R16,111,6,3,56,99,45,56,24,43,7,8,15,69,99,17,3,60,102,46,60,26,42,5,6,16,72,102
2009-06-14 00:00:00.000,Eastbourne Great Britain ATP World Tour 250,GRASS,2,Dmitry Tursunov,Alex Bogdanovic,Dmitry Tursunov,6-7(2); 6-4; 7-6(5),R16,153,7,5,87,131,65,87,22,44,7,8,17,87,131,14,9,54,101,43,54,30,47,1,3,17,73,101
2009-06-14 00:00:00.000,Eastbourne Great Britain ATP World Tour 250,GRASS,2,Frank Dancevic,Leonardo Mayer,Frank Dancevic,6-7(4); 6-4; 7-5,Q,134,16,1,72,101,61,72,14,29,2,2,17,75,101,15,4,75,111,56,75,17,36,3,5,17,73,111
2009-06-14 00:00:00.000,Eastbourne Great Britain ATP World Tour 250,GRASS,2,Fabrice Santoro,Ivan Ljubicic,Fabrice Santoro,3-6; 4-2 RET,Q,63,2,0,19,42,14,19,15,23,0,1,7,29,42,8,1,33,47,25,33,8,14,2,3,8,33,47
2009-06-14 00:00:00.000,Eastbourne Great Britain ATP World Tour 250,GRASS,2,Guillermo Garcia-Lopez,Janko Tipsarevic,Guillermo Garcia-Lopez,6-4; 3-6; 6-3,Q,123,9,2,43,83,32,43,20,40,1,5,14,52,83,4,3,37,75,30,37,16,38,5,10,14,46,75
2009-06-14 00:00:00.000,Eastbourne Great Britain ATP World Tour 250,GRASS,2,Dmitry Tursunov,Denis Istomin,Dmitry Tursunov,7-6(6); 6-4,Q,94,3,4,47,70,40,47,13,23,3,3,11,53,70,8,1,54,81,36,54,17,27,9,10,11,53,81
2009-06-14 00:00:00.000,Eastbourne Great Britain ATP World Tour 250,GRASS,2,Frank Dancevic,Fabrice Santoro,Frank Dancevic,6-4; 6-4,S,84,7,2,47,77,35,47,16,30,6,6,10,51,77,2,2,34,54,28,34,9,20,3,5,10,37,54
2009-06-14 00:00:00.000,Eastbourne Great Britain ATP World Tour 250,GRASS,2,Dmitry Tursunov,Guillermo Garcia-Lopez,Dmitry Tursunov,6-2; 6-2,S,70,2,0,30,49,24,30,12,19,4,4,8,36,49,0,4,30,50,17,30,9,20,3,7,8,26,50
2009-06-14 00:00:00.000,Eastbourne Great Britain ATP World Tour 250,GRASS,2,Dmitry Tursunov,Frank Dancevic,Dmitry Tursunov,6-3; 7-6(5),F,83,12,2,37,61,32,37,17,24,0,0,11,49,61,10,2,45,63,35,45,9,18,2,3,10,44,63
2009-06-14 00:00:00.000,s-Hertogenbosch The Netherlands ATP World Tour 250,GRASS,2,Fernando Verdasco,Pablo Andujar,Fernando Verdasco,6-3; 7-5,R32,82,9,2,37,59,31,37,15,22,1,1,11,46,59,0,5,31,63,23,31,17,32,2,4,10,40,63
2009-06-14 00:00:00.000,s-Hertogenbosch The Netherlands ATP World Tour 250,GRASS,2,Benjamin Becker,Florent Serra,Benjamin Becker,6-3; 6-4,R32,54,15,5,38,62,30,38,13,24,2,2,10,43,62,3,1,33,53,22,33,9,20,4,6,9,31,53
2009-06-14 00:00:00.000,s-Hertogenbosch The Netherlands ATP World Tour 250,GRASS,2,Kristof Vliegen,Jan Hernych,Kristof Vliegen,2-6; 7-5; 6-2,R32,103,12,3,59,88,38,59,16,29,2,5,14,54,88,0,2,51,90,31,51,23,39,5,9,14,54,90
2009-06-14 00:00:00.000,s-Hertogenbosch The Netherlands ATP World Tour 250,GRASS,2,Michael Llodra,Mischa Zverev,Michael Llodra,4-1 RET,R32,20,3,0,8,13,8,8,4,5,0,0,3,12,13,1,0,7,16,2,7,6,9,3,4,2,8,16
2009-06-14 00:00:00.000,s-Hertogenbosch The Netherlands ATP World Tour 250,GRASS,2,Rainer Schuettler,Nicolas Devilder,Rainer Schuettler,6-4; 7-6(6),R32,100,3,1,47,71,28,47,16,24,3,6,11,44,71,2,6,51,89,33,51,13,38,9,13,11,46,89
2009-06-14 00:00:00.000,s-Hertogenbosch The Netherlands ATP World Tour 250,GRASS,2,Thiemo de Bakker,Bjorn Phau,Thiemo de Bakker,7-6(3); 2-6; 6-3,R32,115,6,2,50,83,39,50,14,33,4,8,14,53,83,5,10,64,108,45,64,16,44,8,12,15,61,108
2009-06-14 00:00:00.000,s-Hertogenbosch The Netherlands ATP World Tour 250,GRASS,2,Dick Norman,Daniel Berta,Dick Norman,6-3; 6-3,R32,60,11,5,21,44,18,21,18,23,0,0,9,36,44,1,2,20,51,13,20,18,31,1,4,9,31,51
2009-06-14 00:00:00.000,s-Hertogenbosch The Netherlands ATP World Tour 250,GRASS,2,Jeremy Chardy,Philipp Petzschner,Jeremy Chardy,6-1; 6-3,R32,52,7,1,27,44,24,27,10,17,0,0,8,34,44,6,5,20,49,14,20,12,29,4,8,8,26,49
2009-06-14 00:00:00.000,s-Hertogenbosch The Netherlands ATP World Tour 250,GRASS,2,Marc Gicquel,Steve Darcis,Marc Gicquel,6-2; 6-3,R32,60,7,1,34,52,29,34,10,18,1,1,9,39,52,3,1,31,51,20,31,8,20,4,7,8,28,51
2009-06-14 00:00:00.000,s-Hertogenbosch The Netherlands ATP World Tour 250,GRASS,2,Ivan Navarro,Gilles Muller,Ivan Navarro,7-5; 7-5,R32,84,15,3,42,67,36,42,14,25,4,4,12,50,67,5,2,36,62,27,36,19,26,2,4,12,46,62
2009-06-14 00:00:00.000,s-Hertogenbosch The Netherlands ATP World Tour 250,GRASS,2,Oscar Hernandez,Daniel Koellerer,Oscar Hernandez,6-3; 6-2,R32,72,8,3,36,59,29,36,13,23,3,3,9,42,59,2,1,34,48,20,34,5,14,3,6,8,25,48
2009-06-14 00:00:00.000,s-Hertogenbosch The Netherlands ATP World Tour 250,GRASS,2,David Ferrer,Jesse Huta Galung,David Ferrer,6-2; 7-5,R32,93,3,3,48,70,33,48,11,22,8,10,10,44,70,3,1,35,69,22,35,14,34,7,12,10,36,69
2009-06-14 00:00:00.000,s-Hertogenbosch The Netherlands ATP World Tour 250,GRASS,2,Igor Kunitsyn,Arnaud Clement,Igor Kunitsyn,6-2; 6-3,R32,78,8,2,26,47,22,26,13,21,2,2,8,35,47,2,4,39,64,24,39,8,25,4,8,9,32,64
2009-06-14 00:00:00.000,s-Hertogenbosch The Netherlands ATP World Tour 250,GRASS,2,Dudi Sela,Christophe Rochus,Dudi Sela,6-2; 6-4,R32,58,3,1,28,42,25,28,11,14,0,0,9,36,42,2,2,46,61,27,46,8,15,6,9,9,35,61
2009-06-14 00:00:00.000,s-Hertogenbosch The Netherlands ATP World Tour 250,GRASS,2,Raemon Sluiter,Daniel Gimeno-Traver,Raemon Sluiter,6-2; 7-5,R32,78,8,4,41,64,35,41,9,23,2,2,10,44,64,9,3,29,57,25,29,11,28,1,4,10,36,57
2009-06-14 00:00:00.000,s-Hertogenbosch The Netherlands ATP World Tour 250,GRASS,2,Marcos Baghdatis,Tommy Robredo,Marcos Baghdatis,7-5; 6-2,R32,78,5,0,28,52,23,28,16,24,2,3,10,39,52,2,4,39,69,24,39,13,30,4,8,10,37,69
2009-06-14 00:00:00.000,s-Hertogenbosch The Netherlands ATP World Tour 250,GRASS,2,Benjamin Becker,Fernando Verdasco,Benjamin Becker,7-5; 7-6(4),R16,104,10,2,42,82,34,42,25,40,3,3,12,59,82,9,7,48,86,36,48,20,38,2,3,12,56,86
2009-06-14 00:00:00.000,s-Hertogenbosch The Netherlands ATP World Tour 250,GRASS,2,Michael Llodra,Kristof Vliegen,Michael Llodra,6-2; 6-3,R16,67,8,1,29,49,24,29,13,20,2,2,9,37,49,3,2,42,63,23,42,13,21,7,10,8,36,63
2009-06-14 00:00:00.000,s-Hertogenbosch The Netherlands ATP World Tour 250,GRASS,2,Rainer Schuettler,Thiemo de Bakker,Rainer Schuettler,6-3; 7-6(3),R16,89,2,2,51,74,39,51,14,23,1,1,11,53,74,3,1,36,63,27,36,15,27,1,2,10,42,63
2009-06-14 00:00:00.000,s-Hertogenbosch The Netherlands ATP World Tour 250,GRASS,2,Jeremy Chardy,Dick Norman,Jeremy Chardy,3-6; 6-3; 6-3,R16,102,9,6,40,76,33,40,20,36,2,3,13,53,76,18,13,39,80,32,39,22,41,6,9,14,54,80
2009-06-14 00:00:00.000,s-Hertogenbosch The Netherlands ATP World Tour 250,GRASS,2,Ivan Navarro,Marc Gicquel,Ivan Navarro,6-4; 3-6; 7-5,R16,152,11,7,68,113,51,68,20,45,11,13,15,71,113,3,4,65,107,46,65,21,42,5,8,16,67,107
2009-06-14 00:00:00.000,s-Hertogenbosch The Netherlands ATP World Tour 250,GRASS,2,David Ferrer,Oscar Hernandez,David Ferrer,6-4; 6-3,R16,83,5,0,34,57,28,34,13,23,1,2,10,41,57,2,2,30,56,21,30,10,26,2,5,9,31,56
2009-06-14 00:00:00.000,s-Hertogenbosch The Netherlands ATP World Tour 250,GRASS,2,Dudi Sela,Igor Kunitsyn,Dudi Sela,6-4; 6-3,R16,86,0,2,44,74,32,44,16,30,14,14,9,48,74,5,5,40,61,32,40,6,21,1,4,10,38,61
2009-06-14 00:00:00.000,s-Hertogenbosch The Netherlands ATP World Tour 250,GRASS,2,Raemon Sluiter,Marcos Baghdatis,Raemon Sluiter,4-3 RET,R16,33,2,2,16,28,11,16,6,12,4,5,4,17,28,5,1,15,22,9,15,3,7,1,2,3,12,22
2009-06-14 00:00:00.000,s-Hertogenbosch The Netherlands ATP World Tour 250,GRASS,2,Benjamin Becker,Michael Llodra,Benjamin Becker,7-6(6); 7-5,Q,93,14,2,46,82,37,46,20,36,1,2,12,57,82,10,1,49,75,38,49,13,26,4,6,12,51,75
2009-06-14 00:00:00.000,s-Hertogenbosch The Netherlands ATP World Tour 250,GRASS,2,Rainer Schuettler,Jeremy Chardy,Rainer Schuettler,7-6(7); 3-6; 7-6(11),Q,149,5,6,73,108,53,73,22,35,2,5,16,75,108,16,7,68,110,55,68,22,42,6,8,17,77,110
2009-06-14 00:00:00.000,s-Hertogenbosch The Netherlands ATP World Tour 250,GRASS,2,Ivan Navarro,David Ferrer,Ivan Navarro,6-4; 6-2,Q,81,3,5,44,72,31,44,15,28,5,5,9,46,72,4,0,32,48,22,32,8,16,3,6,9,30,48
2009-06-14 00:00:00.000,s-Hertogenbosch The Netherlands ATP World Tour 250,GRASS,2,Raemon Sluiter,Dudi Sela,Raemon Sluiter,4-6; 6-4; 6-4,Q,126,8,1,63,88,47,63,14,25,5,7,15,61,88,5,4,60,96,44,60,18,36,8,11,15,62,96
2009-06-14 00:00:00.000,s-Hertogenbosch The Netherlands ATP World Tour 250,GRASS,2,Benjamin Becker,Rainer Schuettler,Benjamin Becker,3-6; 7-5; 6-1,S,103,7,1,51,81,36,51,16,30,0,3,14,52,81,2,0,62,82,36,62,10,20,3,8,14,46,82
2009-06-14 00:00:00.000,s-Hertogenbosch The Netherlands ATP World Tour 250,GRASS,2,Raemon Sluiter,Ivan Navarro,Raemon Sluiter,6-7(5); 6-2; 6-3,S,129,3,1,70,93,52,70,12,23,6,7,15,64,93,10,5,54,90,41,54,16,36,2,6,14,57,90
2009-06-14 00:00:00.000,s-Hertogenbosch The Netherlands ATP World Tour 250,GRASS,2,Benjamin Becker,Raemon Sluiter,Benjamin Becker,7-5; 6-3,F,76,11,0,38,57,33,38,12,19,0,0,11,45,57,6,1,44,61,31,44,9,17,3,5,10,40,61
2009-06-22 00:00:00.000,Wimbledon Great Britain Grand Slams,GRASS,3,Juan Martin Del Potro,Arnaud Clement,Juan Martin Del Potro,6-3; 6-1; 6-2,R128,97,10,0,41,59,35,41,13,18,0,0,12,48,59,3,6,27,73,19,27,19,46,3,9,12,38,73
2009-06-22 00:00:00.000,Wimbledon Great Britain Grand Slams,GRASS,3,Lleyton Hewitt,Robby Ginepri,Lleyton Hewitt,6-4; 6-1; 6-1,R128,92,13,3,40,68,37,40,13,28,3,4,12,50,68,3,6,49,88,24,49,16,39,11,18,12,40,88
2009-06-22 00:00:00.000,Wimbledon Great Britain Grand Slams,GRASS,3,Philipp Petzschner,Rajeev Ram,Philipp Petzschner,2-6; 6-1; 7-6(3); 6-1,R128,116,18,6,53,105,43,53,34,52,5,7,18,77,105,12,3,62,97,45,62,15,35,5,9,16,60,97
2009-06-22 00:00:00.000,Wimbledon Great Britain Grand Slams,GRASS,3,Mischa Zverev,Dmitry Tursunov,Mischa Zverev,6-4; 6-2; 3-0 RET,R128,83,6,0,46,62,37,46,9,16,1,1,10,46,62,6,5,41,74,30,41,9,33,5,10,11,39,74
2009-06-22 00:00:00.000,Wimbledon Great Britain Grand Slams,GRASS,3,Radek Stepanek,Alejandro Falla,Radek Stepanek,6-4; 6-4; 6-1,R128,110,5,3,51,81,38,51,17,30,4,5,13,55,81,2,8,55,91,34,55,12,36,3,9,14,46,91
2009-06-22 00:00:00.000,Wimbledon Great Britain Grand Slams,GRASS,3,Potito Starace,Jose Acasuso,Potito Starace,7-6; 6-3 RET,R128,77,3,0,40,51,36,40,7,11,0,0,10,43,51,4,2,44,69,32,44,11,25,3,5,11,43,69
2009-06-22 00:00:00.000,Wimbledon Great Britain Grand Slams,GRASS,3,Fabio Fognini,Denis Istomin,Fabio Fognini,1-6; 6-7(3); 6-4; 3-1 RET,R128,144,7,4,77,117,51,77,20,40,6,9,16,71,117,6,5,83,133,61,83,22,50,14,17,17,83,133
2009-06-22 00:00:00.000,Wimbledon Great Britain Grand Slams,GRASS,3,David Ferrer,Kevin Kim,David Ferrer,7-5; 6-3; 4-6; 6-2,R128,145,7,3,74,117,50,74,20,43,8,14,20,70,117,4,6,61,113,39,61,19,52,5,14,19,58,113
2009-06-22 00:00:00.000,Wimbledon Great Britain Grand Slams,GRASS,3,Nikolay Davydenko,Daniel Evans,Nikolay Davydenko,6-2; 6-3; 6-3,R128,109,3,3,47,64,36,47,9,17,0,3,13,45,64,3,5,65,98,35,65,10,33,7,15,13,45,98
2009-06-22 00:00:00.000,Wimbledon Great Britain Grand Slams,GRASS,3,Victor Crivoi,Bjorn Phau,Victor Crivoi,4-6; 6-1; 7-6(3); 2-6; 6-3,R128,178,5,1,96,143,62,96,29,47,5,10,24,91,143,13,6,75,145,48,75,38,70,7,12,22,86,145
2009-06-22 00:00:00.000,Wimbledon Great Britain Grand Slams,GRASS,3,Paul-Henri Mathieu,Frederico Gil,Paul-Henri Mathieu,6-1; 2-6; 6-4; 6-2,R128,125,13,6,64,100,53,64,15,36,3,5,17,68,100,12,1,60,97,43,60,14,37,6,11,16,57,97
2009-06-22 00:00:00.000,Wimbledon Great Britain Grand Slams,GRASS,3,Tomas Berdych,Alex Bogdanovic,Tomas Berdych,6-3; 6-4; 6-4,R128,88,9,1,44,72,41,44,21,28,0,0,15,62,72,5,3,47,74,37,47,12,27,2,5,14,49,74
2009-06-22 00:00:00.000,Wimbledon Great Britain Grand Slams,GRASS,3,Jurgen Melzer,Wayne Odesnik,Jurgen Melzer,6-1; 6-4; 6-2,R128,85,16,3,51,80,39,51,17,29,3,4,13,56,80,5,7,52,83,30,52,12,31,9,15,12,42,83
2009-06-22 00:00:00.000,Wimbledon Great Britain Grand Slams,GRASS,3,Benjamin Becker,Roko Karanusic,Benjamin Becker,6-4; 6-4; 6-1,R128,73,13,1,45,71,41,45,16,26,5,6,14,57,71,3,2,43,70,25,43,15,27,1,6,13,40,70
2009-06-22 00:00:00.000,Wimbledon Great Britain Grand Slams,GRASS,3,Igor Kunitsyn,Grigor Dimitrov,Igor Kunitsyn,3-6; 6-0; 3-0 RET,R128,75,4,4,31,58,22,31,15,27,3,5,9,37,58,3,6,40,70,22,40,10,30,8,13,9,32,70
2009-06-22 00:00:00.000,Wimbledon Great Britain Grand Slams,GRASS,3,Andy Roddick,Jeremy Chardy,Andy Roddick,6-3; 7-6(3); 4-6; 6-3,R128,132,21,1,76,106,68,76,18,30,1,3,21,86,106,14,6,63,120,51,63,29,57,7,10,19,80,120
2009-06-22 00:00:00.000,Wimbledon Great Britain Grand Slams,GRASS,3,Andy Murray,Robert Kendrick,Andy Murray,7-5; 6-7(3); 6-3; 6-4,R128,158,20,4,74,126,63,74,30,52,1,2,22,93,126,18,5,91,136,66,91,23,45,4,8,21,89,136
2009-06-22 00:00:00.000,Wimbledon Great Britain Grand Slams,GRASS,3,Ernests Gulbis,Riccardo Ghedin,Ernests Gulbis,6-2; 6-4; 6-4,R128,88,11,6,45,80,36,45,21,35,1,2,14,57,80,6,4,42,76,27,42,17,34,1,6,14,44,76
2009-06-22 00:00:00.000,Wimbledon Great Britain Grand Slams,GRASS,3,Daniel Gimeno-Traver,Taylor Dent,Daniel Gimeno-Traver,7-5; 7-6(6); 4-6; 6-7(3); 6-4,R128,205,5,6,113,162,87,113,28,49,3,6,28,115,162,12,20,94,182,77,94,44,88,11,15,28,121,182
2009-06-22 00:00:00.000,Wimbledon Great Britain Grand Slams,GRASS,3,Viktor Troicki,Brian Dabul,Viktor Troicki,6-4; 6-4; 6-3,R128,105,11,5,50,87,40,50,22,37,6,7,14,62,87,3,3,59,92,40,59,14,33,2,7,15,54,92
2009-06-22 00:00:00.000,Wimbledon Great Britain Grand Slams,GRASS,3,Stanislas Wawrinka,Eduardo Schwank,Stanislas Wawrinka,7-5; 6-4; 6-1,R128,112,11,0,54,89,43,54,20,35,6,6,14,63,89,8,5,60,96,42,60,13,36,2,7,15,55,96
2009-06-22 00:00:00.000,Wimbledon Great Britain Grand Slams,GRASS,3,Martin Vassallo Arguello,Pablo Andujar,Martin Vassallo Arguello,4-6; 6-3; 6-2; 6-2,R128,139,4,1,71,101,51,71,16,30,3,6,18,67,101,2,5,57,96,34,57,20,39,4,11,17,54,96
2009-06-22 00:00:00.000,Wimbledon Great Britain Grand Slams,GRASS,3,Pablo Cuevas,Christophe Rochus,Pablo Cuevas,3-6; 4-6; 6-4; 6-1; 11-9,R128,184,33,6,100,150,80,100,23,50,4,9,28,103,150,0,2,116,164,73,116,29,48,7,14,28,102,164
2009-06-22 00:00:00.000,Wimbledon Great Britain Grand Slams,GRASS,3,Jesse Levine,Marat Safin,Jesse Levine,6-2; 3-6; 7-6(4); 6-4,R128,136,11,10,68,119,59,68,25,51,11,13,19,84,119,13,2,78,123,55,78,24,45,4,8,20,79,123
2009-06-22 00:00:00.000,Wimbledon Great Britain Grand Slams,GRASS,3,Fernando Gonzalez,Teymuraz Gabashvili,Fernando Gonzalez,7-5; 7-5; 6-3,R128,134,18,3,63,109,50,63,24,46,4,5,17,74,109,8,9,48,105,36,48,28,57,8,12,16,64,105
2009-06-22 00:00:00.000,Wimbledon Great Britain Grand Slams,GRASS,3,Leonardo Mayer,Oscar Hernandez,Leonardo Mayer,6-0; 6-0; 6-3,R128,71,10,1,38,59,35,38,11,21,3,3,11,46,59,1,5,44,62,21,44,5,18,4,11,10,26,62
2009-06-22 00:00:00.000,Wimbledon Great Britain Grand Slams,GRASS,3,Juan Carlos Ferrero,Mikhail Youzhny,Juan Carlos Ferrero,6-3; 7-6(3); 6-3,R128,114,6,1,64,96,50,64,23,32,5,6,16,73,96,5,0,56,78,44,56,9,22,2,5,14,53,78
2009-06-22 00:00:00.000,Wimbledon Great Britain Grand Slams,GRASS,3,Fabrice Santoro,Nicolas Kiefer,Fabrice Santoro,6-4; 6-2; 6-2,R128,107,11,3,50,82,38,50,20,32,2,2,13,58,82,3,8,42,88,29,42,22,46,7,12,13,51,88
2009-06-22 00:00:00.000,Wimbledon Great Britain Grand Slams,GRASS,3,Victor Hanescu,Ivan Navarro,Victor Hanescu,6-3; 6-7(5); 6-4; 6-7(5); 12-10,R128,251,12,0,135,197,102,135,39,62,5,6,33,141,197,18,10,107,187,83,107,47,80,3,7,32,130,187
2009-06-22 00:00:00.000,Wimbledon Great Britain Grand Slams,GRASS,3,Nicolas Devilder,Nicolas Lapentti,Nicolas Devilder,3-6; 6-4; 6-3; 4-6; 7-5,R128,223,13,4,113,173,74,113,33,60,11,16,25,107,173,5,3,88,152,63,88,34,64,8,14,25,97,152
2009-06-22 00:00:00.000,Wimbledon Great Britain Grand Slams,GRASS,3,Thiago Alves,Andrei Pavel,Thiago Alves,6-3; 2-6; 6-1; 2-6; 6-1,R128,140,3,4,80,121,56,80,17,41,4,8,19,73,121,6,9,68,120,47,68,22,52,9,16,20,69,120
2009-06-22 00:00:00.000,Wimbledon Great Britain Grand Slams,GRASS,3,Gilles Simon,Bobby Reynolds,Gilles Simon,6-4; 6-3; 6-3,R128,96,14,3,50,78,39,50,18,28,2,3,14,57,78,4,4,60,94,40,60,12,34,5,10,14,52,94
2009-06-22 00:00:00.000,Wimbledon Great Britain Grand Slams,GRASS,3,Andreas Seppi,James Blake,Andreas Seppi,7-5; 6-4; 7-6(5),R128,129,9,2,69,108,48,69,24,39,4,6,17,72,108,11,2,81,127,55,81,21,46,11,15,17,76,127
2009-06-22 00:00:00.000,Wimbledon Great Britain Grand Slams,GRASS,3,Marc Gicquel,Adrian Mannarino,Marc Gicquel,6-2; 6-2; 6-4,R128,92,5,3,39,74,31,39,22,35,3,4,13,53,74,8,4,51,80,30,51,12,29,3,9,13,42,80
2009-06-22 00:00:00.000,Wimbledon Great Britain Grand Slams,GRASS,3,Vincent Spadea,Paul Capdeville,Vincent Spadea,6-0; 6-4; 7-5,R128,86,10,0,47,72,41,47,16,25,1,1,14,57,72,11,2,47,76,36,47,11,29,2,7,14,47,76
2009-06-22 00:00:00.000,Wimbledon Great Britain Grand Slams,GRASS,3,Igor Andreev,Evgeny Korolev,Igor Andreev,4-6; 7-6(2); 6-4; 7-6(4),R128,170,20,4,76,131,61,76,33,55,1,4,22,94,131,15,6,104,153,72,104,28,49,8,11,22,100,153
2009-06-22 00:00:00.000,Wimbledon Great Britain Grand Slams,GRASS,3,Tommy Haas,Alexander Peya,Tommy Haas,6-7(5); 7-6; 6-3; 6-4,R128,174,12,13,96,160,76,96,30,64,12,14,22,106,160,11,4,74,127,51,74,32,53,8,12,21,83,127
2009-06-22 00:00:00.000,Wimbledon Great Britain Grand Slams,GRASS,3,Michael Llodra,Josh Goodall,Michael Llodra,4-6; 7-6(5); 6-4; 3-6; 6-4,R128,194,25,4,101,150,78,101,29,49,6,9,25,107,150,17,7,109,173,84,109,32,64,15,18,26,116,173
2009-06-22 00:00:00.000,Wimbledon Great Britain Grand Slams,GRASS,3,Sam Querrey,Danai Udomchoke,Sam Querrey,6-3; 6-4; 6-4,R128,101,14,5,73,103,63,73,9,30,7,7,15,72,103,5,1,69,104,46,69,18,35,7,10,14,64,104
2009-06-22 00:00:00.000,Wimbledon Great Britain Grand Slams,GRASS,3,Marin Cilic,Alberto Martin,Marin Cilic,6-3; 6-4; 6-4,R128,110,12,1,57,90,42,57,23,33,4,4,15,65,90,2,1,56,89,36,56,19,33,5,8,14,55,89
2009-06-22 00:00:00.000,Wimbledon Great Britain Grand Slams,GRASS,3,Tommy Robredo,Luka Gregorc,Tommy Robredo,7-6(4); 6-4; 5-7; 7-6(3),R128,180,13,4,89,139,77,89,25,50,5,7,23,102,139,15,8,97,151,75,97,24,54,10,12,23,99,151
2009-06-22 00:00:00.000,Wimbledon Great Britain Grand Slams,GRASS,3,Stefan Koubek,Edouard Roger-Vasselin,Stefan Koubek,7-5; 6-3; 4-6; 3-6; 6-3,R128,194,9,5,85,149,60,85,32,64,8,12,24,92,149,4,3,100,154,67,100,28,54,6,12,25,95,154
2009-06-22 00:00:00.000,Wimbledon Great Britain Grand Slams,GRASS,3,Dudi Sela,Santiago Gonzalez,Dudi Sela,6-4; 4-6; 7-6(2); 6-3,R128,146,0,4,82,128,59,82,27,46,8,12,21,86,128,4,3,76,114,54,76,18,38,6,11,20,72,114
2009-06-22 00:00:00.000,Wimbledon Great Britain Grand Slams,GRASS,3,Rainer Schuettler,Xavier Malisse,Rainer Schuettler,6-7(9); 6-4; 7-6(3); 6-1,R128,178,8,5,94,138,68,94,24,44,4,7,21,92,138,15,2,80,135,52,80,28,55,4,10,20,80,135
2009-06-22 00:00:00.000,Wimbledon Great Britain Grand Slams,GRASS,3,Mardy Fish,Sergio Roitman,Mardy Fish,6-3; 6-2; 4-1 RET,R128,83,14,0,42,66,35,42,15,24,4,4,11,50,66,0,1,60,77,35,60,5,17,7,12,11,40,77
2009-06-22 00:00:00.000,Wimbledon Great Britain Grand Slams,GRASS,3,Janko Tipsarevic,Jan Hernych,Janko Tipsarevic,6-4; 6-4; 7-6(4),R128,133,10,3,57,97,46,57,17,40,2,5,16,63,97,9,0,65,97,42,65,14,32,1,6,16,56,97
2009-06-22 00:00:00.000,Wimbledon Great Britain Grand Slams,GRASS,3,Simon Greul,Michael Yani,Simon Greul,6-4; 6-2; 7-5,R128,111,4,3,64,103,48,64,22,39,4,4,15,70,103,4,5,46,80,36,46,16,34,2,6,15,52,80
2009-06-22 00:00:00.000,Wimbledon Great Britain Grand Slams,GRASS,3,Novak Djokovic,Julien Benneteau,Novak Djokovic,6-7(8); 7-6(1); 6-2; 6-4,R128,209,14,4,87,128,72,87,20,41,3,4,21,92,128,3,4,104,152,71,104,24,48,8,12,21,95,152
2009-06-22 00:00:00.000,Wimbledon Great Britain Grand Slams,GRASS,3,Fernando Verdasco,James Ward,Fernando Verdasco,6-1; 6-3; 6-4,R128,91,15,4,59,72,47,59,7,13,3,3,13,54,72,4,4,43,74,31,43,13,31,5,10,13,44,74
2009-06-22 00:00:00.000,Wimbledon Great Britain Grand Slams,GRASS,3,Kristof Vliegen,Nicolas Mahut,Kristof Vliegen,6-3; 7-6(6); 5-7; 5-7; 6-4,R128,213,23,5,99,157,77,99,29,58,8,12,27,106,157,22,6,96,165,73,96,36,69,4,9,28,109,165
2009-06-22 00:00:00.000,Wimbledon Great Britain Grand Slams,GRASS,3,Guillermo Canas,Diego Junqueira,Guillermo Canas,6-1; 6-2; 6-2,R128,84,9,2,32,61,28,32,21,29,2,2,12,49,61,0,5,34,65,18,34,12,31,5,11,11,30,65
2009-06-22 00:00:00.000,Wimbledon Great Britain Grand Slams,GRASS,3,Albert Montanes,Grega Zemlja,Albert Montanes,6-4; 6-4; 6-4,R128,98,11,2,61,89,51,61,15,28,3,3,15,66,89,5,4,58,91,39,58,18,33,3,6,15,57,91
2009-06-22 00:00:00.000,Wimbledon Great Britain Grand Slams,GRASS,3,Ivo Karlovic,Lukas Lacko,Ivo Karlovic,6-3; 7-6(4); 6-3,R128,108,28,3,60,87,56,60,16,27,4,4,16,72,87,8,2,69,97,49,69,12,28,3,5,14,61,97
2009-06-22 00:00:00.000,Wimbledon Great Britain Grand Slams,GRASS,3,Steve Darcis,Frank Dancevic,Steve Darcis,6-4; 7-6(4); 6-3,R128,100,8,0,51,93,43,51,31,42,3,3,16,74,93,13,2,61,82,46,61,12,21,1,3,15,58,82
2009-06-22 00:00:00.000,Wimbledon Great Britain Grand Slams,GRASS,3,Simone Bolelli,Daniel Koellerer,Simone Bolelli,6-7(3); 2-6; 7-5; 6-4; 6-4,R128,236,18,5,114,174,85,114,31,60,9,11,26,116,174,5,0,113,149,85,113,20,36,3,6,26,105,149
2009-06-22 00:00:00.000,Wimbledon Great Britain Grand Slams,GRASS,3,Jo-Wilfried Tsonga,Andrey Golubev,Jo-Wilfried Tsonga,6-3; 5-7; 7-6(4); 7-6(5),R128,202,15,3,91,138,69,91,32,47,2,4,23,101,138,6,5,122,182,85,122,31,60,11,13,22,116,182
2009-06-22 00:00:00.000,Wimbledon Great Britain Grand Slams,GRASS,3,Robin Soderling,Gilles Muller,Robin Soderling,6-7(4); 7-5; 6-1; 6-2,R128,126,31,2,82,117,67,82,21,35,8,8,20,88,117,17,4,68,110,51,68,21,42,3,8,19,72,110
2009-06-22 00:00:00.000,Wimbledon Great Britain Grand Slams,GRASS,3,Marcel Granollers,Andreas Beck,Marcel Granollers,6-2; 6-4; 6-7(4); 6-2,R128,160,20,4,73,115,62,73,18,42,4,5,19,80,115,2,13,84,133,58,84,18,49,10,16,19,76,133
2009-06-22 00:00:00.000,Wimbledon Great Britain Grand Slams,GRASS,3,Nicolas Almagro,Juan Monaco,Nicolas Almagro,6-7(3); 6-7(7); 7-6(5); 6-4; 8-6,R128,239,33,13,114,198,91,114,47,84,9,11,30,138,198,13,8,141,208,107,141,33,67,18,22,30,140,208
2009-06-22 00:00:00.000,Wimbledon Great Britain Grand Slams,GRASS,3,Karol Beck,Feliciano Lopez,Karol Beck,1-6; 7-5; 6-3; 4-6; 10-8,R128,226,13,5,108,174,72,108,34,66,9,16,28,106,174,18,7,95,151,66,95,32,56,4,11,28,98,151
2009-06-22 00:00:00.000,Wimbledon Great Britain Grand Slams,GRASS,3,Philipp Kohlschreiber,Florent Serra,Philipp Kohlschreiber,7-6(3); 6-1; 6-4,R128,105,8,2,43,77,34,43,25,34,2,5,15,59,77,5,2,64,99,35,64,18,35,7,13,14,53,99
2009-06-22 00:00:00.000,Wimbledon Great Britain Grand Slams,GRASS,3,Ivo Minar,Maximo Gonzalez,Ivo Minar,6-4; 3-6; 7-5; 6-0,R128,117,9,0,69,99,53,69,18,30,2,4,18,71,99,3,3,71,113,46,71,19,42,8,14,19,65,113
2009-06-22 00:00:00.000,Wimbledon Great Britain Grand Slams,GRASS,3,Guillermo Garcia-Lopez,Agustin Calleri,Guillermo Garcia-Lopez,6-2; 6-3; 6-2,R128,99,6,4,47,70,38,47,16,23,1,2,13,54,70,1,5,63,86,37,63,8,23,2,8,12,45,86
2009-06-22 00:00:00.000,Wimbledon Great Britain Grand Slams,GRASS,3,Roger Federer,Yen-Hsun Lu,Roger Federer,7-5; 6-3; 6-2,R128,105,10,1,53,75,45,53,15,22,2,3,15,60,75,3,1,64,93,40,64,13,29,6,11,14,53,93
2009-06-22 00:00:00.000,Wimbledon Great Britain Grand Slams,GRASS,3,Lleyton Hewitt,Juan Martin Del Potro,Lleyton Hewitt,6-3; 7-5; 7-5,R64,153,14,3,59,115,49,59,29,56,7,8,17,78,115,10,4,55,93,40,55,18,38,5,9,16,58,93
2009-06-22 00:00:00.000,Wimbledon Great Britain Grand Slams,GRASS,3,Philipp Petzschner,Mischa Zverev,Philipp Petzschner,4-6; 7-6(13); 3-6; 7-6(5); 6-0,R64,216,19,8,97,185,72,97,46,88,7,12,24,118,185,9,1,101,156,76,101,26,55,0,6,25,102,156
2009-06-22 00:00:00.000,Wimbledon Great Britain Grand Slams,GRASS,3,Radek Stepanek,Potito Starace,Radek Stepanek,6-4; 4-6; 6-2; 4-6; 6-3,R64,166,15,4,90,131,70,90,22,41,1,5,24,92,131,6,2,88,143,63,88,24,55,5,11,23,87,143
2009-06-22 00:00:00.000,Wimbledon Great Britain Grand Slams,GRASS,3,David Ferrer,Fabio Fognini,David Ferrer,6-2; 6-2; 6-3,R64,97,3,3,43,73,31,43,16,30,3,6,13,47,73,2,7,55,91,31,55,11,36,9,17,12,42,91
2009-06-22 00:00:00.000,Wimbledon Great Britain Grand Slams,GRASS,3,Nikolay Davydenko,Victor Crivoi,Nikolay Davydenko,6-4; 6-4; 6-2,R64,99,7,3,50,81,42,50,15,31,3,4,14,57,81,3,2,57,80,35,57,10,23,2,7,14,45,80
2009-06-22 00:00:00.000,Wimbledon Great Britain Grand Slams,GRASS,3,Tomas Berdych,Paul-Henri Mathieu,Tomas Berdych,6-2; 6-4; 6-4,R64,117,15,3,47,75,43,47,17,28,1,1,14,60,75,14,3,62,111,44,62,18,49,12,16,14,62,111
2009-06-22 00:00:00.000,Wimbledon Great Britain Grand Slams,GRASS,3,Jurgen Melzer,Benjamin Becker,Jurgen Melzer,7-6(6); 6-3; 7-6(1),R64,138,12,4,53,105,43,53,32,52,5,7,17,75,105,8,1,66,111,47,66,21,45,10,13,16,68,111
2009-06-22 00:00:00.000,Wimbledon Great Britain Grand Slams,GRASS,3,Andy Roddick,Igor Kunitsyn,Andy Roddick,6-4; 6-2; 3-6; 6-2,R64,127,18,5,60,86,50,60,16,26,1,2,17,66,86,7,2,77,116,50,77,19,39,7,12,18,69,116
2009-06-22 00:00:00.000,Wimbledon Great Britain Grand Slams,GRASS,3,Andy Murray,Ernests Gulbis,Andy Murray,6-2; 7-5; 6-3,R64,89,11,1,52,71,46,52,13,19,2,2,14,59,71,15,2,64,92,44,64,10,28,2,7,15,54,92
2009-06-22 00:00:00.000,Wimbledon Great Britain Grand Slams,GRASS,3,Viktor Troicki,Daniel Gimeno-Traver,Viktor Troicki,6-7(5); 6-0; 1-6; 6-3; 7-5,R64,183,24,10,95,150,71,95,30,55,9,12,23,101,150,4,11,87,141,65,87,23,54,3,9,23,88,141
2009-06-22 00:00:00.000,Wimbledon Great Britain Grand Slams,GRASS,3,Stanislas Wawrinka,Martin Vassallo Arguello,Stanislas Wawrinka,6-3; 6-2; 6-2,R64,85,10,3,38,67,33,38,21,29,3,3,13,54,67,2,1,44,65,28,44,9,21,2,7,12,37,65
2009-06-22 00:00:00.000,Wimbledon Great Britain Grand Slams,GRASS,3,Jesse Levine,Pablo Cuevas,Jesse Levine,6-2; 6-1; 4-6; 4-6; 6-3,R64,158,6,5,84,140,61,84,28,56,3,7,22,89,140,14,4,91,142,55,91,23,51,7,15,22,78,142
2009-06-22 00:00:00.000,Wimbledon Great Britain Grand Slams,GRASS,3,Fernando Gonzalez,Leonardo Mayer,Fernando Gonzalez,6-7(4); 6-4; 6-4; 6-4,R64,141,14,7,79,118,70,79,22,39,3,3,21,92,118,11,1,70,109,58,70,25,39,1,4,21,83,109
2009-06-22 00:00:00.000,Wimbledon Great Britain Grand Slams,GRASS,3,Juan Carlos Ferrero,Fabrice Santoro,Juan Carlos Ferrero,6-7(1); 6-3; 6-4; 6-3,R64,162,8,2,65,109,51,65,29,44,4,6,20,80,109,7,3,86,140,58,86,24,54,13,19,20,82,140
2009-06-22 00:00:00.000,Wimbledon Great Britain Grand Slams,GRASS,3,Victor Hanescu,Nicolas Devilder,Victor Hanescu,6-2; 6-3; 6-1,R64,89,11,1,48,72,37,48,14,24,5,5,12,51,72,4,7,41,75,22,41,16,34,5,11,12,38,75
2009-06-22 00:00:00.000,Wimbledon Great Britain Grand Slams,GRASS,3,Gilles Simon,Thiago Alves,Gilles Simon,5-7; 6-3; 6-4; 6-4,R64,158,23,5,62,127,52,62,36,65,11,13,21,88,127,5,7,70,140,55,70,31,70,10,14,20,86,140
2009-06-22 00:00:00.000,Wimbledon Great Britain Grand Slams,GRASS,3,Andreas Seppi,Marc Gicquel,Andreas Seppi,7-5; 6-4; 6-7(3); 5-7; 6-4,R64,230,8,6,111,176,75,111,36,65,11,16,28,111,176,21,6,123,190,90,123,27,67,10,17,28,117,190
2009-06-22 00:00:00.000,Wimbledon Great Britain Grand Slams,GRASS,3,Igor Andreev,Vincent Spadea,Igor Andreev,6-3; 7-5; 6-2,R64,102,6,1,53,78,40,53,16,25,3,4,14,56,78,4,9,59,98,38,59,17,39,5,11,15,55,98
2009-06-22 00:00:00.000,Wimbledon Great Britain Grand Slams,GRASS,3,Tommy Haas,Michael Llodra,Tommy Haas,4-3 RET,R64,30,3,1,16,21,15,16,1,5,0,0,4,16,21,2,0,12,19,9,12,4,7,0,0,3,13,19
2009-06-22 00:00:00.000,Wimbledon Great Britain Grand Slams,GRASS,3,Marin Cilic,Sam Querrey,Marin Cilic,4-6; 7-6(3); 6-3; 6-7(4); 6-4,R64,204,13,9,108,185,83,108,42,77,12,15,27,125,185,24,3,107,154,83,107,24,47,3,7,26,107,154
2009-06-22 00:00:00.000,Wimbledon Great Britain Grand Slams,GRASS,3,Tommy Robredo,Stefan Koubek,Tommy Robredo,3-6; 4-6; 6-4; 7-6(5); 6-1,R64,210,11,4,88,143,68,88,31,55,5,8,23,99,143,3,5,120,188,84,120,32,68,18,23,25,116,188
2009-06-22 00:00:00.000,Wimbledon Great Britain Grand Slams,GRASS,3,Dudi Sela,Rainer Schuettler,Dudi Sela,7-6(3); 6-3; 6-2,R64,124,2,1,60,90,50,60,13,30,0,1,15,63,90,3,7,68,108,39,68,20,40,6,10,14,59,108
2009-06-22 00:00:00.000,Wimbledon Great Britain Grand Slams,GRASS,3,Mardy Fish,Janko Tipsarevic,Mardy Fish,6-4; 3-6; 6-1; 6-4,R64,150,11,2,57,94,44,57,22,37,2,5,18,66,94,8,3,62,117,37,62,28,55,7,13,18,65,117
2009-06-22 00:00:00.000,Wimbledon Great Britain Grand Slams,GRASS,3,Novak Djokovic,Simon Greul,Novak Djokovic,7-5; 6-1; 6-4,R64,120,13,6,63,97,40,63,18,34,6,10,15,58,97,0,2,53,87,26,53,16,34,7,15,14,42,87
2009-06-22 00:00:00.000,Wimbledon Great Britain Grand Slams,GRASS,3,Fernando Verdasco,Kristof Vliegen,Fernando Verdasco,7-6(3); 6-7(3); 7-6(4); 6-4,R64,175,20,7,92,140,72,92,33,48,0,0,23,105,140,12,1,103,145,77,103,27,42,4,5,23,104,145
2009-06-22 00:00:00.000,Wimbledon Great Britain Grand Slams,GRASS,3,Albert Montanes,Guillermo Canas,Albert Montanes,6-4; 6-3; 4-6; 6-3,R64,167,4,4,74,133,52,74,32,59,14,17,19,84,133,4,3,53,105,41,53,23,52,4,10,19,64,105
2009-06-22 00:00:00.000,Wimbledon Great Britain Grand Slams,GRASS,3,Ivo Karlovic,Steve Darcis,Ivo Karlovic,7-5; 6-3; 6-4,R64,104,24,1,54,77,46,54,18,23,0,0,16,64,77,3,8,59,95,46,59,15,36,7,10,15,61,95
2009-06-22 00:00:00.000,Wimbledon Great Britain Grand Slams,GRASS,3,Jo-Wilfried Tsonga,Simone Bolelli,Jo-Wilfried Tsonga,W/O,R64,0,0,0,0,0,0,0,0,0,0,0,0,0,0,0,0,0,0,0,0,0,0,0,0,0,0,0
2009-06-22 00:00:00.000,Wimbledon Great Britain Grand Slams,GRASS,3,Robin Soderling,Marcel Granollers,Robin Soderling,4-6; 7-6(7); 6-4; 7-5,R64,167,12,4,82,133,67,82,29,51,2,3,22,96,133,23,7,79,130,65,79,28,51,3,5,22,93,130
2009-06-22 00:00:00.000,Wimbledon Great Britain Grand Slams,GRASS,3,Nicolas Almagro,Karol Beck,Nicolas Almagro,6-4; 7-6(2); 3-6; 3-6; 7-5,R64,184,28,5,77,148,59,77,44,71,7,10,26,103,148,16,4,98,154,73,98,35,56,5,7,26,108,154
2009-06-22 00:00:00.000,Wimbledon Great Britain Grand Slams,GRASS,3,Philipp Kohlschreiber,Ivo Minar,Philipp Kohlschreiber,6-4; 3-6; 4-6; 6-2; 8-6,R64,176,10,1,95,140,77,95,25,45,3,5,25,102,140,14,3,117,179,80,117,33,62,9,13,26,113,179
2009-06-22 00:00:00.000,Wimbledon Great Britain Grand Slams,GRASS,3,Roger Federer,Guillermo Garcia-Lopez,Roger Federer,6-2; 6-2; 6-4,R64,90,11,2,48,75,44,48,13,27,2,2,13,57,75,3,6,55,74,35,55,9,19,2,7,13,44,74
2009-06-22 00:00:00.000,Wimbledon Great Britain Grand Slams,GRASS,3,Lleyton Hewitt,Philipp Petzschner,Lleyton Hewitt,7-5; 7-6(3); 6-3,R32,148,9,5,49,101,40,49,34,52,3,3,16,74,101,16,4,56,114,43,56,30,58,9,12,17,73,114
2009-06-22 00:00:00.000,Wimbledon Great Britain Grand Slams,GRASS,3,Radek Stepanek,David Ferrer,Radek Stepanek,7-5; 7-5; 3-6; 4-6; 6-4,R32,224,9,5,100,163,75,100,32,63,5,9,26,107,163,12,11,110,170,79,110,30,60,4,9,27,109,170
2009-06-22 00:00:00.000,Wimbledon Great Britain Grand Slams,GRASS,3,Tomas Berdych,Nikolay Davydenko,Tomas Berdych,6-2; 6-3; 6-2,R32,108,13,1,44,73,40,44,15,29,4,5,13,55,73,5,4,50,81,33,50,9,31,5,11,12,42,81
2009-06-22 00:00:00.000,Wimbledon Great Britain Grand Slams,GRASS,3,Andy Roddick,Jurgen Melzer,Andy Roddick,7-6(2); 7-6(2); 4-6; 6-3,R32,174,33,1,88,123,70,88,24,35,3,5,22,94,123,26,4,82,138,63,82,28,56,7,9,21,91,138
2009-06-22 00:00:00.000,Wimbledon Great Britain Grand Slams,GRASS,3,Andy Murray,Viktor Troicki,Andy Murray,6-2; 6-3; 6-4,R32,97,17,1,49,75,43,49,14,26,1,1,14,57,75,4,6,49,85,36,49,13,36,4,8,13,49,85
2009-06-22 00:00:00.000,Wimbledon Great Britain Grand Slams,GRASS,3,Stanislas Wawrinka,Jesse Levine,Stanislas Wawrinka,5-7; 7-5; 6-3; 6-3,R32,188,17,4,75,123,62,75,20,48,2,5,21,82,123,10,9,98,161,67,98,26,63,17,23,21,93,161
2009-06-22 00:00:00.000,Wimbledon Great Britain Grand Slams,GRASS,3,Juan Carlos Ferrero,Fernando Gonzalez,Juan Carlos Ferrero,4-6; 7-5; 6-4; 4-6; 6-4,R32,181,14,1,115,166,86,115,28,51,8,10,26,114,166,24,5,87,135,73,87,28,48,4,7,26,101,135
2009-06-22 00:00:00.000,Wimbledon Great Britain Grand Slams,GRASS,3,Gilles Simon,Victor Hanescu,Gilles Simon,6-2; 7-5; 6-2,R32,87,10,1,51,77,40,51,18,26,5,5,14,58,77,5,2,60,82,37,60,10,22,3,8,14,47,82
2009-06-22 00:00:00.000,Wimbledon Great Britain Grand Slams,GRASS,3,Igor Andreev,Andreas Seppi,Igor Andreev,6-1; 7-6(5); 4-6; 7-6(5),R32,183,14,3,82,140,62,82,32,58,6,10,21,94,140,3,3,86,136,54,86,28,50,2,7,20,82,136
2009-06-22 00:00:00.000,Wimbledon Great Britain Grand Slams,GRASS,3,Tommy Haas,Marin Cilic,Tommy Haas,7-5; 7-5; 1-6; 6-7(3); 10-8,R32,268,2,13,116,196,83,116,43,80,8,13,30,126,196,28,11,114,191,90,114,36,77,5,11,31,126,191
2009-06-22 00:00:00.000,Wimbledon Great Britain Grand Slams,GRASS,3,Dudi Sela,Tommy Robredo,Dudi Sela,7-6(8); 7-5; 2-6; 7-5,R32,179,0,3,84,132,53,84,26,48,4,10,22,79,132,10,5,78,131,56,78,25,53,3,9,22,81,131
2009-06-22 00:00:00.000,Wimbledon Great Britain Grand Slams,GRASS,3,Novak Djokovic,Mardy Fish,Novak Djokovic,6-4; 6-4; 6-4,R32,119,8,1,51,81,38,51,23,30,0,1,15,61,81,6,1,56,96,42,56,16,40,8,12,15,58,96
2009-06-22 00:00:00.000,Wimbledon Great Britain Grand Slams,GRASS,3,Fernando Verdasco,Albert Montanes,Fernando Verdasco,4-6; 6-1; 6-4; 7-6(2),R32,138,16,5,87,114,71,87,15,27,4,5,20,86,114,5,0,64,111,50,64,24,47,6,9,19,74,111
2009-06-22 00:00:00.000,Wimbledon Great Britain Grand Slams,GRASS,3,Ivo Karlovic,Jo-Wilfried Tsonga,Ivo Karlovic,7-6(5); 6-7(5); 7-5; 7-6(5),R32,165,47,2,102,130,92,102,19,28,0,0,24,111,130,26,3,94,138,82,94,27,44,1,2,24,109,138
2009-06-22 00:00:00.000,Wimbledon Great Britain Grand Slams,GRASS,3,Robin Soderling,Nicolas Almagro,Robin Soderling,7-6(7); 6-4; 6-4,R32,117,19,3,53,89,50,53,20,36,0,0,16,70,89,20,3,53,110,44,53,27,57,4,6,16,71,110
2009-06-22 00:00:00.000,Wimbledon Great Britain Grand Slams,GRASS,3,Roger Federer,Philipp Kohlschreiber,Roger Federer,6-3; 6-2; 6-7(5); 6-1,R32,151,15,2,87,126,66,87,20,39,5,7,19,86,126,5,4,81,126,50,81,20,45,15,22,17,70,126
2009-06-22 00:00:00.000,Wimbledon Great Britain Grand Slams,GRASS,3,Lleyton Hewitt,Radek Stepanek,Lleyton Hewitt,4-6; 2-6; 6-1; 6-2; 6-2,R16,175,14,7,60,117,51,60,29,57,6,10,21,80,117,11,6,80,134,54,80,22,54,8,15,20,76,134
2009-06-22 00:00:00.000,Wimbledon Great Britain Grand Slams,GRASS,3,Andy Roddick,Tomas Berdych,Andy Roddick,7-6(4); 6-4; 6-3,R16,109,24,0,57,82,51,57,20,25,0,0,16,71,82,9,3,63,96,49,63,16,33,6,8,15,65,96
2009-06-22 00:00:00.000,Wimbledon Great Britain Grand Slams,GRASS,3,Andy Murray,Stanislas Wawrinka,Andy Murray,2-6; 6-3; 6-3; 5-7; 6-3,R16,237,8,4,82,150,61,82,38,68,10,14,24,99,150,17,3,104,162,67,104,29,58,6,11,23,96,162
2009-06-22 00:00:00.000,Wimbledon Great Britain Grand Slams,GRASS,3,Juan Carlos Ferrero,Gilles Simon,Juan Carlos Ferrero,7-6(4); 6-3; 6-2,R16,119,7,1,55,91,45,55,21,36,5,7,15,66,91,6,4,41,93,32,41,23,52,4,9,14,55,93
2009-06-22 00:00:00.000,Wimbledon Great Britain Grand Slams,GRASS,3,Tommy Haas,Igor Andreev,Tommy Haas,7-6(8); 6-4; 6-4,R16,135,12,7,57,92,54,57,20,35,0,0,16,74,92,15,2,74,116,54,74,21,42,5,7,16,75,116
2009-06-22 00:00:00.000,Wimbledon Great Britain Grand Slams,GRASS,3,Novak Djokovic,Dudi Sela,Novak Djokovic,6-2; 6-4; 6-1,R16,90,11,4,46,72,37,46,12,26,4,6,13,49,72,1,2,46,71,26,46,10,25,7,14,12,36,71
2009-06-22 00:00:00.000,Wimbledon Great Britain Grand Slams,GRASS,3,Ivo Karlovic,Fernando Verdasco,Ivo Karlovic,7-6(5); 6-7(4); 6-3; 7-6(9),R16,181,36,5,94,131,88,94,21,37,0,0,23,109,131,7,8,99,146,81,99,27,47,5,6,22,108,146
2009-06-22 00:00:00.000,Wimbledon Great Britain Grand Slams,GRASS,3,Roger Federer,Robin Soderling,Roger Federer,6-4; 7-6(5); 7-6(5),R16,119,23,0,68,102,60,68,21,34,2,2,17,81,102,16,3,55,98,50,55,26,43,3,4,17,76,98
2009-06-22 00:00:00.000,Wimbledon Great Britain Grand Slams,GRASS,3,Andy Roddick,Lleyton Hewitt,Andy Roddick,6-3; 6-7(10); 7-6(1); 4-6; 6-4,Q,231,43,4,121,165,89,121,27,44,5,8,27,116,165,21,9,114,192,87,114,38,78,11,15,26,125,192
2009-06-22 00:00:00.000,Wimbledon Great Britain Grand Slams,GRASS,3,Andy Murray,Juan Carlos Ferrero,Andy Murray,7-5; 6-3; 6-2,Q,102,18,1,48,76,42,48,17,28,1,2,15,59,76,3,3,62,88,37,62,10,26,5,10,14,47,88
2009-06-22 00:00:00.000,Wimbledon Great Britain Grand Slams,GRASS,3,Tommy Haas,Novak Djokovic,Tommy Haas,7-5; 7-6(6); 4-6; 6-3,Q,165,18,7,77,124,62,77,28,47,0,2,22,90,124,13,4,73,124,58,73,28,51,2,5,21,86,124
2009-06-22 00:00:00.000,Wimbledon Great Britain Grand Slams,GRASS,3,Roger Federer,Ivo Karlovic,Roger Federer,6-3; 7-5; 7-6(3),Q,103,7,2,53,85,50,53,24,32,0,0,17,74,85,23,2,57,82,46,57,15,25,0,2,16,61,82
2009-06-22 00:00:00.000,Wimbledon Great Britain Grand Slams,GRASS,3,Andy Roddick,Andy Murray,Andy Roddick,6-4; 4-6; 7-6(7); 7-6(5),S,187,21,1,102,137,79,102,18,35,5,7,22,97,137,25,5,75,146,62,75,38,71,3,5,22,100,146
2009-06-22 00:00:00.000,Wimbledon Great Britain Grand Slams,GRASS,3,Roger Federer,Tommy Haas,Roger Federer,7-6(3); 7-5; 6-3,S,123,11,1,62,83,55,62,17,21,0,0,17,72,83,11,5,72,110,53,72,17,38,6,8,16,70,110
2009-06-22 00:00:00.000,Wimbledon Great Britain Grand Slams,GRASS,3,Roger Federer,Andy Roddick,Roger Federer,5-7; 7-6(6); 7-6(5); 3-6; 16-14,F,256,50,4,127,197,113,127,42,70,3,5,37,155,197,27,4,169,239,140,169,31,70,6,7,38,171,239
2009-07-06 00:00:00.000,Newport RI; U.S.A. ATP World Tour 250,GRASS,2,Rajeev Ram,Alejandro Falla,Rajeev Ram,6-4; 7-5,R32,72,6,0,40,60,35,40,11,20,0,0,11,46,60,3,7,45,75,35,45,13,30,3,5,11,48,75
2009-07-06 00:00:00.000,Newport RI; U.S.A. ATP World Tour 250,GRASS,2,Samuel Groth,Ricardo Mello,Samuel Groth,7-5; 3-6; 6-3,R32,106,9,10,47,100,33,47,27,53,5,8,15,60,100,1,4,49,84,32,49,21,35,0,4,15,53,84
2009-07-06 00:00:00.000,Newport RI; U.S.A. ATP World Tour 250,GRASS,2,Jesse Levine,Chris Guccione,Jesse Levine,7-6(2); 7-6(2),R32,98,13,7,72,108,48,72,18,36,7,9,12,66,108,14,2,54,77,42,54,8,23,3,5,12,50,77
2009-07-06 00:00:00.000,Newport RI; U.S.A. ATP World Tour 250,GRASS,2,Philipp Petzschner,Horacio Zeballos,Philipp Petzschner,6-4; 6-7(4); 6-2,R32,97,13,8,56,93,48,56,16,37,5,6,15,64,93,5,6,51,89,38,51,21,38,7,11,15,59,89
2009-07-06 00:00:00.000,Newport RI; U.S.A. ATP World Tour 250,GRASS,2,Brendan Evans,Benjamin Becker,Brendan Evans,7-6(5); 3-6; 7-5,R32,114,10,1,74,105,54,74,18,31,6,8,16,72,105,12,10,58,106,44,58,28,48,4,6,17,72,106
2009-07-06 00:00:00.000,Newport RI; U.S.A. ATP World Tour 250,GRASS,2,Robby Ginepri,Santiago Ventura,Robby Ginepri,6-2; 1-6; 6-4,R32,95,7,4,49,81,34,49,15,32,7,11,13,49,81,1,5,47,83,29,47,16,36,6,10,12,45,83
2009-07-06 00:00:00.000,Newport RI; U.S.A. ATP World Tour 250,GRASS,2,Olivier Rochus,Alexander Peya,Olivier Rochus,6-2; 4-6; 6-4,R32,103,0,3,55,94,38,55,22,39,5,7,14,60,94,3,1,50,85,35,50,16,35,1,5,14,51,85
2009-07-06 00:00:00.000,Newport RI; U.S.A. ATP World Tour 250,GRASS,2,Sergiy Stakhovsky,Frank Dancevic,Sergiy Stakhovsky,7-6(9); 2-6; 7-5,R32,118,10,6,73,111,58,73,17,38,8,10,16,75,111,7,0,74,116,55,74,22,42,4,5,16,77,116
2009-07-06 00:00:00.000,Newport RI; U.S.A. ATP World Tour 250,GRASS,2,Kevin Kim,Sebastien Grosjean,Kevin Kim,4-6; 6-3 RET,R32,92,1,6,22,54,17,22,16,32,0,2,9,33,54,5,6,59,96,35,59,17,37,13,16,10,52,96
2009-07-06 00:00:00.000,Newport RI; U.S.A. ATP World Tour 250,GRASS,2,Daniel Brands,Vincent Spadea,Daniel Brands,6-0; 6-4,R32,60,6,4,29,50,23,29,12,21,5,5,8,35,50,5,9,29,63,21,29,11,34,11,15,8,32,63
2009-07-06 00:00:00.000,Newport RI; U.S.A. ATP World Tour 250,GRASS,2,Prakash Amritraj,Danai Udomchoke,Prakash Amritraj,6-1; 6-4,R32,63,4,3,29,53,21,29,17,24,3,3,9,38,53,5,5,30,54,19,30,11,24,2,5,8,30,54
2009-07-06 00:00:00.000,Newport RI; U.S.A. ATP World Tour 250,GRASS,2,Sam Querrey,Ruben Ramirez Hidalgo,Sam Querrey,6-3; 6-2,R32,60,6,4,22,48,18,22,15,26,1,2,9,33,48,2,6,24,57,15,24,13,33,3,7,8,28,57
2009-07-06 00:00:00.000,Newport RI; U.S.A. ATP World Tour 250,GRASS,2,Alex Bogomolov Jr.,Arnaud Clement,Alex Bogomolov Jr.,1-6; 6-3; 6-4,R32,115,0,3,42,72,26,42,18,30,4,8,13,44,72,2,8,43,90,26,43,26,47,6,10,13,52,90
2009-07-06 00:00:00.000,Newport RI; U.S.A. ATP World Tour 250,GRASS,2,Nicolas Mahut,Amer Delic,Nicolas Mahut,6-4; 6-4,R32,65,8,5,29,49,27,29,13,20,0,0,10,40,49,6,4,40,61,27,40,11,21,2,4,10,38,61
2009-07-06 00:00:00.000,Newport RI; U.S.A. ATP World Tour 250,GRASS,2,Taylor Dent,Marcos Daniel,Taylor Dent,6-2; 6-1,R32,49,8,5,22,43,21,22,12,21,0,0,8,33,43,3,4,25,50,14,25,12,25,5,9,7,26,50
2009-07-06 00:00:00.000,Newport RI; U.S.A. ATP World Tour 250,GRASS,2,Fabrice Santoro,Flavio Cipolla,Fabrice Santoro,6-3; 7-5,R32,82,2,1,49,76,34,49,17,27,11,12,11,51,76,3,5,41,69,33,41,6,28,8,11,10,39,69
2009-07-06 00:00:00.000,Newport RI; U.S.A. ATP World Tour 250,GRASS,2,Rajeev Ram,Samuel Groth,Rajeev Ram,6-4; 6-2,R16,63,5,1,30,50,24,30,15,20,0,0,9,39,50,8,5,23,52,18,23,14,29,6,9,9,32,52
2009-07-06 00:00:00.000,Newport RI; U.S.A. ATP World Tour 250,GRASS,2,Jesse Levine,Philipp Petzschner,Jesse Levine,7-6(3); 6-2,R16,82,4,8,40,76,33,40,20,36,10,10,10,53,76,5,7,41,76,29,41,16,35,5,7,10,45,76
2009-07-06 00:00:00.000,Newport RI; U.S.A. ATP World Tour 250,GRASS,2,Brendan Evans,Robby Ginepri,Brendan Evans,6-3; 6-4,R16,59,5,1,44,66,34,44,12,22,2,3,10,46,66,2,1,41,58,25,41,9,17,2,5,9,34,58
2009-07-06 00:00:00.000,Newport RI; U.S.A. ATP World Tour 250,GRASS,2,Olivier Rochus,Sergiy Stakhovsky,Olivier Rochus,5-7; 7-6(2); 6-3,R16,121,1,4,68,111,49,68,26,43,2,4,17,75,111,6,3,60,100,47,60,21,40,3,5,16,68,100
2009-07-06 00:00:00.000,Newport RI; U.S.A. ATP World Tour 250,GRASS,2,Kevin Kim,Daniel Brands,Kevin Kim,4-6; 7-6(5); 6-4,R16,122,10,13,56,114,44,56,28,58,7,10,16,72,114,12,7,70,116,51,70,25,46,5,8,16,76,116
2009-07-06 00:00:00.000,Newport RI; U.S.A. ATP World Tour 250,GRASS,2,Sam Querrey,Prakash Amritraj,Sam Querrey,6-7(7); 6-3; 6-2,R16,113,31,10,68,103,56,68,15,35,4,4,15,71,103,7,5,53,99,39,53,23,46,3,6,14,62,99
2009-07-06 00:00:00.000,Newport RI; U.S.A. ATP World Tour 250,GRASS,2,Nicolas Mahut,Alex Bogomolov Jr.,Nicolas Mahut,6-2; 6-2,R16,52,12,2,26,42,22,26,9,16,0,1,8,31,42,0,3,35,54,17,35,7,19,2,7,8,24,54
2009-07-06 00:00:00.000,Newport RI; U.S.A. ATP World Tour 250,GRASS,2,Fabrice Santoro,Taylor Dent,Fabrice Santoro,7-6(5); 6-4,R16,88,1,2,36,65,26,36,17,29,1,3,11,43,65,13,5,46,82,34,46,12,36,3,6,11,46,82
2009-07-06 00:00:00.000,Newport RI; U.S.A. ATP World Tour 250,GRASS,2,Rajeev Ram,Jesse Levine,Rajeev Ram,5-7; 6-2; 7-6(3),Q,104,9,4,61,90,50,61,15,29,3,5,16,65,90,10,12,64,97,47,64,15,33,3,6,16,62,97
2009-07-06 00:00:00.000,Newport RI; U.S.A. ATP World Tour 250,GRASS,2,Olivier Rochus,Brendan Evans,Olivier Rochus,6-4; 6-4,Q,61,2,2,31,53,23,31,15,22,1,2,10,38,53,9,3,34,59,24,34,12,25,0,3,10,36,59
2009-07-06 00:00:00.000,Newport RI; U.S.A. ATP World Tour 250,GRASS,2,Sam Querrey,Kevin Kim,Sam Querrey,6-3; 6-4,Q,55,12,2,28,47,25,28,15,19,0,0,10,40,47,3,14,36,75,27,36,16,39,5,7,9,43,75
2009-07-06 00:00:00.000,Newport RI; U.S.A. ATP World Tour 250,GRASS,2,Fabrice Santoro,Nicolas Mahut,Fabrice Santoro,6-4; 6-4,Q,80,2,1,30,55,25,30,17,25,1,1,10,42,55,6,1,40,65,29,40,10,25,3,5,10,39,65
2009-07-06 00:00:00.000,Newport RI; U.S.A. ATP World Tour 250,GRASS,2,Rajeev Ram,Olivier Rochus,Rajeev Ram,6-3; 6-4,S,80,9,2,35,61,25,35,18,26,6,7,10,43,61,2,2,36,57,23,36,11,21,4,7,9,34,57
2009-07-06 00:00:00.000,Newport RI; U.S.A. ATP World Tour 250,GRASS,2,Sam Querrey,Fabrice Santoro,Sam Querrey,6-3; 7-6(2),S,70,18,2,40,57,38,40,10,17,0,0,11,48,57,0,0,41,65,28,41,15,24,1,2,10,43,65
2009-07-06 00:00:00.000,Newport RI; U.S.A. ATP World Tour 250,GRASS,2,Rajeev Ram,Sam Querrey,Rajeev Ram,6-7(3); 7-5; 6-3,F,122,12,4,67,110,54,67,18,43,5,7,17,72,110,13,7,54,96,41,54,21,42,3,7,16,62,96
2009-07-13 00:00:00.000,Bsstad Sweden ATP World Tour 250,CLAY,2,Fernando Verdasco,N/A Bye,Fernando Verdasco,,R32,0,0,0,0,0,0,0,0,0,0,0,0,0,0,0,0,0,0,0,0,0,0,0,0,0,0,0
2009-07-13 00:00:00.000,Bsstad Sweden ATP World Tour 250,CLAY,2,Daniel Koellerer,Steve Darcis,Daniel Koellerer,1-6; 6-3; 6-4,R32,97,3,2,48,77,34,48,15,29,0,2,13,49,77,4,0,43,72,31,43,18,29,2,4,13,49,72
2009-07-13 00:00:00.000,Bsstad Sweden ATP World Tour 250,CLAY,2,Victor Crivoi,Denis Istomin,Victor Crivoi,6-0; 6-4,R32,0,0,0,0,0,0,0,0,0,0,0,0,0,0,0,0,0,0,0,0,0,0,0,0,0,0,0
2009-07-13 00:00:00.000,Bsstad Sweden ATP World Tour 250,CLAY,2,Juan Monaco,Maximo Gonzalez,Juan Monaco,7-6(4); 3-6; 6-1,R32,139,2,2,78,106,49,78,12,28,7,12,14,61,106,1,3,54,81,36,54,11,27,2,8,14,47,81
2009-07-13 00:00:00.000,Bsstad Sweden ATP World Tour 250,CLAY,2,Tommy Robredo,N/A Bye,Tommy Robredo,,R32,0,0,0,0,0,0,0,0,0,0,0,0,0,0,0,0,0,0,0,0,0,0,0,0,0,0,0
2009-07-13 00:00:00.000,Bsstad Sweden ATP World Tour 250,CLAY,2,Peter Luczak,Alberto Martin,Peter Luczak,6-2; 6-2,R32,65,2,1,30,43,22,30,9,13,3,4,8,31,43,0,4,26,47,13,26,9,21,3,8,8,22,47
2009-07-13 00:00:00.000,Bsstad Sweden ATP World Tour 250,CLAY,2,Bjorn Phau,Daniel Berta,Bjorn Phau,6-3; 6-2,R32,63,3,2,27,47,23,27,13,20,0,0,9,36,47,0,1,33,55,20,33,9,22,3,6,8,29,55
2009-07-13 00:00:00.000,Bsstad Sweden ATP World Tour 250,CLAY,2,Teymuraz Gabashvili,Christophe Rochus,Teymuraz Gabashvili,4-6; 6-1; 6-0,R32,0,0,0,0,0,0,0,0,0,0,0,0,0,0,0,0,0,0,0,0,0,0,0,0,0,0,0
2009-07-13 00:00:00.000,Bsstad Sweden ATP World Tour 250,CLAY,2,Andreas Vinciguerra,Florent Serra,Andreas Vinciguerra,6-7(5); 6-3; 6-4,R32,145,9,5,84,127,62,84,21,43,15,16,16,83,127,2,2,75,109,49,75,19,34,6,9,15,68,109
2009-07-13 00:00:00.000,Bsstad Sweden ATP World Tour 250,CLAY,2,Guillermo Canas,Grigor Dimitrov,Guillermo Canas,6-3; 7-6(2),R32,103,4,0,22,55,16,22,23,33,1,3,10,39,55,3,3,47,75,29,47,11,28,6,10,11,40,75
2009-07-13 00:00:00.000,Bsstad Sweden ATP World Tour 250,CLAY,2,Daniel Gimeno-Traver,Frederico Gil,Daniel Gimeno-Traver,6-1; 6-4,R32,77,3,0,42,67,30,42,14,25,3,3,9,44,67,1,4,35,52,22,35,7,17,4,7,8,29,52
2009-07-13 00:00:00.000,Bsstad Sweden ATP World Tour 250,CLAY,2,Jurgen Melzer,N/A Bye,Jurgen Melzer,,R32,0,0,0,0,0,0,0,0,0,0,0,0,0,0,0,0,0,0,0,0,0,0,0,0,0,0,0
2009-07-13 00:00:00.000,Bsstad Sweden ATP World Tour 250,CLAY,2,Nicolas Almagro,Marat Safin,Nicolas Almagro,6-3; 7-6(6),R32,81,5,2,42,70,36,42,16,28,0,0,11,52,70,9,5,45,75,36,45,15,30,5,6,10,51,75
2009-07-13 00:00:00.000,Bsstad Sweden ATP World Tour 250,CLAY,2,Potito Starace,Julien Benneteau,Potito Starace,7-6(5); 6-3,R32,117,1,0,50,73,35,50,9,23,3,6,11,44,73,2,1,54,70,32,54,6,16,0,4,10,38,70
2009-07-13 00:00:00.000,Bsstad Sweden ATP World Tour 250,CLAY,2,Kristof Vliegen,Marcel Granollers,Kristof Vliegen,7-6(3); 6-4,R32,89,1,1,39,68,30,39,15,29,1,4,11,45,68,2,2,46,69,29,46,11,23,4,8,11,40,69
2009-07-13 00:00:00.000,Bsstad Sweden ATP World Tour 250,CLAY,2,Robin Soderling,N/A Bye,Robin Soderling,,R32,0,0,0,0,0,0,0,0,0,0,0,0,0,0,0,0,0,0,0,0,0,0,0,0,0,0,0
2009-07-13 00:00:00.000,Bsstad Sweden ATP World Tour 250,CLAY,2,Fernando Verdasco,Daniel Koellerer,Fernando Verdasco,6-7(1); 6-2; 7-5,R16,189,6,7,93,128,59,93,16,35,13,16,16,75,128,0,2,83,107,46,83,14,24,6,12,16,60,107
2009-07-13 00:00:00.000,Bsstad Sweden ATP World Tour 250,CLAY,2,Juan Monaco,Victor Crivoi,Juan Monaco,6-0; 7-6(1),R16,89,1,2,38,58,29,38,14,20,2,2,9,43,58,6,4,45,80,32,45,11,35,11,14,9,43,80
2009-07-13 00:00:00.000,Bsstad Sweden ATP World Tour 250,CLAY,2,Tommy Robredo,Peter Luczak,Tommy Robredo,6-2; 6-3,R16,73,10,1,28,49,27,28,12,21,3,3,9,39,49,1,1,34,54,23,34,5,20,3,6,8,28,54
2009-07-13 00:00:00.000,Bsstad Sweden ATP World Tour 250,CLAY,2,Teymuraz Gabashvili,Bjorn Phau,Teymuraz Gabashvili,6-3; 6-2,R16,76,0,9,40,62,30,40,11,22,5,5,9,41,62,4,1,29,43,19,29,6,14,1,4,8,25,43
2009-07-13 00:00:00.000,Bsstad Sweden ATP World Tour 250,CLAY,2,Andreas Vinciguerra,Guillermo Canas,Andreas Vinciguerra,6-7(5); 6-3; 6-4,R16,163,1,1,62,89,47,62,16,27,2,3,15,63,89,4,5,47,97,33,47,29,50,3,7,16,62,97
2009-07-13 00:00:00.000,Bsstad Sweden ATP World Tour 250,CLAY,2,Jurgen Melzer,Daniel Gimeno-Traver,Jurgen Melzer,6-2; 6-2,R16,58,3,1,26,47,22,26,12,21,1,1,8,34,47,3,2,29,47,17,29,8,18,3,7,8,25,47
2009-07-13 00:00:00.000,Bsstad Sweden ATP World Tour 250,CLAY,2,Nicolas Almagro,Potito Starace,Nicolas Almagro,2-6; 6-1; 6-1,R16,82,3,2,40,72,28,40,16,32,4,7,11,44,72,1,1,43,62,23,43,8,19,3,9,11,31,62
2009-07-13 00:00:00.000,Bsstad Sweden ATP World Tour 250,CLAY,2,Robin Soderling,Kristof Vliegen,Robin Soderling,6-2; 6-3,R16,54,5,0,28,48,24,28,14,20,2,2,9,38,48,2,0,23,37,17,23,6,14,0,3,8,23,37
2009-07-13 00:00:00.000,Bsstad Sweden ATP World Tour 250,CLAY,2,Juan Monaco,Fernando Verdasco,Juan Monaco,6-1; 3-1 RET,Q,56,4,2,18,30,14,18,7,12,0,0,5,21,30,0,1,33,51,18,33,6,18,3,7,6,24,51
2009-07-13 00:00:00.000,Bsstad Sweden ATP World Tour 250,CLAY,2,Tommy Robredo,Teymuraz Gabashvili,Tommy Robredo,6-4; 6-0,Q,78,4,1,21,40,17,21,14,19,2,3,8,31,40,1,4,39,60,22,39,4,21,7,12,8,26,60
2009-07-13 00:00:00.000,Bsstad Sweden ATP World Tour 250,CLAY,2,Andreas Vinciguerra,Jurgen Melzer,Andreas Vinciguerra,2-6; 6-4; 6-3,Q,105,5,1,46,66,35,46,13,20,5,7,13,48,66,5,2,56,85,36,56,17,29,3,6,14,53,85
2009-07-13 00:00:00.000,Bsstad Sweden ATP World Tour 250,CLAY,2,Robin Soderling,Nicolas Almagro,Robin Soderling,7-5; 6-3,Q,75,7,1,31,59,27,31,16,28,1,2,11,43,59,7,3,41,58,25,41,7,17,1,4,10,32,58
2009-07-13 00:00:00.000,Bsstad Sweden ATP World Tour 250,CLAY,2,Juan Monaco,Tommy Robredo,Juan Monaco,6-0; 6-2,S,64,1,3,31,42,24,31,5,11,0,1,7,29,42,1,2,30,51,15,30,5,21,5,11,7,20,51
2009-07-13 00:00:00.000,Bsstad Sweden ATP World Tour 250,CLAY,2,Robin Soderling,Andreas Vinciguerra,Robin Soderling,6-1; 7-6(6),S,83,7,1,36,63,33,36,12,27,1,2,10,45,63,6,2,52,71,34,52,6,19,6,9,9,40,71
2009-07-13 00:00:00.000,Bsstad Sweden ATP World Tour 250,CLAY,2,Robin Soderling,Juan Monaco,Robin Soderling,6-3; 7-6(4),F,113,6,5,62,97,47,62,13,35,5,6,11,60,97,4,3,50,71,34,50,10,21,4,6,10,44,71
2009-07-13 00:00:00.000,Stuttgart Germany ATP World Tour 250,CLAY,2,Gilles Simon,Philipp Petzschner,Gilles Simon,6-3; 6-4,R32,74,6,1,26,60,19,26,17,34,6,8,10,36,60,5,2,32,61,24,32,7,29,3,7,9,31,61
2009-07-13 00:00:00.000,Stuttgart Germany ATP World Tour 250,CLAY,2,Mischa Zverev,Guillermo Garcia-Lopez,Mischa Zverev,6-2; 6-4,R32,92,2,1,33,60,26,33,13,27,6,7,9,39,60,2,4,27,55,19,27,11,28,3,7,9,30,55
2009-07-13 00:00:00.000,Stuttgart Germany ATP World Tour 250,CLAY,2,Martin Vassallo Arguello,Andrey Golubev,Martin Vassallo Arguello,3-6; 6-3; 6-0,R32,122,2,0,57,76,42,57,9,19,7,8,12,51,76,3,6,38,78,23,38,22,40,6,10,12,45,78
2009-07-13 00:00:00.000,Stuttgart Germany ATP World Tour 250,CLAY,2,Jeremy Chardy,Jose Acasuso,Jeremy Chardy,6-2; 7-6(4),R32,76,7,2,33,64,29,33,17,31,0,1,10,46,64,3,1,39,60,26,39,11,21,1,4,10,37,60
2009-07-13 00:00:00.000,Stuttgart Germany ATP World Tour 250,CLAY,2,Nicolas Kiefer,Tomas Berdych,Nicolas Kiefer,6-3; 6-3,R32,78,8,1,29,68,22,29,21,39,6,7,9,43,68,5,4,26,47,15,26,9,21,1,5,9,24,47
2009-07-13 00:00:00.000,Stuttgart Germany ATP World Tour 250,CLAY,2,Simon Greul,Andreas Beck,Simon Greul,7-6(4); 7-6(5),R32,115,9,7,48,91,34,48,26,43,2,3,12,60,91,3,2,49,78,36,49,17,29,2,3,12,53,78
2009-07-13 00:00:00.000,Stuttgart Germany ATP World Tour 250,CLAY,2,Lukasz Kubot,Pablo Andujar,Lukasz Kubot,6-2; 6-4,R32,99,2,0,28,53,21,28,15,25,3,4,9,36,53,2,2,36,68,23,36,12,32,8,12,9,35,68
2009-07-13 00:00:00.000,Stuttgart Germany ATP World Tour 250,CLAY,2,Philipp Kohlschreiber,Diego Junqueira,Philipp Kohlschreiber,6-3; 6-2,R32,62,9,6,36,54,28,36,8,18,0,1,9,36,54,0,1,28,43,11,28,9,15,0,4,8,20,43
2009-07-13 00:00:00.000,Stuttgart Germany ATP World Tour 250,CLAY,2,Alexandre Sidorenko,Daniel Munoz-De La Nava,Alexandre Sidorenko,7-6(3); 1-6; 6-2,R32,107,6,1,44,79,34,44,19,35,5,8,13,53,79,8,4,50,79,45,50,9,29,0,3,14,54,79
2009-07-13 00:00:00.000,Stuttgart Germany ATP World Tour 250,CLAY,2,Oscar Hernandez,Janko Tipsarevic,Oscar Hernandez,6-4; 6-4,R32,70,6,0,29,47,24,29,13,18,0,1,10,37,47,4,4,39,69,26,39,14,30,8,11,10,40,69
2009-07-13 00:00:00.000,Stuttgart Germany ATP World Tour 250,CLAY,2,Rainer Schuettler,Ivo Minar,Rainer Schuettler,2-6; 7-6(2); 6-4,R32,136,2,2,60,95,39,60,13,35,5,12,15,52,95,4,2,57,103,30,57,26,46,9,15,15,56,103
2009-07-13 00:00:00.000,Stuttgart Germany ATP World Tour 250,CLAY,2,Victor Hanescu,Dominik Meffert,Victor Hanescu,6-4; 7-6(6),R32,91,4,4,51,77,41,51,12,26,5,6,11,53,77,3,2,45,64,35,45,9,19,1,3,11,44,64
2009-07-13 00:00:00.000,Stuttgart Germany ATP World Tour 250,CLAY,2,Fabio Fognini,Fabrice Santoro,Fabio Fognini,5-7; 7-6(3); 6-1,R32,110,3,7,54,86,36,54,15,32,1,5,15,51,86,1,2,62,108,39,62,20,46,5,11,16,59,108
2009-07-13 00:00:00.000,Stuttgart Germany ATP World Tour 250,CLAY,2,Paul-Henri Mathieu,Mikhail Youzhny,Paul-Henri Mathieu,7-6(4); 7-6(4),R32,131,7,5,52,101,37,52,21,49,9,13,12,58,101,5,3,62,87,35,62,11,25,3,7,12,46,87
2009-07-13 00:00:00.000,Stuttgart Germany ATP World Tour 250,CLAY,2,Michael Berrer,Stefan Koubek,Michael Berrer,0-6; 7-6(3); 7-6(4),R32,132,3,5,79,102,45,79,12,23,5,11,15,57,102,9,3,61,106,41,61,25,45,5,8,15,66,106
2009-07-13 00:00:00.000,Stuttgart Germany ATP World Tour 250,CLAY,2,Nikolay Davydenko,Ivan Navarro,Nikolay Davydenko,4-6; 7-5; 6-3,R32,156,4,2,65,106,46,65,21,41,7,10,16,67,106,6,4,63,103,45,63,15,40,7,11,15,60,103
2009-07-13 00:00:00.000,Stuttgart Germany ATP World Tour 250,CLAY,2,Mischa Zverev,Gilles Simon,Mischa Zverev,6-4; 6-2,R16,67,1,1,34,55,29,34,11,21,5,5,9,40,55,3,1,38,51,25,38,5,13,5,8,9,30,51
2009-07-13 00:00:00.000,Stuttgart Germany ATP World Tour 250,CLAY,2,Jeremy Chardy,Martin Vassallo Arguello,Jeremy Chardy,2-6; 6-3; 6-1,R16,97,6,6,37,62,30,37,13,25,1,3,12,43,62,1,1,48,68,26,48,13,20,2,6,12,39,68
2009-07-13 00:00:00.000,Stuttgart Germany ATP World Tour 250,CLAY,2,Nicolas Kiefer,Simon Greul,Nicolas Kiefer,6-3; 6-4,R16,75,5,1,31,58,29,31,16,27,2,2,10,45,58,4,5,30,55,21,30,13,25,4,6,9,34,55
2009-07-13 00:00:00.000,Stuttgart Germany ATP World Tour 250,CLAY,2,Lukasz Kubot,Philipp Kohlschreiber,Lukasz Kubot,6-2; 6-4,R16,71,6,2,30,45,27,30,9,15,0,0,9,36,45,2,0,42,59,29,42,7,17,2,5,9,36,59
2009-07-13 00:00:00.000,Stuttgart Germany ATP World Tour 250,CLAY,2,Alexandre Sidorenko,Oscar Hernandez,Alexandre Sidorenko,2-6; 6-4; 6-3,R16,126,4,4,45,88,32,45,21,43,2,5,14,53,88,2,2,64,84,44,64,10,20,6,9,13,54,84
2009-07-13 00:00:00.000,Stuttgart Germany ATP World Tour 250,CLAY,2,Victor Hanescu,Rainer Schuettler,Victor Hanescu,6-2; 6-1,R16,56,4,0,32,42,26,32,6,10,0,0,8,32,42,1,3,25,43,15,25,7,18,4,8,7,22,43
2009-07-13 00:00:00.000,Stuttgart Germany ATP World Tour 250,CLAY,2,Fabio Fognini,Paul-Henri Mathieu,Fabio Fognini,6-4; 4-1 RET,R16,59,4,3,27,40,20,27,7,13,0,1,7,27,40,3,0,20,40,12,20,8,20,2,6,8,20,40
2009-07-13 00:00:00.000,Stuttgart Germany ATP World Tour 250,CLAY,2,Nikolay Davydenko,Michael Berrer,Nikolay Davydenko,6-3; 6-3,R16,66,2,0,37,48,27,37,7,11,0,1,9,34,48,1,3,37,54,22,37,8,17,5,9,9,30,54
2009-07-13 00:00:00.000,Stuttgart Germany ATP World Tour 250,CLAY,2,Jeremy Chardy,Mischa Zverev,Jeremy Chardy,7-6(4); 6-1,Q,83,4,1,45,70,31,45,16,25,6,7,10,47,70,0,0,37,60,23,37,12,23,6,9,9,35,60
2009-07-13 00:00:00.000,Stuttgart Germany ATP World Tour 250,CLAY,2,Nicolas Kiefer,Lukasz Kubot,Nicolas Kiefer,6-2; 6-1,Q,64,7,0,20,38,19,20,13,18,0,0,8,32,38,1,4,30,52,18,30,7,22,3,7,7,25,52
2009-07-13 00:00:00.000,Stuttgart Germany ATP World Tour 250,CLAY,2,Victor Hanescu,Alexandre Sidorenko,Victor Hanescu,7-6(2); 6-4,Q,84,6,1,44,66,38,44,13,22,1,1,11,51,66,2,5,41,67,33,41,14,26,3,4,11,47,67
2009-07-13 00:00:00.000,Stuttgart Germany ATP World Tour 250,CLAY,2,Fabio Fognini,Nikolay Davydenko,Fabio Fognini,6-1; 3-6; 7-5,Q,140,3,2,53,94,40,53,16,41,4,7,14,56,94,1,1,54,81,31,54,16,27,7,12,14,47,81
2009-07-13 00:00:00.000,Stuttgart Germany ATP World Tour 250,CLAY,2,Jeremy Chardy,Nicolas Kiefer,Jeremy Chardy,6-3; 7-5,S,79,2,3,31,52,26,31,11,21,1,2,10,37,52,10,1,41,71,27,41,14,30,8,12,11,41,71
2009-07-13 00:00:00.000,Stuttgart Germany ATP World Tour 250,CLAY,2,Victor Hanescu,Fabio Fognini,Victor Hanescu,6-3; 6-7(4); 6-2,S,135,3,4,65,97,42,65,18,32,6,10,15,60,97,5,3,56,94,29,56,20,38,8,15,14,49,94
2009-07-13 00:00:00.000,Stuttgart Germany ATP World Tour 250,CLAY,2,Jeremy Chardy,Victor Hanescu,Jeremy Chardy,1-6; 6-3; 6-4,F,108,10,5,50,83,39,50,14,33,5,8,13,53,83,4,2,52,80,34,52,15,28,3,6,13,49,80
2009-07-19 00:00:00.000,Hamburg Germany ATP World Tour 500,CLAY,2,Gilles Simon,N/A Bye,Gilles Simon,,R64,0,0,0,0,0,0,0,0,0,0,0,0,0,0,0,0,0,0,0,0,0,0,0,0,0,0,0
2009-07-19 00:00:00.000,Hamburg Germany ATP World Tour 500,CLAY,2,Daniel Brands,Victor Crivoi,Daniel Brands,4-6; 6-4; 6-1,R64,99,10,2,52,80,40,52,13,28,6,9,14,53,80,2,4,52,76,32,52,11,24,4,9,13,43,76
2009-07-19 00:00:00.000,Hamburg Germany ATP World Tour 500,CLAY,2,Pere Riba,Evgeny Korolev,Pere Riba,7-6(3); 6-2,R64,105,5,3,39,77,28,39,16,38,8,11,10,44,77,3,1,37,72,22,37,14,35,6,11,10,36,72
2009-07-19 00:00:00.000,Hamburg Germany ATP World Tour 500,CLAY,2,Paul-Henri Mathieu,N/A Bye,Paul-Henri Mathieu,,R64,0,0,0,0,0,0,0,0,0,0,0,0,0,0,0,0,0,0,0,0,0,0,0,0,0,0,0
2009-07-19 00:00:00.000,Hamburg Germany ATP World Tour 500,CLAY,2,Viktor Troicki,N/A Bye,Viktor Troicki,,R64,0,0,0,0,0,0,0,0,0,0,0,0,0,0,0,0,0,0,0,0,0,0,0,0,0,0,0
2009-07-19 00:00:00.000,Hamburg Germany ATP World Tour 500,CLAY,2,Teymuraz Gabashvili,Andreas Seppi,Teymuraz Gabashvili,6-3; 6-1,R64,103,3,3,40,74,24,40,22,34,12,12,8,46,74,3,1,22,49,15,22,12,27,6,10,8,27,49
2009-07-19 00:00:00.000,Hamburg Germany ATP World Tour 500,CLAY,2,Guillermo Garcia-Lopez,Christophe Rochus,Guillermo Garcia-Lopez,6-4; 6-2,R64,70,5,1,38,52,27,38,6,14,1,3,9,33,52,1,1,28,47,15,28,5,19,1,6,9,20,47
2009-07-19 00:00:00.000,Hamburg Germany ATP World Tour 500,CLAY,2,Stanislas Wawrinka,N/A Bye,Stanislas Wawrinka,,R64,0,0,0,0,0,0,0,0,0,0,0,0,0,0,0,0,0,0,0,0,0,0,0,0,0,0,0
2009-07-19 00:00:00.000,Hamburg Germany ATP World Tour 500,CLAY,2,Robin Soderling,N/A Bye,Robin Soderling,,R64,0,0,0,0,0,0,0,0,0,0,0,0,0,0,0,0,0,0,0,0,0,0,0,0,0,0,0
2009-07-19 00:00:00.000,Hamburg Germany ATP World Tour 500,CLAY,2,Fabio Fognini,Ivo Minar,Fabio Fognini,6-4; 6-2,R64,68,1,1,34,50,28,34,9,16,0,0,9,37,50,3,4,35,63,25,35,11,28,5,8,9,36,63
2009-07-19 00:00:00.000,Hamburg Germany ATP World Tour 500,CLAY,2,Marcel Granollers,Martin Vassallo Arguello,Marcel Granollers,6-4; 6-4,R64,90,1,3,43,65,27,43,13,22,6,9,10,40,65,0,2,49,67,27,49,8,18,3,8,10,35,67
2009-07-19 00:00:00.000,Hamburg Germany ATP World Tour 500,CLAY,2,Nicolas Almagro,N/A Bye,Nicolas Almagro,,R64,0,0,0,0,0,0,0,0,0,0,0,0,0,0,0,0,0,0,0,0,0,0,0,0,0,0,0
2009-07-19 00:00:00.000,Hamburg Germany ATP World Tour 500,CLAY,2,Jurgen Melzer,N/A Bye,Jurgen Melzer,,R64,0,0,0,0,0,0,0,0,0,0,0,0,0,0,0,0,0,0,0,0,0,0,0,0,0,0,0
2009-07-19 00:00:00.000,Hamburg Germany ATP World Tour 500,CLAY,2,Pablo Cuevas,Bjorn Phau,Pablo Cuevas,7-6(0); 6-4,R64,93,4,1,53,66,42,53,7,13,0,0,11,49,66,3,2,47,78,34,47,16,31,4,5,11,50,78
2009-07-19 00:00:00.000,Hamburg Germany ATP World Tour 500,CLAY,2,Potito Starace,Maximo Gonzalez,Potito Starace,5-7; 6-4; 6-3,R64,149,2,3,79,105,49,79,11,26,3,8,16,60,105,1,0,78,104,41,78,13,26,7,13,15,54,104
2009-07-19 00:00:00.000,Hamburg Germany ATP World Tour 500,CLAY,2,Philipp Kohlschreiber,N/A Bye,Philipp Kohlschreiber,,R64,0,0,0,0,0,0,0,0,0,0,0,0,0,0,0,0,0,0,0,0,0,0,0,0,0,0,0
2009-07-19 00:00:00.000,Hamburg Germany ATP World Tour 500,CLAY,2,David Ferrer,N/A Bye,David Ferrer,,R64,0,0,0,0,0,0,0,0,0,0,0,0,0,0,0,0,0,0,0,0,0,0,0,0,0,0,0
2009-07-19 00:00:00.000,Hamburg Germany ATP World Tour 500,CLAY,2,Florian Mayer,Rainer Schuettler,Florian Mayer,6-7(3); 6-3; 6-3,R64,140,3,6,65,98,51,65,15,33,6,8,15,66,98,3,5,70,111,43,70,19,41,8,13,15,62,111
2009-07-19 00:00:00.000,Hamburg Germany ATP World Tour 500,CLAY,2,Juan Monaco,Mikhail Youzhny,Juan Monaco,7-6(4); 6-3,R64,112,0,2,52,75,32,52,13,23,4,7,10,45,75,1,3,65,91,40,65,7,26,6,11,11,47,91
2009-07-19 00:00:00.000,Hamburg Germany ATP World Tour 500,CLAY,2,Jose Acasuso,N/A Bye,Jose Acasuso,,R64,0,0,0,0,0,0,0,0,0,0,0,0,0,0,0,0,0,0,0,0,0,0,0,0,0,0,0
2009-07-19 00:00:00.000,Hamburg Germany ATP World Tour 500,CLAY,2,Mischa Zverev,N/A Bye,Mischa Zverev,,R64,0,0,0,0,0,0,0,0,0,0,0,0,0,0,0,0,0,0,0,0,0,0,0,0,0,0,0
2009-07-19 00:00:00.000,Hamburg Germany ATP World Tour 500,CLAY,2,Simon Greul,Janko Tipsarevic,Simon Greul,2-6; 6-3; 6-3,R64,125,7,3,33,70,24,33,23,37,3,6,13,47,70,7,4,43,90,32,43,20,47,5,9,13,52,90
2009-07-19 00:00:00.000,Hamburg Germany ATP World Tour 500,CLAY,2,Ivan Navarro,Steve Darcis,Ivan Navarro,6-4; 6-4,R64,77,5,0,37,57,28,37,12,20,1,2,10,40,57,2,2,39,58,28,39,7,19,1,4,10,35,58
2009-07-19 00:00:00.000,Hamburg Germany ATP World Tour 500,CLAY,2,Tommy Robredo,N/A Bye,Tommy Robredo,,R64,0,0,0,0,0,0,0,0,0,0,0,0,0,0,0,0,0,0,0,0,0,0,0,0,0,0,0
2009-07-19 00:00:00.000,Hamburg Germany ATP World Tour 500,CLAY,2,Igor Andreev,N/A Bye,Igor Andreev,,R64,0,0,0,0,0,0,0,0,0,0,0,0,0,0,0,0,0,0,0,0,0,0,0,0,0,0,0
2009-07-19 00:00:00.000,Hamburg Germany ATP World Tour 500,CLAY,2,Julien Benneteau,Juan Ignacio Chela,Julien Benneteau,6-4; 1-6; 6-1,R64,106,4,4,49,78,32,49,11,29,4,9,12,43,78,3,0,35,60,17,35,11,25,1,7,12,28,60
2009-07-19 00:00:00.000,Hamburg Germany ATP World Tour 500,CLAY,2,Jan Hernych,Kevin Krawietz,Jan Hernych,6-0; 4-6; 6-3,R64,78,7,1,51,72,36,51,11,21,1,4,13,47,72,5,5,42,76,25,42,12,34,4,10,12,37,76
2009-07-19 00:00:00.000,Hamburg Germany ATP World Tour 500,CLAY,2,Victor Hanescu,N/A Bye,Victor Hanescu,,R64,0,0,0,0,0,0,0,0,0,0,0,0,0,0,0,0,0,0,0,0,0,0,0,0,0,0,0
2009-07-19 00:00:00.000,Hamburg Germany ATP World Tour 500,CLAY,2,Jeremy Chardy,N/A Bye,Jeremy Chardy,,R64,0,0,0,0,0,0,0,0,0,0,0,0,0,0,0,0,0,0,0,0,0,0,0,0,0,0,0
2009-07-19 00:00:00.000,Hamburg Germany ATP World Tour 500,CLAY,2,Andreas Beck,Oscar Hernandez,Andreas Beck,6-7(3); 6-4; 6-4,R64,171,4,3,59,100,45,59,22,41,5,7,16,67,100,5,1,90,134,56,90,23,44,13,17,16,79,134
2009-07-19 00:00:00.000,Hamburg Germany ATP World Tour 500,CLAY,2,Philipp Petzschner,Florent Serra,Philipp Petzschner,7-6(3); 6-2,R64,83,6,2,48,82,35,48,16,34,10,12,10,51,82,1,1,37,61,22,37,11,24,1,5,10,33,61
2009-07-19 00:00:00.000,Hamburg Germany ATP World Tour 500,CLAY,2,Nikolay Davydenko,N/A Bye,Nikolay Davydenko,,R64,0,0,0,0,0,0,0,0,0,0,0,0,0,0,0,0,0,0,0,0,0,0,0,0,0,0,0
2009-07-19 00:00:00.000,Hamburg Germany ATP World Tour 500,CLAY,2,Daniel Brands,Gilles Simon,Daniel Brands,3-6; 6-4; 6-3,R32,131,7,4,81,120,53,81,15,39,8,12,14,68,120,4,1,47,88,29,47,20,41,5,10,14,49,88
2009-07-19 00:00:00.000,Hamburg Germany ATP World Tour 500,CLAY,2,Paul-Henri Mathieu,Pere Riba,Paul-Henri Mathieu,6-1; 2-6; 7-6(3),R32,131,5,3,44,94,33,44,26,50,2,5,14,59,94,15,3,46,79,34,46,16,33,2,5,13,50,79
2009-07-19 00:00:00.000,Hamburg Germany ATP World Tour 500,CLAY,2,Viktor Troicki,Teymuraz Gabashvili,Viktor Troicki,3-6; 6-2; 6-4,R32,161,11,4,52,110,37,52,27,58,13,17,14,64,110,3,7,47,89,30,47,19,42,9,14,13,49,89
2009-07-19 00:00:00.000,Hamburg Germany ATP World Tour 500,CLAY,2,Guillermo Garcia-Lopez,Stanislas Wawrinka,Guillermo Garcia-Lopez,6-2; 6-4,R32,86,0,4,41,62,26,41,14,21,6,7,9,40,62,1,2,38,54,20,38,8,16,2,6,9,28,54
2009-07-19 00:00:00.000,Hamburg Germany ATP World Tour 500,CLAY,2,Robin Soderling,Fabio Fognini,Robin Soderling,6-3; 6-7(3); 6-3,R32,128,5,4,56,97,40,56,22,41,6,9,16,62,97,2,3,55,94,34,55,20,39,4,9,14,54,94
2009-07-19 00:00:00.000,Hamburg Germany ATP World Tour 500,CLAY,2,Nicolas Almagro,Marcel Granollers,Nicolas Almagro,4-6; 6-3; 6-4,R32,106,10,2,53,89,37,53,21,36,6,8,15,58,89,5,0,52,73,38,52,12,21,3,6,14,50,73
2009-07-19 00:00:00.000,Hamburg Germany ATP World Tour 500,CLAY,2,Pablo Cuevas,Jurgen Melzer,Pablo Cuevas,7-6(5); 6-3,R32,95,11,1,43,62,32,43,14,19,2,3,11,46,62,1,3,45,73,32,45,13,28,2,4,10,45,73
2009-07-19 00:00:00.000,Hamburg Germany ATP World Tour 500,CLAY,2,Philipp Kohlschreiber,Potito Starace,Philipp Kohlschreiber,6-2; 4-6; 6-4,R32,118,6,0,66,87,48,66,10,21,0,1,14,58,87,2,1,66,86,43,66,10,20,4,7,14,53,86
2009-07-19 00:00:00.000,Hamburg Germany ATP World Tour 500,CLAY,2,David Ferrer,Florian Mayer,David Ferrer,6-3; 6-2,R32,70,0,1,29,49,22,29,15,20,2,2,8,37,49,1,0,37,56,20,37,9,19,4,8,9,29,56
2009-07-19 00:00:00.000,Hamburg Germany ATP World Tour 500,CLAY,2,Juan Monaco,Jose Acasuso,Juan Monaco,6-1; 1-1 RET,R32,42,1,0,15,21,11,15,4,6,0,1,4,15,21,0,3,13,32,7,13,6,19,2,6,5,13,32
2009-07-19 00:00:00.000,Hamburg Germany ATP World Tour 500,CLAY,2,Simon Greul,Mischa Zverev,Simon Greul,0-6; 7-5; 6-1,R32,107,3,3,50,88,35,50,20,38,7,10,13,55,88,1,0,50,70,35,50,11,20,6,9,12,46,70
2009-07-19 00:00:00.000,Hamburg Germany ATP World Tour 500,CLAY,2,Ivan Navarro,Tommy Robredo,Ivan Navarro,7-5; 7-6(2),R32,117,2,1,43,73,33,43,20,30,1,2,12,53,73,1,2,49,81,34,49,18,32,4,6,12,52,81
2009-07-19 00:00:00.000,Hamburg Germany ATP World Tour 500,CLAY,2,Julien Benneteau,Igor Andreev,Julien Benneteau,6-4; 6-3,R32,96,3,1,39,65,24,39,16,26,5,7,10,40,65,2,2,38,58,22,38,9,20,4,8,9,31,58
2009-07-19 00:00:00.000,Hamburg Germany ATP World Tour 500,CLAY,2,Victor Hanescu,Jan Hernych,Victor Hanescu,6-2; 6-3,R32,63,3,0,41,46,32,41,3,5,3,4,9,35,46,2,3,31,50,19,31,6,19,2,6,8,25,50
2009-07-19 00:00:00.000,Hamburg Germany ATP World Tour 500,CLAY,2,Jeremy Chardy,Andreas Beck,Jeremy Chardy,7-6(2); 7-6(6),R32,109,22,3,47,76,40,47,19,29,2,3,12,59,76,8,5,51,86,37,51,22,35,5,6,12,59,86
2009-07-19 00:00:00.000,Hamburg Germany ATP World Tour 500,CLAY,2,Nikolay Davydenko,Philipp Petzschner,Nikolay Davydenko,6-3; 6-2,R32,70,1,1,42,58,31,42,12,16,3,3,9,43,58,3,2,25,50,15,25,13,25,3,6,8,28,50
2009-07-19 00:00:00.000,Hamburg Germany ATP World Tour 500,CLAY,2,Paul-Henri Mathieu,Daniel Brands,Paul-Henri Mathieu,7-5; 7-5,R16,103,7,0,39,78,29,39,25,39,3,3,12,54,78,5,2,56,72,42,56,5,16,2,4,12,47,72
2009-07-19 00:00:00.000,Hamburg Germany ATP World Tour 500,CLAY,2,Viktor Troicki,Guillermo Garcia-Lopez,Viktor Troicki,6-7(2); 6-4; 7-6(6),R16,172,11,2,73,111,48,73,22,38,4,7,17,70,111,4,6,71,109,50,71,16,38,2,6,17,66,109
2009-07-19 00:00:00.000,Hamburg Germany ATP World Tour 500,CLAY,2,Nicolas Almagro,Robin Soderling,Nicolas Almagro,7-5; 6-3,R16,75,0,0,0,0,0,0,0,0,0,0,0,0,0,0,0,0,0,0,0,0,0,0,0,0,0,0
2009-07-19 00:00:00.000,Hamburg Germany ATP World Tour 500,CLAY,2,Pablo Cuevas,Philipp Kohlschreiber,Pablo Cuevas,6-4; 7-6(8),R16,114,8,0,56,82,45,56,14,26,4,4,11,59,82,3,2,59,82,43,59,11,23,7,8,11,54,82
2009-07-19 00:00:00.000,Hamburg Germany ATP World Tour 500,CLAY,2,David Ferrer,Juan Monaco,David Ferrer,4-6; 7-5; 6-2,R16,136,4,3,53,80,36,53,14,27,0,4,15,50,80,2,3,72,95,42,72,10,23,4,10,15,52,95
2009-07-19 00:00:00.000,Hamburg Germany ATP World Tour 500,CLAY,2,Simon Greul,Ivan Navarro,Simon Greul,7-5; 7-6(7),R16,123,3,1,51,82,37,51,18,31,0,1,12,55,82,9,3,56,84,37,56,14,28,5,7,12,51,84
2009-07-19 00:00:00.000,Hamburg Germany ATP World Tour 500,CLAY,2,Victor Hanescu,Julien Benneteau,Victor Hanescu,3-6; 6-3; 6-3,R16,113,7,2,55,83,38,55,16,28,11,13,14,54,83,2,0,56,83,36,56,15,27,8,11,13,51,83
2009-07-19 00:00:00.000,Hamburg Germany ATP World Tour 500,CLAY,2,Nikolay Davydenko,Jeremy Chardy,Nikolay Davydenko,6-3; 6-3,R16,72,4,1,33,42,30,33,6,9,0,0,9,36,42,2,4,48,74,30,48,12,26,8,11,9,42,74
2009-07-19 00:00:00.000,Hamburg Germany ATP World Tour 500,CLAY,2,Paul-Henri Mathieu,Viktor Troicki,Paul-Henri Mathieu,3-0 RET,Q,21,1,0,6,16,5,6,6,10,2,2,2,11,16,0,0,3,8,1,3,1,5,0,1,1,2,8
2009-07-19 00:00:00.000,Hamburg Germany ATP World Tour 500,CLAY,2,Pablo Cuevas,Nicolas Almagro,Pablo Cuevas,6-2; 6-4,Q,74,4,1,36,55,29,36,11,19,5,5,9,40,55,3,1,30,45,24,30,5,15,1,4,9,29,45
2009-07-19 00:00:00.000,Hamburg Germany ATP World Tour 500,CLAY,2,David Ferrer,Simon Greul,David Ferrer,6-2; 6-3,Q,65,0,0,32,46,28,32,8,14,0,0,9,36,46,2,0,36,52,23,36,6,16,4,7,8,29,52
2009-07-19 00:00:00.000,Hamburg Germany ATP World Tour 500,CLAY,2,Nikolay Davydenko,Victor Hanescu,Nikolay Davydenko,6-3; 4-6; 6-3,Q,140,3,1,67,94,51,67,12,27,2,3,14,63,94,2,1,82,104,52,82,10,22,9,12,14,62,104
2009-07-19 00:00:00.000,Hamburg Germany ATP World Tour 500,CLAY,2,Paul-Henri Mathieu,Pablo Cuevas,Paul-Henri Mathieu,4-6; 6-3; 7-5,S,172,2,2,59,101,38,59,25,42,6,10,16,63,101,12,1,56,91,38,56,16,35,2,7,15,54,91
2009-07-19 00:00:00.000,Hamburg Germany ATP World Tour 500,CLAY,2,Nikolay Davydenko,David Ferrer,Nikolay Davydenko,7-5; 7-6(2),S,133,4,2,58,85,39,58,11,27,3,6,12,50,85,3,1,56,98,37,56,16,42,13,17,12,53,98
2009-07-19 00:00:00.000,Hamburg Germany ATP World Tour 500,CLAY,2,Nikolay Davydenko,Paul-Henri Mathieu,Nikolay Davydenko,6-4; 6-2,F,89,3,1,39,50,24,39,8,11,4,6,9,32,50,1,2,31,62,17,31,13,31,8,13,9,30,62
2009-07-19 00:00:00.000,Indianapolis IN; U.S.A. ATP World Tour 250,HARD,2,Dmitry Tursunov,Michael Berrer,Dmitry Tursunov,6-3; 2-6; 6-0,R32,97,6,5,36,74,29,36,14,38,6,10,12,43,74,1,16,42,77,26,42,12,35,4,10,11,38,77
2009-07-19 00:00:00.000,Indianapolis IN; U.S.A. ATP World Tour 250,HARD,2,Marcos Daniel,Taylor Dent,Marcos Daniel,6-2; 6-4,R32,64,5,2,25,45,19,25,17,20,0,0,9,36,45,9,7,24,52,22,24,9,28,0,3,9,31,52
2009-07-19 00:00:00.000,Indianapolis IN; U.S.A. ATP World Tour 250,HARD,2,Frank Dancevic,Bobby Reynolds,Frank Dancevic,6-2; 7-6(5),R32,76,6,1,32,59,26,32,22,27,0,0,10,48,59,10,2,42,72,29,42,18,30,7,9,10,47,72
2009-07-19 00:00:00.000,Indianapolis IN; U.S.A. ATP World Tour 250,HARD,2,Benjamin Becker,Go Soeda,Benjamin Becker,6-2; 6-3,R32,57,6,2,28,45,18,28,13,17,0,1,8,31,45,0,4,28,48,16,28,6,20,1,6,9,22,48
2009-07-19 00:00:00.000,Indianapolis IN; U.S.A. ATP World Tour 250,HARD,2,Sam Querrey,Arnaud Clement,Sam Querrey,6-3; 6-4,R32,73,11,3,37,50,31,37,10,13,0,0,10,41,50,7,0,34,60,26,34,12,26,4,6,9,38,60
2009-07-19 00:00:00.000,Indianapolis IN; U.S.A. ATP World Tour 250,HARD,2,Rajeev Ram,Devin Britton,Rajeev Ram,6-3; 7-5,R32,79,10,2,29,58,24,29,18,29,3,3,10,42,58,3,4,50,86,33,50,15,36,9,12,11,48,86
2009-07-19 00:00:00.000,Indianapolis IN; U.S.A. ATP World Tour 250,HARD,2,Jesse Levine,Danai Udomchoke,Jesse Levine,6-1; 7-6(10),R32,83,2,5,39,64,26,39,12,25,0,3,9,38,64,3,2,45,77,27,45,10,32,7,13,10,37,77
2009-07-19 00:00:00.000,Indianapolis IN; U.S.A. ATP World Tour 250,HARD,2,Marc Gicquel,Ernests Gulbis,Marc Gicquel,6-2; 6-3,R32,61,6,1,26,45,22,26,12,19,3,3,8,34,45,6,3,40,65,24,40,11,25,6,10,9,35,65
2009-07-19 00:00:00.000,Indianapolis IN; U.S.A. ATP World Tour 250,HARD,2,Denis Istomin,Kevin Kim,Denis Istomin,2-6; 6-4; 6-4,R32,107,7,5,58,97,35,58,18,39,6,11,14,53,97,8,9,39,94,29,39,25,55,4,9,14,54,94
2009-07-19 00:00:00.000,Indianapolis IN; U.S.A. ATP World Tour 250,HARD,2,John Isner,Josselin Ouanna,John Isner,6-1; 7-6(6),R32,71,15,1,37,55,32,37,13,18,0,0,10,45,55,1,5,36,66,26,36,15,30,4,6,9,41,66
2009-07-19 00:00:00.000,Indianapolis IN; U.S.A. ATP World Tour 250,HARD,2,Wayne Odesnik,Marcos Baghdatis,Wayne Odesnik,7-6(5); 1-6; 6-4,R32,135,2,5,62,97,44,62,14,35,8,12,14,58,97,7,6,46,87,41,46,16,41,2,5,15,57,87
2009-07-19 00:00:00.000,Indianapolis IN; U.S.A. ATP World Tour 250,HARD,2,Igor Kunitsyn,Brian Dabul,Igor Kunitsyn,6-4; 6-1,R32,72,2,1,30,44,25,30,7,14,0,0,8,32,44,1,4,39,69,22,39,13,30,2,6,9,35,69
2009-07-19 00:00:00.000,Indianapolis IN; U.S.A. ATP World Tour 250,HARD,2,Eduardo Schwank,Yen-Hsun Lu,Eduardo Schwank,4-6; 6-3; 6-2,R32,126,6,7,51,101,36,51,26,50,8,10,14,62,101,5,8,39,80,30,39,16,41,3,7,13,46,80
2009-07-19 00:00:00.000,Indianapolis IN; U.S.A. ATP World Tour 250,HARD,2,Robby Ginepri,Sebastien De Chaunac,Robby Ginepri,7-5; 5-7; 6-2,R32,115,8,2,54,94,43,54,23,40,5,7,16,66,94,7,4,45,89,36,45,22,44,4,8,16,58,89
2009-07-19 00:00:00.000,Indianapolis IN; U.S.A. ATP World Tour 250,HARD,2,Alex Bogomolov Jr.,Flavio Cipolla,Alex Bogomolov Jr.,6-2; 6-3,R32,61,0,0,32,45,22,32,9,13,1,2,8,31,45,1,6,29,49,13,29,8,20,2,7,9,21,49
2009-07-19 00:00:00.000,Indianapolis IN; U.S.A. ATP World Tour 250,HARD,2,Dudi Sela,Vincent Spadea,Dudi Sela,7-5; 6-1,R32,76,0,3,34,63,21,34,17,29,5,7,9,38,63,2,8,31,63,20,31,11,32,3,9,10,31,63
2009-07-19 00:00:00.000,Indianapolis IN; U.S.A. ATP World Tour 250,HARD,2,Dmitry Tursunov,Marcos Daniel,Dmitry Tursunov,6-3; 6-3,R16,69,9,1,30,48,23,30,11,18,1,2,9,34,48,7,4,33,64,19,33,15,31,2,6,9,34,64
2009-07-19 00:00:00.000,Indianapolis IN; U.S.A. ATP World Tour 250,HARD,2,Frank Dancevic,Benjamin Becker,Frank Dancevic,6-2; 7-5,R16,58,9,0,28,50,25,28,16,22,0,0,10,41,50,7,1,25,50,18,25,16,25,0,3,10,34,50
2009-07-19 00:00:00.000,Indianapolis IN; U.S.A. ATP World Tour 250,HARD,2,Sam Querrey,Rajeev Ram,Sam Querrey,7-5; 6-3,R16,69,13,4,36,59,31,36,13,23,0,0,11,44,59,7,5,36,72,27,36,18,36,6,8,10,45,72
2009-07-19 00:00:00.000,Indianapolis IN; U.S.A. ATP World Tour 250,HARD,2,Marc Gicquel,Jesse Levine,Marc Gicquel,6-2; 6-2,R16,65,8,3,34,61,25,34,12,27,4,5,8,37,61,2,8,27,48,15,27,6,21,2,7,8,21,48
2009-07-19 00:00:00.000,Indianapolis IN; U.S.A. ATP World Tour 250,HARD,2,John Isner,Denis Istomin,John Isner,6-4; 6-4,R16,83,5,0,40,58,30,40,13,18,1,1,10,43,58,4,5,44,73,30,44,15,29,4,6,10,45,73
2009-07-19 00:00:00.000,Indianapolis IN; U.S.A. ATP World Tour 250,HARD,2,Wayne Odesnik,Igor Kunitsyn,Wayne Odesnik,2-6; 6-1; 6-1,R16,92,6,2,40,66,25,40,16,26,7,10,11,41,66,4,4,35,59,19,35,9,24,3,9,11,28,59
2009-07-19 00:00:00.000,Indianapolis IN; U.S.A. ATP World Tour 250,HARD,2,Robby Ginepri,Eduardo Schwank,Robby Ginepri,6-7(1); 6-3; 6-0,R16,101,5,2,41,77,31,41,24,36,1,2,14,55,77,7,4,54,88,35,54,16,34,3,8,13,51,88
2009-07-19 00:00:00.000,Indianapolis IN; U.S.A. ATP World Tour 250,HARD,2,Alex Bogomolov Jr.,Dudi Sela,Alex Bogomolov Jr.,6-4; 7-6(5),R16,93,4,1,61,77,42,61,10,16,6,7,11,52,77,3,1,38,66,27,38,16,28,1,3,11,43,66
2009-07-19 00:00:00.000,Indianapolis IN; U.S.A. ATP World Tour 250,HARD,2,Frank Dancevic,Dmitry Tursunov,Frank Dancevic,3-6; 7-6(5); 6-2,Q,123,18,4,49,88,38,49,23,39,0,2,14,61,88,6,2,41,93,33,41,30,52,5,8,15,63,93
2009-07-19 00:00:00.000,Indianapolis IN; U.S.A. ATP World Tour 250,HARD,2,Sam Querrey,Marc Gicquel,Sam Querrey,6-4; 7-5,Q,92,19,4,43,76,38,43,15,33,2,2,11,53,76,6,4,38,77,29,38,18,39,6,8,11,47,77
2009-07-19 00:00:00.000,Indianapolis IN; U.S.A. ATP World Tour 250,HARD,2,John Isner,Wayne Odesnik,John Isner,7-5; 6-7(2); 7-5,Q,158,27,7,63,102,54,63,21,39,5,5,18,75,102,9,6,63,106,51,63,25,43,3,5,18,76,106
2009-07-19 00:00:00.000,Indianapolis IN; U.S.A. ATP World Tour 250,HARD,2,Robby Ginepri,Alex Bogomolov Jr.,Robby Ginepri,7-5; 6-1,Q,76,5,1,38,59,28,38,12,21,1,2,10,40,59,1,2,35,57,20,35,10,22,1,5,9,30,57
2009-07-19 00:00:00.000,Indianapolis IN; U.S.A. ATP World Tour 250,HARD,2,Sam Querrey,Frank Dancevic,Sam Querrey,6-4; 6-4,S,73,11,4,30,54,24,30,12,24,2,4,10,36,54,1,2,33,64,20,33,17,31,5,9,10,37,64
2009-07-19 00:00:00.000,Indianapolis IN; U.S.A. ATP World Tour 250,HARD,2,Robby Ginepri,John Isner,Robby Ginepri,6-4; 6-3,S,86,2,2,42,69,30,42,18,27,5,5,10,48,69,11,3,46,68,32,46,9,22,7,9,9,41,68
2009-07-19 00:00:00.000,Indianapolis IN; U.S.A. ATP World Tour 250,HARD,2,Robby Ginepri,Sam Querrey,Robby Ginepri,6-2; 6-4,F,63,4,2,33,51,27,33,11,18,1,1,9,38,51,2,9,20,53,17,20,15,33,1,4,9,32,53
2009-07-26 00:00:00.000,Gstaad Switzerland ATP World Tour 250,CLAY,2,Stanislas Wawrinka,Federico Delbonis,Stanislas Wawrinka,6-4; 7-5,R32,95,4,7,45,77,31,45,16,32,6,9,11,47,77,2,1,40,67,25,40,13,27,2,7,11,38,67
2009-07-26 00:00:00.000,Gstaad Switzerland ATP World Tour 250,CLAY,2,Thomaz Bellucci,Michael Lammer,Thomaz Bellucci,6-7(5); 7-6(5); 6-4,R32,190,2,6,72,125,49,72,25,53,10,15,17,74,125,3,2,78,127,47,78,27,49,9,15,17,74,127
2009-07-26 00:00:00.000,Gstaad Switzerland ATP World Tour 250,CLAY,2,Ivan Navarro,Farrukh Dustov,Ivan Navarro,7-6(2); 4-6; 6-2,R32,128,4,3,55,81,45,55,17,26,0,1,15,62,81,4,0,86,104,58,86,8,18,5,7,15,66,104
2009-07-26 00:00:00.000,Gstaad Switzerland ATP World Tour 250,CLAY,2,Nicolas Kiefer,Jose Acasuso,Nicolas Kiefer,7-6(5); 6-2,R32,86,9,6,32,60,30,32,15,28,4,5,10,45,60,5,2,35,72,22,35,21,37,7,10,10,43,72
2009-07-26 00:00:00.000,Gstaad Switzerland ATP World Tour 250,CLAY,2,Igor Andreev,Diego Junqueira,Igor Andreev,7-5; 6-4,R32,95,4,1,42,68,25,42,19,26,3,5,11,44,68,1,1,37,65,22,37,14,28,0,4,11,36,65
2009-07-26 00:00:00.000,Gstaad Switzerland ATP World Tour 250,CLAY,2,Jan Hernych,Flavio Cipolla,Jan Hernych,6-1; 6-0,R32,52,4,0,33,53,23,33,13,20,1,1,7,36,53,0,1,24,45,8,24,9,21,3,8,6,17,45
2009-07-26 00:00:00.000,Gstaad Switzerland ATP World Tour 250,CLAY,2,Mikhail Youzhny,Gaston Gaudio,Mikhail Youzhny,6-3; 5-7; 6-4,R32,167,5,3,72,117,42,72,25,45,10,14,15,67,117,0,7,76,120,47,76,21,44,14,20,16,68,120
2009-07-26 00:00:00.000,Gstaad Switzerland ATP World Tour 250,CLAY,2,Jeremy Chardy,Thierry Ascione,Jeremy Chardy,6-3; 6-3,R32,60,12,4,24,49,20,24,14,25,1,2,9,34,49,2,3,36,58,18,36,13,22,3,7,9,31,58
2009-07-26 00:00:00.000,Gstaad Switzerland ATP World Tour 250,CLAY,2,Marcos Daniel,Paul-Henri Mathieu,Marcos Daniel,7-6(3); 7-6(6),R32,118,13,0,51,81,36,51,20,30,4,6,12,56,81,10,5,56,100,43,56,19,44,8,10,12,62,100
2009-07-26 00:00:00.000,Gstaad Switzerland ATP World Tour 250,CLAY,2,Julien Benneteau,Stephane Bohli,Julien Benneteau,7-6(4); 7-5,R32,116,10,4,54,77,42,54,15,23,3,3,12,57,77,10,5,53,93,41,53,18,40,5,6,12,59,93
2009-07-26 00:00:00.000,Gstaad Switzerland ATP World Tour 250,CLAY,2,Florent Serra,Martin Vassallo Arguello,Florent Serra,6-3; 6-2,R32,61,1,1,24,45,20,24,16,21,0,0,9,36,45,5,1,31,47,21,31,6,16,2,5,8,27,47
2009-07-26 00:00:00.000,Gstaad Switzerland ATP World Tour 250,CLAY,2,Victor Hanescu,Ivo Minar,Victor Hanescu,6-2; 6-2,R32,51,4,0,32,42,26,32,7,10,0,0,8,33,42,5,5,29,48,16,29,9,19,1,5,8,25,48
2009-07-26 00:00:00.000,Gstaad Switzerland ATP World Tour 250,CLAY,2,Guillermo Garcia-Lopez,Feliciano Lopez,Guillermo Garcia-Lopez,6-4; 6-7(4); 6-3,R32,138,2,7,64,98,42,64,20,34,3,6,16,62,98,9,4,46,100,33,46,27,54,6,11,15,60,100
2009-07-26 00:00:00.000,Gstaad Switzerland ATP World Tour 250,CLAY,2,Andreas Beck,Marco Chiudinelli,Andreas Beck,4-6; 7-6(7); 6-4,R32,155,6,9,69,118,51,69,25,49,4,5,16,76,118,8,4,58,106,46,58,25,48,6,7,16,71,106
2009-07-26 00:00:00.000,Gstaad Switzerland ATP World Tour 250,CLAY,2,Teymuraz Gabashvili,Paul Capdeville,Teymuraz Gabashvili,1-6; 7-6(3); 6-3,R32,129,7,7,64,106,42,64,22,42,7,12,15,64,106,9,6,56,88,40,56,12,32,8,11,13,52,88
2009-07-26 00:00:00.000,Gstaad Switzerland ATP World Tour 250,CLAY,2,Victor Crivoi,Philipp Kohlschreiber,Victor Crivoi,6-4; 6-0,R32,65,4,0,20,49,13,20,22,29,2,2,8,35,49,2,5,30,55,15,30,12,25,9,13,8,27,55
2009-07-26 00:00:00.000,Gstaad Switzerland ATP World Tour 250,CLAY,2,Thomaz Bellucci,Stanislas Wawrinka,Thomaz Bellucci,6-4; 6-4,R16,75,3,2,35,53,27,35,14,18,0,0,10,41,53,5,3,26,51,22,26,14,25,1,3,10,36,51
2009-07-26 00:00:00.000,Gstaad Switzerland ATP World Tour 250,CLAY,2,Nicolas Kiefer,Ivan Navarro,Nicolas Kiefer,6-3; 6-7(3); 6-2,R16,143,8,3,57,98,42,57,26,41,4,4,15,68,98,7,4,64,92,40,64,16,28,1,4,14,56,92
2009-07-26 00:00:00.000,Gstaad Switzerland ATP World Tour 250,CLAY,2,Igor Andreev,Jan Hernych,Igor Andreev,6-4; 6-1,R16,62,3,3,31,51,27,31,11,20,3,3,9,38,51,1,3,33,50,22,33,7,17,4,7,8,29,50
2009-07-26 00:00:00.000,Gstaad Switzerland ATP World Tour 250,CLAY,2,Jeremy Chardy,Mikhail Youzhny,Jeremy Chardy,6-3; 5-7; 6-3,R16,121,8,6,57,95,43,57,13,38,2,7,15,56,95,3,5,51,97,26,51,24,46,7,14,15,50,97
2009-07-26 00:00:00.000,Gstaad Switzerland ATP World Tour 250,CLAY,2,Marcos Daniel,Julien Benneteau,Marcos Daniel,6-3; 7-6(8),R16,118,3,1,57,92,40,57,23,35,7,7,11,63,92,5,1,41,64,34,41,11,23,1,2,10,45,64
2009-07-26 00:00:00.000,Gstaad Switzerland ATP World Tour 250,CLAY,2,Florent Serra,Victor Hanescu,Florent Serra,6-4 RET,R16,31,1,1,20,28,16,20,5,8,2,2,5,21,28,3,0,19,27,14,19,4,8,1,2,5,18,27
2009-07-26 00:00:00.000,Gstaad Switzerland ATP World Tour 250,CLAY,2,Andreas Beck,Guillermo Garcia-Lopez,Andreas Beck,7-6(3); 1-6; 7-6(3),R16,168,3,10,54,98,41,54,20,44,5,10,15,61,98,12,12,87,138,59,87,22,51,14,17,16,81,138
2009-07-26 00:00:00.000,Gstaad Switzerland ATP World Tour 250,CLAY,2,Victor Crivoi,Teymuraz Gabashvili,Victor Crivoi,6-4; 6-4,R16,71,8,3,32,51,28,32,13,19,2,2,10,41,51,3,5,36,61,22,36,16,25,1,3,10,38,61
2009-07-26 00:00:00.000,Gstaad Switzerland ATP World Tour 250,CLAY,2,Thomaz Bellucci,Nicolas Kiefer,Thomaz Bellucci,3-6; 1-0 RET,Q,53,2,3,13,28,11,13,6,15,0,1,5,17,28,2,2,18,35,14,18,9,17,2,2,5,23,35
2009-07-26 00:00:00.000,Gstaad Switzerland ATP World Tour 250,CLAY,2,Igor Andreev,Jeremy Chardy,Igor Andreev,6-3; 6-3,Q,67,2,2,34,53,24,34,13,19,1,1,9,37,53,4,7,30,57,21,30,11,27,3,6,9,32,57
2009-07-26 00:00:00.000,Gstaad Switzerland ATP World Tour 250,CLAY,2,Marcos Daniel,Florent Serra,Marcos Daniel,6-4; 7-6(1),Q,109,6,2,44,73,32,44,14,29,8,11,11,46,73,2,2,50,93,32,50,17,43,7,11,11,49,93
2009-07-26 00:00:00.000,Gstaad Switzerland ATP World Tour 250,CLAY,2,Andreas Beck,Victor Crivoi,Andreas Beck,6-4; 7-6(5),Q,105,8,6,41,80,29,41,18,39,7,10,11,47,80,4,4,42,80,28,42,18,38,7,11,11,46,80
2009-07-26 00:00:00.000,Gstaad Switzerland ATP World Tour 250,CLAY,2,Thomaz Bellucci,Igor Andreev,Thomaz Bellucci,6-4; 7-5,S,98,2,2,51,74,38,51,12,23,1,1,11,50,74,1,2,37,59,29,37,11,22,0,2,11,40,59
2009-07-26 00:00:00.000,Gstaad Switzerland ATP World Tour 250,CLAY,2,Andreas Beck,Marcos Daniel,Andreas Beck,7-6(3); 6-3,S,85,7,2,36,60,32,36,16,24,0,0,11,48,60,10,2,49,67,38,49,8,18,7,8,10,46,67
2009-07-26 00:00:00.000,Gstaad Switzerland ATP World Tour 250,CLAY,2,Thomaz Bellucci,Andreas Beck,Thomaz Bellucci,6-4; 7-6(2),F,100,7,1,48,67,40,48,10,19,1,1,11,50,67,3,3,34,61,30,34,15,27,2,3,11,45,61
2009-07-27 00:00:00.000,Los Angeles CA; U.S.A. ATP World Tour 250,HARD,2,Tommy Haas,N/A Bye,Tommy Haas,,R32,0,0,0,0,0,0,0,0,0,0,0,0,0,0,0,0,0,0,0,0,0,0,0,0,0,0,0
2009-07-27 00:00:00.000,Los Angeles CA; U.S.A. ATP World Tour 250,HARD,2,Jesse Levine,Bobby Reynolds,Jesse Levine,6-2; 6-3,R32,60,4,2,33,44,26,33,7,11,1,1,8,33,44,6,3,32,62,25,32,9,30,2,6,9,34,62
2009-07-27 00:00:00.000,Los Angeles CA; U.S.A. ATP World Tour 250,HARD,2,Ernests Gulbis,Yen-Hsun Lu,Ernests Gulbis,7-5; 6-2,R32,83,7,6,43,71,33,43,15,28,5,5,10,48,71,0,4,36,59,22,36,11,23,3,6,10,33,59
2009-07-27 00:00:00.000,Los Angeles CA; U.S.A. ATP World Tour 250,HARD,2,Marat Safin,Robby Ginepri,Marat Safin,3-6; 6-3; 6-4,R32,92,8,7,36,71,29,36,16,35,0,4,14,45,71,5,1,43,72,32,43,12,29,4,9,14,44,72
2009-07-27 00:00:00.000,Los Angeles CA; U.S.A. ATP World Tour 250,HARD,2,Dudi Sela,N/A Bye,Dudi Sela,,R32,0,0,0,0,0,0,0,0,0,0,0,0,0,0,0,0,0,0,0,0,0,0,0,0,0,0,0
2009-07-27 00:00:00.000,Los Angeles CA; U.S.A. ATP World Tour 250,HARD,2,Robert Kendrick,Vincent Spadea,Robert Kendrick,6-0; 6-0,R32,36,5,0,18,29,16,18,8,11,0,0,6,24,29,1,3,20,39,6,20,6,19,3,9,6,12,39
2009-07-27 00:00:00.000,Los Angeles CA; U.S.A. ATP World Tour 250,HARD,2,Ryan Sweeting,Taylor Dent,Ryan Sweeting,6-4; 2-6; 6-3,R32,103,5,4,55,91,37,55,19,36,10,13,13,56,91,7,9,40,74,33,40,14,34,5,9,14,47,74
2009-07-27 00:00:00.000,Los Angeles CA; U.S.A. ATP World Tour 250,HARD,2,Sam Querrey,Denis Istomin,Sam Querrey,6-2; 6-0,R32,46,6,2,20,33,18,20,6,13,0,1,7,24,33,2,5,31,47,16,31,2,16,5,11,7,18,47
2009-07-27 00:00:00.000,Los Angeles CA; U.S.A. ATP World Tour 250,HARD,2,John Isner,Benjamin Becker,John Isner,7-6(8); 7-6(3),R32,125,15,5,48,86,44,48,18,38,1,2,12,62,86,6,3,56,98,41,56,20,42,7,8,12,61,98
2009-07-27 00:00:00.000,Los Angeles CA; U.S.A. ATP World Tour 250,HARD,2,Marcos Baghdatis,Frank Dancevic,Marcos Baghdatis,7-6(3); 6-3,R32,101,11,8,39,87,28,39,29,48,8,9,11,57,87,2,3,38,65,26,38,13,27,1,3,10,39,65
2009-07-27 00:00:00.000,Los Angeles CA; U.S.A. ATP World Tour 250,HARD,2,Carsten Ball,Marc Gicquel,Carsten Ball,6-2; 7-6(6),R32,81,9,7,37,66,31,37,14,29,3,4,10,45,66,3,3,40,73,27,40,16,33,5,8,10,43,73
2009-07-27 00:00:00.000,Los Angeles CA; U.S.A. ATP World Tour 250,HARD,2,Dmitry Tursunov,N/A Bye,Dmitry Tursunov,,R32,0,0,0,0,0,0,0,0,0,0,0,0,0,0,0,0,0,0,0,0,0,0,0,0,0,0,0
2009-07-27 00:00:00.000,Los Angeles CA; U.S.A. ATP World Tour 250,HARD,2,Igor Kunitsyn,Somdev Devvarman,Igor Kunitsyn,7-5; 6-2,R32,76,0,0,36,56,25,36,13,20,0,2,10,38,56,1,2,32,55,21,32,8,23,3,8,10,29,55
2009-07-27 00:00:00.000,Los Angeles CA; U.S.A. ATP World Tour 250,HARD,2,Leonardo Mayer,Josselin Ouanna,Leonardo Mayer,6-2; 6-3,R32,75,4,4,21,51,16,21,20,30,0,1,9,36,51,4,4,26,59,16,26,14,33,1,5,8,30,59
2009-07-27 00:00:00.000,Los Angeles CA; U.S.A. ATP World Tour 250,HARD,2,Chris Guccione,Kevin Kim,Chris Guccione,6-1; 6-4,R32,50,11,0,22,47,20,22,17,25,2,2,9,37,47,4,6,26,44,22,26,4,18,0,3,8,26,44
2009-07-27 00:00:00.000,Los Angeles CA; U.S.A. ATP World Tour 250,HARD,2,Mardy Fish,N/A Bye,Mardy Fish,,R32,0,0,0,0,0,0,0,0,0,0,0,0,0,0,0,0,0,0,0,0,0,0,0,0,0,0,0
2009-07-27 00:00:00.000,Los Angeles CA; U.S.A. ATP World Tour 250,HARD,2,Tommy Haas,Jesse Levine,Tommy Haas,6-1; 6-3,R16,63,2,4,23,44,21,23,12,21,0,0,8,33,44,4,9,23,48,16,23,9,25,5,9,8,25,48
2009-07-27 00:00:00.000,Los Angeles CA; U.S.A. ATP World Tour 250,HARD,2,Marat Safin,Ernests Gulbis,Marat Safin,2-6; 6-3; 6-4,R16,105,5,4,49,87,29,49,22,38,9,13,14,51,87,4,8,44,90,30,44,22,46,10,14,13,52,90
2009-07-27 00:00:00.000,Los Angeles CA; U.S.A. ATP World Tour 250,HARD,2,Dudi Sela,Robert Kendrick,Dudi Sela,6-4; 3-6; 6-1,R16,109,2,3,60,82,45,60,11,22,2,3,13,56,82,8,2,45,86,30,45,22,41,3,6,13,52,86
2009-07-27 00:00:00.000,Los Angeles CA; U.S.A. ATP World Tour 250,HARD,2,Sam Querrey,Ryan Sweeting,Sam Querrey,6-3; 6-7(5); 6-3,R16,117,15,5,59,104,46,59,22,45,4,6,16,68,104,8,7,67,98,46,67,13,31,3,7,14,59,98
2009-07-27 00:00:00.000,Los Angeles CA; U.S.A. ATP World Tour 250,HARD,2,John Isner,Marcos Baghdatis,John Isner,6-3; 7-6(11),R16,110,11,1,50,76,34,50,20,26,0,0,11,54,76,3,2,35,71,27,35,20,36,2,3,10,47,71
2009-07-27 00:00:00.000,Los Angeles CA; U.S.A. ATP World Tour 250,HARD,2,Carsten Ball,Dmitry Tursunov,Carsten Ball,6-4; 0-1 RET,R16,49,7,2,16,32,12,16,10,16,0,1,5,22,32,0,1,21,41,12,21,11,20,4,6,6,23,41
2009-07-27 00:00:00.000,Los Angeles CA; U.S.A. ATP World Tour 250,HARD,2,Leonardo Mayer,Igor Kunitsyn,Leonardo Mayer,7-6(5); 6-7(7); 6-3,R16,163,9,9,63,110,49,63,24,47,2,6,17,73,110,1,3,81,125,52,81,24,44,7,12,16,76,125
2009-07-27 00:00:00.000,Los Angeles CA; U.S.A. ATP World Tour 250,HARD,2,Mardy Fish,Chris Guccione,Mardy Fish,6-7(3); 7-6(12); 6-4,R16,143,11,4,70,116,55,70,29,46,2,2,17,84,116,24,6,70,119,55,70,28,49,3,4,17,83,119
2009-07-27 00:00:00.000,Los Angeles CA; U.S.A. ATP World Tour 250,HARD,2,Tommy Haas,Marat Safin,Tommy Haas,7-6(3); 6-2,Q,109,4,4,34,58,23,34,16,24,2,4,10,39,58,4,4,54,102,31,54,20,48,12,16,10,51,102
2009-07-27 00:00:00.000,Los Angeles CA; U.S.A. ATP World Tour 250,HARD,2,Sam Querrey,Dudi Sela,Sam Querrey,6-3; 7-5,Q,77,9,3,27,58,25,27,20,31,0,0,11,45,58,1,2,35,61,26,35,13,26,3,5,10,39,61
2009-07-27 00:00:00.000,Los Angeles CA; U.S.A. ATP World Tour 250,HARD,2,Carsten Ball,John Isner,Carsten Ball,6-4; 6-4,Q,63,9,1,34,60,26,34,17,26,2,2,10,43,60,2,1,37,52,25,37,9,15,0,2,10,34,52
2009-07-27 00:00:00.000,Los Angeles CA; U.S.A. ATP World Tour 250,HARD,2,Leonardo Mayer,Mardy Fish,Leonardo Mayer,W/O,Q,0,0,0,0,0,0,0,0,0,0,0,0,0,0,0,0,0,0,0,0,0,0,0,0,0,0,0
2009-07-27 00:00:00.000,Los Angeles CA; U.S.A. ATP World Tour 250,HARD,2,Sam Querrey,Tommy Haas,Sam Querrey,6-3; 7-5,S,90,8,2,44,71,34,44,16,27,5,5,11,50,71,2,3,35,64,26,35,13,29,4,6,10,39,64
2009-07-27 00:00:00.000,Los Angeles CA; U.S.A. ATP World Tour 250,HARD,2,Carsten Ball,Leonardo Mayer,Carsten Ball,7-5; 7-6(3),S,92,10,4,38,75,32,38,21,37,3,4,12,53,75,6,3,46,75,34,46,15,29,2,4,12,49,75
2009-07-27 00:00:00.000,Los Angeles CA; U.S.A. ATP World Tour 250,HARD,2,Sam Querrey,Carsten Ball,Sam Querrey,6-4; 3-6; 6-1,F,88,11,3,46,81,36,46,17,35,2,4,13,53,81,11,3,43,78,33,43,15,35,3,7,13,48,78
2009-07-27 00:00:00.000,Umag Croatia ATP World Tour 250,CLAY,2,Nikolay Davydenko,Daniel Gimeno-Traver,Nikolay Davydenko,6-2; 6-2,R32,76,1,0,34,46,24,34,9,12,0,0,8,33,46,1,3,29,60,20,29,10,31,4,8,8,30,60
2009-07-27 00:00:00.000,Umag Croatia ATP World Tour 250,CLAY,2,Alberto Martin,Martin Klizan,Alberto Martin,6-4; 6-4,R32,109,0,1,43,74,26,43,16,31,7,10,10,42,74,2,3,28,63,18,28,13,35,4,9,10,31,63
2009-07-27 00:00:00.000,Umag Croatia ATP World Tour 250,CLAY,2,Simone Bolelli,Ruben Ramirez Hidalgo,Simone Bolelli,7-6(7); 3-6; 6-0,R32,155,5,4,65,100,48,65,15,35,7,10,14,63,100,3,6,66,109,42,66,21,43,12,16,13,63,109
2009-07-27 00:00:00.000,Umag Croatia ATP World Tour 250,CLAY,2,Fabio Fognini,Mischa Zverev,Fabio Fognini,2-6; 6-3; 6-4,R32,114,4,5,54,83,43,54,13,29,5,8,14,56,83,2,1,57,94,39,57,16,37,8,11,13,55,94
2009-07-27 00:00:00.000,Umag Croatia ATP World Tour 250,CLAY,2,Jurgen Melzer,Brian Dabul,Jurgen Melzer,6-3; 7-5,R32,89,3,2,34,61,28,34,13,27,2,3,10,41,61,0,1,43,65,27,43,10,22,5,9,11,37,65
2009-07-27 00:00:00.000,Umag Croatia ATP World Tour 250,CLAY,2,Pablo Cuevas,Ivan Dodig,Pablo Cuevas,6-3; 6-1,R32,78,4,2,27,46,21,27,9,19,0,1,8,30,46,4,0,26,55,16,26,9,29,5,10,8,25,55
2009-07-27 00:00:00.000,Umag Croatia ATP World Tour 250,CLAY,2,Ivan Ljubicic,Filippo Volandri,Ivan Ljubicic,6-1; 6-4,R32,64,7,0,26,56,23,26,15,30,6,7,9,38,56,0,2,35,45,20,35,3,10,3,7,8,23,45
2009-07-27 00:00:00.000,Umag Croatia ATP World Tour 250,CLAY,2,Nicolas Almagro,Marcel Granollers,Nicolas Almagro,6-1; 6-3,R32,66,3,3,31,51,23,31,8,20,4,6,8,31,51,1,3,24,48,10,24,8,24,0,6,8,18,48
2009-07-27 00:00:00.000,Umag Croatia ATP World Tour 250,CLAY,2,Juan Carlos Ferrero,Christophe Rochus,Juan Carlos Ferrero,6-2; 6-3,R32,71,6,0,42,62,28,42,10,20,5,6,8,38,62,0,2,21,48,11,21,11,27,2,7,9,22,48
2009-07-27 00:00:00.000,Umag Croatia ATP World Tour 250,CLAY,2,Potito Starace,Grega Zemlja,Potito Starace,6-1; 6-3,R32,67,0,0,40,51,28,40,7,11,2,3,8,35,51,2,5,25,47,15,25,8,22,3,7,7,23,47
2009-07-27 00:00:00.000,Umag Croatia ATP World Tour 250,CLAY,2,Oscar Hernandez,Sergiy Stakhovsky,Oscar Hernandez,7-6(3); 6-1,R32,91,1,0,46,61,35,46,10,15,2,3,10,45,61,4,3,41,64,26,41,9,23,3,6,9,35,64
2009-07-27 00:00:00.000,Umag Croatia ATP World Tour 250,CLAY,2,Maximo Gonzalez,Viktor Troicki,Maximo Gonzalez,6-4; 3-6; 7-6(6),R32,179,1,7,61,108,43,61,19,47,7,11,15,62,108,7,4,75,130,49,75,27,55,13,17,16,76,130
2009-07-27 00:00:00.000,Umag Croatia ATP World Tour 250,CLAY,2,Andreas Seppi,Juan Ignacio Chela,Andreas Seppi,6-4; 2-6; 6-3,R32,128,2,2,68,109,45,68,18,41,10,14,14,63,109,2,1,53,85,34,53,14,32,8,12,13,48,85
2009-07-27 00:00:00.000,Umag Croatia ATP World Tour 250,CLAY,2,Frederico Gil,Sergio Roitman,Frederico Gil,7-5; 6-2,R32,81,2,0,31,50,23,31,11,19,1,3,10,34,50,0,3,39,63,24,39,6,24,3,8,10,30,63
2009-07-27 00:00:00.000,Umag Croatia ATP World Tour 250,CLAY,2,Nicolas Massu,Blaz Kavcic,Nicolas Massu,5-7; 6-3; 6-2,R32,164,4,4,58,86,38,58,15,28,3,7,15,53,86,3,1,70,92,41,70,8,22,6,12,14,49,92
2009-07-27 00:00:00.000,Umag Croatia ATP World Tour 250,CLAY,2,David Ferrer,Daniel Koellerer,David Ferrer,6-1; 6-7(2); 6-3,R32,147,4,4,60,100,38,60,23,40,4,8,15,61,100,2,3,45,79,24,45,17,34,2,9,13,41,79
2009-07-27 00:00:00.000,Umag Croatia ATP World Tour 250,CLAY,2,Nikolay Davydenko,Alberto Martin,Nikolay Davydenko,6-2; 6-3,R16,69,0,1,38,48,29,38,6,10,1,2,9,35,48,0,2,29,47,15,29,8,18,3,7,8,23,47
2009-07-27 00:00:00.000,Umag Croatia ATP World Tour 250,CLAY,2,Simone Bolelli,Fabio Fognini,Simone Bolelli,6-3; 6-4,R16,96,1,1,46,78,30,46,19,32,9,10,10,49,78,5,3,26,53,16,26,16,27,4,7,9,32,53
2009-07-27 00:00:00.000,Umag Croatia ATP World Tour 250,CLAY,2,Jurgen Melzer,Pablo Cuevas,Jurgen Melzer,6-4; 6-3,R16,81,7,3,36,63,29,36,13,27,0,1,10,42,63,6,2,28,55,18,28,14,27,2,5,9,32,55
2009-07-27 00:00:00.000,Umag Croatia ATP World Tour 250,CLAY,2,Ivan Ljubicic,Nicolas Almagro,Ivan Ljubicic,7-5; 7-6(2),R16,121,14,1,53,101,43,53,23,48,8,8,12,66,101,4,0,44,76,31,44,18,32,0,1,12,49,76
2009-07-27 00:00:00.000,Umag Croatia ATP World Tour 250,CLAY,2,Juan Carlos Ferrero,Potito Starace,Juan Carlos Ferrero,1-6; 6-3; 6-2,R16,113,1,1,60,79,40,60,9,19,7,10,12,49,79,2,1,61,80,38,61,9,19,6,10,12,47,80
2009-07-27 00:00:00.000,Umag Croatia ATP World Tour 250,CLAY,2,Maximo Gonzalez,Oscar Hernandez,Maximo Gonzalez,6-4; 6-4,R16,108,1,3,37,59,21,37,9,22,2,6,10,30,59,1,2,48,72,25,48,10,24,9,15,10,35,72
2009-07-27 00:00:00.000,Umag Croatia ATP World Tour 250,CLAY,2,Andreas Seppi,Frederico Gil,Andreas Seppi,7-5; 7-6(5),R16,118,7,2,45,80,32,45,18,35,7,10,12,50,80,2,4,36,75,21,36,19,39,1,5,12,40,75
2009-07-27 00:00:00.000,Umag Croatia ATP World Tour 250,CLAY,2,Nicolas Massu,David Ferrer,Nicolas Massu,4-6; 6-2; 6-4,R16,137,5,5,52,78,35,52,10,26,1,5,14,45,78,4,3,54,83,33,54,12,29,5,11,14,45,83
2009-07-27 00:00:00.000,Umag Croatia ATP World Tour 250,CLAY,2,Nikolay Davydenko,Simone Bolelli,Nikolay Davydenko,7-6(10); 6-1,Q,112,7,3,42,79,28,42,22,37,3,5,10,50,79,5,1,46,80,26,46,16,34,7,11,9,42,80
2009-07-27 00:00:00.000,Umag Croatia ATP World Tour 250,CLAY,2,Jurgen Melzer,Ivan Ljubicic,Jurgen Melzer,4-6; 7-6(3); 6-3,Q,148,3,2,68,109,53,68,20,41,6,8,16,73,109,10,1,53,96,40,53,24,43,6,8,15,64,96
2009-07-27 00:00:00.000,Umag Croatia ATP World Tour 250,CLAY,2,Juan Carlos Ferrero,Maximo Gonzalez,Juan Carlos Ferrero,7-5; 6-2,Q,101,5,2,41,58,30,41,10,17,1,2,10,40,58,1,3,34,59,21,34,11,25,3,7,10,32,59
2009-07-27 00:00:00.000,Umag Croatia ATP World Tour 250,CLAY,2,Andreas Seppi,Nicolas Massu,Andreas Seppi,6-4; 6-4,Q,95,6,2,35,58,27,35,13,23,0,2,10,40,58,3,2,36,68,22,36,16,32,6,10,10,38,68
2009-07-27 00:00:00.000,Umag Croatia ATP World Tour 250,CLAY,2,Nikolay Davydenko,Jurgen Melzer,Nikolay Davydenko,6-1; 6-1,S,51,2,0,28,32,25,28,3,4,0,0,7,28,32,0,0,25,45,12,25,6,20,4,9,7,18,45
2009-07-27 00:00:00.000,Umag Croatia ATP World Tour 250,CLAY,2,Juan Carlos Ferrero,Andreas Seppi,Juan Carlos Ferrero,6-1; 6-7(1); 7-5,S,158,2,2,54,98,40,54,26,44,5,6,16,66,98,3,2,54,100,38,54,21,46,4,8,15,59,100
2009-07-27 00:00:00.000,Umag Croatia ATP World Tour 250,CLAY,2,Nikolay Davydenko,Juan Carlos Ferrero,Nikolay Davydenko,6-3; 6-0,F,71,4,4,28,43,23,28,6,15,1,2,7,29,43,0,0,39,54,14,39,8,15,4,10,8,22,54
2009-08-02 00:00:00.000,Washington DC; USA ATP World Tour 500,HARD,2,Andy Roddick,N/A Bye,Andy Roddick,,R64,0,0,0,0,0,0,0,0,0,0,0,0,0,0,0,0,0,0,0,0,0,0,0,0,0,0,0
2009-08-02 00:00:00.000,Washington DC; USA ATP World Tour 500,HARD,2,Benjamin Becker,Robby Ginepri,Benjamin Becker,7-6(3); 6-7(1); 7-6(4),R64,130,27,7,66,118,60,66,24,52,3,5,18,84,118,13,4,63,102,54,63,23,39,1,3,18,77,102
2009-08-02 00:00:00.000,Washington DC; USA ATP World Tour 500,HARD,2,Igor Kunitsyn,Frederico Gil,Igor Kunitsyn,7-6(1); 6-4,R64,77,4,0,35,71,31,35,21,36,2,2,11,52,71,1,2,38,60,29,38,14,22,1,2,11,43,60
2009-08-02 00:00:00.000,Washington DC; USA ATP World Tour 500,HARD,2,Sam Querrey,N/A Bye,Sam Querrey,,R64,0,0,0,0,0,0,0,0,0,0,0,0,0,0,0,0,0,0,0,0,0,0,0,0,0,0,0
2009-08-02 00:00:00.000,Washington DC; USA ATP World Tour 500,HARD,2,Ivo Karlovic,N/A Bye,Ivo Karlovic,,R64,0,0,0,0,0,0,0,0,0,0,0,0,0,0,0,0,0,0,0,0,0,0,0,0,0,0,0
2009-08-02 00:00:00.000,Washington DC; USA ATP World Tour 500,HARD,2,Rainer Schuettler,Leonardo Mayer,Rainer Schuettler,6-1; 3-6; 7-6(5),R64,128,5,1,57,93,40,57,22,36,5,7,14,62,93,4,2,48,88,36,48,21,40,4,7,14,57,88
2009-08-02 00:00:00.000,Washington DC; USA ATP World Tour 500,HARD,2,Somdev Devvarman,Yuichi Sugita,Somdev Devvarman,6-0; 7-6(6),R64,86,1,0,39,59,30,39,9,20,0,2,9,39,59,1,4,28,57,18,28,10,29,3,8,9,28,57
2009-08-02 00:00:00.000,Washington DC; USA ATP World Tour 500,HARD,2,Marin Cilic,N/A Bye,Marin Cilic,,R64,0,0,0,0,0,0,0,0,0,0,0,0,0,0,0,0,0,0,0,0,0,0,0,0,0,0,0
2009-08-02 00:00:00.000,Washington DC; USA ATP World Tour 500,HARD,2,Jo-Wilfried Tsonga,N/A Bye,Jo-Wilfried Tsonga,,R64,0,0,0,0,0,0,0,0,0,0,0,0,0,0,0,0,0,0,0,0,0,0,0,0,0,0,0
2009-08-02 00:00:00.000,Washington DC; USA ATP World Tour 500,HARD,2,John Isner,Andrey Golubev,John Isner,7-6(8); 6-3,R64,79,4,1,47,61,41,47,10,14,0,0,11,51,61,3,1,39,69,30,39,17,30,1,2,10,47,69
2009-08-02 00:00:00.000,Washington DC; USA ATP World Tour 500,HARD,2,Sebastien De Chaunac,Denis Istomin,Sebastien De Chaunac,6-3; 7-6(7),R64,120,15,4,49,94,38,49,16,45,8,12,11,54,94,5,2,41,69,27,41,9,28,3,8,10,36,69
2009-08-02 00:00:00.000,Washington DC; USA ATP World Tour 500,HARD,2,Dmitry Tursunov,N/A Bye,Dmitry Tursunov,,R64,0,0,0,0,0,0,0,0,0,0,0,0,0,0,0,0,0,0,0,0,0,0,0,0,0,0,0
2009-08-02 00:00:00.000,Washington DC; USA ATP World Tour 500,HARD,2,Mardy Fish,N/A Bye,Mardy Fish,,R64,0,0,0,0,0,0,0,0,0,0,0,0,0,0,0,0,0,0,0,0,0,0,0,0,0,0,0
2009-08-02 00:00:00.000,Washington DC; USA ATP World Tour 500,HARD,2,Philipp Petzschner,Teymuraz Gabashvili,Philipp Petzschner,4-6; 6-3; 6-4,R64,119,7,5,47,90,41,47,19,43,5,7,15,60,90,6,15,41,97,30,41,27,56,4,7,14,57,97
2009-08-02 00:00:00.000,Washington DC; USA ATP World Tour 500,HARD,2,Ernests Gulbis,Kevin Kim,Ernests Gulbis,7-5; 3-6; 6-3,R64,110,9,6,52,86,37,52,17,34,0,3,15,54,86,5,3,48,94,35,48,24,46,3,7,15,59,94
2009-08-02 00:00:00.000,Washington DC; USA ATP World Tour 500,HARD,2,Tomas Berdych,N/A Bye,Tomas Berdych,,R64,0,0,0,0,0,0,0,0,0,0,0,0,0,0,0,0,0,0,0,0,0,0,0,0,0,0,0
2009-08-02 00:00:00.000,Washington DC; USA ATP World Tour 500,HARD,2,Tommy Robredo,N/A Bye,Tommy Robredo,,R64,0,0,0,0,0,0,0,0,0,0,0,0,0,0,0,0,0,0,0,0,0,0,0,0,0,0,0
2009-08-02 00:00:00.000,Washington DC; USA ATP World Tour 500,HARD,2,Juan Carlos Ferrero,Nicolas Lapentti,Juan Carlos Ferrero,6-4; 6-7(5); 6-0,R64,150,2,4,61,106,50,61,21,45,8,8,14,71,106,10,1,54,89,38,54,19,35,2,6,14,57,89
2009-08-02 00:00:00.000,Washington DC; USA ATP World Tour 500,HARD,2,Frank Dancevic,Santiago Giraldo,Frank Dancevic,6-4; 6-3,R64,68,11,1,31,51,25,31,15,20,0,0,10,40,51,3,1,40,63,25,40,13,23,5,7,9,38,63
2009-08-02 00:00:00.000,Washington DC; USA ATP World Tour 500,HARD,2,Tommy Haas,N/A Bye,Tommy Haas,,R64,0,0,0,0,0,0,0,0,0,0,0,0,0,0,0,0,0,0,0,0,0,0,0,0,0,0,0
2009-08-02 00:00:00.000,Washington DC; USA ATP World Tour 500,HARD,2,Igor Andreev,N/A Bye,Igor Andreev,,R64,0,0,0,0,0,0,0,0,0,0,0,0,0,0,0,0,0,0,0,0,0,0,0,0,0,0,0
2009-08-02 00:00:00.000,Washington DC; USA ATP World Tour 500,HARD,2,Wayne Odesnik,Paul Capdeville,Wayne Odesnik,4-6; 6-2; 6-4,R64,127,9,1,43,79,30,43,20,36,7,11,14,50,79,4,7,51,88,30,51,17,37,10,16,14,47,88
2009-08-02 00:00:00.000,Washington DC; USA ATP World Tour 500,HARD,2,Alejandro Falla,Jesse Witten,Alejandro Falla,6-1; 6-4,R64,60,1,1,31,53,22,31,11,22,4,6,9,33,53,2,3,23,42,11,23,8,19,2,7,8,19,42
2009-08-02 00:00:00.000,Washington DC; USA ATP World Tour 500,HARD,2,Fernando Gonzalez,N/A Bye,Fernando Gonzalez,,R64,0,0,0,0,0,0,0,0,0,0,0,0,0,0,0,0,0,0,0,0,0,0,0,0,0,0,0
2009-08-02 00:00:00.000,Washington DC; USA ATP World Tour 500,HARD,2,Robin Soderling,N/A Bye,Robin Soderling,,R64,0,0,0,0,0,0,0,0,0,0,0,0,0,0,0,0,0,0,0,0,0,0,0,0,0,0,0
2009-08-02 00:00:00.000,Washington DC; USA ATP World Tour 500,HARD,2,Mikhail Youzhny,Robert Kendrick,Mikhail Youzhny,7-5; 3-6; 6-1,R64,101,11,6,45,82,36,45,18,37,1,3,14,54,82,7,4,34,70,27,34,19,36,2,6,14,46,70
2009-08-02 00:00:00.000,Washington DC; USA ATP World Tour 500,HARD,2,Marc Gicquel,Jerzy Janowicz,Marc Gicquel,7-5; 2-6; 6-4,R64,118,6,4,49,93,34,49,23,44,2,5,15,57,93,9,1,40,81,30,40,22,41,1,4,15,52,81
2009-08-02 00:00:00.000,Washington DC; USA ATP World Tour 500,HARD,2,Viktor Troicki,N/A Bye,Viktor Troicki,,R64,0,0,0,0,0,0,0,0,0,0,0,0,0,0,0,0,0,0,0,0,0,0,0,0,0,0,0
2009-08-02 00:00:00.000,Washington DC; USA ATP World Tour 500,HARD,2,Dudi Sela,N/A Bye,Dudi Sela,,R64,0,0,0,0,0,0,0,0,0,0,0,0,0,0,0,0,0,0,0,0,0,0,0,0,0,0,0
2009-08-02 00:00:00.000,Washington DC; USA ATP World Tour 500,HARD,2,Lleyton Hewitt,Donald Young,Lleyton Hewitt,7-5; 6-2,R64,94,4,2,27,70,22,27,17,43,8,11,10,39,70,4,5,23,64,17,23,14,41,4,10,10,31,64
2009-08-02 00:00:00.000,Washington DC; USA ATP World Tour 500,HARD,2,Yen-Hsun Lu,Michael Russell,Yen-Hsun Lu,4-6; 6-1; 7-5,R64,167,3,5,61,119,45,61,22,58,14,18,14,67,119,4,5,67,99,39,67,12,32,6,13,15,51,99
2009-08-02 00:00:00.000,Washington DC; USA ATP World Tour 500,HARD,2,Juan Martin Del Potro,N/A Bye,Juan Martin Del Potro,,R64,0,0,0,0,0,0,0,0,0,0,0,0,0,0,0,0,0,0,0,0,0,0,0,0,0,0,0
2009-08-02 00:00:00.000,Washington DC; USA ATP World Tour 500,HARD,2,Andy Roddick,Benjamin Becker,Andy Roddick,6-3; 6-2,R32,55,8,0,27,46,22,27,15,19,0,0,9,37,46,5,2,21,39,14,21,10,18,1,4,8,24,39
2009-08-02 00:00:00.000,Washington DC; USA ATP World Tour 500,HARD,2,Sam Querrey,Igor Kunitsyn,Sam Querrey,6-3; 6-4,R32,67,6,2,34,48,29,34,9,14,0,1,10,38,48,2,2,37,68,23,37,16,31,9,12,9,39,68
2009-08-02 00:00:00.000,Washington DC; USA ATP World Tour 500,HARD,2,Ivo Karlovic,Rainer Schuettler,Ivo Karlovic,6-4; 7-5,R32,76,18,2,34,55,29,34,13,21,0,1,11,42,55,3,1,43,62,30,43,12,19,2,5,11,42,62
2009-08-02 00:00:00.000,Washington DC; USA ATP World Tour 500,HARD,2,Somdev Devvarman,Marin Cilic,Somdev Devvarman,7-5; 6-4,R32,102,1,1,38,61,28,38,13,23,5,7,11,41,61,8,4,41,76,25,41,19,35,3,7,11,44,76
2009-08-02 00:00:00.000,Washington DC; USA ATP World Tour 500,HARD,2,John Isner,Jo-Wilfried Tsonga,John Isner,4-6; 7-6(2); 7-6(4),R32,169,20,4,73,110,57,73,23,37,6,7,17,80,110,8,5,60,111,52,60,29,51,6,6,17,81,111
2009-08-02 00:00:00.000,Washington DC; USA ATP World Tour 500,HARD,2,Sebastien De Chaunac,Dmitry Tursunov,Sebastien De Chaunac,3-6; 7-6(3); 7-5,R32,160,6,5,61,122,39,61,28,61,6,13,17,67,122,6,4,54,100,39,54,16,46,8,14,16,55,100
2009-08-02 00:00:00.000,Washington DC; USA ATP World Tour 500,HARD,2,Philipp Petzschner,Mardy Fish,Philipp Petzschner,1-6; 6-4; 6-1,R32,92,9,5,33,74,26,33,22,41,1,3,12,48,74,7,9,36,72,29,36,16,36,2,5,12,45,72
2009-08-02 00:00:00.000,Washington DC; USA ATP World Tour 500,HARD,2,Tomas Berdych,Ernests Gulbis,Tomas Berdych,6-2; 7-6(6),R32,95,8,5,44,86,34,44,21,42,12,13,10,55,86,5,1,34,62,23,34,16,28,0,3,10,39,62
2009-08-02 00:00:00.000,Washington DC; USA ATP World Tour 500,HARD,2,Juan Carlos Ferrero,Tommy Robredo,Juan Carlos Ferrero,6-3; 6-2,R32,79,3,0,36,55,26,36,14,19,3,3,9,40,55,1,0,32,50,21,32,8,18,4,7,8,29,50
2009-08-02 00:00:00.000,Washington DC; USA ATP World Tour 500,HARD,2,Tommy Haas,Frank Dancevic,Tommy Haas,6-1; 4-6; 6-4,R32,116,12,9,43,97,34,43,28,54,7,9,14,62,97,8,2,48,76,31,48,15,28,6,10,13,46,76
2009-08-02 00:00:00.000,Washington DC; USA ATP World Tour 500,HARD,2,Wayne Odesnik,Igor Andreev,Wayne Odesnik,2-6; 7-5; 6-4,R32,151,8,7,68,103,41,68,12,35,5,12,15,53,103,10,9,52,95,32,52,17,43,7,14,15,49,95
2009-08-02 00:00:00.000,Washington DC; USA ATP World Tour 500,HARD,2,Fernando Gonzalez,Alejandro Falla,Fernando Gonzalez,7-5; 7-5,R32,85,7,6,39,75,29,39,16,36,8,11,12,45,75,2,3,37,63,25,37,9,26,0,5,12,34,63
2009-08-02 00:00:00.000,Washington DC; USA ATP World Tour 500,HARD,2,Robin Soderling,Mikhail Youzhny,Robin Soderling,6-3; 6-1,R32,63,4,0,31,50,25,31,11,19,4,4,8,36,50,1,0,30,50,19,30,6,20,2,6,8,25,50
2009-08-02 00:00:00.000,Washington DC; USA ATP World Tour 500,HARD,2,Marc Gicquel,Viktor Troicki,Marc Gicquel,3-0 RET,R32,16,1,0,3,8,3,3,5,5,0,0,2,8,8,2,2,2,16,2,2,5,14,1,2,1,7,16
2009-08-02 00:00:00.000,Washington DC; USA ATP World Tour 500,HARD,2,Lleyton Hewitt,Dudi Sela,Lleyton Hewitt,6-3; 2-6; 6-2,R32,116,8,5,44,82,30,44,21,38,5,8,13,51,82,3,3,45,85,25,45,24,40,4,8,12,49,85
2009-08-02 00:00:00.000,Washington DC; USA ATP World Tour 500,HARD,2,Juan Martin Del Potro,Yen-Hsun Lu,Juan Martin Del Potro,4-6; 6-3; 6-2,R32,111,11,6,48,84,37,48,22,36,1,2,14,59,84,5,2,45,75,32,45,14,30,5,8,13,46,75
2009-08-02 00:00:00.000,Washington DC; USA ATP World Tour 500,HARD,2,Andy Roddick,Sam Querrey,Andy Roddick,7-6(4); 6-4,R16,95,3,6,51,77,36,51,14,26,7,9,11,50,77,11,1,39,68,30,39,12,29,2,5,11,42,68
2009-08-02 00:00:00.000,Washington DC; USA ATP World Tour 500,HARD,2,Ivo Karlovic,Somdev Devvarman,Ivo Karlovic,7-5; 6-1,R16,64,14,1,29,46,26,29,14,17,0,0,10,40,46,2,0,36,51,23,36,7,15,2,5,9,30,51
2009-08-02 00:00:00.000,Washington DC; USA ATP World Tour 500,HARD,2,John Isner,Sebastien De Chaunac,John Isner,6-2; 6-4,R16,80,3,2,31,47,23,31,13,16,0,0,9,36,47,2,5,31,70,25,31,14,39,1,4,9,39,70
2009-08-02 00:00:00.000,Washington DC; USA ATP World Tour 500,HARD,2,Tomas Berdych,Philipp Petzschner,Tomas Berdych,4-6; 6-3; 6-3,R16,109,6,2,40,77,24,40,22,37,5,9,14,46,77,11,5,49,86,32,49,14,37,3,9,14,46,86
2009-08-02 00:00:00.000,Washington DC; USA ATP World Tour 500,HARD,2,Tommy Haas,Juan Carlos Ferrero,Tommy Haas,7-5; 2-6; 6-1,R16,104,19,5,43,78,36,43,17,35,1,4,14,53,78,3,2,46,72,29,46,16,26,1,5,13,45,72
2009-08-02 00:00:00.000,Washington DC; USA ATP World Tour 500,HARD,2,Fernando Gonzalez,Wayne Odesnik,Fernando Gonzalez,6-2; 6-4,R16,74,7,3,37,68,30,37,13,31,8,9,9,43,68,3,2,33,52,20,33,9,19,4,8,9,29,52
2009-08-02 00:00:00.000,Washington DC; USA ATP World Tour 500,HARD,2,Robin Soderling,Marc Gicquel,Robin Soderling,7-5; 5-7; 6-3,R16,125,15,7,55,96,45,55,21,41,1,3,17,66,96,13,3,59,103,39,59,24,44,7,10,16,63,103
2009-08-02 00:00:00.000,Washington DC; USA ATP World Tour 500,HARD,2,Juan Martin Del Potro,Lleyton Hewitt,Juan Martin Del Potro,4-6; 6-3; 7-6(2),R16,146,18,4,51,96,38,51,27,45,7,10,16,65,96,13,6,49,99,40,49,23,50,6,9,15,63,99
2009-08-02 00:00:00.000,Washington DC; USA ATP World Tour 500,HARD,2,Andy Roddick,Ivo Karlovic,Andy Roddick,7-6(4); 7-6(5),Q,96,7,2,53,72,44,53,10,19,0,2,12,54,72,13,3,44,75,38,44,14,31,1,3,12,52,75
2009-08-02 00:00:00.000,Washington DC; USA ATP World Tour 500,HARD,2,John Isner,Tomas Berdych,John Isner,6-3; 6-7(10); 6-2,Q,149,17,4,69,112,52,69,20,43,7,9,15,72,112,7,8,43,97,33,43,25,54,3,8,14,58,97
2009-08-02 00:00:00.000,Washington DC; USA ATP World Tour 500,HARD,2,Fernando Gonzalez,Tommy Haas,Fernando Gonzalez,7-5; 6-4,Q,83,2,4,36,62,30,36,12,26,2,3,11,42,62,7,6,31,60,23,31,15,29,2,5,11,38,60
2009-08-02 00:00:00.000,Washington DC; USA ATP World Tour 500,HARD,2,Juan Martin Del Potro,Robin Soderling,Juan Martin Del Potro,W/O,Q,0,0,0,0,0,0,0,0,0,0,0,0,0,0,0,0,0,0,0,0,0,0,0,0,0,0,0
2009-08-02 00:00:00.000,Washington DC; USA ATP World Tour 500,HARD,2,Andy Roddick,John Isner,Andy Roddick,6-7(3); 6-2; 7-5,S,151,9,1,57,83,51,57,18,26,2,2,16,69,83,20,0,67,116,48,67,25,49,7,10,16,73,116
2009-08-02 00:00:00.000,Washington DC; USA ATP World Tour 500,HARD,2,Juan Martin Del Potro,Fernando Gonzalez,Juan Martin Del Potro,7-6(2); 6-3,S,127,10,7,42,89,32,42,24,47,6,8,11,56,89,5,6,47,83,31,47,16,36,3,6,10,47,83
2009-08-02 00:00:00.000,Washington DC; USA ATP World Tour 500,HARD,2,Juan Martin Del Potro,Andy Roddick,Juan Martin Del Potro,3-6; 7-5; 7-6(6),F,150,19,6,52,95,40,52,24,43,0,3,16,64,95,21,4,70,103,51,70,16,33,2,5,17,67,103
2009-08-10 00:00:00.000,ATP World Tour Masters 1000 Canada MontrTal; Canada ATP World Tour Masters 1000,HARD,2,Roger Federer,N/A Bye,Roger Federer,,R64,0,0,0,0,0,0,0,0,0,0,0,0,0,0,0,0,0,0,0,0,0,0,0,0,0,0,0
2009-08-10 00:00:00.000,ATP World Tour Masters 1000 Canada MontrTal; Canada ATP World Tour Masters 1000,HARD,2,Frederic Niemeyer,Igor Kunitsyn,Frederic Niemeyer,7-5; 6-1,R64,82,7,3,43,67,32,43,12,24,4,5,10,44,67,2,2,37,56,22,37,7,19,1,5,9,29,56
2009-08-10 00:00:00.000,ATP World Tour Masters 1000 Canada MontrTal; Canada ATP World Tour Masters 1000,HARD,2,Stanislas Wawrinka,Nicolas Kiefer,Stanislas Wawrinka,6-4; 6-1,R64,86,4,2,17,41,17,17,15,24,0,0,8,32,41,6,6,37,73,24,37,14,36,5,9,9,38,73
2009-08-10 00:00:00.000,ATP World Tour Masters 1000 Canada MontrTal; Canada ATP World Tour Masters 1000,HARD,2,Andrey Golubev,Radek Stepanek,Andrey Golubev,6-3; 6-4,R64,75,2,1,39,56,31,39,9,17,0,1,10,40,56,2,0,34,50,21,34,8,16,1,4,9,29,50
2009-08-10 00:00:00.000,ATP World Tour Masters 1000 Canada MontrTal; Canada ATP World Tour Masters 1000,HARD,2,Gilles Simon,Frank Dancevic,Gilles Simon,6-1; 6-2,R64,61,3,0,19,40,14,19,15,21,0,1,8,29,40,4,0,31,50,19,31,3,19,1,6,7,22,50
2009-08-10 00:00:00.000,ATP World Tour Masters 1000 Canada MontrTal; Canada ATP World Tour Masters 1000,HARD,2,Alejandro Falla,Dudi Sela,Alejandro Falla,6-4; 3-6; 6-3,R64,124,4,5,55,104,38,55,27,49,9,12,14,65,104,2,4,51,88,29,51,22,37,6,10,14,51,88
2009-08-10 00:00:00.000,ATP World Tour Masters 1000 Canada MontrTal; Canada ATP World Tour Masters 1000,HARD,2,Rainer Schuettler,Florent Serra,Rainer Schuettler,6-4; 6-0,R64,65,8,1,30,48,21,30,13,18,3,4,8,34,48,0,0,31,59,18,31,9,28,3,8,8,27,59
2009-08-10 00:00:00.000,ATP World Tour Masters 1000 Canada MontrTal; Canada ATP World Tour Masters 1000,HARD,2,Jo-Wilfried Tsonga,N/A Bye,Jo-Wilfried Tsonga,,R64,0,0,0,0,0,0,0,0,0,0,0,0,0,0,0,0,0,0,0,0,0,0,0,0,0,0,0
2009-08-10 00:00:00.000,ATP World Tour Masters 1000 Canada MontrTal; Canada ATP World Tour Masters 1000,HARD,2,Andy Murray,N/A Bye,Andy Murray,,R64,0,0,0,0,0,0,0,0,0,0,0,0,0,0,0,0,0,0,0,0,0,0,0,0,0,0,0
2009-08-10 00:00:00.000,ATP World Tour Masters 1000 Canada MontrTal; Canada ATP World Tour Masters 1000,HARD,2,Jeremy Chardy,Yen-Hsun Lu,Jeremy Chardy,6-7(5); 6-3; 6-4,R64,172,17,6,57,99,48,57,20,42,5,7,15,68,99,4,4,68,109,44,68,21,41,6,11,16,65,109
2009-08-10 00:00:00.000,ATP World Tour Masters 1000 Canada MontrTal; Canada ATP World Tour Masters 1000,HARD,2,Juan Carlos Ferrero,Lleyton Hewitt,Juan Carlos Ferrero,6-1; 6-4,R64,77,6,2,32,50,23,32,12,18,0,1,9,35,50,2,0,29,53,19,29,8,24,4,8,8,27,53
2009-08-10 00:00:00.000,ATP World Tour Masters 1000 Canada MontrTal; Canada ATP World Tour Masters 1000,HARD,2,Gael Monfils,Marat Safin,Gael Monfils,6-2; 3-6; 6-2,R64,109,10,1,48,73,36,48,14,25,0,2,12,50,73,7,5,49,96,33,49,20,47,8,13,13,53,96
2009-08-10 00:00:00.000,ATP World Tour Masters 1000 Canada MontrTal; Canada ATP World Tour Masters 1000,HARD,2,Fernando Gonzalez,Milos Raonic,Fernando Gonzalez,4-6; 7-6(6); 6-4,R64,136,10,4,71,109,51,71,22,38,4,5,16,73,109,20,3,64,110,55,64,21,46,6,7,16,76,110
2009-08-10 00:00:00.000,ATP World Tour Masters 1000 Canada MontrTal; Canada ATP World Tour Masters 1000,HARD,2,Tommy Haas,Ivo Karlovic,Tommy Haas,4-6; 7-6(3); 6-4,R64,121,7,6,63,92,50,63,20,29,3,4,16,70,92,19,4,45,91,41,45,25,46,2,3,16,66,91
2009-08-10 00:00:00.000,ATP World Tour Masters 1000 Canada MontrTal; Canada ATP World Tour Masters 1000,HARD,2,Paul-Henri Mathieu,Guillermo Garcia-Lopez,Paul-Henri Mathieu,7-5; 0-6; 6-1,R64,115,9,5,36,81,28,36,23,45,4,7,13,51,81,5,2,42,65,28,42,14,23,0,3,12,42,65
2009-08-10 00:00:00.000,ATP World Tour Masters 1000 Canada MontrTal; Canada ATP World Tour Masters 1000,HARD,2,Nikolay Davydenko,N/A Bye,Nikolay Davydenko,,R64,0,0,0,0,0,0,0,0,0,0,0,0,0,0,0,0,0,0,0,0,0,0,0,0,0,0,0
2009-08-10 00:00:00.000,ATP World Tour Masters 1000 Canada MontrTal; Canada ATP World Tour Masters 1000,HARD,2,Andy Roddick,N/A Bye,Andy Roddick,,R64,0,0,0,0,0,0,0,0,0,0,0,0,0,0,0,0,0,0,0,0,0,0,0,0,0,0,0
2009-08-10 00:00:00.000,ATP World Tour Masters 1000 Canada MontrTal; Canada ATP World Tour Masters 1000,HARD,2,Igor Andreev,Dmitry Tursunov,Igor Andreev,5-5 RET,R64,37,4,1,15,24,12,15,6,9,1,2,5,18,24,4,2,12,30,10,12,8,18,0,1,5,18,30
2009-08-10 00:00:00.000,ATP World Tour Masters 1000 Canada MontrTal; Canada ATP World Tour Masters 1000,HARD,2,Leonardo Mayer,Mischa Zverev,Leonardo Mayer,7-6(6); 6-3,R64,105,6,1,49,79,38,49,13,30,3,4,10,51,79,6,0,64,84,40,64,7,20,6,9,11,47,84
2009-08-10 00:00:00.000,ATP World Tour Masters 1000 Canada MontrTal; Canada ATP World Tour Masters 1000,HARD,2,Fernando Verdasco,Feliciano Lopez,Fernando Verdasco,6-1; 6-7(5); 6-1,R64,109,14,8,61,83,48,61,11,22,2,3,14,59,83,12,2,60,88,42,60,8,28,5,10,12,50,88
2009-08-10 00:00:00.000,ATP World Tour Masters 1000 Canada MontrTal; Canada ATP World Tour Masters 1000,HARD,2,Mikhail Youzhny,Marin Cilic,Mikhail Youzhny,4-6; 7-6(4); 6-1,R64,147,4,10,60,107,43,60,24,47,5,9,15,67,107,6,5,46,92,28,46,22,46,2,7,14,50,92
2009-08-10 00:00:00.000,ATP World Tour Masters 1000 Canada MontrTal; Canada ATP World Tour Masters 1000,HARD,2,John Isner,Jesse Levine,John Isner,6-3; 6-4,R64,71,10,1,36,58,26,36,17,22,3,3,10,43,58,5,6,36,54,29,36,6,18,5,7,9,35,54
2009-08-10 00:00:00.000,ATP World Tour Masters 1000 Canada MontrTal; Canada ATP World Tour Masters 1000,HARD,2,Peter Polansky,Bruno Agostinelli,Peter Polansky,6-3; 7-6(6),R64,105,5,2,44,75,33,44,19,31,4,5,11,52,75,4,3,42,69,30,42,13,27,8,10,10,43,69
2009-08-10 00:00:00.000,ATP World Tour Masters 1000 Canada MontrTal; Canada ATP World Tour Masters 1000,HARD,2,Novak Djokovic,N/A Bye,Novak Djokovic,,R64,0,0,0,0,0,0,0,0,0,0,0,0,0,0,0,0,0,0,0,0,0,0,0,0,0,0,0
2009-08-10 00:00:00.000,ATP World Tour Masters 1000 Canada MontrTal; Canada ATP World Tour Masters 1000,HARD,2,Juan Martin Del Potro,N/A Bye,Juan Martin Del Potro,,R64,0,0,0,0,0,0,0,0,0,0,0,0,0,0,0,0,0,0,0,0,0,0,0,0,0,0,0
2009-08-10 00:00:00.000,ATP World Tour Masters 1000 Canada MontrTal; Canada ATP World Tour Masters 1000,HARD,2,Jan Hernych,Julien Benneteau,Jan Hernych,6-2; 6-3,R64,60,3,0,39,44,31,39,3,5,1,1,8,34,44,1,2,36,52,25,36,4,16,5,9,9,29,52
2009-08-10 00:00:00.000,ATP World Tour Masters 1000 Canada MontrTal; Canada ATP World Tour Masters 1000,HARD,2,Victor Hanescu,Jurgen Melzer,Victor Hanescu,6-4; 6-3,R64,85,5,1,55,69,38,55,7,14,5,6,10,45,69,7,1,39,65,28,39,10,26,10,13,9,38,65
2009-08-10 00:00:00.000,ATP World Tour Masters 1000 Canada MontrTal; Canada ATP World Tour Masters 1000,HARD,2,Philipp Kohlschreiber,Tomas Berdych,Philipp Kohlschreiber,7-6(5); 6-7(9); 6-4,R64,176,9,3,57,111,44,57,32,54,2,4,17,76,111,9,5,71,140,47,71,41,69,8,11,17,88,140
2009-08-10 00:00:00.000,ATP World Tour Masters 1000 Canada MontrTal; Canada ATP World Tour Masters 1000,HARD,2,Tommy Robredo,Alex Bogomolov Jr.,Tommy Robredo,6-4; 6-2,R64,75,6,0,29,45,26,29,11,16,0,0,9,37,45,1,1,40,62,24,40,12,22,1,4,9,36,62
2009-08-10 00:00:00.000,ATP World Tour Masters 1000 Canada MontrTal; Canada ATP World Tour Masters 1000,HARD,2,Philipp Petzschner,Sam Querrey,Philipp Petzschner,7-5; 6-3,R64,66,11,0,33,51,29,33,13,18,0,0,10,42,51,9,2,43,70,28,43,12,27,0,3,11,40,70
2009-08-10 00:00:00.000,ATP World Tour Masters 1000 Canada MontrTal; Canada ATP World Tour Masters 1000,HARD,2,David Ferrer,Viktor Troicki,David Ferrer,6-3; 6-0,R64,70,4,1,35,53,25,35,10,18,6,7,8,35,53,4,2,29,59,16,29,10,30,6,11,7,26,59
2009-08-10 00:00:00.000,ATP World Tour Masters 1000 Canada MontrTal; Canada ATP World Tour Masters 1000,HARD,2,Rafael Nadal,N/A Bye,Rafael Nadal,,R64,0,0,0,0,0,0,0,0,0,0,0,0,0,0,0,0,0,0,0,0,0,0,0,0,0,0,0
2009-08-10 00:00:00.000,ATP World Tour Masters 1000 Canada MontrTal; Canada ATP World Tour Masters 1000,HARD,2,Roger Federer,Frederic Niemeyer,Roger Federer,7-6(3); 6-4,R32,86,12,1,46,65,40,46,11,19,1,1,11,51,65,6,5,34,72,28,34,21,38,5,6,11,49,72
2009-08-10 00:00:00.000,ATP World Tour Masters 1000 Canada MontrTal; Canada ATP World Tour Masters 1000,HARD,2,Stanislas Wawrinka,Andrey Golubev,Stanislas Wawrinka,7-5; 6-4,R32,88,2,2,30,58,25,30,21,28,1,1,11,46,58,4,4,42,77,33,42,15,35,7,9,11,48,77
2009-08-10 00:00:00.000,ATP World Tour Masters 1000 Canada MontrTal; Canada ATP World Tour Masters 1000,HARD,2,Gilles Simon,Alejandro Falla,Gilles Simon,4-6; 6-2; 6-2,R32,126,1,3,37,75,32,37,21,38,1,2,13,53,75,0,4,63,96,42,63,14,33,7,11,13,56,96
2009-08-10 00:00:00.000,ATP World Tour Masters 1000 Canada MontrTal; Canada ATP World Tour Masters 1000,HARD,2,Jo-Wilfried Tsonga,Rainer Schuettler,Jo-Wilfried Tsonga,4-6; 6-3; 6-4,R32,128,10,1,59,86,50,59,12,27,3,4,15,62,86,4,6,55,95,41,55,20,40,10,12,14,61,95
2009-08-10 00:00:00.000,ATP World Tour Masters 1000 Canada MontrTal; Canada ATP World Tour Masters 1000,HARD,2,Andy Murray,Jeremy Chardy,Andy Murray,6-4; 6-2,R32,95,9,2,47,72,36,47,11,25,10,10,9,47,72,9,1,50,68,32,50,6,18,5,8,9,38,68
2009-08-10 00:00:00.000,ATP World Tour Masters 1000 Canada MontrTal; Canada ATP World Tour Masters 1000,HARD,2,Juan Carlos Ferrero,Gael Monfils,Juan Carlos Ferrero,6-3; 7-6(7),R32,105,2,2,54,76,38,54,16,22,6,7,11,54,76,11,1,41,66,30,41,10,25,0,2,10,40,66
2009-08-10 00:00:00.000,ATP World Tour Masters 1000 Canada MontrTal; Canada ATP World Tour Masters 1000,HARD,2,Fernando Gonzalez,Tommy Haas,Fernando Gonzalez,7-6(2) RET,R32,66,1,1,30,36,21,30,4,6,0,1,6,25,36,0,4,33,55,22,33,9,22,3,4,6,31,55
2009-08-10 00:00:00.000,ATP World Tour Masters 1000 Canada MontrTal; Canada ATP World Tour Masters 1000,HARD,2,Nikolay Davydenko,Paul-Henri Mathieu,Nikolay Davydenko,7-6(4); 7-6(2),R32,125,5,3,50,79,40,50,18,29,0,1,12,58,79,4,2,46,84,36,46,20,38,3,4,12,56,84
2009-08-10 00:00:00.000,ATP World Tour Masters 1000 Canada MontrTal; Canada ATP World Tour Masters 1000,HARD,2,Andy Roddick,Igor Andreev,Andy Roddick,6-1; 7-6(3),R32,82,8,0,37,57,31,37,14,20,0,0,10,45,57,2,2,30,57,23,30,13,27,3,5,9,36,57
2009-08-10 00:00:00.000,ATP World Tour Masters 1000 Canada MontrTal; Canada ATP World Tour Masters 1000,HARD,2,Fernando Verdasco,Leonardo Mayer,Fernando Verdasco,6-1; 6-1,R32,58,1,1,24,34,19,24,8,10,3,4,7,27,34,1,3,25,47,12,25,5,22,4,10,7,17,47
2009-08-10 00:00:00.000,ATP World Tour Masters 1000 Canada MontrTal; Canada ATP World Tour Masters 1000,HARD,2,Mikhail Youzhny,John Isner,Mikhail Youzhny,6-7(8); 6-1; 6-3,R32,155,4,5,73,111,49,73,24,38,5,6,14,73,111,9,6,75,110,46,75,17,35,6,11,14,63,110
2009-08-10 00:00:00.000,ATP World Tour Masters 1000 Canada MontrTal; Canada ATP World Tour Masters 1000,HARD,2,Novak Djokovic,Peter Polansky,Novak Djokovic,6-4; 7-6(6),R32,119,8,7,47,76,39,47,12,29,4,5,11,51,76,7,3,42,83,30,42,19,41,8,10,11,49,83
2009-08-10 00:00:00.000,ATP World Tour Masters 1000 Canada MontrTal; Canada ATP World Tour Masters 1000,HARD,2,Juan Martin Del Potro,Jan Hernych,Juan Martin Del Potro,6-2; 7-5,R32,88,10,2,35,58,28,35,13,23,2,3,10,41,58,4,1,43,73,28,43,10,30,5,9,10,38,73
2009-08-10 00:00:00.000,ATP World Tour Masters 1000 Canada MontrTal; Canada ATP World Tour Masters 1000,HARD,2,Victor Hanescu,Philipp Kohlschreiber,Victor Hanescu,6-3; 4-6; 7-5,R32,126,6,3,66,104,49,66,15,38,5,8,16,64,104,7,2,68,98,46,68,11,30,13,17,15,57,98
2009-08-10 00:00:00.000,ATP World Tour Masters 1000 Canada MontrTal; Canada ATP World Tour Masters 1000,HARD,2,Philipp Petzschner,Tommy Robredo,Philipp Petzschner,7-6(3); 7-6(4),R32,120,11,2,45,90,35,45,22,45,4,6,12,57,90,1,1,36,71,25,36,20,35,0,2,12,45,71
2009-08-10 00:00:00.000,ATP World Tour Masters 1000 Canada MontrTal; Canada ATP World Tour Masters 1000,HARD,2,Rafael Nadal,David Ferrer,Rafael Nadal,4-3 RET,R32,37,0,1,16,34,10,16,9,18,7,8,3,19,34,2,2,14,21,10,14,1,7,1,3,4,11,21
2009-08-10 00:00:00.000,ATP World Tour Masters 1000 Canada MontrTal; Canada ATP World Tour Masters 1000,HARD,2,Roger Federer,Stanislas Wawrinka,Roger Federer,6-3; 7-6(5),R16,106,4,0,49,75,35,49,16,26,6,7,11,51,75,11,2,46,77,32,46,15,31,6,8,10,47,77
2009-08-10 00:00:00.000,ATP World Tour Masters 1000 Canada MontrTal; Canada ATP World Tour Masters 1000,HARD,2,Jo-Wilfried Tsonga,Gilles Simon,Jo-Wilfried Tsonga,6-3; 6-3,R16,82,9,2,54,70,42,54,5,16,7,7,9,47,70,2,2,26,61,13,26,22,35,2,5,9,35,61
2009-08-10 00:00:00.000,ATP World Tour Masters 1000 Canada MontrTal; Canada ATP World Tour Masters 1000,HARD,2,Andy Murray,Juan Carlos Ferrero,Andy Murray,6-1; 6-3,R16,78,9,2,21,42,19,21,13,21,0,0,8,32,42,3,2,50,71,28,50,8,21,10,14,8,36,71
2009-08-10 00:00:00.000,ATP World Tour Masters 1000 Canada MontrTal; Canada ATP World Tour Masters 1000,HARD,2,Nikolay Davydenko,Fernando Gonzalez,Nikolay Davydenko,7-6(2); 7-5,R16,90,6,1,51,70,40,51,15,19,2,2,12,55,70,6,1,42,73,34,42,16,31,2,3,12,50,73
2009-08-10 00:00:00.000,ATP World Tour Masters 1000 Canada MontrTal; Canada ATP World Tour Masters 1000,HARD,2,Andy Roddick,Fernando Verdasco,Andy Roddick,7-6(2); 4-6; 7-6(5),R16,157,12,0,71,105,56,71,21,34,4,6,17,77,105,13,2,75,110,58,75,21,35,5,6,17,79,110
2009-08-10 00:00:00.000,ATP World Tour Masters 1000 Canada MontrTal; Canada ATP World Tour Masters 1000,HARD,2,Novak Djokovic,Mikhail Youzhny,Novak Djokovic,6-3; 6-4,R16,83,3,4,42,62,31,42,12,20,4,5,10,43,62,1,3,26,46,18,26,11,20,3,6,9,29,46
2009-08-10 00:00:00.000,ATP World Tour Masters 1000 Canada MontrTal; Canada ATP World Tour Masters 1000,HARD,2,Juan Martin Del Potro,Victor Hanescu,Juan Martin Del Potro,3-6; 6-3; 6-4,R16,122,9,5,39,74,33,39,18,35,3,6,14,51,74,5,1,49,81,32,49,19,32,1,5,14,51,81
2009-08-10 00:00:00.000,ATP World Tour Masters 1000 Canada MontrTal; Canada ATP World Tour Masters 1000,HARD,2,Rafael Nadal,Philipp Petzschner,Rafael Nadal,6-3; 6-2,R16,70,2,4,33,54,27,33,13,21,2,2,9,40,54,5,1,27,45,16,27,7,18,2,5,8,23,45
2009-08-10 00:00:00.000,ATP World Tour Masters 1000 Canada MontrTal; Canada ATP World Tour Masters 1000,HARD,2,Jo-Wilfried Tsonga,Roger Federer,Jo-Wilfried Tsonga,7-6(5); 1-6; 7-6(3),Q,139,11,6,50,96,39,50,25,46,6,10,15,64,96,9,2,58,101,45,58,26,43,3,5,16,71,101
2009-08-10 00:00:00.000,ATP World Tour Masters 1000 Canada MontrTal; Canada ATP World Tour Masters 1000,HARD,2,Andy Murray,Nikolay Davydenko,Andy Murray,6-2; 6-4,Q,82,9,2,28,56,21,28,16,28,2,3,9,37,56,0,2,34,55,19,34,9,21,0,4,9,28,55
2009-08-10 00:00:00.000,ATP World Tour Masters 1000 Canada MontrTal; Canada ATP World Tour Masters 1000,HARD,2,Andy Roddick,Novak Djokovic,Andy Roddick,6-4; 7-6(4),Q,103,4,1,45,68,36,45,13,23,1,2,11,49,68,10,6,43,78,33,43,16,35,1,3,11,49,78
2009-08-10 00:00:00.000,ATP World Tour Masters 1000 Canada MontrTal; Canada ATP World Tour Masters 1000,HARD,2,Juan Martin Del Potro,Rafael Nadal,Juan Martin Del Potro,7-6(5); 6-1,Q,112,8,0,46,61,35,46,7,15,1,1,9,42,61,1,1,43,67,27,43,11,24,5,8,10,38,67
2009-08-10 00:00:00.000,ATP World Tour Masters 1000 Canada MontrTal; Canada ATP World Tour Masters 1000,HARD,2,Andy Murray,Jo-Wilfried Tsonga,Andy Murray,6-4; 7-6(8),S,110,4,2,30,71,22,30,28,41,5,6,11,50,71,4,2,47,77,34,47,16,30,3,5,11,50,77
2009-08-10 00:00:00.000,ATP World Tour Masters 1000 Canada MontrTal; Canada ATP World Tour Masters 1000,HARD,2,Juan Martin Del Potro,Andy Roddick,Juan Martin Del Potro,4-6; 6-2; 7-5,S,127,19,2,60,87,47,60,15,27,5,6,15,62,87,11,2,60,85,46,60,9,25,4,7,15,55,85
2009-08-10 00:00:00.000,ATP World Tour Masters 1000 Canada MontrTal; Canada ATP World Tour Masters 1000,HARD,2,Andy Murray,Juan Martin Del Potro,Andy Murray,6-7(4); 7-6(3); 6-1,F,165,16,1,46,89,39,46,29,43,1,3,16,68,89,11,5,69,121,46,69,25,52,6,10,15,71,121
2009-08-16 00:00:00.000,ATP World Tour Masters 1000 Cincinnati OH; U.S.A. ATP World Tour Masters 1000,HARD,2,Roger Federer,N/A Bye,Roger Federer,,R64,0,0,0,0,0,0,0,0,0,0,0,0,0,0,0,0,0,0,0,0,0,0,0,0,0,0,0
2009-08-16 00:00:00.000,ATP World Tour Masters 1000 Cincinnati OH; U.S.A. ATP World Tour Masters 1000,HARD,2,Jose Acasuso,Lukasz Kubot,Jose Acasuso,6-4; 6-3,R64,93,7,2,35,57,26,35,12,22,0,2,10,38,57,3,4,36,63,21,36,12,27,4,8,9,33,63
2009-08-16 00:00:00.000,ATP World Tour Masters 1000 Cincinnati OH; U.S.A. ATP World Tour Masters 1000,HARD,2,David Ferrer,Stanislas Wawrinka,David Ferrer,7-5; 6-2,R64,100,1,1,33,60,27,33,16,27,3,4,10,43,60,2,3,34,72,22,34,16,38,7,11,10,38,72
2009-08-16 00:00:00.000,ATP World Tour Masters 1000 Cincinnati OH; U.S.A. ATP World Tour Masters 1000,HARD,2,Marin Cilic,Juan Carlos Ferrero,Marin Cilic,6-3; 6-4,R64,72,5,4,29,59,25,29,16,30,2,3,10,41,59,1,3,38,56,22,38,11,18,5,8,9,33,56
2009-08-16 00:00:00.000,ATP World Tour Masters 1000 Cincinnati OH; U.S.A. ATP World Tour Masters 1000,HARD,2,Lleyton Hewitt,Robin Soderling,Lleyton Hewitt,3-6; 7-6(8); 6-4,R64,130,8,2,52,97,41,52,27,45,3,4,15,68,97,19,7,59,102,51,59,20,43,1,2,16,71,102
2009-08-16 00:00:00.000,ATP World Tour Masters 1000 Cincinnati OH; U.S.A. ATP World Tour Masters 1000,HARD,2,Benjamin Becker,Martin Vassallo Arguello,Benjamin Becker,6-3; 6-3,R64,66,4,2,29,42,27,29,9,13,0,0,9,36,42,3,5,39,61,25,39,10,22,6,9,9,35,61
2009-08-16 00:00:00.000,ATP World Tour Masters 1000 Cincinnati OH; U.S.A. ATP World Tour Masters 1000,HARD,2,Sam Querrey,Yen-Hsun Lu,Sam Querrey,6-3; 6-4,R64,66,9,2,37,53,29,37,9,16,1,2,10,38,53,2,1,36,55,21,36,11,19,5,8,9,32,55
2009-08-16 00:00:00.000,ATP World Tour Masters 1000 Cincinnati OH; U.S.A. ATP World Tour Masters 1000,HARD,2,Andy Roddick,N/A Bye,Andy Roddick,,R64,0,0,0,0,0,0,0,0,0,0,0,0,0,0,0,0,0,0,0,0,0,0,0,0,0,0,0
2009-08-16 00:00:00.000,ATP World Tour Masters 1000 Cincinnati OH; U.S.A. ATP World Tour Masters 1000,HARD,2,Andy Murray,N/A Bye,Andy Murray,,R64,0,0,0,0,0,0,0,0,0,0,0,0,0,0,0,0,0,0,0,0,0,0,0,0,0,0,0
2009-08-16 00:00:00.000,ATP World Tour Masters 1000 Cincinnati OH; U.S.A. ATP World Tour Masters 1000,HARD,2,Nicolas Almagro,Dudi Sela,Nicolas Almagro,6-4; 1-0 RET,R64,40,7,0,13,23,12,13,8,10,0,0,5,20,23,2,2,14,36,9,14,10,22,0,2,6,19,36
2009-08-16 00:00:00.000,ATP World Tour Masters 1000 Cincinnati OH; U.S.A. ATP World Tour Masters 1000,HARD,2,Marat Safin,Robby Ginepri,Marat Safin,7-5; 7-6(2),R64,86,13,4,36,65,28,36,22,29,2,3,12,50,65,2,2,50,78,34,50,15,28,4,6,12,49,78
2009-08-16 00:00:00.000,ATP World Tour Masters 1000 Cincinnati OH; U.S.A. ATP World Tour Masters 1000,HARD,2,Radek Stepanek,Viktor Troicki,Radek Stepanek,7-6(2); 1-0 RET,R64,55,5,1,21,32,18,21,7,11,0,1,6,25,32,1,2,26,44,13,26,11,18,1,3,7,24,44
2009-08-16 00:00:00.000,ATP World Tour Masters 1000 Cincinnati OH; U.S.A. ATP World Tour Masters 1000,HARD,2,Guillermo Garcia-Lopez,Fernando Verdasco,Guillermo Garcia-Lopez,7-6(4); 7-6(4),R64,105,5,3,45,73,37,45,17,28,3,4,12,54,73,11,2,45,70,37,45,13,25,2,3,12,50,70
2009-08-16 00:00:00.000,ATP World Tour Masters 1000 Cincinnati OH; U.S.A. ATP World Tour Masters 1000,HARD,2,Mikhail Youzhny,Victor Hanescu,Mikhail Youzhny,7-5; 6-2,R64,96,4,3,41,65,32,41,15,24,4,4,10,47,65,3,3,45,68,27,45,11,23,5,8,10,38,68
2009-08-16 00:00:00.000,ATP World Tour Masters 1000 Cincinnati OH; U.S.A. ATP World Tour Masters 1000,HARD,2,Jurgen Melzer,Feliciano Lopez,Jurgen Melzer,5-7; 7-6(4); 7-6(7),R64,168,10,2,91,128,70,91,21,37,5,6,18,91,128,16,2,67,121,56,67,31,54,6,6,18,87,121
2009-08-16 00:00:00.000,ATP World Tour Masters 1000 Cincinnati OH; U.S.A. ATP World Tour Masters 1000,HARD,2,Julien Benneteau,N/A Bye,Julien Benneteau,,R64,0,0,0,0,0,0,0,0,0,0,0,0,0,0,0,0,0,0,0,0,0,0,0,0,0,0,0
2009-08-16 00:00:00.000,ATP World Tour Masters 1000 Cincinnati OH; U.S.A. ATP World Tour Masters 1000,HARD,2,Nikolay Davydenko,N/A Bye,Nikolay Davydenko,,R64,0,0,0,0,0,0,0,0,0,0,0,0,0,0,0,0,0,0,0,0,0,0,0,0,0,0,0
2009-08-16 00:00:00.000,ATP World Tour Masters 1000 Cincinnati OH; U.S.A. ATP World Tour Masters 1000,HARD,2,Igor Kunitsyn,James Blake,Igor Kunitsyn,7-6(5); 6-7(5); 6-4,R64,157,9,3,88,126,61,88,21,38,7,10,17,82,126,13,6,62,127,48,62,29,65,8,12,17,77,127
2009-08-16 00:00:00.000,ATP World Tour Masters 1000 Cincinnati OH; U.S.A. ATP World Tour Masters 1000,HARD,2,Igor Andreev,Nicolas Kiefer,Igor Andreev,6-1; 7-5,R64,70,6,1,29,51,25,29,13,22,2,2,9,38,51,4,3,28,50,23,28,8,22,1,5,10,31,50
2009-08-16 00:00:00.000,ATP World Tour Masters 1000 Cincinnati OH; U.S.A. ATP World Tour Masters 1000,HARD,2,Gilles Simon,Wayne Odesnik,Gilles Simon,6-3; 6-2,R64,80,8,1,37,59,31,37,10,22,6,6,9,41,59,3,5,25,52,17,25,13,27,1,4,8,30,52
2009-08-16 00:00:00.000,ATP World Tour Masters 1000 Cincinnati OH; U.S.A. ATP World Tour Masters 1000,HARD,2,Jeremy Chardy,Tommy Robredo,Jeremy Chardy,6-3; 7-5,R64,72,18,0,36,61,28,36,17,25,1,1,11,45,61,7,1,30,49,23,30,13,19,2,4,10,36,49
2009-08-16 00:00:00.000,ATP World Tour Masters 1000 Cincinnati OH; U.S.A. ATP World Tour Masters 1000,HARD,2,John Isner,Tommy Haas,John Isner,7-6(5); 5-7; 7-6(3),R64,154,23,4,67,111,56,67,27,44,5,6,18,83,111,16,4,64,105,56,64,26,41,2,2,18,82,105
2009-08-16 00:00:00.000,ATP World Tour Masters 1000 Cincinnati OH; U.S.A. ATP World Tour Masters 1000,HARD,2,Ivan Ljubicic,Florent Serra,Ivan Ljubicic,4-6; 6-3; 6-4,R64,107,19,2,58,82,44,58,17,24,3,4,15,61,82,4,1,49,73,34,49,17,24,0,2,14,51,73
2009-08-16 00:00:00.000,ATP World Tour Masters 1000 Cincinnati OH; U.S.A. ATP World Tour Masters 1000,HARD,2,Novak Djokovic,N/A Bye,Novak Djokovic,,R64,0,0,0,0,0,0,0,0,0,0,0,0,0,0,0,0,0,0,0,0,0,0,0,0,0,0,0
2009-08-16 00:00:00.000,ATP World Tour Masters 1000 Cincinnati OH; U.S.A. ATP World Tour Masters 1000,HARD,2,Jo-Wilfried Tsonga,N/A Bye,Jo-Wilfried Tsonga,,R64,0,0,0,0,0,0,0,0,0,0,0,0,0,0,0,0,0,0,0,0,0,0,0,0,0,0,0
2009-08-16 00:00:00.000,ATP World Tour Masters 1000 Cincinnati OH; U.S.A. ATP World Tour Masters 1000,HARD,2,Chris Guccione,Philipp Kohlschreiber,Chris Guccione,7-5; 2-6; 6-3,R64,91,19,5,50,85,43,50,16,35,3,5,15,59,85,7,2,43,77,32,43,22,34,2,4,14,54,77
2009-08-16 00:00:00.000,ATP World Tour Masters 1000 Cincinnati OH; U.S.A. ATP World Tour Masters 1000,HARD,2,Philipp Petzschner,Simone Bolelli,Philipp Petzschner,7-6(6); 6-3,R64,90,7,1,39,68,35,39,16,29,1,1,11,51,68,3,0,39,64,31,39,14,25,2,3,10,45,64
2009-08-16 00:00:00.000,ATP World Tour Masters 1000 Cincinnati OH; U.S.A. ATP World Tour Masters 1000,HARD,2,Tomas Berdych,Fernando Gonzalez,Tomas Berdych,6-4 RET,R64,41,5,0,22,36,19,22,6,14,4,4,5,25,36,4,3,21,34,15,21,6,13,4,5,5,21,34
2009-08-16 00:00:00.000,ATP World Tour Masters 1000 Cincinnati OH; U.S.A. ATP World Tour Masters 1000,HARD,2,Ivo Karlovic,Gael Monfils,Ivo Karlovic,6-4; 6-7(5); 7-6(2),R64,131,21,4,74,106,64,74,18,32,5,5,17,82,106,8,1,74,111,57,74,23,37,5,6,17,80,111
2009-08-16 00:00:00.000,ATP World Tour Masters 1000 Cincinnati OH; U.S.A. ATP World Tour Masters 1000,HARD,2,Paul-Henri Mathieu,Mischa Zverev,Paul-Henri Mathieu,6-7(4); 7-5; 6-3,R64,146,7,7,51,88,40,51,19,37,2,5,16,59,88,9,9,67,111,43,67,20,44,12,18,17,63,111
2009-08-16 00:00:00.000,ATP World Tour Masters 1000 Cincinnati OH; U.S.A. ATP World Tour Masters 1000,HARD,2,Andreas Seppi,Jan Hernych,Andreas Seppi,3-6; 6-4; 6-1,R64,117,7,2,52,77,34,52,14,25,5,9,13,48,77,5,2,61,101,39,61,14,40,8,14,13,53,101
2009-08-16 00:00:00.000,ATP World Tour Masters 1000 Cincinnati OH; U.S.A. ATP World Tour Masters 1000,HARD,2,Rafael Nadal,N/A Bye,Rafael Nadal,,R64,0,0,0,0,0,0,0,0,0,0,0,0,0,0,0,0,0,0,0,0,0,0,0,0,0,0,0
2009-08-16 00:00:00.000,ATP World Tour Masters 1000 Cincinnati OH; U.S.A. ATP World Tour Masters 1000,HARD,2,Roger Federer,Jose Acasuso,Roger Federer,6-3; 7-5,R32,70,14,2,40,58,35,40,11,18,1,1,11,46,58,11,3,30,60,23,30,15,30,4,6,10,38,60
2009-08-16 00:00:00.000,ATP World Tour Masters 1000 Cincinnati OH; U.S.A. ATP World Tour Masters 1000,HARD,2,David Ferrer,Marin Cilic,David Ferrer,7-6(4); 6-2,R32,92,1,0,42,60,31,42,15,18,2,2,10,46,60,3,2,47,72,31,47,12,25,3,5,10,43,72
2009-08-16 00:00:00.000,ATP World Tour Masters 1000 Cincinnati OH; U.S.A. ATP World Tour Masters 1000,HARD,2,Lleyton Hewitt,Benjamin Becker,Lleyton Hewitt,6-3; 6-3,R32,68,11,1,28,44,26,28,10,16,0,0,9,36,44,8,2,30,60,21,30,11,30,5,8,9,32,60
2009-08-16 00:00:00.000,ATP World Tour Masters 1000 Cincinnati OH; U.S.A. ATP World Tour Masters 1000,HARD,2,Sam Querrey,Andy Roddick,Sam Querrey,7-6(11); 7-6(3),R32,118,16,4,46,90,37,46,26,44,2,3,12,63,90,10,0,57,87,43,57,16,30,2,3,12,59,87
2009-08-16 00:00:00.000,ATP World Tour Masters 1000 Cincinnati OH; U.S.A. ATP World Tour Masters 1000,HARD,2,Andy Murray,Nicolas Almagro,Andy Murray,7-6(3); 6-2,R32,85,9,1,26,53,26,26,20,27,1,1,10,46,53,5,2,42,74,32,42,15,32,5,7,10,47,74
2009-08-16 00:00:00.000,ATP World Tour Masters 1000 Cincinnati OH; U.S.A. ATP World Tour Masters 1000,HARD,2,Radek Stepanek,Marat Safin,Radek Stepanek,4-6; 6-3; 6-1,R32,114,5,3,37,71,31,37,20,34,0,1,13,51,71,10,8,52,91,35,52,18,39,11,15,13,53,91
2009-08-16 00:00:00.000,ATP World Tour Masters 1000 Cincinnati OH; U.S.A. ATP World Tour Masters 1000,HARD,2,Guillermo Garcia-Lopez,Mikhail Youzhny,Guillermo Garcia-Lopez,7-5; 6-3,R32,103,3,4,31,60,25,31,17,29,2,4,11,42,60,5,3,45,76,29,45,12,31,14,18,10,41,76
2009-08-16 00:00:00.000,ATP World Tour Masters 1000 Cincinnati OH; U.S.A. ATP World Tour Masters 1000,HARD,2,Julien Benneteau,Jurgen Melzer,Julien Benneteau,6-2; 3-6; 6-2,R32,99,6,1,43,73,32,43,17,30,1,3,13,49,73,7,3,49,78,34,49,13,29,7,11,12,47,78
2009-08-16 00:00:00.000,ATP World Tour Masters 1000 Cincinnati OH; U.S.A. ATP World Tour Masters 1000,HARD,2,Nikolay Davydenko,Igor Kunitsyn,Nikolay Davydenko,6-2; 1-6; 6-3,R32,109,5,4,39,67,27,39,15,28,4,7,12,42,67,0,2,64,87,37,64,12,23,11,15,12,49,87
2009-08-16 00:00:00.000,ATP World Tour Masters 1000 Cincinnati OH; U.S.A. ATP World Tour Masters 1000,HARD,2,Gilles Simon,Igor Andreev,Gilles Simon,7-6(5); 6-7(6); 6-1,R32,141,8,4,61,110,48,61,32,49,8,8,16,80,110,10,1,58,100,45,58,25,42,1,3,15,70,100
2009-08-16 00:00:00.000,ATP World Tour Masters 1000 Cincinnati OH; U.S.A. ATP World Tour Masters 1000,HARD,2,Jeremy Chardy,John Isner,Jeremy Chardy,6-7(1); 6-3; 4-1 RET,R32,92,17,2,42,64,38,42,17,22,3,3,13,55,64,19,2,65,88,49,65,7,23,4,7,13,56,88
2009-08-16 00:00:00.000,ATP World Tour Masters 1000 Cincinnati OH; U.S.A. ATP World Tour Masters 1000,HARD,2,Novak Djokovic,Ivan Ljubicic,Novak Djokovic,7-6(5); 6-4,R32,100,9,1,36,63,35,36,17,27,1,1,11,52,63,15,0,48,85,35,48,21,37,3,4,11,56,85
2009-08-16 00:00:00.000,ATP World Tour Masters 1000 Cincinnati OH; U.S.A. ATP World Tour Masters 1000,HARD,2,Chris Guccione,Jo-Wilfried Tsonga,Chris Guccione,7-6(12); 6-2,R32,77,20,6,42,71,38,42,18,29,3,3,10,56,71,3,0,47,69,36,47,13,22,0,2,10,49,69
2009-08-16 00:00:00.000,ATP World Tour Masters 1000 Cincinnati OH; U.S.A. ATP World Tour Masters 1000,HARD,2,Tomas Berdych,Philipp Petzschner,Tomas Berdych,7-6(8); 6-7(7); 6-4,R32,160,14,3,63,108,52,63,27,45,2,4,17,79,108,9,3,66,117,49,66,27,51,5,8,17,76,117
2009-08-16 00:00:00.000,ATP World Tour Masters 1000 Cincinnati OH; U.S.A. ATP World Tour Masters 1000,HARD,2,Paul-Henri Mathieu,Ivo Karlovic,Paul-Henri Mathieu,7-6(9); 6-4,R32,98,8,0,54,76,48,54,10,22,1,1,11,58,76,23,1,47,66,41,47,11,19,0,1,11,52,66
2009-08-16 00:00:00.000,ATP World Tour Masters 1000 Cincinnati OH; U.S.A. ATP World Tour Masters 1000,HARD,2,Rafael Nadal,Andreas Seppi,Rafael Nadal,7-6(4); 7-6(3),R32,131,8,2,60,88,45,60,14,28,9,10,12,59,88,4,4,53,84,36,53,19,31,4,5,12,55,84
2009-08-16 00:00:00.000,ATP World Tour Masters 1000 Cincinnati OH; U.S.A. ATP World Tour Masters 1000,HARD,2,Roger Federer,David Ferrer,Roger Federer,3-6; 6-3; 6-4,R16,102,6,2,53,85,40,53,15,32,4,7,14,55,85,3,2,52,76,36,52,14,24,5,9,14,50,76
2009-08-16 00:00:00.000,ATP World Tour Masters 1000 Cincinnati OH; U.S.A. ATP World Tour Masters 1000,HARD,2,Lleyton Hewitt,Sam Querrey,Lleyton Hewitt,6-1; 2-6; 6-3,R16,87,3,4,35,61,28,35,14,26,1,4,12,42,61,13,2,36,71,24,36,14,35,6,11,12,38,71
2009-08-16 00:00:00.000,ATP World Tour Masters 1000 Cincinnati OH; U.S.A. ATP World Tour Masters 1000,HARD,2,Andy Murray,Radek Stepanek,Andy Murray,6-4; 6-1,R16,77,8,1,38,65,29,38,14,27,3,4,9,43,65,3,3,43,60,22,43,7,17,5,9,8,29,60
2009-08-16 00:00:00.000,ATP World Tour Masters 1000 Cincinnati OH; U.S.A. ATP World Tour Masters 1000,HARD,2,Julien Benneteau,Guillermo Garcia-Lopez,Julien Benneteau,4-6; 6-4; 7-6(4),R16,184,6,2,76,110,53,76,15,34,3,7,16,68,110,4,5,68,107,44,68,20,39,5,9,16,64,107
2009-08-16 00:00:00.000,ATP World Tour Masters 1000 Cincinnati OH; U.S.A. ATP World Tour Masters 1000,HARD,2,Gilles Simon,Nikolay Davydenko,Gilles Simon,6-7(6); 6-4; 6-4,R16,142,5,3,62,115,46,62,31,53,8,9,16,77,115,5,6,65,99,49,65,19,34,3,6,16,68,99
2009-08-16 00:00:00.000,ATP World Tour Masters 1000 Cincinnati OH; U.S.A. ATP World Tour Masters 1000,HARD,2,Novak Djokovic,Jeremy Chardy,Novak Djokovic,7-5; 6-3,R16,93,7,4,36,62,27,36,14,26,3,5,11,41,62,5,7,31,66,21,31,15,35,6,10,10,36,66
2009-08-16 00:00:00.000,ATP World Tour Masters 1000 Cincinnati OH; U.S.A. ATP World Tour Masters 1000,HARD,2,Tomas Berdych,Chris Guccione,Tomas Berdych,6-4; 6-3,R16,65,4,1,22,46,19,22,19,24,2,2,9,38,46,9,6,31,62,22,31,15,31,3,6,10,37,62
2009-08-16 00:00:00.000,ATP World Tour Masters 1000 Cincinnati OH; U.S.A. ATP World Tour Masters 1000,HARD,2,Rafael Nadal,Paul-Henri Mathieu,Rafael Nadal,7-5; 6-2,R16,116,5,0,41,59,32,41,8,18,1,2,10,40,59,3,3,49,84,33,49,13,35,8,12,10,46,84
2009-08-16 00:00:00.000,ATP World Tour Masters 1000 Cincinnati OH; U.S.A. ATP World Tour Masters 1000,HARD,2,Roger Federer,Lleyton Hewitt,Roger Federer,6-3; 6-4,Q,70,11,1,27,51,24,27,16,24,0,0,10,40,51,2,3,32,65,22,32,16,33,3,5,9,38,65
2009-08-16 00:00:00.000,ATP World Tour Masters 1000 Cincinnati OH; U.S.A. ATP World Tour Masters 1000,HARD,2,Andy Murray,Julien Benneteau,Andy Murray,4-6; 6-3; 6-1,Q,132,7,7,53,88,37,53,16,35,5,8,13,53,88,4,3,58,91,34,58,13,33,7,13,13,47,91
2009-08-16 00:00:00.000,ATP World Tour Masters 1000 Cincinnati OH; U.S.A. ATP World Tour Masters 1000,HARD,2,Novak Djokovic,Gilles Simon,Novak Djokovic,6-4; 7-5,Q,88,8,3,40,64,33,40,12,24,2,3,11,45,64,6,3,37,65,26,37,14,28,6,9,11,40,65
2009-08-16 00:00:00.000,ATP World Tour Masters 1000 Cincinnati OH; U.S.A. ATP World Tour Masters 1000,HARD,2,Rafael Nadal,Tomas Berdych,Rafael Nadal,6-4; 7-5,Q,101,2,1,41,58,35,41,11,17,0,0,11,46,58,3,0,38,68,25,38,19,30,4,6,11,44,68
2009-08-16 00:00:00.000,ATP World Tour Masters 1000 Cincinnati OH; U.S.A. ATP World Tour Masters 1000,HARD,2,Roger Federer,Andy Murray,Roger Federer,6-2; 7-6(8),S,90,4,1,35,62,31,35,16,27,0,0,10,47,62,10,3,36,70,26,36,20,34,4,6,10,46,70
2009-08-16 00:00:00.000,ATP World Tour Masters 1000 Cincinnati OH; U.S.A. ATP World Tour Masters 1000,HARD,2,Novak Djokovic,Rafael Nadal,Novak Djokovic,6-1; 6-4,S,92,5,1,36,55,27,36,11,19,1,1,9,38,55,1,3,35,56,21,35,10,21,3,6,8,31,56
2009-08-16 00:00:00.000,ATP World Tour Masters 1000 Cincinnati OH; U.S.A. ATP World Tour Masters 1000,HARD,2,Roger Federer,Novak Djokovic,Roger Federer,6-1; 7-5,F,127,7,0,33,60,28,33,15,27,3,4,10,43,60,3,1,55,81,33,55,9,26,11,15,9,42,81
2009-08-23 00:00:00.000,New Haven CT; U.S.A. ATP World Tour 250,HARD,2,Nikolay Davydenko,N/A Bye,Nikolay Davydenko,,R64,0,0,0,0,0,0,0,0,0,0,0,0,0,0,0,0,0,0,0,0,0,0,0,0,0,0,0
2009-08-23 00:00:00.000,New Haven CT; U.S.A. ATP World Tour 250,HARD,2,Robert Kendrick,Frederik Nielsen,Robert Kendrick,6-3; 7-5,R64,69,8,4,34,66,25,34,18,32,3,5,11,43,66,4,1,27,60,20,27,14,33,4,8,10,34,60
2009-08-23 00:00:00.000,New Haven CT; U.S.A. ATP World Tour 250,HARD,2,Potito Starace,Mischa Zverev,Potito Starace,6-3; 2-6; 6-3,R64,97,4,1,65,81,42,65,10,16,2,4,13,52,81,7,8,49,84,37,49,15,35,6,9,13,52,84
2009-08-23 00:00:00.000,New Haven CT; U.S.A. ATP World Tour 250,HARD,2,Fabrice Santoro,N/A Bye,Fabrice Santoro,,R64,0,0,0,0,0,0,0,0,0,0,0,0,0,0,0,0,0,0,0,0,0,0,0,0,0,0,0
2009-08-23 00:00:00.000,New Haven CT; U.S.A. ATP World Tour 250,HARD,2,Nicolas Almagro,N/A Bye,Nicolas Almagro,,R64,0,0,0,0,0,0,0,0,0,0,0,0,0,0,0,0,0,0,0,0,0,0,0,0,0,0,0
2009-08-23 00:00:00.000,New Haven CT; U.S.A. ATP World Tour 250,HARD,2,Bjorn Phau,Benjamin Becker,Bjorn Phau,2-6; 6-2; 6-3,R64,96,4,7,49,89,33,49,24,40,3,5,13,57,89,8,1,41,62,31,41,11,21,0,3,12,42,62
2009-08-23 00:00:00.000,New Haven CT; U.S.A. ATP World Tour 250,HARD,2,Marc Gicquel,Martin Vassallo Arguello,Marc Gicquel,6-3; 6-4,R64,93,2,5,33,57,26,33,17,24,3,3,10,43,57,3,0,58,85,36,58,12,27,12,14,9,48,85
2009-08-23 00:00:00.000,New Haven CT; U.S.A. ATP World Tour 250,HARD,2,Sam Querrey,N/A Bye,Sam Querrey,,R64,0,0,0,0,0,0,0,0,0,0,0,0,0,0,0,0,0,0,0,0,0,0,0,0,0,0,0
2009-08-23 00:00:00.000,New Haven CT; U.S.A. ATP World Tour 250,HARD,2,Tommy Robredo,N/A Bye,Tommy Robredo,,R64,0,0,0,0,0,0,0,0,0,0,0,0,0,0,0,0,0,0,0,0,0,0,0,0,0,0,0
2009-08-23 00:00:00.000,New Haven CT; U.S.A. ATP World Tour 250,HARD,2,Jose Acasuso,Maximo Gonzalez,Jose Acasuso,6-1; 6-7(7); 6-2,R64,135,19,1,57,100,45,57,24,43,6,6,13,69,100,2,3,54,95,36,54,21,41,9,14,14,57,95
2009-08-23 00:00:00.000,New Haven CT; U.S.A. ATP World Tour 250,HARD,2,Taylor Dent,Ivan Ljubicic,Taylor Dent,6-3; 6-4,R64,66,8,6,33,56,30,33,13,23,1,1,10,43,56,7,1,30,49,22,30,10,19,3,5,9,32,49
2009-08-23 00:00:00.000,New Haven CT; U.S.A. ATP World Tour 250,HARD,2,Igor Kunitsyn,N/A Bye,Igor Kunitsyn,,R64,0,0,0,0,0,0,0,0,0,0,0,0,0,0,0,0,0,0,0,0,0,0,0,0,0,0,0
2009-08-23 00:00:00.000,New Haven CT; U.S.A. ATP World Tour 250,HARD,2,Jeremy Chardy,N/A Bye,Jeremy Chardy,,R64,0,0,0,0,0,0,0,0,0,0,0,0,0,0,0,0,0,0,0,0,0,0,0,0,0,0,0
2009-08-23 00:00:00.000,New Haven CT; U.S.A. ATP World Tour 250,HARD,2,Florent Serra,Steve Darcis,Florent Serra,6-3; 6-3,R64,82,2,0,30,51,22,30,12,21,0,1,9,34,51,4,5,35,77,25,35,16,42,8,12,9,41,77
2009-08-23 00:00:00.000,New Haven CT; U.S.A. ATP World Tour 250,HARD,2,Rajeev Ram,Nicolas Lapentti,Rajeev Ram,7-5; 1-6; 7-6(3),R64,145,11,3,54,107,42,54,24,53,5,8,15,66,107,4,3,61,94,45,61,17,33,3,5,16,62,94
2009-08-23 00:00:00.000,New Haven CT; U.S.A. ATP World Tour 250,HARD,2,Mardy Fish,N/A Bye,Mardy Fish,,R64,0,0,0,0,0,0,0,0,0,0,0,0,0,0,0,0,0,0,0,0,0,0,0,0,0,0,0
2009-08-23 00:00:00.000,New Haven CT; U.S.A. ATP World Tour 250,HARD,2,Igor Andreev,N/A Bye,Igor Andreev,,R64,0,0,0,0,0,0,0,0,0,0,0,0,0,0,0,0,0,0,0,0,0,0,0,0,0,0,0
2009-08-23 00:00:00.000,New Haven CT; U.S.A. ATP World Tour 250,HARD,2,Kevin Kim,Teymuraz Gabashvili,Kevin Kim,6-4; 5-7; 6-3,R64,147,14,8,62,118,49,62,24,56,9,11,15,73,118,11,8,50,105,38,50,27,55,6,10,16,65,105
2009-08-23 00:00:00.000,New Haven CT; U.S.A. ATP World Tour 250,HARD,2,Frederico Gil,Marcos Baghdatis,Frederico Gil,6-4; 6-3,R64,82,4,2,33,57,26,33,16,24,1,1,10,42,57,2,5,21,55,14,21,20,34,4,6,9,34,55
2009-08-23 00:00:00.000,New Haven CT; U.S.A. ATP World Tour 250,HARD,2,Philipp Petzschner,N/A Bye,Philipp Petzschner,,R64,0,0,0,0,0,0,0,0,0,0,0,0,0,0,0,0,0,0,0,0,0,0,0,0,0,0,0
2009-08-23 00:00:00.000,New Haven CT; U.S.A. ATP World Tour 250,HARD,2,Andreas Beck,N/A Bye,Andreas Beck,,R64,0,0,0,0,0,0,0,0,0,0,0,0,0,0,0,0,0,0,0,0,0,0,0,0,0,0,0
2009-08-23 00:00:00.000,New Haven CT; U.S.A. ATP World Tour 250,HARD,2,Simone Bolelli,Christophe Rochus,Simone Bolelli,6-3; 6-4,R64,77,6,3,38,60,26,38,11,22,3,5,9,37,60,2,7,31,58,20,31,10,27,5,10,10,30,58
2009-08-23 00:00:00.000,New Haven CT; U.S.A. ATP World Tour 250,HARD,2,Leonardo Mayer,Denis Istomin,Leonardo Mayer,6-2; 6-4,R64,73,3,3,29,52,23,29,16,23,1,1,9,39,52,2,2,32,58,22,32,12,26,0,3,9,34,58
2009-08-23 00:00:00.000,New Haven CT; U.S.A. ATP World Tour 250,HARD,2,Olivier Rochus,N/A Bye,Olivier Rochus,,R64,0,0,0,0,0,0,0,0,0,0,0,0,0,0,0,0,0,0,0,0,0,0,0,0,0,0,0
2009-08-23 00:00:00.000,New Haven CT; U.S.A. ATP World Tour 250,HARD,2,Victor Hanescu,N/A Bye,Victor Hanescu,,R64,0,0,0,0,0,0,0,0,0,0,0,0,0,0,0,0,0,0,0,0,0,0,0,0,0,0,0
2009-08-23 00:00:00.000,New Haven CT; U.S.A. ATP World Tour 250,HARD,2,Janko Tipsarevic,Fabio Fognini,Janko Tipsarevic,7-5; 2-0 RET,R64,69,2,3,23,53,17,23,14,30,3,5,7,31,53,2,6,23,43,11,23,8,20,1,5,7,19,43
2009-08-23 00:00:00.000,New Haven CT; U.S.A. ATP World Tour 250,HARD,2,Pablo Cuevas,Andrey Golubev,Pablo Cuevas,6-3; 6-4,R64,74,4,5,35,63,28,35,17,28,2,2,10,45,63,4,3,27,51,19,27,15,24,3,5,9,34,51
2009-08-23 00:00:00.000,New Haven CT; U.S.A. ATP World Tour 250,HARD,2,Jurgen Melzer,N/A Bye,Jurgen Melzer,,R64,0,0,0,0,0,0,0,0,0,0,0,0,0,0,0,0,0,0,0,0,0,0,0,0,0,0,0
2009-08-23 00:00:00.000,New Haven CT; U.S.A. ATP World Tour 250,HARD,2,Andreas Seppi,N/A Bye,Andreas Seppi,,R64,0,0,0,0,0,0,0,0,0,0,0,0,0,0,0,0,0,0,0,0,0,0,0,0,0,0,0
2009-08-23 00:00:00.000,New Haven CT; U.S.A. ATP World Tour 250,HARD,2,Yen-Hsun Lu,Guillermo Garcia-Lopez,Yen-Hsun Lu,6-2; 6-2,R64,72,6,1,31,50,23,31,13,19,0,0,8,36,50,1,11,34,54,21,34,5,20,6,10,8,26,54
2009-08-23 00:00:00.000,New Haven CT; U.S.A. ATP World Tour 250,HARD,2,Paul Capdeville,Jarkko Nieminen,Paul Capdeville,7-5; 6-3,R64,77,4,2,38,60,30,38,12,22,2,3,11,42,60,3,3,37,69,23,37,16,32,10,13,10,39,69
2009-08-23 00:00:00.000,New Haven CT; U.S.A. ATP World Tour 250,HARD,2,Fernando Verdasco,N/A Bye,Fernando Verdasco,,R64,0,0,0,0,0,0,0,0,0,0,0,0,0,0,0,0,0,0,0,0,0,0,0,0,0,0,0
2009-08-23 00:00:00.000,New Haven CT; U.S.A. ATP World Tour 250,HARD,2,Nikolay Davydenko,Robert Kendrick,Nikolay Davydenko,7-6(10); 6-3,R32,82,6,1,47,67,34,47,16,20,2,3,11,50,67,12,2,38,66,31,38,11,28,1,3,10,42,66
2009-08-23 00:00:00.000,New Haven CT; U.S.A. ATP World Tour 250,HARD,2,Fabrice Santoro,Potito Starace,Fabrice Santoro,7-5; 6-0,R32,76,3,1,38,65,24,38,13,27,2,4,9,37,65,4,5,33,49,18,33,4,16,4,10,9,22,49
2009-08-23 00:00:00.000,New Haven CT; U.S.A. ATP World Tour 250,HARD,2,Bjorn Phau,Nicolas Almagro,Bjorn Phau,2-6; 6-3; 7-5,R32,122,7,1,46,91,27,46,27,45,8,12,14,54,91,8,3,51,98,36,51,22,47,7,12,15,58,98
2009-08-23 00:00:00.000,New Haven CT; U.S.A. ATP World Tour 250,HARD,2,Sam Querrey,Marc Gicquel,Sam Querrey,6-4; 6-7(3); 6-2,R32,117,11,2,56,94,42,56,21,38,3,5,15,63,94,5,4,49,97,37,49,20,48,9,14,15,57,97
2009-08-23 00:00:00.000,New Haven CT; U.S.A. ATP World Tour 250,HARD,2,Jose Acasuso,Tommy Robredo,Jose Acasuso,3-6; 7-5; 7-6(5),R32,147,7,4,43,97,34,43,33,54,4,7,16,67,97,8,5,63,111,47,63,26,48,6,9,17,73,111
2009-08-23 00:00:00.000,New Haven CT; U.S.A. ATP World Tour 250,HARD,2,Igor Kunitsyn,Taylor Dent,Igor Kunitsyn,6-3; 6-4,R32,82,0,3,39,70,29,39,18,31,6,6,10,47,70,8,3,32,52,26,32,9,20,2,4,9,35,52
2009-08-23 00:00:00.000,New Haven CT; U.S.A. ATP World Tour 250,HARD,2,Florent Serra,Jeremy Chardy,Florent Serra,6-7(8); 7-6(4); 6-1,R32,128,13,2,63,100,46,63,25,37,1,2,16,71,100,11,11,45,106,33,45,31,61,3,6,15,64,106
2009-08-23 00:00:00.000,New Haven CT; U.S.A. ATP World Tour 250,HARD,2,Rajeev Ram,Mardy Fish,Rajeev Ram,6-3; 6-3,R32,73,10,1,31,61,24,31,17,30,5,5,9,41,61,5,1,32,56,20,32,12,24,2,5,9,32,56
2009-08-23 00:00:00.000,New Haven CT; U.S.A. ATP World Tour 250,HARD,2,Igor Andreev,Kevin Kim,Igor Andreev,6-3; 6-1,R32,53,5,2,25,38,23,25,9,13,0,0,8,32,38,1,6,23,57,16,23,13,34,8,12,8,29,57
2009-08-23 00:00:00.000,New Haven CT; U.S.A. ATP World Tour 250,HARD,2,Frederico Gil,Philipp Petzschner,Frederico Gil,6-7(2); 7-6(8); 6-3,R32,176,2,3,94,126,58,94,13,32,9,14,17,71,126,8,4,56,115,37,56,27,59,8,14,16,64,115
2009-08-23 00:00:00.000,New Haven CT; U.S.A. ATP World Tour 250,HARD,2,Simone Bolelli,Andreas Beck,Simone Bolelli,6-4; 6-4,R32,98,10,0,40,69,30,40,13,29,4,6,10,43,69,4,6,41,73,24,41,16,32,8,12,10,40,73
2009-08-23 00:00:00.000,New Haven CT; U.S.A. ATP World Tour 250,HARD,2,Leonardo Mayer,Olivier Rochus,Leonardo Mayer,6-0; 6-4,R32,74,8,2,35,58,26,35,11,23,7,8,8,37,58,0,2,24,49,13,24,9,25,5,10,8,22,49
2009-08-23 00:00:00.000,New Haven CT; U.S.A. ATP World Tour 250,HARD,2,Victor Hanescu,Janko Tipsarevic,Victor Hanescu,6-4; 6-7(8); 6-3,R32,145,5,3,60,90,46,60,14,30,4,7,15,60,90,4,6,55,109,37,55,26,54,6,12,16,63,109
2009-08-23 00:00:00.000,New Haven CT; U.S.A. ATP World Tour 250,HARD,2,Jurgen Melzer,Pablo Cuevas,Jurgen Melzer,6-2; 3-0 RET,R32,50,4,0,14,24,12,14,8,10,0,0,5,20,24,2,2,33,50,19,33,5,17,3,7,6,24,50
2009-08-23 00:00:00.000,New Haven CT; U.S.A. ATP World Tour 250,HARD,2,Andreas Seppi,Yen-Hsun Lu,Andreas Seppi,6-7(5); 6-3; 7-5,R32,153,13,3,66,122,46,66,29,56,8,12,17,75,122,5,7,70,109,46,70,19,39,6,12,16,65,109
2009-08-23 00:00:00.000,New Haven CT; U.S.A. ATP World Tour 250,HARD,2,Fernando Verdasco,Paul Capdeville,Fernando Verdasco,6-0; 6-3,R32,50,8,6,21,43,19,21,12,22,3,4,8,31,43,3,3,31,51,17,31,4,20,6,11,7,21,51
2009-08-23 00:00:00.000,New Haven CT; U.S.A. ATP World Tour 250,HARD,2,Nikolay Davydenko,Fabrice Santoro,Nikolay Davydenko,7-5; 6-3,R16,93,2,3,51,65,40,51,7,14,2,3,11,47,65,0,2,36,74,24,36,18,38,3,6,10,42,74
2009-08-23 00:00:00.000,New Haven CT; U.S.A. ATP World Tour 250,HARD,2,Sam Querrey,Bjorn Phau,Sam Querrey,7-5; 6-3,R16,64,14,2,38,60,32,38,12,22,1,2,11,44,60,2,7,28,55,21,28,10,27,0,3,10,31,55
2009-08-23 00:00:00.000,New Haven CT; U.S.A. ATP World Tour 250,HARD,2,Jose Acasuso,Igor Kunitsyn,Jose Acasuso,3-6; 7-6(3); 6-3,R16,137,6,2,43,87,35,43,22,44,6,9,14,57,87,3,7,58,101,37,58,22,43,9,13,16,59,101
2009-08-23 00:00:00.000,New Haven CT; U.S.A. ATP World Tour 250,HARD,2,Florent Serra,Rajeev Ram,Florent Serra,4-6; 7-6(6); 7-5,R16,140,7,4,54,105,41,54,32,51,4,6,17,73,105,20,3,64,112,49,64,25,48,7,9,17,74,112
2009-08-23 00:00:00.000,New Haven CT; U.S.A. ATP World Tour 250,HARD,2,Igor Andreev,Frederico Gil,Igor Andreev,6-4; 6-4,R16,92,5,3,39,66,30,39,13,27,1,2,10,43,66,5,4,39,70,28,39,13,31,5,8,10,41,70
2009-08-23 00:00:00.000,New Haven CT; U.S.A. ATP World Tour 250,HARD,2,Leonardo Mayer,Simone Bolelli,Leonardo Mayer,6-2; 6-4,R16,80,6,1,25,47,20,25,14,22,0,1,9,34,47,0,2,34,64,24,34,9,30,5,9,9,33,64
2009-08-23 00:00:00.000,New Haven CT; U.S.A. ATP World Tour 250,HARD,2,Jurgen Melzer,Victor Hanescu,Jurgen Melzer,7-6(5); 4-6; 6-1,R16,118,6,4,62,91,51,62,14,29,1,2,15,65,91,9,1,58,91,41,58,18,33,2,4,14,59,91
2009-08-23 00:00:00.000,New Haven CT; U.S.A. ATP World Tour 250,HARD,2,Fernando Verdasco,Andreas Seppi,Fernando Verdasco,7-6(3); 6-2,R16,86,3,7,32,60,28,32,15,28,3,4,10,43,60,3,2,31,68,23,31,17,37,3,6,10,40,68
2009-08-23 00:00:00.000,New Haven CT; U.S.A. ATP World Tour 250,HARD,2,Sam Querrey,Nikolay Davydenko,Sam Querrey,6-3; 3-6; 6-4,Q,102,15,1,47,78,38,47,17,31,5,7,14,55,78,3,4,58,72,43,58,4,14,0,3,14,47,72
2009-08-23 00:00:00.000,New Haven CT; U.S.A. ATP World Tour 250,HARD,2,Jose Acasuso,Florent Serra,Jose Acasuso,7-5; 6-4,Q,84,7,3,39,72,30,39,16,33,3,4,11,46,72,2,1,38,65,28,38,11,27,5,8,11,39,65
2009-08-23 00:00:00.000,New Haven CT; U.S.A. ATP World Tour 250,HARD,2,Igor Andreev,Leonardo Mayer,Igor Andreev,6-4; 6-7(4); 6-3,Q,142,5,6,63,100,43,63,24,37,2,3,16,67,100,3,5,63,109,41,63,25,46,9,12,15,66,109
2009-08-23 00:00:00.000,New Haven CT; U.S.A. ATP World Tour 250,HARD,2,Fernando Verdasco,Jurgen Melzer,Fernando Verdasco,6-3; 6-1,Q,58,5,1,31,47,20,31,12,16,2,3,8,32,47,1,1,27,46,11,27,9,19,1,6,8,20,46
2009-08-23 00:00:00.000,New Haven CT; U.S.A. ATP World Tour 250,HARD,2,Sam Querrey,Jose Acasuso,Sam Querrey,6-3; 6-4,S,64,11,3,33,52,31,33,11,19,1,1,10,42,52,4,1,21,50,16,21,17,29,3,5,9,33,50
2009-08-23 00:00:00.000,New Haven CT; U.S.A. ATP World Tour 250,HARD,2,Fernando Verdasco,Igor Andreev,Fernando Verdasco,7-6(4); 7-6(5),S,112,7,11,57,90,46,57,14,33,5,7,12,60,90,7,4,57,91,39,57,18,34,9,11,12,57,91
2009-08-23 00:00:00.000,New Haven CT; U.S.A. ATP World Tour 250,HARD,2,Fernando Verdasco,Sam Querrey,Fernando Verdasco,6-4; 7-6(6),F,96,4,4,48,67,35,48,13,19,4,6,11,48,67,7,3,51,88,36,51,16,37,4,7,11,52,88
2009-08-31 00:00:00.000,US Open NY; U.S.A. Grand Slams,HARD,3,Roger Federer,Devin Britton,Roger Federer,6-1; 6-3; 7-5,R128,88,6,3,45,69,37,45,13,24,1,3,14,50,69,6,9,58,100,34,58,15,42,2,9,14,49,100
2009-08-31 00:00:00.000,US Open NY; U.S.A. Grand Slams,HARD,3,Simon Greul,Giovanni Lapentti,Simon Greul,6-3; 4-6; 3-6; 6-0; 7-6(9),R128,217,15,9,73,142,59,73,33,69,9,13,23,92,142,5,5,80,153,56,80,38,73,11,17,23,94,153
2009-08-31 00:00:00.000,US Open NY; U.S.A. Grand Slams,HARD,3,Juan Ignacio Chela,Oscar Hernandez,Juan Ignacio Chela,6-4; 6-4; 6-2,R128,121,4,1,56,89,48,56,17,33,3,3,14,65,89,1,3,69,94,47,69,8,25,4,8,14,55,94
2009-08-31 00:00:00.000,US Open NY; U.S.A. Grand Slams,HARD,3,Lleyton Hewitt,Thiago Alves,Lleyton Hewitt,6-0; 6-3; 6-4,R128,110,6,4,36,79,29,36,25,43,1,3,13,54,79,5,5,53,85,26,53,14,32,10,17,12,40,85
2009-08-31 00:00:00.000,US Open NY; U.S.A. Grand Slams,HARD,3,James Blake,Ruben Ramirez Hidalgo,James Blake,6-1; 6-4; 7-5,R128,116,11,2,60,95,42,60,22,35,3,5,15,64,95,1,7,52,95,29,52,22,43,8,14,14,51,95
2009-08-31 00:00:00.000,US Open NY; U.S.A. Grand Slams,HARD,3,Olivier Rochus,Igor Kunitsyn,Olivier Rochus,6-3; 6-0; 6-2,R128,107,2,2,51,82,39,51,18,31,10,10,12,57,82,3,3,47,78,26,47,11,31,5,11,11,37,78
2009-08-31 00:00:00.000,US Open NY; U.S.A. Grand Slams,HARD,3,Guillermo Garcia-Lopez,Peter Polansky,Guillermo Garcia-Lopez,6-4; 6-4; 5-7; 3-6; 6-1,R128,204,5,18,76,153,57,76,36,77,16,22,24,93,153,7,8,80,144,56,80,25,64,11,19,24,81,144
2009-08-31 00:00:00.000,US Open NY; U.S.A. Grand Slams,HARD,3,Tommy Robredo,Donald Young,Tommy Robredo,6-4; 3-6; 6-2; 6-3,R128,137,7,2,55,97,47,55,26,42,1,2,18,73,97,2,5,66,108,49,66,19,42,4,8,18,68,108
2009-08-31 00:00:00.000,US Open NY; U.S.A. Grand Slams,HARD,3,Robin Soderling,Albert Montanes,Robin Soderling,6-1; 3-6; 6-1; 6-4,R128,114,18,5,56,92,48,56,17,36,0,2,17,65,92,7,4,53,105,42,53,16,52,4,10,16,58,105
2009-08-31 00:00:00.000,US Open NY; U.S.A. Grand Slams,HARD,3,Marcel Granollers,Mischa Zverev,Marcel Granollers,2-6; 7-5; 3-6; 6-4; 6-0,R128,175,7,5,80,138,59,80,29,58,8,13,23,88,138,7,1,78,125,50,78,27,47,4,10,22,77,125
2009-08-31 00:00:00.000,US Open NY; U.S.A. Grand Slams,HARD,3,Kevin Kim,Dudi Sela,Kevin Kim,6-3; 0-6; 6-2; 6-2,R128,110,4,7,45,90,32,45,21,45,3,8,16,53,90,1,5,52,91,32,52,16,39,6,13,15,48,91
2009-08-31 00:00:00.000,US Open NY; U.S.A. Grand Slams,HARD,3,Sam Querrey,Michael Yani,Sam Querrey,6-3; 7-5; 6-4,R128,120,10,5,53,99,44,53,28,46,4,4,16,72,99,6,6,61,109,35,61,31,48,9,12,15,66,109
2009-08-31 00:00:00.000,US Open NY; U.S.A. Grand Slams,HARD,3,Mikhail Youzhny,Paul-Henri Mathieu,Mikhail Youzhny,2-6; 7-5; 6-0; 6-2,R128,176,11,8,62,111,52,62,17,49,4,7,17,69,111,6,5,62,119,42,62,21,57,4,11,17,63,119
2009-08-31 00:00:00.000,US Open NY; U.S.A. Grand Slams,HARD,3,Marco Chiudinelli,Potito Starace,Marco Chiudinelli,7-6(3); 7-6(2); 6-0,R128,128,6,1,58,92,49,58,18,34,5,7,15,67,92,6,3,78,105,47,78,12,27,3,8,15,59,105
2009-08-31 00:00:00.000,US Open NY; U.S.A. Grand Slams,HARD,3,Jan Hernych,Rainer Schuettler,Jan Hernych,1-6; 7-6(5); 6-4; 2-6; 6-3,R128,200,4,6,79,134,56,79,23,55,3,10,22,79,134,5,9,99,172,65,99,33,73,14,20,24,98,172
2009-08-31 00:00:00.000,US Open NY; U.S.A. Grand Slams,HARD,3,Nikolay Davydenko,Dieter Kindlmann,Nikolay Davydenko,6-3; 6-4; 7-5,R128,133,6,1,60,97,40,60,24,37,5,7,16,64,97,1,5,41,87,30,41,19,46,6,11,15,49,87
2009-08-31 00:00:00.000,US Open NY; U.S.A. Grand Slams,HARD,3,Novak Djokovic,Ivan Ljubicic,Novak Djokovic,6-3; 6-1; 6-3,R128,97,9,0,52,66,43,52,9,14,0,0,13,52,66,10,4,39,78,23,39,17,39,5,10,12,40,78
2009-08-31 00:00:00.000,US Open NY; U.S.A. Grand Slams,HARD,3,Carsten Ball,Juan Pablo Brzezicki,Carsten Ball,7-6(5); 6-3; 6-4,R128,109,19,2,60,93,49,60,22,33,1,1,16,71,93,2,3,54,94,37,54,27,40,4,6,15,64,94
2009-08-31 00:00:00.000,US Open NY; U.S.A. Grand Slams,HARD,3,Maximo Gonzalez,Karol Beck,Maximo Gonzalez,2-6; 1-6; 6-1; 6-4; 6-3,R128,190,1,10,83,139,56,83,21,56,16,23,20,77,139,8,15,68,143,51,68,29,75,10,18,21,80,143
2009-08-31 00:00:00.000,US Open NY; U.S.A. Grand Slams,HARD,3,Jesse Witten,Igor Andreev,Jesse Witten,6-4; 6-0; 6-2,R128,97,7,4,37,79,28,37,25,42,4,5,12,53,79,1,7,36,82,22,36,15,46,7,13,12,37,82
2009-08-31 00:00:00.000,US Open NY; U.S.A. Grand Slams,HARD,3,Philipp Kohlschreiber,Andreas Seppi,Philipp Kohlschreiber,6-0; 6-4; 6-4,R128,118,5,2,52,90,36,52,24,38,8,9,13,60,90,5,3,40,81,26,40,18,41,7,12,13,44,81
2009-08-31 00:00:00.000,US Open NY; U.S.A. Grand Slams,HARD,3,Somdev Devvarman,Frederico Gil,Somdev Devvarman,6-3; 6-4; 6-3,R128,146,4,2,60,83,42,60,13,23,3,5,14,55,83,0,5,67,106,37,67,20,39,7,14,14,57,106
2009-08-31 00:00:00.000,US Open NY; U.S.A. Grand Slams,HARD,3,Leonardo Mayer,Andrey Golubev,Leonardo Mayer,6-4; 4-6; 7-5; 6-3,R128,174,8,6,88,137,61,88,26,49,10,14,21,87,137,4,3,72,125,52,72,23,53,10,16,20,75,125
2009-08-31 00:00:00.000,US Open NY; U.S.A. Grand Slams,HARD,3,Radek Stepanek,Simone Bolelli,Radek Stepanek,6-4; 6-4; 6-4,R128,126,11,2,44,87,34,44,22,43,6,9,15,56,87,4,1,60,95,32,60,18,35,4,10,15,50,95
2009-08-31 00:00:00.000,US Open NY; U.S.A. Grand Slams,HARD,3,Fernando Verdasco,Benjamin Becker,Fernando Verdasco,7-5; 6-4; 7-5,R128,132,12,5,47,83,40,47,21,36,1,3,17,61,83,1,1,57,106,42,57,21,49,2,7,17,63,106
2009-08-31 00:00:00.000,US Open NY; U.S.A. Grand Slams,HARD,3,Florent Serra,Janko Tipsarevic,Florent Serra,7-6(8); 7-6(5); 7-6(5),R128,172,4,4,71,127,52,71,33,56,5,8,18,85,127,16,7,72,142,61,72,31,70,9,12,18,92,142
2009-08-31 00:00:00.000,US Open NY; U.S.A. Grand Slams,HARD,3,Robert Kendrick,Martin Vassallo Arguello,Robert Kendrick,6-3; 6-2; 6-2,R128,83,16,1,52,76,44,52,11,24,2,3,13,55,76,2,2,44,62,27,44,4,18,2,8,12,31,62
2009-08-31 00:00:00.000,US Open NY; U.S.A. Grand Slams,HARD,3,Tommy Haas,Alejandro Falla,Tommy Haas,7-5; 4-6; 7-6(7); 6-2,R128,190,9,9,75,129,53,75,28,54,3,9,21,81,129,5,10,76,148,52,76,30,72,7,15,21,82,148
2009-08-31 00:00:00.000,US Open NY; U.S.A. Grand Slams,HARD,3,John Isner,Victor Hanescu,John Isner,6-1; 7-6(14); 7-6(5),R128,147,13,2,68,106,56,68,22,38,0,1,16,78,106,9,3,70,100,54,70,15,30,3,6,15,69,100
2009-08-31 00:00:00.000,US Open NY; U.S.A. Grand Slams,HARD,3,Marsel Ilhan,Christophe Rochus,Marsel Ilhan,3-6; 6-3; 3-6; 7-5; 7-5,R128,202,15,4,100,149,71,100,21,49,8,14,25,92,149,6,2,105,175,68,105,35,70,9,17,26,103,175
2009-08-31 00:00:00.000,US Open NY; U.S.A. Grand Slams,HARD,3,Marc Gicquel,Dmitry Tursunov,Marc Gicquel,6-2; 5-7; 6-3; 6-3,R128,179,8,7,77,137,58,77,25,60,7,11,19,83,137,2,6,72,137,43,72,30,65,14,22,19,73,137
2009-08-31 00:00:00.000,US Open NY; U.S.A. Grand Slams,HARD,3,Andy Roddick,Bjorn Phau,Andy Roddick,6-1; 6-4; 6-2,R128,95,13,1,56,69,45,56,8,13,1,2,13,53,69,3,0,41,76,27,41,12,35,3,9,12,39,76
2009-08-31 00:00:00.000,US Open NY; U.S.A. Grand Slams,HARD,3,Jo-Wilfried Tsonga,Chase Buchanan,Jo-Wilfried Tsonga,6-0; 6-2; 6-1,R128,78,8,3,34,54,30,34,13,20,0,1,11,43,54,2,1,50,75,26,50,6,25,8,16,10,32,75
2009-08-31 00:00:00.000,US Open NY; U.S.A. Grand Slams,HARD,3,Jarkko Nieminen,Fabio Fognini,Jarkko Nieminen,7-5; 7-6(6); 6-4,R128,141,4,4,70,114,47,70,23,44,5,9,17,70,114,4,5,54,112,34,54,29,58,8,14,17,63,112
2009-08-31 00:00:00.000,US Open NY; U.S.A. Grand Slams,HARD,3,Julien Benneteau,Flavio Cipolla,Julien Benneteau,4-6; 6-1; 6-3; 6-3,R128,158,9,0,74,108,53,74,21,34,6,8,18,74,108,1,4,78,112,44,78,18,34,5,11,17,62,112
2009-08-31 00:00:00.000,US Open NY; U.S.A. Grand Slams,HARD,3,Viktor Troicki,Peter Luczak,Viktor Troicki,6-3; 6-3; 1-6; 2-6; 6-1,R128,170,14,8,58,124,39,58,32,66,6,12,20,71,124,5,2,73,125,39,73,34,52,10,17,20,73,125
2009-08-31 00:00:00.000,US Open NY; U.S.A. Grand Slams,HARD,3,Tomas Berdych,Wayne Odesnik,Tomas Berdych,7-5; 6-4; 6-4,R128,154,6,4,58,110,46,58,26,52,7,8,16,72,110,3,2,72,111,49,72,15,39,10,14,16,64,111
2009-08-31 00:00:00.000,US Open NY; U.S.A. Grand Slams,HARD,3,Horacio Zeballos,Michael Berrer,Horacio Zeballos,6-3; 7-6(7); 3-6; 6-0,R128,178,7,6,84,146,56,84,34,62,15,18,19,90,146,5,8,81,117,55,81,16,36,8,13,17,71,117
2009-08-31 00:00:00.000,US Open NY; U.S.A. Grand Slams,HARD,3,Josselin Ouanna,Rajeev Ram,Josselin Ouanna,7-6(4); 6-4; 3-6; 6-3,R128,163,11,5,79,125,57,79,28,46,7,9,20,85,125,10,6,72,136,58,72,28,64,6,8,20,86,136
2009-08-31 00:00:00.000,US Open NY; U.S.A. Grand Slams,HARD,3,Fernando Gonzalez,Nicolas Massu,Fernando Gonzalez,6-3; 6-3; 6-3,R128,125,12,2,42,80,31,42,23,38,2,4,14,54,80,6,6,60,103,32,60,18,43,11,17,13,50,103
2009-08-31 00:00:00.000,US Open NY; U.S.A. Grand Slams,HARD,3,Gael Monfils,Jeremy Chardy,Gael Monfils,6-1; 6-4; 6-3,R128,95,12,0,44,76,36,44,16,32,3,4,13,52,76,5,8,47,80,32,47,11,33,4,10,13,43,80
2009-08-31 00:00:00.000,US Open NY; U.S.A. Grand Slams,HARD,3,Andreas Beck,Evgeny Korolev,Andreas Beck,6-3; 6-4; 2-6; 2-6; 6-4,R128,188,10,9,82,134,56,82,30,52,4,8,23,86,134,15,6,94,151,71,94,27,57,7,10,22,98,151
2009-08-31 00:00:00.000,US Open NY; U.S.A. Grand Slams,HARD,3,Jose Acasuso,Marcos Daniel,Jose Acasuso,6-2; 6-4; 6-3,R128,108,13,3,39,68,34,39,19,29,0,0,13,53,68,4,4,37,87,27,37,24,50,4,9,14,51,87
2009-08-31 00:00:00.000,US Open NY; U.S.A. Grand Slams,HARD,3,David Ferrer,Alberto Martin,David Ferrer,7-5; 5-7; 6-3; 6-3,R128,163,2,7,63,113,39,63,23,50,4,12,21,62,113,3,6,72,139,44,72,26,67,18,29,21,70,139
2009-08-31 00:00:00.000,US Open NY; U.S.A. Grand Slams,HARD,3,Nicolas Almagro,Steve Darcis,Nicolas Almagro,6-2; 6-4; 2-6; 7-6(8),R128,164,15,5,82,131,63,82,24,49,7,10,19,87,131,10,2,75,132,57,75,26,57,4,8,19,83,132
2009-08-31 00:00:00.000,US Open NY; U.S.A. Grand Slams,HARD,3,Robby Ginepri,Andrei Pavel,Robby Ginepri,5-7; 6-2; 6-4; 6-0,R128,131,7,1,65,101,48,65,14,36,2,6,18,62,101,3,6,68,120,41,68,20,52,6,15,18,61,120
2009-08-31 00:00:00.000,US Open NY; U.S.A. Grand Slams,HARD,3,Nicolas Kiefer,Michael Llodra,Nicolas Kiefer,6-3; 6-4; 6-4,R128,114,12,5,49,87,39,49,21,38,4,6,15,60,87,6,6,50,83,34,50,13,33,1,5,14,47,83
2009-08-31 00:00:00.000,US Open NY; U.S.A. Grand Slams,HARD,3,Rafael Nadal,Richard Gasquet,Rafael Nadal,6-2; 6-2; 6-3,R128,101,7,0,35,62,33,35,19,27,0,0,13,52,62,4,4,49,75,29,49,12,26,5,10,12,41,75
2009-08-31 00:00:00.000,US Open NY; U.S.A. Grand Slams,HARD,3,Juan Martin Del Potro,Juan Monaco,Juan Martin Del Potro,6-3; 6-3; 6-1,R128,125,7,2,37,65,29,37,20,28,2,4,13,49,65,0,0,74,101,37,74,12,27,7,14,12,49,101
2009-08-31 00:00:00.000,US Open NY; U.S.A. Grand Slams,HARD,3,Jurgen Melzer,Marat Safin,Jurgen Melzer,1-6; 6-4; 6-3; 6-4,R128,133,7,6,58,105,49,58,22,47,4,6,18,71,105,15,4,53,106,41,53,29,53,8,11,18,70,106
2009-08-31 00:00:00.000,US Open NY; U.S.A. Grand Slams,HARD,3,Pablo Cuevas,Chris Guccione,Pablo Cuevas,6-4; 7-6(4); 6-0,R128,103,11,1,58,80,49,58,15,22,1,1,14,64,80,12,3,38,82,25,38,25,44,2,6,14,50,82
2009-08-31 00:00:00.000,US Open NY; U.S.A. Grand Slams,HARD,3,Daniel Koellerer,Rui Machado,Daniel Koellerer,6-2; 6-4; 2-6; 6-2,R128,157,1,0,87,115,56,87,18,28,5,7,17,74,115,6,2,61,104,42,61,22,43,5,10,17,64,104
2009-08-31 00:00:00.000,US Open NY; U.S.A. Grand Slams,HARD,3,Juan Carlos Ferrero,Fabrice Santoro,Juan Carlos Ferrero,6-4; 6-3; 6-3,R128,127,5,1,48,84,36,48,18,36,5,8,14,54,84,2,0,51,98,28,51,20,47,9,16,14,48,98
2009-08-31 00:00:00.000,US Open NY; U.S.A. Grand Slams,HARD,3,Philipp Petzschner,Sergiy Stakhovsky,Philipp Petzschner,7-6(3); 6-7(6); 6-4; 4-6; 6-3,R128,210,14,8,83,174,66,83,51,91,6,9,26,117,174,10,5,85,162,68,85,40,77,6,11,27,108,162
2009-08-31 00:00:00.000,US Open NY; U.S.A. Grand Slams,HARD,3,Thomaz Bellucci,Yen-Hsun Lu,Thomaz Bellucci,6-4; 6-2; 6-3,R128,111,8,2,54,86,41,54,19,32,3,4,14,60,86,1,3,47,79,28,47,17,32,3,8,13,45,79
2009-08-31 00:00:00.000,US Open NY; U.S.A. Grand Slams,HARD,3,Gilles Simon,Daniel Gimeno-Traver,Gilles Simon,6-4; 7-6(3); 6-3,R128,125,3,4,45,93,32,45,26,48,3,6,15,58,93,6,5,57,101,39,57,17,44,0,6,16,56,101
2009-08-31 00:00:00.000,US Open NY; U.S.A. Grand Slams,HARD,3,Marin Cilic,Ryan Sweeting,Marin Cilic,7-6(2); 6-4; 7-6(4),R128,145,10,5,53,101,42,53,24,48,6,11,17,66,101,6,5,90,126,55,90,15,36,9,15,17,70,126
2009-08-31 00:00:00.000,US Open NY; U.S.A. Grand Slams,HARD,3,Jesse Levine,Teymuraz Gabashvili,Jesse Levine,7-5; 6-1; 6-2,R128,109,10,5,50,80,39,50,17,30,3,4,13,56,80,4,7,56,95,33,56,15,39,6,13,14,48,95
2009-08-31 00:00:00.000,US Open NY; U.S.A. Grand Slams,HARD,3,Denis Istomin,Brendan Evans,Denis Istomin,6-4; 6-4; 7-6(3),R128,146,18,2,79,118,58,79,23,39,9,10,16,81,118,8,1,65,100,41,65,23,35,3,6,16,64,100
2009-08-31 00:00:00.000,US Open NY; U.S.A. Grand Slams,HARD,3,Nicolas Lapentti,Stanislas Wawrinka,Nicolas Lapentti,4-6; 3-6; 7-6(6); 7-6(3); 6-3,R128,283,5,4,108,166,74,108,28,58,8,16,26,102,166,19,12,98,188,69,98,38,90,13,20,26,107,188
2009-08-31 00:00:00.000,US Open NY; U.S.A. Grand Slams,HARD,3,Ivan Navarro,Ivo Karlovic,Ivan Navarro,6-4; 7-6(8); 7-6(5),R128,133,8,2,70,102,57,70,23,32,0,1,17,80,102,22,3,75,106,62,75,14,31,3,5,17,76,106
2009-08-31 00:00:00.000,US Open NY; U.S.A. Grand Slams,HARD,3,Taylor Dent,Feliciano Lopez,Taylor Dent,4-6; 7-6(6); 6-3; 7-5,R128,170,17,10,88,140,71,88,26,52,5,7,22,97,140,7,5,88,140,64,88,28,52,6,9,21,92,140
2009-08-31 00:00:00.000,US Open NY; U.S.A. Grand Slams,HARD,3,Paul Capdeville,Victor Crivoi,Paul Capdeville,6-3; 6-0; 7-6(2),R128,107,9,1,47,83,37,47,24,36,2,3,14,61,83,5,8,57,109,35,57,21,52,9,14,13,56,109
2009-08-31 00:00:00.000,US Open NY; U.S.A. Grand Slams,HARD,3,Andy Murray,Ernests Gulbis,Andy Murray,7-5; 6-3; 7-5,R128,137,11,1,50,94,42,50,23,44,4,6,17,65,94,11,3,66,110,46,66,16,44,8,13,16,62,110
2009-08-31 00:00:00.000,US Open NY; U.S.A. Grand Slams,HARD,3,Roger Federer,Simon Greul,Roger Federer,6-3; 7-5; 7-5,R64,118,8,2,66,99,48,66,23,33,5,6,17,71,99,0,4,46,93,32,46,25,47,4,8,16,57,93
2009-08-31 00:00:00.000,US Open NY; U.S.A. Grand Slams,HARD,3,Lleyton Hewitt,Juan Ignacio Chela,Lleyton Hewitt,6-3; 6-3; 6-4,R64,130,3,2,47,88,37,47,25,41,8,9,14,62,88,5,2,62,108,40,62,18,46,12,17,14,58,108
2009-08-31 00:00:00.000,US Open NY; U.S.A. Grand Slams,HARD,3,James Blake,Olivier Rochus,James Blake,6-4; 3-6; 7-6(6); 6-3,R64,164,21,4,59,126,47,59,37,67,5,9,21,84,126,5,4,90,128,58,90,20,38,10,14,19,78,128
2009-08-31 00:00:00.000,US Open NY; U.S.A. Grand Slams,HARD,3,Tommy Robredo,Guillermo Garcia-Lopez,Tommy Robredo,6-2; 4-6; 6-2; 6-4,R64,191,11,7,83,145,60,83,27,62,12,15,18,87,145,1,8,65,124,39,65,29,59,12,18,18,68,124
2009-08-31 00:00:00.000,US Open NY; U.S.A. Grand Slams,HARD,3,Robin Soderling,Marcel Granollers,Robin Soderling,2-0 RET,R64,16,1,0,4,6,4,4,2,2,0,0,2,6,6,1,1,3,10,1,3,3,7,1,2,1,4,10
2009-08-31 00:00:00.000,US Open NY; U.S.A. Grand Slams,HARD,3,Sam Querrey,Kevin Kim,Sam Querrey,7-5; 6-7(6); 6-4; 6-4,R64,176,15,3,82,139,66,82,31,57,5,6,22,97,139,9,3,72,147,57,72,37,75,6,10,22,94,147
2009-08-31 00:00:00.000,US Open NY; U.S.A. Grand Slams,HARD,3,Marco Chiudinelli,Mikhail Youzhny,Marco Chiudinelli,2-6; 7-6(4); 6-4; 6-3,R64,187,4,3,60,119,37,60,31,59,10,17,19,68,119,4,8,86,137,51,86,22,51,4,12,20,73,137
2009-08-31 00:00:00.000,US Open NY; U.S.A. Grand Slams,HARD,3,Nikolay Davydenko,Jan Hernych,Nikolay Davydenko,6-4; 6-1; 6-2,R64,88,2,3,51,68,41,51,10,17,1,2,13,51,68,1,1,44,68,25,44,9,24,3,9,12,34,68
2009-08-31 00:00:00.000,US Open NY; U.S.A. Grand Slams,HARD,3,Novak Djokovic,Carsten Ball,Novak Djokovic,6-3; 6-4; 6-4,R64,109,3,0,46,75,35,46,23,29,1,2,15,58,75,8,7,53,93,37,53,18,40,14,18,14,55,93
2009-08-31 00:00:00.000,US Open NY; U.S.A. Grand Slams,HARD,3,Jesse Witten,Maximo Gonzalez,Jesse Witten,6-7(3); 6-4; 7-5; 6-2,R64,215,10,6,63,130,47,63,29,67,9,15,21,76,130,0,7,107,164,59,107,26,57,15,24,21,85,164
2009-08-31 00:00:00.000,US Open NY; U.S.A. Grand Slams,HARD,3,Philipp Kohlschreiber,Somdev Devvarman,Philipp Kohlschreiber,6-3; 6-4; 0-6; 6-2,R64,168,5,4,74,127,51,74,24,53,16,20,17,75,127,3,2,63,100,42,63,17,37,8,13,16,59,100
2009-08-31 00:00:00.000,US Open NY; U.S.A. Grand Slams,HARD,3,Radek Stepanek,Leonardo Mayer,Radek Stepanek,7-6(5); 6-3; 6-4,R64,134,4,9,66,108,54,66,17,42,3,5,16,71,108,6,2,53,90,35,53,22,37,3,7,15,57,90
2009-08-31 00:00:00.000,US Open NY; U.S.A. Grand Slams,HARD,3,Fernando Verdasco,Florent Serra,Fernando Verdasco,6-3; 6-0; 6-3,R64,89,9,7,33,64,27,33,19,31,1,2,12,46,64,4,2,52,91,34,52,10,39,7,14,12,44,91
2009-08-31 00:00:00.000,US Open NY; U.S.A. Grand Slams,HARD,3,Tommy Haas,Robert Kendrick,Tommy Haas,6-4; 6-4; 7-6(3),R64,144,11,2,60,96,51,60,24,36,4,4,16,75,96,8,2,66,132,48,66,33,66,16,18,16,81,132
2009-08-31 00:00:00.000,US Open NY; U.S.A. Grand Slams,HARD,3,John Isner,Marsel Ilhan,John Isner,6-3; 6-4; 7-6(1),R64,119,16,4,55,90,45,55,22,35,2,3,16,67,90,2,1,64,92,40,64,18,28,3,6,15,58,92
2009-08-31 00:00:00.000,US Open NY; U.S.A. Grand Slams,HARD,3,Andy Roddick,Marc Gicquel,Andy Roddick,6-1; 6-4; 6-4,R64,113,13,0,55,81,42,55,19,26,1,1,14,61,81,5,3,49,86,30,49,20,37,1,5,13,50,86
2009-08-31 00:00:00.000,US Open NY; U.S.A. Grand Slams,HARD,3,Jo-Wilfried Tsonga,Jarkko Nieminen,Jo-Wilfried Tsonga,7-5; 6-3; 6-4,R64,109,11,4,48,83,44,48,24,35,1,1,16,68,83,5,2,45,84,33,45,23,39,0,3,15,56,84
2009-08-31 00:00:00.000,US Open NY; U.S.A. Grand Slams,HARD,3,Julien Benneteau,Viktor Troicki,Julien Benneteau,6-1; 3-6; 6-1; 6-0,R64,140,4,2,56,84,42,56,18,28,2,4,15,60,84,6,5,51,105,33,51,18,54,10,17,14,51,105
2009-08-31 00:00:00.000,US Open NY; U.S.A. Grand Slams,HARD,3,Tomas Berdych,Horacio Zeballos,Tomas Berdych,6-3; 6-7(3); 7-6(2); 6-2,R64,180,17,7,74,125,62,74,30,51,0,1,21,92,125,11,4,95,140,61,95,27,45,7,11,20,88,140
2009-08-31 00:00:00.000,US Open NY; U.S.A. Grand Slams,HARD,3,Fernando Gonzalez,Josselin Ouanna,Fernando Gonzalez,6-4; 6-7(5); 6-3; 6-4,R64,137,26,5,77,124,65,77,28,47,3,3,21,93,124,11,3,74,114,56,74,24,40,3,8,20,80,114
2009-08-31 00:00:00.000,US Open NY; U.S.A. Grand Slams,HARD,3,Gael Monfils,Andreas Beck,Gael Monfils,6-3; 7-5; 6-3,R64,118,17,3,61,99,47,61,19,38,2,3,15,66,99,1,7,60,103,40,60,19,43,8,13,15,59,103
2009-08-31 00:00:00.000,US Open NY; U.S.A. Grand Slams,HARD,3,Jose Acasuso,David Ferrer,Jose Acasuso,6-3; 3-6; 1-6; 6-3; 6-2,R64,192,12,9,63,133,48,63,32,70,12,17,21,80,133,10,10,84,140,62,84,21,56,13,19,21,83,140
2009-08-31 00:00:00.000,US Open NY; U.S.A. Grand Slams,HARD,3,Nicolas Almagro,Robby Ginepri,Nicolas Almagro,6-7(7); 6-2; 6-3; 4-6; 6-4,R64,215,18,9,113,189,75,113,36,76,21,29,25,111,189,11,1,100,151,55,100,27,51,9,19,24,82,151
2009-08-31 00:00:00.000,US Open NY; U.S.A. Grand Slams,HARD,3,Rafael Nadal,Nicolas Kiefer,Rafael Nadal,6-0; 3-6; 6-3; 6-4,R64,179,3,1,51,82,37,51,26,31,1,3,17,63,82,7,5,54,133,38,54,33,79,9,15,17,71,133
2009-08-31 00:00:00.000,US Open NY; U.S.A. Grand Slams,HARD,3,Juan Martin Del Potro,Jurgen Melzer,Juan Martin Del Potro,7-6(6); 6-3; 6-3,R64,141,13,4,49,85,43,49,22,36,4,5,15,65,85,8,2,57,104,44,57,22,47,8,12,15,66,104
2009-08-31 00:00:00.000,US Open NY; U.S.A. Grand Slams,HARD,3,Daniel Koellerer,Pablo Cuevas,Daniel Koellerer,3-6; 6-2; 6-1; 6-4,R64,167,3,2,78,125,58,78,23,47,10,11,17,81,125,16,6,68,108,48,68,17,40,4,9,17,65,108
2009-08-31 00:00:00.000,US Open NY; U.S.A. Grand Slams,HARD,3,Juan Carlos Ferrero,Philipp Petzschner,Juan Carlos Ferrero,1-6; 3-6; 6-4; 6-2; 6-4,R64,180,1,2,98,143,65,98,25,45,10,16,22,90,143,17,6,72,142,56,72,29,70,8,14,22,85,142
2009-08-31 00:00:00.000,US Open NY; U.S.A. Grand Slams,HARD,3,Gilles Simon,Thomaz Bellucci,Gilles Simon,6-3; 6-2; 6-4,R64,122,8,0,38,75,30,38,26,37,1,2,14,56,75,8,3,64,101,36,64,19,37,8,12,13,55,101
2009-08-31 00:00:00.000,US Open NY; U.S.A. Grand Slams,HARD,3,Marin Cilic,Jesse Levine,Marin Cilic,4-6; 2-6; 6-0; 6-3; 6-0,R64,166,14,9,65,126,49,65,28,61,7,12,20,77,126,3,10,58,107,35,58,20,49,6,15,19,55,107
2009-08-31 00:00:00.000,US Open NY; U.S.A. Grand Slams,HARD,3,Denis Istomin,Nicolas Lapentti,Denis Istomin,2-6; 6-4; 4-6; 7-5; 7-6(4),R64,288,12,5,108,174,76,108,32,66,10,17,26,108,174,9,6,120,198,85,120,35,78,12,18,26,120,198
2009-08-31 00:00:00.000,US Open NY; U.S.A. Grand Slams,HARD,3,Taylor Dent,Ivan Navarro,Taylor Dent,6-4; 5-7; 6-7(1); 7-5; 7-6(9),R64,252,19,7,130,186,101,130,29,56,2,5,29,130,186,12,4,156,190,111,156,18,34,7,11,29,129,190
2009-08-31 00:00:00.000,US Open NY; U.S.A. Grand Slams,HARD,3,Andy Murray,Paul Capdeville,Andy Murray,6-2; 3-6; 6-0; 6-2,R64,127,15,2,52,99,39,52,26,47,2,3,15,65,99,6,2,60,97,35,60,18,37,9,16,16,53,97
2009-08-31 00:00:00.000,US Open NY; U.S.A. Grand Slams,HARD,3,Roger Federer,Lleyton Hewitt,Roger Federer,4-6; 6-3; 7-5; 6-4,R32,153,15,4,75,134,56,75,31,59,11,14,21,87,134,5,4,57,110,40,57,29,53,6,11,20,69,110
2009-08-31 00:00:00.000,US Open NY; U.S.A. Grand Slams,HARD,3,Tommy Robredo,James Blake,Tommy Robredo,7-6(2); 6-4; 6-4,R32,139,9,3,68,104,53,68,17,36,3,5,16,70,104,2,8,53,102,39,53,24,49,1,5,16,63,102
2009-08-31 00:00:00.000,US Open NY; U.S.A. Grand Slams,HARD,3,Robin Soderling,Sam Querrey,Robin Soderling,6-2; 7-5; 6-7(6); 6-1,R32,141,24,4,65,123,56,65,37,58,8,9,20,93,123,18,7,87,131,62,87,16,44,5,11,19,78,131
2009-08-31 00:00:00.000,US Open NY; U.S.A. Grand Slams,HARD,3,Nikolay Davydenko,Marco Chiudinelli,Nikolay Davydenko,6-4; 7-5; 7-5,R32,154,10,7,68,104,46,68,21,36,7,10,17,67,104,4,2,62,109,34,62,25,47,4,10,17,59,109
2009-08-31 00:00:00.000,US Open NY; U.S.A. Grand Slams,HARD,3,Novak Djokovic,Jesse Witten,Novak Djokovic,6-7(2); 6-3; 7-6(2); 6-4,R32,208,8,8,83,136,58,83,24,53,5,11,21,82,136,5,11,66,142,39,66,40,76,9,18,22,79,142
2009-08-31 00:00:00.000,US Open NY; U.S.A. Grand Slams,HARD,3,Radek Stepanek,Philipp Kohlschreiber,Radek Stepanek,4-6; 6-2; 6-3; 6-3,R32,155,13,4,60,109,48,60,27,49,7,9,18,75,109,10,3,69,112,45,69,18,43,8,14,18,63,112
2009-08-31 00:00:00.000,US Open NY; U.S.A. Grand Slams,HARD,3,Fernando Verdasco,Tommy Haas,Fernando Verdasco,3-6; 7-5; 7-6(8); 1-6; 6-4,R32,225,18,13,102,163,73,102,27,61,8,14,24,100,163,22,6,99,160,73,99,31,61,6,11,26,104,160
2009-08-31 00:00:00.000,US Open NY; U.S.A. Grand Slams,HARD,3,John Isner,Andy Roddick,John Isner,7-6(3); 6-3; 3-6; 5-7; 7-6(5),R32,231,38,7,106,163,85,106,34,57,7,9,27,119,163,20,2,102,154,85,102,33,52,6,7,27,118,154
2009-08-31 00:00:00.000,US Open NY; U.S.A. Grand Slams,HARD,3,Jo-Wilfried Tsonga,Julien Benneteau,Jo-Wilfried Tsonga,7-6(4); 6-2; 6-4,R32,132,10,1,58,89,49,58,19,31,3,3,15,68,89,6,4,59,98,41,59,21,39,7,10,15,62,98
2009-08-31 00:00:00.000,US Open NY; U.S.A. Grand Slams,HARD,3,Fernando Gonzalez,Tomas Berdych,Fernando Gonzalez,7-5; 6-4; 6-4,R32,132,15,4,56,99,46,56,25,43,4,4,16,71,99,4,1,50,98,36,50,29,48,6,9,16,65,98
2009-08-31 00:00:00.000,US Open NY; U.S.A. Grand Slams,HARD,3,Gael Monfils,Jose Acasuso,Gael Monfils,6-3; 6-4; 1-0 RET,R32,85,10,1,41,59,33,41,11,18,1,1,10,44,59,2,2,29,57,22,29,13,28,3,6,10,35,57
2009-08-31 00:00:00.000,US Open NY; U.S.A. Grand Slams,HARD,3,Rafael Nadal,Nicolas Almagro,Rafael Nadal,7-5; 6-4; 6-4,R32,159,2,3,63,101,39,63,21,38,8,13,16,60,101,5,9,52,102,31,52,18,50,5,12,16,49,102
2009-08-31 00:00:00.000,US Open NY; U.S.A. Grand Slams,HARD,3,Juan Martin Del Potro,Daniel Koellerer,Juan Martin Del Potro,6-1; 3-6; 6-3; 6-3,R32,157,20,4,58,93,47,58,13,35,5,10,17,60,93,0,2,79,113,40,79,15,34,7,16,17,55,113
2009-08-31 00:00:00.000,US Open NY; U.S.A. Grand Slams,HARD,3,Juan Carlos Ferrero,Gilles Simon,Juan Carlos Ferrero,1-6; 6-4; 7-6(5); 1-0 RET,R32,149,9,2,54,91,37,54,22,37,5,8,14,59,91,8,4,65,112,46,65,24,47,9,12,16,70,112
2009-08-31 00:00:00.000,US Open NY; U.S.A. Grand Slams,HARD,3,Marin Cilic,Denis Istomin,Marin Cilic,6-1; 6-4; 6-3,R32,113,2,2,38,79,31,38,27,41,3,3,13,58,79,1,3,59,85,34,59,12,26,3,8,13,46,85
2009-08-31 00:00:00.000,US Open NY; U.S.A. Grand Slams,HARD,3,Andy Murray,Taylor Dent,Andy Murray,6-3; 6-2; 6-2,R32,90,7,1,32,68,29,32,22,36,1,2,13,51,68,2,2,43,70,25,43,11,27,5,11,12,36,70
2009-08-31 00:00:00.000,US Open NY; U.S.A. Grand Slams,HARD,3,Roger Federer,Tommy Robredo,Roger Federer,7-5; 6-2; 6-2,R16,108,9,0,47,75,41,47,19,28,4,4,14,60,75,2,2,64,93,40,64,11,29,5,10,14,51,93
2009-08-31 00:00:00.000,US Open NY; U.S.A. Grand Slams,HARD,3,Robin Soderling,Nikolay Davydenko,Robin Soderling,7-5; 3-6; 6-2 RET,R16,129,8,5,50,90,43,50,15,40,2,5,15,58,90,4,3,65,95,43,65,15,30,9,13,14,58,95
2009-08-31 00:00:00.000,US Open NY; U.S.A. Grand Slams,HARD,3,Novak Djokovic,Radek Stepanek,Novak Djokovic,6-1; 6-3; 6-3,R16,106,5,3,46,74,35,46,16,28,2,3,13,51,74,4,1,49,80,26,49,14,31,7,13,12,40,80
2009-08-31 00:00:00.000,US Open NY; U.S.A. Grand Slams,HARD,3,Fernando Verdasco,John Isner,Fernando Verdasco,4-6; 6-4; 6-4; 6-4,R16,146,7,4,76,102,57,76,16,26,1,4,20,73,102,13,3,72,102,52,72,16,30,3,8,20,68,102
2009-08-31 00:00:00.000,US Open NY; U.S.A. Grand Slams,HARD,3,Fernando Gonzalez,Jo-Wilfried Tsonga,Fernando Gonzalez,3-6; 6-3; 7-6(3); 6-4,R16,161,8,3,85,135,67,85,29,50,13,14,20,96,135,15,4,80,127,64,80,21,47,5,7,20,85,127
2009-08-31 00:00:00.000,US Open NY; U.S.A. Grand Slams,HARD,3,Rafael Nadal,Gael Monfils,Rafael Nadal,6-7(3); 6-3; 6-1; 6-3,R16,165,0,0,81,110,59,81,18,29,3,6,19,77,110,11,4,66,108,46,66,15,42,6,14,18,61,108
2009-08-31 00:00:00.000,US Open NY; U.S.A. Grand Slams,HARD,3,Juan Martin Del Potro,Juan Carlos Ferrero,Juan Martin Del Potro,6-3; 6-3; 6-3,R16,128,22,1,61,90,49,61,15,29,4,4,14,64,90,4,2,56,84,36,56,13,28,5,9,13,49,84
2009-08-31 00:00:00.000,US Open NY; U.S.A. Grand Slams,HARD,3,Marin Cilic,Andy Murray,Marin Cilic,7-5; 6-2; 6-2,R16,128,10,3,48,93,38,48,26,45,7,7,14,64,93,5,3,50,78,33,50,14,28,4,9,14,47,78
2009-08-31 00:00:00.000,US Open NY; U.S.A. Grand Slams,HARD,3,Roger Federer,Robin Soderling,Roger Federer,6-0; 6-3; 6-7(6); 7-6(6),Q,153,28,3,85,128,73,85,24,43,5,5,20,97,128,11,5,85,127,62,85,19,42,7,11,19,81,127
2009-08-31 00:00:00.000,US Open NY; U.S.A. Grand Slams,HARD,3,Novak Djokovic,Fernando Verdasco,Novak Djokovic,7-6(2); 1-6; 7-5; 6-2,Q,185,9,4,93,138,66,93,23,45,10,14,20,89,138,5,8,68,122,47,68,26,54,8,12,19,73,122
2009-08-31 00:00:00.000,US Open NY; U.S.A. Grand Slams,HARD,3,Rafael Nadal,Fernando Gonzalez,Rafael Nadal,7-6(4); 7-6(2); 6-0,Q,157,1,0,65,87,55,65,16,22,2,2,15,71,87,9,6,65,107,43,65,22,42,7,10,15,65,107
2009-08-31 00:00:00.000,US Open NY; U.S.A. Grand Slams,HARD,3,Juan Martin Del Potro,Marin Cilic,Juan Martin Del Potro,4-6; 6-3; 6-2; 6-1,Q,153,6,4,62,94,50,62,14,32,4,7,17,64,94,7,2,62,105,40,62,17,43,0,8,17,57,105
2009-08-31 00:00:00.000,US Open NY; U.S.A. Grand Slams,HARD,3,Roger Federer,Novak Djokovic,Roger Federer,7-6(3); 7-5; 7-5,S,154,8,3,63,109,49,63,28,46,2,3,18,77,109,6,4,78,115,53,78,20,37,7,10,18,73,115
2009-08-31 00:00:00.000,US Open NY; U.S.A. Grand Slams,HARD,3,Juan Martin Del Potro,Rafael Nadal,Juan Martin Del Potro,6-2; 6-2; 6-2,S,140,6,3,56,85,44,56,12,29,5,5,12,56,85,4,4,70,90,40,70,6,20,10,16,12,46,90
2009-08-31 00:00:00.000,US Open NY; U.S.A. Grand Slams,HARD,3,Juan Martin Del Potro,Roger Federer,Juan Martin Del Potro,3-6; 7-6(5); 4-6; 7-6(4); 6-2,F,246,8,6,112,171,81,112,33,59,17,22,25,114,171,14,11,93,181,67,93,48,88,10,15,26,115,181
2009-09-21 00:00:00.000,Bucharest Romania ATP World Tour 250,CLAY,2,Oscar Hernandez,Victor Hanescu,Oscar Hernandez,7-6(5); 6-4,R32,113,4,1,56,81,41,56,10,25,4,6,11,51,81,2,1,54,72,31,54,10,18,2,5,11,41,72
2009-09-21 00:00:00.000,Bucharest Romania ATP World Tour 250,CLAY,2,Maximo Gonzalez,Olivier Rochus,Maximo Gonzalez,6-7(4); 6-1; 6-4,R32,164,7,2,70,111,47,70,21,41,10,12,14,68,111,4,4,79,115,45,79,17,36,6,12,15,62,115
2009-09-21 00:00:00.000,Bucharest Romania ATP World Tour 250,CLAY,2,Simon Greul,Steve Darcis,Simon Greul,7-5; 6-3,R32,104,1,4,46,83,33,46,18,37,4,5,11,51,83,2,1,39,67,26,39,12,28,4,7,10,38,67
2009-09-21 00:00:00.000,Bucharest Romania ATP World Tour 250,CLAY,2,Daniel Koellerer,Filippo Volandri,Daniel Koellerer,2-6; 7-5; 6-3,R32,169,2,1,67,103,36,67,18,36,11,17,15,54,103,1,1,84,105,44,84,12,21,9,15,14,56,105
2009-09-21 00:00:00.000,Bucharest Romania ATP World Tour 250,CLAY,2,Juan Monaco,Julio Silva,Juan Monaco,6-2; 6-4,R32,77,4,0,35,56,23,35,15,21,2,3,9,38,56,1,0,37,53,20,37,9,16,3,7,9,29,53
2009-09-21 00:00:00.000,Bucharest Romania ATP World Tour 250,CLAY,2,Pere Riba,Frederico Gil,Pere Riba,7-5; 5-7; 6-2,R32,158,3,2,59,112,40,59,29,53,7,10,16,69,112,6,6,55,94,36,55,19,39,3,8,16,55,94
2009-09-21 00:00:00.000,Bucharest Romania ATP World Tour 250,CLAY,2,Peter Luczak,Karol Beck,Peter Luczak,7-5; 7-6(6),R32,148,7,3,61,104,42,61,20,43,6,8,12,62,104,9,2,45,79,33,45,13,34,1,4,12,46,79
2009-09-21 00:00:00.000,Bucharest Romania ATP World Tour 250,CLAY,2,Pablo Cuevas,Andrei Pavel,Pablo Cuevas,6-3; 7-6(2),R32,80,8,1,45,63,36,45,11,18,2,3,11,47,63,1,0,45,60,28,45,9,15,2,4,10,37,60
2009-09-21 00:00:00.000,Bucharest Romania ATP World Tour 250,CLAY,2,Ruben Ramirez Hidalgo,Andreas Seppi,Ruben Ramirez Hidalgo,6-4; 6-4,R32,124,1,3,43,69,30,43,12,26,7,9,10,42,69,5,9,33,78,24,33,17,45,8,12,10,41,78
2009-09-21 00:00:00.000,Bucharest Romania ATP World Tour 250,CLAY,2,Marius Copil,Victor Crivoi,Marius Copil,6-3; 6-2,R32,75,3,2,28,57,21,28,18,29,2,2,9,39,57,0,0,25,47,16,25,10,22,2,5,8,26,47
2009-09-21 00:00:00.000,Bucharest Romania ATP World Tour 250,CLAY,2,Alberto Martin,Florent Serra,Alberto Martin,4-6; 6-0; 6-4,R32,137,5,1,53,100,38,53,23,47,6,8,13,61,100,2,5,55,100,37,55,16,45,10,15,13,53,100
2009-09-21 00:00:00.000,Bucharest Romania ATP World Tour 250,CLAY,2,Santiago Ventura,Igor Andreev,Santiago Ventura,6-4; 6-1,R32,64,4,0,29,46,22,29,12,17,2,3,9,34,46,0,2,23,42,12,23,9,19,1,5,8,21,42
2009-09-21 00:00:00.000,Bucharest Romania ATP World Tour 250,CLAY,2,Albert Montanes,Potito Starace,Albert Montanes,6-4; 6-2,R32,76,4,0,40,58,29,40,11,18,6,7,9,40,58,3,2,39,56,22,39,7,17,4,8,9,29,56
2009-09-21 00:00:00.000,Bucharest Romania ATP World Tour 250,CLAY,2,Marcel Granollers,Petru-Alexandru Luncanu,Marcel Granollers,6-2; 6-7(3); 6-1,R32,130,2,1,56,86,45,56,14,30,5,6,14,59,86,0,4,64,98,38,64,16,34,10,15,13,54,98
2009-09-21 00:00:00.000,Bucharest Romania ATP World Tour 250,CLAY,2,Fabio Fognini,Daniel Gimeno-Traver,Fabio Fognini,1-6; 6-4; 6-3,R32,121,2,4,47,77,32,47,12,30,3,7,13,44,77,4,4,51,86,35,51,15,35,4,8,13,50,86
2009-09-21 00:00:00.000,Bucharest Romania ATP World Tour 250,CLAY,2,Nicolas Almagro,Simone Bolelli,Nicolas Almagro,6-4; 6-3,R32,81,5,1,38,66,28,38,17,28,5,6,10,45,66,2,1,43,56,30,43,3,13,2,5,9,33,56
2009-09-21 00:00:00.000,Bucharest Romania ATP World Tour 250,CLAY,2,Maximo Gonzalez,Oscar Hernandez,Maximo Gonzalez,7-5; 3-6; 6-1,R16,139,1,2,60,86,43,60,15,26,4,6,14,58,86,1,6,67,93,42,67,11,26,10,14,14,53,93
2009-09-21 00:00:00.000,Bucharest Romania ATP World Tour 250,CLAY,2,Simon Greul,Daniel Koellerer,Simon Greul,6-1; 6-4,R16,80,11,4,27,59,21,27,17,32,11,12,8,38,59,2,2,34,59,17,34,12,25,3,8,9,29,59
2009-09-21 00:00:00.000,Bucharest Romania ATP World Tour 250,CLAY,2,Juan Monaco,Pere Riba,Juan Monaco,6-4; 6-2,R16,78,0,1,21,44,16,21,20,23,0,0,9,36,44,2,0,39,57,23,39,10,18,5,8,9,33,57
2009-09-21 00:00:00.000,Bucharest Romania ATP World Tour 250,CLAY,2,Pablo Cuevas,Peter Luczak,Pablo Cuevas,7-5; 6-4,R16,119,7,2,41,75,29,41,19,34,7,9,11,48,75,0,3,37,64,23,37,14,27,3,7,11,37,64
2009-09-21 00:00:00.000,Bucharest Romania ATP World Tour 250,CLAY,2,Ruben Ramirez Hidalgo,Marius Copil,Ruben Ramirez Hidalgo,6-3; 6-7(3); 6-4,R16,198,0,6,78,117,51,78,19,39,7,9,15,70,117,11,7,48,99,38,48,20,51,2,7,16,58,99
2009-09-21 00:00:00.000,Bucharest Romania ATP World Tour 250,CLAY,2,Santiago Ventura,Alberto Martin,Santiago Ventura,4-5 RET,R16,49,2,1,25,43,18,25,7,18,2,3,5,25,43,2,1,11,19,10,11,6,8,0,0,4,16,19
2009-09-21 00:00:00.000,Bucharest Romania ATP World Tour 250,CLAY,2,Albert Montanes,Marcel Granollers,Albert Montanes,6-1; 6-3,R16,68,1,3,25,44,21,25,12,19,0,0,8,33,44,2,2,35,52,18,35,7,17,6,10,8,25,52
2009-09-21 00:00:00.000,Bucharest Romania ATP World Tour 250,CLAY,2,Fabio Fognini,Nicolas Almagro,Fabio Fognini,6-4; 7-6(3),R16,103,2,2,55,80,37,55,15,25,6,8,11,52,80,5,2,47,72,32,47,11,25,1,4,11,43,72
2009-09-21 00:00:00.000,Bucharest Romania ATP World Tour 250,CLAY,2,Simon Greul,Maximo Gonzalez,Simon Greul,6-2; 6-2,Q,64,0,0,28,48,17,28,15,20,1,2,8,32,48,0,2,28,45,12,28,8,17,4,9,8,20,45
2009-09-21 00:00:00.000,Bucharest Romania ATP World Tour 250,CLAY,2,Juan Monaco,Pablo Cuevas,Juan Monaco,6-3; 2-6; 6-1,Q,115,1,0,50,76,34,50,17,26,6,8,12,51,76,4,1,54,84,36,54,13,30,7,11,12,49,84
2009-09-21 00:00:00.000,Bucharest Romania ATP World Tour 250,CLAY,2,Santiago Ventura,Ruben Ramirez Hidalgo,Santiago Ventura,6-2; 6-3,Q,91,5,1,35,54,25,35,8,19,3,5,9,33,54,0,2,32,66,18,32,12,34,7,12,8,30,66
2009-09-21 00:00:00.000,Bucharest Romania ATP World Tour 250,CLAY,2,Albert Montanes,Fabio Fognini,Albert Montanes,6-1; 6-1,Q,57,2,0,28,40,22,28,10,12,2,2,7,32,40,2,1,29,53,17,29,6,24,7,12,7,23,53
2009-09-21 00:00:00.000,Bucharest Romania ATP World Tour 250,CLAY,2,Juan Monaco,Simon Greul,Juan Monaco,6-4; 6-3,S,91,3,2,49,68,34,49,9,19,4,5,10,43,68,1,0,32,53,21,32,9,21,2,5,9,30,53
2009-09-21 00:00:00.000,Bucharest Romania ATP World Tour 250,CLAY,2,Albert Montanes,Santiago Ventura,Albert Montanes,4-6; 6-4; 6-1,S,111,1,3,55,84,42,55,14,29,3,6,14,56,84,1,0,50,77,35,50,10,27,4,9,13,45,77
2009-09-21 00:00:00.000,Bucharest Romania ATP World Tour 250,CLAY,2,Albert Montanes,Juan Monaco,Albert Montanes,7-6(2); 7-6(6),F,131,2,2,63,90,43,63,16,27,5,6,12,59,90,1,1,68,83,44,68,9,15,2,3,12,53,83
2009-09-21 00:00:00.000,Metz France ATP World Tour 250,HARD,2,Gael Monfils,N/A Bye,Gael Monfils,,R32,0,0,0,0,0,0,0,0,0,0,0,0,0,0,0,0,0,0,0,0,0,0,0,0,0,0,0
2009-09-21 00:00:00.000,Metz France ATP World Tour 250,HARD,2,Sebastien Grosjean,Nicolas Mahut,Sebastien Grosjean,7-6(1); 7-5,R32,112,4,1,42,81,30,42,25,39,1,2,12,55,81,6,4,48,81,35,48,15,33,5,7,12,50,81
2009-09-21 00:00:00.000,Metz France ATP World Tour 250,HARD,2,Janko Tipsarevic,Arnaud Clement,Janko Tipsarevic,6-4; 6-4,R32,80,10,1,31,50,27,31,13,19,0,0,10,40,50,3,2,33,60,27,33,12,27,3,5,10,39,60
2009-09-21 00:00:00.000,Metz France ATP World Tour 250,HARD,2,Ivan Ljubicic,Sebastien De Chaunac,Ivan Ljubicic,4-6; 6-1; 7-6(1),R32,142,21,3,61,93,50,61,17,32,4,5,15,67,93,5,2,54,102,37,54,26,48,8,10,14,63,102
2009-09-21 00:00:00.000,Metz France ATP World Tour 250,HARD,2,Philipp Petzschner,N/A Bye,Philipp Petzschner,,R32,0,0,0,0,0,0,0,0,0,0,0,0,0,0,0,0,0,0,0,0,0,0,0,0,0,0,0
2009-09-21 00:00:00.000,Metz France ATP World Tour 250,HARD,2,Michael Llodra,Mischa Zverev,Michael Llodra,4-6; 6-3; 6-3,R32,109,15,1,62,90,45,62,15,28,7,8,14,60,90,8,2,59,99,39,59,20,40,7,10,14,59,99
2009-09-21 00:00:00.000,Metz France ATP World Tour 250,HARD,2,Richard Gasquet,Michael Berrer,Richard Gasquet,6-3; 2-6; 7-6(5),R32,152,12,5,63,115,48,63,24,52,10,12,14,72,115,12,3,77,107,58,77,10,30,11,13,15,68,107
2009-09-21 00:00:00.000,Metz France ATP World Tour 250,HARD,2,Christophe Rochus,Fabrice Santoro,Christophe Rochus,0-6; 6-4; 7-6(3),R32,116,0,2,62,89,37,62,9,27,2,9,14,46,89,20,2,46,79,35,46,11,33,1,6,14,46,79
2009-09-21 00:00:00.000,Metz France ATP World Tour 250,HARD,2,Andreas Beck,Yen-Hsun Lu,Andreas Beck,6-4; 6-2,R32,72,6,2,35,61,28,35,15,26,5,5,9,43,61,5,2,30,50,19,30,10,20,2,5,9,29,50
2009-09-21 00:00:00.000,Metz France ATP World Tour 250,HARD,2,Thierry Ascione,Adrian Mannarino,Thierry Ascione,7-6(5); 6-4,R32,96,9,0,48,67,38,48,14,19,1,1,11,52,67,11,1,40,78,32,40,22,38,6,7,11,54,78
2009-09-21 00:00:00.000,Metz France ATP World Tour 250,HARD,2,Marc Gicquel,Roman Valent,Marc Gicquel,6-3; 6-1,R32,54,5,0,24,43,20,24,14,19,0,0,8,34,43,1,2,27,46,16,27,7,19,0,4,8,23,46
2009-09-21 00:00:00.000,Metz France ATP World Tour 250,HARD,2,Paul-Henri Mathieu,N/A Bye,Paul-Henri Mathieu,,R32,0,0,0,0,0,0,0,0,0,0,0,0,0,0,0,0,0,0,0,0,0,0,0,0,0,0,0
2009-09-21 00:00:00.000,Metz France ATP World Tour 250,HARD,2,Evgeny Korolev,Benjamin Becker,Evgeny Korolev,6-2; 6-3,R32,52,7,0,26,39,23,26,9,13,0,0,8,32,39,8,1,30,46,21,30,5,16,0,4,9,26,46
2009-09-21 00:00:00.000,Metz France ATP World Tour 250,HARD,2,Denis Istomin,Andrey Golubev,Denis Istomin,6-2; 6-4,R32,58,0,0,35,49,27,35,7,14,0,1,9,34,49,3,2,33,48,22,33,7,15,0,4,9,29,48
2009-09-21 00:00:00.000,Metz France ATP World Tour 250,HARD,2,Bjorn Phau,Rainer Schuettler,Bjorn Phau,7-6(1); 7-6(5),R32,110,4,3,49,84,36,49,18,35,6,8,12,54,84,3,2,46,80,34,46,14,34,1,3,12,48,80
2009-09-21 00:00:00.000,Metz France ATP World Tour 250,HARD,2,Philipp Kohlschreiber,N/A Bye,Philipp Kohlschreiber,,R32,0,0,0,0,0,0,0,0,0,0,0,0,0,0,0,0,0,0,0,0,0,0,0,0,0,0,0
2009-09-21 00:00:00.000,Metz France ATP World Tour 250,HARD,2,Gael Monfils,Sebastien Grosjean,Gael Monfils,6-1; 6-1,R16,66,10,1,28,50,22,28,10,22,6,7,7,32,50,1,3,41,60,18,41,8,19,7,13,7,26,60
2009-09-21 00:00:00.000,Metz France ATP World Tour 250,HARD,2,Janko Tipsarevic,Ivan Ljubicic,Janko Tipsarevic,6-4; 7-6(3),R16,115,7,3,41,69,33,41,16,28,4,5,11,49,69,11,3,49,83,36,49,16,34,6,8,11,52,83
2009-09-21 00:00:00.000,Metz France ATP World Tour 250,HARD,2,Philipp Petzschner,Michael Llodra,Philipp Petzschner,7-6(3); 6-3,R16,93,6,1,38,70,33,38,18,32,5,5,11,51,70,5,6,38,74,28,38,18,36,4,5,10,46,74
2009-09-21 00:00:00.000,Metz France ATP World Tour 250,HARD,2,Richard Gasquet,Christophe Rochus,Richard Gasquet,7-5; 4-6; 6-2,R16,129,21,3,47,83,38,47,18,36,3,6,15,56,83,6,1,81,110,49,81,13,29,7,12,15,62,110
2009-09-21 00:00:00.000,Metz France ATP World Tour 250,HARD,2,Andreas Beck,Thierry Ascione,Andreas Beck,6-2; 6-4,R16,67,3,1,27,44,24,27,12,17,0,0,9,36,44,2,2,43,57,27,43,6,14,3,6,9,33,57
2009-09-21 00:00:00.000,Metz France ATP World Tour 250,HARD,2,Paul-Henri Mathieu,Marc Gicquel,Paul-Henri Mathieu,7-6(5); 6-4,R16,86,4,0,43,64,36,43,12,21,1,2,11,48,64,8,0,41,68,25,41,21,27,4,6,11,46,68
2009-09-21 00:00:00.000,Metz France ATP World Tour 250,HARD,2,Evgeny Korolev,Denis Istomin,Evgeny Korolev,3-6; 7-5; 7-6(2),R16,138,12,5,65,112,54,65,20,47,5,8,17,74,112,8,2,79,115,56,79,17,36,6,8,16,73,115
2009-09-21 00:00:00.000,Metz France ATP World Tour 250,HARD,2,Philipp Kohlschreiber,Bjorn Phau,Philipp Kohlschreiber,4-6; 6-3; 6-2,R16,109,3,1,46,75,36,46,19,29,1,2,14,55,75,2,3,46,86,32,46,20,40,2,5,13,52,86
2009-09-21 00:00:00.000,Metz France ATP World Tour 250,HARD,2,Gael Monfils,Janko Tipsarevic,Gael Monfils,6-1; 4-2 RET,Q,46,8,0,25,40,22,25,8,15,0,0,7,30,40,2,1,25,34,14,25,3,9,1,4,6,17,34
2009-09-21 00:00:00.000,Metz France ATP World Tour 250,HARD,2,Richard Gasquet,Philipp Petzschner,Richard Gasquet,6-7(2); 6-1; 6-3,Q,106,3,2,48,87,33,48,27,39,2,3,14,60,87,16,5,45,82,33,45,15,37,2,7,14,48,82
2009-09-21 00:00:00.000,Metz France ATP World Tour 250,HARD,2,Paul-Henri Mathieu,Andreas Beck,Paul-Henri Mathieu,6-2; 3-6; 6-3,Q,114,18,3,50,84,41,50,15,34,0,1,13,56,84,14,0,52,86,36,52,18,34,6,9,13,54,86
2009-09-21 00:00:00.000,Metz France ATP World Tour 250,HARD,2,Philipp Kohlschreiber,Evgeny Korolev,Philipp Kohlschreiber,6-1; 6-3,Q,54,5,0,27,40,24,27,9,13,0,0,8,33,40,5,0,27,47,17,27,8,20,2,6,8,25,47
2009-09-21 00:00:00.000,Metz France ATP World Tour 250,HARD,2,Gael Monfils,Richard Gasquet,Gael Monfils,6-4; 6-3,S,81,13,1,30,50,27,30,11,20,4,4,9,38,50,2,4,48,81,33,48,13,33,2,5,10,46,81
2009-09-21 00:00:00.000,Metz France ATP World Tour 250,HARD,2,Philipp Kohlschreiber,Paul-Henri Mathieu,Philipp Kohlschreiber,7-6(5); 6-4,S,99,13,0,48,71,39,48,15,23,5,5,11,54,71,15,2,47,74,38,47,10,27,1,2,11,48,74
2009-09-21 00:00:00.000,Metz France ATP World Tour 250,HARD,2,Gael Monfils,Philipp Kohlschreiber,Gael Monfils,7-6(1); 3-6; 6-2,F,133,14,2,50,84,44,50,19,34,3,4,14,63,84,7,2,79,112,52,79,16,33,8,10,15,68,112
2009-09-28 00:00:00.000,Bangkok Thailand ATP World Tour 250,HARD,2,Jo-Wilfried Tsonga,N/A Bye,Jo-Wilfried Tsonga,,R32,0,0,0,0,0,0,0,0,0,0,0,0,0,0,0,0,0,0,0,0,0,0,0,0,0,0,0
2009-09-28 00:00:00.000,Bangkok Thailand ATP World Tour 250,HARD,2,Ernests Gulbis,Somdev Devvarman,Ernests Gulbis,7-6(7); 6-2,R32,96,14,2,49,68,40,49,7,19,4,5,10,47,68,2,2,53,79,36,53,12,26,5,8,10,48,79
2009-09-28 00:00:00.000,Bangkok Thailand ATP World Tour 250,HARD,2,Marco Chiudinelli,Florian Mayer,Marco Chiudinelli,6-3; 6-3,R32,74,4,0,33,52,25,33,12,19,2,3,9,37,52,5,0,39,53,24,39,7,14,0,4,9,31,53
2009-09-28 00:00:00.000,Bangkok Thailand ATP World Tour 250,HARD,2,Marat Safin,Philipp Petzschner,Marat Safin,6-2; 3-6; 6-1,R32,97,7,6,46,84,36,46,20,38,2,3,12,56,84,0,5,49,85,32,49,16,36,6,10,12,48,85
2009-09-28 00:00:00.000,Bangkok Thailand ATP World Tour 250,HARD,2,Viktor Troicki,N/A Bye,Viktor Troicki,,R32,0,0,0,0,0,0,0,0,0,0,0,0,0,0,0,0,0,0,0,0,0,0,0,0,0,0,0
2009-09-28 00:00:00.000,Bangkok Thailand ATP World Tour 250,HARD,2,Thomaz Bellucci,Guillermo Garcia-Lopez,Thomaz Bellucci,6-4; 7-6(7),R32,117,4,4,54,84,38,54,18,30,11,12,11,56,84,3,3,50,72,36,50,11,22,4,6,11,47,72
2009-09-28 00:00:00.000,Bangkok Thailand ATP World Tour 250,HARD,2,Mischa Zverev,Leonardo Mayer,Mischa Zverev,5-7; 6-3; 6-3,R32,123,5,2,70,101,54,70,14,31,6,7,15,68,101,9,5,55,95,42,55,19,40,3,6,15,61,95
2009-09-28 00:00:00.000,Bangkok Thailand ATP World Tour 250,HARD,2,John Isner,Kittipong Wachiramanowong,John Isner,6-3; 3-6; 7-6(5),R32,132,21,0,72,104,52,72,19,32,4,6,15,71,104,7,1,51,90,36,51,28,39,2,4,15,64,90
2009-09-28 00:00:00.000,Bangkok Thailand ATP World Tour 250,HARD,2,Jurgen Melzer,Marcos Daniel,Jurgen Melzer,6-3; 6-2,R32,56,13,0,38,47,33,38,5,9,1,1,9,38,47,2,2,31,44,20,31,6,13,3,6,8,26,44
2009-09-28 00:00:00.000,Bangkok Thailand ATP World Tour 250,HARD,2,Marsel Ilhan,Benjamin Becker,Marsel Ilhan,4-6; 7-6(4); 6-3,R32,119,8,1,63,90,49,63,15,27,4,5,15,64,90,15,1,53,90,40,53,23,37,0,2,16,63,90
2009-09-28 00:00:00.000,Bangkok Thailand ATP World Tour 250,HARD,2,Andreas Beck,Edouard Roger-Vasselin,Andreas Beck,7-5; 7-6(1),R32,107,8,3,46,71,36,46,13,25,2,4,12,49,71,7,1,56,84,33,56,16,28,6,9,12,49,84
2009-09-28 00:00:00.000,Bangkok Thailand ATP World Tour 250,HARD,2,Donald Young,N/A Bye,Donald Young,,R32,0,0,0,0,0,0,0,0,0,0,0,0,0,0,0,0,0,0,0,0,0,0,0,0,0,0,0
2009-09-28 00:00:00.000,Bangkok Thailand ATP World Tour 250,HARD,2,Evgeny Korolev,Fabrice Santoro,Evgeny Korolev,4-6; 7-6(4); 7-6(7),R32,168,5,4,74,123,51,74,28,49,12,15,17,79,123,13,1,64,121,48,64,29,57,8,10,17,77,121
2009-09-28 00:00:00.000,Bangkok Thailand ATP World Tour 250,HARD,2,Robby Ginepri,Danai Udomchoke,Robby Ginepri,6-4; 6-3,R32,70,5,1,44,55,33,44,8,11,1,1,10,41,55,2,2,41,64,29,41,10,23,8,10,9,39,64
2009-09-28 00:00:00.000,Bangkok Thailand ATP World Tour 250,HARD,2,Kevin Kim,Rainer Schuettler,Kevin Kim,6-4; 6-4,R32,72,7,1,40,60,31,40,11,20,3,4,10,42,60,6,0,42,57,27,42,7,15,1,4,10,34,57
2009-09-28 00:00:00.000,Bangkok Thailand ATP World Tour 250,HARD,2,Gilles Simon,N/A Bye,Gilles Simon,,R32,0,0,0,0,0,0,0,0,0,0,0,0,0,0,0,0,0,0,0,0,0,0,0,0,0,0,0
2009-09-28 00:00:00.000,Bangkok Thailand ATP World Tour 250,HARD,2,Jo-Wilfried Tsonga,Ernests Gulbis,Jo-Wilfried Tsonga,6-7(3); 7-6(4); 7-6(2),R16,132,20,2,76,112,60,76,24,36,0,0,18,84,112,23,2,75,109,63,75,19,34,1,1,18,82,109
2009-09-28 00:00:00.000,Bangkok Thailand ATP World Tour 250,HARD,2,Marco Chiudinelli,Marat Safin,Marco Chiudinelli,6-3; 7-6(4),R16,89,5,1,41,68,33,41,19,27,3,3,11,52,68,6,1,40,65,33,40,12,25,1,2,10,45,65
2009-09-28 00:00:00.000,Bangkok Thailand ATP World Tour 250,HARD,2,Viktor Troicki,Thomaz Bellucci,Viktor Troicki,6-3; 7-6(4),R16,88,3,0,42,65,36,42,15,23,1,1,11,51,65,6,3,46,68,37,46,9,22,4,5,10,46,68
2009-09-28 00:00:00.000,Bangkok Thailand ATP World Tour 250,HARD,2,John Isner,Mischa Zverev,John Isner,7-6(5); 6-4,R16,84,7,2,53,71,40,53,9,18,2,3,11,49,71,8,0,55,79,38,55,12,24,3,5,11,50,79
2009-09-28 00:00:00.000,Bangkok Thailand ATP World Tour 250,HARD,2,Jurgen Melzer,Marsel Ilhan,Jurgen Melzer,6-4; 6-2,R16,67,9,1,28,48,25,28,14,20,4,4,9,39,48,0,0,43,57,25,43,6,14,2,5,9,31,57
2009-09-28 00:00:00.000,Bangkok Thailand ATP World Tour 250,HARD,2,Andreas Beck,Donald Young,Andreas Beck,6-1; 6-7(3); 6-4,R16,120,8,3,55,88,46,55,17,33,3,4,15,63,88,4,0,67,104,34,67,27,37,10,14,14,61,104
2009-09-28 00:00:00.000,Bangkok Thailand ATP World Tour 250,HARD,2,Evgeny Korolev,Robby Ginepri,Evgeny Korolev,6-1; 6-1,R16,43,7,1,25,34,21,25,7,9,0,0,7,28,34,0,0,26,43,16,26,1,17,3,8,7,17,43
2009-09-28 00:00:00.000,Bangkok Thailand ATP World Tour 250,HARD,2,Gilles Simon,Kevin Kim,Gilles Simon,6-2; 6-2,R16,62,11,1,30,55,23,30,15,25,2,2,8,38,55,0,0,25,45,11,25,10,20,3,7,8,21,45
2009-09-28 00:00:00.000,Bangkok Thailand ATP World Tour 250,HARD,2,Jo-Wilfried Tsonga,Marco Chiudinelli,Jo-Wilfried Tsonga,6-7(7); 6-3; 6-4,Q,142,20,2,57,91,49,57,19,34,5,6,16,68,91,7,2,74,114,55,74,16,40,5,8,15,71,114
2009-09-28 00:00:00.000,Bangkok Thailand ATP World Tour 250,HARD,2,Viktor Troicki,John Isner,Viktor Troicki,7-6(3); 6-2,Q,80,13,0,43,58,35,43,11,15,1,1,10,46,58,7,1,51,71,33,51,11,20,7,9,10,44,71
2009-09-28 00:00:00.000,Bangkok Thailand ATP World Tour 250,HARD,2,Jurgen Melzer,Andreas Beck,Jurgen Melzer,6-4; 6-2,Q,67,10,0,26,44,22,26,14,18,0,0,9,36,44,2,2,38,55,23,38,9,17,4,7,9,32,55
2009-09-28 00:00:00.000,Bangkok Thailand ATP World Tour 250,HARD,2,Gilles Simon,Evgeny Korolev,Gilles Simon,4-6; 6-3; 6-4,Q,103,7,1,48,78,37,48,16,30,0,2,15,53,78,4,0,50,77,39,50,13,27,2,5,14,52,77
2009-09-28 00:00:00.000,Bangkok Thailand ATP World Tour 250,HARD,2,Viktor Troicki,Jo-Wilfried Tsonga,Viktor Troicki,1-6; 6-2; 6-3,S,98,5,1,58,78,41,58,7,20,5,8,12,48,78,11,2,53,79,39,53,8,26,5,9,12,47,79
2009-09-28 00:00:00.000,Bangkok Thailand ATP World Tour 250,HARD,2,Gilles Simon,Jurgen Melzer,Gilles Simon,6-4; 7-6(3),S,108,8,1,38,68,29,38,20,30,3,4,11,49,68,3,3,48,78,32,48,14,30,2,4,11,46,78
2009-09-28 00:00:00.000,Bangkok Thailand ATP World Tour 250,HARD,2,Gilles Simon,Viktor Troicki,Gilles Simon,7-5; 6-3,F,76,7,0,38,59,29,38,14,21,1,2,11,43,59,3,1,46,64,31,46,6,18,4,7,10,37,64
2009-09-28 00:00:00.000,Kuala Lumpur Malaysia ATP World Tour 250,HARD,2,Nikolay Davydenko,N/A Bye,Nikolay Davydenko,,R32,0,0,0,0,0,0,0,0,0,0,0,0,0,0,0,0,0,0,0,0,0,0,0,0,0,0,0
2009-09-28 00:00:00.000,Kuala Lumpur Malaysia ATP World Tour 250,HARD,2,Taylor Dent,Andrey Golubev,Taylor Dent,4-6; 6-3; 7-6(4),R32,121,4,8,61,100,51,61,18,39,4,6,16,69,100,8,2,53,86,43,53,18,33,5,7,15,61,86
2009-09-28 00:00:00.000,Kuala Lumpur Malaysia ATP World Tour 250,HARD,2,Martin Vassallo Arguello,Feliciano Lopez,Martin Vassallo Arguello,6-3; 6-3,R32,71,3,1,41,49,33,41,5,8,0,0,9,38,49,2,3,35,61,18,35,16,26,5,8,9,34,61
2009-09-28 00:00:00.000,Kuala Lumpur Malaysia ATP World Tour 250,HARD,2,Gael Monfils,Denis Istomin,Gael Monfils,7-6(3); 7-6(2),R32,96,9,2,48,74,37,48,15,26,0,3,12,52,74,1,2,58,80,40,58,8,22,3,6,12,48,80
2009-09-28 00:00:00.000,Kuala Lumpur Malaysia ATP World Tour 250,HARD,2,Robin Soderling,N/A Bye,Robin Soderling,,R32,0,0,0,0,0,0,0,0,0,0,0,0,0,0,0,0,0,0,0,0,0,0,0,0,0,0,0
2009-09-28 00:00:00.000,Kuala Lumpur Malaysia ATP World Tour 250,HARD,2,Brendan Evans,Michael Yani,Brendan Evans,6-3; 6-4,R32,84,6,0,42,55,37,42,7,13,0,0,10,44,55,4,0,43,71,27,43,14,28,6,8,9,41,71
2009-09-28 00:00:00.000,Kuala Lumpur Malaysia ATP World Tour 250,HARD,2,Simon Greul,Christophe Rochus,Simon Greul,6-4; 3-6; 6-2,R32,119,14,2,40,79,34,40,17,39,1,3,13,51,79,1,5,53,92,37,53,18,39,9,13,14,55,92
2009-09-28 00:00:00.000,Kuala Lumpur Malaysia ATP World Tour 250,HARD,2,Tomas Berdych,Igor Kunitsyn,Tomas Berdych,6-1; 3-6; 6-2,R32,113,5,3,40,71,31,40,15,31,4,6,12,46,71,2,1,53,91,31,53,19,38,4,9,12,50,91
2009-09-28 00:00:00.000,Kuala Lumpur Malaysia ATP World Tour 250,HARD,2,Mikhail Youzhny,David Ferrer,Mikhail Youzhny,7-6(3); 6-2,R32,105,1,2,37,58,26,37,15,21,1,3,10,41,58,2,3,49,81,26,49,15,32,6,10,10,41,81
2009-09-28 00:00:00.000,Kuala Lumpur Malaysia ATP World Tour 250,HARD,2,Marcos Baghdatis,Yen-Hsun Lu,Marcos Baghdatis,4-6; 6-3; 7-6(5),R32,169,17,4,54,119,44,54,25,65,6,11,16,69,119,3,4,67,111,39,67,23,44,9,14,15,62,111
2009-09-28 00:00:00.000,Kuala Lumpur Malaysia ATP World Tour 250,HARD,2,Rohan Bopanna,Jose Acasuso,Rohan Bopanna,4-6; 6-3; 6-4,R32,115,14,4,52,86,39,52,20,34,4,6,15,59,86,5,5,54,95,39,54,22,41,8,11,14,61,95
2009-09-28 00:00:00.000,Kuala Lumpur Malaysia ATP World Tour 250,HARD,2,Fernando Gonzalez,N/A Bye,Fernando Gonzalez,,R32,0,0,0,0,0,0,0,0,0,0,0,0,0,0,0,0,0,0,0,0,0,0,0,0,0,0,0
2009-09-28 00:00:00.000,Kuala Lumpur Malaysia ATP World Tour 250,HARD,2,Joachim Johansson,Lleyton Hewitt,Joachim Johansson,7-6(7); 6-3,R32,100,13,4,47,85,38,47,20,38,9,9,11,58,85,11,4,34,68,24,34,21,34,2,3,10,45,68
2009-09-28 00:00:00.000,Kuala Lumpur Malaysia ATP World Tour 250,HARD,2,Richard Gasquet,Victor Crivoi,Richard Gasquet,6-1; 6-2,R32,67,12,1,31,48,26,31,8,17,3,3,8,34,48,3,1,29,50,12,29,13,21,2,6,7,25,50
2009-09-28 00:00:00.000,Kuala Lumpur Malaysia ATP World Tour 250,HARD,2,Karol Beck,Mikhail Kukushkin,Karol Beck,1-6; 7-6(4); 6-3,R32,147,6,3,55,93,34,55,19,38,6,12,15,53,93,2,4,51,93,38,51,15,42,6,10,13,53,93
2009-09-28 00:00:00.000,Kuala Lumpur Malaysia ATP World Tour 250,HARD,2,Fernando Verdasco,N/A Bye,Fernando Verdasco,,R32,0,0,0,0,0,0,0,0,0,0,0,0,0,0,0,0,0,0,0,0,0,0,0,0,0,0,0
2009-09-28 00:00:00.000,Kuala Lumpur Malaysia ATP World Tour 250,HARD,2,Nikolay Davydenko,Taylor Dent,Nikolay Davydenko,6-3; 7-6(4),R16,115,5,1,74,93,47,74,11,19,12,13,10,58,93,6,4,41,78,28,41,16,37,4,7,11,44,78
2009-09-28 00:00:00.000,Kuala Lumpur Malaysia ATP World Tour 250,HARD,2,Gael Monfils,Martin Vassallo Arguello,Gael Monfils,6-4; 6-2,R16,93,4,1,34,57,25,34,14,23,1,2,9,39,57,0,3,59,84,33,59,10,25,10,14,9,43,84
2009-09-28 00:00:00.000,Kuala Lumpur Malaysia ATP World Tour 250,HARD,2,Robin Soderling,Brendan Evans,Robin Soderling,6-1; 6-1,R16,57,6,3,19,40,19,19,12,21,2,2,7,31,40,5,1,35,60,18,35,8,25,11,16,7,26,60
2009-09-28 00:00:00.000,Kuala Lumpur Malaysia ATP World Tour 250,HARD,2,Tomas Berdych,Simon Greul,Tomas Berdych,6-3; 4-6; 6-3,R16,127,9,3,40,75,32,40,21,35,0,2,14,53,75,4,6,66,106,44,66,16,40,5,9,14,60,106
2009-09-28 00:00:00.000,Kuala Lumpur Malaysia ATP World Tour 250,HARD,2,Mikhail Youzhny,Marcos Baghdatis,Mikhail Youzhny,6-2; 6-3,R16,67,2,0,21,39,20,21,13,18,0,0,8,33,39,1,0,32,54,18,32,10,22,2,6,9,28,54
2009-09-28 00:00:00.000,Kuala Lumpur Malaysia ATP World Tour 250,HARD,2,Fernando Gonzalez,Rohan Bopanna,Fernando Gonzalez,6-4; 3-6; 6-4,R16,83,12,4,43,81,33,43,23,38,1,2,14,56,81,12,3,45,75,40,45,14,30,1,3,15,54,75
2009-09-28 00:00:00.000,Kuala Lumpur Malaysia ATP World Tour 250,HARD,2,Richard Gasquet,Joachim Johansson,Richard Gasquet,4-6; 7-6(1); 6-2,R16,119,26,6,75,102,57,75,13,27,7,8,15,70,102,24,4,62,102,45,62,20,40,11,13,15,65,102
2009-09-28 00:00:00.000,Kuala Lumpur Malaysia ATP World Tour 250,HARD,2,Fernando Verdasco,Karol Beck,Fernando Verdasco,6-4; 6-0,R16,70,5,6,31,56,24,31,11,25,7,9,8,35,56,1,5,25,48,13,25,6,23,3,9,8,19,48
2009-09-28 00:00:00.000,Kuala Lumpur Malaysia ATP World Tour 250,HARD,2,Nikolay Davydenko,Gael Monfils,Nikolay Davydenko,6-3; 6-3,Q,74,0,2,37,52,27,37,10,15,2,3,9,37,52,7,4,34,59,21,34,9,25,5,9,9,30,59
2009-09-28 00:00:00.000,Kuala Lumpur Malaysia ATP World Tour 250,HARD,2,Robin Soderling,Tomas Berdych,Robin Soderling,6-2; 6-2,Q,64,5,1,25,47,20,25,16,22,1,1,8,36,47,2,3,20,44,10,20,11,24,2,6,8,21,44
2009-09-28 00:00:00.000,Kuala Lumpur Malaysia ATP World Tour 250,HARD,2,Fernando Gonzalez,Mikhail Youzhny,Fernando Gonzalez,6-3; 6-4,Q,81,5,0,32,52,26,32,14,20,0,0,10,40,52,2,2,39,59,26,39,11,20,7,9,9,37,59
2009-09-28 00:00:00.000,Kuala Lumpur Malaysia ATP World Tour 250,HARD,2,Fernando Verdasco,Richard Gasquet,Fernando Verdasco,7-5; 6-4,Q,91,4,3,43,73,34,43,15,30,5,6,11,49,73,3,3,37,64,24,37,13,27,3,6,11,37,64
2009-09-28 00:00:00.000,Kuala Lumpur Malaysia ATP World Tour 250,HARD,2,Nikolay Davydenko,Robin Soderling,Nikolay Davydenko,1-6; 7-6(1); 6-2,S,123,9,6,54,90,36,54,20,36,6,9,13,56,90,9,3,52,89,35,52,20,37,6,9,14,55,89
2009-09-28 00:00:00.000,Kuala Lumpur Malaysia ATP World Tour 250,HARD,2,Fernando Verdasco,Fernando Gonzalez,Fernando Verdasco,6-4; 7-5,S,92,7,4,35,65,28,35,20,30,3,3,11,48,65,5,3,39,72,32,39,15,33,4,6,11,47,72
2009-09-28 00:00:00.000,Kuala Lumpur Malaysia ATP World Tour 250,HARD,2,Nikolay Davydenko,Fernando Verdasco,Nikolay Davydenko,6-4; 7-5,F,95,2,2,44,67,30,44,15,23,6,7,11,45,67,8,6,46,81,33,46,14,35,6,9,11,47,81
2009-10-05 00:00:00.000,Beijing China ATP World Tour 500,HARD,2,Rafael Nadal,Marcos Baghdatis,Rafael Nadal,6-4; 3-6; 6-4,R32,130,2,0,61,85,43,61,14,24,1,3,15,57,85,8,3,51,85,38,51,19,34,2,4,14,57,85
2009-10-05 00:00:00.000,Beijing China ATP World Tour 500,HARD,2,James Blake,Florian Mayer,James Blake,6-3; 3-6; 6-3,R32,91,3,1,54,87,41,54,15,33,7,10,14,56,87,3,2,41,76,27,41,18,35,5,9,13,45,76
2009-10-05 00:00:00.000,Beijing China ATP World Tour 500,HARD,2,Marat Safin,Jose Acasuso,Marat Safin,6-4; 6-2,R32,61,6,2,29,46,26,29,12,17,2,2,9,38,46,2,2,34,58,22,34,10,24,3,6,9,32,58
2009-10-05 00:00:00.000,Beijing China ATP World Tour 500,HARD,2,Fernando Gonzalez,David Ferrer,Fernando Gonzalez,7-5; 6-4,R32,125,13,7,78,125,53,78,18,47,18,20,11,71,125,3,5,45,68,30,45,9,23,5,9,11,39,68
2009-10-05 00:00:00.000,Beijing China ATP World Tour 500,HARD,2,Nikolay Davydenko,Igor Kunitsyn,Nikolay Davydenko,6-1; 6-7(6); 6-2,R32,133,5,1,68,94,48,68,11,26,10,13,14,59,94,4,0,62,94,33,62,12,32,3,10,13,45,94
2009-10-05 00:00:00.000,Beijing China ATP World Tour 500,HARD,2,Philipp Kohlschreiber,Ivo Karlovic,Philipp Kohlschreiber,7-6(6); 4-6; 6-1,R32,114,3,2,53,80,42,53,21,27,0,1,15,63,80,27,2,61,89,45,61,14,28,2,4,14,59,89
2009-10-05 00:00:00.000,Beijing China ATP World Tour 500,HARD,2,Julien Benneteau,Marcos Daniel,Julien Benneteau,6-3; 6-4,R32,71,13,0,42,58,32,42,12,16,4,4,10,44,58,6,2,27,52,19,27,14,25,2,4,9,33,52
2009-10-05 00:00:00.000,Beijing China ATP World Tour 500,HARD,2,Marin Cilic,Igor Andreev,Marin Cilic,6-4; 6-4,R32,83,2,0,29,51,21,29,16,22,0,1,10,37,51,0,2,31,56,20,31,14,25,4,7,10,34,56
2009-10-05 00:00:00.000,Beijing China ATP World Tour 500,HARD,2,Robin Soderling,Jeremy Chardy,Robin Soderling,6-3; 4-6; 6-2,R32,101,9,2,43,70,33,43,20,27,0,1,14,53,70,9,4,59,96,40,59,16,37,7,10,13,56,96
2009-10-05 00:00:00.000,Beijing China ATP World Tour 500,HARD,2,Tommy Robredo,Benjamin Becker,Tommy Robredo,6-2; 6-1,R32,52,4,0,29,39,27,29,5,10,0,0,8,32,39,4,0,26,45,14,26,8,19,3,7,7,22,45
2009-10-05 00:00:00.000,Beijing China ATP World Tour 500,HARD,2,Ivan Ljubicic,Paul-Henri Mathieu,Ivan Ljubicic,7-6(8); 4-6; 6-1,R32,137,22,2,63,100,52,63,17,37,0,2,15,69,100,5,4,64,103,44,64,19,39,2,5,14,63,103
2009-10-05 00:00:00.000,Beijing China ATP World Tour 500,HARD,2,Lukasz Kubot,Andy Roddick,Lukasz Kubot,6-2; 6-4,R32,81,5,7,37,57,29,37,7,20,2,4,9,36,57,5,4,41,59,24,41,5,18,4,9,9,29,59
2009-10-05 00:00:00.000,Beijing China ATP World Tour 500,HARD,2,Fernando Verdasco,Robby Ginepri,Fernando Verdasco,6-7(7); 6-1; 6-2,R32,110,6,7,50,82,40,50,18,32,1,3,14,58,82,4,3,67,98,38,67,14,31,5,11,13,52,98
2009-10-05 00:00:00.000,Beijing China ATP World Tour 500,HARD,2,Juan Carlos Ferrero,Nicolas Almagro,Juan Carlos Ferrero,7-5; 7-6(3),R32,97,9,3,66,90,48,66,14,24,8,9,12,62,90,10,3,40,64,34,40,11,24,2,4,12,45,64
2009-10-05 00:00:00.000,Beijing China ATP World Tour 500,HARD,2,Viktor Troicki,Fabio Fognini,Viktor Troicki,7-6(5); 7-5,R32,108,10,0,53,70,37,53,11,17,3,6,12,48,70,1,3,61,88,37,61,15,27,8,12,12,52,88
2009-10-05 00:00:00.000,Beijing China ATP World Tour 500,HARD,2,Novak Djokovic,Victor Hanescu,Novak Djokovic,6-3; 7-5,R32,89,10,3,42,62,29,42,10,20,4,7,11,39,62,0,6,33,58,20,33,8,25,4,9,10,28,58
2009-10-05 00:00:00.000,Beijing China ATP World Tour 500,HARD,2,Rafael Nadal,James Blake,Rafael Nadal,7-5; 6-7(4); 6-3,R16,144,6,2,72,108,48,72,22,36,8,11,17,70,108,6,2,56,101,39,56,19,45,1,6,16,58,101
2009-10-05 00:00:00.000,Beijing China ATP World Tour 500,HARD,2,Marat Safin,Fernando Gonzalez,Marat Safin,6-3; 6-4,R16,69,12,0,34,55,30,34,13,21,1,1,10,43,55,1,2,35,58,26,35,11,23,3,5,9,37,58
2009-10-05 00:00:00.000,Beijing China ATP World Tour 500,HARD,2,Nikolay Davydenko,Philipp Kohlschreiber,Nikolay Davydenko,6-1; 6-0,R16,56,5,0,22,33,19,22,6,11,0,0,6,25,33,2,0,38,53,18,38,4,15,5,11,7,22,53
2009-10-05 00:00:00.000,Beijing China ATP World Tour 500,HARD,2,Marin Cilic,Julien Benneteau,Marin Cilic,6-2; 2-6; 6-0,R16,108,9,4,34,68,24,34,22,34,3,5,11,46,68,2,6,52,85,32,52,12,33,9,14,11,44,85
2009-10-05 00:00:00.000,Beijing China ATP World Tour 500,HARD,2,Robin Soderling,Tommy Robredo,Robin Soderling,6-3; 6-3,R16,80,5,0,23,41,19,23,17,18,0,0,9,36,41,2,0,33,72,21,33,18,39,5,8,9,39,72
2009-10-05 00:00:00.000,Beijing China ATP World Tour 500,HARD,2,Ivan Ljubicic,Lukasz Kubot,Ivan Ljubicic,7-6(6); 4-6; 6-4,R16,155,14,2,64,103,50,64,20,39,5,8,16,70,103,8,4,90,108,61,90,7,18,6,9,16,68,108
2009-10-05 00:00:00.000,Beijing China ATP World Tour 500,HARD,2,Fernando Verdasco,Juan Carlos Ferrero,Fernando Verdasco,7-5; 6-4,R16,90,7,3,42,67,32,42,14,25,2,3,11,46,67,5,2,47,65,31,47,9,18,4,7,11,40,65
2009-10-05 00:00:00.000,Beijing China ATP World Tour 500,HARD,2,Novak Djokovic,Viktor Troicki,Novak Djokovic,6-3; 6-0,R16,61,1,1,23,47,16,23,18,24,0,0,8,34,47,3,1,22,41,14,22,5,19,3,7,7,19,41
2009-10-05 00:00:00.000,Beijing China ATP World Tour 500,HARD,2,Rafael Nadal,Marat Safin,Rafael Nadal,6-3; 6-1,Q,78,1,1,43,55,29,43,8,12,3,3,8,37,55,1,3,32,51,18,32,6,19,1,5,8,24,51
2009-10-05 00:00:00.000,Beijing China ATP World Tour 500,HARD,2,Marin Cilic,Nikolay Davydenko,Marin Cilic,6-4; 6-4,Q,96,5,2,40,65,26,40,14,25,3,5,10,40,65,4,2,39,54,23,39,8,15,2,6,10,31,54
2009-10-05 00:00:00.000,Beijing China ATP World Tour 500,HARD,2,Robin Soderling,Ivan Ljubicic,Robin Soderling,7-6(3); 6-4,Q,97,9,1,43,63,36,43,14,20,1,1,11,50,63,12,6,51,89,38,51,18,38,6,7,11,56,89
2009-10-05 00:00:00.000,Beijing China ATP World Tour 500,HARD,2,Novak Djokovic,Fernando Verdasco,Novak Djokovic,6-3; 1-6; 6-1,Q,105,3,5,51,80,33,51,14,29,4,7,12,47,80,6,3,56,85,35,56,12,29,7,11,11,47,85
2009-10-05 00:00:00.000,Beijing China ATP World Tour 500,HARD,2,Marin Cilic,Rafael Nadal,Marin Cilic,6-1; 6-3,S,82,8,0,31,48,24,31,9,17,1,2,8,33,48,0,0,36,53,18,36,6,17,8,13,8,24,53
2009-10-05 00:00:00.000,Beijing China ATP World Tour 500,HARD,2,Novak Djokovic,Robin Soderling,Novak Djokovic,6-3; 6-3,S,81,6,2,30,50,24,30,12,20,1,2,9,36,50,4,4,36,66,23,36,12,30,8,12,9,35,66
2009-10-05 00:00:00.000,Beijing China ATP World Tour 500,HARD,2,Novak Djokovic,Marin Cilic,Novak Djokovic,6-2; 7-6(4),F,114,2,1,50,74,33,50,11,24,8,11,10,44,74,1,1,41,66,25,41,9,25,4,9,10,34,66
2009-10-05 00:00:00.000,Tokyo Japan ATP World Tour 500,HARD,2,Edouard Roger-Vasselin,Juan Martin Del Potro,Edouard Roger-Vasselin,6-4; 6-4,R32,89,9,2,43,74,34,43,18,31,6,6,10,52,74,6,1,29,58,24,29,14,29,2,4,10,38,58
2009-10-05 00:00:00.000,Tokyo Japan ATP World Tour 500,HARD,2,Jurgen Melzer,Leonardo Mayer,Jurgen Melzer,7-6(4); 6-3,R32,112,5,2,47,72,39,47,13,25,3,3,11,52,72,10,1,55,88,40,55,15,33,6,7,10,55,88
2009-10-05 00:00:00.000,Tokyo Japan ATP World Tour 500,HARD,2,Fabrice Santoro,Andrey Golubev,Fabrice Santoro,6-7(5); 7-6(2); 6-2,R32,157,2,3,83,111,64,83,10,28,6,8,16,74,111,8,4,84,131,52,84,24,47,13,17,16,76,131
2009-10-05 00:00:00.000,Tokyo Japan ATP World Tour 500,HARD,2,Lleyton Hewitt,Tatsuma Ito,Lleyton Hewitt,6-1; 7-5,R32,82,4,1,38,62,25,38,16,24,1,2,10,41,62,5,2,31,54,21,31,7,23,3,7,9,28,54
2009-10-05 00:00:00.000,Tokyo Japan ATP World Tour 500,HARD,2,Gilles Simon,Takao Suzuki,Gilles Simon,6-3; 6-4,R32,64,9,1,34,60,27,34,17,26,2,2,10,44,60,4,2,28,46,16,28,13,18,0,2,9,29,46
2009-10-05 00:00:00.000,Tokyo Japan ATP World Tour 500,HARD,2,Mikhail Youzhny,Thomaz Bellucci,Mikhail Youzhny,6-2; 6-3,R32,93,1,1,31,58,25,31,14,27,4,5,9,39,58,3,3,37,62,17,37,14,25,4,8,8,31,62
2009-10-05 00:00:00.000,Tokyo Japan ATP World Tour 500,HARD,2,Andreas Beck,Rainer Schuettler,Andreas Beck,6-3; 4-6; 7-6(3),R32,164,12,5,63,111,49,63,20,48,9,12,16,69,111,8,5,72,120,44,72,27,48,11,14,15,71,120
2009-10-05 00:00:00.000,Tokyo Japan ATP World Tour 500,HARD,2,Tomas Berdych,Go Soeda,Tomas Berdych,6-2; 6-4,R32,69,6,0,25,44,21,25,15,19,0,0,9,36,44,3,8,35,63,24,35,11,28,4,7,9,35,63
2009-10-05 00:00:00.000,Tokyo Japan ATP World Tour 500,HARD,2,Stanislas Wawrinka,John Isner,Stanislas Wawrinka,6-4; 6-4,R32,93,8,2,30,55,29,30,14,25,1,1,10,43,55,9,2,51,75,33,51,12,24,5,7,10,45,75
2009-10-05 00:00:00.000,Tokyo Japan ATP World Tour 500,HARD,2,Simon Greul,Martin Vassallo Arguello,Simon Greul,4-6; 6-4; 6-2,R32,116,7,1,39,68,33,39,21,29,0,1,14,54,68,8,1,79,99,49,79,11,20,9,12,14,60,99
2009-10-05 00:00:00.000,Tokyo Japan ATP World Tour 500,HARD,2,Marco Chiudinelli,Dudi Sela,Marco Chiudinelli,4-6; 6-1; 6-4,R32,129,8,3,53,99,40,53,25,46,3,4,14,65,99,6,4,43,79,32,43,17,36,5,8,13,49,79
2009-10-05 00:00:00.000,Tokyo Japan ATP World Tour 500,HARD,2,Gael Monfils,Marsel Ilhan,Gael Monfils,6-2; 6-4,R32,66,15,0,47,62,33,47,8,15,5,5,9,41,62,3,1,34,56,24,34,9,22,3,6,9,33,56
2009-10-05 00:00:00.000,Tokyo Japan ATP World Tour 500,HARD,2,Ernests Gulbis,Radek Stepanek,Ernests Gulbis,6-4; 6-4,R32,96,13,6,43,63,33,43,13,20,5,5,10,46,63,10,2,30,48,20,30,12,18,0,2,10,32,48
2009-10-05 00:00:00.000,Tokyo Japan ATP World Tour 500,HARD,2,Juan Monaco,Guillermo Garcia-Lopez,Juan Monaco,5-0 RET,R32,19,2,0,12,16,9,12,3,4,0,0,3,12,16,0,0,3,10,0,3,2,7,0,2,2,2,10
2009-10-05 00:00:00.000,Tokyo Japan ATP World Tour 500,HARD,2,Richard Gasquet,Philipp Petzschner,Richard Gasquet,6-3; 6-2,R32,68,4,0,31,57,25,31,15,26,0,0,9,40,57,2,4,22,52,16,22,14,30,4,7,8,30,52
2009-10-05 00:00:00.000,Tokyo Japan ATP World Tour 500,HARD,2,Jo-Wilfried Tsonga,Mischa Zverev,Jo-Wilfried Tsonga,6-4; 6-3,R32,82,10,2,41,63,29,41,13,22,4,5,10,42,63,3,2,39,62,26,39,9,23,7,10,9,35,62
2009-10-05 00:00:00.000,Tokyo Japan ATP World Tour 500,HARD,2,Edouard Roger-Vasselin,Jurgen Melzer,Edouard Roger-Vasselin,4-6; 6-2; 6-3,R16,109,15,0,64,93,49,64,10,29,7,9,14,59,93,13,1,41,75,27,41,20,34,4,8,13,47,75
2009-10-05 00:00:00.000,Tokyo Japan ATP World Tour 500,HARD,2,Lleyton Hewitt,Fabrice Santoro,Lleyton Hewitt,3-6; 6-3; 6-1,R16,111,10,3,44,80,32,44,18,36,3,6,13,50,80,7,4,45,79,33,45,11,34,7,12,12,44,79
2009-10-05 00:00:00.000,Tokyo Japan ATP World Tour 500,HARD,2,Mikhail Youzhny,Gilles Simon,Mikhail Youzhny,7-6(5); 6-7(5); 6-4,R16,159,8,1,76,108,61,76,15,32,0,1,17,76,108,8,3,75,124,58,75,24,49,8,10,17,82,124
2009-10-05 00:00:00.000,Tokyo Japan ATP World Tour 500,HARD,2,Tomas Berdych,Andreas Beck,Tomas Berdych,6-4; 6-1,R16,83,15,0,41,59,34,41,7,18,4,4,8,41,59,2,6,38,66,21,38,14,28,6,10,9,35,66
2009-10-05 00:00:00.000,Tokyo Japan ATP World Tour 500,HARD,2,Stanislas Wawrinka,Simon Greul,Stanislas Wawrinka,6-3; 6-2,R16,76,9,1,31,47,27,31,10,16,1,1,9,37,47,1,2,35,61,19,35,15,26,5,8,8,34,61
2009-10-05 00:00:00.000,Tokyo Japan ATP World Tour 500,HARD,2,Gael Monfils,Marco Chiudinelli,Gael Monfils,7-6(5); 6-3,R16,86,10,1,37,66,29,37,16,29,4,5,10,45,66,1,2,41,67,28,41,12,26,1,4,11,40,67
2009-10-05 00:00:00.000,Tokyo Japan ATP World Tour 500,HARD,2,Ernests Gulbis,Juan Monaco,Ernests Gulbis,6-3; 4-1 RET,R16,60,2,2,30,41,23,30,4,11,1,2,7,27,41,1,2,27,39,15,27,4,12,0,4,7,19,39
2009-10-05 00:00:00.000,Tokyo Japan ATP World Tour 500,HARD,2,Jo-Wilfried Tsonga,Richard Gasquet,Jo-Wilfried Tsonga,4-6; 6-2; 6-2,R16,99,12,4,48,89,35,48,24,41,5,6,13,59,89,2,4,35,66,24,35,16,31,3,7,13,40,66
2009-10-05 00:00:00.000,Tokyo Japan ATP World Tour 500,HARD,2,Lleyton Hewitt,Edouard Roger-Vasselin,Lleyton Hewitt,6-4; 6-0,Q,67,5,1,24,39,22,24,7,15,1,2,8,29,39,2,1,35,56,21,35,7,21,7,12,8,28,56
2009-10-05 00:00:00.000,Tokyo Japan ATP World Tour 500,HARD,2,Mikhail Youzhny,Tomas Berdych,Mikhail Youzhny,6-2; 7-6(6),Q,97,9,1,46,70,32,46,13,24,3,5,10,45,70,3,1,42,64,24,42,13,22,1,5,10,37,64
2009-10-05 00:00:00.000,Tokyo Japan ATP World Tour 500,HARD,2,Gael Monfils,Stanislas Wawrinka,Gael Monfils,2-6; 6-3; 6-4,Q,113,9,3,63,94,45,63,15,31,4,6,14,60,94,10,0,37,78,31,37,21,41,2,4,13,52,78
2009-10-05 00:00:00.000,Tokyo Japan ATP World Tour 500,HARD,2,Jo-Wilfried Tsonga,Ernests Gulbis,Jo-Wilfried Tsonga,4-6; 6-4; 6-3,Q,92,19,0,56,78,48,56,11,22,2,3,15,59,78,11,2,53,75,39,53,14,22,2,4,14,53,75
2009-10-05 00:00:00.000,Tokyo Japan ATP World Tour 500,HARD,2,Mikhail Youzhny,Lleyton Hewitt,Mikhail Youzhny,6-2; 5-7; 7-5,S,159,10,3,62,105,46,62,25,43,6,7,16,71,105,3,1,43,92,31,43,28,49,2,5,16,59,92
2009-10-05 00:00:00.000,Tokyo Japan ATP World Tour 500,HARD,2,Jo-Wilfried Tsonga,Gael Monfils,Jo-Wilfried Tsonga,6-3; 6-3,S,56,9,0,29,42,28,29,8,13,0,0,9,36,42,4,3,41,61,29,41,6,20,4,7,9,35,61
2009-10-05 00:00:00.000,Tokyo Japan ATP World Tour 500,HARD,2,Jo-Wilfried Tsonga,Mikhail Youzhny,Jo-Wilfried Tsonga,6-3; 6-3,F,69,11,0,43,57,34,43,8,14,1,1,9,42,57,3,0,35,50,22,35,7,15,1,4,9,29,50
2009-10-11 00:00:00.000,ATP World Tour Masters 1000 Shanghai China ATP World Tour Masters 1000,HARD,2,Rafael Nadal,N/A Bye,Rafael Nadal,,R64,0,0,0,0,0,0,0,0,0,0,0,0,0,0,0,0,0,0,0,0,0,0,0,0,0,0,0
2009-10-11 00:00:00.000,ATP World Tour Masters 1000 Shanghai China ATP World Tour Masters 1000,HARD,2,James Blake,Ivo Karlovic,James Blake,3-6; 7-6(4); 6-3,R64,114,5,4,50,81,44,50,17,31,0,1,14,61,81,27,3,76,100,60,76,9,24,4,6,16,69,100
2009-10-11 00:00:00.000,ATP World Tour Masters 1000 Shanghai China ATP World Tour Masters 1000,HARD,2,Florian Mayer,Philipp Petzschner,Florian Mayer,6-3; 6-2,R64,61,1,0,42,65,27,42,16,23,7,8,9,43,65,1,1,34,51,19,34,6,17,3,7,8,25,51
2009-10-11 00:00:00.000,ATP World Tour Masters 1000 Shanghai China ATP World Tour Masters 1000,HARD,2,Tommy Robredo,Michael Llodra,Tommy Robredo,6-1; 6-4,R64,105,5,1,31,41,29,31,7,10,0,0,9,36,41,2,2,35,55,21,35,9,20,4,7,8,30,55
2009-10-11 00:00:00.000,ATP World Tour Masters 1000 Shanghai China ATP World Tour Masters 1000,HARD,2,Gael Monfils,Paul-Henri Mathieu,Gael Monfils,6-2; 6-2,R64,55,7,3,29,44,24,29,9,15,1,1,8,33,44,1,4,24,46,17,24,7,22,4,8,8,24,46
2009-10-11 00:00:00.000,ATP World Tour Masters 1000 Shanghai China ATP World Tour Masters 1000,HARD,2,Lleyton Hewitt,John Isner,Lleyton Hewitt,6-2; 6-4,R64,77,2,2,31,50,28,31,11,19,2,2,9,39,50,5,0,46,65,32,46,5,19,7,10,9,37,65
2009-10-11 00:00:00.000,ATP World Tour Masters 1000 Shanghai China ATP World Tour Masters 1000,HARD,2,Ivan Ljubicic,Julien Benneteau,Ivan Ljubicic,6-3; 3-6; 6-1,R64,107,16,1,42,78,36,42,19,36,3,4,13,55,78,6,1,44,68,32,44,8,24,4,7,12,40,68
2009-10-11 00:00:00.000,ATP World Tour Masters 1000 Shanghai China ATP World Tour Masters 1000,HARD,2,Fernando Verdasco,N/A Bye,Fernando Verdasco,,R64,0,0,0,0,0,0,0,0,0,0,0,0,0,0,0,0,0,0,0,0,0,0,0,0,0,0,0
2009-10-11 00:00:00.000,ATP World Tour Masters 1000 Shanghai China ATP World Tour Masters 1000,HARD,2,Juan Martin Del Potro,N/A Bye,Juan Martin Del Potro,,R64,0,0,0,0,0,0,0,0,0,0,0,0,0,0,0,0,0,0,0,0,0,0,0,0,0,0,0
2009-10-11 00:00:00.000,ATP World Tour Masters 1000 Shanghai China ATP World Tour Masters 1000,HARD,2,Jurgen Melzer,Jeremy Chardy,Jurgen Melzer,6-4; 6-4,R64,65,9,0,33,48,30,33,10,15,0,0,10,40,48,9,2,37,61,24,37,12,24,2,4,10,36,61
2009-10-11 00:00:00.000,ATP World Tour Masters 1000 Shanghai China ATP World Tour Masters 1000,HARD,2,Feliciano Lopez,Guillermo Garcia-Lopez,Feliciano Lopez,6-3; 6-4,R64,83,7,1,41,62,33,41,11,21,2,2,10,44,62,1,1,42,59,32,42,6,17,3,5,9,38,59
2009-10-11 00:00:00.000,ATP World Tour Masters 1000 Shanghai China ATP World Tour Masters 1000,HARD,2,David Ferrer,Richard Gasquet,David Ferrer,6-4; 6-3,R64,86,1,2,36,55,25,36,10,19,1,3,9,35,55,0,1,44,73,27,44,9,29,9,14,10,36,73
2009-10-11 00:00:00.000,ATP World Tour Masters 1000 Shanghai China ATP World Tour Masters 1000,HARD,2,Robin Soderling,Victor Hanescu,Robin Soderling,6-3; 6-4,R64,74,9,2,35,52,29,35,10,17,2,3,10,39,52,4,1,51,67,28,51,8,16,3,6,9,36,67
2009-10-11 00:00:00.000,ATP World Tour Masters 1000 Shanghai China ATP World Tour Masters 1000,HARD,2,Nicolas Almagro,Philipp Kohlschreiber,Nicolas Almagro,6-7(2); 6-1; 7-6(6),R64,132,23,3,68,114,49,68,26,46,8,9,16,75,114,8,0,72,108,48,72,20,36,4,7,15,68,108
2009-10-11 00:00:00.000,ATP World Tour Masters 1000 Shanghai China ATP World Tour Masters 1000,HARD,2,Shao-Xuan Zeng,Dudi Sela,Shao-Xuan Zeng,2-6; 6-1; 6-4,R64,111,5,4,50,86,32,50,17,36,4,9,13,49,86,1,3,55,85,31,55,13,30,10,16,12,44,85
2009-10-11 00:00:00.000,ATP World Tour Masters 1000 Shanghai China ATP World Tour Masters 1000,HARD,2,Jo-Wilfried Tsonga,N/A Bye,Jo-Wilfried Tsonga,,R64,0,0,0,0,0,0,0,0,0,0,0,0,0,0,0,0,0,0,0,0,0,0,0,0,0,0,0
2009-10-11 00:00:00.000,ATP World Tour Masters 1000 Shanghai China ATP World Tour Masters 1000,HARD,2,Nikolay Davydenko,N/A Bye,Nikolay Davydenko,,R64,0,0,0,0,0,0,0,0,0,0,0,0,0,0,0,0,0,0,0,0,0,0,0,0,0,0,0
2009-10-11 00:00:00.000,ATP World Tour Masters 1000 Shanghai China ATP World Tour Masters 1000,HARD,2,Igor Kunitsyn,Igor Andreev,Igor Kunitsyn,6-7(6); 6-4; 6-2,R64,132,4,1,48,88,34,48,26,40,6,8,15,60,88,8,3,69,104,42,69,17,35,4,9,15,59,104
2009-10-11 00:00:00.000,ATP World Tour Masters 1000 Shanghai China ATP World Tour Masters 1000,HARD,2,Thomaz Bellucci,Marco Chiudinelli,Thomaz Bellucci,7-6(3); 6-4,R64,112,11,2,39,62,35,39,13,23,1,2,11,48,62,4,2,47,68,38,47,9,21,4,6,11,47,68
2009-10-11 00:00:00.000,ATP World Tour Masters 1000 Shanghai China ATP World Tour Masters 1000,HARD,2,Fernando Gonzalez,Mischa Zverev,Fernando Gonzalez,7-5; 6-7(0); 2-2 RET,R64,114,9,3,59,83,40,59,14,24,3,4,14,54,83,0,1,80,94,55,80,10,14,4,6,14,65,94
2009-10-11 00:00:00.000,ATP World Tour Masters 1000 Shanghai China ATP World Tour Masters 1000,HARD,2,Radek Stepanek,Juan Carlos Ferrero,Radek Stepanek,6-3; 6-0,R64,57,4,0,25,44,24,25,10,19,4,4,8,34,44,3,1,28,43,14,28,6,15,2,6,7,20,43
2009-10-11 00:00:00.000,ATP World Tour Masters 1000 Shanghai China ATP World Tour Masters 1000,HARD,2,Andreas Beck,Jose Acasuso,Andreas Beck,7-6(2); 1-0 RET,R64,62,5,1,21,35,16,21,9,14,0,1,6,25,35,5,6,27,50,20,27,9,23,3,5,7,29,50
2009-10-11 00:00:00.000,ATP World Tour Masters 1000 Shanghai China ATP World Tour Masters 1000,HARD,2,Stanislas Wawrinka,Lukasz Kubot,Stanislas Wawrinka,2-6; 7-6(5); 7-6(3),R64,190,12,1,66,115,49,66,31,49,5,7,16,80,115,5,3,74,113,54,74,24,39,5,5,16,78,113
2009-10-11 00:00:00.000,ATP World Tour Masters 1000 Shanghai China ATP World Tour Masters 1000,HARD,2,Andy Roddick,N/A Bye,Andy Roddick,,R64,0,0,0,0,0,0,0,0,0,0,0,0,0,0,0,0,0,0,0,0,0,0,0,0,0,0,0
2009-10-11 00:00:00.000,ATP World Tour Masters 1000 Shanghai China ATP World Tour Masters 1000,HARD,2,Gilles Simon,N/A Bye,Gilles Simon,,R64,0,0,0,0,0,0,0,0,0,0,0,0,0,0,0,0,0,0,0,0,0,0,0,0,0,0,0
2009-10-11 00:00:00.000,ATP World Tour Masters 1000 Shanghai China ATP World Tour Masters 1000,HARD,2,Viktor Troicki,Juan Monaco,Viktor Troicki,6-1; 6-2,R64,61,8,2,26,40,22,26,5,14,2,4,7,27,40,0,3,29,53,16,29,4,24,6,13,8,20,53
2009-10-11 00:00:00.000,ATP World Tour Masters 1000 Shanghai China ATP World Tour Masters 1000,HARD,2,Marat Safin,Mao-Xin Gong,Marat Safin,6-4; 6-4,R64,86,12,2,33,63,27,33,16,30,1,2,10,43,63,0,7,34,61,24,34,9,27,1,4,10,33,61
2009-10-11 00:00:00.000,ATP World Tour Masters 1000 Shanghai China ATP World Tour Masters 1000,HARD,2,Tomas Berdych,Marin Cilic,Tomas Berdych,7-6(8); 3-6; 6-4,R64,159,5,2,71,109,47,71,18,38,8,12,15,65,109,8,3,63,100,48,63,14,37,1,5,16,62,100
2009-10-11 00:00:00.000,ATP World Tour Masters 1000 Shanghai China ATP World Tour Masters 1000,HARD,2,Tommy Haas,Benjamin Becker,Tommy Haas,7-6(5); 6-4,R64,90,11,5,38,64,32,38,18,26,1,1,11,50,64,13,1,45,79,34,45,19,34,3,4,11,53,79
2009-10-11 00:00:00.000,ATP World Tour Masters 1000 Shanghai China ATP World Tour Masters 1000,HARD,2,Rainer Schuettler,Martin Vassallo Arguello,Rainer Schuettler,6-4; 3-6; 7-6(2),R64,150,1,2,58,85,41,58,14,27,0,4,15,55,85,2,2,64,96,45,64,16,32,4,8,16,61,96
2009-10-11 00:00:00.000,ATP World Tour Masters 1000 Shanghai China ATP World Tour Masters 1000,HARD,2,Fabio Fognini,Ernests Gulbis,Fabio Fognini,7-6(3); 6-3,R64,80,2,2,36,62,27,36,18,26,0,2,11,45,62,7,6,43,64,31,43,7,21,2,5,10,38,64
2009-10-11 00:00:00.000,ATP World Tour Masters 1000 Shanghai China ATP World Tour Masters 1000,HARD,2,Novak Djokovic,N/A Bye,Novak Djokovic,,R64,0,0,0,0,0,0,0,0,0,0,0,0,0,0,0,0,0,0,0,0,0,0,0,0,0,0,0
2009-10-11 00:00:00.000,ATP World Tour Masters 1000 Shanghai China ATP World Tour Masters 1000,HARD,2,Rafael Nadal,James Blake,Rafael Nadal,6-2; 6-7(4); 6-4,R32,132,6,1,62,85,48,62,11,23,1,3,15,59,85,5,4,60,99,40,60,16,39,3,8,15,56,99
2009-10-11 00:00:00.000,ATP World Tour Masters 1000 Shanghai China ATP World Tour Masters 1000,HARD,2,Tommy Robredo,Florian Mayer,Tommy Robredo,4-6; 7-6(10); 6-4,R32,128,9,4,72,105,52,72,19,33,3,5,16,71,105,10,3,67,109,52,67,20,42,5,7,16,72,109
2009-10-11 00:00:00.000,ATP World Tour Masters 1000 Shanghai China ATP World Tour Masters 1000,HARD,2,Gael Monfils,Lleyton Hewitt,Gael Monfils,4-6; 6-4; 6-2,R32,124,7,7,46,76,31,46,13,30,3,7,14,44,76,0,5,58,102,34,58,19,44,5,11,14,53,102
2009-10-11 00:00:00.000,ATP World Tour Masters 1000 Shanghai China ATP World Tour Masters 1000,HARD,2,Ivan Ljubicic,Fernando Verdasco,Ivan Ljubicic,6-4; 7-6(6),R32,94,8,0,42,64,36,42,10,22,0,1,11,46,64,8,2,51,66,32,51,10,15,1,3,11,42,66
2009-10-11 00:00:00.000,ATP World Tour Masters 1000 Shanghai China ATP World Tour Masters 1000,HARD,2,Jurgen Melzer,Juan Martin Del Potro,Jurgen Melzer,7-5; 2-1 RET,R32,75,6,1,27,45,22,27,10,18,3,4,8,32,45,4,2,35,54,23,35,8,19,4,6,7,31,54
2009-10-11 00:00:00.000,ATP World Tour Masters 1000 Shanghai China ATP World Tour Masters 1000,HARD,2,Feliciano Lopez,David Ferrer,Feliciano Lopez,4-6; 7-5; 6-1,R32,113,11,1,50,80,41,50,15,30,0,1,14,56,80,6,2,67,87,45,67,8,20,3,7,15,53,87
2009-10-11 00:00:00.000,ATP World Tour Masters 1000 Shanghai China ATP World Tour Masters 1000,HARD,2,Robin Soderling,Nicolas Almagro,Robin Soderling,6-4; 7-5,R32,82,9,6,39,67,31,39,15,28,2,3,11,46,67,12,1,49,73,35,49,8,24,6,9,11,43,73
2009-10-11 00:00:00.000,ATP World Tour Masters 1000 Shanghai China ATP World Tour Masters 1000,HARD,2,Jo-Wilfried Tsonga,Shao-Xuan Zeng,Jo-Wilfried Tsonga,6-3; 6-3,R32,61,3,0,29,42,26,29,10,13,0,0,9,36,42,0,0,37,57,26,37,7,20,4,7,9,33,57
2009-10-11 00:00:00.000,ATP World Tour Masters 1000 Shanghai China ATP World Tour Masters 1000,HARD,2,Nikolay Davydenko,Igor Kunitsyn,Nikolay Davydenko,6-4; 6-2,R32,72,8,1,32,51,27,32,11,19,1,1,9,38,51,3,1,27,50,18,27,12,23,2,5,9,30,50
2009-10-11 00:00:00.000,ATP World Tour Masters 1000 Shanghai China ATP World Tour Masters 1000,HARD,2,Fernando Gonzalez,Thomaz Bellucci,Fernando Gonzalez,6-3; 6-4,R32,82,5,2,40,60,32,40,13,20,3,3,10,45,60,2,2,31,59,21,31,16,28,9,11,9,37,59
2009-10-11 00:00:00.000,ATP World Tour Masters 1000 Shanghai China ATP World Tour Masters 1000,HARD,2,Radek Stepanek,Andreas Beck,Radek Stepanek,7-5; 6-4,R32,106,15,5,52,72,41,52,9,20,5,5,11,50,72,9,5,58,89,40,58,13,31,7,9,11,53,89
2009-10-11 00:00:00.000,ATP World Tour Masters 1000 Shanghai China ATP World Tour Masters 1000,HARD,2,Stanislas Wawrinka,Andy Roddick,Stanislas Wawrinka,3-4 RET,R32,36,2,2,13,25,9,13,7,12,2,2,3,16,25,4,0,16,22,13,16,4,6,0,0,4,17,22
2009-10-11 00:00:00.000,ATP World Tour Masters 1000 Shanghai China ATP World Tour Masters 1000,HARD,2,Gilles Simon,Viktor Troicki,Gilles Simon,6-3; 6-4,R32,66,3,2,37,60,28,37,14,23,2,3,10,42,60,2,0,35,46,24,35,5,11,2,5,9,29,46
2009-10-11 00:00:00.000,ATP World Tour Masters 1000 Shanghai China ATP World Tour Masters 1000,HARD,2,Tomas Berdych,Marat Safin,Tomas Berdych,3-6; 6-4; 6-4,R32,137,2,4,67,104,41,67,20,37,9,13,15,61,104,18,1,60,90,41,60,14,30,1,5,14,55,90
2009-10-11 00:00:00.000,ATP World Tour Masters 1000 Shanghai China ATP World Tour Masters 1000,HARD,2,Rainer Schuettler,Tommy Haas,Rainer Schuettler,6-4 RET,R32,40,3,1,16,26,16,16,4,10,0,0,5,20,26,4,3,21,35,19,21,3,14,3,4,5,22,35
2009-10-11 00:00:00.000,ATP World Tour Masters 1000 Shanghai China ATP World Tour Masters 1000,HARD,2,Novak Djokovic,Fabio Fognini,Novak Djokovic,6-3; 6-1,R32,70,3,1,29,50,24,29,10,21,3,4,8,34,50,2,2,39,50,21,39,2,11,2,7,8,23,50
2009-10-11 00:00:00.000,ATP World Tour Masters 1000 Shanghai China ATP World Tour Masters 1000,HARD,2,Rafael Nadal,Tommy Robredo,Rafael Nadal,6-1; 6-4,R16,93,0,2,42,57,29,42,9,15,1,2,9,38,57,2,2,33,57,20,33,9,24,6,10,8,29,57
2009-10-11 00:00:00.000,ATP World Tour Masters 1000 Shanghai China ATP World Tour Masters 1000,HARD,2,Ivan Ljubicic,Gael Monfils,Ivan Ljubicic,6-2; 3-0 RET,R16,37,5,0,19,25,17,19,3,6,0,0,5,20,25,0,2,33,39,16,33,2,6,1,5,6,18,39
2009-10-11 00:00:00.000,ATP World Tour Masters 1000 Shanghai China ATP World Tour Masters 1000,HARD,2,Feliciano Lopez,Jurgen Melzer,Feliciano Lopez,5-7; 7-6(3); 6-1,R16,128,15,3,57,100,44,57,24,43,4,6,16,68,100,17,4,52,94,40,52,20,42,1,4,15,60,94
2009-10-11 00:00:00.000,ATP World Tour Masters 1000 Shanghai China ATP World Tour Masters 1000,HARD,2,Robin Soderling,Jo-Wilfried Tsonga,Robin Soderling,6-3; 6-3,R16,70,8,2,34,50,26,34,11,16,1,2,9,37,50,5,1,29,52,18,29,10,23,4,8,9,28,52
2009-10-11 00:00:00.000,ATP World Tour Masters 1000 Shanghai China ATP World Tour Masters 1000,HARD,2,Nikolay Davydenko,Fernando Gonzalez,Nikolay Davydenko,6-3; 7-5,R16,81,2,1,32,47,29,32,9,15,0,1,10,38,47,8,1,42,69,33,42,8,27,4,8,11,41,69
2009-10-11 00:00:00.000,ATP World Tour Masters 1000 Shanghai China ATP World Tour Masters 1000,HARD,2,Radek Stepanek,Stanislas Wawrinka,Radek Stepanek,3-6; 7-6(5); 4-2 RET,R16,142,5,3,61,90,40,61,15,29,6,9,13,55,90,8,7,52,97,40,52,18,45,6,9,14,58,97
2009-10-11 00:00:00.000,ATP World Tour Masters 1000 Shanghai China ATP World Tour Masters 1000,HARD,2,Gilles Simon,Tomas Berdych,Gilles Simon,6-3; 6-4,R16,91,6,1,41,68,31,41,14,27,6,7,10,45,68,3,4,33,61,22,33,12,28,3,6,9,34,61
2009-10-11 00:00:00.000,ATP World Tour Masters 1000 Shanghai China ATP World Tour Masters 1000,HARD,2,Novak Djokovic,Rainer Schuettler,Novak Djokovic,6-4; 6-2,R16,84,5,3,29,48,22,29,12,19,0,1,9,34,48,0,3,32,63,20,32,13,31,5,9,9,33,63
2009-10-11 00:00:00.000,ATP World Tour Masters 1000 Shanghai China ATP World Tour Masters 1000,HARD,2,Rafael Nadal,Ivan Ljubicic,Rafael Nadal,3-6; 6-3 RET,Q,96,2,2,41,55,28,41,10,14,5,6,9,38,55,12,3,40,62,28,40,11,22,5,6,9,39,62
2009-10-11 00:00:00.000,ATP World Tour Masters 1000 Shanghai China ATP World Tour Masters 1000,HARD,2,Feliciano Lopez,Robin Soderling,Feliciano Lopez,7-6(4); 6-3,Q,103,10,1,41,75,28,41,24,34,3,4,11,52,75,11,3,37,58,29,37,11,21,3,5,10,40,58
2009-10-11 00:00:00.000,ATP World Tour Masters 1000 Shanghai China ATP World Tour Masters 1000,HARD,2,Nikolay Davydenko,Radek Stepanek,Nikolay Davydenko,6-1; 4-6; 6-1,Q,122,5,2,60,87,40,60,13,27,7,9,12,53,87,7,2,51,92,33,51,14,41,8,14,12,47,92
2009-10-11 00:00:00.000,ATP World Tour Masters 1000 Shanghai China ATP World Tour Masters 1000,HARD,2,Novak Djokovic,Gilles Simon,Novak Djokovic,6-3; 2-6; 6-2,Q,144,1,5,52,84,32,52,14,32,4,9,13,46,84,4,1,51,97,31,51,19,46,8,14,12,50,97
2009-10-11 00:00:00.000,ATP World Tour Masters 1000 Shanghai China ATP World Tour Masters 1000,HARD,2,Rafael Nadal,Feliciano Lopez,Rafael Nadal,6-1; 3-0 RET,S,51,1,0,14,24,12,14,8,10,0,0,5,20,24,1,0,12,31,5,12,5,19,1,5,5,10,31
2009-10-11 00:00:00.000,ATP World Tour Masters 1000 Shanghai China ATP World Tour Masters 1000,HARD,2,Nikolay Davydenko,Novak Djokovic,Nikolay Davydenko,4-6; 6-4; 7-6(1),S,183,5,1,66,99,49,66,18,33,6,7,16,67,99,5,2,77,120,50,77,26,43,8,9,16,76,120
2009-10-11 00:00:00.000,ATP World Tour Masters 1000 Shanghai China ATP World Tour Masters 1000,HARD,2,Nikolay Davydenko,Rafael Nadal,Nikolay Davydenko,7-6(3); 6-3,F,123,4,1,53,76,39,53,12,23,3,4,11,51,76,1,0,42,61,29,42,9,19,5,7,10,38,61
2009-10-19 00:00:00.000,Moscow Russia ATP World Tour 250,HARD,2,Marat Safin,Nikolay Davydenko,Marat Safin,4-6; 6-4; 6-2,R32,116,10,2,42,77,30,42,25,35,1,2,14,55,77,7,4,55,93,37,55,20,38,5,8,14,57,93
2009-10-19 00:00:00.000,Moscow Russia ATP World Tour 250,HARD,2,Evgeny Korolev,Igor Kunitsyn,Evgeny Korolev,7-6(6); 6-3,R32,79,8,1,43,67,34,43,15,24,1,2,11,49,67,6,1,36,62,24,36,17,26,3,5,10,41,62
2009-10-19 00:00:00.000,Moscow Russia ATP World Tour 250,HARD,2,Illya Marchenko,Denis Istomin,Illya Marchenko,1-6; 6-4; 4-1 RET,R32,110,2,5,41,77,26,41,21,36,9,12,11,47,77,3,0,53,70,34,53,8,17,2,5,11,42,70
2009-10-19 00:00:00.000,Moscow Russia ATP World Tour 250,HARD,2,Andrey Golubev,Martin Vassallo Arguello,Andrey Golubev,7-5; 6-3,R32,87,3,1,29,54,26,29,18,25,1,1,10,44,54,0,1,50,70,33,50,10,20,2,5,11,43,70
2009-10-19 00:00:00.000,Moscow Russia ATP World Tour 250,HARD,2,Robby Ginepri,Igor Andreev,Robby Ginepri,6-3; 6-7(9); 7-6(1),R32,152,8,1,85,128,65,85,17,43,6,9,17,82,128,8,3,70,101,50,70,16,31,5,9,16,66,101
2009-10-19 00:00:00.000,Moscow Russia ATP World Tour 250,HARD,2,Marcel Granollers,Nicolas Kiefer,Marcel Granollers,6-4; 1-0 RET,R32,68,1,0,26,46,14,26,10,20,6,8,5,24,46,2,1,18,33,10,18,3,15,2,6,6,13,33
2009-10-19 00:00:00.000,Moscow Russia ATP World Tour 250,HARD,2,Christophe Rochus,Marc Gicquel,Christophe Rochus,7-5 RET,R32,51,2,2,24,40,16,24,9,16,3,4,6,25,40,5,1,21,37,14,21,6,16,1,3,6,20,37
2009-10-19 00:00:00.000,Moscow Russia ATP World Tour 250,HARD,2,Janko Tipsarevic,Daniel Koellerer,Janko Tipsarevic,6-4; 6-3,R32,83,10,2,31,51,28,31,9,20,1,2,10,37,51,0,1,35,49,26,35,6,14,1,4,9,32,49
2009-10-19 00:00:00.000,Moscow Russia ATP World Tour 250,HARD,2,Fabrice Santoro,Andrey Kuznetsov,Fabrice Santoro,4-6; 6-2; 6-2,R32,117,6,1,49,92,37,49,19,43,8,11,13,56,92,3,1,42,76,23,42,18,34,3,9,13,41,76
2009-10-19 00:00:00.000,Moscow Russia ATP World Tour 250,HARD,2,Sergiy Stakhovsky,Mikhail Biryukov,Sergiy Stakhovsky,6-0; 6-2,R32,48,5,0,35,46,29,35,4,11,3,3,7,33,46,0,1,23,41,12,23,5,18,3,8,7,17,41
2009-10-19 00:00:00.000,Moscow Russia ATP World Tour 250,HARD,2,Potito Starace,Evgeny Donskoy,Potito Starace,6-3; 6-3,R32,68,1,0,44,56,33,44,7,12,1,1,9,40,56,6,1,21,50,17,21,15,29,4,7,9,32,50
2009-10-19 00:00:00.000,Moscow Russia ATP World Tour 250,HARD,2,Mikhail Youzhny,Horacio Zeballos,Mikhail Youzhny,6-1; 7-6(5),R32,87,8,1,37,50,32,37,6,13,0,1,9,38,50,4,1,49,74,31,49,9,25,5,9,10,40,74
2009-10-19 00:00:00.000,Moscow Russia ATP World Tour 250,HARD,2,Pablo Cuevas,Yen-Hsun Lu,Pablo Cuevas,6-4; 6-2,R32,60,9,1,40,50,33,40,5,10,1,1,9,38,50,1,4,27,50,22,27,8,23,0,3,9,30,50
2009-10-19 00:00:00.000,Moscow Russia ATP World Tour 250,HARD,2,Teymuraz Gabashvili,Karol Beck,Teymuraz Gabashvili,3-6; 6-4; 6-4,R32,164,9,7,38,96,25,38,28,58,10,15,14,53,96,4,2,51,97,34,51,19,46,8,14,15,53,97
2009-10-19 00:00:00.000,Moscow Russia ATP World Tour 250,HARD,2,Mikhail Kukushkin,Fabio Fognini,Mikhail Kukushkin,6-4; 5-7; 6-4,R32,147,2,4,40,85,28,40,24,45,0,5,16,52,85,9,1,78,119,48,78,16,41,12,18,16,64,119
2009-10-19 00:00:00.000,Moscow Russia ATP World Tour 250,HARD,2,Wayne Odesnik,Victor Hanescu,Wayne Odesnik,5-7; 7-5; 6-4,R32,135,7,1,64,98,45,64,13,34,2,7,17,58,98,4,2,61,97,42,61,14,36,5,11,17,56,97
2009-10-19 00:00:00.000,Moscow Russia ATP World Tour 250,HARD,2,Evgeny Korolev,Marat Safin,Evgeny Korolev,6-4; 7-6(4),R16,90,7,0,43,72,32,43,14,29,3,5,11,46,72,6,2,40,69,30,40,11,29,4,7,11,41,69
2009-10-19 00:00:00.000,Moscow Russia ATP World Tour 250,HARD,2,Illya Marchenko,Andrey Golubev,Illya Marchenko,6-1; 1-6; 6-4,R16,105,0,2,39,66,23,39,15,27,1,5,12,38,66,5,1,47,71,28,47,10,24,3,8,12,38,71
2009-10-19 00:00:00.000,Moscow Russia ATP World Tour 250,HARD,2,Robby Ginepri,Marcel Granollers,Robby Ginepri,7-6(5); 6-0,R16,91,7,0,39,69,28,39,18,30,9,10,9,46,69,0,2,42,63,24,42,10,21,5,9,9,34,63
2009-10-19 00:00:00.000,Moscow Russia ATP World Tour 250,HARD,2,Janko Tipsarevic,Christophe Rochus,Janko Tipsarevic,6-4; 2-1 RET,R16,63,13,2,26,41,19,26,7,15,2,3,6,26,41,2,3,32,49,21,32,5,17,2,5,7,26,49
2009-10-19 00:00:00.000,Moscow Russia ATP World Tour 250,HARD,2,Sergiy Stakhovsky,Fabrice Santoro,Sergiy Stakhovsky,7-5; 6-1,R16,73,11,0,43,62,32,43,13,19,3,3,10,45,62,1,1,28,56,16,28,18,28,3,6,9,34,56
2009-10-19 00:00:00.000,Moscow Russia ATP World Tour 250,HARD,2,Mikhail Youzhny,Potito Starace,Mikhail Youzhny,6-1; 6-1,R16,54,5,0,22,33,20,22,8,11,0,0,7,28,33,1,2,28,41,14,28,4,13,6,11,7,18,41
2009-10-19 00:00:00.000,Moscow Russia ATP World Tour 250,HARD,2,Pablo Cuevas,Teymuraz Gabashvili,Pablo Cuevas,3-6; 6-1; 6-4,R16,117,9,3,46,70,37,46,14,24,0,1,13,51,70,4,3,41,82,28,41,25,41,1,4,13,53,82
2009-10-19 00:00:00.000,Moscow Russia ATP World Tour 250,HARD,2,Mikhail Kukushkin,Wayne Odesnik,Mikhail Kukushkin,6-3; 6-4,R16,101,6,2,47,75,34,47,16,28,9,9,10,50,75,3,1,38,52,26,38,8,14,4,6,9,34,52
2009-10-19 00:00:00.000,Moscow Russia ATP World Tour 250,HARD,2,Illya Marchenko,Evgeny Korolev,Illya Marchenko,0-6; 6-2; 6-3,Q,95,3,5,35,67,24,35,11,32,2,7,12,35,67,9,1,38,57,24,38,6,19,1,6,11,30,57
2009-10-19 00:00:00.000,Moscow Russia ATP World Tour 250,HARD,2,Janko Tipsarevic,Robby Ginepri,Janko Tipsarevic,6-3; 6-3,Q,71,10,2,28,50,26,28,12,22,1,1,9,38,50,5,0,34,53,19,34,11,19,5,8,9,30,53
2009-10-19 00:00:00.000,Moscow Russia ATP World Tour 250,HARD,2,Mikhail Youzhny,Sergiy Stakhovsky,Mikhail Youzhny,6-3; 6-3,Q,72,5,1,28,46,23,28,11,18,3,5,9,34,46,3,4,33,58,21,33,7,25,4,9,9,28,58
2009-10-19 00:00:00.000,Moscow Russia ATP World Tour 250,HARD,2,Mikhail Kukushkin,Pablo Cuevas,Mikhail Kukushkin,4-6; 6-1; 6-4,Q,127,5,1,51,89,39,51,18,38,7,9,14,57,89,6,1,51,86,33,51,19,35,10,14,13,52,86
2009-10-19 00:00:00.000,Moscow Russia ATP World Tour 250,HARD,2,Janko Tipsarevic,Illya Marchenko,Janko Tipsarevic,6-1; 6-4,S,90,5,0,32,45,27,32,9,13,0,0,9,36,45,2,0,32,59,19,32,13,27,6,9,8,32,59
2009-10-19 00:00:00.000,Moscow Russia ATP World Tour 250,HARD,2,Mikhail Youzhny,Mikhail Kukushkin,Mikhail Youzhny,6-2; 6-1,S,69,6,0,21,39,17,21,10,18,1,2,7,27,39,1,1,33,52,18,33,4,19,3,9,8,22,52
2009-10-19 00:00:00.000,Moscow Russia ATP World Tour 250,HARD,2,Mikhail Youzhny,Janko Tipsarevic,Mikhail Youzhny,6-7(5); 6-0; 6-4,F,165,14,1,49,79,42,49,17,30,2,3,14,59,79,8,3,71,116,43,71,22,45,13,18,14,65,116
2009-10-19 00:00:00.000,Stockholm Sweden ATP World Tour 250,HARD,2,Robin Soderling,Giovanni Lapentti,Robin Soderling,6-3; 6-0,R32,64,9,1,27,40,23,27,10,13,1,1,8,33,40,2,5,33,56,18,33,8,23,6,10,7,26,56
2009-10-19 00:00:00.000,Stockholm Sweden ATP World Tour 250,HARD,2,Andreas Seppi,Victor Crivoi,Andreas Seppi,6-4; 6-1,R32,66,6,3,29,53,23,29,13,24,1,3,9,36,53,1,4,40,57,19,40,9,17,4,9,8,28,57
2009-10-19 00:00:00.000,Stockholm Sweden ATP World Tour 250,HARD,2,Guillermo Garcia-Lopez,Alberto Martin,Guillermo Garcia-Lopez,6-3; 6-2,R32,76,2,3,38,59,26,38,9,21,6,7,8,35,59,1,2,26,52,12,26,13,26,3,8,9,25,52
2009-10-19 00:00:00.000,Stockholm Sweden ATP World Tour 250,HARD,2,Simon Greul,Benjamin Becker,Simon Greul,2-6; 6-3; 7-5,R32,103,7,4,46,84,38,46,20,38,1,4,15,58,84,12,3,43,82,36,43,19,39,1,4,14,55,82
2009-10-19 00:00:00.000,Stockholm Sweden ATP World Tour 250,HARD,2,Marcos Baghdatis,Juan Carlos Ferrero,Marcos Baghdatis,6-4; 6-2,R32,85,13,1,33,59,28,33,10,26,1,2,9,38,59,3,4,35,60,21,35,10,25,3,7,9,31,60
2009-10-19 00:00:00.000,Stockholm Sweden ATP World Tour 250,HARD,2,Robert Kendrick,Oscar Hernandez,Robert Kendrick,6-3; 6-4,R32,79,8,0,34,57,24,34,14,23,5,7,10,38,57,3,4,33,61,22,33,10,28,5,9,9,32,61
2009-10-19 00:00:00.000,Stockholm Sweden ATP World Tour 250,HARD,2,Michael Berrer,Henri Kontinen,Michael Berrer,7-5; 7-6(7),R32,129,4,5,61,86,46,61,12,25,3,4,12,58,86,8,2,60,96,40,60,16,36,10,12,12,56,96
2009-10-19 00:00:00.000,Stockholm Sweden ATP World Tour 250,HARD,2,Arnaud Clement,Andreas Beck,Arnaud Clement,6-4; 6-2,R32,76,3,3,25,48,23,25,15,23,2,2,9,38,48,6,3,23,55,21,23,11,32,3,6,9,32,55
2009-10-19 00:00:00.000,Stockholm Sweden ATP World Tour 250,HARD,2,Leonardo Mayer,Albert Montanes,Leonardo Mayer,6-4; 6-3,R32,73,3,4,30,51,25,30,9,21,1,3,9,34,51,0,4,44,66,25,44,8,22,4,9,10,33,66
2009-10-19 00:00:00.000,Stockholm Sweden ATP World Tour 250,HARD,2,Thomaz Bellucci,Frederik Nielsen,Thomaz Bellucci,7-6(6); 6-3,R32,91,10,1,39,73,30,39,18,34,5,6,10,48,73,2,0,61,77,37,61,8,16,7,10,11,45,77
2009-10-19 00:00:00.000,Stockholm Sweden ATP World Tour 250,HARD,2,Joachim Johansson,Peter Luczak,Joachim Johansson,7-5; 6-2,R32,83,21,4,36,51,33,36,8,15,1,1,10,41,51,8,7,43,74,32,43,11,31,5,8,10,43,74
2009-10-19 00:00:00.000,Stockholm Sweden ATP World Tour 250,HARD,2,Juan Monaco,Jan Hernych,Juan Monaco,6-2; 5-7; 7-5,R32,129,3,10,58,103,36,58,24,45,7,11,16,60,103,4,4,72,107,43,72,16,35,6,12,16,59,107
2009-10-19 00:00:00.000,Stockholm Sweden ATP World Tour 250,HARD,2,Feliciano Lopez,Ernests Gulbis,Feliciano Lopez,6-2; 6-4,R32,54,8,3,34,46,27,34,7,12,2,3,9,34,46,4,2,37,54,18,37,10,17,0,4,9,28,54
2009-10-19 00:00:00.000,Stockholm Sweden ATP World Tour 250,HARD,2,Olivier Rochus,Andreas Vinciguerra,Olivier Rochus,6-3; 6-2,R32,68,2,0,35,49,29,35,7,14,0,0,9,36,49,5,1,29,45,19,29,9,16,3,6,8,28,45
2009-10-19 00:00:00.000,Stockholm Sweden ATP World Tour 250,HARD,2,Jarkko Nieminen,Grigor Dimitrov,Jarkko Nieminen,6-0; 6-2,R32,50,1,1,27,35,23,27,6,8,0,0,7,29,35,1,3,16,39,10,16,7,23,0,5,7,17,39
2009-10-19 00:00:00.000,Stockholm Sweden ATP World Tour 250,HARD,2,Tommy Haas,Florent Serra,Tommy Haas,6-3; 6-4,R32,56,17,4,35,53,31,35,11,18,0,0,10,42,53,3,1,33,48,24,33,10,15,2,4,9,34,48
2009-10-19 00:00:00.000,Stockholm Sweden ATP World Tour 250,HARD,2,Robin Soderling,Andreas Seppi,Robin Soderling,6-1; 6-3,R16,63,3,3,25,43,18,25,13,18,1,2,8,31,43,0,3,30,54,15,30,10,24,4,9,8,25,54
2009-10-19 00:00:00.000,Stockholm Sweden ATP World Tour 250,HARD,2,Guillermo Garcia-Lopez,Simon Greul,Guillermo Garcia-Lopez,6-3; 7-5,R16,92,5,5,37,62,29,37,12,25,1,2,10,41,62,2,3,36,66,26,36,10,30,3,7,11,36,66
2009-10-19 00:00:00.000,Stockholm Sweden ATP World Tour 250,HARD,2,Marcos Baghdatis,Robert Kendrick,Marcos Baghdatis,6-2; 6-2,R16,53,7,0,20,40,17,20,13,20,0,1,8,30,40,3,0,29,42,16,29,2,13,0,5,8,18,42
2009-10-19 00:00:00.000,Stockholm Sweden ATP World Tour 250,HARD,2,Arnaud Clement,Michael Berrer,Arnaud Clement,3-6; 7-6(7); 6-1,R16,148,6,1,65,115,44,65,27,50,7,10,15,71,115,12,2,54,77,37,54,10,23,1,4,13,47,77
2009-10-19 00:00:00.000,Stockholm Sweden ATP World Tour 250,HARD,2,Thomaz Bellucci,Leonardo Mayer,Thomaz Bellucci,7-5; 3-6; 6-3,R16,137,6,3,56,95,40,56,20,39,6,10,15,60,95,3,2,56,92,39,56,16,36,4,9,15,55,92
2009-10-19 00:00:00.000,Stockholm Sweden ATP World Tour 250,HARD,2,Joachim Johansson,Juan Monaco,Joachim Johansson,6-4; 6-4,R16,63,11,1,35,48,32,35,9,13,0,0,10,41,48,6,3,38,58,25,38,13,20,1,3,10,38,58
2009-10-19 00:00:00.000,Stockholm Sweden ATP World Tour 250,HARD,2,Olivier Rochus,Feliciano Lopez,Olivier Rochus,4-6; 6-4; 6-1,R16,115,4,1,65,88,41,65,17,23,4,5,14,58,88,15,3,39,69,32,39,14,30,0,3,13,46,69
2009-10-19 00:00:00.000,Stockholm Sweden ATP World Tour 250,HARD,2,Jarkko Nieminen,Tommy Haas,Jarkko Nieminen,W/O,R16,0,0,0,0,0,0,0,0,0,0,0,0,0,0,0,0,0,0,0,0,0,0,0,0,0,0,0
2009-10-19 00:00:00.000,Stockholm Sweden ATP World Tour 250,HARD,2,Robin Soderling,Guillermo Garcia-Lopez,Robin Soderling,7-6(4); 6-4,Q,104,8,3,38,69,29,38,18,31,3,5,11,47,69,6,5,46,71,28,46,13,25,4,7,11,41,71
2009-10-19 00:00:00.000,Stockholm Sweden ATP World Tour 250,HARD,2,Marcos Baghdatis,Arnaud Clement,Marcos Baghdatis,6-4; 6-4,Q,88,6,3,30,55,24,30,15,25,3,4,10,39,55,1,4,34,62,22,34,13,28,2,5,10,35,62
2009-10-19 00:00:00.000,Stockholm Sweden ATP World Tour 250,HARD,2,Thomaz Bellucci,Joachim Johansson,Thomaz Bellucci,7-6(4); 6-3,Q,82,18,1,42,68,37,42,15,26,1,1,11,52,68,13,0,43,62,34,43,12,19,4,5,10,46,62
2009-10-19 00:00:00.000,Stockholm Sweden ATP World Tour 250,HARD,2,Olivier Rochus,Jarkko Nieminen,Olivier Rochus,6-3; 2-6; 6-1,Q,107,4,2,51,69,31,51,8,18,1,5,12,39,69,8,3,45,77,28,45,10,32,3,9,12,38,77
2009-10-19 00:00:00.000,Stockholm Sweden ATP World Tour 250,HARD,2,Marcos Baghdatis,Robin Soderling,Marcos Baghdatis,W/O,S,0,0,0,0,0,0,0,0,0,0,0,0,0,0,0,0,0,0,0,0,0,0,0,0,0,0,0
2009-10-19 00:00:00.000,Stockholm Sweden ATP World Tour 250,HARD,2,Olivier Rochus,Thomaz Bellucci,Olivier Rochus,7-6(4); 4-6; 6-3,S,143,4,1,65,91,50,65,16,26,2,6,16,66,91,17,2,52,92,39,52,17,40,5,9,15,56,92
2009-10-19 00:00:00.000,Stockholm Sweden ATP World Tour 250,HARD,2,Marcos Baghdatis,Olivier Rochus,Marcos Baghdatis,6-1; 7-5,F,99,15,2,37,65,30,37,10,28,4,6,10,40,65,0,4,35,63,21,35,11,28,5,10,9,32,63
2009-10-25 00:00:00.000,St. Petersburg Russia ATP World Tour 250,HARD,2,Mikhail Youzhny,Andrey Golubev,Mikhail Youzhny,6-3; 6-2,R32,71,0,0,28,47,21,28,15,19,0,0,9,36,47,1,3,32,52,16,32,13,20,3,6,8,29,52
2009-10-25 00:00:00.000,St. Petersburg Russia ATP World Tour 250,HARD,2,Denis Istomin,Rainer Schuettler,Denis Istomin,6-4; 6-4,R32,81,2,1,46,61,36,46,8,15,4,5,10,44,61,7,2,41,65,27,41,11,24,5,8,10,38,65
2009-10-25 00:00:00.000,St. Petersburg Russia ATP World Tour 250,HARD,2,Marat Safin,Richard Gasquet,Marat Safin,7-6(5); 6-4,R32,101,14,2,50,84,36,50,18,34,4,5,11,54,84,6,4,36,70,27,36,18,34,5,7,11,45,70
2009-10-25 00:00:00.000,St. Petersburg Russia ATP World Tour 250,HARD,2,Igor Andreev,Potito Starace,Igor Andreev,6-4; 6-2,R32,85,4,2,43,69,32,43,13,26,6,7,9,45,69,0,2,35,61,16,35,15,26,1,5,9,31,61
2009-10-25 00:00:00.000,St. Petersburg Russia ATP World Tour 250,HARD,2,Karol Beck,Viktor Troicki,Karol Beck,7-6(4); 4-6; 6-4,R32,154,8,2,68,104,54,68,18,36,3,5,16,72,104,10,4,64,107,53,64,15,43,5,7,16,68,107
2009-10-25 00:00:00.000,St. Petersburg Russia ATP World Tour 250,HARD,2,Bjorn Phau,Stanislav Vovk,Bjorn Phau,6-3; 6-2,R32,78,1,2,21,42,18,21,15,21,1,1,8,33,42,1,2,40,70,24,40,13,30,3,7,9,37,70
2009-10-25 00:00:00.000,St. Petersburg Russia ATP World Tour 250,HARD,2,Andrey Kuznetsov,Marcel Granollers,Andrey Kuznetsov,6-7(4); 7-6(6); 6-4,R32,172,8,4,69,116,52,69,24,47,6,8,17,76,116,7,3,86,132,57,86,25,46,3,6,17,82,132
2009-10-25 00:00:00.000,St. Petersburg Russia ATP World Tour 250,HARD,2,Sergiy Stakhovsky,Evgeny Korolev,Sergiy Stakhovsky,6-4; 6-3,R32,59,6,0,32,47,28,32,12,15,0,0,10,40,47,0,2,39,52,24,39,8,13,3,5,9,32,52
2009-10-25 00:00:00.000,St. Petersburg Russia ATP World Tour 250,HARD,2,Horacio Zeballos,Yuri Schukin,Horacio Zeballos,7-6(9); 6-3,R32,99,17,4,46,71,36,46,13,25,2,3,11,49,71,7,3,53,81,39,53,11,28,3,5,10,50,81
2009-10-25 00:00:00.000,St. Petersburg Russia ATP World Tour 250,HARD,2,Alexandr Dolgopolov,Robby Ginepri,Alexandr Dolgopolov,6-2; 1-0 RET,R32,29,1,0,16,23,13,16,4,7,0,0,4,17,23,3,1,18,33,13,18,3,15,0,3,5,16,33
2009-10-25 00:00:00.000,St. Petersburg Russia ATP World Tour 250,HARD,2,Ernests Gulbis,Florian Mayer,Ernests Gulbis,6-3; 7-6(3),R32,64,3,5,55,79,45,55,11,24,7,7,11,56,79,1,0,45,59,35,45,7,14,3,4,10,42,59
2009-10-25 00:00:00.000,St. Petersburg Russia ATP World Tour 250,HARD,2,Jeremy Chardy,Petru-Alexandru Luncanu,Jeremy Chardy,6-2; 6-2,R32,63,6,0,30,39,24,30,8,9,0,0,8,32,39,0,4,34,65,20,34,12,31,7,11,8,32,65
2009-10-25 00:00:00.000,St. Petersburg Russia ATP World Tour 250,HARD,2,Igor Kunitsyn,Pablo Cuevas,Igor Kunitsyn,6-4; 6-3,R32,70,1,0,44,61,30,44,10,17,3,5,10,40,61,2,6,31,57,19,31,9,26,5,9,9,28,57
2009-10-25 00:00:00.000,St. Petersburg Russia ATP World Tour 250,HARD,2,Mikhail Elgin,Mikhail Kukushkin,Mikhail Elgin,6-3; 6-3,R32,92,11,1,44,70,35,44,11,26,5,5,9,46,70,2,1,39,70,22,39,16,31,7,10,9,38,70
2009-10-25 00:00:00.000,St. Petersburg Russia ATP World Tour 250,HARD,2,Illya Marchenko,Fabio Fognini,Illya Marchenko,6-4; 6-1,R32,62,1,3,34,51,29,34,10,17,2,2,9,39,51,2,4,29,55,17,29,13,26,4,7,8,30,55
2009-10-25 00:00:00.000,St. Petersburg Russia ATP World Tour 250,HARD,2,Victor Hanescu,Teymuraz Gabashvili,Victor Hanescu,6-1; 6-2,R32,59,4,0,30,43,27,30,7,13,2,2,8,34,43,1,4,29,44,17,29,5,15,4,8,7,22,44
2009-10-25 00:00:00.000,St. Petersburg Russia ATP World Tour 250,HARD,2,Denis Istomin,Mikhail Youzhny,Denis Istomin,6-2; 2-1 RET,R16,51,0,0,33,38,24,33,3,5,2,2,6,27,38,3,1,18,32,10,18,6,14,1,3,5,16,32
2009-10-25 00:00:00.000,St. Petersburg Russia ATP World Tour 250,HARD,2,Marat Safin,Igor Andreev,Marat Safin,6-3; 0-1 RET,R16,41,4,0,17,31,15,17,6,14,0,0,5,21,31,0,0,29,37,20,29,2,8,2,3,5,22,37
2009-10-25 00:00:00.000,St. Petersburg Russia ATP World Tour 250,HARD,2,Bjorn Phau,Karol Beck,Bjorn Phau,6-4; 2-1 RET,R16,50,1,1,18,32,13,18,9,14,1,2,6,22,32,3,1,16,37,10,16,9,21,0,3,7,19,37
2009-10-25 00:00:00.000,St. Petersburg Russia ATP World Tour 250,HARD,2,Sergiy Stakhovsky,Andrey Kuznetsov,Sergiy Stakhovsky,6-1; 6-4,R16,62,7,0,32,53,26,32,14,21,3,3,9,40,53,2,2,25,42,17,25,7,17,1,4,8,24,42
2009-10-25 00:00:00.000,St. Petersburg Russia ATP World Tour 250,HARD,2,Horacio Zeballos,Alexandr Dolgopolov,Horacio Zeballos,6-3; 6-1,R16,49,4,1,30,42,23,30,9,12,0,0,8,32,42,8,2,32,49,20,32,6,17,2,6,8,26,49
2009-10-25 00:00:00.000,St. Petersburg Russia ATP World Tour 250,HARD,2,Ernests Gulbis,Jeremy Chardy,Ernests Gulbis,7-6(7); 6-3,R16,95,22,4,52,73,46,52,8,21,3,4,11,54,73,9,2,49,83,37,49,14,34,8,10,10,51,83
2009-10-25 00:00:00.000,St. Petersburg Russia ATP World Tour 250,HARD,2,Igor Kunitsyn,Mikhail Elgin,Igor Kunitsyn,6-2; 6-3,R16,69,3,0,43,63,29,43,13,20,2,2,9,42,63,6,1,30,47,20,30,5,17,3,6,8,25,47
2009-10-25 00:00:00.000,St. Petersburg Russia ATP World Tour 250,HARD,2,Victor Hanescu,Illya Marchenko,Victor Hanescu,6-3; 6-4,R16,79,7,1,36,54,32,36,9,18,0,0,10,41,54,1,1,34,55,26,34,9,21,0,2,9,35,55
2009-10-25 00:00:00.000,St. Petersburg Russia ATP World Tour 250,HARD,2,Marat Safin,Denis Istomin,Marat Safin,6-0; 7-6(4),Q,82,12,1,31,51,26,31,10,20,0,2,9,36,51,4,0,55,76,32,55,7,21,10,15,9,39,76
2009-10-25 00:00:00.000,St. Petersburg Russia ATP World Tour 250,HARD,2,Sergiy Stakhovsky,Bjorn Phau,Sergiy Stakhovsky,6-2; 7-5,Q,90,4,1,49,72,35,49,13,23,1,2,10,48,72,1,4,39,67,27,39,9,28,5,9,10,36,67
2009-10-25 00:00:00.000,St. Petersburg Russia ATP World Tour 250,HARD,2,Horacio Zeballos,Ernests Gulbis,Horacio Zeballos,7-6(8); 6-4,Q,92,3,0,52,80,38,52,18,28,6,6,11,56,80,18,4,47,65,37,47,11,18,1,2,11,48,65
2009-10-25 00:00:00.000,St. Petersburg Russia ATP World Tour 250,HARD,2,Igor Kunitsyn,Victor Hanescu,Igor Kunitsyn,6-3; 3-6; 7-6(6),Q,132,4,1,75,99,52,75,14,24,7,9,15,66,99,5,1,78,95,55,78,8,17,5,7,15,63,95
2009-10-25 00:00:00.000,St. Petersburg Russia ATP World Tour 250,HARD,2,Sergiy Stakhovsky,Marat Safin,Sergiy Stakhovsky,6-4; 4-6; 6-4,S,108,7,3,68,98,49,68,14,30,4,6,15,63,98,10,3,40,72,32,40,18,32,1,4,15,50,72
2009-10-25 00:00:00.000,St. Petersburg Russia ATP World Tour 250,HARD,2,Horacio Zeballos,Igor Kunitsyn,Horacio Zeballos,7-6(7); 6-3,S,85,10,2,52,74,39,52,10,22,1,2,11,49,74,3,0,41,59,30,41,10,18,0,2,10,40,59
2009-10-25 00:00:00.000,St. Petersburg Russia ATP World Tour 250,HARD,2,Sergiy Stakhovsky,Horacio Zeballos,Sergiy Stakhovsky,2-6; 7-6(8); 7-6(7),F,139,9,3,69,103,53,69,13,34,7,11,16,66,103,1,2,68,99,49,68,19,31,1,3,16,68,99
2009-10-26 00:00:00.000,Lyon France ATP World Tour 250,HARD,2,Jo-Wilfried Tsonga,Kevin Kim,Jo-Wilfried Tsonga,7-6(5); 7-6(5),R32,96,14,2,52,75,47,52,11,23,0,0,12,58,75,5,3,59,83,47,59,12,24,2,2,12,59,83
2009-10-26 00:00:00.000,Lyon France ATP World Tour 250,HARD,2,Olivier Rochus,Vincent Millot,Olivier Rochus,6-3; 6-2,R32,82,1,1,35,53,23,35,14,18,1,2,9,37,53,2,0,36,58,23,36,5,22,5,9,8,28,58
2009-10-26 00:00:00.000,Lyon France ATP World Tour 250,HARD,2,Arnaud Clement,Oscar Hernandez,Arnaud Clement,6-1; 6-3,R32,68,6,0,26,44,17,26,10,18,0,2,8,27,44,3,5,33,54,17,33,5,21,6,12,8,22,54
2009-10-26 00:00:00.000,Lyon France ATP World Tour 250,HARD,2,Benjamin Becker,Paolo Lorenzi,Benjamin Becker,6-2; 6-2,R32,53,10,0,26,39,26,26,6,13,0,0,8,32,39,2,2,25,46,16,25,6,21,2,6,8,22,46
2009-10-26 00:00:00.000,Lyon France ATP World Tour 250,HARD,2,Ivan Ljubicic,Martin Vassallo Arguello,Ivan Ljubicic,6-3; 6-4,R32,89,7,2,33,57,29,33,12,24,1,1,10,41,57,1,2,64,80,40,64,7,16,10,12,9,47,80
2009-10-26 00:00:00.000,Lyon France ATP World Tour 250,HARD,2,Nicolas Kiefer,Sebastien Grosjean,Nicolas Kiefer,4-6; 7-6(7); 7-6(2),R32,148,20,7,67,119,53,67,26,52,7,10,17,79,119,17,3,80,120,61,80,17,40,9,11,17,78,120
2009-10-26 00:00:00.000,Lyon France ATP World Tour 250,HARD,2,Florent Serra,Christophe Rochus,Florent Serra,6-3; 6-3,R32,62,6,2,37,54,29,37,11,17,4,4,9,40,54,4,1,36,54,21,36,10,18,3,6,9,31,54
2009-10-26 00:00:00.000,Lyon France ATP World Tour 250,HARD,2,Albert Montanes,Fabrice Santoro,Albert Montanes,6-4; 6-4,R32,85,0,0,49,80,29,49,22,31,5,5,10,51,80,13,2,42,61,34,42,6,19,3,5,10,40,61
2009-10-26 00:00:00.000,Lyon France ATP World Tour 250,HARD,2,Paul-Henri Mathieu,Leonardo Mayer,Paul-Henri Mathieu,7-6(5); 6-2,R32,91,7,0,32,57,24,32,19,25,1,2,10,43,57,18,4,41,72,31,41,14,31,6,9,10,45,72
2009-10-26 00:00:00.000,Lyon France ATP World Tour 250,HARD,2,Marc Gicquel,Jerome Haehnel,Marc Gicquel,6-1; 6-4,R32,59,8,0,37,50,29,37,9,13,1,1,9,38,50,2,2,30,50,18,30,10,20,3,6,8,28,50
2009-10-26 00:00:00.000,Lyon France ATP World Tour 250,HARD,2,Michael Llodra,Lamine Ouahab,Michael Llodra,6-1; 6-2,R32,48,11,1,22,37,21,22,11,15,0,0,8,32,37,2,5,17,42,10,17,8,25,2,6,7,18,42
2009-10-26 00:00:00.000,Lyon France ATP World Tour 250,HARD,2,Juan Monaco,Josselin Ouanna,Juan Monaco,6-3; 6-2,R32,61,3,1,30,45,18,30,10,15,1,3,8,28,45,6,2,36,58,20,36,5,22,4,10,9,25,58
2009-10-26 00:00:00.000,Lyon France ATP World Tour 250,HARD,2,Julien Benneteau,Alberto Martin,Julien Benneteau,7-6(1); 6-1,R32,90,6,1,39,57,32,39,9,18,0,0,9,41,57,2,3,48,78,31,48,12,30,6,9,10,43,78
2009-10-26 00:00:00.000,Lyon France ATP World Tour 250,HARD,2,Kevin Anderson,Simon Greul,Kevin Anderson,6-4; 4-6; 7-6(3),R32,134,24,2,75,104,60,75,12,29,3,5,16,72,104,6,6,56,103,45,56,25,47,4,6,16,70,103
2009-10-26 00:00:00.000,Lyon France ATP World Tour 250,HARD,2,David Guez,Rajeev Ram,David Guez,6-2; 6-4,R32,72,2,1,32,55,24,32,16,23,3,3,9,40,55,7,1,34,51,22,34,9,17,2,5,9,31,51
2009-10-26 00:00:00.000,Lyon France ATP World Tour 250,HARD,2,Gilles Simon,Simone Bolelli,Gilles Simon,7-6(5); 7-6(5),R32,128,14,2,47,89,38,47,21,42,3,4,12,59,89,1,0,65,101,43,65,20,36,3,4,12,63,101
2009-10-26 00:00:00.000,Lyon France ATP World Tour 250,HARD,2,Jo-Wilfried Tsonga,Olivier Rochus,Jo-Wilfried Tsonga,6-3; 6-2,R16,64,13,1,30,49,25,30,12,19,2,2,9,37,49,0,0,37,50,21,37,8,13,1,4,8,29,50
2009-10-26 00:00:00.000,Lyon France ATP World Tour 250,HARD,2,Arnaud Clement,Benjamin Becker,Arnaud Clement,6-4; 6-3,R16,82,2,1,39,56,30,39,12,17,1,1,10,42,56,6,4,28,59,21,28,15,31,3,5,9,36,59
2009-10-26 00:00:00.000,Lyon France ATP World Tour 250,HARD,2,Ivan Ljubicic,Nicolas Kiefer,Ivan Ljubicic,6-3; 3-6; 6-3,R16,103,27,0,52,73,44,52,11,21,0,1,14,55,73,9,3,61,89,46,61,10,28,9,11,13,56,89
2009-10-26 00:00:00.000,Lyon France ATP World Tour 250,HARD,2,Florent Serra,Albert Montanes,Florent Serra,7-5; 6-3,R16,70,11,2,39,57,32,39,11,18,2,3,11,43,57,4,0,36,67,26,36,13,31,3,6,10,39,67
2009-10-26 00:00:00.000,Lyon France ATP World Tour 250,HARD,2,Marc Gicquel,Paul-Henri Mathieu,Marc Gicquel,6-4; 6-0,R16,72,10,0,30,48,26,30,7,18,3,4,8,33,48,5,0,34,63,21,34,8,29,8,13,8,29,63
2009-10-26 00:00:00.000,Lyon France ATP World Tour 250,HARD,2,Michael Llodra,Juan Monaco,Michael Llodra,6-3; 6-4,R16,75,11,0,37,56,31,37,11,19,0,0,10,42,56,4,2,41,61,27,41,10,20,3,5,9,37,61
2009-10-26 00:00:00.000,Lyon France ATP World Tour 250,HARD,2,Julien Benneteau,Kevin Anderson,Julien Benneteau,7-5; 6-2,R16,70,5,1,34,43,33,34,7,9,0,0,10,40,43,12,2,45,61,33,45,7,16,4,7,10,40,61
2009-10-26 00:00:00.000,Lyon France ATP World Tour 250,HARD,2,Gilles Simon,David Guez,Gilles Simon,6-1; 6-2,R16,53,5,0,29,44,20,29,9,15,4,5,7,29,44,1,4,19,41,7,19,7,22,0,6,8,14,41
2009-10-26 00:00:00.000,Lyon France ATP World Tour 250,HARD,2,Arnaud Clement,Jo-Wilfried Tsonga,Arnaud Clement,5-7; 6-4; 7-6(8),Q,167,5,1,83,124,63,83,20,41,5,6,17,83,124,27,3,80,114,67,80,10,34,5,6,17,77,114
2009-10-26 00:00:00.000,Lyon France ATP World Tour 250,HARD,2,Ivan Ljubicic,Florent Serra,Ivan Ljubicic,7-6(6); 6-2,Q,82,16,1,40,55,36,40,10,15,0,0,10,46,55,4,4,60,92,40,60,15,32,10,12,10,55,92
2009-10-26 00:00:00.000,Lyon France ATP World Tour 250,HARD,2,Michael Llodra,Marc Gicquel,Michael Llodra,7-6(5); 6-4,Q,86,13,0,42,65,35,42,14,23,4,5,11,49,65,4,1,44,64,34,44,10,20,1,3,11,44,64
2009-10-26 00:00:00.000,Lyon France ATP World Tour 250,HARD,2,Gilles Simon,Julien Benneteau,Gilles Simon,7-6(5); 6-3,Q,83,6,0,35,53,33,35,12,18,0,0,10,45,53,4,1,45,74,35,45,14,29,1,3,11,49,74
2009-10-26 00:00:00.000,Lyon France ATP World Tour 250,HARD,2,Ivan Ljubicic,Arnaud Clement,Ivan Ljubicic,6-2; 6-4,S,81,6,0,25,46,22,25,15,21,0,0,9,37,46,2,1,36,56,27,36,8,20,4,7,9,35,56
2009-10-26 00:00:00.000,Lyon France ATP World Tour 250,HARD,2,Michael Llodra,Gilles Simon,Michael Llodra,6-7(4); 6-3; 7-6(1),S,108,24,2,67,90,59,67,17,23,0,0,17,76,90,7,0,53,93,42,53,27,40,3,4,16,69,93
2009-10-26 00:00:00.000,Lyon France ATP World Tour 250,HARD,2,Ivan Ljubicic,Michael Llodra,Ivan Ljubicic,7-5; 6-3,F,97,7,0,56,77,41,56,9,21,3,4,11,50,77,9,6,43,71,31,43,10,28,6,9,10,41,71
2009-10-26 00:00:00.000,Vienna Austria ATP World Tour 250,HARD,2,Marin Cilic,Alejandro Falla,Marin Cilic,6-2; 6-3,R32,78,7,2,27,45,21,27,10,18,0,1,8,31,45,5,2,46,77,25,46,12,31,6,11,9,37,77
2009-10-26 00:00:00.000,Vienna Austria ATP World Tour 250,HARD,2,Daniel Brands,Robert Kendrick,Daniel Brands,7-6(5); 7-5,R32,76,13,1,51,69,37,51,14,18,2,3,12,51,69,16,1,38,63,31,38,15,25,0,2,12,46,63
2009-10-26 00:00:00.000,Vienna Austria ATP World Tour 250,HARD,2,Daniel Koellerer,Jarkko Nieminen,Daniel Koellerer,6-1; 6-2,R32,71,2,2,46,64,33,46,10,18,8,8,8,43,64,1,2,25,40,14,25,4,15,2,6,7,18,40
2009-10-26 00:00:00.000,Vienna Austria ATP World Tour 250,HARD,2,Feliciano Lopez,Andreas Haider-Maurer,Feliciano Lopez,6-4; 6-4,R32,72,5,1,26,50,24,26,15,24,1,2,10,39,50,6,7,26,57,18,26,16,31,4,7,10,34,57
2009-10-26 00:00:00.000,Vienna Austria ATP World Tour 250,HARD,2,Philipp Kohlschreiber,Dieter Kindlmann,Philipp Kohlschreiber,6-1; 6-3,R32,69,9,0,30,54,23,30,16,24,4,4,8,39,54,1,5,23,57,17,23,11,34,7,11,8,28,57
2009-10-26 00:00:00.000,Vienna Austria ATP World Tour 250,HARD,2,Victor Crivoi,Jan Hernych,Victor Crivoi,6-3; 6-3,R32,69,3,4,31,53,26,31,11,22,2,3,9,37,53,4,3,45,61,27,45,4,16,7,11,9,31,61
2009-10-26 00:00:00.000,Vienna Austria ATP World Tour 250,HARD,2,Wayne Odesnik,Lukas Rosol,Wayne Odesnik,6-2; 5-7; 7-6(6),R32,141,10,1,73,103,51,73,18,30,2,5,16,69,103,10,3,70,110,52,70,16,40,8,12,16,68,110
2009-10-26 00:00:00.000,Vienna Austria ATP World Tour 250,HARD,2,Nicolas Almagro,Peter Luczak,Nicolas Almagro,5-7; 7-6(3); 6-1,R32,134,20,1,61,108,47,61,27,47,7,9,16,74,108,15,4,69,106,51,69,15,37,4,7,15,66,106
2009-10-26 00:00:00.000,Vienna Austria ATP World Tour 250,HARD,2,Janko Tipsarevic,John Isner,Janko Tipsarevic,7-6(4); 6-4,R32,93,9,2,45,69,37,45,16,24,4,4,11,53,69,11,2,54,71,40,54,11,17,4,5,11,51,71
2009-10-26 00:00:00.000,Vienna Austria ATP World Tour 250,HARD,2,Michael Berrer,Steve Darcis,Michael Berrer,6-3; 6-2,R32,61,9,1,43,57,30,43,9,14,4,4,9,39,57,7,0,28,41,19,28,5,13,3,6,8,24,41
2009-10-26 00:00:00.000,Vienna Austria ATP World Tour 250,HARD,2,Jan Hajek,Andreas Seppi,Jan Hajek,7-6(4); 5-7; 6-3,R32,140,7,2,81,112,54,81,17,31,4,7,17,71,112,9,6,63,104,47,63,18,41,4,7,16,65,104
2009-10-26 00:00:00.000,Vienna Austria ATP World Tour 250,HARD,2,Gael Monfils,Guillermo Garcia-Lopez,Gael Monfils,7-5; 6-4,R32,82,7,1,35,58,30,35,16,23,2,2,11,46,58,2,3,35,65,26,35,16,30,6,8,11,42,65
2009-10-26 00:00:00.000,Vienna Austria ATP World Tour 250,HARD,2,Jurgen Melzer,Marco Chiudinelli,Jurgen Melzer,7-6(4); 7-6(10),R32,127,12,1,54,97,42,54,23,43,3,4,12,65,97,5,1,49,86,36,49,23,37,3,4,12,59,86
2009-10-26 00:00:00.000,Vienna Austria ATP World Tour 250,HARD,2,Dominik Hrbaty,Ruben Ramirez Hidalgo,Dominik Hrbaty,6-3; 6-4,R32,80,4,2,32,54,25,32,9,22,4,6,9,34,54,5,5,33,65,18,33,13,32,3,8,10,31,65
2009-10-26 00:00:00.000,Vienna Austria ATP World Tour 250,HARD,2,Frederico Gil,Stefan Koubek,Frederico Gil,4-6; 6-4; 6-4,R32,120,5,0,62,90,45,62,13,28,6,9,15,58,90,5,3,48,86,31,48,20,38,5,9,15,51,86
2009-10-26 00:00:00.000,Vienna Austria ATP World Tour 250,HARD,2,Radek Stepanek,Lukasz Kubot,Radek Stepanek,6-4; 6-1,R32,83,10,1,33,46,27,33,6,13,2,2,8,33,46,5,0,44,73,24,44,13,29,7,11,9,37,73
2009-10-26 00:00:00.000,Vienna Austria ATP World Tour 250,HARD,2,Marin Cilic,Daniel Brands,Marin Cilic,7-6(7); 6-4,R16,95,7,3,33,63,30,33,20,30,2,3,11,50,63,5,6,50,77,38,50,12,27,6,8,11,50,77
2009-10-26 00:00:00.000,Vienna Austria ATP World Tour 250,HARD,2,Feliciano Lopez,Daniel Koellerer,Feliciano Lopez,6-3; 6-3,R16,81,6,1,28,49,22,28,13,21,1,2,9,35,49,1,2,49,58,28,49,3,9,4,8,9,31,58
2009-10-26 00:00:00.000,Vienna Austria ATP World Tour 250,HARD,2,Philipp Kohlschreiber,Victor Crivoi,Philipp Kohlschreiber,6-2; 3-0 RET,R16,35,4,0,14,25,11,14,9,11,0,0,5,20,25,3,1,15,34,9,15,7,19,3,7,6,16,34
2009-10-26 00:00:00.000,Vienna Austria ATP World Tour 250,HARD,2,Nicolas Almagro,Wayne Odesnik,Nicolas Almagro,6-4; 6-4,R16,73,8,0,32,50,27,32,13,18,0,0,10,40,50,9,1,28,55,22,28,14,27,2,4,10,36,55
2009-10-26 00:00:00.000,Vienna Austria ATP World Tour 250,HARD,2,Janko Tipsarevic,Michael Berrer,Janko Tipsarevic,7-6(3); 6-1,R16,95,6,2,37,67,29,37,13,30,5,7,9,42,67,3,2,38,60,20,38,7,22,1,6,10,27,60
2009-10-26 00:00:00.000,Vienna Austria ATP World Tour 250,HARD,2,Gael Monfils,Jan Hajek,Gael Monfils,6-1; 2-6; 6-4,R16,91,8,3,52,75,37,52,12,23,1,3,12,49,75,3,2,55,86,34,55,15,31,7,11,13,49,86
2009-10-26 00:00:00.000,Vienna Austria ATP World Tour 250,HARD,2,Jurgen Melzer,Dominik Hrbaty,Jurgen Melzer,6-4; 7-5,R16,79,5,4,49,71,38,49,11,22,5,6,11,49,71,5,2,40,63,28,40,11,23,3,6,11,39,63
2009-10-26 00:00:00.000,Vienna Austria ATP World Tour 250,HARD,2,Radek Stepanek,Frederico Gil,Radek Stepanek,6-2; 6-3,R16,70,2,1,29,49,26,29,11,20,0,0,9,37,49,4,0,40,56,23,40,8,16,3,6,8,31,56
2009-10-26 00:00:00.000,Vienna Austria ATP World Tour 250,HARD,2,Marin Cilic,Feliciano Lopez,Marin Cilic,6-1; 6-4,Q,85,8,1,33,61,25,33,17,28,2,2,9,42,61,4,5,33,59,20,33,13,26,5,8,8,33,59
2009-10-26 00:00:00.000,Vienna Austria ATP World Tour 250,HARD,2,Philipp Kohlschreiber,Nicolas Almagro,Philipp Kohlschreiber,7-5; 6-4,Q,77,8,0,47,65,35,47,13,18,3,3,11,48,65,9,4,39,66,32,39,12,27,3,5,11,44,66
2009-10-26 00:00:00.000,Vienna Austria ATP World Tour 250,HARD,2,Janko Tipsarevic,Gael Monfils,Janko Tipsarevic,6-4; 6-7(8); 6-3,Q,132,8,0,68,101,47,68,24,33,4,5,16,71,101,8,3,65,101,49,65,17,36,7,10,15,66,101
2009-10-26 00:00:00.000,Vienna Austria ATP World Tour 250,HARD,2,Jurgen Melzer,Radek Stepanek,Jurgen Melzer,6-2; 6-2,Q,61,6,0,28,42,22,28,12,14,1,1,8,34,42,1,2,35,52,21,35,5,17,3,7,8,26,52
2009-10-26 00:00:00.000,Vienna Austria ATP World Tour 250,HARD,2,Marin Cilic,Philipp Kohlschreiber,Marin Cilic,6-4; 7-6(4),S,99,12,1,39,66,31,39,17,27,2,3,11,48,66,2,1,56,82,37,56,13,26,6,8,11,50,82
2009-10-26 00:00:00.000,Vienna Austria ATP World Tour 250,HARD,2,Jurgen Melzer,Janko Tipsarevic,Jurgen Melzer,4-6; 7-6(5); 6-4,S,149,17,2,55,105,44,55,31,50,3,4,16,75,105,5,3,49,96,41,49,25,47,2,3,16,66,96
2009-10-26 00:00:00.000,Vienna Austria ATP World Tour 250,HARD,2,Jurgen Melzer,Marin Cilic,Jurgen Melzer,6-4; 6-3,F,93,1,1,33,61,24,33,17,28,5,5,9,41,61,10,3,40,65,31,40,10,25,5,8,10,41,65
2009-11-02 00:00:00.000,Basel Switzerland ATP World Tour 500,HARD,2,Roger Federer,Olivier Rochus,Roger Federer,6-3; 6-4,R32,67,12,1,37,55,32,37,10,18,0,0,10,42,55,1,0,36,59,22,36,14,23,0,2,9,36,59
2009-11-02 00:00:00.000,Basel Switzerland ATP World Tour 500,HARD,2,Andreas Seppi,Stephane Bohli,Andreas Seppi,4-6; 6-1; 7-5,R32,151,6,6,53,94,36,53,20,41,4,7,14,56,94,4,3,54,105,31,54,26,51,3,9,15,57,105
2009-11-02 00:00:00.000,Basel Switzerland ATP World Tour 500,HARD,2,Evgeny Korolev,Simone Bolelli,Evgeny Korolev,3-6; 7-6(4); 6-2,R32,130,11,6,70,110,51,70,20,40,9,10,14,71,110,14,0,74,108,51,74,18,34,10,12,15,69,108
2009-11-02 00:00:00.000,Basel Switzerland ATP World Tour 500,HARD,2,Jeremy Chardy,James Blake,Jeremy Chardy,7-6(4); 6-7(6); 6-4,R32,137,24,1,56,103,48,56,30,47,2,2,17,78,103,14,8,73,128,56,73,26,55,6,7,17,82,128
2009-11-02 00:00:00.000,Basel Switzerland ATP World Tour 500,HARD,2,John Isner,Fernando Gonzalez,John Isner,7-6(3); 4-6; 6-4,R32,112,18,1,76,101,55,76,17,25,1,2,16,72,101,17,4,61,92,51,61,17,31,1,2,16,68,92
2009-11-02 00:00:00.000,Basel Switzerland ATP World Tour 500,HARD,2,Richard Gasquet,Horacio Zeballos,Richard Gasquet,7-6(3); 6-4,R32,87,9,1,40,74,32,40,21,34,2,2,11,53,74,6,1,45,71,30,45,17,26,3,4,11,47,71
2009-11-02 00:00:00.000,Basel Switzerland ATP World Tour 500,HARD,2,Michael Lammer,Daniel Koellerer,Michael Lammer,3-6; 6-2; 7-5,R32,128,4,3,45,72,33,45,17,27,0,3,14,50,72,2,2,85,104,51,85,9,19,12,17,15,60,104
2009-11-02 00:00:00.000,Basel Switzerland ATP World Tour 500,HARD,2,Marco Chiudinelli,Philipp Kohlschreiber,Marco Chiudinelli,7-6(5); 3-6; 7-5,R32,135,11,3,67,105,48,67,20,38,10,12,16,68,105,15,5,65,98,52,65,19,33,4,6,17,71,98
2009-11-02 00:00:00.000,Basel Switzerland ATP World Tour 500,HARD,2,Radek Stepanek,Rainer Schuettler,Radek Stepanek,6-2; 6-0,R32,68,6,2,43,63,30,43,10,20,5,5,7,40,63,1,3,28,46,14,28,7,18,6,11,7,21,46
2009-11-02 00:00:00.000,Basel Switzerland ATP World Tour 500,HARD,2,Florent Serra,Ivo Karlovic,Florent Serra,7-6(5); 6-4,R32,78,6,2,41,63,34,41,17,22,2,2,11,51,63,28,2,49,70,41,49,8,21,3,4,11,49,70
2009-11-02 00:00:00.000,Basel Switzerland ATP World Tour 500,HARD,2,Viktor Troicki,Benjamin Becker,Viktor Troicki,6-2; 7-6(5),R32,88,8,1,36,64,30,36,14,28,1,2,10,44,64,4,2,36,69,25,36,15,33,5,8,10,40,69
2009-11-02 00:00:00.000,Basel Switzerland ATP World Tour 500,HARD,2,Marin Cilic,Philipp Petzschner,Marin Cilic,6-4; 6-4,R32,83,14,5,38,68,31,38,15,30,2,2,10,46,68,10,2,43,66,35,43,7,23,3,5,10,42,66
2009-11-02 00:00:00.000,Basel Switzerland ATP World Tour 500,HARD,2,Stanislas Wawrinka,Ivan Ljubicic,Stanislas Wawrinka,6-7(5); 6-3; 6-4,R32,132,15,4,57,95,46,57,23,38,4,6,16,69,95,13,3,56,97,42,56,20,41,3,7,15,62,97
2009-11-02 00:00:00.000,Basel Switzerland ATP World Tour 500,HARD,2,Jarkko Nieminen,Julien Benneteau,Jarkko Nieminen,7-5; 6-2,R32,94,1,2,46,68,33,46,11,22,1,2,10,44,68,4,1,48,68,28,48,7,20,4,8,10,35,68
2009-11-02 00:00:00.000,Basel Switzerland ATP World Tour 500,HARD,2,Jan Hernych,Peter Luczak,Jan Hernych,6-3; 6-4,R32,76,4,1,38,66,30,38,16,28,6,6,10,46,66,4,2,23,47,16,23,14,24,0,2,9,30,47
2009-11-02 00:00:00.000,Basel Switzerland ATP World Tour 500,HARD,2,Novak Djokovic,Andreas Beck,Novak Djokovic,6-3; 7-5,R32,87,10,2,41,63,33,41,11,22,3,4,11,44,63,6,3,38,64,29,38,7,26,5,8,10,36,64
2009-11-02 00:00:00.000,Basel Switzerland ATP World Tour 500,HARD,2,Roger Federer,Andreas Seppi,Roger Federer,6-3; 6-3,R16,61,6,0,38,55,30,38,10,17,2,2,9,40,55,2,1,37,56,23,37,10,19,4,7,9,33,56
2009-11-02 00:00:00.000,Basel Switzerland ATP World Tour 500,HARD,2,Evgeny Korolev,Jeremy Chardy,Evgeny Korolev,6-4; 7-6(1),R16,71,8,3,42,64,32,42,13,22,0,1,11,45,64,12,2,28,55,26,28,15,27,2,4,11,41,55
2009-11-02 00:00:00.000,Basel Switzerland ATP World Tour 500,HARD,2,Richard Gasquet,John Isner,Richard Gasquet,4-6; 7-6(9); 6-2,R16,121,6,4,58,93,48,58,22,35,3,4,15,70,93,22,4,77,102,58,77,12,25,4,6,15,70,102
2009-11-02 00:00:00.000,Basel Switzerland ATP World Tour 500,HARD,2,Marco Chiudinelli,Michael Lammer,Marco Chiudinelli,2-6; 6-3; 6-3,R16,127,8,4,53,80,37,53,17,27,6,8,13,54,80,3,4,56,89,37,56,16,33,6,9,13,53,89
2009-11-02 00:00:00.000,Basel Switzerland ATP World Tour 500,HARD,2,Radek Stepanek,Florent Serra,Radek Stepanek,3-6; 7-6(1); 7-6(1),R16,140,22,4,67,103,54,67,20,36,2,3,16,74,103,11,4,87,137,65,87,24,50,16,16,17,89,137
2009-11-02 00:00:00.000,Basel Switzerland ATP World Tour 500,HARD,2,Marin Cilic,Viktor Troicki,Marin Cilic,7-6(7); 6-7(8); 7-6(6),R16,181,10,3,74,126,57,74,28,52,4,7,18,85,126,9,5,83,138,60,83,26,55,5,8,18,86,138
2009-11-02 00:00:00.000,Basel Switzerland ATP World Tour 500,HARD,2,Stanislas Wawrinka,Jarkko Nieminen,Stanislas Wawrinka,7-5; 2-6; 6-1,R16,120,10,2,47,78,37,47,13,31,0,3,14,50,78,2,1,64,98,38,64,18,34,10,14,13,56,98
2009-11-02 00:00:00.000,Basel Switzerland ATP World Tour 500,HARD,2,Novak Djokovic,Jan Hernych,Novak Djokovic,6-0; 6-0,R16,53,4,1,30,47,21,30,11,17,3,3,6,32,47,2,2,21,37,8,21,3,16,3,9,6,11,37
2009-11-02 00:00:00.000,Basel Switzerland ATP World Tour 500,HARD,2,Roger Federer,Evgeny Korolev,Roger Federer,6-3; 6-2,Q,56,7,0,41,55,32,41,8,14,2,2,9,40,55,3,2,25,43,18,25,8,18,1,4,8,26,43
2009-11-02 00:00:00.000,Basel Switzerland ATP World Tour 500,HARD,2,Marco Chiudinelli,Richard Gasquet,Marco Chiudinelli,6-1; 6-3,Q,62,13,2,31,44,28,31,6,13,3,3,8,34,44,3,2,39,50,20,39,3,11,3,7,8,23,50
2009-11-02 00:00:00.000,Basel Switzerland ATP World Tour 500,HARD,2,Radek Stepanek,Marin Cilic,Radek Stepanek,4-6; 6-3; 6-3,Q,122,7,4,53,86,37,53,20,33,6,8,14,57,86,10,1,46,84,33,46,17,38,0,4,14,50,84
2009-11-02 00:00:00.000,Basel Switzerland ATP World Tour 500,HARD,2,Novak Djokovic,Stanislas Wawrinka,Novak Djokovic,3-6; 7-6(5); 6-2,Q,139,5,1,51,84,44,51,17,33,4,6,14,61,84,13,1,61,96,44,61,19,35,6,9,15,63,96
2009-11-02 00:00:00.000,Basel Switzerland ATP World Tour 500,HARD,2,Roger Federer,Marco Chiudinelli,Roger Federer,7-6(7); 6-3,S,85,4,0,44,63,36,44,15,19,3,3,11,51,63,1,2,52,67,39,52,7,15,2,3,10,46,67
2009-11-02 00:00:00.000,Basel Switzerland ATP World Tour 500,HARD,2,Novak Djokovic,Radek Stepanek,Novak Djokovic,6-7(4); 7-5; 6-2,S,151,7,7,58,105,44,58,28,47,7,7,16,72,105,8,2,62,106,48,62,21,44,5,8,16,69,106
2009-11-02 00:00:00.000,Basel Switzerland ATP World Tour 500,HARD,2,Novak Djokovic,Roger Federer,Novak Djokovic,6-4; 4-6; 6-2,F,131,6,7,63,98,45,63,19,35,9,11,14,64,98,10,1,61,86,42,61,11,25,4,8,14,53,86
2009-11-02 00:00:00.000,Valencia Spain ATP World Tour 500,HARD,2,Andy Murray,Daniel Gimeno-Traver,Andy Murray,6-3; 6-1,R32,60,3,2,26,45,22,26,9,19,1,2,8,31,45,2,2,25,47,18,25,5,22,5,10,8,23,47
2009-11-02 00:00:00.000,Valencia Spain ATP World Tour 500,HARD,2,Leonardo Mayer,Igor Andreev,Leonardo Mayer,6-3; 6-3,R32,63,3,0,32,46,27,32,9,14,0,1,9,36,46,2,2,36,54,24,36,5,18,5,9,9,29,54
2009-11-02 00:00:00.000,Valencia Spain ATP World Tour 500,HARD,2,Albert Montanes,Roberto Bautista Agut,Albert Montanes,6-1; 3-6; 6-4,R32,115,4,3,43,80,28,43,22,37,3,6,13,50,80,0,1,49,84,32,49,16,35,4,9,13,48,84
2009-11-02 00:00:00.000,Valencia Spain ATP World Tour 500,HARD,2,David Ferrer,Nicolas Almagro,David Ferrer,7-5; 6-7(3); 6-2,R32,137,1,3,50,92,38,50,20,42,0,3,16,58,92,8,1,65,103,44,65,17,38,5,11,16,61,103
2009-11-02 00:00:00.000,Valencia Spain ATP World Tour 500,HARD,2,Fernando Verdasco,Oscar Hernandez,Fernando Verdasco,6-1; 0-1 RET,R32,30,2,0,10,19,10,10,6,9,0,0,4,16,19,0,1,13,20,9,13,2,7,0,2,4,11,20
2009-11-02 00:00:00.000,Valencia Spain ATP World Tour 500,HARD,2,Janko Tipsarevic,Victor Hanescu,Janko Tipsarevic,6-4; 6-3,R32,85,5,2,33,60,24,33,15,27,1,2,9,39,60,4,0,49,61,29,49,3,12,4,8,10,32,61
2009-11-02 00:00:00.000,Valencia Spain ATP World Tour 500,HARD,2,Feliciano Lopez,Alberto Martin,Feliciano Lopez,7-5; 6-3,R32,80,12,3,38,57,34,38,9,19,2,2,10,43,57,1,4,47,70,28,47,13,23,3,6,11,41,70
2009-11-02 00:00:00.000,Valencia Spain ATP World Tour 500,HARD,2,Tommy Robredo,Christophe Rochus,Tommy Robredo,6-0; 5-7; 6-3,R32,130,16,1,63,100,45,63,16,37,10,13,13,61,100,0,1,53,84,28,53,12,31,3,10,14,40,84
2009-11-02 00:00:00.000,Valencia Spain ATP World Tour 500,HARD,2,Gilles Simon,Igor Kunitsyn,Gilles Simon,6-3; 6-2,R32,54,4,0,35,50,30,35,9,15,3,3,9,39,50,0,1,23,44,15,23,10,21,0,3,8,25,44
2009-11-02 00:00:00.000,Valencia Spain ATP World Tour 500,HARD,2,Tomas Berdych,Paul-Henri Mathieu,Tomas Berdych,6-3; 6-4,R32,80,8,2,41,61,36,41,9,20,4,4,10,45,61,2,2,26,56,16,26,18,30,2,4,9,34,56
2009-11-02 00:00:00.000,Valencia Spain ATP World Tour 500,HARD,2,Pablo Cuevas,Juan Carlos Ferrero,Pablo Cuevas,2-6; 7-6(4); 6-3,R32,127,10,3,57,103,42,57,24,46,7,11,15,66,103,6,0,46,78,35,46,16,32,1,4,14,51,78
2009-11-02 00:00:00.000,Valencia Spain ATP World Tour 500,HARD,2,Mikhail Youzhny,Jo-Wilfried Tsonga,Mikhail Youzhny,6-7(3); 6-0; 3-0 RET,R32,89,5,2,31,60,25,31,19,29,2,3,10,44,60,10,3,46,82,30,46,13,36,3,9,11,43,82
2009-11-02 00:00:00.000,Valencia Spain ATP World Tour 500,HARD,2,Gael Monfils,Marcel Granollers,Gael Monfils,6-4; 6-2,R32,71,2,1,38,71,26,38,15,33,8,10,9,41,71,0,3,29,57,13,29,16,28,5,10,9,29,57
2009-11-02 00:00:00.000,Valencia Spain ATP World Tour 500,HARD,2,Guillermo Garcia-Lopez,Simon Greul,Guillermo Garcia-Lopez,7-5; 6-2,R32,86,4,4,41,60,28,41,10,19,7,9,10,38,60,1,0,40,59,22,40,8,19,1,6,10,30,59
2009-11-02 00:00:00.000,Valencia Spain ATP World Tour 500,HARD,2,Juan Monaco,Martin Vassallo Arguello,Juan Monaco,6-3; 6-2,R32,75,3,0,30,49,20,30,13,19,2,3,8,33,49,0,3,37,55,21,37,5,18,1,6,9,26,55
2009-11-02 00:00:00.000,Valencia Spain ATP World Tour 500,HARD,2,Nikolay Davydenko,Alejandro Falla,Nikolay Davydenko,6-2; 6-1,R32,62,5,0,26,37,21,26,7,11,0,1,8,28,37,0,3,25,50,13,25,9,25,7,12,7,22,50
2009-11-02 00:00:00.000,Valencia Spain ATP World Tour 500,HARD,2,Andy Murray,Leonardo Mayer,Andy Murray,6-4; 3-6; 6-3,R16,142,8,3,52,93,41,52,18,41,3,5,14,59,93,3,1,49,90,32,49,24,41,10,13,14,56,90
2009-11-02 00:00:00.000,Valencia Spain ATP World Tour 500,HARD,2,Albert Montanes,David Ferrer,Albert Montanes,W/O,R16,0,0,0,0,0,0,0,0,0,0,0,0,0,0,0,0,0,0,0,0,0,0,0,0,0,0,0
2009-11-02 00:00:00.000,Valencia Spain ATP World Tour 500,HARD,2,Fernando Verdasco,Janko Tipsarevic,Fernando Verdasco,6-3; 6-3,R16,83,7,2,40,61,31,40,9,21,5,6,9,40,61,2,1,29,54,18,29,13,25,2,6,9,31,54
2009-11-02 00:00:00.000,Valencia Spain ATP World Tour 500,HARD,2,Tommy Robredo,Feliciano Lopez,Tommy Robredo,4-6; 6-3; 6-4,R16,102,7,1,48,80,37,48,21,32,4,6,15,58,80,16,4,51,72,39,51,11,21,3,6,14,50,72
2009-11-02 00:00:00.000,Valencia Spain ATP World Tour 500,HARD,2,Gilles Simon,Tomas Berdych,Gilles Simon,6-4; 4-6; 6-3,R16,139,11,1,67,114,49,67,23,47,11,13,15,72,114,5,2,50,84,39,50,15,34,6,9,14,54,84
2009-11-02 00:00:00.000,Valencia Spain ATP World Tour 500,HARD,2,Mikhail Youzhny,Pablo Cuevas,Mikhail Youzhny,6-2; 2-6; 6-1,R16,95,1,2,39,64,33,39,12,25,2,4,12,45,64,3,1,43,67,25,43,12,24,4,8,11,37,67
2009-11-02 00:00:00.000,Valencia Spain ATP World Tour 500,HARD,2,Guillermo Garcia-Lopez,Gael Monfils,Guillermo Garcia-Lopez,6-2; 7-5,R16,97,1,4,39,62,31,39,12,23,1,1,10,43,62,1,4,50,75,28,50,14,25,5,8,10,42,75
2009-11-02 00:00:00.000,Valencia Spain ATP World Tour 500,HARD,2,Nikolay Davydenko,Juan Monaco,Nikolay Davydenko,6-3; 7-5,R16,102,0,4,39,68,27,39,15,29,3,5,11,42,68,2,0,49,65,30,49,6,16,5,9,10,36,65
2009-11-02 00:00:00.000,Valencia Spain ATP World Tour 500,HARD,2,Andy Murray,Albert Montanes,Andy Murray,6-4; 6-2,Q,74,3,1,31,52,24,31,11,21,1,2,9,35,52,1,2,35,59,20,35,12,24,6,10,9,32,59
2009-11-02 00:00:00.000,Valencia Spain ATP World Tour 500,HARD,2,Fernando Verdasco,Tommy Robredo,Fernando Verdasco,6-3; 6-2,Q,76,5,1,35,55,25,35,14,20,2,2,9,39,55,0,3,34,56,24,34,8,22,4,7,8,32,56
2009-11-02 00:00:00.000,Valencia Spain ATP World Tour 500,HARD,2,Mikhail Youzhny,Gilles Simon,Mikhail Youzhny,6-4; 6-4,Q,97,4,0,55,77,36,55,15,22,11,11,10,51,77,5,2,32,54,25,32,11,22,2,4,10,36,54
2009-11-02 00:00:00.000,Valencia Spain ATP World Tour 500,HARD,2,Nikolay Davydenko,Guillermo Garcia-Lopez,Nikolay Davydenko,6-4; 7-6(3),Q,117,9,2,30,62,25,30,20,32,2,4,11,45,62,1,5,46,76,30,46,14,30,3,6,11,44,76
2009-11-02 00:00:00.000,Valencia Spain ATP World Tour 500,HARD,2,Andy Murray,Fernando Verdasco,Andy Murray,6-3; 2-6; 6-3,S,122,5,4,42,87,29,42,26,45,6,8,13,55,87,5,3,40,74,30,40,16,34,5,8,13,46,74
2009-11-02 00:00:00.000,Valencia Spain ATP World Tour 500,HARD,2,Mikhail Youzhny,Nikolay Davydenko,Mikhail Youzhny,3-6; 6-4; 6-3,S,144,2,0,56,87,37,56,13,31,6,10,14,50,87,2,2,57,97,35,57,20,40,8,13,14,55,97
2009-11-02 00:00:00.000,Valencia Spain ATP World Tour 500,HARD,2,Andy Murray,Mikhail Youzhny,Andy Murray,6-3; 6-2,F,68,8,1,29,49,26,29,9,20,2,3,9,35,49,0,0,30,43,19,30,3,13,1,5,8,22,43
2009-11-08 00:00:00.000,ATP World Tour Masters 1000 Paris France ATP World Tour Masters 1000,HARD,2,Roger Federer,N/A Bye,Roger Federer,,R64,0,0,0,0,0,0,0,0,0,0,0,0,0,0,0,0,0,0,0,0,0,0,0,0,0,0,0
2009-11-08 00:00:00.000,ATP World Tour Masters 1000 Paris France ATP World Tour Masters 1000,HARD,2,Julien Benneteau,Philipp Petzschner,Julien Benneteau,4-6; 7-5; 6-3,R64,122,10,1,65,90,48,65,16,25,0,2,16,64,90,12,5,58,98,43,58,16,40,4,7,15,59,98
2009-11-08 00:00:00.000,ATP World Tour Masters 1000 Paris France ATP World Tour Masters 1000,HARD,2,David Guez,Stanislas Wawrinka,David Guez,6-3; 6-4,R64,102,0,0,34,64,19,34,20,30,3,5,10,39,64,4,1,36,69,20,36,16,33,3,7,9,36,69
2009-11-08 00:00:00.000,ATP World Tour Masters 1000 Paris France ATP World Tour Masters 1000,HARD,2,Gael Monfils,N/A Bye,Gael Monfils,,R64,0,0,0,0,0,0,0,0,0,0,0,0,0,0,0,0,0,0,0,0,0,0,0,0,0,0,0
2009-11-08 00:00:00.000,ATP World Tour Masters 1000 Paris France ATP World Tour Masters 1000,HARD,2,Marin Cilic,N/A Bye,Marin Cilic,,R64,0,0,0,0,0,0,0,0,0,0,0,0,0,0,0,0,0,0,0,0,0,0,0,0,0,0,0
2009-11-08 00:00:00.000,ATP World Tour Masters 1000 Paris France ATP World Tour Masters 1000,HARD,2,Lukasz Kubot,Andreas Beck,Lukasz Kubot,6-4; 3-6; 6-4,R64,124,14,1,46,72,38,46,16,26,0,1,14,54,72,8,2,60,97,45,60,19,37,7,9,15,64,97
2009-11-08 00:00:00.000,ATP World Tour Masters 1000 Paris France ATP World Tour Masters 1000,HARD,2,Andreas Seppi,Philipp Kohlschreiber,Andreas Seppi,6-3; 6-3,R64,57,7,1,33,50,26,33,11,17,2,3,9,37,50,6,3,33,51,21,33,7,18,3,7,9,28,51
2009-11-08 00:00:00.000,ATP World Tour Masters 1000 Paris France ATP World Tour Masters 1000,HARD,2,Fernando Verdasco,N/A Bye,Fernando Verdasco,,R64,0,0,0,0,0,0,0,0,0,0,0,0,0,0,0,0,0,0,0,0,0,0,0,0,0,0,0
2009-11-08 00:00:00.000,ATP World Tour Masters 1000 Paris France ATP World Tour Masters 1000,HARD,2,Andy Murray,N/A Bye,Andy Murray,,R64,0,0,0,0,0,0,0,0,0,0,0,0,0,0,0,0,0,0,0,0,0,0,0,0,0,0,0
2009-11-08 00:00:00.000,ATP World Tour Masters 1000 Paris France ATP World Tour Masters 1000,HARD,2,James Blake,Fabrice Santoro,James Blake,6-4; 6-3,R64,75,3,1,38,63,25,38,14,25,4,6,10,39,63,0,1,34,55,20,34,7,21,2,6,9,27,55
2009-11-08 00:00:00.000,ATP World Tour Masters 1000 Paris France ATP World Tour Masters 1000,HARD,2,Viktor Troicki,Paul-Henri Mathieu,Viktor Troicki,7-6(4); 3-0 RET,R64,69,16,1,48,65,36,48,8,17,3,3,8,44,65,5,1,29,48,19,29,13,19,1,2,7,32,48
2009-11-08 00:00:00.000,ATP World Tour Masters 1000 Paris France ATP World Tour Masters 1000,HARD,2,Radek Stepanek,N/A Bye,Radek Stepanek,,R64,0,0,0,0,0,0,0,0,0,0,0,0,0,0,0,0,0,0,0,0,0,0,0,0,0,0,0
2009-11-08 00:00:00.000,ATP World Tour Masters 1000 Paris France ATP World Tour Masters 1000,HARD,2,Fernando Gonzalez,N/A Bye,Fernando Gonzalez,,R64,0,0,0,0,0,0,0,0,0,0,0,0,0,0,0,0,0,0,0,0,0,0,0,0,0,0,0
2009-11-08 00:00:00.000,ATP World Tour Masters 1000 Paris France ATP World Tour Masters 1000,HARD,2,John Isner,Alejandro Falla,John Isner,4-6; 7-6(10); 7-5,R64,138,17,2,81,109,62,81,18,28,5,6,17,80,109,12,3,74,107,61,74,18,33,4,5,17,79,107
2009-11-08 00:00:00.000,ATP World Tour Masters 1000 Paris France ATP World Tour Masters 1000,HARD,2,Marat Safin,Thierry Ascione,Marat Safin,6-4; 4-6; 7-6(3),R64,112,24,0,65,104,49,65,22,39,10,12,16,71,104,13,2,54,87,42,54,20,33,2,4,16,62,87
2009-11-08 00:00:00.000,ATP World Tour Masters 1000 Paris France ATP World Tour Masters 1000,HARD,2,Juan Martin Del Potro,N/A Bye,Juan Martin Del Potro,,R64,0,0,0,0,0,0,0,0,0,0,0,0,0,0,0,0,0,0,0,0,0,0,0,0,0,0,0
2009-11-08 00:00:00.000,ATP World Tour Masters 1000 Paris France ATP World Tour Masters 1000,HARD,2,Nikolay Davydenko,N/A Bye,Nikolay Davydenko,,R64,0,0,0,0,0,0,0,0,0,0,0,0,0,0,0,0,0,0,0,0,0,0,0,0,0,0,0
2009-11-08 00:00:00.000,ATP World Tour Masters 1000 Paris France ATP World Tour Masters 1000,HARD,2,Benjamin Becker,Michael Llodra,Benjamin Becker,3-6; 6-2; 6-3,R64,101,9,3,49,82,39,49,17,33,3,4,13,56,82,9,5,49,79,35,49,15,30,0,3,13,50,79
2009-11-08 00:00:00.000,ATP World Tour Masters 1000 Paris France ATP World Tour Masters 1000,HARD,2,Ivo Karlovic,Pablo Cuevas,Ivo Karlovic,7-6(3); 6-4,R64,76,21,1,43,55,40,43,9,12,0,0,11,49,55,6,1,46,76,35,46,17,30,4,5,11,52,76
2009-11-08 00:00:00.000,ATP World Tour Masters 1000 Paris France ATP World Tour Masters 1000,HARD,2,Robin Soderling,N/A Bye,Robin Soderling,,R64,0,0,0,0,0,0,0,0,0,0,0,0,0,0,0,0,0,0,0,0,0,0,0,0,0,0,0
2009-11-08 00:00:00.000,ATP World Tour Masters 1000 Paris France ATP World Tour Masters 1000,HARD,2,Tommy Haas,N/A Bye,Tommy Haas,,R64,0,0,0,0,0,0,0,0,0,0,0,0,0,0,0,0,0,0,0,0,0,0,0,0,0,0,0
2009-11-08 00:00:00.000,ATP World Tour Masters 1000 Paris France ATP World Tour Masters 1000,HARD,2,Arnaud Clement,Feliciano Lopez,Arnaud Clement,6-3; 6-1,R64,51,6,0,28,38,25,28,7,10,0,0,8,32,38,5,2,27,40,15,27,4,13,1,5,8,19,40
2009-11-08 00:00:00.000,ATP World Tour Masters 1000 Paris France ATP World Tour Masters 1000,HARD,2,Juan Monaco,Jeremy Chardy,Juan Monaco,7-6(6); 7-5,R64,117,5,1,48,70,36,48,12,22,0,2,12,48,70,9,5,61,109,45,61,17,48,7,10,12,62,109
2009-11-08 00:00:00.000,ATP World Tour Masters 1000 Paris France ATP World Tour Masters 1000,HARD,2,Novak Djokovic,N/A Bye,Novak Djokovic,,R64,0,0,0,0,0,0,0,0,0,0,0,0,0,0,0,0,0,0,0,0,0,0,0,0,0,0,0
2009-11-08 00:00:00.000,ATP World Tour Masters 1000 Paris France ATP World Tour Masters 1000,HARD,2,Jo-Wilfried Tsonga,N/A Bye,Jo-Wilfried Tsonga,,R64,0,0,0,0,0,0,0,0,0,0,0,0,0,0,0,0,0,0,0,0,0,0,0,0,0,0,0
2009-11-08 00:00:00.000,ATP World Tour Masters 1000 Paris France ATP World Tour Masters 1000,HARD,2,Albert Montanes,Victor Hanescu,Albert Montanes,3-6; 6-3; 7-6(3),R64,128,4,0,68,109,51,68,21,41,3,4,15,72,109,13,3,59,95,49,59,15,36,1,2,15,64,95
2009-11-08 00:00:00.000,ATP World Tour Masters 1000 Paris France ATP World Tour Masters 1000,HARD,2,Ivan Ljubicic,Sebastien Grosjean,Ivan Ljubicic,7-6(2); 6-4,R64,94,7,2,44,69,36,44,11,25,1,2,11,47,69,4,3,33,69,23,33,20,36,3,5,11,43,69
2009-11-08 00:00:00.000,ATP World Tour Masters 1000 Paris France ATP World Tour Masters 1000,HARD,2,Gilles Simon,N/A Bye,Gilles Simon,,R64,0,0,0,0,0,0,0,0,0,0,0,0,0,0,0,0,0,0,0,0,0,0,0,0,0,0,0
2009-11-08 00:00:00.000,ATP World Tour Masters 1000 Paris France ATP World Tour Masters 1000,HARD,2,Tommy Robredo,N/A Bye,Tommy Robredo,,R64,0,0,0,0,0,0,0,0,0,0,0,0,0,0,0,0,0,0,0,0,0,0,0,0,0,0,0
2009-11-08 00:00:00.000,ATP World Tour Masters 1000 Paris France ATP World Tour Masters 1000,HARD,2,Tomas Berdych,Vincent Millot,Tomas Berdych,6-3; 7-6(4),R64,86,10,3,35,67,27,35,21,32,1,3,11,48,67,5,3,33,63,24,33,15,30,1,4,10,39,63
2009-11-08 00:00:00.000,ATP World Tour Masters 1000 Paris France ATP World Tour Masters 1000,HARD,2,Nicolas Almagro,Marco Chiudinelli,Nicolas Almagro,6-2; 6-4,R64,88,12,2,36,67,30,36,13,31,5,6,9,43,67,3,1,37,60,23,37,7,23,5,9,9,30,60
2009-11-08 00:00:00.000,ATP World Tour Masters 1000 Paris France ATP World Tour Masters 1000,HARD,2,Rafael Nadal,N/A Bye,Rafael Nadal,,R64,0,0,0,0,0,0,0,0,0,0,0,0,0,0,0,0,0,0,0,0,0,0,0,0,0,0,0
2009-11-08 00:00:00.000,ATP World Tour Masters 1000 Paris France ATP World Tour Masters 1000,HARD,2,Julien Benneteau,Roger Federer,Julien Benneteau,3-6; 7-6(4); 6-4,R32,115,7,2,72,91,57,72,11,19,6,7,15,68,91,14,0,70,96,57,70,13,26,6,7,16,70,96
2009-11-08 00:00:00.000,ATP World Tour Masters 1000 Paris France ATP World Tour Masters 1000,HARD,2,Gael Monfils,David Guez,Gael Monfils,6-4; 7-5,R32,93,11,3,45,68,38,45,9,23,3,4,11,47,68,1,5,39,72,26,39,17,33,8,11,11,43,72
2009-11-08 00:00:00.000,ATP World Tour Masters 1000 Paris France ATP World Tour Masters 1000,HARD,2,Marin Cilic,Lukasz Kubot,Marin Cilic,6-7(3); 6-4; 6-2,R32,150,16,2,61,98,46,61,23,37,9,9,15,69,98,9,5,76,109,57,76,14,33,10,13,15,71,109
2009-11-08 00:00:00.000,ATP World Tour Masters 1000 Paris France ATP World Tour Masters 1000,HARD,2,Fernando Verdasco,Andreas Seppi,Fernando Verdasco,6-7(3); 6-4; 6-4,R32,128,9,2,50,88,40,50,21,38,0,3,16,61,88,5,3,62,102,44,62,19,40,5,10,16,63,102
2009-11-08 00:00:00.000,ATP World Tour Masters 1000 Paris France ATP World Tour Masters 1000,HARD,2,Andy Murray,James Blake,Andy Murray,6-3; 6-7(5); 7-6(4),R32,134,21,3,67,106,56,67,19,39,2,3,17,75,106,4,5,69,116,45,69,28,47,4,6,16,73,116
2009-11-08 00:00:00.000,ATP World Tour Masters 1000 Paris France ATP World Tour Masters 1000,HARD,2,Radek Stepanek,Viktor Troicki,Radek Stepanek,6-4; 6-0,R32,75,5,0,26,46,21,26,11,20,0,1,8,32,46,3,1,35,60,19,35,8,25,5,10,8,27,60
2009-11-08 00:00:00.000,ATP World Tour Masters 1000 Paris France ATP World Tour Masters 1000,HARD,2,Fernando Gonzalez,John Isner,Fernando Gonzalez,7-5; 7-6(3),R32,90,13,3,48,72,42,48,13,24,3,3,12,55,72,13,1,60,84,43,60,12,24,7,8,12,55,84
2009-11-08 00:00:00.000,ATP World Tour Masters 1000 Paris France ATP World Tour Masters 1000,HARD,2,Juan Martin Del Potro,Marat Safin,Juan Martin Del Potro,6-4; 5-7; 6-4,R32,116,11,1,50,81,40,50,22,31,2,3,16,62,81,15,1,57,102,42,57,25,45,7,9,16,67,102
2009-11-08 00:00:00.000,ATP World Tour Masters 1000 Paris France ATP World Tour Masters 1000,HARD,2,Nikolay Davydenko,Benjamin Becker,Nikolay Davydenko,6-2; 6-1,R32,78,5,2,33,48,26,33,8,15,4,4,7,34,48,4,0,40,68,24,40,6,28,8,13,8,30,68
2009-11-08 00:00:00.000,ATP World Tour Masters 1000 Paris France ATP World Tour Masters 1000,HARD,2,Robin Soderling,Ivo Karlovic,Robin Soderling,6-4; 7-6(6),R32,85,12,1,53,82,45,53,14,29,8,8,11,59,82,14,2,47,63,37,47,10,16,0,1,11,47,63
2009-11-08 00:00:00.000,ATP World Tour Masters 1000 Paris France ATP World Tour Masters 1000,HARD,2,Arnaud Clement,Tommy Haas,Arnaud Clement,5-7; 6-3; 7-6(8),R32,168,6,3,61,112,46,61,29,51,8,12,17,75,112,16,11,74,121,52,74,21,47,12,16,16,73,121
2009-11-08 00:00:00.000,ATP World Tour Masters 1000 Paris France ATP World Tour Masters 1000,HARD,2,Novak Djokovic,Juan Monaco,Novak Djokovic,6-3; 7-5,R32,92,4,5,40,63,25,40,13,23,5,8,11,38,63,2,1,39,60,22,39,9,21,7,12,10,31,60
2009-11-08 00:00:00.000,ATP World Tour Masters 1000 Paris France ATP World Tour Masters 1000,HARD,2,Jo-Wilfried Tsonga,Albert Montanes,Jo-Wilfried Tsonga,6-1; 7-5,R32,63,12,2,30,48,28,30,12,18,0,0,10,40,48,1,2,33,53,23,33,8,20,0,3,9,31,53
2009-11-08 00:00:00.000,ATP World Tour Masters 1000 Paris France ATP World Tour Masters 1000,HARD,2,Gilles Simon,Ivan Ljubicic,Gilles Simon,6-3; 3-6; 7-6(4),R32,127,12,5,49,91,43,49,23,42,2,3,15,66,91,18,0,71,101,56,71,14,30,6,7,15,70,101
2009-11-08 00:00:00.000,ATP World Tour Masters 1000 Paris France ATP World Tour Masters 1000,HARD,2,Tommy Robredo,Tomas Berdych,Tommy Robredo,6-4; 6-4,R32,78,4,3,45,69,34,45,13,24,5,5,10,47,69,4,1,31,51,24,31,11,20,1,3,10,35,51
2009-11-08 00:00:00.000,ATP World Tour Masters 1000 Paris France ATP World Tour Masters 1000,HARD,2,Rafael Nadal,Nicolas Almagro,Rafael Nadal,3-6; 7-6(2); 7-5,R32,194,9,4,65,110,40,65,24,45,6,12,16,64,110,12,1,79,124,50,79,19,45,8,14,17,69,124
2009-11-08 00:00:00.000,ATP World Tour Masters 1000 Paris France ATP World Tour Masters 1000,HARD,2,Gael Monfils,Julien Benneteau,Gael Monfils,6-4; 6-3,R16,83,16,0,49,72,38,49,11,23,6,6,10,49,72,2,0,43,52,30,43,4,9,2,4,9,34,52
2009-11-08 00:00:00.000,ATP World Tour Masters 1000 Paris France ATP World Tour Masters 1000,HARD,2,Marin Cilic,Fernando Verdasco,Marin Cilic,3-6; 6-3; 6-4,R16,116,3,0,52,80,38,52,17,28,1,2,14,55,80,9,5,56,89,45,56,13,33,5,7,14,58,89
2009-11-08 00:00:00.000,ATP World Tour Masters 1000 Paris France ATP World Tour Masters 1000,HARD,2,Radek Stepanek,Andy Murray,Radek Stepanek,1-6; 6-3; 6-4,R16,97,5,2,41,68,33,41,11,27,2,5,13,44,68,11,3,41,80,35,41,16,39,3,6,13,51,80
2009-11-08 00:00:00.000,ATP World Tour Masters 1000 Paris France ATP World Tour Masters 1000,HARD,2,Juan Martin Del Potro,Fernando Gonzalez,Juan Martin Del Potro,6-7(6); 7-6(6) RET,R16,144,8,1,79,118,54,79,18,39,15,16,12,72,118,13,3,55,97,44,55,18,42,5,6,12,62,97
2009-11-08 00:00:00.000,ATP World Tour Masters 1000 Paris France ATP World Tour Masters 1000,HARD,2,Robin Soderling,Nikolay Davydenko,Robin Soderling,6-3; 3-6; 6-4,R16,122,9,1,56,87,43,56,15,31,2,3,14,58,87,11,1,54,87,41,54,16,33,8,10,14,57,87
2009-11-08 00:00:00.000,ATP World Tour Masters 1000 Paris France ATP World Tour Masters 1000,HARD,2,Novak Djokovic,Arnaud Clement,Novak Djokovic,6-2; 6-2,R16,76,8,3,30,45,24,30,7,15,2,3,8,31,45,2,2,30,57,18,30,7,27,4,9,8,25,57
2009-11-08 00:00:00.000,ATP World Tour Masters 1000 Paris France ATP World Tour Masters 1000,HARD,2,Jo-Wilfried Tsonga,Gilles Simon,Jo-Wilfried Tsonga,6-2; 6-3,R16,53,13,0,27,40,24,27,12,13,0,0,9,36,40,3,1,37,57,22,37,9,20,8,11,8,31,57
2009-11-08 00:00:00.000,ATP World Tour Masters 1000 Paris France ATP World Tour Masters 1000,HARD,2,Rafael Nadal,Tommy Robredo,Rafael Nadal,6-3; 3-6; 7-5,R16,141,5,2,64,89,45,64,16,25,4,6,15,61,89,7,0,49,83,36,49,20,34,4,7,15,56,83
2009-11-08 00:00:00.000,ATP World Tour Masters 1000 Paris France ATP World Tour Masters 1000,HARD,2,Gael Monfils,Marin Cilic,Gael Monfils,3-6; 6-4; 6-4,Q,142,13,0,61,92,48,61,14,31,4,6,15,62,92,7,4,50,89,40,50,21,39,3,5,14,61,89
2009-11-08 00:00:00.000,ATP World Tour Masters 1000 Paris France ATP World Tour Masters 1000,HARD,2,Radek Stepanek,Juan Martin Del Potro,Radek Stepanek,4-0 RET,Q,28,1,0,14,24,10,14,4,10,3,3,2,14,24,0,0,13,15,5,13,0,2,0,2,2,5,15
2009-11-08 00:00:00.000,ATP World Tour Masters 1000 Paris France ATP World Tour Masters 1000,HARD,2,Novak Djokovic,Robin Soderling,Novak Djokovic,6-4; 1-6; 6-3,Q,117,3,4,57,87,39,57,15,30,11,14,13,54,87,7,3,35,69,28,35,17,34,3,6,13,45,69
2009-11-08 00:00:00.000,ATP World Tour Masters 1000 Paris France ATP World Tour Masters 1000,HARD,2,Rafael Nadal,Jo-Wilfried Tsonga,Rafael Nadal,7-5; 7-5,Q,112,7,0,54,74,39,54,15,20,6,6,12,54,74,10,5,50,78,39,50,10,28,4,6,12,49,78
2009-11-08 00:00:00.000,ATP World Tour Masters 1000 Paris France ATP World Tour Masters 1000,HARD,2,Gael Monfils,Radek Stepanek,Gael Monfils,6-4; 5-7; 6-4,S,162,11,0,60,96,40,60,15,36,0,5,16,55,96,4,4,62,104,43,62,16,42,5,11,16,59,104
2009-11-08 00:00:00.000,ATP World Tour Masters 1000 Paris France ATP World Tour Masters 1000,HARD,2,Novak Djokovic,Rafael Nadal,Novak Djokovic,6-2; 6-3,S,77,4,4,29,50,24,29,13,21,0,0,9,37,50,4,2,25,38,14,25,6,13,0,3,8,20,38
2009-11-08 00:00:00.000,ATP World Tour Masters 1000 Paris France ATP World Tour Masters 1000,HARD,2,Novak Djokovic,Gael Monfils,Novak Djokovic,6-2; 5-7; 7-6(3),F,164,2,5,66,98,47,66,19,32,3,7,16,66,98,12,6,65,106,48,65,15,41,5,10,16,63,106
