event_time,event_name,surface,num_of_sets,playerA,playerB,winner,score,round,duration_minutes,a_aces,a_double_faults,a_first_serve_hits,a_first_serve_total,a_first_serve_won,a_first_serve_played,a_second_serve_won,a_second_serve_played,a_break_points_saved,a_break_points_total,a_service_games,a_service_points_won,a_service_points_total,b_aces,b_double_faults,b_first_serve_hits,b_first_serve_total,b_first_serve_won,b_first_serve_played,b_second_serve_won,b_second_serve_played,b_break_points_saved,b_break_points_total,b_service_games,b_service_points_won,b_service_points_total
2007-01-01 00:00:00.000,Chennai India ATP World Tour,HARD,2,Rafael Nadal,Rainer Schuettler,Rafael Nadal,6-4; 6-2,R32,87,5,2,23,50,18,23,18,27,2,3,9,36,50,2,2,33,63,24,33,10,30,6,10,9,34,63
2007-01-01 00:00:00.000,Chennai India ATP World Tour,HARD,2,Karan Rastogi,Thiago Alves,Karan Rastogi,6-3; 6-4,R32,79,0,4,49,64,31,49,6,15,6,9,10,37,64,0,1,45,53,23,45,3,8,2,7,9,26,53
2007-01-01 00:00:00.000,Chennai India ATP World Tour,HARD,2,Davide Sanguinetti,Konstantinos Economidis,Davide Sanguinetti,6-4; 6-3,R32,73,6,1,36,64,29,36,14,28,4,4,9,43,64,6,3,34,65,20,34,17,31,3,6,10,37,65
2007-01-01 00:00:00.000,Chennai India ATP World Tour,HARD,2,Nicolas Mahut,Alejandro Falla,Nicolas Mahut,7-5; 6-4,R32,105,4,5,34,75,28,34,21,41,7,8,11,49,75,4,2,40,72,26,40,17,32,8,11,11,43,72
2007-01-01 00:00:00.000,Chennai India ATP World Tour,HARD,2,Xavier Malisse,Danai Udomchoke,Xavier Malisse,6-2; 6-2,R32,62,5,1,20,41,15,20,15,21,2,3,8,30,41,2,4,22,45,11,22,9,23,6,11,8,20,45
2007-01-01 00:00:00.000,Chennai India ATP World Tour,HARD,2,Stefano Galvani,Yen-Hsun Lu,Stefano Galvani,6-2; 6-3,R32,86,2,5,37,58,23,37,11,21,4,5,8,34,58,4,4,47,65,25,47,5,18,6,11,9,30,65
2007-01-01 00:00:00.000,Chennai India ATP World Tour,HARD,2,Bjorn Phau,Olivier Patience,Bjorn Phau,6-4; 6-4,R32,90,2,2,37,63,25,37,15,26,2,4,10,40,63,2,3,62,90,37,62,10,28,9,13,10,47,90
2007-01-01 00:00:00.000,Chennai India ATP World Tour,HARD,2,Fabrice Santoro,David Skoch,Fabrice Santoro,3-0 RET,R32,13,1,0,5,10,4,5,4,5,0,0,2,8,10,0,1,3,9,0,3,3,6,2,3,1,3,9
2007-01-01 00:00:00.000,Chennai India ATP World Tour,HARD,2,Paradorn Srichaphan,Simone Bolelli,Paradorn Srichaphan,7-6(5); 6-4,R32,77,9,4,38,62,35,38,13,24,0,1,11,48,62,2,1,36,67,25,36,17,31,0,2,11,42,67
2007-01-01 00:00:00.000,Chennai India ATP World Tour,HARD,2,Stefan Koubek,Bartolome Salva-Vidal,Stefan Koubek,2-6; 6-3; 7-5,R32,109,3,2,47,78,27,47,18,31,4,9,14,45,78,3,6,39,79,25,39,16,40,2,8,15,41,79
2007-01-01 00:00:00.000,Chennai India ATP World Tour,HARD,2,Igor Andreev,Santiago Giraldo,Igor Andreev,6-3; 7-6(2),R32,90,7,2,40,64,31,40,15,24,1,3,11,46,64,1,2,38,67,24,38,14,29,4,7,10,38,67
2007-01-01 00:00:00.000,Chennai India ATP World Tour,HARD,2,Julien Benneteau,Teymuraz Gabashvili,Julien Benneteau,6-3; 6-4,R32,66,3,0,34,51,28,34,13,17,2,2,10,41,51,3,5,40,66,30,40,9,26,7,9,9,39,66
2007-01-01 00:00:00.000,Chennai India ATP World Tour,HARD,2,Carlos Moya,Alexander Waske,Carlos Moya,7-6(3); 6-3,R32,80,11,0,40,61,32,40,14,21,0,1,11,46,61,4,5,37,66,29,37,12,29,2,4,10,41,66
2007-01-01 00:00:00.000,Chennai India ATP World Tour,HARD,2,Kevin Kim,Simon Greul,Kevin Kim,1-6; 6-2; 6-3,R32,80,5,3,47,77,34,47,12,30,3,7,12,46,77,3,3,34,68,25,34,13,34,4,9,12,38,68
2007-01-01 00:00:00.000,Chennai India ATP World Tour,HARD,2,Ivo Karlovic,Prakash Amritraj,Ivo Karlovic,7-6(3); 6-3,R32,82,14,2,46,67,37,46,14,21,2,2,11,51,67,2,3,36,60,30,36,11,24,3,4,10,41,60
2007-01-01 00:00:00.000,Chennai India ATP World Tour,HARD,2,Kristian Pless,David Nalbandian,Kristian Pless,2-6; 6-3; 7-5,R32,143,13,2,67,117,40,67,32,50,16,19,15,72,117,4,7,72,122,51,72,19,50,11,14,14,70,122
2007-01-01 00:00:00.000,Chennai India ATP World Tour,HARD,2,Rafael Nadal,Karan Rastogi,Rafael Nadal,6-4; 6-1,R16,84,5,1,26,46,19,26,15,20,0,0,8,34,46,0,1,35,61,17,35,15,26,3,7,9,32,61
2007-01-01 00:00:00.000,Chennai India ATP World Tour,HARD,2,Davide Sanguinetti,Nicolas Mahut,Davide Sanguinetti,7-6(6); 3-6; 6-3,R16,139,12,2,70,92,52,70,11,22,1,3,15,63,92,12,7,67,103,48,67,19,36,8,10,15,67,103
2007-01-01 00:00:00.000,Chennai India ATP World Tour,HARD,2,Xavier Malisse,Stefano Galvani,Xavier Malisse,6-3; 6-2,R16,89,6,2,36,61,25,36,15,25,4,5,9,40,61,0,5,31,68,18,31,16,37,8,12,8,34,68
2007-01-01 00:00:00.000,Chennai India ATP World Tour,HARD,2,Fabrice Santoro,Bjorn Phau,Fabrice Santoro,6-4; 6-2,R16,78,2,0,39,60,27,39,12,21,4,5,9,39,60,0,5,33,63,21,33,12,30,4,8,9,33,63
2007-01-01 00:00:00.000,Chennai India ATP World Tour,HARD,2,Stefan Koubek,Paradorn Srichaphan,Stefan Koubek,6-1; 6-2,R16,48,3,1,26,41,23,26,10,15,0,0,8,33,41,1,2,28,44,14,28,6,16,1,5,7,20,44
2007-01-01 00:00:00.000,Chennai India ATP World Tour,HARD,2,Julien Benneteau,Igor Andreev,Julien Benneteau,7-6(4); 6-2,R16,88,3,2,40,61,30,40,14,21,3,4,10,44,61,3,0,34,60,21,34,17,26,3,6,10,38,60
2007-01-01 00:00:00.000,Chennai India ATP World Tour,HARD,2,Carlos Moya,Kevin Kim,Carlos Moya,6-4; 6-3,R16,81,8,2,45,85,32,45,20,40,7,8,10,52,85,4,3,34,52,24,34,6,18,1,4,9,30,52
2007-01-01 00:00:00.000,Chennai India ATP World Tour,HARD,2,Ivo Karlovic,Kristian Pless,Ivo Karlovic,7-6(3); 7-6(2),R16,86,26,2,56,79,48,56,12,23,1,2,12,60,79,6,2,47,68,36,47,14,21,0,1,12,50,68
2007-01-01 00:00:00.000,Chennai India ATP World Tour,HARD,2,Rafael Nadal,Davide Sanguinetti,Rafael Nadal,6-3; 6-2,Q,60,7,3,21,42,20,21,16,21,0,0,9,36,42,2,0,28,49,17,28,9,21,7,10,8,26,49
2007-01-01 00:00:00.000,Chennai India ATP World Tour,HARD,2,Xavier Malisse,Fabrice Santoro,Xavier Malisse,6-4; 4-6; 6-0,Q,100,8,1,43,67,32,43,13,24,1,4,13,45,67,6,2,50,84,31,50,12,34,4,10,13,43,84
2007-01-01 00:00:00.000,Chennai India ATP World Tour,HARD,2,Stefan Koubek,Julien Benneteau,Stefan Koubek,6-1; 6-2,Q,61,1,0,25,48,19,25,14,23,0,0,8,33,48,0,3,27,45,15,27,8,18,6,10,7,23,45
2007-01-01 00:00:00.000,Chennai India ATP World Tour,HARD,2,Carlos Moya,Ivo Karlovic,Carlos Moya,6-4; 7-6(6),Q,77,2,1,49,62,42,49,8,13,0,0,11,50,62,21,1,46,67,39,46,9,21,3,4,11,48,67
2007-01-01 00:00:00.000,Chennai India ATP World Tour,HARD,2,Xavier Malisse,Rafael Nadal,Xavier Malisse,6-4; 7-6(4),S,127,7,1,62,91,41,62,19,29,7,7,11,60,91,2,0,43,67,33,43,14,24,4,5,11,47,67
2007-01-01 00:00:00.000,Chennai India ATP World Tour,HARD,2,Stefan Koubek,Carlos Moya,Stefan Koubek,6-3; 6-1,S,63,5,1,28,49,23,28,13,21,2,2,8,36,49,5,4,36,59,20,36,9,23,7,11,8,29,59
2007-01-01 00:00:00.000,Chennai India ATP World Tour,HARD,2,Xavier Malisse,Stefan Koubek,Xavier Malisse,6-1; 6-3,F,61,6,0,31,47,23,31,10,16,2,3,8,33,47,0,2,26,47,15,26,6,21,2,7,8,21,47
2007-01-01 00:00:00.000,Doha Qatar ATP World Tour,HARD,2,Nikolay Davydenko,Hyung-Taik Lee,Nikolay Davydenko,7-5; 6-4,R32,83,2,3,41,61,37,41,9,20,0,0,11,46,61,1,0,47,67,33,47,11,20,3,5,11,44,67
2007-01-01 00:00:00.000,Doha Qatar ATP World Tour,HARD,2,Jonas Bjorkman,Nicolas Almagro,Jonas Bjorkman,7-5; 7-5,R32,114,3,2,63,90,39,63,17,27,5,6,12,56,90,9,1,53,84,35,53,15,31,5,8,12,50,84
2007-01-01 00:00:00.000,Doha Qatar ATP World Tour,HARD,2,Federico Luzzi,Jurgen Melzer,Federico Luzzi,5-7; 6-4; 7-5,R32,152,8,7,72,127,59,72,21,55,11,13,17,80,127,9,2,73,110,49,73,21,37,4,7,17,70,110
2007-01-01 00:00:00.000,Doha Qatar ATP World Tour,HARD,2,Olivier Rochus,Sebastien Grosjean,Olivier Rochus,6-4; 6-4,R32,97,1,2,33,55,24,33,10,22,1,4,10,34,55,7,2,35,75,23,35,15,40,3,8,10,38,75
2007-01-01 00:00:00.000,Doha Qatar ATP World Tour,HARD,2,Andy Murray,Filippo Volandri,Andy Murray,4-6; 6-2; 6-4,R32,109,5,3,47,78,32,47,19,31,3,6,14,51,78,1,2,50,84,31,50,18,34,4,9,14,49,84
2007-01-01 00:00:00.000,Doha Qatar ATP World Tour,HARD,2,Christophe Rochus,Alberto Martin,Christophe Rochus,6-4; 7-5,R32,95,0,2,46,68,32,46,12,22,3,5,11,44,68,3,2,47,70,31,47,11,23,4,8,11,42,70
2007-01-01 00:00:00.000,Doha Qatar ATP World Tour,HARD,2,Marco Chiudinelli,Tomas Cakl,Marco Chiudinelli,6-2; 6-2,R32,49,4,2,31,52,23,31,9,21,2,4,8,32,52,0,1,44,52,18,44,3,8,2,8,8,21,52
2007-01-01 00:00:00.000,Doha Qatar ATP World Tour,HARD,2,Max Mirnyi,Stanislas Wawrinka,Max Mirnyi,5-7; 6-4; 6-4,R32,130,6,5,64,106,51,64,18,42,6,8,16,69,106,1,4,66,98,47,66,16,32,2,5,16,63,98
2007-01-01 00:00:00.000,Doha Qatar ATP World Tour,HARD,2,Robin Soderling,Kristof Vliegen,Robin Soderling,6-3; 6-3,R32,71,2,1,32,57,22,32,13,25,0,2,9,35,57,1,0,41,54,20,41,4,13,0,5,9,24,54
2007-01-01 00:00:00.000,Doha Qatar ATP World Tour,HARD,2,Guillermo Garcia-Lopez,Potito Starace,Guillermo Garcia-Lopez,2-6; 7-5; 7-5,R32,188,2,6,75,121,49,75,17,46,22,28,16,66,121,2,3,95,139,55,95,21,44,23,29,16,76,139
2007-01-01 00:00:00.000,Doha Qatar ATP World Tour,HARD,2,Ruben Ramirez Hidalgo,Sultan Khalfan,Ruben Ramirez Hidalgo,7-6(5); 6-2,R32,87,2,5,35,59,26,35,10,24,3,6,10,36,59,2,8,43,84,27,43,15,41,9,14,10,42,84
2007-01-01 00:00:00.000,Doha Qatar ATP World Tour,HARD,2,Marcos Baghdatis,Philipp Kohlschreiber,Marcos Baghdatis,6-4; 7-5,R32,100,3,2,34,92,22,34,35,58,11,12,11,57,92,2,1,39,59,28,39,10,20,1,4,11,38,59
2007-01-01 00:00:00.000,Doha Qatar ATP World Tour,HARD,2,Mikhail Youzhny,Daniele Bracciali,Mikhail Youzhny,7-5; 6-3,R32,87,5,1,47,62,34,47,9,15,4,5,10,43,62,2,1,49,78,32,49,11,29,2,6,11,43,78
2007-01-01 00:00:00.000,Doha Qatar ATP World Tour,HARD,2,Gael Monfils,Andreas Seppi,Gael Monfils,6-3; 6-4,R32,76,2,2,34,57,24,34,14,23,2,4,10,38,57,1,0,34,61,20,34,12,27,6,10,9,32,61
2007-01-01 00:00:00.000,Doha Qatar ATP World Tour,HARD,2,Younes El Aynaoui,Thomas Johansson,Younes El Aynaoui,7-6(5); 7-6(1),R32,110,7,2,57,84,46,57,15,27,3,4,12,61,84,9,2,44,79,33,44,21,35,1,2,12,54,79
2007-01-01 00:00:00.000,Doha Qatar ATP World Tour,HARD,2,Ivan Ljubicic,Denis Gremelmayr,Ivan Ljubicic,6-1; 6-2,R32,59,9,5,30,52,26,30,11,22,2,2,8,37,52,0,0,21,38,15,21,4,17,2,6,7,19,38
2007-01-01 00:00:00.000,Doha Qatar ATP World Tour,HARD,2,Nikolay Davydenko,Jonas Bjorkman,Nikolay Davydenko,6-4; 6-3,R16,89,1,1,52,68,35,52,7,16,4,5,9,42,68,1,3,52,68,27,52,8,16,3,7,10,35,68
2007-01-01 00:00:00.000,Doha Qatar ATP World Tour,HARD,2,Olivier Rochus,Federico Luzzi,Olivier Rochus,6-1; 6-0,R16,44,4,4,20,33,17,20,8,13,1,1,6,25,33,5,6,31,51,14,31,6,20,4,10,7,20,51
2007-01-01 00:00:00.000,Doha Qatar ATP World Tour,HARD,2,Andy Murray,Christophe Rochus,Andy Murray,6-1; 6-3,R16,83,3,0,30,51,20,30,13,21,1,2,8,33,51,1,2,49,67,25,49,6,18,6,11,8,31,67
2007-01-01 00:00:00.000,Doha Qatar ATP World Tour,HARD,2,Max Mirnyi,Marco Chiudinelli,Max Mirnyi,6-3; 6-3,R16,83,1,4,43,63,33,43,7,20,3,4,9,40,63,1,1,38,69,19,38,17,31,5,9,9,36,69
2007-01-01 00:00:00.000,Doha Qatar ATP World Tour,HARD,2,Robin Soderling,Guillermo Garcia-Lopez,Robin Soderling,4-6; 6-0; 6-3,R16,111,8,1,66,97,45,66,16,31,5,7,13,61,97,3,2,51,68,27,51,10,17,3,8,12,37,68
2007-01-01 00:00:00.000,Doha Qatar ATP World Tour,HARD,2,Marcos Baghdatis,Ruben Ramirez Hidalgo,Marcos Baghdatis,6-2; 6-0,R16,65,1,1,26,49,18,26,16,23,3,3,7,34,49,0,1,35,52,18,35,5,17,7,12,7,23,52
2007-01-01 00:00:00.000,Doha Qatar ATP World Tour,HARD,2,Mikhail Youzhny,Gael Monfils,Mikhail Youzhny,6-4; 6-2,R16,64,1,1,43,50,30,43,5,7,1,2,9,35,50,1,2,49,63,25,49,6,14,3,7,9,31,63
2007-01-01 00:00:00.000,Doha Qatar ATP World Tour,HARD,2,Ivan Ljubicic,Younes El Aynaoui,Ivan Ljubicic,6-3; 6-4,R16,76,6,1,32,55,27,32,13,23,2,3,10,40,55,1,0,41,51,27,41,3,10,1,4,9,30,51
2007-01-01 00:00:00.000,Doha Qatar ATP World Tour,HARD,2,Nikolay Davydenko,Olivier Rochus,Nikolay Davydenko,6-4; 6-3,Q,89,6,1,42,63,27,42,11,21,2,4,9,38,63,0,1,31,60,16,31,16,29,3,8,10,32,60
2007-01-01 00:00:00.000,Doha Qatar ATP World Tour,HARD,2,Andy Murray,Max Mirnyi,Andy Murray,2-6; 6-2; 6-2,Q,96,2,1,57,81,36,57,12,24,6,9,12,48,81,3,3,38,64,22,38,12,26,3,8,12,34,64
2007-01-01 00:00:00.000,Doha Qatar ATP World Tour,HARD,2,Robin Soderling,Marcos Baghdatis,Robin Soderling,6-3; 6-2,Q,57,4,1,36,51,32,36,8,15,3,3,9,40,51,3,0,28,44,17,28,7,16,3,6,8,24,44
2007-01-01 00:00:00.000,Doha Qatar ATP World Tour,HARD,2,Ivan Ljubicic,Mikhail Youzhny,Ivan Ljubicic,2-6; 7-6(2); 7-6(3),Q,174,18,1,72,118,53,72,22,46,7,10,16,75,118,3,5,61,115,43,61,31,54,8,9,16,74,115
2007-01-01 00:00:00.000,Doha Qatar ATP World Tour,HARD,2,Andy Murray,Nikolay Davydenko,Andy Murray,7-5; 6-2,S,92,1,0,36,52,25,36,9,16,0,2,10,34,52,1,3,36,64,21,36,11,28,5,10,10,32,64
2007-01-01 00:00:00.000,Doha Qatar ATP World Tour,HARD,2,Ivan Ljubicic,Robin Soderling,Ivan Ljubicic,3-6; 6-4; 7-6(5),S,126,21,2,53,99,40,53,26,46,5,7,15,66,99,7,1,59,86,47,59,18,27,1,3,16,65,86
2007-01-01 00:00:00.000,Doha Qatar ATP World Tour,HARD,2,Ivan Ljubicic,Andy Murray,Ivan Ljubicic,6-4; 6-4,F,108,5,1,39,71,28,39,20,32,8,9,10,48,71,2,0,46,68,27,46,13,22,6,9,10,40,68
2007-01-08 00:00:00.000,Auckland New Zealand ATP World Tour,HARD,2,Tommy Robredo,Ruben Ramirez Hidalgo,Tommy Robredo,6-2; 6-1,R32,65,5,2,21,39,16,21,11,18,0,1,7,27,39,0,6,29,59,16,29,9,30,4,10,8,25,59
2007-01-08 00:00:00.000,Auckland New Zealand ATP World Tour,HARD,2,Alberto Martin,Gael Monfils,Alberto Martin,6-4; 6-4,R32,73,3,1,35,60,28,35,15,25,0,0,10,43,60,4,6,41,75,30,41,13,34,4,6,10,43,75
2007-01-08 00:00:00.000,Auckland New Zealand ATP World Tour,HARD,2,Philipp Kohlschreiber,Luis Horna,Philipp Kohlschreiber,6-4; 7-5,R32,93,8,3,45,76,30,45,19,31,6,7,11,49,76,8,2,51,78,34,51,13,27,1,4,11,47,78
2007-01-08 00:00:00.000,Auckland New Zealand ATP World Tour,HARD,2,Dominik Hrbaty,Woong-Sun Jun,Dominik Hrbaty,6-4; 7-5,R32,93,1,2,36,59,27,36,13,23,1,3,11,40,59,6,4,48,93,29,48,20,45,10,14,11,49,93
2007-01-08 00:00:00.000,Auckland New Zealand ATP World Tour,HARD,2,Olivier Rochus,Jarkko Nieminen,Olivier Rochus,7-6(3); 6-1,R32,83,1,2,48,71,34,48,12,23,9,11,10,46,71,2,3,29,57,19,29,10,28,1,5,9,29,57
2007-01-08 00:00:00.000,Auckland New Zealand ATP World Tour,HARD,2,Juan Monaco,Daniel King-Turner,Juan Monaco,6-3; 6-3,R32,64,3,1,48,59,30,48,6,11,4,6,9,36,59,3,3,29,47,18,29,6,18,1,6,9,24,47
2007-01-08 00:00:00.000,Auckland New Zealand ATP World Tour,HARD,2,Florent Serra,Nicolas Lapentti,Florent Serra,6-3; 1-6; 6-4,R32,116,1,2,57,87,38,57,16,30,3,6,13,54,87,5,1,50,77,35,50,12,27,5,8,13,47,77
2007-01-08 00:00:00.000,Auckland New Zealand ATP World Tour,HARD,2,Agustin Calleri,Juan Martin Del Potro,Agustin Calleri,6-1; 6-3,R32,60,10,7,27,49,23,27,13,22,2,2,8,36,49,0,3,28,49,16,28,9,21,3,7,8,25,49
2007-01-08 00:00:00.000,Auckland New Zealand ATP World Tour,HARD,2,Nicolas Almagro,Stanislas Wawrinka,Nicolas Almagro,1-6; 6-4; 6-1,R32,92,7,2,35,67,26,35,20,32,3,5,12,46,67,0,5,49,89,32,49,21,40,12,15,12,53,89
2007-01-08 00:00:00.000,Auckland New Zealand ATP World Tour,HARD,2,Kristof Vliegen,Janko Tipsarevic,Kristof Vliegen,7-6(3); 6-0,R32,72,6,1,36,55,32,36,10,19,1,2,9,42,55,3,3,34,60,20,34,13,26,4,8,9,33,60
2007-01-08 00:00:00.000,Auckland New Zealand ATP World Tour,HARD,2,Daniele Bracciali,Gilles Simon,Daniele Bracciali,6-3; 6-2,R32,67,4,2,32,58,24,32,14,26,5,6,9,38,58,5,1,24,49,16,24,9,25,4,8,8,25,49
2007-01-08 00:00:00.000,Auckland New Zealand ATP World Tour,HARD,2,David Ferrer,Gaston Gaudio,David Ferrer,5-7; 6-3; 6-2,R32,148,1,4,64,107,43,64,18,43,9,13,14,61,107,0,8,56,104,35,56,18,48,10,17,15,53,104
2007-01-08 00:00:00.000,Auckland New Zealand ATP World Tour,HARD,2,Nicolas Massu,Juan Carlos Ferrero,Nicolas Massu,6-4; 6-2,R32,81,6,2,34,61,28,34,13,27,5,5,9,41,61,4,6,28,51,18,28,13,23,3,6,9,31,51
2007-01-08 00:00:00.000,Auckland New Zealand ATP World Tour,HARD,2,Juan Ignacio Chela,Nicolas Mahut,Juan Ignacio Chela,7-6(2); 6-3,R32,91,1,3,31,60,21,31,19,29,2,4,10,40,60,0,11,32,70,19,32,16,38,4,8,11,35,70
2007-01-08 00:00:00.000,Auckland New Zealand ATP World Tour,HARD,2,Mardy Fish,Robert Kendrick,Mardy Fish,6-2; 6-4,R32,70,3,2,28,64,21,28,19,36,3,4,9,40,64,5,4,30,61,20,30,12,31,3,7,9,32,61
2007-01-08 00:00:00.000,Auckland New Zealand ATP World Tour,HARD,2,Mario Ancic,Lukas Rosol,Mario Ancic,6-3; 7-6(4),R32,105,9,1,41,76,35,41,15,35,5,7,11,50,76,1,6,45,86,28,45,20,41,6,9,10,48,86
2007-01-08 00:00:00.000,Auckland New Zealand ATP World Tour,HARD,2,Tommy Robredo,Alberto Martin,Tommy Robredo,6-4; 6-2,R16,71,3,1,30,52,26,30,11,22,3,4,9,37,52,0,4,28,51,17,28,10,23,4,8,9,27,51
2007-01-08 00:00:00.000,Auckland New Zealand ATP World Tour,HARD,2,Philipp Kohlschreiber,Dominik Hrbaty,Philipp Kohlschreiber,6-2; 6-3,R16,82,1,2,36,53,27,36,8,17,7,8,8,35,53,0,3,39,62,22,39,8,23,3,8,9,30,62
2007-01-08 00:00:00.000,Auckland New Zealand ATP World Tour,HARD,2,Juan Monaco,Olivier Rochus,Juan Monaco,7-5; 5-7; 6-3,R16,170,4,4,84,117,53,84,10,33,8,15,17,63,117,2,5,67,112,39,67,17,45,3,11,16,56,112
2007-01-08 00:00:00.000,Auckland New Zealand ATP World Tour,HARD,2,Agustin Calleri,Florent Serra,Agustin Calleri,6-4; 6-1,R16,55,10,1,27,43,24,27,9,16,2,2,8,33,43,0,2,32,56,21,32,8,24,4,8,9,29,56
2007-01-08 00:00:00.000,Auckland New Zealand ATP World Tour,HARD,2,Kristof Vliegen,Nicolas Almagro,Kristof Vliegen,7-6(2); 2-6; 7-5,R16,138,6,1,71,115,46,71,22,44,5,10,16,68,115,5,3,54,102,36,54,25,48,6,10,16,61,102
2007-01-08 00:00:00.000,Auckland New Zealand ATP World Tour,HARD,2,David Ferrer,Daniele Bracciali,David Ferrer,6-0; 6-1,R16,67,6,6,20,43,14,20,12,23,0,1,6,26,43,0,5,34,61,13,34,10,27,8,15,7,23,61
2007-01-08 00:00:00.000,Auckland New Zealand ATP World Tour,HARD,2,Juan Ignacio Chela,Nicolas Massu,Juan Ignacio Chela,7-5; 4-6; 6-3,R16,180,1,7,73,125,46,73,28,52,6,9,16,74,125,7,4,63,105,44,63,18,42,12,16,15,62,105
2007-01-08 00:00:00.000,Auckland New Zealand ATP World Tour,HARD,2,Mardy Fish,Mario Ancic,Mardy Fish,6-4; 6-4,R16,87,1,1,27,53,23,27,16,26,2,3,10,39,53,5,5,44,77,30,44,14,33,10,13,10,44,77
2007-01-08 00:00:00.000,Auckland New Zealand ATP World Tour,HARD,2,Tommy Robredo,Philipp Kohlschreiber,Tommy Robredo,6-4; 5-7; 6-2,Q,116,9,2,72,99,52,72,12,27,6,8,15,64,99,1,4,52,83,36,52,15,31,4,8,15,51,83
2007-01-08 00:00:00.000,Auckland New Zealand ATP World Tour,HARD,2,Agustin Calleri,Juan Monaco,Agustin Calleri,4-6; 6-4; 6-3,Q,122,5,2,52,91,37,52,21,39,4,6,15,58,91,4,1,83,108,52,83,12,25,11,14,14,64,108
2007-01-08 00:00:00.000,Auckland New Zealand ATP World Tour,HARD,2,David Ferrer,Kristof Vliegen,David Ferrer,3-6; 6-3; 6-2,Q,109,0,3,52,76,35,52,11,24,4,8,13,46,76,3,1,48,81,31,48,11,33,8,14,13,42,81
2007-01-08 00:00:00.000,Auckland New Zealand ATP World Tour,HARD,2,Mardy Fish,Juan Ignacio Chela,Mardy Fish,7-6(3); 7-6(8),Q,102,9,2,46,90,33,46,29,44,5,7,12,62,90,4,3,52,78,40,52,14,26,3,5,12,54,78
2007-01-08 00:00:00.000,Auckland New Zealand ATP World Tour,HARD,2,Tommy Robredo,Agustin Calleri,Tommy Robredo,6-4; 6-0,S,66,1,0,29,39,25,29,8,10,0,0,8,33,39,1,4,44,72,26,44,10,28,12,16,8,36,72
2007-01-08 00:00:00.000,Auckland New Zealand ATP World Tour,HARD,2,David Ferrer,Mardy Fish,David Ferrer,6-0; 4-6; 6-1,S,102,4,0,55,78,37,55,12,23,10,12,11,49,78,4,4,41,82,25,41,13,41,2,9,12,38,82
2007-01-08 00:00:00.000,Auckland New Zealand ATP World Tour,HARD,2,David Ferrer,Tommy Robredo,David Ferrer,6-4; 6-2,F,75,0,0,44,62,30,44,11,18,3,4,9,41,62,0,1,31,50,19,31,8,19,2,6,9,27,50
2007-01-08 00:00:00.000,Sydney Australia ATP World Tour,HARD,2,Chris Guccione,Rafael Nadal,Chris Guccione,6-5 RET,R32,39,9,0,18,27,18,18,6,9,0,0,6,24,27,3,0,17,27,13,17,8,10,2,2,5,21,27
2007-01-08 00:00:00.000,Sydney Australia ATP World Tour,HARD,2,Jurgen Melzer,Fabrice Santoro,Jurgen Melzer,6-2; 2-6; 6-4,R32,94,5,2,45,78,29,45,18,33,3,7,13,47,78,7,1,46,80,29,46,18,34,6,11,13,47,80
2007-01-08 00:00:00.000,Sydney Australia ATP World Tour,HARD,2,Ivo Minar,Paradorn Srichaphan,Ivo Minar,6-2; 3-0 RET,R32,34,5,0,19,31,18,19,6,12,0,0,6,24,31,1,3,18,34,10,18,7,16,4,7,5,17,34
2007-01-08 00:00:00.000,Sydney Australia ATP World Tour,HARD,2,Tomas Berdych,Robert Smeets,Tomas Berdych,6-2; 7-5,R32,88,2,0,36,60,28,36,12,24,3,5,10,40,60,2,9,41,75,27,41,10,34,9,14,10,37,75
2007-01-08 00:00:00.000,Sydney Australia ATP World Tour,HARD,2,James Blake,Kevin Kim,James Blake,6-3; 6-4,R32,46,6,1,35,52,29,35,11,17,2,3,10,40,52,2,1,31,44,22,31,5,13,1,4,9,27,44
2007-01-08 00:00:00.000,Sydney Australia ATP World Tour,HARD,2,Nathan Healey,Stefan Koubek,Nathan Healey,6-3; 7-5,R32,77,4,5,34,62,25,34,18,28,1,2,11,43,62,1,3,53,79,27,53,16,26,15,18,10,43,79
2007-01-08 00:00:00.000,Sydney Australia ATP World Tour,HARD,2,Robby Ginepri,Florian Mayer,Robby Ginepri,6-3; 6-2,R32,54,8,3,32,50,27,32,9,18,2,3,9,36,50,1,0,37,52,19,37,8,15,5,9,8,27,52
2007-01-08 00:00:00.000,Sydney Australia ATP World Tour,HARD,2,Evgeny Korolev,Hyung-Taik Lee,Evgeny Korolev,6-7(2); 6-3; 6-2,R32,137,9,4,66,115,44,66,29,49,10,11,15,73,115,1,2,75,112,48,75,15,37,9,13,14,63,112
2007-01-08 00:00:00.000,Sydney Australia ATP World Tour,HARD,2,Fernando Verdasco,Sebastien Grosjean,Fernando Verdasco,6-4; 6-4,R32,86,2,3,39,59,29,39,10,20,3,5,10,39,59,1,4,39,73,26,39,12,34,6,10,10,38,73
2007-01-08 00:00:00.000,Sydney Australia ATP World Tour,HARD,2,Carlos Moya,Luke Bourgeois,Carlos Moya,7-6(4); 4-6; 7-6(6),R32,150,2,2,84,114,64,84,17,30,3,4,17,81,114,16,10,58,119,52,58,31,61,8,8,17,83,119
2007-01-08 00:00:00.000,Sydney Australia ATP World Tour,HARD,2,Jan Hernych,Andreas Seppi,Jan Hernych,6-4; 6-2,R32,66,3,0,34,53,27,34,10,19,1,2,9,37,53,1,4,27,52,17,27,11,25,3,7,9,28,52
2007-01-08 00:00:00.000,Sydney Australia ATP World Tour,HARD,2,Marcos Baghdatis,Ernests Gulbis,Marcos Baghdatis,7-6(3); 6-1,R32,84,3,4,34,66,30,34,16,32,5,6,10,46,66,3,3,36,64,25,36,10,28,3,6,9,35,64
2007-01-08 00:00:00.000,Sydney Australia ATP World Tour,HARD,2,Richard Gasquet,Julien Benneteau,Richard Gasquet,6-1; 6-4,R32,71,2,1,32,55,27,32,12,23,4,5,9,39,55,0,3,30,48,17,30,6,18,1,5,8,23,48
2007-01-08 00:00:00.000,Sydney Australia ATP World Tour,HARD,2,Benjamin Becker,Filippo Volandri,Benjamin Becker,6-3; 6-2,R32,66,5,1,22,48,19,22,18,26,1,1,9,37,48,0,3,33,69,24,33,13,36,7,10,8,37,69
2007-01-08 00:00:00.000,Sydney Australia ATP World Tour,HARD,2,Paul-Henri Mathieu,Arnaud Clement,Paul-Henri Mathieu,7-6(5); 6-4,R32,122,6,5,49,94,34,49,21,45,4,7,11,55,94,8,4,43,73,27,43,14,30,6,10,11,41,73
2007-01-08 00:00:00.000,Sydney Australia ATP World Tour,HARD,2,Nikolay Davydenko,Vincent Spadea,Nikolay Davydenko,3-6; 6-3; 6-4,R32,123,3,6,61,97,36,61,17,36,4,9,14,53,97,1,2,59,95,35,59,15,36,5,11,14,50,95
2007-01-08 00:00:00.000,Sydney Australia ATP World Tour,HARD,2,Jurgen Melzer,Chris Guccione,Jurgen Melzer,7-6(3); 6-3,R16,72,1,2,37,60,31,37,14,23,0,2,11,45,60,12,2,34,62,24,34,14,28,1,4,10,38,62
2007-01-08 00:00:00.000,Sydney Australia ATP World Tour,HARD,2,Tomas Berdych,Ivo Minar,Tomas Berdych,6-7(4); 6-0; 6-4,R16,93,4,2,33,73,31,33,28,40,0,0,14,59,73,4,3,52,91,39,52,17,39,10,14,14,56,91
2007-01-08 00:00:00.000,Sydney Australia ATP World Tour,HARD,2,James Blake,Nathan Healey,James Blake,6-2; 6-4,R16,57,6,1,26,44,22,26,12,18,2,3,9,34,44,4,6,28,52,17,28,11,24,0,4,9,28,52
2007-01-08 00:00:00.000,Sydney Australia ATP World Tour,HARD,2,Evgeny Korolev,Robby Ginepri,Evgeny Korolev,0-6; 6-4; 6-4,R16,101,8,3,52,83,38,52,11,31,4,8,13,49,83,5,2,57,89,40,57,15,32,7,10,13,55,89
2007-01-08 00:00:00.000,Sydney Australia ATP World Tour,HARD,2,Carlos Moya,Fernando Verdasco,Carlos Moya,4-6; 7-6(9); 6-3,R16,128,6,8,66,106,45,66,20,40,6,11,16,65,106,5,6,63,93,44,63,12,30,5,10,15,56,93
2007-01-08 00:00:00.000,Sydney Australia ATP World Tour,HARD,2,Marcos Baghdatis,Jan Hernych,Marcos Baghdatis,6-4; 6-7(2); 6-3,R16,141,7,3,59,112,44,59,29,53,9,10,16,73,112,3,2,66,98,45,66,19,32,5,8,15,64,98
2007-01-08 00:00:00.000,Sydney Australia ATP World Tour,HARD,2,Richard Gasquet,Benjamin Becker,Richard Gasquet,6-3; 6-4,R16,87,2,2,29,49,22,29,12,20,0,2,10,34,49,2,3,43,87,21,43,23,44,13,17,9,44,87
2007-01-08 00:00:00.000,Sydney Australia ATP World Tour,HARD,2,Paul-Henri Mathieu,Nikolay Davydenko,Paul-Henri Mathieu,6-4 RET,R16,49,0,0,17,34,9,17,11,17,3,4,5,20,34,1,0,24,35,13,24,6,11,3,5,5,19,35
2007-01-08 00:00:00.000,Sydney Australia ATP World Tour,HARD,2,Jurgen Melzer,Tomas Berdych,Jurgen Melzer,6-2; 6-4,Q,60,5,0,29,49,21,29,16,20,0,0,9,37,49,7,3,32,53,22,32,9,21,1,4,9,31,53
2007-01-08 00:00:00.000,Sydney Australia ATP World Tour,HARD,2,James Blake,Evgeny Korolev,James Blake,6-1; 6-4,Q,53,8,1,34,55,25,34,15,21,5,5,9,40,55,4,4,25,50,19,25,10,25,4,7,8,29,50
2007-01-08 00:00:00.000,Sydney Australia ATP World Tour,HARD,2,Carlos Moya,Marcos Baghdatis,Carlos Moya,6-1; 3-6; 7-6(3),Q,147,9,4,58,102,44,58,23,44,8,10,14,67,102,6,2,59,115,36,59,31,56,9,12,14,67,115
2007-01-08 00:00:00.000,Sydney Australia ATP World Tour,HARD,2,Richard Gasquet,Paul-Henri Mathieu,Richard Gasquet,6-4; 6-7(1); 6-0,Q,137,8,3,57,92,42,57,17,35,3,5,14,59,92,2,4,48,88,33,48,16,40,4,10,14,49,88
2007-01-08 00:00:00.000,Sydney Australia ATP World Tour,HARD,2,James Blake,Jurgen Melzer,James Blake,W/O,S,0,0,0,0,0,0,0,0,0,0,0,0,0,0,0,0,0,0,0,0,0,0,0,0,0,0,0
2007-01-08 00:00:00.000,Sydney Australia ATP World Tour,HARD,2,Carlos Moya,Richard Gasquet,Carlos Moya,6-3; 4-6; 6-2,S,113,6,4,58,88,40,58,12,30,9,12,13,52,88,1,3,61,98,35,61,17,37,6,12,14,52,98
2007-01-08 00:00:00.000,Sydney Australia ATP World Tour,HARD,2,James Blake,Carlos Moya,James Blake,6-3; 5-7; 6-1,F,122,3,4,59,102,41,59,18,43,12,15,14,59,102,4,4,65,101,38,65,15,36,4,10,14,53,101
2007-01-15 00:00:00.000,Australian Open Australia Grand Slams,HARD,3,Roger Federer,Bjorn Phau,Roger Federer,7-5; 6-0; 6-4,R128,107,7,1,56,79,39,56,12,23,2,6,14,51,79,3,3,52,107,28,52,19,55,10,19,14,47,107
2007-01-15 00:00:00.000,Australian Open Australia Grand Slams,HARD,3,Jonas Bjorkman,Olivier Patience,Jonas Bjorkman,5-7; 4-6; 6-0; 6-1; 6-2,R128,165,3,5,78,124,58,78,24,46,5,9,22,82,124,4,6,107,136,61,107,10,29,11,20,21,71,136
2007-01-15 00:00:00.000,Australian Open Australia Grand Slams,HARD,3,Yen-Hsun Lu,Simon Greul,Yen-Hsun Lu,6-3; 6-4; 6-3,R128,120,5,6,54,87,41,54,15,33,2,4,14,56,87,1,3,46,79,27,46,16,33,5,11,14,43,79
2007-01-15 00:00:00.000,Australian Open Australia Grand Slams,HARD,3,Mikhail Youzhny,Jan Hernych,Mikhail Youzhny,7-6(6); 6-2; 6-0,R128,118,4,2,42,79,31,42,20,37,3,5,13,51,79,3,2,64,103,37,64,11,39,8,15,13,48,103
2007-01-15 00:00:00.000,Australian Open Australia Grand Slams,HARD,3,Juan Carlos Ferrero,Jan Hajek,Juan Carlos Ferrero,3-0 RET,R128,6,4,1,7,10,7,7,1,3,0,0,2,8,10,1,0,2,5,1,2,0,3,1,2,1,1,5
2007-01-15 00:00:00.000,Australian Open Australia Grand Slams,HARD,3,Danai Udomchoke,Martin Vassallo Arguello,Danai Udomchoke,6-3; 6-3; 6-2,R128,126,3,8,51,85,38,51,13,34,4,7,13,51,85,7,4,65,103,38,65,12,38,8,16,13,50,103
2007-01-15 00:00:00.000,Australian Open Australia Grand Slams,HARD,3,Feliciano Lopez,Brian Wilson,Feliciano Lopez,7-6(8); 4-6; 6-2; 7-6(3),R128,177,19,2,85,133,71,85,27,48,2,3,22,98,133,13,3,104,159,76,104,26,55,9,10,21,102,159
2007-01-15 00:00:00.000,Australian Open Australia Grand Slams,HARD,3,Novak Djokovic,Nicolas Massu,Novak Djokovic,6-1; 6-1; 6-0,R128,81,5,1,40,59,33,40,11,19,3,3,10,44,59,1,4,37,69,17,37,12,32,7,15,10,29,69
2007-01-15 00:00:00.000,Australian Open Australia Grand Slams,HARD,3,Marcos Baghdatis,Rainer Schuettler,Marcos Baghdatis,6-4; 2-6; 6-3; 6-2,R128,144,11,7,43,101,36,43,27,58,2,6,17,63,101,2,6,59,111,40,59,22,52,3,10,18,62,111
2007-01-15 00:00:00.000,Australian Open Australia Grand Slams,HARD,3,Gael Monfils,Daniele Bracciali,Gael Monfils,7-6(2); 6-7(9); 6-4; 7-6(5),R128,208,25,1,76,142,65,76,45,66,6,8,23,110,142,11,1,105,179,73,105,42,74,7,10,23,115,179
2007-01-15 00:00:00.000,Australian Open Australia Grand Slams,HARD,3,Amer Delic,Gilles Simon,Amer Delic,6-3; 6-0; 6-2,R128,84,7,1,31,63,26,31,17,32,2,3,11,43,63,1,6,39,76,20,39,15,37,2,10,12,35,76
2007-01-15 00:00:00.000,Australian Open Australia Grand Slams,HARD,3,Richard Gasquet,Filippo Volandri,Richard Gasquet,6-4; 6-4; 6-2,R128,116,4,3,54,84,35,54,13,30,3,7,14,48,84,3,3,59,100,32,59,17,41,8,16,14,49,100
2007-01-15 00:00:00.000,Australian Open Australia Grand Slams,HARD,3,Sam Querrey,Jose Acasuso,Sam Querrey,6-7(2); 6-4; 6-1; 6-3,R128,148,20,5,70,123,59,70,24,53,9,10,19,83,123,13,3,62,120,42,62,31,58,7,13,19,73,120
2007-01-15 00:00:00.000,Australian Open Australia Grand Slams,HARD,3,Florent Serra,Nicolas Devilder,Florent Serra,7-5; 6-2; 6-4,R128,131,4,1,48,93,33,48,29,45,3,4,15,62,93,7,2,59,113,36,59,28,54,10,15,15,64,113
2007-01-15 00:00:00.000,Australian Open Australia Grand Slams,HARD,3,Jurgen Melzer,Ivo Karlovic,Jurgen Melzer,6-4; 6-4; 7-6(6),R128,122,1,4,77,116,61,77,22,39,4,4,16,83,116,27,3,50,83,47,50,19,33,1,3,16,66,83
2007-01-15 00:00:00.000,Australian Open Australia Grand Slams,HARD,3,Tommy Robredo,Ruben Ramirez Hidalgo,Tommy Robredo,6-4; 6-4; 6-0,R128,104,10,2,44,66,37,44,12,22,0,1,13,49,66,4,8,38,76,24,38,15,38,1,7,13,39,76
2007-01-15 00:00:00.000,Australian Open Australia Grand Slams,HARD,3,Mardy Fish,Ivan Ljubicic,Mardy Fish,4-6; 7-6(2); 6-4; 6-4,R128,173,14,1,70,143,56,70,43,73,6,7,21,99,143,28,2,71,124,60,71,25,53,2,4,21,85,124
2007-01-15 00:00:00.000,Australian Open Australia Grand Slams,HARD,3,Nicolas Mahut,Juan Monaco,Nicolas Mahut,6-0; 6-7(0); 6-3; 6-4,R128,161,10,8,51,115,40,51,32,64,6,10,19,72,115,3,5,83,118,51,83,12,35,8,17,18,63,118
2007-01-15 00:00:00.000,Australian Open Australia Grand Slams,HARD,3,Wayne Arthurs,Stefan Koubek,Wayne Arthurs,1-6; 6-7(4); 7-6(5); 6-2; 6-3,R128,180,19,9,85,150,64,85,31,65,6,12,24,95,150,4,6,101,152,65,101,28,51,8,15,24,93,152
2007-01-15 00:00:00.000,Australian Open Australia Grand Slams,HARD,3,Zack Fleishman,Agustin Calleri,Zack Fleishman,7-5; 4-6; 6-3; 6-4,R128,150,10,4,71,143,49,71,36,72,8,13,21,85,143,12,12,72,126,50,72,22,54,5,12,20,72,126
2007-01-15 00:00:00.000,Australian Open Australia Grand Slams,HARD,3,Radek Stepanek,Michael Llodra,Radek Stepanek,6-2; 6-4; 6-0,R128,76,15,1,41,58,38,41,11,17,1,1,12,49,58,1,1,59,83,33,59,9,24,5,11,12,42,83
2007-01-15 00:00:00.000,Australian Open Australia Grand Slams,HARD,3,Lukas Dlouhy,Teymuraz Gabashvili,Lukas Dlouhy,6-3; 6-1; 6-7(5); 6-7(5); 16-14,R128,286,17,8,150,237,110,150,36,87,9,17,35,146,237,13,11,145,253,96,145,47,108,12,25,35,143,253
2007-01-15 00:00:00.000,Australian Open Australia Grand Slams,HARD,3,Thomas Johansson,Marco Chiudinelli,Thomas Johansson,6-4; 3-6; 1-6; 6-4; 6-2,R128,182,14,4,75,126,56,75,22,51,3,9,22,78,126,7,2,75,139,53,75,31,64,2,8,22,84,139
2007-01-15 00:00:00.000,Australian Open Australia Grand Slams,HARD,3,David Ferrer,Kristian Pless,David Ferrer,7-5; 6-4; 6-3,R128,126,4,4,66,105,43,66,21,39,3,6,15,64,105,6,4,57,103,34,57,23,46,7,14,16,57,103
2007-01-15 00:00:00.000,Australian Open Australia Grand Slams,HARD,3,Mario Ancic,Go Soeda,Mario Ancic,6-4; 6-3; 6-2,R128,115,7,4,44,69,40,44,14,25,2,3,14,54,69,0,5,55,99,33,55,20,44,8,13,13,53,99
2007-01-15 00:00:00.000,Australian Open Australia Grand Slams,HARD,3,Guillermo Garcia-Lopez,Joachim Johansson,Guillermo Garcia-Lopez,1-1 RET,R128,43,0,0,6,8,5,6,0,2,0,0,1,5,8,0,1,5,10,4,5,2,5,0,0,1,6,10
2007-01-15 00:00:00.000,Australian Open Australia Grand Slams,HARD,3,Vincent Spadea,Igor Andreev,Vincent Spadea,6-2; 7-6(3); 6-1,R128,110,3,1,60,86,40,60,17,26,4,6,13,57,86,1,4,58,93,33,58,13,35,9,16,14,46,93
2007-01-15 00:00:00.000,Australian Open Australia Grand Slams,HARD,3,Dominik Hrbaty,Jiri Vanek,Dominik Hrbaty,6-7(7); 7-6(1); 6-1; 6-3,R128,172,9,10,77,131,59,77,25,54,3,7,20,84,131,10,8,89,165,54,89,33,76,11,19,20,87,165
2007-01-15 00:00:00.000,Australian Open Australia Grand Slams,HARD,3,Marat Safin,Benjamin Becker,Marat Safin,5-7; 7-6(2); 3-6; 6-3; 6-4,R128,206,19,2,98,149,78,98,29,51,5,8,26,107,149,14,6,81,166,64,81,49,85,9,12,26,113,166
2007-01-15 00:00:00.000,Australian Open Australia Grand Slams,HARD,3,Dudi Sela,Paradorn Srichaphan,Dudi Sela,6-4; 6-2; 6-2,R128,111,0,4,51,81,38,51,14,30,3,5,13,52,81,0,8,51,88,28,51,16,37,12,19,13,44,88
2007-01-15 00:00:00.000,Australian Open Australia Grand Slams,HARD,3,Marc Gicquel,Alun Jones,Marc Gicquel,3-6; 6-7(1); 6-4; 6-1; 6-0,R128,188,14,4,73,130,53,73,31,57,8,12,21,84,130,5,6,90,153,49,90,32,63,6,16,23,81,153
2007-01-15 00:00:00.000,Australian Open Australia Grand Slams,HARD,3,Andy Roddick,Jo-Wilfried Tsonga,Andy Roddick,6-7(18); 7-6(2); 6-2; 6-3,R128,164,13,2,101,141,81,101,23,40,6,7,21,104,141,16,5,96,141,72,96,22,45,2,6,21,94,141
2007-01-15 00:00:00.000,Australian Open Australia Grand Slams,HARD,3,David Nalbandian,Janko Tipsarevic,David Nalbandian,6-7(5); 4-6; 7-6(2); 6-0; 2-1,R128,199,20,10,84,142,61,84,26,58,10,16,21,87,142,14,12,79,146,57,79,21,67,12,21,22,78,146
2007-01-15 00:00:00.000,Australian Open Australia Grand Slams,HARD,3,Nicolas Lapentti,Alan Mackin,Nicolas Lapentti,6-4; 6-4; 6-2,R128,134,2,2,64,97,45,64,17,33,8,10,14,62,97,1,9,58,95,35,58,15,37,9,15,14,50,95
2007-01-15 00:00:00.000,Australian Open Australia Grand Slams,HARD,3,Olivier Rochus,Chris Guccione,Olivier Rochus,3-6; 7-5; 7-5; 6-7(4); 9-7,R128,237,6,6,108,170,92,108,36,62,10,11,30,128,170,45,3,131,206,106,131,32,75,9,12,31,138,206
2007-01-15 00:00:00.000,Australian Open Australia Grand Slams,HARD,3,Sebastien Grosjean,Christophe Rochus,Sebastien Grosjean,6-2; 4-1 RET,R128,54,7,2,13,31,13,13,15,18,0,0,7,28,31,0,3,43,58,24,43,5,15,7,10,6,29,58
2007-01-15 00:00:00.000,Australian Open Australia Grand Slams,HARD,3,Florian Mayer,Robin Soderling,Florian Mayer,3-6; 6-4; 3-6; 6-4; 6-0,R128,139,12,0,74,125,55,74,27,51,3,7,22,82,125,11,9,86,134,64,86,19,48,7,13,22,83,134
2007-01-15 00:00:00.000,Australian Open Australia Grand Slams,HARD,3,Andreas Seppi,Bobby Reynolds,Andreas Seppi,6-1; 6-7(4); 6-7(5); 7-6; 6-3,R128,239,23,10,84,168,69,84,49,84,5,7,27,118,168,21,8,90,167,69,90,32,77,5,10,25,101,167
2007-01-15 00:00:00.000,Australian Open Australia Grand Slams,HARD,3,Ilija Bozoljac,Marin Cilic,Ilija Bozoljac,6-2; 6-4; 6-1,R128,79,4,2,39,63,32,39,18,24,0,0,12,50,63,6,6,33,74,28,33,12,41,2,8,13,40,74
2007-01-15 00:00:00.000,Australian Open Australia Grand Slams,HARD,3,Tommy Haas,Albert Montanes,Tommy Haas,7-5; 6-1; 7-6(3),R128,110,17,4,56,81,47,56,18,25,0,1,16,65,81,5,3,68,100,45,68,13,32,8,12,15,58,100
2007-01-15 00:00:00.000,Australian Open Australia Grand Slams,HARD,3,Tomas Berdych,Hyung-Taik Lee,Tomas Berdych,6-1; 6-2; 6-2,R128,90,10,3,35,74,31,35,22,39,7,8,12,53,74,4,3,41,60,19,41,4,19,1,8,11,23,60
2007-01-15 00:00:00.000,Australian Open Australia Grand Slams,HARD,3,Robert Smeets,Lukas Lacko,Robert Smeets,6-2; 3-6; 6-1; 6-4,R128,109,14,4,53,101,46,53,27,48,5,6,17,73,101,5,5,64,108,42,64,24,44,9,14,17,66,108
2007-01-15 00:00:00.000,Australian Open Australia Grand Slams,HARD,3,Max Mirnyi,Luis Horna,Max Mirnyi,7-6(4); 3-6; 2-6; 6-4; 6-4,R128,218,23,4,90,163,71,90,34,73,9,14,25,105,163,7,8,125,166,87,125,21,41,16,19,24,108,166
2007-01-15 00:00:00.000,Australian Open Australia Grand Slams,HARD,3,Dmitry Tursunov,Alexander Waske,Dmitry Tursunov,5-7; 6-4; 6-3; 6-4,R128,132,26,7,55,103,48,55,30,48,1,3,21,78,103,24,7,74,126,53,74,26,52,4,8,20,79,126
2007-01-15 00:00:00.000,Australian Open Australia Grand Slams,HARD,3,Arnaud Clement,Xavier Malisse,Arnaud Clement,6-3; 3-6; 7-5; 6-4,R128,167,11,2,64,116,48,64,29,52,2,6,20,77,116,14,2,60,116,40,60,31,56,5,11,20,71,116
2007-01-15 00:00:00.000,Australian Open Australia Grand Slams,HARD,3,Fabrice Santoro,Igor Kunitsyn,Fabrice Santoro,7-6(5); 6-3; 6-0,R128,117,11,5,46,89,39,46,20,43,3,5,13,59,89,3,4,56,100,32,56,18,44,6,13,14,50,100
2007-01-15 00:00:00.000,Australian Open Australia Grand Slams,HARD,3,Gilles Muller,Gaston Gaudio,Gilles Muller,6-0; 4-6; 6-2; 6-3,R128,121,24,3,61,93,49,61,19,32,3,4,17,68,93,5,9,56,98,36,56,18,42,1,7,16,54,98
2007-01-15 00:00:00.000,Australian Open Australia Grand Slams,HARD,3,Nikolay Davydenko,Sergio Roitman,Nikolay Davydenko,6-2; 7-5; 6-2,R128,118,12,6,55,85,44,55,15,30,1,2,14,59,85,2,2,57,92,32,57,17,35,10,16,14,49,92
2007-01-15 00:00:00.000,Australian Open Australia Grand Slams,HARD,3,James Blake,Carlos Moya,James Blake,7-6(8); 6-2; 6-4,R128,110,18,1,50,87,41,50,27,37,1,1,15,68,87,8,1,69,105,50,69,11,36,2,5,15,61,105
2007-01-15 00:00:00.000,Australian Open Australia Grand Slams,HARD,3,Alex Kuznetsov,Peter Luczak,Alex Kuznetsov,6-4; 5-7; 6-7(5); 6-1; 6-4,R128,212,26,5,102,162,80,102,30,60,7,11,26,110,162,13,1,97,148,70,97,23,51,10,17,25,93,148
2007-01-15 00:00:00.000,Australian Open Australia Grand Slams,HARD,3,Mischa Zverev,Michael Berrer,Mischa Zverev,6-4; 7-6(1); 3-6; 6-4,R128,180,16,3,92,142,64,92,28,50,14,18,21,92,142,10,15,77,131,57,77,21,54,4,8,20,78,131
2007-01-15 00:00:00.000,Australian Open Australia Grand Slams,HARD,3,Robby Ginepri,Nicolas Almagro,Robby Ginepri,4-6; 6-2; 4-6; 7-5; 6-3,R128,170,15,3,91,143,71,91,28,52,4,7,25,99,143,19,9,90,163,68,90,34,73,8,13,24,102,163
2007-01-15 00:00:00.000,Australian Open Australia Grand Slams,HARD,3,Lleyton Hewitt,Michael Russell,Lleyton Hewitt,3-6; 2-6; 6-3; 6-3; 6-3,R128,209,18,3,61,120,47,61,31,59,3,9,22,78,120,6,1,99,131,63,99,13,32,2,9,22,76,131
2007-01-15 00:00:00.000,Australian Open Australia Grand Slams,HARD,3,Frank Dancevic,Victor Hanescu,Frank Dancevic,6-3; 6-3; 7-6(3),R128,113,25,3,55,87,46,55,17,32,2,3,15,63,87,4,0,80,111,51,80,15,31,6,10,15,66,111
2007-01-15 00:00:00.000,Australian Open Australia Grand Slams,HARD,3,Juan Martin Del Potro,Alessio Di Mauro,Juan Martin Del Potro,6-3; 6-3; 6-1,R128,100,0,2,48,70,35,48,17,22,3,4,13,52,70,5,4,37,72,21,37,15,35,4,10,12,36,72
2007-01-15 00:00:00.000,Australian Open Australia Grand Slams,HARD,3,Fernando Gonzalez,Evgeny Korolev,Fernando Gonzalez,6-7(4); 7-6(6); 6-3; 6-2,R128,145,11,1,82,129,69,82,30,47,2,2,21,99,129,14,5,80,116,66,80,19,36,2,5,20,85,116
2007-01-15 00:00:00.000,Australian Open Australia Grand Slams,HARD,3,Andy Murray,Alberto Martin,Andy Murray,6-0; 6-0; 6-1,R128,70,3,3,25,53,22,25,19,28,0,0,10,41,53,1,3,28,58,11,28,10,30,7,15,9,21,58
2007-01-15 00:00:00.000,Australian Open Australia Grand Slams,HARD,3,Fernando Verdasco,Paul-Henri Mathieu,Fernando Verdasco,6-7; 4-6; 6-6(1) RET,R128,180,17,2,80,132,50,80,35,52,14,16,17,85,132,5,4,67,115,54,67,26,48,5,6,17,80,115
2007-01-15 00:00:00.000,Australian Open Australia Grand Slams,HARD,3,Juan Ignacio Chela,Potito Starace,Juan Ignacio Chela,7-6(5); 6-4; 6-4,R128,141,2,0,53,94,36,53,28,41,3,6,16,64,94,1,2,74,110,49,74,16,36,8,13,16,65,110
2007-01-15 00:00:00.000,Australian Open Australia Grand Slams,HARD,3,Jarkko Nieminen,Paul Goldstein,Jarkko Nieminen,5-7; 6-2; 7-6(4); 6-4,R128,182,9,10,81,144,58,81,26,63,11,17,21,84,144,9,5,66,135,43,66,32,69,7,15,21,75,135
2007-01-15 00:00:00.000,Australian Open Australia Grand Slams,HARD,3,Stanislas Wawrinka,Kevin Kim,Stanislas Wawrinka,6-1; 2-6; 6-4; 6-2,R128,131,14,4,73,114,48,73,22,41,10,14,17,70,114,2,1,58,91,39,58,9,33,3,10,16,48,91
2007-01-15 00:00:00.000,Australian Open Australia Grand Slams,HARD,3,Paul Capdeville,Julien Benneteau,Paul Capdeville,4-6; 6-7(4); 6-2; 6-1; 6-2,R128,215,14,8,92,153,57,92,26,61,6,16,23,83,153,3,18,102,149,53,102,12,47,9,24,22,65,149
2007-01-15 00:00:00.000,Australian Open Australia Grand Slams,HARD,3,Philipp Kohlschreiber,Kristof Vliegen,Philipp Kohlschreiber,5-7; 6-3; 6-2; 6-4,R128,174,11,3,75,123,57,75,25,48,8,10,19,82,123,11,3,87,140,59,87,23,53,14,20,20,82,140
2007-01-15 00:00:00.000,Australian Open Australia Grand Slams,HARD,3,Rafael Nadal,Robert Kendrick,Rafael Nadal,7-6(6); 6-3; 6-2,R128,127,7,2,53,87,40,53,24,34,0,0,15,64,87,7,6,56,98,42,56,16,42,4,7,14,58,98
2007-01-15 00:00:00.000,Australian Open Australia Grand Slams,HARD,3,Roger Federer,Jonas Bjorkman,Roger Federer,6-2; 6-3; 6-2,R64,95,7,1,42,66,31,42,16,24,0,2,13,47,66,2,3,52,86,27,52,13,34,5,12,12,40,86
2007-01-15 00:00:00.000,Australian Open Australia Grand Slams,HARD,3,Mikhail Youzhny,Yen-Hsun Lu,Mikhail Youzhny,7-5; 6-4; 6-4,R64,157,8,6,49,105,38,49,26,56,8,12,16,64,105,4,6,53,103,31,53,23,50,8,15,16,54,103
2007-01-15 00:00:00.000,Australian Open Australia Grand Slams,HARD,3,Danai Udomchoke,Juan Carlos Ferrero,Danai Udomchoke,7-6(0); 7-5; 4-6; 6-1,R64,203,7,11,95,163,69,95,33,68,9,13,21,102,163,6,3,96,145,61,96,20,49,14,20,20,81,145
2007-01-15 00:00:00.000,Australian Open Australia Grand Slams,HARD,3,Novak Djokovic,Feliciano Lopez,Novak Djokovic,6-2; 7-5; 6-1,R64,121,8,1,59,86,41,59,18,27,4,5,14,59,86,5,6,53,90,34,53,12,37,9,15,13,46,90
2007-01-15 00:00:00.000,Australian Open Australia Grand Slams,HARD,3,Gael Monfils,Marcos Baghdatis,Gael Monfils,7-6(5); 6-2; 2-6; 6-0,R64,157,11,4,65,115,45,65,27,50,6,9,17,72,115,6,2,59,110,43,59,23,51,11,17,17,66,110
2007-01-15 00:00:00.000,Australian Open Australia Grand Slams,HARD,3,Richard Gasquet,Amer Delic,Richard Gasquet,6-1; 6-2; 6-4,R64,82,5,1,48,73,41,48,16,25,4,4,13,57,73,6,3,35,68,21,35,14,33,2,7,12,35,68
2007-01-15 00:00:00.000,Australian Open Australia Grand Slams,HARD,3,Sam Querrey,Florent Serra,Sam Querrey,6-3; 6-4; 6-3,R64,104,16,4,46,76,39,46,19,30,0,0,14,58,76,5,3,70,107,46,70,15,37,8,12,14,61,107
2007-01-15 00:00:00.000,Australian Open Australia Grand Slams,HARD,3,Tommy Robredo,Jurgen Melzer,Tommy Robredo,6-1; 6-3; 6-3,R64,98,5,1,54,81,38,54,14,27,3,5,13,52,81,1,4,53,79,24,53,11,26,7,14,12,35,79
2007-01-15 00:00:00.000,Australian Open Australia Grand Slams,HARD,3,Mardy Fish,Nicolas Mahut,Mardy Fish,7-5; 6-4; 3-6; 6-4,R64,175,17,3,67,127,58,67,26,60,3,6,21,84,127,8,7,67,127,49,67,31,60,7,11,20,80,127
2007-01-15 00:00:00.000,Australian Open Australia Grand Slams,HARD,3,Wayne Arthurs,Zack Fleishman,Wayne Arthurs,6-7(5); 6-1; 6-4; 6-4,R64,140,26,8,77,120,62,77,23,43,3,4,20,85,120,11,12,53,113,44,53,28,60,3,8,19,72,113
2007-01-15 00:00:00.000,Australian Open Australia Grand Slams,HARD,3,Radek Stepanek,Lukas Dlouhy,Radek Stepanek,4-6; 4-6; 6-4; 6-1; 6-4,R64,165,16,1,103,157,72,103,30,54,10,14,24,102,157,12,3,82,129,64,82,20,47,5,11,23,84,129
2007-01-15 00:00:00.000,Australian Open Australia Grand Slams,HARD,3,David Ferrer,Thomas Johansson,David Ferrer,6-2; 6-7(5); 6-2; 6-2,R64,145,5,0,67,109,49,67,27,42,3,4,18,76,109,9,5,57,108,42,57,21,51,6,13,18,63,108
2007-01-15 00:00:00.000,Australian Open Australia Grand Slams,HARD,3,Mario Ancic,Guillermo Garcia-Lopez,Mario Ancic,3-6; 7-5; 6-2; 6-2,R64,157,8,3,75,107,50,75,19,32,2,6,19,69,107,2,3,67,111,41,67,22,44,5,12,18,63,111
2007-01-15 00:00:00.000,Australian Open Australia Grand Slams,HARD,3,Dominik Hrbaty,Vincent Spadea,Dominik Hrbaty,6-7; 6-4; 6-4; 6-3,R64,173,4,2,69,127,48,69,30,58,9,13,20,78,127,4,7,91,156,58,91,29,65,18,25,21,87,156
2007-01-15 00:00:00.000,Australian Open Australia Grand Slams,HARD,3,Marat Safin,Dudi Sela,Marat Safin,6-3; 5-7; 4-6; 7-6(4); 6-0,R64,201,13,6,107,164,68,107,28,57,11,20,25,96,164,1,8,81,144,48,81,32,63,11,22,24,80,144
2007-01-15 00:00:00.000,Australian Open Australia Grand Slams,HARD,3,Andy Roddick,Marc Gicquel,Andy Roddick,6-3; 7-6(4); 6-4,R64,116,18,2,62,93,52,62,19,31,3,3,16,71,93,10,2,47,90,38,47,23,43,4,6,15,61,90
2007-01-15 00:00:00.000,Australian Open Australia Grand Slams,HARD,3,David Nalbandian,Nicolas Lapentti,David Nalbandian,6-4; 6-4; 6-4,R64,116,4,2,49,79,42,49,19,30,2,2,15,61,79,5,2,59,87,42,59,16,28,4,7,15,58,87
2007-01-15 00:00:00.000,Australian Open Australia Grand Slams,HARD,3,Sebastien Grosjean,Olivier Rochus,Sebastien Grosjean,4-6; 6-1; 6-3; 4-6; 6-4,R64,242,20,0,77,153,61,77,37,76,11,15,23,98,153,4,7,114,166,73,114,23,52,15,22,23,96,166
2007-01-15 00:00:00.000,Australian Open Australia Grand Slams,HARD,3,Florian Mayer,Andreas Seppi,Florian Mayer,5-7; 7-5; 6-2; 6-2,R64,146,8,5,66,126,43,66,30,60,6,12,20,73,126,6,3,63,119,38,63,23,56,9,19,20,61,119
2007-01-15 00:00:00.000,Australian Open Australia Grand Slams,HARD,3,Tommy Haas,Ilija Bozoljac,Tommy Haas,7-6(3); 6-1; 6-3,R64,103,18,1,58,76,50,58,12,18,0,0,14,62,76,18,9,44,93,36,44,19,49,5,9,14,55,93
2007-01-15 00:00:00.000,Australian Open Australia Grand Slams,HARD,3,Tomas Berdych,Robert Smeets,Tomas Berdych,6-3; 6-2; 6-4,R64,115,4,4,64,99,49,64,17,35,8,9,14,66,99,11,7,57,105,40,57,16,48,14,19,13,56,105
2007-01-15 00:00:00.000,Australian Open Australia Grand Slams,HARD,3,Dmitry Tursunov,Max Mirnyi,Dmitry Tursunov,6-2; 6-3; 7-6(4),R64,132,9,5,55,104,46,55,25,49,4,5,15,71,104,9,3,66,99,43,66,14,33,5,9,14,57,99
2007-01-15 00:00:00.000,Australian Open Australia Grand Slams,HARD,3,Fabrice Santoro,Arnaud Clement,Fabrice Santoro,6-2; 6-4; 6-4,R64,129,13,2,40,83,33,40,29,43,2,2,14,62,83,1,1,55,84,37,55,12,29,7,11,14,49,84
2007-01-15 00:00:00.000,Australian Open Australia Grand Slams,HARD,3,Nikolay Davydenko,Gilles Muller,Nikolay Davydenko,6-4; 6-0; 6-3,R64,101,7,0,53,79,39,53,16,26,2,2,12,55,79,15,2,58,87,34,58,12,29,4,10,13,46,87
2007-01-15 00:00:00.000,Australian Open Australia Grand Slams,HARD,3,James Blake,Alex Kuznetsov,James Blake,6-4; 6-1; 6-2,R64,82,6,1,42,69,32,42,17,27,0,2,13,49,69,9,4,44,74,30,44,6,30,4,11,12,36,74
2007-01-15 00:00:00.000,Australian Open Australia Grand Slams,HARD,3,Robby Ginepri,Mischa Zverev,Robby Ginepri,6-4; 7-5; 6-1,R64,123,10,2,65,100,49,65,17,35,5,6,15,66,100,9,4,86,130,56,86,17,44,15,20,14,73,130
2007-01-15 00:00:00.000,Australian Open Australia Grand Slams,HARD,3,Lleyton Hewitt,Frank Dancevic,Lleyton Hewitt,6-4; 6-4; 3-6; 6-4,R64,168,14,12,56,118,45,56,31,62,4,7,19,76,118,16,6,59,112,44,59,26,53,1,6,20,70,112
2007-01-15 00:00:00.000,Australian Open Australia Grand Slams,HARD,3,Fernando Gonzalez,Juan Martin Del Potro,Fernando Gonzalez,7-6(7); 4-6; 6-7(3); 6-4; 4-0 RET,R64,206,18,4,89,147,71,89,27,58,3,7,24,98,147,11,6,96,161,64,96,35,65,4,10,24,99,161
2007-01-15 00:00:00.000,Australian Open Australia Grand Slams,HARD,3,Andy Murray,Fernando Verdasco,Andy Murray,7-6(4); 7-5; 6-4,R64,168,4,0,57,109,38,57,26,52,3,8,17,64,109,7,7,69,109,42,69,14,40,10,17,17,56,109
2007-01-15 00:00:00.000,Australian Open Australia Grand Slams,HARD,3,Juan Ignacio Chela,Jarkko Nieminen,Juan Ignacio Chela,6-3; 2-6; 6-4; 6-4,R64,160,6,3,65,111,47,65,26,46,4,8,19,73,111,4,2,68,114,47,68,22,46,7,12,18,69,114
2007-01-15 00:00:00.000,Australian Open Australia Grand Slams,HARD,3,Stanislas Wawrinka,Paul Capdeville,Stanislas Wawrinka,6-4; 6-3; 6-2,R64,99,21,2,52,80,44,52,14,28,1,2,14,58,80,5,1,53,76,35,53,9,23,4,9,13,44,76
2007-01-15 00:00:00.000,Australian Open Australia Grand Slams,HARD,3,Rafael Nadal,Philipp Kohlschreiber,Rafael Nadal,7-5; 6-3; 4-6; 6-2,R64,210,4,6,81,125,57,81,22,44,9,13,20,79,125,8,3,68,128,41,68,30,60,14,21,19,71,128
2007-01-15 00:00:00.000,Australian Open Australia Grand Slams,HARD,3,Roger Federer,Mikhail Youzhny,Roger Federer,6-3; 6-3; 7-6(5),R32,124,7,1,53,100,44,53,25,47,3,4,15,69,100,7,1,55,101,43,55,18,46,4,8,15,61,101
2007-01-15 00:00:00.000,Australian Open Australia Grand Slams,HARD,3,Novak Djokovic,Danai Udomchoke,Novak Djokovic,6-3; 6-4; 5-7; 6-1,R32,165,15,1,90,121,61,90,17,31,6,9,19,78,121,1,4,64,121,41,64,27,57,8,15,19,68,121
2007-01-15 00:00:00.000,Australian Open Australia Grand Slams,HARD,3,Richard Gasquet,Gael Monfils,Richard Gasquet,6-0; 4-6; 7-5; 6-3,R32,146,6,2,76,100,60,76,14,24,5,7,19,74,100,9,3,68,105,43,68,19,37,3,9,18,62,105
2007-01-15 00:00:00.000,Australian Open Australia Grand Slams,HARD,3,Tommy Robredo,Sam Querrey,Tommy Robredo,6-4; 6-7(5); 6-2; 6-1,R32,143,18,2,77,112,60,77,24,35,2,2,19,84,112,9,0,63,106,47,63,19,43,3,8,18,66,106
2007-01-15 00:00:00.000,Australian Open Australia Grand Slams,HARD,3,Mardy Fish,Wayne Arthurs,Mardy Fish,3-0 RET,R32,6,3,0,3,4,3,3,1,1,0,0,1,4,4,0,2,5,10,1,5,1,5,1,3,2,2,10
2007-01-15 00:00:00.000,Australian Open Australia Grand Slams,HARD,3,David Ferrer,Radek Stepanek,David Ferrer,6-7(5); 4-6; 6-0; 6-4; 6-3,R32,231,3,1,106,162,77,106,21,56,7,13,24,98,162,9,8,104,176,69,104,26,72,19,29,23,95,176
2007-01-15 00:00:00.000,Australian Open Australia Grand Slams,HARD,3,Mario Ancic,Dominik Hrbaty,Mario Ancic,6-3; 6-2; 6-1,R32,103,13,0,58,76,43,58,9,18,5,6,12,52,76,0,3,38,75,18,38,15,37,1,8,12,33,75
2007-01-15 00:00:00.000,Australian Open Australia Grand Slams,HARD,3,Andy Roddick,Marat Safin,Andy Roddick,7-6(2); 2-6; 6-4; 7-6(2),R32,192,14,2,81,124,59,81,25,43,3,7,21,84,124,22,2,85,139,63,85,25,54,9,12,21,88,139
2007-01-15 00:00:00.000,Australian Open Australia Grand Slams,HARD,3,David Nalbandian,Sebastien Grosjean,David Nalbandian,5-7; 4-6; 7-6(4); 6-4; 6-1,R32,236,14,6,113,180,77,113,33,67,13,20,26,110,180,15,2,88,167,65,88,29,79,14,22,25,94,167
2007-01-15 00:00:00.000,Australian Open Australia Grand Slams,HARD,3,Tommy Haas,Florian Mayer,Tommy Haas,7-6(3); 6-3; 6-3,R32,125,6,2,64,97,48,64,17,33,4,6,15,65,97,10,2,71,118,41,71,23,47,5,10,15,64,118
2007-01-15 00:00:00.000,Australian Open Australia Grand Slams,HARD,3,Tomas Berdych,Dmitry Tursunov,Tomas Berdych,6-2; 6-1; 6-1,R32,83,8,2,34,58,30,34,14,24,0,0,11,44,58,5,6,40,77,20,40,14,37,6,13,11,34,77
2007-01-15 00:00:00.000,Australian Open Australia Grand Slams,HARD,3,Nikolay Davydenko,Fabrice Santoro,Nikolay Davydenko,7-6(1); 6-2; 6-2,R32,124,6,2,57,92,43,57,22,35,1,2,14,65,92,4,1,44,88,28,44,22,44,3,8,14,50,88
2007-01-15 00:00:00.000,Australian Open Australia Grand Slams,HARD,3,James Blake,Robby Ginepri,James Blake,7-6(7); 7-5; 6-2,R32,113,10,3,55,87,44,55,21,32,1,4,16,65,87,5,0,66,113,41,66,26,47,7,13,16,67,113
2007-01-15 00:00:00.000,Australian Open Australia Grand Slams,HARD,3,Fernando Gonzalez,Lleyton Hewitt,Fernando Gonzalez,6-2; 6-2; 5-7; 6-4,R32,160,19,3,67,102,49,67,23,35,1,3,19,72,102,17,7,75,129,58,75,18,54,13,19,19,76,129
2007-01-15 00:00:00.000,Australian Open Australia Grand Slams,HARD,3,Andy Murray,Juan Ignacio Chela,Andy Murray,6-3; 6-2; 6-4,R32,110,9,2,61,86,42,61,12,25,2,4,14,54,86,3,4,64,95,39,64,9,31,9,15,13,48,95
2007-01-15 00:00:00.000,Australian Open Australia Grand Slams,HARD,3,Rafael Nadal,Stanislas Wawrinka,Rafael Nadal,6-2; 6-2; 6-2,R32,123,1,3,51,69,43,51,7,18,0,1,12,50,69,4,2,52,92,30,52,13,40,4,11,12,43,92
2007-01-15 00:00:00.000,Australian Open Australia Grand Slams,HARD,3,Roger Federer,Novak Djokovic,Roger Federer,6-2; 7-5; 6-3,R16,110,12,1,50,80,40,50,20,30,1,2,15,60,80,7,2,62,101,38,62,18,39,3,8,14,56,101
2007-01-15 00:00:00.000,Australian Open Australia Grand Slams,HARD,3,Tommy Robredo,Richard Gasquet,Tommy Robredo,6-4; 6-2; 3-6; 6-4,R16,167,8,1,65,103,51,65,21,38,2,3,18,72,103,1,2,114,147,68,114,18,33,17,21,19,86,147
2007-01-15 00:00:00.000,Australian Open Australia Grand Slams,HARD,3,Mardy Fish,David Ferrer,Mardy Fish,6-1; 7-6(4); 2-6; 7-5,R16,150,15,5,65,125,49,65,34,60,2,5,20,83,125,7,1,78,113,53,78,17,35,1,5,19,70,113
2007-01-15 00:00:00.000,Australian Open Australia Grand Slams,HARD,3,Andy Roddick,Mario Ancic,Andy Roddick,6-3; 3-6; 6-1; 5-7; 6-4,R16,183,16,1,91,132,72,91,20,41,1,4,24,92,132,21,3,84,131,61,84,28,47,9,14,23,89,131
2007-01-15 00:00:00.000,Australian Open Australia Grand Slams,HARD,3,Tommy Haas,David Nalbandian,Tommy Haas,4-6; 6-3; 6-2; 6-3,R16,149,16,2,80,113,61,80,15,33,5,7,18,76,113,9,6,65,118,41,65,26,53,5,11,18,67,118
2007-01-15 00:00:00.000,Australian Open Australia Grand Slams,HARD,3,Nikolay Davydenko,Tomas Berdych,Nikolay Davydenko,5-7; 6-4; 6-1; 7-6(5),R16,180,8,5,74,128,56,74,30,54,9,12,20,86,128,6,7,73,129,50,73,26,56,8,14,21,76,129
2007-01-15 00:00:00.000,Australian Open Australia Grand Slams,HARD,3,Fernando Gonzalez,James Blake,Fernando Gonzalez,7-5; 6-4; 7-6(4),R16,126,18,1,71,102,53,71,17,31,5,8,17,70,102,8,6,55,111,41,55,26,56,8,13,17,67,111
2007-01-15 00:00:00.000,Australian Open Australia Grand Slams,HARD,3,Rafael Nadal,Andy Murray,Rafael Nadal,6-7(3); 6-4; 4-6; 6-3; 6-1,R16,231,5,1,113,155,78,113,23,42,14,17,24,101,155,15,9,84,160,62,84,33,76,9,16,24,95,160
2007-01-15 00:00:00.000,Australian Open Australia Grand Slams,HARD,3,Roger Federer,Tommy Robredo,Roger Federer,6-3; 7-6(2); 7-5,Q,140,5,1,60,96,43,60,21,36,4,8,17,64,96,4,4,71,117,45,71,17,46,6,12,16,62,117
2007-01-15 00:00:00.000,Australian Open Australia Grand Slams,HARD,3,Andy Roddick,Mardy Fish,Andy Roddick,6-2; 6-2; 6-2,Q,87,10,2,38,61,35,38,12,23,0,1,12,47,61,12,5,31,70,20,31,12,39,6,13,12,32,70
2007-01-15 00:00:00.000,Australian Open Australia Grand Slams,HARD,3,Tommy Haas,Nikolay Davydenko,Tommy Haas,6-3; 2-6; 1-6; 6-1; 7-5,Q,199,9,8,78,132,54,78,26,54,4,10,22,80,132,5,2,94,134,58,94,22,40,10,16,21,80,134
2007-01-15 00:00:00.000,Australian Open Australia Grand Slams,HARD,3,Fernando Gonzalez,Rafael Nadal,Fernando Gonzalez,6-2; 6-4; 6-3,Q,125,10,0,55,83,40,55,17,28,3,3,13,57,83,1,2,56,79,39,56,8,23,3,8,14,47,79
2007-01-15 00:00:00.000,Australian Open Australia Grand Slams,HARD,3,Roger Federer,Andy Roddick,Roger Federer,6-4; 6-0; 6-2,S,83,10,2,32,63,26,32,21,31,0,1,12,47,63,4,2,41,65,22,41,7,24,0,7,12,29,65
2007-01-15 00:00:00.000,Australian Open Australia Grand Slams,HARD,3,Fernando Gonzalez,Tommy Haas,Fernando Gonzalez,6-1; 6-3; 6-1,S,91,9,0,38,60,33,38,14,22,0,0,11,47,60,0,4,40,67,25,40,7,27,5,12,12,32,67
2007-01-15 00:00:00.000,Australian Open Australia Grand Slams,HARD,3,Roger Federer,Fernando Gonzalez,Roger Federer,7-6(2); 6-4; 6-4,F,140,5,1,50,86,41,50,28,36,0,1,16,69,86,6,3,77,127,53,77,23,50,7,10,16,76,127
2007-01-29 00:00:00.000,Zagreb Croatia ATP World Tour,HARD,2,Ivan Ljubicic,Roko Karanusic,Ivan Ljubicic,6-4; 6-3,R32,68,9,4,30,58,26,30,14,28,2,2,9,40,58,4,1,32,55,22,32,12,23,1,4,10,34,55
2007-01-29 00:00:00.000,Zagreb Croatia ATP World Tour,HARD,2,Stefan Koubek,Feliciano Lopez,Stefan Koubek,2-6; 7-6(2); 6-4,R32,107,9,3,58,98,44,58,21,40,3,5,15,65,98,14,2,54,89,40,54,22,35,5,6,15,62,89
2007-01-29 00:00:00.000,Zagreb Croatia ATP World Tour,HARD,2,Thomas Johansson,Janko Tipsarevic,Thomas Johansson,6-4; 6-4,R32,66,13,3,36,51,32,36,9,15,1,1,10,41,51,6,1,36,64,25,36,15,28,5,7,10,40,64
2007-01-29 00:00:00.000,Zagreb Croatia ATP World Tour,HARD,2,Daniele Bracciali,Julien Benneteau,Daniele Bracciali,7-5; 7-6(4),R32,106,14,1,33,72,30,33,23,39,4,5,12,53,72,7,4,52,79,38,52,13,27,2,4,12,51,79
2007-01-29 00:00:00.000,Zagreb Croatia ATP World Tour,HARD,2,Mikhail Youzhny,Nicolas Mahut,Mikhail Youzhny,7-6(4); 6-3,R32,87,9,1,33,67,30,33,22,34,0,0,11,52,67,3,3,37,63,27,37,17,26,2,3,10,44,63
2007-01-29 00:00:00.000,Zagreb Croatia ATP World Tour,HARD,2,Tomas Cakl,Potito Starace,Tomas Cakl,6-4; 6-7(10); 6-4,R32,131,13,5,47,113,37,47,36,66,4,6,16,73,113,7,2,57,106,44,57,22,49,8,12,16,66,106
2007-01-29 00:00:00.000,Zagreb Croatia ATP World Tour,HARD,2,Fabrice Santoro,Guillermo Canas,Fabrice Santoro,5-7; 6-3; 6-2,R32,122,13,0,57,85,44,57,14,28,0,2,15,58,85,3,3,45,87,32,45,17,42,3,7,14,49,87
2007-01-29 00:00:00.000,Zagreb Croatia ATP World Tour,HARD,2,Marc Gicquel,Fernando Verdasco,Marc Gicquel,6-4; 7-6(7),R32,88,6,1,40,69,30,40,20,29,3,4,11,50,69,5,4,48,77,34,48,15,29,1,3,11,49,77
2007-01-29 00:00:00.000,Zagreb Croatia ATP World Tour,HARD,2,Michael Llodra,Kristof Vliegen,Michael Llodra,6-7(3); 7-6(6); 6-3,R32,124,7,1,88,97,69,88,7,9,0,0,17,76,97,14,1,66,107,53,66,24,41,6,7,16,77,107
2007-01-29 00:00:00.000,Zagreb Croatia ATP World Tour,HARD,2,Ivo Karlovic,Jiri Vanek,Ivo Karlovic,6-3; 6-2,R32,50,20,0,30,38,28,30,8,8,0,0,9,36,38,0,2,21,47,15,21,12,26,2,5,8,27,47
2007-01-29 00:00:00.000,Zagreb Croatia ATP World Tour,HARD,2,Alexander Peya,Andreas Seppi,Alexander Peya,1-6; 7-6(8); 6-4,R32,115,7,6,58,95,45,58,14,37,3,6,14,59,95,9,4,61,97,48,61,18,36,6,8,15,66,97
2007-01-29 00:00:00.000,Zagreb Croatia ATP World Tour,HARD,2,Robin Soderling,Gilles Simon,Robin Soderling,3-6; 7-6(5); 7-6(4),R32,113,13,4,64,97,57,64,15,33,4,6,16,72,97,4,4,61,105,43,61,30,44,3,4,17,73,105
2007-01-29 00:00:00.000,Zagreb Croatia ATP World Tour,HARD,2,Arnaud Clement,Marin Cilic,Arnaud Clement,6-4; 6-1,R32,57,3,2,23,43,20,23,14,20,0,0,8,34,43,6,3,26,45,18,26,6,19,1,5,9,24,45
2007-01-29 00:00:00.000,Zagreb Croatia ATP World Tour,HARD,2,Lukas Dlouhy,Bjorn Phau,Lukas Dlouhy,4-6; 6-2; 7-5,R32,112,10,4,48,99,33,48,29,51,7,10,15,62,99,5,7,59,102,41,59,18,43,6,11,15,59,102
2007-01-29 00:00:00.000,Zagreb Croatia ATP World Tour,HARD,2,Frank Dancevic,Alexander Waske,Frank Dancevic,6-3; 7-6(4),R32,73,13,0,36,56,33,36,17,20,0,0,11,50,56,15,3,35,64,31,35,14,29,4,5,10,45,64
2007-01-29 00:00:00.000,Zagreb Croatia ATP World Tour,HARD,2,Marcos Baghdatis,Florent Serra,Marcos Baghdatis,6-2; 7-6(5),R32,79,15,3,44,67,37,44,10,23,6,7,10,47,67,7,3,41,72,29,41,12,31,1,4,10,41,72
2007-01-29 00:00:00.000,Zagreb Croatia ATP World Tour,HARD,2,Ivan Ljubicic,Stefan Koubek,Ivan Ljubicic,7-6(6); 6-7(5); 6-4,R16,148,26,4,61,101,57,61,20,40,0,0,17,77,101,8,7,69,119,55,69,27,50,6,7,17,82,119
2007-01-29 00:00:00.000,Zagreb Croatia ATP World Tour,HARD,2,Thomas Johansson,Daniele Bracciali,Thomas Johansson,6-3; 1-0 RET,R16,45,9,0,14,26,12,14,9,12,0,0,5,21,26,5,5,22,43,16,22,6,21,3,5,5,22,43
2007-01-29 00:00:00.000,Zagreb Croatia ATP World Tour,HARD,2,Mikhail Youzhny,Tomas Cakl,Mikhail Youzhny,6-4; 6-2,R16,63,9,1,32,51,28,32,8,19,1,2,9,36,51,5,3,31,67,21,31,15,36,3,7,9,36,67
2007-01-29 00:00:00.000,Zagreb Croatia ATP World Tour,HARD,2,Marc Gicquel,Fabrice Santoro,Marc Gicquel,6-4; 3-6; 6-4,R16,116,6,2,39,88,30,39,30,49,5,6,14,60,88,11,1,40,83,36,40,23,43,3,5,15,59,83
2007-01-29 00:00:00.000,Zagreb Croatia ATP World Tour,HARD,2,Michael Llodra,Ivo Karlovic,Michael Llodra,6-4; 7-6(8),R16,86,3,0,47,63,41,47,12,16,3,3,11,53,63,18,3,53,73,43,53,10,20,3,4,11,53,73
2007-01-29 00:00:00.000,Zagreb Croatia ATP World Tour,HARD,2,Alexander Peya,Robin Soderling,Alexander Peya,7-5; 4-6; 6-2,R16,105,11,1,78,104,59,78,8,26,5,7,15,67,104,12,2,52,79,40,52,12,27,4,8,15,52,79
2007-01-29 00:00:00.000,Zagreb Croatia ATP World Tour,HARD,2,Arnaud Clement,Lukas Dlouhy,Arnaud Clement,6-4; 7-6(5),R16,102,6,1,36,70,32,36,20,34,2,3,11,52,70,5,7,50,93,38,50,17,43,5,7,11,55,93
2007-01-29 00:00:00.000,Zagreb Croatia ATP World Tour,HARD,2,Marcos Baghdatis,Frank Dancevic,Marcos Baghdatis,7-6(1); 6-3,R16,78,11,2,38,72,31,38,20,34,2,3,11,51,72,9,2,39,60,30,39,8,21,2,4,10,38,60
2007-01-29 00:00:00.000,Zagreb Croatia ATP World Tour,HARD,2,Ivan Ljubicic,Thomas Johansson,Ivan Ljubicic,7-6(8); 6-7(8); 7-6(4),Q,166,28,5,74,120,66,74,26,46,3,4,18,92,120,17,6,59,112,55,59,33,53,1,2,18,88,112
2007-01-29 00:00:00.000,Zagreb Croatia ATP World Tour,HARD,2,Mikhail Youzhny,Marc Gicquel,Mikhail Youzhny,7-5; 6-2,Q,82,6,1,47,68,36,47,12,21,8,8,10,48,68,2,1,38,67,26,38,13,29,2,5,10,39,67
2007-01-29 00:00:00.000,Zagreb Croatia ATP World Tour,HARD,2,Alexander Peya,Michael Llodra,Alexander Peya,6-3; 6-3,Q,76,3,2,41,58,28,41,8,17,5,7,9,36,58,4,2,55,74,27,55,8,19,8,13,9,35,74
2007-01-29 00:00:00.000,Zagreb Croatia ATP World Tour,HARD,2,Marcos Baghdatis,Arnaud Clement,Marcos Baghdatis,6-2; 6-7(2); 7-6(5),Q,147,19,4,62,107,47,62,27,45,5,6,16,74,107,3,2,47,102,38,47,30,55,4,7,16,68,102
2007-01-29 00:00:00.000,Zagreb Croatia ATP World Tour,HARD,2,Ivan Ljubicic,Mikhail Youzhny,Ivan Ljubicic,2-6; 6-3; 7-5,S,121,16,5,48,86,41,48,15,38,4,7,15,56,86,2,2,46,79,32,46,19,33,1,4,14,51,79
2007-01-29 00:00:00.000,Zagreb Croatia ATP World Tour,HARD,2,Marcos Baghdatis,Alexander Peya,Marcos Baghdatis,6-4; 6-3,S,72,7,0,38,61,29,38,14,23,4,5,10,43,61,3,1,31,53,20,31,11,22,2,5,9,31,53
2007-01-29 00:00:00.000,Zagreb Croatia ATP World Tour,HARD,2,Marcos Baghdatis,Ivan Ljubicic,Marcos Baghdatis,7-6(4); 4-6; 6-4,F,151,16,2,75,115,57,75,21,40,5,6,16,78,115,11,1,64,106,51,64,22,42,5,6,16,73,106
2007-02-12 00:00:00.000,Costa Do Sauipe Brasil ATP World Tour,CLAY,2,Juan Carlos Ferrero,Sergio Roitman,Juan Carlos Ferrero,6-4; 6-4,R32,95,3,4,51,69,38,51,7,18,4,5,10,45,69,2,1,32,59,21,32,12,27,2,5,10,33,59
2007-02-12 00:00:00.000,Costa Do Sauipe Brasil ATP World Tour,CLAY,2,Nicolas Devilder,Rogerio Dutra Silva,Nicolas Devilder,6-1; 6-3,R32,77,2,0,35,48,26,35,8,13,0,0,8,34,48,2,2,30,56,18,30,10,26,2,6,8,28,56
2007-02-12 00:00:00.000,Costa Do Sauipe Brasil ATP World Tour,CLAY,2,Martin Vassallo Arguello,Olivier Patience,Martin Vassallo Arguello,6-4; 6-3,R32,94,5,0,49,75,34,49,15,26,6,6,9,49,75,3,3,40,56,25,40,8,16,1,4,10,33,56
2007-02-12 00:00:00.000,Costa Do Sauipe Brasil ATP World Tour,CLAY,2,Potito Starace,Gaston Gaudio,Potito Starace,6-4; 6-3,R32,76,2,1,41,51,30,41,6,10,1,3,10,36,51,2,5,33,55,19,33,10,22,2,6,9,29,55
2007-02-12 00:00:00.000,Costa Do Sauipe Brasil ATP World Tour,CLAY,2,Nicolas Almagro,Fernando Vicente,Nicolas Almagro,6-0; 6-1,R32,58,1,1,30,42,24,30,7,12,3,3,7,31,42,0,1,31,51,16,31,5,20,4,9,6,21,51
2007-02-12 00:00:00.000,Costa Do Sauipe Brasil ATP World Tour,CLAY,2,Lukas Dlouhy,Igor Andreev,Lukas Dlouhy,,R32,0,0,0,0,0,0,0,0,0,0,0,0,0,0,0,0,0,0,0,0,0,0,0,0,0,0,0
2007-02-12 00:00:00.000,Costa Do Sauipe Brasil ATP World Tour,CLAY,2,Flavio Saretta,Alessio Di Mauro,Flavio Saretta,6-1; 6-2,R32,74,1,3,26,50,22,26,12,24,5,6,8,34,50,3,2,21,43,10,21,9,22,3,8,7,19,43
2007-02-12 00:00:00.000,Costa Do Sauipe Brasil ATP World Tour,CLAY,2,Gustavo Kuerten,Filippo Volandri,Gustavo Kuerten,6-3; 6-1,R32,47,13,1,31,39,29,31,3,8,0,0,8,32,39,0,4,19,45,11,19,10,26,2,6,8,21,45
2007-02-12 00:00:00.000,Costa Do Sauipe Brasil ATP World Tour,CLAY,2,Juan Ignacio Chela,Alberto Martin,Juan Ignacio Chela,6-4; 6-2,R32,87,1,1,33,50,27,33,11,17,0,0,9,38,50,3,3,24,61,15,24,18,37,6,9,9,33,61
2007-02-12 00:00:00.000,Costa Do Sauipe Brasil ATP World Tour,CLAY,2,Ruben Ramirez Hidalgo,Stefano Galvani,Ruben Ramirez Hidalgo,7-6(4); 6-3,R32,111,5,3,39,66,32,39,14,27,4,5,10,46,66,1,6,46,84,31,46,18,38,4,7,11,49,84
2007-02-12 00:00:00.000,Costa Do Sauipe Brasil ATP World Tour,CLAY,2,Juan Monaco,Jiri Vanek,Juan Monaco,6-3; 4-6; 6-3,R32,130,4,1,53,80,35,53,14,27,4,8,14,49,80,7,4,61,101,38,61,16,40,8,14,14,54,101
2007-02-12 00:00:00.000,Costa Do Sauipe Brasil ATP World Tour,CLAY,2,Thiago Alves,Carlos Moya,Thiago Alves,2-6; 7-5; 6-3,R32,120,3,3,53,80,36,53,13,27,1,6,15,49,80,11,6,55,97,35,55,18,42,7,12,14,53,97
2007-02-12 00:00:00.000,Costa Do Sauipe Brasil ATP World Tour,CLAY,2,Albert Portas,Eduardo Schwank,Albert Portas,6-2; 6-2,R32,62,4,1,27,43,23,27,6,16,0,1,8,29,43,2,4,35,54,15,35,9,19,4,9,8,24,54
2007-02-12 00:00:00.000,Costa Do Sauipe Brasil ATP World Tour,CLAY,2,Guillermo Canas,Marcos Daniel,Guillermo Canas,6-1; 6-4,R32,71,5,3,37,54,31,37,9,17,0,0,9,40,54,1,2,24,41,16,24,7,17,2,5,8,23,41
2007-02-12 00:00:00.000,Costa Do Sauipe Brasil ATP World Tour,CLAY,2,Albert Montanes,Pablo Andujar,Albert Montanes,6-2; 7-6(6),R32,99,2,2,39,74,30,39,16,35,5,7,10,46,74,0,0,46,62,28,46,6,16,1,5,10,34,62
2007-02-12 00:00:00.000,Costa Do Sauipe Brasil ATP World Tour,CLAY,2,Agustin Calleri,Diego Hartfield,Agustin Calleri,6-4; 6-1,R32,72,4,3,27,49,21,27,12,22,2,3,8,33,49,3,3,43,59,24,43,4,16,2,7,9,28,59
2007-02-12 00:00:00.000,Costa Do Sauipe Brasil ATP World Tour,CLAY,2,Juan Carlos Ferrero,Nicolas Devilder,Juan Carlos Ferrero,6-2; 6-4,R16,101,4,1,45,64,33,45,8,19,11,12,9,41,64,1,2,39,72,26,39,11,33,8,12,9,37,72
2007-02-12 00:00:00.000,Costa Do Sauipe Brasil ATP World Tour,CLAY,2,Potito Starace,Martin Vassallo Arguello,Potito Starace,7-5; 6-3,R16,97,0,3,42,60,33,42,8,18,0,2,11,41,60,2,3,34,64,19,34,15,30,3,7,10,34,64
2007-02-12 00:00:00.000,Costa Do Sauipe Brasil ATP World Tour,CLAY,2,Nicolas Almagro,Lukas Dlouhy,Nicolas Almagro,6-3; 6-3,R16,59,8,5,40,53,34,40,5,13,2,2,9,39,53,5,2,32,53,21,32,9,21,3,6,9,30,53
2007-02-12 00:00:00.000,Costa Do Sauipe Brasil ATP World Tour,CLAY,2,Flavio Saretta,Gustavo Kuerten,Flavio Saretta,6-2; 3-6; 7-5,R16,179,5,4,49,90,37,49,19,41,5,7,14,56,90,8,2,53,87,39,53,15,34,2,6,15,54,87
2007-02-12 00:00:00.000,Costa Do Sauipe Brasil ATP World Tour,CLAY,2,Juan Ignacio Chela,Ruben Ramirez Hidalgo,Juan Ignacio Chela,6-2; 6-3,R16,101,0,3,28,53,20,28,12,25,4,6,8,32,53,1,3,39,75,17,39,16,36,4,10,9,33,75
2007-02-12 00:00:00.000,Costa Do Sauipe Brasil ATP World Tour,CLAY,2,Juan Monaco,Thiago Alves,Juan Monaco,6-2; 6-3,R16,55,5,0,24,41,21,24,15,17,0,0,9,36,41,4,1,31,48,22,31,7,17,3,6,8,29,48
2007-02-12 00:00:00.000,Costa Do Sauipe Brasil ATP World Tour,CLAY,2,Guillermo Canas,Albert Portas,Guillermo Canas,6-4; 6-0,R16,74,6,0,25,38,22,25,8,13,0,1,8,30,38,4,1,21,47,10,21,11,26,3,8,8,21,47
2007-02-12 00:00:00.000,Costa Do Sauipe Brasil ATP World Tour,CLAY,2,Agustin Calleri,Albert Montanes,Agustin Calleri,3-6; 6-3; 6-4,R16,108,9,4,35,72,27,35,19,37,2,6,14,46,72,0,5,57,95,32,57,21,38,5,10,14,53,95
2007-02-12 00:00:00.000,Costa Do Sauipe Brasil ATP World Tour,CLAY,2,Juan Carlos Ferrero,Potito Starace,Juan Carlos Ferrero,5-7; 6-2; 6-2,Q,110,0,0,51,68,39,51,12,17,3,5,14,51,68,2,0,52,79,32,52,11,27,7,12,14,43,79
2007-02-12 00:00:00.000,Costa Do Sauipe Brasil ATP World Tour,CLAY,2,Flavio Saretta,Nicolas Almagro,Flavio Saretta,6-4; 6-4,Q,87,1,1,47,68,35,47,11,21,5,6,10,46,68,1,3,44,63,29,44,11,19,1,4,10,40,63
2007-02-12 00:00:00.000,Costa Do Sauipe Brasil ATP World Tour,CLAY,2,Juan Ignacio Chela,Juan Monaco,Juan Ignacio Chela,6-4; 2-6; 7-5,Q,127,3,5,46,84,37,46,17,38,1,4,15,54,84,5,2,69,94,48,69,13,25,4,7,15,61,94
2007-02-12 00:00:00.000,Costa Do Sauipe Brasil ATP World Tour,CLAY,2,Guillermo Canas,Agustin Calleri,Guillermo Canas,7-6(3); 6-1,Q,85,4,3,29,50,24,29,14,21,0,1,9,38,50,5,5,31,61,21,31,13,30,1,5,10,34,61
2007-02-12 00:00:00.000,Costa Do Sauipe Brasil ATP World Tour,CLAY,2,Juan Carlos Ferrero,Flavio Saretta,Juan Carlos Ferrero,6-2; 6-4,S,92,1,2,46,67,30,46,13,21,4,5,9,43,67,2,3,36,54,25,36,4,18,3,7,9,29,54
2007-02-12 00:00:00.000,Costa Do Sauipe Brasil ATP World Tour,CLAY,2,Guillermo Canas,Juan Ignacio Chela,Guillermo Canas,7-6(6); 6-1,S,123,2,0,36,66,27,36,12,30,3,5,9,39,66,2,4,35,77,19,35,19,42,0,5,10,38,77
2007-02-12 00:00:00.000,Costa Do Sauipe Brasil ATP World Tour,CLAY,2,Guillermo Canas,Juan Carlos Ferrero,Guillermo Canas,7-6(4); 6-2,F,121,5,3,38,72,31,38,17,34,4,5,10,48,72,1,1,49,65,28,49,10,16,3,6,10,38,65
2007-02-12 00:00:00.000,Marseille France ATP World Tour,HARD,2,Robin Soderling,Nikolay Davydenko,Robin Soderling,3-6; 6-4; 6-1,R32,102,9,3,59,90,42,59,12,31,3,5,13,54,90,3,3,53,74,35,53,9,21,2,6,13,44,74
2007-02-12 00:00:00.000,Marseille France ATP World Tour,HARD,2,Thomas Johansson,George Bastl,Thomas Johansson,4-6; 7-5; 6-3,R32,136,11,2,58,104,46,58,22,46,5,7,16,68,104,9,5,55,83,43,55,12,28,1,4,15,55,83
2007-02-12 00:00:00.000,Marseille France ATP World Tour,HARD,2,Marc Gicquel,Gael Monfils,Marc Gicquel,4-6; 7-6(1); 7-5,R32,161,2,3,60,118,39,60,34,58,9,13,17,73,118,16,4,59,124,45,59,28,65,7,11,17,73,124
2007-02-12 00:00:00.000,Marseille France ATP World Tour,HARD,2,Richard Gasquet,Jan Hernych,Richard Gasquet,6-1; 7-5,R32,75,6,2,41,59,30,41,11,18,2,3,10,41,59,4,5,39,66,23,39,12,27,6,10,9,35,66
2007-02-12 00:00:00.000,Marseille France ATP World Tour,HARD,2,Andreas Seppi,Mario Ancic,Andreas Seppi,4-0,R32,16,1,0,8,12,5,8,4,4,2,2,2,9,12,0,1,10,15,4,10,1,5,3,5,2,5,15
2007-02-12 00:00:00.000,Marseille France ATP World Tour,HARD,2,Jonas Bjorkman,Daniele Bracciali,Jonas Bjorkman,6-3; 6-2,R32,70,6,2,32,60,23,32,18,28,5,5,9,41,60,1,5,25,55,18,25,12,30,2,5,8,30,55
2007-02-12 00:00:00.000,Marseille France ATP World Tour,HARD,2,Gilles Simon,Jesse Huta Galung,Gilles Simon,6-1; 6-1,R32,51,8,2,21,36,19,21,10,15,1,1,7,29,36,2,2,18,47,13,18,5,29,2,7,7,18,47
2007-02-12 00:00:00.000,Marseille France ATP World Tour,HARD,2,Lleyton Hewitt,Michael Llodra,Lleyton Hewitt,4-6; 6-1; 6-4,R32,106,12,4,48,81,40,48,17,33,4,6,14,57,81,8,7,42,81,32,42,17,39,6,10,13,49,81
2007-02-12 00:00:00.000,Marseille France ATP World Tour,HARD,2,Marcos Baghdatis,Janko Tipsarevic,Marcos Baghdatis,6-3; 6-4,R32,77,12,1,37,59,33,37,10,22,3,3,10,43,59,2,2,32,60,25,32,11,28,2,4,9,36,60
2007-02-12 00:00:00.000,Marseille France ATP World Tour,HARD,2,Cyril Saulnier,David Guez,Cyril Saulnier,6-4; 6-2,R32,78,9,0,27,44,21,27,13,17,1,2,9,34,44,1,2,34,66,22,34,13,32,2,6,9,35,66
2007-02-12 00:00:00.000,Marseille France ATP World Tour,HARD,2,Fabrice Santoro,Fernando Verdasco,Fabrice Santoro,6-3; 3-2,R32,72,3,1,18,42,16,18,16,24,1,1,7,32,42,3,1,40,55,22,40,8,15,5,7,7,30,55
2007-02-12 00:00:00.000,Marseille France ATP World Tour,HARD,2,Mikhail Youzhny,Novak Djokovic,Mikhail Youzhny,6-4; 4-6; 7-6,R32,152,11,3,52,98,39,52,25,46,1,4,16,64,98,5,3,59,114,38,59,31,55,6,9,16,69,114
2007-02-12 00:00:00.000,Marseille France ATP World Tour,HARD,2,David Ferrer,Arnaud Clement,David Ferrer,6-4; 6-4,R32,94,3,2,39,57,27,39,12,18,3,5,10,39,57,4,2,30,61,21,30,12,31,5,9,10,33,61
2007-02-12 00:00:00.000,Marseille France ATP World Tour,HARD,2,Julien Benneteau,Florent Serra,Julien Benneteau,2-6; 6-1; 6-2,R32,101,7,4,46,75,33,46,15,29,1,3,12,48,75,4,2,40,72,26,40,14,32,2,6,11,40,72
2007-02-12 00:00:00.000,Marseille France ATP World Tour,HARD,2,Jarkko Nieminen,Jeremy Chardy,Jarkko Nieminen,6-7(1); 7-6(4); 7-6(6),R32,141,5,4,68,116,47,68,27,48,5,9,18,74,116,17,4,64,114,52,64,22,50,3,7,18,74,114
2007-02-12 00:00:00.000,Marseille France ATP World Tour,HARD,2,Nicolas Mahut,Ivan Ljubicic,Nicolas Mahut,6-4; 6-4,R32,86,8,2,30,61,24,30,20,31,2,2,10,44,61,18,6,30,56,24,30,11,26,0,2,10,35,56
2007-02-12 00:00:00.000,Marseille France ATP World Tour,HARD,2,Robin Soderling,Thomas Johansson,Robin Soderling,6-4; 7-5,R16,75,5,2,45,67,36,45,10,22,2,3,11,46,67,12,2,35,60,26,35,10,25,5,8,11,36,60
2007-02-12 00:00:00.000,Marseille France ATP World Tour,HARD,2,Richard Gasquet,Marc Gicquel,Richard Gasquet,7-6(2); 6-2,R16,96,4,1,36,63,30,36,13,27,0,2,10,43,63,5,0,48,83,32,48,12,35,11,15,10,44,83
2007-02-12 00:00:00.000,Marseille France ATP World Tour,HARD,2,Jonas Bjorkman,Andreas Seppi,Jonas Bjorkman,6-1; 6-0,R16,51,5,2,20,38,18,20,10,18,0,0,7,28,38,2,3,22,44,11,22,6,22,2,7,6,17,44
2007-02-12 00:00:00.000,Marseille France ATP World Tour,HARD,2,Gilles Simon,Lleyton Hewitt,Gilles Simon,6-1; 3-2,R16,58,1,1,16,44,13,16,18,28,2,2,6,31,44,0,5,11,33,9,11,8,22,1,4,6,17,33
2007-02-12 00:00:00.000,Marseille France ATP World Tour,HARD,2,Marcos Baghdatis,Cyril Saulnier,Marcos Baghdatis,6-4; 6-3,R16,67,7,0,27,52,23,27,17,25,2,2,9,40,52,6,4,34,54,28,34,7,20,4,7,10,35,54
2007-02-12 00:00:00.000,Marseille France ATP World Tour,HARD,2,Mikhail Youzhny,Fabrice Santoro,Mikhail Youzhny,6-7(4); 6-2; 6-3,R16,133,8,6,47,91,41,47,22,44,1,3,14,63,91,5,4,53,101,35,53,26,48,8,14,15,61,101
2007-02-12 00:00:00.000,Marseille France ATP World Tour,HARD,2,Julien Benneteau,David Ferrer,Julien Benneteau,4-6; 6-0; 6-1,R16,99,1,4,37,66,24,37,14,29,2,4,11,38,66,1,2,38,64,21,38,9,26,1,8,12,30,64
2007-02-12 00:00:00.000,Marseille France ATP World Tour,HARD,2,Jarkko Nieminen,Nicolas Mahut,Jarkko Nieminen,6-4; 3-6; 6-3,R16,113,5,0,52,85,39,52,20,33,5,6,14,59,85,10,3,52,84,42,52,15,32,2,4,14,57,84
2007-02-12 00:00:00.000,Marseille France ATP World Tour,HARD,2,Robin Soderling,Richard Gasquet,Robin Soderling,6-1; 7-6(4),Q,73,12,1,37,56,29,37,14,19,3,3,9,43,56,5,3,50,73,32,50,10,23,5,8,10,42,73
2007-02-12 00:00:00.000,Marseille France ATP World Tour,HARD,2,Gilles Simon,Jonas Bjorkman,Gilles Simon,7-6(4); 6-2,Q,89,3,1,34,67,24,34,21,33,3,4,10,45,67,2,3,45,71,31,45,9,26,6,9,10,40,71
2007-02-12 00:00:00.000,Marseille France ATP World Tour,HARD,2,Marcos Baghdatis,Mikhail Youzhny,Marcos Baghdatis,2-6; 7-6(7); 7-5,Q,150,9,4,54,106,39,54,29,52,4,7,16,68,106,6,2,62,105,47,62,25,43,2,4,16,72,105
2007-02-12 00:00:00.000,Marseille France ATP World Tour,HARD,2,Jarkko Nieminen,Julien Benneteau,Jarkko Nieminen,6-2; 1-6; 6-3,Q,101,2,1,44,66,30,44,15,22,2,4,12,45,66,1,2,54,74,39,54,8,20,2,5,12,47,74
2007-02-12 00:00:00.000,Marseille France ATP World Tour,HARD,2,Gilles Simon,Robin Soderling,Gilles Simon,6-2; 7-6(2),S,77,5,1,35,59,21,35,15,24,2,5,10,36,59,4,0,43,64,21,43,11,21,3,8,10,32,64
2007-02-12 00:00:00.000,Marseille France ATP World Tour,HARD,2,Marcos Baghdatis,Jarkko Nieminen,Marcos Baghdatis,3-6; 6-3; 6-2,S,107,7,2,32,74,19,32,22,42,0,4,13,41,74,4,1,49,84,32,49,13,35,6,12,13,45,84
2007-02-12 00:00:00.000,Marseille France ATP World Tour,HARD,2,Gilles Simon,Marcos Baghdatis,Gilles Simon,6-4; 7-6(3),F,97,4,0,44,77,32,44,15,33,2,4,11,47,77,6,0,40,68,26,40,14,28,3,6,11,40,68
2007-02-12 00:00:00.000,San Jose CA; U.S.A. ATP World Tour,HARD,2,Andy Roddick,Frank Dancevic,Andy Roddick,7-5; 6-1,R32,50,13,1,38,51,31,38,9,13,0,0,10,40,51,7,1,21,43,16,21,13,22,0,3,9,29,43
2007-02-12 00:00:00.000,San Jose CA; U.S.A. ATP World Tour,HARD,2,Sam Querrey,Paul Goldstein,Sam Querrey,6-2; 6-1,R32,50,13,2,30,50,25,30,10,20,3,3,8,35,50,1,0,31,43,17,31,5,12,2,6,7,22,43
2007-02-12 00:00:00.000,San Jose CA; U.S.A. ATP World Tour,HARD,2,Feliciano Lopez,Rainer Schuettler,Feliciano Lopez,7-6(1); 6-1,R32,71,9,1,33,60,26,33,17,27,2,3,10,43,60,3,1,24,50,17,24,14,26,2,5,9,31,50
2007-02-12 00:00:00.000,San Jose CA; U.S.A. ATP World Tour,HARD,2,Vincent Spadea,Danai Udomchoke,Vincent Spadea,6-3; 6-4,R32,71,8,2,38,60,29,38,11,22,2,3,10,40,60,5,1,37,58,21,37,13,21,6,9,9,34,58
2007-02-12 00:00:00.000,San Jose CA; U.S.A. ATP World Tour,HARD,2,Andy Murray,Kevin Kim,Andy Murray,6-3; 6-1,R32,57,11,4,28,51,24,28,10,23,2,3,8,34,51,0,2,29,53,17,29,5,24,4,9,8,22,53
2007-02-12 00:00:00.000,San Jose CA; U.S.A. ATP World Tour,HARD,2,Kristian Pless,Sergiy Stakhovsky,Kristian Pless,7-5; 6-1,R32,59,3,0,32,55,27,32,15,23,0,0,10,42,55,5,3,26,52,16,26,15,26,2,5,9,31,52
2007-02-12 00:00:00.000,San Jose CA; U.S.A. ATP World Tour,HARD,2,Simon Greul,Robert Kendrick,Simon Greul,6-3; 6-2,R32,54,7,1,26,50,21,26,16,24,2,2,9,37,50,12,4,26,45,19,26,7,19,2,5,8,26,45
2007-02-12 00:00:00.000,San Jose CA; U.S.A. ATP World Tour,HARD,2,Hyung-Taik Lee,Phillip King,Hyung-Taik Lee,7-6(4); 6-3,R32,88,3,0,41,67,32,41,17,26,3,4,11,49,67,5,0,43,82,30,43,18,39,4,6,10,48,82
2007-02-12 00:00:00.000,San Jose CA; U.S.A. ATP World Tour,HARD,2,Benjamin Becker,Dusan Vemic,Benjamin Becker,6-4; 3-6; 6-4,R32,84,11,3,38,69,34,38,20,31,0,1,14,54,69,14,9,32,72,32,32,21,40,1,3,15,53,72
2007-02-12 00:00:00.000,San Jose CA; U.S.A. ATP World Tour,HARD,2,Bjorn Phau,Konstantinos Economidis,Bjorn Phau,6-2; 6-3,R32,56,6,2,34,53,22,34,13,19,6,7,8,35,53,1,3,33,50,18,33,5,17,1,6,9,23,50
2007-02-12 00:00:00.000,San Jose CA; U.S.A. ATP World Tour,HARD,2,Yen-Hsun Lu,Brian Wilson,Yen-Hsun Lu,6-1; 6-2,R32,59,3,2,24,46,21,24,13,22,1,1,8,34,46,2,5,20,39,13,20,6,19,2,6,7,19,39
2007-02-12 00:00:00.000,San Jose CA; U.S.A. ATP World Tour,HARD,2,Marat Safin,Scott Oudsema,Marat Safin,6-4; 7-6(3),R32,89,4,2,36,65,29,36,18,29,0,1,11,47,65,17,5,33,83,30,33,20,50,4,6,11,50,83
2007-02-12 00:00:00.000,San Jose CA; U.S.A. ATP World Tour,HARD,2,Mardy Fish,Teymuraz Gabashvili,Mardy Fish,6-3; 6-2,R32,61,11,2,26,46,24,26,12,20,0,0,9,36,46,7,7,33,60,25,33,9,27,5,8,8,34,60
2007-02-12 00:00:00.000,San Jose CA; U.S.A. ATP World Tour,HARD,2,Sam Warburg,Amer Delic,Sam Warburg,6-4; 6-3,R32,70,5,2,31,54,27,31,15,23,1,1,10,42,54,7,1,30,58,23,30,14,28,1,3,9,37,58
2007-02-12 00:00:00.000,San Jose CA; U.S.A. ATP World Tour,HARD,2,Ivo Karlovic,Guillermo Garcia-Lopez,Ivo Karlovic,6-3; 7-6(7),R32,87,14,1,52,76,44,52,12,24,2,2,11,56,76,2,4,51,67,41,51,8,16,2,3,10,49,67
2007-02-12 00:00:00.000,San Jose CA; U.S.A. ATP World Tour,HARD,2,James Blake,Igor Kunitsyn,James Blake,6-3; 6-2,R32,52,2,0,29,51,20,29,17,22,0,0,9,37,51,1,1,27,51,17,27,12,24,2,5,8,29,51
2007-02-12 00:00:00.000,San Jose CA; U.S.A. ATP World Tour,HARD,2,Andy Roddick,Sam Querrey,Andy Roddick,6-4; 7-6(3),R16,73,11,1,37,65,30,37,21,28,2,2,11,51,65,20,1,43,72,37,43,15,29,3,4,11,52,72
2007-02-12 00:00:00.000,San Jose CA; U.S.A. ATP World Tour,HARD,2,Vincent Spadea,Feliciano Lopez,Vincent Spadea,4-6; 7-5; 7-6(6),R16,134,7,3,60,110,47,60,30,50,4,6,17,77,110,21,2,64,105,50,64,19,41,0,2,17,69,105
2007-02-12 00:00:00.000,San Jose CA; U.S.A. ATP World Tour,HARD,2,Andy Murray,Kristian Pless,Andy Murray,6-0; 6-7(5); 6-4,R16,102,10,1,39,77,34,39,25,38,4,5,14,59,77,8,4,55,100,34,55,24,45,6,11,14,58,100
2007-02-12 00:00:00.000,San Jose CA; U.S.A. ATP World Tour,HARD,2,Hyung-Taik Lee,Simon Greul,Hyung-Taik Lee,6-2; 7-6(3),R16,83,8,0,51,78,40,51,15,27,6,6,10,55,78,4,2,39,68,28,39,14,29,4,6,10,42,68
2007-02-12 00:00:00.000,San Jose CA; U.S.A. ATP World Tour,HARD,2,Benjamin Becker,Bjorn Phau,Benjamin Becker,7-6(4); 1-6; 6-3,R16,112,6,4,50,103,38,50,24,53,6,10,14,62,103,6,4,44,93,34,44,24,49,5,8,14,58,93
2007-02-12 00:00:00.000,San Jose CA; U.S.A. ATP World Tour,HARD,2,Marat Safin,Yen-Hsun Lu,Marat Safin,6-4; 5-7; 6-4,R16,123,9,4,59,103,47,59,17,44,8,12,16,64,103,5,4,48,95,34,48,22,47,3,8,16,56,95
2007-02-12 00:00:00.000,San Jose CA; U.S.A. ATP World Tour,HARD,2,Mardy Fish,Sam Warburg,Mardy Fish,2-6; 6-4; 6-2,R16,88,11,1,32,65,30,32,17,33,1,3,13,47,65,7,3,46,73,32,46,15,27,2,5,13,47,73
2007-02-12 00:00:00.000,San Jose CA; U.S.A. ATP World Tour,HARD,2,Ivo Karlovic,James Blake,Ivo Karlovic,6-7(4); 7-6(11); 6-4,R16,127,29,4,71,112,63,71,19,41,0,1,17,82,112,3,2,68,106,57,68,22,38,2,4,17,79,106
2007-02-12 00:00:00.000,San Jose CA; U.S.A. ATP World Tour,HARD,2,Andy Roddick,Vincent Spadea,Andy Roddick,6-3; 6-7(5); 6-1,Q,121,19,5,69,94,53,69,12,25,3,4,15,65,94,4,7,69,111,44,69,20,42,11,15,13,64,111
2007-02-12 00:00:00.000,San Jose CA; U.S.A. ATP World Tour,HARD,2,Andy Murray,Hyung-Taik Lee,Andy Murray,4-6; 6-3; 7-6(4),Q,128,9,4,43,93,32,43,32,50,1,4,16,64,93,2,1,68,101,45,68,20,33,3,6,15,65,101
2007-02-12 00:00:00.000,San Jose CA; U.S.A. ATP World Tour,HARD,2,Benjamin Becker,Marat Safin,Benjamin Becker,6-4; 6-3,Q,61,11,2,28,52,27,28,13,24,0,0,10,40,52,3,3,32,54,24,32,11,22,6,8,9,35,54
2007-02-12 00:00:00.000,San Jose CA; U.S.A. ATP World Tour,HARD,2,Ivo Karlovic,Mardy Fish,Ivo Karlovic,7-6(2); 6-4,Q,78,17,2,40,59,37,40,12,19,0,0,11,49,59,10,1,31,58,29,31,15,27,1,2,11,44,58
2007-02-12 00:00:00.000,San Jose CA; U.S.A. ATP World Tour,HARD,2,Andy Murray,Andy Roddick,Andy Murray,7-6(8); 6-4,S,93,14,2,37,74,33,37,16,37,5,6,11,49,74,9,3,49,70,40,49,5,21,2,4,11,45,70
2007-02-12 00:00:00.000,San Jose CA; U.S.A. ATP World Tour,HARD,2,Ivo Karlovic,Benjamin Becker,Ivo Karlovic,7-6(5); 7-5,S,101,27,4,51,71,43,51,13,20,1,1,12,56,71,8,2,41,81,30,41,25,40,1,2,12,55,81
2007-02-12 00:00:00.000,San Jose CA; U.S.A. ATP World Tour,HARD,2,Andy Murray,Ivo Karlovic,Andy Murray,6-7(3); 6-4; 7-6(2),F,155,8,3,66,119,50,66,33,53,4,5,17,83,119,26,1,73,113,61,73,16,40,2,4,17,77,113
2007-02-19 00:00:00.000,Memphis TN; U.S.A. ATP World Tour,HARD,2,Andy Roddick,Thomas Johansson,Andy Roddick,6-2; 7-5,R32,78,9,3,34,57,27,34,16,23,1,1,10,43,57,11,2,38,69,28,38,10,31,0,3,10,38,69
2007-02-19 00:00:00.000,Memphis TN; U.S.A. ATP World Tour,HARD,2,Benjamin Becker,Robert Kendrick,Benjamin Becker,2-6; 6-3; 6-4,R32,96,10,4,48,89,37,48,21,41,9,11,14,58,89,20,3,53,84,41,53,14,31,8,10,13,55,84
2007-02-19 00:00:00.000,Memphis TN; U.S.A. ATP World Tour,HARD,2,Yen-Hsun Lu,Chris Guccione,Yen-Hsun Lu,7-6(4); 6-3,R32,76,7,3,38,63,33,38,18,25,1,1,11,51,63,11,2,36,62,30,36,13,26,2,3,10,43,62
2007-02-19 00:00:00.000,Memphis TN; U.S.A. ATP World Tour,HARD,2,Jurgen Melzer,Jesse Witten,Jurgen Melzer,1-6; 6-3; 7-6(3),R32,85,4,2,56,80,41,56,14,24,3,6,14,55,80,9,6,43,75,35,43,18,32,0,2,14,53,75
2007-02-19 00:00:00.000,Memphis TN; U.S.A. ATP World Tour,HARD,2,Andy Murray,Frank Dancevic,Andy Murray,6-3; 4-6; 6-4,R32,107,11,2,48,87,37,48,16,39,2,6,15,53,87,8,1,53,82,38,53,13,29,9,14,14,51,82
2007-02-19 00:00:00.000,Memphis TN; U.S.A. ATP World Tour,HARD,2,Kristian Pless,Igor Kunitsyn,Kristian Pless,6-3; 6-1,R32,45,6,1,27,38,23,27,7,11,0,1,8,30,38,1,1,27,55,14,27,12,28,5,10,8,26,55
2007-02-19 00:00:00.000,Memphis TN; U.S.A. ATP World Tour,HARD,2,Stefan Koubek,Simon Greul,Stefan Koubek,6-3; 7-6(3),R32,87,7,1,56,74,35,56,12,18,4,6,11,47,74,5,2,41,71,22,41,18,30,6,9,10,40,71
2007-02-19 00:00:00.000,Memphis TN; U.S.A. ATP World Tour,HARD,2,Evgeny Korolev,Robby Ginepri,Evgeny Korolev,7-6(4); 4-6; 6-3,R32,111,6,3,66,104,47,66,23,38,4,6,16,70,104,11,2,62,95,49,62,14,33,5,7,15,63,95
2007-02-19 00:00:00.000,Memphis TN; U.S.A. ATP World Tour,HARD,2,Teymuraz Gabashvili,Xavier Malisse,Teymuraz Gabashvili,4-6; 2-2,R32,57,1,1,21,41,16,21,9,20,2,4,7,25,41,8,1,26,39,21,26,6,13,0,1,7,27,39
2007-02-19 00:00:00.000,Memphis TN; U.S.A. ATP World Tour,HARD,2,Alex Kuznetsov,Kevin Kim,Alex Kuznetsov,6-2; 2-6; 6-4,R32,93,11,3,47,83,35,47,17,36,7,10,13,52,83,10,6,45,83,35,45,15,38,2,6,13,50,83
2007-02-19 00:00:00.000,Memphis TN; U.S.A. ATP World Tour,HARD,2,Juan Martin Del Potro,Feliciano Lopez,Juan Martin Del Potro,6-1; 6-2,R32,50,1,3,24,42,21,24,12,18,1,1,8,33,42,1,2,25,38,13,25,5,13,3,7,7,18,38
2007-02-19 00:00:00.000,Memphis TN; U.S.A. ATP World Tour,HARD,2,Mardy Fish,Bjorn Phau,Mardy Fish,6-3; 6-2,R32,64,8,2,25,46,22,25,13,21,1,2,9,35,46,3,4,31,53,20,31,6,22,4,8,8,26,53
2007-02-19 00:00:00.000,Memphis TN; U.S.A. ATP World Tour,HARD,2,Julien Benneteau,Hyung-Taik Lee,Julien Benneteau,7-5; 6-3,R32,74,4,3,49,66,40,49,8,17,3,3,11,48,66,5,1,38,58,29,38,9,20,3,5,10,38,58
2007-02-19 00:00:00.000,Memphis TN; U.S.A. ATP World Tour,HARD,2,Sam Querrey,Ivo Karlovic,Sam Querrey,6-3; 6-2,R32,53,17,1,29,52,26,29,14,23,0,0,9,40,52,5,2,24,45,19,24,9,21,1,4,8,28,45
2007-02-19 00:00:00.000,Memphis TN; U.S.A. ATP World Tour,HARD,2,Amer Delic,Paul Goldstein,Amer Delic,7-5; 7-6(0),R32,107,19,1,58,91,40,58,19,33,6,8,12,59,91,3,1,55,90,37,55,17,35,9,12,12,54,90
2007-02-19 00:00:00.000,Memphis TN; U.S.A. ATP World Tour,HARD,2,Tommy Haas,Vincent Spadea,Tommy Haas,6-4; 6-1,R32,56,6,1,20,38,20,20,12,18,0,0,8,32,38,6,3,40,61,26,40,6,21,7,11,9,32,61
2007-02-19 00:00:00.000,Memphis TN; U.S.A. ATP World Tour,HARD,2,Andy Roddick,Benjamin Becker,Andy Roddick,7-6(4); 6-4,R16,86,14,0,33,55,31,33,18,22,0,0,11,49,55,12,2,31,69,24,31,24,38,4,5,11,48,69
2007-02-19 00:00:00.000,Memphis TN; U.S.A. ATP World Tour,HARD,2,Yen-Hsun Lu,Jurgen Melzer,Yen-Hsun Lu,7-6(2); 1-1,R16,55,5,3,22,41,20,22,13,19,0,0,7,33,41,6,3,35,53,27,35,8,18,2,2,7,35,53
2007-02-19 00:00:00.000,Memphis TN; U.S.A. ATP World Tour,HARD,2,Andy Murray,Kristian Pless,Andy Murray,6-3; 7-6(4),R16,94,11,2,29,71,26,29,26,42,1,1,11,52,71,3,0,58,86,37,58,15,28,10,11,10,52,86
2007-02-19 00:00:00.000,Memphis TN; U.S.A. ATP World Tour,HARD,2,Stefan Koubek,Evgeny Korolev,Stefan Koubek,7-6(4); 6-2,R16,69,5,1,39,60,31,39,13,21,0,1,10,44,60,3,2,31,61,26,31,11,30,1,4,10,37,61
2007-02-19 00:00:00.000,Memphis TN; U.S.A. ATP World Tour,HARD,2,Teymuraz Gabashvili,Alex Kuznetsov,Teymuraz Gabashvili,5-7; 6-3; 6-4,R16,111,13,0,53,92,45,53,23,39,3,4,16,68,92,11,6,56,96,43,56,21,40,3,5,15,64,96
2007-02-19 00:00:00.000,Memphis TN; U.S.A. ATP World Tour,HARD,2,Mardy Fish,Juan Martin Del Potro,Mardy Fish,6-1; 7-6(9),R16,77,22,1,32,61,31,32,19,29,0,0,10,50,61,9,2,36,66,25,36,18,30,3,5,9,43,66
2007-02-19 00:00:00.000,Memphis TN; U.S.A. ATP World Tour,HARD,2,Sam Querrey,Julien Benneteau,Sam Querrey,6-3; 6-4,R16,83,22,2,39,74,35,39,15,35,9,9,10,50,74,4,4,41,63,22,41,15,22,2,4,9,37,63
2007-02-19 00:00:00.000,Memphis TN; U.S.A. ATP World Tour,HARD,2,Tommy Haas,Amer Delic,Tommy Haas,7-6(2); 7-6(5),R16,87,7,1,52,76,47,52,14,24,0,0,12,61,76,11,0,43,72,37,43,16,29,0,0,12,53,72
2007-02-19 00:00:00.000,Memphis TN; U.S.A. ATP World Tour,HARD,2,Andy Roddick,Yen-Hsun Lu,Andy Roddick,6-4; 7-6(7),Q,94,18,3,54,79,42,54,13,25,5,6,11,55,79,6,7,47,84,38,47,17,37,10,12,11,55,84
2007-02-19 00:00:00.000,Memphis TN; U.S.A. ATP World Tour,HARD,2,Andy Murray,Stefan Koubek,Andy Murray,6-3; 6-2,Q,62,1,0,26,54,21,26,16,28,2,2,9,37,54,1,0,24,41,16,24,7,17,2,5,8,23,41
2007-02-19 00:00:00.000,Memphis TN; U.S.A. ATP World Tour,HARD,2,Mardy Fish,Teymuraz Gabashvili,Mardy Fish,6-2; 4-1,Q,50,11,1,19,31,19,19,9,12,0,0,7,28,31,2,3,28,50,21,28,4,22,3,6,6,25,50
2007-02-19 00:00:00.000,Memphis TN; U.S.A. ATP World Tour,HARD,2,Tommy Haas,Sam Querrey,Tommy Haas,6-2; 6-2,Q,44,7,0,27,38,23,27,9,11,0,0,8,32,38,1,4,19,42,12,19,10,23,3,7,8,22,42
2007-02-19 00:00:00.000,Memphis TN; U.S.A. ATP World Tour,HARD,2,Andy Roddick,Andy Murray,Andy Roddick,6-3; 7-6(4),S,92,15,1,52,75,37,52,15,23,2,3,11,52,75,8,3,29,66,23,29,18,37,4,6,10,41,66
2007-02-19 00:00:00.000,Memphis TN; U.S.A. ATP World Tour,HARD,2,Tommy Haas,Mardy Fish,Tommy Haas,6-3; 6-4,S,71,13,2,34,51,29,34,11,17,0,0,10,40,51,16,2,35,65,30,35,10,30,5,7,9,40,65
2007-02-19 00:00:00.000,Memphis TN; U.S.A. ATP World Tour,HARD,2,Tommy Haas,Andy Roddick,Tommy Haas,6-3; 6-2,F,62,8,2,25,43,24,25,12,18,0,0,9,36,43,7,2,27,53,20,27,10,26,5,8,8,30,53
2007-02-19 00:00:00.000,Rotterdam The Netherlands ATP World Tour,HARD,2,Nikolay Davydenko,Michael Berrer,Nikolay Davydenko,6-3; 6-4,R32,75,9,0,41,62,29,41,14,21,1,1,10,43,62,2,1,33,49,22,33,8,16,2,4,9,30,49
2007-02-19 00:00:00.000,Rotterdam The Netherlands ATP World Tour,HARD,2,Marc Gicquel,Arnaud Clement,Marc Gicquel,6-4; 6-3,R32,82,6,0,20,48,17,20,18,28,1,2,9,35,48,4,3,39,68,22,39,14,29,1,5,10,36,68
2007-02-19 00:00:00.000,Rotterdam The Netherlands ATP World Tour,HARD,2,Philipp Kohlschreiber,Gilles Simon,Philipp Kohlschreiber,6-3; 3-1,R32,56,7,1,20,42,18,20,12,22,0,0,6,30,42,2,1,25,41,16,25,6,16,1,4,7,22,41
2007-02-19 00:00:00.000,Rotterdam The Netherlands ATP World Tour,HARD,2,Radek Stepanek,Jan Hernych,Radek Stepanek,6-2; 7-5,R32,107,4,1,55,69,38,55,8,14,5,6,10,46,69,1,2,44,56,26,44,4,12,1,5,10,30,56
2007-02-19 00:00:00.000,Rotterdam The Netherlands ATP World Tour,HARD,2,Ivan Ljubicic,Thiemo de Bakker,Ivan Ljubicic,7-5; 6-3,R32,72,14,1,38,55,32,38,12,17,0,0,11,44,55,7,0,32,53,25,32,11,21,3,5,10,36,53
2007-02-19 00:00:00.000,Rotterdam The Netherlands ATP World Tour,HARD,2,Olivier Rochus,Janko Tipsarevic,Olivier Rochus,4-6; 6-2; 6-4,R32,114,4,2,47,80,37,47,20,33,7,9,14,57,80,9,0,37,64,30,37,13,27,1,5,14,43,64
2007-02-19 00:00:00.000,Rotterdam The Netherlands ATP World Tour,HARD,2,Florian Mayer,Dominik Hrbaty,Florian Mayer,7-6(5); 2-6; 7-5,R32,125,7,2,56,104,37,56,28,48,4,9,16,65,104,3,3,53,103,42,53,22,50,6,10,16,64,103
2007-02-19 00:00:00.000,Rotterdam The Netherlands ATP World Tour,HARD,2,Dennis van Scheppingen,Gael Monfils,Dennis van Scheppingen,6-7(3); 6-4; 6-3,R32,102,6,1,53,83,46,53,19,30,0,1,16,65,83,19,2,62,100,44,62,22,38,7,10,15,66,100
2007-02-19 00:00:00.000,Rotterdam The Netherlands ATP World Tour,HARD,2,David Ferrer,Christophe Rochus,David Ferrer,6-3; 6-0,R32,63,6,4,35,46,27,35,5,11,3,3,7,32,46,0,2,28,48,14,28,8,20,2,7,8,22,48
2007-02-19 00:00:00.000,Rotterdam The Netherlands ATP World Tour,HARD,2,Kristof Vliegen,Jarkko Nieminen,Kristof Vliegen,6-1; 6-4,R32,69,3,1,38,59,31,38,10,21,4,4,9,41,59,2,1,20,39,14,20,9,19,1,4,8,23,39
2007-02-19 00:00:00.000,Rotterdam The Netherlands ATP World Tour,HARD,2,Robin Haase,Roko Karanusic,Robin Haase,6-3; 7-6(2),R32,79,6,0,38,62,30,38,16,24,2,3,11,46,62,6,0,37,60,25,37,12,23,1,3,10,37,60
2007-02-19 00:00:00.000,Rotterdam The Netherlands ATP World Tour,HARD,2,Mikhail Youzhny,Tomas Berdych,Mikhail Youzhny,6-4; 6-7(5); 6-1,R32,136,8,1,56,99,47,56,26,43,8,8,15,73,99,13,3,58,106,42,58,23,48,4,7,14,65,106
2007-02-19 00:00:00.000,Rotterdam The Netherlands ATP World Tour,HARD,2,Novak Djokovic,Florent Serra,Novak Djokovic,7-6(6); 6-4,R32,88,5,0,49,67,38,49,11,18,0,0,11,49,67,5,0,52,71,37,52,11,19,2,3,11,48,71
2007-02-19 00:00:00.000,Rotterdam The Netherlands ATP World Tour,HARD,2,Andrei Pavel,Daniele Bracciali,Andrei Pavel,6-1; 6-1,R32,50,4,1,26,38,23,26,6,12,1,1,7,29,38,3,1,20,39,12,20,5,19,5,10,7,17,39
2007-02-19 00:00:00.000,Rotterdam The Netherlands ATP World Tour,HARD,2,Rik De Voest,Martin Verkerk,Rik De Voest,6-3; 7-6(0),R32,78,7,2,40,59,34,40,11,19,0,1,11,45,59,8,3,43,68,30,43,10,25,3,5,10,40,68
2007-02-19 00:00:00.000,Rotterdam The Netherlands ATP World Tour,HARD,2,Tommy Robredo,Simone Bolelli,Tommy Robredo,6-2; 6-2,R32,79,8,1,25,42,22,25,10,17,0,0,8,32,42,4,2,41,68,25,41,10,27,5,9,8,35,68
2007-02-19 00:00:00.000,Rotterdam The Netherlands ATP World Tour,HARD,2,Nikolay Davydenko,Marc Gicquel,Nikolay Davydenko,6-3; 6-3,R16,71,7,1,34,49,29,34,8,15,0,0,9,37,49,3,0,32,57,20,32,12,25,3,6,9,32,57
2007-02-19 00:00:00.000,Rotterdam The Netherlands ATP World Tour,HARD,2,Philipp Kohlschreiber,Radek Stepanek,Philipp Kohlschreiber,7-6(12); 7-6(6),R16,132,10,1,54,95,42,54,24,41,1,3,12,66,95,13,2,71,107,56,71,13,36,10,12,12,69,107
2007-02-19 00:00:00.000,Rotterdam The Netherlands ATP World Tour,HARD,2,Ivan Ljubicic,Olivier Rochus,Ivan Ljubicic,6-3; 7-6(4),R16,104,26,0,45,70,42,45,10,25,1,1,11,52,70,1,2,48,73,34,48,13,25,1,2,10,47,73
2007-02-19 00:00:00.000,Rotterdam The Netherlands ATP World Tour,HARD,2,Florian Mayer,Dennis van Scheppingen,Florian Mayer,7-5; 6-2,R16,68,11,4,44,67,33,44,11,23,5,6,10,44,67,2,1,42,61,27,42,6,19,6,10,10,33,61
2007-02-19 00:00:00.000,Rotterdam The Netherlands ATP World Tour,HARD,2,David Ferrer,Kristof Vliegen,David Ferrer,6-4; 6-2,R16,79,0,3,35,52,29,35,8,17,0,1,9,37,52,4,0,38,62,23,38,9,24,5,9,9,32,62
2007-02-19 00:00:00.000,Rotterdam The Netherlands ATP World Tour,HARD,2,Mikhail Youzhny,Robin Haase,Mikhail Youzhny,6-2; 6-4,R16,96,5,0,43,60,33,43,8,17,4,4,9,41,60,5,0,49,90,29,49,20,41,17,20,9,49,90
2007-02-19 00:00:00.000,Rotterdam The Netherlands ATP World Tour,HARD,2,Novak Djokovic,Andrei Pavel,Novak Djokovic,6-7(8); 6-1; 6-3,R16,129,9,2,61,80,48,61,12,19,1,2,14,60,80,2,1,76,116,54,76,12,40,11,16,14,66,116
2007-02-19 00:00:00.000,Rotterdam The Netherlands ATP World Tour,HARD,2,Tommy Robredo,Rik De Voest,Tommy Robredo,6-0; 6-4,R16,78,3,3,36,58,25,36,11,22,9,10,8,36,58,0,0,28,52,19,28,5,24,3,8,8,24,52
2007-02-19 00:00:00.000,Rotterdam The Netherlands ATP World Tour,HARD,2,Nikolay Davydenko,Philipp Kohlschreiber,Nikolay Davydenko,6-7(6); 6-4; 6-4,Q,125,10,2,53,87,45,53,23,34,0,1,16,68,87,8,4,51,91,38,51,24,40,2,5,16,62,91
2007-02-19 00:00:00.000,Rotterdam The Netherlands ATP World Tour,HARD,2,Ivan Ljubicic,Florian Mayer,Ivan Ljubicic,6-4; 6-2,Q,56,13,1,28,44,28,28,8,16,0,0,9,36,44,5,0,33,47,22,33,6,14,1,4,9,28,47
2007-02-19 00:00:00.000,Rotterdam The Netherlands ATP World Tour,HARD,2,Mikhail Youzhny,David Ferrer,Mikhail Youzhny,6-2; 7-5,Q,81,6,0,34,56,28,34,10,22,3,5,10,38,56,1,1,48,68,25,48,12,20,4,9,10,37,68
2007-02-19 00:00:00.000,Rotterdam The Netherlands ATP World Tour,HARD,2,Novak Djokovic,Tommy Robredo,Novak Djokovic,4-6; 6-4; 7-5,Q,146,4,2,65,93,49,65,11,28,2,5,16,60,93,6,0,54,94,38,54,20,40,6,10,16,58,94
2007-02-19 00:00:00.000,Rotterdam The Netherlands ATP World Tour,HARD,2,Ivan Ljubicic,Nikolay Davydenko,Ivan Ljubicic,4-6; 7-6(4); 7-6(4),S,170,24,1,74,114,61,74,18,40,3,5,17,79,114,5,3,80,119,59,80,19,39,5,6,17,78,119
2007-02-19 00:00:00.000,Rotterdam The Netherlands ATP World Tour,HARD,2,Mikhail Youzhny,Novak Djokovic,Mikhail Youzhny,3-6; 7-6(7); 7-5,S,0,0,0,0,0,0,0,0,0,0,0,0,0,0,0,0,0,0,0,0,0,0,0,0,0,0,0
2007-02-19 00:00:00.000,Rotterdam The Netherlands ATP World Tour,HARD,2,Mikhail Youzhny,Ivan Ljubicic,Mikhail Youzhny,6-2; 6-4,F,65,14,0,29,47,28,29,9,18,0,0,9,37,47,14,1,31,47,21,31,7,16,0,3,9,28,47
2007-02-26 00:00:00.000,Acapulco Mexico ATP World Tour,CLAY,2,Juan Carlos Ferrero,Potito Starace,Juan Carlos Ferrero,7-6(3); 4-6; 6-3,R32,168,1,1,96,122,62,96,12,26,14,17,16,74,122,5,2,79,118,50,79,20,39,10,13,15,70,118
2007-02-26 00:00:00.000,Acapulco Mexico ATP World Tour,CLAY,2,Lukas Dlouhy,Alessio Di Mauro,Lukas Dlouhy,6-3; 6-2,R32,61,3,2,33,50,25,33,10,17,1,2,9,35,50,0,2,32,63,21,32,10,31,9,13,8,31,63
2007-02-26 00:00:00.000,Acapulco Mexico ATP World Tour,CLAY,2,Juan-Pablo Guzman,Kevin Kim,Juan-Pablo Guzman,6-4; 6-2,R32,61,7,1,43,62,31,43,8,19,3,4,9,39,62,4,4,31,49,22,31,6,18,3,7,9,28,49
2007-02-26 00:00:00.000,Acapulco Mexico ATP World Tour,CLAY,2,Gaston Gaudio,Luis Horna,Gaston Gaudio,1-1 RET,R32,15,2,0,3,4,3,3,1,1,0,0,1,4,4,0,1,6,8,4,6,0,2,0,0,1,4,8
2007-02-26 00:00:00.000,Acapulco Mexico ATP World Tour,CLAY,2,Nicolas Almagro,Mariano Zabaleta,Nicolas Almagro,6-3; 6-4,R32,81,14,0,42,67,34,42,9,25,5,6,10,43,67,2,4,27,56,20,27,13,29,1,4,9,33,56
2007-02-26 00:00:00.000,Acapulco Mexico ATP World Tour,CLAY,2,Ruben Ramirez Hidalgo,Santiago Gonzalez,Ruben Ramirez Hidalgo,6-4; 6-3,R32,76,1,6,39,68,26,39,16,29,3,6,10,42,68,0,5,45,59,25,45,5,14,5,10,9,30,59
2007-02-26 00:00:00.000,Acapulco Mexico ATP World Tour,CLAY,2,Diego Hartfield,Hugo Armando,Diego Hartfield,6-4; 7-6(4),R32,116,1,1,52,68,41,52,8,16,4,5,11,49,68,4,6,43,86,27,43,23,43,3,5,11,50,86
2007-02-26 00:00:00.000,Acapulco Mexico ATP World Tour,CLAY,2,Carlos Moya,Bruno Echagaray,Carlos Moya,6-3; 6-4,R32,69,8,1,32,52,26,32,13,20,2,3,10,39,52,1,2,37,56,23,37,10,19,2,5,9,33,56
2007-02-26 00:00:00.000,Acapulco Mexico ATP World Tour,CLAY,2,Nicolas Massu,Juan Monaco,Nicolas Massu,7-6(4); 7-5,R32,123,8,4,47,74,35,47,19,27,0,1,12,54,74,3,3,58,87,40,58,13,29,5,7,12,53,87
2007-02-26 00:00:00.000,Acapulco Mexico ATP World Tour,CLAY,2,Stefano Galvani,Jan Hajek,Stefano Galvani,6-3; 6-2,R32,61,10,2,32,60,28,32,14,28,1,1,9,42,60,8,1,21,38,16,21,6,17,1,4,8,22,38
2007-02-26 00:00:00.000,Acapulco Mexico ATP World Tour,CLAY,2,Nicolas Devilder,Fabio Fognini,Nicolas Devilder,7-6(2); 6-7(5); 6-4,R32,183,2,4,100,127,68,100,15,27,6,8,17,83,127,8,7,61,127,44,61,34,66,9,12,17,78,127
2007-02-26 00:00:00.000,Acapulco Mexico ATP World Tour,CLAY,2,Juan Ignacio Chela,Sergio Roitman,Juan Ignacio Chela,6-3; 6-2,R32,74,3,1,33,52,27,33,10,19,1,2,9,37,52,2,2,37,60,22,37,8,23,4,8,8,30,60
2007-02-26 00:00:00.000,Acapulco Mexico ATP World Tour,CLAY,2,Jose Acasuso,Albert Montanes,Jose Acasuso,6-0; 7-5,R32,73,10,0,33,44,27,33,9,11,0,0,9,36,44,3,3,38,65,21,38,15,27,7,11,9,36,65
2007-02-26 00:00:00.000,Acapulco Mexico ATP World Tour,CLAY,2,Jiri Vanek,Martin Vassallo Arguello,Jiri Vanek,2-6; 6-1; 6-3,R32,111,5,3,54,75,34,54,10,21,1,5,12,44,75,1,1,55,75,32,55,8,20,6,12,12,40,75
2007-02-26 00:00:00.000,Acapulco Mexico ATP World Tour,CLAY,2,Oscar Hernandez,Fernando Vicente,Oscar Hernandez,6-2; 7-5,R32,95,0,1,45,55,37,45,5,10,1,1,10,42,55,1,1,46,73,29,46,13,27,6,9,10,42,73
2007-02-26 00:00:00.000,Acapulco Mexico ATP World Tour,CLAY,2,Agustin Calleri,Alberto Martin,Agustin Calleri,6-3; 6-2,R32,69,11,1,31,56,26,31,14,25,1,1,9,40,56,0,2,24,46,14,24,12,22,2,5,8,26,46
2007-02-26 00:00:00.000,Acapulco Mexico ATP World Tour,CLAY,2,Juan Carlos Ferrero,Lukas Dlouhy,Juan Carlos Ferrero,6-3; 7-6(2),R16,124,2,1,60,77,40,60,10,17,9,11,11,50,77,7,6,44,68,31,44,8,24,3,6,10,39,68
2007-02-26 00:00:00.000,Acapulco Mexico ATP World Tour,CLAY,2,Gaston Gaudio,Juan-Pablo Guzman,Gaston Gaudio,1-6; 6-3; 6-2,R16,120,1,3,61,87,40,61,10,26,4,8,12,50,87,3,0,46,87,30,46,16,41,9,14,12,46,87
2007-02-26 00:00:00.000,Acapulco Mexico ATP World Tour,CLAY,2,Nicolas Almagro,Ruben Ramirez Hidalgo,Nicolas Almagro,6-1; 4-6; 7-6(2),R16,113,10,9,45,81,37,45,16,36,4,8,14,53,81,2,12,48,98,32,48,18,50,5,11,15,50,98
2007-02-26 00:00:00.000,Acapulco Mexico ATP World Tour,CLAY,2,Carlos Moya,Diego Hartfield,Carlos Moya,4-6; 6-1; 4-6,R16,0,3,3,52,76,30,52,15,24,1,5,13,45,76,4,2,45,82,26,45,22,37,2,7,14,48,82
2007-02-26 00:00:00.000,Acapulco Mexico ATP World Tour,CLAY,2,Nicolas Massu,Stefano Galvani,Nicolas Massu,7-6(2); 6-3,R16,121,3,4,44,75,29,44,19,31,5,7,11,48,75,0,7,49,77,35,49,8,28,5,8,10,43,77
2007-02-26 00:00:00.000,Acapulco Mexico ATP World Tour,CLAY,2,Juan Ignacio Chela,Nicolas Devilder,Juan Ignacio Chela,6-0; 6-4,R16,78,4,2,32,55,25,32,13,23,4,4,8,38,55,2,1,39,56,19,39,9,17,3,7,8,28,56
2007-02-26 00:00:00.000,Acapulco Mexico ATP World Tour,CLAY,2,Jose Acasuso,Jiri Vanek,Jose Acasuso,6-1; 6-2,R16,70,2,1,22,42,19,22,13,20,3,3,7,32,42,2,2,35,66,22,35,8,31,7,12,8,30,66
2007-02-26 00:00:00.000,Acapulco Mexico ATP World Tour,CLAY,2,Agustin Calleri,Oscar Hernandez,Agustin Calleri,4-6; 6-3; 6-3,R16,119,11,0,49,80,39,49,20,31,5,6,14,59,80,2,1,68,87,42,68,11,19,5,8,14,53,87
2007-02-26 00:00:00.000,Acapulco Mexico ATP World Tour,CLAY,2,Juan Carlos Ferrero,Gaston Gaudio,Juan Carlos Ferrero,6-4; 6-1,Q,86,2,0,28,39,20,28,10,11,2,3,8,30,39,0,2,41,66,22,41,11,25,5,10,9,33,66
2007-02-26 00:00:00.000,Acapulco Mexico ATP World Tour,CLAY,2,Carlos Moya,Nicolas Almagro,Carlos Moya,7-6(3); 6-3,Q,95,11,0,53,76,38,53,11,23,6,7,11,49,76,5,1,49,73,34,49,10,24,4,6,10,44,73
2007-02-26 00:00:00.000,Acapulco Mexico ATP World Tour,CLAY,2,Juan Ignacio Chela,Nicolas Massu,Juan Ignacio Chela,6-3; 6-7(6); 7-5,Q,219,2,3,71,109,54,71,18,38,5,9,17,72,109,8,6,83,124,51,83,21,41,12,18,16,72,124
2007-02-26 00:00:00.000,Acapulco Mexico ATP World Tour,CLAY,2,Agustin Calleri,Jose Acasuso,Agustin Calleri,6-3; 6-4,Q,84,7,2,27,58,19,27,15,31,3,6,9,34,58,3,7,27,66,16,27,15,39,3,9,10,31,66
2007-02-26 00:00:00.000,Acapulco Mexico ATP World Tour,CLAY,2,Carlos Moya,Juan Carlos Ferrero,Carlos Moya,2-6; 6-2; 6-3,S,110,4,4,51,91,36,51,19,40,2,4,13,55,91,3,0,48,61,29,48,10,13,0,3,12,39,61
2007-02-26 00:00:00.000,Acapulco Mexico ATP World Tour,CLAY,2,Juan Ignacio Chela,Agustin Calleri,Juan Ignacio Chela,4-6; 5-5 RET,S,95,0,3,42,62,32,42,8,20,2,4,10,40,62,5,5,38,65,29,38,12,27,0,1,10,41,65
2007-02-26 00:00:00.000,Acapulco Mexico ATP World Tour,CLAY,2,Juan Ignacio Chela,Carlos Moya,Juan Ignacio Chela,6-3; 7-6(2),F,106,2,3,54,80,40,54,15,26,3,3,11,55,80,2,4,43,68,30,43,13,25,4,5,10,43,68
2007-02-26 00:00:00.000,Dubai U.A.E. ATP World Tour,HARD,2,Roger Federer,Kristian Pless,Roger Federer,7-6(2); 3-6; 6-3,R32,88,11,0,54,80,42,54,19,26,0,1,15,61,80,9,3,60,94,45,60,18,34,5,6,15,63,94
2007-02-26 00:00:00.000,Dubai U.A.E. ATP World Tour,HARD,2,Daniele Bracciali,Oliver Marach,Daniele Bracciali,6-4; 6-3,R32,89,7,1,30,46,26,30,10,16,0,0,9,36,46,4,4,47,79,28,47,16,32,7,10,10,44,79
2007-02-26 00:00:00.000,Dubai U.A.E. ATP World Tour,HARD,2,Rainer Schuettler,Andreas Seppi,Rainer Schuettler,6-0; 7-6(5),R32,87,0,1,33,57,24,33,16,24,2,3,9,40,57,3,2,43,59,26,43,5,16,3,7,9,31,59
2007-02-26 00:00:00.000,Dubai U.A.E. ATP World Tour,HARD,2,Novak Djokovic,Kristof Vliegen,Novak Djokovic,4-6; 6-4; 6-3,R32,114,6,4,54,88,40,54,18,34,3,6,15,58,88,5,2,55,84,35,55,14,29,1,5,14,49,84
2007-02-26 00:00:00.000,Dubai U.A.E. ATP World Tour,HARD,2,Nikolay Davydenko,Younes El Aynaoui,Nikolay Davydenko,6-7(2); 7-5; 7-5,R32,170,5,8,75,113,58,75,20,38,5,7,18,78,113,8,4,84,129,58,84,22,45,7,11,18,80,129
2007-02-26 00:00:00.000,Dubai U.A.E. ATP World Tour,HARD,2,Olivier Rochus,Hyung-Taik Lee,Olivier Rochus,7-6(4); 6-2,R32,91,1,1,41,69,26,41,18,28,6,8,10,44,69,6,2,38,64,20,38,15,26,1,5,10,35,64
2007-02-26 00:00:00.000,Dubai U.A.E. ATP World Tour,HARD,2,Florent Serra,Jonas Bjorkman,Florent Serra,5-7; 6-3; 6-2,R32,127,3,4,44,81,31,44,18,37,5,9,14,49,81,8,5,64,113,41,64,18,49,11,18,15,59,113
2007-02-26 00:00:00.000,Dubai U.A.E. ATP World Tour,HARD,2,Tommy Haas,Radek Stepanek,Tommy Haas,6-4; 6-3,R32,77,7,3,33,54,27,33,13,21,0,1,10,40,54,2,4,47,69,27,47,11,22,8,11,9,38,69
2007-02-26 00:00:00.000,Dubai U.A.E. ATP World Tour,HARD,2,Robin Soderling,David Ferrer,Robin Soderling,7-6(13); 6-1,R32,93,4,2,51,75,37,51,13,24,3,4,10,50,75,3,2,49,71,29,49,13,22,2,5,9,42,71
2007-02-26 00:00:00.000,Dubai U.A.E. ATP World Tour,HARD,2,Dominik Hrbaty,Omar Awadhy,Dominik Hrbaty,6-1; 6-2,R32,56,3,3,25,43,21,25,9,18,1,2,8,30,43,0,9,26,59,17,26,8,33,4,9,7,25,59
2007-02-26 00:00:00.000,Dubai U.A.E. ATP World Tour,HARD,2,Gilles Simon,Philipp Kohlschreiber,Gilles Simon,6-4; 6-4,R32,77,3,1,40,66,25,40,15,26,5,7,10,40,66,3,3,33,59,22,33,12,26,3,7,10,34,59
2007-02-26 00:00:00.000,Dubai U.A.E. ATP World Tour,HARD,2,Fabrice Santoro,Tommy Robredo,Fabrice Santoro,7-6(6); 6-4,R32,93,1,2,39,68,29,39,16,29,2,5,11,45,68,2,5,58,80,35,58,11,22,8,12,11,46,80
2007-02-26 00:00:00.000,Dubai U.A.E. ATP World Tour,HARD,2,Tomas Berdych,Mohammad Ghareeb,Tomas Berdych,3-6; 6-3; 6-2,R32,95,9,2,35,72,31,35,19,37,3,5,13,50,72,8,1,46,87,34,46,17,41,2,6,13,51,87
2007-02-26 00:00:00.000,Dubai U.A.E. ATP World Tour,HARD,2,Mikhail Youzhny,Jarkko Nieminen,Mikhail Youzhny,3-6; 6-3; 6-3,R32,113,3,3,50,79,38,50,11,29,3,6,14,49,79,6,2,45,94,30,45,22,49,8,12,13,52,94
2007-02-26 00:00:00.000,Dubai U.A.E. ATP World Tour,HARD,2,Igor Andreev,Marc Gicquel,Igor Andreev,6-7(4); 6-4; 7-5,R32,145,5,2,64,105,52,64,20,41,6,7,17,72,105,8,4,63,99,48,63,16,36,4,7,17,64,99
2007-02-26 00:00:00.000,Dubai U.A.E. ATP World Tour,HARD,2,Rafael Nadal,Marcos Baghdatis,Rafael Nadal,3-6; 6-2; 6-3,R32,118,5,0,42,65,34,42,14,23,3,5,13,48,65,16,8,41,87,34,41,17,46,4,8,13,51,87
2007-02-26 00:00:00.000,Dubai U.A.E. ATP World Tour,HARD,2,Roger Federer,Daniele Bracciali,Roger Federer,7-5; 6-3,R16,87,5,0,36,58,28,36,18,22,2,2,11,46,58,9,3,38,81,26,38,23,43,9,11,10,49,81
2007-02-26 00:00:00.000,Dubai U.A.E. ATP World Tour,HARD,2,Novak Djokovic,Rainer Schuettler,Novak Djokovic,7-6(5); 6-3,R16,98,7,3,48,67,37,48,11,19,3,3,10,48,67,5,3,47,84,30,47,22,37,11,13,11,52,84
2007-02-26 00:00:00.000,Dubai U.A.E. ATP World Tour,HARD,2,Olivier Rochus,Nikolay Davydenko,Olivier Rochus,4-6; 6-4; 6-2,R16,121,2,0,51,75,36,51,15,24,0,3,14,51,75,6,8,53,92,36,53,18,39,4,9,14,54,92
2007-02-26 00:00:00.000,Dubai U.A.E. ATP World Tour,HARD,2,Tommy Haas,Florent Serra,Tommy Haas,7-6(5); 6-3,R16,102,3,5,34,66,25,34,17,32,3,6,10,42,66,5,5,47,83,25,47,21,36,10,15,11,46,83
2007-02-26 00:00:00.000,Dubai U.A.E. ATP World Tour,HARD,2,Robin Soderling,Dominik Hrbaty,Robin Soderling,6-3; 7-5,R16,82,6,2,45,77,34,45,17,32,3,4,11,51,77,0,2,35,53,23,35,10,18,1,4,10,33,53
2007-02-26 00:00:00.000,Dubai U.A.E. ATP World Tour,HARD,2,Fabrice Santoro,Gilles Simon,Fabrice Santoro,6-4; 6-2,R16,64,1,0,22,42,18,22,14,20,0,1,9,32,42,3,3,31,56,17,31,14,25,5,9,9,31,56
2007-02-26 00:00:00.000,Dubai U.A.E. ATP World Tour,HARD,2,Mikhail Youzhny,Tomas Berdych,Mikhail Youzhny,7-6(6); 6-3,R16,96,10,2,42,73,31,42,20,31,0,1,11,51,73,5,2,33,71,25,33,22,38,7,9,10,47,71
2007-02-26 00:00:00.000,Dubai U.A.E. ATP World Tour,HARD,2,Rafael Nadal,Igor Andreev,Rafael Nadal,6-2; 3-6; 7-6(2),R16,153,1,1,62,87,44,62,17,25,3,5,14,61,87,3,1,78,106,54,78,12,28,6,9,15,66,106
2007-02-26 00:00:00.000,Dubai U.A.E. ATP World Tour,HARD,2,Roger Federer,Novak Djokovic,Roger Federer,6-3; 6-7(6); 6-3,Q,123,8,1,62,100,46,62,22,38,3,5,16,68,100,6,4,63,98,42,63,17,35,3,7,14,59,98
2007-02-26 00:00:00.000,Dubai U.A.E. ATP World Tour,HARD,2,Tommy Haas,Olivier Rochus,Tommy Haas,6-0; 6-2,Q,50,2,1,22,33,19,22,9,11,0,0,7,28,33,2,0,29,48,15,29,5,19,1,6,7,20,48
2007-02-26 00:00:00.000,Dubai U.A.E. ATP World Tour,HARD,2,Robin Soderling,Fabrice Santoro,Robin Soderling,6-1; 6-7(2); 6-0,Q,123,10,3,62,95,44,62,16,33,8,9,13,60,95,5,3,37,87,23,37,22,50,9,15,12,45,87
2007-02-26 00:00:00.000,Dubai U.A.E. ATP World Tour,HARD,2,Mikhail Youzhny,Rafael Nadal,Mikhail Youzhny,7-6(5); 6-3,Q,114,11,1,43,72,33,43,18,29,2,3,11,51,72,2,3,41,73,26,41,21,32,4,6,10,47,73
2007-02-26 00:00:00.000,Dubai U.A.E. ATP World Tour,HARD,2,Roger Federer,Tommy Haas,Roger Federer,6-4; 7-5,S,91,11,0,43,75,33,43,20,32,5,5,11,53,75,5,0,40,63,28,40,13,23,3,5,11,41,63
2007-02-26 00:00:00.000,Dubai U.A.E. ATP World Tour,HARD,2,Mikhail Youzhny,Robin Soderling,Mikhail Youzhny,7-5; 6-2,S,75,7,0,35,50,32,35,9,15,2,2,10,41,50,8,3,47,69,30,47,9,22,6,9,10,39,69
2007-02-26 00:00:00.000,Dubai U.A.E. ATP World Tour,HARD,2,Roger Federer,Mikhail Youzhny,Roger Federer,6-4; 6-3,F,85,4,0,29,51,23,29,12,22,0,2,10,35,51,3,4,38,73,23,38,15,35,14,18,9,38,73
2007-03-05 00:00:00.000,ATP Masters Series Indian Wells CA; U.S.A. ATP World Tour,HARD,2,Roger Federer,N/A Bye,Roger Federer,,R128,0,0,0,0,0,0,0,0,0,0,0,0,0,0,0,0,0,0,0,0,0,0,0,0,0,0,0
2007-03-05 00:00:00.000,ATP Masters Series Indian Wells CA; U.S.A. ATP World Tour,HARD,2,Guillermo Canas,Jan Hajek,Guillermo Canas,6-1; 6-1,R128,49,10,2,23,44,19,23,12,21,4,4,7,31,44,1,3,21,46,12,21,7,25,2,7,7,19,46
2007-03-05 00:00:00.000,ATP Masters Series Indian Wells CA; U.S.A. ATP World Tour,HARD,2,Carlos Moya,Paul Capdeville,Carlos Moya,6-4; 6-4,R128,79,6,0,35,60,29,35,17,25,5,5,10,46,60,2,4,44,68,28,44,13,24,5,7,10,41,68
2007-03-05 00:00:00.000,ATP Masters Series Indian Wells CA; U.S.A. ATP World Tour,HARD,2,Radek Stepanek,N/A Bye,Radek Stepanek,,R128,0,0,0,0,0,0,0,0,0,0,0,0,0,0,0,0,0,0,0,0,0,0,0,0,0,0,0
2007-03-05 00:00:00.000,ATP Masters Series Indian Wells CA; U.S.A. ATP World Tour,HARD,2,Lleyton Hewitt,N/A Bye,Lleyton Hewitt,,R128,0,0,0,0,0,0,0,0,0,0,0,0,0,0,0,0,0,0,0,0,0,0,0,0,0,0,0
2007-03-05 00:00:00.000,ATP Masters Series Indian Wells CA; U.S.A. ATP World Tour,HARD,2,Janko Tipsarevic,Paradorn Srichaphan,Janko Tipsarevic,6-4; 6-2,R128,70,4,0,29,50,21,29,17,21,1,1,9,38,50,7,2,40,67,25,40,13,27,10,13,9,38,67
2007-03-05 00:00:00.000,ATP Masters Series Indian Wells CA; U.S.A. ATP World Tour,HARD,2,Luis Horna,Filippo Volandri,Luis Horna,6-0; 4-6; 6-2,R128,96,1,6,64,85,45,64,6,21,4,6,12,51,85,3,3,46,70,26,46,8,24,2,8,12,34,70
2007-03-05 00:00:00.000,ATP Masters Series Indian Wells CA; U.S.A. ATP World Tour,HARD,2,David Ferrer,N/A Bye,David Ferrer,,R128,0,0,0,0,0,0,0,0,0,0,0,0,0,0,0,0,0,0,0,0,0,0,0,0,0,0,0
2007-03-05 00:00:00.000,ATP Masters Series Indian Wells CA; U.S.A. ATP World Tour,HARD,2,Novak Djokovic,N/A Bye,Novak Djokovic,,R128,0,0,0,0,0,0,0,0,0,0,0,0,0,0,0,0,0,0,0,0,0,0,0,0,0,0,0
2007-03-05 00:00:00.000,ATP Masters Series Indian Wells CA; U.S.A. ATP World Tour,HARD,2,Robby Ginepri,Robert Kendrick,Robby Ginepri,7-5; 7-6(3),R128,86,0,1,42,69,33,42,17,27,0,1,12,50,69,7,3,57,84,38,57,15,27,5,7,12,53,84
2007-03-05 00:00:00.000,ATP Masters Series Indian Wells CA; U.S.A. ATP World Tour,HARD,2,Evgeny Korolev,Simon Greul,Evgeny Korolev,6-7(6); 7-5; 6-1,R128,121,14,2,86,117,61,86,14,31,8,10,16,75,117,7,2,49,84,37,49,15,35,2,7,15,52,84
2007-03-05 00:00:00.000,ATP Masters Series Indian Wells CA; U.S.A. ATP World Tour,HARD,2,Dmitry Tursunov,N/A Bye,Dmitry Tursunov,,R128,0,0,0,0,0,0,0,0,0,0,0,0,0,0,0,0,0,0,0,0,0,0,0,0,0,0,0
2007-03-05 00:00:00.000,ATP Masters Series Indian Wells CA; U.S.A. ATP World Tour,HARD,2,Jurgen Melzer,N/A Bye,Jurgen Melzer,,R128,0,0,0,0,0,0,0,0,0,0,0,0,0,0,0,0,0,0,0,0,0,0,0,0,0,0,0
2007-03-05 00:00:00.000,ATP Masters Series Indian Wells CA; U.S.A. ATP World Tour,HARD,2,Julien Benneteau,Gael Monfils,Julien Benneteau,3-6; 6-3; 7-5,R128,126,0,2,48,81,31,48,23,33,3,6,15,54,81,13,2,63,99,47,63,14,36,6,10,15,61,99
2007-03-05 00:00:00.000,ATP Masters Series Indian Wells CA; U.S.A. ATP World Tour,HARD,2,Florent Serra,Kristian Pless,Florent Serra,7-6(6); 6-4,R128,76,5,2,41,72,35,41,17,31,3,3,11,52,72,6,0,41,66,30,41,16,25,2,3,11,46,66
2007-03-05 00:00:00.000,ATP Masters Series Indian Wells CA; U.S.A. ATP World Tour,HARD,2,James Blake,N/A Bye,James Blake,,R128,0,0,0,0,0,0,0,0,0,0,0,0,0,0,0,0,0,0,0,0,0,0,0,0,0,0,0
2007-03-05 00:00:00.000,ATP Masters Series Indian Wells CA; U.S.A. ATP World Tour,HARD,2,Nikolay Davydenko,N/A Bye,Nikolay Davydenko,,R128,0,0,0,0,0,0,0,0,0,0,0,0,0,0,0,0,0,0,0,0,0,0,0,0,0,0,0
2007-03-05 00:00:00.000,ATP Masters Series Indian Wells CA; U.S.A. ATP World Tour,HARD,2,Sam Querrey,Christophe Rochus,Sam Querrey,6-2; 6-4,R128,73,14,1,36,59,28,36,10,23,6,7,9,38,59,2,1,35,64,19,35,12,29,2,6,9,31,64
2007-03-05 00:00:00.000,ATP Masters Series Indian Wells CA; U.S.A. ATP World Tour,HARD,2,Jan Hernych,Tim Henman,Jan Hernych,7-5; 3-6; 7-5,R128,143,2,1,60,93,36,60,19,33,4,10,16,55,93,6,4,66,108,39,66,20,42,7,14,17,59,108
2007-03-05 00:00:00.000,ATP Masters Series Indian Wells CA; U.S.A. ATP World Tour,HARD,2,Agustin Calleri,N/A Bye,Agustin Calleri,,R128,0,0,0,0,0,0,0,0,0,0,0,0,0,0,0,0,0,0,0,0,0,0,0,0,0,0,0
2007-03-05 00:00:00.000,ATP Masters Series Indian Wells CA; U.S.A. ATP World Tour,HARD,2,Marat Safin,N/A Bye,Marat Safin,,R128,0,0,0,0,0,0,0,0,0,0,0,0,0,0,0,0,0,0,0,0,0,0,0,0,0,0,0
2007-03-05 00:00:00.000,ATP Masters Series Indian Wells CA; U.S.A. ATP World Tour,HARD,2,Nicolas Mahut,Juan Monaco,Nicolas Mahut,3-6; 6-3; 7-6(2),R128,133,7,7,53,96,39,53,20,43,7,10,15,59,96,7,3,57,94,42,57,17,37,2,5,15,59,94
2007-03-05 00:00:00.000,ATP Masters Series Indian Wells CA; U.S.A. ATP World Tour,HARD,2,Wesley Moodie,Lukas Dlouhy,Wesley Moodie,7-5; 6-3,R128,62,9,2,44,60,36,44,11,16,1,1,11,47,60,4,3,34,59,23,34,17,25,4,6,10,40,59
2007-03-05 00:00:00.000,ATP Masters Series Indian Wells CA; U.S.A. ATP World Tour,HARD,2,Andy Murray,N/A Bye,Andy Murray,,R128,0,0,0,0,0,0,0,0,0,0,0,0,0,0,0,0,0,0,0,0,0,0,0,0,0,0,0
2007-03-05 00:00:00.000,ATP Masters Series Indian Wells CA; U.S.A. ATP World Tour,HARD,2,Tommy Haas,N/A Bye,Tommy Haas,,R128,0,0,0,0,0,0,0,0,0,0,0,0,0,0,0,0,0,0,0,0,0,0,0,0,0,0,0
2007-03-05 00:00:00.000,ATP Masters Series Indian Wells CA; U.S.A. ATP World Tour,HARD,2,Michael Llodra,Tomas Zib,Michael Llodra,6-4; 6-4,R128,80,11,2,30,50,22,30,13,20,1,3,10,35,50,1,4,45,76,28,45,12,31,9,13,10,40,76
2007-03-05 00:00:00.000,ATP Masters Series Indian Wells CA; U.S.A. ATP World Tour,HARD,2,Teymuraz Gabashvili,Kristof Vliegen,Teymuraz Gabashvili,6-3; 6-4,R128,72,6,2,24,49,23,24,14,25,0,1,10,37,49,5,2,41,63,26,41,11,22,4,7,9,37,63
2007-03-05 00:00:00.000,ATP Masters Series Indian Wells CA; U.S.A. ATP World Tour,HARD,2,Dominik Hrbaty,N/A Bye,Dominik Hrbaty,,R128,0,0,0,0,0,0,0,0,0,0,0,0,0,0,0,0,0,0,0,0,0,0,0,0,0,0,0
2007-03-05 00:00:00.000,ATP Masters Series Indian Wells CA; U.S.A. ATP World Tour,HARD,2,Robin Soderling,N/A Bye,Robin Soderling,,R128,0,0,0,0,0,0,0,0,0,0,0,0,0,0,0,0,0,0,0,0,0,0,0,0,0,0,0
2007-03-05 00:00:00.000,ATP Masters Series Indian Wells CA; U.S.A. ATP World Tour,HARD,2,Daniele Bracciali,Justin Gimelstob,Daniele Bracciali,6-2; 6-1,R128,66,4,2,25,51,17,25,16,26,1,1,7,33,51,3,5,20,50,11,20,12,30,5,10,8,23,50
2007-03-05 00:00:00.000,ATP Masters Series Indian Wells CA; U.S.A. ATP World Tour,HARD,2,Frank Dancevic,Alexander Waske,Frank Dancevic,6-1; 6-7(5); 6-4,R128,102,17,2,54,83,43,54,20,29,2,3,15,63,83,9,3,61,88,41,61,15,27,7,11,14,56,88
2007-03-05 00:00:00.000,ATP Masters Series Indian Wells CA; U.S.A. ATP World Tour,HARD,2,Fernando Gonzalez,N/A Bye,Fernando Gonzalez,,R128,0,0,0,0,0,0,0,0,0,0,0,0,0,0,0,0,0,0,0,0,0,0,0,0,0,0,0
2007-03-05 00:00:00.000,ATP Masters Series Indian Wells CA; U.S.A. ATP World Tour,HARD,2,Ivan Ljubicic,N/A Bye,Ivan Ljubicic,,R128,0,0,0,0,0,0,0,0,0,0,0,0,0,0,0,0,0,0,0,0,0,0,0,0,0,0,0
2007-03-05 00:00:00.000,ATP Masters Series Indian Wells CA; U.S.A. ATP World Tour,HARD,2,Alejandro Falla,Benjamin Becker,Alejandro Falla,7-6(1); 6-3,R128,89,5,3,45,73,34,45,16,28,3,4,11,50,73,8,3,35,75,27,35,16,40,5,7,10,43,75
2007-03-05 00:00:00.000,ATP Masters Series Indian Wells CA; U.S.A. ATP World Tour,HARD,2,Thomas Johansson,Max Mirnyi,Thomas Johansson,6-4; 7-6(7),R128,75,12,2,37,65,32,37,17,28,0,0,11,49,65,8,4,34,61,31,34,15,27,0,1,11,46,61
2007-03-05 00:00:00.000,ATP Masters Series Indian Wells CA; U.S.A. ATP World Tour,HARD,2,Nicolas Almagro,N/A Bye,Nicolas Almagro,,R128,0,0,0,0,0,0,0,0,0,0,0,0,0,0,0,0,0,0,0,0,0,0,0,0,0,0,0
2007-03-05 00:00:00.000,ATP Masters Series Indian Wells CA; U.S.A. ATP World Tour,HARD,2,Mardy Fish,N/A Bye,Mardy Fish,,R128,0,0,0,0,0,0,0,0,0,0,0,0,0,0,0,0,0,0,0,0,0,0,0,0,0,0,0
2007-03-05 00:00:00.000,ATP Masters Series Indian Wells CA; U.S.A. ATP World Tour,HARD,2,Paul-Henri Mathieu,Alberto Martin,Paul-Henri Mathieu,6-4; 6-1,R128,83,5,1,33,57,27,33,11,24,4,5,9,38,57,2,5,24,56,15,24,13,32,5,9,8,28,56
2007-03-05 00:00:00.000,ATP Masters Series Indian Wells CA; U.S.A. ATP World Tour,HARD,2,Philipp Kohlschreiber,Hyung-Taik Lee,Philipp Kohlschreiber,6-4; 7-5,R128,76,4,0,40,58,30,40,16,18,1,1,11,46,58,1,1,38,58,27,38,12,20,0,2,11,39,58
2007-03-05 00:00:00.000,ATP Masters Series Indian Wells CA; U.S.A. ATP World Tour,HARD,2,David Nalbandian,N/A Bye,David Nalbandian,,R128,0,0,0,0,0,0,0,0,0,0,0,0,0,0,0,0,0,0,0,0,0,0,0,0,0,0,0
2007-03-05 00:00:00.000,ATP Masters Series Indian Wells CA; U.S.A. ATP World Tour,HARD,2,Richard Gasquet,N/A Bye,Richard Gasquet,,R128,0,0,0,0,0,0,0,0,0,0,0,0,0,0,0,0,0,0,0,0,0,0,0,0,0,0,0
2007-03-05 00:00:00.000,ATP Masters Series Indian Wells CA; U.S.A. ATP World Tour,HARD,2,Juan Martin Del Potro,Gustavo Kuerten,Juan Martin Del Potro,7-6(5); 6-2,R128,88,11,4,36,64,32,36,15,28,3,4,10,47,64,6,2,37,76,25,37,18,39,2,5,10,43,76
2007-03-05 00:00:00.000,ATP Masters Series Indian Wells CA; U.S.A. ATP World Tour,HARD,2,Paul Goldstein,Sergio Roitman,Paul Goldstein,6-3; 7-6(3),R128,93,0,2,54,71,40,54,7,17,2,4,11,47,71,6,3,46,77,33,46,11,31,5,8,10,44,77
2007-03-05 00:00:00.000,ATP Masters Series Indian Wells CA; U.S.A. ATP World Tour,HARD,2,Jarkko Nieminen,N/A Bye,Jarkko Nieminen,,R128,0,0,0,0,0,0,0,0,0,0,0,0,0,0,0,0,0,0,0,0,0,0,0,0,0,0,0
2007-03-05 00:00:00.000,ATP Masters Series Indian Wells CA; U.S.A. ATP World Tour,HARD,2,Olivier Rochus,N/A Bye,Olivier Rochus,,R128,0,0,0,0,0,0,0,0,0,0,0,0,0,0,0,0,0,0,0,0,0,0,0,0,0,0,0
2007-03-05 00:00:00.000,ATP Masters Series Indian Wells CA; U.S.A. ATP World Tour,HARD,2,Vincent Spadea,Stefan Koubek,Vincent Spadea,6-1; 6-2,R128,59,3,0,29,48,20,29,16,19,1,1,8,36,48,1,2,29,53,17,29,8,24,3,7,7,25,53
2007-03-05 00:00:00.000,ATP Masters Series Indian Wells CA; U.S.A. ATP World Tour,HARD,2,Feliciano Lopez,Chris Guccione,Feliciano Lopez,6-2; 7-6(6),R128,86,6,1,40,68,31,40,19,28,0,0,10,50,68,15,3,36,73,27,36,20,37,4,6,10,47,73
2007-03-05 00:00:00.000,ATP Masters Series Indian Wells CA; U.S.A. ATP World Tour,HARD,2,Andy Roddick,N/A Bye,Andy Roddick,,R128,0,0,0,0,0,0,0,0,0,0,0,0,0,0,0,0,0,0,0,0,0,0,0,0,0,0,0
2007-03-05 00:00:00.000,ATP Masters Series Indian Wells CA; U.S.A. ATP World Tour,HARD,2,Tommy Robredo,N/A Bye,Tommy Robredo,,R128,0,0,0,0,0,0,0,0,0,0,0,0,0,0,0,0,0,0,0,0,0,0,0,0,0,0,0
2007-03-05 00:00:00.000,ATP Masters Series Indian Wells CA; U.S.A. ATP World Tour,HARD,2,Gilles Simon,Rainer Schuettler,Gilles Simon,6-1; 4-6; 7-5,R128,139,13,2,68,105,45,68,18,37,7,11,15,63,105,1,0,57,90,34,57,14,33,6,12,14,48,90
2007-03-05 00:00:00.000,ATP Masters Series Indian Wells CA; U.S.A. ATP World Tour,HARD,2,Jonas Bjorkman,Bjorn Phau,Jonas Bjorkman,3-6; 6-4; 7-6(4),R128,144,2,5,65,115,40,65,22,50,6,12,16,62,115,6,2,51,100,30,51,28,49,3,8,15,58,100
2007-03-05 00:00:00.000,ATP Masters Series Indian Wells CA; U.S.A. ATP World Tour,HARD,2,Juan Ignacio Chela,N/A Bye,Juan Ignacio Chela,,R128,0,0,0,0,0,0,0,0,0,0,0,0,0,0,0,0,0,0,0,0,0,0,0,0,0,0,0
2007-03-05 00:00:00.000,ATP Masters Series Indian Wells CA; U.S.A. ATP World Tour,HARD,2,Marcos Baghdatis,N/A Bye,Marcos Baghdatis,,R128,0,0,0,0,0,0,0,0,0,0,0,0,0,0,0,0,0,0,0,0,0,0,0,0,0,0,0
2007-03-05 00:00:00.000,ATP Masters Series Indian Wells CA; U.S.A. ATP World Tour,HARD,2,Guillermo Garcia-Lopez,Nicolas Massu,Guillermo Garcia-Lopez,6-3; 7-6(3),R128,161,9,2,51,79,41,51,14,28,6,7,11,55,79,3,1,40,66,30,40,12,26,1,3,10,42,66
2007-03-05 00:00:00.000,ATP Masters Series Indian Wells CA; U.S.A. ATP World Tour,HARD,2,Michael Russell,Marc Gicquel,Michael Russell,6-3; 7-5,R128,91,1,2,52,71,38,52,12,19,4,4,11,50,71,7,1,26,59,21,26,16,33,3,5,10,37,59
2007-03-05 00:00:00.000,ATP Masters Series Indian Wells CA; U.S.A. ATP World Tour,HARD,2,Tomas Berdych,N/A Bye,Tomas Berdych,,R128,0,0,0,0,0,0,0,0,0,0,0,0,0,0,0,0,0,0,0,0,0,0,0,0,0,0,0
2007-03-05 00:00:00.000,ATP Masters Series Indian Wells CA; U.S.A. ATP World Tour,HARD,2,Mikhail Youzhny,N/A Bye,Mikhail Youzhny,,R128,0,0,0,0,0,0,0,0,0,0,0,0,0,0,0,0,0,0,0,0,0,0,0,0,0,0,0
2007-03-05 00:00:00.000,ATP Masters Series Indian Wells CA; U.S.A. ATP World Tour,HARD,2,Jose Acasuso,Sebastien Grosjean,Jose Acasuso,6-4; 6-4,R128,85,6,2,39,59,31,39,11,20,3,3,10,42,59,2,2,37,65,27,37,14,28,6,8,10,41,65
2007-03-05 00:00:00.000,ATP Masters Series Indian Wells CA; U.S.A. ATP World Tour,HARD,2,Florian Mayer,Igor Kunitsyn,Florian Mayer,6-1; 6-2,R128,47,4,4,26,45,21,26,11,19,2,3,8,32,45,1,0,27,44,10,27,7,17,1,6,7,17,44
2007-03-05 00:00:00.000,ATP Masters Series Indian Wells CA; U.S.A. ATP World Tour,HARD,2,Juan Carlos Ferrero,N/A Bye,Juan Carlos Ferrero,,R128,0,0,0,0,0,0,0,0,0,0,0,0,0,0,0,0,0,0,0,0,0,0,0,0,0,0,0
2007-03-05 00:00:00.000,ATP Masters Series Indian Wells CA; U.S.A. ATP World Tour,HARD,2,Fernando Verdasco,N/A Bye,Fernando Verdasco,,R128,0,0,0,0,0,0,0,0,0,0,0,0,0,0,0,0,0,0,0,0,0,0,0,0,0,0,0
2007-03-05 00:00:00.000,ATP Masters Series Indian Wells CA; U.S.A. ATP World Tour,HARD,2,Andreas Seppi,Alex Kuznetsov,Andreas Seppi,6-4; 6-4,R128,69,4,3,33,53,28,33,14,20,2,2,10,42,53,6,1,32,55,24,32,15,23,3,5,10,39,55
2007-03-05 00:00:00.000,ATP Masters Series Indian Wells CA; U.S.A. ATP World Tour,HARD,2,Arnaud Clement,Viktor Troicki,Arnaud Clement,6-7(3); 6-4; 6-2,R128,164,2,2,69,119,50,69,22,50,11,14,15,72,119,6,1,56,94,36,56,19,38,2,8,15,55,94
2007-03-05 00:00:00.000,ATP Masters Series Indian Wells CA; U.S.A. ATP World Tour,HARD,2,Rafael Nadal,N/A Bye,Rafael Nadal,,R128,0,0,0,0,0,0,0,0,0,0,0,0,0,0,0,0,0,0,0,0,0,0,0,0,0,0,0
2007-03-05 00:00:00.000,ATP Masters Series Indian Wells CA; U.S.A. ATP World Tour,HARD,2,Guillermo Canas,Roger Federer,Guillermo Canas,7-5; 6-2,R64,105,1,1,42,68,29,42,14,26,2,3,10,43,68,5,2,44,77,30,44,12,33,3,7,10,42,77
2007-03-05 00:00:00.000,ATP Masters Series Indian Wells CA; U.S.A. ATP World Tour,HARD,2,Carlos Moya,Radek Stepanek,Carlos Moya,6-3; 6-4,R64,73,5,0,34,52,24,34,14,18,0,1,10,38,52,2,2,29,58,17,29,16,29,3,6,9,33,58
2007-03-05 00:00:00.000,ATP Masters Series Indian Wells CA; U.S.A. ATP World Tour,HARD,2,Janko Tipsarevic,Lleyton Hewitt,Janko Tipsarevic,7-6(3); 4-6; 6-2,R64,139,10,2,50,95,40,50,22,45,1,4,15,62,95,9,6,43,85,36,43,19,42,0,4,15,55,85
2007-03-05 00:00:00.000,ATP Masters Series Indian Wells CA; U.S.A. ATP World Tour,HARD,2,David Ferrer,Luis Horna,David Ferrer,6-3; 6-1,R64,68,8,2,30,44,25,30,7,14,0,1,8,32,44,1,1,41,64,21,41,9,23,6,11,8,30,64
2007-03-05 00:00:00.000,ATP Masters Series Indian Wells CA; U.S.A. ATP World Tour,HARD,2,Novak Djokovic,Robby Ginepri,Novak Djokovic,6-4; 6-4,R64,82,2,4,35,63,24,35,14,28,1,4,10,38,63,6,1,39,67,24,39,11,28,7,12,10,35,67
2007-03-05 00:00:00.000,ATP Masters Series Indian Wells CA; U.S.A. ATP World Tour,HARD,2,Evgeny Korolev,Dmitry Tursunov,Evgeny Korolev,6-4; 6-7(3); 6-3,R64,126,3,5,45,94,35,45,25,49,1,4,16,60,94,13,3,44,85,30,44,18,41,4,9,15,48,85
2007-03-05 00:00:00.000,ATP Masters Series Indian Wells CA; U.S.A. ATP World Tour,HARD,2,Julien Benneteau,Jurgen Melzer,Julien Benneteau,6-4; 6-4,R64,84,3,2,33,58,22,33,17,25,1,3,10,39,58,3,4,50,75,30,50,9,25,9,13,10,39,75
2007-03-05 00:00:00.000,ATP Masters Series Indian Wells CA; U.S.A. ATP World Tour,HARD,2,James Blake,Florent Serra,James Blake,6-3; 7-6(2),R64,64,5,0,34,54,31,34,16,20,0,0,11,47,54,4,0,36,57,28,36,12,21,0,1,10,40,57
2007-03-05 00:00:00.000,ATP Masters Series Indian Wells CA; U.S.A. ATP World Tour,HARD,2,Nikolay Davydenko,Sam Querrey,Nikolay Davydenko,2-6; 7-6(6); 6-2,R64,132,2,3,71,98,50,71,10,27,2,6,14,60,98,10,3,57,97,40,57,16,40,3,7,14,56,97
2007-03-05 00:00:00.000,ATP Masters Series Indian Wells CA; U.S.A. ATP World Tour,HARD,2,Jan Hernych,Agustin Calleri,Jan Hernych,6-3; 6-3,R64,68,4,1,38,55,28,38,12,17,8,8,9,40,55,4,4,34,64,25,34,11,30,0,3,9,36,64
2007-03-05 00:00:00.000,ATP Masters Series Indian Wells CA; U.S.A. ATP World Tour,HARD,2,Nicolas Mahut,Marat Safin,Nicolas Mahut,6-3; 4-6; 6-0,R64,98,9,8,39,79,34,39,22,40,2,3,13,56,79,6,1,32,65,24,32,16,33,1,5,12,40,65
2007-03-05 00:00:00.000,ATP Masters Series Indian Wells CA; U.S.A. ATP World Tour,HARD,2,Andy Murray,Wesley Moodie,Andy Murray,6-3; 6-3,R64,70,3,2,34,51,26,34,9,17,1,2,9,35,51,4,2,39,55,24,39,7,16,7,11,9,31,55
2007-03-05 00:00:00.000,ATP Masters Series Indian Wells CA; U.S.A. ATP World Tour,HARD,2,Tommy Haas,Michael Llodra,Tommy Haas,6-4; 6-1,R64,77,6,2,24,50,19,24,16,26,2,2,8,35,50,4,3,38,61,22,38,9,23,3,7,9,31,61
2007-03-05 00:00:00.000,ATP Masters Series Indian Wells CA; U.S.A. ATP World Tour,HARD,2,Teymuraz Gabashvili,Dominik Hrbaty,Teymuraz Gabashvili,7-5; 6-3,R64,78,7,7,33,71,24,33,20,38,11,13,11,44,71,3,3,28,57,21,28,11,29,3,7,10,32,57
2007-03-05 00:00:00.000,ATP Masters Series Indian Wells CA; U.S.A. ATP World Tour,HARD,2,Robin Soderling,Daniele Bracciali,Robin Soderling,6-3; 6-4,R64,69,9,4,23,51,18,23,20,28,0,1,10,38,51,0,1,29,58,20,29,12,29,8,11,9,32,58
2007-03-05 00:00:00.000,ATP Masters Series Indian Wells CA; U.S.A. ATP World Tour,HARD,2,Fernando Gonzalez,Frank Dancevic,Fernando Gonzalez,7-6(6); 1-6; 7-5,R64,119,6,5,61,97,43,61,17,36,2,5,15,60,97,18,4,62,100,49,62,17,38,4,6,16,66,100
2007-03-05 00:00:00.000,ATP Masters Series Indian Wells CA; U.S.A. ATP World Tour,HARD,2,Ivan Ljubicic,Alejandro Falla,Ivan Ljubicic,6-7(4); 6-4; 6-4,R64,210,14,2,58,96,47,58,19,38,1,3,16,66,96,4,0,66,109,46,66,23,43,9,13,16,69,109
2007-03-05 00:00:00.000,ATP Masters Series Indian Wells CA; U.S.A. ATP World Tour,HARD,2,Thomas Johansson,Nicolas Almagro,Thomas Johansson,7-6(4); 7-5,R64,98,11,2,46,85,41,46,16,39,5,6,12,57,85,13,2,41,75,29,41,20,34,1,3,12,49,75
2007-03-05 00:00:00.000,ATP Masters Series Indian Wells CA; U.S.A. ATP World Tour,HARD,2,Paul-Henri Mathieu,Mardy Fish,Paul-Henri Mathieu,7-6(4); 4-6; 7-6(5),R64,168,4,2,69,114,53,69,24,45,8,10,17,77,114,24,8,48,114,43,48,33,66,1,2,17,76,114
2007-03-05 00:00:00.000,ATP Masters Series Indian Wells CA; U.S.A. ATP World Tour,HARD,2,David Nalbandian,Philipp Kohlschreiber,David Nalbandian,1-6; 7-5; 7-6(1),R64,143,2,2,65,117,44,65,24,52,13,18,16,68,117,10,9,51,93,39,51,20,42,4,7,15,59,93
2007-03-05 00:00:00.000,ATP Masters Series Indian Wells CA; U.S.A. ATP World Tour,HARD,2,Richard Gasquet,Juan Martin Del Potro,Richard Gasquet,7-6(2); 6-2,R64,95,7,1,43,64,31,43,14,21,4,5,10,45,64,4,1,49,74,26,49,14,25,4,7,10,40,74
2007-03-05 00:00:00.000,ATP Masters Series Indian Wells CA; U.S.A. ATP World Tour,HARD,2,Jarkko Nieminen,Paul Goldstein,Jarkko Nieminen,1-6; 6-4; 6-4,R64,119,2,3,50,83,27,50,12,33,2,9,13,39,83,2,9,66,106,37,66,17,40,13,20,14,54,106
2007-03-05 00:00:00.000,ATP Masters Series Indian Wells CA; U.S.A. ATP World Tour,HARD,2,Olivier Rochus,Vincent Spadea,Olivier Rochus,6-1; 6-4,R64,73,1,2,27,50,18,27,14,23,1,2,8,32,50,1,1,36,62,17,36,14,26,7,12,9,31,62
2007-03-05 00:00:00.000,ATP Masters Series Indian Wells CA; U.S.A. ATP World Tour,HARD,2,Andy Roddick,Feliciano Lopez,Andy Roddick,7-6(5); 6-4,R64,79,15,1,43,65,36,43,13,22,0,0,11,49,65,12,2,43,65,33,43,14,22,3,4,11,47,65
2007-03-05 00:00:00.000,ATP Masters Series Indian Wells CA; U.S.A. ATP World Tour,HARD,2,Gilles Simon,Tommy Robredo,Gilles Simon,6-7(0); 6-3; 6-0,R64,157,2,4,80,118,52,80,19,38,14,15,13,71,118,0,4,60,113,37,60,23,53,17,23,14,60,113
2007-03-05 00:00:00.000,ATP Masters Series Indian Wells CA; U.S.A. ATP World Tour,HARD,2,Juan Ignacio Chela,Jonas Bjorkman,Juan Ignacio Chela,6-3; 3-6; 6-4,R64,194,6,2,55,92,41,55,18,37,9,12,14,59,92,4,2,55,106,36,55,25,51,9,13,14,61,106
2007-03-05 00:00:00.000,ATP Masters Series Indian Wells CA; U.S.A. ATP World Tour,HARD,2,Guillermo Garcia-Lopez,Marcos Baghdatis,Guillermo Garcia-Lopez,7-5; 7-5,R64,110,1,1,51,81,33,51,15,30,3,6,12,48,81,7,4,29,67,20,29,18,38,5,10,12,38,67
2007-03-05 00:00:00.000,ATP Masters Series Indian Wells CA; U.S.A. ATP World Tour,HARD,2,Michael Russell,Tomas Berdych,Michael Russell,7-6(2); 6-4,R64,101,3,3,52,70,38,52,9,18,3,5,11,47,70,3,2,37,71,27,37,15,34,3,6,11,42,71
2007-03-05 00:00:00.000,ATP Masters Series Indian Wells CA; U.S.A. ATP World Tour,HARD,2,Jose Acasuso,Mikhail Youzhny,Jose Acasuso,7-6(9); 6-4,R64,115,7,1,39,77,30,39,21,38,4,6,11,51,77,0,2,46,81,32,46,17,35,2,5,11,49,81
2007-03-05 00:00:00.000,ATP Masters Series Indian Wells CA; U.S.A. ATP World Tour,HARD,2,Juan Carlos Ferrero,Florian Mayer,Juan Carlos Ferrero,6-0; 6-2,R64,50,2,2,30,49,21,30,11,19,4,4,7,32,49,3,1,16,33,8,16,4,17,2,7,7,12,33
2007-03-05 00:00:00.000,ATP Masters Series Indian Wells CA; U.S.A. ATP World Tour,HARD,2,Fernando Verdasco,Andreas Seppi,Fernando Verdasco,7-6(5); 6-3,R64,88,5,1,43,64,36,43,12,21,1,2,11,48,64,5,1,50,80,33,50,16,30,10,12,10,49,80
2007-03-05 00:00:00.000,ATP Masters Series Indian Wells CA; U.S.A. ATP World Tour,HARD,2,Rafael Nadal,Arnaud Clement,Rafael Nadal,6-3; 7-6(3),R64,104,10,6,39,66,31,39,14,27,5,6,10,45,66,6,2,32,66,26,32,16,34,4,7,11,42,66
2007-03-05 00:00:00.000,ATP Masters Series Indian Wells CA; U.S.A. ATP World Tour,HARD,2,Carlos Moya,Guillermo Canas,Carlos Moya,6-4; 6-4,R32,90,6,3,45,71,32,45,16,26,5,5,10,48,71,5,2,31,52,24,31,13,21,2,4,10,37,52
2007-03-05 00:00:00.000,ATP Masters Series Indian Wells CA; U.S.A. ATP World Tour,HARD,2,David Ferrer,Janko Tipsarevic,David Ferrer,6-1; 6-3,R32,78,5,0,30,61,23,30,15,31,6,7,8,38,61,1,2,30,57,18,30,8,27,5,10,8,26,57
2007-03-05 00:00:00.000,ATP Masters Series Indian Wells CA; U.S.A. ATP World Tour,HARD,2,Novak Djokovic,Evgeny Korolev,Novak Djokovic,6-2; 6-1,R32,55,2,2,25,43,23,25,8,18,2,3,8,31,43,3,2,26,49,9,26,11,23,5,10,7,20,49
2007-03-05 00:00:00.000,ATP Masters Series Indian Wells CA; U.S.A. ATP World Tour,HARD,2,Julien Benneteau,James Blake,Julien Benneteau,6-2; 7-6(1),R32,84,6,0,44,66,30,44,14,22,1,3,10,44,66,7,2,38,65,24,38,11,27,2,6,10,35,65
2007-03-05 00:00:00.000,ATP Masters Series Indian Wells CA; U.S.A. ATP World Tour,HARD,2,Nikolay Davydenko,Jan Hernych,Nikolay Davydenko,6-3; 6-1,R32,66,0,2,33,48,22,33,9,15,2,3,8,31,48,1,2,30,46,14,30,6,16,2,7,8,20,46
2007-03-05 00:00:00.000,ATP Masters Series Indian Wells CA; U.S.A. ATP World Tour,HARD,2,Andy Murray,Nicolas Mahut,Andy Murray,6-1; 6-3,R32,66,7,1,29,47,24,29,9,18,1,1,8,33,47,7,2,21,48,15,21,9,27,4,8,8,24,48
2007-03-05 00:00:00.000,ATP Masters Series Indian Wells CA; U.S.A. ATP World Tour,HARD,2,Tommy Haas,Teymuraz Gabashvili,Tommy Haas,6-0; 6-3,R32,57,5,1,27,46,24,27,10,19,3,3,8,34,46,0,3,22,38,12,22,7,16,0,4,7,19,38
2007-03-05 00:00:00.000,ATP Masters Series Indian Wells CA; U.S.A. ATP World Tour,HARD,2,Fernando Gonzalez,Robin Soderling,Fernando Gonzalez,7-6(4); 7-6(2),R32,101,7,1,50,82,36,50,23,32,1,2,12,59,82,5,3,39,69,32,39,17,30,1,2,12,49,69
2007-03-05 00:00:00.000,ATP Masters Series Indian Wells CA; U.S.A. ATP World Tour,HARD,2,Ivan Ljubicic,Thomas Johansson,Ivan Ljubicic,6-1; 6-4,R32,76,9,2,26,49,20,26,19,23,1,1,9,39,49,1,2,26,55,16,26,12,29,3,6,8,28,55
2007-03-05 00:00:00.000,ATP Masters Series Indian Wells CA; U.S.A. ATP World Tour,HARD,2,David Nalbandian,Paul-Henri Mathieu,David Nalbandian,6-7(3); 6-2; 6-0,R32,129,7,3,42,76,36,42,19,34,2,3,13,55,76,5,7,49,97,31,49,18,48,5,11,13,49,97
2007-03-05 00:00:00.000,ATP Masters Series Indian Wells CA; U.S.A. ATP World Tour,HARD,2,Richard Gasquet,Jarkko Nieminen,Richard Gasquet,6-3; 1-6; 6-3,R32,120,5,3,69,113,46,69,18,44,10,13,13,64,113,4,2,36,73,28,36,18,37,4,7,12,46,73
2007-03-05 00:00:00.000,ATP Masters Series Indian Wells CA; U.S.A. ATP World Tour,HARD,2,Andy Roddick,Olivier Rochus,Andy Roddick,6-3; 7-6(5),R32,149,18,1,38,62,31,38,17,24,0,0,11,48,62,0,3,29,63,22,29,20,34,1,2,10,42,63
2007-03-05 00:00:00.000,ATP Masters Series Indian Wells CA; U.S.A. ATP World Tour,HARD,2,Juan Ignacio Chela,Gilles Simon,Juan Ignacio Chela,6-2; 6-2,R32,79,2,1,30,55,20,30,15,25,2,3,8,35,55,1,3,31,56,16,31,10,25,4,9,8,26,56
2007-03-05 00:00:00.000,ATP Masters Series Indian Wells CA; U.S.A. ATP World Tour,HARD,2,Michael Russell,Guillermo Garcia-Lopez,Michael Russell,6-1; 7-5,R32,78,2,0,40,54,29,40,9,14,1,2,10,38,54,0,4,24,50,17,24,10,26,1,5,9,27,50
2007-03-05 00:00:00.000,ATP Masters Series Indian Wells CA; U.S.A. ATP World Tour,HARD,2,Juan Carlos Ferrero,Jose Acasuso,Juan Carlos Ferrero,4-6; 7-6(8); 6-4,R32,136,8,3,72,97,55,72,16,25,1,3,16,71,97,10,4,51,95,45,51,25,44,4,6,16,70,95
2007-03-05 00:00:00.000,ATP Masters Series Indian Wells CA; U.S.A. ATP World Tour,HARD,2,Rafael Nadal,Fernando Verdasco,Rafael Nadal,6-4; 6-4,R32,87,4,1,34,52,27,34,13,18,0,0,10,40,52,7,1,40,56,29,40,9,16,4,6,10,38,56
2007-03-05 00:00:00.000,ATP Masters Series Indian Wells CA; U.S.A. ATP World Tour,HARD,2,David Ferrer,Carlos Moya,David Ferrer,1-6; 6-2; 6-3,R16,111,4,3,49,85,31,49,20,36,8,10,12,51,85,8,1,52,79,35,52,13,27,8,11,12,48,79
2007-03-05 00:00:00.000,ATP Masters Series Indian Wells CA; U.S.A. ATP World Tour,HARD,2,Novak Djokovic,Julien Benneteau,Novak Djokovic,6-3; 6-1,R16,91,7,1,46,65,30,46,10,19,10,11,8,40,65,4,3,32,60,19,32,10,28,3,8,8,29,60
2007-03-05 00:00:00.000,ATP Masters Series Indian Wells CA; U.S.A. ATP World Tour,HARD,2,Andy Murray,Nikolay Davydenko,Andy Murray,7-6(3); 6-4,R16,125,10,2,33,79,24,33,27,46,1,3,11,51,79,1,3,43,73,31,43,13,30,5,8,11,44,73
2007-03-05 00:00:00.000,ATP Masters Series Indian Wells CA; U.S.A. ATP World Tour,HARD,2,Tommy Haas,Fernando Gonzalez,Tommy Haas,6-3; 6-2,R16,62,4,2,30,51,24,30,14,21,1,1,9,38,51,1,2,32,50,20,32,8,18,6,9,8,28,50
2007-03-05 00:00:00.000,ATP Masters Series Indian Wells CA; U.S.A. ATP World Tour,HARD,2,Ivan Ljubicic,David Nalbandian,Ivan Ljubicic,2-6; 6-4; 6-2,R16,117,10,2,44,76,35,44,16,32,1,3,13,51,76,2,1,50,81,36,50,13,31,5,8,13,49,81
2007-03-05 00:00:00.000,ATP Masters Series Indian Wells CA; U.S.A. ATP World Tour,HARD,2,Andy Roddick,Richard Gasquet,Andy Roddick,7-6(3); 6-3,R16,74,15,0,43,62,37,43,13,19,0,0,11,50,62,6,1,41,64,30,41,12,23,0,1,10,42,64
2007-03-05 00:00:00.000,ATP Masters Series Indian Wells CA; U.S.A. ATP World Tour,HARD,2,Juan Ignacio Chela,Michael Russell,Juan Ignacio Chela,6-4; 6-4,R16,90,5,0,40,60,29,40,12,20,4,5,10,41,60,3,1,44,60,28,44,8,16,3,6,10,36,60
2007-03-05 00:00:00.000,ATP Masters Series Indian Wells CA; U.S.A. ATP World Tour,HARD,2,Rafael Nadal,Juan Carlos Ferrero,Rafael Nadal,6-1; 6-1,R16,62,4,0,26,41,21,26,9,15,5,5,7,30,41,2,1,27,41,11,27,5,14,2,7,7,16,41
2007-03-05 00:00:00.000,ATP Masters Series Indian Wells CA; U.S.A. ATP World Tour,HARD,2,Novak Djokovic,David Ferrer,Novak Djokovic,6-3; 6-4,Q,77,4,2,39,58,30,39,11,19,3,4,10,41,58,3,3,33,49,20,33,8,16,2,5,9,28,49
2007-03-05 00:00:00.000,ATP Masters Series Indian Wells CA; U.S.A. ATP World Tour,HARD,2,Andy Murray,Tommy Haas,Andy Murray,3-6; 6-3; 7-6(8),Q,172,8,3,54,97,34,54,29,43,3,5,15,63,97,7,3,61,116,46,61,29,55,11,13,15,75,116
2007-03-05 00:00:00.000,ATP Masters Series Indian Wells CA; U.S.A. ATP World Tour,HARD,2,Andy Roddick,Ivan Ljubicic,Andy Roddick,7-6(7); 7-6(8),Q,127,8,1,57,90,48,57,18,33,0,0,12,66,90,12,2,52,84,46,52,15,32,3,3,12,61,84
2007-03-05 00:00:00.000,ATP Masters Series Indian Wells CA; U.S.A. ATP World Tour,HARD,2,Rafael Nadal,Juan Ignacio Chela,Rafael Nadal,7-5; 7-5,Q,116,2,5,47,70,37,47,9,23,2,4,12,46,70,2,0,39,74,25,39,18,35,3,7,12,43,74
2007-03-05 00:00:00.000,ATP Masters Series Indian Wells CA; U.S.A. ATP World Tour,HARD,2,Novak Djokovic,Andy Murray,Novak Djokovic,6-2; 6-3,S,63,3,0,24,42,20,24,11,18,2,3,8,31,42,3,0,24,46,12,24,12,22,3,8,9,24,46
2007-03-05 00:00:00.000,ATP Masters Series Indian Wells CA; U.S.A. ATP World Tour,HARD,2,Rafael Nadal,Andy Roddick,Rafael Nadal,6-4; 6-3,S,74,6,1,38,45,31,38,5,7,0,0,9,36,45,16,2,38,65,28,38,11,27,7,10,10,39,65
2007-03-05 00:00:00.000,ATP Masters Series Indian Wells CA; U.S.A. ATP World Tour,HARD,2,Rafael Nadal,Novak Djokovic,Rafael Nadal,6-2; 7-5,F,94,2,1,44,65,32,44,14,21,3,3,10,46,65,3,2,26,51,20,26,11,25,1,4,10,31,51
2007-03-19 00:00:00.000,ATP Masters Series Miami FL; U.S.A. ATP World Tour,HARD,2,Roger Federer,N/A Bye,Roger Federer,,R128,0,0,0,0,0,0,0,0,0,0,0,0,0,0,0,0,0,0,0,0,0,0,0,0,0,0,0
2007-03-19 00:00:00.000,ATP Masters Series Miami FL; U.S.A. ATP World Tour,HARD,2,Sam Querrey,Igor Andreev,Sam Querrey,5-7; 6-2; 6-4,R128,118,9,5,49,89,39,49,19,40,2,4,15,58,89,2,1,60,96,40,60,16,36,8,12,15,56,96
2007-03-19 00:00:00.000,ATP Masters Series Miami FL; U.S.A. ATP World Tour,HARD,2,Potito Starace,Alex Kuznetsov,Potito Starace,6-4; 7-6(4),R128,91,1,0,55,72,39,55,11,17,0,0,11,50,72,1,1,33,61,27,33,17,28,2,3,11,44,61
2007-03-19 00:00:00.000,ATP Masters Series Miami FL; U.S.A. ATP World Tour,HARD,2,Nicolas Almagro,N/A Bye,Nicolas Almagro,,R128,0,0,0,0,0,0,0,0,0,0,0,0,0,0,0,0,0,0,0,0,0,0,0,0,0,0,0
2007-03-19 00:00:00.000,ATP Masters Series Miami FL; U.S.A. ATP World Tour,HARD,2,Juan Carlos Ferrero,N/A Bye,Juan Carlos Ferrero,,R128,0,0,0,0,0,0,0,0,0,0,0,0,0,0,0,0,0,0,0,0,0,0,0,0,0,0,0
2007-03-19 00:00:00.000,ATP Masters Series Miami FL; U.S.A. ATP World Tour,HARD,2,Guillermo Canas,Tim Henman,Guillermo Canas,3-6; 6-2; 6-1,R128,112,3,1,66,83,43,66,7,17,8,11,12,50,83,4,5,54,82,28,54,13,28,7,13,12,41,82
2007-03-19 00:00:00.000,ATP Masters Series Miami FL; U.S.A. ATP World Tour,HARD,2,Sebastien Grosjean,Martin Verkerk,Sebastien Grosjean,6-3; 6-4,R128,61,4,1,25,48,21,25,19,23,0,0,10,40,48,4,3,36,54,27,36,8,18,2,4,9,35,54
2007-03-19 00:00:00.000,ATP Masters Series Miami FL; U.S.A. ATP World Tour,HARD,2,Richard Gasquet,N/A Bye,Richard Gasquet,,R128,0,0,0,0,0,0,0,0,0,0,0,0,0,0,0,0,0,0,0,0,0,0,0,0,0,0,0
2007-03-19 00:00:00.000,ATP Masters Series Miami FL; U.S.A. ATP World Tour,HARD,2,Tommy Haas,N/A Bye,Tommy Haas,,R128,0,0,0,0,0,0,0,0,0,0,0,0,0,0,0,0,0,0,0,0,0,0,0,0,0,0,0
2007-03-19 00:00:00.000,ATP Masters Series Miami FL; U.S.A. ATP World Tour,HARD,2,Alejandro Falla,Sergio Roitman,Alejandro Falla,4-6; 6-3; 6-1,R128,108,2,0,53,85,33,53,18,32,8,11,13,51,85,6,3,47,79,24,47,18,32,7,13,13,42,79
2007-03-19 00:00:00.000,ATP Masters Series Miami FL; U.S.A. ATP World Tour,HARD,2,Gaston Gaudio,Ruben Ramirez Hidalgo,Gaston Gaudio,7-5; 1-6; 6-3,R128,123,2,10,41,72,32,41,12,31,2,7,14,44,72,4,6,53,106,35,53,24,53,12,17,14,59,106
2007-03-19 00:00:00.000,ATP Masters Series Miami FL; U.S.A. ATP World Tour,HARD,2,Radek Stepanek,N/A Bye,Radek Stepanek,,R128,0,0,0,0,0,0,0,0,0,0,0,0,0,0,0,0,0,0,0,0,0,0,0,0,0,0,0
2007-03-19 00:00:00.000,ATP Masters Series Miami FL; U.S.A. ATP World Tour,HARD,2,Fernando Verdasco,N/A Bye,Fernando Verdasco,,R128,0,0,0,0,0,0,0,0,0,0,0,0,0,0,0,0,0,0,0,0,0,0,0,0,0,0,0
2007-03-19 00:00:00.000,ATP Masters Series Miami FL; U.S.A. ATP World Tour,HARD,2,Florian Mayer,Igor Kunitsyn,Florian Mayer,6-1; 6-0,R128,48,5,1,19,33,16,19,8,14,0,0,6,24,33,1,3,26,45,8,26,8,19,3,9,7,16,45
2007-03-19 00:00:00.000,ATP Masters Series Miami FL; U.S.A. ATP World Tour,HARD,2,Kevin Kim,Benjamin Becker,Kevin Kim,6-4; 3-6; 6-2,R128,112,1,5,50,78,35,50,12,28,6,10,13,47,78,4,9,47,102,33,47,21,55,6,12,14,54,102
2007-03-19 00:00:00.000,ATP Masters Series Miami FL; U.S.A. ATP World Tour,HARD,2,Tommy Robredo,N/A Bye,Tommy Robredo,,R128,0,0,0,0,0,0,0,0,0,0,0,0,0,0,0,0,0,0,0,0,0,0,0,0,0,0,0
2007-03-19 00:00:00.000,ATP Masters Series Miami FL; U.S.A. ATP World Tour,HARD,2,Nikolay Davydenko,N/A Bye,Nikolay Davydenko,,R128,0,0,0,0,0,0,0,0,0,0,0,0,0,0,0,0,0,0,0,0,0,0,0,0,0,0,0
2007-03-19 00:00:00.000,ATP Masters Series Miami FL; U.S.A. ATP World Tour,HARD,2,Simon Greul,Danai Udomchoke,Simon Greul,6-7(2); 6-2; 6-3,R128,131,5,1,57,93,40,57,21,36,3,5,15,61,93,4,2,58,85,40,58,9,27,2,7,14,49,85
2007-03-19 00:00:00.000,ATP Masters Series Miami FL; U.S.A. ATP World Tour,HARD,2,Amer Delic,Julien Benneteau,Amer Delic,6-4; 6-4,R128,88,10,2,44,67,30,44,12,23,8,10,10,42,67,2,2,37,61,20,37,14,24,4,8,10,34,61
2007-03-19 00:00:00.000,ATP Masters Series Miami FL; U.S.A. ATP World Tour,HARD,2,Jose Acasuso,N/A Bye,Jose Acasuso,,R128,0,0,0,0,0,0,0,0,0,0,0,0,0,0,0,0,0,0,0,0,0,0,0,0,0,0,0
2007-03-19 00:00:00.000,ATP Masters Series Miami FL; U.S.A. ATP World Tour,HARD,2,Juan Ignacio Chela,N/A Bye,Juan Ignacio Chela,,R128,0,0,0,0,0,0,0,0,0,0,0,0,0,0,0,0,0,0,0,0,0,0,0,0,0,0,0
2007-03-19 00:00:00.000,ATP Masters Series Miami FL; U.S.A. ATP World Tour,HARD,2,Janko Tipsarevic,Andreas Seppi,Janko Tipsarevic,7-5; 7-5,R128,97,11,1,46,72,33,46,13,26,3,5,12,46,72,5,2,40,71,25,40,18,31,5,9,12,43,71
2007-03-19 00:00:00.000,ATP Masters Series Miami FL; U.S.A. ATP World Tour,HARD,2,Arnaud Clement,Albert Montanes,Arnaud Clement,6-4; 6-1,R128,62,4,2,23,47,21,23,13,24,0,1,9,34,47,4,5,24,52,16,24,11,28,4,8,8,27,52
2007-03-19 00:00:00.000,ATP Masters Series Miami FL; U.S.A. ATP World Tour,HARD,2,Tomas Berdych,N/A Bye,Tomas Berdych,,R128,0,0,0,0,0,0,0,0,0,0,0,0,0,0,0,0,0,0,0,0,0,0,0,0,0,0,0
2007-03-19 00:00:00.000,ATP Masters Series Miami FL; U.S.A. ATP World Tour,HARD,2,David Nalbandian,N/A Bye,David Nalbandian,,R128,0,0,0,0,0,0,0,0,0,0,0,0,0,0,0,0,0,0,0,0,0,0,0,0,0,0,0
2007-03-19 00:00:00.000,ATP Masters Series Miami FL; U.S.A. ATP World Tour,HARD,2,Vincent Spadea,Robby Ginepri,Vincent Spadea,6-1; 6-3,R128,59,1,2,27,50,19,27,13,23,3,4,8,32,50,5,3,28,48,17,28,5,20,2,7,8,22,48
2007-03-19 00:00:00.000,ATP Masters Series Miami FL; U.S.A. ATP World Tour,HARD,2,Evgeny Korolev,Marc Gicquel,Evgeny Korolev,6-4; 6-2,R128,77,7,2,33,59,25,33,14,26,8,9,9,39,59,4,0,42,54,28,42,2,12,4,8,9,30,54
2007-03-19 00:00:00.000,ATP Masters Series Miami FL; U.S.A. ATP World Tour,HARD,2,Jarkko Nieminen,N/A Bye,Jarkko Nieminen,,R128,0,0,0,0,0,0,0,0,0,0,0,0,0,0,0,0,0,0,0,0,0,0,0,0,0,0,0
2007-03-19 00:00:00.000,ATP Masters Series Miami FL; U.S.A. ATP World Tour,HARD,2,Carlos Moya,N/A Bye,Carlos Moya,,R128,0,0,0,0,0,0,0,0,0,0,0,0,0,0,0,0,0,0,0,0,0,0,0,0,0,0,0
2007-03-19 00:00:00.000,ATP Masters Series Miami FL; U.S.A. ATP World Tour,HARD,2,Fabrice Santoro,Christophe Rochus,Fabrice Santoro,5-7; 7-5; 6-2,R128,135,13,0,46,95,35,46,23,49,3,7,16,58,95,2,0,61,92,36,61,16,31,3,9,16,52,92
2007-03-19 00:00:00.000,ATP Masters Series Miami FL; U.S.A. ATP World Tour,HARD,2,Filippo Volandri,Nicolas Mahut,Filippo Volandri,6-3 RET,R128,39,2,3,14,30,10,14,11,16,2,2,4,21,30,0,5,11,24,9,11,3,13,0,2,5,12,24
2007-03-19 00:00:00.000,ATP Masters Series Miami FL; U.S.A. ATP World Tour,HARD,2,Ivan Ljubicic,N/A Bye,Ivan Ljubicic,,R128,0,0,0,0,0,0,0,0,0,0,0,0,0,0,0,0,0,0,0,0,0,0,0,0,0,0,0
2007-03-19 00:00:00.000,ATP Masters Series Miami FL; U.S.A. ATP World Tour,HARD,2,Fernando Gonzalez,N/A Bye,Fernando Gonzalez,,R128,0,0,0,0,0,0,0,0,0,0,0,0,0,0,0,0,0,0,0,0,0,0,0,0,0,0,0
2007-03-19 00:00:00.000,ATP Masters Series Miami FL; U.S.A. ATP World Tour,HARD,2,Thomas Johansson,Alberto Martin,Thomas Johansson,6-4; 6-3,R128,83,5,0,29,51,21,29,14,22,3,4,9,35,51,2,2,47,71,31,47,9,24,6,10,10,40,71
2007-03-19 00:00:00.000,ATP Masters Series Miami FL; U.S.A. ATP World Tour,HARD,2,Paul-Henri Mathieu,Kristof Vliegen,Paul-Henri Mathieu,6-1; 6-1,R128,62,1,1,27,47,21,27,12,20,3,3,7,33,47,0,1,29,49,16,29,7,20,5,10,7,23,49
2007-03-19 00:00:00.000,ATP Masters Series Miami FL; U.S.A. ATP World Tour,HARD,2,Jurgen Melzer,N/A Bye,Jurgen Melzer,,R128,0,0,0,0,0,0,0,0,0,0,0,0,0,0,0,0,0,0,0,0,0,0,0,0,0,0,0
2007-03-19 00:00:00.000,ATP Masters Series Miami FL; U.S.A. ATP World Tour,HARD,2,Robert Kendrick,N/A Bye,Robert Kendrick,,R128,0,0,0,0,0,0,0,0,0,0,0,0,0,0,0,0,0,0,0,0,0,0,0,0,0,0,0
2007-03-19 00:00:00.000,ATP Masters Series Miami FL; U.S.A. ATP World Tour,HARD,2,Raemon Sluiter,Gustavo Kuerten,Raemon Sluiter,6-2; 6-2,R128,58,4,0,20,42,17,20,16,22,0,0,8,33,42,11,1,28,52,18,28,9,24,9,13,8,27,52
2007-03-19 00:00:00.000,ATP Masters Series Miami FL; U.S.A. ATP World Tour,HARD,2,Paul Goldstein,Ryan Sweeting,Paul Goldstein,6-2; 2-6; 6-3,R128,100,1,4,45,75,31,45,15,30,4,7,12,46,75,6,4,43,89,31,43,19,46,11,16,13,50,89
2007-03-19 00:00:00.000,ATP Masters Series Miami FL; U.S.A. ATP World Tour,HARD,2,Andy Murray,N/A Bye,Andy Murray,,R128,0,0,0,0,0,0,0,0,0,0,0,0,0,0,0,0,0,0,0,0,0,0,0,0,0,0,0
2007-03-19 00:00:00.000,ATP Masters Series Miami FL; U.S.A. ATP World Tour,HARD,2,David Ferrer,N/A Bye,David Ferrer,,R128,0,0,0,0,0,0,0,0,0,0,0,0,0,0,0,0,0,0,0,0,0,0,0,0,0,0,0
2007-03-19 00:00:00.000,ATP Masters Series Miami FL; U.S.A. ATP World Tour,HARD,2,Juan Monaco,Robin Haase,Juan Monaco,6-4; 6-4,R128,81,1,3,37,59,25,37,12,22,2,4,10,37,59,4,3,45,76,27,45,13,31,5,9,10,40,76
2007-03-19 00:00:00.000,ATP Masters Series Miami FL; U.S.A. ATP World Tour,HARD,2,Simone Bolelli,Gael Monfils,Simone Bolelli,6-4; 6-2,R128,63,1,1,36,57,23,36,16,21,4,4,9,39,57,4,1,25,47,20,25,9,22,2,5,9,29,47
2007-03-19 00:00:00.000,ATP Masters Series Miami FL; U.S.A. ATP World Tour,HARD,2,Dmitry Tursunov,N/A Bye,Dmitry Tursunov,,R128,0,0,0,0,0,0,0,0,0,0,0,0,0,0,0,0,0,0,0,0,0,0,0,0,0,0,0
2007-03-19 00:00:00.000,ATP Masters Series Miami FL; U.S.A. ATP World Tour,HARD,2,Gilles Simon,N/A Bye,Gilles Simon,,R128,0,0,0,0,0,0,0,0,0,0,0,0,0,0,0,0,0,0,0,0,0,0,0,0,0,0,0
2007-03-19 00:00:00.000,ATP Masters Series Miami FL; U.S.A. ATP World Tour,HARD,2,Luis Horna,Paradorn Srichaphan,Luis Horna,5-2 RET,R128,18,1,0,19,20,15,19,1,1,0,0,4,16,20,0,0,11,14,6,11,2,3,0,1,3,8,14
2007-03-19 00:00:00.000,ATP Masters Series Miami FL; U.S.A. ATP World Tour,HARD,2,Martin Vassallo Arguello,Hyung-Taik Lee,Martin Vassallo Arguello,6-4; 6-2,R128,81,4,3,37,59,27,37,12,22,4,5,9,39,59,1,1,35,63,22,35,11,28,5,9,9,33,63
2007-03-19 00:00:00.000,ATP Masters Series Miami FL; U.S.A. ATP World Tour,HARD,2,Andy Roddick,N/A Bye,Andy Roddick,,R128,0,0,0,0,0,0,0,0,0,0,0,0,0,0,0,0,0,0,0,0,0,0,0,0,0,0,0
2007-03-19 00:00:00.000,ATP Masters Series Miami FL; U.S.A. ATP World Tour,HARD,2,James Blake,N/A Bye,James Blake,,R128,0,0,0,0,0,0,0,0,0,0,0,0,0,0,0,0,0,0,0,0,0,0,0,0,0,0,0
2007-03-19 00:00:00.000,ATP Masters Series Miami FL; U.S.A. ATP World Tour,HARD,2,Florent Serra,Chris Guccione,Florent Serra,6-7(6); 7-6(8); 6-4,R128,115,6,3,66,102,53,66,25,36,0,0,17,78,102,22,3,68,119,57,68,27,51,3,4,17,84,119
2007-03-19 00:00:00.000,ATP Masters Series Miami FL; U.S.A. ATP World Tour,HARD,2,Feliciano Lopez,Nicolas Massu,Feliciano Lopez,6-3; 6-3,R128,79,12,2,37,64,30,37,12,27,9,10,9,42,64,3,4,29,57,18,29,12,28,5,9,9,30,57
2007-03-19 00:00:00.000,ATP Masters Series Miami FL; U.S.A. ATP World Tour,HARD,2,Marat Safin,N/A Bye,Marat Safin,,R128,0,0,0,0,0,0,0,0,0,0,0,0,0,0,0,0,0,0,0,0,0,0,0,0,0,0,0
2007-03-19 00:00:00.000,ATP Masters Series Miami FL; U.S.A. ATP World Tour,HARD,2,Dominik Hrbaty,N/A Bye,Dominik Hrbaty,,R128,0,0,0,0,0,0,0,0,0,0,0,0,0,0,0,0,0,0,0,0,0,0,0,0,0,0,0
2007-03-19 00:00:00.000,ATP Masters Series Miami FL; U.S.A. ATP World Tour,HARD,2,Michael Llodra,Stefan Koubek,Michael Llodra,6-4; 6-0,R128,58,8,4,29,48,24,29,10,19,1,1,8,34,48,2,2,26,49,14,26,11,23,3,7,8,25,49
2007-03-19 00:00:00.000,ATP Masters Series Miami FL; U.S.A. ATP World Tour,HARD,2,Daniele Bracciali,Max Mirnyi,Daniele Bracciali,7-6(2); 6-4,R128,85,4,1,36,69,31,36,18,33,2,2,11,49,69,11,7,36,65,31,36,13,29,4,5,11,44,65
2007-03-19 00:00:00.000,ATP Masters Series Miami FL; U.S.A. ATP World Tour,HARD,2,Novak Djokovic,N/A Bye,Novak Djokovic,,R128,0,0,0,0,0,0,0,0,0,0,0,0,0,0,0,0,0,0,0,0,0,0,0,0,0,0,0
2007-03-19 00:00:00.000,ATP Masters Series Miami FL; U.S.A. ATP World Tour,HARD,2,Mikhail Youzhny,N/A Bye,Mikhail Youzhny,,R128,0,0,0,0,0,0,0,0,0,0,0,0,0,0,0,0,0,0,0,0,0,0,0,0,0,0,0
2007-03-19 00:00:00.000,ATP Masters Series Miami FL; U.S.A. ATP World Tour,HARD,2,Teymuraz Gabashvili,Jan Hajek,Teymuraz Gabashvili,7-5; 4-6; 7-5,R128,143,10,6,56,102,46,56,25,46,4,5,17,71,102,7,1,60,113,42,60,30,53,6,8,17,72,113
2007-03-19 00:00:00.000,ATP Masters Series Miami FL; U.S.A. ATP World Tour,HARD,2,Juan Martin Del Potro,Jonas Bjorkman,Juan Martin Del Potro,7-5; 6-1,R128,79,3,4,39,57,22,39,11,18,1,4,9,33,57,1,6,34,61,19,34,7,27,5,12,10,26,61
2007-03-19 00:00:00.000,ATP Masters Series Miami FL; U.S.A. ATP World Tour,HARD,2,Marcos Baghdatis,N/A Bye,Marcos Baghdatis,,R128,0,0,0,0,0,0,0,0,0,0,0,0,0,0,0,0,0,0,0,0,0,0,0,0,0,0,0
2007-03-19 00:00:00.000,ATP Masters Series Miami FL; U.S.A. ATP World Tour,HARD,2,Olivier Rochus,N/A Bye,Olivier Rochus,,R128,0,0,0,0,0,0,0,0,0,0,0,0,0,0,0,0,0,0,0,0,0,0,0,0,0,0,0
2007-03-19 00:00:00.000,ATP Masters Series Miami FL; U.S.A. ATP World Tour,HARD,2,Guillermo Garcia-Lopez,Ivo Karlovic,Guillermo Garcia-Lopez,6-4; 6-7(4); 7-6(5),R128,207,0,0,77,104,59,77,18,27,3,4,17,77,104,19,7,66,101,58,66,16,35,0,2,17,74,101
2007-03-19 00:00:00.000,ATP Masters Series Miami FL; U.S.A. ATP World Tour,HARD,2,Ricardo Mello,Jan Hernych,Ricardo Mello,6-1; 7-6(3),R128,90,2,2,43,64,34,43,13,21,2,2,10,47,64,2,0,52,71,29,52,11,19,5,7,9,40,71
2007-03-19 00:00:00.000,ATP Masters Series Miami FL; U.S.A. ATP World Tour,HARD,2,Rafael Nadal,N/A Bye,Rafael Nadal,,R128,0,0,0,0,0,0,0,0,0,0,0,0,0,0,0,0,0,0,0,0,0,0,0,0,0,0,0
2007-03-19 00:00:00.000,ATP Masters Series Miami FL; U.S.A. ATP World Tour,HARD,2,Roger Federer,Sam Querrey,Roger Federer,6-4; 6-3,R64,62,6,1,26,45,25,26,11,19,0,0,9,36,45,5,7,35,65,23,35,15,30,5,8,10,38,65
2007-03-19 00:00:00.000,ATP Masters Series Miami FL; U.S.A. ATP World Tour,HARD,2,Nicolas Almagro,Potito Starace,Nicolas Almagro,7-6(2); 6-3,R64,80,5,3,34,55,29,34,16,21,0,0,10,45,55,0,6,58,89,40,58,14,31,10,12,11,54,89
2007-03-19 00:00:00.000,ATP Masters Series Miami FL; U.S.A. ATP World Tour,HARD,2,Guillermo Canas,Juan Carlos Ferrero,Guillermo Canas,6-7(5); 6-3; 7-5,R64,174,7,4,59,98,44,59,20,39,4,7,16,64,98,3,0,79,117,51,79,13,38,10,16,17,64,117
2007-03-19 00:00:00.000,ATP Masters Series Miami FL; U.S.A. ATP World Tour,HARD,2,Richard Gasquet,Sebastien Grosjean,Richard Gasquet,6-4; 0-6; 6-2,R64,105,5,3,37,74,28,37,15,37,3,7,12,43,74,6,2,40,65,24,40,14,25,3,7,12,38,65
2007-03-19 00:00:00.000,ATP Masters Series Miami FL; U.S.A. ATP World Tour,HARD,2,Alejandro Falla,Tommy Haas,Alejandro Falla,6-4; 6-4,R64,67,2,1,35,57,25,35,11,22,5,7,10,36,57,5,2,41,61,26,41,10,20,4,8,10,36,61
2007-03-19 00:00:00.000,ATP Masters Series Miami FL; U.S.A. ATP World Tour,HARD,2,Radek Stepanek,Gaston Gaudio,Radek Stepanek,6-3; 6-2,R64,60,1,3,34,50,25,34,10,16,1,3,9,35,50,0,6,26,43,14,26,5,17,1,6,8,19,43
2007-03-19 00:00:00.000,ATP Masters Series Miami FL; U.S.A. ATP World Tour,HARD,2,Florian Mayer,Fernando Verdasco,Florian Mayer,7-6(5); 6-1,R64,87,8,0,37,64,30,37,17,27,0,0,10,47,64,8,7,43,74,32,43,11,31,9,11,9,43,74
2007-03-19 00:00:00.000,ATP Masters Series Miami FL; U.S.A. ATP World Tour,HARD,2,Tommy Robredo,Kevin Kim,Tommy Robredo,6-2; 6-4,R64,69,2,1,40,52,28,40,7,12,4,5,9,35,52,2,1,39,54,22,39,6,15,1,5,9,28,54
2007-03-19 00:00:00.000,ATP Masters Series Miami FL; U.S.A. ATP World Tour,HARD,2,Nikolay Davydenko,Simon Greul,Nikolay Davydenko,6-4; 6-0,R64,55,2,1,33,43,25,33,8,10,0,0,8,33,43,4,1,30,51,17,30,8,21,2,6,8,25,51
2007-03-19 00:00:00.000,ATP Masters Series Miami FL; U.S.A. ATP World Tour,HARD,2,Amer Delic,Jose Acasuso,Amer Delic,6-0; 6-3,R64,54,7,1,27,45,20,27,10,18,1,2,8,30,45,0,5,17,41,9,17,8,24,1,6,7,17,41
2007-03-19 00:00:00.000,ATP Masters Series Miami FL; U.S.A. ATP World Tour,HARD,2,Juan Ignacio Chela,Janko Tipsarevic,Juan Ignacio Chela,6-2; 6-2,R64,70,5,0,37,51,27,37,9,14,2,3,8,36,51,1,1,26,54,13,26,10,28,7,12,8,23,54
2007-03-19 00:00:00.000,ATP Masters Series Miami FL; U.S.A. ATP World Tour,HARD,2,Tomas Berdych,Arnaud Clement,Tomas Berdych,6-4; 6-1,R64,68,9,0,33,48,28,33,10,15,1,1,9,38,48,4,1,29,51,20,29,10,22,3,6,8,30,51
2007-03-19 00:00:00.000,ATP Masters Series Miami FL; U.S.A. ATP World Tour,HARD,2,David Nalbandian,Vincent Spadea,David Nalbandian,6-3; 6-4,R64,76,4,2,32,55,26,32,12,23,5,6,9,38,55,6,1,34,64,23,34,13,30,8,12,10,36,64
2007-03-19 00:00:00.000,ATP Masters Series Miami FL; U.S.A. ATP World Tour,HARD,2,Jarkko Nieminen,Evgeny Korolev,Jarkko Nieminen,6-0; 6-0,R64,55,0,0,20,30,18,20,6,10,0,0,6,24,30,1,1,37,64,19,37,7,27,9,15,6,26,64
2007-03-19 00:00:00.000,ATP Masters Series Miami FL; U.S.A. ATP World Tour,HARD,2,Fabrice Santoro,Carlos Moya,Fabrice Santoro,7-6(5); 6-2,R64,102,5,1,45,70,32,45,13,25,3,4,10,45,70,2,5,46,74,29,46,14,28,8,11,10,43,74
2007-03-19 00:00:00.000,ATP Masters Series Miami FL; U.S.A. ATP World Tour,HARD,2,Ivan Ljubicic,Filippo Volandri,Ivan Ljubicic,6-3; 6-2,R64,65,12,1,25,52,18,25,17,27,1,2,9,35,52,0,4,27,52,13,27,14,25,8,12,8,27,52
2007-03-19 00:00:00.000,ATP Masters Series Miami FL; U.S.A. ATP World Tour,HARD,2,Fernando Gonzalez,Thomas Johansson,Fernando Gonzalez,7-5; 6-3,R64,88,13,4,41,66,34,41,11,25,6,7,11,45,66,9,5,37,68,28,37,10,31,7,10,10,38,68
2007-03-19 00:00:00.000,ATP Masters Series Miami FL; U.S.A. ATP World Tour,HARD,2,Paul-Henri Mathieu,Jurgen Melzer,Paul-Henri Mathieu,6-0; 7-5,R64,82,0,1,35,64,24,35,16,29,3,4,9,40,64,4,4,29,58,15,29,12,29,3,8,9,27,58
2007-03-19 00:00:00.000,ATP Masters Series Miami FL; U.S.A. ATP World Tour,HARD,2,Robert Kendrick,Raemon Sluiter,Robert Kendrick,6-4; 6-4,R64,86,16,9,35,74,25,35,19,39,4,6,10,44,74,6,1,29,64,20,29,14,35,6,10,10,34,64
2007-03-19 00:00:00.000,ATP Masters Series Miami FL; U.S.A. ATP World Tour,HARD,2,Andy Murray,Paul Goldstein,Andy Murray,6-2; 7-6(4),R64,94,8,7,38,77,31,38,14,39,4,7,10,45,77,2,3,41,73,21,41,15,32,4,9,10,36,73
2007-03-19 00:00:00.000,ATP Masters Series Miami FL; U.S.A. ATP World Tour,HARD,2,David Ferrer,Juan Monaco,David Ferrer,6-2; 6-2,R64,63,2,0,29,45,21,29,12,16,0,0,8,33,45,1,1,34,52,20,34,6,18,1,5,8,26,52
2007-03-19 00:00:00.000,ATP Masters Series Miami FL; U.S.A. ATP World Tour,HARD,2,Simone Bolelli,Dmitry Tursunov,Simone Bolelli,6-7(0); 6-3; 6-4,R64,150,4,1,71,107,46,71,22,36,7,8,15,68,107,10,4,37,87,29,37,30,50,1,5,16,59,87
2007-03-19 00:00:00.000,ATP Masters Series Miami FL; U.S.A. ATP World Tour,HARD,2,Gilles Simon,Luis Horna,Gilles Simon,6-3; 7-6(4),R64,115,3,2,55,89,39,55,20,34,10,10,11,59,89,3,0,41,67,30,41,15,26,0,1,10,45,67
2007-03-19 00:00:00.000,ATP Masters Series Miami FL; U.S.A. ATP World Tour,HARD,2,Andy Roddick,Martin Vassallo Arguello,Andy Roddick,6-3; 6-2,R64,61,7,3,42,55,35,42,6,13,3,3,9,41,55,3,2,28,46,21,28,5,18,0,3,8,26,46
2007-03-19 00:00:00.000,ATP Masters Series Miami FL; U.S.A. ATP World Tour,HARD,2,Florent Serra,James Blake,Florent Serra,7-6(8); 2-6; 6-3,R64,120,5,4,78,104,57,78,11,26,5,8,15,68,104,13,5,63,104,49,63,17,41,7,9,14,66,104
2007-03-19 00:00:00.000,ATP Masters Series Miami FL; U.S.A. ATP World Tour,HARD,2,Feliciano Lopez,Marat Safin,Feliciano Lopez,7-5; 7-6(2),R64,121,12,3,45,99,36,45,25,54,12,14,12,61,99,9,4,31,69,22,31,21,38,2,5,12,43,69
2007-03-19 00:00:00.000,ATP Masters Series Miami FL; U.S.A. ATP World Tour,HARD,2,Michael Llodra,Dominik Hrbaty,Michael Llodra,6-3; 6-2,R64,66,5,1,32,46,28,32,8,14,0,0,9,36,46,2,4,37,62,24,37,8,25,5,8,8,32,62
2007-03-19 00:00:00.000,ATP Masters Series Miami FL; U.S.A. ATP World Tour,HARD,2,Novak Djokovic,Daniele Bracciali,Novak Djokovic,7-6(4); 6-4,R64,84,13,1,45,66,36,45,15,21,3,3,11,51,66,8,0,47,72,34,47,16,25,3,4,11,50,72
2007-03-19 00:00:00.000,ATP Masters Series Miami FL; U.S.A. ATP World Tour,HARD,2,Mikhail Youzhny,Teymuraz Gabashvili,Mikhail Youzhny,3-6; 6-3; 6-3,R64,108,5,4,40,76,33,40,20,36,1,3,13,53,76,3,8,39,73,32,39,15,34,0,4,14,47,73
2007-03-19 00:00:00.000,ATP Masters Series Miami FL; U.S.A. ATP World Tour,HARD,2,Juan Martin Del Potro,Marcos Baghdatis,Juan Martin Del Potro,6-2; 5-7; 6-0,R64,116,9,3,63,91,42,63,16,28,7,9,13,58,91,5,6,40,72,28,40,9,32,0,6,13,37,72
2007-03-19 00:00:00.000,ATP Masters Series Miami FL; U.S.A. ATP World Tour,HARD,2,Olivier Rochus,Guillermo Garcia-Lopez,Olivier Rochus,6-3; 6-4,R64,82,1,3,44,71,33,44,15,27,6,6,10,48,71,4,1,32,51,20,32,11,19,1,3,9,31,51
2007-03-19 00:00:00.000,ATP Masters Series Miami FL; U.S.A. ATP World Tour,HARD,2,Rafael Nadal,Ricardo Mello,Rafael Nadal,7-6(7); 6-2,R64,106,4,0,40,63,33,40,14,23,1,1,10,47,63,4,1,49,74,32,49,14,25,5,7,10,46,74
2007-03-19 00:00:00.000,ATP Masters Series Miami FL; U.S.A. ATP World Tour,HARD,2,Roger Federer,Nicolas Almagro,Roger Federer,7-5; 6-3,R32,82,9,1,27,57,22,27,19,30,0,1,11,41,57,5,3,48,73,31,48,11,25,6,9,10,42,73
2007-03-19 00:00:00.000,ATP Masters Series Miami FL; U.S.A. ATP World Tour,HARD,2,Guillermo Canas,Richard Gasquet,Guillermo Canas,7-6(3); 6-3,R32,99,6,2,52,74,40,52,11,22,5,6,11,51,74,2,1,40,62,27,40,13,22,4,6,10,40,62
2007-03-19 00:00:00.000,ATP Masters Series Miami FL; U.S.A. ATP World Tour,HARD,2,Radek Stepanek,Alejandro Falla,Radek Stepanek,6-3; 6-2,R32,71,0,3,27,50,21,27,13,23,0,1,9,34,50,1,4,28,47,17,28,8,19,1,5,8,25,47
2007-03-19 00:00:00.000,ATP Masters Series Miami FL; U.S.A. ATP World Tour,HARD,2,Tommy Robredo,Florian Mayer,Tommy Robredo,6-4; 6-4,R32,83,2,4,47,73,35,47,12,26,8,9,10,47,73,3,1,33,51,23,33,7,18,0,3,10,30,51
2007-03-19 00:00:00.000,ATP Masters Series Miami FL; U.S.A. ATP World Tour,HARD,2,Amer Delic,Nikolay Davydenko,Amer Delic,7-6(5); 6-3,R32,92,6,0,55,77,39,55,12,22,7,8,10,51,77,1,4,50,74,36,50,11,24,3,6,11,47,74
2007-03-19 00:00:00.000,ATP Masters Series Miami FL; U.S.A. ATP World Tour,HARD,2,Juan Ignacio Chela,Tomas Berdych,Juan Ignacio Chela,6-4; 7-6(6),R32,89,2,2,35,64,25,35,20,29,0,1,11,45,64,9,2,40,72,33,40,14,32,4,6,11,47,72
2007-03-19 00:00:00.000,ATP Masters Series Miami FL; U.S.A. ATP World Tour,HARD,2,Jarkko Nieminen,David Nalbandian,Jarkko Nieminen,6-4; 7-6(3),R32,129,1,2,67,102,44,67,12,35,7,10,11,56,102,2,3,31,73,21,31,20,42,3,7,11,41,73
2007-03-19 00:00:00.000,ATP Masters Series Miami FL; U.S.A. ATP World Tour,HARD,2,Ivan Ljubicic,Fabrice Santoro,Ivan Ljubicic,3-6; 6-3; 6-4,R32,133,11,6,44,87,34,44,21,43,3,6,14,55,87,4,2,59,99,35,59,22,40,10,14,14,57,99
2007-03-19 00:00:00.000,ATP Masters Series Miami FL; U.S.A. ATP World Tour,HARD,2,Paul-Henri Mathieu,Fernando Gonzalez,Paul-Henri Mathieu,6-3; 7-6(6),R32,112,3,0,48,75,36,48,16,27,5,6,11,52,75,8,4,44,78,30,44,17,34,4,6,10,47,78
2007-03-19 00:00:00.000,ATP Masters Series Miami FL; U.S.A. ATP World Tour,HARD,2,Andy Murray,Robert Kendrick,Andy Murray,6-3; 6-1,R32,62,1,0,34,43,25,34,7,9,0,0,8,32,43,4,6,37,62,21,37,11,25,4,8,8,32,62
2007-03-19 00:00:00.000,ATP Masters Series Miami FL; U.S.A. ATP World Tour,HARD,2,David Ferrer,Simone Bolelli,David Ferrer,7-6(0); 6-2,R32,70,3,0,46,56,35,46,7,10,0,1,10,42,56,2,3,32,56,23,32,10,24,0,3,10,33,56
2007-03-19 00:00:00.000,ATP Masters Series Miami FL; U.S.A. ATP World Tour,HARD,2,Andy Roddick,Gilles Simon,Andy Roddick,6-4; 6-4,R32,71,8,2,33,57,28,33,15,24,1,1,10,43,57,4,2,36,61,25,36,14,25,3,5,10,39,61
2007-03-19 00:00:00.000,ATP Masters Series Miami FL; U.S.A. ATP World Tour,HARD,2,Feliciano Lopez,Florent Serra,Feliciano Lopez,7-6(4); 6-3,R32,84,5,1,28,60,26,28,23,32,0,0,11,49,60,2,4,57,77,37,57,11,20,5,6,10,48,77
2007-03-19 00:00:00.000,ATP Masters Series Miami FL; U.S.A. ATP World Tour,HARD,2,Novak Djokovic,Michael Llodra,Novak Djokovic,6-4; 6-1,R32,60,1,1,27,44,23,27,13,17,0,0,9,36,44,3,3,27,48,16,27,10,21,2,5,8,26,48
2007-03-19 00:00:00.000,ATP Masters Series Miami FL; U.S.A. ATP World Tour,HARD,2,Juan Martin Del Potro,Mikhail Youzhny,Juan Martin Del Potro,7-6(2); 6-4,R32,97,6,1,45,70,31,45,15,25,1,3,11,46,70,0,4,44,71,32,44,9,27,2,5,11,41,71
2007-03-19 00:00:00.000,ATP Masters Series Miami FL; U.S.A. ATP World Tour,HARD,2,Rafael Nadal,Olivier Rochus,Rafael Nadal,W/O,R32,0,0,0,0,0,0,0,0,0,0,0,0,0,0,0,0,0,0,0,0,0,0,0,0,0,0,0
2007-03-19 00:00:00.000,ATP Masters Series Miami FL; U.S.A. ATP World Tour,HARD,2,Guillermo Canas,Roger Federer,Guillermo Canas,7-6(2); 2-6; 7-6(5),R16,159,5,0,67,122,51,67,26,55,12,16,16,77,122,7,1,54,97,39,54,27,43,3,5,16,66,97
2007-03-19 00:00:00.000,ATP Masters Series Miami FL; U.S.A. ATP World Tour,HARD,2,Tommy Robredo,Radek Stepanek,Tommy Robredo,7-6(4); 5-7; 7-6(3),R16,176,3,0,85,119,59,85,20,34,6,10,18,79,119,7,1,76,117,57,76,20,41,5,8,18,77,117
2007-03-19 00:00:00.000,ATP Masters Series Miami FL; U.S.A. ATP World Tour,HARD,2,Juan Ignacio Chela,Amer Delic,Juan Ignacio Chela,6-3; 6-2,R16,80,6,5,46,79,35,46,13,33,11,12,9,48,79,3,1,22,44,13,22,10,22,1,5,8,23,44
2007-03-19 00:00:00.000,ATP Masters Series Miami FL; U.S.A. ATP World Tour,HARD,2,Ivan Ljubicic,Jarkko Nieminen,Ivan Ljubicic,7-6(4); 6-4,R16,100,13,1,44,73,35,44,18,29,1,1,11,53,73,1,1,42,73,26,42,23,31,4,5,11,49,73
2007-03-19 00:00:00.000,ATP Masters Series Miami FL; U.S.A. ATP World Tour,HARD,2,Andy Murray,Paul-Henri Mathieu,Andy Murray,2-6; 7-5; 6-3,R16,127,9,2,48,84,34,48,19,36,4,8,15,53,84,1,4,49,83,30,49,19,34,5,9,14,49,83
2007-03-19 00:00:00.000,ATP Masters Series Miami FL; U.S.A. ATP World Tour,HARD,2,Andy Roddick,David Ferrer,Andy Roddick,7-5; 6-3,R16,87,7,2,36,65,31,36,16,29,3,4,11,47,65,2,0,45,58,29,45,6,13,4,7,10,35,58
2007-03-19 00:00:00.000,ATP Masters Series Miami FL; U.S.A. ATP World Tour,HARD,2,Novak Djokovic,Feliciano Lopez,Novak Djokovic,6-0; 6-3,R16,57,4,1,28,41,24,28,9,13,1,1,8,33,41,1,2,29,40,17,29,3,11,4,8,7,20,40
2007-03-19 00:00:00.000,ATP Masters Series Miami FL; U.S.A. ATP World Tour,HARD,2,Rafael Nadal,Juan Martin Del Potro,Rafael Nadal,6-0; 6-4,R16,89,3,0,36,53,26,36,10,17,2,2,8,36,53,0,1,47,60,24,47,6,13,9,13,8,30,60
2007-03-19 00:00:00.000,ATP Masters Series Miami FL; U.S.A. ATP World Tour,HARD,2,Guillermo Canas,Tommy Robredo,Guillermo Canas,7-6(5); 6-1,Q,97,2,0,30,53,24,30,18,23,0,0,9,42,53,3,2,52,78,33,52,12,26,8,11,10,45,78
2007-03-19 00:00:00.000,ATP Masters Series Miami FL; U.S.A. ATP World Tour,HARD,2,Ivan Ljubicic,Juan Ignacio Chela,Ivan Ljubicic,6-3; 7-5,Q,90,14,2,43,72,32,43,16,29,3,4,11,48,72,3,2,33,49,27,33,5,16,2,5,10,32,49
2007-03-19 00:00:00.000,ATP Masters Series Miami FL; U.S.A. ATP World Tour,HARD,2,Andy Murray,Andy Roddick,Andy Murray,5-3 RET,Q,36,2,1,14,22,11,14,5,8,0,0,4,16,22,2,1,13,24,11,13,5,11,3,4,4,16,24
2007-03-19 00:00:00.000,ATP Masters Series Miami FL; U.S.A. ATP World Tour,HARD,2,Novak Djokovic,Rafael Nadal,Novak Djokovic,6-3; 6-4,Q,97,7,0,45,65,29,45,15,20,4,5,10,44,65,1,1,40,54,28,40,5,14,4,7,9,33,54
2007-03-19 00:00:00.000,ATP Masters Series Miami FL; U.S.A. ATP World Tour,HARD,2,Guillermo Canas,Ivan Ljubicic,Guillermo Canas,7-5; 6-2,S,94,4,3,49,72,36,49,12,23,7,7,10,48,72,6,0,32,49,24,32,9,17,0,3,10,33,49
2007-03-19 00:00:00.000,ATP Masters Series Miami FL; U.S.A. ATP World Tour,HARD,2,Novak Djokovic,Andy Murray,Novak Djokovic,6-1; 6-0,S,63,2,2,28,42,20,28,10,14,3,3,7,30,42,1,5,18,44,10,18,8,26,4,9,6,18,44
2007-03-19 00:00:00.000,ATP Masters Series Miami FL; U.S.A. ATP World Tour,HARD,2,Novak Djokovic,Guillermo Canas,Novak Djokovic,6-3; 6-2; 6-4,F,140,7,1,64,96,44,64,23,32,5,5,14,67,96,6,5,37,69,24,37,16,32,3,7,13,40,69
2007-04-09 00:00:00.000,Houston TX; U.S.A. ATP World Tour,CLAY,2,Albert Montanes,Alexander Peya,Albert Montanes,6-3; 6-2,R32,74,0,0,36,57,26,36,14,21,4,4,9,40,57,0,3,24,51,17,24,13,27,4,7,8,30,51
2007-04-09 00:00:00.000,Houston TX; U.S.A. ATP World Tour,CLAY,2,Dusan Vemic,Ruben Ramirez Hidalgo,Dusan Vemic,6-3; 6-0,R32,68,8,1,30,47,21,30,12,17,4,4,7,33,47,0,10,24,52,16,24,9,28,6,11,8,25,52
2007-04-09 00:00:00.000,Houston TX; U.S.A. ATP World Tour,CLAY,2,Michael Russell,Paul Goldstein,Michael Russell,6-2; 6-0,R32,70,1,0,26,38,21,26,9,12,2,2,7,30,38,2,3,36,61,21,36,6,25,4,9,7,27,61
2007-04-09 00:00:00.000,Houston TX; U.S.A. ATP World Tour,CLAY,2,Vincent Spadea,Robby Ginepri,Vincent Spadea,6-3; 3-6; 6-3,R32,108,3,4,55,90,40,55,14,35,8,12,14,54,90,2,0,45,74,22,45,19,29,5,10,13,41,74
2007-04-09 00:00:00.000,Houston TX; U.S.A. ATP World Tour,CLAY,2,Tommy Haas,Sam Querrey,Tommy Haas,3-6; 6-3; 7-5,R32,99,5,6,38,78,32,38,18,40,1,5,15,50,78,10,7,46,91,36,46,16,45,7,12,15,52,91
2007-04-09 00:00:00.000,Houston TX; U.S.A. ATP World Tour,CLAY,2,Nicolas Devilder,Justin Gimelstob,Nicolas Devilder,6-2; 6-3,R32,78,4,3,24,47,20,24,15,23,1,1,8,35,47,2,4,41,69,28,41,8,28,9,13,9,36,69
2007-04-09 00:00:00.000,Houston TX; U.S.A. ATP World Tour,CLAY,2,Diego Hartfield,Sebastien Grosjean,Diego Hartfield,6-4; 6-4,R32,89,4,2,46,70,33,46,12,24,8,10,10,45,70,3,3,42,70,29,42,10,28,4,8,10,39,70
2007-04-09 00:00:00.000,Houston TX; U.S.A. ATP World Tour,CLAY,2,Ivo Karlovic,Benjamin Becker,Ivo Karlovic,7-5; 7-6(3),R32,116,16,2,55,88,40,55,20,33,9,10,12,60,88,4,3,42,78,34,42,14,36,3,5,12,48,78
2007-04-09 00:00:00.000,Houston TX; U.S.A. ATP World Tour,CLAY,2,Jurgen Melzer,Rainer Schuettler,Jurgen Melzer,6-2; 3-6; 6-1,R32,111,5,4,54,92,37,54,21,38,5,6,12,58,92,3,1,42,71,24,42,17,29,5,9,12,41,71
2007-04-09 00:00:00.000,Houston TX; U.S.A. ATP World Tour,CLAY,2,Victor Hanescu,Martin Verkerk,Victor Hanescu,6-4; 6-4,R32,68,3,1,42,60,35,42,10,18,2,2,10,45,60,8,1,43,63,28,43,12,20,2,4,10,40,63
2007-04-09 00:00:00.000,Houston TX; U.S.A. ATP World Tour,CLAY,2,Mariano Zabaleta,Ryan Sweeting,Mariano Zabaleta,6-0; 7-6(8),R32,82,8,1,42,62,31,42,14,20,3,3,9,45,62,4,4,43,64,29,43,8,21,2,5,9,37,64
2007-04-09 00:00:00.000,Houston TX; U.S.A. ATP World Tour,CLAY,2,Mardy Fish,Martin Vassallo Arguello,Mardy Fish,5-7; 6-2; 7-5,R32,152,5,6,45,91,34,45,20,46,7,12,16,54,91,4,4,61,101,34,61,20,40,6,13,16,54,101
2007-04-09 00:00:00.000,Houston TX; U.S.A. ATP World Tour,CLAY,2,Juan Monaco,Jan-Michael Gambill,Juan Monaco,7-5; 6-4,R32,70,2,1,36,57,30,36,15,21,3,4,11,45,57,6,4,33,59,26,33,10,26,1,4,11,36,59
2007-04-09 00:00:00.000,Houston TX; U.S.A. ATP World Tour,CLAY,2,Amer Delic,Robert Kendrick,Amer Delic,6-3; 1-6; 7-5,R32,91,8,2,51,74,37,51,12,23,3,6,14,49,74,6,7,47,86,36,47,19,39,9,12,14,55,86
2007-04-09 00:00:00.000,Houston TX; U.S.A. ATP World Tour,CLAY,2,Alex Kuznetsov,Lars Burgsmuller,Alex Kuznetsov,7-5; 7-5,R32,102,5,1,46,68,36,46,10,22,2,4,12,46,68,1,8,59,87,37,59,12,28,6,10,12,49,87
2007-04-09 00:00:00.000,Houston TX; U.S.A. ATP World Tour,CLAY,2,James Blake,Davide Sanguinetti,James Blake,6-3; 6-0,R32,59,2,1,35,66,24,35,19,31,5,5,8,43,66,4,3,32,48,18,32,5,16,3,7,7,23,48
2007-04-09 00:00:00.000,Houston TX; U.S.A. ATP World Tour,CLAY,2,Albert Montanes,Dusan Vemic,Albert Montanes,6-4; 4-6; 6-4,R16,125,5,2,63,101,46,63,22,38,9,10,15,68,101,9,1,60,90,47,60,16,30,6,8,15,63,90
2007-04-09 00:00:00.000,Houston TX; U.S.A. ATP World Tour,CLAY,2,Vincent Spadea,Michael Russell,Vincent Spadea,7-6(3); 2-6; 6-1,R16,135,6,3,65,101,39,65,15,36,5,11,14,54,101,0,4,67,85,38,67,6,18,8,14,13,44,85
2007-04-09 00:00:00.000,Houston TX; U.S.A. ATP World Tour,CLAY,2,Tommy Haas,Nicolas Devilder,Tommy Haas,6-3; 6-4,R16,77,7,3,37,62,30,37,15,25,5,5,10,45,62,2,1,30,62,19,30,17,32,3,5,9,36,62
2007-04-09 00:00:00.000,Houston TX; U.S.A. ATP World Tour,CLAY,2,Ivo Karlovic,Diego Hartfield,Ivo Karlovic,W/O,R16,0,0,0,0,0,0,0,0,0,0,0,0,0,0,0,0,0,0,0,0,0,0,0,0,0,0,0
2007-04-09 00:00:00.000,Houston TX; U.S.A. ATP World Tour,CLAY,2,Jurgen Melzer,Victor Hanescu,Jurgen Melzer,6-4; 6-2,R16,81,5,2,35,59,25,35,15,24,3,3,9,40,59,3,3,47,73,34,47,7,26,8,11,9,41,73
2007-04-09 00:00:00.000,Houston TX; U.S.A. ATP World Tour,CLAY,2,Mariano Zabaleta,Mardy Fish,Mariano Zabaleta,7-5; 6-4,R16,100,0,0,37,72,29,37,18,35,5,7,11,47,72,5,0,29,63,24,29,15,34,4,8,11,39,63
2007-04-09 00:00:00.000,Houston TX; U.S.A. ATP World Tour,CLAY,2,Juan Monaco,Amer Delic,Juan Monaco,6-2; 6-3,R16,66,0,0,24,37,19,24,10,13,0,1,8,29,37,6,3,42,74,24,42,12,32,13,18,9,36,74
2007-04-09 00:00:00.000,Houston TX; U.S.A. ATP World Tour,CLAY,2,James Blake,Alex Kuznetsov,James Blake,7-6(4); 6-1,R16,77,5,4,38,66,27,38,16,28,2,4,10,43,66,1,2,31,62,21,31,12,31,7,11,9,33,62
2007-04-09 00:00:00.000,Houston TX; U.S.A. ATP World Tour,CLAY,2,Albert Montanes,Vincent Spadea,Albert Montanes,6-4; 6-4,Q,80,4,0,53,64,38,53,5,11,1,2,10,43,64,2,3,39,65,26,39,11,26,8,11,10,37,65
2007-04-09 00:00:00.000,Houston TX; U.S.A. ATP World Tour,CLAY,2,Ivo Karlovic,Tommy Haas,Ivo Karlovic,7-6(7); 6-4,Q,98,12,2,42,75,36,42,16,33,2,2,11,52,75,7,4,36,67,31,36,16,31,3,4,11,47,67
2007-04-09 00:00:00.000,Houston TX; U.S.A. ATP World Tour,CLAY,2,Mariano Zabaleta,Jurgen Melzer,Mariano Zabaleta,6-1; 6-2,Q,69,3,3,28,53,17,28,18,25,5,5,7,35,53,1,2,30,47,17,30,4,17,5,10,8,21,47
2007-04-09 00:00:00.000,Houston TX; U.S.A. ATP World Tour,CLAY,2,James Blake,Juan Monaco,James Blake,7-6(5); 1-6; 7-6(0),Q,132,6,3,66,107,42,66,26,41,4,8,16,68,107,1,0,76,106,53,76,17,30,5,6,15,70,106
2007-04-09 00:00:00.000,Houston TX; U.S.A. ATP World Tour,CLAY,2,Ivo Karlovic,Albert Montanes,Ivo Karlovic,7-6(5); 6-2,S,72,15,0,45,63,38,45,12,18,3,3,10,50,63,4,4,35,57,30,35,11,22,1,3,10,41,57
2007-04-09 00:00:00.000,Houston TX; U.S.A. ATP World Tour,CLAY,2,Mariano Zabaleta,James Blake,Mariano Zabaleta,7-5; 7-6(7),S,104,3,4,51,79,42,51,15,28,4,5,12,57,79,2,5,64,92,44,64,14,28,8,10,12,58,92
2007-04-09 00:00:00.000,Houston TX; U.S.A. ATP World Tour,CLAY,2,Ivo Karlovic,Mariano Zabaleta,Ivo Karlovic,6-4; 6-1,F,79,10,1,41,60,32,41,8,19,5,5,9,40,60,0,5,35,54,21,35,9,19,5,8,8,30,54
2007-04-09 00:00:00.000,Valencia Spain ATP World Tour,CLAY,2,Ivan Navarro,Daniele Bracciali,Ivan Navarro,6-3; 6-1,R32,53,7,0,32,40,27,32,6,8,1,1,8,33,40,1,1,26,42,12,26,9,16,1,5,8,21,42
2007-04-09 00:00:00.000,Valencia Spain ATP World Tour,CLAY,2,Augustin Gensse,James Ward,Augustin Gensse,6-7(2); 6-4; 6-3,R32,148,1,2,94,127,60,94,16,33,5,8,16,76,127,2,2,54,96,34,54,24,42,1,6,15,58,96
2007-04-09 00:00:00.000,Valencia Spain ATP World Tour,CLAY,2,Sergio Roitman,Jan Hernych,Sergio Roitman,7-5; 7-6(7),R32,134,1,0,64,94,42,64,14,30,6,8,12,56,94,4,1,62,101,42,62,16,39,12,15,12,58,101
2007-04-09 00:00:00.000,Valencia Spain ATP World Tour,CLAY,2,Evgeny Korolev,Guillermo Garcia-Lopez,Evgeny Korolev,6-3; 1-6; 6-3,R32,99,1,2,41,70,27,41,11,29,3,8,12,38,70,1,2,54,76,29,54,10,22,1,7,13,39,76
2007-04-09 00:00:00.000,Valencia Spain ATP World Tour,CLAY,2,Potito Starace,Fernando Verdasco,Potito Starace,6-1; 4-6; 6-3,R32,118,2,2,72,88,42,72,7,16,8,13,13,49,88,1,12,57,90,33,57,8,33,9,17,13,41,90
2007-04-09 00:00:00.000,Valencia Spain ATP World Tour,CLAY,2,Pablo Andujar,Simon Greul,Pablo Andujar,6-2; 6-4,R32,80,1,2,36,60,27,36,15,24,6,6,9,42,60,2,0,34,61,19,34,15,27,3,6,9,34,61
2007-04-09 00:00:00.000,Valencia Spain ATP World Tour,CLAY,2,Marcel Granollers,Kristian Pless,Marcel Granollers,2-6; 6-3; 6-3,R32,97,1,2,56,76,37,56,12,20,1,4,13,49,76,1,2,52,89,34,52,18,37,3,7,13,52,89
2007-04-09 00:00:00.000,Valencia Spain ATP World Tour,CLAY,2,Gilles Simon,Teymuraz Gabashvili,Gilles Simon,4-6; 6-3; 6-2,R32,123,4,1,53,91,37,53,21,38,3,5,14,58,91,3,3,47,90,33,47,17,43,8,12,13,50,90
2007-04-09 00:00:00.000,Valencia Spain ATP World Tour,CLAY,2,Filippo Volandri,Igor Andreev,Filippo Volandri,6-4; 7-6(8),R32,104,0,2,53,73,32,53,8,20,3,8,11,40,73,3,2,50,75,28,50,11,25,3,9,11,39,75
2007-04-09 00:00:00.000,Valencia Spain ATP World Tour,CLAY,2,Stefan Koubek,Oscar Hernandez,Stefan Koubek,7-6(5); 6-4,R32,88,4,5,40,71,33,40,15,31,4,6,11,48,71,0,4,41,64,26,41,15,23,1,4,11,41,64
2007-04-09 00:00:00.000,Valencia Spain ATP World Tour,CLAY,2,Alessio Di Mauro,Marc Fornell-Mestres,Alessio Di Mauro,6-4; 6-7(5); 6-3,R32,171,6,6,53,108,32,53,28,55,7,14,16,60,108,0,1,51,100,28,51,22,49,7,16,15,50,100
2007-04-09 00:00:00.000,Valencia Spain ATP World Tour,CLAY,2,Nicolas Almagro,Jan Hajek,Nicolas Almagro,6-2; 6-1,R32,43,16,1,19,34,17,19,11,15,0,0,7,28,34,0,4,35,50,19,35,3,15,4,9,8,22,50
2007-04-09 00:00:00.000,Valencia Spain ATP World Tour,CLAY,2,Santiago Ventura,Florian Mayer,Santiago Ventura,6-3; 6-3,R32,70,2,1,26,54,20,26,9,28,2,5,9,29,54,0,0,31,55,15,31,10,24,3,9,9,25,55
2007-04-09 00:00:00.000,Valencia Spain ATP World Tour,CLAY,2,Alejandro Falla,Andreas Seppi,Alejandro Falla,6-3; 6-4,R32,104,2,2,47,75,34,47,12,28,8,10,10,46,75,3,3,40,70,26,40,11,30,5,9,9,37,70
2007-04-09 00:00:00.000,Valencia Spain ATP World Tour,CLAY,2,Alberto Martin,Feliciano Lopez,Alberto Martin,6-2; 3-6; 6-2,R32,102,4,2,45,73,34,45,15,28,2,3,12,49,73,8,3,58,91,33,58,19,33,9,13,13,52,91
2007-04-09 00:00:00.000,Valencia Spain ATP World Tour,CLAY,2,Juan Carlos Ferrero,Ernests Gulbis,Juan Carlos Ferrero,6-3; 6-1,R32,64,1,0,42,54,29,42,8,12,7,7,8,37,54,4,4,28,56,20,28,8,28,7,11,8,28,56
2007-04-09 00:00:00.000,Valencia Spain ATP World Tour,CLAY,2,Ivan Navarro,Augustin Gensse,Ivan Navarro,7-6(11); 6-4,R16,115,3,1,53,71,43,53,12,18,1,1,11,55,71,0,0,61,94,40,61,19,33,6,7,11,59,94
2007-04-09 00:00:00.000,Valencia Spain ATP World Tour,CLAY,2,Evgeny Korolev,Sergio Roitman,Evgeny Korolev,1-6; 7-5; 6-0,R16,114,0,3,27,70,16,27,21,43,5,10,12,37,70,2,3,49,85,27,49,14,36,4,11,13,41,85
2007-04-09 00:00:00.000,Valencia Spain ATP World Tour,CLAY,2,Potito Starace,Pablo Andujar,Potito Starace,6-4; 1-6; 6-3,R16,117,1,2,65,86,43,65,9,21,2,6,13,52,86,1,2,63,91,39,63,14,28,11,15,13,53,91
2007-04-09 00:00:00.000,Valencia Spain ATP World Tour,CLAY,2,Marcel Granollers,Gilles Simon,Marcel Granollers,6-3; 4-6; 6-1,R16,130,4,1,69,97,42,69,11,28,8,13,13,53,97,2,1,50,85,23,50,17,35,9,17,13,40,85
2007-04-09 00:00:00.000,Valencia Spain ATP World Tour,CLAY,2,Filippo Volandri,Stefan Koubek,Filippo Volandri,6-4; 1-0 RET,R16,48,0,1,24,32,14,24,4,8,0,2,5,18,32,1,1,18,36,10,18,7,18,1,5,6,17,36
2007-04-09 00:00:00.000,Valencia Spain ATP World Tour,CLAY,2,Nicolas Almagro,Alessio Di Mauro,Nicolas Almagro,7-5; 6-2,R16,101,3,4,31,66,23,31,17,35,4,7,10,40,66,0,0,38,63,16,38,14,25,3,9,10,30,63
2007-04-09 00:00:00.000,Valencia Spain ATP World Tour,CLAY,2,Santiago Ventura,Alejandro Falla,Santiago Ventura,7-5; 6-7(6); 6-4,R16,162,4,4,47,117,32,47,41,70,4,8,17,73,117,0,2,54,113,30,54,31,59,7,13,17,61,113
2007-04-09 00:00:00.000,Valencia Spain ATP World Tour,CLAY,2,Alberto Martin,Juan Carlos Ferrero,Alberto Martin,6-4; 6-2,R16,97,3,1,45,69,27,45,10,24,11,14,9,37,69,1,0,51,62,24,51,3,11,4,10,9,27,62
2007-04-09 00:00:00.000,Valencia Spain ATP World Tour,CLAY,2,Ivan Navarro,Evgeny Korolev,Ivan Navarro,6-3; 6-1,Q,61,9,0,26,43,21,26,11,17,0,0,8,32,43,0,0,32,49,19,32,5,17,5,9,8,24,49
2007-04-09 00:00:00.000,Valencia Spain ATP World Tour,CLAY,2,Potito Starace,Marcel Granollers,Potito Starace,6-4; 6-4,Q,87,2,0,53,70,42,53,8,17,3,3,10,50,70,2,3,29,61,20,29,18,32,3,5,10,38,61
2007-04-09 00:00:00.000,Valencia Spain ATP World Tour,CLAY,2,Nicolas Almagro,Filippo Volandri,Nicolas Almagro,6-3; 1-0,Q,55,7,1,16,27,13,16,6,11,0,1,5,19,27,0,0,36,48,17,36,5,12,7,10,5,22,48
2007-04-09 00:00:00.000,Valencia Spain ATP World Tour,CLAY,2,Santiago Ventura,Alberto Martin,Santiago Ventura,1-6; 7-6(2); 6-4,Q,173,4,7,52,110,41,52,29,58,13,16,14,70,110,3,5,53,87,43,53,16,34,0,2,15,59,87
2007-04-09 00:00:00.000,Valencia Spain ATP World Tour,CLAY,2,Potito Starace,Ivan Navarro,Potito Starace,6-7(2); 6-0; 7-5,S,149,0,2,80,93,58,80,8,13,1,1,15,66,93,5,4,60,101,42,60,22,41,6,10,15,64,101
2007-04-09 00:00:00.000,Valencia Spain ATP World Tour,CLAY,2,Nicolas Almagro,Santiago Ventura,Nicolas Almagro,6-7(6); 6-4; 6-4,S,165,16,2,64,99,50,64,19,35,3,4,16,69,99,5,7,63,119,47,63,27,56,10,13,16,74,119
2007-04-09 00:00:00.000,Valencia Spain ATP World Tour,CLAY,2,Nicolas Almagro,Potito Starace,Nicolas Almagro,4-6; 6-2; 6-1,F,97,8,1,48,66,37,48,10,18,1,3,13,47,66,0,1,58,80,31,58,13,22,5,10,12,44,80
2007-04-15 00:00:00.000,ATP Masters Series Monte Carlo Monaco ATP World Tour,CLAY,2,Roger Federer,N/A Bye,Roger Federer,,R64,0,0,0,0,0,0,0,0,0,0,0,0,0,0,0,0,0,0,0,0,0,0,0,0,0,0,0
2007-04-15 00:00:00.000,ATP Masters Series Monte Carlo Monaco ATP World Tour,CLAY,2,Andreas Seppi,Teymuraz Gabashvili,Andreas Seppi,6-1; 6-3,R64,75,4,5,25,51,19,25,11,26,5,7,8,30,51,0,3,27,58,11,27,11,31,7,13,8,22,58
2007-04-15 00:00:00.000,ATP Masters Series Monte Carlo Monaco ATP World Tour,CLAY,2,Hyung-Taik Lee,Jonas Bjorkman,Hyung-Taik Lee,7-6(6); 6-1,R64,92,0,1,36,61,26,36,13,25,1,3,10,39,61,3,2,44,75,24,44,14,31,5,9,9,38,75
2007-04-15 00:00:00.000,ATP Masters Series Monte Carlo Monaco ATP World Tour,CLAY,2,Mikhail Youzhny,Carlos Moya,Mikhail Youzhny,6-2; 3-1 RET,R64,64,2,1,31,49,22,31,10,18,8,8,6,32,49,0,2,18,36,13,18,3,18,2,5,6,16,36
2007-04-15 00:00:00.000,ATP Masters Series Monte Carlo Monaco ATP World Tour,CLAY,2,David Ferrer,Gilles Simon,David Ferrer,6-3; 6-1,R64,68,2,4,24,51,17,24,17,27,2,3,8,34,51,0,2,27,53,14,27,8,26,6,11,8,22,53
2007-04-15 00:00:00.000,ATP Masters Series Monte Carlo Monaco ATP World Tour,CLAY,2,Julien Benneteau,Benjamin Balleret,Julien Benneteau,7-5; 5-7; 6-2,R64,126,1,12,63,99,41,63,16,36,3,8,16,57,99,6,5,51,96,35,51,17,45,9,16,16,52,96
2007-04-15 00:00:00.000,ATP Masters Series Monte Carlo Monaco ATP World Tour,CLAY,2,Gaston Gaudio,Dmitry Tursunov,Gaston Gaudio,5-7; 6-2; 6-2,R64,129,0,6,75,102,51,75,12,27,11,14,14,63,102,6,5,43,90,31,43,19,47,3,9,14,50,90
2007-04-15 00:00:00.000,ATP Masters Series Monte Carlo Monaco ATP World Tour,CLAY,2,Novak Djokovic,N/A Bye,Novak Djokovic,,R64,0,0,0,0,0,0,0,0,0,0,0,0,0,0,0,0,0,0,0,0,0,0,0,0,0,0,0
2007-04-15 00:00:00.000,ATP Masters Series Monte Carlo Monaco ATP World Tour,CLAY,2,Fernando Gonzalez,N/A Bye,Fernando Gonzalez,,R64,0,0,0,0,0,0,0,0,0,0,0,0,0,0,0,0,0,0,0,0,0,0,0,0,0,0,0
2007-04-15 00:00:00.000,ATP Masters Series Monte Carlo Monaco ATP World Tour,CLAY,2,Igor Andreev,Jose Acasuso,Igor Andreev,6-4; 6-1,R64,85,4,1,50,71,32,50,12,21,4,5,9,44,71,0,5,30,52,16,30,10,22,3,7,8,26,52
2007-04-15 00:00:00.000,ATP Masters Series Monte Carlo Monaco ATP World Tour,CLAY,2,Nicolas Massu,Filippo Volandri,Nicolas Massu,4-6; 7-5; 6-3,R64,166,5,6,58,120,34,58,33,62,9,15,16,67,120,0,3,64,89,38,64,10,25,6,13,15,48,89
2007-04-15 00:00:00.000,ATP Masters Series Monte Carlo Monaco ATP World Tour,CLAY,2,Juan Carlos Ferrero,Tim Henman,Juan Carlos Ferrero,7-5; 6-2,R64,84,1,1,34,52,27,34,15,18,3,3,10,42,52,6,3,34,68,24,34,17,34,4,7,10,41,68
2007-04-15 00:00:00.000,ATP Masters Series Monte Carlo Monaco ATP World Tour,CLAY,2,Richard Gasquet,Fernando Verdasco,Richard Gasquet,7-5; 6-7(12); 7-6(3),R64,200,9,10,76,140,52,76,29,64,5,11,18,81,140,0,5,102,136,63,102,16,34,8,15,18,79,136
2007-04-15 00:00:00.000,ATP Masters Series Monte Carlo Monaco ATP World Tour,CLAY,2,Dominik Hrbaty,Albert Portas,Dominik Hrbaty,7-6(3); 7-5,R64,100,3,5,42,78,31,42,22,36,2,4,12,53,78,4,4,40,77,25,40,20,37,3,6,12,45,77
2007-04-15 00:00:00.000,ATP Masters Series Monte Carlo Monaco ATP World Tour,CLAY,2,Radek Stepanek,Gael Monfils,Radek Stepanek,6-0; 2-0 RET,R64,43,0,0,11,19,9,11,7,8,0,0,4,16,19,2,2,12,25,4,12,3,13,0,4,4,7,25
2007-04-15 00:00:00.000,ATP Masters Series Monte Carlo Monaco ATP World Tour,CLAY,2,Ivan Ljubicic,N/A Bye,Ivan Ljubicic,,R64,0,0,0,0,0,0,0,0,0,0,0,0,0,0,0,0,0,0,0,0,0,0,0,0,0,0,0
2007-04-15 00:00:00.000,ATP Masters Series Monte Carlo Monaco ATP World Tour,CLAY,2,Tommy Robredo,N/A Bye,Tommy Robredo,,R64,0,0,0,0,0,0,0,0,0,0,0,0,0,0,0,0,0,0,0,0,0,0,0,0,0,0,0
2007-04-15 00:00:00.000,ATP Masters Series Monte Carlo Monaco ATP World Tour,CLAY,2,Arnaud Clement,Florent Serra,Arnaud Clement,6-4; 7-6(5),R64,115,2,4,30,68,20,30,22,38,2,5,11,42,68,3,3,46,84,27,46,18,38,8,12,11,45,84
2007-04-15 00:00:00.000,ATP Masters Series Monte Carlo Monaco ATP World Tour,CLAY,2,Benjamin Becker,Thomas Johansson,Benjamin Becker,7-6(4); 6-2,R64,93,4,4,31,64,24,31,22,33,4,4,10,46,64,7,3,43,78,29,43,16,35,6,8,10,45,78
2007-04-15 00:00:00.000,ATP Masters Series Monte Carlo Monaco ATP World Tour,CLAY,2,Tomas Berdych,Nicolas Almagro,Tomas Berdych,5-0 RET,R64,19,1,0,7,15,6,7,6,8,0,0,3,12,15,1,0,8,16,4,8,2,8,1,3,2,6,16
2007-04-15 00:00:00.000,ATP Masters Series Monte Carlo Monaco ATP World Tour,CLAY,2,Max Mirnyi,Marcos Baghdatis,Max Mirnyi,7-5; 6-4,R64,99,5,6,39,82,32,39,19,43,7,8,11,51,82,4,4,33,75,23,33,21,42,3,6,11,44,75
2007-04-15 00:00:00.000,ATP Masters Series Monte Carlo Monaco ATP World Tour,CLAY,2,Sergio Roitman,Jurgen Melzer,Sergio Roitman,3-6; 6-1; 6-4,R64,109,2,0,57,85,37,57,16,28,3,6,13,53,85,3,7,52,92,34,52,16,40,3,8,13,50,92
2007-04-15 00:00:00.000,ATP Masters Series Monte Carlo Monaco ATP World Tour,CLAY,2,Robin Soderling,Olivier Rochus,Robin Soderling,6-4; 6-4,R64,92,13,5,44,70,36,44,8,26,6,7,10,44,70,1,2,41,66,28,41,10,25,3,6,10,38,66
2007-04-15 00:00:00.000,ATP Masters Series Monte Carlo Monaco ATP World Tour,CLAY,2,Nikolay Davydenko,N/A Bye,Nikolay Davydenko,,R64,0,0,0,0,0,0,0,0,0,0,0,0,0,0,0,0,0,0,0,0,0,0,0,0,0,0,0
2007-04-15 00:00:00.000,ATP Masters Series Monte Carlo Monaco ATP World Tour,CLAY,2,Guillermo Garcia-Lopez,N/A Bye,Guillermo Garcia-Lopez,,R64,0,0,0,0,0,0,0,0,0,0,0,0,0,0,0,0,0,0,0,0,0,0,0,0,0,0,0
2007-04-15 00:00:00.000,ATP Masters Series Monte Carlo Monaco ATP World Tour,CLAY,2,Marc Gicquel,Florian Mayer,Marc Gicquel,7-5; 5-7; 7-5,R64,132,7,3,73,111,56,73,14,38,5,9,18,70,111,9,3,58,105,40,58,29,47,8,13,18,69,105
2007-04-15 00:00:00.000,ATP Masters Series Monte Carlo Monaco ATP World Tour,CLAY,2,Philipp Kohlschreiber,Andrei Pavel,Philipp Kohlschreiber,6-2; 5-7; 6-4,R64,120,5,4,52,85,35,52,19,33,3,6,15,54,85,3,1,63,96,35,63,19,33,6,11,15,54,96
2007-04-15 00:00:00.000,ATP Masters Series Monte Carlo Monaco ATP World Tour,CLAY,2,David Nalbandian,Federico Luzzi,David Nalbandian,3-6; 6-2; 6-1,R64,104,6,4,40,68,32,40,14,28,3,5,12,46,68,7,8,33,85,22,33,23,52,2,7,12,45,85
2007-04-15 00:00:00.000,ATP Masters Series Monte Carlo Monaco ATP World Tour,CLAY,2,Marat Safin,Jarkko Nieminen,Marat Safin,5-7; 6-3; 6-2,R64,113,7,5,47,94,33,47,25,47,7,10,15,58,94,1,5,36,80,24,36,20,44,2,7,14,44,80
2007-04-15 00:00:00.000,ATP Masters Series Monte Carlo Monaco ATP World Tour,CLAY,2,Kristof Vliegen,Paul-Henri Mathieu,Kristof Vliegen,7-5; 6-3,R64,94,4,2,21,53,15,21,19,32,0,2,10,34,53,0,2,34,66,19,34,16,32,4,9,11,35,66
2007-04-15 00:00:00.000,ATP Masters Series Monte Carlo Monaco ATP World Tour,CLAY,2,Juan Ignacio Chela,Martin Verkerk,Juan Ignacio Chela,7-5; 6-2,R64,89,6,4,37,60,29,37,12,23,1,2,10,41,60,5,7,44,78,25,44,15,34,6,10,10,40,78
2007-04-15 00:00:00.000,ATP Masters Series Monte Carlo Monaco ATP World Tour,CLAY,2,Rafael Nadal,N/A Bye,Rafael Nadal,,R64,0,0,0,0,0,0,0,0,0,0,0,0,0,0,0,0,0,0,0,0,0,0,0,0,0,0,0
2007-04-15 00:00:00.000,ATP Masters Series Monte Carlo Monaco ATP World Tour,CLAY,2,Roger Federer,Andreas Seppi,Roger Federer,7-6(4); 7-6(6),R32,108,6,3,42,78,31,42,17,36,1,4,12,48,78,3,3,48,90,31,48,20,42,6,9,12,51,90
2007-04-15 00:00:00.000,ATP Masters Series Monte Carlo Monaco ATP World Tour,CLAY,2,Hyung-Taik Lee,Mikhail Youzhny,Hyung-Taik Lee,6-4; 6-3,R32,94,0,1,29,63,19,29,17,34,5,7,9,36,63,2,6,45,71,22,45,11,26,8,13,10,33,71
2007-04-15 00:00:00.000,ATP Masters Series Monte Carlo Monaco ATP World Tour,CLAY,2,David Ferrer,Julien Benneteau,David Ferrer,6-1; 7-5,R32,96,2,2,39,62,29,39,11,23,6,8,10,40,62,0,2,30,57,16,30,11,27,5,10,9,27,57
2007-04-15 00:00:00.000,ATP Masters Series Monte Carlo Monaco ATP World Tour,CLAY,2,Novak Djokovic,Gaston Gaudio,Novak Djokovic,6-1; 3-6; 6-1,R32,102,3,2,36,66,27,36,13,30,4,8,12,40,66,1,4,57,85,24,57,14,28,8,15,11,38,85
2007-04-15 00:00:00.000,ATP Masters Series Monte Carlo Monaco ATP World Tour,CLAY,2,Igor Andreev,Fernando Gonzalez,Igor Andreev,6-2; 2-6; 6-3,R32,121,5,4,52,83,39,52,15,31,4,6,13,54,83,2,5,57,96,40,57,16,39,10,13,12,56,96
2007-04-15 00:00:00.000,ATP Masters Series Monte Carlo Monaco ATP World Tour,CLAY,2,Juan Carlos Ferrero,Nicolas Massu,Juan Carlos Ferrero,6-2; 6-0,R32,54,1,1,24,35,21,24,7,11,0,0,7,28,35,0,3,22,41,10,22,8,19,4,9,7,18,41
2007-04-15 00:00:00.000,ATP Masters Series Monte Carlo Monaco ATP World Tour,CLAY,2,Richard Gasquet,Dominik Hrbaty,Richard Gasquet,6-3; 6-2,R32,76,3,5,32,61,24,32,17,29,6,7,9,41,61,3,5,26,46,15,26,8,20,1,5,8,23,46
2007-04-15 00:00:00.000,ATP Masters Series Monte Carlo Monaco ATP World Tour,CLAY,2,Ivan Ljubicic,Radek Stepanek,Ivan Ljubicic,7-6(6); 7-6(5),R32,145,7,1,46,95,36,46,31,49,8,8,12,67,95,3,3,70,107,48,70,22,37,11,11,12,70,107
2007-04-15 00:00:00.000,ATP Masters Series Monte Carlo Monaco ATP World Tour,CLAY,2,Tommy Robredo,Arnaud Clement,Tommy Robredo,6-3; 6-2,R32,85,5,1,32,52,24,32,11,20,2,3,8,35,52,1,4,27,53,18,27,7,26,3,8,9,25,53
2007-04-15 00:00:00.000,ATP Masters Series Monte Carlo Monaco ATP World Tour,CLAY,2,Tomas Berdych,Benjamin Becker,Tomas Berdych,6-1; 6-2,R32,64,3,1,19,39,15,19,13,20,4,5,7,28,39,1,3,27,54,13,27,8,27,2,8,8,21,54
2007-04-15 00:00:00.000,ATP Masters Series Monte Carlo Monaco ATP World Tour,CLAY,2,Max Mirnyi,Sergio Roitman,Max Mirnyi,7-5; 6-4,R32,99,1,3,44,74,31,44,20,30,2,3,11,51,74,0,2,55,77,35,55,10,22,6,9,11,45,77
2007-04-15 00:00:00.000,ATP Masters Series Monte Carlo Monaco ATP World Tour,CLAY,2,Robin Soderling,Nikolay Davydenko,Robin Soderling,6-4; 6-7(6); 6-3,R32,166,2,3,59,102,40,59,19,43,3,7,15,59,102,2,1,87,125,49,87,15,38,6,13,16,64,125
2007-04-15 00:00:00.000,ATP Masters Series Monte Carlo Monaco ATP World Tour,CLAY,2,Guillermo Garcia-Lopez,Marc Gicquel,Guillermo Garcia-Lopez,6-4; 1-6; 6-3,R32,119,3,7,43,92,31,43,23,49,6,9,13,54,92,8,3,45,87,33,45,20,42,2,5,13,53,87
2007-04-15 00:00:00.000,ATP Masters Series Monte Carlo Monaco ATP World Tour,CLAY,2,Philipp Kohlschreiber,David Nalbandian,Philipp Kohlschreiber,7-5; 4-1 RET,R32,74,2,1,30,44,21,30,9,14,0,1,8,30,44,1,4,32,50,20,32,4,18,0,4,9,24,50
2007-04-15 00:00:00.000,ATP Masters Series Monte Carlo Monaco ATP World Tour,CLAY,2,Kristof Vliegen,Marat Safin,Kristof Vliegen,0-6; 7-6(8); 6-4,R32,145,1,1,47,93,28,47,31,46,3,7,14,59,93,8,6,65,111,49,65,21,46,8,10,14,70,111
2007-04-15 00:00:00.000,ATP Masters Series Monte Carlo Monaco ATP World Tour,CLAY,2,Rafael Nadal,Juan Ignacio Chela,Rafael Nadal,6-3; 6-1,R32,87,0,1,31,54,23,31,12,23,1,2,8,35,54,0,5,31,58,18,31,10,27,6,11,8,28,58
2007-04-15 00:00:00.000,ATP Masters Series Monte Carlo Monaco ATP World Tour,CLAY,2,Roger Federer,Hyung-Taik Lee,Roger Federer,6-4; 6-3,R16,65,1,2,35,56,27,35,12,21,5,6,10,39,56,0,0,41,55,28,41,3,14,3,6,9,31,55
2007-04-15 00:00:00.000,ATP Masters Series Monte Carlo Monaco ATP World Tour,CLAY,2,David Ferrer,Novak Djokovic,David Ferrer,7-5; 6-4,R16,109,2,5,46,74,31,46,13,28,1,4,11,44,74,3,3,50,81,30,50,13,31,6,11,11,43,81
2007-04-15 00:00:00.000,ATP Masters Series Monte Carlo Monaco ATP World Tour,CLAY,2,Juan Carlos Ferrero,Igor Andreev,Juan Carlos Ferrero,6-3; 6-3,R16,93,2,0,47,65,30,47,11,18,7,8,9,41,65,0,1,47,60,27,47,4,13,3,7,9,31,60
2007-04-15 00:00:00.000,ATP Masters Series Monte Carlo Monaco ATP World Tour,CLAY,2,Richard Gasquet,Ivan Ljubicic,Richard Gasquet,6-3; 6-7(5); 7-5,R16,171,5,7,52,96,40,52,25,44,2,5,17,65,96,6,5,65,138,44,65,33,73,13,18,16,77,138
2007-04-15 00:00:00.000,ATP Masters Series Monte Carlo Monaco ATP World Tour,CLAY,2,Tomas Berdych,Tommy Robredo,Tomas Berdych,1-6; 6-3; 6-2,R16,127,2,1,51,97,39,51,19,46,11,14,12,58,97,1,1,54,77,33,54,13,23,4,8,12,46,77
2007-04-15 00:00:00.000,ATP Masters Series Monte Carlo Monaco ATP World Tour,CLAY,2,Robin Soderling,Max Mirnyi,Robin Soderling,7-6(5); 6-2,R16,94,2,1,45,62,36,45,9,17,4,5,10,45,62,2,9,44,74,31,44,11,30,6,9,10,42,74
2007-04-15 00:00:00.000,ATP Masters Series Monte Carlo Monaco ATP World Tour,CLAY,2,Philipp Kohlschreiber,Guillermo Garcia-Lopez,Philipp Kohlschreiber,5-7; 7-6(4); 7-6(4),R16,178,4,4,90,137,57,90,24,47,6,11,18,81,137,3,3,90,132,64,90,15,42,7,11,18,79,132
2007-04-15 00:00:00.000,ATP Masters Series Monte Carlo Monaco ATP World Tour,CLAY,2,Rafael Nadal,Kristof Vliegen,Rafael Nadal,6-1; 6-1,R16,62,0,0,30,44,18,30,9,14,2,4,7,27,44,0,4,17,34,4,17,2,17,2,9,7,6,34
2007-04-15 00:00:00.000,ATP Masters Series Monte Carlo Monaco ATP World Tour,CLAY,2,Roger Federer,David Ferrer,Roger Federer,6-4; 6-0,Q,59,6,0,24,43,17,24,9,19,0,2,8,26,43,0,1,23,50,7,23,13,27,4,10,8,20,50
2007-04-15 00:00:00.000,ATP Masters Series Monte Carlo Monaco ATP World Tour,CLAY,2,Juan Carlos Ferrero,Richard Gasquet,Juan Carlos Ferrero,5-7; 7-5; 6-2,Q,146,5,4,63,96,45,63,18,33,4,7,16,63,96,5,6,52,109,38,52,25,57,2,7,16,63,109
2007-04-15 00:00:00.000,ATP Masters Series Monte Carlo Monaco ATP World Tour,CLAY,2,Tomas Berdych,Robin Soderling,Tomas Berdych,5-7; 6-3; 6-0,Q,123,5,2,41,82,27,41,23,41,8,11,13,50,82,3,8,51,109,31,51,25,58,10,17,14,56,109
2007-04-15 00:00:00.000,ATP Masters Series Monte Carlo Monaco ATP World Tour,CLAY,2,Rafael Nadal,Philipp Kohlschreiber,Rafael Nadal,6-2; 6-3,Q,77,4,0,30,50,23,30,15,20,2,2,9,38,50,1,2,22,48,10,22,16,26,5,8,8,26,48
2007-04-15 00:00:00.000,ATP Masters Series Monte Carlo Monaco ATP World Tour,CLAY,2,Roger Federer,Juan Carlos Ferrero,Roger Federer,6-3; 6-4,S,85,3,1,38,65,28,38,15,27,3,4,10,43,65,0,1,34,49,18,34,11,15,1,4,9,29,49
2007-04-15 00:00:00.000,ATP Masters Series Monte Carlo Monaco ATP World Tour,CLAY,2,Rafael Nadal,Tomas Berdych,Rafael Nadal,6-0; 7-5,S,83,2,1,24,50,17,24,20,26,0,0,9,37,50,1,3,30,52,16,30,10,22,0,4,9,26,52
2007-04-15 00:00:00.000,ATP Masters Series Monte Carlo Monaco ATP World Tour,CLAY,2,Rafael Nadal,Roger Federer,Rafael Nadal,6-4; 6-4,F,95,1,1,52,66,38,52,8,14,3,3,10,46,66,3,4,36,66,26,36,13,30,6,8,10,39,66
2007-04-23 00:00:00.000,Barcelona Spain ATP World Tour,CLAY,2,Rafael Nadal,N/A Bye,Rafael Nadal,,R64,0,0,0,0,0,0,0,0,0,0,0,0,0,0,0,0,0,0,0,0,0,0,0,0,0,0,0
2007-04-23 00:00:00.000,Barcelona Spain ATP World Tour,CLAY,2,Kristof Vliegen,Davide Sanguinetti,Kristof Vliegen,6-2; 6-4,R64,76,4,1,43,69,30,43,13,26,7,8,9,43,69,2,2,30,52,19,30,10,22,2,6,9,29,52
2007-04-23 00:00:00.000,Barcelona Spain ATP World Tour,CLAY,2,Thomas Johansson,Hyung-Taik Lee,Thomas Johansson,6-3; 6-3,R64,77,9,2,29,62,22,29,21,33,9,9,9,43,62,5,0,35,54,26,35,7,19,3,6,9,33,54
2007-04-23 00:00:00.000,Barcelona Spain ATP World Tour,CLAY,2,Robin Soderling,Gaston Gaudio,Robin Soderling,6-1; 6-0,R64,43,2,0,19,35,17,19,11,16,0,0,7,28,35,0,4,19,34,10,19,3,15,2,7,6,13,34
2007-04-23 00:00:00.000,Barcelona Spain ATP World Tour,CLAY,2,Simone Bolelli,Marat Safin,Simone Bolelli,6-4; 7-6(5),R64,89,6,1,46,68,38,46,12,22,0,1,11,50,68,6,2,38,71,27,38,19,33,3,5,11,46,71
2007-04-23 00:00:00.000,Barcelona Spain ATP World Tour,CLAY,2,Potito Starace,Sam Querrey,Potito Starace,6-4; 6-4,R64,89,1,2,54,70,38,54,11,16,4,4,10,49,70,3,1,46,67,32,46,10,21,1,3,10,42,67
2007-04-23 00:00:00.000,Barcelona Spain ATP World Tour,CLAY,2,Vincent Spadea,Teymuraz Gabashvili,Vincent Spadea,6-3; 3-6; 6-1,R64,98,1,3,54,81,40,54,13,27,5,7,13,53,81,3,3,49,80,32,49,13,31,6,10,12,45,80
2007-04-23 00:00:00.000,Barcelona Spain ATP World Tour,CLAY,2,Juan Ignacio Chela,N/A Bye,Juan Ignacio Chela,,R64,0,0,0,0,0,0,0,0,0,0,0,0,0,0,0,0,0,0,0,0,0,0,0,0,0,0,0
2007-04-23 00:00:00.000,Barcelona Spain ATP World Tour,CLAY,2,David Nalbandian,N/A Bye,David Nalbandian,,R64,0,0,0,0,0,0,0,0,0,0,0,0,0,0,0,0,0,0,0,0,0,0,0,0,0,0,0
2007-04-23 00:00:00.000,Barcelona Spain ATP World Tour,CLAY,2,Alberto Martin,Alejandro Falla,Alberto Martin,6-1; 6-4,R64,74,0,3,28,51,20,28,11,23,2,4,9,31,51,1,1,38,62,16,38,12,24,8,13,8,28,62
2007-04-23 00:00:00.000,Barcelona Spain ATP World Tour,CLAY,2,Felix Mantilla,Farrukh Dustov,Felix Mantilla,6-4; 1-6; 6-0,R64,108,1,0,51,73,31,51,12,22,2,6,12,43,73,5,5,43,74,28,43,12,31,4,9,11,40,74
2007-04-23 00:00:00.000,Barcelona Spain ATP World Tour,CLAY,2,Carlos Moya,Marcel Granollers,Carlos Moya,6-2; 6-4,R64,63,2,1,25,50,21,25,16,25,0,0,9,37,50,0,1,33,55,23,33,10,22,1,4,9,33,55
2007-04-23 00:00:00.000,Barcelona Spain ATP World Tour,CLAY,2,Andrei Pavel,Radek Stepanek,Andrei Pavel,4-6; 6-3; 6-4,R64,112,2,4,59,90,40,59,17,31,5,8,15,57,90,10,1,53,87,37,53,15,34,5,9,14,52,87
2007-04-23 00:00:00.000,Barcelona Spain ATP World Tour,CLAY,2,Boris Pashanski,Carlos Berlocq,Boris Pashanski,4-0 RET,R64,22,0,0,9,11,7,9,2,2,0,0,2,9,11,0,0,6,12,1,6,2,6,0,2,2,3,12
2007-04-23 00:00:00.000,Barcelona Spain ATP World Tour,CLAY,2,Paul Goldstein,Fernando Vicente,Paul Goldstein,6-3; 6-7(6); 6-3,R64,132,1,4,67,97,48,67,20,30,4,5,16,68,97,2,2,64,92,42,64,15,28,3,6,14,57,92
2007-04-23 00:00:00.000,Barcelona Spain ATP World Tour,CLAY,2,David Ferrer,N/A Bye,David Ferrer,,R64,0,0,0,0,0,0,0,0,0,0,0,0,0,0,0,0,0,0,0,0,0,0,0,0,0,0,0
2007-04-23 00:00:00.000,Barcelona Spain ATP World Tour,CLAY,2,Jarkko Nieminen,N/A Bye,Jarkko Nieminen,,R64,0,0,0,0,0,0,0,0,0,0,0,0,0,0,0,0,0,0,0,0,0,0,0,0,0,0,0
2007-04-23 00:00:00.000,Barcelona Spain ATP World Tour,CLAY,2,Andreas Seppi,Ivo Karlovic,Andreas Seppi,6-7(2); 7-5; 6-3,R64,166,3,4,65,96,52,65,16,31,0,1,17,68,96,16,3,83,121,60,83,13,38,4,7,16,73,121
2007-04-23 00:00:00.000,Barcelona Spain ATP World Tour,CLAY,2,Benjamin Becker,Igor Kunitsyn,Benjamin Becker,7-6(2); 6-4,R64,96,4,1,46,73,30,46,20,27,4,5,11,50,73,2,0,52,68,37,52,7,16,4,6,11,44,68
2007-04-23 00:00:00.000,Barcelona Spain ATP World Tour,CLAY,2,Oscar Hernandez,Dmitry Tursunov,Oscar Hernandez,6-4; 6-4,R64,94,2,1,40,62,27,40,14,22,2,3,10,41,62,3,1,31,57,21,31,13,26,0,3,10,34,57
2007-04-23 00:00:00.000,Barcelona Spain ATP World Tour,CLAY,2,Agustin Calleri,Marc Lopez,Agustin Calleri,7-5; 5-7; 6-3,R64,147,10,7,56,109,42,56,25,53,3,7,17,67,109,0,2,51,100,36,51,23,49,6,11,16,59,100
2007-04-23 00:00:00.000,Barcelona Spain ATP World Tour,CLAY,2,Paolo Lorenzi,Stefano Galvani,Paolo Lorenzi,6-7(6); 6-2; 7-6(1),R64,170,1,4,91,120,57,91,15,29,4,8,16,72,120,1,6,59,107,37,59,23,48,4,10,16,60,107
2007-04-23 00:00:00.000,Barcelona Spain ATP World Tour,CLAY,2,Feliciano Lopez,Guillermo Garcia-Lopez,Feliciano Lopez,7-5; 6-3,R64,84,7,3,41,71,28,41,15,30,5,7,11,43,71,0,2,42,56,25,42,6,14,1,5,10,31,56
2007-04-23 00:00:00.000,Barcelona Spain ATP World Tour,CLAY,2,Tommy Robredo,N/A Bye,Tommy Robredo,,R64,0,0,0,0,0,0,0,0,0,0,0,0,0,0,0,0,0,0,0,0,0,0,0,0,0,0,0
2007-04-23 00:00:00.000,Barcelona Spain ATP World Tour,CLAY,2,Juan Carlos Ferrero,N/A Bye,Juan Carlos Ferrero,,R64,0,0,0,0,0,0,0,0,0,0,0,0,0,0,0,0,0,0,0,0,0,0,0,0,0,0,0
2007-04-23 00:00:00.000,Barcelona Spain ATP World Tour,CLAY,2,Pablo Andujar,Bartolome Salva-Vidal,Pablo Andujar,6-4; 6-0,R64,80,0,3,37,54,25,37,7,17,4,6,8,32,54,1,6,26,59,12,26,12,33,14,20,8,24,59
2007-04-23 00:00:00.000,Barcelona Spain ATP World Tour,CLAY,2,Jiri Vanek,Juan Antonio Marin,Jiri Vanek,6-0; 3-2 RET,R64,72,0,1,24,36,16,24,6,12,3,4,5,22,36,2,3,20,46,11,20,7,26,2,7,6,18,46
2007-04-23 00:00:00.000,Barcelona Spain ATP World Tour,CLAY,2,Guillermo Canas,Max Mirnyi,Guillermo Canas,6-2; 7-6(4),R64,84,3,2,39,63,31,39,14,24,4,6,10,45,63,4,4,36,66,25,36,13,30,7,11,10,38,66
2007-04-23 00:00:00.000,Barcelona Spain ATP World Tour,CLAY,2,Nicolas Almagro,Fabio Fognini,Nicolas Almagro,6-3; 6-2,R64,58,6,0,25,47,20,25,16,22,1,2,9,36,47,2,4,26,51,15,26,11,25,1,5,8,26,51
2007-04-23 00:00:00.000,Barcelona Spain ATP World Tour,CLAY,2,Filippo Volandri,Evgeny Korolev,Filippo Volandri,6-0; 6-4,R64,60,2,1,33,43,25,33,8,10,0,0,8,33,43,1,0,28,48,17,28,6,20,1,5,8,23,48
2007-04-23 00:00:00.000,Barcelona Spain ATP World Tour,CLAY,2,Yuri Schukin,Werner Eschauer,Yuri Schukin,6-4; 6-4,R64,89,1,1,37,51,25,37,8,14,1,3,10,33,51,5,0,33,66,25,33,14,33,4,8,10,39,66
2007-04-23 00:00:00.000,Barcelona Spain ATP World Tour,CLAY,2,Nikolay Davydenko,N/A Bye,Nikolay Davydenko,,R64,0,0,0,0,0,0,0,0,0,0,0,0,0,0,0,0,0,0,0,0,0,0,0,0,0,0,0
2007-04-23 00:00:00.000,Barcelona Spain ATP World Tour,CLAY,2,Rafael Nadal,Kristof Vliegen,Rafael Nadal,6-1; 6-2,R32,71,0,0,19,32,17,19,11,13,0,0,7,28,32,0,0,31,47,19,31,3,16,3,8,8,22,47
2007-04-23 00:00:00.000,Barcelona Spain ATP World Tour,CLAY,2,Thomas Johansson,Robin Soderling,Thomas Johansson,7-6(4); 7-6(2),R32,100,9,2,49,82,38,49,20,33,5,6,12,58,82,4,3,44,81,30,44,26,37,5,6,12,56,81
2007-04-23 00:00:00.000,Barcelona Spain ATP World Tour,CLAY,2,Potito Starace,Simone Bolelli,Potito Starace,6-4; 6-3,R32,68,2,0,38,47,32,38,4,9,0,1,9,36,47,1,1,42,60,27,42,5,18,2,6,10,32,60
2007-04-23 00:00:00.000,Barcelona Spain ATP World Tour,CLAY,2,Juan Ignacio Chela,Vincent Spadea,Juan Ignacio Chela,6-3; 6-3,R32,86,3,2,45,64,33,45,3,19,4,7,9,36,64,0,4,36,68,17,36,14,32,4,10,9,31,68
2007-04-23 00:00:00.000,Barcelona Spain ATP World Tour,CLAY,2,David Nalbandian,Alberto Martin,David Nalbandian,6-2; 6-0,R32,65,3,0,28,42,21,28,10,14,1,1,7,31,42,2,1,33,49,17,33,4,16,1,6,7,21,49
2007-04-23 00:00:00.000,Barcelona Spain ATP World Tour,CLAY,2,Carlos Moya,Felix Mantilla,Carlos Moya,3-6; 6-3; 6-4,R32,125,9,2,44,82,30,44,19,38,6,10,14,49,82,1,0,83,107,47,83,11,24,17,22,14,58,107
2007-04-23 00:00:00.000,Barcelona Spain ATP World Tour,CLAY,2,Boris Pashanski,Andrei Pavel,Boris Pashanski,6-3; 4-6; 6-2,R32,105,2,1,56,84,40,56,15,28,4,6,14,55,84,4,1,61,81,39,61,7,20,2,6,13,46,81
2007-04-23 00:00:00.000,Barcelona Spain ATP World Tour,CLAY,2,David Ferrer,Paul Goldstein,David Ferrer,6-0; 6-0,R32,44,4,1,29,41,22,29,5,12,1,1,6,27,41,1,0,23,31,7,23,0,8,5,11,6,7,31
2007-04-23 00:00:00.000,Barcelona Spain ATP World Tour,CLAY,2,Jarkko Nieminen,Andreas Seppi,Jarkko Nieminen,6-4; 7-5,R32,96,1,2,31,62,21,31,17,31,2,5,11,38,62,1,4,46,76,26,46,14,30,4,9,11,40,76
2007-04-23 00:00:00.000,Barcelona Spain ATP World Tour,CLAY,2,Oscar Hernandez,Benjamin Becker,Oscar Hernandez,6-1; 7-6(4),R32,79,6,3,41,57,30,41,9,16,2,4,10,39,57,2,3,25,60,16,25,16,35,4,8,9,32,60
2007-04-23 00:00:00.000,Barcelona Spain ATP World Tour,CLAY,2,Agustin Calleri,Paolo Lorenzi,Agustin Calleri,6-2; 6-2,R32,58,3,0,25,36,22,25,10,11,0,0,8,32,36,0,2,29,51,18,29,8,22,3,7,8,26,51
2007-04-23 00:00:00.000,Barcelona Spain ATP World Tour,CLAY,2,Tommy Robredo,Feliciano Lopez,Tommy Robredo,6-2; 6-2,R32,69,2,2,52,60,33,52,5,8,3,4,8,38,60,3,4,24,47,14,24,7,23,5,10,8,21,47
2007-04-23 00:00:00.000,Barcelona Spain ATP World Tour,CLAY,2,Pablo Andujar,Juan Carlos Ferrero,Pablo Andujar,2-1 RET,R32,14,1,0,7,12,5,7,3,5,0,0,2,8,12,0,0,6,10,5,6,1,4,2,2,1,6,10
2007-04-23 00:00:00.000,Barcelona Spain ATP World Tour,CLAY,2,Guillermo Canas,Jiri Vanek,Guillermo Canas,6-1; 6-1,R32,53,4,1,21,39,17,21,13,18,1,1,7,30,39,3,1,36,49,17,36,5,13,1,6,7,22,49
2007-04-23 00:00:00.000,Barcelona Spain ATP World Tour,CLAY,2,Filippo Volandri,Nicolas Almagro,Filippo Volandri,6-7(5); 6-4; 6-1,R32,126,2,0,81,96,56,81,8,15,4,7,15,64,96,13,3,50,102,36,50,22,52,7,13,14,58,102
2007-04-23 00:00:00.000,Barcelona Spain ATP World Tour,CLAY,2,Nikolay Davydenko,Yuri Schukin,Nikolay Davydenko,6-4; 3-6; 6-2,R32,104,7,2,39,62,32,39,15,23,0,2,13,47,62,5,3,44,71,28,44,15,27,1,5,14,43,71
2007-04-23 00:00:00.000,Barcelona Spain ATP World Tour,CLAY,2,Rafael Nadal,Thomas Johansson,Rafael Nadal,6-1; 6-4,R16,70,1,1,27,37,26,27,6,10,0,0,8,32,37,6,4,36,66,24,36,10,30,6,10,9,34,66
2007-04-23 00:00:00.000,Barcelona Spain ATP World Tour,CLAY,2,Potito Starace,Juan Ignacio Chela,Potito Starace,6-4; 7-6(10),R16,120,0,0,82,96,49,82,8,14,7,9,11,57,96,2,5,45,80,29,45,18,35,6,9,11,47,80
2007-04-23 00:00:00.000,Barcelona Spain ATP World Tour,CLAY,2,David Nalbandian,Carlos Moya,David Nalbandian,6-4; 6-3,R16,90,2,3,35,61,21,35,15,26,3,5,9,36,61,5,3,43,76,22,43,19,33,12,17,10,41,76
2007-04-23 00:00:00.000,Barcelona Spain ATP World Tour,CLAY,2,David Ferrer,Boris Pashanski,David Ferrer,6-2; 7-5,R16,100,5,0,36,52,24,36,9,16,0,3,10,33,52,2,1,38,70,18,38,13,32,6,12,10,31,70
2007-04-23 00:00:00.000,Barcelona Spain ATP World Tour,CLAY,2,Oscar Hernandez,Jarkko Nieminen,Oscar Hernandez,6-1; 6-7(6); 6-3,R16,161,3,3,80,121,54,80,20,41,17,19,15,74,121,2,0,70,104,42,70,12,34,7,12,13,54,104
2007-04-23 00:00:00.000,Barcelona Spain ATP World Tour,CLAY,2,Agustin Calleri,Tommy Robredo,Agustin Calleri,6-4; 2-6; 6-3,R16,111,2,3,43,77,31,43,15,34,0,5,14,46,77,0,1,60,81,30,60,13,21,5,10,13,43,81
2007-04-23 00:00:00.000,Barcelona Spain ATP World Tour,CLAY,2,Guillermo Canas,Pablo Andujar,Guillermo Canas,7-5; 6-3,R16,108,1,3,32,62,21,32,19,30,3,5,11,40,62,2,6,47,73,30,47,9,26,7,11,10,39,73
2007-04-23 00:00:00.000,Barcelona Spain ATP World Tour,CLAY,2,Nikolay Davydenko,Filippo Volandri,Nikolay Davydenko,7-6(5); 7-6(6),R16,128,5,3,51,80,33,51,14,29,5,10,12,47,80,0,0,72,89,39,72,10,17,4,9,12,49,89
2007-04-23 00:00:00.000,Barcelona Spain ATP World Tour,CLAY,2,Rafael Nadal,Potito Starace,Rafael Nadal,6-2; 7-5,Q,102,2,0,47,64,30,47,12,17,3,4,10,42,64,1,1,50,61,28,50,5,11,0,4,10,33,61
2007-04-23 00:00:00.000,Barcelona Spain ATP World Tour,CLAY,2,David Ferrer,David Nalbandian,David Ferrer,7-6(5); 6-2,Q,86,4,2,38,60,31,38,13,22,0,0,10,44,60,2,5,36,66,23,36,17,30,0,2,10,40,66
2007-04-23 00:00:00.000,Barcelona Spain ATP World Tour,CLAY,2,Agustin Calleri,Oscar Hernandez,Agustin Calleri,6-0; 6-3,Q,59,5,1,19,36,18,19,12,17,0,0,7,30,36,0,1,29,47,15,29,5,18,5,10,8,20,47
2007-04-23 00:00:00.000,Barcelona Spain ATP World Tour,CLAY,2,Guillermo Canas,Nikolay Davydenko,Guillermo Canas,W/O,Q,0,0,0,0,0,0,0,0,0,0,0,0,0,0,0,0,0,0,0,0,0,0,0,0,0,0,0
2007-04-23 00:00:00.000,Barcelona Spain ATP World Tour,CLAY,2,Rafael Nadal,David Ferrer,Rafael Nadal,7-5; 6-1,S,95,0,1,41,53,26,41,7,12,1,3,9,33,53,0,0,40,65,25,40,7,25,5,11,10,32,65
2007-04-23 00:00:00.000,Barcelona Spain ATP World Tour,CLAY,2,Guillermo Canas,Agustin Calleri,Guillermo Canas,7-6(1); 6-7(5); 6-2,S,177,7,3,64,115,45,64,24,51,7,11,16,69,115,7,3,56,107,38,56,21,51,4,10,16,59,107
2007-04-23 00:00:00.000,Barcelona Spain ATP World Tour,CLAY,2,Rafael Nadal,Guillermo Canas,Rafael Nadal,6-3; 6-4,F,101,2,0,40,53,33,40,8,13,2,2,10,41,53,5,1,36,63,25,36,15,27,2,4,9,40,63
2007-04-23 00:00:00.000,Casablanca Morocco ATP World Tour,CLAY,2,Dominik Hrbaty,Alexander Peya,Dominik Hrbaty,7-6(7); 6-4,R32,90,5,0,41,64,32,41,15,23,2,3,11,47,64,2,6,60,98,41,60,16,38,15,17,11,57,98
2007-04-23 00:00:00.000,Casablanca Morocco ATP World Tour,CLAY,2,Slimane Saoudi,Rabie Chaki,Slimane Saoudi,6-2; 6-1,R32,59,1,2,29,43,24,29,9,14,1,1,8,33,43,1,2,24,48,12,24,12,24,2,6,7,24,48
2007-04-23 00:00:00.000,Casablanca Morocco ATP World Tour,CLAY,2,Albert Montanes,Danai Udomchoke,Albert Montanes,1-6; 6-3; 7-5,R32,101,3,3,48,85,34,48,20,37,3,6,14,54,85,4,0,50,75,38,50,13,25,1,4,14,51,75
2007-04-23 00:00:00.000,Casablanca Morocco ATP World Tour,CLAY,2,Nicolas Massu,Sergio Roitman,Nicolas Massu,6-2; 6-3,R32,74,2,3,26,46,19,26,11,20,1,2,8,30,46,0,1,44,53,25,44,1,9,3,8,9,26,53
2007-04-23 00:00:00.000,Casablanca Morocco ATP World Tour,CLAY,2,Ruben Ramirez Hidalgo,Gilles Simon,Ruben Ramirez Hidalgo,6-4; 6-4,R32,78,2,6,36,62,28,36,14,26,1,2,10,42,62,2,0,57,74,32,57,10,17,6,9,10,42,74
2007-04-23 00:00:00.000,Casablanca Morocco ATP World Tour,CLAY,2,Thierry Ascione,Younes El Aynaoui,Thierry Ascione,6-4; 6-3,R32,77,4,3,39,59,29,39,10,20,5,7,10,39,59,4,1,32,55,20,32,10,23,4,8,9,30,55
2007-04-23 00:00:00.000,Casablanca Morocco ATP World Tour,CLAY,2,Sebastien Grosjean,Victor Hanescu,Sebastien Grosjean,7-6(4); 6-4,R32,97,4,1,38,73,30,38,21,35,7,8,11,51,73,2,1,62,75,42,62,7,13,7,9,11,49,75
2007-04-23 00:00:00.000,Casablanca Morocco ATP World Tour,CLAY,2,Arnaud Clement,Ernests Gulbis,Arnaud Clement,7-6(1); 6-3,R32,88,2,2,34,64,26,34,21,30,3,3,10,47,64,11,2,48,70,33,48,12,22,5,7,11,45,70
2007-04-23 00:00:00.000,Casablanca Morocco ATP World Tour,CLAY,2,Marc Gicquel,Alessio Di Mauro,Marc Gicquel,6-4; 6-2,R32,66,6,0,29,47,20,29,14,18,0,1,9,34,47,3,3,32,49,24,32,5,17,3,7,9,29,49
2007-04-23 00:00:00.000,Casablanca Morocco ATP World Tour,CLAY,2,Nicolas Mahut,Florent Serra,Nicolas Mahut,6-2; 6-4,R32,78,2,1,32,59,24,32,16,27,3,4,9,40,59,3,2,42,66,25,42,9,24,6,10,9,34,66
2007-04-23 00:00:00.000,Casablanca Morocco ATP World Tour,CLAY,2,Michael Russell,Diego Hartfield,Michael Russell,6-1; 6-4,R32,78,2,3,32,48,28,32,6,16,0,1,9,34,48,0,0,45,57,22,45,6,12,3,7,8,28,57
2007-04-23 00:00:00.000,Casablanca Morocco ATP World Tour,CLAY,2,Julien Benneteau,Frederico Gil,Julien Benneteau,7-6(2); 3-6; 7-6(5),R32,170,6,5,81,121,55,81,21,40,16,20,16,76,121,6,5,70,114,48,70,25,44,5,8,17,73,114
2007-04-23 00:00:00.000,Casablanca Morocco ATP World Tour,CLAY,2,Paul-Henri Mathieu,Kristian Pless,Paul-Henri Mathieu,6-3; 6-1,R32,132,4,0,28,45,24,28,11,17,3,3,8,35,45,3,5,26,46,16,26,7,20,5,9,8,23,46
2007-04-23 00:00:00.000,Casablanca Morocco ATP World Tour,CLAY,2,Edouard Roger-Vasselin,Martin Vassallo Arguello,Edouard Roger-Vasselin,6-2; 6-2,R32,102,2,3,41,59,28,41,8,18,4,5,8,36,59,4,1,62,89,32,62,12,27,17,22,8,44,89
2007-04-23 00:00:00.000,Casablanca Morocco ATP World Tour,CLAY,2,Janko Tipsarevic,Michael Llodra,Janko Tipsarevic,6-2; 7-6(6),R32,95,7,0,30,63,24,30,20,33,0,1,10,44,63,3,8,39,77,27,39,16,38,6,9,10,43,77
2007-04-23 00:00:00.000,Casablanca Morocco ATP World Tour,CLAY,2,Jose Acasuso,Nicolas Devilder,Jose Acasuso,6-4; 6-4,R32,76,2,0,33,57,26,33,13,24,0,1,10,39,57,7,0,45,65,31,45,8,20,2,5,10,39,65
2007-04-23 00:00:00.000,Casablanca Morocco ATP World Tour,CLAY,2,Dominik Hrbaty,Slimane Saoudi,Dominik Hrbaty,7-5; 7-6(2),R16,99,3,4,44,77,29,44,16,33,3,7,12,45,77,4,5,49,79,29,49,13,30,6,11,12,42,79
2007-04-23 00:00:00.000,Casablanca Morocco ATP World Tour,CLAY,2,Albert Montanes,Nicolas Massu,Albert Montanes,6-1; 2-1 RET,R16,56,2,1,17,30,14,17,6,13,2,3,5,20,30,3,0,29,41,17,29,1,12,9,13,5,18,41
2007-04-23 00:00:00.000,Casablanca Morocco ATP World Tour,CLAY,2,Ruben Ramirez Hidalgo,Thierry Ascione,Ruben Ramirez Hidalgo,6-4; 7-6(4),R16,90,5,1,30,63,25,30,21,33,4,5,11,46,63,0,0,56,66,35,56,7,10,0,2,11,42,66
2007-04-23 00:00:00.000,Casablanca Morocco ATP World Tour,CLAY,2,Sebastien Grosjean,Arnaud Clement,Sebastien Grosjean,4-6; 7-5; 6-1,R16,147,8,1,39,91,30,39,31,52,4,6,15,61,91,5,6,37,87,28,37,23,50,5,9,14,51,87
2007-04-23 00:00:00.000,Casablanca Morocco ATP World Tour,CLAY,2,Marc Gicquel,Nicolas Mahut,Marc Gicquel,6-2; 6-4,R16,76,10,0,33,62,24,33,18,29,2,2,9,42,62,1,5,27,51,16,27,13,24,1,4,9,29,51
2007-04-23 00:00:00.000,Casablanca Morocco ATP World Tour,CLAY,2,Julien Benneteau,Michael Russell,Julien Benneteau,6-3; 6-3,R16,84,8,1,37,49,27,37,9,12,2,3,9,36,49,1,2,42,66,23,42,12,24,2,6,9,35,66
2007-04-23 00:00:00.000,Casablanca Morocco ATP World Tour,CLAY,2,Paul-Henri Mathieu,Edouard Roger-Vasselin,Paul-Henri Mathieu,4-6; 6-3; 6-4,R16,138,3,1,55,94,38,55,29,39,3,4,15,67,94,3,2,67,97,45,67,16,30,4,6,14,61,97
2007-04-23 00:00:00.000,Casablanca Morocco ATP World Tour,CLAY,2,Jose Acasuso,Janko Tipsarevic,Jose Acasuso,6-4; 6-4,R16,74,6,1,29,56,20,29,15,27,0,2,10,35,56,6,2,33,63,24,33,12,30,6,10,10,36,63
2007-04-23 00:00:00.000,Casablanca Morocco ATP World Tour,CLAY,2,Albert Montanes,Dominik Hrbaty,Albert Montanes,7-6(5); 6-3,Q,88,8,2,42,71,35,42,14,29,2,3,11,49,71,7,3,39,76,31,39,17,37,5,7,10,48,76
2007-04-23 00:00:00.000,Casablanca Morocco ATP World Tour,CLAY,2,Ruben Ramirez Hidalgo,Sebastien Grosjean,Ruben Ramirez Hidalgo,1-6; 7-5; 7-6(3),Q,155,3,4,63,109,42,63,20,46,8,13,15,62,109,5,1,54,92,41,54,18,38,1,5,16,59,92
2007-04-23 00:00:00.000,Casablanca Morocco ATP World Tour,CLAY,2,Marc Gicquel,Julien Benneteau,Marc Gicquel,3-6; 6-1; 6-1,Q,95,6,0,42,62,29,42,13,20,2,4,11,42,62,3,1,54,77,32,54,8,23,5,11,12,40,77
2007-04-23 00:00:00.000,Casablanca Morocco ATP World Tour,CLAY,2,Paul-Henri Mathieu,Jose Acasuso,Paul-Henri Mathieu,7-6(5); 6-4,Q,106,3,0,37,65,27,37,17,28,3,6,11,44,65,5,2,40,73,29,40,14,33,4,8,11,43,73
2007-04-23 00:00:00.000,Casablanca Morocco ATP World Tour,CLAY,2,Albert Montanes,Ruben Ramirez Hidalgo,Albert Montanes,1-6; 7-5; 6-3,S,132,1,4,59,93,40,59,14,34,3,7,14,54,93,3,5,60,96,39,60,15,36,5,9,14,54,96
2007-04-23 00:00:00.000,Casablanca Morocco ATP World Tour,CLAY,2,Paul-Henri Mathieu,Marc Gicquel,Paul-Henri Mathieu,6-3; 7-5,S,95,7,0,36,61,28,36,17,25,1,2,11,45,61,10,2,49,71,33,49,5,22,4,7,10,38,71
2007-04-23 00:00:00.000,Casablanca Morocco ATP World Tour,CLAY,2,Paul-Henri Mathieu,Albert Montanes,Paul-Henri Mathieu,6-1; 6-1,F,63,5,0,18,36,17,18,12,18,1,1,7,29,36,2,5,32,51,19,32,4,19,8,13,7,23,51
2007-04-29 00:00:00.000,Estoril Portugal ATP World Tour,CLAY,2,Olivier Patience,Nikolay Davydenko,Olivier Patience,7-5; 6-1,R32,78,3,2,50,76,32,50,12,26,9,11,10,44,76,1,2,37,60,19,37,10,23,7,12,9,29,60
2007-04-29 00:00:00.000,Estoril Portugal ATP World Tour,CLAY,2,Vincent Spadea,Teymuraz Gabashvili,Vincent Spadea,6-1; 5-7; 6-4,R32,120,0,3,60,96,32,60,24,36,9,13,15,56,96,3,9,46,93,27,46,20,47,7,13,14,47,93
2007-04-29 00:00:00.000,Estoril Portugal ATP World Tour,CLAY,2,Frederico Gil,Ruben Ramirez Hidalgo,Frederico Gil,6-1; 4-6; 6-3,R32,126,1,1,48,76,33,48,14,28,0,3,13,47,76,4,7,55,87,31,55,14,32,6,12,13,45,87
2007-04-29 00:00:00.000,Estoril Portugal ATP World Tour,CLAY,2,Richard Gasquet,Max Mirnyi,Richard Gasquet,6-3; 6-3,R32,76,2,3,34,51,29,34,8,17,1,2,9,37,51,4,7,38,70,26,38,12,32,8,12,9,38,70
2007-04-29 00:00:00.000,Estoril Portugal ATP World Tour,CLAY,2,Paul-Henri Mathieu,Fernando Gonzalez,Paul-Henri Mathieu,6-2; 6-4,R32,83,0,4,32,56,21,32,14,24,2,4,9,35,56,0,4,38,59,21,38,6,21,1,6,9,27,59
2007-04-29 00:00:00.000,Estoril Portugal ATP World Tour,CLAY,2,Igor Kunitsyn,Pedro Sousa,Igor Kunitsyn,6-1; 6-1,R32,50,1,2,26,37,22,26,7,11,0,0,7,29,37,2,3,22,50,11,22,10,28,9,14,7,21,50
2007-04-29 00:00:00.000,Estoril Portugal ATP World Tour,CLAY,2,Sam Querrey,Luis Horna,Sam Querrey,7-6(5); 6-4,R32,95,10,7,31,66,25,31,17,35,2,5,11,42,66,2,3,49,71,27,49,12,22,2,6,11,39,71
2007-04-29 00:00:00.000,Estoril Portugal ATP World Tour,CLAY,2,Juan Monaco,Gael Monfils,Juan Monaco,7-5; 1-6; 6-2,R32,107,0,2,49,80,28,49,19,31,4,9,13,47,80,5,6,44,82,30,44,14,38,5,11,14,44,82
2007-04-29 00:00:00.000,Estoril Portugal ATP World Tour,CLAY,2,Dmitry Tursunov,Florent Serra,Dmitry Tursunov,4-6; 6-3; 6-1,R32,84,8,2,39,76,30,39,22,37,1,2,13,52,76,2,2,47,73,34,47,12,26,4,8,13,46,73
2007-04-29 00:00:00.000,Estoril Portugal ATP World Tour,CLAY,2,Guillermo Garcia-Lopez,Michael Russell,Guillermo Garcia-Lopez,6-1; 6-2,R32,67,0,1,23,40,19,23,8,17,0,1,7,27,40,0,5,34,53,15,34,5,19,5,11,8,20,53
2007-04-29 00:00:00.000,Estoril Portugal ATP World Tour,CLAY,2,Santiago Ventura,Sergio Roitman,Santiago Ventura,7-5; 6-2,R32,73,2,1,27,49,23,27,14,22,0,1,10,37,49,2,0,39,63,18,39,15,24,6,10,10,33,63
2007-04-29 00:00:00.000,Estoril Portugal ATP World Tour,CLAY,2,Novak Djokovic,Igor Andreev,Novak Djokovic,6-2; 4-6; 7-6(5),R32,163,2,3,65,99,45,65,22,34,2,4,15,67,99,3,3,62,102,39,62,25,40,5,8,15,64,102
2007-04-29 00:00:00.000,Estoril Portugal ATP World Tour,CLAY,2,Agustin Calleri,Danai Udomchoke,Agustin Calleri,6-4; 4-6; 6-1,R32,105,5,1,31,86,23,31,33,55,4,6,14,56,86,1,1,41,74,27,41,18,33,5,9,13,45,74
2007-04-29 00:00:00.000,Estoril Portugal ATP World Tour,CLAY,2,Juan Martin Del Potro,Alejandro Falla,Juan Martin Del Potro,1-6; 6-2; 6-4,R32,107,4,1,55,77,34,55,13,22,6,9,12,47,77,1,1,39,70,25,39,18,31,3,7,13,43,70
2007-04-29 00:00:00.000,Estoril Portugal ATP World Tour,CLAY,2,Alberto Martin,Evgeny Korolev,Alberto Martin,6-1; 2-0 RET,R32,40,2,2,20,39,13,20,11,19,3,4,5,24,39,0,2,6,17,0,6,1,11,0,4,4,1,17
2007-04-29 00:00:00.000,Estoril Portugal ATP World Tour,CLAY,2,Tommy Robredo,Albert Montanes,Tommy Robredo,6-4; 6-3,R32,78,4,2,40,54,31,40,7,14,5,6,9,38,54,0,1,33,58,20,33,13,25,2,6,10,33,58
2007-04-29 00:00:00.000,Estoril Portugal ATP World Tour,CLAY,2,Vincent Spadea,Olivier Patience,Vincent Spadea,2-6; 6-3; 6-4,R16,117,1,0,51,87,33,51,20,36,7,11,14,53,87,3,4,60,96,40,60,16,36,11,15,13,56,96
2007-04-29 00:00:00.000,Estoril Portugal ATP World Tour,CLAY,2,Richard Gasquet,Frederico Gil,Richard Gasquet,6-1; 6-2,R16,65,2,0,28,43,22,28,11,15,0,0,8,33,43,0,1,28,45,14,28,8,17,4,8,7,22,45
2007-04-29 00:00:00.000,Estoril Portugal ATP World Tour,CLAY,2,Paul-Henri Mathieu,Igor Kunitsyn,Paul-Henri Mathieu,6-2; 6-1,R16,70,1,1,25,46,19,25,13,21,0,1,8,32,46,0,0,28,46,12,28,7,18,2,7,7,19,46
2007-04-29 00:00:00.000,Estoril Portugal ATP World Tour,CLAY,2,Juan Monaco,Sam Querrey,Juan Monaco,3-6; 6-1; 6-4,R16,91,3,4,46,74,36,46,15,28,5,7,13,51,74,7,4,44,82,34,44,14,38,2,6,13,48,82
2007-04-29 00:00:00.000,Estoril Portugal ATP World Tour,CLAY,2,Guillermo Garcia-Lopez,Dmitry Tursunov,Guillermo Garcia-Lopez,6-4; 6-3,R16,68,3,1,36,57,24,36,16,21,4,4,9,40,57,7,1,28,59,14,28,22,31,4,7,10,36,59
2007-04-29 00:00:00.000,Estoril Portugal ATP World Tour,CLAY,2,Novak Djokovic,Santiago Ventura,Novak Djokovic,6-2; 6-2,R16,56,3,2,32,44,25,32,5,12,0,1,8,30,44,0,2,19,46,13,19,8,27,1,6,8,21,46
2007-04-29 00:00:00.000,Estoril Portugal ATP World Tour,CLAY,2,Agustin Calleri,Juan Martin Del Potro,Agustin Calleri,7-5; 1-0 RET,R16,61,1,2,20,40,13,20,10,20,3,5,6,23,40,0,3,32,47,17,32,4,15,2,6,7,21,47
2007-04-29 00:00:00.000,Estoril Portugal ATP World Tour,CLAY,2,Tommy Robredo,Alberto Martin,Tommy Robredo,6-7(4); 7-5; 6-2,R16,147,3,2,77,108,53,77,16,31,6,9,16,69,108,1,4,68,105,40,68,19,37,7,13,16,59,105
2007-04-29 00:00:00.000,Estoril Portugal ATP World Tour,CLAY,2,Richard Gasquet,Vincent Spadea,Richard Gasquet,6-3; 6-4,Q,81,2,0,33,51,23,33,12,18,0,2,10,35,51,0,1,36,62,18,36,14,26,4,8,9,32,62
2007-04-29 00:00:00.000,Estoril Portugal ATP World Tour,CLAY,2,Paul-Henri Mathieu,Juan Monaco,Paul-Henri Mathieu,6-4; 4-6; 6-1,Q,132,1,3,43,81,27,43,17,38,2,8,14,44,81,1,4,65,101,39,65,9,36,8,16,13,48,101
2007-04-29 00:00:00.000,Estoril Portugal ATP World Tour,CLAY,2,Novak Djokovic,Guillermo Garcia-Lopez,Novak Djokovic,6-4; 1-6; 7-5,Q,163,5,4,61,109,35,61,24,48,6,12,15,59,109,4,2,59,104,34,59,21,45,10,15,14,55,104
2007-04-29 00:00:00.000,Estoril Portugal ATP World Tour,CLAY,2,Tommy Robredo,Agustin Calleri,Tommy Robredo,7-5; 6-7(5); 6-3,Q,150,1,1,101,122,62,101,11,21,10,14,17,73,122,3,6,71,121,45,71,20,50,10,16,16,65,121
2007-04-29 00:00:00.000,Estoril Portugal ATP World Tour,CLAY,2,Richard Gasquet,Paul-Henri Mathieu,Richard Gasquet,3-1 RET,S,17,0,0,10,14,5,10,2,4,1,2,2,7,14,0,1,7,12,2,7,1,5,0,2,2,3,12
2007-04-29 00:00:00.000,Estoril Portugal ATP World Tour,CLAY,2,Novak Djokovic,Tommy Robredo,Novak Djokovic,7-5; 6-1,S,79,1,4,32,58,24,32,15,26,1,2,10,39,58,0,0,47,60,27,47,6,13,6,10,9,33,60
2007-04-29 00:00:00.000,Estoril Portugal ATP World Tour,CLAY,2,Novak Djokovic,Richard Gasquet,Novak Djokovic,7-6(7); 0-6; 6-1,F,131,3,4,60,96,39,60,14,36,7,12,13,53,96,4,5,42,69,31,42,11,27,2,6,12,42,69
2007-04-30 00:00:00.000,Munich Germany ATP World Tour,CLAY,2,Sebastien Grosjean,Tommy Haas,Sebastien Grosjean,6-4; 6-4,R32,87,6,1,31,57,25,31,17,26,0,0,10,42,57,4,2,25,51,20,25,15,26,0,2,10,35,51
2007-04-30 00:00:00.000,Munich Germany ATP World Tour,CLAY,2,Martin Vassallo Arguello,Hyung-Taik Lee,Martin Vassallo Arguello,7-6(5); 6-4,R32,118,4,1,67,94,45,67,14,27,14,16,11,59,94,1,0,53,77,36,53,9,24,1,4,11,45,77
2007-04-30 00:00:00.000,Munich Germany ATP World Tour,CLAY,2,Philipp Kohlschreiber,Arnaud Clement,Philipp Kohlschreiber,6-2; 7-6(5),R32,102,5,0,37,54,28,37,14,17,2,3,10,42,54,5,3,47,79,34,47,10,32,3,6,10,44,79
2007-04-30 00:00:00.000,Munich Germany ATP World Tour,CLAY,2,Jarkko Nieminen,Rainer Schuettler,Jarkko Nieminen,6-4; 6-4,R32,96,5,1,45,63,31,45,8,18,4,6,10,39,63,3,3,42,67,25,42,12,25,9,13,10,37,67
2007-04-30 00:00:00.000,Munich Germany ATP World Tour,CLAY,2,Marcos Baghdatis,Diego Hartfield,Marcos Baghdatis,7-6(5); 6-3,R32,119,3,5,39,79,28,39,19,40,7,9,10,47,79,3,1,60,80,31,60,12,20,9,13,11,43,80
2007-04-30 00:00:00.000,Munich Germany ATP World Tour,CLAY,2,Matthias Bachinger,Andreas Beck,Matthias Bachinger,6-2; 6-7(5); 7-5,R32,121,17,1,63,106,47,63,22,43,4,7,16,69,106,2,6,68,102,43,68,18,34,5,11,16,61,102
2007-04-30 00:00:00.000,Munich Germany ATP World Tour,CLAY,2,Daniel Brands,Martin Verkerk,Daniel Brands,7-6(4); 6-3,R32,60,9,1,39,60,36,39,15,21,2,2,11,51,60,9,1,42,57,32,42,11,15,2,3,10,43,57
2007-04-30 00:00:00.000,Munich Germany ATP World Tour,CLAY,2,Alexander Waske,Radek Stepanek,Alexander Waske,7-6(3); 6-3,R32,85,11,0,38,67,31,38,19,29,2,3,11,50,67,4,1,35,55,25,35,12,20,0,2,10,37,55
2007-04-30 00:00:00.000,Munich Germany ATP World Tour,CLAY,2,Jurgen Melzer,Olivier Rochus,Jurgen Melzer,6-2; 6-4,R32,68,7,2,26,47,21,26,14,21,2,3,9,35,47,0,1,33,55,21,33,7,22,1,5,9,28,55
2007-04-30 00:00:00.000,Munich Germany ATP World Tour,CLAY,2,Raemon Sluiter,Jan Hajek,Raemon Sluiter,3-6; 6-2; 7-6(5),R32,114,18,1,53,86,42,53,16,33,0,3,14,58,86,2,1,60,88,42,60,14,28,5,9,15,56,88
2007-04-30 00:00:00.000,Munich Germany ATP World Tour,CLAY,2,Benjamin Becker,Nenad Zimonjic,Benjamin Becker,7-6(6); 6-3,R32,72,11,0,42,62,34,42,16,20,0,0,11,50,62,8,2,39,61,31,39,14,22,2,3,10,45,61
2007-04-30 00:00:00.000,Munich Germany ATP World Tour,CLAY,2,Mikhail Youzhny,Stefan Koubek,Mikhail Youzhny,6-4; 3-6; 6-1,R32,122,1,1,53,94,34,53,24,41,6,8,13,58,94,2,7,48,90,28,48,24,42,6,10,13,52,90
2007-04-30 00:00:00.000,Munich Germany ATP World Tour,CLAY,2,Nicolas Devilder,Guillermo Canas,Nicolas Devilder,4-6; 2-1 RET,R32,61,1,2,19,43,11,19,12,24,4,7,7,23,43,1,1,19,35,12,19,8,16,2,4,6,20,35
2007-04-30 00:00:00.000,Munich Germany ATP World Tour,CLAY,2,Tobias Summerer,Ernests Gulbis,Tobias Summerer,5-7; 6-4; 6-4,R32,143,4,2,64,103,41,64,24,39,5,8,16,65,103,14,10,79,121,53,79,18,42,11,15,16,71,121
2007-04-30 00:00:00.000,Munich Germany ATP World Tour,CLAY,2,Nicolas Massu,Thomas Johansson,Nicolas Massu,6-2; 6-1,R32,70,7,0,31,46,25,31,8,15,1,1,8,33,46,3,3,29,64,16,29,16,35,12,16,7,32,64
2007-04-30 00:00:00.000,Munich Germany ATP World Tour,CLAY,2,Tomas Berdych,Florian Mayer,Tomas Berdych,6-2; 6-1,R32,52,3,3,23,44,19,23,15,21,1,1,8,34,44,5,1,35,53,18,35,6,18,5,9,7,24,53
2007-04-30 00:00:00.000,Munich Germany ATP World Tour,CLAY,2,Sebastien Grosjean,Martin Vassallo Arguello,Sebastien Grosjean,2-6; 6-3; 6-4,R16,124,0,3,43,83,31,43,17,40,3,8,14,48,83,3,4,50,74,33,50,11,24,6,11,13,44,74
2007-04-30 00:00:00.000,Munich Germany ATP World Tour,CLAY,2,Philipp Kohlschreiber,Jarkko Nieminen,Philipp Kohlschreiber,6-1; 6-4,R16,79,3,1,44,71,30,44,15,27,5,6,9,45,71,1,0,30,50,18,30,9,20,3,7,8,27,50
2007-04-30 00:00:00.000,Munich Germany ATP World Tour,CLAY,2,Marcos Baghdatis,Matthias Bachinger,Marcos Baghdatis,6-7(7); 6-2; 6-4,R16,137,10,2,49,92,38,49,28,43,3,5,15,66,92,3,4,55,107,33,55,29,52,5,10,15,62,107
2007-04-30 00:00:00.000,Munich Germany ATP World Tour,CLAY,2,Alexander Waske,Daniel Brands,Alexander Waske,7-6(5); 7-6(5),R16,108,9,5,43,76,36,43,23,33,2,2,12,59,76,6,3,54,85,45,54,15,31,4,4,12,60,85
2007-04-30 00:00:00.000,Munich Germany ATP World Tour,CLAY,2,Jurgen Melzer,Raemon Sluiter,Jurgen Melzer,5-7; 6-1; 6-2,R16,93,6,1,40,67,33,40,19,27,0,2,14,52,67,3,4,46,84,30,46,17,38,4,9,13,47,84
2007-04-30 00:00:00.000,Munich Germany ATP World Tour,CLAY,2,Mikhail Youzhny,Benjamin Becker,Mikhail Youzhny,7-6(4); 7-6(3),R16,117,6,1,43,80,33,43,25,37,2,2,12,58,80,8,2,53,88,41,53,18,35,9,9,12,59,88
2007-04-30 00:00:00.000,Munich Germany ATP World Tour,CLAY,2,Nicolas Devilder,Tobias Summerer,Nicolas Devilder,6-3; 7-5,R16,106,1,0,54,68,30,54,11,14,1,4,11,41,68,0,3,38,57,25,38,5,19,3,8,10,30,57
2007-04-30 00:00:00.000,Munich Germany ATP World Tour,CLAY,2,Tomas Berdych,Nicolas Massu,Tomas Berdych,7-5; 6-1,R16,71,9,2,36,55,28,36,12,19,0,1,10,40,55,1,3,25,48,17,25,8,23,1,5,9,25,48
2007-04-30 00:00:00.000,Munich Germany ATP World Tour,CLAY,2,Philipp Kohlschreiber,Sebastien Grosjean,Philipp Kohlschreiber,6-4; 7-6(5),Q,90,3,0,43,60,30,43,11,17,1,4,11,41,60,3,1,37,71,27,37,14,34,3,7,11,41,71
2007-04-30 00:00:00.000,Munich Germany ATP World Tour,CLAY,2,Marcos Baghdatis,Alexander Waske,Marcos Baghdatis,2-6; 7-6(5); 6-4,Q,122,17,4,50,99,38,50,24,49,2,5,15,62,99,17,8,51,89,37,51,21,38,4,6,15,58,89
2007-04-30 00:00:00.000,Munich Germany ATP World Tour,CLAY,2,Mikhail Youzhny,Jurgen Melzer,Mikhail Youzhny,6-2; 7-6(5),Q,97,5,0,43,63,27,43,14,20,2,4,10,41,63,2,6,38,80,24,38,18,42,8,12,10,42,80
2007-04-30 00:00:00.000,Munich Germany ATP World Tour,CLAY,2,Tomas Berdych,Nicolas Devilder,Tomas Berdych,6-4; 6-0,Q,48,2,0,25,38,21,25,11,13,0,0,8,32,38,6,3,22,46,14,22,9,24,1,5,8,23,46
2007-04-30 00:00:00.000,Munich Germany ATP World Tour,CLAY,2,Philipp Kohlschreiber,Marcos Baghdatis,Philipp Kohlschreiber,6-2; 6-3,S,81,2,1,37,48,28,37,6,11,4,5,8,34,48,4,0,50,86,29,50,14,36,8,13,9,43,86
2007-04-30 00:00:00.000,Munich Germany ATP World Tour,CLAY,2,Mikhail Youzhny,Tomas Berdych,Mikhail Youzhny,6-4; 6-3,S,74,5,1,31,44,27,31,9,13,0,0,9,36,44,3,1,37,56,25,37,9,19,1,4,10,34,56
2007-04-30 00:00:00.000,Munich Germany ATP World Tour,CLAY,2,Philipp Kohlschreiber,Mikhail Youzhny,Philipp Kohlschreiber,2-6; 6-3; 6-4,F,121,4,1,63,95,38,63,20,32,5,8,14,58,95,5,0,47,77,36,47,13,30,5,8,13,49,77
2007-05-07 00:00:00.000,ATP Masters Series Rome Italy ATP World Tour,CLAY,2,Roger Federer,N/A Bye,Roger Federer,,R64,0,0,0,0,0,0,0,0,0,0,0,0,0,0,0,0,0,0,0,0,0,0,0,0,0,0,0
2007-05-07 00:00:00.000,ATP Masters Series Rome Italy ATP World Tour,CLAY,2,Nicolas Almagro,Tim Henman,Nicolas Almagro,7-5; 6-1,R64,78,13,1,30,60,26,30,16,30,3,4,10,42,60,4,3,36,59,23,36,10,23,6,10,9,33,59
2007-05-07 00:00:00.000,ATP Masters Series Rome Italy ATP World Tour,CLAY,2,Filippo Volandri,Teymuraz Gabashvili,Filippo Volandri,6-0; 6-3,R64,63,2,0,36,57,25,36,13,21,0,0,8,38,57,2,6,20,45,14,20,7,25,7,11,7,21,45
2007-05-07 00:00:00.000,ATP Masters Series Rome Italy ATP World Tour,CLAY,2,Richard Gasquet,Fernando Verdasco,Richard Gasquet,6-1; 7-5,R64,80,3,1,43,60,29,43,10,17,5,7,10,39,60,0,3,42,51,21,42,5,9,3,8,9,26,51
2007-05-07 00:00:00.000,ATP Masters Series Rome Italy ATP World Tour,CLAY,2,Tomas Berdych,Jarkko Nieminen,Tomas Berdych,6-4; 7-5,R64,86,2,2,52,63,37,52,4,11,3,5,11,41,63,0,3,53,66,34,53,4,13,5,9,11,38,66
2007-05-07 00:00:00.000,ATP Masters Series Rome Italy ATP World Tour,CLAY,2,Albert Montanes,Stanislas Wawrinka,Albert Montanes,3-6; 6-1; 7-6(3),R64,138,2,3,59,90,42,59,19,31,7,9,14,61,90,5,5,60,104,39,60,22,44,9,12,14,61,104
2007-05-07 00:00:00.000,ATP Masters Series Rome Italy ATP World Tour,CLAY,2,Jose Acasuso,Martin Verkerk,Jose Acasuso,6-3; 7-5,R64,78,7,0,59,61,42,59,1,2,4,5,10,43,61,3,4,51,65,31,51,6,14,2,6,11,37,65
2007-05-07 00:00:00.000,ATP Masters Series Rome Italy ATP World Tour,CLAY,2,Ivan Ljubicic,N/A Bye,Ivan Ljubicic,,R64,0,0,0,0,0,0,0,0,0,0,0,0,0,0,0,0,0,0,0,0,0,0,0,0,0,0,0
2007-05-07 00:00:00.000,ATP Masters Series Rome Italy ATP World Tour,CLAY,2,Andy Roddick,N/A Bye,Andy Roddick,,R64,0,0,0,0,0,0,0,0,0,0,0,0,0,0,0,0,0,0,0,0,0,0,0,0,0,0,0
2007-05-07 00:00:00.000,ATP Masters Series Rome Italy ATP World Tour,CLAY,2,Gaston Gaudio,Mardy Fish,Gaston Gaudio,6-4; 6-4,R64,112,0,1,36,57,26,36,16,21,3,4,10,42,57,5,3,39,91,28,39,23,52,11,14,10,51,91
2007-05-07 00:00:00.000,ATP Masters Series Rome Italy ATP World Tour,CLAY,2,Juan Ignacio Chela,Marc Gicquel,Juan Ignacio Chela,2-6; 6-4; 6-1,R64,120,3,1,64,83,42,64,11,19,3,5,13,53,83,4,1,69,85,41,69,10,16,7,10,12,51,85
2007-05-07 00:00:00.000,ATP Masters Series Rome Italy ATP World Tour,CLAY,2,Igor Andreev,David Ferrer,Igor Andreev,6-4; 6-1,R64,84,7,2,33,56,25,33,12,23,6,7,8,37,56,2,5,39,65,21,39,11,26,6,11,9,32,65
2007-05-07 00:00:00.000,ATP Masters Series Rome Italy ATP World Tour,CLAY,2,James Blake,Gael Monfils,James Blake,7-6(4); 6-3,R64,85,3,1,44,75,34,44,18,31,3,4,11,52,75,8,6,36,71,29,36,14,35,3,5,10,43,71
2007-05-07 00:00:00.000,ATP Masters Series Rome Italy ATP World Tour,CLAY,2,Nicolas Massu,Simone Bolelli,Nicolas Massu,6-3; 7-6(5),R64,107,2,1,36,61,26,36,18,25,0,1,10,44,61,1,0,42,64,30,42,11,22,1,4,11,41,64
2007-05-07 00:00:00.000,ATP Masters Series Rome Italy ATP World Tour,CLAY,2,Dmitry Tursunov,Jonas Bjorkman,Dmitry Tursunov,7-6(10); 3-6; 6-1,R64,153,5,11,58,113,40,58,24,55,7,11,14,64,113,2,4,63,106,38,63,20,43,6,11,14,58,106
2007-05-07 00:00:00.000,ATP Masters Series Rome Italy ATP World Tour,CLAY,2,Fernando Gonzalez,N/A Bye,Fernando Gonzalez,,R64,0,0,0,0,0,0,0,0,0,0,0,0,0,0,0,0,0,0,0,0,0,0,0,0,0,0,0
2007-05-07 00:00:00.000,ATP Masters Series Rome Italy ATP World Tour,CLAY,2,Tommy Robredo,N/A Bye,Tommy Robredo,,R64,0,0,0,0,0,0,0,0,0,0,0,0,0,0,0,0,0,0,0,0,0,0,0,0,0,0,0
2007-05-07 00:00:00.000,ATP Masters Series Rome Italy ATP World Tour,CLAY,2,Oscar Hernandez,Lleyton Hewitt,Oscar Hernandez,3-6; 7-6(3); 6-1,R64,164,1,2,54,86,37,54,14,32,4,7,13,51,86,7,7,67,110,44,67,16,43,15,20,15,60,110
2007-05-07 00:00:00.000,ATP Masters Series Rome Italy ATP World Tour,CLAY,2,Guillermo Canas,Jurgen Melzer,Guillermo Canas,7-5; 6-2,R64,101,2,1,41,73,28,41,19,32,6,7,10,47,73,2,3,36,66,23,36,12,30,3,7,10,35,66
2007-05-07 00:00:00.000,ATP Masters Series Rome Italy ATP World Tour,CLAY,2,Gilles Simon,Andy Murray,Gilles Simon,6-1; 1-6; 6-3,R64,125,0,0,46,69,32,46,8,23,2,7,12,40,69,3,6,33,71,20,33,15,38,5,11,11,35,71
2007-05-07 00:00:00.000,ATP Masters Series Rome Italy ATP World Tour,CLAY,2,Juan Carlos Ferrero,Dominik Hrbaty,Juan Carlos Ferrero,3-6; 6-1; 6-4,R64,123,4,2,64,89,35,64,8,25,6,12,13,43,89,2,6,47,85,26,47,14,38,4,12,13,40,85
2007-05-07 00:00:00.000,ATP Masters Series Rome Italy ATP World Tour,CLAY,2,Potito Starace,Agustin Calleri,Potito Starace,6-3; 6-1,R64,73,0,1,37,48,27,37,6,11,2,2,8,33,48,1,0,35,66,20,35,13,31,7,11,8,33,66
2007-05-07 00:00:00.000,ATP Masters Series Rome Italy ATP World Tour,CLAY,2,Marat Safin,Amer Delic,Marat Safin,2-6; 6-3; 6-4,R64,111,3,1,38,73,26,38,24,35,2,4,14,50,73,8,2,45,85,34,45,19,40,5,7,13,53,85
2007-05-07 00:00:00.000,ATP Masters Series Rome Italy ATP World Tour,CLAY,2,Nikolay Davydenko,N/A Bye,Nikolay Davydenko,,R64,0,0,0,0,0,0,0,0,0,0,0,0,0,0,0,0,0,0,0,0,0,0,0,0,0,0,0
2007-05-07 00:00:00.000,ATP Masters Series Rome Italy ATP World Tour,CLAY,2,Novak Djokovic,N/A Bye,Novak Djokovic,,R64,0,0,0,0,0,0,0,0,0,0,0,0,0,0,0,0,0,0,0,0,0,0,0,0,0,0,0
2007-05-07 00:00:00.000,ATP Masters Series Rome Italy ATP World Tour,CLAY,2,Robin Soderling,Benjamin Becker,Robin Soderling,6-3; 6-3,R64,69,5,2,32,59,25,32,15,27,4,5,9,40,59,2,2,28,56,19,28,10,28,4,8,9,29,56
2007-05-07 00:00:00.000,ATP Masters Series Rome Italy ATP World Tour,CLAY,2,Marcos Baghdatis,Carlos Moya,Marcos Baghdatis,6-2; 6-3,R64,69,3,0,52,58,34,52,5,6,8,8,8,39,58,2,0,39,51,20,39,7,12,1,5,9,27,51
2007-05-07 00:00:00.000,ATP Masters Series Rome Italy ATP World Tour,CLAY,2,Radek Stepanek,Tommy Haas,Radek Stepanek,6-3; 3-2 RET,R64,59,4,1,24,45,17,24,14,21,0,0,7,31,45,1,1,25,40,18,25,8,15,3,5,7,26,40
2007-05-07 00:00:00.000,ATP Masters Series Rome Italy ATP World Tour,CLAY,2,Mikhail Youzhny,Julien Benneteau,Mikhail Youzhny,6-1; 3-6; 6-2,R64,116,3,2,52,79,38,52,12,27,9,11,12,50,79,2,2,44,74,24,44,15,30,3,8,12,39,74
2007-05-07 00:00:00.000,ATP Masters Series Rome Italy ATP World Tour,CLAY,2,Olivier Rochus,Michael Llodra,Olivier Rochus,5-7; 6-3; 6-3,R64,136,1,5,63,96,43,63,17,33,10,13,15,60,96,8,5,55,108,30,55,29,53,5,10,15,59,108
2007-05-07 00:00:00.000,ATP Masters Series Rome Italy ATP World Tour,CLAY,2,Daniele Bracciali,Robby Ginepri,Daniele Bracciali,7-5; 7-6(2),R64,104,8,1,39,73,30,39,21,34,3,5,12,51,73,3,5,57,84,38,57,12,27,7,10,12,50,84
2007-05-07 00:00:00.000,ATP Masters Series Rome Italy ATP World Tour,CLAY,2,Rafael Nadal,N/A Bye,Rafael Nadal,,R64,0,0,0,0,0,0,0,0,0,0,0,0,0,0,0,0,0,0,0,0,0,0,0,0,0,0,0
2007-05-07 00:00:00.000,ATP Masters Series Rome Italy ATP World Tour,CLAY,2,Roger Federer,Nicolas Almagro,Roger Federer,6-3; 6-4,R32,75,3,0,37,60,26,37,17,23,1,1,10,43,60,3,2,40,60,28,40,9,20,3,5,9,37,60
2007-05-07 00:00:00.000,ATP Masters Series Rome Italy ATP World Tour,CLAY,2,Filippo Volandri,Richard Gasquet,Filippo Volandri,6-4; 6-7(5); 6-4,R32,141,2,2,68,98,44,68,17,30,3,8,16,61,98,3,3,60,100,40,60,17,40,4,11,16,57,100
2007-05-07 00:00:00.000,ATP Masters Series Rome Italy ATP World Tour,CLAY,2,Tomas Berdych,Albert Montanes,Tomas Berdych,7-6(5); 6-3,R32,97,11,2,64,74,46,64,3,10,5,6,10,49,74,0,2,54,70,35,54,7,16,3,6,11,42,70
2007-05-07 00:00:00.000,ATP Masters Series Rome Italy ATP World Tour,CLAY,2,Jose Acasuso,Ivan Ljubicic,Jose Acasuso,6-4; 6-3,R32,107,4,1,30,52,22,30,12,22,2,3,9,34,52,5,2,31,66,21,31,14,35,5,9,10,35,66
2007-05-07 00:00:00.000,ATP Masters Series Rome Italy ATP World Tour,CLAY,2,Andy Roddick,Gaston Gaudio,Andy Roddick,6-1; 7-6(8),R32,94,9,2,44,69,35,44,15,25,3,3,10,50,69,0,5,40,69,29,40,13,29,4,6,9,42,69
2007-05-07 00:00:00.000,ATP Masters Series Rome Italy ATP World Tour,CLAY,2,Juan Ignacio Chela,Igor Andreev,Juan Ignacio Chela,7-5; 7-5,R32,124,2,6,44,69,31,44,12,25,2,5,12,43,69,3,2,67,93,40,67,10,26,10,15,12,50,93
2007-05-07 00:00:00.000,ATP Masters Series Rome Italy ATP World Tour,CLAY,2,Nicolas Massu,James Blake,Nicolas Massu,7-6(3); 7-5,R32,118,2,7,46,78,29,46,16,32,3,7,12,45,78,5,5,44,78,29,44,14,34,9,14,12,43,78
2007-05-07 00:00:00.000,ATP Masters Series Rome Italy ATP World Tour,CLAY,2,Fernando Gonzalez,Dmitry Tursunov,Fernando Gonzalez,6-2; 6-1,R32,67,4,1,24,36,18,24,10,12,0,0,7,28,36,3,5,38,67,23,38,7,29,9,14,8,30,67
2007-05-07 00:00:00.000,ATP Masters Series Rome Italy ATP World Tour,CLAY,2,Tommy Robredo,Oscar Hernandez,Tommy Robredo,7-5; 4-6; 6-1,R32,160,3,5,66,103,42,66,20,37,7,10,15,62,103,2,1,55,83,32,55,17,28,5,10,14,49,83
2007-05-07 00:00:00.000,ATP Masters Series Rome Italy ATP World Tour,CLAY,2,Gilles Simon,Guillermo Canas,Gilles Simon,7-6(4); 6-4,R32,137,3,1,48,85,34,48,17,37,3,5,11,51,85,3,0,34,68,21,34,19,34,1,4,11,40,68
2007-05-07 00:00:00.000,ATP Masters Series Rome Italy ATP World Tour,CLAY,2,Potito Starace,Juan Carlos Ferrero,Potito Starace,6-2; 3-6; 6-2,R32,120,2,0,56,82,37,56,14,26,9,12,13,51,82,0,1,54,82,28,54,14,28,5,10,12,42,82
2007-05-07 00:00:00.000,ATP Masters Series Rome Italy ATP World Tour,CLAY,2,Nikolay Davydenko,Marat Safin,Nikolay Davydenko,7-6(4); 7-5,R32,137,2,4,58,86,39,58,13,28,8,11,12,52,86,5,2,41,81,26,41,19,40,4,8,12,45,81
2007-05-07 00:00:00.000,ATP Masters Series Rome Italy ATP World Tour,CLAY,2,Novak Djokovic,Robin Soderling,Novak Djokovic,3-6; 6-4; 6-3,R32,132,4,3,56,90,38,56,16,34,9,13,14,54,90,4,1,55,83,35,55,12,28,1,6,14,47,83
2007-05-07 00:00:00.000,ATP Masters Series Rome Italy ATP World Tour,CLAY,2,Marcos Baghdatis,Radek Stepanek,Marcos Baghdatis,3-6; 7-6(5); 6-2,R32,130,4,1,42,82,31,42,25,40,2,5,14,56,82,7,3,60,109,35,60,30,49,7,11,15,65,109
2007-05-07 00:00:00.000,ATP Masters Series Rome Italy ATP World Tour,CLAY,2,Mikhail Youzhny,Olivier Rochus,Mikhail Youzhny,7-6(7); 6-3,R32,109,9,4,43,77,32,43,15,34,2,4,11,47,77,3,4,46,70,31,46,10,24,6,9,10,41,70
2007-05-07 00:00:00.000,ATP Masters Series Rome Italy ATP World Tour,CLAY,2,Rafael Nadal,Daniele Bracciali,Rafael Nadal,6-4; 6-2,R32,92,4,1,31,50,23,31,11,19,2,3,9,34,50,6,2,37,58,23,37,6,21,3,7,9,29,58
2007-05-07 00:00:00.000,ATP Masters Series Rome Italy ATP World Tour,CLAY,2,Filippo Volandri,Roger Federer,Filippo Volandri,6-2; 6-4,R16,78,0,2,46,62,33,46,7,16,6,7,9,40,62,5,4,24,54,17,24,11,30,4,8,9,28,54
2007-05-07 00:00:00.000,ATP Masters Series Rome Italy ATP World Tour,CLAY,2,Tomas Berdych,Jose Acasuso,Tomas Berdych,6-1; 6-2,R16,58,2,3,26,45,22,26,10,19,1,2,8,32,45,1,3,14,40,8,14,8,26,3,8,7,16,40
2007-05-07 00:00:00.000,ATP Masters Series Rome Italy ATP World Tour,CLAY,2,Juan Ignacio Chela,Andy Roddick,Juan Ignacio Chela,6-0; 6-4,R16,70,3,1,27,43,21,27,12,16,3,3,8,33,43,2,1,26,52,16,26,12,26,4,8,8,28,52
2007-05-07 00:00:00.000,ATP Masters Series Rome Italy ATP World Tour,CLAY,2,Fernando Gonzalez,Nicolas Massu,Fernando Gonzalez,6-7(4); 6-3; 6-4,R16,180,2,1,62,88,44,62,15,26,3,6,15,59,88,0,3,82,114,49,82,14,32,6,12,16,63,114
2007-05-07 00:00:00.000,ATP Masters Series Rome Italy ATP World Tour,CLAY,2,Tommy Robredo,Gilles Simon,Tommy Robredo,6-2; 6-2,R16,67,1,0,27,39,23,27,7,12,0,1,8,30,39,0,3,29,47,15,29,6,18,2,7,8,21,47
2007-05-07 00:00:00.000,ATP Masters Series Rome Italy ATP World Tour,CLAY,2,Nikolay Davydenko,Potito Starace,Nikolay Davydenko,4-6; 6-2; 7-5,R16,154,4,5,57,87,43,57,15,30,7,10,15,58,87,0,3,73,99,44,73,11,26,7,12,15,55,99
2007-05-07 00:00:00.000,ATP Masters Series Rome Italy ATP World Tour,CLAY,2,Novak Djokovic,Marcos Baghdatis,Novak Djokovic,6-2; 7-5,R16,95,4,1,35,63,20,35,16,28,2,5,10,36,63,4,2,27,65,17,27,14,38,4,10,10,31,65
2007-05-07 00:00:00.000,ATP Masters Series Rome Italy ATP World Tour,CLAY,2,Rafael Nadal,Mikhail Youzhny,Rafael Nadal,6-2; 6-2,R16,86,1,0,28,41,21,28,11,13,0,0,8,32,41,3,1,41,66,24,41,9,25,10,14,8,33,66
2007-05-07 00:00:00.000,ATP Masters Series Rome Italy ATP World Tour,CLAY,2,Filippo Volandri,Tomas Berdych,Filippo Volandri,6-2; 6-3,Q,64,0,1,25,37,23,25,9,12,0,0,8,32,37,4,3,39,61,22,39,11,22,6,10,9,33,61
2007-05-07 00:00:00.000,ATP Masters Series Rome Italy ATP World Tour,CLAY,2,Fernando Gonzalez,Juan Ignacio Chela,Fernando Gonzalez,6-3; 6-4,Q,111,0,0,45,67,33,45,10,22,2,3,10,43,67,1,1,39,75,22,39,18,36,11,14,9,40,75
2007-05-07 00:00:00.000,ATP Masters Series Rome Italy ATP World Tour,CLAY,2,Nikolay Davydenko,Tommy Robredo,Nikolay Davydenko,1-6; 6-3; 6-3,Q,135,1,4,69,88,41,69,6,19,10,15,13,47,88,2,4,58,76,34,58,5,18,5,10,12,39,76
2007-05-07 00:00:00.000,ATP Masters Series Rome Italy ATP World Tour,CLAY,2,Rafael Nadal,Novak Djokovic,Rafael Nadal,6-2; 6-3,Q,101,2,2,34,46,28,34,5,12,1,1,8,33,46,1,1,48,67,27,48,6,19,8,12,9,33,67
2007-05-07 00:00:00.000,ATP Masters Series Rome Italy ATP World Tour,CLAY,2,Fernando Gonzalez,Filippo Volandri,Fernando Gonzalez,6-1; 6-2,S,67,3,1,34,52,27,34,9,18,3,3,8,36,52,0,1,26,42,15,26,7,16,0,4,7,22,42
2007-05-07 00:00:00.000,ATP Masters Series Rome Italy ATP World Tour,CLAY,2,Rafael Nadal,Nikolay Davydenko,Rafael Nadal,7-6(3); 6-7(8); 6-4,S,219,4,3,78,115,49,78,15,37,5,12,17,64,115,3,4,97,129,52,97,13,32,7,15,17,65,129
2007-05-07 00:00:00.000,ATP Masters Series Rome Italy ATP World Tour,CLAY,2,Rafael Nadal,Fernando Gonzalez,Rafael Nadal,6-2; 6-2,F,84,2,1,35,44,27,35,4,9,1,2,8,31,44,4,2,40,58,23,40,4,18,6,11,8,27,58
2007-05-14 00:00:00.000,ATP Masters Series Hamburg Germany ATP World Tour,CLAY,2,Roger Federer,N/A Bye,Roger Federer,,R64,0,0,0,0,0,0,0,0,0,0,0,0,0,0,0,0,0,0,0,0,0,0,0,0,0,0,0
2007-05-14 00:00:00.000,ATP Masters Series Hamburg Germany ATP World Tour,CLAY,2,Juan Monaco,Dominik Hrbaty,Juan Monaco,6-2; 6-2,R64,61,3,1,32,47,18,32,11,15,0,2,8,29,47,2,6,22,51,13,22,6,29,2,8,8,19,51
2007-05-14 00:00:00.000,ATP Masters Series Hamburg Germany ATP World Tour,CLAY,2,Marat Safin,Nicolas Massu,Marat Safin,7-6(7); 6-4,R64,121,5,1,47,75,33,47,16,28,6,9,11,49,75,1,3,48,77,31,48,14,29,4,8,11,45,77
2007-05-14 00:00:00.000,ATP Masters Series Hamburg Germany ATP World Tour,CLAY,2,Juan Carlos Ferrero,Stanislas Wawrinka,Juan Carlos Ferrero,6-1; 7-6(5),R64,91,0,1,55,67,37,55,10,12,4,5,9,47,67,2,3,33,67,23,33,16,34,3,7,10,39,67
2007-05-14 00:00:00.000,ATP Masters Series Hamburg Germany ATP World Tour,CLAY,2,David Ferrer,Jonas Bjorkman,David Ferrer,6-4; 3-6; 6-2,R64,123,0,1,57,87,29,57,14,30,6,12,13,43,87,0,6,55,89,34,55,10,34,8,16,14,44,89
2007-05-14 00:00:00.000,ATP Masters Series Hamburg Germany ATP World Tour,CLAY,2,Robin Soderling,Robby Ginepri,Robin Soderling,4-6; 6-4; 6-3,R64,109,5,3,47,80,38,47,17,33,1,3,14,55,80,4,1,66,100,40,66,17,34,7,11,15,57,100
2007-05-14 00:00:00.000,ATP Masters Series Hamburg Germany ATP World Tour,CLAY,2,Florent Serra,Simone Bolelli,Florent Serra,6-7(3); 6-2; 6-2,R64,118,9,1,51,78,42,51,18,27,1,1,14,60,78,4,1,82,104,47,82,10,22,7,11,14,57,104
2007-05-14 00:00:00.000,ATP Masters Series Hamburg Germany ATP World Tour,CLAY,2,Ivan Ljubicic,N/A Bye,Ivan Ljubicic,,R64,0,0,0,0,0,0,0,0,0,0,0,0,0,0,0,0,0,0,0,0,0,0,0,0,0,0,0
2007-05-14 00:00:00.000,ATP Masters Series Hamburg Germany ATP World Tour,CLAY,2,Novak Djokovic,N/A Bye,Novak Djokovic,,R64,0,0,0,0,0,0,0,0,0,0,0,0,0,0,0,0,0,0,0,0,0,0,0,0,0,0,0
2007-05-14 00:00:00.000,ATP Masters Series Hamburg Germany ATP World Tour,CLAY,2,Julien Benneteau,Rainer Schuettler,Julien Benneteau,7-6(2); 6-2,R64,100,3,1,53,67,33,53,9,14,5,7,10,42,67,0,1,34,66,21,34,14,32,4,8,10,35,66
2007-05-14 00:00:00.000,ATP Masters Series Hamburg Germany ATP World Tour,CLAY,2,Jarkko Nieminen,Tobias Summerer,Jarkko Nieminen,6-1; 7-6(5),R64,87,3,1,48,65,34,48,12,17,3,4,10,46,65,1,0,36,63,22,36,13,27,2,5,9,35,63
2007-05-14 00:00:00.000,ATP Masters Series Hamburg Germany ATP World Tour,CLAY,2,Florian Mayer,Mikhail Youzhny,Florian Mayer,6-4; 2-6; 7-6(5),R64,131,2,1,71,104,39,71,18,33,4,9,15,57,104,4,2,56,97,39,56,19,41,11,15,15,58,97
2007-05-14 00:00:00.000,ATP Masters Series Hamburg Germany ATP World Tour,CLAY,2,Tomas Berdych,Fernando Verdasco,Tomas Berdych,7-6(6); 6-4,R64,89,2,4,45,73,34,45,16,28,1,2,11,50,73,1,5,47,67,32,47,10,20,0,2,11,42,67
2007-05-14 00:00:00.000,ATP Masters Series Hamburg Germany ATP World Tour,CLAY,2,Carlos Moya,Mardy Fish,Carlos Moya,6-0; 6-3,R64,61,1,1,27,42,24,27,7,15,2,2,7,31,42,1,2,36,61,22,36,7,25,5,10,8,29,61
2007-05-14 00:00:00.000,ATP Masters Series Hamburg Germany ATP World Tour,CLAY,2,Arnaud Clement,Radek Stepanek,Arnaud Clement,6-3; 6-7(4); 6-3,R64,144,2,5,48,105,37,48,31,57,2,4,16,68,105,8,3,53,92,35,53,21,39,3,7,14,56,92
2007-05-14 00:00:00.000,ATP Masters Series Hamburg Germany ATP World Tour,CLAY,2,James Blake,N/A Bye,James Blake,,R64,0,0,0,0,0,0,0,0,0,0,0,0,0,0,0,0,0,0,0,0,0,0,0,0,0,0,0
2007-05-14 00:00:00.000,ATP Masters Series Hamburg Germany ATP World Tour,CLAY,2,Tommy Robredo,N/A Bye,Tommy Robredo,,R64,0,0,0,0,0,0,0,0,0,0,0,0,0,0,0,0,0,0,0,0,0,0,0,0,0,0,0
2007-05-14 00:00:00.000,ATP Masters Series Hamburg Germany ATP World Tour,CLAY,2,Nicolas Almagro,Martin Verkerk,Nicolas Almagro,6-1; 6-3,R64,52,5,2,31,46,23,31,10,15,0,0,8,33,46,2,1,27,45,15,27,8,18,1,5,8,23,45
2007-05-14 00:00:00.000,ATP Masters Series Hamburg Germany ATP World Tour,CLAY,2,Jose Acasuso,Guillermo Garcia-Lopez,Jose Acasuso,6-3; 6-4,R64,88,1,2,29,58,22,29,17,29,0,1,10,39,58,3,1,47,73,32,47,8,26,7,10,9,40,73
2007-05-14 00:00:00.000,ATP Masters Series Hamburg Germany ATP World Tour,CLAY,2,Filippo Volandri,Andy Murray,Filippo Volandri,1-5 RET,R64,34,1,1,17,26,7,17,2,9,2,5,3,9,26,0,1,13,19,9,13,3,6,2,3,3,12,19
2007-05-14 00:00:00.000,ATP Masters Series Hamburg Germany ATP World Tour,CLAY,2,Lleyton Hewitt,Agustin Calleri,Lleyton Hewitt,6-3; 6-4,R64,80,4,2,30,57,21,30,20,27,2,3,10,41,57,8,1,26,56,19,26,16,30,9,12,9,35,56
2007-05-14 00:00:00.000,ATP Masters Series Hamburg Germany ATP World Tour,CLAY,2,Juan Ignacio Chela,Guillermo Canas,Juan Ignacio Chela,6-1; 4-6; 6-1,R64,116,2,6,32,73,25,32,20,41,0,2,12,45,73,1,3,35,67,20,35,14,32,6,12,12,34,67
2007-05-14 00:00:00.000,ATP Masters Series Hamburg Germany ATP World Tour,CLAY,2,Gilles Simon,Marc Gicquel,Gilles Simon,6-1; 6-0,R64,52,10,1,30,49,20,30,10,19,4,5,7,30,49,0,1,19,34,6,19,4,15,0,6,6,10,34
2007-05-14 00:00:00.000,ATP Masters Series Hamburg Germany ATP World Tour,CLAY,2,Nikolay Davydenko,N/A Bye,Nikolay Davydenko,,R64,0,0,0,0,0,0,0,0,0,0,0,0,0,0,0,0,0,0,0,0,0,0,0,0,0,0,0
2007-05-14 00:00:00.000,ATP Masters Series Hamburg Germany ATP World Tour,CLAY,2,Fernando Gonzalez,N/A Bye,Fernando Gonzalez,,R64,0,0,0,0,0,0,0,0,0,0,0,0,0,0,0,0,0,0,0,0,0,0,0,0,0,0,0
2007-05-14 00:00:00.000,ATP Masters Series Hamburg Germany ATP World Tour,CLAY,2,Paul-Henri Mathieu,Olivier Rochus,Paul-Henri Mathieu,6-1; 7-6(3),R64,107,4,2,35,70,25,35,22,35,3,4,10,47,70,2,4,46,71,31,46,7,25,2,5,9,38,71
2007-05-14 00:00:00.000,ATP Masters Series Hamburg Germany ATP World Tour,CLAY,2,Jurgen Melzer,Alexander Waske,Jurgen Melzer,6-3; 6-4,R64,76,2,1,31,43,25,31,9,12,1,2,9,34,43,4,6,47,74,29,47,10,27,2,6,10,39,74
2007-05-14 00:00:00.000,ATP Masters Series Hamburg Germany ATP World Tour,CLAY,2,Richard Gasquet,Gaston Gaudio,Richard Gasquet,6-1; 6-4,R64,58,2,0,25,46,19,25,14,21,0,1,9,33,46,0,2,24,41,14,24,7,17,2,6,8,21,41
2007-05-14 00:00:00.000,ATP Masters Series Hamburg Germany ATP World Tour,CLAY,2,Philipp Kohlschreiber,Marcos Baghdatis,Philipp Kohlschreiber,7-5; 6-3,R64,80,2,1,48,62,33,48,6,14,3,5,10,39,62,3,4,40,71,27,40,12,31,5,10,11,39,71
2007-05-14 00:00:00.000,ATP Masters Series Hamburg Germany ATP World Tour,CLAY,2,Igor Andreev,Dmitry Tursunov,Igor Andreev,6-2; 1-0 RET,R64,35,5,1,24,30,20,24,2,6,2,2,5,22,30,1,0,10,23,6,10,4,13,1,3,4,10,23
2007-05-14 00:00:00.000,ATP Masters Series Hamburg Germany ATP World Tour,CLAY,2,Oscar Hernandez,Benjamin Becker,Oscar Hernandez,6-3; 6-7(2); 6-3,R64,184,8,6,78,115,54,78,20,37,5,6,16,74,115,7,3,62,126,48,62,26,64,10,13,14,74,126
2007-05-14 00:00:00.000,ATP Masters Series Hamburg Germany ATP World Tour,CLAY,2,Rafael Nadal,N/A Bye,Rafael Nadal,,R64,0,0,0,0,0,0,0,0,0,0,0,0,0,0,0,0,0,0,0,0,0,0,0,0,0,0,0
2007-05-14 00:00:00.000,ATP Masters Series Hamburg Germany ATP World Tour,CLAY,2,Roger Federer,Juan Monaco,Roger Federer,6-3; 2-6; 6-4,R32,117,5,4,49,93,37,49,22,44,8,11,14,59,93,0,3,59,83,38,59,12,24,3,6,13,50,83
2007-05-14 00:00:00.000,ATP Masters Series Hamburg Germany ATP World Tour,CLAY,2,Juan Carlos Ferrero,Marat Safin,Juan Carlos Ferrero,6-3; 7-6(15),R32,130,1,1,65,92,47,65,14,27,4,5,11,61,92,4,2,50,76,33,50,16,26,1,3,10,49,76
2007-05-14 00:00:00.000,ATP Masters Series Hamburg Germany ATP World Tour,CLAY,2,David Ferrer,Robin Soderling,David Ferrer,1-6; 6-3; 6-2,R32,90,0,2,38,65,26,38,16,27,1,4,12,42,65,1,0,38,68,25,38,13,30,3,7,12,38,68
2007-05-14 00:00:00.000,ATP Masters Series Hamburg Germany ATP World Tour,CLAY,2,Ivan Ljubicic,Florent Serra,Ivan Ljubicic,4-6; 6-2; 6-2,R32,113,13,1,52,94,39,52,20,42,11,13,13,59,94,2,1,56,80,31,56,13,24,8,13,13,44,80
2007-05-14 00:00:00.000,ATP Masters Series Hamburg Germany ATP World Tour,CLAY,2,Novak Djokovic,Julien Benneteau,Novak Djokovic,7-6(5); 6-3,R32,113,9,1,44,63,32,44,13,19,3,4,10,45,63,3,3,46,77,28,46,17,31,3,6,11,45,77
2007-05-14 00:00:00.000,ATP Masters Series Hamburg Germany ATP World Tour,CLAY,2,Jarkko Nieminen,Florian Mayer,Jarkko Nieminen,6-2; 6-4,R32,66,0,0,43,55,31,43,7,12,4,5,9,38,55,1,0,38,60,22,38,8,22,3,7,9,30,60
2007-05-14 00:00:00.000,ATP Masters Series Hamburg Germany ATP World Tour,CLAY,2,Carlos Moya,Tomas Berdych,Carlos Moya,3-6; 7-5; 7-6(6),R32,145,5,2,69,106,52,69,18,37,4,6,16,70,106,3,6,67,117,46,67,29,50,9,11,17,75,117
2007-05-14 00:00:00.000,ATP Masters Series Hamburg Germany ATP World Tour,CLAY,2,James Blake,Arnaud Clement,James Blake,6-2; 6-3,R32,82,7,2,30,51,26,30,10,21,4,4,8,36,51,4,0,42,72,26,42,12,30,4,8,9,38,72
2007-05-14 00:00:00.000,ATP Masters Series Hamburg Germany ATP World Tour,CLAY,2,Nicolas Almagro,Tommy Robredo,Nicolas Almagro,6-7(1); 6-2; 6-4,R32,149,4,3,67,109,42,67,24,42,7,10,15,66,109,3,4,67,102,40,67,19,35,10,16,15,59,102
2007-05-14 00:00:00.000,ATP Masters Series Hamburg Germany ATP World Tour,CLAY,2,Jose Acasuso,Filippo Volandri,Jose Acasuso,3-6; 7-6(3); 6-3,R32,144,2,5,69,115,41,69,24,46,7,12,16,65,115,1,2,78,94,45,78,9,16,2,6,14,54,94
2007-05-14 00:00:00.000,ATP Masters Series Hamburg Germany ATP World Tour,CLAY,2,Lleyton Hewitt,Juan Ignacio Chela,Lleyton Hewitt,6-2; 7-6(3),R32,105,2,2,42,68,29,42,18,26,4,5,10,47,68,1,2,36,62,24,36,13,26,1,4,10,37,62
2007-05-14 00:00:00.000,ATP Masters Series Hamburg Germany ATP World Tour,CLAY,2,Nikolay Davydenko,Gilles Simon,Nikolay Davydenko,6-7(5); 6-4; 7-5,R32,193,2,4,80,129,53,80,22,49,9,13,17,75,129,2,2,63,110,38,63,26,47,5,11,17,64,110
2007-05-14 00:00:00.000,ATP Masters Series Hamburg Germany ATP World Tour,CLAY,2,Fernando Gonzalez,Paul-Henri Mathieu,Fernando Gonzalez,7-5; 6-4,R32,109,7,2,36,63,28,36,14,27,4,6,11,42,63,1,2,40,78,30,40,14,38,5,9,11,44,78
2007-05-14 00:00:00.000,ATP Masters Series Hamburg Germany ATP World Tour,CLAY,2,Jurgen Melzer,Richard Gasquet,Jurgen Melzer,6-3; 6-4,R32,103,3,1,41,67,24,41,17,26,2,4,9,41,67,1,3,46,82,27,46,14,36,11,16,10,41,82
2007-05-14 00:00:00.000,ATP Masters Series Hamburg Germany ATP World Tour,CLAY,2,Igor Andreev,Philipp Kohlschreiber,Igor Andreev,6-7(3); 6-1; 6-4,R32,135,1,2,74,101,48,74,16,27,4,5,14,64,101,1,1,67,99,41,67,15,32,7,12,15,56,99
2007-05-14 00:00:00.000,ATP Masters Series Hamburg Germany ATP World Tour,CLAY,2,Rafael Nadal,Oscar Hernandez,Rafael Nadal,7-5; 6-1,R32,109,0,3,52,64,36,52,3,12,4,6,9,39,64,1,1,43,66,23,43,8,23,3,9,10,31,66
2007-05-14 00:00:00.000,ATP Masters Series Hamburg Germany ATP World Tour,CLAY,2,Roger Federer,Juan Carlos Ferrero,Roger Federer,6-2; 6-3,R16,65,5,1,28,50,21,28,17,22,1,1,9,38,50,1,2,28,40,19,28,5,12,1,4,8,24,40
2007-05-14 00:00:00.000,ATP Masters Series Hamburg Germany ATP World Tour,CLAY,2,David Ferrer,Ivan Ljubicic,David Ferrer,6-3; 6-3,R16,83,1,0,41,64,27,41,14,23,3,4,9,41,64,3,1,31,56,22,31,8,25,3,7,9,30,56
2007-05-14 00:00:00.000,ATP Masters Series Hamburg Germany ATP World Tour,CLAY,2,Novak Djokovic,Jarkko Nieminen,Novak Djokovic,7-5; 4-6; 6-4,R16,158,2,0,79,123,44,79,22,44,14,20,16,66,123,3,0,68,101,45,68,13,33,4,11,16,58,101
2007-05-14 00:00:00.000,ATP Masters Series Hamburg Germany ATP World Tour,CLAY,2,Carlos Moya,James Blake,Carlos Moya,1-6; 6-3; 6-3,R16,88,3,3,60,86,36,60,12,26,7,11,12,48,86,3,3,45,73,31,45,11,28,3,8,13,42,73
2007-05-14 00:00:00.000,ATP Masters Series Hamburg Germany ATP World Tour,CLAY,2,Nicolas Almagro,Jose Acasuso,Nicolas Almagro,6-2; 6-3,R16,63,6,1,33,46,25,33,8,13,0,1,9,33,46,1,3,22,49,17,22,8,27,1,5,8,25,49
2007-05-14 00:00:00.000,ATP Masters Series Hamburg Germany ATP World Tour,CLAY,2,Lleyton Hewitt,Nikolay Davydenko,Lleyton Hewitt,6-4; 2-6; 6-4,R16,140,3,3,52,92,36,52,22,40,5,8,14,58,92,1,0,61,85,39,61,15,24,2,5,14,54,85
2007-05-14 00:00:00.000,ATP Masters Series Hamburg Germany ATP World Tour,CLAY,2,Fernando Gonzalez,Jurgen Melzer,Fernando Gonzalez,3-6; 6-3; 6-4,R16,101,3,2,44,76,34,44,20,32,1,3,14,54,76,4,4,62,89,43,62,11,27,4,7,14,54,89
2007-05-14 00:00:00.000,ATP Masters Series Hamburg Germany ATP World Tour,CLAY,2,Rafael Nadal,Igor Andreev,Rafael Nadal,6-4; 6-1,R16,88,2,0,37,50,26,37,10,13,2,2,8,36,50,1,4,39,62,21,39,10,23,5,9,9,31,62
2007-05-14 00:00:00.000,ATP Masters Series Hamburg Germany ATP World Tour,CLAY,2,Roger Federer,David Ferrer,Roger Federer,6-3; 4-6; 6-3,Q,106,8,1,44,77,37,44,11,33,2,6,14,48,77,1,6,61,88,32,61,14,27,10,16,14,46,88
2007-05-14 00:00:00.000,ATP Masters Series Hamburg Germany ATP World Tour,CLAY,2,Carlos Moya,Novak Djokovic,Carlos Moya,7-6(4); 4-6; 7-5,Q,161,5,5,65,115,46,65,25,50,5,8,17,71,115,4,2,75,108,55,75,12,33,8,11,17,67,108
2007-05-14 00:00:00.000,ATP Masters Series Hamburg Germany ATP World Tour,CLAY,2,Lleyton Hewitt,Nicolas Almagro,Lleyton Hewitt,6-3; 6-4,Q,101,8,1,43,67,35,43,12,24,6,6,10,47,67,4,2,37,81,24,37,23,44,7,9,9,47,81
2007-05-14 00:00:00.000,ATP Masters Series Hamburg Germany ATP World Tour,CLAY,2,Rafael Nadal,Fernando Gonzalez,Rafael Nadal,6-4; 6-4,Q,100,0,0,40,54,31,40,8,14,3,4,10,39,54,2,2,46,68,29,46,9,22,6,9,10,38,68
2007-05-14 00:00:00.000,ATP Masters Series Hamburg Germany ATP World Tour,CLAY,2,Roger Federer,Carlos Moya,Roger Federer,4-6; 6-4; 6-2,S,127,6,3,68,106,41,68,24,38,8,11,14,65,106,3,2,66,96,36,66,17,30,7,12,14,53,96
2007-05-14 00:00:00.000,ATP Masters Series Hamburg Germany ATP World Tour,CLAY,2,Rafael Nadal,Lleyton Hewitt,Rafael Nadal,2-6; 6-3; 7-5,S,155,2,1,74,97,50,74,10,23,8,12,15,60,97,5,0,41,78,27,41,20,37,1,5,14,47,78
2007-05-14 00:00:00.000,ATP Masters Series Hamburg Germany ATP World Tour,CLAY,2,Roger Federer,Rafael Nadal,Roger Federer,2-6; 6-2; 6-0,F,115,6,0,38,73,29,38,17,35,5,7,11,46,73,1,1,62,79,32,62,8,17,6,11,11,40,79
2007-05-20 00:00:00.000,Poertschach Austria ATP World Tour,CLAY,2,Nikolay Davydenko,Ruben Ramirez Hidalgo,Nikolay Davydenko,6-3; 6-0,R32,79,6,3,26,38,21,26,6,12,0,1,7,27,38,2,1,27,62,14,27,13,35,6,12,8,27,62
2007-05-20 00:00:00.000,Poertschach Austria ATP World Tour,CLAY,2,Nicolas Lapentti,Martin Verkerk,Nicolas Lapentti,6-4; 7-6(4),R32,116,7,2,46,79,35,46,13,33,6,8,11,48,79,7,4,55,93,39,55,14,38,8,11,11,53,93
2007-05-20 00:00:00.000,Poertschach Austria ATP World Tour,CLAY,2,Michael Russell,Martin Vassallo Arguello,Michael Russell,6-1; 7-6(4),R32,109,2,2,43,64,31,43,11,21,3,5,10,42,64,2,4,41,68,24,41,11,27,3,7,9,35,68
2007-05-20 00:00:00.000,Poertschach Austria ATP World Tour,CLAY,2,Juan Monaco,Jurgen Melzer,Juan Monaco,6-3; 6-1,R32,73,5,0,35,56,23,35,13,21,5,6,8,36,56,3,2,27,48,13,27,8,21,2,7,8,21,48
2007-05-20 00:00:00.000,Poertschach Austria ATP World Tour,CLAY,2,Ivan Ljubicic,Amer Delic,Ivan Ljubicic,7-6(7); 7-6(8),R32,112,14,1,43,85,34,43,26,42,1,2,12,60,85,16,2,48,82,38,48,19,34,3,4,12,57,82
2007-05-20 00:00:00.000,Poertschach Austria ATP World Tour,CLAY,2,Luis Horna,Alexandr Dolgopolov,Luis Horna,6-3; 6-0,R32,43,10,3,26,40,24,26,8,14,0,0,8,32,40,1,3,13,39,9,13,9,26,2,6,7,18,39
2007-05-20 00:00:00.000,Poertschach Austria ATP World Tour,CLAY,2,Albert Montanes,Daniele Bracciali,Albert Montanes,6-0; 6-4,R32,75,4,1,33,56,24,33,14,23,6,6,8,38,56,2,2,35,64,22,35,10,29,5,9,8,32,64
2007-05-20 00:00:00.000,Poertschach Austria ATP World Tour,CLAY,2,Mathieu Montcourt,Max Mirnyi,Mathieu Montcourt,6-4; 6-4,R32,79,1,0,30,48,25,30,11,18,0,2,10,36,48,6,5,36,57,22,36,9,21,3,7,10,31,57
2007-05-20 00:00:00.000,Poertschach Austria ATP World Tour,CLAY,2,Vincent Spadea,Dominik Hrbaty,Vincent Spadea,6-1; 7-5,R32,96,4,0,34,65,23,34,21,31,5,6,10,44,65,2,7,34,79,18,34,24,45,12,16,9,42,79
2007-05-20 00:00:00.000,Poertschach Austria ATP World Tour,CLAY,2,Diego Hartfield,Stanislas Wawrinka,Diego Hartfield,6-2; 6-4,R32,75,3,2,35,53,25,35,13,18,2,2,9,38,53,1,1,29,53,17,29,15,24,4,7,9,32,53
2007-05-20 00:00:00.000,Poertschach Austria ATP World Tour,CLAY,2,Potito Starace,Stefan Koubek,Potito Starace,6-4; 6-4,R32,83,2,2,54,70,38,54,9,16,6,6,10,47,70,1,3,37,59,27,37,9,22,1,3,10,36,59
2007-05-20 00:00:00.000,Poertschach Austria ATP World Tour,CLAY,2,Lleyton Hewitt,Sergio Roitman,Lleyton Hewitt,6-2; 6-2,R32,67,3,0,26,48,18,26,13,22,2,3,8,31,48,0,3,26,47,11,26,9,21,6,11,8,20,47
2007-05-20 00:00:00.000,Poertschach Austria ATP World Tour,CLAY,2,Hyung-Taik Lee,Danai Udomchoke,Hyung-Taik Lee,6-3; 6-0,R32,51,3,2,31,43,24,31,7,12,0,1,8,31,43,1,5,24,44,15,24,5,20,4,9,7,20,44
2007-05-20 00:00:00.000,Poertschach Austria ATP World Tour,CLAY,2,Gael Monfils,Sam Querrey,Gael Monfils,6-4; 7-5,R32,81,9,1,42,56,33,42,11,14,0,0,11,44,56,7,2,39,74,26,39,21,35,5,7,11,47,74
2007-05-20 00:00:00.000,Poertschach Austria ATP World Tour,CLAY,2,Kristian Pless,Carlos Berlocq,Kristian Pless,6-3; 6-3,R32,70,5,1,26,45,21,26,13,19,3,4,9,34,45,0,2,32,45,17,32,7,13,1,5,9,24,45
2007-05-20 00:00:00.000,Poertschach Austria ATP World Tour,CLAY,2,Andy Roddick,Alexander Peya,Andy Roddick,6-4; 7-5,R32,80,2,0,34,50,30,34,14,16,0,0,11,44,50,6,6,37,70,30,37,15,33,4,6,11,45,70
2007-05-20 00:00:00.000,Poertschach Austria ATP World Tour,CLAY,2,Nikolay Davydenko,Nicolas Lapentti,Nikolay Davydenko,6-4; 6-2,R16,85,2,1,38,50,31,38,7,12,5,5,9,38,50,1,2,42,66,27,42,9,24,3,6,9,36,66
2007-05-20 00:00:00.000,Poertschach Austria ATP World Tour,CLAY,2,Juan Monaco,Michael Russell,Juan Monaco,6-3; 6-1,R16,62,5,0,29,38,25,29,7,9,0,0,8,32,38,1,1,32,50,19,32,7,18,4,8,8,26,50
2007-05-20 00:00:00.000,Poertschach Austria ATP World Tour,CLAY,2,Luis Horna,Ivan Ljubicic,Luis Horna,7-6(5); 6-4,R16,89,5,0,43,62,37,43,13,19,1,1,11,50,62,13,2,36,71,27,36,22,35,3,4,11,49,71
2007-05-20 00:00:00.000,Poertschach Austria ATP World Tour,CLAY,2,Albert Montanes,Mathieu Montcourt,Albert Montanes,7-6(6); 6-1,R16,103,5,5,33,66,24,33,16,33,1,3,10,40,66,2,2,54,74,28,54,11,20,5,9,9,39,74
2007-05-20 00:00:00.000,Poertschach Austria ATP World Tour,CLAY,2,Diego Hartfield,Vincent Spadea,Diego Hartfield,6-4; 7-6(5),R16,101,3,3,53,80,36,53,13,27,2,4,11,49,80,0,0,43,64,31,43,8,21,6,9,11,39,64
2007-05-20 00:00:00.000,Poertschach Austria ATP World Tour,CLAY,2,Lleyton Hewitt,Potito Starace,Lleyton Hewitt,6-4; 6-4,R16,90,4,0,35,68,29,35,19,33,5,5,10,48,68,1,0,44,61,31,44,10,17,4,6,10,41,61
2007-05-20 00:00:00.000,Poertschach Austria ATP World Tour,CLAY,2,Gael Monfils,Hyung-Taik Lee,Gael Monfils,7-6(5); 6-4,R16,99,6,2,49,72,38,49,10,23,1,3,11,48,72,0,0,44,84,26,44,22,40,6,9,11,48,84
2007-05-20 00:00:00.000,Poertschach Austria ATP World Tour,CLAY,2,Andy Roddick,Kristian Pless,Andy Roddick,6-4; 6-3,R16,66,6,2,34,49,30,34,10,15,0,0,10,40,49,7,2,28,53,23,28,13,25,4,6,9,36,53
2007-05-20 00:00:00.000,Poertschach Austria ATP World Tour,CLAY,2,Juan Monaco,Nikolay Davydenko,Juan Monaco,6-2; 6-7(5); 6-4,Q,159,5,2,80,121,50,80,20,41,10,14,15,70,121,1,7,58,93,35,58,13,35,5,12,15,48,93
2007-05-20 00:00:00.000,Poertschach Austria ATP World Tour,CLAY,2,Luis Horna,Albert Montanes,Luis Horna,7-6(4); 6-7(2); 6-1,Q,133,5,1,59,100,45,59,24,41,5,6,16,69,100,6,2,60,92,43,60,16,32,1,4,15,59,92
2007-05-20 00:00:00.000,Poertschach Austria ATP World Tour,CLAY,2,Lleyton Hewitt,Diego Hartfield,Lleyton Hewitt,6-2; 6-2,Q,73,6,0,23,45,17,23,15,22,2,3,8,32,45,1,4,30,56,17,30,9,26,3,8,8,26,56
2007-05-20 00:00:00.000,Poertschach Austria ATP World Tour,CLAY,2,Gael Monfils,Andy Roddick,Gael Monfils,7-5; 6-3,Q,164,7,4,31,68,25,31,21,37,5,6,11,46,68,0,3,25,55,18,25,17,30,1,4,10,35,55
2007-05-20 00:00:00.000,Poertschach Austria ATP World Tour,CLAY,2,Juan Monaco,Luis Horna,Juan Monaco,6-4; 6-4,S,78,2,1,31,53,19,31,16,22,2,4,10,35,53,2,2,36,51,21,36,5,15,0,4,10,26,51
2007-05-20 00:00:00.000,Poertschach Austria ATP World Tour,CLAY,2,Gael Monfils,Lleyton Hewitt,Gael Monfils,6-4; 7-5,S,100,5,4,37,75,29,37,15,38,6,8,11,44,75,3,1,36,62,25,36,10,26,2,6,11,35,62
2007-05-20 00:00:00.000,Poertschach Austria ATP World Tour,CLAY,2,Juan Monaco,Gael Monfils,Juan Monaco,7-6(3); 6-0,F,81,1,0,31,51,24,31,14,20,0,1,9,38,51,2,6,28,60,15,28,15,32,6,10,9,30,60
2007-05-28 00:00:00.000,Roland Garros France Grand Slams,CLAY,3,Roger Federer,Michael Russell,Roger Federer,6-4; 6-2; 6-4,R128,105,6,0,53,75,42,53,17,22,0,0,14,59,75,1,4,73,93,46,73,10,20,7,11,14,56,93
2007-05-28 00:00:00.000,Roland Garros France Grand Slams,CLAY,3,Thierry Ascione,Marin Cilic,Thierry Ascione,6-2; 6-2; 6-1,R128,93,2,2,58,80,41,58,15,22,9,9,12,56,80,4,2,33,67,22,33,12,34,4,10,11,34,67
2007-05-28 00:00:00.000,Roland Garros France Grand Slams,CLAY,3,Potito Starace,Ivo Minar,Potito Starace,4-6; 6-1; 6-4; 7-6(5),R128,147,0,1,104,137,68,104,24,33,5,6,20,92,137,8,2,67,114,53,67,22,47,2,5,19,75,114
2007-05-28 00:00:00.000,Roland Garros France Grand Slams,CLAY,3,Carlos Berlocq,Julien Benneteau,Carlos Berlocq,6-7(5); 7-5; 6-2; 6-3,R128,239,2,0,92,122,55,92,21,30,7,11,20,76,122,3,2,106,165,59,106,26,59,19,28,21,85,165
2007-05-28 00:00:00.000,Roland Garros France Grand Slams,CLAY,3,Juan Carlos Ferrero,Amer Delic,Juan Carlos Ferrero,6-7(5); 6-3; 6-3; 6-4,R128,164,4,2,85,115,62,85,20,30,2,4,20,82,115,10,3,78,138,56,78,27,60,10,16,20,83,138
2007-05-28 00:00:00.000,Roland Garros France Grand Slams,CLAY,3,Stefan Koubek,Christophe Rochus,Stefan Koubek,6-7; 7-6; 6-4; 1-2 RET,R128,168,11,4,83,143,60,83,36,60,12,13,18,96,143,4,2,74,125,56,74,27,51,7,9,19,83,125
2007-05-28 00:00:00.000,Roland Garros France Grand Slams,CLAY,3,Nicolas Lapentti,Alexander Peya,Nicolas Lapentti,6-1; 6-4; 2-1 RET,R128,91,1,1,39,58,28,39,13,19,4,5,10,41,58,0,3,35,55,21,35,8,20,1,6,10,29,55
2007-05-28 00:00:00.000,Roland Garros France Grand Slams,CLAY,3,Mikhail Youzhny,Jan Hernych,Mikhail Youzhny,RET,R128,8,0,0,0,0,0,0,0,0,0,0,0,0,0,0,1,5,9,3,5,1,4,1,1,0,4,9
2007-05-28 00:00:00.000,Roland Garros France Grand Slams,CLAY,3,Tommy Robredo,Sergio Roitman,Tommy Robredo,6-3; 6-4; 6-2,R128,116,1,2,44,81,30,44,23,37,2,4,14,53,81,0,1,61,87,33,61,13,26,10,16,13,46,87
2007-05-28 00:00:00.000,Roland Garros France Grand Slams,CLAY,3,Konstantinos Economidis,Chris Guccione,Konstantinos Economidis,6-7(6); 6-4; 6-4; 6-1,R128,141,11,4,80,124,58,80,34,44,3,3,20,92,124,19,5,67,117,48,67,29,50,6,10,19,77,117
2007-05-28 00:00:00.000,Roland Garros France Grand Slams,CLAY,3,Janko Tipsarevic,Dusan Vemic,Janko Tipsarevic,7-6(3); 6-4; 4-6; 6-3,R128,168,8,2,66,117,51,66,30,51,3,7,21,81,117,15,4,84,128,51,84,27,44,6,11,20,78,128
2007-05-28 00:00:00.000,Roland Garros France Grand Slams,CLAY,3,Marat Safin,Fernando Vicente,Marat Safin,6-1; 6-3; 6-1,R128,84,8,2,28,56,24,28,18,28,0,1,11,42,56,2,2,65,83,32,65,5,18,6,14,12,37,83
2007-05-28 00:00:00.000,Roland Garros France Grand Slams,CLAY,3,Filippo Volandri,Paul Capdeville,Filippo Volandri,6-3; 7-5; 6-3,R128,119,2,1,91,115,57,91,11,24,10,14,15,68,115,2,1,62,93,30,62,16,31,8,16,15,46,93
2007-05-28 00:00:00.000,Roland Garros France Grand Slams,CLAY,3,Martin Vassallo Arguello,Alejandro Falla,Martin Vassallo Arguello,6-3; 6-3; 6-7(3); 7-6(4),R128,216,5,12,94,157,69,94,33,63,10,12,21,102,157,0,0,98,144,68,98,21,46,11,16,21,89,144
2007-05-28 00:00:00.000,Roland Garros France Grand Slams,CLAY,3,Stanislas Wawrinka,Ruben Ramirez Hidalgo,Stanislas Wawrinka,0-6; 5-7; 6-2; 7-5; 6-4,R128,243,11,4,76,140,53,76,30,64,1,8,24,83,140,2,8,93,172,60,93,39,79,15,22,24,99,172
2007-05-28 00:00:00.000,Roland Garros France Grand Slams,CLAY,3,Ivan Ljubicic,Arnaud Clement,Ivan Ljubicic,6-1; 7-5; 7-6(2),R128,149,11,2,46,89,39,46,27,43,2,3,16,66,89,0,3,47,94,30,47,26,47,4,8,15,56,94
2007-05-28 00:00:00.000,Roland Garros France Grand Slams,CLAY,3,Nikolay Davydenko,Stefano Galvani,Nikolay Davydenko,6-3; 6-1; 6-1,R128,90,3,1,37,60,31,37,16,23,0,1,12,47,60,1,2,47,72,20,47,12,25,4,11,11,32,72
2007-05-28 00:00:00.000,Roland Garros France Grand Slams,CLAY,3,Werner Eschauer,Alexandre Sidorenko,Werner Eschauer,6-3; 3-6; 6-3; 5-4 RET,R128,188,2,4,78,124,52,78,22,46,5,10,18,74,124,3,0,86,135,50,86,23,49,15,22,18,73,135
2007-05-28 00:00:00.000,Roland Garros France Grand Slams,CLAY,3,Michael Llodra,Nicolas Devilder,Michael Llodra,6-4; 6-3; 6-3,R128,127,8,1,49,95,40,49,24,46,1,2,14,64,95,1,0,61,93,36,61,17,32,6,11,14,53,93
2007-05-28 00:00:00.000,Roland Garros France Grand Slams,CLAY,3,Nicolas Almagro,Justin Gimelstob,Nicolas Almagro,6-4; 6-4; 6-4,R128,113,18,2,43,82,33,43,25,39,0,1,15,58,82,4,3,72,103,43,72,16,31,9,13,15,59,103
2007-05-28 00:00:00.000,Roland Garros France Grand Slams,CLAY,3,Juan Ignacio Chela,Fabrice Santoro,Juan Ignacio Chela,6-7(5); 6-0; 6-3; 6-3,R128,180,2,2,58,110,43,58,33,52,7,9,18,76,110,2,2,76,136,49,76,22,60,13,21,18,71,136
2007-05-28 00:00:00.000,Roland Garros France Grand Slams,CLAY,3,Gael Monfils,Olivier Rochus,Gael Monfils,4-6; 6-4; 6-2; 3-6; 6-1,R128,193,14,3,78,130,57,78,27,52,4,9,22,84,130,0,2,95,157,61,95,27,62,14,22,22,88,157
2007-05-28 00:00:00.000,Roland Garros France Grand Slams,CLAY,3,Ivan Navarro,Boris Pashanski,Ivan Navarro,7-6(1); 6-4; 6-4,R128,139,16,2,68,110,49,68,24,42,9,10,16,73,110,1,3,73,108,49,73,17,35,6,9,16,66,108
2007-05-28 00:00:00.000,Roland Garros France Grand Slams,CLAY,3,David Nalbandian,Hyung-Taik Lee,David Nalbandian,6-2; 6-1; 3-6; 6-3,R128,138,5,4,71,111,50,71,23,40,9,11,16,73,111,3,3,70,110,43,70,14,40,7,14,17,57,110
2007-05-28 00:00:00.000,Roland Garros France Grand Slams,CLAY,3,Richard Gasquet,Nicolas Mahut,Richard Gasquet,6-3; 6-2; 6-2,R128,109,6,5,41,72,33,41,21,31,1,2,13,54,72,3,2,59,88,32,59,12,29,9,15,12,44,88
2007-05-28 00:00:00.000,Roland Garros France Grand Slams,CLAY,3,Kristof Vliegen,Danai Udomchoke,Kristof Vliegen,6-2; 6-4; 6-3,R128,97,8,1,52,69,43,52,11,17,2,2,13,54,69,1,1,61,85,36,61,11,24,4,9,14,47,85
2007-05-28 00:00:00.000,Roland Garros France Grand Slams,CLAY,3,Simone Bolelli,Martin Verkerk,Simone Bolelli,6-1; 6-4; 6-4,R128,92,11,1,48,73,42,48,15,25,5,6,14,57,73,7,4,46,84,27,46,20,38,8,13,13,47,84
2007-05-28 00:00:00.000,Roland Garros France Grand Slams,CLAY,3,Guillermo Canas,Victor Hanescu,Guillermo Canas,6-3; 6-1; 6-4,R128,120,12,1,59,90,47,59,16,31,9,9,13,63,90,2,1,59,85,38,59,10,26,7,12,13,48,85
2007-05-28 00:00:00.000,Roland Garros France Grand Slams,CLAY,3,Jurgen Melzer,Jose Acasuso,Jurgen Melzer,6-4; 7-5; 6-4,R128,126,6,0,66,101,50,66,19,35,6,7,16,69,101,2,2,47,94,30,47,28,47,7,11,16,58,94
2007-05-28 00:00:00.000,Roland Garros France Grand Slams,CLAY,3,Juan Monaco,Fabio Fognini,Juan Monaco,3-6; 2-6; 6-1; 6-2; 6-4,R128,157,2,4,83,119,57,83,22,36,4,8,21,79,119,5,5,86,129,57,86,20,43,11,17,21,77,129
2007-05-28 00:00:00.000,Roland Garros France Grand Slams,CLAY,3,Edouard Roger-Vasselin,Marcos Daniel,Edouard Roger-Vasselin,6-1; 4-1 RET,R128,63,1,0,34,48,24,34,8,14,4,4,6,32,48,2,2,25,42,13,25,5,17,3,7,6,18,42
2007-05-28 00:00:00.000,Roland Garros France Grand Slams,CLAY,3,Radek Stepanek,Fernando Gonzalez,Radek Stepanek,6-2; 6-2; 6-4,R128,112,3,2,47,74,37,47,18,27,4,4,13,55,74,2,2,64,92,40,64,10,28,6,11,13,50,92
2007-05-28 00:00:00.000,Roland Garros France Grand Slams,CLAY,3,Novak Djokovic,Santiago Giraldo,Novak Djokovic,6-3; 7-6(3); 6-4,R128,131,7,6,78,117,55,78,18,39,9,11,16,73,117,5,2,61,95,39,61,15,34,7,11,15,54,95
2007-05-28 00:00:00.000,Roland Garros France Grand Slams,CLAY,3,Laurent Recouderc,Sam Querrey,Laurent Recouderc,7-6(4); 2-6; 6-0; 6-7(5); 6-3,R128,174,2,2,88,150,61,88,41,62,12,15,23,102,150,13,8,87,153,69,87,31,66,13,19,24,100,153
2007-05-28 00:00:00.000,Roland Garros France Grand Slams,CLAY,3,Olivier Patience,Jonathan Eysseric,Olivier Patience,6-1; 3-6; 6-2; 6-4,R128,122,6,3,76,104,56,76,12,28,3,6,17,68,104,5,8,53,102,36,53,20,49,4,11,17,56,102
2007-05-28 00:00:00.000,Roland Garros France Grand Slams,CLAY,3,Mariano Zabaleta,Agustin Calleri,Mariano Zabaleta,6-4; 6-7(5); 7-6(5); 7-5,R128,210,5,5,109,163,76,109,30,54,8,11,23,106,163,13,6,103,173,74,103,31,70,9,14,23,105,173
2007-05-28 00:00:00.000,Roland Garros France Grand Slams,CLAY,3,Dmitry Tursunov,Alessio Di Mauro,Dmitry Tursunov,6-3; 6-4; 3-6; 6-3,R128,163,3,2,79,118,56,79,23,39,7,9,19,79,118,6,4,69,119,51,69,25,50,13,17,18,76,119
2007-05-28 00:00:00.000,Roland Garros France Grand Slams,CLAY,3,Fernando Verdasco,Jerome Haehnel,Fernando Verdasco,4-6; 6-2; 6-2; 6-0,R128,133,8,5,62,96,50,62,18,34,5,6,16,68,96,4,3,55,105,32,55,25,50,7,14,16,57,105
2007-05-28 00:00:00.000,Roland Garros France Grand Slams,CLAY,3,Diego Hartfield,Robby Ginepri,Diego Hartfield,6-4; 1-6; 5-7; 6-4; 6-2,R128,205,3,2,125,165,78,125,20,40,13,19,23,98,165,6,5,106,160,66,106,27,54,12,19,24,93,160
2007-05-28 00:00:00.000,Roland Garros France Grand Slams,CLAY,3,David Ferrer,Daniele Bracciali,David Ferrer,6-1; 6-1; 6-2,R128,90,5,1,49,69,36,49,10,20,2,3,11,46,69,2,3,35,75,18,35,12,40,5,13,11,30,75
2007-05-28 00:00:00.000,Roland Garros France Grand Slams,CLAY,3,Marcos Baghdatis,Sebastien Grosjean,Marcos Baghdatis,6-3; 6-2; 6-4,R128,118,3,3,38,80,29,38,29,42,0,0,14,58,80,3,1,57,83,38,57,12,26,7,11,13,50,83
2007-05-28 00:00:00.000,Roland Garros France Grand Slams,CLAY,3,Kristian Pless,Yen-Hsun Lu,Kristian Pless,6-3; 6-2; 7-6(1),R128,103,6,3,55,78,44,55,18,23,2,3,15,62,78,3,5,53,93,33,53,17,40,6,10,14,50,93
2007-05-28 00:00:00.000,Roland Garros France Grand Slams,CLAY,3,Jan Hajek,Thomas Johansson,Jan Hajek,7-5; 7-6(3); 7-6(3),R128,143,20,5,69,115,53,69,28,46,4,7,18,81,115,8,1,92,146,58,92,30,54,12,16,18,88,146
2007-05-28 00:00:00.000,Roland Garros France Grand Slams,CLAY,3,Bohdan Ulihrach,Dominik Hrbaty,Bohdan Ulihrach,6-2; 5-7; 6-7(3); 6-4; 6-3,R128,174,14,8,92,144,70,92,26,52,5,9,25,96,144,4,9,93,169,60,93,41,76,11,19,26,101,169
2007-05-28 00:00:00.000,Roland Garros France Grand Slams,CLAY,3,Paul-Henri Mathieu,Florian Mayer,Paul-Henri Mathieu,6-3; 6-4; 6-2,R128,115,6,1,60,93,45,60,19,33,10,11,14,64,93,2,2,49,84,31,49,16,35,4,9,13,47,84
2007-05-28 00:00:00.000,Roland Garros France Grand Slams,CLAY,3,Gilles Simon,Vincent Spadea,Gilles Simon,2-6; 6-4; 6-4; 6-3,R128,154,7,2,79,119,56,79,15,40,7,13,19,71,119,3,3,72,118,43,72,24,46,12,19,18,67,118
2007-05-28 00:00:00.000,Roland Garros France Grand Slams,CLAY,3,Nicolas Massu,Luis Horna,Nicolas Massu,6-4; 7-5; 3-6; 6-7(1); 6-2,R128,254,8,2,118,155,77,118,21,37,16,22,25,98,155,11,8,115,169,78,115,22,54,5,14,26,100,169
2007-05-28 00:00:00.000,Roland Garros France Grand Slams,CLAY,3,Igor Andreev,Andy Roddick,Igor Andreev,3-6; 6-4; 6-3; 6-4,R128,163,8,3,76,120,51,76,29,44,10,12,19,80,120,5,3,77,126,48,77,27,49,7,11,19,75,126
2007-05-28 00:00:00.000,Roland Garros France Grand Slams,CLAY,3,Ivo Karlovic,James Blake,Ivo Karlovic,4-6; 6-4; 7-5; 7-5,R128,152,22,2,84,121,63,84,27,37,4,5,22,90,121,1,1,85,135,60,85,30,50,8,11,22,90,135
2007-05-28 00:00:00.000,Roland Garros France Grand Slams,CLAY,3,Jonas Bjorkman,Peter Luczak,Jonas Bjorkman,6-7(4); 5-7; 6-3; 6-3; 6-1,R128,196,20,1,96,149,73,96,27,53,8,11,24,100,149,14,4,106,159,71,106,25,53,7,15,25,96,159
2007-05-28 00:00:00.000,Roland Garros France Grand Slams,CLAY,3,Oscar Hernandez,Juan-Pablo Guzman,Oscar Hernandez,7-6(4); 6-0; 6-2,R128,101,4,1,52,73,40,52,15,21,0,1,13,55,73,3,3,50,84,34,50,11,34,1,7,13,45,84
2007-05-28 00:00:00.000,Roland Garros France Grand Slams,CLAY,3,Philipp Kohlschreiber,Lukas Dlouhy,Philipp Kohlschreiber,6-2; 3-6; 7-5; 4-6; 17-15,R128,235,6,2,138,199,97,138,37,61,6,11,35,134,199,18,8,153,240,108,153,43,87,13,20,36,151,240
2007-05-28 00:00:00.000,Roland Garros France Grand Slams,CLAY,3,Carlos Moya,Andreas Seppi,Carlos Moya,6-1; 3-6; 6-3; 2-6; 6-0,R128,168,4,8,82,133,55,82,27,51,13,17,20,82,133,3,5,72,124,42,72,26,52,5,12,19,68,124
2007-05-28 00:00:00.000,Roland Garros France Grand Slams,CLAY,3,Florent Serra,Igor Kunitsyn,Florent Serra,6-3; 6-0; 6-2,R128,73,6,1,48,63,41,48,7,15,0,0,12,48,63,0,1,39,56,20,39,7,17,5,11,11,27,56
2007-05-28 00:00:00.000,Roland Garros France Grand Slams,CLAY,3,Juan Pablo Brzezicki,Robert Kendrick,Juan Pablo Brzezicki,6-1; 3-6; 6-2; 6-1,R128,123,3,0,53,89,37,53,22,36,2,5,16,59,89,7,6,55,100,26,55,21,45,7,15,15,47,100
2007-05-28 00:00:00.000,Roland Garros France Grand Slams,CLAY,3,Guillermo Garcia-Lopez,Tomas Berdych,Guillermo Garcia-Lopez,7-5; 6-4; 6-4,R128,130,4,3,55,85,44,55,15,30,3,6,16,59,85,4,4,71,109,44,71,14,38,7,13,16,58,109
2007-05-28 00:00:00.000,Roland Garros France Grand Slams,CLAY,3,Lleyton Hewitt,Max Mirnyi,Lleyton Hewitt,6-3; 6-1; 6-3,R128,104,4,2,49,72,36,49,16,23,6,6,12,52,72,4,7,48,86,29,48,15,38,5,11,13,44,86
2007-05-28 00:00:00.000,Roland Garros France Grand Slams,CLAY,3,Gaston Gaudio,Marc Gicquel,Gaston Gaudio,3-6; 6-3; 3-6; 6-4; 6-3,R128,197,2,2,78,140,46,78,37,62,6,12,23,83,140,10,4,74,148,56,74,31,74,6,13,23,87,148
2007-05-28 00:00:00.000,Roland Garros France Grand Slams,CLAY,3,Mathieu Montcourt,Benjamin Becker,Mathieu Montcourt,6-3; 6-1; 6-3,R128,101,4,7,61,88,49,61,11,27,7,7,12,60,88,4,1,43,72,28,43,13,29,4,10,13,41,72
2007-05-28 00:00:00.000,Roland Garros France Grand Slams,CLAY,3,Jarkko Nieminen,Feliciano Lopez,Jarkko Nieminen,6-2; 6-4; 7-6(2),R128,125,5,1,56,85,45,56,20,29,3,4,15,65,85,7,2,70,116,50,70,19,46,8,12,15,69,116
2007-05-28 00:00:00.000,Roland Garros France Grand Slams,CLAY,3,Albert Montanes,Robin Soderling,Albert Montanes,7-6(4); 4-1 RET,R128,75,6,1,41,58,32,41,12,17,2,2,9,44,58,7,1,31,59,26,31,11,28,0,1,8,37,59
2007-05-28 00:00:00.000,Roland Garros France Grand Slams,CLAY,3,Ernests Gulbis,Tim Henman,Ernests Gulbis,6-4; 6-3; 6-2,R128,109,8,3,64,89,50,64,11,25,5,6,14,61,89,3,1,59,94,32,59,19,35,12,17,13,51,94
2007-05-28 00:00:00.000,Roland Garros France Grand Slams,CLAY,3,Flavio Cipolla,Teymuraz Gabashvili,Flavio Cipolla,7-6(6); 6-3; 5-2 RET,R128,138,2,7,72,95,46,72,11,23,6,10,14,57,95,1,3,61,111,38,61,20,50,8,15,14,58,111
2007-05-28 00:00:00.000,Roland Garros France Grand Slams,CLAY,3,Rafael Nadal,Juan Martin Del Potro,Rafael Nadal,7-5; 6-3; 6-2,R128,139,1,2,49,78,37,49,15,29,6,9,14,52,78,0,3,67,95,34,67,14,28,12,20,15,48,95
2007-05-28 00:00:00.000,Roland Garros France Grand Slams,CLAY,3,Roger Federer,Thierry Ascione,Roger Federer,6-1; 6-2; 7-6(8),R64,111,6,0,64,94,47,64,17,30,3,4,14,64,94,3,5,79,118,48,79,17,39,16,21,13,65,118
2007-05-28 00:00:00.000,Roland Garros France Grand Slams,CLAY,3,Potito Starace,Carlos Berlocq,Potito Starace,6-2; 6-4; 6-2,R64,125,1,0,54,70,40,54,11,16,0,1,13,51,70,1,0,55,91,30,55,16,36,9,15,13,46,91
2007-05-28 00:00:00.000,Roland Garros France Grand Slams,CLAY,3,Juan Carlos Ferrero,Stefan Koubek,Juan Carlos Ferrero,6-4; 7-5; 6-3,R64,141,5,1,68,97,40,68,15,29,4,9,15,55,97,7,5,73,108,40,73,14,35,10,19,16,54,108
2007-05-28 00:00:00.000,Roland Garros France Grand Slams,CLAY,3,Mikhail Youzhny,Nicolas Lapentti,Mikhail Youzhny,6-3; 6-0; 6-4,R64,98,7,1,49,72,41,49,13,23,1,1,13,54,72,3,2,45,69,31,45,9,24,2,7,12,40,69
2007-05-28 00:00:00.000,Roland Garros France Grand Slams,CLAY,3,Tommy Robredo,Konstantinos Economidis,Tommy Robredo,6-4; 7-5; 6-4,R64,133,3,1,59,93,39,59,23,34,3,6,16,62,93,0,6,69,111,49,69,14,42,8,14,16,63,111
2007-05-28 00:00:00.000,Roland Garros France Grand Slams,CLAY,3,Janko Tipsarevic,Marat Safin,Janko Tipsarevic,6-4; 6-4; 7-5,R64,158,3,0,53,106,32,53,33,53,9,12,16,65,106,5,5,57,102,37,57,19,45,5,11,16,56,102
2007-05-28 00:00:00.000,Roland Garros France Grand Slams,CLAY,3,Filippo Volandri,Martin Vassallo Arguello,Filippo Volandri,7-6(2); 7-5; 6-2,R64,146,0,0,93,109,56,93,11,16,2,5,16,67,109,2,4,66,109,39,66,19,43,5,11,16,58,109
2007-05-28 00:00:00.000,Roland Garros France Grand Slams,CLAY,3,Ivan Ljubicic,Stanislas Wawrinka,Ivan Ljubicic,6-4; 6-3; 6-7(3); 6-3,R64,209,16,0,79,134,60,79,31,55,3,4,21,91,134,11,1,70,123,48,70,30,53,7,11,19,78,123
2007-05-28 00:00:00.000,Roland Garros France Grand Slams,CLAY,3,Nikolay Davydenko,Werner Eschauer,Nikolay Davydenko,7-5; 6-3; 6-1,R64,125,3,3,43,76,35,43,18,33,2,4,14,53,76,2,4,61,93,32,61,12,32,5,12,14,44,93
2007-05-28 00:00:00.000,Roland Garros France Grand Slams,CLAY,3,Michael Llodra,Nicolas Almagro,Michael Llodra,2-6; 6-2; 6-7(7); 6-4; 6-4,R64,185,19,4,108,174,77,108,35,66,9,12,24,112,174,23,3,81,144,57,81,37,63,3,8,24,94,144
2007-05-28 00:00:00.000,Roland Garros France Grand Slams,CLAY,3,Gael Monfils,Juan Ignacio Chela,Gael Monfils,3-6; 6-3; 6-3; 6-1,R64,165,4,5,68,109,49,68,23,41,5,7,17,72,109,2,8,72,127,43,72,25,55,12,18,17,68,127
2007-05-28 00:00:00.000,Roland Garros France Grand Slams,CLAY,3,David Nalbandian,Ivan Navarro,David Nalbandian,7-5; 6-4; 6-4,R64,132,1,2,62,94,45,62,21,32,3,4,16,66,94,13,2,56,99,46,56,17,43,5,9,16,63,99
2007-05-28 00:00:00.000,Roland Garros France Grand Slams,CLAY,3,Kristof Vliegen,Richard Gasquet,Kristof Vliegen,7-6(4); 6-3; 6-1,R64,136,6,1,64,99,42,64,20,35,5,8,14,62,99,5,3,55,90,32,55,11,35,7,14,14,43,90
2007-05-28 00:00:00.000,Roland Garros France Grand Slams,CLAY,3,Guillermo Canas,Simone Bolelli,Guillermo Canas,6-4; 6-3; 6-3,R64,135,10,0,53,91,41,53,18,38,5,6,14,59,91,2,2,63,90,43,63,9,27,5,10,14,52,90
2007-05-28 00:00:00.000,Roland Garros France Grand Slams,CLAY,3,Juan Monaco,Jurgen Melzer,Juan Monaco,6-2; 6-3; 6-2,R64,90,6,0,30,70,25,30,30,40,4,4,13,55,70,2,1,48,69,30,48,10,21,2,7,12,40,69
2007-05-28 00:00:00.000,Roland Garros France Grand Slams,CLAY,3,Edouard Roger-Vasselin,Radek Stepanek,Edouard Roger-Vasselin,3-6; 6-1; 0-6; 6-4; 6-4,R64,187,1,3,98,148,61,98,25,50,13,19,21,86,148,12,3,82,139,50,82,31,57,6,12,21,81,139
2007-05-28 00:00:00.000,Roland Garros France Grand Slams,CLAY,3,Novak Djokovic,Laurent Recouderc,Novak Djokovic,6-3; 3-6; 6-3; 6-1,R64,135,5,1,68,101,49,68,19,33,2,4,17,68,101,0,0,58,108,38,58,22,50,5,11,17,60,108
2007-05-28 00:00:00.000,Roland Garros France Grand Slams,CLAY,3,Olivier Patience,Mariano Zabaleta,Olivier Patience,7-5; 6-3; 3-6; 2-6; 6-4,R64,216,5,4,118,194,69,118,39,76,20,28,24,108,194,10,7,87,138,62,87,22,51,4,12,24,84,138
2007-05-28 00:00:00.000,Roland Garros France Grand Slams,CLAY,3,Fernando Verdasco,Dmitry Tursunov,Fernando Verdasco,6-4; 6-4; 6-4,R64,129,5,2,60,88,44,60,16,28,1,3,15,60,88,7,2,56,96,36,56,20,40,1,6,15,56,96
2007-05-28 00:00:00.000,Roland Garros France Grand Slams,CLAY,3,David Ferrer,Diego Hartfield,David Ferrer,6-4; 6-3; 7-6(4),R64,139,3,1,76,104,48,76,19,28,1,5,16,67,104,2,2,69,96,45,69,8,27,4,10,15,53,96
2007-05-28 00:00:00.000,Roland Garros France Grand Slams,CLAY,3,Marcos Baghdatis,Kristian Pless,Marcos Baghdatis,7-5; 6-3; 6-4,R64,114,7,3,40,92,29,40,34,52,3,5,16,63,92,0,3,66,97,39,66,15,31,7,12,15,54,97
2007-05-28 00:00:00.000,Roland Garros France Grand Slams,CLAY,3,Jan Hajek,Bohdan Ulihrach,Jan Hajek,1-6; 6-2; 7-6(6); 3-6; 6-2,R64,168,10,4,80,147,60,80,33,67,14,19,21,93,147,14,11,102,168,69,102,34,66,16,22,23,103,168
2007-05-28 00:00:00.000,Roland Garros France Grand Slams,CLAY,3,Paul-Henri Mathieu,Gilles Simon,Paul-Henri Mathieu,3-6; 6-4; 6-1; 7-6(2),R64,218,4,2,84,137,63,84,22,53,6,10,19,85,137,9,4,92,160,53,92,34,68,12,18,19,87,160
2007-05-28 00:00:00.000,Roland Garros France Grand Slams,CLAY,3,Igor Andreev,Nicolas Massu,Igor Andreev,6-3; 3-6; 6-3; 7-5,R64,178,4,3,75,106,57,75,14,31,3,7,20,71,106,2,5,88,143,47,88,33,55,11,17,19,80,143
2007-05-28 00:00:00.000,Roland Garros France Grand Slams,CLAY,3,Jonas Bjorkman,Ivo Karlovic,Jonas Bjorkman,3-6; 3-6; 6-4; 7-6(2); 6-3,R64,202,5,1,103,159,75,103,35,56,12,15,25,110,159,32,3,100,144,82,100,18,44,10,12,24,100,144
2007-05-28 00:00:00.000,Roland Garros France Grand Slams,CLAY,3,Oscar Hernandez,Philipp Kohlschreiber,Oscar Hernandez,7-6(8); 6-1; 6-1,R64,131,8,0,66,98,46,66,21,32,6,7,13,67,98,1,6,56,88,32,56,13,32,5,11,13,45,88
2007-05-28 00:00:00.000,Roland Garros France Grand Slams,CLAY,3,Carlos Moya,Florent Serra,Carlos Moya,6-4; 6-2; 6-4,R64,109,6,0,48,74,39,48,18,26,2,2,14,57,74,4,4,69,112,44,69,20,43,10,14,14,64,112
2007-05-28 00:00:00.000,Roland Garros France Grand Slams,CLAY,3,Juan Pablo Brzezicki,Guillermo Garcia-Lopez,Juan Pablo Brzezicki,7-6(4); 6-2; 6-0,R64,136,1,1,61,93,43,61,16,32,5,7,13,59,93,1,0,56,89,31,56,13,33,7,14,13,44,89
2007-05-28 00:00:00.000,Roland Garros France Grand Slams,CLAY,3,Lleyton Hewitt,Gaston Gaudio,Lleyton Hewitt,4-6; 3-6; 6-2; 6-4; 6-2,R64,208,20,3,81,143,57,81,37,62,4,7,23,94,143,6,13,94,132,69,94,13,38,6,11,22,82,132
2007-05-28 00:00:00.000,Roland Garros France Grand Slams,CLAY,3,Jarkko Nieminen,Mathieu Montcourt,Jarkko Nieminen,6-1; 6-1; 6-4,R64,89,1,1,44,65,34,44,13,21,1,2,12,47,65,4,1,47,70,23,47,9,23,5,12,12,32,70
2007-05-28 00:00:00.000,Roland Garros France Grand Slams,CLAY,3,Albert Montanes,Ernests Gulbis,Albert Montanes,6-1; 6-2; 1-6; 7-6(3),R64,119,3,2,63,101,44,63,25,38,4,7,17,69,101,12,6,66,106,48,66,16,40,5,10,17,64,106
2007-05-28 00:00:00.000,Roland Garros France Grand Slams,CLAY,3,Rafael Nadal,Flavio Cipolla,Rafael Nadal,6-2; 6-1; 6-4,R64,113,4,4,55,73,43,55,6,18,2,4,13,49,73,0,2,56,82,27,56,12,26,3,10,12,39,82
2007-05-28 00:00:00.000,Roland Garros France Grand Slams,CLAY,3,Roger Federer,Potito Starace,Roger Federer,6-2; 6-3; 6-0,R32,91,5,2,47,76,39,47,15,29,3,3,12,54,76,1,2,40,69,20,40,14,29,5,11,11,34,69
2007-05-28 00:00:00.000,Roland Garros France Grand Slams,CLAY,3,Mikhail Youzhny,Juan Carlos Ferrero,Mikhail Youzhny,6-7(3); 7-6(3); 6-2; 6-2,R32,207,12,1,86,137,62,86,25,51,4,9,20,87,137,2,1,91,143,53,91,23,52,9,18,20,76,143
2007-05-28 00:00:00.000,Roland Garros France Grand Slams,CLAY,3,Tommy Robredo,Janko Tipsarevic,Tommy Robredo,6-3; 6-4; 6-0,R32,102,3,0,47,72,35,47,19,25,0,0,13,54,72,3,0,49,80,28,49,13,31,1,6,12,41,80
2007-05-28 00:00:00.000,Roland Garros France Grand Slams,CLAY,3,Filippo Volandri,Ivan Ljubicic,Filippo Volandri,6-4; 6-7(4); 4-6; 6-3; 6-4,R32,231,0,3,137,171,86,137,20,34,4,9,26,106,171,16,3,93,157,61,93,34,64,8,15,25,95,157
2007-05-28 00:00:00.000,Roland Garros France Grand Slams,CLAY,3,Nikolay Davydenko,Michael Llodra,Nikolay Davydenko,6-4; 6-2; 6-4,R32,113,3,6,57,72,47,57,8,15,0,1,14,55,72,6,3,65,99,36,65,17,34,9,14,14,53,99
2007-05-28 00:00:00.000,Roland Garros France Grand Slams,CLAY,3,David Nalbandian,Gael Monfils,David Nalbandian,7-6(5); 5-7; 6-4; 7-6(5),R32,214,3,6,99,166,74,99,38,67,8,10,23,112,166,25,3,102,158,74,102,30,56,8,10,23,104,158
2007-05-28 00:00:00.000,Roland Garros France Grand Slams,CLAY,3,Guillermo Canas,Kristof Vliegen,Guillermo Canas,6-2; 6-2; 2-6; 6-3,R32,145,3,0,49,87,40,49,20,38,1,4,16,60,87,2,0,64,100,41,64,17,36,6,13,17,58,100
2007-05-28 00:00:00.000,Roland Garros France Grand Slams,CLAY,3,Juan Monaco,Edouard Roger-Vasselin,Juan Monaco,6-4; 6-2; 6-4,R32,103,8,2,52,78,40,52,16,26,1,2,14,56,78,3,1,64,93,41,64,13,29,4,9,14,54,93
2007-05-28 00:00:00.000,Roland Garros France Grand Slams,CLAY,3,Novak Djokovic,Olivier Patience,Novak Djokovic,7-6(2); 2-6; 3-6; 7-6(4); 6-3,R32,244,11,3,94,159,66,94,41,65,7,12,26,107,159,8,6,96,171,68,96,45,75,14,16,24,113,171
2007-05-28 00:00:00.000,Roland Garros France Grand Slams,CLAY,3,Fernando Verdasco,David Ferrer,Fernando Verdasco,4-6; 7-6(2); 6-3; 6-3,R32,196,4,7,96,140,63,96,24,44,8,12,20,87,140,6,4,108,151,65,108,19,43,12,18,20,84,151
2007-05-28 00:00:00.000,Roland Garros France Grand Slams,CLAY,3,Marcos Baghdatis,Jan Hajek,Marcos Baghdatis,6-2; 6-2 RET,R32,58,7,5,21,48,20,21,12,27,3,4,8,32,48,0,1,27,42,11,27,8,15,1,6,8,19,42
2007-05-28 00:00:00.000,Roland Garros France Grand Slams,CLAY,3,Igor Andreev,Paul-Henri Mathieu,Igor Andreev,7-6(4); 6-0; 6-3,R32,130,3,1,69,98,42,69,21,29,9,11,14,63,98,3,1,44,80,26,44,15,36,5,11,13,41,80
2007-05-28 00:00:00.000,Roland Garros France Grand Slams,CLAY,3,Jonas Bjorkman,Oscar Hernandez,Jonas Bjorkman,6-7(3); 6-3; 6-0; 6-1,R32,154,6,2,70,121,50,70,29,51,8,10,17,79,121,3,7,65,104,37,65,15,39,4,13,17,52,104
2007-05-28 00:00:00.000,Roland Garros France Grand Slams,CLAY,3,Carlos Moya,Juan Pablo Brzezicki,Carlos Moya,6-1; 6-3; 7-5,R32,110,4,0,49,80,40,49,15,31,2,4,14,55,80,1,1,70,93,37,70,11,23,10,17,14,48,93
2007-05-28 00:00:00.000,Roland Garros France Grand Slams,CLAY,3,Lleyton Hewitt,Jarkko Nieminen,Lleyton Hewitt,1-6; 6-3; 7-5; 6-2,R32,178,11,4,66,127,57,66,22,61,6,9,18,79,127,4,3,68,113,47,68,23,45,6,11,18,70,113
2007-05-28 00:00:00.000,Roland Garros France Grand Slams,CLAY,3,Rafael Nadal,Albert Montanes,Rafael Nadal,6-1; 6-3; 6-2,R32,141,3,1,55,80,40,55,16,25,9,9,12,56,80,3,13,64,126,41,64,21,62,13,19,12,62,126
2007-05-28 00:00:00.000,Roland Garros France Grand Slams,CLAY,3,Roger Federer,Mikhail Youzhny,Roger Federer,7-6(3); 6-4; 6-4,R16,145,1,2,50,100,35,50,33,50,6,8,16,68,100,3,2,54,110,33,54,31,56,4,8,16,64,110
2007-05-28 00:00:00.000,Roland Garros France Grand Slams,CLAY,3,Tommy Robredo,Filippo Volandri,Tommy Robredo,6-2; 7-5; 6-1,R16,108,2,3,44,70,31,44,16,26,0,3,13,47,70,0,3,67,90,31,67,9,23,4,13,14,40,90
2007-05-28 00:00:00.000,Roland Garros France Grand Slams,CLAY,3,Nikolay Davydenko,David Nalbandian,Nikolay Davydenko,6-3; 7-6(1); 3-6; 7-6(2),R16,204,3,7,103,150,73,103,22,47,15,19,20,95,150,1,5,104,157,61,104,28,53,7,12,22,89,157
2007-05-28 00:00:00.000,Roland Garros France Grand Slams,CLAY,3,Guillermo Canas,Juan Monaco,Guillermo Canas,6-0; 6-4; 6-2,R16,124,3,4,31,67,25,31,19,36,2,4,12,44,67,1,1,46,77,15,46,16,31,4,12,12,31,77
2007-05-28 00:00:00.000,Roland Garros France Grand Slams,CLAY,3,Novak Djokovic,Fernando Verdasco,Novak Djokovic,6-3; 6-3; 7-6(1),R16,165,9,1,81,113,55,81,19,32,6,7,15,74,113,3,2,86,116,55,86,12,30,15,19,15,67,116
2007-05-28 00:00:00.000,Roland Garros France Grand Slams,CLAY,3,Igor Andreev,Marcos Baghdatis,Igor Andreev,2-6; 6-1; 6-3; 6-4,R16,148,0,3,78,106,51,78,16,28,3,7,17,67,106,4,2,53,110,38,53,25,57,5,12,17,63,110
2007-05-28 00:00:00.000,Roland Garros France Grand Slams,CLAY,3,Carlos Moya,Jonas Bjorkman,Carlos Moya,7-6(5); 6-2; 7-5,R16,158,3,9,59,110,43,59,28,51,11,14,16,71,110,3,1,58,113,34,58,27,55,7,13,16,61,113
2007-05-28 00:00:00.000,Roland Garros France Grand Slams,CLAY,3,Rafael Nadal,Lleyton Hewitt,Rafael Nadal,6-3; 6-1; 7-6(5),R16,141,4,1,62,87,48,62,11,25,4,6,14,59,87,8,3,47,82,31,47,12,35,3,9,14,43,82
2007-05-28 00:00:00.000,Roland Garros France Grand Slams,CLAY,3,Roger Federer,Tommy Robredo,Roger Federer,7-5; 1-6; 6-1; 6-2,Q,122,8,0,51,87,42,51,19,36,5,9,17,61,87,2,2,78,102,43,78,12,24,4,11,17,55,102
2007-05-28 00:00:00.000,Roland Garros France Grand Slams,CLAY,3,Nikolay Davydenko,Guillermo Canas,Nikolay Davydenko,7-5; 6-4; 6-4,Q,180,6,6,74,107,51,74,16,33,4,6,16,67,107,8,1,61,116,38,61,29,55,12,17,16,67,116
2007-05-28 00:00:00.000,Roland Garros France Grand Slams,CLAY,3,Novak Djokovic,Igor Andreev,Novak Djokovic,6-3; 6-3; 6-3,Q,132,3,3,68,101,48,68,16,33,5,6,14,64,101,2,3,55,82,34,55,13,27,5,10,13,47,82
2007-05-28 00:00:00.000,Roland Garros France Grand Slams,CLAY,3,Rafael Nadal,Carlos Moya,Rafael Nadal,6-4; 6-3; 6-0,Q,122,0,0,54,72,38,54,12,18,3,4,12,50,72,2,3,50,89,29,50,15,39,5,12,13,44,89
2007-05-28 00:00:00.000,Roland Garros France Grand Slams,CLAY,3,Roger Federer,Nikolay Davydenko,Roger Federer,7-5; 7-6(5); 7-6(7),S,181,10,3,71,138,56,71,31,67,14,17,18,87,138,2,5,95,140,60,95,24,45,11,15,18,84,140
2007-05-28 00:00:00.000,Roland Garros France Grand Slams,CLAY,3,Rafael Nadal,Novak Djokovic,Rafael Nadal,7-5; 6-4; 6-2,S,148,3,1,61,86,45,61,15,25,4,6,15,60,86,3,1,68,95,39,68,10,27,3,9,15,49,95
2007-05-28 00:00:00.000,Roland Garros France Grand Slams,CLAY,3,Rafael Nadal,Roger Federer,Rafael Nadal,6-3; 4-6; 6-3; 6-4,F,190,2,1,106,137,74,106,17,31,16,17,19,91,137,9,1,76,118,50,76,23,42,6,10,19,73,118
2007-06-11 00:00:00.000,Halle Germany ATP World Tour,GRASS,2,Andrei Pavel,Olivier Rochus,Andrei Pavel,6-3; 7-6(5),R32,90,14,4,42,73,34,42,15,31,1,1,10,49,73,3,2,38,61,28,38,13,23,1,3,11,41,61
2007-06-11 00:00:00.000,Halle Germany ATP World Tour,GRASS,2,Jarkko Nieminen,Kristof Vliegen,Jarkko Nieminen,6-3; 6-1,R32,52,1,0,33,45,29,33,5,12,0,0,8,34,45,2,2,30,44,17,30,5,14,1,5,8,22,44
2007-06-11 00:00:00.000,Halle Germany ATP World Tour,GRASS,2,Benjamin Becker,Teymuraz Gabashvili,Benjamin Becker,6-4; 7-6(1),R32,99,8,1,31,61,27,31,18,30,0,1,11,45,61,5,6,44,95,35,44,19,51,12,14,11,54,95
2007-06-11 00:00:00.000,Halle Germany ATP World Tour,GRASS,2,Marc Gicquel,David Nalbandian,Marc Gicquel,5-7; 6-2; 6-4,R32,111,5,2,49,90,39,49,21,41,2,4,15,60,90,8,7,47,86,38,47,17,39,2,6,15,55,86
2007-06-11 00:00:00.000,Halle Germany ATP World Tour,GRASS,2,Tomas Berdych,Nicolas Kiefer,Tomas Berdych,6-4; 7-6(3),R32,100,9,1,36,60,31,36,15,24,2,3,11,46,60,9,4,43,80,33,43,15,37,6,8,11,48,80
2007-06-11 00:00:00.000,Halle Germany ATP World Tour,GRASS,2,Fabrice Santoro,Wesley Moodie,Fabrice Santoro,6-3; 7-6(9),R32,86,3,0,41,69,37,41,17,28,3,3,11,54,69,8,3,45,71,35,45,14,26,4,5,10,49,71
2007-06-11 00:00:00.000,Halle Germany ATP World Tour,GRASS,2,Simon Stadler,Mischa Zverev,Simon Stadler,6-4; 7-6(5),R32,82,2,2,47,77,33,47,16,30,3,4,11,49,77,3,1,49,63,35,49,7,14,2,4,11,42,63
2007-06-11 00:00:00.000,Halle Germany ATP World Tour,GRASS,2,Mikhail Youzhny,Michael Russell,Mikhail Youzhny,6-2; 6-2,R32,60,4,2,20,39,19,20,13,19,0,0,8,32,39,0,1,27,42,19,27,3,15,3,7,8,22,42
2007-06-11 00:00:00.000,Halle Germany ATP World Tour,GRASS,2,Aisam-Ul-Haq Qureshi,Richard Gasquet,Aisam-Ul-Haq Qureshi,7-6(8); 6-4,R32,98,12,6,47,78,38,47,15,31,6,7,11,53,78,6,2,34,64,25,34,20,30,1,3,11,45,64
2007-06-11 00:00:00.000,Halle Germany ATP World Tour,GRASS,2,Philipp Kohlschreiber,Raemon Sluiter,Philipp Kohlschreiber,7-6(5); 7-5,R32,95,9,2,42,77,35,42,21,35,2,2,12,56,77,12,5,42,71,34,42,16,29,0,1,12,50,71
2007-06-11 00:00:00.000,Halle Germany ATP World Tour,GRASS,2,Evgeny Korolev,Stanislas Wawrinka,Evgeny Korolev,3-6; 6-3; 6-4,R32,115,6,2,50,89,33,50,21,39,3,6,14,54,89,8,4,52,84,37,52,13,32,3,7,14,50,84
2007-06-11 00:00:00.000,Halle Germany ATP World Tour,GRASS,2,James Blake,Sam Querrey,James Blake,4-6; 6-4; 6-3,R32,94,12,5,57,98,45,57,19,41,9,12,15,64,98,15,5,42,81,31,42,16,39,5,9,14,47,81
2007-06-11 00:00:00.000,Halle Germany ATP World Tour,GRASS,2,Marcos Baghdatis,Gilles Simon,Marcos Baghdatis,6-3; 6-3,R32,70,6,2,28,51,21,28,15,23,1,2,9,36,51,2,6,38,65,25,38,9,27,3,7,9,34,65
2007-06-11 00:00:00.000,Halle Germany ATP World Tour,GRASS,2,Robin Soderling,Stefan Koubek,Robin Soderling,5-7; 6-3; 7-5,R32,113,14,4,73,96,56,73,11,23,6,7,16,67,96,5,4,70,112,45,70,24,42,6,9,17,69,112
2007-06-11 00:00:00.000,Halle Germany ATP World Tour,GRASS,2,Florian Mayer,Michael Kohlmann,Florian Mayer,7-6(4); 7-5,R32,87,5,3,46,74,38,46,15,28,4,5,12,53,74,7,5,50,77,39,50,12,27,1,3,12,51,77
2007-06-11 00:00:00.000,Halle Germany ATP World Tour,GRASS,2,Nikolay Davydenko,Jurgen Melzer,Nikolay Davydenko,7-6(6); 4-6; 6-2,R32,120,15,10,58,91,51,58,12,33,1,3,15,63,91,6,5,57,94,40,57,18,37,3,6,15,58,94
2007-06-11 00:00:00.000,Halle Germany ATP World Tour,GRASS,2,Jarkko Nieminen,Andrei Pavel,Jarkko Nieminen,7-6(5); 3-6; 6-1,R16,110,3,4,48,78,36,48,15,30,1,5,14,51,78,8,3,53,92,38,53,14,39,6,11,14,52,92
2007-06-11 00:00:00.000,Halle Germany ATP World Tour,GRASS,2,Marc Gicquel,Benjamin Becker,Marc Gicquel,6-2; 7-6(5),R16,95,10,2,42,67,34,42,16,25,6,6,10,50,67,7,0,32,70,26,32,19,38,6,8,10,45,70
2007-06-11 00:00:00.000,Halle Germany ATP World Tour,GRASS,2,Tomas Berdych,Fabrice Santoro,Tomas Berdych,6-3; 7-6(5),R16,86,9,3,37,63,29,37,18,26,2,2,10,47,63,5,2,40,71,29,40,16,31,1,3,11,45,71
2007-06-11 00:00:00.000,Halle Germany ATP World Tour,GRASS,2,Mikhail Youzhny,Simon Stadler,Mikhail Youzhny,6-4; 1-6; 6-3,R16,122,7,1,61,92,43,61,14,31,4,7,13,57,92,5,2,54,86,39,54,14,32,7,10,13,53,86
2007-06-11 00:00:00.000,Halle Germany ATP World Tour,GRASS,2,Philipp Kohlschreiber,Aisam-Ul-Haq Qureshi,Philipp Kohlschreiber,6-4; 6-3,R16,73,6,1,31,53,27,31,13,22,0,0,9,40,53,5,2,40,55,27,40,8,15,4,7,10,35,55
2007-06-11 00:00:00.000,Halle Germany ATP World Tour,GRASS,2,James Blake,Evgeny Korolev,James Blake,7-5; 6-1,R16,65,16,3,32,55,29,32,12,23,0,0,10,41,55,0,4,39,67,27,39,11,28,6,9,9,38,67
2007-06-11 00:00:00.000,Halle Germany ATP World Tour,GRASS,2,Marcos Baghdatis,Robin Soderling,Marcos Baghdatis,6-7(9); 6-4; 6-3,R16,121,14,0,51,96,43,51,26,45,2,4,16,69,96,7,5,59,98,46,59,17,39,4,8,15,63,98
2007-06-11 00:00:00.000,Halle Germany ATP World Tour,GRASS,2,Florian Mayer,Nikolay Davydenko,Florian Mayer,6-4; 6-4,R16,71,3,3,30,54,22,30,18,24,3,4,10,40,54,3,5,30,62,25,30,14,32,1,4,10,39,62
2007-06-11 00:00:00.000,Halle Germany ATP World Tour,GRASS,2,Jarkko Nieminen,Marc Gicquel,Jarkko Nieminen,6-4 RET,Q,31,3,0,18,32,14,18,7,14,0,0,5,21,32,3,0,15,23,12,15,5,8,0,1,5,17,23
2007-06-11 00:00:00.000,Halle Germany ATP World Tour,GRASS,2,Tomas Berdych,Mikhail Youzhny,Tomas Berdych,W/O,Q,0,0,0,0,0,0,0,0,0,0,0,0,0,0,0,0,0,0,0,0,0,0,0,0,0,0,0
2007-06-11 00:00:00.000,Halle Germany ATP World Tour,GRASS,2,Philipp Kohlschreiber,James Blake,Philipp Kohlschreiber,6-4; 6-3,Q,72,5,0,29,52,26,29,15,23,0,0,10,41,52,10,4,29,59,22,29,13,30,2,4,9,35,59
2007-06-11 00:00:00.000,Halle Germany ATP World Tour,GRASS,2,Marcos Baghdatis,Florian Mayer,Marcos Baghdatis,6-3; 6-3,Q,59,9,0,32,52,26,32,14,20,1,1,9,40,52,1,0,39,51,23,39,7,12,2,5,9,30,51
2007-06-11 00:00:00.000,Halle Germany ATP World Tour,GRASS,2,Tomas Berdych,Jarkko Nieminen,Tomas Berdych,7-6(5); 6-4,S,84,7,4,37,65,31,37,16,28,2,3,11,47,65,4,1,44,75,30,44,18,31,4,6,11,48,75
2007-06-11 00:00:00.000,Halle Germany ATP World Tour,GRASS,2,Marcos Baghdatis,Philipp Kohlschreiber,Marcos Baghdatis,7-6(1); 6-4,S,101,6,2,35,66,30,35,17,31,6,7,11,47,66,6,2,54,92,35,54,19,38,9,11,11,54,92
2007-06-11 00:00:00.000,Halle Germany ATP World Tour,GRASS,2,Tomas Berdych,Marcos Baghdatis,Tomas Berdych,7-5; 6-4,F,81,8,2,37,63,35,37,14,26,3,3,11,49,63,4,2,40,67,33,40,11,27,3,5,11,44,67
2007-06-11 00:00:00.000,London / Queen's Club Great Britain ATP World Tour,GRASS,2,Rafael Nadal,N/A Bye,Rafael Nadal,,R64,0,0,0,0,0,0,0,0,0,0,0,0,0,0,0,0,0,0,0,0,0,0,0,0,0,0,0
2007-06-11 00:00:00.000,London / Queen's Club Great Britain ATP World Tour,GRASS,2,Juan Martin Del Potro,Thomas Johansson,Juan Martin Del Potro,6-2; 6-4,R64,59,7,0,26,40,25,26,11,14,0,0,9,36,40,6,0,37,54,23,37,7,17,0,3,9,30,54
2007-06-11 00:00:00.000,London / Queen's Club Great Britain ATP World Tour,GRASS,2,Gael Monfils,Igor Andreev,Gael Monfils,6-3; 6-4,R64,49,14,3,27,49,25,27,15,22,0,0,10,40,49,2,1,33,49,22,33,11,16,1,3,9,33,49
2007-06-11 00:00:00.000,London / Queen's Club Great Britain ATP World Tour,GRASS,2,Max Mirnyi,Fernando Verdasco,Max Mirnyi,6-3; 6-3,R64,64,7,1,35,49,28,35,6,14,1,2,9,34,49,5,5,46,62,29,46,4,16,3,7,9,33,62
2007-06-11 00:00:00.000,London / Queen's Club Great Britain ATP World Tour,GRASS,2,Jonas Bjorkman,Justin Gimelstob,Jonas Bjorkman,6-3; 3-6; 6-1,R64,104,4,4,51,84,37,51,16,33,5,8,13,53,84,7,5,48,75,29,48,12,27,6,11,12,41,75
2007-06-11 00:00:00.000,London / Queen's Club Great Britain ATP World Tour,GRASS,2,Nicolas Mahut,Igor Kunitsyn,Nicolas Mahut,6-4; 6-4,R64,79,5,4,28,45,23,28,11,17,1,3,10,34,45,4,6,37,69,24,37,12,32,3,7,10,36,69
2007-06-11 00:00:00.000,London / Queen's Club Great Britain ATP World Tour,GRASS,2,Danai Udomchoke,Oscar Hernandez,Danai Udomchoke,6-2; 6-3,R64,58,3,2,31,49,26,31,10,18,0,0,9,36,49,2,0,28,49,18,28,8,21,3,6,8,26,49
2007-06-11 00:00:00.000,London / Queen's Club Great Britain ATP World Tour,GRASS,2,Ivan Ljubicic,N/A Bye,Ivan Ljubicic,,R64,0,0,0,0,0,0,0,0,0,0,0,0,0,0,0,0,0,0,0,0,0,0,0,0,0,0,0
2007-06-11 00:00:00.000,London / Queen's Club Great Britain ATP World Tour,GRASS,2,Novak Djokovic,N/A Bye,Novak Djokovic,,R64,0,0,0,0,0,0,0,0,0,0,0,0,0,0,0,0,0,0,0,0,0,0,0,0,0,0,0
2007-06-11 00:00:00.000,London / Queen's Club Great Britain ATP World Tour,GRASS,2,Robert Kendrick,Ernests Gulbis,Robert Kendrick,7-6(5); 7-6(8),R64,86,7,6,47,87,39,47,25,40,4,5,12,64,87,15,5,56,80,48,56,11,24,4,5,12,59,80
2007-06-11 00:00:00.000,London / Queen's Club Great Britain ATP World Tour,GRASS,2,Chris Guccione,Andreas Seppi,Chris Guccione,7-6(4); 6-4,R64,80,11,3,39,73,36,39,13,34,1,2,11,49,73,8,1,43,69,31,43,14,26,1,3,11,45,69
2007-06-11 00:00:00.000,London / Queen's Club Great Britain ATP World Tour,GRASS,2,Arnaud Clement,Ivan Navarro,Arnaud Clement,7-6(2); 6-4,R64,111,2,7,41,73,32,41,15,32,3,5,11,47,73,11,7,54,96,36,54,18,42,9,12,11,54,96
2007-06-11 00:00:00.000,London / Queen's Club Great Britain ATP World Tour,GRASS,2,Ivo Karlovic,Mardy Fish,Ivo Karlovic,6-3; 6-4,R64,66,19,2,43,62,36,43,9,19,2,2,10,45,62,6,2,19,43,16,19,15,24,0,2,9,31,43
2007-06-11 00:00:00.000,London / Queen's Club Great Britain ATP World Tour,GRASS,2,Alex Kuznetsov,Frederik Nielsen,Alex Kuznetsov,7-5; 6-3,R64,83,11,4,35,67,26,35,16,32,2,4,11,42,67,4,5,45,76,31,45,9,31,8,12,10,40,76
2007-06-11 00:00:00.000,London / Queen's Club Great Britain ATP World Tour,GRASS,2,Sebastien Grosjean,Michael Berrer,Sebastien Grosjean,6-4; 6-2,R64,62,7,1,28,40,24,28,8,12,0,1,9,32,40,5,2,41,65,30,41,4,24,5,9,9,34,65
2007-06-11 00:00:00.000,London / Queen's Club Great Britain ATP World Tour,GRASS,2,Marat Safin,N/A Bye,Marat Safin,,R64,0,0,0,0,0,0,0,0,0,0,0,0,0,0,0,0,0,0,0,0,0,0,0,0,0,0,0
2007-06-11 00:00:00.000,London / Queen's Club Great Britain ATP World Tour,GRASS,2,Dmitry Tursunov,N/A Bye,Dmitry Tursunov,,R64,0,0,0,0,0,0,0,0,0,0,0,0,0,0,0,0,0,0,0,0,0,0,0,0,0,0,0
2007-06-11 00:00:00.000,London / Queen's Club Great Britain ATP World Tour,GRASS,2,Frank Dancevic,Sergio Roitman,Frank Dancevic,6-3; 6-7(5); 6-1,R64,93,11,0,61,87,49,61,16,26,1,1,15,65,87,2,4,51,84,39,51,15,33,5,8,13,54,84
2007-06-11 00:00:00.000,London / Queen's Club Great Britain ATP World Tour,GRASS,2,Michael Llodra,Yen-Hsun Lu,Michael Llodra,6-1; 6-1,R64,41,6,1,26,35,24,26,4,9,0,0,7,28,35,1,2,24,38,11,24,4,14,3,8,7,15,38
2007-06-11 00:00:00.000,London / Queen's Club Great Britain ATP World Tour,GRASS,2,Paul-Henri Mathieu,Feliciano Lopez,Paul-Henri Mathieu,6-3; 6-7(5); 6-3,R64,131,13,5,58,94,51,58,18,36,1,1,16,69,94,17,8,61,105,50,61,17,44,5,7,14,67,105
2007-06-11 00:00:00.000,London / Queen's Club Great Britain ATP World Tour,GRASS,2,Robby Ginepri,Richard Bloomfield,Robby Ginepri,6-4; 6-2,R64,61,5,0,30,45,24,30,10,15,0,1,9,34,45,5,3,32,55,21,32,8,23,3,7,9,29,55
2007-06-11 00:00:00.000,London / Queen's Club Great Britain ATP World Tour,GRASS,2,Florent Serra,Amer Delic,Florent Serra,6-7(5); 6-4; 6-4,R64,105,6,0,59,84,54,59,13,25,0,0,16,67,84,19,4,60,100,49,60,21,40,5,7,16,70,100
2007-06-11 00:00:00.000,London / Queen's Club Great Britain ATP World Tour,GRASS,2,Janko Tipsarevic,Dusan Vemic,Janko Tipsarevic,4-6; 6-3; 7-5,R64,107,6,2,49,85,43,49,21,36,2,3,16,64,85,17,7,48,79,42,48,15,31,1,3,15,57,79
2007-06-11 00:00:00.000,London / Queen's Club Great Britain ATP World Tour,GRASS,2,Fernando Gonzalez,N/A Bye,Fernando Gonzalez,,R64,0,0,0,0,0,0,0,0,0,0,0,0,0,0,0,0,0,0,0,0,0,0,0,0,0,0,0
2007-06-11 00:00:00.000,London / Queen's Club Great Britain ATP World Tour,GRASS,2,Lleyton Hewitt,N/A Bye,Lleyton Hewitt,,R64,0,0,0,0,0,0,0,0,0,0,0,0,0,0,0,0,0,0,0,0,0,0,0,0,0,0,0
2007-06-11 00:00:00.000,London / Queen's Club Great Britain ATP World Tour,GRASS,2,Jo-Wilfried Tsonga,Kristian Pless,Jo-Wilfried Tsonga,7-6(2); 6-0,R64,60,5,2,35,55,29,35,13,20,1,2,9,42,55,3,4,34,62,21,34,10,28,5,9,9,31,62
2007-06-11 00:00:00.000,London / Queen's Club Great Britain ATP World Tour,GRASS,2,Marin Cilic,Tim Henman,Marin Cilic,7-6(5); 2-6; 6-4,R64,139,6,2,58,103,35,58,22,45,7,12,15,57,103,5,3,61,101,34,61,26,40,6,10,15,60,101
2007-06-11 00:00:00.000,London / Queen's Club Great Britain ATP World Tour,GRASS,2,Alejandro Falla,Julien Benneteau,Alejandro Falla,7-5; 6-3,R64,96,4,0,40,66,29,40,15,26,4,5,10,44,66,4,5,44,82,27,44,17,38,7,11,11,44,82
2007-06-11 00:00:00.000,London / Queen's Club Great Britain ATP World Tour,GRASS,2,Alex Bogdanovic,Hyung-Taik Lee,Alex Bogdanovic,6-4; 6-4,R64,77,8,0,50,69,36,50,9,19,7,8,10,45,69,4,1,35,61,22,35,15,26,5,8,10,37,61
2007-06-11 00:00:00.000,London / Queen's Club Great Britain ATP World Tour,GRASS,2,Jamie Baker,Alexander Peya,Jamie Baker,3-6; 7-6(5); 6-3,R64,138,2,3,59,100,43,59,19,41,8,11,14,62,100,7,3,69,98,46,69,15,29,6,10,16,61,98
2007-06-11 00:00:00.000,London / Queen's Club Great Britain ATP World Tour,GRASS,2,Radek Stepanek,Davide Sanguinetti,Radek Stepanek,6-2; 2-0 RET,R64,35,7,1,19,28,17,19,6,9,1,1,5,23,28,0,1,17,30,8,17,5,13,2,5,5,13,30
2007-06-11 00:00:00.000,London / Queen's Club Great Britain ATP World Tour,GRASS,2,Andy Roddick,N/A Bye,Andy Roddick,,R64,0,0,0,0,0,0,0,0,0,0,0,0,0,0,0,0,0,0,0,0,0,0,0,0,0,0,0
2007-06-11 00:00:00.000,London / Queen's Club Great Britain ATP World Tour,GRASS,2,Rafael Nadal,Juan Martin Del Potro,Rafael Nadal,6-4; 6-4,R32,67,4,0,34,46,30,34,10,12,0,0,10,40,46,10,2,38,57,30,38,8,19,3,5,10,38,57
2007-06-11 00:00:00.000,London / Queen's Club Great Britain ATP World Tour,GRASS,2,Max Mirnyi,Gael Monfils,Max Mirnyi,6-7(2); 6-2; 7-5,R32,128,2,6,57,93,42,57,20,36,5,8,16,62,93,10,4,65,107,42,65,19,42,5,11,16,61,107
2007-06-11 00:00:00.000,London / Queen's Club Great Britain ATP World Tour,GRASS,2,Nicolas Mahut,Jonas Bjorkman,Nicolas Mahut,6-3; 6-7(2); 6-3,R32,138,13,3,56,93,40,56,23,37,3,4,14,63,93,4,8,68,111,47,68,20,43,14,19,16,67,111
2007-06-11 00:00:00.000,London / Queen's Club Great Britain ATP World Tour,GRASS,2,Ivan Ljubicic,Danai Udomchoke,Ivan Ljubicic,6-3; 6-4,R32,69,12,3,34,58,28,34,14,24,2,2,10,42,58,6,2,44,65,29,44,11,21,8,10,9,40,65
2007-06-11 00:00:00.000,London / Queen's Club Great Britain ATP World Tour,GRASS,2,Novak Djokovic,Robert Kendrick,Novak Djokovic,3-6; 6-3; 6-2,R32,94,6,1,54,84,39,54,18,30,3,4,13,57,84,8,6,46,73,37,46,8,27,4,7,13,45,73
2007-06-11 00:00:00.000,London / Queen's Club Great Britain ATP World Tour,GRASS,2,Arnaud Clement,Chris Guccione,Arnaud Clement,6-4; 6-4,R32,79,9,3,41,65,33,41,13,24,4,4,10,46,65,13,4,38,62,27,38,12,24,2,4,10,39,62
2007-06-11 00:00:00.000,London / Queen's Club Great Britain ATP World Tour,GRASS,2,Ivo Karlovic,Alex Kuznetsov,Ivo Karlovic,2-6; 6-2; 7-6(2),R32,108,18,3,51,76,42,51,14,25,1,3,14,56,76,3,5,49,89,34,49,23,40,3,5,14,57,89
2007-06-11 00:00:00.000,London / Queen's Club Great Britain ATP World Tour,GRASS,2,Marat Safin,Sebastien Grosjean,Marat Safin,3-6; 6-4; 6-4,R32,104,5,2,45,78,38,45,17,33,3,5,14,55,78,1,3,46,79,34,46,18,33,1,4,15,52,79
2007-06-11 00:00:00.000,London / Queen's Club Great Britain ATP World Tour,GRASS,2,Dmitry Tursunov,Frank Dancevic,Dmitry Tursunov,7-5; 6-1,R32,72,6,4,34,55,26,34,11,21,4,5,9,37,55,6,3,31,59,18,31,10,28,2,7,10,28,59
2007-06-11 00:00:00.000,London / Queen's Club Great Britain ATP World Tour,GRASS,2,Paul-Henri Mathieu,Michael Llodra,Paul-Henri Mathieu,7-6(4) RET,R32,66,2,1,25,45,17,25,14,20,1,1,6,31,45,7,4,28,47,23,28,9,19,3,3,6,32,47
2007-06-11 00:00:00.000,London / Queen's Club Great Britain ATP World Tour,GRASS,2,Robby Ginepri,Florent Serra,Robby Ginepri,6-4; 7-6(3),R32,81,11,4,38,70,33,38,20,32,1,1,11,53,70,7,2,43,79,31,43,20,36,8,9,11,51,79
2007-06-11 00:00:00.000,London / Queen's Club Great Britain ATP World Tour,GRASS,2,Fernando Gonzalez,Janko Tipsarevic,Fernando Gonzalez,7-6(7); 4-6; 7-6(7),R32,151,19,4,67,111,57,67,23,44,1,3,17,80,111,18,3,66,116,59,66,24,50,3,4,17,83,116
2007-06-11 00:00:00.000,London / Queen's Club Great Britain ATP World Tour,GRASS,2,Jo-Wilfried Tsonga,Lleyton Hewitt,Jo-Wilfried Tsonga,7-6(5); 7-6(2),R32,101,12,0,45,79,35,45,21,34,1,3,12,56,79,12,1,60,87,42,60,15,27,3,5,12,57,87
2007-06-11 00:00:00.000,London / Queen's Club Great Britain ATP World Tour,GRASS,2,Marin Cilic,Alejandro Falla,Marin Cilic,6-3; 6-4,R32,67,9,2,34,58,28,34,14,24,0,0,10,42,58,1,0,37,51,25,37,7,14,0,2,9,32,51
2007-06-11 00:00:00.000,London / Queen's Club Great Britain ATP World Tour,GRASS,2,Alex Bogdanovic,Jamie Baker,Alex Bogdanovic,4-6; 7-6(4); 6-3,R32,142,8,3,71,111,53,71,17,40,5,8,15,70,111,5,3,72,100,46,72,14,28,3,7,16,60,100
2007-06-11 00:00:00.000,London / Queen's Club Great Britain ATP World Tour,GRASS,2,Andy Roddick,Radek Stepanek,Andy Roddick,6-4; 6-4,R32,66,12,0,31,44,30,31,10,13,0,0,10,40,44,8,3,36,60,27,36,11,24,1,3,10,38,60
2007-06-11 00:00:00.000,London / Queen's Club Great Britain ATP World Tour,GRASS,2,Rafael Nadal,Max Mirnyi,Rafael Nadal,7-6(3); 6-3,R16,74,4,0,38,58,33,38,16,20,0,0,11,49,58,8,3,40,55,32,40,8,15,0,1,10,40,55
2007-06-11 00:00:00.000,London / Queen's Club Great Britain ATP World Tour,GRASS,2,Nicolas Mahut,Ivan Ljubicic,Nicolas Mahut,7-6(3); 6-3,R16,84,10,5,42,73,36,42,13,31,2,3,11,49,73,13,3,35,59,29,35,11,24,1,3,10,40,59
2007-06-11 00:00:00.000,London / Queen's Club Great Britain ATP World Tour,GRASS,2,Arnaud Clement,Novak Djokovic,Arnaud Clement,2-6; 6-3; 6-4,R16,113,2,0,58,91,47,58,13,33,7,9,14,60,91,18,4,48,77,38,48,14,29,6,8,13,52,77
2007-06-11 00:00:00.000,London / Queen's Club Great Britain ATP World Tour,GRASS,2,Ivo Karlovic,Marat Safin,Ivo Karlovic,7-6(3); 7-6(4),R16,102,22,2,53,70,47,53,11,17,0,0,12,58,70,9,2,54,87,43,54,17,33,5,5,12,60,87
2007-06-11 00:00:00.000,London / Queen's Club Great Britain ATP World Tour,GRASS,2,Dmitry Tursunov,Paul-Henri Mathieu,Dmitry Tursunov,7-6(3); 3-6; 6-3,R16,137,10,4,63,106,44,63,20,43,6,10,15,64,106,8,7,40,95,28,40,29,55,3,7,15,57,95
2007-06-11 00:00:00.000,London / Queen's Club Great Britain ATP World Tour,GRASS,2,Fernando Gonzalez,Robby Ginepri,Fernando Gonzalez,6-2; 7-5,R16,67,9,1,37,55,27,37,14,18,0,0,10,41,55,7,0,36,61,25,36,12,25,3,6,10,37,61
2007-06-11 00:00:00.000,London / Queen's Club Great Britain ATP World Tour,GRASS,2,Marin Cilic,Jo-Wilfried Tsonga,Marin Cilic,4-6; 6-3; 6-2,R16,114,9,6,62,98,47,62,16,36,8,9,14,63,98,8,2,54,90,37,54,19,36,5,8,13,56,90
2007-06-11 00:00:00.000,London / Queen's Club Great Britain ATP World Tour,GRASS,2,Andy Roddick,Alex Bogdanovic,Andy Roddick,4-6; 7-6(5); 6-4,R16,110,22,1,67,89,57,67,14,22,2,3,16,71,89,8,4,56,94,41,56,25,38,1,2,16,66,94
2007-06-11 00:00:00.000,London / Queen's Club Great Britain ATP World Tour,GRASS,2,Nicolas Mahut,Rafael Nadal,Nicolas Mahut,7-5; 7-6(0),Q,115,11,7,51,83,39,51,17,32,7,8,12,56,83,2,4,49,80,36,49,14,31,3,5,12,50,80
2007-06-11 00:00:00.000,London / Queen's Club Great Britain ATP World Tour,GRASS,2,Arnaud Clement,Ivo Karlovic,Arnaud Clement,7-5; 6-4,Q,88,3,2,45,61,38,45,10,16,1,1,11,48,61,16,4,43,72,31,43,15,29,6,8,11,46,72
2007-06-11 00:00:00.000,London / Queen's Club Great Britain ATP World Tour,GRASS,2,Dmitry Tursunov,Fernando Gonzalez,Dmitry Tursunov,6-3; 6-7(5); 6-4,Q,108,7,3,61,90,51,61,15,29,2,3,16,66,90,9,4,61,89,46,61,14,28,4,7,15,60,89
2007-06-11 00:00:00.000,London / Queen's Club Great Britain ATP World Tour,GRASS,2,Andy Roddick,Marin Cilic,Andy Roddick,6-4; 7-6(5),Q,91,10,3,45,72,42,45,11,27,2,3,11,53,72,10,5,46,84,37,46,15,38,5,7,11,52,84
2007-06-11 00:00:00.000,London / Queen's Club Great Britain ATP World Tour,GRASS,2,Nicolas Mahut,Arnaud Clement,Nicolas Mahut,6-3; 7-6(4),S,103,17,5,46,71,40,46,14,25,2,2,11,54,71,4,1,30,58,25,30,19,28,1,2,10,44,58
2007-06-11 00:00:00.000,London / Queen's Club Great Britain ATP World Tour,GRASS,2,Andy Roddick,Dmitry Tursunov,Andy Roddick,6-4; 7-5,S,71,10,1,37,54,33,37,11,17,0,0,11,44,54,0,2,33,62,25,33,16,29,1,3,11,41,62
2007-06-11 00:00:00.000,London / Queen's Club Great Britain ATP World Tour,GRASS,2,Andy Roddick,Nicolas Mahut,Andy Roddick,4-6; 7-6(7); 7-6(2),F,137,24,1,64,97,57,64,23,33,0,1,17,80,97,21,4,66,110,58,66,24,44,1,1,17,82,110
2007-06-17 00:00:00.000,'s-Hertogenbosch The Netherlands ATP World Tour,GRASS,2,Tommy Robredo,Michel Koning,Tommy Robredo,6-4; 7-6(4),R32,79,3,0,38,57,33,38,16,19,0,0,11,49,57,8,3,47,74,36,47,12,27,4,5,11,48,74
2007-06-17 00:00:00.000,'s-Hertogenbosch The Netherlands ATP World Tour,GRASS,2,Kristof Vliegen,Fabrice Santoro,Kristof Vliegen,6-3; 1-1 RET,R32,52,3,2,23,38,17,23,8,15,2,3,6,25,38,1,1,11,32,7,11,10,21,3,5,5,17,32
2007-06-17 00:00:00.000,'s-Hertogenbosch The Netherlands ATP World Tour,GRASS,2,Peter Wessels,Nicolas Devilder,Peter Wessels,6-4; 6-3,R32,58,6,1,25,45,23,25,13,20,0,0,9,36,45,9,3,35,63,27,35,11,28,4,7,10,38,63
2007-06-17 00:00:00.000,'s-Hertogenbosch The Netherlands ATP World Tour,GRASS,2,Carlos Berlocq,Juan Carlos Ferrero,Carlos Berlocq,2-6; 6-3; 6-2,R32,100,9,2,52,83,40,52,16,31,5,7,13,56,83,2,1,55,79,36,55,12,24,5,8,12,48,79
2007-06-17 00:00:00.000,'s-Hertogenbosch The Netherlands ATP World Tour,GRASS,2,Yves Allegro,Kristian Pless,Yves Allegro,7-6(4); 3-6; 6-4,R32,110,12,2,67,97,49,67,17,30,7,9,15,66,97,10,2,64,103,46,64,22,39,2,4,16,68,103
2007-06-17 00:00:00.000,'s-Hertogenbosch The Netherlands ATP World Tour,GRASS,2,Benjamin Becker,Olivier Rochus,Benjamin Becker,6-3; 7-6(4),R32,102,16,5,52,98,40,52,23,46,10,10,11,63,98,5,2,36,58,28,36,11,22,0,1,10,39,58
2007-06-17 00:00:00.000,'s-Hertogenbosch The Netherlands ATP World Tour,GRASS,2,Antony Dupuis,Thiemo de Bakker,Antony Dupuis,7-5; 7-6(1),R32,105,6,0,52,69,39,52,13,17,0,1,12,52,69,3,2,65,96,43,65,13,31,9,11,12,56,96
2007-06-17 00:00:00.000,'s-Hertogenbosch The Netherlands ATP World Tour,GRASS,2,Sergio Roitman,Philipp Kohlschreiber,Sergio Roitman,6-2 RET,R32,35,1,1,11,18,11,11,5,7,0,0,4,16,18,0,3,16,31,11,16,5,15,4,6,4,16,31
2007-06-17 00:00:00.000,'s-Hertogenbosch The Netherlands ATP World Tour,GRASS,2,Julien Benneteau,Juan Ignacio Chela,Julien Benneteau,6-4; 6-4,R32,113,3,3,39,60,28,39,13,21,1,2,10,41,60,1,5,31,65,18,31,19,34,7,10,10,37,65
2007-06-17 00:00:00.000,'s-Hertogenbosch The Netherlands ATP World Tour,GRASS,2,Robin Haase,Florent Serra,Robin Haase,5-7; 6-4; 6-4,R32,96,15,4,48,85,41,48,23,37,3,4,16,64,85,6,1,64,91,49,64,15,27,3,5,16,64,91
2007-06-17 00:00:00.000,'s-Hertogenbosch The Netherlands ATP World Tour,GRASS,2,Michael Berrer,Diego Hartfield,Michael Berrer,6-3; 6-0,R32,43,7,1,30,38,28,30,4,8,0,0,8,32,38,4,0,23,33,12,23,2,10,0,4,7,14,33
2007-06-17 00:00:00.000,'s-Hertogenbosch The Netherlands ATP World Tour,GRASS,2,Guillermo Canas,Ernests Gulbis,Guillermo Canas,7-6(5); 7-5,R32,87,8,1,40,63,33,40,18,23,0,0,12,51,63,6,5,44,82,35,44,19,38,5,6,12,54,82
2007-06-17 00:00:00.000,'s-Hertogenbosch The Netherlands ATP World Tour,GRASS,2,Janko Tipsarevic,Marc Gicquel,Janko Tipsarevic,6-4; 6-2,R32,64,12,2,27,48,21,27,16,21,1,1,9,37,48,6,3,26,55,24,26,9,29,2,5,9,33,55
2007-06-17 00:00:00.000,'s-Hertogenbosch The Netherlands ATP World Tour,GRASS,2,Lukas Dlouhy,Danai Udomchoke,Lukas Dlouhy,4-6; 6-3; 6-4,R32,99,9,3,60,96,44,60,21,36,4,5,15,65,96,4,5,45,89,37,45,22,44,2,4,14,59,89
2007-06-17 00:00:00.000,'s-Hertogenbosch The Netherlands ATP World Tour,GRASS,2,Andreas Seppi,Alexander Peya,Andreas Seppi,6-4; 6-4,R32,97,4,3,39,79,28,39,18,40,3,5,10,46,79,4,5,33,72,24,33,14,39,3,7,10,38,72
2007-06-17 00:00:00.000,'s-Hertogenbosch The Netherlands ATP World Tour,GRASS,2,Ivan Ljubicic,Gael Monfils,Ivan Ljubicic,3-6; 6-3; 6-0,R32,85,9,3,45,78,34,45,20,33,4,5,12,54,78,17,6,29,65,23,29,18,36,5,9,12,41,65
2007-06-17 00:00:00.000,'s-Hertogenbosch The Netherlands ATP World Tour,GRASS,2,Tommy Robredo,Kristof Vliegen,Tommy Robredo,6-4; 6-7(3); 6-3,R16,114,10,2,60,83,53,60,15,23,0,0,16,68,83,10,5,58,95,47,58,18,37,4,6,15,65,95
2007-06-17 00:00:00.000,'s-Hertogenbosch The Netherlands ATP World Tour,GRASS,2,Peter Wessels,Carlos Berlocq,Peter Wessels,6-2; 7-6(3),R16,79,10,3,34,59,29,34,16,25,0,0,10,45,59,5,1,60,78,39,60,8,18,5,7,10,47,78
2007-06-17 00:00:00.000,'s-Hertogenbosch The Netherlands ATP World Tour,GRASS,2,Benjamin Becker,Yves Allegro,Benjamin Becker,6-4; 7-6(6),R16,80,8,3,32,59,29,32,20,27,0,0,11,49,59,5,5,54,86,38,54,17,32,7,8,11,55,86
2007-06-17 00:00:00.000,'s-Hertogenbosch The Netherlands ATP World Tour,GRASS,2,Antony Dupuis,Sergio Roitman,Antony Dupuis,6-4; 7-6(2),R16,79,8,0,46,57,38,46,10,11,0,0,11,48,57,4,0,47,68,37,47,9,21,4,5,11,46,68
2007-06-17 00:00:00.000,'s-Hertogenbosch The Netherlands ATP World Tour,GRASS,2,Julien Benneteau,Robin Haase,Julien Benneteau,7-6(5); 6-3,R16,90,5,1,43,63,32,43,17,20,3,3,11,49,63,7,6,44,75,33,44,14,31,7,8,10,47,75
2007-06-17 00:00:00.000,'s-Hertogenbosch The Netherlands ATP World Tour,GRASS,2,Michael Berrer,Guillermo Canas,Michael Berrer,3-6; 6-4; 6-4,R16,112,10,2,64,89,49,64,13,25,4,6,15,62,89,9,3,53,83,40,53,15,30,3,5,14,55,83
2007-06-17 00:00:00.000,'s-Hertogenbosch The Netherlands ATP World Tour,GRASS,2,Janko Tipsarevic,Lukas Dlouhy,Janko Tipsarevic,6-2; 2-6; 7-5,R16,95,8,3,45,84,39,45,20,39,6,8,14,59,84,7,10,58,87,45,58,12,29,2,5,14,57,87
2007-06-17 00:00:00.000,'s-Hertogenbosch The Netherlands ATP World Tour,GRASS,2,Ivan Ljubicic,Andreas Seppi,Ivan Ljubicic,6-3; 6-4,R16,58,10,1,35,48,30,35,10,13,0,0,10,40,48,7,3,23,45,18,23,12,22,0,2,9,30,45
2007-06-17 00:00:00.000,'s-Hertogenbosch The Netherlands ATP World Tour,GRASS,2,Peter Wessels,Tommy Robredo,Peter Wessels,6-3; 6-3,Q,66,5,2,41,57,34,41,6,16,2,2,9,40,57,4,2,37,59,24,37,10,22,1,4,9,34,59
2007-06-17 00:00:00.000,'s-Hertogenbosch The Netherlands ATP World Tour,GRASS,2,Antony Dupuis,Benjamin Becker,Antony Dupuis,7-6(2); 6-3,Q,83,11,0,59,79,43,59,13,20,4,4,11,56,79,14,2,39,60,29,39,11,21,2,3,10,40,60
2007-06-17 00:00:00.000,'s-Hertogenbosch The Netherlands ATP World Tour,GRASS,2,Julien Benneteau,Michael Berrer,Julien Benneteau,7-6(2); 7-5,Q,92,6,0,45,64,32,45,14,19,1,3,12,46,64,5,1,36,68,27,36,16,32,1,4,12,43,68
2007-06-17 00:00:00.000,'s-Hertogenbosch The Netherlands ATP World Tour,GRASS,2,Ivan Ljubicic,Janko Tipsarevic,Ivan Ljubicic,6-3; 6-7(8); 6-3,Q,133,25,5,86,121,64,86,17,35,11,11,16,81,121,15,10,57,92,48,57,15,35,6,8,14,63,92
2007-06-17 00:00:00.000,'s-Hertogenbosch The Netherlands ATP World Tour,GRASS,2,Peter Wessels,Antony Dupuis,Peter Wessels,7-6(5); 7-6(3),S,90,15,3,56,72,45,56,10,16,2,3,12,55,72,9,3,62,88,47,62,10,26,2,3,12,57,88
2007-06-17 00:00:00.000,'s-Hertogenbosch The Netherlands ATP World Tour,GRASS,2,Ivan Ljubicic,Julien Benneteau,Ivan Ljubicic,7-6(1); 3-6; 6-4,S,133,16,5,55,91,45,55,20,36,4,5,15,65,91,8,3,68,101,50,68,17,33,5,6,16,67,101
2007-06-17 00:00:00.000,'s-Hertogenbosch The Netherlands ATP World Tour,GRASS,2,Ivan Ljubicic,Peter Wessels,Ivan Ljubicic,7-6(5); 4-6; 7-6(4),F,121,21,1,62,102,48,62,30,40,1,2,17,78,102,13,1,69,107,57,69,25,38,5,5,17,82,107
2007-06-18 00:00:00.000,Nottingham Great Britain ATP World Tour,GRASS,2,Richard Gasquet,Vincent Spadea,Richard Gasquet,6-3; 6-4,R32,74,11,3,37,57,28,37,10,20,0,1,10,38,57,1,3,44,70,28,44,12,26,8,11,9,40,70
2007-06-18 00:00:00.000,Nottingham Great Britain ATP World Tour,GRASS,2,Jan Vacek,Nicolas Lapentti,Jan Vacek,7-6(1); 6-3,R32,88,7,1,44,66,32,44,14,22,5,7,11,46,66,10,3,37,65,27,37,11,28,3,6,10,38,65
2007-06-18 00:00:00.000,Nottingham Great Britain ATP World Tour,GRASS,2,Teymuraz Gabashvili,Josh Goodall,Teymuraz Gabashvili,7-5; 6-3,R32,69,8,4,25,51,21,25,17,26,1,2,10,38,51,9,5,35,61,24,35,13,26,3,7,11,37,61
2007-06-18 00:00:00.000,Nottingham Great Britain ATP World Tour,GRASS,2,Arnaud Clement,Thomas Johansson,Arnaud Clement,7-5; 6-2,R32,79,6,2,32,54,28,32,12,22,3,4,10,40,54,7,3,33,58,21,33,11,25,3,7,10,32,58
2007-06-18 00:00:00.000,Nottingham Great Britain ATP World Tour,GRASS,2,Jonas Bjorkman,Richard Bloomfield,Jonas Bjorkman,6-2; 6-0,R32,59,2,1,25,34,21,25,7,9,0,0,7,28,34,2,1,20,54,16,20,8,34,3,8,7,24,54
2007-06-18 00:00:00.000,Nottingham Great Britain ATP World Tour,GRASS,2,Amer Delic,Justin Gimelstob,Amer Delic,6-4; 6-4,R32,83,11,6,40,75,32,40,18,35,4,4,10,50,75,4,16,42,75,32,42,12,33,4,6,10,44,75
2007-06-18 00:00:00.000,Nottingham Great Britain ATP World Tour,GRASS,2,Hyung-Taik Lee,Max Mirnyi,Hyung-Taik Lee,6-4; 4-6; 6-4,R32,123,2,1,64,96,46,64,17,32,6,8,15,63,96,11,6,56,87,43,56,15,31,10,13,15,58,87
2007-06-18 00:00:00.000,Nottingham Great Britain ATP World Tour,GRASS,2,Paul-Henri Mathieu,Robby Ginepri,Paul-Henri Mathieu,6-3; 6-4,R32,71,8,4,30,57,28,30,16,27,2,2,10,44,57,4,2,43,66,26,43,12,23,6,8,9,38,66
2007-06-18 00:00:00.000,Nottingham Great Britain ATP World Tour,GRASS,2,Ivo Karlovic,Stanislas Wawrinka,Ivo Karlovic,6-3; 7-6(3),R32,99,10,3,43,68,39,43,12,25,2,2,10,51,68,1,5,45,77,33,45,14,32,2,4,11,47,77
2007-06-18 00:00:00.000,Nottingham Great Britain ATP World Tour,GRASS,2,Gilles Simon,Andrei Pavel,Gilles Simon,6-2; 4-6; 6-4,R32,110,5,2,57,82,45,57,10,25,6,8,14,55,82,4,2,70,103,50,70,12,33,6,10,14,62,103
2007-06-18 00:00:00.000,Nottingham Great Britain ATP World Tour,GRASS,2,Juan Martin Del Potro,Jamie Baker,Juan Martin Del Potro,6-4; 6-2,R32,77,7,2,32,46,27,32,10,14,0,0,9,37,46,1,2,40,67,24,40,14,27,8,11,9,38,67
2007-06-18 00:00:00.000,Nottingham Great Britain ATP World Tour,GRASS,2,Igor Kunitsyn,Agustin Calleri,Igor Kunitsyn,7-6(8); 3-6; 6-4,R32,134,4,4,65,108,43,65,27,43,6,8,16,70,108,15,6,65,110,48,65,22,45,8,9,15,70,110
2007-06-18 00:00:00.000,Nottingham Great Britain ATP World Tour,GRASS,2,Sebastien Grosjean,Dominik Hrbaty,Sebastien Grosjean,6-3; 6-4,R32,85,7,1,35,64,26,35,14,29,4,6,10,40,64,0,6,52,81,31,52,11,29,8,12,9,42,81
2007-06-18 00:00:00.000,Nottingham Great Britain ATP World Tour,GRASS,2,Guillermo Garcia-Lopez,Alex Bogdanovic,Guillermo Garcia-Lopez,6-4; 7-6(13),R32,118,5,0,51,71,44,51,11,20,1,1,11,55,71,8,4,53,79,37,53,14,26,1,2,11,51,79
2007-06-18 00:00:00.000,Nottingham Great Britain ATP World Tour,GRASS,2,Tim Henman,Michael Russell,Tim Henman,6-1; 7-6(5),R32,102,3,4,34,66,28,34,17,32,5,6,9,45,66,1,5,47,65,31,47,5,18,4,8,10,36,65
2007-06-18 00:00:00.000,Nottingham Great Britain ATP World Tour,GRASS,2,Dmitry Tursunov,Robert Kendrick,Dmitry Tursunov,6-1; 6-4,R32,55,8,3,27,51,21,27,15,24,1,2,9,36,51,7,6,29,49,17,29,7,20,2,6,8,24,49
2007-06-18 00:00:00.000,Nottingham Great Britain ATP World Tour,GRASS,2,Richard Gasquet,Jan Vacek,Richard Gasquet,6-4; 6-0,R16,59,6,1,35,44,31,35,2,9,1,1,8,33,44,3,2,35,52,21,35,4,17,4,8,8,25,52
2007-06-18 00:00:00.000,Nottingham Great Britain ATP World Tour,GRASS,2,Arnaud Clement,Teymuraz Gabashvili,Arnaud Clement,7-6(5); 3-6; 6-3,R16,132,12,2,57,84,50,57,16,27,0,1,15,66,84,9,5,59,97,49,59,22,38,7,8,15,71,97
2007-06-18 00:00:00.000,Nottingham Great Britain ATP World Tour,GRASS,2,Jonas Bjorkman,Amer Delic,Jonas Bjorkman,7-5; 7-6(2),R16,89,2,5,48,73,33,48,19,25,2,4,12,52,73,6,3,46,73,31,46,16,27,3,6,12,47,73
2007-06-18 00:00:00.000,Nottingham Great Britain ATP World Tour,GRASS,2,Paul-Henri Mathieu,Hyung-Taik Lee,Paul-Henri Mathieu,7-6(2); 6-0,R16,83,10,3,38,62,31,38,13,24,0,0,9,44,62,1,3,35,58,23,35,10,23,1,4,9,33,58
2007-06-18 00:00:00.000,Nottingham Great Britain ATP World Tour,GRASS,2,Ivo Karlovic,Gilles Simon,Ivo Karlovic,7-6(4); 6-7(4); 6-4,R16,139,30,4,71,103,59,71,19,32,4,4,17,78,103,3,1,65,116,48,65,32,51,8,9,17,80,116
2007-06-18 00:00:00.000,Nottingham Great Britain ATP World Tour,GRASS,2,Juan Martin Del Potro,Igor Kunitsyn,Juan Martin Del Potro,6-2; 7-5,R16,81,6,2,37,56,31,37,6,19,0,2,10,37,56,0,2,34,65,21,34,12,31,6,11,10,33,65
2007-06-18 00:00:00.000,Nottingham Great Britain ATP World Tour,GRASS,2,Guillermo Garcia-Lopez,Sebastien Grosjean,Guillermo Garcia-Lopez,6-4; 6-3,R16,78,3,2,41,60,31,41,10,19,4,4,9,41,60,8,4,35,61,24,35,12,26,1,4,10,36,61
2007-06-18 00:00:00.000,Nottingham Great Britain ATP World Tour,GRASS,2,Dmitry Tursunov,Tim Henman,Dmitry Tursunov,7-6(7); 3-6; 6-2,R16,120,7,3,47,79,35,47,22,32,0,3,14,57,79,9,5,64,100,47,64,14,36,5,9,15,61,100
2007-06-18 00:00:00.000,Nottingham Great Britain ATP World Tour,GRASS,2,Arnaud Clement,Richard Gasquet,Arnaud Clement,6-4; 6-3,Q,67,6,0,20,44,20,20,17,24,1,1,9,37,44,3,0,32,54,23,32,9,22,2,5,10,32,54
2007-06-18 00:00:00.000,Nottingham Great Britain ATP World Tour,GRASS,2,Jonas Bjorkman,Paul-Henri Mathieu,Jonas Bjorkman,2-6; 6-3; 6-4,Q,137,6,3,65,94,46,65,14,29,10,12,14,60,94,12,4,47,92,36,47,22,45,9,11,13,58,92
2007-06-18 00:00:00.000,Nottingham Great Britain ATP World Tour,GRASS,2,Ivo Karlovic,Juan Martin Del Potro,Ivo Karlovic,7-6(10); 7-5,Q,112,24,0,49,69,42,49,13,20,0,0,12,55,69,4,1,50,82,35,50,22,32,3,4,12,57,82
2007-06-18 00:00:00.000,Nottingham Great Britain ATP World Tour,GRASS,2,Dmitry Tursunov,Guillermo Garcia-Lopez,Dmitry Tursunov,4-6; 6-3; 7-5,Q,140,7,2,51,94,37,51,30,43,6,7,16,67,94,6,3,64,107,45,64,22,43,12,14,15,67,107
2007-06-18 00:00:00.000,Nottingham Great Britain ATP World Tour,GRASS,2,Arnaud Clement,Jonas Bjorkman,Arnaud Clement,6-2; 6-4,S,91,6,0,21,44,19,21,14,23,0,1,9,33,44,9,2,56,87,33,56,11,31,10,14,9,44,87
2007-06-18 00:00:00.000,Nottingham Great Britain ATP World Tour,GRASS,2,Ivo Karlovic,Dmitry Tursunov,Ivo Karlovic,7-5; 6-4,S,85,16,0,30,52,29,30,15,22,0,0,11,44,52,8,3,46,87,31,46,22,41,9,11,11,53,87
2007-06-18 00:00:00.000,Nottingham Great Britain ATP World Tour,GRASS,2,Ivo Karlovic,Arnaud Clement,Ivo Karlovic,3-6; 6-4; 6-4,F,120,21,2,53,74,43,53,12,21,2,3,14,55,74,5,3,65,99,44,65,21,34,8,10,15,65,99
2007-06-25 00:00:00.000,Wimbledon Great Britain Grand Slams,GRASS,3,Roger Federer,Teymuraz Gabashvili,Roger Federer,6-3; 6-2; 6-4,R128,92,9,0,48,78,35,48,22,30,1,1,14,57,78,2,3,47,86,26,47,25,39,8,12,13,51,86
2007-06-25 00:00:00.000,Wimbledon Great Britain Grand Slams,GRASS,3,Juan Martin Del Potro,Davide Sanguinetti,Juan Martin Del Potro,3-6; 6-3; 6-4; 6-4,R128,146,15,2,66,101,47,66,22,35,6,10,19,69,101,8,3,76,126,52,76,22,50,10,16,19,74,126
2007-06-25 00:00:00.000,Wimbledon Great Britain Grand Slams,GRASS,3,Aisam-Ul-Haq Qureshi,Lee Childs,Aisam-Ul-Haq Qureshi,6-3; 6-4; 7-6(6),R128,136,16,7,67,111,58,67,19,44,3,3,16,77,111,9,4,65,121,45,65,31,56,8,10,15,76,121
2007-06-25 00:00:00.000,Wimbledon Great Britain Grand Slams,GRASS,3,Marat Safin,Rik De Voest,Marat Safin,7-6(5); 6-4; 7-5,R128,137,7,2,71,112,49,71,25,41,8,10,17,74,112,2,2,73,112,51,73,20,39,8,12,17,71,112
2007-06-25 00:00:00.000,Wimbledon Great Britain Grand Slams,GRASS,3,Dmitry Tursunov,Nicolas Almagro,Dmitry Tursunov,7-6(2); 6-4; 6-7(7); 6-3,R128,156,15,4,84,139,69,84,31,55,8,10,22,100,139,14,5,85,138,65,85,26,53,4,8,21,91,138
2007-06-25 00:00:00.000,Wimbledon Great Britain Grand Slams,GRASS,3,Michael Berrer,Albert Montanes,Michael Berrer,6-3; 6-3; 6-2,R128,80,9,2,39,71,34,39,20,32,3,3,13,54,71,7,4,53,80,32,53,12,27,3,8,13,44,80
2007-06-25 00:00:00.000,Wimbledon Great Britain Grand Slams,GRASS,3,Tomas Zib,Diego Hartfield,Tomas Zib,4-6; 7-6(4); 3-6; 6-3; 6-4,R128,183,5,3,104,148,80,104,21,44,7,11,25,101,148,28,5,95,146,69,95,28,51,6,10,25,97,146
2007-06-25 00:00:00.000,Wimbledon Great Britain Grand Slams,GRASS,3,Tommy Haas,Zack Fleishman,Tommy Haas,6-3; 6-4; 6-2,R128,76,8,3,38,68,35,38,21,30,0,0,14,56,68,7,4,41,77,27,41,18,36,5,9,13,45,77
2007-06-25 00:00:00.000,Wimbledon Great Britain Grand Slams,GRASS,3,James Blake,Igor Andreev,James Blake,6-3; 6-4; 6-4,R128,94,5,4,55,88,40,55,19,33,2,5,15,59,88,3,3,47,76,31,47,12,29,2,8,14,43,76
2007-06-25 00:00:00.000,Wimbledon Great Britain Grand Slams,GRASS,3,Andrei Pavel,Juan-Pablo Guzman,Andrei Pavel,6-4; 6-4; 6-1,R128,76,8,1,50,69,42,50,10,19,1,3,14,52,69,8,5,59,82,39,59,3,23,4,10,13,42,82
2007-06-25 00:00:00.000,Wimbledon Great Britain Grand Slams,GRASS,3,Gilles Muller,Oscar Hernandez,Gilles Muller,6-2; 6-7(6); 4-3 RET,R128,101,8,3,51,76,40,51,15,25,1,2,13,55,76,4,4,63,96,37,63,19,33,6,10,14,56,96
2007-06-25 00:00:00.000,Wimbledon Great Britain Grand Slams,GRASS,3,Juan Carlos Ferrero,Jan Hajek,Juan Carlos Ferrero,6-7(5); 4-6; 6-3; 6-2; 7-5,R128,187,27,8,116,171,83,116,26,55,14,19,26,109,171,17,7,96,161,64,96,31,65,7,15,25,95,161
2007-06-25 00:00:00.000,Wimbledon Great Britain Grand Slams,GRASS,3,Florent Serra,Philipp Kohlschreiber,Florent Serra,7-6(4); 6-4; 6-4,R128,103,8,0,60,88,53,60,17,28,2,2,16,70,88,19,6,53,98,47,53,18,45,5,7,16,65,98
2007-06-25 00:00:00.000,Wimbledon Great Britain Grand Slams,GRASS,3,Janko Tipsarevic,Alexander Peya,Janko Tipsarevic,4-6; 3-6; 6-3; 6-4; 6-3,R128,183,6,5,67,129,49,67,37,62,3,7,23,86,129,10,5,97,153,69,97,28,56,3,9,24,97,153
2007-06-25 00:00:00.000,Wimbledon Great Britain Grand Slams,GRASS,3,Alejandro Falla,Sam Querrey,Alejandro Falla,7-6(5); 6-1; 6-4,R128,89,3,1,67,84,53,67,12,17,3,3,15,65,84,14,2,48,83,35,48,19,35,4,7,14,54,83
2007-06-25 00:00:00.000,Wimbledon Great Britain Grand Slams,GRASS,3,Fernando Gonzalez,Robby Ginepri,Fernando Gonzalez,3-6; 7-6(4); 6-2; 6-2,R128,128,6,4,72,111,52,72,16,39,3,6,18,68,111,11,3,71,116,51,71,20,45,5,11,19,71,116
2007-06-25 00:00:00.000,Wimbledon Great Britain Grand Slams,GRASS,3,Andy Roddick,Justin Gimelstob,Andy Roddick,6-1; 7-5; 7-6(3),R128,126,16,1,72,97,61,72,14,25,1,1,16,75,97,11,9,71,120,51,71,21,49,6,9,15,72,120
2007-06-25 00:00:00.000,Wimbledon Great Britain Grand Slams,GRASS,3,Danai Udomchoke,Carlos Berlocq,Danai Udomchoke,6-4; 7-5; 6-3,R128,106,4,0,50,80,40,50,20,30,2,3,15,60,80,10,1,59,102,43,59,18,43,9,14,16,61,102
2007-06-25 00:00:00.000,Wimbledon Great Britain Grand Slams,GRASS,3,Fernando Verdasco,Bobby Reynolds,Fernando Verdasco,6-4; 6-4; 6-3,R128,96,7,5,66,89,51,66,14,23,8,8,14,65,89,10,4,62,89,41,62,13,27,5,9,15,54,89
2007-06-25 00:00:00.000,Wimbledon Great Britain Grand Slams,GRASS,3,Andreas Seppi,Dominik Hrbaty,Andreas Seppi,7-6(8); 6-1; 6-2,R128,89,9,2,63,88,46,63,16,25,3,4,14,62,88,2,7,50,79,33,50,13,29,3,8,13,46,79
2007-06-25 00:00:00.000,Wimbledon Great Britain Grand Slams,GRASS,3,David Ferrer,Sergio Roitman,David Ferrer,6-3; 6-3; 6-1,R128,109,1,1,56,81,42,56,14,25,3,3,12,56,81,6,3,58,86,39,58,8,28,6,12,13,47,86
2007-06-25 00:00:00.000,Wimbledon Great Britain Grand Slams,GRASS,3,Paul-Henri Mathieu,Radek Stepanek,Paul-Henri Mathieu,7-6(4); 6-2; 6-2,R128,107,11,2,45,80,42,45,20,35,4,4,14,62,80,11,4,54,84,40,54,14,30,4,8,14,54,84
2007-06-25 00:00:00.000,Wimbledon Great Britain Grand Slams,GRASS,3,Jan Hernych,Marc Gicquel,Jan Hernych,0-6; 6-4; 6-4; 6-4,R128,138,11,0,79,119,53,79,21,40,3,6,18,74,119,9,4,76,123,52,76,24,47,6,9,18,76,123
2007-06-25 00:00:00.000,Wimbledon Great Britain Grand Slams,GRASS,3,Ivan Ljubicic,Vincent Spadea,Ivan Ljubicic,6-4; 6-4; 4-6; 7-6(4),R128,149,22,1,91,122,75,91,15,31,9,11,21,90,122,5,5,84,136,56,84,30,52,3,6,21,86,136
2007-06-25 00:00:00.000,Wimbledon Great Britain Grand Slams,GRASS,3,Richard Gasquet,Bohdan Ulihrach,Richard Gasquet,6-3; 6-4; 6-4,R128,90,6,1,51,81,43,51,21,30,2,2,15,64,81,10,7,51,91,37,51,20,40,3,6,14,57,91
2007-06-25 00:00:00.000,Wimbledon Great Britain Grand Slams,GRASS,3,Nicolas Mahut,Arnaud Clement,Nicolas Mahut,6-3; 3-6; 7-6(5); 6-4,R128,198,16,5,71,124,53,71,31,53,4,7,20,84,124,17,4,79,144,55,79,32,65,11,15,20,87,144
2007-06-25 00:00:00.000,Wimbledon Great Britain Grand Slams,GRASS,3,Edouard Roger-Vasselin,Jamie Baker,Edouard Roger-Vasselin,7-6(2); 6-2; 6-3,R128,115,6,3,73,100,53,73,14,27,2,3,15,67,100,4,3,69,108,42,69,18,39,9,13,14,60,108
2007-06-25 00:00:00.000,Wimbledon Great Britain Grand Slams,GRASS,3,Juan Ignacio Chela,Benjamin Becker,Juan Ignacio Chela,3-6; 4-6; 6-4; 6-4; 10-8,R128,231,14,6,95,167,67,95,40,72,4,10,28,107,167,22,8,110,196,84,110,35,86,22,29,29,119,196
2007-06-25 00:00:00.000,Wimbledon Great Britain Grand Slams,GRASS,3,Tim Henman,Carlos Moya,Tim Henman,6-3; 1-6; 5-7; 6-2; 13-11,R128,251,10,9,121,190,86,121,36,69,7,11,30,122,190,17,6,127,199,92,127,37,72,16,21,30,129,199
2007-06-25 00:00:00.000,Wimbledon Great Britain Grand Slams,GRASS,3,Feliciano Lopez,Josh Goodall,Feliciano Lopez,6-1; 6-4; 6-4,R128,81,24,7,44,76,38,44,18,32,0,1,14,56,76,4,7,34,72,24,34,17,38,1,6,13,41,72
2007-06-25 00:00:00.000,Wimbledon Great Britain Grand Slams,GRASS,3,Jo-Wilfried Tsonga,Julien Benneteau,Jo-Wilfried Tsonga,7-6(4); 7-5; 6-4,R128,115,9,3,75,121,54,75,19,46,9,14,17,73,121,4,3,63,100,35,63,17,37,5,12,17,52,100
2007-06-25 00:00:00.000,Wimbledon Great Britain Grand Slams,GRASS,3,Nicolas Lapentti,Kevin Kim,Nicolas Lapentti,2-6; 6-2; 4-6; 6-3; 6-4,R128,174,12,5,95,147,70,95,25,52,5,9,23,95,147,4,7,89,138,62,89,22,49,5,10,22,84,138
2007-06-25 00:00:00.000,Wimbledon Great Britain Grand Slams,GRASS,3,Nikolay Davydenko,Evgeny Korolev,Nikolay Davydenko,7-6(12); 6-4; 7-6(5),R128,159,7,3,87,123,64,87,15,36,7,9,17,79,123,4,6,84,139,57,84,26,55,11,14,17,83,139
2007-06-25 00:00:00.000,Wimbledon Great Britain Grand Slams,GRASS,3,Chris Guccione,Alex Bogdanovic,Chris Guccione,7-6(2); 6-4; 6-4,R128,111,14,2,60,102,45,60,31,42,5,5,16,76,102,13,3,71,94,51,71,14,23,4,6,16,65,94
2007-06-25 00:00:00.000,Wimbledon Great Britain Grand Slams,GRASS,3,Gael Monfils,Thomas Johansson,Gael Monfils,6-4; 7-6(5); 6-2,R128,94,34,4,49,78,45,49,23,29,1,1,15,68,78,4,5,80,117,57,80,14,37,10,13,15,71,117
2007-06-25 00:00:00.000,Wimbledon Great Britain Grand Slams,GRASS,3,Kristof Vliegen,Juan Monaco,Kristof Vliegen,6-4; 6-3; 7-6(3),R128,132,8,1,73,114,59,73,17,41,9,11,16,76,114,0,2,81,107,45,81,17,26,4,8,15,62,107
2007-06-25 00:00:00.000,Wimbledon Great Britain Grand Slams,GRASS,3,David Nalbandian,Mischa Zverev,David Nalbandian,6-3; 6-4; 6-2,R128,103,6,6,61,105,41,61,23,44,4,6,14,64,105,3,2,49,74,31,49,8,25,2,8,13,39,74
2007-06-25 00:00:00.000,Wimbledon Great Britain Grand Slams,GRASS,3,Frank Dancevic,Stefan Koubek,Frank Dancevic,6-2; 6-4; 6-2,R128,77,20,4,43,66,37,43,15,23,0,0,13,52,66,4,3,67,90,40,67,11,23,7,12,13,51,90
2007-06-25 00:00:00.000,Wimbledon Great Britain Grand Slams,GRASS,3,Nicolas Devilder,Mariano Zabaleta,Nicolas Devilder,6-7(3); 6-4; 7-5; 6-4,R128,162,3,6,82,140,59,82,36,58,7,10,22,95,140,9,6,90,137,60,90,24,47,6,12,22,84,137
2007-06-25 00:00:00.000,Wimbledon Great Britain Grand Slams,GRASS,3,Marcos Baghdatis,Ernests Gulbis,Marcos Baghdatis,3-6; 6-4; 6-3; 6-2,R128,117,9,4,62,106,50,62,25,44,0,1,18,75,106,6,5,70,103,49,70,15,33,2,6,18,64,103
2007-06-25 00:00:00.000,Wimbledon Great Britain Grand Slams,GRASS,3,Lleyton Hewitt,Richard Bloomfield,Lleyton Hewitt,7-5; 6-3; 7-5,R128,123,6,2,54,89,45,54,23,35,2,3,17,68,89,8,2,51,90,34,51,20,39,1,5,16,54,90
2007-06-25 00:00:00.000,Wimbledon Great Britain Grand Slams,GRASS,3,Simone Bolelli,Guillermo Garcia-Lopez,Simone Bolelli,4-6; 7-6(5); 6-4; 6-4,R128,151,14,0,89,122,62,89,28,33,2,3,21,90,122,11,2,86,126,66,86,22,40,1,3,21,88,126
2007-06-25 00:00:00.000,Wimbledon Great Britain Grand Slams,GRASS,3,Max Mirnyi,Yen-Hsun Lu,Max Mirnyi,6-3; 6-4; 2-1 RET,R128,94,4,5,35,60,33,35,14,25,0,0,11,47,60,3,6,54,81,33,54,13,27,5,8,11,46,81
2007-06-25 00:00:00.000,Wimbledon Great Britain Grand Slams,GRASS,3,Guillermo Canas,Ivan Navarro,Guillermo Canas,7-6(3); 6-3; 6-1,R128,94,6,2,51,74,45,51,17,23,2,2,14,62,74,6,5,62,97,41,62,19,35,11,15,14,60,97
2007-06-25 00:00:00.000,Wimbledon Great Britain Grand Slams,GRASS,3,Nicolas Kiefer,Filippo Volandri,Nicolas Kiefer,6-3; 7-6(6); 6-1,R128,147,5,2,62,111,46,62,26,49,7,9,15,72,111,2,4,68,117,41,68,21,49,13,18,13,62,117
2007-06-25 00:00:00.000,Wimbledon Great Britain Grand Slams,GRASS,3,Fabrice Santoro,Ivo Karlovic,Fabrice Santoro,4-6; 7-6(4); 7-6(3); 3-6; 6-4,R128,186,4,1,109,156,81,109,31,47,2,4,26,112,156,31,6,103,144,90,103,20,41,1,2,27,110,144
2007-06-25 00:00:00.000,Wimbledon Great Britain Grand Slams,GRASS,3,Amer Delic,Lukas Dlouhy,Amer Delic,6-3; 6-4; 5-7; 6-4,R128,140,20,2,83,131,65,83,25,48,8,10,21,90,131,9,7,88,142,64,88,26,54,9,13,20,90,142
2007-06-25 00:00:00.000,Wimbledon Great Britain Grand Slams,GRASS,3,Novak Djokovic,Potito Starace,Novak Djokovic,6-0; 6-3; 6-4,R128,95,6,1,49,74,38,49,16,25,1,2,13,54,74,2,3,54,87,28,54,18,33,10,16,12,46,87
2007-06-25 00:00:00.000,Wimbledon Great Britain Grand Slams,GRASS,3,Tomas Berdych,Nicolas Massu,Tomas Berdych,7-6(5); 6-4; 6-2,R128,116,14,1,54,90,49,54,22,36,6,6,15,71,90,8,3,65,97,45,65,20,32,6,9,15,65,97
2007-06-25 00:00:00.000,Wimbledon Great Britain Grand Slams,GRASS,3,Michael Llodra,Stanislas Wawrinka,Michael Llodra,6-4; 6-4; 6-1,R128,92,8,1,48,70,39,48,19,22,1,1,14,58,70,3,4,51,88,33,51,16,37,4,8,13,49,88
2007-06-25 00:00:00.000,Wimbledon Great Britain Grand Slams,GRASS,3,Hyung-Taik Lee,Martin Vassallo Arguello,Hyung-Taik Lee,6-4; 6-2; 6-3,R128,92,2,0,51,68,38,51,13,17,2,3,13,51,68,0,10,60,88,38,60,9,28,5,11,14,47,88
2007-06-25 00:00:00.000,Wimbledon Great Britain Grand Slams,GRASS,3,Agustin Calleri,Luis Horna,Agustin Calleri,6-2; 7-6(4); 7-5,R128,111,13,3,56,94,47,56,21,38,2,3,16,68,94,7,3,65,102,42,65,18,37,6,10,16,60,102
2007-06-25 00:00:00.000,Wimbledon Great Britain Grand Slams,GRASS,3,Jonas Bjorkman,Fernando Vicente,Jonas Bjorkman,6-3; 6-1; 6-2,R128,87,3,1,42,66,36,42,15,24,2,2,12,51,66,2,0,67,84,36,67,7,17,9,15,12,43,84
2007-06-25 00:00:00.000,Wimbledon Great Britain Grand Slams,GRASS,3,Jimmy Wang,Igor Kunitsyn,Jimmy Wang,6-3; 6-4; 6-7(5); 6-7(8); 6-2,R128,245,7,4,122,181,95,122,24,59,6,10,26,119,181,6,2,105,186,67,105,40,81,7,15,25,107,186
2007-06-25 00:00:00.000,Wimbledon Great Britain Grand Slams,GRASS,3,Wayne Arthurs,Thiemo de Bakker,Wayne Arthurs,6-7(7); 6-7(7); 7-6(4); 6-4; 6-4,R128,197,41,6,102,162,89,102,37,60,3,5,28,126,162,18,2,129,185,98,129,33,56,7,11,28,131,185
2007-06-25 00:00:00.000,Wimbledon Great Britain Grand Slams,GRASS,3,Tommy Robredo,Robert Kendrick,Tommy Robredo,6-2; 3-6; 6-3; 6-7(5); 6-3,R128,166,14,0,111,160,80,111,29,49,8,9,24,109,160,13,7,93,139,73,93,22,46,4,8,23,95,139
2007-06-25 00:00:00.000,Wimbledon Great Britain Grand Slams,GRASS,3,Mikhail Youzhny,Kristian Pless,Mikhail Youzhny,6-4; 6-2; 6-4,R128,89,8,3,63,81,51,63,9,18,4,4,14,60,81,2,1,48,79,32,48,16,31,3,7,14,48,79
2007-06-25 00:00:00.000,Wimbledon Great Britain Grand Slams,GRASS,3,Gilles Simon,Marin Cilic,Gilles Simon,3-6; 7-5; 6-4; 4-6; 6-3,R128,200,5,1,105,173,75,105,34,68,9,12,25,109,173,14,10,81,150,65,81,34,69,4,8,25,99,150
2007-06-25 00:00:00.000,Wimbledon Great Britain Grand Slams,GRASS,3,Florian Mayer,Sam Warburg,Florian Mayer,6-4; 6-2; 6-2,R128,84,7,1,59,76,48,59,8,17,1,1,13,56,76,0,4,62,85,37,62,10,23,5,10,13,47,85
2007-06-25 00:00:00.000,Wimbledon Great Britain Grand Slams,GRASS,3,Jarkko Nieminen,Michael Russell,Jarkko Nieminen,6-3; 6-2; 7-5,R128,113,8,2,70,94,48,70,14,24,4,7,15,62,94,2,0,71,97,36,71,12,26,6,13,14,48,97
2007-06-25 00:00:00.000,Wimbledon Great Britain Grand Slams,GRASS,3,Robin Soderling,Olivier Rochus,Robin Soderling,6-3; 6-2; 6-2,R128,79,20,2,53,69,44,53,8,16,0,0,13,52,69,1,3,47,69,28,47,9,22,0,5,12,37,69
2007-06-25 00:00:00.000,Wimbledon Great Britain Grand Slams,GRASS,3,Sebastien Grosjean,Jonathan Marray,Sebastien Grosjean,6-2; 7-6(0); 7-5,R128,133,6,2,61,102,43,61,25,41,1,3,16,68,102,2,3,63,100,37,63,20,37,1,6,16,57,100
2007-06-25 00:00:00.000,Wimbledon Great Britain Grand Slams,GRASS,3,Werner Eschauer,Ruben Ramirez Hidalgo,Werner Eschauer,6-2; 3-6; 6-4; 6-3,R128,134,9,5,74,103,56,74,17,29,3,5,18,73,103,8,5,69,112,50,69,16,43,6,11,18,66,112
2007-06-25 00:00:00.000,Wimbledon Great Britain Grand Slams,GRASS,3,Rafael Nadal,Mardy Fish,Rafael Nadal,6-3; 7-6(4); 6-3,R128,138,4,4,61,91,54,61,18,30,2,2,16,72,91,17,5,57,104,37,57,29,47,6,8,14,66,104
2007-06-25 00:00:00.000,Wimbledon Great Britain Grand Slams,GRASS,3,Roger Federer,Juan Martin Del Potro,Roger Federer,6-2; 7-5; 6-1,R64,93,5,1,45,77,38,45,20,32,1,1,14,58,77,1,2,41,76,25,41,18,35,4,9,13,43,76
2007-06-25 00:00:00.000,Wimbledon Great Britain Grand Slams,GRASS,3,Marat Safin,Aisam-Ul-Haq Qureshi,Marat Safin,6-4; 6-2; 7-6(4),R64,119,12,5,66,108,50,66,26,42,8,8,15,76,108,12,1,67,94,47,67,13,27,5,8,15,60,94
2007-06-25 00:00:00.000,Wimbledon Great Britain Grand Slams,GRASS,3,Dmitry Tursunov,Michael Berrer,Dmitry Tursunov,4-6; 6-4; 6-4; 6-4,R64,135,13,6,74,121,48,74,33,47,3,5,20,81,121,11,2,81,115,53,81,21,34,3,7,20,74,115
2007-06-25 00:00:00.000,Wimbledon Great Britain Grand Slams,GRASS,3,Tommy Haas,Tomas Zib,Tommy Haas,6-3; 7-6(5); 6-4,R64,111,20,8,68,100,53,68,18,32,1,2,16,71,100,2,2,66,91,45,66,13,25,2,5,15,58,91
2007-06-25 00:00:00.000,Wimbledon Great Britain Grand Slams,GRASS,3,James Blake,Andrei Pavel,James Blake,6-4; 6-3; 6-3,R64,103,12,2,61,98,37,61,27,37,9,10,14,64,98,1,0,61,86,38,61,8,25,2,7,14,46,86
2007-06-25 00:00:00.000,Wimbledon Great Britain Grand Slams,GRASS,3,Juan Carlos Ferrero,Gilles Muller,Juan Carlos Ferrero,6-4; 6-4; 6-7(2); 7-6(8),R64,161,8,2,90,126,71,90,25,36,1,2,22,96,126,25,6,102,149,78,102,24,47,8,11,22,102,149
2007-06-25 00:00:00.000,Wimbledon Great Britain Grand Slams,GRASS,3,Janko Tipsarevic,Florent Serra,Janko Tipsarevic,6-3; 6-2; 6-7(3); 3-6; 6-2,R64,161,17,4,79,138,66,79,28,59,6,8,22,94,138,18,4,110,157,76,110,20,47,7,14,24,96,157
2007-06-25 00:00:00.000,Wimbledon Great Britain Grand Slams,GRASS,3,Fernando Gonzalez,Alejandro Falla,Fernando Gonzalez,4-6; 6-3; 6-4; 7-6(1),R64,156,9,4,82,128,60,82,27,46,3,6,21,87,128,4,0,91,127,65,91,15,36,8,12,20,80,127
2007-06-25 00:00:00.000,Wimbledon Great Britain Grand Slams,GRASS,3,Andy Roddick,Danai Udomchoke,Andy Roddick,6-3; 6-4; 7-6(3),R64,104,15,2,66,94,54,66,17,28,8,9,16,71,94,1,4,61,94,40,61,23,33,5,8,15,63,94
2007-06-25 00:00:00.000,Wimbledon Great Britain Grand Slams,GRASS,3,Fernando Verdasco,Andreas Seppi,Fernando Verdasco,6-3; 6-2; 6-4,R64,97,7,3,59,78,45,59,12,19,3,4,14,57,78,7,4,51,85,32,51,15,34,9,14,13,47,85
2007-06-25 00:00:00.000,Wimbledon Great Britain Grand Slams,GRASS,3,Paul-Henri Mathieu,David Ferrer,Paul-Henri Mathieu,6-3; 6-4; 6-3,R64,117,6,1,51,80,42,51,14,29,4,5,14,56,80,1,0,76,100,44,76,11,24,5,10,14,55,100
2007-06-25 00:00:00.000,Wimbledon Great Britain Grand Slams,GRASS,3,Ivan Ljubicic,Jan Hernych,Ivan Ljubicic,6-4; 6-3; 6-4,R64,93,19,2,58,75,52,58,9,17,1,1,15,61,75,4,2,66,93,44,66,14,27,8,11,14,58,93
2007-06-25 00:00:00.000,Wimbledon Great Britain Grand Slams,GRASS,3,Richard Gasquet,Nicolas Mahut,Richard Gasquet,6-4; 6-3; 6-4,R64,98,6,3,43,74,40,43,22,31,2,2,15,62,74,5,6,52,81,36,52,14,29,3,6,14,50,81
2007-06-25 00:00:00.000,Wimbledon Great Britain Grand Slams,GRASS,3,Edouard Roger-Vasselin,Juan Ignacio Chela,Edouard Roger-Vasselin,7-6(3); 6-4; 7-5,R64,113,2,2,72,102,58,72,19,30,2,3,17,77,102,7,4,60,95,42,60,22,35,1,4,17,64,95
2007-06-25 00:00:00.000,Wimbledon Great Britain Grand Slams,GRASS,3,Feliciano Lopez,Tim Henman,Feliciano Lopez,7-6(3); 7-6(5); 3-6; 2-6; 6-1,R64,197,13,8,94,148,74,94,29,54,4,8,24,103,148,16,6,115,158,87,115,21,43,6,9,24,108,158
2007-06-25 00:00:00.000,Wimbledon Great Britain Grand Slams,GRASS,3,Jo-Wilfried Tsonga,Nicolas Lapentti,Jo-Wilfried Tsonga,6-4; 6-2; 6-3,R64,112,12,1,45,76,39,45,20,31,1,1,14,59,76,7,3,66,98,44,66,12,32,11,15,13,56,98
2007-06-25 00:00:00.000,Wimbledon Great Britain Grand Slams,GRASS,3,Nikolay Davydenko,Chris Guccione,Nikolay Davydenko,3-6; 5-7; 7-6(5); 6-4; 6-2,R64,168,7,4,96,143,73,96,29,47,5,8,25,102,143,23,5,89,132,74,89,26,43,5,9,26,100,132
2007-06-25 00:00:00.000,Wimbledon Great Britain Grand Slams,GRASS,3,Gael Monfils,Kristof Vliegen,Gael Monfils,7-5; 7-6(4); 7-6(1),R64,145,18,8,65,108,55,65,23,43,4,6,18,78,108,5,4,89,150,57,89,31,61,10,13,18,88,150
2007-06-25 00:00:00.000,Wimbledon Great Britain Grand Slams,GRASS,3,David Nalbandian,Frank Dancevic,David Nalbandian,6-2; 6-3; 5-7; 6-3,R64,147,4,5,86,130,60,86,24,44,11,13,19,84,130,17,5,65,113,48,65,19,48,10,16,19,67,113
2007-06-25 00:00:00.000,Wimbledon Great Britain Grand Slams,GRASS,3,Marcos Baghdatis,Nicolas Devilder,Marcos Baghdatis,6-0; 7-6(5); 6-7(4); 6-2,R64,169,10,2,71,117,56,71,25,46,2,4,19,81,117,13,5,92,149,61,92,24,57,15,22,19,85,149
2007-06-25 00:00:00.000,Wimbledon Great Britain Grand Slams,GRASS,3,Lleyton Hewitt,Simone Bolelli,Lleyton Hewitt,6-2; 6-2; 6-1,R64,98,14,1,41,66,28,41,21,25,4,4,11,49,66,4,2,52,80,27,52,11,28,5,12,12,38,80
2007-06-25 00:00:00.000,Wimbledon Great Britain Grand Slams,GRASS,3,Guillermo Canas,Max Mirnyi,Guillermo Canas,6-7(4); 6-1; 7-6(4); 7-6(4),R64,205,9,4,91,146,66,91,31,55,11,15,22,97,146,14,2,93,153,66,93,27,60,5,11,21,93,153
2007-06-25 00:00:00.000,Wimbledon Great Britain Grand Slams,GRASS,3,Nicolas Kiefer,Fabrice Santoro,Nicolas Kiefer,6-4; 6-3; 6-4,R64,115,9,0,42,75,38,42,22,33,0,0,15,60,75,4,3,65,99,41,65,17,34,9,12,14,58,99
2007-06-25 00:00:00.000,Wimbledon Great Britain Grand Slams,GRASS,3,Novak Djokovic,Amer Delic,Novak Djokovic,6-3; 3-6; 6-3; 7-6(4),R64,139,8,2,76,108,58,76,20,32,3,6,20,78,108,19,4,76,123,59,76,18,47,7,11,19,77,123
2007-06-25 00:00:00.000,Wimbledon Great Britain Grand Slams,GRASS,3,Tomas Berdych,Michael Llodra,Tomas Berdych,7-6(4); 7-6(2); 3-6; 7-6(4),R64,198,24,4,94,160,76,94,36,66,8,10,22,112,160,21,7,100,161,81,100,30,61,5,6,23,111,161
2007-06-25 00:00:00.000,Wimbledon Great Britain Grand Slams,GRASS,3,Hyung-Taik Lee,Agustin Calleri,Hyung-Taik Lee,7-6(6); 6-4; 6-7(3); 6-3,R64,154,5,1,111,146,80,111,23,35,8,9,22,103,146,9,5,91,143,62,91,30,52,10,13,21,92,143
2007-06-25 00:00:00.000,Wimbledon Great Britain Grand Slams,GRASS,3,Jonas Bjorkman,Jimmy Wang,Jonas Bjorkman,6-0; 6-3; 6-7(8); 6-4,R64,170,8,2,92,135,63,92,23,43,7,10,20,86,135,1,2,86,121,48,86,16,35,9,16,17,64,121
2007-06-25 00:00:00.000,Wimbledon Great Britain Grand Slams,GRASS,3,Wayne Arthurs,Tommy Robredo,Wayne Arthurs,6-3; 7-6(5); 6-3,R64,110,14,3,64,101,51,64,22,37,3,3,16,73,101,5,0,63,91,44,63,17,28,7,9,14,61,91
2007-06-25 00:00:00.000,Wimbledon Great Britain Grand Slams,GRASS,3,Mikhail Youzhny,Gilles Simon,Mikhail Youzhny,6-4; 4-6; 3-6; 7-5; 6-4,R64,226,4,3,115,169,71,115,27,54,4,12,25,98,169,4,2,101,169,66,101,30,68,9,18,26,96,169
2007-06-25 00:00:00.000,Wimbledon Great Britain Grand Slams,GRASS,3,Jarkko Nieminen,Florian Mayer,Jarkko Nieminen,3-6; 6-3; 7-6(2); 2-6; 6-3,R64,160,7,6,101,148,70,101,22,47,7,13,24,92,148,6,3,108,154,74,108,21,46,3,8,23,95,154
2007-06-25 00:00:00.000,Wimbledon Great Britain Grand Slams,GRASS,3,Robin Soderling,Sebastien Grosjean,Robin Soderling,6-3; 3-6; 6-3; 6-2,R64,142,10,2,64,104,54,64,21,40,2,3,18,75,104,14,2,65,108,49,65,19,43,6,10,17,68,108
2007-06-25 00:00:00.000,Wimbledon Great Britain Grand Slams,GRASS,3,Rafael Nadal,Werner Eschauer,Rafael Nadal,6-2; 6-4; 6-1,R64,96,4,2,37,62,29,37,17,25,2,3,12,46,62,8,2,54,75,28,54,6,21,3,10,13,34,75
2007-06-25 00:00:00.000,Wimbledon Great Britain Grand Slams,GRASS,3,Roger Federer,Marat Safin,Roger Federer,6-1; 6-4; 7-6(4),R32,99,12,1,56,86,49,56,15,30,0,1,15,64,86,5,1,53,89,39,53,15,36,7,11,14,54,89
2007-06-25 00:00:00.000,Wimbledon Great Britain Grand Slams,GRASS,3,Tommy Haas,Dmitry Tursunov,Tommy Haas,1-6; 6-4; 7-6(5); 6-4,R32,172,7,3,85,125,57,85,18,40,10,15,19,75,125,13,6,77,133,56,77,26,56,4,9,20,82,133
2007-06-25 00:00:00.000,Wimbledon Great Britain Grand Slams,GRASS,3,Juan Carlos Ferrero,James Blake,Juan Carlos Ferrero,3-6; 6-3; 6-3; 7-6(4),R32,128,8,1,77,103,59,77,16,26,1,4,19,75,103,9,8,75,125,56,75,21,50,7,12,20,77,125
2007-06-25 00:00:00.000,Wimbledon Great Britain Grand Slams,GRASS,3,Janko Tipsarevic,Fernando Gonzalez,Janko Tipsarevic,6-3; 3-6; 6-3; 4-6; 8-6,R32,215,13,1,91,154,68,91,35,63,7,11,26,103,154,21,3,93,155,67,93,30,62,6,11,25,97,155
2007-06-25 00:00:00.000,Wimbledon Great Britain Grand Slams,GRASS,3,Andy Roddick,Fernando Verdasco,Andy Roddick,6-3; 6-4; 7-6(2),R32,113,12,1,73,110,54,73,22,37,5,6,16,76,110,13,2,63,81,48,63,9,18,4,7,15,57,81
2007-06-25 00:00:00.000,Wimbledon Great Britain Grand Slams,GRASS,3,Paul-Henri Mathieu,Ivan Ljubicic,Paul-Henri Mathieu,4-6; 7-5; 6-2; 6-3,R32,182,6,2,75,122,60,75,25,47,10,11,20,85,122,14,3,92,148,64,92,25,56,6,10,19,89,148
2007-06-25 00:00:00.000,Wimbledon Great Britain Grand Slams,GRASS,3,Richard Gasquet,Edouard Roger-Vasselin,Richard Gasquet,6-3; 6-4; 6-2,R32,88,7,2,52,77,42,52,17,25,2,2,14,59,77,6,2,50,73,38,50,6,23,1,5,13,44,73
2007-06-25 00:00:00.000,Wimbledon Great Britain Grand Slams,GRASS,3,Jo-Wilfried Tsonga,Feliciano Lopez,Jo-Wilfried Tsonga,6-3; 7-6(4); 6-3,R32,108,16,2,65,96,53,65,21,31,3,3,16,74,96,2,3,46,81,35,46,21,35,5,7,14,56,81
2007-06-25 00:00:00.000,Wimbledon Great Britain Grand Slams,GRASS,3,Nikolay Davydenko,Gael Monfils,Nikolay Davydenko,6-3; 7-5; 6-3,R32,106,1,4,57,84,43,57,15,27,3,5,15,58,84,12,3,46,92,33,46,20,46,1,7,15,53,92
2007-06-25 00:00:00.000,Wimbledon Great Britain Grand Slams,GRASS,3,Marcos Baghdatis,David Nalbandian,Marcos Baghdatis,6-2; 7-5; 6-0,R32,101,5,0,37,76,33,37,25,39,1,1,13,58,76,3,7,45,86,27,45,16,41,4,10,13,43,86
2007-06-25 00:00:00.000,Wimbledon Great Britain Grand Slams,GRASS,3,Lleyton Hewitt,Guillermo Canas,Lleyton Hewitt,6-4; 3-6; 6-3; 6-4,R32,163,8,2,66,119,44,66,34,53,4,7,19,78,119,17,2,66,113,45,66,24,47,6,11,19,69,113
2007-06-25 00:00:00.000,Wimbledon Great Britain Grand Slams,GRASS,3,Novak Djokovic,Nicolas Kiefer,Novak Djokovic,7-6(4); 6-7(6); 6-2; 7-6(5),R32,219,11,4,91,142,74,91,31,51,2,3,22,105,142,9,6,102,164,74,102,32,62,9,12,22,106,164
2007-06-25 00:00:00.000,Wimbledon Great Britain Grand Slams,GRASS,3,Tomas Berdych,Hyung-Taik Lee,Tomas Berdych,6-4; 7-6(2); 7-6(3),R32,127,15,3,61,101,54,61,21,40,1,2,17,75,101,2,3,71,106,52,71,16,35,1,3,17,68,106
2007-06-25 00:00:00.000,Wimbledon Great Britain Grand Slams,GRASS,3,Jonas Bjorkman,Wayne Arthurs,Jonas Bjorkman,6-2; 6-1; 6-4,R32,87,6,0,53,77,45,53,12,24,2,2,13,57,77,10,7,40,68,29,40,10,28,4,9,12,39,68
2007-06-25 00:00:00.000,Wimbledon Great Britain Grand Slams,GRASS,3,Mikhail Youzhny,Jarkko Nieminen,Mikhail Youzhny,7-5; 7-6(5); 6-3,R32,139,2,3,53,110,39,53,33,57,6,9,17,72,110,2,1,66,106,45,66,17,40,4,9,16,62,106
2007-06-25 00:00:00.000,Wimbledon Great Britain Grand Slams,GRASS,3,Rafael Nadal,Robin Soderling,Rafael Nadal,6-4; 6-4; 6-7(7); 4-6; 7-5,R32,241,5,3,122,184,85,122,29,62,10,15,27,114,184,21,4,106,166,78,106,28,60,8,15,27,106,166
2007-06-25 00:00:00.000,Wimbledon Great Britain Grand Slams,GRASS,3,Roger Federer,Tommy Haas,Roger Federer,W/O,R16,0,0,0,0,0,0,0,0,0,0,0,0,0,0,0,0,0,0,0,0,0,0,0,0,0,0,0
2007-06-25 00:00:00.000,Wimbledon Great Britain Grand Slams,GRASS,3,Juan Carlos Ferrero,Janko Tipsarevic,Juan Carlos Ferrero,7-5; 6-3; 7-6(5),R16,112,14,1,62,99,49,62,23,37,3,4,17,72,99,14,3,51,87,39,51,21,36,1,4,16,60,87
2007-06-25 00:00:00.000,Wimbledon Great Britain Grand Slams,GRASS,3,Andy Roddick,Paul-Henri Mathieu,Andy Roddick,6-2; 7-5; 7-6(6),R16,110,19,0,66,90,55,66,11,24,0,1,16,66,90,2,0,55,90,37,55,22,35,4,8,16,59,90
2007-06-25 00:00:00.000,Wimbledon Great Britain Grand Slams,GRASS,3,Richard Gasquet,Jo-Wilfried Tsonga,Richard Gasquet,6-4; 6-3; 6-4,R16,102,3,1,45,75,36,45,20,30,2,4,15,56,75,10,3,58,92,39,58,12,34,1,6,14,51,92
2007-06-25 00:00:00.000,Wimbledon Great Britain Grand Slams,GRASS,3,Marcos Baghdatis,Nikolay Davydenko,Marcos Baghdatis,7-6(5); 7-6(5); 6-3,R16,129,4,4,57,100,46,57,16,43,4,8,16,62,100,5,5,77,113,45,77,20,36,4,10,17,65,113
2007-06-25 00:00:00.000,Wimbledon Great Britain Grand Slams,GRASS,3,Novak Djokovic,Lleyton Hewitt,Novak Djokovic,7-6(8); 7-6(2); 4-6; 7-6(5),R16,252,17,5,125,174,92,125,22,49,8,12,23,114,174,7,2,80,157,59,80,41,77,5,8,23,100,157
2007-06-25 00:00:00.000,Wimbledon Great Britain Grand Slams,GRASS,3,Tomas Berdych,Jonas Bjorkman,Tomas Berdych,6-4; 6-0; 6-7(6); 6-0,R16,141,15,7,57,101,48,57,25,44,3,3,17,73,101,6,3,80,119,54,80,14,39,11,18,17,68,119
2007-06-25 00:00:00.000,Wimbledon Great Britain Grand Slams,GRASS,3,Rafael Nadal,Mikhail Youzhny,Rafael Nadal,4-6; 3-6; 6-1; 6-2; 6-2,R16,185,11,3,84,115,64,84,19,31,2,4,21,83,115,6,6,88,139,62,88,21,51,4,10,21,83,139
2007-06-25 00:00:00.000,Wimbledon Great Britain Grand Slams,GRASS,3,Roger Federer,Juan Carlos Ferrero,Roger Federer,7-6(2); 3-6; 6-1; 6-3,Q,136,15,1,67,113,54,67,26,46,5,7,18,80,113,3,3,79,120,54,79,16,41,3,8,19,70,120
2007-06-25 00:00:00.000,Wimbledon Great Britain Grand Slams,GRASS,3,Richard Gasquet,Andy Roddick,Richard Gasquet,4-6; 4-6; 7-6(2); 7-6(3); 8-6,Q,214,23,4,116,179,90,116,41,63,7,10,29,131,179,22,4,107,170,86,107,33,63,4,6,29,119,170
2007-06-25 00:00:00.000,Wimbledon Great Britain Grand Slams,GRASS,3,Novak Djokovic,Marcos Baghdatis,Novak Djokovic,7-6(4); 7-6(9); 6-7(3); 4-6; 7-5,Q,300,12,4,131,188,95,131,30,57,3,8,29,125,188,6,8,113,225,82,113,58,112,12,17,29,140,225
2007-06-25 00:00:00.000,Wimbledon Great Britain Grand Slams,GRASS,3,Rafael Nadal,Tomas Berdych,Rafael Nadal,7-6(1); 6-4; 6-2,Q,127,6,2,72,93,51,72,16,21,4,5,15,67,93,11,2,53,91,36,53,17,38,5,9,15,53,91
2007-06-25 00:00:00.000,Wimbledon Great Britain Grand Slams,GRASS,3,Roger Federer,Richard Gasquet,Roger Federer,7-5; 6-3; 6-4,S,104,20,0,64,90,50,64,17,26,3,3,16,67,90,4,1,56,89,37,56,20,33,1,4,15,57,89
2007-06-25 00:00:00.000,Wimbledon Great Britain Grand Slams,GRASS,3,Rafael Nadal,Novak Djokovic,Rafael Nadal,3-6; 6-1; 4-1 RET,S,101,4,0,32,55,25,32,13,23,1,2,10,38,55,7,2,50,77,33,50,11,27,6,10,11,44,77
2007-06-25 00:00:00.000,Wimbledon Great Britain Grand Slams,GRASS,3,Roger Federer,Rafael Nadal,Roger Federer,7-6(7); 4-6; 7-6(3); 2-6; 6-2,F,225,24,3,111,156,79,111,28,45,7,11,25,107,156,1,2,118,167,81,118,28,49,5,8,25,109,167
2007-07-09 00:00:00.000,Bastad Sweden ATP World Tour,CLAY,2,Luis Horna,Tommy Robredo,Luis Horna,6-1; 1-6; 6-1,R32,96,1,3,50,76,38,50,10,26,6,8,11,48,76,3,1,47,60,29,47,3,13,3,7,10,32,60
2007-07-09 00:00:00.000,Bastad Sweden ATP World Tour,CLAY,2,Carlos Berlocq,Tim Goransson,Carlos Berlocq,6-2; 6-0,R32,73,1,3,21,40,17,21,10,19,4,5,7,27,40,0,1,42,57,19,42,4,15,9,15,7,23,57
2007-07-09 00:00:00.000,Bastad Sweden ATP World Tour,CLAY,2,Nicolas Almagro,Filip Prpic,Nicolas Almagro,6-1; 3-6; 6-1,R32,77,8,4,47,71,40,47,9,24,1,2,12,49,71,0,1,44,66,26,44,12,22,3,7,11,38,66
2007-07-09 00:00:00.000,Bastad Sweden ATP World Tour,CLAY,2,Jonas Bjorkman,Michal Przysiezny,Jonas Bjorkman,5-7; 6-2; 6-4,R32,136,6,2,65,105,50,65,16,40,7,10,15,66,105,6,4,56,89,36,56,16,33,5,10,15,52,89
2007-07-09 00:00:00.000,Bastad Sweden ATP World Tour,CLAY,2,Carlos Moya,Ivan Navarro,Carlos Moya,6-2; 6-4,R32,67,3,1,26,54,22,26,13,28,0,1,9,35,54,1,2,34,50,21,34,5,16,1,5,9,26,50
2007-07-09 00:00:00.000,Bastad Sweden ATP World Tour,CLAY,2,Thomas Johansson,Oscar Hernandez,Thomas Johansson,6-4; 6-4,R32,97,6,1,50,84,34,50,18,34,11,13,10,52,84,1,2,41,61,23,41,9,20,2,6,10,32,61
2007-07-09 00:00:00.000,Bastad Sweden ATP World Tour,CLAY,2,Fernando Verdasco,Erling Tveit,Fernando Verdasco,7-5; 6-1,R32,72,1,3,35,44,28,35,5,9,1,2,9,33,44,5,2,43,67,24,43,9,24,3,8,10,33,67
2007-07-09 00:00:00.000,Bastad Sweden ATP World Tour,CLAY,2,Robin Soderling,Simone Bolelli,Robin Soderling,6-3; 6-3,R32,67,10,1,30,59,26,30,18,29,4,4,9,44,59,3,0,38,59,25,38,9,21,3,6,9,34,59
2007-07-09 00:00:00.000,Bastad Sweden ATP World Tour,CLAY,2,Filippo Volandri,Federico Luzzi,Filippo Volandri,4-6; 7-5; 6-1,R32,115,3,6,40,79,29,40,25,39,2,5,15,54,79,5,3,40,84,27,40,22,44,3,8,14,49,84
2007-07-09 00:00:00.000,Bastad Sweden ATP World Tour,CLAY,2,Yuri Schukin,Mariano Zabaleta,Yuri Schukin,6-1; 1-6; 7-5,R32,134,1,1,55,80,37,55,12,25,4,8,13,49,80,3,3,64,107,39,64,20,43,4,9,13,59,107
2007-07-09 00:00:00.000,Bastad Sweden ATP World Tour,CLAY,2,Lukas Dlouhy,Michael Ryderstedt,Lukas Dlouhy,6-1; 6-4,R32,62,7,2,36,59,27,36,15,23,6,6,9,42,59,4,1,28,52,16,28,15,24,4,7,8,31,52
2007-07-09 00:00:00.000,Bastad Sweden ATP World Tour,CLAY,2,Olivier Rochus,Jarkko Nieminen,Olivier Rochus,6-4; 6-2,R32,85,1,0,40,60,30,40,8,20,3,4,9,38,60,4,2,32,61,23,32,9,29,1,5,9,32,61
2007-07-09 00:00:00.000,Bastad Sweden ATP World Tour,CLAY,2,Juan Monaco,Ernests Gulbis,Juan Monaco,7-6(6); 3-6; 6-4,R32,99,2,2,50,80,40,50,19,30,2,4,15,59,80,5,5,71,98,52,71,15,27,3,5,16,67,98
2007-07-09 00:00:00.000,Bastad Sweden ATP World Tour,CLAY,2,Gilles Simon,Viktor Troicki,Gilles Simon,6-2; 6-3,R32,69,1,0,42,63,29,42,11,21,3,4,9,40,63,2,5,30,51,17,30,7,21,4,8,8,24,51
2007-07-09 00:00:00.000,Bastad Sweden ATP World Tour,CLAY,2,Nicolas Massu,Evgeny Korolev,Nicolas Massu,4-6; 6-3; 6-4,R32,166,7,5,61,93,49,61,17,32,3,4,15,66,93,10,7,76,119,52,76,20,43,11,13,14,72,119
2007-07-09 00:00:00.000,Bastad Sweden ATP World Tour,CLAY,2,David Ferrer,Guillermo Garcia-Lopez,David Ferrer,6-2; 6-1,R32,59,1,0,26,34,21,26,7,8,0,0,7,28,34,1,2,28,50,14,28,8,22,4,9,8,22,50
2007-07-09 00:00:00.000,Bastad Sweden ATP World Tour,CLAY,2,Luis Horna,Carlos Berlocq,Luis Horna,6-3; 7-6(5),R16,107,0,3,60,78,41,60,10,18,5,6,11,51,78,4,5,34,68,24,34,17,34,3,5,10,41,68
2007-07-09 00:00:00.000,Bastad Sweden ATP World Tour,CLAY,2,Nicolas Almagro,Jonas Bjorkman,Nicolas Almagro,6-4; 6-2,R16,74,4,2,25,49,22,25,16,24,3,3,9,38,49,3,1,38,61,27,38,9,23,5,8,9,36,61
2007-07-09 00:00:00.000,Bastad Sweden ATP World Tour,CLAY,2,Carlos Moya,Thomas Johansson,Carlos Moya,6-2; 6-3,R16,60,6,4,29,49,24,29,13,20,0,0,9,37,49,4,3,30,48,19,30,10,18,1,4,8,29,48
2007-07-09 00:00:00.000,Bastad Sweden ATP World Tour,CLAY,2,Robin Soderling,Fernando Verdasco,Robin Soderling,6-3; 5-7; 7-6(4),R16,145,11,6,71,117,53,71,18,46,5,9,17,71,117,5,3,71,105,44,71,19,34,4,8,16,63,105
2007-07-09 00:00:00.000,Bastad Sweden ATP World Tour,CLAY,2,Filippo Volandri,Yuri Schukin,Filippo Volandri,4-6; 6-3; 6-3,R16,110,0,2,60,82,37,60,12,22,4,8,14,49,82,1,1,52,88,30,52,17,36,7,13,14,47,88
2007-07-09 00:00:00.000,Bastad Sweden ATP World Tour,CLAY,2,Olivier Rochus,Lukas Dlouhy,Olivier Rochus,6-4; 7-5,R16,96,2,2,40,65,27,40,15,25,0,2,11,42,65,6,4,55,85,35,55,11,30,7,11,11,46,85
2007-07-09 00:00:00.000,Bastad Sweden ATP World Tour,CLAY,2,Gilles Simon,Juan Monaco,Gilles Simon,6-4; 6-4,R16,84,1,2,38,69,25,38,15,31,6,9,10,40,69,0,2,43,65,23,43,9,22,8,13,10,32,65
2007-07-09 00:00:00.000,Bastad Sweden ATP World Tour,CLAY,2,David Ferrer,Nicolas Massu,David Ferrer,6-3; 3-6; 6-3,R16,137,0,1,51,73,38,51,12,22,0,3,14,50,73,5,0,60,96,40,60,14,36,6,10,13,54,96
2007-07-09 00:00:00.000,Bastad Sweden ATP World Tour,CLAY,2,Nicolas Almagro,Luis Horna,Nicolas Almagro,7-5; 6-4,Q,93,5,1,44,64,35,44,11,20,1,2,11,46,64,2,1,45,74,22,45,21,29,3,6,11,43,74
2007-07-09 00:00:00.000,Bastad Sweden ATP World Tour,CLAY,2,Carlos Moya,Robin Soderling,Carlos Moya,6-2; 6-4,Q,69,9,2,32,60,25,32,16,28,5,5,9,41,60,2,3,26,45,18,26,9,19,0,3,9,27,45
2007-07-09 00:00:00.000,Bastad Sweden ATP World Tour,CLAY,2,Filippo Volandri,Olivier Rochus,Filippo Volandri,6-1; 6-2,Q,71,1,0,42,55,28,42,8,13,3,3,7,36,55,0,3,29,51,14,29,9,22,4,9,8,23,51
2007-07-09 00:00:00.000,Bastad Sweden ATP World Tour,CLAY,2,David Ferrer,Gilles Simon,David Ferrer,6-1; 6-0,Q,72,0,0,32,48,24,32,7,16,4,4,6,31,48,1,2,27,52,10,27,9,25,8,14,7,19,52
2007-07-09 00:00:00.000,Bastad Sweden ATP World Tour,CLAY,2,Nicolas Almagro,Carlos Moya,Nicolas Almagro,6-3; 1-6; 6-2,S,100,2,1,47,75,31,47,12,28,8,12,12,43,75,6,9,45,82,28,45,16,37,8,13,12,44,82
2007-07-09 00:00:00.000,Bastad Sweden ATP World Tour,CLAY,2,David Ferrer,Filippo Volandri,David Ferrer,6-2; 6-1,S,65,0,0,32,44,20,32,6,12,4,6,7,26,44,0,1,36,56,14,36,7,20,5,12,8,21,56
2007-07-09 00:00:00.000,Bastad Sweden ATP World Tour,CLAY,2,David Ferrer,Nicolas Almagro,David Ferrer,6-1; 6-2,F,69,1,0,31,48,23,31,11,17,4,4,7,34,48,1,2,31,63,21,31,8,32,8,13,8,29,63
2007-07-09 00:00:00.000,Gstaad Switzerland ATP World Tour,CLAY,2,Gael Monfils,Nikolay Davydenko,Gael Monfils,3-6; 6-4; 7-5,R32,118,12,8,59,110,45,59,24,51,16,19,16,69,110,1,3,66,93,45,66,16,27,6,9,15,61,93
2007-07-09 00:00:00.000,Gstaad Switzerland ATP World Tour,CLAY,2,Jiri Vanek,Florent Serra,Jiri Vanek,6-4; 6-1,R32,61,7,2,28,44,22,28,9,16,0,1,8,31,44,4,3,33,59,17,33,12,26,9,14,9,29,59
2007-07-09 00:00:00.000,Gstaad Switzerland ATP World Tour,CLAY,2,Feliciano Lopez,Michel Kratochvil,Feliciano Lopez,6-2; 6-3,R32,80,10,4,24,58,21,24,19,34,4,4,8,40,58,0,3,26,59,17,26,14,33,5,9,9,31,59
2007-07-09 00:00:00.000,Gstaad Switzerland ATP World Tour,CLAY,2,Paul-Henri Mathieu,Sergio Roitman,Paul-Henri Mathieu,7-6(4); 6-4,R32,106,5,3,39,78,31,39,20,39,3,4,11,51,78,3,1,54,83,37,54,12,29,8,10,11,49,83
2007-07-09 00:00:00.000,Gstaad Switzerland ATP World Tour,CLAY,2,Philipp Kohlschreiber,Jan Hernych,Philipp Kohlschreiber,7-6(0); 7-6(3),R32,104,4,3,38,74,30,38,22,36,3,5,12,52,74,2,2,46,79,36,46,14,33,5,7,12,50,79
2007-07-09 00:00:00.000,Gstaad Switzerland ATP World Tour,CLAY,2,Radek Stepanek,Marin Cilic,Radek Stepanek,7-5; 6-3,R32,128,6,1,33,53,28,33,13,20,0,0,10,41,53,6,4,37,78,25,37,20,41,6,9,11,45,78
2007-07-09 00:00:00.000,Gstaad Switzerland ATP World Tour,CLAY,2,Werner Eschauer,Michael Lammer,Werner Eschauer,6-2; 4-6; 6-2,R32,113,5,4,59,89,40,59,14,30,8,10,13,54,89,1,3,48,71,30,48,9,23,4,9,13,39,71
2007-07-09 00:00:00.000,Gstaad Switzerland ATP World Tour,CLAY,2,Marc Gicquel,Diego Hartfield,Marc Gicquel,6-3; 7-6(5),R32,89,3,5,41,72,33,41,18,31,2,2,11,51,72,4,2,45,67,29,45,14,22,1,2,10,43,67
2007-07-09 00:00:00.000,Gstaad Switzerland ATP World Tour,CLAY,2,Potito Starace,Jan Hajek,Potito Starace,7-6(4); 6-1,R32,72,3,2,39,55,32,39,11,16,1,2,10,43,55,3,2,39,66,25,39,11,27,6,9,9,36,66
2007-07-09 00:00:00.000,Gstaad Switzerland ATP World Tour,CLAY,2,Igor Andreev,Albert Montanes,Igor Andreev,3-6; 6-3; 6-4,R32,111,3,2,55,74,43,55,13,19,3,4,14,56,74,4,5,49,100,35,49,28,51,9,11,14,63,100
2007-07-09 00:00:00.000,Gstaad Switzerland ATP World Tour,CLAY,2,Kristof Vliegen,Gaston Gaudio,Kristof Vliegen,6-4; 6-7(3); 6-4,R32,143,12,2,66,115,47,66,26,49,4,6,16,73,115,3,7,67,104,47,67,17,37,8,12,16,64,104
2007-07-09 00:00:00.000,Gstaad Switzerland ATP World Tour,CLAY,2,Richard Gasquet,Ruben Ramirez Hidalgo,Richard Gasquet,6-3; 6-4,R32,77,9,2,52,78,34,52,10,26,7,10,10,44,78,2,3,31,55,17,31,10,24,4,9,9,27,55
2007-07-09 00:00:00.000,Gstaad Switzerland ATP World Tour,CLAY,2,Martin Vassallo Arguello,Stanislas Wawrinka,Martin Vassallo Arguello,7-5; 1-6; 6-4,R32,129,0,6,55,82,31,55,16,27,7,12,14,47,82,8,12,40,98,28,40,28,58,8,13,15,56,98
2007-07-09 00:00:00.000,Gstaad Switzerland ATP World Tour,CLAY,2,Nicolas Lapentti,Jose Acasuso,Nicolas Lapentti,7-5; 6-1,R32,92,5,3,36,70,28,36,19,34,7,7,9,47,70,2,1,32,64,18,32,17,32,1,5,10,35,64
2007-07-09 00:00:00.000,Gstaad Switzerland ATP World Tour,CLAY,2,Andreas Seppi,Bartolome Salva-Vidal,Andreas Seppi,6-4; 6-0,R32,70,3,3,28,56,19,28,16,28,6,7,8,35,56,1,4,33,53,14,33,9,20,2,7,8,23,53
2007-07-09 00:00:00.000,Gstaad Switzerland ATP World Tour,CLAY,2,Stefan Koubek,Mikhail Youzhny,Stefan Koubek,6-4; 6-3,R32,70,4,1,37,69,29,37,18,32,9,9,10,47,69,5,4,21,52,17,21,17,31,4,6,9,34,52
2007-07-09 00:00:00.000,Gstaad Switzerland ATP World Tour,CLAY,2,Gael Monfils,Jiri Vanek,Gael Monfils,6-1; 6-4,R16,51,15,4,26,44,25,26,11,18,0,0,9,36,44,1,1,34,53,20,34,9,19,1,4,8,29,53
2007-07-09 00:00:00.000,Gstaad Switzerland ATP World Tour,CLAY,2,Paul-Henri Mathieu,Feliciano Lopez,Paul-Henri Mathieu,4-6; 6-4; 7-6(4),R16,132,9,0,51,101,40,51,29,50,8,10,16,69,101,11,5,43,90,37,43,26,47,2,4,16,63,90
2007-07-09 00:00:00.000,Gstaad Switzerland ATP World Tour,CLAY,2,Radek Stepanek,Philipp Kohlschreiber,Radek Stepanek,7-5; 6-3,R16,85,10,0,40,63,31,40,16,23,1,1,11,47,63,5,5,54,82,37,54,11,28,5,7,10,48,82
2007-07-09 00:00:00.000,Gstaad Switzerland ATP World Tour,CLAY,2,Marc Gicquel,Werner Eschauer,Marc Gicquel,6-2; 7-6(4),R16,80,11,2,32,62,29,32,15,30,0,0,10,44,62,6,3,44,67,31,44,8,23,1,3,10,39,67
2007-07-09 00:00:00.000,Gstaad Switzerland ATP World Tour,CLAY,2,Igor Andreev,Potito Starace,Igor Andreev,6-3; 7-5,R16,73,10,4,43,63,36,43,9,20,0,1,11,45,63,5,2,41,66,32,41,8,25,3,6,10,40,66
2007-07-09 00:00:00.000,Gstaad Switzerland ATP World Tour,CLAY,2,Richard Gasquet,Kristof Vliegen,Richard Gasquet,6-3; 6-4,R16,59,6,1,29,52,24,29,15,23,0,1,10,39,52,3,2,26,49,17,26,14,23,2,5,9,31,49
2007-07-09 00:00:00.000,Gstaad Switzerland ATP World Tour,CLAY,2,Martin Vassallo Arguello,Nicolas Lapentti,Martin Vassallo Arguello,6-4; 3-6; 6-4,R16,144,3,5,52,78,36,52,15,26,3,6,14,51,78,1,2,56,98,39,56,21,42,9,13,15,60,98
2007-07-09 00:00:00.000,Gstaad Switzerland ATP World Tour,CLAY,2,Andreas Seppi,Stefan Koubek,Andreas Seppi,1-6; 7-6(4); 7-6(6),R16,139,4,6,62,110,49,62,20,48,7,11,15,69,110,6,5,55,106,42,55,28,51,3,5,16,70,106
2007-07-09 00:00:00.000,Gstaad Switzerland ATP World Tour,CLAY,2,Paul-Henri Mathieu,Gael Monfils,Paul-Henri Mathieu,6-1; 4-6; 6-3,Q,99,4,2,37,69,28,37,22,32,0,1,13,50,69,20,9,47,80,34,47,13,33,2,6,13,47,80
2007-07-09 00:00:00.000,Gstaad Switzerland ATP World Tour,CLAY,2,Radek Stepanek,Marc Gicquel,Radek Stepanek,6-3; 6-3,Q,70,11,4,29,53,26,29,15,24,4,4,9,41,53,3,1,42,68,27,42,11,26,9,12,9,38,68
2007-07-09 00:00:00.000,Gstaad Switzerland ATP World Tour,CLAY,2,Igor Andreev,Richard Gasquet,Igor Andreev,7-5; 6-2,Q,76,3,0,30,49,27,30,13,19,0,0,10,40,49,4,4,40,67,26,40,14,27,6,9,10,40,67
2007-07-09 00:00:00.000,Gstaad Switzerland ATP World Tour,CLAY,2,Andreas Seppi,Martin Vassallo Arguello,Andreas Seppi,6-4; 6-0,Q,70,1,2,21,41,17,21,12,20,1,2,8,29,41,3,2,29,44,13,29,6,15,2,7,8,19,44
2007-07-09 00:00:00.000,Gstaad Switzerland ATP World Tour,CLAY,2,Paul-Henri Mathieu,Radek Stepanek,Paul-Henri Mathieu,6-3; 6-4,S,72,4,2,35,54,29,35,13,19,0,0,10,42,54,4,3,28,53,21,28,14,25,2,4,9,35,53
2007-07-09 00:00:00.000,Gstaad Switzerland ATP World Tour,CLAY,2,Andreas Seppi,Igor Andreev,Andreas Seppi,6-4; 3-6; 7-6(5),S,127,5,3,67,95,52,67,15,28,2,3,15,67,95,8,2,68,100,49,68,21,32,2,3,16,70,100
2007-07-09 00:00:00.000,Gstaad Switzerland ATP World Tour,CLAY,2,Paul-Henri Mathieu,Andreas Seppi,Paul-Henri Mathieu,6-7(1); 6-4; 7-5,F,161,8,1,51,106,38,51,31,55,6,9,17,69,106,6,3,58,101,45,58,17,43,3,8,17,62,101
2007-07-09 00:00:00.000,Newport RI; U.S.A. ATP World Tour,GRASS,2,Aisam-Ul-Haq Qureshi,Mardy Fish,Aisam-Ul-Haq Qureshi,6-3; 6-4,R32,80,9,4,35,64,27,35,15,29,0,1,10,42,64,4,5,25,49,22,25,7,24,4,7,9,29,49
2007-07-09 00:00:00.000,Newport RI; U.S.A. ATP World Tour,GRASS,2,Nathan Healey,Jesse Levine,Nathan Healey,6-1; 6-0,R32,51,5,1,22,45,18,22,15,23,4,4,7,33,45,0,4,28,51,14,28,7,23,6,11,6,21,51
2007-07-09 00:00:00.000,Newport RI; U.S.A. ATP World Tour,GRASS,2,Dick Norman,John Isner,Dick Norman,7-6(3); 6-3,R32,86,14,6,46,70,41,46,14,24,3,3,11,55,70,11,7,41,67,30,41,13,26,1,2,10,43,67
2007-07-09 00:00:00.000,Newport RI; U.S.A. ATP World Tour,GRASS,2,Michael Berrer,Chris Guccione,Michael Berrer,6-4; 7-6(5),R32,87,5,5,42,69,38,42,14,27,3,3,11,52,69,16,12,44,81,35,44,16,37,2,3,11,51,81
2007-07-09 00:00:00.000,Newport RI; U.S.A. ATP World Tour,GRASS,2,Prakash Amritraj,Ilija Bozoljac,Prakash Amritraj,3-6; 6-3; 6-3,R32,92,6,4,45,77,33,45,17,32,1,4,14,50,77,8,5,42,74,31,42,12,32,1,5,13,43,74
2007-07-09 00:00:00.000,Newport RI; U.S.A. ATP World Tour,GRASS,2,Scoville Jenkins,Daniele Bracciali,Scoville Jenkins,6-2; 6-1,R32,52,11,2,30,45,26,30,8,15,0,0,8,34,45,1,4,24,39,17,24,2,15,2,6,7,19,39
2007-07-09 00:00:00.000,Newport RI; U.S.A. ATP World Tour,GRASS,2,Antony Dupuis,Konstantinos Economidis,Antony Dupuis,6-4; 6-3,R32,59,11,3,30,57,23,30,15,27,2,3,9,38,57,5,5,30,56,21,30,12,26,3,7,10,33,56
2007-07-09 00:00:00.000,Newport RI; U.S.A. ATP World Tour,GRASS,2,Nicolas Mahut,Adrian Garcia,Nicolas Mahut,7-6(6); 6-1,R32,82,14,8,32,60,31,32,14,28,1,2,10,45,60,2,8,33,76,23,33,19,43,5,8,9,42,76
2007-07-09 00:00:00.000,Newport RI; U.S.A. ATP World Tour,GRASS,2,Mischa Zverev,Igor Kunitsyn,Mischa Zverev,6-1; 2-6; 6-1,R32,89,5,4,35,69,23,35,18,34,3,6,11,41,69,2,6,44,77,27,44,10,33,9,15,11,37,77
2007-07-09 00:00:00.000,Newport RI; U.S.A. ATP World Tour,GRASS,2,Danai Udomchoke,Alex Bogdanovic,Danai Udomchoke,6-3; 3-6; 6-0,R32,86,7,2,48,73,33,48,13,25,3,6,12,46,73,3,1,39,72,21,39,13,33,4,10,12,34,72
2007-07-09 00:00:00.000,Newport RI; U.S.A. ATP World Tour,GRASS,2,Frank Dancevic,Kevin Kim,Frank Dancevic,6-3; 6-3,R32,48,15,3,24,46,22,24,13,22,2,3,9,35,46,2,5,38,59,24,38,9,21,4,8,9,33,59
2007-07-09 00:00:00.000,Newport RI; U.S.A. ATP World Tour,GRASS,2,Fabrice Santoro,Alexander Peya,Fabrice Santoro,6-4; 6-1,R32,72,1,1,23,53,18,23,15,30,0,1,8,33,53,0,6,28,55,16,28,9,27,2,7,9,25,55
2007-07-09 00:00:00.000,Newport RI; U.S.A. ATP World Tour,GRASS,2,Roko Karanusic,Teymuraz Gabashvili,Roko Karanusic,6-4; 6-3,R32,66,2,1,30,47,22,30,9,17,1,3,9,31,47,2,7,32,64,20,32,13,32,1,6,10,33,64
2007-07-09 00:00:00.000,Newport RI; U.S.A. ATP World Tour,GRASS,2,Wesley Moodie,Thiago Alves,Wesley Moodie,6-3; 6-4,R32,53,15,5,37,55,33,37,9,18,1,1,10,42,55,3,2,39,59,25,39,9,20,2,4,9,34,59
2007-07-09 00:00:00.000,Newport RI; U.S.A. ATP World Tour,GRASS,2,Paul Capdeville,Nicolas Kiefer,Paul Capdeville,7-6(3); 4-6; 7-5,R32,148,4,6,66,108,41,66,27,42,8,11,17,68,108,12,7,50,107,41,50,29,57,3,6,17,70,107
2007-07-09 00:00:00.000,Newport RI; U.S.A. ATP World Tour,GRASS,2,Vincent Spadea,Justin Gimelstob,Vincent Spadea,6-4; 6-3,R32,76,4,3,29,55,21,29,15,26,1,3,10,36,55,3,3,32,61,19,32,13,29,5,9,9,32,61
2007-07-09 00:00:00.000,Newport RI; U.S.A. ATP World Tour,GRASS,2,Aisam-Ul-Haq Qureshi,Nathan Healey,Aisam-Ul-Haq Qureshi,7-6(2); 5-7; 6-4,R16,151,14,5,57,109,44,57,31,52,8,10,17,75,109,9,13,64,113,52,64,21,49,4,6,17,73,113
2007-07-09 00:00:00.000,Newport RI; U.S.A. ATP World Tour,GRASS,2,Dick Norman,Michael Berrer,Dick Norman,6-2; 6-7(4); 7-6(6),R16,142,6,7,60,100,53,60,23,40,3,3,16,76,100,9,9,64,108,49,64,25,44,3,5,16,74,108
2007-07-09 00:00:00.000,Newport RI; U.S.A. ATP World Tour,GRASS,2,Prakash Amritraj,Scoville Jenkins,Prakash Amritraj,6-4; 6-3,R16,83,3,0,26,53,19,26,16,27,3,4,9,35,53,6,4,37,67,23,37,15,30,3,7,10,38,67
2007-07-09 00:00:00.000,Newport RI; U.S.A. ATP World Tour,GRASS,2,Nicolas Mahut,Antony Dupuis,Nicolas Mahut,6-3; 6-7(5); 6-1,R16,126,6,10,55,95,45,55,21,40,3,4,15,66,95,4,0,59,98,37,59,20,39,6,10,13,57,98
2007-07-09 00:00:00.000,Newport RI; U.S.A. ATP World Tour,GRASS,2,Mischa Zverev,Danai Udomchoke,Mischa Zverev,2-6; 7-5; 7-6(4),R16,112,6,4,59,106,45,59,19,47,5,10,16,64,106,5,7,67,104,44,67,20,37,4,8,16,64,104
2007-07-09 00:00:00.000,Newport RI; U.S.A. ATP World Tour,GRASS,2,Fabrice Santoro,Frank Dancevic,Fabrice Santoro,6-7(6); 6-3; 6-4,R16,131,4,2,62,114,38,62,35,52,13,14,16,73,114,9,4,56,98,43,56,18,42,3,6,15,61,98
2007-07-09 00:00:00.000,Newport RI; U.S.A. ATP World Tour,GRASS,2,Wesley Moodie,Roko Karanusic,Wesley Moodie,6-4; 4-6; 6-2,R16,89,8,3,50,75,38,50,16,25,2,4,14,54,75,0,3,44,95,31,44,25,51,3,7,14,56,95
2007-07-09 00:00:00.000,Newport RI; U.S.A. ATP World Tour,GRASS,2,Vincent Spadea,Paul Capdeville,Vincent Spadea,6-3; 7-5,R16,70,3,1,42,66,29,42,12,24,3,6,11,41,66,1,4,34,60,22,34,9,26,2,7,10,31,60
2007-07-09 00:00:00.000,Newport RI; U.S.A. ATP World Tour,GRASS,2,Dick Norman,Aisam-Ul-Haq Qureshi,Dick Norman,6-4; 3-6; 6-4,Q,126,12,5,53,85,39,53,20,32,3,4,14,59,85,11,5,51,92,43,51,19,41,7,9,15,62,92
2007-07-09 00:00:00.000,Newport RI; U.S.A. ATP World Tour,GRASS,2,Nicolas Mahut,Prakash Amritraj,Nicolas Mahut,6-4; 7-6(4),Q,95,8,6,36,67,28,36,19,31,0,1,11,47,67,8,3,43,73,33,43,13,30,3,5,11,46,73
2007-07-09 00:00:00.000,Newport RI; U.S.A. ATP World Tour,GRASS,2,Fabrice Santoro,Mischa Zverev,Fabrice Santoro,6-4; 6-3,Q,70,0,1,34,59,23,34,16,25,3,5,10,39,59,3,1,34,61,19,34,13,27,3,7,9,32,61
2007-07-09 00:00:00.000,Newport RI; U.S.A. ATP World Tour,GRASS,2,Wesley Moodie,Vincent Spadea,Wesley Moodie,6-4; 6-4,Q,73,10,5,47,75,35,47,16,28,6,6,10,51,75,1,3,48,63,30,48,10,15,4,6,10,40,63
2007-07-09 00:00:00.000,Newport RI; U.S.A. ATP World Tour,GRASS,2,Nicolas Mahut,Dick Norman,Nicolas Mahut,6-4; 6-7(2); 6-2,S,110,10,6,46,77,40,46,23,31,1,1,15,63,77,10,6,65,87,48,65,9,22,1,4,15,57,87
2007-07-09 00:00:00.000,Newport RI; U.S.A. ATP World Tour,GRASS,2,Fabrice Santoro,Wesley Moodie,Fabrice Santoro,7-6(2); 6-3,S,77,2,2,45,68,37,45,11,23,3,4,11,48,68,9,3,41,65,27,41,13,24,2,4,10,40,65
2007-07-09 00:00:00.000,Newport RI; U.S.A. ATP World Tour,GRASS,2,Fabrice Santoro,Nicolas Mahut,Fabrice Santoro,6-4; 6-4,F,78,3,4,30,55,26,30,13,25,1,2,10,39,55,2,10,38,63,27,38,11,25,4,7,10,38,63
2007-07-16 00:00:00.000,Amersfoort The Netherlands ATP World Tour,CLAY,2,Florent Serra,Nikolay Davydenko,Florent Serra,4-6; 6-1; 6-1,R32,99,2,3,51,83,33,51,18,32,9,11,12,51,83,1,3,50,70,25,50,11,20,5,11,12,36,70
2007-07-16 00:00:00.000,Amersfoort The Netherlands ATP World Tour,CLAY,2,Thiemo de Bakker,Nicolas Massu,Thiemo de Bakker,7-6(7); 7-6(5),R32,145,5,0,64,95,42,64,21,31,4,5,12,63,95,1,3,52,84,35,52,21,32,2,3,12,56,84
2007-07-16 00:00:00.000,Amersfoort The Netherlands ATP World Tour,CLAY,2,Robin Haase,Felix Mantilla,Robin Haase,6-3; 6-2,R32,60,11,0,32,50,28,32,10,18,0,0,9,38,50,1,1,26,44,16,26,10,18,3,6,8,26,44
2007-07-16 00:00:00.000,Amersfoort The Netherlands ATP World Tour,CLAY,2,Nicolas Devilder,Agustin Calleri,Nicolas Devilder,6-3; 6-1,R32,46,5,1,28,43,26,28,7,15,0,0,8,33,43,1,5,21,43,15,21,8,22,1,5,8,23,43
2007-07-16 00:00:00.000,Amersfoort The Netherlands ATP World Tour,CLAY,2,Carlos Moya,Christophe Rochus,Carlos Moya,6-2; 6-3,R32,67,9,0,26,46,24,26,10,20,0,0,8,34,46,0,2,45,64,28,45,6,19,3,7,9,34,64
2007-07-16 00:00:00.000,Amersfoort The Netherlands ATP World Tour,CLAY,2,Mariano Zabaleta,Kristof Vliegen,Mariano Zabaleta,6-3; 6-3,R32,93,5,4,31,56,23,31,11,25,6,8,9,34,56,3,2,45,80,28,45,11,35,13,18,9,39,80
2007-07-16 00:00:00.000,Amersfoort The Netherlands ATP World Tour,CLAY,2,Raemon Sluiter,Luis Horna,Raemon Sluiter,3-6; 7-5; 6-3,R32,119,10,1,40,85,33,40,27,45,4,6,15,60,85,2,3,70,89,46,70,9,19,2,5,15,55,89
2007-07-16 00:00:00.000,Amersfoort The Netherlands ATP World Tour,CLAY,2,Werner Eschauer,Nicolas Almagro,Werner Eschauer,7-6(1); 6-4,R32,101,2,1,51,74,40,51,13,23,4,5,11,53,74,5,1,68,92,46,68,7,24,9,11,11,53,92
2007-07-16 00:00:00.000,Amersfoort The Netherlands ATP World Tour,CLAY,2,Steve Darcis,Marc Gicquel,Steve Darcis,6-3; 6-4,R32,67,3,1,26,54,16,26,15,28,1,4,10,31,54,5,0,34,57,18,34,9,23,2,7,9,27,57
2007-07-16 00:00:00.000,Amersfoort The Netherlands ATP World Tour,CLAY,2,Gilles Simon,Ruben Ramirez Hidalgo,Gilles Simon,6-2; 6-4,R32,67,5,0,29,43,25,29,9,14,0,1,9,34,43,2,2,27,53,17,27,11,26,1,5,9,28,53
2007-07-16 00:00:00.000,Amersfoort The Netherlands ATP World Tour,CLAY,2,Igor Andreev,Janko Tipsarevic,Igor Andreev,6-1; 6-1,R32,37,7,3,21,34,19,21,9,13,0,0,7,28,34,3,5,38,53,18,38,5,15,6,11,7,23,53
2007-07-16 00:00:00.000,Amersfoort The Netherlands ATP World Tour,CLAY,2,Filippo Volandri,Oscar Hernandez,Filippo Volandri,6-2; 6-4,R32,59,2,0,39,47,28,39,4,8,0,2,9,32,47,0,1,34,56,18,34,9,22,3,8,9,27,56
2007-07-16 00:00:00.000,Amersfoort The Netherlands ATP World Tour,CLAY,2,Evgeny Korolev,Dominik Hrbaty,Evgeny Korolev,6-3; 6-7(3); 6-3,R32,117,12,1,62,102,50,62,23,40,3,3,16,73,102,9,1,48,80,37,48,20,32,0,2,14,57,80
2007-07-16 00:00:00.000,Amersfoort The Netherlands ATP World Tour,CLAY,2,Sergio Roitman,Jeremy Chardy,Sergio Roitman,7-6(5); 6-1,R32,97,5,0,46,61,33,46,8,15,4,5,9,41,61,1,2,43,75,27,43,13,32,6,10,10,40,75
2007-07-16 00:00:00.000,Amersfoort The Netherlands ATP World Tour,CLAY,2,Victor Hanescu,Albert Montanes,Victor Hanescu,7-6(3); 4-6; 7-6(4),R32,133,15,1,83,113,65,83,15,30,5,7,17,80,113,4,4,77,114,56,77,19,37,4,5,17,75,114
2007-07-16 00:00:00.000,Amersfoort The Netherlands ATP World Tour,CLAY,2,Mikhail Youzhny,Martin Vassallo Arguello,Mikhail Youzhny,6-2; 7-5,R32,92,1,1,36,58,30,36,13,22,1,1,10,43,58,1,3,41,60,30,41,7,19,5,8,10,37,60
2007-07-16 00:00:00.000,Amersfoort The Netherlands ATP World Tour,CLAY,2,Florent Serra,Thiemo de Bakker,Florent Serra,4-6; 6-3; 7-6(5),R16,109,5,2,53,94,47,53,21,41,3,4,16,68,94,8,2,52,82,38,52,22,30,0,1,15,60,82
2007-07-16 00:00:00.000,Amersfoort The Netherlands ATP World Tour,CLAY,2,Robin Haase,Nicolas Devilder,Robin Haase,6-4; 3-6; 6-3,R16,120,2,0,41,76,31,41,23,35,2,4,14,54,76,4,3,56,86,40,56,14,30,9,12,14,54,86
2007-07-16 00:00:00.000,Amersfoort The Netherlands ATP World Tour,CLAY,2,Carlos Moya,Mariano Zabaleta,Carlos Moya,6-2; 6-3,R16,62,2,1,32,47,28,32,9,15,0,0,9,37,47,0,0,26,41,19,26,4,15,0,3,8,23,41
2007-07-16 00:00:00.000,Amersfoort The Netherlands ATP World Tour,CLAY,2,Werner Eschauer,Raemon Sluiter,Werner Eschauer,6-2; 6-4,R16,70,6,0,28,43,23,28,13,15,0,0,9,36,43,5,1,32,57,22,32,12,25,3,6,9,34,57
2007-07-16 00:00:00.000,Amersfoort The Netherlands ATP World Tour,CLAY,2,Steve Darcis,Gilles Simon,Steve Darcis,7-6(4); 6-1,R16,92,6,1,33,68,26,33,20,35,1,2,10,46,68,6,2,36,70,25,36,14,34,6,9,9,39,70
2007-07-16 00:00:00.000,Amersfoort The Netherlands ATP World Tour,CLAY,2,Igor Andreev,Filippo Volandri,Igor Andreev,3-6; 6-1; 6-4,R16,86,10,0,53,74,37,53,16,21,3,4,13,53,74,2,4,50,78,35,50,13,28,4,7,13,48,78
2007-07-16 00:00:00.000,Amersfoort The Netherlands ATP World Tour,CLAY,2,Evgeny Korolev,Sergio Roitman,Evgeny Korolev,7-5; 7-6(6),R16,149,5,2,45,79,34,45,18,34,1,3,12,52,79,3,0,51,80,34,51,15,29,4,7,12,49,80
2007-07-16 00:00:00.000,Amersfoort The Netherlands ATP World Tour,CLAY,2,Mikhail Youzhny,Victor Hanescu,Mikhail Youzhny,6-4; 6-2,R16,0,0,0,0,0,0,0,0,0,0,0,0,0,0,0,0,0,0,0,0,0,0,0,0,0,0,0
2007-07-16 00:00:00.000,Amersfoort The Netherlands ATP World Tour,CLAY,2,Robin Haase,Florent Serra,Robin Haase,4-6; 7-5; 6-4,Q,125,5,2,57,99,37,57,25,42,4,7,16,62,99,4,0,63,110,45,63,22,47,7,11,16,67,110
2007-07-16 00:00:00.000,Amersfoort The Netherlands ATP World Tour,CLAY,2,Werner Eschauer,Carlos Moya,Werner Eschauer,6-7(4); 6-4; 6-4,Q,154,9,2,73,124,52,73,31,51,9,9,16,83,124,9,1,60,103,47,60,24,43,1,3,16,71,103
2007-07-16 00:00:00.000,Amersfoort The Netherlands ATP World Tour,CLAY,2,Steve Darcis,Igor Andreev,Steve Darcis,6-3; 6-4,Q,74,1,0,32,57,24,32,14,25,1,3,10,38,57,1,2,39,55,25,39,4,16,6,10,9,29,55
2007-07-16 00:00:00.000,Amersfoort The Netherlands ATP World Tour,CLAY,2,Mikhail Youzhny,Evgeny Korolev,Mikhail Youzhny,6-4; 6-3,Q,91,4,1,53,80,36,53,13,27,6,6,9,49,80,2,3,31,64,18,31,19,33,3,6,10,37,64
2007-07-16 00:00:00.000,Amersfoort The Netherlands ATP World Tour,CLAY,2,Werner Eschauer,Robin Haase,Werner Eschauer,6-4; 6-4,S,76,4,1,26,52,19,26,19,26,1,2,10,38,52,0,2,41,65,28,41,11,24,2,5,10,39,65
2007-07-16 00:00:00.000,Amersfoort The Netherlands ATP World Tour,CLAY,2,Steve Darcis,Mikhail Youzhny,Steve Darcis,4-6; 6-0; 7-5,S,138,8,1,59,97,46,59,15,38,9,12,14,61,97,5,1,55,99,32,55,22,44,7,13,14,54,99
2007-07-16 00:00:00.000,Amersfoort The Netherlands ATP World Tour,CLAY,2,Steve Darcis,Werner Eschauer,Steve Darcis,6-1; 7-6(1),F,91,4,1,46,76,37,46,15,30,7,7,10,52,76,5,1,33,59,23,33,13,26,4,6,9,36,59
2007-07-16 00:00:00.000,Los Angeles CA; U.S.A. ATP World Tour,HARD,2,Zack Fleishman,Fernando Gonzalez,Zack Fleishman,7-6(5); 6-4,R32,77,5,2,45,72,38,45,13,27,4,5,11,51,72,2,1,47,61,35,47,9,14,2,4,11,44,61
2007-07-16 00:00:00.000,Los Angeles CA; U.S.A. ATP World Tour,HARD,2,Robert Kendrick,Wesley Whitehouse,Robert Kendrick,6-4; 6-3,R32,70,6,2,32,54,24,32,15,22,1,1,9,39,54,9,8,47,80,32,47,13,33,6,9,10,45,80
2007-07-16 00:00:00.000,Los Angeles CA; U.S.A. ATP World Tour,HARD,2,Radek Stepanek,Alex Bogdanovic,Radek Stepanek,6-1 RET,R32,24,2,0,4,13,4,4,8,9,0,0,3,12,13,0,1,14,20,6,14,1,6,2,5,4,7,20
2007-07-16 00:00:00.000,Los Angeles CA; U.S.A. ATP World Tour,HARD,2,Mardy Fish,Sam Querrey,Mardy Fish,7-5; 6-4,R32,87,10,2,37,78,28,37,25,41,6,6,11,53,78,8,1,32,61,26,32,15,29,1,3,11,41,61
2007-07-16 00:00:00.000,Los Angeles CA; U.S.A. ATP World Tour,HARD,2,Igor Kunitsyn,David Nalbandian,Igor Kunitsyn,7-6(5); 7-5,R32,118,2,6,51,85,31,51,16,34,5,9,12,47,85,5,6,59,87,34,59,10,28,7,12,12,44,87
2007-07-16 00:00:00.000,Los Angeles CA; U.S.A. ATP World Tour,HARD,2,Nicolas Kiefer,Teymuraz Gabashvili,Nicolas Kiefer,6-3; 6-3,R32,66,7,1,27,48,24,27,12,21,0,0,9,36,48,3,3,28,54,18,28,11,26,1,4,9,29,54
2007-07-16 00:00:00.000,Los Angeles CA; U.S.A. ATP World Tour,HARD,2,Ricardo Mello,Phillip King,Ricardo Mello,6-4; 6-2,R32,70,0,2,30,46,23,30,10,16,0,1,9,33,46,2,4,31,52,20,31,7,21,1,5,9,27,52
2007-07-16 00:00:00.000,Los Angeles CA; U.S.A. ATP World Tour,HARD,2,Michael Berrer,Amer Delic,Michael Berrer,6-4; 6-4,R32,63,2,1,31,50,27,31,14,19,2,2,10,41,50,6,1,26,50,21,26,15,24,2,4,10,36,50
2007-07-16 00:00:00.000,Los Angeles CA; U.S.A. ATP World Tour,HARD,2,Hyung-Taik Lee,Kevin Kim,Hyung-Taik Lee,6-3; 6-2,R32,58,3,1,29,50,22,29,16,21,2,2,9,38,50,3,2,30,49,18,30,8,19,3,6,8,26,49
2007-07-16 00:00:00.000,Los Angeles CA; U.S.A. ATP World Tour,HARD,2,Wesley Moodie,Kei Nishikori,Wesley Moodie,6-3; 6-2,R32,81,5,5,36,56,26,36,8,20,3,5,9,34,56,2,3,44,71,27,44,6,27,8,13,8,33,71
2007-07-16 00:00:00.000,Los Angeles CA; U.S.A. ATP World Tour,HARD,2,George Bastl,Ilija Bozoljac,George Bastl,6-4; 6-7(5); 6-3,R32,153,6,4,74,109,53,74,14,35,8,10,15,67,109,12,10,58,125,39,58,30,67,9,14,16,69,125
2007-07-16 00:00:00.000,Los Angeles CA; U.S.A. ATP World Tour,HARD,2,Marat Safin,Chris Guccione,Marat Safin,6-3; 6-7(4); 7-6(2),R32,125,8,3,74,116,55,74,23,42,7,9,17,78,116,10,5,57,104,39,57,28,47,3,6,16,67,104
2007-07-16 00:00:00.000,Los Angeles CA; U.S.A. ATP World Tour,HARD,2,Dmitry Tursunov,Danai Udomchoke,Dmitry Tursunov,6-1; 6-4,R32,62,8,3,22,48,20,22,15,26,0,1,9,35,48,1,3,31,64,16,31,17,33,3,7,8,33,64
2007-07-16 00:00:00.000,Los Angeles CA; U.S.A. ATP World Tour,HARD,2,Vincent Spadea,Thiago Alves,Vincent Spadea,7-6(2); 6-2,R32,83,10,1,49,73,37,49,13,24,6,7,10,50,73,1,0,43,62,28,43,9,19,3,6,10,37,62
2007-07-16 00:00:00.000,Los Angeles CA; U.S.A. ATP World Tour,HARD,2,Paul Goldstein,Adrian Garcia,Paul Goldstein,6-3; 5-7; 6-4,R32,115,1,4,73,99,49,73,13,26,7,11,16,62,99,6,4,52,90,35,52,18,38,0,5,15,53,90
2007-07-16 00:00:00.000,Los Angeles CA; U.S.A. ATP World Tour,HARD,2,James Blake,Alexander Peya,James Blake,7-5; 6-4,R32,72,4,2,35,58,29,35,16,23,1,1,11,45,58,3,3,41,66,29,41,14,25,1,3,11,43,66
2007-07-16 00:00:00.000,Los Angeles CA; U.S.A. ATP World Tour,HARD,2,Zack Fleishman,Robert Kendrick,Zack Fleishman,7-6(4); 6-3,R16,73,3,1,39,63,32,39,14,24,2,2,10,46,63,12,3,35,62,26,35,15,27,0,2,11,41,62
2007-07-16 00:00:00.000,Los Angeles CA; U.S.A. ATP World Tour,HARD,2,Radek Stepanek,Mardy Fish,Radek Stepanek,6-2; 6-2,R16,65,2,1,30,48,24,30,11,18,1,1,8,35,48,6,5,26,51,16,26,11,25,2,6,8,27,51
2007-07-16 00:00:00.000,Los Angeles CA; U.S.A. ATP World Tour,HARD,2,Nicolas Kiefer,Igor Kunitsyn,Nicolas Kiefer,6-3; 6-2,R16,72,3,0,33,50,29,33,9,17,0,0,9,38,50,2,5,26,53,16,26,14,27,4,7,8,30,53
2007-07-16 00:00:00.000,Los Angeles CA; U.S.A. ATP World Tour,HARD,2,Michael Berrer,Ricardo Mello,Michael Berrer,6-3; 7-5,R16,90,6,2,49,71,33,49,11,22,4,7,11,44,71,1,1,48,61,29,48,4,13,3,8,10,33,61
2007-07-16 00:00:00.000,Los Angeles CA; U.S.A. ATP World Tour,HARD,2,Hyung-Taik Lee,Wesley Moodie,Hyung-Taik Lee,6-2; 3-0 RET,R16,41,3,0,25,35,19,25,7,10,0,0,6,26,35,3,1,21,30,12,21,2,9,1,4,5,14,30
2007-07-16 00:00:00.000,Los Angeles CA; U.S.A. ATP World Tour,HARD,2,Marat Safin,George Bastl,Marat Safin,6-2; 2-6; 6-4,R16,120,17,6,62,102,47,62,15,40,13,15,13,62,102,4,3,59,86,40,59,12,27,3,6,13,52,86
2007-07-16 00:00:00.000,Los Angeles CA; U.S.A. ATP World Tour,HARD,2,Vincent Spadea,Dmitry Tursunov,Vincent Spadea,6-7(5); 7-5; 6-3,R16,138,7,4,62,101,48,62,19,39,6,9,16,67,101,5,14,52,107,40,52,22,55,9,15,17,62,107
2007-07-16 00:00:00.000,Los Angeles CA; U.S.A. ATP World Tour,HARD,2,James Blake,Paul Goldstein,James Blake,6-0; 1-6; 7-5,R16,90,12,3,48,85,37,48,17,37,4,7,13,54,85,2,3,48,81,32,48,14,33,5,9,12,46,81
2007-07-16 00:00:00.000,Los Angeles CA; U.S.A. ATP World Tour,HARD,2,Radek Stepanek,Zack Fleishman,Radek Stepanek,6-4; 6-2,Q,62,5,1,30,45,25,30,11,15,0,0,9,36,45,4,3,28,55,19,28,11,27,3,6,9,30,55
2007-07-16 00:00:00.000,Los Angeles CA; U.S.A. ATP World Tour,HARD,2,Nicolas Kiefer,Michael Berrer,Nicolas Kiefer,7-6(5); 6-1,Q,82,8,3,29,53,26,29,12,24,3,4,9,38,53,3,2,40,62,25,40,10,22,2,6,10,35,62
2007-07-16 00:00:00.000,Los Angeles CA; U.S.A. ATP World Tour,HARD,2,Hyung-Taik Lee,Marat Safin,Hyung-Taik Lee,4-6; 7-5; 6-4,Q,134,0,1,40,87,28,40,33,47,4,6,16,61,87,16,5,63,115,46,63,23,52,12,15,16,69,115
2007-07-16 00:00:00.000,Los Angeles CA; U.S.A. ATP World Tour,HARD,2,James Blake,Vincent Spadea,James Blake,7-6(2); 6-4,Q,82,5,3,34,69,25,34,21,35,3,5,11,46,69,3,2,45,71,29,45,13,26,2,5,11,42,71
2007-07-16 00:00:00.000,Los Angeles CA; U.S.A. ATP World Tour,HARD,2,Radek Stepanek,Nicolas Kiefer,Radek Stepanek,W/O,S,0,0,0,0,0,0,0,0,0,0,0,0,0,0,0,0,0,0,0,0,0,0,0,0,0,0,0
2007-07-16 00:00:00.000,Los Angeles CA; U.S.A. ATP World Tour,HARD,2,James Blake,Hyung-Taik Lee,James Blake,6-3; 4-6; 6-3,S,108,10,3,59,100,45,59,16,41,3,5,14,61,100,4,3,60,93,37,60,17,33,11,15,14,54,93
2007-07-16 00:00:00.000,Los Angeles CA; U.S.A. ATP World Tour,HARD,2,Radek Stepanek,James Blake,Radek Stepanek,7-6(7); 5-7; 6-2,F,140,8,3,65,100,51,65,17,35,6,8,16,68,100,8,4,68,116,49,68,22,48,6,9,16,71,116
2007-07-16 00:00:00.000,Stuttgart Germany ATP World Tour,CLAY,2,Rafael Nadal,Alexander Waske,Rafael Nadal,6-1; 6-1,R32,73,4,2,29,43,22,29,9,14,2,2,7,31,43,3,6,21,54,11,21,10,33,8,13,7,21,54
2007-07-16 00:00:00.000,Stuttgart Germany ATP World Tour,CLAY,2,Philipp Kohlschreiber,Simon Greul,Philipp Kohlschreiber,6-1; 6-2,R32,54,1,2,29,45,21,29,11,16,0,0,8,32,45,0,1,21,36,8,21,8,15,1,5,7,16,36
2007-07-16 00:00:00.000,Stuttgart Germany ATP World Tour,CLAY,2,Stefan Koubek,Jose Acasuso,Stefan Koubek,6-2; 7-5,R32,91,10,1,37,64,32,37,12,27,5,6,10,44,64,1,7,51,96,34,51,19,45,12,16,10,53,96
2007-07-16 00:00:00.000,Stuttgart Germany ATP World Tour,CLAY,2,Juan Monaco,Jan Hernych,Juan Monaco,6-2; 6-1,R32,61,5,0,20,44,19,20,15,24,0,0,8,34,44,0,2,26,44,14,26,9,18,1,5,7,23,44
2007-07-16 00:00:00.000,Stuttgart Germany ATP World Tour,CLAY,2,Tomas Berdych,Nicolas Lapentti,Tomas Berdych,6-1; 6-1,R32,50,3,1,18,39,15,18,15,21,1,1,7,30,39,0,4,26,40,14,26,1,14,4,9,7,15,40
2007-07-16 00:00:00.000,Stuttgart Germany ATP World Tour,CLAY,2,Feliciano Lopez,Carlos Berlocq,Feliciano Lopez,6-7(5); 7-6(7); 6-4,R32,155,16,2,61,110,53,61,26,49,7,8,17,79,110,9,3,65,109,46,65,32,44,3,5,17,78,109
2007-07-16 00:00:00.000,Stuttgart Germany ATP World Tour,CLAY,2,Diego Hartfield,Jan Hajek,Diego Hartfield,6-4; 6-2,R32,74,3,1,30,48,26,30,10,18,0,0,9,36,48,1,2,39,64,24,39,13,25,6,9,9,37,64
2007-07-16 00:00:00.000,Stuttgart Germany ATP World Tour,CLAY,2,Juan Carlos Ferrero,Gaston Gaudio,Juan Carlos Ferrero,6-1; 6-2,R32,72,4,2,21,47,16,21,13,26,3,4,7,29,47,1,8,28,52,14,28,7,24,3,9,8,21,52
2007-07-16 00:00:00.000,Stuttgart Germany ATP World Tour,CLAY,2,Juan Ignacio Chela,Max Mirnyi,Juan Ignacio Chela,6-3; 6-3,R32,75,4,7,31,56,24,31,13,25,6,7,9,37,56,3,8,13,54,8,13,20,41,3,7,9,28,54
2007-07-16 00:00:00.000,Stuttgart Germany ATP World Tour,CLAY,2,Boris Pashanski,Guillermo Garcia-Lopez,Boris Pashanski,1-6; 6-2; 6-4,R32,138,5,8,46,93,30,46,23,47,8,12,13,53,93,4,3,51,89,30,51,19,38,7,11,12,49,89
2007-07-16 00:00:00.000,Stuttgart Germany ATP World Tour,CLAY,2,Fernando Verdasco,Florian Mayer,Fernando Verdasco,6-3; 6-2,R32,69,3,2,33,50,23,33,12,17,2,3,9,35,50,4,2,38,59,23,38,7,21,8,12,8,30,59
2007-07-16 00:00:00.000,Stuttgart Germany ATP World Tour,CLAY,2,David Ferrer,Lukas Lacko,David Ferrer,6-2; 6-2,R32,51,2,0,29,40,26,29,7,11,3,3,8,33,40,1,1,26,45,14,26,8,19,0,4,8,22,45
2007-07-16 00:00:00.000,Stuttgart Germany ATP World Tour,CLAY,2,Stanislas Wawrinka,Guillermo Canas,Stanislas Wawrinka,6-7(5); 6-2; 1-0 RET,R32,134,6,3,30,66,22,30,24,36,4,5,10,46,66,5,3,40,90,29,40,21,50,7,11,11,50,90
2007-07-16 00:00:00.000,Stuttgart Germany ATP World Tour,CLAY,2,Marin Cilic,Benjamin Becker,Marin Cilic,6-3; 6-2,R32,70,14,4,25,51,21,25,14,26,4,5,9,35,51,5,2,15,56,11,15,19,41,3,7,8,30,56
2007-07-16 00:00:00.000,Stuttgart Germany ATP World Tour,CLAY,2,Jiri Vanek,Ivan Navarro,Jiri Vanek,6-1; 6-1,R32,73,5,1,24,41,18,24,12,17,1,1,7,30,41,6,3,32,54,18,32,6,22,5,10,7,24,54
2007-07-16 00:00:00.000,Stuttgart Germany ATP World Tour,CLAY,2,Gael Monfils,Tommy Robredo,Gael Monfils,7-6(5); 6-2,R32,90,11,2,35,66,28,35,20,31,3,3,10,48,66,1,3,42,62,30,42,10,20,3,5,10,40,62
2007-07-16 00:00:00.000,Stuttgart Germany ATP World Tour,CLAY,2,Rafael Nadal,Philipp Kohlschreiber,Rafael Nadal,6-3; 6-3,R16,101,1,1,29,47,22,29,11,18,0,1,9,33,47,2,3,31,70,21,31,15,39,7,11,9,36,70
2007-07-16 00:00:00.000,Stuttgart Germany ATP World Tour,CLAY,2,Juan Monaco,Stefan Koubek,Juan Monaco,6-2; 3-6; 6-3,R16,104,8,1,45,77,33,45,18,32,3,5,13,51,77,2,6,47,94,30,47,22,47,11,15,13,52,94
2007-07-16 00:00:00.000,Stuttgart Germany ATP World Tour,CLAY,2,Feliciano Lopez,Tomas Berdych,Feliciano Lopez,6-0; 6-3,R16,51,5,1,22,38,21,22,11,16,0,0,8,32,38,2,2,23,39,12,23,8,16,1,5,7,20,39
2007-07-16 00:00:00.000,Stuttgart Germany ATP World Tour,CLAY,2,Juan Carlos Ferrero,Diego Hartfield,Juan Carlos Ferrero,6-4; 1-6; 6-3,R16,123,5,5,55,90,38,55,18,35,6,8,13,56,90,4,3,50,78,32,50,19,28,3,5,13,51,78
2007-07-16 00:00:00.000,Stuttgart Germany ATP World Tour,CLAY,2,Juan Ignacio Chela,Boris Pashanski,Juan Ignacio Chela,7-5; 4-6; 6-4,R16,168,3,5,55,106,36,55,29,51,7,10,16,65,106,1,4,67,114,40,67,25,47,8,12,16,65,114
2007-07-16 00:00:00.000,Stuttgart Germany ATP World Tour,CLAY,2,Fernando Verdasco,David Ferrer,Fernando Verdasco,7-5; 6-3,R16,93,2,1,52,62,35,52,5,10,3,5,10,40,62,0,5,36,66,22,36,12,30,1,6,11,34,66
2007-07-16 00:00:00.000,Stuttgart Germany ATP World Tour,CLAY,2,Stanislas Wawrinka,Marin Cilic,Stanislas Wawrinka,6-4; 6-1,R16,79,2,4,28,58,22,28,15,30,1,2,9,37,58,5,1,22,52,14,22,13,30,9,13,8,27,52
2007-07-16 00:00:00.000,Stuttgart Germany ATP World Tour,CLAY,2,Jiri Vanek,Gael Monfils,Jiri Vanek,1-6; 7-6(4); 6-2,R16,111,3,4,43,91,32,43,26,48,6,8,13,58,91,17,5,44,79,37,44,21,35,2,4,14,58,79
2007-07-16 00:00:00.000,Stuttgart Germany ATP World Tour,CLAY,2,Rafael Nadal,Juan Monaco,Rafael Nadal,6-1; 6-3,Q,77,3,0,28,39,23,28,9,11,0,0,8,32,39,3,6,31,63,18,31,15,32,4,8,8,33,63
2007-07-16 00:00:00.000,Stuttgart Germany ATP World Tour,CLAY,2,Feliciano Lopez,Juan Carlos Ferrero,Feliciano Lopez,6-4; 3-6; 6-4,Q,125,10,8,50,96,35,50,27,46,4,6,15,62,96,5,2,60,91,43,60,17,31,4,6,14,60,91
2007-07-16 00:00:00.000,Stuttgart Germany ATP World Tour,CLAY,2,Juan Ignacio Chela,Fernando Verdasco,Juan Ignacio Chela,2-6; 6-3; 6-2,Q,124,2,4,52,84,35,52,19,32,5,7,13,54,84,1,2,62,72,39,62,5,10,5,8,12,44,72
2007-07-16 00:00:00.000,Stuttgart Germany ATP World Tour,CLAY,2,Stanislas Wawrinka,Jiri Vanek,Stanislas Wawrinka,6-1; 6-4,Q,60,8,6,29,55,24,29,12,26,2,3,9,36,55,1,3,36,54,20,36,6,18,4,8,8,26,54
2007-07-16 00:00:00.000,Stuttgart Germany ATP World Tour,CLAY,2,Rafael Nadal,Feliciano Lopez,Rafael Nadal,6-1; 7-5,S,86,5,1,35,52,29,35,12,17,0,0,10,41,52,4,2,40,65,26,40,11,25,3,6,9,37,65
2007-07-16 00:00:00.000,Stuttgart Germany ATP World Tour,CLAY,2,Stanislas Wawrinka,Juan Ignacio Chela,Stanislas Wawrinka,6-7(2); 6-4; 6-1,S,155,8,2,63,98,39,63,20,35,8,11,14,59,98,1,5,69,118,41,69,19,49,7,14,15,60,118
2007-07-16 00:00:00.000,Stuttgart Germany ATP World Tour,CLAY,2,Rafael Nadal,Stanislas Wawrinka,Rafael Nadal,6-4; 7-5,F,129,1,3,56,79,36,56,10,23,6,9,11,46,79,5,6,36,72,20,36,18,36,7,12,11,38,72
2007-07-23 00:00:00.000,Indianapolis IN; U.S.A. ATP World Tour,HARD,2,Andy Roddick,Alex Kuznetsov,Andy Roddick,6-4; 6-0,R32,63,8,0,22,42,19,22,13,20,0,0,8,32,42,3,6,35,58,22,35,7,23,7,11,8,29,58
2007-07-23 00:00:00.000,Indianapolis IN; U.S.A. ATP World Tour,HARD,2,Evgeny Korolev,Justin Gimelstob,Evgeny Korolev,6-2; 6-4,R32,73,9,3,28,51,23,28,14,23,0,0,9,37,51,6,3,32,69,21,32,17,37,9,12,9,38,69
2007-07-23 00:00:00.000,Indianapolis IN; U.S.A. ATP World Tour,HARD,2,Paul Goldstein,Robert Kendrick,Paul Goldstein,6-4; 6-4,R32,87,3,2,55,86,37,55,15,31,7,9,10,52,86,6,7,42,71,25,42,13,29,4,8,10,38,71
2007-07-23 00:00:00.000,Indianapolis IN; U.S.A. ATP World Tour,HARD,2,Hyung-Taik Lee,Donald Young,Hyung-Taik Lee,6-2; 6-4,R32,68,0,1,38,59,26,38,12,21,4,5,9,38,59,1,6,34,65,24,34,12,31,5,9,9,36,65
2007-07-23 00:00:00.000,Indianapolis IN; U.S.A. ATP World Tour,HARD,2,Mardy Fish,Vincent Spadea,Mardy Fish,2-6; 7-5; 7-5,R32,129,10,5,50,106,38,50,26,56,8,12,16,64,106,5,3,53,95,36,53,21,42,8,12,16,57,95
2007-07-23 00:00:00.000,Indianapolis IN; U.S.A. ATP World Tour,HARD,2,Igor Kunitsyn,Santiago Giraldo,Igor Kunitsyn,6-2; 1-6; 7-5,R32,122,0,2,61,88,38,61,14,27,7,11,13,52,88,3,3,75,107,47,75,14,32,17,22,14,61,107
2007-07-23 00:00:00.000,Indianapolis IN; U.S.A. ATP World Tour,HARD,2,Juan Martin Del Potro,Amer Delic,Juan Martin Del Potro,7-5; 7-6(5),R32,105,11,4,49,82,41,49,17,33,5,5,12,58,82,11,1,49,81,40,49,15,32,3,4,12,55,81
2007-07-23 00:00:00.000,Indianapolis IN; U.S.A. ATP World Tour,HARD,2,Frank Dancevic,Benjamin Becker,Frank Dancevic,6-4; 6-3,R32,71,14,3,32,66,25,32,21,34,6,6,9,46,66,2,3,29,62,19,29,18,33,6,9,10,37,62
2007-07-23 00:00:00.000,Indianapolis IN; U.S.A. ATP World Tour,HARD,2,Michael Berrer,Robby Ginepri,Michael Berrer,3-6; 6-2; 6-1,R32,84,8,1,36,59,28,36,18,23,1,2,12,46,59,3,5,49,84,30,49,18,35,5,9,12,48,84
2007-07-23 00:00:00.000,Indianapolis IN; U.S.A. ATP World Tour,HARD,2,Kei Nishikori,Alejandro Falla,Kei Nishikori,6-4; 6-3,R32,89,2,5,36,71,26,36,20,35,8,10,10,46,71,1,1,41,61,24,41,8,20,4,8,9,32,61
2007-07-23 00:00:00.000,Indianapolis IN; U.S.A. ATP World Tour,HARD,2,Teymuraz Gabashvili,Rajeev Ram,Teymuraz Gabashvili,7-5; 3-6; 6-4,R32,122,8,7,58,110,40,58,24,52,8,12,16,64,110,6,4,49,83,35,49,18,34,5,9,15,53,83
2007-07-23 00:00:00.000,Indianapolis IN; U.S.A. ATP World Tour,HARD,2,Dmitry Tursunov,Michael Russell,Dmitry Tursunov,6-3; 7-5,R32,83,11,3,30,65,24,30,22,35,3,4,11,46,65,5,4,42,59,28,42,6,17,2,5,10,34,59
2007-07-23 00:00:00.000,Indianapolis IN; U.S.A. ATP World Tour,HARD,2,Ivo Karlovic,Andre Sa,Ivo Karlovic,6-4; 6-7(5); 7-6(3),R32,151,24,3,69,105,57,69,18,36,2,3,17,75,105,0,5,80,119,57,80,19,39,2,4,17,76,119
2007-07-23 00:00:00.000,Indianapolis IN; U.S.A. ATP World Tour,HARD,2,Sam Querrey,Julien Benneteau,Sam Querrey,7-6(6); 6-1,R32,85,19,3,39,61,35,39,10,22,2,2,9,45,61,5,3,35,67,24,35,16,32,2,5,10,40,67
2007-07-23 00:00:00.000,Indianapolis IN; U.S.A. ATP World Tour,HARD,2,Ricardo Mello,Gael Monfils,Ricardo Mello,6-4; 6-4,R32,74,0,1,43,60,31,43,11,17,1,1,10,42,60,6,4,34,69,24,34,19,35,3,5,10,43,69
2007-07-23 00:00:00.000,Indianapolis IN; U.S.A. ATP World Tour,HARD,2,James Blake,Thomas Johansson,James Blake,7-5; 7-6(9),R32,102,13,2,44,75,36,44,18,31,1,2,12,54,75,11,3,50,99,38,50,22,49,10,12,12,60,99
2007-07-23 00:00:00.000,Indianapolis IN; U.S.A. ATP World Tour,HARD,2,Andy Roddick,Evgeny Korolev,Andy Roddick,6-3; 6-2,R16,66,6,0,27,51,21,27,15,24,1,2,9,36,51,1,5,32,54,19,32,7,22,5,9,8,26,54
2007-07-23 00:00:00.000,Indianapolis IN; U.S.A. ATP World Tour,HARD,2,Hyung-Taik Lee,Paul Goldstein,Hyung-Taik Lee,6-3; 6-3,R16,66,4,1,22,47,19,22,15,25,0,1,9,34,47,4,4,27,60,19,27,14,33,5,9,9,33,60
2007-07-23 00:00:00.000,Indianapolis IN; U.S.A. ATP World Tour,HARD,2,Igor Kunitsyn,Mardy Fish,Igor Kunitsyn,6-4 RET,R16,50,2,1,15,26,13,15,7,11,0,0,5,20,26,3,1,17,33,13,17,6,16,0,1,5,19,33
2007-07-23 00:00:00.000,Indianapolis IN; U.S.A. ATP World Tour,HARD,2,Frank Dancevic,Juan Martin Del Potro,Frank Dancevic,3-6; 7-6(5); 6-4,R16,130,17,2,50,92,39,50,26,42,3,5,15,65,92,7,9,58,111,48,58,25,53,4,6,16,73,111
2007-07-23 00:00:00.000,Indianapolis IN; U.S.A. ATP World Tour,HARD,2,Kei Nishikori,Michael Berrer,Kei Nishikori,6-3; 3-6; 6-1,R16,97,2,1,51,79,39,51,16,28,3,4,13,55,79,6,2,45,68,32,45,11,23,5,8,12,43,68
2007-07-23 00:00:00.000,Indianapolis IN; U.S.A. ATP World Tour,HARD,2,Dmitry Tursunov,Teymuraz Gabashvili,Dmitry Tursunov,6-3; 0-6; 6-2,R16,82,7,8,36,67,24,36,17,31,1,4,12,41,67,7,3,42,64,29,42,11,22,4,7,11,40,64
2007-07-23 00:00:00.000,Indianapolis IN; U.S.A. ATP World Tour,HARD,2,Sam Querrey,Ivo Karlovic,Sam Querrey,5-7; 7-5; 7-6(6),R16,140,14,2,52,101,47,52,31,49,2,3,18,78,101,17,2,65,108,56,65,22,43,6,7,18,78,108
2007-07-23 00:00:00.000,Indianapolis IN; U.S.A. ATP World Tour,HARD,2,James Blake,Ricardo Mello,James Blake,6-4; 6-2,R16,67,8,0,26,47,22,26,14,21,0,0,9,36,47,3,2,41,67,23,41,15,26,5,8,9,38,67
2007-07-23 00:00:00.000,Indianapolis IN; U.S.A. ATP World Tour,HARD,2,Andy Roddick,Hyung-Taik Lee,Andy Roddick,6-3; 6-7(7); 6-1,Q,127,16,1,47,79,40,47,26,32,3,3,15,66,79,4,5,56,98,40,56,21,42,6,9,13,61,98
2007-07-23 00:00:00.000,Indianapolis IN; U.S.A. ATP World Tour,HARD,2,Frank Dancevic,Igor Kunitsyn,Frank Dancevic,6-4; 7-6(3),Q,87,11,2,35,64,29,35,15,29,6,9,11,44,64,1,2,32,63,18,32,18,31,2,6,11,36,63
2007-07-23 00:00:00.000,Indianapolis IN; U.S.A. ATP World Tour,HARD,2,Dmitry Tursunov,Kei Nishikori,Dmitry Tursunov,6-1; 6-4,Q,71,8,3,33,60,26,33,13,27,5,6,9,39,60,5,4,28,58,16,28,14,30,6,10,8,30,58
2007-07-23 00:00:00.000,Indianapolis IN; U.S.A. ATP World Tour,HARD,2,Sam Querrey,James Blake,Sam Querrey,7-6(6); 6-7(4); 7-6(4),Q,125,34,3,76,119,67,76,23,43,0,0,18,90,119,10,3,66,122,57,66,32,56,1,1,18,89,122
2007-07-23 00:00:00.000,Indianapolis IN; U.S.A. ATP World Tour,HARD,2,Frank Dancevic,Andy Roddick,Frank Dancevic,6-4; 7-6(1),S,96,15,1,34,66,26,34,22,32,5,6,11,48,66,8,5,37,78,26,37,21,41,3,5,11,47,78
2007-07-23 00:00:00.000,Indianapolis IN; U.S.A. ATP World Tour,HARD,2,Dmitry Tursunov,Sam Querrey,Dmitry Tursunov,7-6(5); 6-2,S,74,7,2,33,56,26,33,16,23,0,1,10,42,56,10,3,36,64,28,36,10,28,4,7,10,38,64
2007-07-23 00:00:00.000,Indianapolis IN; U.S.A. ATP World Tour,HARD,2,Dmitry Tursunov,Frank Dancevic,Dmitry Tursunov,6-4; 7-5,F,77,3,2,26,54,26,26,18,28,0,0,11,44,54,11,4,29,65,26,29,17,36,2,4,11,43,65
2007-07-23 00:00:00.000,Kitzbuhel Austria ATP World Tour,CLAY,2,Tommy Robredo,N/A Bye,Tommy Robredo,,R64,0,0,0,0,0,0,0,0,0,0,0,0,0,0,0,0,0,0,0,0,0,0,0,0,0,0,0
2007-07-23 00:00:00.000,Kitzbuhel Austria ATP World Tour,CLAY,2,Juan-Pablo Guzman,Peter Luczak,Juan-Pablo Guzman,6-3; 6-4,R64,71,6,1,38,53,29,38,13,15,3,3,10,42,53,3,3,31,61,19,31,16,30,6,8,9,35,61
2007-07-23 00:00:00.000,Kitzbuhel Austria ATP World Tour,CLAY,2,Olivier Patience,Jan Hajek,Olivier Patience,6-3; 6-2,R64,71,5,3,22,57,20,22,21,35,0,0,9,41,57,3,3,26,57,17,26,17,31,8,11,8,34,57
2007-07-23 00:00:00.000,Kitzbuhel Austria ATP World Tour,CLAY,2,Igor Andreev,N/A Bye,Igor Andreev,,R64,0,0,0,0,0,0,0,0,0,0,0,0,0,0,0,0,0,0,0,0,0,0,0,0,0,0,0
2007-07-23 00:00:00.000,Kitzbuhel Austria ATP World Tour,CLAY,2,Philipp Kohlschreiber,N/A Bye,Philipp Kohlschreiber,,R64,0,0,0,0,0,0,0,0,0,0,0,0,0,0,0,0,0,0,0,0,0,0,0,0,0,0,0
2007-07-23 00:00:00.000,Kitzbuhel Austria ATP World Tour,CLAY,2,Paul Capdeville,Hugo Armando,Paul Capdeville,6-0; 6-3,R64,60,4,3,26,40,20,26,7,14,0,1,7,27,40,1,4,37,65,18,37,10,28,6,12,8,28,65
2007-07-23 00:00:00.000,Kitzbuhel Austria ATP World Tour,CLAY,2,Mariano Zabaleta,Federico Luzzi,Mariano Zabaleta,7-6(5); 6-2,R64,83,8,2,44,72,32,44,14,28,1,3,10,46,72,2,3,26,60,19,26,13,34,2,6,10,32,60
2007-07-23 00:00:00.000,Kitzbuhel Austria ATP World Tour,CLAY,2,Juan Monaco,N/A Bye,Juan Monaco,,R64,0,0,0,0,0,0,0,0,0,0,0,0,0,0,0,0,0,0,0,0,0,0,0,0,0,0,0
2007-07-23 00:00:00.000,Kitzbuhel Austria ATP World Tour,CLAY,2,Juan Ignacio Chela,N/A Bye,Juan Ignacio Chela,,R64,0,0,0,0,0,0,0,0,0,0,0,0,0,0,0,0,0,0,0,0,0,0,0,0,0,0,0
2007-07-23 00:00:00.000,Kitzbuhel Austria ATP World Tour,CLAY,2,Daniel Koellerer,Stefan Koubek,Daniel Koellerer,6-4; 6-0,R64,60,2,3,23,45,18,23,14,22,0,1,8,32,45,3,3,21,45,11,21,9,24,2,7,8,20,45
2007-07-23 00:00:00.000,Kitzbuhel Austria ATP World Tour,CLAY,2,Sergio Roitman,Guillermo Garcia-Lopez,Sergio Roitman,2-6; 6-1; 6-1,R64,76,0,1,45,61,30,45,7,16,2,5,11,37,61,1,2,37,65,22,37,8,28,5,11,11,30,65
2007-07-23 00:00:00.000,Kitzbuhel Austria ATP World Tour,CLAY,2,Nicolas Massu,N/A Bye,Nicolas Massu,,R64,0,0,0,0,0,0,0,0,0,0,0,0,0,0,0,0,0,0,0,0,0,0,0,0,0,0,0
2007-07-23 00:00:00.000,Kitzbuhel Austria ATP World Tour,CLAY,2,Fernando Verdasco,N/A Bye,Fernando Verdasco,,R64,0,0,0,0,0,0,0,0,0,0,0,0,0,0,0,0,0,0,0,0,0,0,0,0,0,0,0
2007-07-23 00:00:00.000,Kitzbuhel Austria ATP World Tour,CLAY,2,Luis Horna,Jeremy Chardy,Luis Horna,7-5; 6-3,R64,74,3,0,36,60,33,36,12,24,2,3,11,45,60,5,3,32,54,22,32,13,22,4,7,10,35,54
2007-07-23 00:00:00.000,Kitzbuhel Austria ATP World Tour,CLAY,2,Ivan Navarro,Konstantinos Economidis,Ivan Navarro,6-4; 6-2,R64,74,4,1,32,47,24,32,12,15,3,4,9,36,47,3,4,35,52,21,35,5,17,4,8,9,26,52
2007-07-23 00:00:00.000,Kitzbuhel Austria ATP World Tour,CLAY,2,Nicolas Almagro,N/A Bye,Nicolas Almagro,,R64,0,0,0,0,0,0,0,0,0,0,0,0,0,0,0,0,0,0,0,0,0,0,0,0,0,0,0
2007-07-23 00:00:00.000,Kitzbuhel Austria ATP World Tour,CLAY,2,Florian Mayer,N/A Bye,Florian Mayer,,R64,0,0,0,0,0,0,0,0,0,0,0,0,0,0,0,0,0,0,0,0,0,0,0,0,0,0,0
2007-07-23 00:00:00.000,Kitzbuhel Austria ATP World Tour,CLAY,2,Martin Vassallo Arguello,Jonathan Eysseric,Martin Vassallo Arguello,6-2; 6-3,R64,91,2,1,32,48,23,32,12,16,0,0,8,35,48,1,5,31,64,22,31,13,33,8,12,9,35,64
2007-07-23 00:00:00.000,Kitzbuhel Austria ATP World Tour,CLAY,2,Christophe Rochus,Chris Guccione,Christophe Rochus,7-6(6); 7-6(10),R64,125,5,1,68,100,49,68,20,32,9,10,12,69,100,14,7,61,110,47,61,23,49,6,7,12,70,110
2007-07-23 00:00:00.000,Kitzbuhel Austria ATP World Tour,CLAY,2,Potito Starace,N/A Bye,Potito Starace,,R64,0,0,0,0,0,0,0,0,0,0,0,0,0,0,0,0,0,0,0,0,0,0,0,0,0,0,0
2007-07-23 00:00:00.000,Kitzbuhel Austria ATP World Tour,CLAY,2,Werner Eschauer,N/A Bye,Werner Eschauer,,R64,0,0,0,0,0,0,0,0,0,0,0,0,0,0,0,0,0,0,0,0,0,0,0,0,0,0,0
2007-07-23 00:00:00.000,Kitzbuhel Austria ATP World Tour,CLAY,2,Fabio Fognini,Juan Pablo Brzezicki,Fabio Fognini,6-4; 6-3,R64,77,1,2,27,62,23,27,16,35,5,7,10,39,62,0,3,29,48,18,29,7,19,1,5,9,25,48
2007-07-23 00:00:00.000,Kitzbuhel Austria ATP World Tour,CLAY,2,Andreas Seppi,Feliciano Lopez,Andreas Seppi,5-7; 6-0; 7-6(3),R64,118,8,6,57,89,41,57,18,32,2,5,15,59,89,12,8,58,101,41,58,17,43,5,10,15,58,101
2007-07-23 00:00:00.000,Kitzbuhel Austria ATP World Tour,CLAY,2,Juan Carlos Ferrero,N/A Bye,Juan Carlos Ferrero,,R64,0,0,0,0,0,0,0,0,0,0,0,0,0,0,0,0,0,0,0,0,0,0,0,0,0,0,0
2007-07-23 00:00:00.000,Kitzbuhel Austria ATP World Tour,CLAY,2,Agustin Calleri,N/A Bye,Agustin Calleri,,R64,0,0,0,0,0,0,0,0,0,0,0,0,0,0,0,0,0,0,0,0,0,0,0,0,0,0,0
2007-07-23 00:00:00.000,Kitzbuhel Austria ATP World Tour,CLAY,2,Rainer Eitzinger,Max Mirnyi,Rainer Eitzinger,6-4; 3-6; 7-6(3),R64,123,0,4,82,108,54,82,15,26,5,7,15,69,108,11,5,48,96,37,48,27,48,3,5,16,64,96
2007-07-23 00:00:00.000,Kitzbuhel Austria ATP World Tour,CLAY,2,Diego Hartfield,Martin Fischer,Diego Hartfield,5-7; 6-4; 6-2,R64,137,7,4,66,101,47,66,17,35,7,10,15,64,101,1,4,46,95,28,46,25,49,3,8,15,53,95
2007-07-23 00:00:00.000,Kitzbuhel Austria ATP World Tour,CLAY,2,Oscar Hernandez,N/A Bye,Oscar Hernandez,,R64,0,0,0,0,0,0,0,0,0,0,0,0,0,0,0,0,0,0,0,0,0,0,0,0,0,0,0
2007-07-23 00:00:00.000,Kitzbuhel Austria ATP World Tour,CLAY,2,Nicolas Lapentti,N/A Bye,Nicolas Lapentti,,R64,0,0,0,0,0,0,0,0,0,0,0,0,0,0,0,0,0,0,0,0,0,0,0,0,0,0,0
2007-07-23 00:00:00.000,Kitzbuhel Austria ATP World Tour,CLAY,2,Laurent Recouderc,Ernests Gulbis,Laurent Recouderc,5-7; 6-3; 6-4,R64,103,3,0,53,82,37,53,21,29,4,7,16,58,82,3,7,63,106,41,63,20,43,9,13,15,61,106
2007-07-23 00:00:00.000,Kitzbuhel Austria ATP World Tour,CLAY,2,Alexander Peya,Oliver Marach,Alexander Peya,6-3; 7-6(5),R64,99,12,1,38,65,33,38,15,27,2,3,11,48,65,0,3,47,70,33,47,11,23,5,7,10,44,70
2007-07-23 00:00:00.000,Kitzbuhel Austria ATP World Tour,CLAY,2,Mikhail Youzhny,N/A Bye,Mikhail Youzhny,,R64,0,0,0,0,0,0,0,0,0,0,0,0,0,0,0,0,0,0,0,0,0,0,0,0,0,0,0
2007-07-23 00:00:00.000,Kitzbuhel Austria ATP World Tour,CLAY,2,Tommy Robredo,Juan-Pablo Guzman,Tommy Robredo,6-1; 6-4,R32,72,4,2,47,65,34,47,11,18,10,10,9,45,65,0,4,16,48,11,16,16,32,2,5,8,27,48
2007-07-23 00:00:00.000,Kitzbuhel Austria ATP World Tour,CLAY,2,Igor Andreev,Olivier Patience,Igor Andreev,7-6(5); 6-2,R32,91,5,0,45,60,29,45,10,15,3,5,10,39,60,2,1,49,78,27,49,15,29,5,9,10,42,78
2007-07-23 00:00:00.000,Kitzbuhel Austria ATP World Tour,CLAY,2,Philipp Kohlschreiber,Paul Capdeville,Philipp Kohlschreiber,6-4; 6-1,R32,74,0,0,33,51,20,33,14,18,6,7,8,34,51,3,5,33,60,21,33,7,27,1,6,9,28,60
2007-07-23 00:00:00.000,Kitzbuhel Austria ATP World Tour,CLAY,2,Juan Monaco,Mariano Zabaleta,Juan Monaco,6-1; 2-6; 6-3,R32,100,3,1,46,80,28,46,19,34,7,11,12,47,80,3,5,41,76,24,41,15,35,5,11,12,39,76
2007-07-23 00:00:00.000,Kitzbuhel Austria ATP World Tour,CLAY,2,Juan Ignacio Chela,Daniel Koellerer,Juan Ignacio Chela,3-6; 6-3; 6-2,R32,168,4,6,51,108,37,51,24,57,14,18,13,61,108,1,4,47,89,28,47,17,42,3,9,13,45,89
2007-07-23 00:00:00.000,Kitzbuhel Austria ATP World Tour,CLAY,2,Sergio Roitman,Nicolas Massu,Sergio Roitman,7-5; 6-2,R32,106,2,1,37,68,22,37,18,31,2,4,10,40,68,0,3,29,65,20,29,13,36,7,12,10,33,65
2007-07-23 00:00:00.000,Kitzbuhel Austria ATP World Tour,CLAY,2,Fernando Verdasco,Luis Horna,Fernando Verdasco,6-1; 6-4,R32,72,0,2,36,44,29,36,2,8,0,1,8,31,44,0,2,31,50,18,31,5,19,4,9,9,23,50
2007-07-23 00:00:00.000,Kitzbuhel Austria ATP World Tour,CLAY,2,Nicolas Almagro,Ivan Navarro,Nicolas Almagro,7-5; 6-3,R32,89,11,3,37,73,30,37,21,36,6,6,11,51,73,5,1,28,54,23,28,13,26,0,2,10,36,54
2007-07-23 00:00:00.000,Kitzbuhel Austria ATP World Tour,CLAY,2,Florian Mayer,Martin Vassallo Arguello,Florian Mayer,6-1; 6-3,R32,59,5,0,28,41,23,28,9,13,0,0,8,32,41,3,3,30,48,17,30,7,18,2,6,8,24,48
2007-07-23 00:00:00.000,Kitzbuhel Austria ATP World Tour,CLAY,2,Potito Starace,Christophe Rochus,Potito Starace,6-2; 6-2,R32,68,4,2,36,52,26,36,9,16,4,5,8,35,52,0,2,29,49,14,29,8,20,2,7,8,22,49
2007-07-23 00:00:00.000,Kitzbuhel Austria ATP World Tour,CLAY,2,Fabio Fognini,Werner Eschauer,Fabio Fognini,4-6; 6-4; 7-5,R32,136,6,3,54,98,38,54,21,44,3,7,16,59,98,7,4,60,103,41,60,22,43,9,14,16,63,103
2007-07-23 00:00:00.000,Kitzbuhel Austria ATP World Tour,CLAY,2,Andreas Seppi,Juan Carlos Ferrero,Andreas Seppi,7-6(3); 4-6; 6-2,R32,128,5,7,51,91,38,51,22,40,3,6,15,60,91,4,2,58,90,37,58,17,32,3,7,15,54,90
2007-07-23 00:00:00.000,Kitzbuhel Austria ATP World Tour,CLAY,2,Agustin Calleri,Rainer Eitzinger,Agustin Calleri,6-3; 7-6(4),R32,84,6,6,30,61,28,30,14,31,3,4,10,42,61,0,3,65,76,37,65,6,11,7,10,11,43,76
2007-07-23 00:00:00.000,Kitzbuhel Austria ATP World Tour,CLAY,2,Diego Hartfield,Oscar Hernandez,Diego Hartfield,5-7; 6-0; 6-3,R32,124,5,4,53,84,41,53,14,31,3,6,14,55,84,2,7,40,68,23,40,12,28,2,8,13,35,68
2007-07-23 00:00:00.000,Kitzbuhel Austria ATP World Tour,CLAY,2,Nicolas Lapentti,Laurent Recouderc,Nicolas Lapentti,7-6(5); 6-2,R32,103,7,6,47,87,34,47,19,40,11,13,10,53,87,2,3,53,76,32,53,10,23,6,10,10,42,76
2007-07-23 00:00:00.000,Kitzbuhel Austria ATP World Tour,CLAY,2,Alexander Peya,Mikhail Youzhny,Alexander Peya,7-5; 6-0,R32,86,3,5,30,53,23,30,13,23,4,5,9,36,53,2,6,37,78,23,37,14,41,7,12,9,37,78
2007-07-23 00:00:00.000,Kitzbuhel Austria ATP World Tour,CLAY,2,Tommy Robredo,Igor Andreev,Tommy Robredo,4-6; 6-1; 7-6(5),R16,124,2,2,69,94,52,69,12,25,1,3,15,64,94,2,0,62,89,42,62,15,27,5,8,14,57,89
2007-07-23 00:00:00.000,Kitzbuhel Austria ATP World Tour,CLAY,2,Juan Monaco,Philipp Kohlschreiber,Juan Monaco,6-3; 6-3,R16,66,1,1,30,49,23,30,15,19,1,1,9,38,49,1,2,27,55,16,27,15,28,2,5,9,31,55
2007-07-23 00:00:00.000,Kitzbuhel Austria ATP World Tour,CLAY,2,Sergio Roitman,Juan Ignacio Chela,Sergio Roitman,5-7; 6-3; 6-4,R16,140,2,2,47,92,29,47,25,45,8,14,16,54,92,2,10,48,98,31,48,21,50,7,14,15,52,98
2007-07-23 00:00:00.000,Kitzbuhel Austria ATP World Tour,CLAY,2,Fernando Verdasco,Nicolas Almagro,Fernando Verdasco,6-2; 7-6(6),R16,93,0,2,49,71,31,49,15,22,3,4,10,46,71,5,3,30,64,22,30,16,34,3,6,10,38,64
2007-07-23 00:00:00.000,Kitzbuhel Austria ATP World Tour,CLAY,2,Potito Starace,Florian Mayer,Potito Starace,4-6; 7-6(0); 6-2,R16,128,1,3,60,97,36,60,21,37,4,8,15,57,97,7,5,47,91,29,47,23,44,4,9,15,52,91
2007-07-23 00:00:00.000,Kitzbuhel Austria ATP World Tour,CLAY,2,Andreas Seppi,Fabio Fognini,Andreas Seppi,7-6(3); 7-5,R16,110,6,2,46,72,29,46,17,26,3,7,12,46,72,6,7,39,89,27,39,20,50,6,11,12,47,89
2007-07-23 00:00:00.000,Kitzbuhel Austria ATP World Tour,CLAY,2,Agustin Calleri,Diego Hartfield,Agustin Calleri,7-5; 6-2,R16,81,8,4,25,55,21,25,19,30,0,1,10,40,55,3,2,29,64,18,29,16,35,3,7,10,34,64
2007-07-23 00:00:00.000,Kitzbuhel Austria ATP World Tour,CLAY,2,Nicolas Lapentti,Alexander Peya,Nicolas Lapentti,6-4; 6-4,R16,95,2,1,42,68,28,42,15,26,1,2,10,43,68,4,3,38,55,28,38,6,17,0,3,10,34,55
2007-07-23 00:00:00.000,Kitzbuhel Austria ATP World Tour,CLAY,2,Juan Monaco,Tommy Robredo,Juan Monaco,6-2; 2-6; 6-2,Q,104,6,3,43,72,27,43,13,29,2,7,12,40,72,3,6,40,74,22,40,14,34,9,16,12,36,74
2007-07-23 00:00:00.000,Kitzbuhel Austria ATP World Tour,CLAY,2,Fernando Verdasco,Sergio Roitman,Fernando Verdasco,7-6(6); 3-6; 6-3,Q,136,5,3,74,85,53,74,3,11,4,8,15,56,85,0,2,73,109,48,73,17,36,10,14,15,65,109
2007-07-23 00:00:00.000,Kitzbuhel Austria ATP World Tour,CLAY,2,Potito Starace,Andreas Seppi,Potito Starace,1-6; 7-5; 7-6(7),Q,142,3,1,64,95,35,64,18,31,7,14,16,53,95,2,5,49,91,34,49,20,42,3,8,15,54,91
2007-07-23 00:00:00.000,Kitzbuhel Austria ATP World Tour,CLAY,2,Agustin Calleri,Nicolas Lapentti,Agustin Calleri,7-6(5); 6-1,Q,84,4,2,31,53,25,31,14,22,1,2,9,39,53,4,1,39,70,25,39,12,31,5,9,10,37,70
2007-07-23 00:00:00.000,Kitzbuhel Austria ATP World Tour,CLAY,2,Juan Monaco,Fernando Verdasco,Juan Monaco,7-5; 7-5,S,87,2,0,44,62,36,44,13,18,1,1,12,49,62,1,0,48,63,33,48,11,15,0,2,12,44,63
2007-07-23 00:00:00.000,Kitzbuhel Austria ATP World Tour,CLAY,2,Potito Starace,Agustin Calleri,Potito Starace,6-4; 7-5,S,84,0,0,47,63,35,47,10,16,5,6,11,45,63,4,5,30,68,21,30,21,38,2,5,11,42,68
2007-07-23 00:00:00.000,Kitzbuhel Austria ATP World Tour,CLAY,2,Juan Monaco,Potito Starace,Juan Monaco,5-7; 6-3; 6-4,F,150,4,2,81,116,51,81,20,35,7,10,16,71,116,1,3,70,100,43,70,16,30,10,14,15,59,100
2007-07-23 00:00:00.000,Umag Croatia ATP World Tour,CLAY,2,Novak Djokovic,Pablo Andujar,Novak Djokovic,6-1; 6-3,R32,71,3,1,38,56,28,38,11,18,6,6,8,39,56,0,0,30,43,16,30,5,13,3,7,8,21,43
2007-07-23 00:00:00.000,Umag Croatia ATP World Tour,CLAY,2,Viktor Troicki,Predrag Rusevski,Viktor Troicki,6-3; 1-6; 6-4,R32,134,6,3,46,88,32,46,22,42,5,8,13,54,88,1,2,58,83,35,58,16,25,10,13,13,51,83
2007-07-23 00:00:00.000,Umag Croatia ATP World Tour,CLAY,2,Carlos Berlocq,Maximo Gonzalez,Carlos Berlocq,6-3; 6-4,R32,91,4,4,29,55,23,29,13,26,1,3,10,36,55,1,4,25,51,18,25,11,26,1,5,9,29,51
2007-07-23 00:00:00.000,Umag Croatia ATP World Tour,CLAY,2,Victor Hanescu,Janko Tipsarevic,Victor Hanescu,2-0 RET,R32,4,1,0,4,4,4,4,0,0,0,0,1,4,4,0,1,1,5,1,1,0,4,1,2,1,1,5
2007-07-23 00:00:00.000,Umag Croatia ATP World Tour,CLAY,2,Andrei Pavel,Ivan Ljubicic,Andrei Pavel,7-6(5); 7-5,R32,128,1,2,51,78,35,51,12,27,4,7,12,47,78,6,2,50,94,31,50,18,44,8,12,12,49,94
2007-07-23 00:00:00.000,Umag Croatia ATP World Tour,CLAY,2,Robin Haase,Felix Mantilla,Robin Haase,2-6; 6-4; 6-4,R32,117,3,2,59,97,37,59,21,38,3,6,14,58,97,0,2,64,88,38,64,17,24,5,8,14,55,88
2007-07-23 00:00:00.000,Umag Croatia ATP World Tour,CLAY,2,Mischa Zverev,Florent Serra,Mischa Zverev,6-0; 7-5,R32,81,3,1,31,57,23,31,18,26,3,4,9,41,57,3,3,39,61,22,39,8,22,3,8,9,30,61
2007-07-23 00:00:00.000,Umag Croatia ATP World Tour,CLAY,2,Filippo Volandri,Lukas Dlouhy,Filippo Volandri,6-2; 6-1,R32,63,0,1,57,67,34,57,6,10,4,6,8,40,67,0,2,23,45,6,23,10,22,6,12,7,16,45
2007-07-23 00:00:00.000,Umag Croatia ATP World Tour,CLAY,2,Carlos Moya,Stanislas Wawrinka,Carlos Moya,6-3; 6-2,R32,65,2,4,29,45,26,29,6,16,2,3,8,32,45,0,2,37,52,17,37,7,15,2,7,9,24,52
2007-07-23 00:00:00.000,Umag Croatia ATP World Tour,CLAY,2,Pere Riba,Luka Belic,Pere Riba,6-2; 2-6; 6-4,R32,141,2,3,47,80,30,47,19,33,5,8,13,49,80,7,5,57,92,38,57,16,35,8,12,13,54,92
2007-07-23 00:00:00.000,Umag Croatia ATP World Tour,CLAY,2,Jose Acasuso,Edouard Roger-Vasselin,Jose Acasuso,6-2; 6-0,R32,51,2,4,19,42,16,19,15,23,1,1,7,31,42,1,2,23,34,10,23,1,11,1,6,7,11,34
2007-07-23 00:00:00.000,Umag Croatia ATP World Tour,CLAY,2,David Ferrer,Albert Montanes,David Ferrer,6-2; 6-2,R32,73,1,2,29,48,23,29,9,19,2,3,8,32,48,0,1,24,48,13,24,9,24,2,7,8,22,48
2007-07-23 00:00:00.000,Umag Croatia ATP World Tour,CLAY,2,Guillermo Canas,Roko Karanusic,Guillermo Canas,6-3; 6-3,R32,94,2,1,37,64,26,37,17,27,5,5,9,43,64,3,1,31,59,24,31,10,28,2,5,9,34,59
2007-07-23 00:00:00.000,Umag Croatia ATP World Tour,CLAY,2,Ruben Ramirez Hidalgo,Gaston Gaudio,Ruben Ramirez Hidalgo,6-0; 6-4,R32,74,4,2,31,44,21,31,9,13,1,2,8,30,44,0,2,29,54,14,29,11,25,1,6,8,25,54
2007-07-23 00:00:00.000,Umag Croatia ATP World Tour,CLAY,2,Marin Cilic,Mathieu Montcourt,Marin Cilic,3-6; 6-4; 6-1,R32,125,6,3,36,85,29,36,25,49,8,11,13,54,85,0,6,40,75,23,40,19,35,1,6,13,42,75
2007-07-23 00:00:00.000,Umag Croatia ATP World Tour,CLAY,2,Gilles Simon,Nikolay Davydenko,Gilles Simon,6-2; 2-6; 6-3,R32,137,5,4,48,114,35,48,31,66,16,19,13,66,114,1,2,58,77,35,58,10,19,5,9,12,45,77
2007-07-23 00:00:00.000,Umag Croatia ATP World Tour,CLAY,2,Viktor Troicki,Novak Djokovic,Viktor Troicki,2-6; 6-4; 7-5,R16,142,2,3,55,100,37,55,17,45,8,14,15,54,100,3,2,55,88,34,55,15,33,4,10,15,49,88
2007-07-23 00:00:00.000,Umag Croatia ATP World Tour,CLAY,2,Carlos Berlocq,Victor Hanescu,Carlos Berlocq,6-7(13); 6-4; 6-2,R16,189,6,1,69,116,53,69,25,47,10,10,15,78,116,5,2,99,126,68,99,9,27,5,8,15,77,126
2007-07-23 00:00:00.000,Umag Croatia ATP World Tour,CLAY,2,Andrei Pavel,Robin Haase,Andrei Pavel,7-5; 6-4,R16,87,3,2,38,62,29,38,16,24,3,4,11,45,62,3,2,40,71,31,40,13,31,4,7,11,44,71
2007-07-23 00:00:00.000,Umag Croatia ATP World Tour,CLAY,2,Filippo Volandri,Mischa Zverev,Filippo Volandri,7-6(2); 7-5,R16,102,1,3,59,80,42,59,9,21,4,7,12,51,80,3,1,39,72,22,39,19,33,3,7,12,41,72
2007-07-23 00:00:00.000,Umag Croatia ATP World Tour,CLAY,2,Carlos Moya,Pere Riba,Carlos Moya,6-0; 6-3,R16,51,1,0,20,39,17,20,13,19,2,2,7,30,39,2,1,21,42,10,21,8,21,4,9,8,18,42
2007-07-23 00:00:00.000,Umag Croatia ATP World Tour,CLAY,2,David Ferrer,Jose Acasuso,David Ferrer,2-6; 7-6(4); 6-2,R16,144,6,2,63,97,47,63,14,34,6,9,14,61,97,6,2,45,91,36,45,21,46,0,3,14,57,91
2007-07-23 00:00:00.000,Umag Croatia ATP World Tour,CLAY,2,Guillermo Canas,Ruben Ramirez Hidalgo,Guillermo Canas,6-4; 6-3,R16,114,8,2,23,47,19,23,11,24,1,4,9,30,47,3,8,40,85,23,40,18,45,7,13,10,41,85
2007-07-23 00:00:00.000,Umag Croatia ATP World Tour,CLAY,2,Gilles Simon,Marin Cilic,Gilles Simon,7-5; 2-6; 6-3,R16,147,4,1,54,98,32,54,21,44,10,16,14,53,98,4,4,49,105,34,49,21,56,1,8,15,55,105
2007-07-23 00:00:00.000,Umag Croatia ATP World Tour,CLAY,2,Viktor Troicki,Carlos Berlocq,Viktor Troicki,7-5; 6-2,Q,95,2,4,43,63,29,43,12,20,2,4,10,41,63,0,2,33,55,19,33,9,22,1,6,10,28,55
2007-07-23 00:00:00.000,Umag Croatia ATP World Tour,CLAY,2,Andrei Pavel,Filippo Volandri,Andrei Pavel,1-6; 6-2; 6-3,Q,107,4,1,40,75,30,40,19,35,2,4,12,49,75,0,3,57,74,39,57,6,17,2,5,12,45,74
2007-07-23 00:00:00.000,Umag Croatia ATP World Tour,CLAY,2,Carlos Moya,David Ferrer,Carlos Moya,7-5; 6-4,Q,97,2,1,53,79,31,53,14,26,2,5,11,45,79,2,3,44,63,26,44,8,19,5,10,11,34,63
2007-07-23 00:00:00.000,Umag Croatia ATP World Tour,CLAY,2,Guillermo Canas,Gilles Simon,Guillermo Canas,6-2; 6-1,Q,74,2,0,19,43,11,19,16,24,4,6,7,27,43,2,2,28,49,12,28,5,21,3,10,8,17,49
2007-07-23 00:00:00.000,Umag Croatia ATP World Tour,CLAY,2,Andrei Pavel,Viktor Troicki,Andrei Pavel,6-3; 6-3,S,90,0,3,33,57,23,33,11,24,1,3,9,34,57,2,2,29,58,18,29,10,29,4,9,9,28,58
2007-07-23 00:00:00.000,Umag Croatia ATP World Tour,CLAY,2,Carlos Moya,Guillermo Canas,Carlos Moya,6-3; 6-2,S,84,1,0,34,50,25,34,8,16,1,2,8,33,50,0,4,36,57,20,36,8,21,2,7,9,28,57
2007-07-23 00:00:00.000,Umag Croatia ATP World Tour,CLAY,2,Carlos Moya,Andrei Pavel,Carlos Moya,6-4; 6-2,F,88,9,2,45,66,37,45,10,21,4,4,9,47,66,1,1,34,56,22,34,11,22,3,6,9,33,56
2007-07-29 00:00:00.000,Washington DC; U.S.A. ATP World Tour,HARD,2,Andy Roddick,N/A Bye,Andy Roddick,,R64,0,0,0,0,0,0,0,0,0,0,0,0,0,0,0,0,0,0,0,0,0,0,0,0,0,0,0
2007-07-29 00:00:00.000,Washington DC; U.S.A. ATP World Tour,HARD,2,Tomas Zib,Kevin Kim,Tomas Zib,7-6(2); 6-4,R64,85,9,3,41,78,32,41,20,37,6,7,11,52,78,10,2,35,63,31,35,12,28,1,3,11,43,63
2007-07-29 00:00:00.000,Washington DC; U.S.A. ATP World Tour,HARD,2,Paul Goldstein,Somdev Devvarman,Paul Goldstein,6-4; 6-2,R64,93,1,9,43,73,30,43,11,30,8,10,9,41,73,6,6,37,72,22,37,12,35,7,12,9,34,72
2007-07-29 00:00:00.000,Washington DC; U.S.A. ATP World Tour,HARD,2,Radek Stepanek,N/A Bye,Radek Stepanek,,R64,0,0,0,0,0,0,0,0,0,0,0,0,0,0,0,0,0,0,0,0,0,0,0,0,0,0,0
2007-07-29 00:00:00.000,Washington DC; U.S.A. ATP World Tour,HARD,2,Julien Benneteau,N/A Bye,Julien Benneteau,,R64,0,0,0,0,0,0,0,0,0,0,0,0,0,0,0,0,0,0,0,0,0,0,0,0,0,0,0
2007-07-29 00:00:00.000,Washington DC; U.S.A. ATP World Tour,HARD,2,Kei Nishikori,Teymuraz Gabashvili,Kei Nishikori,7-6(4); 6-3,R64,78,3,4,38,62,34,38,17,24,0,0,11,51,62,6,7,29,69,23,29,22,40,1,2,10,45,69
2007-07-29 00:00:00.000,Washington DC; U.S.A. ATP World Tour,HARD,2,Igor Kunitsyn,Sebastien Grosjean,Igor Kunitsyn,6-7(3); 6-4; 6-3,R64,167,2,3,62,117,40,62,33,55,12,14,16,73,117,2,1,40,94,31,40,28,54,3,7,15,59,94
2007-07-29 00:00:00.000,Washington DC; U.S.A. ATP World Tour,HARD,2,Hyung-Taik Lee,N/A Bye,Hyung-Taik Lee,,R64,0,0,0,0,0,0,0,0,0,0,0,0,0,0,0,0,0,0,0,0,0,0,0,0,0,0,0
2007-07-29 00:00:00.000,Washington DC; U.S.A. ATP World Tour,HARD,2,Arnaud Clement,N/A Bye,Arnaud Clement,,R64,0,0,0,0,0,0,0,0,0,0,0,0,0,0,0,0,0,0,0,0,0,0,0,0,0,0,0
2007-07-29 00:00:00.000,Washington DC; U.S.A. ATP World Tour,HARD,2,Thomas Johansson,Santiago Giraldo,Thomas Johansson,7-6(7); 6-7(5); 6-4,R64,160,14,5,63,109,50,63,24,46,5,8,17,74,109,8,5,59,133,43,59,37,74,5,9,17,80,133
2007-07-29 00:00:00.000,Washington DC; U.S.A. ATP World Tour,HARD,2,Paul Capdeville,Ilija Bozoljac,Paul Capdeville,4-6; 6-3; 6-0,R64,98,6,4,46,85,35,46,20,39,4,5,12,55,85,6,4,33,69,21,33,19,36,1,6,13,40,69
2007-07-29 00:00:00.000,Washington DC; U.S.A. ATP World Tour,HARD,2,Amer Delic,N/A Bye,Amer Delic,,R64,0,0,0,0,0,0,0,0,0,0,0,0,0,0,0,0,0,0,0,0,0,0,0,0,0,0,0
2007-07-29 00:00:00.000,Washington DC; U.S.A. ATP World Tour,HARD,2,Vincent Spadea,N/A Bye,Vincent Spadea,,R64,0,0,0,0,0,0,0,0,0,0,0,0,0,0,0,0,0,0,0,0,0,0,0,0,0,0,0
2007-07-29 00:00:00.000,Washington DC; U.S.A. ATP World Tour,HARD,2,Wesley Moodie,Ryan Sweeting,Wesley Moodie,6-3; 6-4,R64,64,8,3,39,62,31,39,13,23,5,5,10,44,62,7,2,31,51,21,31,12,20,0,2,9,33,51
2007-07-29 00:00:00.000,Washington DC; U.S.A. ATP World Tour,HARD,2,Evgeny Korolev,Ricardo Mello,Evgeny Korolev,6-4; 6-4,R64,81,4,3,32,60,24,32,12,28,3,7,10,36,60,2,3,47,68,23,47,9,21,3,9,10,32,68
2007-07-29 00:00:00.000,Washington DC; U.S.A. ATP World Tour,HARD,2,Ivo Karlovic,N/A Bye,Ivo Karlovic,,R64,0,0,0,0,0,0,0,0,0,0,0,0,0,0,0,0,0,0,0,0,0,0,0,0,0,0,0
2007-07-29 00:00:00.000,Washington DC; U.S.A. ATP World Tour,HARD,2,Mardy Fish,N/A Bye,Mardy Fish,,R64,0,0,0,0,0,0,0,0,0,0,0,0,0,0,0,0,0,0,0,0,0,0,0,0,0,0,0
2007-07-29 00:00:00.000,Washington DC; U.S.A. ATP World Tour,HARD,2,Michael Berrer,George Bastl,Michael Berrer,6-3; 6-2,R64,77,4,4,26,51,23,26,15,25,2,2,9,38,51,3,3,24,50,18,24,11,26,3,6,8,29,50
2007-07-29 00:00:00.000,Washington DC; U.S.A. ATP World Tour,HARD,2,Martin Klizan,Konstantinos Economidis,Martin Klizan,6-4; 6-3,R64,63,9,8,39,71,30,39,14,32,10,12,10,44,71,1,4,32,53,22,32,7,21,4,8,9,29,53
2007-07-29 00:00:00.000,Washington DC; U.S.A. ATP World Tour,HARD,2,Gael Monfils,N/A Bye,Gael Monfils,,R64,0,0,0,0,0,0,0,0,0,0,0,0,0,0,0,0,0,0,0,0,0,0,0,0,0,0,0
2007-07-29 00:00:00.000,Washington DC; U.S.A. ATP World Tour,HARD,2,Michael Llodra,N/A Bye,Michael Llodra,,R64,0,0,0,0,0,0,0,0,0,0,0,0,0,0,0,0,0,0,0,0,0,0,0,0,0,0,0
2007-07-29 00:00:00.000,Washington DC; U.S.A. ATP World Tour,HARD,2,Robin Haase,Alex Bogdanovic,Robin Haase,6-4; 6-2,R64,59,10,1,31,49,26,31,11,18,0,0,9,37,49,2,2,32,58,21,32,13,26,2,5,9,34,58
2007-07-29 00:00:00.000,Washington DC; U.S.A. ATP World Tour,HARD,2,Jan Hernych,Nathan Healey,Jan Hernych,6-3; 1-1,R64,41,3,1,19,30,16,19,8,11,0,0,6,24,30,2,3,19,38,13,19,9,19,5,6,5,22,38
2007-07-29 00:00:00.000,Washington DC; U.S.A. ATP World Tour,HARD,2,Marat Safin,N/A Bye,Marat Safin,,R64,0,0,0,0,0,0,0,0,0,0,0,0,0,0,0,0,0,0,0,0,0,0,0,0,0,0,0
2007-07-29 00:00:00.000,Washington DC; U.S.A. ATP World Tour,HARD,2,Benjamin Becker,N/A Bye,Benjamin Becker,,R64,0,0,0,0,0,0,0,0,0,0,0,0,0,0,0,0,0,0,0,0,0,0,0,0,0,0,0
2007-07-29 00:00:00.000,Washington DC; U.S.A. ATP World Tour,HARD,2,John Isner,Tim Henman,John Isner,4-6; 6-4; 7-6(4),R64,122,18,1,59,89,51,59,19,30,2,3,16,70,89,16,5,63,97,50,63,20,34,7,8,16,70,97
2007-07-29 00:00:00.000,Washington DC; U.S.A. ATP World Tour,HARD,2,Wayne Odesnik,Adrian Garcia,Wayne Odesnik,4-6; 6-3; 6-0,R64,72,14,2,48,64,36,48,10,16,0,2,13,46,64,6,4,42,77,26,42,17,35,2,7,12,43,77
2007-07-29 00:00:00.000,Washington DC; U.S.A. ATP World Tour,HARD,2,Juan Martin Del Potro,N/A Bye,Juan Martin Del Potro,,R64,0,0,0,0,0,0,0,0,0,0,0,0,0,0,0,0,0,0,0,0,0,0,0,0,0,0,0
2007-07-29 00:00:00.000,Washington DC; U.S.A. ATP World Tour,HARD,2,Michael Russell,N/A Bye,Michael Russell,,R64,0,0,0,0,0,0,0,0,0,0,0,0,0,0,0,0,0,0,0,0,0,0,0,0,0,0,0
2007-07-29 00:00:00.000,Washington DC; U.S.A. ATP World Tour,HARD,2,Wesley Whitehouse,Jiri Vanek,Wesley Whitehouse,3-6; 6-3; 6-3,R64,87,14,10,44,91,36,44,21,47,4,7,14,57,91,6,5,41,68,32,41,11,27,2,6,13,43,68
2007-07-29 00:00:00.000,Washington DC; U.S.A. ATP World Tour,HARD,2,Alejandro Falla,Robert Kendrick,Alejandro Falla,3-6; 6-2; 7-5,R64,112,2,2,40,91,27,40,27,51,9,13,14,54,91,7,8,49,92,30,49,20,43,3,9,15,50,92
2007-07-29 00:00:00.000,Washington DC; U.S.A. ATP World Tour,HARD,2,Tommy Haas,N/A Bye,Tommy Haas,,R64,0,0,0,0,0,0,0,0,0,0,0,0,0,0,0,0,0,0,0,0,0,0,0,0,0,0,0
2007-07-29 00:00:00.000,Washington DC; U.S.A. ATP World Tour,HARD,2,Andy Roddick,Tomas Zib,Andy Roddick,6-4; 6-2,R32,61,18,1,33,54,32,33,8,21,2,2,9,40,54,5,0,24,50,19,24,10,26,2,5,9,29,50
2007-07-29 00:00:00.000,Washington DC; U.S.A. ATP World Tour,HARD,2,Radek Stepanek,Paul Goldstein,Radek Stepanek,6-3; 4-6; 6-4,R32,119,14,2,59,82,46,59,11,23,5,6,14,57,82,2,6,52,88,33,52,22,36,7,10,15,55,88
2007-07-29 00:00:00.000,Washington DC; U.S.A. ATP World Tour,HARD,2,Julien Benneteau,Kei Nishikori,Julien Benneteau,6-2; 6-3,R32,60,3,0,29,45,21,29,13,16,0,0,8,34,45,2,3,32,51,17,32,11,19,3,7,9,28,51
2007-07-29 00:00:00.000,Washington DC; U.S.A. ATP World Tour,HARD,2,Hyung-Taik Lee,Igor Kunitsyn,Hyung-Taik Lee,6-7(7); 6-3; 6-1,R32,128,9,1,53,86,42,53,22,33,0,0,14,64,86,1,1,57,94,38,57,17,37,7,11,14,55,94
2007-07-29 00:00:00.000,Washington DC; U.S.A. ATP World Tour,HARD,2,Thomas Johansson,Arnaud Clement,Thomas Johansson,1-6; 6-3; 6-4,R32,110,9,5,47,78,40,47,12,31,2,4,13,52,78,6,2,33,72,27,33,22,39,3,5,13,49,72
2007-07-29 00:00:00.000,Washington DC; U.S.A. ATP World Tour,HARD,2,Paul Capdeville,Amer Delic,Paul Capdeville,7-6(5); 7-5,R32,105,10,6,54,94,39,54,22,40,10,11,12,61,94,14,2,40,78,28,40,24,38,6,8,12,52,78
2007-07-29 00:00:00.000,Washington DC; U.S.A. ATP World Tour,HARD,2,Vincent Spadea,Wesley Moodie,Vincent Spadea,7-6(5); 7-6(3),R32,95,1,1,54,81,41,54,17,27,0,1,12,58,81,13,4,53,79,43,53,11,26,2,3,12,54,79
2007-07-29 00:00:00.000,Washington DC; U.S.A. ATP World Tour,HARD,2,Ivo Karlovic,Evgeny Korolev,Ivo Karlovic,6-3; 6-3,R32,59,18,1,29,45,26,29,10,16,0,0,9,36,45,4,7,27,52,23,27,8,25,3,6,9,31,52
2007-07-29 00:00:00.000,Washington DC; U.S.A. ATP World Tour,HARD,2,Michael Berrer,Mardy Fish,Michael Berrer,7-6(4); 6-4,R32,101,9,3,43,73,35,43,10,30,4,7,11,45,73,8,1,42,81,24,42,19,39,5,9,11,43,81
2007-07-29 00:00:00.000,Washington DC; U.S.A. ATP World Tour,HARD,2,Gael Monfils,Martin Klizan,Gael Monfils,7-6(5); 6-4,R32,74,12,4,42,66,33,42,8,24,3,5,11,41,66,0,2,33,71,17,33,22,38,2,5,11,39,71
2007-07-29 00:00:00.000,Washington DC; U.S.A. ATP World Tour,HARD,2,Robin Haase,Michael Llodra,Robin Haase,6-2; 6-7(7); 7-6(4),R32,125,6,5,73,114,54,73,26,41,8,9,16,80,114,13,6,60,100,50,60,23,40,4,7,16,73,100
2007-07-29 00:00:00.000,Washington DC; U.S.A. ATP World Tour,HARD,2,Marat Safin,Jan Hernych,Marat Safin,6-2; 2-6; 6-2,R32,101,7,5,51,99,34,51,23,48,8,11,12,57,99,1,3,51,73,27,51,13,22,6,11,12,40,73
2007-07-29 00:00:00.000,Washington DC; U.S.A. ATP World Tour,HARD,2,John Isner,Benjamin Becker,John Isner,3-6; 7-5; 7-6(6),R32,131,30,2,78,106,62,78,13,28,2,4,17,75,106,14,5,49,96,40,49,28,47,3,4,16,68,96
2007-07-29 00:00:00.000,Washington DC; U.S.A. ATP World Tour,HARD,2,Wayne Odesnik,Juan Martin Del Potro,Wayne Odesnik,3-6; 7-6(10); 6-3,R32,152,12,1,70,107,47,70,19,37,5,8,14,66,107,17,5,63,115,50,63,21,52,3,7,16,71,115
2007-07-29 00:00:00.000,Washington DC; U.S.A. ATP World Tour,HARD,2,Michael Russell,Wesley Whitehouse,Michael Russell,7-6(1); 4-1,R32,74,1,4,38,59,29,38,14,21,1,1,8,43,59,9,6,30,62,21,30,13,32,4,6,9,34,62
2007-07-29 00:00:00.000,Washington DC; U.S.A. ATP World Tour,HARD,2,Tommy Haas,Alejandro Falla,Tommy Haas,6-3; 6-2,R32,84,10,3,36,71,28,36,13,35,7,9,9,41,71,5,2,24,51,14,24,9,27,2,7,8,23,51
2007-07-29 00:00:00.000,Washington DC; U.S.A. ATP World Tour,HARD,2,Andy Roddick,Radek Stepanek,Andy Roddick,6-3; 1-6; 7-5,R16,111,23,2,58,84,47,58,12,26,4,6,14,59,84,20,1,50,81,43,50,15,31,3,5,14,58,81
2007-07-29 00:00:00.000,Washington DC; U.S.A. ATP World Tour,HARD,2,Hyung-Taik Lee,Julien Benneteau,Hyung-Taik Lee,2-6; 6-2; 6-3,R16,100,3,1,45,74,34,45,15,29,3,6,13,49,74,14,5,43,76,32,43,12,33,4,8,12,44,76
2007-07-29 00:00:00.000,Washington DC; U.S.A. ATP World Tour,HARD,2,Paul Capdeville,Thomas Johansson,Paul Capdeville,7-6(5); 6-3,R16,96,5,2,54,84,37,54,16,30,10,12,11,53,84,8,3,42,66,30,42,9,24,3,6,10,39,66
2007-07-29 00:00:00.000,Washington DC; U.S.A. ATP World Tour,HARD,2,Ivo Karlovic,Vincent Spadea,Ivo Karlovic,6-2; 6-4,R16,55,19,1,37,45,31,37,5,8,0,0,9,36,45,1,1,26,46,16,26,13,20,1,4,9,29,46
2007-07-29 00:00:00.000,Washington DC; U.S.A. ATP World Tour,HARD,2,Gael Monfils,Michael Berrer,Gael Monfils,6-7(5); 6-3; 6-3,R16,117,21,4,44,83,36,44,25,39,0,1,15,61,83,2,4,56,101,38,56,22,45,7,11,15,60,101
2007-07-29 00:00:00.000,Washington DC; U.S.A. ATP World Tour,HARD,2,Marat Safin,Robin Haase,Marat Safin,7-5; 6-7(2); 7-5,R16,155,12,6,64,109,48,64,27,45,4,6,18,75,109,9,9,79,154,58,79,33,75,20,24,18,91,154
2007-07-29 00:00:00.000,Washington DC; U.S.A. ATP World Tour,HARD,2,John Isner,Wayne Odesnik,John Isner,6-7(4); 7-6(3); 7-6(2),R16,142,31,2,76,102,69,76,19,26,0,0,18,88,102,6,6,94,121,73,94,13,27,2,2,18,86,121
2007-07-29 00:00:00.000,Washington DC; U.S.A. ATP World Tour,HARD,2,Tommy Haas,Michael Russell,Tommy Haas,6-3; 6-4,R16,71,10,2,24,53,21,24,21,29,0,0,10,42,53,3,1,30,49,21,30,12,19,4,6,9,33,49
2007-07-29 00:00:00.000,Washington DC; U.S.A. ATP World Tour,HARD,2,Andy Roddick,Hyung-Taik Lee,Andy Roddick,7-6(6); 6-2,Q,85,16,0,44,63,35,44,13,19,2,2,10,48,63,4,0,39,66,26,39,16,27,5,7,10,42,66
2007-07-29 00:00:00.000,Washington DC; U.S.A. ATP World Tour,HARD,2,Ivo Karlovic,Paul Capdeville,Ivo Karlovic,4-6; 6-3; 7-6(5),Q,135,29,4,65,92,56,65,14,27,2,3,16,70,92,7,1,63,100,49,63,20,37,3,4,15,69,100
2007-07-29 00:00:00.000,Washington DC; U.S.A. ATP World Tour,HARD,2,Gael Monfils,Marat Safin,Gael Monfils,6-3; 7-5,Q,75,14,3,34,56,30,34,14,22,0,0,11,44,56,3,4,47,72,33,47,13,25,3,5,10,46,72
2007-07-29 00:00:00.000,Washington DC; U.S.A. ATP World Tour,HARD,2,John Isner,Tommy Haas,John Isner,6-4; 6-7(6); 7-6(5),Q,147,30,2,66,104,56,66,24,38,0,0,17,80,104,20,2,59,98,53,59,24,39,1,2,17,77,98
2007-07-29 00:00:00.000,Washington DC; U.S.A. ATP World Tour,HARD,2,Andy Roddick,Ivo Karlovic,Andy Roddick,7-6(7); 7-6(5),S,97,12,1,45,76,44,45,18,31,1,1,12,62,76,19,0,47,69,43,47,15,22,0,0,12,58,69
2007-07-29 00:00:00.000,Washington DC; U.S.A. ATP World Tour,HARD,2,John Isner,Gael Monfils,John Isner,6-7(4); 7-6(1); 7-6(2),S,147,23,5,91,123,70,91,20,32,5,6,18,90,123,25,4,54,102,47,54,32,48,1,2,18,79,102
2007-07-29 00:00:00.000,Washington DC; U.S.A. ATP World Tour,HARD,2,Andy Roddick,John Isner,Andy Roddick,6-4; 7-6(4),F,81,14,1,38,61,34,38,17,23,1,1,11,51,61,12,2,44,64,35,44,11,20,2,3,11,46,64
2007-07-30 00:00:00.000,Sopot Poland ATP World Tour,CLAY,2,Nikolay Davydenko,Andrei Pavel,Nikolay Davydenko,6-3; 6-4,R32,80,2,1,32,49,28,32,7,17,1,2,9,35,49,1,0,43,71,22,43,16,28,5,9,10,38,71
2007-07-30 00:00:00.000,Sopot Poland ATP World Tour,CLAY,2,Martin Vassallo Arguello,Maximo Gonzalez,Martin Vassallo Arguello,2-6; 6-3; 6-2,R32,86,5,2,51,68,35,51,12,17,1,4,13,47,68,1,2,55,74,34,55,7,19,3,7,12,41,74
2007-07-30 00:00:00.000,Sopot Poland ATP World Tour,CLAY,2,Albert Montanes,Diego Hartfield,Albert Montanes,6-1; 6-3,R32,83,1,2,30,62,23,30,19,32,3,3,8,42,62,4,2,45,69,25,45,10,24,6,10,8,35,69
2007-07-30 00:00:00.000,Sopot Poland ATP World Tour,CLAY,2,Mariano Zabaleta,Nicolas Almagro,Mariano Zabaleta,6-3; 7-5,R32,109,0,2,46,73,27,46,14,27,7,10,10,41,73,0,4,58,68,31,58,3,10,3,9,11,34,68
2007-07-30 00:00:00.000,Sopot Poland ATP World Tour,CLAY,2,Sergio Roitman,Juan Ignacio Chela,Sergio Roitman,6-1; 6-2,R32,70,1,0,45,65,31,45,7,20,11,12,7,38,65,0,2,23,47,12,23,8,24,1,7,8,20,47
2007-07-30 00:00:00.000,Sopot Poland ATP World Tour,CLAY,2,Jose Acasuso,Werner Eschauer,Jose Acasuso,6-2; 6-3,R32,74,2,2,31,47,23,31,5,16,0,2,8,28,47,4,2,42,72,26,42,8,30,8,14,9,34,72
2007-07-30 00:00:00.000,Sopot Poland ATP World Tour,CLAY,2,Olivier Patience,Dawid Olejniczak,Olivier Patience,7-6(0); 6-4,R32,83,3,7,41,73,31,41,19,32,3,4,11,50,73,6,2,37,65,26,37,16,28,1,3,11,42,65
2007-07-30 00:00:00.000,Sopot Poland ATP World Tour,CLAY,2,Florian Mayer,Juan Pablo Brzezicki,Florian Mayer,6-3; 6-3,R32,86,1,1,29,48,23,29,12,19,0,1,9,35,48,1,0,50,72,24,50,14,22,8,12,9,38,72
2007-07-30 00:00:00.000,Sopot Poland ATP World Tour,CLAY,2,Boris Pashanski,Potito Starace,Boris Pashanski,6-7(4); 6-2; 3-1 RET,R32,94,5,1,42,62,36,42,13,20,1,2,12,49,62,2,1,64,83,36,64,11,19,3,7,12,47,83
2007-07-30 00:00:00.000,Sopot Poland ATP World Tour,CLAY,2,Gilles Simon,Viktor Troicki,Gilles Simon,6-0; 7-6(6),R32,84,3,0,30,58,23,30,13,28,2,4,9,36,58,1,3,37,68,19,37,12,31,1,6,9,31,68
2007-07-30 00:00:00.000,Sopot Poland ATP World Tour,CLAY,2,Igor Andreev,Nicolas Lapentti,Igor Andreev,6-0; 6-4,R32,71,2,2,43,57,30,43,9,14,4,4,8,39,57,0,1,32,53,18,32,9,21,4,8,8,27,53
2007-07-30 00:00:00.000,Sopot Poland ATP World Tour,CLAY,2,Michal Przysiezny,Filippo Volandri,Michal Przysiezny,6-4; 2-6; 7-5,R32,132,2,2,59,102,40,59,15,43,6,11,15,55,102,0,5,67,87,40,67,9,20,5,10,15,49,87
2007-07-30 00:00:00.000,Sopot Poland ATP World Tour,CLAY,2,Stefan Koubek,Agustin Calleri,Stefan Koubek,0-6; 7-6(3); 7-5,R32,131,5,2,53,93,36,53,19,40,4,10,15,55,93,4,9,64,115,45,64,22,51,7,11,15,67,115
2007-07-30 00:00:00.000,Sopot Poland ATP World Tour,CLAY,2,Kristof Vliegen,Luis Horna,Kristof Vliegen,6-2; 6-7(8); 6-3,R32,144,2,2,51,97,39,51,24,46,2,4,15,63,97,6,5,82,113,52,82,13,31,8,13,14,65,113
2007-07-30 00:00:00.000,Sopot Poland ATP World Tour,CLAY,2,Steve Darcis,Nicolas Massu,Steve Darcis,6-7(8); 7-6(0); 6-4,R32,193,5,5,65,105,49,65,21,40,5,8,17,70,105,4,2,58,124,36,58,39,66,5,9,17,75,124
2007-07-30 00:00:00.000,Sopot Poland ATP World Tour,CLAY,2,Tommy Robredo,Lukasz Kubot,Tommy Robredo,6-4; 5-7; 7-5,R32,125,4,3,74,101,48,74,9,27,5,10,15,57,101,3,4,45,72,27,45,11,27,2,9,14,38,72
2007-07-30 00:00:00.000,Sopot Poland ATP World Tour,CLAY,2,Martin Vassallo Arguello,Nikolay Davydenko,Martin Vassallo Arguello,2-6; 6-3; 2-1 RET,R16,115,3,1,41,59,30,41,8,18,1,3,10,38,59,0,4,46,74,26,46,18,28,9,11,10,44,74
2007-07-30 00:00:00.000,Sopot Poland ATP World Tour,CLAY,2,Albert Montanes,Mariano Zabaleta,Albert Montanes,4-6; 6-3; 7-5,R16,122,3,5,49,85,36,49,18,36,0,4,15,54,85,2,6,52,99,31,52,25,47,9,15,16,56,99
2007-07-30 00:00:00.000,Sopot Poland ATP World Tour,CLAY,2,Jose Acasuso,Sergio Roitman,Jose Acasuso,6-4; 6-4,R16,76,5,0,30,54,22,30,17,24,1,2,10,39,54,3,0,39,53,24,39,8,14,2,5,10,32,53
2007-07-30 00:00:00.000,Sopot Poland ATP World Tour,CLAY,2,Florian Mayer,Olivier Patience,Florian Mayer,6-1; 6-1,R16,47,4,0,24,35,22,24,6,11,0,0,7,28,35,1,0,35,53,16,35,7,18,4,9,7,23,53
2007-07-30 00:00:00.000,Sopot Poland ATP World Tour,CLAY,2,Gilles Simon,Boris Pashanski,Gilles Simon,6-4; 4-6; 6-3,R16,151,3,1,43,105,26,43,34,62,7,11,15,60,105,2,4,51,103,34,51,22,52,11,16,14,56,103
2007-07-30 00:00:00.000,Sopot Poland ATP World Tour,CLAY,2,Igor Andreev,Michal Przysiezny,Igor Andreev,7-5; 6-4,R16,91,7,0,49,66,33,49,14,17,4,5,11,47,66,6,4,39,72,31,39,13,33,5,8,11,44,72
2007-07-30 00:00:00.000,Sopot Poland ATP World Tour,CLAY,2,Stefan Koubek,Kristof Vliegen,Stefan Koubek,6-2; 3-6; 6-4,R16,121,4,4,56,99,37,56,22,43,9,13,14,59,99,0,4,37,72,22,37,18,35,4,9,13,40,72
2007-07-30 00:00:00.000,Sopot Poland ATP World Tour,CLAY,2,Tommy Robredo,Steve Darcis,Tommy Robredo,1-6; 6-0; 7-5,R16,97,3,2,54,74,33,54,9,20,4,8,12,42,74,1,0,37,71,25,37,12,34,2,8,13,37,71
2007-07-30 00:00:00.000,Sopot Poland ATP World Tour,CLAY,2,Albert Montanes,Martin Vassallo Arguello,Albert Montanes,2-6; 6-4; 6-2,Q,138,4,2,48,69,31,48,13,21,1,5,13,44,69,3,2,53,74,32,53,13,21,8,13,13,45,74
2007-07-30 00:00:00.000,Sopot Poland ATP World Tour,CLAY,2,Jose Acasuso,Florian Mayer,Jose Acasuso,7-6(4); 6-3,Q,105,2,2,30,63,25,30,17,33,1,4,11,42,63,4,4,41,87,28,41,19,46,7,11,10,47,87
2007-07-30 00:00:00.000,Sopot Poland ATP World Tour,CLAY,2,Gilles Simon,Igor Andreev,Gilles Simon,6-4; 7-5,Q,100,3,2,29,65,23,29,23,36,4,5,11,46,65,1,2,39,65,23,39,17,26,0,3,11,40,65
2007-07-30 00:00:00.000,Sopot Poland ATP World Tour,CLAY,2,Tommy Robredo,Stefan Koubek,Tommy Robredo,5-7; 6-4; 6-1,Q,143,1,3,65,96,42,65,16,31,2,5,14,58,96,0,4,75,120,44,75,22,45,8,14,15,66,120
2007-07-30 00:00:00.000,Sopot Poland ATP World Tour,CLAY,2,Jose Acasuso,Albert Montanes,Jose Acasuso,6-1; 6-2,S,62,5,3,25,49,21,25,15,24,5,5,8,36,49,2,5,20,43,14,20,6,23,0,4,7,20,43
2007-07-30 00:00:00.000,Sopot Poland ATP World Tour,CLAY,2,Tommy Robredo,Gilles Simon,Tommy Robredo,6-3; 7-6(4),S,117,2,1,51,72,27,51,12,21,2,6,10,39,72,0,3,52,82,27,52,11,30,3,9,11,38,82
2007-07-30 00:00:00.000,Sopot Poland ATP World Tour,CLAY,2,Tommy Robredo,Jose Acasuso,Tommy Robredo,7-5; 6-0,F,112,1,0,39,55,25,39,11,16,3,5,9,36,55,0,1,30,53,12,30,10,23,2,8,9,22,53
2007-08-05 00:00:00.000,ATP Masters Series Canada Montreal; Canada ATP World Tour,HARD,2,Roger Federer,N/A Bye,Roger Federer,,R64,0,0,0,0,0,0,0,0,0,0,0,0,0,0,0,0,0,0,0,0,0,0,0,0,0,0,0
2007-08-05 00:00:00.000,ATP Masters Series Canada Montreal; Canada ATP World Tour,HARD,2,Ivo Karlovic,Max Mirnyi,Ivo Karlovic,4-6; 6-3; 7-6(3),R64,129,21,1,63,97,50,63,19,34,1,2,16,69,97,7,5,37,79,28,37,34,42,0,1,15,62,79
2007-08-05 00:00:00.000,ATP Masters Series Canada Montreal; Canada ATP World Tour,HARD,2,Fabio Fognini,Peter Polansky,Fabio Fognini,6-3; 7-6(7),R64,110,5,4,33,75,26,33,22,42,6,8,10,48,75,5,5,46,79,31,46,15,33,5,9,11,46,79
2007-08-05 00:00:00.000,ATP Masters Series Canada Montreal; Canada ATP World Tour,HARD,2,Andy Murray,Robby Ginepri,Andy Murray,6-4; 6-4,R64,85,6,1,40,63,30,40,9,23,1,3,10,39,63,2,0,41,71,29,41,10,30,3,7,10,39,71
2007-08-05 00:00:00.000,ATP Masters Series Canada Montreal; Canada ATP World Tour,HARD,2,James Blake,Jurgen Melzer,James Blake,7-5; 7-6(4),R64,98,6,3,41,70,36,41,17,29,0,0,12,53,70,7,1,64,99,45,64,17,35,13,14,12,62,99
2007-08-05 00:00:00.000,ATP Masters Series Canada Montreal; Canada ATP World Tour,HARD,2,Lleyton Hewitt,Juan Carlos Ferrero,Lleyton Hewitt,7-6(5); 6-4,R64,108,6,5,42,69,33,42,15,27,1,2,11,48,69,7,0,52,79,35,52,15,27,5,7,11,50,79
2007-08-05 00:00:00.000,ATP Masters Series Canada Montreal; Canada ATP World Tour,HARD,2,Dominik Hrbaty,Philipp Kohlschreiber,Dominik Hrbaty,7-6(6); 6-4,R64,96,5,2,50,83,37,50,18,33,7,8,11,55,83,8,3,46,79,35,46,15,33,2,4,11,50,79
2007-08-05 00:00:00.000,ATP Masters Series Canada Montreal; Canada ATP World Tour,HARD,2,Tommy Robredo,N/A Bye,Tommy Robredo,,R64,0,0,0,0,0,0,0,0,0,0,0,0,0,0,0,0,0,0,0,0,0,0,0,0,0,0,0
2007-08-05 00:00:00.000,ATP Masters Series Canada Montreal; Canada ATP World Tour,HARD,2,Nikolay Davydenko,N/A Bye,Nikolay Davydenko,,R64,0,0,0,0,0,0,0,0,0,0,0,0,0,0,0,0,0,0,0,0,0,0,0,0,0,0,0
2007-08-05 00:00:00.000,ATP Masters Series Canada Montreal; Canada ATP World Tour,HARD,2,Jarkko Nieminen,Julien Benneteau,Jarkko Nieminen,6-3; 6-4,R64,88,1,0,41,58,30,41,9,17,2,4,10,39,58,7,6,44,77,28,44,12,33,9,13,9,40,77
2007-08-05 00:00:00.000,ATP Masters Series Canada Montreal; Canada ATP World Tour,HARD,2,Stanislas Wawrinka,Hyung-Taik Lee,Stanislas Wawrinka,6-3; 3-6; 6-1,R64,98,11,4,38,80,32,38,22,42,4,5,13,54,80,0,2,43,65,28,43,15,22,3,6,12,43,65
2007-08-05 00:00:00.000,ATP Masters Series Canada Montreal; Canada ATP World Tour,HARD,2,Mikhail Youzhny,Sebastien Grosjean,Mikhail Youzhny,6-2; 6-4,R64,92,1,3,35,71,23,35,19,36,2,4,9,42,71,2,1,21,51,15,21,12,30,5,10,9,27,51
2007-08-05 00:00:00.000,ATP Masters Series Canada Montreal; Canada ATP World Tour,HARD,2,Tommy Haas,Agustin Calleri,Tommy Haas,6-3; 7-6(6),R64,78,11,4,32,63,29,32,21,31,2,2,11,50,63,14,5,37,61,33,37,9,24,4,5,10,42,61
2007-08-05 00:00:00.000,ATP Masters Series Canada Montreal; Canada ATP World Tour,HARD,2,Michael Russell,Nicolas Almagro,Michael Russell,2-6; 7-6(3); 6-3,R64,122,0,6,69,101,45,69,18,32,3,6,14,63,101,11,4,53,87,40,53,17,34,3,6,15,57,87
2007-08-05 00:00:00.000,ATP Masters Series Canada Montreal; Canada ATP World Tour,HARD,2,Radek Stepanek,Jonas Bjorkman,Radek Stepanek,6-4; 6-1,R64,69,3,0,23,37,21,23,11,14,0,0,8,32,37,0,1,29,60,16,29,15,31,4,8,9,31,60
2007-08-05 00:00:00.000,ATP Masters Series Canada Montreal; Canada ATP World Tour,HARD,2,Fernando Gonzalez,N/A Bye,Fernando Gonzalez,,R64,0,0,0,0,0,0,0,0,0,0,0,0,0,0,0,0,0,0,0,0,0,0,0,0,0,0,0
2007-08-05 00:00:00.000,ATP Masters Series Canada Montreal; Canada ATP World Tour,HARD,2,Andy Roddick,N/A Bye,Andy Roddick,,R64,0,0,0,0,0,0,0,0,0,0,0,0,0,0,0,0,0,0,0,0,0,0,0,0,0,0,0
2007-08-05 00:00:00.000,ATP Masters Series Canada Montreal; Canada ATP World Tour,HARD,2,Arnaud Clement,Philip Bester,Arnaud Clement,7-6(2); 6-2,R64,77,5,1,40,57,30,40,14,17,2,3,10,44,57,5,0,28,57,21,28,13,29,0,3,10,34,57
2007-08-05 00:00:00.000,ATP Masters Series Canada Montreal; Canada ATP World Tour,HARD,2,Marcos Baghdatis,Carlos Moya,Marcos Baghdatis,7-6(7); 6-1,R64,86,3,2,24,62,22,24,23,38,0,1,10,45,62,2,0,37,60,25,37,10,23,3,6,9,35,60
2007-08-05 00:00:00.000,ATP Masters Series Canada Montreal; Canada ATP World Tour,HARD,2,Robin Haase,Tomas Berdych,Robin Haase,6-4; 7-5,R64,91,11,5,50,76,43,50,8,26,6,6,11,51,76,6,1,40,63,28,40,15,23,1,3,11,43,63
2007-08-05 00:00:00.000,ATP Masters Series Canada Montreal; Canada ATP World Tour,HARD,2,David Ferrer,Ernests Gulbis,David Ferrer,6-2; 6-1,R64,65,1,0,38,54,27,38,11,16,3,3,8,38,54,3,3,26,50,15,26,10,24,3,7,7,25,50
2007-08-05 00:00:00.000,ATP Masters Series Canada Montreal; Canada ATP World Tour,HARD,2,David Nalbandian,Alejandro Falla,David Nalbandian,6-4; 6-3,R64,80,1,2,25,57,15,25,23,32,2,4,10,38,57,4,0,26,51,18,26,9,25,1,5,9,27,51
2007-08-05 00:00:00.000,ATP Masters Series Canada Montreal; Canada ATP World Tour,HARD,2,Nicolas Kiefer,Dmitry Tursunov,Nicolas Kiefer,1-6; 6-4; 6-3,R64,115,7,6,46,87,34,46,18,41,6,9,13,52,87,6,9,45,86,34,45,20,41,9,12,13,54,86
2007-08-05 00:00:00.000,ATP Masters Series Canada Montreal; Canada ATP World Tour,HARD,2,Novak Djokovic,N/A Bye,Novak Djokovic,,R64,0,0,0,0,0,0,0,0,0,0,0,0,0,0,0,0,0,0,0,0,0,0,0,0,0,0,0
2007-08-05 00:00:00.000,ATP Masters Series Canada Montreal; Canada ATP World Tour,HARD,2,Richard Gasquet,N/A Bye,Richard Gasquet,,R64,0,0,0,0,0,0,0,0,0,0,0,0,0,0,0,0,0,0,0,0,0,0,0,0,0,0,0
2007-08-05 00:00:00.000,ATP Masters Series Canada Montreal; Canada ATP World Tour,HARD,2,Fernando Verdasco,Juan Ignacio Chela,Fernando Verdasco,3-6; 6-1; 6-3,R64,123,8,5,54,89,37,54,18,35,7,9,12,55,89,3,7,58,100,34,58,20,42,4,9,13,54,100
2007-08-05 00:00:00.000,ATP Masters Series Canada Montreal; Canada ATP World Tour,HARD,2,Frank Dancevic,Juan Martin Del Potro,Frank Dancevic,6-4; 3-6; 6-3,R64,116,14,1,55,81,43,55,14,26,3,4,14,57,81,4,3,53,87,36,53,21,34,5,7,14,57,87
2007-08-05 00:00:00.000,ATP Masters Series Canada Montreal; Canada ATP World Tour,HARD,2,Wayne Odesnik,Ivan Ljubicic,Wayne Odesnik,6-3; 4-6; 7-6(5),R64,143,8,1,77,102,52,77,13,25,5,7,15,65,102,24,4,55,94,44,55,18,39,3,6,16,62,94
2007-08-05 00:00:00.000,ATP Masters Series Canada Montreal; Canada ATP World Tour,HARD,2,Paul-Henri Mathieu,Guillermo Canas,Paul-Henri Mathieu,4-6; 7-5; 6-0,R64,133,4,2,44,77,32,44,20,33,2,5,14,52,77,10,5,37,75,28,37,14,38,3,9,14,42,75
2007-08-05 00:00:00.000,ATP Masters Series Canada Montreal; Canada ATP World Tour,HARD,2,Mario Ancic,Frederic Niemeyer,Mario Ancic,6-4; 6-2,R64,67,8,1,25,41,23,25,13,16,0,0,9,36,41,7,6,27,51,22,27,7,24,0,3,9,29,51
2007-08-05 00:00:00.000,ATP Masters Series Canada Montreal; Canada ATP World Tour,HARD,2,Marat Safin,Robin Soderling,Marat Safin,1-2 RET,R64,14,0,0,2,6,0,2,2,4,0,1,1,2,6,0,0,9,12,5,9,2,3,1,2,2,7,12
2007-08-05 00:00:00.000,ATP Masters Series Canada Montreal; Canada ATP World Tour,HARD,2,Rafael Nadal,N/A Bye,Rafael Nadal,,R64,0,0,0,0,0,0,0,0,0,0,0,0,0,0,0,0,0,0,0,0,0,0,0,0,0,0,0
2007-08-05 00:00:00.000,ATP Masters Series Canada Montreal; Canada ATP World Tour,HARD,2,Roger Federer,Ivo Karlovic,Roger Federer,7-6(2); 7-6(3),R32,83,3,0,55,65,50,55,8,10,0,0,12,58,65,16,1,61,74,51,61,4,13,0,0,12,55,74
2007-08-05 00:00:00.000,ATP Masters Series Canada Montreal; Canada ATP World Tour,HARD,2,Fabio Fognini,Andy Murray,Fabio Fognini,6-2; 6-2,R32,68,5,2,30,55,22,30,13,25,5,6,8,35,55,5,3,30,52,19,30,5,22,3,8,8,24,52
2007-08-05 00:00:00.000,ATP Masters Series Canada Montreal; Canada ATP World Tour,HARD,2,Lleyton Hewitt,James Blake,Lleyton Hewitt,W/O,R32,0,0,0,0,0,0,0,0,0,0,0,0,0,0,0,0,0,0,0,0,0,0,0,0,0,0,0
2007-08-05 00:00:00.000,ATP Masters Series Canada Montreal; Canada ATP World Tour,HARD,2,Dominik Hrbaty,Tommy Robredo,Dominik Hrbaty,6-2; 6-4,R32,72,2,5,30,55,23,30,8,25,2,5,9,31,55,1,5,31,59,17,31,9,28,2,8,9,26,59
2007-08-05 00:00:00.000,ATP Masters Series Canada Montreal; Canada ATP World Tour,HARD,2,Nikolay Davydenko,Jarkko Nieminen,Nikolay Davydenko,6-3; 7-6(5),R32,104,1,3,45,80,35,45,15,35,8,10,10,50,80,4,3,45,73,28,45,12,28,5,9,11,40,73
2007-08-05 00:00:00.000,ATP Masters Series Canada Montreal; Canada ATP World Tour,HARD,2,Mikhail Youzhny,Stanislas Wawrinka,Mikhail Youzhny,6-4; 6-4,R32,100,4,1,47,71,32,47,15,24,5,6,10,47,71,6,0,38,63,25,38,12,25,4,7,10,37,63
2007-08-05 00:00:00.000,ATP Masters Series Canada Montreal; Canada ATP World Tour,HARD,2,Tommy Haas,Michael Russell,Tommy Haas,6-3; 3-0 RET,R32,52,8,2,20,37,16,20,9,17,3,4,6,25,37,1,4,21,37,11,21,5,16,2,6,6,16,37
2007-08-05 00:00:00.000,ATP Masters Series Canada Montreal; Canada ATP World Tour,HARD,2,Radek Stepanek,Fernando Gonzalez,Radek Stepanek,6-7(2); 7-6(1); 6-4,R32,151,16,0,89,116,69,89,15,27,8,8,17,84,116,8,6,57,108,44,57,32,51,0,1,17,76,108
2007-08-05 00:00:00.000,ATP Masters Series Canada Montreal; Canada ATP World Tour,HARD,2,Andy Roddick,Arnaud Clement,Andy Roddick,6-1; 7-6(5),R32,90,10,1,47,70,36,47,13,23,3,3,10,49,70,6,2,31,59,22,31,15,28,0,2,9,37,59
2007-08-05 00:00:00.000,ATP Masters Series Canada Montreal; Canada ATP World Tour,HARD,2,Marcos Baghdatis,Robin Haase,Marcos Baghdatis,6-2; 3-6; 6-1,R32,96,6,2,36,71,25,36,21,35,5,7,12,46,71,4,5,47,85,30,47,15,38,3,8,12,45,85
2007-08-05 00:00:00.000,ATP Masters Series Canada Montreal; Canada ATP World Tour,HARD,2,David Nalbandian,David Ferrer,David Nalbandian,7-6(4); 6-1,R32,92,5,2,32,58,26,32,14,26,2,3,10,40,58,1,1,39,66,24,39,12,27,8,11,9,36,66
2007-08-05 00:00:00.000,ATP Masters Series Canada Montreal; Canada ATP World Tour,HARD,2,Novak Djokovic,Nicolas Kiefer,Novak Djokovic,6-3; 6-3,R32,84,5,2,41,54,31,41,9,13,3,3,9,40,54,4,3,36,54,25,36,7,18,2,5,9,32,54
2007-08-05 00:00:00.000,ATP Masters Series Canada Montreal; Canada ATP World Tour,HARD,2,Fernando Verdasco,Richard Gasquet,Fernando Verdasco,3-6; 7-6(7); 6-4,R32,143,5,8,84,107,60,84,11,23,4,5,15,71,107,5,3,61,91,49,61,21,30,5,6,16,70,91
2007-08-05 00:00:00.000,ATP Masters Series Canada Montreal; Canada ATP World Tour,HARD,2,Frank Dancevic,Wayne Odesnik,Frank Dancevic,6-3; 4-6; 7-5,R32,134,19,3,61,92,52,61,16,31,4,5,16,68,92,3,1,58,88,40,58,20,30,3,5,15,60,88
2007-08-05 00:00:00.000,ATP Masters Series Canada Montreal; Canada ATP World Tour,HARD,2,Paul-Henri Mathieu,Mario Ancic,Paul-Henri Mathieu,6-3; 6-2,R32,85,8,2,29,43,26,29,10,14,0,0,9,36,43,3,1,39,63,23,39,9,24,4,7,8,32,63
2007-08-05 00:00:00.000,ATP Masters Series Canada Montreal; Canada ATP World Tour,HARD,2,Rafael Nadal,Marat Safin,Rafael Nadal,7-6(4); 6-0,R32,101,1,4,40,63,30,40,13,23,2,3,9,43,63,11,3,36,72,28,36,11,36,5,9,9,39,72
2007-08-05 00:00:00.000,ATP Masters Series Canada Montreal; Canada ATP World Tour,HARD,2,Roger Federer,Fabio Fognini,Roger Federer,6-1; 6-1,R16,45,3,2,25,35,22,25,6,10,0,0,7,28,35,3,3,20,48,10,20,10,28,4,9,7,20,48
2007-08-05 00:00:00.000,ATP Masters Series Canada Montreal; Canada ATP World Tour,HARD,2,Lleyton Hewitt,Dominik Hrbaty,Lleyton Hewitt,6-7(10); 7-6(6); 7-5,R16,192,15,5,62,128,52,62,32,66,6,10,18,84,128,7,6,79,141,51,79,32,62,8,13,18,83,141
2007-08-05 00:00:00.000,ATP Masters Series Canada Montreal; Canada ATP World Tour,HARD,2,Nikolay Davydenko,Mikhail Youzhny,Nikolay Davydenko,7-6(8); 6-3,R16,106,3,2,38,66,31,38,13,28,1,4,11,44,66,2,1,39,73,25,39,16,34,7,11,10,41,73
2007-08-05 00:00:00.000,ATP Masters Series Canada Montreal; Canada ATP World Tour,HARD,2,Radek Stepanek,Tommy Haas,Radek Stepanek,6-3; 2-6; 6-2,R16,123,6,3,54,84,32,54,16,30,8,12,12,48,84,6,3,55,88,35,55,13,33,7,13,13,48,88
2007-08-05 00:00:00.000,ATP Masters Series Canada Montreal; Canada ATP World Tour,HARD,2,Andy Roddick,Marcos Baghdatis,Andy Roddick,6-2; 6-3,R16,70,6,1,30,51,25,30,11,21,1,2,9,36,51,5,0,25,49,14,25,12,24,4,8,8,26,49
2007-08-05 00:00:00.000,ATP Masters Series Canada Montreal; Canada ATP World Tour,HARD,2,Novak Djokovic,David Nalbandian,Novak Djokovic,6-2; 6-3,R16,70,5,0,34,44,31,34,6,10,0,0,9,37,44,5,2,30,56,21,30,11,26,5,8,8,32,56
2007-08-05 00:00:00.000,ATP Masters Series Canada Montreal; Canada ATP World Tour,HARD,2,Frank Dancevic,Fernando Verdasco,Frank Dancevic,4-6; 6-4; 6-3,R16,115,14,1,47,73,39,47,14,26,2,3,14,53,73,3,7,75,99,50,75,12,24,3,6,15,62,99
2007-08-05 00:00:00.000,ATP Masters Series Canada Montreal; Canada ATP World Tour,HARD,2,Rafael Nadal,Paul-Henri Mathieu,Rafael Nadal,3-6; 6-3; 6-2,R16,163,3,2,58,92,42,58,15,34,9,11,13,57,92,4,2,35,84,25,35,25,49,5,9,13,50,84
2007-08-05 00:00:00.000,ATP Masters Series Canada Montreal; Canada ATP World Tour,HARD,2,Roger Federer,Lleyton Hewitt,Roger Federer,6-3; 6-4,Q,86,13,2,40,70,35,40,10,30,2,3,10,45,70,5,4,30,61,19,30,15,31,3,6,9,34,61
2007-08-05 00:00:00.000,ATP Masters Series Canada Montreal; Canada ATP World Tour,HARD,2,Radek Stepanek,Nikolay Davydenko,Radek Stepanek,6-4; 7-5,Q,106,9,0,33,60,31,33,11,27,0,1,11,42,60,2,5,51,84,33,51,14,33,4,7,11,47,84
2007-08-05 00:00:00.000,ATP Masters Series Canada Montreal; Canada ATP World Tour,HARD,2,Novak Djokovic,Andy Roddick,Novak Djokovic,7-6(4); 6-4,Q,106,13,5,47,74,38,47,13,27,2,3,11,51,74,5,1,48,72,34,48,13,24,4,6,11,47,72
2007-08-05 00:00:00.000,ATP Masters Series Canada Montreal; Canada ATP World Tour,HARD,2,Rafael Nadal,Frank Dancevic,Rafael Nadal,4-6; 6-2; 6-3,Q,127,9,0,59,85,41,59,18,26,9,10,13,59,85,10,4,38,81,28,38,20,43,4,8,14,48,81
2007-08-05 00:00:00.000,ATP Masters Series Canada Montreal; Canada ATP World Tour,HARD,2,Roger Federer,Radek Stepanek,Roger Federer,7-6(6); 6-2,S,82,13,0,38,63,33,38,14,25,3,3,10,47,63,3,1,42,66,28,42,15,24,5,7,10,43,66
2007-08-05 00:00:00.000,ATP Masters Series Canada Montreal; Canada ATP World Tour,HARD,2,Novak Djokovic,Rafael Nadal,Novak Djokovic,7-5; 6-3,S,111,11,2,46,71,37,46,15,25,8,8,11,52,71,2,2,42,61,26,42,11,19,2,4,10,37,61
2007-08-05 00:00:00.000,ATP Masters Series Canada Montreal; Canada ATP World Tour,HARD,2,Novak Djokovic,Roger Federer,Novak Djokovic,7-6(2); 2-6; 7-6(2),F,133,6,3,63,96,44,63,19,33,4,9,16,63,96,15,1,69,102,53,69,14,33,3,6,16,67,102
2007-08-13 00:00:00.000,ATP Masters Series Cincinnati OH; U.S.A. ATP World Tour,HARD,2,Roger Federer,N/A Bye,Roger Federer,,R64,0,0,0,0,0,0,0,0,0,0,0,0,0,0,0,0,0,0,0,0,0,0,0,0,0,0,0
2007-08-13 00:00:00.000,ATP Masters Series Cincinnati OH; U.S.A. ATP World Tour,HARD,2,Julien Benneteau,Dmitry Tursunov,Julien Benneteau,6-4; 3-6; 6-3,R64,101,9,0,44,70,37,44,17,26,0,1,14,54,70,11,3,56,85,44,56,13,29,1,3,14,57,85
2007-08-13 00:00:00.000,ATP Masters Series Cincinnati OH; U.S.A. ATP World Tour,HARD,2,Juan Ignacio Chela,Tim Henman,Juan Ignacio Chela,6-4; 3-6; 6-3,R64,113,4,4,43,81,30,43,25,38,4,6,14,55,81,5,6,47,83,38,47,18,36,3,6,14,56,83
2007-08-13 00:00:00.000,ATP Masters Series Cincinnati OH; U.S.A. ATP World Tour,HARD,2,Marcos Baghdatis,Andy Murray,Marcos Baghdatis,6-1; 6-2,R64,49,5,0,17,35,15,17,13,18,0,0,7,28,35,2,5,20,41,12,20,5,21,1,6,8,17,41
2007-08-13 00:00:00.000,ATP Masters Series Cincinnati OH; U.S.A. ATP World Tour,HARD,2,Ivan Ljubicic,Amer Delic,Ivan Ljubicic,1-6; 7-6(3); 6-3,R64,133,12,4,50,96,38,50,23,46,5,9,15,61,96,17,4,53,96,38,53,23,43,6,8,13,61,96
2007-08-13 00:00:00.000,ATP Masters Series Cincinnati OH; U.S.A. ATP World Tour,HARD,2,Nicolas Almagro,Florian Mayer,Nicolas Almagro,7-6(5); 6-4,R64,78,8,2,46,67,37,46,12,21,3,4,11,49,67,4,1,37,58,31,37,10,21,1,3,11,41,58
2007-08-13 00:00:00.000,ATP Masters Series Cincinnati OH; U.S.A. ATP World Tour,HARD,2,Jarkko Nieminen,Vincent Spadea,Jarkko Nieminen,6-2; 6-0,R64,51,2,0,38,45,26,38,6,7,5,5,7,32,45,1,1,20,36,8,20,4,16,1,6,7,12,36
2007-08-13 00:00:00.000,ATP Masters Series Cincinnati OH; U.S.A. ATP World Tour,HARD,2,Tommy Robredo,N/A Bye,Tommy Robredo,,R64,0,0,0,0,0,0,0,0,0,0,0,0,0,0,0,0,0,0,0,0,0,0,0,0,0,0,0
2007-08-13 00:00:00.000,ATP Masters Series Cincinnati OH; U.S.A. ATP World Tour,HARD,2,Novak Djokovic,N/A Bye,Novak Djokovic,,R64,0,0,0,0,0,0,0,0,0,0,0,0,0,0,0,0,0,0,0,0,0,0,0,0,0,0,0
2007-08-13 00:00:00.000,ATP Masters Series Cincinnati OH; U.S.A. ATP World Tour,HARD,2,Carlos Moya,David Nalbandian,Carlos Moya,7-6(4); 7-6(2),R64,125,11,6,53,92,42,53,19,39,0,2,12,61,92,5,3,47,86,37,47,19,39,6,8,12,56,86
2007-08-13 00:00:00.000,ATP Masters Series Cincinnati OH; U.S.A. ATP World Tour,HARD,2,Philipp Kohlschreiber,Agustin Calleri,Philipp Kohlschreiber,7-6(2); 2-6; 7-6(7),R64,137,18,2,68,113,51,68,24,45,2,5,16,75,113,20,3,55,104,48,55,26,49,2,3,16,74,104
2007-08-13 00:00:00.000,ATP Masters Series Cincinnati OH; U.S.A. ATP World Tour,HARD,2,Juan Martin Del Potro,Guillermo Canas,Juan Martin Del Potro,6-2; 6-2,R64,75,4,3,32,52,20,32,13,20,4,5,8,33,52,4,2,22,47,11,22,11,25,5,10,8,22,47
2007-08-13 00:00:00.000,ATP Masters Series Cincinnati OH; U.S.A. ATP World Tour,HARD,2,Mario Ancic,Tommy Haas,Mario Ancic,3-6; 7-6(3); 6-3,R64,136,12,0,56,95,40,56,25,39,7,10,16,65,95,8,7,55,93,46,55,14,38,3,5,14,60,93
2007-08-13 00:00:00.000,ATP Masters Series Cincinnati OH; U.S.A. ATP World Tour,HARD,2,Jurgen Melzer,Ivo Karlovic,Jurgen Melzer,7-6(4); 7-6(2),R64,96,2,5,68,91,56,68,9,23,4,4,12,65,91,15,0,40,66,36,40,16,26,0,0,12,52,66
2007-08-13 00:00:00.000,ATP Masters Series Cincinnati OH; U.S.A. ATP World Tour,HARD,2,Lleyton Hewitt,Stanislas Wawrinka,Lleyton Hewitt,7-5; 3-6; 7-6(5),R64,178,4,8,55,115,37,55,32,60,6,10,16,69,115,11,2,55,105,41,55,25,50,2,6,17,66,105
2007-08-13 00:00:00.000,ATP Masters Series Cincinnati OH; U.S.A. ATP World Tour,HARD,2,Richard Gasquet,N/A Bye,Richard Gasquet,,R64,0,0,0,0,0,0,0,0,0,0,0,0,0,0,0,0,0,0,0,0,0,0,0,0,0,0,0
2007-08-13 00:00:00.000,ATP Masters Series Cincinnati OH; U.S.A. ATP World Tour,HARD,2,Nikolay Davydenko,N/A Bye,Nikolay Davydenko,,R64,0,0,0,0,0,0,0,0,0,0,0,0,0,0,0,0,0,0,0,0,0,0,0,0,0,0,0
2007-08-13 00:00:00.000,ATP Masters Series Cincinnati OH; U.S.A. ATP World Tour,HARD,2,Robby Ginepri,Jonas Bjorkman,Robby Ginepri,6-3; 6-3,R64,71,10,1,42,59,32,42,9,17,5,5,9,41,59,1,3,35,57,24,35,8,22,3,6,9,32,57
2007-08-13 00:00:00.000,ATP Masters Series Cincinnati OH; U.S.A. ATP World Tour,HARD,2,Arnaud Clement,Paul-Henri Mathieu,Arnaud Clement,6-4; 6-2,R64,87,4,4,21,48,19,21,15,27,0,1,9,34,48,4,1,46,74,27,46,13,28,9,13,9,40,74
2007-08-13 00:00:00.000,ATP Masters Series Cincinnati OH; U.S.A. ATP World Tour,HARD,2,Tomas Berdych,Benjamin Becker,Tomas Berdych,6-3; 6-4,R64,57,7,3,32,53,28,32,13,21,1,1,10,41,53,7,3,23,41,21,23,8,18,1,3,9,29,41
2007-08-13 00:00:00.000,ATP Masters Series Cincinnati OH; U.S.A. ATP World Tour,HARD,2,David Ferrer,John Isner,David Ferrer,7-6(3); 6-3,R64,76,8,0,50,65,40,50,12,15,2,2,11,52,65,9,3,34,61,30,34,13,27,1,2,10,43,61
2007-08-13 00:00:00.000,ATP Masters Series Cincinnati OH; U.S.A. ATP World Tour,HARD,2,Radek Stepanek,Mardy Fish,Radek Stepanek,7-5; 7-6(3),R64,100,4,2,44,75,41,44,15,31,4,5,12,56,75,11,1,42,80,34,42,20,38,5,7,12,54,80
2007-08-13 00:00:00.000,ATP Masters Series Cincinnati OH; U.S.A. ATP World Tour,HARD,2,Fernando Verdasco,Filippo Volandri,Fernando Verdasco,6-2; 6-2,R64,74,4,3,39,58,25,39,11,19,4,5,8,36,58,0,1,33,52,16,33,7,19,3,8,8,23,52
2007-08-13 00:00:00.000,ATP Masters Series Cincinnati OH; U.S.A. ATP World Tour,HARD,2,Andy Roddick,N/A Bye,Andy Roddick,,R64,0,0,0,0,0,0,0,0,0,0,0,0,0,0,0,0,0,0,0,0,0,0,0,0,0,0,0
2007-08-13 00:00:00.000,ATP Masters Series Cincinnati OH; U.S.A. ATP World Tour,HARD,2,Fernando Gonzalez,N/A Bye,Fernando Gonzalez,,R64,0,0,0,0,0,0,0,0,0,0,0,0,0,0,0,0,0,0,0,0,0,0,0,0,0,0,0
2007-08-13 00:00:00.000,ATP Masters Series Cincinnati OH; U.S.A. ATP World Tour,HARD,2,Juan Carlos Ferrero,Olivier Rochus,Juan Carlos Ferrero,6-1; 3-6; 7-5,R64,133,14,4,51,88,40,51,20,37,7,9,14,60,88,2,2,72,99,44,72,14,27,8,12,14,58,99
2007-08-13 00:00:00.000,ATP Masters Series Cincinnati OH; U.S.A. ATP World Tour,HARD,2,Nicolas Kiefer,Marat Safin,Nicolas Kiefer,6-3; 7-6(1),R64,97,14,2,44,76,35,44,16,32,5,7,11,51,76,9,4,35,66,23,35,16,31,2,5,10,39,66
2007-08-13 00:00:00.000,ATP Masters Series Cincinnati OH; U.S.A. ATP World Tour,HARD,2,James Blake,Alejandro Falla,James Blake,7-6(5); 6-1,R64,67,0,4,27,58,23,27,19,31,0,1,10,42,58,3,1,37,61,26,37,8,24,3,6,9,34,61
2007-08-13 00:00:00.000,ATP Masters Series Cincinnati OH; U.S.A. ATP World Tour,HARD,2,Mikhail Youzhny,Dominik Hrbaty,Mikhail Youzhny,6-3; 6-1,R64,68,5,3,29,50,22,29,13,21,2,2,8,35,50,1,4,13,47,9,13,15,34,3,7,8,24,47
2007-08-13 00:00:00.000,ATP Masters Series Cincinnati OH; U.S.A. ATP World Tour,HARD,2,Sam Querrey,Marc Gicquel,Sam Querrey,7-5; 5-7; 6-4,R64,134,15,4,53,91,44,53,19,38,4,8,17,63,91,4,5,57,117,36,57,34,60,4,9,17,70,117
2007-08-13 00:00:00.000,ATP Masters Series Cincinnati OH; U.S.A. ATP World Tour,HARD,2,Juan Monaco,Feliciano Lopez,Juan Monaco,6-4; 6-7(5); 6-3,R64,119,9,4,62,91,51,62,14,29,2,4,16,65,91,12,9,56,102,44,56,19,46,4,8,15,63,102
2007-08-13 00:00:00.000,ATP Masters Series Cincinnati OH; U.S.A. ATP World Tour,HARD,2,Rafael Nadal,N/A Bye,Rafael Nadal,,R64,0,0,0,0,0,0,0,0,0,0,0,0,0,0,0,0,0,0,0,0,0,0,0,0,0,0,0
2007-08-13 00:00:00.000,ATP Masters Series Cincinnati OH; U.S.A. ATP World Tour,HARD,2,Roger Federer,Julien Benneteau,Roger Federer,6-3; 6-3,R32,77,3,1,28,51,22,28,15,23,0,0,9,37,51,5,6,39,72,28,39,12,33,5,8,9,40,72
2007-08-13 00:00:00.000,ATP Masters Series Cincinnati OH; U.S.A. ATP World Tour,HARD,2,Marcos Baghdatis,Juan Ignacio Chela,Marcos Baghdatis,6-7(6); 6-4; 6-2,R32,134,6,0,51,109,35,51,36,58,5,6,15,71,109,5,6,55,102,35,55,25,47,6,10,15,60,102
2007-08-13 00:00:00.000,ATP Masters Series Cincinnati OH; U.S.A. ATP World Tour,HARD,2,Nicolas Almagro,Ivan Ljubicic,Nicolas Almagro,6-4; 6-4,R32,66,7,2,36,54,31,36,11,18,1,1,10,42,54,9,4,26,49,22,26,13,23,1,3,10,35,49
2007-08-13 00:00:00.000,ATP Masters Series Cincinnati OH; U.S.A. ATP World Tour,HARD,2,Jarkko Nieminen,Tommy Robredo,Jarkko Nieminen,6-4; 6-1,R32,77,1,0,48,59,34,48,5,11,3,4,9,39,59,4,6,28,58,19,28,9,30,6,10,8,28,58
2007-08-13 00:00:00.000,ATP Masters Series Cincinnati OH; U.S.A. ATP World Tour,HARD,2,Carlos Moya,Novak Djokovic,Carlos Moya,6-4; 6-1,R32,61,3,1,21,42,20,21,13,21,1,1,8,33,42,5,4,25,46,18,25,9,21,0,4,9,27,46
2007-08-13 00:00:00.000,ATP Masters Series Cincinnati OH; U.S.A. ATP World Tour,HARD,2,Juan Martin Del Potro,Philipp Kohlschreiber,Juan Martin Del Potro,6-1; 2-6; 6-4,R32,105,9,0,45,78,30,45,18,33,6,9,13,48,78,5,2,50,71,30,50,10,21,0,4,12,40,71
2007-08-13 00:00:00.000,ATP Masters Series Cincinnati OH; U.S.A. ATP World Tour,HARD,2,Jurgen Melzer,Mario Ancic,Jurgen Melzer,6-3; 2-6; 7-6(9),R32,123,5,0,63,81,49,63,10,18,1,3,14,59,81,9,3,65,99,47,65,19,34,5,7,15,66,99
2007-08-13 00:00:00.000,ATP Masters Series Cincinnati OH; U.S.A. ATP World Tour,HARD,2,Lleyton Hewitt,Richard Gasquet,Lleyton Hewitt,6-1; 3-2 RET,R32,51,5,1,17,33,16,17,9,16,0,0,6,25,33,5,1,17,36,11,17,7,19,1,4,6,18,36
2007-08-13 00:00:00.000,ATP Masters Series Cincinnati OH; U.S.A. ATP World Tour,HARD,2,Nikolay Davydenko,Robby Ginepri,Nikolay Davydenko,6-2; 6-7(7); 6-3,R32,130,6,1,70,98,45,70,17,28,4,6,15,62,98,3,4,50,87,35,50,14,37,3,8,14,49,87
2007-08-13 00:00:00.000,ATP Masters Series Cincinnati OH; U.S.A. ATP World Tour,HARD,2,Tomas Berdych,Arnaud Clement,Tomas Berdych,7-6(1); 7-6(4),R32,111,19,5,51,80,47,51,11,29,0,1,12,58,80,7,4,49,82,39,49,15,33,3,4,12,54,82
2007-08-13 00:00:00.000,ATP Masters Series Cincinnati OH; U.S.A. ATP World Tour,HARD,2,David Ferrer,Radek Stepanek,David Ferrer,6-2; 7-5,R32,90,1,1,53,77,39,53,10,24,5,6,10,49,77,3,2,42,68,28,42,10,26,6,10,10,38,68
2007-08-13 00:00:00.000,ATP Masters Series Cincinnati OH; U.S.A. ATP World Tour,HARD,2,Andy Roddick,Fernando Verdasco,Andy Roddick,7-6(3); 6-2,R32,77,13,1,38,63,33,38,16,25,2,2,10,49,63,7,3,43,55,35,43,3,12,1,3,10,38,55
2007-08-13 00:00:00.000,ATP Masters Series Cincinnati OH; U.S.A. ATP World Tour,HARD,2,Juan Carlos Ferrero,Fernando Gonzalez,Juan Carlos Ferrero,6-2; 7-6(7),R32,90,6,0,43,61,30,43,12,18,0,1,10,42,61,4,3,42,70,28,42,12,28,7,10,10,40,70
2007-08-13 00:00:00.000,ATP Masters Series Cincinnati OH; U.S.A. ATP World Tour,HARD,2,James Blake,Nicolas Kiefer,James Blake,6-4; 6-4,R32,76,7,3,44,67,34,44,13,23,3,3,10,47,67,11,1,29,55,23,29,11,26,1,3,10,34,55
2007-08-13 00:00:00.000,ATP Masters Series Cincinnati OH; U.S.A. ATP World Tour,HARD,2,Sam Querrey,Mikhail Youzhny,Sam Querrey,5-7; 6-3; 6-4,R32,116,17,0,52,84,42,52,20,32,5,7,16,62,84,4,4,49,87,36,49,18,38,2,5,15,54,87
2007-08-13 00:00:00.000,ATP Masters Series Cincinnati OH; U.S.A. ATP World Tour,HARD,2,Juan Monaco,Rafael Nadal,Juan Monaco,7-6(5); 4-1 RET,R32,97,2,2,38,51,28,38,9,13,1,2,8,37,51,1,2,34,62,24,34,11,28,4,7,9,35,62
2007-08-13 00:00:00.000,ATP Masters Series Cincinnati OH; U.S.A. ATP World Tour,HARD,2,Roger Federer,Marcos Baghdatis,Roger Federer,7-6(5); 7-5,R16,102,8,1,50,86,33,50,22,36,9,11,12,55,86,8,9,39,86,31,39,23,47,2,5,12,54,86
2007-08-13 00:00:00.000,ATP Masters Series Cincinnati OH; U.S.A. ATP World Tour,HARD,2,Nicolas Almagro,Jarkko Nieminen,Nicolas Almagro,6-2; 6-2,R16,60,8,2,29,50,24,29,11,21,1,1,8,35,50,0,5,34,54,21,34,6,20,3,7,8,27,54
2007-08-13 00:00:00.000,ATP Masters Series Cincinnati OH; U.S.A. ATP World Tour,HARD,2,Carlos Moya,Juan Martin Del Potro,Carlos Moya,7-5; 3-6; 7-5,R16,141,17,5,55,87,45,55,16,32,1,3,16,61,87,10,6,57,101,42,57,25,44,4,7,17,67,101
2007-08-13 00:00:00.000,ATP Masters Series Cincinnati OH; U.S.A. ATP World Tour,HARD,2,Lleyton Hewitt,Jurgen Melzer,Lleyton Hewitt,6-3; 6-3,R16,71,7,0,22,49,18,22,17,27,1,2,9,35,49,5,5,30,54,19,30,8,24,5,9,9,27,54
2007-08-13 00:00:00.000,ATP Masters Series Cincinnati OH; U.S.A. ATP World Tour,HARD,2,Nikolay Davydenko,Tomas Berdych,Nikolay Davydenko,6-3; 6-2,R16,70,2,2,34,51,27,34,11,17,4,4,9,38,51,2,2,25,46,17,25,8,21,2,5,8,25,46
2007-08-13 00:00:00.000,ATP Masters Series Cincinnati OH; U.S.A. ATP World Tour,HARD,2,David Ferrer,Andy Roddick,David Ferrer,7-6(4); 6-4,R16,85,9,1,47,68,40,47,13,21,3,3,11,53,68,9,1,36,58,32,36,14,22,0,1,11,46,58
2007-08-13 00:00:00.000,ATP Masters Series Cincinnati OH; U.S.A. ATP World Tour,HARD,2,James Blake,Juan Carlos Ferrero,James Blake,6-1; 6-4,R16,64,5,1,31,49,25,31,13,18,1,1,9,38,49,4,3,36,60,25,36,8,24,6,9,8,33,60
2007-08-13 00:00:00.000,ATP Masters Series Cincinnati OH; U.S.A. ATP World Tour,HARD,2,Sam Querrey,Juan Monaco,Sam Querrey,6-3; 7-5,R16,77,10,3,39,70,33,39,16,31,1,1,11,49,70,4,1,27,52,19,27,16,25,1,3,10,35,52
2007-08-13 00:00:00.000,ATP Masters Series Cincinnati OH; U.S.A. ATP World Tour,HARD,2,Roger Federer,Nicolas Almagro,Roger Federer,6-3; 3-6; 6-2,Q,82,9,2,46,61,40,46,6,15,0,2,13,46,61,5,3,51,78,35,51,14,27,2,6,13,49,78
2007-08-13 00:00:00.000,ATP Masters Series Cincinnati OH; U.S.A. ATP World Tour,HARD,2,Lleyton Hewitt,Carlos Moya,Lleyton Hewitt,6-2; 6-4,Q,78,5,2,29,52,23,29,13,23,1,2,9,36,52,6,1,32,56,24,32,5,24,3,7,9,29,56
2007-08-13 00:00:00.000,ATP Masters Series Cincinnati OH; U.S.A. ATP World Tour,HARD,2,Nikolay Davydenko,David Ferrer,Nikolay Davydenko,6-2; 6-4,Q,80,4,3,47,61,35,47,4,14,4,5,9,39,61,1,3,32,51,18,32,7,19,3,7,9,25,51
2007-08-13 00:00:00.000,ATP Masters Series Cincinnati OH; U.S.A. ATP World Tour,HARD,2,James Blake,Sam Querrey,James Blake,5-7; 6-4; 6-4,Q,108,8,3,50,85,39,50,25,35,2,3,16,64,85,14,4,53,100,42,53,23,47,3,5,16,65,100
2007-08-13 00:00:00.000,ATP Masters Series Cincinnati OH; U.S.A. ATP World Tour,HARD,2,Roger Federer,Lleyton Hewitt,Roger Federer,6-3; 6-7(7); 7-6(1),S,155,18,2,70,112,50,70,26,42,2,4,17,76,112,5,6,50,113,34,50,36,63,8,11,16,70,113
2007-08-13 00:00:00.000,ATP Masters Series Cincinnati OH; U.S.A. ATP World Tour,HARD,2,James Blake,Nikolay Davydenko,James Blake,6-4; 6-2,S,71,2,1,36,61,26,36,10,25,2,4,9,36,61,1,1,45,57,23,45,5,12,3,8,9,28,57
2007-08-13 00:00:00.000,ATP Masters Series Cincinnati OH; U.S.A. ATP World Tour,HARD,2,Roger Federer,James Blake,Roger Federer,6-1; 6-4,F,65,9,2,40,66,33,40,11,26,5,5,9,44,66,3,4,24,47,15,24,11,23,3,6,8,26,47
2007-08-19 00:00:00.000,New Haven CT; U.S.A. ATP World Tour,HARD,2,Nikolay Davydenko,N/A Bye,Nikolay Davydenko,,R64,0,0,0,0,0,0,0,0,0,0,0,0,0,0,0,0,0,0,0,0,0,0,0,0,0,0,0
2007-08-19 00:00:00.000,New Haven CT; U.S.A. ATP World Tour,HARD,2,Donald Young,Amer Delic,Donald Young,4-6; 6-3; 6-4,R64,96,2,3,47,85,37,47,24,38,3,4,15,61,85,13,3,56,85,43,56,13,29,3,5,14,56,85
2007-08-19 00:00:00.000,New Haven CT; U.S.A. ATP World Tour,HARD,2,Juan Martin Del Potro,Jo-Wilfried Tsonga,Juan Martin Del Potro,3-6; 6-3; 6-4,R64,121,6,1,57,98,40,57,24,41,8,9,14,64,98,10,6,51,95,39,51,20,44,5,7,14,59,95
2007-08-19 00:00:00.000,New Haven CT; U.S.A. ATP World Tour,HARD,2,Gilles Simon,N/A Bye,Gilles Simon,,R64,0,0,0,0,0,0,0,0,0,0,0,0,0,0,0,0,0,0,0,0,0,0,0,0,0,0,0
2007-08-19 00:00:00.000,New Haven CT; U.S.A. ATP World Tour,HARD,2,Nicolas Almagro,N/A Bye,Nicolas Almagro,,R64,0,0,0,0,0,0,0,0,0,0,0,0,0,0,0,0,0,0,0,0,0,0,0,0,0,0,0
2007-08-19 00:00:00.000,New Haven CT; U.S.A. ATP World Tour,HARD,2,Julien Benneteau,Oscar Hernandez,Julien Benneteau,6-2; 6-2,R64,65,4,1,25,48,19,25,17,23,3,3,8,36,48,1,3,29,49,17,29,7,20,3,7,8,24,49
2007-08-19 00:00:00.000,New Haven CT; U.S.A. ATP World Tour,HARD,2,Luis Horna,Stefan Koubek,Luis Horna,6-4; 2-6; 6-4,R64,88,5,1,56,77,47,56,8,21,2,4,14,55,77,5,2,42,74,29,42,21,32,0,2,14,50,74
2007-08-19 00:00:00.000,New Haven CT; U.S.A. ATP World Tour,HARD,2,Paul-Henri Mathieu,N/A Bye,Paul-Henri Mathieu,,R64,0,0,0,0,0,0,0,0,0,0,0,0,0,0,0,0,0,0,0,0,0,0,0,0,0,0,0
2007-08-19 00:00:00.000,New Haven CT; U.S.A. ATP World Tour,HARD,2,James Blake,N/A Bye,James Blake,,R64,0,0,0,0,0,0,0,0,0,0,0,0,0,0,0,0,0,0,0,0,0,0,0,0,0,0,0
2007-08-19 00:00:00.000,New Haven CT; U.S.A. ATP World Tour,HARD,2,Arnaud Clement,Kevin Anderson,Arnaud Clement,6-1; 6-4,R64,62,4,3,26,46,22,26,14,20,0,0,9,36,46,7,1,42,56,23,42,6,14,3,6,8,29,56
2007-08-19 00:00:00.000,New Haven CT; U.S.A. ATP World Tour,HARD,2,Robby Ginepri,Nicolas Massu,Robby Ginepri,7-6(1); 6-4,R64,103,10,1,44,66,31,44,11,22,4,7,11,42,66,8,3,60,93,41,60,8,33,9,13,11,49,93
2007-08-19 00:00:00.000,New Haven CT; U.S.A. ATP World Tour,HARD,2,Agustin Calleri,N/A Bye,Agustin Calleri,,R64,0,0,0,0,0,0,0,0,0,0,0,0,0,0,0,0,0,0,0,0,0,0,0,0,0,0,0
2007-08-19 00:00:00.000,New Haven CT; U.S.A. ATP World Tour,HARD,2,Fernando Verdasco,N/A Bye,Fernando Verdasco,,R64,0,0,0,0,0,0,0,0,0,0,0,0,0,0,0,0,0,0,0,0,0,0,0,0,0,0,0
2007-08-19 00:00:00.000,New Haven CT; U.S.A. ATP World Tour,HARD,2,Vincent Spadea,Evgeny Korolev,Vincent Spadea,6-2; 5-7; 7-5,R64,112,3,1,69,100,46,69,19,31,9,12,16,65,100,12,7,56,89,45,56,13,33,2,7,16,58,89
2007-08-19 00:00:00.000,New Haven CT; U.S.A. ATP World Tour,HARD,2,Feliciano Lopez,Janko Tipsarevic,Feliciano Lopez,7-6(5); 7-6(2),R64,111,18,2,48,80,38,48,17,32,6,8,12,55,80,6,0,58,93,39,58,17,35,9,11,12,56,93
2007-08-19 00:00:00.000,New Haven CT; U.S.A. ATP World Tour,HARD,2,Jarkko Nieminen,N/A Bye,Jarkko Nieminen,,R64,0,0,0,0,0,0,0,0,0,0,0,0,0,0,0,0,0,0,0,0,0,0,0,0,0,0,0
2007-08-19 00:00:00.000,New Haven CT; U.S.A. ATP World Tour,HARD,2,Potito Starace,N/A Bye,Potito Starace,,R64,0,0,0,0,0,0,0,0,0,0,0,0,0,0,0,0,0,0,0,0,0,0,0,0,0,0,0
2007-08-19 00:00:00.000,New Haven CT; U.S.A. ATP World Tour,HARD,2,Thomas Johansson,Kristof Vliegen,Thomas Johansson,6-2; 6-1,R64,63,4,2,22,38,20,22,8,16,0,0,7,28,38,9,2,44,74,28,44,8,30,8,13,8,36,74
2007-08-19 00:00:00.000,New Haven CT; U.S.A. ATP World Tour,HARD,2,Michael Russell,Guillermo Garcia-Lopez,Michael Russell,3-6; 6-4; 6-0,R64,130,5,5,58,103,37,58,19,45,8,13,13,56,103,6,5,51,86,31,51,9,35,3,10,12,40,86
2007-08-19 00:00:00.000,New Haven CT; U.S.A. ATP World Tour,HARD,2,Ivo Karlovic,N/A Bye,Ivo Karlovic,,R64,0,0,0,0,0,0,0,0,0,0,0,0,0,0,0,0,0,0,0,0,0,0,0,0,0,0,0
2007-08-19 00:00:00.000,New Haven CT; U.S.A. ATP World Tour,HARD,2,Igor Andreev,N/A Bye,Igor Andreev,,R64,0,0,0,0,0,0,0,0,0,0,0,0,0,0,0,0,0,0,0,0,0,0,0,0,0,0,0
2007-08-19 00:00:00.000,New Haven CT; U.S.A. ATP World Tour,HARD,2,Albert Montanes,Teymuraz Gabashvili,Albert Montanes,6-4; 6-4,R64,67,6,2,39,60,29,39,12,21,4,5,10,41,60,6,6,41,65,32,41,7,24,5,8,10,39,65
2007-08-19 00:00:00.000,New Haven CT; U.S.A. ATP World Tour,HARD,2,John Isner,Benjamin Becker,John Isner,6-3; 6-4,R64,58,13,3,35,55,26,35,15,20,0,0,10,41,55,14,1,32,55,24,32,11,23,2,4,9,35,55
2007-08-19 00:00:00.000,New Haven CT; U.S.A. ATP World Tour,HARD,2,David Ferrer,N/A Bye,David Ferrer,,R64,0,0,0,0,0,0,0,0,0,0,0,0,0,0,0,0,0,0,0,0,0,0,0,0,0,0,0
2007-08-19 00:00:00.000,New Haven CT; U.S.A. ATP World Tour,HARD,2,Filippo Volandri,N/A Bye,Filippo Volandri,,R64,0,0,0,0,0,0,0,0,0,0,0,0,0,0,0,0,0,0,0,0,0,0,0,0,0,0,0
2007-08-19 00:00:00.000,New Haven CT; U.S.A. ATP World Tour,HARD,2,Mardy Fish,Florian Mayer,Mardy Fish,4-6; 7-5; 6-4,R64,106,13,4,51,97,42,51,19,46,3,7,16,61,97,2,2,55,87,40,55,13,32,1,6,16,53,87
2007-08-19 00:00:00.000,New Haven CT; U.S.A. ATP World Tour,HARD,2,Jose Acasuso,Olivier Rochus,Jose Acasuso,6-1; 7-6(7),R64,99,16,5,48,83,40,48,14,35,7,8,10,54,83,0,0,44,65,25,44,14,21,6,9,9,39,65
2007-08-19 00:00:00.000,New Haven CT; U.S.A. ATP World Tour,HARD,2,Dominik Hrbaty,N/A Bye,Dominik Hrbaty,,R64,0,0,0,0,0,0,0,0,0,0,0,0,0,0,0,0,0,0,0,0,0,0,0,0,0,0,0
2007-08-19 00:00:00.000,New Haven CT; U.S.A. ATP World Tour,HARD,2,Gael Monfils,N/A Bye,Gael Monfils,,R64,0,0,0,0,0,0,0,0,0,0,0,0,0,0,0,0,0,0,0,0,0,0,0,0,0,0,0
2007-08-19 00:00:00.000,New Haven CT; U.S.A. ATP World Tour,HARD,2,Stanislas Wawrinka,Mario Ancic,Stanislas Wawrinka,7-6(4); 6-4,R64,116,8,2,36,73,30,36,25,37,3,3,11,55,73,3,0,65,88,46,65,10,23,4,5,11,56,88
2007-08-19 00:00:00.000,New Haven CT; U.S.A. ATP World Tour,HARD,2,Marc Gicquel,Carlos Berlocq,Marc Gicquel,6-2; 6-4,R64,86,4,1,28,58,22,28,16,30,2,3,9,38,58,8,4,31,61,24,31,9,30,7,11,9,33,61
2007-08-19 00:00:00.000,New Haven CT; U.S.A. ATP World Tour,HARD,2,Tommy Robredo,N/A Bye,Tommy Robredo,,R64,0,0,0,0,0,0,0,0,0,0,0,0,0,0,0,0,0,0,0,0,0,0,0,0,0,0,0
2007-08-19 00:00:00.000,New Haven CT; U.S.A. ATP World Tour,HARD,2,Nikolay Davydenko,Donald Young,Nikolay Davydenko,6-2; 4-6; 7-5,R32,114,3,4,56,85,35,56,14,29,6,11,15,49,85,6,5,43,85,30,43,14,42,4,11,15,44,85
2007-08-19 00:00:00.000,New Haven CT; U.S.A. ATP World Tour,HARD,2,Gilles Simon,Juan Martin Del Potro,Gilles Simon,7-6(3); 6-7(5); 7-5,R32,182,2,6,65,133,38,65,38,68,4,10,18,76,133,4,8,79,133,51,79,21,54,7,14,18,72,133
2007-08-19 00:00:00.000,New Haven CT; U.S.A. ATP World Tour,HARD,2,Nicolas Almagro,Julien Benneteau,Nicolas Almagro,6-7(5); 6-3; 6-3,R32,128,9,4,60,101,43,60,24,41,4,6,15,67,101,4,6,61,102,45,61,16,41,11,16,15,61,102
2007-08-19 00:00:00.000,New Haven CT; U.S.A. ATP World Tour,HARD,2,Paul-Henri Mathieu,Luis Horna,Paul-Henri Mathieu,6-3; 7-6(3),R32,88,11,3,45,72,38,45,12,27,4,6,11,50,72,10,2,36,60,26,36,12,24,2,5,10,38,60
2007-08-19 00:00:00.000,New Haven CT; U.S.A. ATP World Tour,HARD,2,James Blake,Arnaud Clement,James Blake,6-4; 6-2,R32,75,6,2,32,56,24,32,8,24,1,4,9,32,56,3,3,33,56,21,33,5,23,7,13,9,26,56
2007-08-19 00:00:00.000,New Haven CT; U.S.A. ATP World Tour,HARD,2,Agustin Calleri,Robby Ginepri,Agustin Calleri,6-4; 3-6; 7-5,R32,105,14,5,50,84,41,50,17,34,2,4,15,58,84,4,1,59,98,43,59,19,39,3,6,16,62,98
2007-08-19 00:00:00.000,New Haven CT; U.S.A. ATP World Tour,HARD,2,Fernando Verdasco,Vincent Spadea,Fernando Verdasco,2-6; 6-4; 6-2,R32,103,1,5,55,79,38,55,12,24,5,9,13,50,79,3,2,50,81,30,50,14,31,2,7,13,44,81
2007-08-19 00:00:00.000,New Haven CT; U.S.A. ATP World Tour,HARD,2,Jarkko Nieminen,Feliciano Lopez,Jarkko Nieminen,3-6; 6-2; 7-6(6),R32,125,3,0,79,101,51,79,12,22,5,7,14,63,101,9,1,68,102,46,68,17,34,8,11,15,63,102
2007-08-19 00:00:00.000,New Haven CT; U.S.A. ATP World Tour,HARD,2,Thomas Johansson,Potito Starace,Thomas Johansson,7-6(3); 6-3,R32,76,10,1,48,65,43,48,9,17,4,4,11,52,65,10,1,40,58,31,40,11,18,0,1,10,42,58
2007-08-19 00:00:00.000,New Haven CT; U.S.A. ATP World Tour,HARD,2,Ivo Karlovic,Michael Russell,Ivo Karlovic,7-6(2); 6-4,R32,86,14,1,40,55,37,40,12,15,0,0,11,49,55,3,4,54,74,38,54,12,20,6,7,11,50,74
2007-08-19 00:00:00.000,New Haven CT; U.S.A. ATP World Tour,HARD,2,Igor Andreev,Albert Montanes,Igor Andreev,6-1; 6-7(4); 7-6(4),R32,119,6,2,58,90,43,58,22,32,1,2,16,65,90,0,3,64,106,45,64,21,42,3,6,15,66,106
2007-08-19 00:00:00.000,New Haven CT; U.S.A. ATP World Tour,HARD,2,David Ferrer,John Isner,David Ferrer,6-7(2); 6-2; 6-2,R32,123,5,1,50,92,38,50,26,42,7,7,14,64,92,11,2,65,98,41,65,19,33,7,11,14,60,98
2007-08-19 00:00:00.000,New Haven CT; U.S.A. ATP World Tour,HARD,2,Mardy Fish,Filippo Volandri,Mardy Fish,6-7(4); 7-5; 6-0,R32,104,18,2,57,88,46,57,15,31,2,4,15,61,88,0,3,63,94,35,63,18,31,4,10,15,53,94
2007-08-19 00:00:00.000,New Haven CT; U.S.A. ATP World Tour,HARD,2,Jose Acasuso,Dominik Hrbaty,Jose Acasuso,6-1; 7-5,R32,82,4,3,31,62,26,31,15,31,3,4,10,41,62,4,6,41,58,27,41,3,17,7,11,9,30,58
2007-08-19 00:00:00.000,New Haven CT; U.S.A. ATP World Tour,HARD,2,Stanislas Wawrinka,Gael Monfils,Stanislas Wawrinka,7-6(5); 6-4,R32,114,5,4,51,92,38,51,19,41,10,11,11,57,92,6,0,35,67,25,35,19,32,5,7,11,44,67
2007-08-19 00:00:00.000,New Haven CT; U.S.A. ATP World Tour,HARD,2,Tommy Robredo,Marc Gicquel,Tommy Robredo,6-4; 6-4,R32,87,1,1,36,56,24,36,13,20,3,4,10,37,56,3,5,34,67,26,34,13,33,5,8,10,39,67
2007-08-19 00:00:00.000,New Haven CT; U.S.A. ATP World Tour,HARD,2,Gilles Simon,Nikolay Davydenko,Gilles Simon,6-4; 6-4,R16,81,1,0,39,62,28,39,12,23,0,1,10,40,62,3,4,41,66,24,41,12,25,2,5,10,36,66
2007-08-19 00:00:00.000,New Haven CT; U.S.A. ATP World Tour,HARD,2,Paul-Henri Mathieu,Nicolas Almagro,Paul-Henri Mathieu,4-6; 6-3; 6-2,R16,87,11,6,45,76,39,45,18,31,1,2,14,57,76,16,8,43,76,34,43,14,33,5,8,13,48,76
2007-08-19 00:00:00.000,New Haven CT; U.S.A. ATP World Tour,HARD,2,James Blake,Agustin Calleri,James Blake,3-6; 7-6(2); 6-1,R16,120,11,7,56,102,40,56,21,46,4,7,13,61,102,9,4,49,100,39,49,18,51,5,10,15,57,100
2007-08-19 00:00:00.000,New Haven CT; U.S.A. ATP World Tour,HARD,2,Fernando Verdasco,Jarkko Nieminen,Fernando Verdasco,6-3; 2-6; 6-4,R16,112,4,5,70,95,41,70,12,25,9,14,14,53,95,3,3,51,76,29,51,13,25,3,8,13,42,76
2007-08-19 00:00:00.000,New Haven CT; U.S.A. ATP World Tour,HARD,2,Ivo Karlovic,Thomas Johansson,Ivo Karlovic,4-6; 6-4; 7-5,R16,110,24,2,57,82,50,57,12,25,0,1,16,62,82,7,3,56,93,43,56,22,37,5,7,16,65,93
2007-08-19 00:00:00.000,New Haven CT; U.S.A. ATP World Tour,HARD,2,Igor Andreev,David Ferrer,Igor Andreev,3-6; 7-6(3); 6-4,R16,148,5,5,67,99,48,67,13,32,3,7,15,61,99,2,0,71,114,48,71,21,43,7,11,16,69,114
2007-08-19 00:00:00.000,New Haven CT; U.S.A. ATP World Tour,HARD,2,Mardy Fish,Jose Acasuso,Mardy Fish,6-7(4); 6-3; 6-0,R16,106,14,1,36,73,30,36,26,37,0,0,13,56,73,7,5,45,87,33,45,18,42,4,9,14,51,87
2007-08-19 00:00:00.000,New Haven CT; U.S.A. ATP World Tour,HARD,2,Stanislas Wawrinka,Tommy Robredo,Stanislas Wawrinka,6-3; 6-3,R16,75,7,3,32,56,27,32,13,24,3,3,9,40,56,0,1,39,56,23,39,11,17,2,5,9,34,56
2007-08-19 00:00:00.000,New Haven CT; U.S.A. ATP World Tour,HARD,2,Paul-Henri Mathieu,Gilles Simon,Paul-Henri Mathieu,6-4; 6-3,Q,83,7,0,28,44,24,28,12,16,0,0,9,36,44,1,1,35,70,26,35,12,35,6,9,10,38,70
2007-08-19 00:00:00.000,New Haven CT; U.S.A. ATP World Tour,HARD,2,James Blake,Fernando Verdasco,James Blake,6-4; 6-2,Q,60,6,1,30,50,26,30,12,20,1,1,9,38,50,3,2,36,53,21,36,10,17,0,3,9,31,53
2007-08-19 00:00:00.000,New Haven CT; U.S.A. ATP World Tour,HARD,2,Ivo Karlovic,Igor Andreev,Ivo Karlovic,6-7(8); 6-4; 7-6(1),Q,131,28,1,71,94,65,71,14,23,0,0,17,79,94,6,2,79,118,58,79,25,39,3,4,17,83,118
2007-08-19 00:00:00.000,New Haven CT; U.S.A. ATP World Tour,HARD,2,Mardy Fish,Stanislas Wawrinka,Mardy Fish,6-3; 6-3,Q,81,7,2,31,56,25,31,11,25,1,2,9,36,56,1,2,30,66,19,30,18,36,10,14,9,37,66
2007-08-19 00:00:00.000,New Haven CT; U.S.A. ATP World Tour,HARD,2,James Blake,Paul-Henri Mathieu,James Blake,6-4; 3-6; 7-6(2),S,126,9,1,45,84,36,45,25,39,1,4,15,61,84,5,4,55,96,45,55,19,41,4,7,16,64,96
2007-08-19 00:00:00.000,New Haven CT; U.S.A. ATP World Tour,HARD,2,Mardy Fish,Ivo Karlovic,Mardy Fish,7-6(3); 6-4,S,96,7,3,38,69,30,38,17,31,1,2,11,47,69,11,2,49,82,36,49,12,33,3,5,11,48,82
2007-08-19 00:00:00.000,New Haven CT; U.S.A. ATP World Tour,HARD,2,James Blake,Mardy Fish,James Blake,7-5; 6-4,F,78,5,2,31,62,25,31,14,31,1,4,11,39,62,6,3,32,60,22,32,13,28,2,7,11,35,60
2007-08-27 00:00:00.000,US Open NY; U.S.A. Grand Slams,HARD,3,Roger Federer,Scoville Jenkins,Roger Federer,6-3; 6-2; 6-4,R128,90,13,2,46,73,40,46,18,27,2,2,14,58,73,9,7,54,81,37,54,11,27,5,9,13,48,81
2007-08-27 00:00:00.000,US Open NY; U.S.A. Grand Slams,HARD,3,Paul Capdeville,Rainer Schuettler,Paul Capdeville,5-7; 6-3; 6-7(4); 6-4; 6-3,R128,219,11,5,89,151,56,89,32,62,6,14,25,88,151,14,4,129,193,72,129,30,64,19,31,27,102,193
2007-08-27 00:00:00.000,US Open NY; U.S.A. Grand Slams,HARD,3,Rik De Voest,Thierry Ascione,Rik De Voest,6-2; 3-0 RET,R128,45,6,1,23,40,20,23,8,17,1,1,6,28,40,1,6,22,35,12,22,3,13,2,5,5,15,35
2007-08-27 00:00:00.000,US Open NY; U.S.A. Grand Slams,HARD,3,John Isner,Jarkko Nieminen,John Isner,6-7(4); 7-6(4); 7-6(5); 6-4,R128,188,36,5,98,154,78,98,34,56,7,7,23,112,154,13,8,101,147,79,101,27,46,2,3,23,106,147
2007-08-27 00:00:00.000,US Open NY; U.S.A. Grand Slams,HARD,3,Feliciano Lopez,Juan Carlos Ferrero,Feliciano Lopez,6-3; 6-4; 6-4,R128,103,18,7,46,82,39,46,20,36,2,3,15,59,82,8,6,48,88,30,48,21,40,5,9,14,51,88
2007-08-27 00:00:00.000,US Open NY; U.S.A. Grand Slams,HARD,3,Igor Andreev,Robert Kendrick,Igor Andreev,7-6(4); 6-3; 6-4,R128,130,4,2,62,101,46,62,22,39,1,3,16,68,101,5,5,59,109,41,59,21,50,9,13,15,62,109
2007-08-27 00:00:00.000,US Open NY; U.S.A. Grand Slams,HARD,3,Donald Young,Chris Guccione,Donald Young,6-7(2); 6-3; 6-2; 6-3,R128,148,7,3,72,119,61,72,24,47,2,2,19,85,119,9,4,92,143,65,92,20,51,7,12,19,85,143
2007-08-27 00:00:00.000,US Open NY; U.S.A. Grand Slams,HARD,3,Richard Gasquet,Sergio Roitman,Richard Gasquet,7-5; 6-1; 6-2,R128,97,11,2,41,77,35,41,20,36,3,4,14,55,77,3,0,46,81,27,46,14,35,3,9,13,41,81
2007-08-27 00:00:00.000,US Open NY; U.S.A. Grand Slams,HARD,3,Tomas Berdych,Marc Gicquel,Tomas Berdych,6-3; 7-6(0); 6-2,R128,114,9,1,45,81,39,45,24,36,2,3,15,63,81,2,3,42,98,30,42,25,56,6,10,14,55,98
2007-08-27 00:00:00.000,US Open NY; U.S.A. Grand Slams,HARD,3,Simone Bolelli,Julien Benneteau,Simone Bolelli,6-3; 6-4; 3-6; 6-1,R128,134,12,2,61,103,50,61,24,42,3,5,18,74,103,7,8,70,106,47,70,14,36,5,10,17,61,106
2007-08-27 00:00:00.000,US Open NY; U.S.A. Grand Slams,HARD,3,Gilles Simon,Alexander Waske,Gilles Simon,6-4; 6-1 RET,R128,77,11,2,30,59,23,30,18,29,5,6,9,41,59,3,4,24,48,15,24,9,24,2,6,8,24,48
2007-08-27 00:00:00.000,US Open NY; U.S.A. Grand Slams,HARD,3,Fernando Verdasco,Paul-Henri Mathieu,Fernando Verdasco,3-6; 1-6; 6-4; 6-3; 6-3,R128,204,9,8,106,159,70,106,22,53,11,18,22,92,159,7,6,81,134,56,81,23,53,4,11,22,79,134
2007-08-27 00:00:00.000,US Open NY; U.S.A. Grand Slams,HARD,3,Arnaud Clement,Ivo Karlovic,Arnaud Clement,7-6(5); 6-4; 4-6; 6-7(6); 6-4,R128,246,10,5,94,168,71,94,43,74,7,11,27,114,168,38,4,120,178,85,120,25,58,10,15,27,110,178
2007-08-27 00:00:00.000,US Open NY; U.S.A. Grand Slams,HARD,3,Thomas Johansson,Nicolas Massu,Thomas Johansson,2-6; 7-6(3); 6-3; 6-3,R128,163,12,4,53,104,37,53,34,51,3,7,19,71,104,10,2,64,115,44,64,26,51,5,10,19,70,115
2007-08-27 00:00:00.000,US Open NY; U.S.A. Grand Slams,HARD,3,Jose Acasuso,Martin Vassallo Arguello,Jose Acasuso,6-4; 6-7(2); 6-3; 6-4,R128,159,9,3,36,40,32,36,1,4,0,0,8,33,40,6,1,33,35,16,33,0,2,2,6,7,16,35
2007-08-27 00:00:00.000,US Open NY; U.S.A. Grand Slams,HARD,3,Andy Roddick,Justin Gimelstob,Andy Roddick,7-6(6); 6-3; 6-3,R128,118,17,2,66,86,58,66,10,20,2,2,15,68,86,8,5,58,95,41,58,22,37,2,5,15,63,95
2007-08-27 00:00:00.000,US Open NY; U.S.A. Grand Slams,HARD,3,Nikolay Davydenko,Jesse Levine,Nikolay Davydenko,6-4; 6-0; 6-1,R128,99,5,2,45,68,36,45,13,23,5,5,11,49,68,4,8,51,87,26,51,15,36,7,14,12,41,87
2007-08-27 00:00:00.000,US Open NY; U.S.A. Grand Slams,HARD,3,Nicolas Kiefer,Vincent Spadea,Nicolas Kiefer,6-2; 7-6(1); 6-3,R128,116,12,6,43,80,37,43,24,37,0,1,15,61,80,0,5,60,99,37,60,19,39,8,12,14,56,99
2007-08-27 00:00:00.000,US Open NY; U.S.A. Grand Slams,HARD,3,Luis Horna,Peter Luczak,Luis Horna,7-6(4); 6-3; 7-6(6),R128,134,12,3,71,102,57,71,19,31,2,3,17,76,102,11,2,79,115,59,79,16,36,6,8,16,75,115
2007-08-27 00:00:00.000,US Open NY; U.S.A. Grand Slams,HARD,3,Nicolas Almagro,Alex Kuznetsov,Nicolas Almagro,6-4; 6-0; 7-6(4),R128,96,12,1,50,77,43,50,19,27,1,1,14,62,77,7,3,38,74,31,38,19,36,2,6,14,50,74
2007-08-27 00:00:00.000,US Open NY; U.S.A. Grand Slams,HARD,3,Andy Murray,Pablo Cuevas,Andy Murray,6-2; 6-3; 6-0,R128,102,6,4,40,78,31,40,20,38,6,7,12,51,78,1,5,34,78,17,34,18,44,10,17,11,35,78
2007-08-27 00:00:00.000,US Open NY; U.S.A. Grand Slams,HARD,3,Jonas Bjorkman,Juan-Pablo Guzman,Jonas Bjorkman,6-3; 7-6(4); 6-2,R128,116,9,4,54,93,44,54,25,39,7,7,15,69,93,8,4,53,95,40,53,18,42,5,8,14,58,95
2007-08-27 00:00:00.000,US Open NY; U.S.A. Grand Slams,HARD,3,Hyung-Taik Lee,Dominik Hrbaty,Hyung-Taik Lee,6-7(4); 6-4; 7-5; 6-7(6); 6-4,R128,238,12,5,109,182,75,109,31,73,8,16,28,106,182,12,12,111,192,72,111,35,81,12,23,28,107,192
2007-08-27 00:00:00.000,US Open NY; U.S.A. Grand Slams,HARD,3,Guillermo Canas,Ruben Ramirez Hidalgo,Guillermo Canas,6-3; 4-6; 7-5; 6-3,R128,195,6,3,64,112,50,64,27,48,5,9,20,77,112,9,5,65,125,44,65,28,60,7,14,20,72,125
2007-08-27 00:00:00.000,US Open NY; U.S.A. Grand Slams,HARD,3,Tommy Haas,Steve Darcis,Tommy Haas,6-7(5); 7-5; 6-3; 6-4,R128,153,14,4,75,127,63,75,34,52,4,5,22,97,127,7,6,74,114,61,74,22,40,1,5,21,83,114
2007-08-27 00:00:00.000,US Open NY; U.S.A. Grand Slams,HARD,3,Philipp Petzschner,Benjamin Becker,Philipp Petzschner,2-6; 3-6; 6-4; 6-4; 6-1,R128,161,20,6,74,126,58,74,28,52,5,9,22,86,126,6,14,66,139,52,66,33,73,8,13,22,85,139
2007-08-27 00:00:00.000,US Open NY; U.S.A. Grand Slams,HARD,3,Sebastien Grosjean,Paul Goldstein,Sebastien Grosjean,6-1; 4-1 RET,R128,45,5,0,12,28,12,12,12,16,0,0,6,24,28,1,4,29,51,15,29,8,22,7,11,6,23,51
2007-08-27 00:00:00.000,US Open NY; U.S.A. Grand Slams,HARD,3,Max Mirnyi,Marcos Baghdatis,Max Mirnyi,6-3; 7-5; 3-6; 7-6(6),R128,201,16,12,85,148,67,85,31,63,8,10,21,98,148,2,8,56,142,46,56,47,86,4,7,21,93,142
2007-08-27 00:00:00.000,US Open NY; U.S.A. Grand Slams,HARD,3,Michael Llodra,Filippo Volandri,Michael Llodra,6-3; 4-6; 6-4; 6-4,R128,154,8,8,72,125,55,72,28,53,10,13,20,83,125,1,2,84,120,55,84,19,36,8,13,19,74,120
2007-08-27 00:00:00.000,US Open NY; U.S.A. Grand Slams,HARD,3,Stefan Koubek,Sam Querrey,Stefan Koubek,7-6(1); 6-1; 6-1,R128,82,8,3,48,78,40,48,20,30,7,7,13,60,78,6,7,50,82,33,50,12,32,2,7,13,45,82
2007-08-27 00:00:00.000,US Open NY; U.S.A. Grand Slams,HARD,3,Fabrice Santoro,Albert Montanes,Fabrice Santoro,6-1; 6-7(8); 6-2; 6-1,R128,151,18,1,65,101,55,65,25,36,4,5,18,80,101,3,2,85,115,50,85,14,30,8,15,16,64,115
2007-08-27 00:00:00.000,US Open NY; U.S.A. Grand Slams,HARD,3,James Blake,Michael Russell,James Blake,7-6(6); 6-3; 7-6(4),R128,161,14,5,82,122,59,82,22,40,2,3,17,81,122,5,5,76,128,53,76,25,52,11,13,16,78,128
2007-08-27 00:00:00.000,US Open NY; U.S.A. Grand Slams,HARD,3,Tommy Robredo,Bobby Reynolds,Tommy Robredo,6-3; 7-6(5); 6-1,R128,119,5,0,71,102,51,71,21,31,9,9,15,72,102,7,5,46,75,30,46,18,29,0,3,13,48,75
2007-08-27 00:00:00.000,US Open NY; U.S.A. Grand Slams,HARD,3,Mardy Fish,Bruno Echagaray,Mardy Fish,6-4; 6-1; 6-2,R128,95,12,3,35,69,30,35,21,34,2,3,13,51,69,4,3,48,76,27,48,10,28,7,13,12,37,76
2007-08-27 00:00:00.000,US Open NY; U.S.A. Grand Slams,HARD,3,Michael Berrer,Michal Przysiezny,Michael Berrer,6-1; 4-6; 6-1; 7-6(4),R128,194,9,4,68,111,49,68,22,43,5,8,18,71,111,13,9,97,159,60,97,25,62,19,26,18,85,159
2007-08-27 00:00:00.000,US Open NY; U.S.A. Grand Slams,HARD,3,Ernests Gulbis,Potito Starace,Ernests Gulbis,7-5; 7-6(4); 6-3,R128,117,17,5,60,101,50,60,24,41,4,5,17,74,101,3,6,64,102,44,64,21,38,3,6,16,65,102
2007-08-27 00:00:00.000,US Open NY; U.S.A. Grand Slams,HARD,3,Carlos Moya,Bjorn Phau,Carlos Moya,6-1; 6-2; 6-4,R128,89,7,4,55,79,42,55,14,24,3,3,13,56,79,4,2,28,72,18,28,21,44,4,9,12,39,72
2007-08-27 00:00:00.000,US Open NY; U.S.A. Grand Slams,HARD,3,Igor Kunitsyn,Guillermo Garcia-Lopez,Igor Kunitsyn,4-6; 6-3; 7-5; 2-6; 7-5,R128,227,7,4,100,178,66,100,36,78,8,17,26,102,178,7,7,79,151,54,79,32,72,5,14,25,86,151
2007-08-27 00:00:00.000,US Open NY; U.S.A. Grand Slams,HARD,3,Philipp Kohlschreiber,Mariano Zabaleta,Philipp Kohlschreiber,6-2; 6-2; 6-4,R128,102,3,3,43,77,34,43,20,34,5,6,13,54,77,3,7,41,82,23,41,20,41,5,11,13,43,82
2007-08-27 00:00:00.000,US Open NY; U.S.A. Grand Slams,HARD,3,Mikhail Youzhny,Nicolas Devilder,Mikhail Youzhny,6-0; 6-1; 6-2,R128,101,6,4,36,68,24,36,18,32,3,5,11,42,68,1,1,29,69,13,29,12,40,4,13,10,25,69
2007-08-27 00:00:00.000,US Open NY; U.S.A. Grand Slams,HARD,3,Lleyton Hewitt,Amer Delic,Lleyton Hewitt,6-2; 6-4; 6-2,R128,97,8,1,39,61,37,39,15,22,0,0,13,52,61,9,1,47,85,29,47,18,38,6,11,13,47,85
2007-08-27 00:00:00.000,US Open NY; U.S.A. Grand Slams,HARD,3,Agustin Calleri,Andreas Seppi,Agustin Calleri,6-4; 6-4; 3-6; 7-5,R128,169,12,5,70,117,52,70,26,47,4,7,20,78,117,13,10,80,159,59,80,36,79,10,15,21,95,159
2007-08-27 00:00:00.000,US Open NY; U.S.A. Grand Slams,HARD,3,Dudi Sela,Nicolas Lapentti,Dudi Sela,5-7; 6-2; 6-1; 6-3,R128,166,9,6,72,112,54,72,20,40,7,10,18,74,112,4,0,84,119,46,84,16,35,5,13,18,62,119
2007-08-27 00:00:00.000,US Open NY; U.S.A. Grand Slams,HARD,3,Juan Monaco,Edouard Roger-Vasselin,Juan Monaco,6-2; 3-6; 6-1; 7-5,R128,140,10,3,62,104,46,62,21,42,3,7,18,67,104,1,2,63,103,43,63,12,40,4,12,18,55,103
2007-08-27 00:00:00.000,US Open NY; U.S.A. Grand Slams,HARD,3,Jurgen Melzer,Diego Hartfield,Jurgen Melzer,6-4; 7-5; 7-5,R128,138,11,2,86,118,67,86,14,32,9,9,17,81,118,5,9,60,100,45,60,19,40,6,9,17,64,100
2007-08-27 00:00:00.000,US Open NY; U.S.A. Grand Slams,HARD,3,Juan Martin Del Potro,Nicolas Mahut,Juan Martin Del Potro,6-0; 6-4; 6-2,R128,116,14,3,44,72,35,44,15,28,2,3,12,50,72,8,6,53,97,30,53,17,44,15,22,12,47,97
2007-08-27 00:00:00.000,US Open NY; U.S.A. Grand Slams,HARD,3,Radek Stepanek,Carlos Berlocq,Radek Stepanek,7-6(3); 6-7(4); 6-4; 6-2,R128,193,9,5,82,125,66,82,27,43,5,7,21,93,125,4,1,85,148,55,85,36,63,10,15,21,91,148
2007-08-27 00:00:00.000,US Open NY; U.S.A. Grand Slams,HARD,3,Novak Djokovic,Robin Haase,Novak Djokovic,6-2; 6-1; 6-3,R128,96,5,1,40,66,33,40,17,26,1,1,12,50,66,6,4,62,97,37,62,11,35,11,17,12,48,97
2007-08-27 00:00:00.000,US Open NY; U.S.A. Grand Slams,HARD,3,Teymuraz Gabashvili,Fernando Gonzalez,Teymuraz Gabashvili,6-4; 6-1; 3-6; 5-7; 6-4,R128,173,16,10,84,144,70,84,24,60,5,9,24,94,144,10,7,84,134,60,84,25,50,5,11,24,85,134
2007-08-27 00:00:00.000,US Open NY; U.S.A. Grand Slams,HARD,3,Robby Ginepri,Olivier Rochus,Robby Ginepri,6-0; 6-3; 6-1,R128,104,10,3,57,84,44,57,11,27,3,3,11,55,84,0,6,60,83,31,60,7,23,5,12,11,38,83
2007-08-27 00:00:00.000,US Open NY; U.S.A. Grand Slams,HARD,3,Stanislas Wawrinka,Evgeny Korolev,Stanislas Wawrinka,4-6; 6-3; 4-6; 6-4; 7-5,R128,229,15,7,73,154,57,73,36,81,8,16,26,93,154,12,7,81,152,56,81,33,71,9,18,25,89,152
2007-08-27 00:00:00.000,US Open NY; U.S.A. Grand Slams,HARD,3,Marat Safin,Frank Dancevic,Marat Safin,7-5; 7-6(5); 7-6(7),R128,144,19,7,58,107,47,58,28,49,3,6,18,75,107,10,5,70,121,48,70,27,51,7,11,18,75,121
2007-08-27 00:00:00.000,US Open NY; U.S.A. Grand Slams,HARD,3,Juan Ignacio Chela,Michael McClune,Juan Ignacio Chela,6-2; 6-1; 7-6(0),R128,122,3,5,55,89,46,55,20,34,5,5,14,66,89,5,2,50,92,36,50,15,42,6,10,13,51,92
2007-08-27 00:00:00.000,US Open NY; U.S.A. Grand Slams,HARD,3,Wayne Odesnik,Danai Udomchoke,Wayne Odesnik,6-7(2); 6-3; 6-1; 3-6; 7-6(2),R128,225,11,6,95,155,69,95,33,60,6,10,24,102,155,5,10,110,182,74,110,34,72,10,17,25,108,182
2007-08-27 00:00:00.000,US Open NY; U.S.A. Grand Slams,HARD,3,Andrei Pavel,Dominik Meffert,Andrei Pavel,3-6; 6-3; 6-2; 7-5,R128,154,13,4,69,104,57,69,16,35,0,2,19,73,104,8,12,60,116,45,60,28,56,4,9,19,73,116
2007-08-27 00:00:00.000,US Open NY; U.S.A. Grand Slams,HARD,3,Ivan Ljubicic,Kristof Vliegen,Ivan Ljubicic,6-1; 7-6(1); 6-1,R128,113,28,5,52,90,43,52,23,38,4,4,14,66,90,6,4,53,89,34,53,16,36,6,10,12,50,89
2007-08-27 00:00:00.000,US Open NY; U.S.A. Grand Slams,HARD,3,David Ferrer,Florian Mayer,David Ferrer,6-3; 6-2; 6-3,R128,95,3,2,55,75,46,55,11,20,4,4,13,57,75,3,3,45,80,27,45,15,35,2,7,13,42,80
2007-08-27 00:00:00.000,US Open NY; U.S.A. Grand Slams,HARD,3,Florent Serra,Werner Eschauer,Florent Serra,6-7(3); 7-6(2); 6-4; 6-2,R128,174,7,3,75,136,60,75,38,61,8,9,21,98,136,23,11,77,144,60,77,30,67,4,8,21,90,144
2007-08-27 00:00:00.000,US Open NY; U.S.A. Grand Slams,HARD,3,Xavier Malisse,Kristian Pless,Xavier Malisse,6-4; 6-7(5); 6-3; 7-5,R128,158,21,4,86,151,60,86,39,65,8,10,22,99,151,10,3,86,120,65,86,15,34,3,8,21,80,120
2007-08-27 00:00:00.000,US Open NY; U.S.A. Grand Slams,HARD,3,David Nalbandian,Ivan Navarro,David Nalbandian,7-5; 7-6(4); 7-6(6),R128,184,12,6,66,114,60,66,26,48,5,6,18,86,114,16,10,66,127,54,66,30,61,8,10,18,84,127
2007-08-27 00:00:00.000,US Open NY; U.S.A. Grand Slams,HARD,3,Tim Henman,Dmitry Tursunov,Tim Henman,6-4; 3-6; 6-3; 6-4,R128,162,13,3,85,130,60,85,22,45,6,9,19,82,130,8,11,58,116,43,58,27,58,2,7,19,70,116
2007-08-27 00:00:00.000,US Open NY; U.S.A. Grand Slams,HARD,3,Jo-Wilfried Tsonga,Oscar Hernandez,Jo-Wilfried Tsonga,7-5; 6-1; 6-3,R128,93,6,2,46,67,39,46,16,21,2,3,14,55,67,2,1,57,85,34,57,12,28,7,13,14,46,85
2007-08-27 00:00:00.000,US Open NY; U.S.A. Grand Slams,HARD,3,Janko Tipsarevic,Ryan Sweeting,Janko Tipsarevic,5-7; 6-2; 6-4; 6-2,R128,157,13,9,60,119,50,60,26,59,5,8,19,76,119,17,8,67,116,53,67,15,49,6,13,19,68,116
2007-08-27 00:00:00.000,US Open NY; U.S.A. Grand Slams,HARD,3,Rafael Nadal,Alun Jones,Rafael Nadal,7-5; 3-6; 6-4; 6-1,R128,162,4,3,73,115,47,73,25,42,5,9,19,72,115,6,7,80,115,49,80,15,35,8,15,19,64,115
2007-08-27 00:00:00.000,US Open NY; U.S.A. Grand Slams,HARD,3,Roger Federer,Paul Capdeville,Roger Federer,6-1; 6-4; 6-4,R64,88,5,1,47,72,35,47,19,25,0,1,14,54,72,5,2,51,84,33,51,13,33,4,9,13,46,84
2007-08-27 00:00:00.000,US Open NY; U.S.A. Grand Slams,HARD,3,John Isner,Rik De Voest,John Isner,6-3; 6-3; 7-6(4),R64,114,14,1,65,94,47,65,21,29,4,5,15,68,94,7,2,62,96,38,62,19,34,7,11,15,57,96
2007-08-27 00:00:00.000,US Open NY; U.S.A. Grand Slams,HARD,3,Feliciano Lopez,Igor Andreev,Feliciano Lopez,6-7(3); 7-5; 3-6; 6-4; 7-6(5),R64,212,13,7,100,154,79,100,32,54,1,3,27,111,154,7,3,113,163,81,113,32,50,1,4,28,113,163
2007-08-27 00:00:00.000,US Open NY; U.S.A. Grand Slams,HARD,3,Donald Young,Richard Gasquet,Donald Young,W/O,R64,0,0,0,0,0,0,0,0,0,0,0,0,0,0,0,0,0,0,0,0,0,0,0,0,0,0,0
2007-08-27 00:00:00.000,US Open NY; U.S.A. Grand Slams,HARD,3,Tomas Berdych,Simone Bolelli,Tomas Berdych,7-5; 6-3; 6-3,R64,95,13,0,41,70,37,41,23,29,0,0,15,60,70,6,0,61,83,41,61,10,22,4,8,15,51,83
2007-08-27 00:00:00.000,US Open NY; U.S.A. Grand Slams,HARD,3,Fernando Verdasco,Gilles Simon,Fernando Verdasco,6-0; 6-4; 6-3,R64,93,5,3,51,66,35,51,11,15,3,5,12,46,66,2,2,42,83,20,42,18,41,9,17,13,38,83
2007-08-27 00:00:00.000,US Open NY; U.S.A. Grand Slams,HARD,3,Thomas Johansson,Arnaud Clement,Thomas Johansson,6-4; 7-6(4); 6-7(9); 7-6(1),R64,223,18,5,102,157,85,102,28,55,9,11,23,113,157,18,8,81,152,61,81,40,71,2,5,23,101,152
2007-08-27 00:00:00.000,US Open NY; U.S.A. Grand Slams,HARD,3,Andy Roddick,Jose Acasuso,Andy Roddick,4-6; 6-1; 6-2 RET,R64,92,12,1,41,62,35,41,14,21,0,1,13,49,62,5,3,39,74,28,39,14,35,4,8,12,42,74
2007-08-27 00:00:00.000,US Open NY; U.S.A. Grand Slams,HARD,3,Nikolay Davydenko,Nicolas Kiefer,Nikolay Davydenko,6-2; 6-2; 6-2,R64,104,5,3,53,64,42,53,7,11,2,2,12,49,64,6,4,40,76,25,40,13,36,6,12,12,38,76
2007-08-27 00:00:00.000,US Open NY; U.S.A. Grand Slams,HARD,3,Nicolas Almagro,Luis Horna,Nicolas Almagro,6-4; 6-2; 2-1 RET,R64,76,11,1,30,58,25,30,18,28,4,4,10,43,58,3,4,37,62,23,37,12,25,1,5,11,35,62
2007-08-27 00:00:00.000,US Open NY; U.S.A. Grand Slams,HARD,3,Andy Murray,Jonas Bjorkman,Andy Murray,5-7; 6-3; 6-1; 4-6; 6-1,R64,215,17,7,81,151,57,81,34,70,11,16,22,91,151,7,5,107,177,64,107,29,70,9,19,23,93,177
2007-08-27 00:00:00.000,US Open NY; U.S.A. Grand Slams,HARD,3,Hyung-Taik Lee,Guillermo Canas,Hyung-Taik Lee,7-5; 7-5; 6-3,R64,142,3,3,62,99,46,62,19,37,3,6,17,65,99,16,6,47,100,36,47,21,53,6,12,16,57,100
2007-08-27 00:00:00.000,US Open NY; U.S.A. Grand Slams,HARD,3,Tommy Haas,Philipp Petzschner,Tommy Haas,4-6; 6-3; 6-2; 7-5,R64,154,8,4,83,131,62,83,24,48,11,14,20,86,131,12,5,57,116,41,57,27,59,5,11,19,68,116
2007-08-27 00:00:00.000,US Open NY; U.S.A. Grand Slams,HARD,3,Sebastien Grosjean,Max Mirnyi,Sebastien Grosjean,6-4; 6-7(6); 6-4; 6-3,R64,186,13,2,70,120,62,70,27,50,1,2,21,89,120,14,15,68,136,51,68,34,68,3,7,20,85,136
2007-08-27 00:00:00.000,US Open NY; U.S.A. Grand Slams,HARD,3,Stefan Koubek,Michael Llodra,Stefan Koubek,6-1; 6-3; 6-3,R64,83,8,2,47,74,37,47,17,27,5,6,13,54,74,4,2,46,72,22,46,15,26,2,8,12,37,72
2007-08-27 00:00:00.000,US Open NY; U.S.A. Grand Slams,HARD,3,James Blake,Fabrice Santoro,James Blake,6-4; 3-6; 6-2; 4-6; 6-4,R64,202,7,8,73,149,52,73,36,76,10,17,23,88,149,4,2,93,145,61,93,23,52,13,22,24,84,145
2007-08-27 00:00:00.000,US Open NY; U.S.A. Grand Slams,HARD,3,Tommy Robredo,Mardy Fish,Tommy Robredo,6-4; 3-6; 6-4; 6-7(7); 6-4,R64,207,2,2,115,152,79,115,23,37,4,7,25,102,152,21,4,84,155,64,84,41,71,5,10,26,105,155
2007-08-27 00:00:00.000,US Open NY; U.S.A. Grand Slams,HARD,3,Ernests Gulbis,Michael Berrer,Ernests Gulbis,7-6(4); 6-2; 6-1,R64,106,9,3,52,84,40,52,19,32,3,5,14,59,84,4,1,53,85,32,53,16,32,4,10,13,48,85
2007-08-27 00:00:00.000,US Open NY; U.S.A. Grand Slams,HARD,3,Carlos Moya,Igor Kunitsyn,Carlos Moya,6-4; 6-4; 7-5,R64,127,10,2,64,103,46,64,22,39,9,11,16,68,103,1,4,53,95,34,53,19,42,1,6,16,53,95
2007-08-27 00:00:00.000,US Open NY; U.S.A. Grand Slams,HARD,3,Philipp Kohlschreiber,Mikhail Youzhny,Philipp Kohlschreiber,3-6; 6-4; 6-3; 6-3,R64,176,5,7,63,125,48,63,34,62,10,11,18,82,125,6,4,71,120,49,71,22,49,4,8,19,71,120
2007-08-27 00:00:00.000,US Open NY; U.S.A. Grand Slams,HARD,3,Agustin Calleri,Lleyton Hewitt,Agustin Calleri,4-6; 6-4; 6-4; 6-2,R64,161,13,3,73,126,57,73,27,53,11,14,19,84,126,10,4,68,114,48,68,18,46,5,11,19,66,114
2007-08-27 00:00:00.000,US Open NY; U.S.A. Grand Slams,HARD,3,Juan Monaco,Dudi Sela,Juan Monaco,6-4; 6-0; 6-7(1); 6-4,R64,151,6,6,80,133,49,80,33,53,9,12,19,82,133,3,5,72,116,44,72,19,44,5,13,19,63,116
2007-08-27 00:00:00.000,US Open NY; U.S.A. Grand Slams,HARD,3,Juan Martin Del Potro,Jurgen Melzer,Juan Martin Del Potro,6-3; 6-1; 6-4,R64,95,11,6,42,70,31,42,15,28,0,3,13,46,70,5,3,61,88,32,61,9,27,5,13,13,41,88
2007-08-27 00:00:00.000,US Open NY; U.S.A. Grand Slams,HARD,3,Novak Djokovic,Radek Stepanek,Novak Djokovic,6-7(4); 7-6(5); 5-7; 7-5; 7-6(2),R64,281,18,4,97,175,77,97,49,78,4,7,30,126,175,12,2,113,181,88,113,34,68,1,4,30,122,181
2007-08-27 00:00:00.000,US Open NY; U.S.A. Grand Slams,HARD,3,Robby Ginepri,Teymuraz Gabashvili,Robby Ginepri,6-2; 6-3; 6-1,R64,75,8,0,46,57,35,46,7,11,0,2,12,42,57,6,5,38,67,22,38,9,29,4,12,12,31,67
2007-08-27 00:00:00.000,US Open NY; U.S.A. Grand Slams,HARD,3,Stanislas Wawrinka,Marat Safin,Stanislas Wawrinka,6-3; 6-3; 6-3,R64,116,13,0,44,82,35,44,28,38,4,4,14,63,82,5,6,53,96,36,53,17,43,6,10,13,53,96
2007-08-27 00:00:00.000,US Open NY; U.S.A. Grand Slams,HARD,3,Juan Ignacio Chela,Wayne Odesnik,Juan Ignacio Chela,6-3; 6-1; 7-5,R64,111,3,1,42,80,34,42,22,38,0,1,14,56,80,9,6,54,89,34,54,14,35,8,14,14,48,89
2007-08-27 00:00:00.000,US Open NY; U.S.A. Grand Slams,HARD,3,Ivan Ljubicic,Andrei Pavel,Ivan Ljubicic,6-3; 6-4; 7-6(6),R64,148,18,3,50,99,46,50,27,49,0,0,16,73,99,8,7,69,108,49,69,18,39,8,10,15,67,108
2007-08-27 00:00:00.000,US Open NY; U.S.A. Grand Slams,HARD,3,David Ferrer,Florent Serra,David Ferrer,4-6; 6-3; 6-3; 6-2,R64,154,9,2,76,118,49,76,23,42,7,11,18,72,118,4,6,61,121,38,61,28,60,7,15,18,66,121
2007-08-27 00:00:00.000,US Open NY; U.S.A. Grand Slams,HARD,3,David Nalbandian,Xavier Malisse,David Nalbandian,6-4; 6-4; 6-2,R64,109,7,2,39,73,32,39,22,34,1,2,14,54,73,5,4,50,93,36,50,16,43,2,7,14,52,93
2007-08-27 00:00:00.000,US Open NY; U.S.A. Grand Slams,HARD,3,Jo-Wilfried Tsonga,Tim Henman,Jo-Wilfried Tsonga,7-6(2); 2-6; 7-5; 6-4,R64,157,10,1,85,119,67,85,17,34,1,4,21,84,119,5,5,91,131,65,91,19,40,7,10,21,84,131
2007-08-27 00:00:00.000,US Open NY; U.S.A. Grand Slams,HARD,3,Rafael Nadal,Janko Tipsarevic,Rafael Nadal,6-2; 6-3; 3-2 RET,R64,97,5,1,40,58,27,40,15,18,1,2,11,42,58,11,3,40,68,29,40,7,28,6,11,11,36,68
2007-08-27 00:00:00.000,US Open NY; U.S.A. Grand Slams,HARD,3,Roger Federer,John Isner,Roger Federer,6-7(4); 6-2; 6-4; 6-2,R32,135,10,1,71,107,57,71,26,36,1,1,19,83,107,17,5,88,121,60,88,15,33,4,9,19,75,121
2007-08-27 00:00:00.000,US Open NY; U.S.A. Grand Slams,HARD,3,Feliciano Lopez,Donald Young,Feliciano Lopez,3-6; 6-3; 7-6(5); 7-5,R32,159,20,2,80,130,64,80,23,50,7,9,21,87,130,10,5,76,124,55,76,26,48,3,6,21,81,124
2007-08-27 00:00:00.000,US Open NY; U.S.A. Grand Slams,HARD,3,Tomas Berdych,Fernando Verdasco,Tomas Berdych,7-6(2); 6-1; 7-6(3),R32,137,10,4,53,99,45,53,26,46,6,7,15,71,99,3,4,64,101,42,64,18,37,2,6,16,60,101
2007-08-27 00:00:00.000,US Open NY; U.S.A. Grand Slams,HARD,3,Andy Roddick,Thomas Johansson,Andy Roddick,6-3; 6-2; 6-0,R32,82,19,0,44,65,36,44,13,21,2,2,12,49,65,5,4,48,76,29,48,10,28,4,10,11,39,76
2007-08-27 00:00:00.000,US Open NY; U.S.A. Grand Slams,HARD,3,Nikolay Davydenko,Nicolas Almagro,Nikolay Davydenko,7-5; 6-0; 7-5,R32,146,3,4,67,90,48,67,12,23,1,3,15,60,90,8,3,67,115,42,67,18,48,15,22,15,60,115
2007-08-27 00:00:00.000,US Open NY; U.S.A. Grand Slams,HARD,3,Hyung-Taik Lee,Andy Murray,Hyung-Taik Lee,6-3; 6-3; 2-6; 7-5,R32,163,5,3,75,117,55,75,20,42,3,7,19,75,117,15,8,75,141,45,75,35,66,10,16,19,80,141
2007-08-27 00:00:00.000,US Open NY; U.S.A. Grand Slams,HARD,3,Tommy Haas,Sebastien Grosjean,Tommy Haas,6-2; 6-4; 3-6; 4-6; 6-3,R32,194,6,8,73,127,59,73,29,54,2,5,23,88,127,15,7,87,163,66,87,32,76,20,25,23,98,163
2007-08-27 00:00:00.000,US Open NY; U.S.A. Grand Slams,HARD,3,James Blake,Stefan Koubek,James Blake,6-4; 3-6; 7-6(5); 6-1,R32,157,6,6,62,122,41,62,26,60,8,15,18,67,122,6,5,88,137,55,88,16,49,8,18,20,71,137
2007-08-27 00:00:00.000,US Open NY; U.S.A. Grand Slams,HARD,3,Ernests Gulbis,Tommy Robredo,Ernests Gulbis,6-1; 6-3; 6-2,R32,89,5,0,46,66,37,46,13,20,3,3,12,50,66,1,2,55,75,24,55,13,20,4,10,12,37,75
2007-08-27 00:00:00.000,US Open NY; U.S.A. Grand Slams,HARD,3,Carlos Moya,Philipp Kohlschreiber,Carlos Moya,4-6; 7-5; 7-6(5); 4-6; 6-4,R32,241,20,7,124,199,83,124,44,75,15,19,27,127,199,8,5,113,166,84,113,27,53,5,9,27,111,166
2007-08-27 00:00:00.000,US Open NY; U.S.A. Grand Slams,HARD,3,Juan Monaco,Agustin Calleri,Juan Monaco,7-6(5); 6-2; 6-4,R32,113,3,0,62,89,44,62,18,27,2,4,15,62,89,7,5,69,103,40,69,19,34,3,8,15,59,103
2007-08-27 00:00:00.000,US Open NY; U.S.A. Grand Slams,HARD,3,Novak Djokovic,Juan Martin Del Potro,Novak Djokovic,6-1; 6-3; 6-4,R32,102,7,2,54,72,43,54,9,18,5,6,13,52,72,1,1,49,71,24,49,12,22,0,6,13,36,71
2007-08-27 00:00:00.000,US Open NY; U.S.A. Grand Slams,HARD,3,Stanislas Wawrinka,Robby Ginepri,Stanislas Wawrinka,5-7; 6-4; 4-6; 6-4; 6-3,R32,217,16,4,85,150,69,85,30,65,4,7,25,99,150,2,0,101,161,65,101,36,60,12,17,26,101,161
2007-08-27 00:00:00.000,US Open NY; U.S.A. Grand Slams,HARD,3,Juan Ignacio Chela,Ivan Ljubicic,Juan Ignacio Chela,6-4; 6-7(5); 2-6; 6-3; 6-3,R32,221,6,5,90,156,65,90,34,66,7,12,24,99,156,25,4,90,156,70,90,26,66,7,14,24,96,156
2007-08-27 00:00:00.000,US Open NY; U.S.A. Grand Slams,HARD,3,David Ferrer,David Nalbandian,David Ferrer,6-3; 3-6; 4-6; 7-6(5); 7-5,R32,236,2,4,89,142,60,89,29,53,3,10,26,89,142,12,8,109,185,74,109,35,76,10,17,26,109,185
2007-08-27 00:00:00.000,US Open NY; U.S.A. Grand Slams,HARD,3,Rafael Nadal,Jo-Wilfried Tsonga,Rafael Nadal,7-6(3); 6-2; 6-1,R32,123,2,3,62,84,50,62,15,22,2,2,14,65,84,7,1,55,77,36,55,11,22,2,6,13,47,77
2007-08-27 00:00:00.000,US Open NY; U.S.A. Grand Slams,HARD,3,Roger Federer,Feliciano Lopez,Roger Federer,3-6; 6-4; 6-1; 6-4,R16,118,11,0,62,85,50,62,20,23,3,4,18,70,85,13,7,64,114,49,64,21,50,8,12,18,70,114
2007-08-27 00:00:00.000,US Open NY; U.S.A. Grand Slams,HARD,3,Andy Roddick,Tomas Berdych,Andy Roddick,7-6(6); 2-0 RET,R16,60,10,1,31,42,23,31,6,11,0,2,7,29,42,2,5,28,56,20,28,10,28,2,5,7,30,56
2007-08-27 00:00:00.000,US Open NY; U.S.A. Grand Slams,HARD,3,Nikolay Davydenko,Hyung-Taik Lee,Nikolay Davydenko,6-1; 6-3; 6-4,R16,123,8,2,51,77,39,51,17,26,2,2,13,56,77,5,1,67,101,40,67,15,34,15,20,13,55,101
2007-08-27 00:00:00.000,US Open NY; U.S.A. Grand Slams,HARD,3,Tommy Haas,James Blake,Tommy Haas,4-6; 6-4; 3-6; 6-0; 7-6(4),R16,196,18,4,106,169,70,106,32,63,12,18,24,102,169,19,5,76,138,53,76,29,62,4,11,23,82,138
2007-08-27 00:00:00.000,US Open NY; U.S.A. Grand Slams,HARD,3,Carlos Moya,Ernests Gulbis,Carlos Moya,7-5; 6-2; 6-7(5); 6-4,R16,143,7,2,72,111,60,72,27,39,0,1,21,87,111,13,1,101,143,68,101,23,42,11,16,21,91,143
2007-08-27 00:00:00.000,US Open NY; U.S.A. Grand Slams,HARD,3,Novak Djokovic,Juan Monaco,Novak Djokovic,7-5; 7-6(2); 6-7(6); 6-1,R16,231,14,6,87,152,69,87,29,65,5,8,22,98,152,3,6,87,145,57,87,28,58,8,14,21,85,145
2007-08-27 00:00:00.000,US Open NY; U.S.A. Grand Slams,HARD,3,Juan Ignacio Chela,Stanislas Wawrinka,Juan Ignacio Chela,4-6; 6-2; 7-6(6); 1-6; 6-4,R16,218,2,3,78,142,51,78,31,64,4,12,24,82,142,9,4,70,145,48,70,37,75,1,8,23,85,145
2007-08-27 00:00:00.000,US Open NY; U.S.A. Grand Slams,HARD,3,David Ferrer,Rafael Nadal,David Ferrer,6-7(3); 6-4; 7-6(4); 6-2,R16,206,5,2,83,124,58,83,25,41,2,6,21,83,124,2,7,97,139,63,97,18,42,7,14,21,81,139
2007-08-27 00:00:00.000,US Open NY; U.S.A. Grand Slams,HARD,3,Roger Federer,Andy Roddick,Roger Federer,7-6(5); 7-6(4); 6-2,Q,121,15,0,62,101,50,62,28,39,1,1,16,78,101,14,0,74,103,57,74,14,29,2,4,16,71,103
2007-08-27 00:00:00.000,US Open NY; U.S.A. Grand Slams,HARD,3,Nikolay Davydenko,Tommy Haas,Nikolay Davydenko,6-3; 6-3; 6-4,Q,141,7,1,59,82,42,59,9,23,5,9,14,51,82,10,2,70,113,44,70,12,43,9,17,14,56,113
2007-08-27 00:00:00.000,US Open NY; U.S.A. Grand Slams,HARD,3,Novak Djokovic,Carlos Moya,Novak Djokovic,6-4; 7-6(7); 6-1,Q,138,9,2,57,83,45,57,16,26,2,3,14,61,83,2,7,65,114,45,65,19,49,12,17,15,64,114
2007-08-27 00:00:00.000,US Open NY; U.S.A. Grand Slams,HARD,3,David Ferrer,Juan Ignacio Chela,David Ferrer,6-2; 6-3; 7-5,Q,123,3,0,53,80,41,53,18,27,1,2,15,59,80,2,1,61,96,36,61,21,35,11,16,14,57,96
2007-08-27 00:00:00.000,US Open NY; U.S.A. Grand Slams,HARD,3,Roger Federer,Nikolay Davydenko,Roger Federer,7-5; 6-1; 7-5,S,138,10,3,59,108,39,59,23,49,9,14,16,62,108,1,8,68,102,37,68,11,34,16,25,15,48,102
2007-08-27 00:00:00.000,US Open NY; U.S.A. Grand Slams,HARD,3,Novak Djokovic,David Ferrer,Novak Djokovic,6-4; 6-4; 6-3,S,132,9,3,60,91,41,60,19,31,1,3,14,60,91,5,1,71,97,43,71,10,26,5,11,15,53,97
2007-08-27 00:00:00.000,US Open NY; U.S.A. Grand Slams,HARD,3,Roger Federer,Novak Djokovic,Roger Federer,7-6(4); 7-6(2); 6-4,F,144,11,4,66,106,52,66,25,40,7,9,17,77,106,5,7,64,116,45,64,29,52,2,5,17,74,116
2007-09-10 00:00:00.000,Beijing China ATP World Tour,HARD,2,Nikolay Davydenko,Zack Fleishman,Nikolay Davydenko,6-3; 6-3,R32,67,1,5,36,52,28,36,8,16,1,2,9,36,52,1,1,30,53,17,30,11,23,0,4,9,28,53
2007-09-10 00:00:00.000,Beijing China ATP World Tour,HARD,2,Marin Cilic,Rainer Schuettler,Marin Cilic,6-7(5); 6-3; 6-3,R32,117,10,6,44,86,35,44,27,42,1,3,15,62,86,1,3,48,86,35,48,17,38,0,5,15,52,86
2007-09-10 00:00:00.000,Beijing China ATP World Tour,HARD,2,Nicolas Kiefer,Dudi Sela,Nicolas Kiefer,6-2; 6-3,R32,75,4,1,32,59,26,32,15,27,3,3,9,41,59,2,5,27,49,15,27,11,22,2,5,8,26,49
2007-09-10 00:00:00.000,Beijing China ATP World Tour,HARD,2,Jo-Wilfried Tsonga,Rohan Bopanna,Jo-Wilfried Tsonga,6-3; 1-0 RET,R32,52,1,1,10,26,10,10,11,16,2,2,5,21,26,3,2,27,51,16,27,11,24,5,7,5,27,51
2007-09-10 00:00:00.000,Beijing China ATP World Tour,HARD,2,Tommy Robredo,Denis Gremelmayr,Tommy Robredo,6-2; 6-4,R32,80,5,0,33,51,23,33,16,18,2,2,9,39,51,0,1,47,72,30,47,12,25,3,6,9,42,72
2007-09-10 00:00:00.000,Beijing China ATP World Tour,HARD,2,Rik De Voest,Woong-Sun Jun,Rik De Voest,6-4; 7-6(4),R32,93,2,3,41,75,33,41,18,34,3,4,11,51,75,1,1,42,68,32,42,12,26,2,4,11,44,68
2007-09-10 00:00:00.000,Beijing China ATP World Tour,HARD,2,Kevin Kim,Xin-Yuan Yu,Kevin Kim,6-3; 7-5,R32,90,4,2,43,63,33,43,9,20,2,3,10,42,63,4,7,38,74,28,38,13,36,7,11,11,41,74
2007-09-10 00:00:00.000,Beijing China ATP World Tour,HARD,2,Igor Kunitsyn,Peng Sun,Igor Kunitsyn,6-2; 7-6(7),R32,97,5,0,34,64,28,34,17,30,3,4,10,45,64,1,2,33,63,22,33,15,30,3,6,10,37,63
2007-09-10 00:00:00.000,Beijing China ATP World Tour,HARD,2,Marcos Baghdatis,Shao-Xuan Zeng,Marcos Baghdatis,7-6(3); 7-5,R32,109,3,4,36,76,26,36,21,40,6,10,12,47,76,1,4,47,89,26,47,21,42,8,13,12,47,89
2007-09-10 00:00:00.000,Beijing China ATP World Tour,HARD,2,Boris Pashanski,Yen-Hsun Lu,Boris Pashanski,6-7(4); 6-2; 7-6(6),R32,165,8,5,60,107,43,60,23,47,4,8,16,66,107,10,5,66,117,46,66,20,51,9,15,16,66,117
2007-09-10 00:00:00.000,Beijing China ATP World Tour,HARD,2,Viktor Troicki,Teymuraz Gabashvili,Viktor Troicki,6-7(3); 6-3; 6-4,R32,125,7,8,53,82,39,53,10,29,0,5,15,49,82,1,6,41,100,22,41,30,59,3,11,16,52,100
2007-09-10 00:00:00.000,Beijing China ATP World Tour,HARD,2,Ivan Ljubicic,Kei Nishikori,Ivan Ljubicic,6-3; 6-4,R32,79,10,7,27,54,24,27,15,27,0,1,10,39,54,1,2,43,78,31,43,11,35,7,10,9,42,78
2007-09-10 00:00:00.000,Beijing China ATP World Tour,HARD,2,Hyung-Taik Lee,Adrian Garcia,Hyung-Taik Lee,6-4; 6-3,R32,82,2,1,30,53,23,30,15,23,0,1,10,38,53,5,3,31,66,19,31,18,35,8,11,9,37,66
2007-09-10 00:00:00.000,Beijing China ATP World Tour,HARD,2,Bjorn Phau,Davide Sanguinetti,Bjorn Phau,5-7; 7-6(9); 6-2,R32,149,5,10,48,115,34,48,35,67,4,8,16,69,115,5,7,68,123,48,68,20,55,10,15,16,68,123
2007-09-10 00:00:00.000,Beijing China ATP World Tour,HARD,2,Paul Capdeville,Danai Udomchoke,Paul Capdeville,6-2; 6-2,R32,58,5,3,34,58,24,34,15,24,2,2,8,39,58,0,5,21,44,14,21,8,23,2,6,8,22,44
2007-09-10 00:00:00.000,Beijing China ATP World Tour,HARD,2,Fernando Gonzalez,Alexander Peya,Fernando Gonzalez,3-6; 6-3; 7-5,R32,112,1,2,62,89,48,62,15,27,4,6,15,63,89,5,4,69,90,49,69,9,21,6,9,15,58,90
2007-09-10 00:00:00.000,Beijing China ATP World Tour,HARD,2,Marin Cilic,Nikolay Davydenko,Marin Cilic,6-3; 6-4,R16,74,3,2,33,58,27,33,14,25,1,2,10,41,58,1,2,35,49,22,35,7,14,1,4,9,29,49
2007-09-10 00:00:00.000,Beijing China ATP World Tour,HARD,2,Nicolas Kiefer,Jo-Wilfried Tsonga,Nicolas Kiefer,6-3; 6-4,R16,77,5,1,29,55,27,29,16,26,1,1,10,43,55,3,3,30,55,22,30,12,25,1,3,9,34,55
2007-09-10 00:00:00.000,Beijing China ATP World Tour,HARD,2,Tommy Robredo,Rik De Voest,Tommy Robredo,6-2; 6-3,R16,85,2,1,34,50,23,34,9,16,4,5,8,32,50,1,2,45,72,25,45,10,27,7,12,9,35,72
2007-09-10 00:00:00.000,Beijing China ATP World Tour,HARD,2,Igor Kunitsyn,Kevin Kim,Igor Kunitsyn,7-6(4); 6-4,R16,100,3,3,32,72,20,32,25,40,7,9,11,45,72,1,0,37,72,22,37,17,35,1,4,11,39,72
2007-09-10 00:00:00.000,Beijing China ATP World Tour,HARD,2,Marcos Baghdatis,Boris Pashanski,Marcos Baghdatis,6-4; 6-4,R16,77,7,5,25,66,20,25,20,41,1,3,10,40,66,1,2,35,53,20,35,10,18,1,5,10,30,53
2007-09-10 00:00:00.000,Beijing China ATP World Tour,HARD,2,Ivan Ljubicic,Viktor Troicki,Ivan Ljubicic,6-1; 6-1,R16,65,0,1,21,45,18,21,15,24,3,3,7,33,45,1,2,23,47,11,23,10,24,2,7,7,21,47
2007-09-10 00:00:00.000,Beijing China ATP World Tour,HARD,2,Hyung-Taik Lee,Bjorn Phau,Hyung-Taik Lee,7-6(4); 6-1,R16,80,5,4,39,65,31,39,15,26,6,6,9,46,65,5,4,39,68,26,39,11,29,8,11,10,37,68
2007-09-10 00:00:00.000,Beijing China ATP World Tour,HARD,2,Fernando Gonzalez,Paul Capdeville,Fernando Gonzalez,6-1; 6-2,R16,51,5,0,25,39,18,25,11,14,1,1,7,29,39,1,2,30,45,17,30,2,15,2,7,8,19,45
2007-09-10 00:00:00.000,Beijing China ATP World Tour,HARD,2,Nicolas Kiefer,Marin Cilic,Nicolas Kiefer,6-3; 7-5,Q,96,6,2,39,68,30,39,16,29,5,7,11,46,68,2,4,33,71,20,33,18,38,12,16,10,38,71
2007-09-10 00:00:00.000,Beijing China ATP World Tour,HARD,2,Tommy Robredo,Igor Kunitsyn,Tommy Robredo,6-3; 6-1,Q,65,2,1,29,43,21,29,13,14,0,0,8,34,43,0,3,32,50,17,32,8,18,2,6,8,25,50
2007-09-10 00:00:00.000,Beijing China ATP World Tour,HARD,2,Ivan Ljubicic,Marcos Baghdatis,Ivan Ljubicic,6-4; 4-6; 7-6(5),Q,148,6,2,48,96,37,48,25,48,5,9,16,62,96,7,4,47,94,40,47,20,47,5,9,16,60,94
2007-09-10 00:00:00.000,Beijing China ATP World Tour,HARD,2,Fernando Gonzalez,Hyung-Taik Lee,Fernando Gonzalez,7-5; 6-7(5); 6-4,Q,143,8,4,68,106,48,68,18,38,4,8,17,66,106,4,6,62,107,41,62,19,45,6,12,17,60,107
2007-09-10 00:00:00.000,Beijing China ATP World Tour,HARD,2,Tommy Robredo,Nicolas Kiefer,Tommy Robredo,7-6(5); 7-5,S,138,1,0,61,83,42,61,14,22,6,8,12,56,83,5,2,42,74,30,42,15,32,1,4,12,45,74
2007-09-10 00:00:00.000,Beijing China ATP World Tour,HARD,2,Fernando Gonzalez,Ivan Ljubicic,Fernando Gonzalez,2-6; 6-3; 6-4,S,117,7,3,59,80,38,59,8,21,4,8,13,46,80,6,2,46,77,29,46,16,31,4,9,14,45,77
2007-09-10 00:00:00.000,Beijing China ATP World Tour,HARD,2,Fernando Gonzalez,Tommy Robredo,Fernando Gonzalez,6-1; 3-6; 6-1,F,106,1,1,40,63,33,40,12,23,1,3,12,45,63,2,2,61,83,35,61,8,22,9,14,11,43,83
2007-09-10 00:00:00.000,Bucharest Romania ATP World Tour,CLAY,2,Simone Bolelli,Nicolas Almagro,Simone Bolelli,4-6; 5-1 RET,R32,62,3,1,33,46,25,33,8,13,3,4,8,33,46,4,1,39,50,25,39,6,11,5,7,8,31,50
2007-09-10 00:00:00.000,Bucharest Romania ATP World Tour,CLAY,2,Yuri Schukin,Diego Hartfield,Yuri Schukin,7-6(5); 5-7; 6-2,R32,170,6,0,63,103,44,63,22,40,6,10,16,66,103,11,8,54,108,37,54,23,54,7,12,16,60,108
2007-09-10 00:00:00.000,Bucharest Romania ATP World Tour,CLAY,2,Ivan Navarro,Chris Guccione,Ivan Navarro,6-4; 7-6(4),R32,82,7,0,55,66,39,55,6,11,2,4,11,45,66,5,1,42,62,27,42,12,20,4,7,11,39,62
2007-09-10 00:00:00.000,Bucharest Romania ATP World Tour,CLAY,2,Carlos Berlocq,Fabrice Santoro,Carlos Berlocq,7-6(5); 6-1,R32,94,0,1,48,58,31,48,6,10,1,4,9,37,58,0,2,31,66,20,31,12,35,5,11,10,32,66
2007-09-10 00:00:00.000,Bucharest Romania ATP World Tour,CLAY,2,Andreas Seppi,Jurgen Melzer,Andreas Seppi,4-6; 7-5; 6-4,R32,150,3,8,66,114,39,66,23,48,10,16,16,62,114,3,6,67,102,41,67,12,35,5,12,16,53,102
2007-09-10 00:00:00.000,Bucharest Romania ATP World Tour,CLAY,2,Hugo Armando,Sergio Roitman,Hugo Armando,6-0; 6-1,R32,48,0,0,23,34,21,23,7,11,0,0,7,28,34,0,0,22,39,7,22,7,17,1,6,6,14,39
2007-09-10 00:00:00.000,Bucharest Romania ATP World Tour,CLAY,2,Evgeny Korolev,Florent Serra,Evgeny Korolev,4-6; 6-5 RET,R32,97,1,4,23,61,15,23,23,38,2,5,11,38,61,1,1,37,69,21,37,20,32,3,5,10,41,69
2007-09-10 00:00:00.000,Bucharest Romania ATP World Tour,CLAY,2,Gilles Simon,Guillermo Garcia-Lopez,Gilles Simon,7-6(3); 6-4,R32,121,0,1,46,81,31,46,17,35,7,11,11,48,81,0,2,48,70,27,48,8,22,4,9,11,35,70
2007-09-10 00:00:00.000,Bucharest Romania ATP World Tour,CLAY,2,Albert Montanes,Nicolas Devilder,Albert Montanes,6-3; 6-1,R32,62,3,4,24,49,19,24,14,25,2,3,8,33,49,4,2,22,49,12,22,8,27,3,8,8,20,49
2007-09-10 00:00:00.000,Bucharest Romania ATP World Tour,CLAY,2,Victor Hanescu,Florian Mayer,Victor Hanescu,7-6(1); 7-6(3),R32,97,3,0,46,76,33,46,20,30,2,4,12,53,76,4,5,47,78,34,47,16,31,1,3,12,50,78
2007-09-10 00:00:00.000,Bucharest Romania ATP World Tour,CLAY,2,Andrei Pavel,Oscar Hernandez,Andrei Pavel,7-5; 7-5,R32,106,3,2,40,67,30,40,16,27,1,3,12,46,67,2,3,46,72,31,46,12,26,5,9,12,43,72
2007-09-10 00:00:00.000,Bucharest Romania ATP World Tour,CLAY,2,Potito Starace,Kristof Vliegen,Potito Starace,3-6; 7-5; 6-2,R32,126,3,1,70,92,43,70,15,22,5,8,14,58,92,0,5,43,90,31,43,23,47,3,8,15,54,90
2007-09-10 00:00:00.000,Bucharest Romania ATP World Tour,CLAY,2,Igor Andreev,Peter Luczak,Igor Andreev,6-4; 3-6; 6-4,R32,128,9,0,58,80,40,58,16,22,2,4,14,56,80,4,1,59,99,45,59,17,40,7,10,15,62,99
2007-09-10 00:00:00.000,Bucharest Romania ATP World Tour,CLAY,2,Marc Gicquel,Catalin-Ionut Gard,Marc Gicquel,6-4; 6-4,R32,98,2,1,36,59,28,36,11,23,1,2,10,39,59,3,4,47,64,32,47,6,17,2,5,10,38,64
2007-09-10 00:00:00.000,Bucharest Romania ATP World Tour,CLAY,2,Martin Vassallo Arguello,Werner Eschauer,Martin Vassallo Arguello,6-4; 6-4,R32,95,4,0,32,51,25,32,12,19,0,1,10,37,51,2,0,25,64,20,25,17,39,2,5,10,37,64
2007-09-10 00:00:00.000,Bucharest Romania ATP World Tour,CLAY,2,Gael Monfils,Filippo Volandri,Gael Monfils,6-3; 7-6(4),R32,104,3,7,33,69,25,33,14,36,1,5,11,39,69,0,2,53,74,25,53,13,21,4,9,10,38,74
2007-09-10 00:00:00.000,Bucharest Romania ATP World Tour,CLAY,2,Yuri Schukin,Simone Bolelli,Yuri Schukin,6-4; 6-3,R16,82,4,2,40,58,30,40,8,18,5,6,9,38,58,2,0,40,57,26,40,7,17,1,5,10,33,57
2007-09-10 00:00:00.000,Bucharest Romania ATP World Tour,CLAY,2,Carlos Berlocq,Ivan Navarro,Carlos Berlocq,7-5; 6-3,R16,116,0,1,39,55,32,39,10,16,1,2,11,42,55,1,2,38,65,25,38,14,27,4,7,10,39,65
2007-09-10 00:00:00.000,Bucharest Romania ATP World Tour,CLAY,2,Hugo Armando,Andreas Seppi,Hugo Armando,6-0; 6-3,R16,67,1,1,29,45,24,29,10,16,1,1,8,34,45,0,4,24,49,11,24,10,25,8,12,7,21,49
2007-09-10 00:00:00.000,Bucharest Romania ATP World Tour,CLAY,2,Gilles Simon,Evgeny Korolev,Gilles Simon,6-4; 6-2,R16,85,1,2,37,64,26,37,14,27,4,6,9,40,64,0,2,28,51,20,28,6,23,2,7,9,26,51
2007-09-10 00:00:00.000,Bucharest Romania ATP World Tour,CLAY,2,Victor Hanescu,Albert Montanes,Victor Hanescu,6-3; 6-2,R16,72,5,0,46,60,35,46,7,14,3,3,9,42,60,5,2,29,46,18,29,8,17,2,5,8,26,46
2007-09-10 00:00:00.000,Bucharest Romania ATP World Tour,CLAY,2,Potito Starace,Andrei Pavel,Potito Starace,6-3; 6-3,R16,78,3,0,41,55,28,41,7,14,2,3,9,35,55,1,1,35,54,25,35,4,19,7,11,9,29,54
2007-09-10 00:00:00.000,Bucharest Romania ATP World Tour,CLAY,2,Marc Gicquel,Igor Andreev,Marc Gicquel,6-4; 6-3,R16,79,1,2,21,55,18,21,15,34,4,6,9,33,55,1,3,47,64,25,47,8,17,3,8,10,33,64
2007-09-10 00:00:00.000,Bucharest Romania ATP World Tour,CLAY,2,Gael Monfils,Martin Vassallo Arguello,Gael Monfils,6-4; 6-4,R16,90,1,0,37,60,24,37,16,23,2,3,10,40,60,1,1,38,54,26,38,9,16,4,7,10,35,54
2007-09-10 00:00:00.000,Bucharest Romania ATP World Tour,CLAY,2,Carlos Berlocq,Yuri Schukin,Carlos Berlocq,7-5; 6-3,Q,94,4,0,50,65,35,50,13,15,3,3,11,48,65,1,1,34,56,22,34,14,22,1,3,10,36,56
2007-09-10 00:00:00.000,Bucharest Romania ATP World Tour,CLAY,2,Gilles Simon,Hugo Armando,Gilles Simon,6-4; 6-2,Q,80,3,0,41,63,31,41,11,22,4,5,9,42,63,0,1,43,63,25,43,8,20,4,8,9,33,63
2007-09-10 00:00:00.000,Bucharest Romania ATP World Tour,CLAY,2,Victor Hanescu,Potito Starace,Victor Hanescu,7-6(5); 7-5,Q,97,3,0,44,62,39,44,13,18,0,0,12,52,62,3,0,63,84,45,63,12,21,5,6,12,57,84
2007-09-10 00:00:00.000,Bucharest Romania ATP World Tour,CLAY,2,Gael Monfils,Marc Gicquel,Gael Monfils,6-4; 6-2,Q,74,12,5,35,64,28,35,16,29,8,8,9,44,64,1,3,44,64,28,44,9,20,6,9,9,37,64
2007-09-10 00:00:00.000,Bucharest Romania ATP World Tour,CLAY,2,Gilles Simon,Carlos Berlocq,Gilles Simon,6-7(4); 6-2; 6-3,S,143,2,2,44,94,31,44,28,50,7,10,14,59,94,2,1,56,95,37,56,12,39,5,12,15,49,95
2007-09-10 00:00:00.000,Bucharest Romania ATP World Tour,CLAY,2,Victor Hanescu,Gael Monfils,Victor Hanescu,6-2; 6-3,S,66,3,0,30,39,24,30,8,9,0,0,8,32,39,2,2,33,57,21,33,10,24,4,8,9,31,57
2007-09-10 00:00:00.000,Bucharest Romania ATP World Tour,CLAY,2,Gilles Simon,Victor Hanescu,Gilles Simon,4-6; 6-3; 6-2,F,111,4,2,54,88,41,54,18,34,6,7,14,59,88,3,1,55,76,41,55,8,21,2,5,13,49,76
2007-09-24 00:00:00.000,Bangkok Thailand ATP World Tour,HARD,2,Igor Kunitsyn,George Bastl,Igor Kunitsyn,6-3; 6-4,R32,96,1,2,34,55,28,34,13,21,2,2,9,41,55,8,0,53,68,34,53,5,15,3,6,10,39,68
2007-09-24 00:00:00.000,Bangkok Thailand ATP World Tour,HARD,2,Dominik Meffert,Amer Delic,Dominik Meffert,7-5; 6-1,R32,73,7,4,41,56,36,41,6,15,0,0,10,42,56,7,2,45,66,32,45,5,21,2,5,9,37,66
2007-09-24 00:00:00.000,Bangkok Thailand ATP World Tour,HARD,2,Danai Udomchoke,Harel Levy,Danai Udomchoke,5-7; 7-6(4); 6-3,R32,138,2,3,75,109,52,75,16,34,4,8,17,68,109,10,2,59,104,42,59,19,45,4,8,16,61,104
2007-09-24 00:00:00.000,Bangkok Thailand ATP World Tour,HARD,2,Benjamin Becker,Carlos Moya,Benjamin Becker,7-6(5); 6-4,R32,85,8,1,45,75,36,45,19,30,2,2,11,55,75,7,1,40,63,31,40,14,23,0,1,11,45,63
2007-09-24 00:00:00.000,Bangkok Thailand ATP World Tour,HARD,2,Tomas Berdych,Kittipong Wachiramanowong,Tomas Berdych,6-3; 6-0,R32,50,5,0,32,43,26,32,8,11,1,1,8,34,43,1,1,28,40,15,28,5,12,1,5,7,20,40
2007-09-24 00:00:00.000,Bangkok Thailand ATP World Tour,HARD,2,Mischa Zverev,Michael Russell,Mischa Zverev,6-4; 3-6; 6-1,R32,108,10,5,55,85,39,55,16,30,11,14,13,55,85,0,1,60,82,32,60,13,22,3,8,13,45,82
2007-09-24 00:00:00.000,Bangkok Thailand ATP World Tour,HARD,2,Simon Stadler,Peerakiat Siriluethaiwattana,Simon Stadler,6-1; 6-2,R32,62,3,0,36,53,26,36,9,17,4,5,8,35,53,0,1,34,52,18,34,5,18,4,9,7,23,52
2007-09-24 00:00:00.000,Bangkok Thailand ATP World Tour,HARD,2,Ivo Karlovic,Feliciano Lopez,Ivo Karlovic,7-6(2); 6-3,R32,71,23,1,40,55,38,40,7,15,0,0,10,45,55,9,3,40,68,26,40,18,28,2,4,11,44,68
2007-09-24 00:00:00.000,Bangkok Thailand ATP World Tour,HARD,2,Fernando Verdasco,David Martin,Fernando Verdasco,6-2; 6-1,R32,76,6,0,32,37,21,32,4,5,2,3,7,25,37,2,6,38,69,22,38,9,31,9,15,8,31,69
2007-09-24 00:00:00.000,Bangkok Thailand ATP World Tour,HARD,2,Frank Dancevic,Juan Martin Del Potro,Frank Dancevic,6-4; 1-6; 7-6(4),R32,110,12,4,54,89,38,54,18,35,6,9,14,56,89,12,4,65,98,49,65,16,33,4,6,15,65,98
2007-09-24 00:00:00.000,Bangkok Thailand ATP World Tour,HARD,2,Nicolas Mahut,Zack Fleishman,Nicolas Mahut,7-5; 6-2,R32,71,4,2,26,50,20,26,17,24,1,2,10,37,50,8,3,35,66,26,35,9,31,4,8,10,35,66
2007-09-24 00:00:00.000,Bangkok Thailand ATP World Tour,HARD,2,Tommy Haas,Vincent Spadea,Tommy Haas,4-6; 6-4; 6-1,R32,101,7,4,52,90,37,52,23,38,9,11,13,60,90,3,4,48,71,32,48,10,23,0,5,14,42,71
2007-09-24 00:00:00.000,Bangkok Thailand ATP World Tour,HARD,2,Dmitry Tursunov,Werner Eschauer,Dmitry Tursunov,6-3; 3-6; 6-1,R32,87,10,5,49,73,38,49,14,24,0,1,13,52,73,12,2,50,75,35,50,10,25,3,6,12,45,75
2007-09-24 00:00:00.000,Bangkok Thailand ATP World Tour,HARD,2,Michael Llodra,Teymuraz Gabashvili,Michael Llodra,7-6(2); 7-5,R32,101,11,6,42,71,39,42,14,29,4,5,12,53,71,3,2,49,85,38,49,16,36,8,10,12,54,85
2007-09-24 00:00:00.000,Bangkok Thailand ATP World Tour,HARD,2,Nick Lindahl,Sam Querrey,Nick Lindahl,2-6; 6-4; 6-3,R32,83,4,1,50,76,34,50,17,26,0,2,13,51,76,8,1,45,77,34,45,15,32,1,4,14,49,77
2007-09-24 00:00:00.000,Bangkok Thailand ATP World Tour,HARD,2,Jimmy Wang,Phillip King,Jimmy Wang,6-3; 6-3,R32,76,3,1,35,56,25,35,9,21,3,5,9,34,56,1,4,32,55,21,32,6,23,4,9,9,27,55
2007-09-24 00:00:00.000,Bangkok Thailand ATP World Tour,HARD,2,Dominik Meffert,Igor Kunitsyn,Dominik Meffert,3-6; 7-6(6); 6-0,R16,127,4,1,51,81,42,51,13,30,5,7,13,55,81,6,4,45,98,30,45,28,53,5,9,14,58,98
2007-09-24 00:00:00.000,Bangkok Thailand ATP World Tour,HARD,2,Benjamin Becker,Danai Udomchoke,Benjamin Becker,6-2; 6-3,R16,70,13,1,29,56,27,29,12,27,3,3,9,39,56,4,2,35,55,21,35,9,20,2,5,8,30,55
2007-09-24 00:00:00.000,Bangkok Thailand ATP World Tour,HARD,2,Tomas Berdych,Mischa Zverev,Tomas Berdych,6-1; 6-4,R16,59,3,2,31,49,29,31,9,18,3,3,9,38,49,2,0,44,66,26,44,11,22,10,13,8,37,66
2007-09-24 00:00:00.000,Bangkok Thailand ATP World Tour,HARD,2,Ivo Karlovic,Simon Stadler,Ivo Karlovic,6-7(3); 7-6(4); 7-5,R16,139,21,1,84,116,68,84,19,32,5,5,18,87,116,6,1,83,112,65,83,18,29,5,6,18,83,112
2007-09-24 00:00:00.000,Bangkok Thailand ATP World Tour,HARD,2,Fernando Verdasco,Frank Dancevic,Fernando Verdasco,3-6; 6-3; 6-4,R16,105,2,2,61,79,43,61,10,18,4,7,14,53,79,6,0,58,91,39,58,13,33,4,8,14,52,91
2007-09-24 00:00:00.000,Bangkok Thailand ATP World Tour,HARD,2,Nicolas Mahut,Tommy Haas,Nicolas Mahut,6-4; 6-4,R16,90,9,4,38,59,31,38,11,21,1,1,10,42,59,2,2,46,75,25,46,19,29,8,10,10,44,75
2007-09-24 00:00:00.000,Bangkok Thailand ATP World Tour,HARD,2,Dmitry Tursunov,Michael Llodra,Dmitry Tursunov,6-4; 6-4,R16,62,4,1,34,51,30,34,11,17,0,0,10,41,51,5,2,39,56,29,39,10,17,0,2,10,39,56
2007-09-24 00:00:00.000,Bangkok Thailand ATP World Tour,HARD,2,Jimmy Wang,Nick Lindahl,Jimmy Wang,6-3; 6-3,R16,64,2,1,36,51,29,36,8,15,3,4,9,37,51,1,1,26,46,13,26,11,20,1,5,9,24,46
2007-09-24 00:00:00.000,Bangkok Thailand ATP World Tour,HARD,2,Benjamin Becker,Dominik Meffert,Benjamin Becker,7-6(2); 7-5,Q,116,13,3,46,81,33,46,19,35,6,8,12,52,81,11,4,55,92,36,55,17,37,5,8,12,53,92
2007-09-24 00:00:00.000,Bangkok Thailand ATP World Tour,HARD,2,Tomas Berdych,Ivo Karlovic,Tomas Berdych,7-5; 6-4,Q,72,9,2,40,60,32,40,14,20,0,0,11,46,60,16,2,40,55,34,40,7,15,3,5,11,41,55
2007-09-24 00:00:00.000,Bangkok Thailand ATP World Tour,HARD,2,Fernando Verdasco,Nicolas Mahut,Fernando Verdasco,4-6; 7-6(2); 6-4,Q,146,8,2,74,97,50,74,13,23,2,5,16,63,97,12,5,69,119,46,69,25,50,8,11,16,71,119
2007-09-24 00:00:00.000,Bangkok Thailand ATP World Tour,HARD,2,Dmitry Tursunov,Jimmy Wang,Dmitry Tursunov,4-6; 6-2; 6-4,Q,121,14,2,66,93,47,66,14,27,5,7,14,61,93,5,1,55,91,36,55,16,36,8,12,14,52,91
2007-09-24 00:00:00.000,Bangkok Thailand ATP World Tour,HARD,2,Benjamin Becker,Tomas Berdych,Benjamin Becker,3-6; 6-4; 6-4,S,118,13,1,53,87,43,53,17,34,5,7,15,60,87,15,0,53,87,42,53,18,34,4,6,14,60,87
2007-09-24 00:00:00.000,Bangkok Thailand ATP World Tour,HARD,2,Dmitry Tursunov,Fernando Verdasco,Dmitry Tursunov,7-6(4); 4-6; 6-4,S,148,11,3,83,122,64,83,13,39,8,10,16,77,122,3,7,74,102,54,74,13,28,3,5,16,67,102
2007-09-24 00:00:00.000,Bangkok Thailand ATP World Tour,HARD,2,Dmitry Tursunov,Benjamin Becker,Dmitry Tursunov,6-2; 6-1,F,58,5,2,26,46,21,26,14,20,3,3,8,35,46,7,0,22,40,13,22,7,18,8,12,7,20,40
2007-09-24 00:00:00.000,Mumbai India ATP World Tour,HARD,2,Richard Gasquet,Kristof Vliegen,Richard Gasquet,6-1; 6-2,R32,53,8,1,26,42,22,26,11,16,1,1,8,33,42,2,3,17,38,11,17,7,21,2,6,7,18,38
2007-09-24 00:00:00.000,Mumbai India ATP World Tour,HARD,2,Fabio Fognini,Somdev Devvarman,Fabio Fognini,6-3; 7-6(8),R32,95,7,3,47,78,36,47,16,31,1,3,11,52,78,2,4,51,72,34,51,8,21,3,6,10,42,72
2007-09-24 00:00:00.000,Mumbai India ATP World Tour,HARD,2,Bjorn Phau,Wesley Moodie,Bjorn Phau,6-3; 2-6; 6-4,R32,117,3,5,54,95,36,54,21,41,8,11,14,57,95,5,6,60,88,41,60,12,28,11,14,13,53,88
2007-09-24 00:00:00.000,Mumbai India ATP World Tour,HARD,2,Stefan Koubek,Paul Capdeville,Stefan Koubek,6-3; 6-2,R32,55,3,1,27,50,22,27,16,23,3,3,9,38,50,2,3,30,49,19,30,6,19,2,5,8,25,49
2007-09-24 00:00:00.000,Mumbai India ATP World Tour,HARD,2,Jarkko Nieminen,Davide Sanguinetti,Jarkko Nieminen,6-7(5); 6-1; 2-0 RET,R32,107,5,1,41,76,29,41,20,35,1,2,11,49,76,4,2,47,80,33,47,11,33,9,13,10,44,80
2007-09-24 00:00:00.000,Mumbai India ATP World Tour,HARD,2,Toshihide Matsui,Navdeep Singh,Toshihide Matsui,6-4; 7-6(7),R32,123,2,6,64,83,47,64,9,19,8,9,11,56,83,3,1,56,78,35,56,15,22,3,5,11,50,78
2007-09-24 00:00:00.000,Mumbai India ATP World Tour,HARD,2,Nicolas Devilder,Rohan Bopanna,Nicolas Devilder,3-6; 6-3; 7-6(9),R32,132,7,2,67,111,51,67,22,44,11,13,15,73,111,15,3,61,92,47,61,15,31,0,2,15,62,92
2007-09-24 00:00:00.000,Mumbai India ATP World Tour,HARD,2,Fabrice Santoro,Edouard Roger-Vasselin,Fabrice Santoro,6-1; 6-2,R32,67,3,0,25,45,19,25,15,20,1,1,8,34,45,1,4,24,44,13,24,7,20,1,5,7,20,44
2007-09-24 00:00:00.000,Mumbai India ATP World Tour,HARD,2,Olivier Rochus,Robin Haase,Olivier Rochus,6-2; 6-2,R32,66,0,2,25,45,22,25,12,20,2,2,8,34,45,2,3,25,51,17,25,9,26,3,7,8,26,51
2007-09-24 00:00:00.000,Mumbai India ATP World Tour,HARD,2,Ivan Navarro,Purav Raja,Ivan Navarro,6-4; 6-1,R32,85,6,1,30,40,24,30,8,10,0,0,8,32,40,1,9,28,78,21,28,19,50,7,11,9,40,78
2007-09-24 00:00:00.000,Mumbai India ATP World Tour,HARD,2,Yen-Hsun Lu,Jiri Vanek,Yen-Hsun Lu,4-6; 7-5; 6-4,R32,160,5,2,50,88,38,50,19,38,3,6,16,57,88,13,2,89,130,64,89,11,41,17,21,16,75,130
2007-09-24 00:00:00.000,Mumbai India ATP World Tour,HARD,2,Nicolas Kiefer,Paul-Henri Mathieu,Nicolas Kiefer,6-4; 6-3,R32,83,8,0,27,50,23,27,15,23,2,2,9,38,50,3,3,22,56,15,22,18,34,3,6,10,33,56
2007-09-24 00:00:00.000,Mumbai India ATP World Tour,HARD,2,Rainer Schuettler,Julien Benneteau,Rainer Schuettler,7-5; 6-3,R32,82,2,0,35,64,28,35,19,29,5,6,11,47,64,4,0,38,52,24,38,8,14,1,4,10,32,52
2007-09-24 00:00:00.000,Mumbai India ATP World Tour,HARD,2,Viktor Troicki,Aisam-Ul-Haq Qureshi,Viktor Troicki,6-2; 7-6(4),R32,100,9,5,58,82,43,58,12,24,4,5,10,55,82,3,2,40,62,28,40,10,22,1,4,10,38,62
2007-09-24 00:00:00.000,Mumbai India ATP World Tour,HARD,2,Boris Pashanski,Sergio Roitman,Boris Pashanski,1-6; 6-3; 6-3,R32,116,1,4,49,78,29,49,18,29,5,8,12,47,78,10,2,43,77,29,43,17,34,0,4,13,46,77
2007-09-24 00:00:00.000,Mumbai India ATP World Tour,HARD,2,Lleyton Hewitt,Ti Chen,Lleyton Hewitt,6-3; 6-3,R32,78,9,2,31,53,24,31,14,22,2,2,9,38,53,1,1,39,54,25,39,6,15,1,4,9,31,54
2007-09-24 00:00:00.000,Mumbai India ATP World Tour,HARD,2,Richard Gasquet,Fabio Fognini,Richard Gasquet,6-0; 6-1,R16,41,4,2,22,36,19,22,9,14,0,0,7,28,36,1,2,21,35,8,21,4,14,0,5,6,12,35
2007-09-24 00:00:00.000,Mumbai India ATP World Tour,HARD,2,Stefan Koubek,Bjorn Phau,Stefan Koubek,4-6; 6-3; 7-5,R16,114,1,2,48,92,36,48,30,44,3,4,16,66,92,7,7,50,94,38,50,24,44,3,5,15,62,94
2007-09-24 00:00:00.000,Mumbai India ATP World Tour,HARD,2,Jarkko Nieminen,Toshihide Matsui,Jarkko Nieminen,6-0; 6-4,R16,83,1,1,37,43,30,37,3,6,0,0,8,33,43,2,2,48,73,30,48,7,25,6,10,8,37,73
2007-09-24 00:00:00.000,Mumbai India ATP World Tour,HARD,2,Fabrice Santoro,Nicolas Devilder,Fabrice Santoro,2-6; 6-3; 6-2,R16,104,12,0,42,74,34,42,17,32,2,4,13,51,74,3,5,33,67,25,33,17,34,1,4,12,42,67
2007-09-24 00:00:00.000,Mumbai India ATP World Tour,HARD,2,Olivier Rochus,Ivan Navarro,Olivier Rochus,3-6; 6-3; 6-4,R16,138,2,4,43,76,32,43,18,33,6,9,14,50,76,8,5,42,82,33,42,17,40,5,9,14,50,82
2007-09-24 00:00:00.000,Mumbai India ATP World Tour,HARD,2,Nicolas Kiefer,Yen-Hsun Lu,Nicolas Kiefer,6-3; 6-3,R16,101,7,2,33,58,26,33,11,25,3,5,9,37,58,0,3,41,58,21,41,6,17,2,7,9,27,58
2007-09-24 00:00:00.000,Mumbai India ATP World Tour,HARD,2,Rainer Schuettler,Viktor Troicki,Rainer Schuettler,6-2; 6-7(4); 7-6(1),R16,177,3,4,65,117,49,65,29,52,7,9,16,78,117,7,7,78,123,55,78,19,45,11,15,16,74,123
2007-09-24 00:00:00.000,Mumbai India ATP World Tour,HARD,2,Lleyton Hewitt,Boris Pashanski,Lleyton Hewitt,7-6(2); 6-2,R16,102,9,3,29,61,24,29,21,32,5,6,10,45,61,0,3,30,65,21,30,18,35,2,5,10,39,65
2007-09-24 00:00:00.000,Mumbai India ATP World Tour,HARD,2,Richard Gasquet,Stefan Koubek,Richard Gasquet,6-2; 6-4,Q,67,8,1,32,50,24,32,10,18,1,2,9,34,50,3,2,36,56,22,36,9,20,3,7,9,31,56
2007-09-24 00:00:00.000,Mumbai India ATP World Tour,HARD,2,Fabrice Santoro,Jarkko Nieminen,Fabrice Santoro,6-3; 6-4,Q,81,2,0,36,57,26,36,12,21,1,3,10,38,57,0,1,45,56,28,45,2,11,5,9,9,30,56
2007-09-24 00:00:00.000,Mumbai India ATP World Tour,HARD,2,Olivier Rochus,Nicolas Kiefer,Olivier Rochus,4-1 RET,Q,37,0,0,10,18,7,10,4,8,1,1,2,11,18,5,2,17,27,11,17,2,10,0,2,3,13,27
2007-09-24 00:00:00.000,Mumbai India ATP World Tour,HARD,2,Rainer Schuettler,Lleyton Hewitt,Rainer Schuettler,6-3; 7-5,Q,96,8,2,34,62,26,34,11,28,3,6,11,37,62,4,6,29,67,17,29,16,38,5,10,10,33,67
2007-09-24 00:00:00.000,Mumbai India ATP World Tour,HARD,2,Richard Gasquet,Fabrice Santoro,Richard Gasquet,6-0; 6-3,S,58,0,4,24,44,22,24,11,20,0,0,8,33,44,1,1,20,37,10,20,8,17,1,5,7,18,37
2007-09-24 00:00:00.000,Mumbai India ATP World Tour,HARD,2,Olivier Rochus,Rainer Schuettler,Olivier Rochus,6-4; 6-4,S,108,4,1,37,61,29,37,12,24,3,4,10,41,61,5,4,47,86,31,47,18,39,8,11,10,49,86
2007-09-24 00:00:00.000,Mumbai India ATP World Tour,HARD,2,Richard Gasquet,Olivier Rochus,Richard Gasquet,6-3; 6-4,F,86,4,3,33,53,28,33,11,20,0,1,10,39,53,2,2,21,52,13,21,18,31,2,5,9,31,52
2007-10-01 00:00:00.000,Metz France ATP World Tour,HARD,2,Tommy Robredo,Florian Mayer,Tommy Robredo,4-6; 7-6(9); 6-2,R32,130,3,0,52,87,38,52,24,35,1,4,15,62,87,5,0,61,95,45,61,16,34,4,8,15,61,95
2007-10-01 00:00:00.000,Metz France ATP World Tour,HARD,2,Andreas Seppi,Arnaud Clement,Andreas Seppi,6-2; 6-4,R32,79,6,1,39,54,33,39,6,15,0,0,9,39,54,7,1,32,60,22,32,11,28,4,7,9,33,60
2007-10-01 00:00:00.000,Metz France ATP World Tour,HARD,2,Sebastien Grosjean,Oliver Marach,Sebastien Grosjean,3-6; 6-1; 6-3,R32,111,8,1,45,82,32,45,20,37,1,4,13,52,82,2,7,36,65,24,36,14,29,5,10,12,38,65
2007-10-01 00:00:00.000,Metz France ATP World Tour,HARD,2,Stefan Koubek,Gilles Simon,Stefan Koubek,6-2; 6-1,R32,60,0,3,25,48,17,25,12,23,4,5,7,29,48,3,1,20,47,9,20,10,27,0,6,8,19,47
2007-10-01 00:00:00.000,Metz France ATP World Tour,HARD,2,Julien Benneteau,Paul-Henri Mathieu,Julien Benneteau,6-4; 6-1,R32,79,6,1,31,44,23,31,8,13,5,6,8,31,44,1,6,28,61,15,28,14,33,6,11,9,29,61
2007-10-01 00:00:00.000,Metz France ATP World Tour,HARD,2,Nicolas Mahut,Mathieu Montcourt,Nicolas Mahut,6-2; 7-5,R32,80,10,3,30,58,24,30,18,28,0,0,10,42,58,8,4,36,54,26,36,7,18,1,4,10,33,54
2007-10-01 00:00:00.000,Metz France ATP World Tour,HARD,2,Nicolas Lapentti,Nicolas Massu,Nicolas Lapentti,3-6; 6-4; 7-6(3),R32,188,11,1,72,120,50,72,23,48,6,10,16,73,120,3,5,68,107,49,68,17,39,10,13,15,66,107
2007-10-01 00:00:00.000,Metz France ATP World Tour,HARD,2,Igor Andreev,Fabrice Santoro,Igor Andreev,6-3; 6-3,R32,85,4,0,43,65,31,43,13,22,7,7,9,44,65,2,3,30,62,24,30,10,32,4,7,9,34,62
2007-10-01 00:00:00.000,Metz France ATP World Tour,HARD,2,Philipp Kohlschreiber,Agustin Calleri,Philipp Kohlschreiber,6-3; 6-1,R32,59,5,2,22,43,19,22,13,21,0,0,8,32,43,4,5,29,58,17,29,12,29,5,9,8,29,58
2007-10-01 00:00:00.000,Metz France ATP World Tour,HARD,2,Jo-Wilfried Tsonga,Stanislas Wawrinka,Jo-Wilfried Tsonga,6-7(6); 6-4; 6-4,R32,146,6,4,66,102,49,66,20,36,6,7,16,69,102,7,1,53,100,42,53,20,47,0,3,16,62,100
2007-10-01 00:00:00.000,Metz France ATP World Tour,HARD,2,Michael Llodra,Werner Eschauer,Michael Llodra,4-1 RET,R32,24,3,0,4,12,3,4,6,8,2,2,2,9,12,2,0,14,21,5,14,4,7,0,2,3,9,21
2007-10-01 00:00:00.000,Metz France ATP World Tour,HARD,2,Andy Murray,Janko Tipsarevic,Andy Murray,6-4; 1-6; 6-2,R32,101,7,3,36,69,28,36,17,33,2,4,12,45,69,10,2,50,86,38,50,16,36,12,15,13,54,86
2007-10-01 00:00:00.000,Metz France ATP World Tour,HARD,2,Evgeny Korolev,Potito Starace,Evgeny Korolev,6-3; 6-3,R32,65,8,4,35,50,29,35,7,15,2,3,9,36,50,4,0,51,67,26,51,9,16,7,11,9,35,67
2007-10-01 00:00:00.000,Metz France ATP World Tour,HARD,2,Marc Gicquel,Florent Serra,Marc Gicquel,6-4; 7-6(0),R32,87,15,1,41,60,36,41,13,19,1,1,11,49,60,4,0,57,80,41,57,9,23,7,8,11,50,80
2007-10-01 00:00:00.000,Metz France ATP World Tour,HARD,2,Jurgen Melzer,David Guez,Jurgen Melzer,7-5; 6-7(2); 6-2,R32,166,13,0,65,103,45,65,19,38,6,10,16,64,103,3,1,76,126,46,76,23,50,14,21,16,69,126
2007-10-01 00:00:00.000,Metz France ATP World Tour,HARD,2,Guillermo Canas,Mikhail Ledovskikh,Guillermo Canas,7-6(1); 6-4,R32,106,3,5,38,70,29,38,14,32,8,11,11,43,70,9,0,37,75,27,37,13,38,6,10,11,40,75
2007-10-01 00:00:00.000,Metz France ATP World Tour,HARD,2,Tommy Robredo,Andreas Seppi,Tommy Robredo,6-4; 6-2,R16,82,8,0,34,55,25,34,15,21,2,2,9,40,55,2,3,27,56,18,27,13,29,3,6,9,31,56
2007-10-01 00:00:00.000,Metz France ATP World Tour,HARD,2,Sebastien Grosjean,Stefan Koubek,Sebastien Grosjean,7-5; 6-7(4); 2-4 DEF,R16,153,3,2,56,112,33,56,28,56,8,14,15,61,112,3,2,52,91,32,52,19,39,2,8,15,51,91
2007-10-01 00:00:00.000,Metz France ATP World Tour,HARD,2,Nicolas Mahut,Julien Benneteau,Nicolas Mahut,6-3; 3-6; 6-3,R16,132,9,1,55,80,41,55,14,25,2,4,14,55,80,7,4,57,87,40,57,13,30,7,10,13,53,87
2007-10-01 00:00:00.000,Metz France ATP World Tour,HARD,2,Igor Andreev,Nicolas Lapentti,Igor Andreev,6-3; 6-3,R16,89,5,1,42,65,33,42,12,23,5,5,9,45,65,3,0,32,58,22,32,12,26,2,5,9,34,58
2007-10-01 00:00:00.000,Metz France ATP World Tour,HARD,2,Jo-Wilfried Tsonga,Philipp Kohlschreiber,Jo-Wilfried Tsonga,5-7; 7-6(5); 6-3,R16,135,20,5,62,100,48,62,16,38,2,6,16,64,100,3,5,64,107,41,64,21,43,2,7,17,62,107
2007-10-01 00:00:00.000,Metz France ATP World Tour,HARD,2,Andy Murray,Michael Llodra,Andy Murray,6-4; 6-3,R16,71,6,3,32,56,28,32,10,24,3,4,9,38,56,6,3,35,55,26,35,6,20,4,8,10,32,55
2007-10-01 00:00:00.000,Metz France ATP World Tour,HARD,2,Evgeny Korolev,Marc Gicquel,Evgeny Korolev,6-4; 7-6(3),R16,96,7,7,37,70,33,37,15,33,3,4,11,48,70,6,2,32,71,27,32,17,39,2,4,11,44,71
2007-10-01 00:00:00.000,Metz France ATP World Tour,HARD,2,Guillermo Canas,Jurgen Melzer,Guillermo Canas,7-6(3); 7-6(6),R16,138,9,3,54,94,39,54,20,40,5,7,12,59,94,6,1,70,90,45,70,7,20,3,5,12,52,90
2007-10-01 00:00:00.000,Metz France ATP World Tour,HARD,2,Tommy Robredo,Sebastien Grosjean,Tommy Robredo,6-4; 6-4,Q,85,6,2,26,53,21,26,16,27,2,4,10,37,53,2,1,27,57,17,27,15,30,5,9,10,32,57
2007-10-01 00:00:00.000,Metz France ATP World Tour,HARD,2,Nicolas Mahut,Igor Andreev,Nicolas Mahut,3-6; 7-5; 7-6(1),Q,149,5,5,67,110,44,67,26,43,6,9,16,70,110,11,2,63,94,43,63,19,31,1,4,17,62,94
2007-10-01 00:00:00.000,Metz France ATP World Tour,HARD,2,Andy Murray,Jo-Wilfried Tsonga,Andy Murray,6-3; 6-3,Q,73,3,0,26,45,20,26,13,19,0,1,9,33,45,5,1,50,69,25,50,11,19,10,14,9,36,69
2007-10-01 00:00:00.000,Metz France ATP World Tour,HARD,2,Guillermo Canas,Evgeny Korolev,Guillermo Canas,6-1; 6-4,Q,76,5,2,27,48,24,27,13,21,2,2,9,37,48,2,3,29,50,16,29,11,21,1,4,8,27,50
2007-10-01 00:00:00.000,Metz France ATP World Tour,HARD,2,Tommy Robredo,Nicolas Mahut,Tommy Robredo,7-5; 4-6; 6-4,S,135,13,2,60,92,51,60,16,32,3,4,16,67,92,7,0,63,90,49,63,12,27,5,7,16,61,90
2007-10-01 00:00:00.000,Metz France ATP World Tour,HARD,2,Andy Murray,Guillermo Canas,Andy Murray,7-6(2); 6-4,S,116,6,3,43,64,38,43,9,21,1,2,11,47,64,4,2,49,84,34,49,15,35,5,7,11,49,84
2007-10-01 00:00:00.000,Metz France ATP World Tour,HARD,2,Tommy Robredo,Andy Murray,Tommy Robredo,0-6; 6-2; 6-3,F,113,1,2,47,69,32,47,9,22,3,6,11,41,69,3,2,43,85,24,43,21,42,4,8,12,45,85
2007-10-01 00:00:00.000,Tokyo Japan ATP World Tour,HARD,2,David Ferrer,N/A Bye,David Ferrer,,R64,0,0,0,0,0,0,0,0,0,0,0,0,0,0,0,0,0,0,0,0,0,0,0,0,0,0,0
2007-10-01 00:00:00.000,Tokyo Japan ATP World Tour,HARD,2,Wesley Moodie,Simone Bolelli,Wesley Moodie,7-6(6); 7-6(8),R64,88,21,1,55,72,45,55,11,17,0,1,12,56,72,7,1,50,79,36,50,19,29,0,1,12,55,79
2007-10-01 00:00:00.000,Tokyo Japan ATP World Tour,HARD,2,Vincent Spadea,Amer Delic,Vincent Spadea,6-3; 6-1,R64,52,2,0,36,47,28,36,6,11,1,1,8,34,47,2,0,24,42,15,24,6,18,3,7,8,21,42
2007-10-01 00:00:00.000,Tokyo Japan ATP World Tour,HARD,2,Sergio Roitman,N/A Bye,Sergio Roitman,,R64,0,0,0,0,0,0,0,0,0,0,0,0,0,0,0,0,0,0,0,0,0,0,0,0,0,0,0
2007-10-01 00:00:00.000,Tokyo Japan ATP World Tour,HARD,2,Feliciano Lopez,N/A Bye,Feliciano Lopez,,R64,0,0,0,0,0,0,0,0,0,0,0,0,0,0,0,0,0,0,0,0,0,0,0,0,0,0,0
2007-10-01 00:00:00.000,Tokyo Japan ATP World Tour,HARD,2,Robert Kendrick,Hyun-Woo Nam,Robert Kendrick,7-6(5); 6-7(7); 6-3,R64,133,16,3,68,114,59,68,22,46,5,6,16,81,114,7,1,81,121,57,81,22,40,2,5,17,79,121
2007-10-01 00:00:00.000,Tokyo Japan ATP World Tour,HARD,2,Paul Capdeville,Teymuraz Gabashvili,Paul Capdeville,7-6(4); 7-5,R64,94,3,2,65,83,50,65,8,18,4,4,12,58,83,12,2,54,81,42,54,12,27,5,6,12,54,81
2007-10-01 00:00:00.000,Tokyo Japan ATP World Tour,HARD,2,Dmitry Tursunov,N/A Bye,Dmitry Tursunov,,R64,0,0,0,0,0,0,0,0,0,0,0,0,0,0,0,0,0,0,0,0,0,0,0,0,0,0,0
2007-10-01 00:00:00.000,Tokyo Japan ATP World Tour,HARD,2,Lleyton Hewitt,N/A Bye,Lleyton Hewitt,,R64,0,0,0,0,0,0,0,0,0,0,0,0,0,0,0,0,0,0,0,0,0,0,0,0,0,0,0
2007-10-01 00:00:00.000,Tokyo Japan ATP World Tour,HARD,2,Luka Gregorc,Takahiro Terachi,Luka Gregorc,6-4; 6-4,R64,84,4,6,33,59,26,33,13,26,0,2,10,39,59,2,3,36,73,22,36,19,37,7,11,10,41,73
2007-10-01 00:00:00.000,Tokyo Japan ATP World Tour,HARD,2,Ivan Navarro,Robin Haase,Ivan Navarro,7-6(5); 7-6(0),R64,119,10,3,45,77,35,45,18,32,3,5,12,53,77,3,1,54,92,33,54,23,38,7,9,12,56,92
2007-10-01 00:00:00.000,Tokyo Japan ATP World Tour,HARD,2,Sam Querrey,N/A Bye,Sam Querrey,,R64,0,0,0,0,0,0,0,0,0,0,0,0,0,0,0,0,0,0,0,0,0,0,0,0,0,0,0
2007-10-01 00:00:00.000,Tokyo Japan ATP World Tour,HARD,2,Hyung-Taik Lee,N/A Bye,Hyung-Taik Lee,,R64,0,0,0,0,0,0,0,0,0,0,0,0,0,0,0,0,0,0,0,0,0,0,0,0,0,0,0
2007-10-01 00:00:00.000,Tokyo Japan ATP World Tour,HARD,2,Yen-Hsun Lu,Danai Udomchoke,Yen-Hsun Lu,6-7(4); 7-6(7); 6-1,R64,144,7,2,63,99,46,63,21,36,1,3,16,67,99,7,4,84,119,56,84,16,35,7,11,15,72,119
2007-10-01 00:00:00.000,Tokyo Japan ATP World Tour,HARD,2,Benjamin Becker,Takao Suzuki,Benjamin Becker,7-5; 3-6; 6-4,R64,125,12,3,61,102,45,61,24,41,6,7,15,69,102,12,4,51,94,39,51,26,43,2,4,16,65,94
2007-10-01 00:00:00.000,Tokyo Japan ATP World Tour,HARD,2,Ivo Karlovic,N/A Bye,Ivo Karlovic,,R64,0,0,0,0,0,0,0,0,0,0,0,0,0,0,0,0,0,0,0,0,0,0,0,0,0,0,0
2007-10-01 00:00:00.000,Tokyo Japan ATP World Tour,HARD,2,Jarkko Nieminen,N/A Bye,Jarkko Nieminen,,R64,0,0,0,0,0,0,0,0,0,0,0,0,0,0,0,0,0,0,0,0,0,0,0,0,0,0,0
2007-10-01 00:00:00.000,Tokyo Japan ATP World Tour,HARD,2,Boris Pashanski,Jean-Claude Scherrer,Boris Pashanski,7-6(5); 1-6; 7-5,R64,128,2,4,74,106,54,74,17,32,5,7,15,71,106,25,6,58,98,51,58,20,40,3,4,16,71,98
2007-10-01 00:00:00.000,Tokyo Japan ATP World Tour,HARD,2,Dudi Sela,Simon Stadler,Dudi Sela,6-4; 7-5,R64,89,1,2,41,69,27,41,17,28,3,5,11,44,69,3,0,51,72,30,51,9,21,6,10,11,39,72
2007-10-01 00:00:00.000,Tokyo Japan ATP World Tour,HARD,2,Juan Martin Del Potro,N/A Bye,Juan Martin Del Potro,,R64,0,0,0,0,0,0,0,0,0,0,0,0,0,0,0,0,0,0,0,0,0,0,0,0,0,0,0
2007-10-01 00:00:00.000,Tokyo Japan ATP World Tour,HARD,2,Frank Dancevic,N/A Bye,Frank Dancevic,,R64,0,0,0,0,0,0,0,0,0,0,0,0,0,0,0,0,0,0,0,0,0,0,0,0,0,0,0
2007-10-01 00:00:00.000,Tokyo Japan ATP World Tour,HARD,2,Rainer Schuettler,Go Soeda,Rainer Schuettler,6-3; 1-6; 6-2,R64,86,2,4,40,69,32,40,15,29,2,4,12,47,69,4,0,40,62,30,40,12,22,1,4,12,42,62
2007-10-01 00:00:00.000,Tokyo Japan ATP World Tour,HARD,2,Zack Fleishman,Kei Nishikori,Zack Fleishman,7-6(5); 3-6; 6-1,R64,104,9,2,45,88,27,45,28,43,4,7,14,55,88,7,6,56,87,43,56,12,31,2,6,14,55,87
2007-10-01 00:00:00.000,Tokyo Japan ATP World Tour,HARD,2,Richard Gasquet,N/A Bye,Richard Gasquet,,R64,0,0,0,0,0,0,0,0,0,0,0,0,0,0,0,0,0,0,0,0,0,0,0,0,0,0,0
2007-10-01 00:00:00.000,Tokyo Japan ATP World Tour,HARD,2,Fernando Verdasco,N/A Bye,Fernando Verdasco,,R64,0,0,0,0,0,0,0,0,0,0,0,0,0,0,0,0,0,0,0,0,0,0,0,0,0,0,0
2007-10-01 00:00:00.000,Tokyo Japan ATP World Tour,HARD,2,Mischa Zverev,Fabio Fognini,Mischa Zverev,6-1; 7-6(9),R64,79,4,1,50,77,40,50,14,27,5,5,10,54,77,5,3,41,74,33,41,12,33,6,8,9,45,74
2007-10-01 00:00:00.000,Tokyo Japan ATP World Tour,HARD,2,Justin Gimelstob,Lukasz Kubot,Justin Gimelstob,6-4; 7-5,R64,96,4,3,39,61,25,39,7,22,3,7,11,32,61,3,1,28,60,18,28,11,32,1,7,11,29,60
2007-10-01 00:00:00.000,Tokyo Japan ATP World Tour,HARD,2,Thomas Johansson,N/A Bye,Thomas Johansson,,R64,0,0,0,0,0,0,0,0,0,0,0,0,0,0,0,0,0,0,0,0,0,0,0,0,0,0,0
2007-10-01 00:00:00.000,Tokyo Japan ATP World Tour,HARD,2,Michael Russell,N/A Bye,Michael Russell,,R64,0,0,0,0,0,0,0,0,0,0,0,0,0,0,0,0,0,0,0,0,0,0,0,0,0,0,0
2007-10-01 00:00:00.000,Tokyo Japan ATP World Tour,HARD,2,Marin Cilic,Woong-Sun Jun,Marin Cilic,6-2; 6-2,R64,76,2,2,27,53,20,27,14,26,4,5,8,34,53,1,1,31,61,17,31,12,30,5,10,8,29,61
2007-10-01 00:00:00.000,Tokyo Japan ATP World Tour,HARD,2,Jiri Vanek,Satoshi Iwabuchi,Jiri Vanek,6-4; 6-4,R64,70,12,2,42,56,36,42,6,14,4,4,10,42,56,3,2,34,59,23,34,15,25,3,5,10,38,59
2007-10-01 00:00:00.000,Tokyo Japan ATP World Tour,HARD,2,Tomas Berdych,N/A Bye,Tomas Berdych,,R64,0,0,0,0,0,0,0,0,0,0,0,0,0,0,0,0,0,0,0,0,0,0,0,0,0,0,0
2007-10-01 00:00:00.000,Tokyo Japan ATP World Tour,HARD,2,David Ferrer,Wesley Moodie,David Ferrer,7-6(5); 6-2,R32,92,5,1,45,71,32,45,16,26,5,6,10,48,71,3,4,67,96,40,67,13,29,10,13,10,53,96
2007-10-01 00:00:00.000,Tokyo Japan ATP World Tour,HARD,2,Vincent Spadea,Sergio Roitman,Vincent Spadea,4-6; 6-1; 7-6(7),R32,130,2,0,66,93,45,66,16,27,2,5,15,61,93,8,1,72,108,46,72,16,36,6,10,14,62,108
2007-10-01 00:00:00.000,Tokyo Japan ATP World Tour,HARD,2,Feliciano Lopez,Robert Kendrick,Feliciano Lopez,6-2; 6-4,R32,63,8,2,31,46,26,31,8,15,0,1,9,34,46,6,3,32,52,20,32,9,20,3,7,9,29,52
2007-10-01 00:00:00.000,Tokyo Japan ATP World Tour,HARD,2,Dmitry Tursunov,Paul Capdeville,Dmitry Tursunov,6-4; 6-3,R32,69,14,5,31,58,26,31,15,27,4,5,10,41,58,5,1,41,59,26,41,7,18,2,5,9,33,59
2007-10-01 00:00:00.000,Tokyo Japan ATP World Tour,HARD,2,Lleyton Hewitt,Luka Gregorc,Lleyton Hewitt,6-3; 6-3,R32,73,4,3,23,55,20,23,19,32,0,0,9,39,55,6,3,36,56,23,36,9,20,2,5,9,32,56
2007-10-01 00:00:00.000,Tokyo Japan ATP World Tour,HARD,2,Ivan Navarro,Sam Querrey,Ivan Navarro,7-5; 6-3,R32,69,10,2,41,58,33,41,10,17,3,3,10,43,58,5,3,31,55,25,31,12,24,2,5,11,37,55
2007-10-01 00:00:00.000,Tokyo Japan ATP World Tour,HARD,2,Hyung-Taik Lee,Yen-Hsun Lu,Hyung-Taik Lee,6-1; 6-4,R32,73,1,2,35,52,29,35,7,17,0,1,9,36,52,3,2,29,52,14,29,12,23,2,6,8,26,52
2007-10-01 00:00:00.000,Tokyo Japan ATP World Tour,HARD,2,Ivo Karlovic,Benjamin Becker,Ivo Karlovic,6-4; 6-3,R32,66,13,1,42,58,34,42,9,16,3,3,10,43,58,3,1,22,47,16,22,15,25,1,3,9,31,47
2007-10-01 00:00:00.000,Tokyo Japan ATP World Tour,HARD,2,Boris Pashanski,Jarkko Nieminen,Boris Pashanski,6-3; 4-6; 6-4,R32,96,5,2,58,84,49,58,10,26,4,6,15,59,84,7,0,47,80,36,47,18,33,5,8,14,54,80
2007-10-01 00:00:00.000,Tokyo Japan ATP World Tour,HARD,2,Dudi Sela,Juan Martin Del Potro,Dudi Sela,2-6; 7-5; 5-3 RET,R32,114,8,1,52,80,40,52,15,28,1,3,14,55,80,6,6,54,88,40,54,16,34,5,7,14,56,88
2007-10-01 00:00:00.000,Tokyo Japan ATP World Tour,HARD,2,Rainer Schuettler,Frank Dancevic,Rainer Schuettler,6-2; 4-6; 6-2,R32,95,9,1,47,69,35,47,14,22,1,3,13,49,69,12,6,56,93,40,56,12,37,11,16,13,52,93
2007-10-01 00:00:00.000,Tokyo Japan ATP World Tour,HARD,2,Richard Gasquet,Zack Fleishman,Richard Gasquet,6-3; 6-3,R32,62,7,1,38,46,35,38,3,8,1,1,9,38,46,5,4,30,61,19,30,16,31,5,8,9,35,61
2007-10-01 00:00:00.000,Tokyo Japan ATP World Tour,HARD,2,Fernando Verdasco,Mischa Zverev,Fernando Verdasco,6-3; 6-2,R32,52,3,0,38,46,30,38,6,8,0,0,9,36,46,2,2,26,49,14,26,12,23,1,4,8,26,49
2007-10-01 00:00:00.000,Tokyo Japan ATP World Tour,HARD,2,Thomas Johansson,Justin Gimelstob,Thomas Johansson,6-4; 6-4,R32,75,8,2,27,48,24,27,16,21,0,0,10,40,48,1,3,35,57,26,35,11,22,1,3,10,37,57
2007-10-01 00:00:00.000,Tokyo Japan ATP World Tour,HARD,2,Michael Russell,Marin Cilic,Michael Russell,7-6(2); 2-6; 6-1,R32,119,3,3,58,82,42,58,13,24,1,3,14,55,82,9,5,53,93,34,53,22,40,6,8,13,56,93
2007-10-01 00:00:00.000,Tokyo Japan ATP World Tour,HARD,2,Tomas Berdych,Jiri Vanek,Tomas Berdych,6-1; 6-4,R32,55,13,1,30,46,26,30,11,16,0,0,9,37,46,10,3,27,54,21,27,9,27,6,9,8,30,54
2007-10-01 00:00:00.000,Tokyo Japan ATP World Tour,HARD,2,David Ferrer,Vincent Spadea,David Ferrer,6-1; 7-6(0),R16,85,3,0,35,55,27,35,13,20,5,6,9,40,55,2,0,55,74,29,55,9,19,6,10,10,38,74
2007-10-01 00:00:00.000,Tokyo Japan ATP World Tour,HARD,2,Feliciano Lopez,Dmitry Tursunov,Feliciano Lopez,7-6(8); 6-4,R16,83,15,2,51,74,40,51,12,23,2,4,11,52,74,12,3,39,65,31,39,14,26,0,3,11,45,65
2007-10-01 00:00:00.000,Tokyo Japan ATP World Tour,HARD,2,Lleyton Hewitt,Ivan Navarro,Lleyton Hewitt,7-5; 6-3,R16,94,5,3,34,64,28,34,15,30,1,2,11,43,64,8,4,38,66,26,38,12,28,3,6,10,38,66
2007-10-01 00:00:00.000,Tokyo Japan ATP World Tour,HARD,2,Ivo Karlovic,Hyung-Taik Lee,Ivo Karlovic,7-6(6); 6-7(8); 7-6(8),R16,159,35,2,93,130,75,93,22,37,4,4,18,97,130,3,2,87,121,74,87,19,34,2,2,18,93,121
2007-10-01 00:00:00.000,Tokyo Japan ATP World Tour,HARD,2,Dudi Sela,Boris Pashanski,Dudi Sela,6-2; 4-0 RET,R16,40,4,1,21,32,19,21,6,11,0,0,6,25,32,0,3,17,30,7,17,4,13,0,4,6,11,30
2007-10-01 00:00:00.000,Tokyo Japan ATP World Tour,HARD,2,Richard Gasquet,Rainer Schuettler,Richard Gasquet,6-2; 6-2,R16,64,5,0,32,44,26,32,9,12,1,1,8,35,44,2,1,32,53,15,32,11,21,3,7,8,26,53
2007-10-01 00:00:00.000,Tokyo Japan ATP World Tour,HARD,2,Fernando Verdasco,Thomas Johansson,Fernando Verdasco,7-6(4); 5-7; 6-3,R16,125,23,5,75,106,60,75,14,31,2,4,17,74,106,8,2,52,87,40,52,23,35,1,3,16,63,87
2007-10-01 00:00:00.000,Tokyo Japan ATP World Tour,HARD,2,Tomas Berdych,Michael Russell,Tomas Berdych,6-4; 6-2,R16,80,12,2,43,65,31,43,11,22,4,5,9,42,65,3,1,35,56,21,35,10,21,2,6,9,31,56
2007-10-01 00:00:00.000,Tokyo Japan ATP World Tour,HARD,2,David Ferrer,Feliciano Lopez,David Ferrer,6-4; 6-4,Q,79,3,0,45,65,31,45,10,20,3,4,10,41,65,4,2,31,55,19,31,14,24,0,3,10,33,55
2007-10-01 00:00:00.000,Tokyo Japan ATP World Tour,HARD,2,Ivo Karlovic,Lleyton Hewitt,Ivo Karlovic,7-6(5); 7-6(6),Q,111,25,2,56,80,51,56,10,24,4,4,12,61,80,9,3,40,79,35,40,23,39,0,0,12,58,79
2007-10-01 00:00:00.000,Tokyo Japan ATP World Tour,HARD,2,Richard Gasquet,Dudi Sela,Richard Gasquet,6-4; 6-1,Q,68,7,3,33,49,25,33,10,16,3,3,8,35,49,4,0,38,58,22,38,8,20,4,8,9,30,58
2007-10-01 00:00:00.000,Tokyo Japan ATP World Tour,HARD,2,Tomas Berdych,Fernando Verdasco,Tomas Berdych,7-6(7); 4-6; 7-5,Q,146,7,2,71,121,53,71,22,50,3,7,17,75,121,3,6,66,95,51,66,15,29,7,11,17,66,95
2007-10-01 00:00:00.000,Tokyo Japan ATP World Tour,HARD,2,David Ferrer,Ivo Karlovic,David Ferrer,7-6(3); 6-3,S,81,3,0,39,59,33,39,15,20,0,0,11,48,59,10,1,47,71,37,47,9,24,2,3,10,46,71
2007-10-01 00:00:00.000,Tokyo Japan ATP World Tour,HARD,2,Richard Gasquet,Tomas Berdych,Richard Gasquet,7-6(3); 6-3,S,89,14,0,51,80,41,51,13,29,5,6,11,54,80,9,1,34,62,26,34,14,28,6,8,10,40,62
2007-10-01 00:00:00.000,Tokyo Japan ATP World Tour,HARD,2,David Ferrer,Richard Gasquet,David Ferrer,6-1; 6-2,F,53,7,0,27,38,23,27,7,11,2,2,7,30,38,6,1,27,46,17,27,3,19,3,8,8,20,46
2007-10-07 00:00:00.000,Stockholm Sweden ATP World Tour,HARD,2,James Blake,Jonas Bjorkman,James Blake,6-7(3); 7-5; 6-3,R32,156,13,8,65,124,45,65,30,59,6,9,16,75,124,6,6,74,136,50,74,26,62,12,18,17,76,136
2007-10-07 00:00:00.000,Stockholm Sweden ATP World Tour,HARD,2,Frank Dancevic,Peter Wessels,Frank Dancevic,6-1; 6-7(7); 7-6(6),R32,110,35,2,80,114,65,80,17,34,1,2,16,82,114,23,6,69,104,55,69,15,35,3,6,15,70,104
2007-10-07 00:00:00.000,Stockholm Sweden ATP World Tour,HARD,2,Peter Luczak,Benjamin Becker,Peter Luczak,2-6; 6-3; 6-4,R32,111,9,8,53,100,39,53,25,47,5,7,14,64,100,18,5,36,79,29,36,22,43,5,7,13,51,79
2007-10-07 00:00:00.000,Stockholm Sweden ATP World Tour,HARD,2,Jarkko Nieminen,Tobias Kamke,Jarkko Nieminen,6-1; 6-2,R32,52,1,0,23,34,21,23,7,11,0,0,7,28,34,0,6,25,53,14,25,10,28,1,6,8,24,53
2007-10-07 00:00:00.000,Stockholm Sweden ATP World Tour,HARD,2,Michael Llodra,Denis Gremelmayr,Michael Llodra,6-3; 6-2,R32,63,11,4,33,55,26,33,15,22,5,5,9,41,55,6,2,32,57,22,32,8,25,2,5,8,30,57
2007-10-07 00:00:00.000,Stockholm Sweden ATP World Tour,HARD,2,Thomas Johansson,Juan Martin Del Potro,Thomas Johansson,6-4; 1-0 RET,R32,56,3,0,21,31,13,21,7,10,1,2,5,20,31,3,2,22,49,18,22,6,27,9,12,6,24,49
2007-10-07 00:00:00.000,Stockholm Sweden ATP World Tour,HARD,2,Mario Ancic,Amer Delic,Mario Ancic,6-1; 6-4,R32,72,4,1,39,63,32,39,12,24,3,3,9,44,63,1,3,38,57,23,38,9,19,5,8,8,32,57
2007-10-07 00:00:00.000,Stockholm Sweden ATP World Tour,HARD,2,Bjorn Rehnquist,Vincent Spadea,Bjorn Rehnquist,6-4; 6-4,R32,83,4,5,28,62,23,28,20,34,4,5,10,43,62,1,3,39,57,23,39,11,18,0,3,10,34,57
2007-10-07 00:00:00.000,Stockholm Sweden ATP World Tour,HARD,2,Juan Monaco,Ervin Eleskovic,Juan Monaco,6-3; 6-3,R32,84,2,1,32,57,26,32,16,25,7,7,9,42,57,5,3,25,52,17,25,13,27,1,4,9,30,52
2007-10-07 00:00:00.000,Stockholm Sweden ATP World Tour,HARD,2,Filip Prpic,Oscar Hernandez,Filip Prpic,6-2; 7-6(4),R32,71,6,3,35,62,31,35,16,27,1,1,10,47,62,3,2,35,57,26,35,12,22,1,3,10,38,57
2007-10-07 00:00:00.000,Stockholm Sweden ATP World Tour,HARD,2,Albert Montanes,Rohan Bopanna,Albert Montanes,7-6(5); 6-1,R32,65,5,4,37,59,31,37,14,22,0,1,10,45,59,3,1,27,55,23,27,11,28,3,6,9,34,55
2007-10-07 00:00:00.000,Stockholm Sweden ATP World Tour,HARD,2,Tommy Haas,Olivier Rochus,Tommy Haas,6-4; 6-1,R32,63,8,3,29,55,27,29,14,26,2,2,9,41,55,0,4,32,46,20,32,6,14,2,5,8,26,46
2007-10-07 00:00:00.000,Stockholm Sweden ATP World Tour,HARD,2,Ivo Karlovic,Nicolas Massu,Ivo Karlovic,7-6(6); 6-7(4); 6-4,R32,166,34,0,71,100,55,71,24,29,3,3,17,79,100,2,1,87,115,65,87,16,28,10,11,17,81,115
2007-10-07 00:00:00.000,Stockholm Sweden ATP World Tour,HARD,2,Joachim Johansson,Carlos Berlocq,Joachim Johansson,7-6(1); 6-2,R32,91,18,3,39,64,33,39,14,25,2,2,10,47,64,7,3,41,73,30,41,14,32,3,5,10,44,73
2007-10-07 00:00:00.000,Stockholm Sweden ATP World Tour,HARD,2,Arnaud Clement,Max Mirnyi,Arnaud Clement,6-3; 6-2,R32,220,0,3,20,37,17,20,8,17,0,2,8,25,37,9,7,28,61,16,28,10,33,2,8,9,26,61
2007-10-07 00:00:00.000,Stockholm Sweden ATP World Tour,HARD,2,Michael Ryderstedt,Kenneth Carlsen,Michael Ryderstedt,6-3; 7-6(4),R32,78,12,1,41,66,34,41,18,25,2,2,11,52,66,13,1,45,59,36,45,7,14,0,1,10,43,59
2007-10-07 00:00:00.000,Stockholm Sweden ATP World Tour,HARD,2,James Blake,Frank Dancevic,James Blake,6-3; 6-2,R16,53,6,1,28,52,24,28,15,24,1,1,9,39,52,3,1,32,51,19,32,10,19,4,7,8,29,51
2007-10-07 00:00:00.000,Stockholm Sweden ATP World Tour,HARD,2,Jarkko Nieminen,Peter Luczak,Jarkko Nieminen,6-0; 6-4,R16,72,6,0,36,55,29,36,9,19,6,6,8,38,55,5,1,38,63,21,38,10,25,4,8,8,31,63
2007-10-07 00:00:00.000,Stockholm Sweden ATP World Tour,HARD,2,Thomas Johansson,Michael Llodra,Thomas Johansson,6-4; 7-6(10),R16,97,10,0,46,85,32,46,27,39,4,4,11,59,85,18,5,42,70,34,42,15,28,2,3,11,49,70
2007-10-07 00:00:00.000,Stockholm Sweden ATP World Tour,HARD,2,Mario Ancic,Bjorn Rehnquist,Mario Ancic,6-1; 6-3,R16,61,11,1,25,38,24,25,8,13,0,0,8,32,38,0,5,26,52,15,26,12,26,3,7,8,27,52
2007-10-07 00:00:00.000,Stockholm Sweden ATP World Tour,HARD,2,Juan Monaco,Filip Prpic,Juan Monaco,6-4; 6-4,R16,91,2,1,46,66,27,46,11,20,4,7,10,38,66,1,6,40,80,26,40,15,40,11,16,10,41,80
2007-10-07 00:00:00.000,Stockholm Sweden ATP World Tour,HARD,2,Tommy Haas,Albert Montanes,Tommy Haas,6-2; 3-6; 6-3,R16,94,6,3,41,66,33,41,15,25,0,1,13,48,66,5,3,41,86,30,41,21,45,6,9,13,51,86
2007-10-07 00:00:00.000,Stockholm Sweden ATP World Tour,HARD,2,Ivo Karlovic,Joachim Johansson,Ivo Karlovic,W/O,R16,0,0,0,0,0,0,0,0,0,0,0,0,0,0,0,0,0,0,0,0,0,0,0,0,0,0,0
2007-10-07 00:00:00.000,Stockholm Sweden ATP World Tour,HARD,2,Arnaud Clement,Michael Ryderstedt,Arnaud Clement,7-6(2); 3-6; 6-3,R16,151,8,1,54,97,41,54,25,43,4,5,15,66,97,23,7,65,114,48,65,25,49,13,14,15,73,114
2007-10-07 00:00:00.000,Stockholm Sweden ATP World Tour,HARD,2,James Blake,Jarkko Nieminen,James Blake,6-7(1); 6-4; 6-2,Q,100,10,2,64,105,47,64,22,41,6,7,15,69,105,4,1,59,88,42,59,15,29,3,7,15,57,88
2007-10-07 00:00:00.000,Stockholm Sweden ATP World Tour,HARD,2,Thomas Johansson,Mario Ancic,Thomas Johansson,4-6; 7-5; 7-6(3),Q,141,10,0,63,101,50,63,21,38,1,3,17,71,101,14,4,59,99,51,59,17,40,2,4,17,68,99
2007-10-07 00:00:00.000,Stockholm Sweden ATP World Tour,HARD,2,Tommy Haas,Juan Monaco,Tommy Haas,6-3; 6-3,Q,74,10,3,38,60,30,38,9,22,1,2,9,39,60,2,3,37,56,24,37,5,19,5,9,9,29,56
2007-10-07 00:00:00.000,Stockholm Sweden ATP World Tour,HARD,2,Ivo Karlovic,Arnaud Clement,Ivo Karlovic,7-6(1); 3-6; 7-6(7),Q,144,30,0,70,96,58,70,17,26,2,3,16,75,96,8,3,76,109,57,76,21,33,3,3,17,78,109
2007-10-07 00:00:00.000,Stockholm Sweden ATP World Tour,HARD,2,Thomas Johansson,James Blake,Thomas Johansson,3-6; 6-1; 7-6(3),S,131,10,4,54,106,42,54,25,52,12,14,14,67,106,10,3,50,94,36,50,22,44,5,8,14,58,94
2007-10-07 00:00:00.000,Stockholm Sweden ATP World Tour,HARD,2,Ivo Karlovic,Tommy Haas,Ivo Karlovic,6-4; 6-3,S,76,15,1,40,56,34,40,8,16,3,3,10,42,56,2,4,42,61,26,42,11,19,7,9,9,37,61
2007-10-07 00:00:00.000,Stockholm Sweden ATP World Tour,HARD,2,Ivo Karlovic,Thomas Johansson,Ivo Karlovic,6-3; 3-6; 6-1,F,114,27,1,44,66,40,44,10,22,0,1,13,50,66,5,2,42,66,33,42,11,24,3,6,12,44,66
2007-10-07 00:00:00.000,Vienna Austria ATP World Tour,HARD,2,Novak Djokovic,Robby Ginepri,Novak Djokovic,6-3; 6-4,R32,77,5,3,34,55,22,34,12,21,0,3,10,34,55,5,0,35,54,21,35,5,19,4,9,9,26,54
2007-10-07 00:00:00.000,Vienna Austria ATP World Tour,HARD,2,Tomas Zib,Florian Mayer,Tomas Zib,6-1; 6-4,R32,66,2,0,32,53,25,32,12,21,5,6,9,37,53,3,1,34,49,18,34,7,15,2,6,8,25,49
2007-10-07 00:00:00.000,Vienna Austria ATP World Tour,HARD,2,Jurgen Melzer,Alexander Peya,Jurgen Melzer,6-4; 6-3,R32,76,1,1,27,48,22,27,15,21,0,0,9,37,48,5,1,54,73,33,54,10,19,9,12,10,43,73
2007-10-07 00:00:00.000,Vienna Austria ATP World Tour,HARD,2,Juan Ignacio Chela,Guillermo Garcia-Lopez,Juan Ignacio Chela,6-1; 6-3,R32,56,0,2,23,43,21,23,12,20,0,0,8,33,43,3,4,35,48,20,35,6,13,2,6,8,26,48
2007-10-07 00:00:00.000,Vienna Austria ATP World Tour,HARD,2,Ivan Ljubicic,Andreas Haider-Maurer,Ivan Ljubicic,6-4; 7-5,R32,86,15,1,33,61,28,33,15,28,1,2,11,43,61,3,8,33,67,22,33,19,34,2,5,11,41,67
2007-10-07 00:00:00.000,Vienna Austria ATP World Tour,HARD,2,Mardy Fish,Nicolas Almagro,Mardy Fish,6-7(4); 6-2; 6-4,R32,121,12,1,52,88,44,52,23,36,4,4,15,67,88,7,3,63,104,48,63,19,41,4,7,15,67,104
2007-10-07 00:00:00.000,Vienna Austria ATP World Tour,HARD,2,Robin Haase,Agustin Calleri,Robin Haase,4-6; 6-3; 6-3,R32,91,9,0,52,82,41,52,16,30,3,4,14,57,82,8,2,42,73,32,42,16,31,2,5,14,48,73
2007-10-07 00:00:00.000,Vienna Austria ATP World Tour,HARD,2,Andreas Seppi,Marcos Baghdatis,Andreas Seppi,6-2; 6-2,R32,68,0,0,26,45,20,26,13,19,1,1,8,33,45,4,1,31,57,14,31,16,26,5,9,8,30,57
2007-10-07 00:00:00.000,Vienna Austria ATP World Tour,HARD,2,Stefan Koubek,Carlos Moya,Stefan Koubek,7-6(3); 5-7; 6-2,R32,129,4,2,53,88,41,53,21,35,4,8,16,62,88,8,6,64,108,44,64,18,44,17,22,16,62,108
2007-10-07 00:00:00.000,Vienna Austria ATP World Tour,HARD,2,Feliciano Lopez,Werner Eschauer,Feliciano Lopez,6-3; 6-2,R32,62,10,1,30,44,27,30,9,14,0,0,9,36,44,3,3,20,47,17,20,11,27,3,6,8,28,47
2007-10-07 00:00:00.000,Vienna Austria ATP World Tour,HARD,2,Stanislas Wawrinka,Marc Gicquel,Stanislas Wawrinka,4-6; 6-3; 6-4,R32,122,8,0,57,95,43,57,24,38,3,4,15,67,95,3,4,47,87,37,47,19,40,10,12,14,56,87
2007-10-07 00:00:00.000,Vienna Austria ATP World Tour,HARD,2,David Nalbandian,Stefano Galvani,David Nalbandian,6-3; 7-6(3),R32,94,4,0,37,74,26,37,25,37,4,5,11,51,74,3,5,44,68,32,44,10,24,4,6,10,42,68
2007-10-07 00:00:00.000,Vienna Austria ATP World Tour,HARD,2,Juan Carlos Ferrero,Guillermo Canas,Juan Carlos Ferrero,3-6; 6-3; 7-6(5),R32,184,5,4,81,124,50,81,25,43,11,14,15,75,124,8,5,51,102,38,51,25,51,3,6,15,63,102
2007-10-07 00:00:00.000,Vienna Austria ATP World Tour,HARD,2,Julien Benneteau,Ivo Minar,Julien Benneteau,6-4; 6-2,R32,68,2,1,38,52,27,38,9,14,3,4,9,36,52,3,2,41,67,24,41,13,26,6,10,9,37,67
2007-10-07 00:00:00.000,Vienna Austria ATP World Tour,HARD,2,Jiri Vanek,Roko Karanusic,Jiri Vanek,6-7(1); 6-4; 7-6(3),R32,135,8,1,70,105,51,70,22,35,1,2,17,73,105,4,1,65,105,50,65,23,40,2,4,17,73,105
2007-10-07 00:00:00.000,Vienna Austria ATP World Tour,HARD,2,Fernando Gonzalez,Filippo Volandri,Fernando Gonzalez,3-6; 6-1; 6-3,R32,91,3,4,35,61,27,35,16,26,1,3,12,43,61,1,2,40,73,25,40,12,33,3,8,13,37,73
2007-10-07 00:00:00.000,Vienna Austria ATP World Tour,HARD,2,Novak Djokovic,Tomas Zib,Novak Djokovic,6-4; 6-4,R16,77,7,1,24,47,22,24,14,23,0,1,10,36,47,0,0,30,58,20,30,13,28,1,4,10,33,58
2007-10-07 00:00:00.000,Vienna Austria ATP World Tour,HARD,2,Juan Ignacio Chela,Jurgen Melzer,Juan Ignacio Chela,4-6; 6-3; 6-2,R16,120,2,0,49,82,33,49,22,33,4,7,14,55,82,10,4,78,107,52,78,7,29,11,16,13,59,107
2007-10-07 00:00:00.000,Vienna Austria ATP World Tour,HARD,2,Ivan Ljubicic,Mardy Fish,Ivan Ljubicic,6-7(4); 6-2; 7-6(4),R16,146,17,3,63,102,54,63,24,39,4,4,16,78,102,17,3,60,110,46,60,29,50,8,10,16,75,110
2007-10-07 00:00:00.000,Vienna Austria ATP World Tour,HARD,2,Andreas Seppi,Robin Haase,Andreas Seppi,7-5; 6-3,R16,87,3,1,44,74,29,44,17,30,3,5,11,46,74,5,1,30,55,23,30,10,25,3,7,10,33,55
2007-10-07 00:00:00.000,Vienna Austria ATP World Tour,HARD,2,Feliciano Lopez,Stefan Koubek,Feliciano Lopez,6-4; 3-6; 6-4,R16,126,14,8,58,101,46,58,21,43,5,6,14,67,101,8,3,59,97,48,59,15,38,8,10,15,63,97
2007-10-07 00:00:00.000,Vienna Austria ATP World Tour,HARD,2,Stanislas Wawrinka,David Nalbandian,Stanislas Wawrinka,5-7; 6-3; 6-1,R16,124,7,6,48,84,33,48,17,36,5,9,14,50,84,2,4,51,82,33,51,8,31,3,10,14,41,82
2007-10-07 00:00:00.000,Vienna Austria ATP World Tour,HARD,2,Juan Carlos Ferrero,Julien Benneteau,Juan Carlos Ferrero,7-6(2); 1-6; 6-2,R16,133,3,0,62,91,46,62,14,29,3,5,13,60,91,9,4,64,88,51,64,8,24,3,5,14,59,88
2007-10-07 00:00:00.000,Vienna Austria ATP World Tour,HARD,2,Fernando Gonzalez,Jiri Vanek,Fernando Gonzalez,6-3; 6-4,R16,56,8,1,31,49,27,31,13,18,0,0,10,40,49,3,1,33,51,24,33,7,18,1,3,9,31,51
2007-10-07 00:00:00.000,Vienna Austria ATP World Tour,HARD,2,Novak Djokovic,Juan Ignacio Chela,Novak Djokovic,6-3; 5-7; 7-6(2),Q,174,7,1,75,128,54,75,31,53,12,14,17,85,128,6,4,62,108,50,62,20,46,5,7,16,70,108
2007-10-07 00:00:00.000,Vienna Austria ATP World Tour,HARD,2,Andreas Seppi,Ivan Ljubicic,Andreas Seppi,6-3; 6-3,Q,79,3,3,32,63,23,32,18,31,2,2,9,41,63,8,1,27,50,18,27,12,23,0,3,9,30,50
2007-10-07 00:00:00.000,Vienna Austria ATP World Tour,HARD,2,Stanislas Wawrinka,Feliciano Lopez,Stanislas Wawrinka,6-7(8); 6-3; 6-4,Q,150,6,2,57,104,44,57,30,47,8,9,16,74,104,4,6,53,98,37,53,27,45,4,7,15,64,98
2007-10-07 00:00:00.000,Vienna Austria ATP World Tour,HARD,2,Juan Carlos Ferrero,Fernando Gonzalez,Juan Carlos Ferrero,6-3; 4-6; 6-4,Q,120,3,1,62,86,49,62,12,24,3,4,15,61,86,8,2,56,97,35,56,26,41,5,7,14,61,97
2007-10-07 00:00:00.000,Vienna Austria ATP World Tour,HARD,2,Novak Djokovic,Andreas Seppi,Novak Djokovic,6-4; 6-3,S,106,4,2,48,78,37,48,12,30,6,7,10,49,78,1,2,33,56,22,33,9,23,4,7,9,31,56
2007-10-07 00:00:00.000,Vienna Austria ATP World Tour,HARD,2,Stanislas Wawrinka,Juan Carlos Ferrero,Stanislas Wawrinka,7-5; 6-1,S,99,11,4,44,73,30,44,15,29,3,5,10,45,73,2,0,40,65,22,40,11,25,6,11,9,33,65
2007-10-07 00:00:00.000,Vienna Austria ATP World Tour,HARD,2,Novak Djokovic,Stanislas Wawrinka,Novak Djokovic,6-4; 6-0,F,76,1,0,33,46,26,33,9,13,1,1,8,35,46,2,2,36,55,24,36,4,19,4,8,8,28,55
2007-10-08 00:00:00.000,Moscow Russia ATP World Tour,HARD,2,Nikolay Davydenko,Jo-Wilfried Tsonga,Nikolay Davydenko,7-6(0); 6-2,R32,88,2,2,39,60,29,39,15,21,3,4,10,44,60,5,3,51,73,29,51,12,22,3,6,10,41,73
2007-10-08 00:00:00.000,Moscow Russia ATP World Tour,HARD,2,Nicolas Lapentti,Fabrice Santoro,Nicolas Lapentti,3-6; 6-3; 6-2,R32,123,5,1,53,84,35,53,20,31,2,3,13,55,84,6,3,41,79,29,41,19,38,5,8,13,48,79
2007-10-08 00:00:00.000,Moscow Russia ATP World Tour,HARD,2,Igor Andreev,Nicolas Mahut,Igor Andreev,6-3; 6-4,R32,58,8,0,33,46,30,33,10,13,0,0,10,40,46,4,1,21,44,18,21,12,23,0,2,9,30,44
2007-10-08 00:00:00.000,Moscow Russia ATP World Tour,HARD,2,Marat Safin,Denis Matsukevich,Marat Safin,7-6(2); 7-5,R32,106,7,0,40,72,30,40,24,32,1,2,12,54,72,4,2,58,93,40,58,17,35,8,10,12,57,93
2007-10-08 00:00:00.000,Moscow Russia ATP World Tour,HARD,2,Andy Murray,Evgeny Korolev,Andy Murray,6-2; 6-4,R32,72,5,4,29,53,22,29,16,24,1,1,9,38,53,6,0,38,62,24,38,11,24,7,10,9,35,62
2007-10-08 00:00:00.000,Moscow Russia ATP World Tour,HARD,2,Janko Tipsarevic,Sergio Roitman,Janko Tipsarevic,3-6; 6-4; 6-4,R32,105,8,1,37,79,31,37,24,42,0,3,15,55,79,7,2,57,91,39,57,16,34,5,8,14,55,91
2007-10-08 00:00:00.000,Moscow Russia ATP World Tour,HARD,2,Radek Stepanek,Teymuraz Gabashvili,Radek Stepanek,7-5; 6-3,R32,84,9,0,50,67,38,50,11,17,5,5,11,49,67,5,3,41,65,29,41,11,24,3,5,10,40,65
2007-10-08 00:00:00.000,Moscow Russia ATP World Tour,HARD,2,Dmitry Tursunov,Mischa Zverev,Dmitry Tursunov,6-4; 3-6; 6-4,R32,104,11,3,52,91,38,52,23,39,3,5,15,61,91,3,0,56,83,44,56,14,27,2,4,14,58,83
2007-10-08 00:00:00.000,Moscow Russia ATP World Tour,HARD,2,Florent Serra,Potito Starace,Florent Serra,4-6; 6-4; 6-3,R32,105,6,0,74,103,49,74,16,29,7,10,15,65,103,2,2,53,78,33,53,15,25,3,7,14,48,78
2007-10-08 00:00:00.000,Moscow Russia ATP World Tour,HARD,2,Kristof Vliegen,Viktor Troicki,Kristof Vliegen,6-3; 2-2 RET,R32,55,2,0,28,38,25,28,5,10,0,0,7,30,38,5,1,28,45,19,28,6,17,3,4,6,25,45
2007-10-08 00:00:00.000,Moscow Russia ATP World Tour,HARD,2,Igor Kunitsyn,Diego Hartfield,Igor Kunitsyn,7-6(1); 1-6; 6-1,R32,125,3,3,53,90,40,53,13,37,6,11,13,53,90,3,6,63,92,38,63,12,29,6,11,13,50,92
2007-10-08 00:00:00.000,Moscow Russia ATP World Tour,HARD,2,Paul-Henri Mathieu,Sebastien Grosjean,Paul-Henri Mathieu,6-2; 6-2,R32,70,6,0,25,49,21,25,12,24,2,3,8,33,49,0,0,27,50,14,27,9,23,2,7,8,23,50
2007-10-08 00:00:00.000,Moscow Russia ATP World Tour,HARD,2,Philipp Kohlschreiber,Justin Gimelstob,Philipp Kohlschreiber,6-1; 6-3,R32,53,7,2,25,50,23,25,12,25,2,2,8,35,50,2,2,22,37,12,22,6,15,1,5,8,18,37
2007-10-08 00:00:00.000,Moscow Russia ATP World Tour,HARD,2,Marin Cilic,Simone Bolelli,Marin Cilic,6-3; 6-4,R32,69,6,5,28,55,25,28,14,27,5,5,9,39,55,2,1,31,52,20,31,11,21,1,4,10,31,52
2007-10-08 00:00:00.000,Moscow Russia ATP World Tour,HARD,2,Michael Berrer,Jose Acasuso,Michael Berrer,6-7(5); 7-5; 6-4,R32,137,12,2,60,104,52,60,27,44,7,7,17,79,104,15,7,67,111,55,67,21,44,7,9,17,76,111
2007-10-08 00:00:00.000,Moscow Russia ATP World Tour,HARD,2,Mikhail Youzhny,Ernests Gulbis,Mikhail Youzhny,6-3; 6-2,R32,78,5,0,32,57,26,32,15,25,3,3,9,41,57,5,5,39,66,25,39,10,27,8,11,8,35,66
2007-10-08 00:00:00.000,Moscow Russia ATP World Tour,HARD,2,Nikolay Davydenko,Nicolas Lapentti,Nikolay Davydenko,6-4; 6-4,R16,97,4,3,29,58,25,29,17,29,2,3,10,42,58,4,4,35,67,26,35,12,32,4,7,10,38,67
2007-10-08 00:00:00.000,Moscow Russia ATP World Tour,HARD,2,Igor Andreev,Marat Safin,Igor Andreev,6-4; 6-4,R16,75,2,1,43,62,35,43,11,19,3,3,10,46,62,4,3,36,61,26,36,12,25,0,2,10,38,61
2007-10-08 00:00:00.000,Moscow Russia ATP World Tour,HARD,2,Janko Tipsarevic,Andy Murray,Janko Tipsarevic,6-4; 7-5,R16,102,6,4,41,79,34,41,17,38,9,10,11,51,79,7,4,38,74,29,38,15,36,7,10,11,44,74
2007-10-08 00:00:00.000,Moscow Russia ATP World Tour,HARD,2,Radek Stepanek,Dmitry Tursunov,Radek Stepanek,3-6; 6-3; 6-1,R16,110,7,3,46,76,35,46,15,30,3,4,12,50,76,5,2,40,78,28,40,19,38,4,8,13,47,78
2007-10-08 00:00:00.000,Moscow Russia ATP World Tour,HARD,2,Florent Serra,Kristof Vliegen,Florent Serra,6-7(2); 6-4; 6-2,R16,120,4,0,64,109,49,64,23,45,7,7,15,72,109,13,0,61,87,44,61,14,26,2,5,15,58,87
2007-10-08 00:00:00.000,Moscow Russia ATP World Tour,HARD,2,Paul-Henri Mathieu,Igor Kunitsyn,Paul-Henri Mathieu,6-3; 6-4,R16,97,2,5,31,63,25,31,16,32,2,4,10,41,63,3,1,22,57,12,22,17,35,4,8,9,29,57
2007-10-08 00:00:00.000,Moscow Russia ATP World Tour,HARD,2,Philipp Kohlschreiber,Marin Cilic,Philipp Kohlschreiber,7-6(8); 1-6; 6-4,R16,139,3,3,66,111,47,66,23,45,6,10,15,70,111,10,1,57,96,45,57,19,39,4,6,14,64,96
2007-10-08 00:00:00.000,Moscow Russia ATP World Tour,HARD,2,Michael Berrer,Mikhail Youzhny,Michael Berrer,7-5; 6-4,R16,87,7,2,35,57,29,35,15,22,0,0,11,44,57,4,2,38,62,26,38,15,24,0,2,11,41,62
2007-10-08 00:00:00.000,Moscow Russia ATP World Tour,HARD,2,Nikolay Davydenko,Igor Andreev,Nikolay Davydenko,7-5; 7-5,Q,123,3,3,47,75,32,47,12,28,4,8,12,44,75,2,1,63,82,35,63,6,19,3,9,12,41,82
2007-10-08 00:00:00.000,Moscow Russia ATP World Tour,HARD,2,Janko Tipsarevic,Radek Stepanek,Janko Tipsarevic,6-4; 3-6; 6-3,Q,130,9,2,53,88,39,53,22,35,7,8,14,61,88,10,2,62,90,48,62,12,28,5,7,14,60,90
2007-10-08 00:00:00.000,Moscow Russia ATP World Tour,HARD,2,Paul-Henri Mathieu,Florent Serra,Paul-Henri Mathieu,6-3; 6-3,Q,81,10,0,33,63,24,33,19,30,4,4,9,43,63,2,0,32,53,17,32,14,21,1,4,9,31,53
2007-10-08 00:00:00.000,Moscow Russia ATP World Tour,HARD,2,Michael Berrer,Philipp Kohlschreiber,Michael Berrer,6-3 RET,Q,36,8,3,26,39,17,26,8,13,3,3,5,25,39,1,0,10,20,8,10,5,10,0,1,4,13,20
2007-10-08 00:00:00.000,Moscow Russia ATP World Tour,HARD,2,Nikolay Davydenko,Janko Tipsarevic,Nikolay Davydenko,7-6(6); 6-1,S,93,8,2,43,66,35,43,14,23,3,3,10,49,66,2,3,30,59,23,30,13,29,3,5,9,36,59
2007-10-08 00:00:00.000,Moscow Russia ATP World Tour,HARD,2,Paul-Henri Mathieu,Michael Berrer,Paul-Henri Mathieu,7-5; 6-3,S,89,7,3,35,67,32,35,17,32,1,1,11,49,67,8,2,41,55,28,41,8,14,2,4,10,36,55
2007-10-08 00:00:00.000,Moscow Russia ATP World Tour,HARD,2,Nikolay Davydenko,Paul-Henri Mathieu,Nikolay Davydenko,7-5; 7-6(9),F,155,3,9,68,94,43,68,8,26,8,12,12,51,94,7,3,46,98,32,46,18,52,6,11,12,50,98
2007-10-15 00:00:00.000,ATP Masters Series Madrid Spain ATP World Tour,HARD,2,Roger Federer,N/A Bye,Roger Federer,,R64,0,0,0,0,0,0,0,0,0,0,0,0,0,0,0,0,0,0,0,0,0,0,0,0,0,0,0
2007-10-15 00:00:00.000,ATP Masters Series Madrid Spain ATP World Tour,HARD,2,Robby Ginepri,Jurgen Melzer,Robby Ginepri,2-6; 7-6(2); 6-4,R64,117,4,3,64,99,40,64,23,35,4,7,15,63,99,4,2,61,89,43,61,16,28,4,6,15,59,89
2007-10-15 00:00:00.000,ATP Masters Series Madrid Spain ATP World Tour,HARD,2,Agustin Calleri,Dmitry Tursunov,Agustin Calleri,3-6; 7-6(4); 6-4,R64,108,9,2,44,83,35,44,28,39,0,1,15,63,83,6,2,53,91,43,53,23,38,0,1,16,66,91
2007-10-15 00:00:00.000,ATP Masters Series Madrid Spain ATP World Tour,HARD,2,Guillermo Canas,N/A Bye,Guillermo Canas,,R64,0,0,0,0,0,0,0,0,0,0,0,0,0,0,0,0,0,0,0,0,0,0,0,0,0,0,0
2007-10-15 00:00:00.000,ATP Masters Series Madrid Spain ATP World Tour,HARD,2,Ivan Ljubicic,N/A Bye,Ivan Ljubicic,,R64,0,0,0,0,0,0,0,0,0,0,0,0,0,0,0,0,0,0,0,0,0,0,0,0,0,0,0
2007-10-15 00:00:00.000,ATP Masters Series Madrid Spain ATP World Tour,HARD,2,Stefan Koubek,Jarkko Nieminen,Stefan Koubek,6-3; 3-6; 6-4,R64,98,5,3,42,78,32,42,18,36,3,7,14,50,78,3,4,63,94,37,63,16,31,8,13,14,53,94
2007-10-15 00:00:00.000,ATP Masters Series Madrid Spain ATP World Tour,HARD,2,Feliciano Lopez,Filippo Volandri,Feliciano Lopez,6-3; 6-2,R64,79,5,2,37,57,30,37,7,20,3,4,9,37,57,0,3,18,42,12,18,10,24,1,5,8,22,42
2007-10-15 00:00:00.000,ATP Masters Series Madrid Spain ATP World Tour,HARD,2,David Ferrer,N/A Bye,David Ferrer,,R64,0,0,0,0,0,0,0,0,0,0,0,0,0,0,0,0,0,0,0,0,0,0,0,0,0,0,0
2007-10-15 00:00:00.000,ATP Masters Series Madrid Spain ATP World Tour,HARD,2,Oscar Hernandez,N/A Bye,Oscar Hernandez,,R64,0,0,0,0,0,0,0,0,0,0,0,0,0,0,0,0,0,0,0,0,0,0,0,0,0,0,0
2007-10-15 00:00:00.000,ATP Masters Series Madrid Spain ATP World Tour,HARD,2,Ivo Karlovic,Marat Safin,Ivo Karlovic,6-3; 6-4,R64,58,17,2,38,53,34,38,7,15,2,2,10,41,53,3,2,26,47,21,26,12,21,2,4,9,33,47
2007-10-15 00:00:00.000,ATP Masters Series Madrid Spain ATP World Tour,HARD,2,Nicolas Kiefer,Stanislas Wawrinka,Nicolas Kiefer,7-5; 6-3,R64,98,3,2,40,68,28,40,19,28,4,5,11,47,68,1,1,45,67,25,45,13,22,2,5,10,38,67
2007-10-15 00:00:00.000,ATP Masters Series Madrid Spain ATP World Tour,HARD,2,Mikhail Youzhny,N/A Bye,Mikhail Youzhny,,R64,0,0,0,0,0,0,0,0,0,0,0,0,0,0,0,0,0,0,0,0,0,0,0,0,0,0,0
2007-10-15 00:00:00.000,ATP Masters Series Madrid Spain ATP World Tour,HARD,2,Tommy Haas,N/A Bye,Tommy Haas,,R64,0,0,0,0,0,0,0,0,0,0,0,0,0,0,0,0,0,0,0,0,0,0,0,0,0,0,0
2007-10-15 00:00:00.000,ATP Masters Series Madrid Spain ATP World Tour,HARD,2,Juan Monaco,Igor Andreev,Juan Monaco,6-7(5); 6-0; 6-4,R64,240,3,1,77,104,53,77,16,27,10,11,14,69,104,5,3,70,100,44,70,13,30,6,11,14,57,100
2007-10-15 00:00:00.000,ATP Masters Series Madrid Spain ATP World Tour,HARD,2,Nicolas Almagro,Fabrice Santoro,Nicolas Almagro,6-4; 6-4,R64,79,7,1,38,56,29,38,11,18,1,2,10,40,56,4,2,30,59,19,30,16,29,3,6,10,35,59
2007-10-15 00:00:00.000,ATP Masters Series Madrid Spain ATP World Tour,HARD,2,Fernando Gonzalez,N/A Bye,Fernando Gonzalez,,R64,0,0,0,0,0,0,0,0,0,0,0,0,0,0,0,0,0,0,0,0,0,0,0,0,0,0,0
2007-10-15 00:00:00.000,ATP Masters Series Madrid Spain ATP World Tour,HARD,2,James Blake,N/A Bye,James Blake,,R64,0,0,0,0,0,0,0,0,0,0,0,0,0,0,0,0,0,0,0,0,0,0,0,0,0,0,0
2007-10-15 00:00:00.000,ATP Masters Series Madrid Spain ATP World Tour,HARD,2,Mario Ancic,Marc Gicquel,Mario Ancic,6-4; 6-2,R64,71,11,0,27,43,26,27,10,16,0,0,9,36,43,6,3,25,47,19,25,10,22,3,6,9,29,47
2007-10-15 00:00:00.000,ATP Masters Series Madrid Spain ATP World Tour,HARD,2,Paul-Henri Mathieu,Mardy Fish,Paul-Henri Mathieu,6-3; 2-6; 7-5,R64,130,12,4,49,85,38,49,18,36,2,4,14,56,85,19,2,52,95,42,52,15,43,5,8,15,57,95
2007-10-15 00:00:00.000,ATP Masters Series Madrid Spain ATP World Tour,HARD,2,Richard Gasquet,N/A Bye,Richard Gasquet,,R64,0,0,0,0,0,0,0,0,0,0,0,0,0,0,0,0,0,0,0,0,0,0,0,0,0,0,0
2007-10-15 00:00:00.000,ATP Masters Series Madrid Spain ATP World Tour,HARD,2,Carlos Moya,N/A Bye,Carlos Moya,,R64,0,0,0,0,0,0,0,0,0,0,0,0,0,0,0,0,0,0,0,0,0,0,0,0,0,0,0
2007-10-15 00:00:00.000,ATP Masters Series Madrid Spain ATP World Tour,HARD,2,Juan Carlos Ferrero,Alejandro Falla,Juan Carlos Ferrero,6-4; 7-5,R64,96,2,2,43,75,26,43,19,32,4,6,11,45,75,2,2,39,61,26,39,10,22,2,6,11,36,61
2007-10-15 00:00:00.000,ATP Masters Series Madrid Spain ATP World Tour,HARD,2,Fernando Verdasco,Albert Montanes,Fernando Verdasco,6-1; 6-1,R64,56,3,1,32,45,24,32,8,13,3,3,7,32,45,1,6,27,55,14,27,12,28,7,12,7,26,55
2007-10-15 00:00:00.000,ATP Masters Series Madrid Spain ATP World Tour,HARD,2,Novak Djokovic,N/A Bye,Novak Djokovic,,R64,0,0,0,0,0,0,0,0,0,0,0,0,0,0,0,0,0,0,0,0,0,0,0,0,0,0,0
2007-10-15 00:00:00.000,ATP Masters Series Madrid Spain ATP World Tour,HARD,2,Tommy Robredo,N/A Bye,Tommy Robredo,,R64,0,0,0,0,0,0,0,0,0,0,0,0,0,0,0,0,0,0,0,0,0,0,0,0,0,0,0
2007-10-15 00:00:00.000,ATP Masters Series Madrid Spain ATP World Tour,HARD,2,Juan Martin Del Potro,Potito Starace,Juan Martin Del Potro,7-5; 6-1,R64,78,10,1,35,51,27,35,12,16,1,2,10,39,51,1,2,31,58,14,31,16,27,3,7,9,30,58
2007-10-15 00:00:00.000,ATP Masters Series Madrid Spain ATP World Tour,HARD,2,David Nalbandian,Arnaud Clement,David Nalbandian,5-7; 6-2; 6-4,R64,137,14,4,51,96,35,51,24,45,6,9,15,59,96,6,4,35,83,25,35,22,48,2,7,15,47,83
2007-10-15 00:00:00.000,ATP Masters Series Madrid Spain ATP World Tour,HARD,2,Tomas Berdych,N/A Bye,Tomas Berdych,,R64,0,0,0,0,0,0,0,0,0,0,0,0,0,0,0,0,0,0,0,0,0,0,0,0,0,0,0
2007-10-15 00:00:00.000,ATP Masters Series Madrid Spain ATP World Tour,HARD,2,Juan Ignacio Chela,N/A Bye,Juan Ignacio Chela,,R64,0,0,0,0,0,0,0,0,0,0,0,0,0,0,0,0,0,0,0,0,0,0,0,0,0,0,0
2007-10-15 00:00:00.000,ATP Masters Series Madrid Spain ATP World Tour,HARD,2,Andy Murray,Radek Stepanek,Andy Murray,6-4; 6-1,R64,63,6,1,24,44,22,24,14,20,0,0,9,36,44,2,2,39,58,22,39,11,19,11,14,8,33,58
2007-10-15 00:00:00.000,ATP Masters Series Madrid Spain ATP World Tour,HARD,2,Marcos Baghdatis,Andrei Pavel,Marcos Baghdatis,6-3; 4-6; 6-1,R64,120,5,1,48,81,36,48,16,33,1,3,13,52,81,11,5,52,86,39,52,10,34,6,11,13,49,86
2007-10-15 00:00:00.000,ATP Masters Series Madrid Spain ATP World Tour,HARD,2,Rafael Nadal,N/A Bye,Rafael Nadal,,R64,0,0,0,0,0,0,0,0,0,0,0,0,0,0,0,0,0,0,0,0,0,0,0,0,0,0,0
2007-10-15 00:00:00.000,ATP Masters Series Madrid Spain ATP World Tour,HARD,2,Roger Federer,Robby Ginepri,Roger Federer,7-6(2); 6-4,R32,86,11,1,44,70,35,44,18,26,3,3,11,53,70,1,1,42,73,30,42,18,31,3,4,11,48,73
2007-10-15 00:00:00.000,ATP Masters Series Madrid Spain ATP World Tour,HARD,2,Guillermo Canas,Agustin Calleri,Guillermo Canas,6-3; 3-6; 7-5,R32,143,9,2,55,88,38,55,19,33,5,8,15,57,88,14,6,60,104,47,60,16,44,8,12,15,63,104
2007-10-15 00:00:00.000,ATP Masters Series Madrid Spain ATP World Tour,HARD,2,Stefan Koubek,Ivan Ljubicic,Stefan Koubek,6-3; 6-7(2); 7-5,R32,136,8,3,64,103,47,64,26,39,3,3,17,73,103,23,3,58,90,49,58,15,32,1,3,16,64,90
2007-10-15 00:00:00.000,ATP Masters Series Madrid Spain ATP World Tour,HARD,2,Feliciano Lopez,David Ferrer,Feliciano Lopez,7-6(3); 7-5,R32,108,9,3,41,84,30,41,27,43,3,4,12,57,84,3,2,43,78,31,43,19,35,0,2,12,50,78
2007-10-15 00:00:00.000,ATP Masters Series Madrid Spain ATP World Tour,HARD,2,Ivo Karlovic,Oscar Hernandez,Ivo Karlovic,7-5; 6-2,R32,73,20,2,36,50,32,36,9,14,0,0,10,41,50,0,2,36,59,22,36,13,23,6,9,10,35,59
2007-10-15 00:00:00.000,ATP Masters Series Madrid Spain ATP World Tour,HARD,2,Nicolas Kiefer,Mikhail Youzhny,Nicolas Kiefer,6-1; 6-3,R32,66,6,1,28,44,26,28,7,16,1,1,8,33,44,2,1,30,49,15,30,9,19,2,6,8,24,49
2007-10-15 00:00:00.000,ATP Masters Series Madrid Spain ATP World Tour,HARD,2,Juan Monaco,Tommy Haas,Juan Monaco,6-4; 7-5,R32,85,4,3,40,63,30,40,15,23,3,4,11,45,63,5,3,48,74,33,48,11,26,5,8,11,44,74
2007-10-15 00:00:00.000,ATP Masters Series Madrid Spain ATP World Tour,HARD,2,Fernando Gonzalez,Nicolas Almagro,Fernando Gonzalez,7-6(11); 7-5,R32,97,7,1,52,75,42,52,14,23,1,2,12,56,75,11,1,60,86,42,60,14,26,5,7,12,56,86
2007-10-15 00:00:00.000,ATP Masters Series Madrid Spain ATP World Tour,HARD,2,Mario Ancic,James Blake,Mario Ancic,6-3; 6-4,R32,69,7,3,36,57,32,36,10,21,1,1,10,42,57,5,4,31,54,26,31,9,23,2,4,9,35,54
2007-10-15 00:00:00.000,ATP Masters Series Madrid Spain ATP World Tour,HARD,2,Paul-Henri Mathieu,Richard Gasquet,Paul-Henri Mathieu,7-6(8); 7-5,R32,133,4,2,44,91,28,44,31,47,7,8,12,59,91,7,0,43,80,32,43,21,37,1,3,12,53,80
2007-10-15 00:00:00.000,ATP Masters Series Madrid Spain ATP World Tour,HARD,2,Juan Carlos Ferrero,Carlos Moya,Juan Carlos Ferrero,7-6(2); 6-4,R32,104,6,0,45,65,36,45,12,20,3,5,11,48,65,8,5,49,86,31,49,17,37,12,15,11,48,86
2007-10-15 00:00:00.000,ATP Masters Series Madrid Spain ATP World Tour,HARD,2,Novak Djokovic,Fernando Verdasco,Novak Djokovic,6-7(7); 6-3; 6-3,R32,154,6,4,61,112,47,61,28,51,10,10,15,75,112,2,4,67,90,49,67,9,23,2,5,15,58,90
2007-10-15 00:00:00.000,ATP Masters Series Madrid Spain ATP World Tour,HARD,2,Juan Martin Del Potro,Tommy Robredo,Juan Martin Del Potro,6-7(4); 6-4; 6-3,R32,152,7,2,55,91,42,55,23,36,1,2,15,65,91,10,0,70,109,49,70,20,39,5,9,16,69,109
2007-10-15 00:00:00.000,ATP Masters Series Madrid Spain ATP World Tour,HARD,2,David Nalbandian,Tomas Berdych,David Nalbandian,4-6; 6-4; 7-6(2),R32,130,9,2,59,100,46,59,20,41,4,8,16,66,100,12,2,51,92,39,51,18,41,0,4,16,57,92
2007-10-15 00:00:00.000,ATP Masters Series Madrid Spain ATP World Tour,HARD,2,Andy Murray,Juan Ignacio Chela,Andy Murray,6-1; 6-3,R32,66,6,3,28,50,22,28,11,22,2,3,8,33,50,0,3,27,56,16,27,9,29,4,9,8,25,56
2007-10-15 00:00:00.000,ATP Masters Series Madrid Spain ATP World Tour,HARD,2,Rafael Nadal,Marcos Baghdatis,Rafael Nadal,6-4; 6-4,R32,98,1,0,29,55,24,29,15,26,4,5,10,39,55,5,2,31,59,22,31,13,28,2,5,10,35,59
2007-10-15 00:00:00.000,ATP Masters Series Madrid Spain ATP World Tour,HARD,2,Roger Federer,Guillermo Canas,Roger Federer,6-0; 6-3,R16,53,4,1,26,41,22,26,10,15,0,0,8,32,41,5,2,35,50,21,35,3,15,4,8,7,24,50
2007-10-15 00:00:00.000,ATP Masters Series Madrid Spain ATP World Tour,HARD,2,Feliciano Lopez,Stefan Koubek,Feliciano Lopez,7-6(9); 6-1,R16,83,7,2,32,61,27,32,18,29,0,1,10,45,61,4,2,36,66,20,36,18,30,0,3,9,38,66
2007-10-15 00:00:00.000,ATP Masters Series Madrid Spain ATP World Tour,HARD,2,Nicolas Kiefer,Ivo Karlovic,Nicolas Kiefer,7-6(5); 7-6(3),R16,105,4,6,41,76,38,41,23,35,2,2,12,61,76,22,2,61,78,49,61,9,17,3,3,12,58,78
2007-10-15 00:00:00.000,ATP Masters Series Madrid Spain ATP World Tour,HARD,2,Fernando Gonzalez,Juan Monaco,Fernando Gonzalez,6-4; 6-2,R16,69,1,2,38,55,29,38,10,17,1,1,9,39,55,0,3,38,53,24,38,5,15,0,3,9,29,53
2007-10-15 00:00:00.000,ATP Masters Series Madrid Spain ATP World Tour,HARD,2,Mario Ancic,Paul-Henri Mathieu,Mario Ancic,6-4; 6-3,R16,94,11,1,32,52,27,32,13,20,0,0,10,40,52,6,2,40,66,27,40,14,26,8,10,9,41,66
2007-10-15 00:00:00.000,ATP Masters Series Madrid Spain ATP World Tour,HARD,2,Novak Djokovic,Juan Carlos Ferrero,Novak Djokovic,6-3; 2-6; 6-4,R16,133,4,2,49,82,36,49,18,33,2,4,14,54,82,8,2,50,88,34,50,21,38,8,10,13,55,88
2007-10-15 00:00:00.000,ATP Masters Series Madrid Spain ATP World Tour,HARD,2,David Nalbandian,Juan Martin Del Potro,David Nalbandian,6-2; 6-4,R16,95,5,1,46,69,33,46,10,23,4,5,9,43,69,6,4,37,67,26,37,9,30,6,10,9,35,67
2007-10-15 00:00:00.000,ATP Masters Series Madrid Spain ATP World Tour,HARD,2,Rafael Nadal,Andy Murray,Rafael Nadal,7-6(5); 6-4,R16,137,2,1,60,87,36,60,13,27,9,12,11,49,87,9,2,45,85,28,45,19,40,10,14,11,47,85
2007-10-15 00:00:00.000,ATP Masters Series Madrid Spain ATP World Tour,HARD,2,Roger Federer,Feliciano Lopez,Roger Federer,7-6(4); 6-4,Q,96,8,1,33,56,29,33,18,23,0,0,11,47,56,11,3,56,94,40,56,17,38,10,11,11,57,94
2007-10-15 00:00:00.000,ATP Masters Series Madrid Spain ATP World Tour,HARD,2,Nicolas Kiefer,Fernando Gonzalez,Nicolas Kiefer,7-6(5); 6-2,Q,99,3,1,44,70,32,44,16,26,3,4,10,48,70,3,2,44,65,31,44,9,21,5,8,10,40,65
2007-10-15 00:00:00.000,ATP Masters Series Madrid Spain ATP World Tour,HARD,2,Novak Djokovic,Mario Ancic,Novak Djokovic,7-6(2); 6-2,Q,105,8,4,38,70,33,38,18,32,6,6,10,51,70,6,2,38,65,30,38,12,27,0,2,10,42,65
2007-10-15 00:00:00.000,ATP Masters Series Madrid Spain ATP World Tour,HARD,2,David Nalbandian,Rafael Nadal,David Nalbandian,6-1; 6-2,Q,71,1,2,18,38,17,18,12,20,0,0,7,29,38,0,1,35,53,19,35,5,18,3,8,8,24,53
2007-10-15 00:00:00.000,ATP Masters Series Madrid Spain ATP World Tour,HARD,2,Roger Federer,Nicolas Kiefer,Roger Federer,6-4; 6-4,S,84,10,0,34,51,31,34,10,17,1,1,10,41,51,4,3,37,72,26,37,19,35,10,12,10,45,72
2007-10-15 00:00:00.000,ATP Masters Series Madrid Spain ATP World Tour,HARD,2,David Nalbandian,Novak Djokovic,David Nalbandian,6-4; 7-6(4),S,105,8,0,41,68,35,41,15,27,2,2,11,50,68,9,5,47,81,34,47,16,34,4,5,11,50,81
2007-10-15 00:00:00.000,ATP Masters Series Madrid Spain ATP World Tour,HARD,2,David Nalbandian,Roger Federer,David Nalbandian,1-6; 6-3; 6-3,F,109,4,2,40,75,30,40,18,35,3,5,12,48,75,8,1,48,81,36,48,15,33,2,5,13,51,81
2007-10-22 00:00:00.000,Basel Switzerland ATP World Tour,HARD,2,Roger Federer,Michael Berrer,Roger Federer,6-1; 3-6; 6-3,R32,88,11,0,43,69,36,43,14,26,3,5,13,50,69,5,5,44,75,29,44,15,31,7,11,12,44,75
2007-10-22 00:00:00.000,Basel Switzerland ATP World Tour,HARD,2,Juan Martin Del Potro,Michael Russell,Juan Martin Del Potro,5-2 RET,R32,34,7,1,12,17,9,12,3,5,0,0,3,12,17,1,2,14,26,9,14,3,12,0,2,4,12,26
2007-10-22 00:00:00.000,Basel Switzerland ATP World Tour,HARD,2,Nicolas Kiefer,Carlos Berlocq,Nicolas Kiefer,6-1; 6-1,R32,64,6,0,18,33,17,18,11,15,0,0,7,28,33,3,3,37,59,20,37,8,22,7,12,7,28,59
2007-10-22 00:00:00.000,Basel Switzerland ATP World Tour,HARD,2,Stefan Koubek,Juan Ignacio Chela,Stefan Koubek,6-3; 6-4,R32,56,2,1,27,53,19,27,15,26,0,2,10,34,53,0,3,36,52,22,36,7,16,1,5,9,29,52
2007-10-22 00:00:00.000,Basel Switzerland ATP World Tour,HARD,2,James Blake,Oscar Hernandez,James Blake,6-3; 6-4,R32,62,8,1,31,46,29,31,11,15,0,0,10,40,46,4,1,33,55,28,33,5,22,1,3,9,33,55
2007-10-22 00:00:00.000,Basel Switzerland ATP World Tour,HARD,2,Ivo Karlovic,Marco Chiudinelli,Ivo Karlovic,6-3; 6-2,R32,69,16,0,29,42,24,29,8,13,0,0,8,32,42,3,2,37,61,22,37,11,24,6,10,9,33,61
2007-10-22 00:00:00.000,Basel Switzerland ATP World Tour,HARD,2,Stanislas Wawrinka,David Nalbandian,Stanislas Wawrinka,7-6(5); 6-2,R32,88,14,0,36,62,33,36,15,26,1,1,10,48,62,4,1,33,62,24,33,17,29,1,3,10,41,62
2007-10-22 00:00:00.000,Basel Switzerland ATP World Tour,HARD,2,Tomas Berdych,Feliciano Lopez,Tomas Berdych,7-6(4); 3-6; 6-3,R32,108,15,3,54,94,43,54,24,40,3,4,15,67,94,14,0,66,86,50,66,14,20,2,3,15,64,86
2007-10-22 00:00:00.000,Basel Switzerland ATP World Tour,HARD,2,Paul-Henri Mathieu,Frank Dancevic,Paul-Henri Mathieu,6-3; 6-1,R32,59,3,2,21,45,18,21,16,24,0,0,8,34,45,11,0,47,61,24,47,6,14,8,12,8,30,61
2007-10-22 00:00:00.000,Basel Switzerland ATP World Tour,HARD,2,Andrey Golubev,Amer Delic,Andrey Golubev,6-4; 6-3,R32,64,1,1,34,54,27,34,14,20,0,0,10,41,54,4,2,33,53,24,33,9,20,3,5,9,33,53
2007-10-22 00:00:00.000,Basel Switzerland ATP World Tour,HARD,2,Marcos Baghdatis,Albert Montanes,Marcos Baghdatis,6-2; 6-2,R32,66,4,2,20,43,16,20,17,23,0,0,8,33,43,1,5,39,66,21,39,12,27,7,11,8,33,66
2007-10-22 00:00:00.000,Basel Switzerland ATP World Tour,HARD,2,Agustin Calleri,David Ferrer,Agustin Calleri,6-4; 7-6(3),R32,100,10,2,34,60,28,34,12,26,1,4,11,40,60,7,2,53,89,34,53,16,36,7,11,11,50,89
2007-10-22 00:00:00.000,Basel Switzerland ATP World Tour,HARD,2,Guillermo Canas,Jose Acasuso,Guillermo Canas,6-4; 6-3,R32,88,6,1,32,61,25,32,20,29,2,2,10,45,61,4,0,30,54,21,30,15,24,3,5,9,36,54
2007-10-22 00:00:00.000,Basel Switzerland ATP World Tour,HARD,2,Jarkko Nieminen,Robby Ginepri,Jarkko Nieminen,3-6; 6-4; 7-5,R32,115,7,6,56,88,33,56,15,32,4,10,15,48,88,11,1,79,109,46,79,14,30,11,18,16,60,109
2007-10-22 00:00:00.000,Basel Switzerland ATP World Tour,HARD,2,Roko Karanusic,Julian Reister,Roko Karanusic,6-0; 6-3,R32,56,1,0,30,42,22,30,9,12,2,2,7,31,42,0,1,29,42,15,29,3,13,4,9,8,18,42
2007-10-22 00:00:00.000,Basel Switzerland ATP World Tour,HARD,2,Fernando Gonzalez,Jerome Haehnel,Fernando Gonzalez,7-6(5); 6-4,R32,91,10,4,44,70,33,44,12,26,1,3,11,45,70,1,4,41,74,27,41,16,33,3,6,11,43,74
2007-10-22 00:00:00.000,Basel Switzerland ATP World Tour,HARD,2,Roger Federer,Juan Martin Del Potro,Roger Federer,6-1; 6-4,R16,58,10,1,34,51,27,34,10,17,2,3,9,37,51,2,1,33,46,18,33,5,13,5,9,8,23,46
2007-10-22 00:00:00.000,Basel Switzerland ATP World Tour,HARD,2,Nicolas Kiefer,Stefan Koubek,Nicolas Kiefer,6-3; 6-2,R16,69,9,0,32,48,27,32,10,16,0,0,9,37,48,2,1,33,49,20,33,5,16,5,8,8,25,49
2007-10-22 00:00:00.000,Basel Switzerland ATP World Tour,HARD,2,Ivo Karlovic,James Blake,Ivo Karlovic,4-6; 7-6(4); 6-4,R16,119,24,1,63,96,52,63,19,33,1,2,16,71,96,9,2,58,92,50,58,18,34,3,4,16,68,92
2007-10-22 00:00:00.000,Basel Switzerland ATP World Tour,HARD,2,Tomas Berdych,Stanislas Wawrinka,Tomas Berdych,7-5; 6-4,R16,87,22,2,45,71,40,45,12,26,4,4,11,52,71,7,4,35,57,30,35,10,22,1,3,11,40,57
2007-10-22 00:00:00.000,Basel Switzerland ATP World Tour,HARD,2,Paul-Henri Mathieu,Andrey Golubev,Paul-Henri Mathieu,6-7(7); 6-4; 6-1,R16,136,2,2,54,92,44,54,17,38,3,5,14,61,92,10,8,64,119,46,64,20,55,11,17,15,66,119
2007-10-22 00:00:00.000,Basel Switzerland ATP World Tour,HARD,2,Marcos Baghdatis,Agustin Calleri,Marcos Baghdatis,6-7(1); 6-3; 6-3,R16,122,6,8,49,92,39,49,23,43,2,4,15,62,92,6,10,59,100,40,59,18,41,4,9,15,58,100
2007-10-22 00:00:00.000,Basel Switzerland ATP World Tour,HARD,2,Jarkko Nieminen,Guillermo Canas,Jarkko Nieminen,6-4; 3-6; 7-5,R16,134,1,2,65,91,44,65,14,26,1,4,15,58,91,9,2,54,100,38,54,24,46,4,8,16,62,100
2007-10-22 00:00:00.000,Basel Switzerland ATP World Tour,HARD,2,Fernando Gonzalez,Roko Karanusic,Fernando Gonzalez,6-4; 7-6(5),R16,104,3,2,55,91,35,55,19,36,11,14,11,54,91,0,2,41,72,25,41,14,31,5,9,11,39,72
2007-10-22 00:00:00.000,Basel Switzerland ATP World Tour,HARD,2,Roger Federer,Nicolas Kiefer,Roger Federer,6-3; 6-2,Q,71,1,1,33,56,23,33,15,23,3,4,9,38,56,4,3,24,49,17,24,8,25,5,9,8,25,49
2007-10-22 00:00:00.000,Basel Switzerland ATP World Tour,HARD,2,Ivo Karlovic,Tomas Berdych,Ivo Karlovic,6-7(5); 7-6(2); 7-6(13),Q,157,38,3,94,123,81,94,18,29,1,1,18,99,123,14,1,82,125,68,82,26,43,2,2,18,94,125
2007-10-22 00:00:00.000,Basel Switzerland ATP World Tour,HARD,2,Marcos Baghdatis,Paul-Henri Mathieu,Marcos Baghdatis,6-2; 7-6(5),Q,97,13,0,40,73,29,40,21,33,4,4,10,50,73,5,2,41,68,28,41,13,27,7,9,10,41,68
2007-10-22 00:00:00.000,Basel Switzerland ATP World Tour,HARD,2,Jarkko Nieminen,Fernando Gonzalez,Jarkko Nieminen,6-3; 7-5,Q,91,0,0,66,82,43,66,10,16,3,4,11,53,82,5,2,32,55,22,32,11,23,1,4,10,33,55
2007-10-22 00:00:00.000,Basel Switzerland ATP World Tour,HARD,2,Roger Federer,Ivo Karlovic,Roger Federer,7-6(6); 7-6(5),S,98,10,1,57,81,47,57,17,24,1,1,12,64,81,16,1,53,79,48,53,12,26,2,2,12,60,79
2007-10-22 00:00:00.000,Basel Switzerland ATP World Tour,HARD,2,Jarkko Nieminen,Marcos Baghdatis,Jarkko Nieminen,7-6(4); 6-2,S,74,4,1,43,55,34,43,10,12,0,0,10,44,55,9,5,33,61,26,33,14,28,1,3,10,40,61
2007-10-22 00:00:00.000,Basel Switzerland ATP World Tour,HARD,2,Roger Federer,Jarkko Nieminen,Roger Federer,6-3; 6-4,F,61,4,0,33,56,26,33,15,23,1,1,10,41,56,2,1,39,50,27,39,6,11,2,4,9,33,50
2007-10-22 00:00:00.000,Lyon France ATP World Tour,HARD,2,Fabrice Santoro,Andy Roddick,Fabrice Santoro,7-6(5); 2-6; 6-4,R32,121,11,2,56,94,44,56,20,38,2,4,15,64,94,17,4,64,96,47,64,17,32,1,2,15,64,96
2007-10-22 00:00:00.000,Lyon France ATP World Tour,HARD,2,Sebastien Grosjean,Rodolphe Cadart,Sebastien Grosjean,6-3; 6-2,R32,73,6,3,23,43,23,23,13,20,0,0,9,36,43,0,1,41,61,26,41,8,20,5,8,8,34,61
2007-10-22 00:00:00.000,Lyon France ATP World Tour,HARD,2,Julien Benneteau,Edouard Roger-Vasselin,Julien Benneteau,5-7; 6-3; 6-1,R32,108,10,3,60,87,44,60,10,27,6,9,14,54,87,6,2,57,84,29,57,17,27,0,6,14,46,84
2007-10-22 00:00:00.000,Lyon France ATP World Tour,HARD,2,Gilles Simon,Andrei Pavel,Gilles Simon,6-2; 2-6; 6-1,R32,87,8,0,47,82,36,47,15,35,2,4,12,51,82,10,0,49,65,31,49,6,16,3,7,11,37,65
2007-10-22 00:00:00.000,Lyon France ATP World Tour,HARD,2,Richard Gasquet,Christophe Rochus,Richard Gasquet,7-6(5); 6-3,R32,84,23,3,40,63,36,40,13,23,3,3,10,49,63,4,1,50,77,33,50,18,27,5,7,11,51,77
2007-10-22 00:00:00.000,Lyon France ATP World Tour,HARD,2,Jo-Wilfried Tsonga,Vincent Spadea,Jo-Wilfried Tsonga,6-3; 6-4,R32,76,12,1,50,65,41,50,6,15,5,5,10,47,65,2,1,41,71,28,41,12,30,8,10,9,40,71
2007-10-22 00:00:00.000,Lyon France ATP World Tour,HARD,2,Olivier Rochus,Michael Llodra,Olivier Rochus,7-6(6); 6-2,R32,67,7,1,49,67,38,49,9,18,3,4,10,47,67,3,6,49,68,35,49,6,19,4,7,10,41,68
2007-10-22 00:00:00.000,Lyon France ATP World Tour,HARD,2,Mardy Fish,Nicolas Almagro,Mardy Fish,2-6; 6-3; 7-6(4),R32,97,17,1,44,83,39,44,21,39,1,4,15,60,83,9,2,56,83,38,56,17,27,0,2,14,55,83
2007-10-22 00:00:00.000,Lyon France ATP World Tour,HARD,2,Ivan Ljubicic,Sam Querrey,Ivan Ljubicic,7-6(5); 7-6(7),R32,86,17,0,59,79,51,59,11,20,1,1,12,62,79,19,2,50,74,43,50,16,24,0,0,12,59,74
2007-10-22 00:00:00.000,Lyon France ATP World Tour,HARD,2,Thierry Ascione,Janko Tipsarevic,Thierry Ascione,6-3; 7-6(3),R32,75,11,2,41,65,36,41,12,24,0,1,11,48,65,14,1,41,75,32,41,15,34,7,9,10,47,75
2007-10-22 00:00:00.000,Lyon France ATP World Tour,HARD,2,Oliver Marach,Andreas Seppi,Oliver Marach,7-6(7); 7-6(5),R32,101,9,1,56,78,47,56,14,22,2,2,12,61,78,11,3,51,81,43,51,15,30,0,0,12,58,81
2007-10-22 00:00:00.000,Lyon France ATP World Tour,HARD,2,Alejandro Falla,Igor Andreev,Alejandro Falla,7-6(2); 6-1,R32,81,4,1,44,59,33,44,9,15,3,4,10,42,59,3,1,39,56,21,39,8,17,4,7,9,29,56
2007-10-22 00:00:00.000,Lyon France ATP World Tour,HARD,2,Juan Monaco,Sebastien De Chaunac,Juan Monaco,6-7(11); 6-3; 7-6(3),R32,158,6,2,79,118,58,79,22,39,7,10,17,80,118,7,2,74,122,55,74,23,48,7,11,16,78,122
2007-10-22 00:00:00.000,Lyon France ATP World Tour,HARD,2,Diego Hartfield,Nicolas Mahut,Diego Hartfield,7-6(8); 6-4,R32,100,11,3,42,76,34,42,18,34,1,2,11,52,76,13,2,44,69,34,44,12,25,1,3,11,46,69
2007-10-22 00:00:00.000,Lyon France ATP World Tour,HARD,2,Benjamin Becker,Arnaud Clement,Benjamin Becker,7-6(0); 7-6(3),R32,114,19,4,49,87,41,49,22,38,3,3,12,63,87,12,6,59,90,44,59,14,31,5,5,12,58,90
2007-10-22 00:00:00.000,Lyon France ATP World Tour,HARD,2,Marc Gicquel,Tommy Robredo,Marc Gicquel,6-4; 7-6(5),R32,89,6,2,45,67,39,45,11,22,0,0,11,50,67,7,2,56,82,40,56,12,26,6,7,11,52,82
2007-10-22 00:00:00.000,Lyon France ATP World Tour,HARD,2,Sebastien Grosjean,Fabrice Santoro,Sebastien Grosjean,4-6; 6-1; 6-2,R16,138,8,0,37,74,30,37,19,37,0,2,13,49,74,10,0,54,81,31,54,13,27,4,9,12,44,81
2007-10-22 00:00:00.000,Lyon France ATP World Tour,HARD,2,Julien Benneteau,Gilles Simon,Julien Benneteau,7-5; 6-4,R16,90,4,2,50,67,36,50,7,17,3,5,11,43,67,6,2,31,68,19,31,20,37,5,9,11,39,68
2007-10-22 00:00:00.000,Lyon France ATP World Tour,HARD,2,Jo-Wilfried Tsonga,Richard Gasquet,Jo-Wilfried Tsonga,6-4; 6-4,R16,67,10,0,40,56,32,40,9,16,0,0,10,41,56,6,1,33,51,22,33,14,18,3,5,10,36,51
2007-10-22 00:00:00.000,Lyon France ATP World Tour,HARD,2,Olivier Rochus,Mardy Fish,Olivier Rochus,6-7(5); 7-6(6); 7-6(15),R16,181,2,3,73,130,55,73,41,57,5,7,18,96,130,43,6,75,137,64,75,34,62,5,7,18,98,137
2007-10-22 00:00:00.000,Lyon France ATP World Tour,HARD,2,Ivan Ljubicic,Thierry Ascione,Ivan Ljubicic,6-3; 6-7(4); 7-6(5),R16,136,34,2,68,98,60,68,17,30,2,2,17,77,98,9,1,73,115,61,73,21,42,9,10,16,82,115
2007-10-22 00:00:00.000,Lyon France ATP World Tour,HARD,2,Alejandro Falla,Oliver Marach,Alejandro Falla,6-2; 6-1,R16,44,8,0,20,34,18,20,10,14,0,0,7,28,34,0,5,26,48,17,26,7,22,3,8,8,24,48
2007-10-22 00:00:00.000,Lyon France ATP World Tour,HARD,2,Diego Hartfield,Juan Monaco,Diego Hartfield,6-4; 6-3,R16,77,3,2,34,55,25,34,14,21,2,2,9,39,55,2,3,36,55,25,36,8,19,1,4,10,33,55
2007-10-22 00:00:00.000,Lyon France ATP World Tour,HARD,2,Marc Gicquel,Benjamin Becker,Marc Gicquel,6-3; 6-3,R16,61,14,1,36,49,30,36,7,13,1,1,9,37,49,12,3,31,58,25,31,9,27,5,8,9,34,58
2007-10-22 00:00:00.000,Lyon France ATP World Tour,HARD,2,Sebastien Grosjean,Julien Benneteau,Sebastien Grosjean,6-7(6); 6-2; 7-6(4),Q,155,9,0,59,114,45,59,37,55,5,5,16,82,114,8,1,68,100,48,68,22,32,0,2,16,70,100
2007-10-22 00:00:00.000,Lyon France ATP World Tour,HARD,2,Jo-Wilfried Tsonga,Olivier Rochus,Jo-Wilfried Tsonga,6-3; 6-2,Q,59,10,0,28,40,27,28,9,12,0,0,9,36,40,0,1,31,48,16,31,10,17,4,7,8,26,48
2007-10-22 00:00:00.000,Lyon France ATP World Tour,HARD,2,Alejandro Falla,Ivan Ljubicic,Alejandro Falla,7-5; 6-7(3); 7-5,Q,152,9,1,65,98,56,65,21,33,0,0,18,77,98,30,4,70,116,57,70,24,46,8,10,18,81,116
2007-10-22 00:00:00.000,Lyon France ATP World Tour,HARD,2,Marc Gicquel,Diego Hartfield,Marc Gicquel,7-5; 6-3,Q,77,12,1,39,57,33,39,12,18,0,0,11,45,57,5,2,29,63,22,29,17,34,4,6,10,39,63
2007-10-22 00:00:00.000,Lyon France ATP World Tour,HARD,2,Sebastien Grosjean,Jo-Wilfried Tsonga,Sebastien Grosjean,6-1; 6-2,S,53,2,0,27,43,18,27,15,16,0,0,8,33,43,2,1,27,37,16,27,0,10,1,5,7,16,37
2007-10-22 00:00:00.000,Lyon France ATP World Tour,HARD,2,Marc Gicquel,Alejandro Falla,Marc Gicquel,4-6; 6-2; 7-6(7),S,125,4,1,65,97,50,65,20,32,3,4,15,70,97,8,1,54,88,41,54,22,34,1,3,15,63,88
2007-10-22 00:00:00.000,Lyon France ATP World Tour,HARD,2,Sebastien Grosjean,Marc Gicquel,Sebastien Grosjean,7-6(5); 6-4,F,96,17,2,45,71,38,45,15,26,1,1,11,53,71,4,0,52,74,39,52,11,22,2,3,11,50,74
2007-10-22 00:00:00.000,St. Petersburg Russia ATP World Tour,HARD,2,Nikolay Davydenko,Filippo Volandri,Nikolay Davydenko,6-1; 6-1,R32,57,2,1,18,35,17,18,9,17,0,1,7,26,35,1,2,26,52,12,26,7,26,3,9,7,19,52
2007-10-22 00:00:00.000,St. Petersburg Russia ATP World Tour,HARD,2,Marin Cilic,Mikhail Elgin,Marin Cilic,6-3; 6-4,R32,64,10,3,34,51,29,34,8,17,0,1,10,37,51,3,2,35,58,22,35,12,23,0,3,9,34,58
2007-10-22 00:00:00.000,St. Petersburg Russia ATP World Tour,HARD,2,Nicolas Massu,Teymuraz Gabashvili,Nicolas Massu,3-6; 6-3; 6-4,R32,118,3,0,64,90,43,64,19,26,6,7,14,62,90,3,2,48,74,33,48,18,26,4,6,14,51,74
2007-10-22 00:00:00.000,St. Petersburg Russia ATP World Tour,HARD,2,Ernests Gulbis,Thomas Johansson,Ernests Gulbis,6-2; 6-1,R32,47,11,1,23,38,22,23,8,15,3,3,7,30,38,2,2,24,42,12,24,7,18,1,6,8,19,42
2007-10-22 00:00:00.000,St. Petersburg Russia ATP World Tour,HARD,2,Potito Starace,Kristof Vliegen,Potito Starace,3-6; 6-4; 7-6(3),R32,133,3,2,72,93,51,72,9,21,5,9,15,60,93,6,4,66,108,44,66,21,42,5,9,16,65,108
2007-10-22 00:00:00.000,St. Petersburg Russia ATP World Tour,HARD,2,Mikhail Ledovskikh,Mikhail Kukushkin,Mikhail Ledovskikh,7-5; 6-3,R32,79,20,2,41,68,39,41,9,27,0,0,11,48,68,5,1,45,62,35,45,6,17,3,5,10,41,62
2007-10-22 00:00:00.000,St. Petersburg Russia ATP World Tour,HARD,2,Simone Bolelli,Jonas Bjorkman,Simone Bolelli,7-6(8); 6-2,R32,112,6,1,57,82,38,57,15,25,2,2,10,53,82,2,4,48,81,35,48,14,33,4,6,10,49,81
2007-10-22 00:00:00.000,St. Petersburg Russia ATP World Tour,HARD,2,Fernando Verdasco,Werner Eschauer,Fernando Verdasco,7-6(4); 6-1,R32,82,3,1,46,56,37,46,7,10,0,1,10,44,56,7,6,31,70,23,31,18,39,1,4,9,41,70
2007-10-22 00:00:00.000,St. Petersburg Russia ATP World Tour,HARD,2,Philipp Kohlschreiber,Evgeny Korolev,Philipp Kohlschreiber,7-6(4); 6-3,R32,99,5,1,52,73,36,52,11,21,2,4,11,47,73,3,4,38,64,24,38,12,26,4,7,10,36,64
2007-10-22 00:00:00.000,St. Petersburg Russia ATP World Tour,HARD,2,Denis Matsukevich,Igor Kunitsyn,Denis Matsukevich,7-6(2); 6-3,R32,96,3,3,40,74,29,40,19,34,2,3,11,48,74,2,1,38,62,26,38,10,24,1,3,10,36,62
2007-10-22 00:00:00.000,St. Petersburg Russia ATP World Tour,HARD,2,Mario Ancic,Nicolas Lapentti,Mario Ancic,6-4; 6-1,R32,67,4,1,26,41,20,26,11,15,0,1,8,31,41,3,1,27,52,19,27,7,25,1,6,9,26,52
2007-10-22 00:00:00.000,St. Petersburg Russia ATP World Tour,HARD,2,Mikhail Youzhny,Justin Gimelstob,Mikhail Youzhny,6-2; 6-4,R32,68,5,1,25,46,20,25,17,21,1,1,9,37,46,1,2,26,53,18,26,12,27,0,3,9,30,53
2007-10-22 00:00:00.000,St. Petersburg Russia ATP World Tour,HARD,2,Dmitry Tursunov,Jurgen Melzer,Dmitry Tursunov,7-6(6); 7-6(0),R32,112,7,5,56,86,44,56,16,30,4,5,12,60,86,4,3,64,95,44,64,16,31,7,8,12,60,95
2007-10-22 00:00:00.000,St. Petersburg Russia ATP World Tour,HARD,2,Boris Pashanski,Guillermo Garcia-Lopez,Boris Pashanski,7-6(6); 6-4,R32,109,5,1,56,84,35,56,14,28,4,7,11,49,84,2,4,37,70,26,37,13,33,3,7,11,39,70
2007-10-22 00:00:00.000,St. Petersburg Russia ATP World Tour,HARD,2,Lukas Dlouhy,Pavel Chekhov,Lukas Dlouhy,7-6(5); 6-4,R32,74,4,4,53,75,42,53,13,22,2,2,11,55,75,14,3,44,70,39,44,10,26,2,3,11,49,70
2007-10-22 00:00:00.000,St. Petersburg Russia ATP World Tour,HARD,2,Andy Murray,Max Mirnyi,Andy Murray,6-2; 6-2,R32,52,3,0,21,39,18,21,14,18,0,0,8,32,39,4,4,25,44,17,25,7,19,2,6,8,24,44
2007-10-22 00:00:00.000,St. Petersburg Russia ATP World Tour,HARD,2,Marin Cilic,Nikolay Davydenko,Marin Cilic,1-6; 7-5; 6-1,R16,116,4,0,45,82,29,45,20,37,4,7,13,49,82,1,10,58,82,39,58,8,24,4,8,13,47,82
2007-10-22 00:00:00.000,St. Petersburg Russia ATP World Tour,HARD,2,Ernests Gulbis,Nicolas Massu,Ernests Gulbis,6-1; 6-2,R16,51,14,0,29,41,28,29,6,12,1,1,8,34,41,1,2,23,45,13,23,8,22,4,8,7,21,45
2007-10-22 00:00:00.000,St. Petersburg Russia ATP World Tour,HARD,2,Potito Starace,Mikhail Ledovskikh,Potito Starace,7-6(4); 6-2,R16,88,2,1,51,72,36,51,13,21,5,6,10,49,72,7,4,34,64,23,34,14,30,1,4,10,37,64
2007-10-22 00:00:00.000,St. Petersburg Russia ATP World Tour,HARD,2,Fernando Verdasco,Simone Bolelli,Fernando Verdasco,6-4; 6-4,R16,77,5,1,46,55,36,46,6,9,1,1,10,42,55,1,2,37,69,25,37,19,32,7,9,10,44,69
2007-10-22 00:00:00.000,St. Petersburg Russia ATP World Tour,HARD,2,Philipp Kohlschreiber,Denis Matsukevich,Philipp Kohlschreiber,6-1; 6-1,R16,59,0,0,24,41,20,24,10,17,2,2,7,30,41,1,0,25,47,12,25,10,22,6,11,7,22,47
2007-10-22 00:00:00.000,St. Petersburg Russia ATP World Tour,HARD,2,Mikhail Youzhny,Mario Ancic,Mikhail Youzhny,6-4; 6-2,R16,85,3,4,31,55,25,31,16,24,4,4,9,41,55,0,3,38,62,20,38,14,24,4,7,9,34,62
2007-10-22 00:00:00.000,St. Petersburg Russia ATP World Tour,HARD,2,Dmitry Tursunov,Boris Pashanski,Dmitry Tursunov,4-6; 6-3; 6-4,R16,112,14,6,43,86,35,43,24,43,2,4,15,59,86,4,2,45,80,34,45,18,35,0,3,14,52,80
2007-10-22 00:00:00.000,St. Petersburg Russia ATP World Tour,HARD,2,Andy Murray,Lukas Dlouhy,Andy Murray,6-2; 6-4,R16,70,3,3,40,69,31,40,12,29,4,5,9,43,69,4,5,38,61,25,38,5,23,2,6,9,30,61
2007-10-22 00:00:00.000,St. Petersburg Russia ATP World Tour,HARD,2,Marin Cilic,Ernests Gulbis,Marin Cilic,6-4; 6-4,Q,84,9,1,30,60,23,30,21,30,1,1,10,44,60,2,4,44,72,32,44,12,28,7,9,10,44,72
2007-10-22 00:00:00.000,St. Petersburg Russia ATP World Tour,HARD,2,Fernando Verdasco,Potito Starace,Fernando Verdasco,6-3; 6-4,Q,69,4,1,38,47,33,38,7,9,0,0,10,40,47,1,3,45,61,28,45,8,16,2,4,9,36,61
2007-10-22 00:00:00.000,St. Petersburg Russia ATP World Tour,HARD,2,Mikhail Youzhny,Philipp Kohlschreiber,Mikhail Youzhny,6-4 RET,Q,42,0,0,14,27,10,14,6,13,1,3,5,16,27,1,1,16,27,8,16,4,11,0,3,5,12,27
2007-10-22 00:00:00.000,St. Petersburg Russia ATP World Tour,HARD,2,Andy Murray,Dmitry Tursunov,Andy Murray,3-6; 7-6(2); 6-4,Q,134,9,4,57,111,47,57,27,54,12,14,15,74,111,6,2,57,91,43,57,20,34,1,3,16,63,91
2007-10-22 00:00:00.000,St. Petersburg Russia ATP World Tour,HARD,2,Fernando Verdasco,Marin Cilic,Fernando Verdasco,6-2; 6-3,S,69,1,0,43,52,35,43,5,9,1,1,9,40,52,4,2,25,49,16,25,11,24,2,5,8,27,49
2007-10-22 00:00:00.000,St. Petersburg Russia ATP World Tour,HARD,2,Andy Murray,Mikhail Youzhny,Andy Murray,6-2; 5-7; 7-6(1),S,151,10,2,54,102,45,54,24,48,2,4,16,69,102,3,3,67,104,50,67,17,37,5,8,16,67,104
2007-10-22 00:00:00.000,St. Petersburg Russia ATP World Tour,HARD,2,Andy Murray,Fernando Verdasco,Andy Murray,6-2; 6-3,F,77,1,0,23,51,19,23,16,28,1,1,8,35,51,1,0,40,59,22,40,8,19,3,7,9,30,59
2007-10-28 00:00:00.000,ATP Masters Series Paris France ATP World Tour,HARD,2,Roger Federer,N/A Bye,Roger Federer,,R64,0,0,0,0,0,0,0,0,0,0,0,0,0,0,0,0,0,0,0,0,0,0,0,0,0,0,0
2007-10-28 00:00:00.000,ATP Masters Series Paris France ATP World Tour,HARD,2,Ivo Karlovic,Fernando Verdasco,Ivo Karlovic,4-6; 6-3; 6-4,R64,100,14,1,61,83,53,61,9,22,3,4,15,62,83,4,1,57,75,44,57,10,18,1,3,14,54,75
2007-10-28 00:00:00.000,ATP Masters Series Paris France ATP World Tour,HARD,2,David Nalbandian,Nicolas Almagro,David Nalbandian,6-4; 6-4,R64,81,4,2,33,55,30,33,12,22,1,1,10,42,55,5,2,44,80,30,44,17,36,10,12,10,47,80
2007-10-28 00:00:00.000,ATP Masters Series Paris France ATP World Tour,HARD,2,Carlos Moya,N/A Bye,Carlos Moya,,R64,0,0,0,0,0,0,0,0,0,0,0,0,0,0,0,0,0,0,0,0,0,0,0,0,0,0,0
2007-10-28 00:00:00.000,ATP Masters Series Paris France ATP World Tour,HARD,2,Tomas Berdych,N/A Bye,Tomas Berdych,,R64,0,0,0,0,0,0,0,0,0,0,0,0,0,0,0,0,0,0,0,0,0,0,0,0,0,0,0
2007-10-28 00:00:00.000,ATP Masters Series Paris France ATP World Tour,HARD,2,Mario Ancic,Paul-Henri Mathieu,Mario Ancic,4-6; 6-2; 6-3,R64,118,13,1,43,66,37,43,16,23,0,1,14,53,66,4,3,57,90,42,57,14,33,4,7,13,56,90
2007-10-28 00:00:00.000,ATP Masters Series Paris France ATP World Tour,HARD,2,Mardy Fish,Dmitry Tursunov,Mardy Fish,7-6(7); 6-4,R64,103,19,3,46,84,35,46,23,38,3,3,11,58,84,7,1,42,71,31,42,20,29,3,4,11,51,71
2007-10-28 00:00:00.000,ATP Masters Series Paris France ATP World Tour,HARD,2,David Ferrer,N/A Bye,David Ferrer,,R64,0,0,0,0,0,0,0,0,0,0,0,0,0,0,0,0,0,0,0,0,0,0,0,0,0,0,0
2007-10-28 00:00:00.000,ATP Masters Series Paris France ATP World Tour,HARD,2,Novak Djokovic,N/A Bye,Novak Djokovic,,R64,0,0,0,0,0,0,0,0,0,0,0,0,0,0,0,0,0,0,0,0,0,0,0,0,0,0,0
2007-10-28 00:00:00.000,ATP Masters Series Paris France ATP World Tour,HARD,2,Fabrice Santoro,Albert Montanes,Fabrice Santoro,7-6(4); 6-2,R64,105,5,1,42,70,29,42,18,28,3,4,10,47,70,1,5,44,75,28,44,15,31,3,6,10,43,75
2007-10-28 00:00:00.000,ATP Masters Series Paris France ATP World Tour,HARD,2,Jarkko Nieminen,Juan Monaco,Jarkko Nieminen,6-4; 6-4,R64,69,2,1,49,61,35,49,7,12,2,3,10,42,61,4,1,36,51,25,36,6,15,1,4,10,31,51
2007-10-28 00:00:00.000,ATP Masters Series Paris France ATP World Tour,HARD,2,Andy Murray,N/A Bye,Andy Murray,,R64,0,0,0,0,0,0,0,0,0,0,0,0,0,0,0,0,0,0,0,0,0,0,0,0,0,0,0
2007-10-28 00:00:00.000,ATP Masters Series Paris France ATP World Tour,HARD,2,Richard Gasquet,N/A Bye,Richard Gasquet,,R64,0,0,0,0,0,0,0,0,0,0,0,0,0,0,0,0,0,0,0,0,0,0,0,0,0,0,0
2007-10-28 00:00:00.000,ATP Masters Series Paris France ATP World Tour,HARD,2,Jo-Wilfried Tsonga,Sebastien Grosjean,Jo-Wilfried Tsonga,6-3; 3-6; 6-3,R64,109,6,1,62,77,48,62,7,15,1,3,14,55,77,3,0,48,82,33,48,19,34,7,10,13,52,82
2007-10-28 00:00:00.000,ATP Masters Series Paris France ATP World Tour,HARD,2,Nicolas Mahut,Teymuraz Gabashvili,Nicolas Mahut,6-4; 7-6(4),R64,104,12,2,49,74,40,49,14,25,0,0,11,54,74,9,4,53,82,40,53,15,29,8,9,11,55,82
2007-10-28 00:00:00.000,ATP Masters Series Paris France ATP World Tour,HARD,2,James Blake,N/A Bye,James Blake,,R64,0,0,0,0,0,0,0,0,0,0,0,0,0,0,0,0,0,0,0,0,0,0,0,0,0,0,0
2007-10-28 00:00:00.000,ATP Masters Series Paris France ATP World Tour,HARD,2,Tommy Robredo,N/A Bye,Tommy Robredo,,R64,0,0,0,0,0,0,0,0,0,0,0,0,0,0,0,0,0,0,0,0,0,0,0,0,0,0,0
2007-10-28 00:00:00.000,ATP Masters Series Paris France ATP World Tour,HARD,2,Gilles Simon,Potito Starace,Gilles Simon,6-3; 3-6; 6-3,R64,105,8,0,42,76,32,42,24,34,0,1,14,56,76,3,2,58,94,39,58,20,36,6,8,13,59,94
2007-10-28 00:00:00.000,ATP Masters Series Paris France ATP World Tour,HARD,2,Andreas Seppi,Sam Querrey,Andreas Seppi,5-7; 6-1; 6-3,R64,99,6,3,51,81,43,51,16,30,4,6,14,59,81,9,3,54,94,37,54,16,40,5,10,14,53,94
2007-10-28 00:00:00.000,ATP Masters Series Paris France ATP World Tour,HARD,2,Guillermo Canas,N/A Bye,Guillermo Canas,,R64,0,0,0,0,0,0,0,0,0,0,0,0,0,0,0,0,0,0,0,0,0,0,0,0,0,0,0
2007-10-28 00:00:00.000,ATP Masters Series Paris France ATP World Tour,HARD,2,Ivan Ljubicic,N/A Bye,Ivan Ljubicic,,R64,0,0,0,0,0,0,0,0,0,0,0,0,0,0,0,0,0,0,0,0,0,0,0,0,0,0,0
2007-10-28 00:00:00.000,ATP Masters Series Paris France ATP World Tour,HARD,2,Marcos Baghdatis,Juan Carlos Ferrero,Marcos Baghdatis,6-4; 6-2,R64,74,9,1,33,51,26,33,12,18,2,2,9,38,51,3,1,37,57,20,37,13,20,0,3,9,33,57
2007-10-28 00:00:00.000,ATP Masters Series Paris France ATP World Tour,HARD,2,Juan Martin Del Potro,Feliciano Lopez,Juan Martin Del Potro,6-4; 6-3,R64,69,6,1,36,55,32,36,8,19,0,1,10,40,55,7,2,39,56,26,39,6,17,1,4,9,32,56
2007-10-28 00:00:00.000,ATP Masters Series Paris France ATP World Tour,HARD,2,Nikolay Davydenko,N/A Bye,Nikolay Davydenko,,R64,0,0,0,0,0,0,0,0,0,0,0,0,0,0,0,0,0,0,0,0,0,0,0,0,0,0,0
2007-10-28 00:00:00.000,ATP Masters Series Paris France ATP World Tour,HARD,2,Fernando Gonzalez,N/A Bye,Fernando Gonzalez,,R64,0,0,0,0,0,0,0,0,0,0,0,0,0,0,0,0,0,0,0,0,0,0,0,0,0,0,0
2007-10-28 00:00:00.000,ATP Masters Series Paris France ATP World Tour,HARD,2,Mikhail Youzhny,Arnaud Clement,Mikhail Youzhny,6-4; 6-3,R64,83,5,0,33,49,24,33,10,16,1,2,9,34,49,4,2,41,63,28,41,7,22,7,11,10,35,63
2007-10-28 00:00:00.000,ATP Masters Series Paris France ATP World Tour,HARD,2,Janko Tipsarevic,Vincent Spadea,Janko Tipsarevic,7-6(9); 7-6(2),R64,111,16,3,51,85,46,51,15,34,1,2,12,61,85,4,0,49,77,35,49,19,28,2,3,12,54,77
2007-10-28 00:00:00.000,ATP Masters Series Paris France ATP World Tour,HARD,2,Tommy Haas,N/A Bye,Tommy Haas,,R64,0,0,0,0,0,0,0,0,0,0,0,0,0,0,0,0,0,0,0,0,0,0,0,0,0,0,0
2007-10-28 00:00:00.000,ATP Masters Series Paris France ATP World Tour,HARD,2,Juan Ignacio Chela,N/A Bye,Juan Ignacio Chela,,R64,0,0,0,0,0,0,0,0,0,0,0,0,0,0,0,0,0,0,0,0,0,0,0,0,0,0,0
2007-10-28 00:00:00.000,ATP Masters Series Paris France ATP World Tour,HARD,2,Stanislas Wawrinka,Nicolas Kiefer,Stanislas Wawrinka,7-5; 6-3,R64,91,8,0,42,66,33,42,16,24,3,3,11,49,66,7,3,35,52,30,35,7,17,2,4,10,37,52
2007-10-28 00:00:00.000,ATP Masters Series Paris France ATP World Tour,HARD,2,Filippo Volandri,Jurgen Melzer,Filippo Volandri,6-0; 6-3,R64,58,0,3,28,47,20,28,11,19,3,4,7,31,47,2,2,27,50,10,27,9,23,6,12,8,19,50
2007-10-28 00:00:00.000,ATP Masters Series Paris France ATP World Tour,HARD,2,Rafael Nadal,N/A Bye,Rafael Nadal,,R64,0,0,0,0,0,0,0,0,0,0,0,0,0,0,0,0,0,0,0,0,0,0,0,0,0,0,0
2007-10-28 00:00:00.000,ATP Masters Series Paris France ATP World Tour,HARD,2,Roger Federer,Ivo Karlovic,Roger Federer,6-3; 4-6; 6-3,R32,104,6,0,41,74,35,41,21,33,5,6,14,56,74,16,1,59,92,42,59,15,33,6,9,14,57,92
2007-10-28 00:00:00.000,ATP Masters Series Paris France ATP World Tour,HARD,2,David Nalbandian,Carlos Moya,David Nalbandian,6-4; 6-4,R32,93,5,0,28,57,25,28,17,29,2,2,10,42,57,3,2,48,87,34,48,17,39,9,11,10,51,87
2007-10-28 00:00:00.000,ATP Masters Series Paris France ATP World Tour,HARD,2,Tomas Berdych,Mario Ancic,Tomas Berdych,6-3; 6-3,R32,66,7,2,28,51,23,28,16,23,2,2,9,39,51,11,1,34,53,25,34,6,19,1,4,9,31,53
2007-10-28 00:00:00.000,ATP Masters Series Paris France ATP World Tour,HARD,2,David Ferrer,Mardy Fish,David Ferrer,6-1; 7-6(4),R32,98,4,3,50,85,37,50,15,35,7,8,9,52,85,4,3,28,64,22,28,13,36,3,7,10,35,64
2007-10-28 00:00:00.000,ATP Masters Series Paris France ATP World Tour,HARD,2,Fabrice Santoro,Novak Djokovic,Fabrice Santoro,6-3; 6-2,R32,175,1,2,25,47,21,25,16,22,2,2,9,37,47,5,3,31,57,21,31,10,26,4,7,8,31,57
2007-10-28 00:00:00.000,ATP Masters Series Paris France ATP World Tour,HARD,2,Andy Murray,Jarkko Nieminen,Andy Murray,7-6(5); 6-3,R32,133,2,5,37,74,31,37,21,37,5,6,10,52,74,1,1,60,91,36,60,17,31,9,12,11,53,91
2007-10-28 00:00:00.000,ATP Masters Series Paris France ATP World Tour,HARD,2,Richard Gasquet,Jo-Wilfried Tsonga,Richard Gasquet,7-5; 7-6(3),R32,96,1,1,42,68,31,42,20,26,0,1,12,51,68,8,0,41,68,32,41,15,27,1,3,12,47,68
2007-10-28 00:00:00.000,ATP Masters Series Paris France ATP World Tour,HARD,2,James Blake,Nicolas Mahut,James Blake,6-7(3); 7-6(4); 6-1,R32,148,19,2,67,108,50,67,20,41,7,10,16,70,108,9,7,63,114,43,63,22,51,9,14,15,65,114
2007-10-28 00:00:00.000,ATP Masters Series Paris France ATP World Tour,HARD,2,Tommy Robredo,Gilles Simon,Tommy Robredo,6-4; 2-6; 6-4,R32,143,4,0,69,104,47,69,14,35,5,8,14,61,104,3,0,58,86,43,58,12,28,4,7,14,55,86
2007-10-28 00:00:00.000,ATP Masters Series Paris France ATP World Tour,HARD,2,Guillermo Canas,Andreas Seppi,Guillermo Canas,6-3; 7-6(5),R32,110,10,0,43,70,34,43,14,27,4,6,11,48,70,3,2,37,77,22,37,22,40,9,12,10,44,77
2007-10-28 00:00:00.000,ATP Masters Series Paris France ATP World Tour,HARD,2,Marcos Baghdatis,Ivan Ljubicic,Marcos Baghdatis,6-4; 7-6(4),R32,104,11,2,41,64,32,41,13,23,1,3,11,45,64,4,0,51,81,36,51,15,30,5,8,11,51,81
2007-10-28 00:00:00.000,ATP Masters Series Paris France ATP World Tour,HARD,2,Nikolay Davydenko,Juan Martin Del Potro,Nikolay Davydenko,7-6(3); 6-1,R32,84,1,3,45,68,37,45,11,23,4,5,10,48,68,4,2,40,64,29,40,7,24,6,9,9,36,64
2007-10-28 00:00:00.000,ATP Masters Series Paris France ATP World Tour,HARD,2,Mikhail Youzhny,Fernando Gonzalez,Mikhail Youzhny,3-6; 6-3; 6-3,R32,125,5,1,58,84,39,58,15,26,5,8,14,54,84,5,1,48,86,36,48,15,38,5,9,13,51,86
2007-10-28 00:00:00.000,ATP Masters Series Paris France ATP World Tour,HARD,2,Tommy Haas,Janko Tipsarevic,Tommy Haas,6-3; 6-7(5); 6-3,R32,116,7,1,58,86,47,58,17,28,1,3,16,64,86,8,4,58,92,42,58,14,34,2,6,14,56,92
2007-10-28 00:00:00.000,ATP Masters Series Paris France ATP World Tour,HARD,2,Stanislas Wawrinka,Juan Ignacio Chela,Stanislas Wawrinka,6-3; 6-1,R32,57,3,1,33,54,23,33,14,21,0,0,8,37,54,0,4,22,46,14,22,9,24,1,5,8,23,46
2007-10-28 00:00:00.000,ATP Masters Series Paris France ATP World Tour,HARD,2,Rafael Nadal,Filippo Volandri,Rafael Nadal,6-3; 6-1,R32,68,1,0,33,44,26,33,5,11,0,1,8,31,44,0,1,33,50,18,33,6,17,2,7,8,24,50
2007-10-28 00:00:00.000,ATP Masters Series Paris France ATP World Tour,HARD,2,David Nalbandian,Roger Federer,David Nalbandian,6-4; 7-6(3),R16,102,6,2,44,88,31,44,24,44,3,5,11,55,88,4,0,44,66,30,44,12,22,3,6,11,42,66
2007-10-28 00:00:00.000,ATP Masters Series Paris France ATP World Tour,HARD,2,David Ferrer,Tomas Berdych,David Ferrer,6-4; 6-2,R16,74,3,1,37,57,28,37,10,20,0,1,9,38,57,3,4,31,60,20,31,12,29,2,6,9,32,60
2007-10-28 00:00:00.000,ATP Masters Series Paris France ATP World Tour,HARD,2,Andy Murray,Fabrice Santoro,Andy Murray,6-4; 6-2,R16,70,4,1,34,63,24,34,18,29,3,4,9,42,63,2,2,31,49,17,31,8,18,2,6,9,25,49
2007-10-28 00:00:00.000,ATP Masters Series Paris France ATP World Tour,HARD,2,Richard Gasquet,James Blake,Richard Gasquet,6-4; 6-4,R16,83,3,3,37,67,28,37,16,30,5,6,10,44,67,5,0,40,74,29,40,16,34,6,9,10,45,74
2007-10-28 00:00:00.000,ATP Masters Series Paris France ATP World Tour,HARD,2,Tommy Robredo,Guillermo Canas,Tommy Robredo,7-5; 7-5,R16,149,5,1,48,77,31,48,20,29,3,5,12,51,77,3,3,51,96,33,51,21,45,5,9,12,54,96
2007-10-28 00:00:00.000,ATP Masters Series Paris France ATP World Tour,HARD,2,Marcos Baghdatis,Nikolay Davydenko,Marcos Baghdatis,6-2; 6-2,R16,73,1,2,30,58,21,30,15,28,6,7,8,36,58,0,10,24,40,15,24,2,16,0,5,8,17,40
2007-10-28 00:00:00.000,ATP Masters Series Paris France ATP World Tour,HARD,2,Mikhail Youzhny,Tommy Haas,Mikhail Youzhny,6-4; 1-6; 6-3,R16,144,5,1,57,92,36,57,20,35,9,12,13,56,92,5,2,60,96,40,60,17,36,9,12,13,57,96
2007-10-28 00:00:00.000,ATP Masters Series Paris France ATP World Tour,HARD,2,Rafael Nadal,Stanislas Wawrinka,Rafael Nadal,6-4; 6-3,R16,101,2,1,50,66,35,50,8,16,7,8,9,43,66,6,2,28,58,18,28,14,30,5,9,10,32,58
2007-10-28 00:00:00.000,ATP Masters Series Paris France ATP World Tour,HARD,2,David Nalbandian,David Ferrer,David Nalbandian,7-6(3); 6-7(3); 6-2,Q,169,18,0,77,117,57,77,18,40,6,8,16,75,117,8,2,76,119,50,76,20,43,7,11,16,70,119
2007-10-28 00:00:00.000,ATP Masters Series Paris France ATP World Tour,HARD,2,Richard Gasquet,Andy Murray,Richard Gasquet,6-3; 0-6; 6-4,Q,99,3,3,47,81,32,47,19,34,4,7,13,51,81,5,1,35,68,24,35,21,33,2,4,12,45,68
2007-10-28 00:00:00.000,ATP Masters Series Paris France ATP World Tour,HARD,2,Marcos Baghdatis,Tommy Robredo,Marcos Baghdatis,6-4; 6-4,Q,86,1,1,34,62,25,34,20,28,3,3,10,45,62,1,0,40,58,25,40,12,18,1,3,10,37,58
2007-10-28 00:00:00.000,ATP Masters Series Paris France ATP World Tour,HARD,2,Rafael Nadal,Mikhail Youzhny,Rafael Nadal,6-4; 6-2,Q,94,1,1,32,52,25,32,10,20,1,2,9,35,52,2,1,39,56,20,39,9,17,6,10,9,29,56
2007-10-28 00:00:00.000,ATP Masters Series Paris France ATP World Tour,HARD,2,David Nalbandian,Richard Gasquet,David Nalbandian,6-2; 6-4,S,68,8,3,20,46,18,20,15,26,0,1,9,33,46,6,0,26,51,17,26,10,25,1,5,9,27,51
2007-10-28 00:00:00.000,ATP Masters Series Paris France ATP World Tour,HARD,2,Rafael Nadal,Marcos Baghdatis,Rafael Nadal,4-6; 6-4; 6-3,S,146,2,2,58,88,41,58,16,30,1,4,15,57,88,8,5,49,95,33,49,22,46,10,14,14,55,95
2007-10-28 00:00:00.000,ATP Masters Series Paris France ATP World Tour,HARD,2,David Nalbandian,Rafael Nadal,David Nalbandian,6-4; 6-0,F,70,5,0,24,41,21,24,13,17,0,0,8,34,41,1,1,31,47,21,31,3,16,2,6,8,24,47
