event_time,event_name,surface,num_of_sets,playerA,playerB,winner,score,round,duration_minutes,a_aces,a_double_faults,a_first_serve_hits,a_first_serve_total,a_first_serve_won,a_first_serve_played,a_second_serve_won,a_second_serve_played,a_break_points_saved,a_break_points_total,a_service_games,a_service_points_won,a_service_points_total,b_aces,b_double_faults,b_first_serve_hits,b_first_serve_total,b_first_serve_won,b_first_serve_played,b_second_serve_won,b_second_serve_played,b_break_points_saved,b_break_points_total,b_service_games,b_service_points_won,b_service_points_total
2006-01-02 00:00:00.000,Adelaide Australia ATP World Tour,HARD,2,Lleyton Hewitt,Jan Hernych,Lleyton Hewitt,4-6; 6-2; 6-4,R32,116,5,4,51,89,36,51,15,38,6,11,14,51,89,1,0,69,103,40,69,12,34,9,16,14,52,103
2006-01-02 00:00:00.000,Adelaide Australia ATP World Tour,HARD,2,Philipp Kohlschreiber,Chris Guccione,Philipp Kohlschreiber,6-4; 6-3,R32,76,4,1,28,49,22,28,14,21,2,3,9,36,49,14,5,49,84,30,49,14,35,12,16,10,44,84
2006-01-02 00:00:00.000,Adelaide Australia ATP World Tour,HARD,2,Andy Murray,Paolo Lorenzi,Andy Murray,3-6; 6-0; 6-2,R32,88,7,6,44,70,29,44,13,26,5,8,11,42,70,0,1,40,75,17,40,17,35,5,12,12,34,75
2006-01-02 00:00:00.000,Adelaide Australia ATP World Tour,HARD,2,Tomas Berdych,Agustin Calleri,Tomas Berdych,6-4; 6-7(5); 6-4,R32,138,5,5,53,103,43,53,29,50,4,5,16,72,103,13,9,58,110,43,58,27,52,5,8,16,70,110
2006-01-02 00:00:00.000,Adelaide Australia ATP World Tour,HARD,2,Mario Ancic,Arnaud Clement,Mario Ancic,6-0; 6-2,R32,59,7,0,23,36,21,23,8,13,2,2,7,29,36,1,1,23,45,15,23,4,22,4,9,7,19,45
2006-01-02 00:00:00.000,Adelaide Australia ATP World Tour,HARD,2,Xavier Malisse,Peter Luczak,Xavier Malisse,7-6(11); 6-3,R32,105,17,4,54,95,44,54,17,41,14,16,11,61,95,5,2,40,73,29,40,15,33,6,9,10,44,73
2006-01-02 00:00:00.000,Adelaide Australia ATP World Tour,HARD,2,Andreas Seppi,Boris Pashanski,Andreas Seppi,6-4; 6-4,R32,70,8,2,36,57,29,36,11,21,2,3,10,40,57,3,4,33,58,24,33,11,25,5,8,10,35,58
2006-01-02 00:00:00.000,Adelaide Australia ATP World Tour,HARD,2,James Blake,Alberto Martin,James Blake,6-3; 6-3,R32,65,4,0,25,51,21,25,13,26,3,5,9,34,51,3,6,33,60,21,33,8,27,6,11,9,29,60
2006-01-02 00:00:00.000,Adelaide Australia ATP World Tour,HARD,2,Jarkko Nieminen,Paul-Henri Mathieu,Jarkko Nieminen,6-2; 7-6(5),R32,92,3,2,52,78,36,52,14,26,5,6,10,50,78,4,5,35,66,27,35,13,31,5,8,10,40,66
2006-01-02 00:00:00.000,Adelaide Australia ATP World Tour,HARD,2,Florian Mayer,Juan Monaco,Florian Mayer,6-2; 6-4,R32,73,2,3,25,45,22,25,11,20,1,2,9,33,45,1,0,42,67,24,42,11,25,5,9,9,35,67
2006-01-02 00:00:00.000,Adelaide Australia ATP World Tour,HARD,2,Florent Serra,Michael Llodra,Florent Serra,3-6; 3-1 RET,R32,70,3,2,31,40,19,31,5,9,2,4,6,24,40,1,1,30,48,16,30,11,18,3,5,7,27,48
2006-01-02 00:00:00.000,Adelaide Australia ATP World Tour,HARD,2,Tommy Robredo,Jurgen Melzer,Tommy Robredo,7-5; 6-4,R32,83,2,3,27,59,23,27,23,32,0,0,11,46,59,1,4,41,79,32,41,17,38,4,6,11,49,79
2006-01-02 00:00:00.000,Adelaide Australia ATP World Tour,HARD,2,Ivo Karlovic,Juan Ignacio Chela,Ivo Karlovic,6-3; 3-6; 6-1,R32,104,13,2,46,79,37,46,16,33,1,2,13,53,79,3,3,48,80,33,48,16,32,5,8,12,49,80
2006-01-02 00:00:00.000,Adelaide Australia ATP World Tour,HARD,2,Kenneth Carlsen,Gregory Carraz,Kenneth Carlsen,5-7; 7-5; 6-3,R32,127,7,2,65,96,52,65,17,31,6,7,16,69,96,18,9,60,104,46,60,21,44,3,6,17,67,104
2006-01-02 00:00:00.000,Adelaide Australia ATP World Tour,HARD,2,Mark Philippoussis,Vincent Spadea,Mark Philippoussis,6-4; 3-6; 6-4,R32,121,14,2,53,94,36,53,21,41,6,10,15,57,94,4,3,55,95,37,55,18,40,6,10,14,55,95
2006-01-02 00:00:00.000,Adelaide Australia ATP World Tour,HARD,2,Dominik Hrbaty,Rameez Junaid,Dominik Hrbaty,6-3; 7-5,R32,71,6,5,37,63,26,37,15,26,3,5,11,41,63,2,5,33,58,23,33,9,25,2,6,10,32,58
2006-01-02 00:00:00.000,Adelaide Australia ATP World Tour,HARD,2,Philipp Kohlschreiber,Lleyton Hewitt,Philipp Kohlschreiber,6-3; 0-6; 7-5,R16,115,4,0,42,91,22,42,31,49,4,8,14,53,91,7,4,48,80,35,48,17,32,5,8,13,52,80
2006-01-02 00:00:00.000,Adelaide Australia ATP World Tour,HARD,2,Tomas Berdych,Andy Murray,Tomas Berdych,7-6(2); 4-6; 6-1,R16,127,5,5,56,94,42,56,18,38,0,2,14,60,94,5,3,54,106,39,54,22,52,10,14,15,61,106
2006-01-02 00:00:00.000,Adelaide Australia ATP World Tour,HARD,2,Xavier Malisse,Mario Ancic,Xavier Malisse,3-6; 6-3; 7-6(8),R16,147,6,1,56,93,40,56,18,37,4,8,15,58,93,5,5,54,100,35,54,25,46,5,9,15,60,100
2006-01-02 00:00:00.000,Adelaide Australia ATP World Tour,HARD,2,Andreas Seppi,James Blake,Andreas Seppi,3-6; 6-3; 6-4,R16,113,5,2,79,111,48,79,19,32,12,14,14,67,111,4,2,45,87,33,45,21,42,6,9,14,54,87
2006-01-02 00:00:00.000,Adelaide Australia ATP World Tour,HARD,2,Jarkko Nieminen,Florian Mayer,Jarkko Nieminen,7-6(1); 7-5,R16,78,2,1,43,69,32,43,15,26,0,3,12,47,69,4,0,36,69,24,36,18,33,2,6,12,42,69
2006-01-02 00:00:00.000,Adelaide Australia ATP World Tour,HARD,2,Florent Serra,Tommy Robredo,Florent Serra,7-6(4); 3-6; 6-3,R16,129,0,2,67,105,47,67,18,38,6,9,15,65,105,5,3,57,100,41,57,21,43,10,13,15,62,100
2006-01-02 00:00:00.000,Adelaide Australia ATP World Tour,HARD,2,Kenneth Carlsen,Ivo Karlovic,Kenneth Carlsen,2-6; 7-6(5); 6-4,R16,117,4,5,54,86,43,54,17,32,1,3,15,60,86,24,2,56,84,45,56,19,28,2,3,15,64,84
2006-01-02 00:00:00.000,Adelaide Australia ATP World Tour,HARD,2,Dominik Hrbaty,Mark Philippoussis,Dominik Hrbaty,3-6; 6-4; 6-1,R16,111,4,6,54,89,39,54,16,35,6,9,13,55,89,5,1,41,85,26,41,21,44,7,12,13,47,85
2006-01-02 00:00:00.000,Adelaide Australia ATP World Tour,HARD,2,Tomas Berdych,Philipp Kohlschreiber,Tomas Berdych,6-1; 6-4,Q,55,5,2,28,50,24,28,13,22,0,0,9,37,50,2,2,30,47,19,30,7,17,3,6,8,26,47
2006-01-02 00:00:00.000,Adelaide Australia ATP World Tour,HARD,2,Xavier Malisse,Andreas Seppi,Xavier Malisse,6-0; 6-1,Q,48,6,0,19,29,16,19,8,10,0,0,6,24,29,2,2,27,50,16,27,2,23,7,13,7,18,50
2006-01-02 00:00:00.000,Adelaide Australia ATP World Tour,HARD,2,Florent Serra,Jarkko Nieminen,Florent Serra,6-4; 6-7(4); 6-2,Q,118,4,2,63,98,45,63,18,35,4,6,15,63,98,1,5,57,95,37,57,16,38,1,6,15,53,95
2006-01-02 00:00:00.000,Adelaide Australia ATP World Tour,HARD,2,Dominik Hrbaty,Kenneth Carlsen,Dominik Hrbaty,7-5; 6-3,Q,86,4,5,46,72,33,46,14,26,7,8,10,47,72,4,3,41,70,26,41,12,29,3,7,11,38,70
2006-01-02 00:00:00.000,Adelaide Australia ATP World Tour,HARD,2,Xavier Malisse,Tomas Berdych,Xavier Malisse,6-4; 6-0,S,61,5,2,29,58,19,29,17,29,4,5,8,36,58,2,2,21,41,12,21,4,20,0,5,8,16,41
2006-01-02 00:00:00.000,Adelaide Australia ATP World Tour,HARD,2,Florent Serra,Dominik Hrbaty,Florent Serra,6-3; 6-3,S,76,4,4,38,66,25,38,16,28,7,8,9,41,66,1,6,33,60,17,33,12,27,4,8,9,29,60
2006-01-02 00:00:00.000,Adelaide Australia ATP World Tour,HARD,2,Florent Serra,Xavier Malisse,Florent Serra,6-3; 6-4,F,71,7,0,41,63,30,41,14,22,6,6,10,44,63,12,1,41,64,26,41,11,23,3,5,9,37,64
2006-01-02 00:00:00.000,Chennai India ATP World Tour,HARD,2,Ivan Ljubicic,Guillermo Garcia-Lopez,Ivan Ljubicic,7-6(6); 7-5,R32,130,13,3,58,86,41,58,15,28,6,8,12,56,86,6,8,70,104,46,70,14,34,3,6,12,60,104
2006-01-02 00:00:00.000,Chennai India ATP World Tour,HARD,2,Jiri Vanek,Vishal Uppal,Jiri Vanek,6-3; 6-1,R32,58,3,0,30,44,24,30,7,14,4,5,8,31,44,2,6,24,53,15,24,9,29,0,5,8,24,53
2006-01-02 00:00:00.000,Chennai India ATP World Tour,HARD,2,Rohan Bopanna,Cyril Saulnier,Rohan Bopanna,6-3; 6-3,R32,55,7,3,38,58,29,38,11,20,3,3,9,40,58,3,3,28,45,21,28,8,17,0,3,9,29,45
2006-01-02 00:00:00.000,Chennai India ATP World Tour,HARD,2,Gilles Muller,Razvan Sabau,Gilles Muller,6-2; 7-6(5),R32,73,13,6,32,57,29,32,10,25,1,4,10,39,57,1,10,32,66,25,32,11,34,4,9,10,36,66
2006-01-02 00:00:00.000,Chennai India ATP World Tour,HARD,2,Paradorn Srichaphan,Ramon Delgado,Paradorn Srichaphan,4-6; 6-1; 7-6(3),R32,136,11,2,51,90,41,51,23,39,1,2,15,64,90,6,2,65,113,46,65,23,48,11,13,14,69,113
2006-01-02 00:00:00.000,Chennai India ATP World Tour,HARD,2,Marc Gicquel,Hyung-Taik Lee,Marc Gicquel,7-5; 6-4,R32,94,6,1,39,72,25,39,13,33,2,6,11,38,72,1,1,35,65,18,35,15,30,7,13,11,33,65
2006-01-02 00:00:00.000,Chennai India ATP World Tour,HARD,2,Kristof Vliegen,Jimmy Wang,Kristof Vliegen,6-3; 6-2,R32,70,7,2,36,49,25,36,7,13,5,6,8,32,49,4,6,32,66,20,32,13,34,4,9,9,33,66
2006-01-02 00:00:00.000,Chennai India ATP World Tour,HARD,2,Rainer Schuettler,Fernando Vicente,Rainer Schuettler,6-4; 6-3,R32,78,1,3,41,58,27,41,8,17,4,7,10,35,58,4,3,30,52,17,30,8,22,3,8,9,25,52
2006-01-02 00:00:00.000,Chennai India ATP World Tour,HARD,2,Bjorn Phau,Bobby Reynolds,Bjorn Phau,6-3; 6-0,R32,67,2,3,21,48,15,21,18,27,2,2,7,33,48,2,6,31,58,16,31,10,27,3,8,8,26,58
2006-01-02 00:00:00.000,Chennai India ATP World Tour,HARD,2,Michael Berrer,Lukas Dlouhy,Michael Berrer,3-6; 6-3; 6-2,R32,97,5,1,48,66,37,48,10,18,1,3,13,47,66,8,5,54,96,35,54,18,42,7,11,13,53,96
2006-01-02 00:00:00.000,Chennai India ATP World Tour,HARD,2,Justin Gimelstob,Alexander Waske,Justin Gimelstob,6-2; 6-2,R32,70,9,2,37,52,27,37,8,15,2,3,8,35,52,5,4,32,55,18,32,8,23,5,10,8,26,55
2006-01-02 00:00:00.000,Chennai India ATP World Tour,HARD,2,Carlos Moya,Dick Norman,Carlos Moya,6-4; 3-6; 6-1,R32,101,13,2,39,73,35,39,18,34,4,5,13,53,73,12,6,57,98,37,57,22,41,10,13,13,59,98
2006-01-02 00:00:00.000,Chennai India ATP World Tour,HARD,2,Tomas Behrend,Marcos Daniel,Tomas Behrend,6-3; 7-5,R32,76,7,4,39,61,33,39,10,22,4,5,10,43,61,3,2,38,62,24,38,14,24,2,6,11,38,62
2006-01-02 00:00:00.000,Chennai India ATP World Tour,HARD,2,Thierry Ascione,Simon Greul,Thierry Ascione,7-5; 6-1,R32,75,7,2,34,61,24,34,18,27,1,1,10,42,61,2,1,20,54,13,20,19,34,3,6,9,32,54
2006-01-02 00:00:00.000,Chennai India ATP World Tour,HARD,2,Prakash Amritraj,Ricardo Mello,Prakash Amritraj,2-6; 6-2; 6-3,R32,102,1,2,27,65,24,27,21,38,3,6,13,45,65,3,1,51,68,33,51,7,17,2,6,12,40,68
2006-01-02 00:00:00.000,Chennai India ATP World Tour,HARD,2,Radek Stepanek,Ivan Navarro,Radek Stepanek,6-4; 7-6(3),R32,92,3,1,48,68,39,48,14,20,2,2,11,53,68,9,4,35,80,30,35,22,45,2,3,11,52,80
2006-01-02 00:00:00.000,Chennai India ATP World Tour,HARD,2,Ivan Ljubicic,Jiri Vanek,Ivan Ljubicic,6-3; 3-6; 6-3,R16,107,10,0,50,86,40,50,20,36,5,6,14,60,86,10,3,53,83,41,53,14,30,7,9,13,55,83
2006-01-02 00:00:00.000,Chennai India ATP World Tour,HARD,2,Gilles Muller,Rohan Bopanna,Gilles Muller,6-3; 6-4,R16,67,6,2,39,51,32,39,9,12,0,0,10,41,51,4,2,39,56,28,39,7,17,6,8,9,35,56
2006-01-02 00:00:00.000,Chennai India ATP World Tour,HARD,2,Paradorn Srichaphan,Marc Gicquel,Paradorn Srichaphan,6-3; 6-7(5); 6-2,R16,128,6,4,45,87,37,45,26,42,0,0,15,63,87,8,2,51,113,39,51,31,62,10,13,14,70,113
2006-01-02 00:00:00.000,Chennai India ATP World Tour,HARD,2,Kristof Vliegen,Rainer Schuettler,Kristof Vliegen,6-2; 6-4,R16,65,3,1,37,52,25,37,11,15,4,5,9,36,52,1,2,27,47,18,27,8,20,2,6,9,26,47
2006-01-02 00:00:00.000,Chennai India ATP World Tour,HARD,2,Bjorn Phau,Michael Berrer,Bjorn Phau,1-6; 6-2; 6-4,R16,102,2,1,44,79,31,44,18,35,6,10,13,49,79,2,2,48,72,30,48,11,24,5,9,12,41,72
2006-01-02 00:00:00.000,Chennai India ATP World Tour,HARD,2,Carlos Moya,Justin Gimelstob,Carlos Moya,3-6; 6-3; 6-4,R16,100,12,2,50,74,35,50,15,24,1,4,14,50,74,11,2,57,86,40,57,10,29,3,7,14,50,86
2006-01-02 00:00:00.000,Chennai India ATP World Tour,HARD,2,Thierry Ascione,Tomas Behrend,Thierry Ascione,6-4; 6-1,R16,75,4,3,39,60,31,39,8,21,4,5,9,39,60,2,3,35,60,22,35,9,25,7,11,8,31,60
2006-01-02 00:00:00.000,Chennai India ATP World Tour,HARD,2,Radek Stepanek,Prakash Amritraj,Radek Stepanek,3-6; 6-0; 6-4,R16,104,8,1,49,60,36,49,10,11,1,2,12,46,60,3,2,62,90,36,62,16,28,7,11,13,52,90
2006-01-02 00:00:00.000,Chennai India ATP World Tour,HARD,2,Ivan Ljubicic,Gilles Muller,Ivan Ljubicic,6-1; 6-3,Q,60,7,0,27,41,22,27,11,14,0,0,8,33,41,3,4,35,56,22,35,7,21,3,7,8,29,56
2006-01-02 00:00:00.000,Chennai India ATP World Tour,HARD,2,Kristof Vliegen,Paradorn Srichaphan,Kristof Vliegen,6-1; 6-2,Q,53,5,1,23,33,22,23,6,10,0,0,7,28,33,4,1,30,59,14,30,15,29,5,10,8,29,59
2006-01-02 00:00:00.000,Chennai India ATP World Tour,HARD,2,Carlos Moya,Bjorn Phau,Carlos Moya,6-4; 4-6; 6-1,Q,108,7,3,54,86,41,54,17,32,3,5,14,58,86,1,1,56,93,34,56,20,37,8,12,13,54,93
2006-01-02 00:00:00.000,Chennai India ATP World Tour,HARD,2,Radek Stepanek,Thierry Ascione,Radek Stepanek,6-3; 6-4,Q,78,2,0,33,56,20,33,16,23,2,3,9,36,56,0,3,32,62,19,32,16,30,0,4,10,35,62
2006-01-02 00:00:00.000,Chennai India ATP World Tour,HARD,2,Ivan Ljubicic,Kristof Vliegen,Ivan Ljubicic,6-3; 3-6; 7-6(6),S,124,20,2,56,85,47,56,18,29,2,3,15,65,85,4,3,62,99,49,62,21,37,3,4,15,70,99
2006-01-02 00:00:00.000,Chennai India ATP World Tour,HARD,2,Carlos Moya,Radek Stepanek,Carlos Moya,6-4; 6-7(5); 7-6(3),S,165,12,4,66,115,49,66,32,49,8,9,17,81,115,5,3,66,109,48,66,25,43,4,6,17,73,109
2006-01-02 00:00:00.000,Chennai India ATP World Tour,HARD,2,Ivan Ljubicic,Carlos Moya,Ivan Ljubicic,7-6(6); 6-2,F,101,12,4,40,63,35,40,12,23,2,2,10,47,63,5,2,56,93,39,56,15,37,7,9,10,54,93
2006-01-02 00:00:00.000,Doha Qatar ATP World Tour,HARD,2,Roger Federer,Ivo Minar,Roger Federer,6-1; 6-3,R32,64,0,1,33,62,21,33,18,29,6,7,8,39,62,5,3,36,66,20,36,12,30,7,12,8,32,66
2006-01-02 00:00:00.000,Doha Qatar ATP World Tour,HARD,2,Fabrice Santoro,Oliver Marach,Fabrice Santoro,6-0; 2-6; 6-4,R32,125,3,3,57,89,34,57,16,32,7,11,12,50,89,1,2,43,74,27,43,12,31,7,13,12,39,74
2006-01-02 00:00:00.000,Doha Qatar ATP World Tour,HARD,2,Marcos Baghdatis,Sultan Khalfan,Marcos Baghdatis,6-1; 6-1,R32,69,4,4,13,39,12,13,18,26,0,0,7,30,39,0,3,30,54,17,30,6,24,6,11,7,23,54
2006-01-02 00:00:00.000,Doha Qatar ATP World Tour,HARD,2,Feliciano Lopez,Victor Hanescu,Feliciano Lopez,6-4; 7-6(2),R32,80,6,3,28,64,21,28,21,36,2,5,11,42,64,2,0,38,58,25,38,8,20,1,5,11,33,58
2006-01-02 00:00:00.000,Doha Qatar ATP World Tour,HARD,2,Tim Henman,Richard Gasquet,Tim Henman,6-4; 6-4,R32,98,2,2,50,75,38,50,10,25,4,5,10,48,75,2,2,48,73,28,48,14,25,9,12,10,42,73
2006-01-02 00:00:00.000,Doha Qatar ATP World Tour,HARD,2,Tommy Haas,Stanislas Wawrinka,Tommy Haas,5-7; 6-2; 7-5,R32,147,5,4,55,99,37,55,24,44,2,5,16,61,99,4,8,62,116,39,62,26,54,10,15,16,65,116
2006-01-02 00:00:00.000,Doha Qatar ATP World Tour,HARD,2,Mikhail Youzhny,Jonas Bjorkman,Mikhail Youzhny,1-6; 6-3; 6-4,R32,103,7,9,45,89,32,45,17,44,5,10,13,49,89,3,6,54,83,35,54,9,29,5,10,13,44,83
2006-01-02 00:00:00.000,Doha Qatar ATP World Tour,HARD,2,Davide Sanguinetti,Olivier Rochus,Davide Sanguinetti,2-6; 7-6(4); 7-6(5),R32,166,18,3,72,135,55,72,25,63,16,21,16,80,135,0,2,69,110,46,69,22,41,2,5,16,68,110
2006-01-02 00:00:00.000,Doha Qatar ATP World Tour,HARD,2,Gael Monfils,Tomas Zib,Gael Monfils,7-5; 6-4,R32,81,11,1,32,61,27,32,16,29,0,1,11,43,61,0,1,37,62,22,37,15,25,4,7,11,37,62
2006-01-02 00:00:00.000,Doha Qatar ATP World Tour,HARD,2,Wesley Moodie,Max Mirnyi,Wesley Moodie,6-4; 4-6; 7-6(3),R32,132,13,3,66,94,50,66,17,28,2,5,16,67,94,15,9,72,111,56,72,14,39,10,13,16,70,111
2006-01-02 00:00:00.000,Doha Qatar ATP World Tour,HARD,2,Dmitry Tursunov,Janko Tipsarevic,Dmitry Tursunov,7-5; 6-2,R32,85,5,2,31,63,21,31,20,32,5,6,10,41,63,3,0,40,77,26,40,16,37,5,9,10,42,77
2006-01-02 00:00:00.000,Doha Qatar ATP World Tour,HARD,2,Younes El Aynaoui,Sebastien Grosjean,Younes El Aynaoui,6-4; 6-4,R32,80,4,2,34,58,26,34,11,24,1,3,10,37,58,3,1,32,52,23,32,7,20,2,6,10,30,52
2006-01-02 00:00:00.000,Doha Qatar ATP World Tour,HARD,2,Potito Starace,Igor Andreev,Potito Starace,7-5; 1-6; 7-5,R32,130,5,4,63,99,43,63,14,36,7,11,15,57,99,6,4,59,90,44,59,13,31,2,6,16,57,90
2006-01-02 00:00:00.000,Doha Qatar ATP World Tour,HARD,2,Filippo Volandri,Nicolas Mahut,Filippo Volandri,6-4; 6-4,R32,80,0,1,43,66,30,43,13,23,7,9,10,43,66,2,2,40,63,24,40,9,23,6,10,10,33,63
2006-01-02 00:00:00.000,Doha Qatar ATP World Tour,HARD,2,Robin Vik,Andrei Pavel,Robin Vik,2-6; 7-6(2); 7-6(1),R32,145,7,4,85,109,54,85,11,24,3,8,16,65,109,1,3,79,109,48,79,18,30,6,9,16,66,109
2006-01-02 00:00:00.000,Doha Qatar ATP World Tour,HARD,2,Nikolay Davydenko,Christophe Rochus,Nikolay Davydenko,6-3; 6-1,R32,61,4,1,38,48,27,38,5,10,3,4,8,32,48,0,3,32,59,17,32,9,27,5,10,8,26,59
2006-01-02 00:00:00.000,Doha Qatar ATP World Tour,HARD,2,Roger Federer,Fabrice Santoro,Roger Federer,7-6(2); 7-6(5),R16,95,11,0,57,74,44,57,12,17,0,0,12,56,74,4,2,59,92,42,59,20,33,6,6,12,62,92
2006-01-02 00:00:00.000,Doha Qatar ATP World Tour,HARD,2,Marcos Baghdatis,Feliciano Lopez,Marcos Baghdatis,6-2; 3-6; 7-5,R16,112,10,3,54,86,41,54,20,32,5,6,14,61,86,7,9,55,95,41,55,19,40,7,10,15,60,95
2006-01-02 00:00:00.000,Doha Qatar ATP World Tour,HARD,2,Tommy Haas,Tim Henman,Tommy Haas,6-2; 7-6(5),R16,101,7,0,43,58,33,43,11,15,0,0,10,44,58,3,4,44,85,34,44,15,41,9,11,10,49,85
2006-01-02 00:00:00.000,Doha Qatar ATP World Tour,HARD,2,Mikhail Youzhny,Davide Sanguinetti,Mikhail Youzhny,6-2; 6-3,R16,76,0,1,31,55,23,31,15,24,1,1,9,38,55,3,1,38,55,24,38,5,17,5,8,8,29,55
2006-01-02 00:00:00.000,Doha Qatar ATP World Tour,HARD,2,Gael Monfils,Wesley Moodie,Gael Monfils,7-6(3); 6-4,R16,91,4,1,37,64,31,37,16,27,0,1,11,47,64,3,2,45,63,31,45,12,18,0,2,11,43,63
2006-01-02 00:00:00.000,Doha Qatar ATP World Tour,HARD,2,Dmitry Tursunov,Younes El Aynaoui,Dmitry Tursunov,7-6(1); 6-2,R16,97,7,2,40,74,31,40,16,34,9,10,10,47,74,5,4,31,65,23,31,14,34,2,5,10,37,65
2006-01-02 00:00:00.000,Doha Qatar ATP World Tour,HARD,2,Filippo Volandri,Potito Starace,Filippo Volandri,6-4; 6-3,R16,78,1,3,35,52,26,35,10,17,0,1,9,36,52,1,1,45,72,25,45,14,27,6,10,10,39,72
2006-01-02 00:00:00.000,Doha Qatar ATP World Tour,HARD,2,Nikolay Davydenko,Robin Vik,Nikolay Davydenko,6-3; 6-4,R16,91,2,2,36,52,27,36,10,16,4,5,9,37,52,2,2,51,80,31,51,12,29,5,9,10,43,80
2006-01-02 00:00:00.000,Doha Qatar ATP World Tour,HARD,2,Roger Federer,Marcos Baghdatis,Roger Federer,6-4; 6-3,Q,69,3,1,43,61,31,43,11,18,3,4,10,42,61,4,2,38,53,26,38,5,15,5,8,9,31,53
2006-01-02 00:00:00.000,Doha Qatar ATP World Tour,HARD,2,Tommy Haas,Mikhail Youzhny,Tommy Haas,6-4; 6-3,Q,81,1,2,43,64,28,43,10,21,6,9,10,38,64,2,5,27,65,17,27,15,38,7,12,9,32,65
2006-01-02 00:00:00.000,Doha Qatar ATP World Tour,HARD,2,Gael Monfils,Dmitry Tursunov,Gael Monfils,6-2; 7-6(4),Q,101,4,4,36,71,23,36,17,35,3,7,10,40,71,5,1,45,72,25,45,12,27,5,11,10,37,72
2006-01-02 00:00:00.000,Doha Qatar ATP World Tour,HARD,2,Filippo Volandri,Nikolay Davydenko,Filippo Volandri,6-3; 6-4,Q,89,0,7,45,76,32,45,16,31,6,7,10,48,76,1,3,32,60,20,32,14,28,4,7,9,34,60
2006-01-02 00:00:00.000,Doha Qatar ATP World Tour,HARD,2,Roger Federer,Tommy Haas,Roger Federer,6-3; 6-3,S,70,3,3,26,55,21,26,19,29,0,0,9,40,55,2,1,32,49,21,32,8,17,3,6,9,29,49
2006-01-02 00:00:00.000,Doha Qatar ATP World Tour,HARD,2,Gael Monfils,Filippo Volandri,Gael Monfils,6-3; 6-4,S,69,8,3,36,63,22,36,18,27,2,4,10,40,63,0,0,38,53,21,38,8,15,2,6,9,29,53
2006-01-02 00:00:00.000,Doha Qatar ATP World Tour,HARD,2,Roger Federer,Gael Monfils,Roger Federer,6-3; 7-6(5),F,115,2,0,40,69,28,40,18,29,4,6,11,46,69,12,8,47,96,31,47,20,49,12,15,10,51,96
2006-01-09 00:00:00.000,Auckland New Zealand ATP World Tour,HARD,2,Fernando Gonzalez,Luis Horna,Fernando Gonzalez,6-3; 6-4,R32,65,13,7,26,55,23,26,17,29,1,2,10,40,55,2,4,34,53,20,34,12,19,2,5,9,32,53
2006-01-09 00:00:00.000,Auckland New Zealand ATP World Tour,HARD,2,Ivo Minar,Wesley Moodie,Ivo Minar,2-1 RET,R32,14,1,1,14,22,12,14,1,8,4,4,2,13,22,0,1,3,5,3,3,1,2,0,0,1,4,5
2006-01-09 00:00:00.000,Auckland New Zealand ATP World Tour,HARD,2,Andy Murray,Kenneth Carlsen,Andy Murray,7-5; 6-2,R32,105,5,8,35,65,22,35,16,30,4,7,10,38,65,1,4,36,72,18,36,16,36,9,15,10,34,72
2006-01-09 00:00:00.000,Auckland New Zealand ATP World Tour,HARD,2,Mario Ancic,Mark Nielsen,Mario Ancic,6-1; 6-2,R32,77,10,1,23,48,18,23,18,25,2,2,8,36,48,1,1,46,60,22,46,7,14,5,9,7,29,60
2006-01-09 00:00:00.000,Auckland New Zealand ATP World Tour,HARD,2,Alberto Martin,Robby Ginepri,Alberto Martin,7-6(1); 3-6; 6-2,R32,113,3,5,53,90,35,53,18,37,4,10,15,53,90,4,1,53,94,32,53,18,41,9,15,14,50,94
2006-01-09 00:00:00.000,Auckland New Zealand ATP World Tour,HARD,2,Stanislas Wawrinka,Tomas Zib,Stanislas Wawrinka,6-3; 6-4,R32,76,8,2,42,67,33,42,12,25,1,2,10,45,67,3,1,33,62,21,33,15,29,4,7,9,36,62
2006-01-09 00:00:00.000,Auckland New Zealand ATP World Tour,HARD,2,Florian Mayer,Daniel King-Turner,Florian Mayer,6-2; 6-2,R32,63,2,1,25,41,23,25,10,16,1,1,8,33,41,3,4,42,67,24,42,9,25,3,7,8,33,67
2006-01-09 00:00:00.000,Auckland New Zealand ATP World Tour,HARD,2,Robin Vik,Feliciano Lopez,Robin Vik,7-6(6); 6-1,R32,81,6,7,38,67,29,38,15,29,5,7,9,44,67,3,5,46,80,28,46,13,34,10,15,10,41,80
2006-01-09 00:00:00.000,Auckland New Zealand ATP World Tour,HARD,2,Jarkko Nieminen,Marcos Baghdatis,Jarkko Nieminen,6-2; 6-2,R32,51,2,0,29,42,22,29,11,13,0,0,8,33,42,3,6,27,49,19,27,5,22,6,10,8,24,49
2006-01-09 00:00:00.000,Auckland New Zealand ATP World Tour,HARD,2,Paul Goldstein,Filippo Volandri,Paul Goldstein,6-0; 3-1 RET,R32,39,1,0,13,27,10,13,10,14,0,0,5,20,27,0,4,26,40,14,26,3,14,6,10,5,17,40
2006-01-09 00:00:00.000,Auckland New Zealand ATP World Tour,HARD,2,Christophe Rochus,Jose Acasuso,Christophe Rochus,6-4; 6-4,R32,66,1,3,44,64,35,44,9,20,9,10,10,44,64,9,3,30,54,21,30,12,24,3,6,10,33,54
2006-01-09 00:00:00.000,Auckland New Zealand ATP World Tour,HARD,2,Nicolas Massu,Dominik Hrbaty,Nicolas Massu,6-2; 6-4,R32,91,6,0,30,55,22,30,16,25,1,2,9,38,55,3,4,27,70,16,27,19,43,5,9,9,35,70
2006-01-09 00:00:00.000,Auckland New Zealand ATP World Tour,HARD,2,Olivier Rochus,Albert Montanes,Olivier Rochus,6-2; 6-4,R32,60,3,0,29,47,20,29,15,18,3,4,9,35,47,6,6,35,63,23,35,10,28,3,7,9,33,63
2006-01-09 00:00:00.000,Auckland New Zealand ATP World Tour,HARD,2,Jan Hernych,Andrei Pavel,Jan Hernych,6-1; 6-2,R32,53,2,0,47,60,29,47,11,13,5,5,8,40,60,0,0,35,46,17,35,4,11,4,8,7,21,46
2006-01-09 00:00:00.000,Auckland New Zealand ATP World Tour,HARD,2,Raemon Sluiter,Daniele Bracciali,Raemon Sluiter,6-3; 6-4,R32,63,13,1,26,47,25,26,16,21,0,0,10,41,47,5,5,24,62,17,24,19,38,4,6,9,36,62
2006-01-09 00:00:00.000,Auckland New Zealand ATP World Tour,HARD,2,David Ferrer,Federico Luzzi,David Ferrer,7-5; 6-2,R32,67,5,0,36,54,25,36,15,18,4,5,10,40,54,3,2,29,56,18,29,14,27,2,6,10,32,56
2006-01-09 00:00:00.000,Auckland New Zealand ATP World Tour,HARD,2,Fernando Gonzalez,Ivo Minar,Fernando Gonzalez,6-1; 6-4,R16,56,6,8,30,57,23,30,12,27,3,5,9,35,57,1,3,20,46,13,20,8,26,3,8,8,21,46
2006-01-09 00:00:00.000,Auckland New Zealand ATP World Tour,HARD,2,Mario Ancic,Andy Murray,Mario Ancic,6-3; 7-6(4),R16,95,6,2,48,80,36,48,16,32,8,10,11,52,80,1,4,32,62,22,32,17,30,2,5,10,39,62
2006-01-09 00:00:00.000,Auckland New Zealand ATP World Tour,HARD,2,Stanislas Wawrinka,Alberto Martin,Stanislas Wawrinka,6-2; 6-2,R16,69,5,3,20,41,19,20,10,21,1,2,8,29,41,0,1,41,66,22,41,9,25,10,15,8,31,66
2006-01-09 00:00:00.000,Auckland New Zealand ATP World Tour,HARD,2,Florian Mayer,Robin Vik,Florian Mayer,6-2; 6-2,R16,56,1,1,25,46,16,25,14,21,1,2,8,30,46,0,1,25,48,11,25,10,23,3,8,8,21,48
2006-01-09 00:00:00.000,Auckland New Zealand ATP World Tour,HARD,2,Jarkko Nieminen,Paul Goldstein,Jarkko Nieminen,6-4; 6-3,R16,74,5,0,39,56,29,39,11,17,1,2,10,40,56,3,2,36,59,22,36,11,23,2,5,9,33,59
2006-01-09 00:00:00.000,Auckland New Zealand ATP World Tour,HARD,2,Nicolas Massu,Christophe Rochus,Nicolas Massu,6-4; 6-2,R16,85,9,4,33,58,25,33,13,25,1,2,9,38,58,2,0,45,65,26,45,8,20,8,12,9,34,65
2006-01-09 00:00:00.000,Auckland New Zealand ATP World Tour,HARD,2,Olivier Rochus,Jan Hernych,Olivier Rochus,6-1; 7-5,R16,93,1,2,44,72,27,44,15,28,5,7,9,42,72,7,2,62,91,35,62,8,29,7,13,10,43,91
2006-01-09 00:00:00.000,Auckland New Zealand ATP World Tour,HARD,2,David Ferrer,Raemon Sluiter,David Ferrer,6-4; 6-3,R16,65,4,2,40,65,29,40,15,25,4,5,10,44,65,1,3,24,47,15,24,12,23,1,4,9,27,47
2006-01-09 00:00:00.000,Auckland New Zealand ATP World Tour,HARD,2,Mario Ancic,Fernando Gonzalez,Mario Ancic,6-0; 6-3,Q,53,6,1,35,48,27,35,8,13,5,5,8,35,48,2,5,23,39,14,23,4,16,4,8,7,18,39
2006-01-09 00:00:00.000,Auckland New Zealand ATP World Tour,HARD,2,Stanislas Wawrinka,Florian Mayer,Stanislas Wawrinka,6-3; 6-4,Q,64,4,7,26,54,23,26,17,28,0,0,10,40,54,3,0,37,63,26,37,13,26,7,9,9,39,63
2006-01-09 00:00:00.000,Auckland New Zealand ATP World Tour,HARD,2,Jarkko Nieminen,Nicolas Massu,Jarkko Nieminen,6-3; 7-6(4),Q,92,1,1,55,75,41,55,11,20,1,1,10,52,75,6,3,34,56,24,34,15,22,0,2,11,39,56
2006-01-09 00:00:00.000,Auckland New Zealand ATP World Tour,HARD,2,Olivier Rochus,David Ferrer,Olivier Rochus,6-2; 6-0,Q,50,0,0,22,35,18,22,11,13,0,0,7,29,35,2,2,27,43,14,27,4,16,4,9,7,18,43
2006-01-09 00:00:00.000,Auckland New Zealand ATP World Tour,HARD,2,Mario Ancic,Stanislas Wawrinka,Mario Ancic,6-3; 6-1,S,78,2,2,35,57,23,35,13,22,2,3,8,36,57,1,4,21,54,11,21,14,33,1,6,8,25,54
2006-01-09 00:00:00.000,Auckland New Zealand ATP World Tour,HARD,2,Jarkko Nieminen,Olivier Rochus,Jarkko Nieminen,6-4; 6-7(4); 7-6(4),S,172,10,5,116,166,70,116,22,50,15,21,17,92,166,5,2,73,122,41,73,28,49,8,15,17,69,122
2006-01-09 00:00:00.000,Auckland New Zealand ATP World Tour,HARD,2,Jarkko Nieminen,Mario Ancic,Jarkko Nieminen,6-2; 6-2,F,61,0,0,37,54,26,37,11,17,3,3,8,37,54,1,0,28,45,17,28,5,17,1,5,8,22,45
2006-01-09 00:00:00.000,Sydney Australia ATP World Tour,HARD,2,Lleyton Hewitt,Vincent Spadea,Lleyton Hewitt,2-6; 7-5; 6-3,R32,122,6,10,50,98,36,50,25,48,11,14,15,61,98,2,3,38,80,28,38,22,42,2,5,14,50,80
2006-01-09 00:00:00.000,Sydney Australia ATP World Tour,HARD,2,Jurgen Melzer,Juan Ignacio Chela,Jurgen Melzer,6-2; 7-6(1),R32,75,3,3,32,62,28,32,14,30,1,2,10,42,62,0,1,35,55,20,35,13,20,1,4,10,33,55
2006-01-09 00:00:00.000,Sydney Australia ATP World Tour,HARD,2,Andreas Seppi,Kristof Vliegen,Andreas Seppi,6-3; 6-7(3); 6-3,R32,122,2,1,59,87,37,59,17,28,3,6,14,54,87,8,2,83,111,46,83,17,28,4,11,16,63,111
2006-01-09 00:00:00.000,Sydney Australia ATP World Tour,HARD,2,Chris Guccione,Juan Carlos Ferrero,Chris Guccione,4-6; 6-3; 7-5,R32,97,27,4,47,82,44,47,18,35,0,1,16,62,82,6,2,50,80,40,50,17,30,1,3,15,57,80
2006-01-09 00:00:00.000,Sydney Australia ATP World Tour,HARD,2,Igor Andreev,Richard Gasquet,Igor Andreev,6-2; 6-4,R32,65,2,2,33,53,22,33,14,20,3,4,9,36,53,1,4,24,50,15,24,11,26,3,7,9,26,50
2006-01-09 00:00:00.000,Sydney Australia ATP World Tour,HARD,2,Peter Luczak,Xavier Malisse,Peter Luczak,7-6(5); 7-6(3),R32,111,4,6,53,82,41,53,14,29,2,4,12,55,82,3,4,39,84,30,39,23,45,4,6,12,53,84
2006-01-09 00:00:00.000,Sydney Australia ATP World Tour,HARD,2,Florent Serra,Fabrice Santoro,Florent Serra,5-7; 6-2; 6-4,R32,126,3,2,67,106,41,67,20,39,7,11,15,61,106,3,7,48,92,32,48,18,44,7,13,15,50,92
2006-01-09 00:00:00.000,Sydney Australia ATP World Tour,HARD,2,Dmitry Tursunov,Tommy Robredo,Dmitry Tursunov,7-6(4); 6-3,R32,93,7,4,39,79,24,39,25,40,3,4,10,49,79,2,1,40,69,25,40,13,29,1,4,11,38,69
2006-01-09 00:00:00.000,Sydney Australia ATP World Tour,HARD,2,James Blake,Davide Sanguinetti,James Blake,7-6(4); 6-4,R32,84,5,3,47,78,37,47,15,31,2,3,11,52,78,2,7,39,74,29,39,17,35,2,4,11,46,74
2006-01-09 00:00:00.000,Sydney Australia ATP World Tour,HARD,2,Carlos Moya,Sebastien Grosjean,Carlos Moya,5-7; 7-5; 7-6(4),R32,153,10,8,60,109,44,60,30,49,3,6,18,74,109,9,1,65,125,52,65,29,60,15,18,18,81,125
2006-01-09 00:00:00.000,Sydney Australia ATP World Tour,HARD,2,Arnaud Clement,Taylor Dent,Arnaud Clement,6-1; 2-6; 6-2,R32,60,4,2,34,66,26,34,20,32,4,6,12,46,66,7,8,29,66,21,29,18,37,6,10,11,39,66
2006-01-09 00:00:00.000,Sydney Australia ATP World Tour,HARD,2,Juan Monaco,Fernando Verdasco,Juan Monaco,6-3; 6-2,R32,63,2,1,30,50,25,30,14,20,2,2,9,39,50,2,5,25,47,21,25,7,22,4,7,8,28,47
2006-01-09 00:00:00.000,Sydney Australia ATP World Tour,HARD,2,Paradorn Srichaphan,Radek Stepanek,Paradorn Srichaphan,6-3; 6-4,R32,71,10,3,36,59,29,36,15,23,2,2,10,44,59,4,3,26,45,19,26,11,19,1,3,9,30,45
2006-01-09 00:00:00.000,Sydney Australia ATP World Tour,HARD,2,Ivo Karlovic,Victor Hanescu,Ivo Karlovic,7-6(7); 3-6; 6-3,R32,124,11,2,57,89,44,57,19,32,4,5,15,63,89,3,3,53,91,39,53,24,38,3,4,15,63,91
2006-01-09 00:00:00.000,Sydney Australia ATP World Tour,HARD,2,Agustin Calleri,Paul-Henri Mathieu,Agustin Calleri,6-4; 6-3,R32,85,4,5,13,45,10,13,17,32,1,4,9,27,45,0,8,34,72,20,34,14,38,3,9,10,34,72
2006-01-09 00:00:00.000,Sydney Australia ATP World Tour,HARD,2,Nikolay Davydenko,Tomas Berdych,Nikolay Davydenko,7-6(4); 6-3,R32,106,1,2,47,74,34,47,14,27,4,6,11,48,74,4,5,41,79,27,41,17,38,6,9,10,44,79
2006-01-09 00:00:00.000,Sydney Australia ATP World Tour,HARD,2,Lleyton Hewitt,Jurgen Melzer,Lleyton Hewitt,6-1; 6-4,R16,84,6,2,35,68,25,35,16,33,3,4,9,41,68,1,4,36,70,19,36,17,34,7,11,8,36,70
2006-01-09 00:00:00.000,Sydney Australia ATP World Tour,HARD,2,Andreas Seppi,Chris Guccione,Andreas Seppi,7-5; 7-6(2),R16,83,5,6,38,70,31,38,20,32,4,6,12,51,70,15,5,55,91,38,55,15,36,10,13,12,53,91
2006-01-09 00:00:00.000,Sydney Australia ATP World Tour,HARD,2,Igor Andreev,Peter Luczak,Igor Andreev,6-7(6); 7-6(5); 7-6(6),R16,195,6,7,94,132,69,94,13,38,4,8,18,82,132,3,3,106,136,65,106,17,30,6,10,18,82,136
2006-01-09 00:00:00.000,Sydney Australia ATP World Tour,HARD,2,Dmitry Tursunov,Florent Serra,Dmitry Tursunov,7-6(3); 6-2,R16,78,6,2,37,61,30,37,13,24,1,2,10,43,61,2,0,39,69,21,39,17,30,4,7,10,38,69
2006-01-09 00:00:00.000,Sydney Australia ATP World Tour,HARD,2,James Blake,Carlos Moya,James Blake,W/O,R16,0,0,0,0,0,0,0,0,0,0,0,0,0,0,0,0,0,0,0,0,0,0,0,0,0,0,0
2006-01-09 00:00:00.000,Sydney Australia ATP World Tour,HARD,2,Arnaud Clement,Juan Monaco,Arnaud Clement,7-6(3); 6-3,R16,112,4,3,28,63,20,28,26,35,1,1,10,46,63,1,1,41,71,26,41,18,30,3,5,11,44,71
2006-01-09 00:00:00.000,Sydney Australia ATP World Tour,HARD,2,Paradorn Srichaphan,Ivo Karlovic,Paradorn Srichaphan,7-6(5); 7-6(6),R16,109,2,5,43,82,35,43,26,39,1,2,12,61,82,21,4,47,83,42,47,16,36,2,3,12,58,83
2006-01-09 00:00:00.000,Sydney Australia ATP World Tour,HARD,2,Nikolay Davydenko,Agustin Calleri,Nikolay Davydenko,6-4; 7-6(4),R16,109,1,3,71,95,44,71,15,24,8,10,11,59,95,2,4,42,71,29,42,14,29,2,5,11,43,71
2006-01-09 00:00:00.000,Sydney Australia ATP World Tour,HARD,2,Andreas Seppi,Lleyton Hewitt,Andreas Seppi,4-6; 7-5; 7-5,Q,137,8,2,64,108,42,64,20,44,5,11,17,62,108,5,4,53,92,38,53,16,39,4,11,17,54,92
2006-01-09 00:00:00.000,Sydney Australia ATP World Tour,HARD,2,Igor Andreev,Dmitry Tursunov,Igor Andreev,6-2; 3-6; 6-4,Q,121,7,4,57,85,37,57,13,28,7,10,13,50,85,8,1,62,102,38,62,19,40,9,14,14,57,102
2006-01-09 00:00:00.000,Sydney Australia ATP World Tour,HARD,2,James Blake,Arnaud Clement,James Blake,3-6; 6-1; 6-4,Q,121,11,5,51,96,39,51,22,45,4,5,13,61,96,7,5,53,96,37,53,20,43,8,11,13,57,96
2006-01-09 00:00:00.000,Sydney Australia ATP World Tour,HARD,2,Nikolay Davydenko,Paradorn Srichaphan,Nikolay Davydenko,W/O,Q,0,0,0,0,0,0,0,0,0,0,0,0,0,0,0,0,0,0,0,0,0,0,0,0,0,0,0
2006-01-09 00:00:00.000,Sydney Australia ATP World Tour,HARD,2,Igor Andreev,Andreas Seppi,Igor Andreev,6-2; 2-6; 6-2,S,97,2,5,48,78,33,48,15,30,1,3,12,48,78,1,1,28,64,21,28,18,36,0,4,12,39,64
2006-01-09 00:00:00.000,Sydney Australia ATP World Tour,HARD,2,James Blake,Nikolay Davydenko,James Blake,6-4; 6-2,S,83,7,1,43,75,26,43,16,32,8,11,9,42,75,1,4,34,57,20,34,5,23,3,9,9,25,57
2006-01-09 00:00:00.000,Sydney Australia ATP World Tour,HARD,2,James Blake,Igor Andreev,James Blake,6-2; 3-6; 7-6(3),F,109,9,3,53,95,38,53,22,42,4,7,14,60,95,7,4,61,92,44,61,14,31,5,9,15,58,92
2006-01-16 00:00:00.000,Australian Open Australia Grand Slams,HARD,3,Roger Federer,Denis Istomin,Roger Federer,6-2; 6-3; 6-2,R128,83,2,0,46,67,38,46,12,21,2,3,13,50,67,8,3,53,83,31,53,11,30,5,11,12,42,83
2006-01-16 00:00:00.000,Australian Open Australia Grand Slams,HARD,3,Florian Mayer,Hyung-Taik Lee,Florian Mayer,6-4; 6-1; 4-6; 6-4,R128,138,10,3,54,107,42,54,23,53,2,7,18,65,107,2,4,71,113,36,71,22,42,5,14,19,58,113
2006-01-16 00:00:00.000,Australian Open Australia Grand Slams,HARD,3,Davide Sanguinetti,Jacob Adaktusson,Davide Sanguinetti,7-6(5); 6-3; 6-2,R128,111,5,1,52,92,40,52,25,40,3,4,14,65,92,5,3,60,112,39,60,22,52,7,12,15,61,112
2006-01-16 00:00:00.000,Australian Open Australia Grand Slams,HARD,3,Max Mirnyi,Thierry Ascione,Max Mirnyi,6-3; 3-6; 6-1; 6-7(4); 6-0,R128,155,11,7,107,145,78,107,20,38,10,12,22,98,145,4,4,99,130,65,99,13,31,5,12,21,78,130
2006-01-16 00:00:00.000,Australian Open Australia Grand Slams,HARD,3,Olivier Rochus,Michael Llodra,Olivier Rochus,6-4; 6-2; 6-2,R128,96,2,0,48,73,34,48,21,25,3,3,13,55,73,9,2,45,78,30,45,14,33,2,7,13,44,78
2006-01-16 00:00:00.000,Australian Open Australia Grand Slams,HARD,3,Peter Luczak,Ivo Minar,Peter Luczak,7-6(4); 7-6(5); 6-4,R128,120,15,2,69,107,54,69,26,38,2,3,17,80,107,12,0,54,101,44,54,31,47,2,4,17,75,101
2006-01-16 00:00:00.000,Australian Open Australia Grand Slams,HARD,3,Paul Goldstein,Novak Djokovic,Paul Goldstein,6-2; 1-6; 6-3; 6-2,R128,148,2,7,72,116,51,72,20,44,10,13,16,71,116,6,9,71,114,44,71,18,43,13,19,16,62,114
2006-01-16 00:00:00.000,Australian Open Australia Grand Slams,HARD,3,Tommy Haas,Richard Gasquet,Tommy Haas,6-2; 7-5; 6-2,R128,111,7,1,56,91,44,56,19,35,10,11,14,63,91,4,4,39,78,25,39,20,39,4,10,14,45,78
2006-01-16 00:00:00.000,Australian Open Australia Grand Slams,HARD,3,Dominik Hrbaty,Oliver Marach,Dominik Hrbaty,3-6; 4-6; 6-2; 6-1; 6-3,R128,183,7,8,66,113,46,66,26,47,3,9,21,72,113,12,9,79,166,53,79,32,87,13,23,22,85,166
2006-01-16 00:00:00.000,Australian Open Australia Grand Slams,HARD,3,Dick Norman,Zack Fleishman,Dick Norman,6-4; 7-6(6); 5-7; 0-6; 6-3,R128,211,18,9,112,179,81,112,22,67,17,25,25,103,179,6,9,84,161,58,84,41,77,7,13,24,99,161
2006-01-16 00:00:00.000,Australian Open Australia Grand Slams,HARD,3,Raemon Sluiter,Pavel Snobel,Raemon Sluiter,6-4; 2-6; 6-2; 6-4,R128,124,7,5,54,95,42,54,25,41,1,4,18,67,95,5,7,56,121,36,56,38,65,8,13,18,74,121
2006-01-16 00:00:00.000,Australian Open Australia Grand Slams,HARD,3,Igor Andreev,Nicolas Almagro,Igor Andreev,7-5; 6-4; 6-3,R128,109,3,1,63,99,47,63,19,36,3,5,16,66,99,7,2,64,88,38,64,14,24,7,12,15,52,88
2006-01-16 00:00:00.000,Australian Open Australia Grand Slams,HARD,3,Nathan Healey,Filippo Volandri,Nathan Healey,6-2; 6-3 RET,R128,68,3,4,23,42,18,23,13,19,1,2,8,31,42,1,3,48,72,25,48,8,24,7,12,9,33,72
2006-01-16 00:00:00.000,Australian Open Australia Grand Slams,HARD,3,Amer Delic,Potito Starace,Amer Delic,7-5; 6-7(3); 6-3; 3-6; 6-3,R128,196,14,8,109,178,77,109,37,69,9,12,26,114,178,6,5,122,163,79,122,25,41,10,15,25,104,163
2006-01-16 00:00:00.000,Australian Open Australia Grand Slams,HARD,3,Kevin Kim,Harel Levy,Kevin Kim,6-4; 6-4; 6-0,R128,97,8,6,58,93,42,58,19,35,7,8,13,61,93,2,4,59,94,34,59,13,35,3,9,13,47,94
2006-01-16 00:00:00.000,Australian Open Australia Grand Slams,HARD,3,Nikolay Davydenko,Ivo Karlovic,Nikolay Davydenko,7-5; 4-6; 3-6; 7-5; 6-3,R128,201,5,4,126,155,92,126,18,29,7,9,26,110,155,31,4,107,166,85,107,26,59,8,11,26,111,166
2006-01-16 00:00:00.000,Australian Open Australia Grand Slams,HARD,3,Lleyton Hewitt,Robin Vik,Lleyton Hewitt,6-4; 2-6; 5-7; 7-6(4); 6-3,R128,226,11,13,107,186,68,107,33,79,20,29,25,101,186,8,13,104,165,71,104,22,61,12,21,26,93,165
2006-01-16 00:00:00.000,Australian Open Australia Grand Slams,HARD,3,Juan Ignacio Chela,Andy Murray,Juan Ignacio Chela,6-1; 6-3; 6-3,R128,106,1,1,54,84,38,54,20,30,3,3,13,58,84,7,1,39,77,25,39,17,38,3,8,12,42,77
2006-01-16 00:00:00.000,Australian Open Australia Grand Slams,HARD,3,Kristof Vliegen,Christophe Rochus,Kristof Vliegen,6-3; 6-1; 6-4,R128,87,17,3,58,88,46,58,14,30,4,5,13,60,88,1,2,37,65,20,37,14,28,2,8,13,34,65
2006-01-16 00:00:00.000,Australian Open Australia Grand Slams,HARD,3,Fernando Verdasco,Kenneth Carlsen,Fernando Verdasco,7-6(5); 6-4; 6-4,R128,134,3,6,63,100,53,63,20,37,6,6,16,73,100,7,5,66,117,50,66,24,51,13,15,16,74,117
2006-01-16 00:00:00.000,Australian Open Australia Grand Slams,HARD,3,Nicolas Kiefer,Paradorn Srichaphan,Nicolas Kiefer,6-7(5); 4-6; 7-6(5); 6-1; 6-2,R128,230,11,6,74,158,53,74,48,84,6,13,25,101,158,6,13,72,150,41,72,36,78,6,16,24,77,150
2006-01-16 00:00:00.000,Australian Open Australia Grand Slams,HARD,3,Boris Pashanski,Wayne Arthurs,Boris Pashanski,6-3; 6-4; 4-6; 7-6(2),R128,161,6,0,82,122,61,82,27,40,4,5,20,88,122,29,9,63,134,50,63,35,71,6,9,21,85,134
2006-01-16 00:00:00.000,Australian Open Australia Grand Slams,HARD,3,Janko Tipsarevic,Andreas Seppi,Janko Tipsarevic,1-6; 6-4; 4-6; 6-2; 6-4,R128,184,9,3,78,147,53,78,35,69,7,14,23,88,147,9,5,62,129,44,62,31,67,7,14,22,75,129
2006-01-16 00:00:00.000,Australian Open Australia Grand Slams,HARD,3,Juan Carlos Ferrero,Tomas Zib,Juan Carlos Ferrero,7-5; 6-0; 6-2,R128,97,8,0,40,70,29,40,20,30,1,3,13,49,70,3,3,50,80,27,50,11,30,4,12,13,38,80
2006-01-16 00:00:00.000,Australian Open Australia Grand Slams,HARD,3,Alex Bogomolov Jr.,Fernando Gonzalez,Alex Bogomolov Jr.,4-6; 7-6(6); 6-3; 6-7(3); 7-5,R128,245,7,10,154,217,98,154,25,63,14,22,28,123,217,10,14,98,178,70,98,36,80,4,13,27,106,178
2006-01-16 00:00:00.000,Australian Open Australia Grand Slams,HARD,3,Paul-Henri Mathieu,Arnaud Clement,Paul-Henri Mathieu,6-3; 7-6(4); 6-3,R128,152,11,3,62,106,45,62,23,44,5,7,16,68,106,5,2,51,89,36,51,15,38,3,7,14,51,89
2006-01-16 00:00:00.000,Australian Open Australia Grand Slams,HARD,3,Bjorn Phau,Carlos Berlocq,Bjorn Phau,6-4; 7-6(3); 2-6; 7-6(4),R128,192,2,5,70,138,44,70,35,68,8,17,21,79,138,6,6,75,132,45,75,28,57,4,12,21,73,132
2006-01-16 00:00:00.000,Australian Open Australia Grand Slams,HARD,3,Luis Horna,Gael Monfils,Luis Horna,6-4; 7-5; 6-1,R128,114,1,2,63,75,46,63,8,12,1,2,14,54,75,6,6,46,91,32,46,19,45,5,11,15,51,91
2006-01-16 00:00:00.000,Australian Open Australia Grand Slams,HARD,3,Sebastien Grosjean,Mark Philippoussis,Sebastien Grosjean,6-4; 6-2; 6-3,R128,107,6,1,31,69,23,31,29,38,1,2,13,52,69,3,9,48,82,28,48,16,34,3,9,14,44,82
2006-01-16 00:00:00.000,Australian Open Australia Grand Slams,HARD,3,Juan Monaco,Jean-Rene Lisnard,Juan Monaco,4-6; 6-2; 6-4; 6-3,R128,154,2,4,66,114,45,66,27,48,9,13,19,72,114,1,9,45,123,36,45,31,78,7,14,18,67,123
2006-01-16 00:00:00.000,Australian Open Australia Grand Slams,HARD,3,Federico Luzzi,Juan Antonio Marin,Federico Luzzi,6-1; 6-4; 7-5,R128,115,8,2,46,83,40,46,17,37,1,3,15,57,83,0,1,49,81,30,49,17,32,6,12,14,47,81
2006-01-16 00:00:00.000,Australian Open Australia Grand Slams,HARD,3,Guillermo Coria,Victor Hanescu,Guillermo Coria,6-4; 1-6; 4-6; 6-2; 6-1,R128,209,2,17,107,156,61,107,16,49,14,24,21,77,156,9,7,100,148,54,100,15,48,16,28,21,69,148
2006-01-16 00:00:00.000,Australian Open Australia Grand Slams,HARD,3,Gaston Gaudio,Razvan Sabau,Gaston Gaudio,6-2; 5-0 RET,R128,56,6,2,23,42,19,23,10,19,1,2,7,29,42,1,9,23,45,13,23,6,22,6,11,6,19,45
2006-01-16 00:00:00.000,Australian Open Australia Grand Slams,HARD,3,Lars Burgsmuller,Rainer Schuettler,Lars Burgsmuller,3-6; 6-3; 7-6(2); 6-3,R128,170,3,5,73,127,50,73,24,54,9,15,20,74,127,2,3,60,105,40,60,20,45,3,10,19,60,105
2006-01-16 00:00:00.000,Australian Open Australia Grand Slams,HARD,3,Fabrice Santoro,Vincent Spadea,Fabrice Santoro,3-6; 6-0; 6-2; 6-3,R128,123,1,1,50,87,34,50,24,37,3,6,16,58,87,0,7,59,110,34,59,21,51,10,18,16,55,110
2006-01-16 00:00:00.000,Australian Open Australia Grand Slams,HARD,3,Andrei Pavel,Carlos Moya,Andrei Pavel,6-4; 7-6(5); 4-6; 3-6; 6-4,R128,224,0,3,100,148,70,100,21,48,2,8,25,91,148,8,4,98,179,69,98,40,81,16,22,26,109,179
2006-01-16 00:00:00.000,Australian Open Australia Grand Slams,HARD,3,Mario Ancic,Agustin Calleri,Mario Ancic,6-4; 4-6; 6-3; 6-4,R128,166,9,4,69,122,54,69,23,53,6,10,20,77,122,6,7,60,118,41,60,29,58,13,19,19,70,118
2006-01-16 00:00:00.000,Australian Open Australia Grand Slams,HARD,3,Jan Hernych,Fernando Vicente,Jan Hernych,2-6; 6-3; 7-6(5); 6-2,R128,159,5,4,95,134,67,95,19,39,7,10,19,86,134,4,5,88,132,58,88,22,44,9,13,18,80,132
2006-01-16 00:00:00.000,Australian Open Australia Grand Slams,HARD,3,Daniele Bracciali,Yen-Hsun Lu,Daniele Bracciali,6-1; 7-6(4); 6-2,R128,0,0,0,0,0,0,0,0,0,0,0,18,0,0,0,0,0,0,0,0,0,0,0,0,9,0,0
2006-01-16 00:00:00.000,Australian Open Australia Grand Slams,HARD,3,David Ferrer,Florent Serra,David Ferrer,4-6; 6-3; 6-1; 6-4,R128,149,3,4,70,107,43,70,19,37,4,10,18,62,107,2,4,97,155,62,97,14,58,10,20,18,76,155
2006-01-16 00:00:00.000,Australian Open Australia Grand Slams,HARD,3,Tommy Robredo,Jiri Vanek,Tommy Robredo,6-4; 7-6(6); 6-3,R128,125,10,4,75,104,55,75,16,29,4,5,16,71,104,8,10,73,111,52,73,14,38,8,11,15,66,111
2006-01-16 00:00:00.000,Australian Open Australia Grand Slams,HARD,3,Dmitry Tursunov,Tim Henman,Dmitry Tursunov,5-7; 6-3; 6-4; 7-5,R128,194,7,8,84,149,61,84,26,65,10,16,21,87,149,5,5,93,144,56,93,22,51,9,18,22,78,144
2006-01-16 00:00:00.000,Australian Open Australia Grand Slams,HARD,3,Jean-Christophe Faurel,Alexander Waske,Jean-Christophe Faurel,7-6(5); 6-3; 7-6(2),R128,153,7,4,73,102,56,73,15,29,0,1,16,71,102,17,5,81,120,57,81,14,39,4,7,17,71,120
2006-01-16 00:00:00.000,Australian Open Australia Grand Slams,HARD,3,James Blake,Jose Acasuso,James Blake,6-2; 6-3; 4-6; 7-6(4),R128,155,11,2,73,133,51,73,32,60,9,13,20,83,133,11,3,66,124,42,66,31,58,11,17,19,73,124
2006-01-16 00:00:00.000,Australian Open Australia Grand Slams,HARD,3,Jarkko Nieminen,Marc Kimmich,Jarkko Nieminen,6-2; 6-3; 6-1,R128,88,2,2,56,77,41,56,10,21,1,2,12,51,77,4,4,31,67,18,31,15,36,1,8,12,33,67
2006-01-16 00:00:00.000,Australian Open Australia Grand Slams,HARD,3,Jimmy Wang,Mariano Zabaleta,Jimmy Wang,6-2; 7-5; 4-1 RET,R128,124,4,2,46,75,33,46,19,29,5,7,13,52,75,3,8,47,92,28,47,19,45,11,17,12,47,92
2006-01-16 00:00:00.000,Australian Open Australia Grand Slams,HARD,3,Stanislas Wawrinka,Albert Montanes,Stanislas Wawrinka,4-6; 6-2; 6-3; 6-0,R128,108,10,6,54,101,46,54,24,47,1,2,17,70,101,6,4,55,91,35,55,20,36,2,8,16,55,91
2006-01-16 00:00:00.000,Australian Open Australia Grand Slams,HARD,3,David Nalbandian,Danai Udomchoke,David Nalbandian,6-2; 6-2; 1-6; 6-7(4); 6-1,R128,211,5,6,106,171,70,106,31,65,13,17,20,101,171,10,11,81,144,52,81,28,63,6,15,22,80,144
2006-01-16 00:00:00.000,Australian Open Australia Grand Slams,HARD,3,Ivan Ljubicic,Chris Guccione,Ivan Ljubicic,7-6(5); 6-4; 7-6(3),R128,126,13,1,64,102,54,64,25,38,2,3,17,79,102,23,5,72,118,59,72,21,46,8,10,17,80,118
2006-01-16 00:00:00.000,Australian Open Australia Grand Slams,HARD,3,Philipp Kohlschreiber,Lukas Dlouhy,Philipp Kohlschreiber,7-5; 6-2; 6-4,R128,106,12,1,44,81,37,44,22,37,5,7,15,59,81,8,2,51,93,29,51,21,42,10,16,15,50,93
2006-01-16 00:00:00.000,Australian Open Australia Grand Slams,HARD,3,Gilles Muller,Ricardo Mello,Gilles Muller,5-7; 6-2; 6-7(4); 7-6(4); 6-0,R128,196,24,3,105,169,82,105,33,64,5,7,25,115,169,4,11,106,161,74,106,24,55,9,15,25,98,161
2006-01-16 00:00:00.000,Australian Open Australia Grand Slams,HARD,3,Feliciano Lopez,Tomas Behrend,Feliciano Lopez,6-2; 7-5; 6-3,R128,115,13,1,46,85,38,46,25,39,2,2,14,63,85,4,5,67,114,43,67,22,47,14,19,15,65,114
2006-01-16 00:00:00.000,Australian Open Australia Grand Slams,HARD,3,Tomas Berdych,Bobby Reynolds,Tomas Berdych,7-5; 6-3; 6-7(2); 6-1,R128,173,24,7,76,143,61,76,30,67,8,10,21,91,143,10,10,73,128,49,73,23,55,3,9,19,72,128
2006-01-16 00:00:00.000,Australian Open Australia Grand Slams,HARD,3,Gilles Simon,Nicolas Massu,Gilles Simon,7-6(6); 6-2; 3-6; 4-6; 6-3,R128,253,8,3,89,169,60,89,40,80,10,17,24,100,169,7,4,108,183,68,108,35,75,13,21,24,103,183
2006-01-16 00:00:00.000,Australian Open Australia Grand Slams,HARD,3,Xavier Malisse,Mikhail Youzhny,Xavier Malisse,7-5; 5-7; 6-4; 6-2,R128,169,7,2,61,125,46,61,32,64,7,13,21,78,125,3,9,63,127,40,63,28,64,10,19,21,68,127
2006-01-16 00:00:00.000,Australian Open Australia Grand Slams,HARD,3,Thomas Johansson,Cyril Saulnier,Thomas Johansson,6-1; 7-6(3); 6-4,R128,139,13,3,51,95,42,51,26,44,7,8,15,68,95,10,5,56,111,36,56,27,55,9,13,14,63,111
2006-01-16 00:00:00.000,Australian Open Australia Grand Slams,HARD,3,Robby Ginepri,Jurgen Melzer,Robby Ginepri,6-1; 6-4; 6-2,R128,79,1,4,37,73,29,37,18,36,1,4,13,47,73,3,1,35,67,16,35,13,32,6,14,12,29,67
2006-01-16 00:00:00.000,Australian Open Australia Grand Slams,HARD,3,Denis Gremelmayr,Jonas Bjorkman,Denis Gremelmayr,3-6; 6-2; 6-0; 6-1,R128,125,8,2,51,93,38,51,23,42,3,5,15,61,93,4,6,52,98,28,52,18,46,3,11,15,46,98
2006-01-16 00:00:00.000,Australian Open Australia Grand Slams,HARD,3,Marcos Baghdatis,Justin Gimelstob,Marcos Baghdatis,7-6(6); 7-5; 6-0,R128,139,4,4,38,83,33,38,25,45,2,4,15,58,83,8,4,60,112,36,60,24,52,9,15,15,60,112
2006-01-16 00:00:00.000,Australian Open Australia Grand Slams,HARD,3,Radek Stepanek,Bjorn Rehnquist,Radek Stepanek,6-1; 6-2; 6-2,R128,88,1,1,41,71,29,41,22,30,3,3,12,51,71,3,2,32,54,16,32,10,22,1,7,11,26,54
2006-01-16 00:00:00.000,Australian Open Australia Grand Slams,HARD,3,Guillermo Garcia-Lopez,Taylor Dent,Guillermo Garcia-Lopez,7-6(4); 6-3; 7-6(4),R128,136,9,4,67,105,53,67,18,38,5,8,17,71,105,13,7,50,97,40,50,20,47,2,6,16,60,97
2006-01-16 00:00:00.000,Australian Open Australia Grand Slams,HARD,3,Julien Benneteau,Marcos Daniel,Julien Benneteau,6-2; 6-1; 3-0 RET,R128,71,4,1,35,50,26,35,12,15,3,3,9,38,50,2,3,43,60,21,43,5,17,4,10,9,26,60
2006-01-16 00:00:00.000,Australian Open Australia Grand Slams,HARD,3,Wesley Moodie,Oscar Hernandez,Wesley Moodie,3-6; 7-6(5); 6-4; 6-2,R128,180,21,9,84,133,65,84,27,49,9,10,19,92,133,6,1,87,135,61,87,27,48,9,12,20,88,135
2006-01-16 00:00:00.000,Australian Open Australia Grand Slams,HARD,3,Andy Roddick,Michael Lammer,Andy Roddick,6-4; 6-2; 6-2,R128,104,7,2,46,79,39,46,15,33,2,3,13,54,79,2,2,43,74,26,43,11,31,3,9,13,37,74
2006-01-16 00:00:00.000,Australian Open Australia Grand Slams,HARD,3,Roger Federer,Florian Mayer,Roger Federer,6-1; 6-4; 6-0,R64,72,9,1,45,74,34,45,18,29,1,1,12,52,74,2,5,44,69,23,44,11,25,4,10,11,34,69
2006-01-16 00:00:00.000,Australian Open Australia Grand Slams,HARD,3,Max Mirnyi,Davide Sanguinetti,Max Mirnyi,7-5; 6-3; 4-6; 7-6(8),R64,190,7,4,96,145,68,96,31,49,10,14,22,99,145,6,5,86,147,58,86,36,61,10,15,21,94,147
2006-01-16 00:00:00.000,Australian Open Australia Grand Slams,HARD,3,Peter Luczak,Olivier Rochus,Peter Luczak,6-7(4); 6-4; 6-1; 6-7(1); 6-1,R64,187,22,3,101,147,76,101,23,46,3,6,25,99,147,9,12,84,143,61,84,26,59,8,16,23,87,143
2006-01-16 00:00:00.000,Australian Open Australia Grand Slams,HARD,3,Tommy Haas,Paul Goldstein,Tommy Haas,6-0; 6-1; 6-2,R64,76,2,0,31,57,29,31,17,26,2,2,11,46,57,3,3,38,63,25,38,5,25,2,9,10,30,63
2006-01-16 00:00:00.000,Australian Open Australia Grand Slams,HARD,3,Dominik Hrbaty,Dick Norman,Dominik Hrbaty,6-2; 7-5; 5-7; 4-6; 10-8,R64,231,11,12,96,162,77,96,32,66,5,11,30,109,162,20,17,127,221,85,127,42,94,23,31,30,127,221
2006-01-16 00:00:00.000,Australian Open Australia Grand Slams,HARD,3,Igor Andreev,Raemon Sluiter,Igor Andreev,3-6; 6-3; 7-6(4); 2-6; 6-2,R64,180,9,4,100,146,70,100,24,46,6,11,23,94,146,11,3,80,139,54,80,34,59,4,9,23,88,139
2006-01-16 00:00:00.000,Australian Open Australia Grand Slams,HARD,3,Nathan Healey,Amer Delic,Nathan Healey,6-4; 6-7(4); 6-3; 6-4,R64,166,10,6,86,143,64,86,36,57,10,10,21,100,143,13,6,62,112,51,62,27,50,4,7,20,78,112
2006-01-16 00:00:00.000,Australian Open Australia Grand Slams,HARD,3,Nikolay Davydenko,Kevin Kim,Nikolay Davydenko,4-6; 6-0; 6-3; 6-2,R64,134,3,2,81,102,54,81,14,21,2,5,17,68,102,0,9,58,99,37,58,15,41,6,14,16,52,99
2006-01-16 00:00:00.000,Australian Open Australia Grand Slams,HARD,3,Juan Ignacio Chela,Lleyton Hewitt,Juan Ignacio Chela,6-4; 6-4; 6-7(8); 6-2,R64,203,6,0,82,129,52,82,30,47,9,13,20,82,129,8,3,81,146,53,81,28,65,13,21,20,81,146
2006-01-16 00:00:00.000,Australian Open Australia Grand Slams,HARD,3,Kristof Vliegen,Fernando Verdasco,Kristof Vliegen,3-6; 6-2; 7-6(4); 7-5,R64,193,10,2,92,138,63,92,19,46,8,13,20,82,138,9,20,97,163,65,97,28,66,15,22,21,93,163
2006-01-16 00:00:00.000,Australian Open Australia Grand Slams,HARD,3,Nicolas Kiefer,Boris Pashanski,Nicolas Kiefer,4-6; 6-1; 6-4; 6-1,R64,152,15,4,53,103,42,53,24,50,5,9,17,66,103,4,6,64,117,37,64,21,53,7,16,17,58,117
2006-01-16 00:00:00.000,Australian Open Australia Grand Slams,HARD,3,Juan Carlos Ferrero,Janko Tipsarevic,Juan Carlos Ferrero,6-3; 3-6; 5-7; 6-3; 6-2,R64,218,14,2,80,129,59,80,26,49,0,5,24,85,129,16,3,81,163,54,81,38,82,13,20,23,92,163
2006-01-16 00:00:00.000,Australian Open Australia Grand Slams,HARD,3,Paul-Henri Mathieu,Alex Bogomolov Jr.,Paul-Henri Mathieu,6-0; 7-6(5); 6-2,R64,145,13,3,40,81,35,40,22,41,0,2,13,57,81,1,7,75,117,43,75,15,42,12,19,13,58,117
2006-01-16 00:00:00.000,Australian Open Australia Grand Slams,HARD,3,Luis Horna,Bjorn Phau,Luis Horna,6-3; 6-2; 6-1,R64,78,8,2,46,65,38,46,9,19,1,2,12,47,65,2,6,33,63,18,33,10,30,3,10,12,28,63
2006-01-16 00:00:00.000,Australian Open Australia Grand Slams,HARD,3,Sebastien Grosjean,Juan Monaco,Sebastien Grosjean,6-4; 6-3; 6-3,R64,122,3,1,38,85,33,38,23,47,4,6,14,56,85,2,4,45,74,22,45,18,29,1,7,14,40,74
2006-01-16 00:00:00.000,Australian Open Australia Grand Slams,HARD,3,Guillermo Coria,Federico Luzzi,Guillermo Coria,7-6(10); 6-4; 6-3,R64,172,1,9,93,119,63,93,12,26,7,10,16,75,119,5,6,71,127,46,71,24,56,13,18,15,70,127
2006-01-16 00:00:00.000,Australian Open Australia Grand Slams,HARD,3,Gaston Gaudio,Lars Burgsmuller,Gaston Gaudio,6-3; 6-2; 6-3,R64,118,1,1,42,76,32,42,21,34,4,5,13,53,76,3,4,41,82,29,41,13,41,5,11,13,42,82
2006-01-16 00:00:00.000,Australian Open Australia Grand Slams,HARD,3,Fabrice Santoro,Andrei Pavel,Fabrice Santoro,6-4; 6-1; 6-4,R64,129,8,2,59,100,41,59,18,41,10,13,14,59,100,4,3,54,83,30,54,10,29,4,11,13,40,83
2006-01-16 00:00:00.000,Australian Open Australia Grand Slams,HARD,3,Mario Ancic,Jan Hernych,Mario Ancic,6-1; 6-4; 6-4,R64,107,10,2,44,70,40,44,16,26,0,0,14,56,70,1,1,56,86,34,56,18,30,11,15,13,52,86
2006-01-16 00:00:00.000,Australian Open Australia Grand Slams,HARD,3,David Ferrer,Daniele Bracciali,David Ferrer,6-4; 6-4; 6-7(5); 6-2,R64,169,5,2,93,140,60,93,22,47,7,12,20,82,140,6,11,63,123,33,63,27,60,4,13,20,60,123
2006-01-16 00:00:00.000,Australian Open Australia Grand Slams,HARD,3,Tommy Robredo,Dmitry Tursunov,Tommy Robredo,7-6(4); 3-6; 7-6(5); 6-3,R64,183,5,2,102,140,70,102,24,38,6,9,20,94,140,8,5,83,154,65,83,29,71,2,6,22,94,154
2006-01-16 00:00:00.000,Australian Open Australia Grand Slams,HARD,3,James Blake,Jean-Christophe Faurel,James Blake,2-6; 6-1; 6-4; 6-3,R64,129,5,3,53,97,41,53,21,44,4,8,17,62,97,9,6,74,122,47,74,18,48,8,15,17,65,122
2006-01-16 00:00:00.000,Australian Open Australia Grand Slams,HARD,3,Jarkko Nieminen,Jimmy Wang,Jarkko Nieminen,6-2; 7-6(3); 6-2,R64,113,4,2,58,93,42,58,23,35,8,10,14,65,93,4,2,43,86,27,43,17,43,3,9,14,44,86
2006-01-16 00:00:00.000,Australian Open Australia Grand Slams,HARD,3,David Nalbandian,Stanislas Wawrinka,David Nalbandian,6-4; 3-6; 6-4; 6-2,R64,180,2,3,83,125,55,83,28,42,11,12,18,83,125,10,4,74,134,48,74,33,60,8,12,19,81,134
2006-01-16 00:00:00.000,Australian Open Australia Grand Slams,HARD,3,Ivan Ljubicic,Philipp Kohlschreiber,Ivan Ljubicic,7-5; 6-2; 6-1,R64,140,3,4,50,96,35,50,26,46,3,5,14,61,96,3,5,43,93,25,43,22,50,9,16,13,47,93
2006-01-16 00:00:00.000,Australian Open Australia Grand Slams,HARD,3,Feliciano Lopez,Gilles Muller,Feliciano Lopez,6-2; 6-4; 6-7(6); 6-4,R64,155,17,5,74,122,59,74,23,48,1,3,20,82,122,10,4,92,141,61,92,24,49,10,16,20,85,141
2006-01-16 00:00:00.000,Australian Open Australia Grand Slams,HARD,3,Gilles Simon,Tomas Berdych,Gilles Simon,6-3; 6-2; 4-6; 6-2,R64,150,6,3,63,129,46,63,34,66,11,14,18,80,129,3,9,52,112,34,52,23,60,2,9,17,57,112
2006-01-16 00:00:00.000,Australian Open Australia Grand Slams,HARD,3,Thomas Johansson,Xavier Malisse,Thomas Johansson,6-3; 3-6; 7-5; 4-6; 6-3,R64,220,12,4,81,154,61,81,39,73,6,10,25,100,154,16,3,69,147,52,69,42,78,6,11,24,94,147
2006-01-16 00:00:00.000,Australian Open Australia Grand Slams,HARD,3,Denis Gremelmayr,Robby Ginepri,Denis Gremelmayr,2-6; 5-7; 6-4; 6-3; 6-3,R64,183,8,10,91,181,61,91,41,90,14,21,24,102,181,7,3,99,150,66,99,23,51,4,12,24,89,150
2006-01-16 00:00:00.000,Australian Open Australia Grand Slams,HARD,3,Marcos Baghdatis,Radek Stepanek,Marcos Baghdatis,6-4; 6-3; 3-6; 0-6; 7-5,R64,190,6,6,65,128,47,65,36,63,5,11,23,83,128,11,4,85,150,57,85,35,65,7,12,23,92,150
2006-01-16 00:00:00.000,Australian Open Australia Grand Slams,HARD,3,Julien Benneteau,Guillermo Garcia-Lopez,Julien Benneteau,6-4; 7-6(3); 6-1,R64,131,8,4,73,97,57,73,12,24,2,2,15,69,97,4,6,54,99,38,54,22,45,9,12,14,60,99
2006-01-16 00:00:00.000,Australian Open Australia Grand Slams,HARD,3,Andy Roddick,Wesley Moodie,Andy Roddick,7-5; 6-3; 6-2,R64,108,11,1,48,78,41,48,20,30,1,1,15,61,78,11,2,61,85,38,61,16,24,5,9,14,54,85
2006-01-16 00:00:00.000,Australian Open Australia Grand Slams,HARD,3,Roger Federer,Max Mirnyi,Roger Federer,6-3; 6-4; 6-3,R32,109,6,2,47,70,37,47,20,23,1,1,14,57,70,5,6,72,108,50,72,11,36,11,15,14,61,108
2006-01-16 00:00:00.000,Australian Open Australia Grand Slams,HARD,3,Tommy Haas,Peter Luczak,Tommy Haas,4-6; 6-3; 6-4; 6-4,R32,157,18,1,68,113,55,68,28,45,0,1,20,83,113,21,2,69,115,50,69,25,46,3,6,19,75,115
2006-01-16 00:00:00.000,Australian Open Australia Grand Slams,HARD,3,Dominik Hrbaty,Igor Andreev,Dominik Hrbaty,1-6; 6-4; 6-3; 2-6; 6-4,R32,211,12,5,87,156,53,87,39,69,8,14,22,92,156,12,6,95,164,63,95,33,69,16,21,22,96,164
2006-01-16 00:00:00.000,Australian Open Australia Grand Slams,HARD,3,Nikolay Davydenko,Nathan Healey,Nikolay Davydenko,6-2; 5-7; 6-4; 7-5,R32,179,4,2,86,114,64,86,20,28,4,6,21,84,114,17,6,90,146,63,90,23,56,13,18,21,86,146
2006-01-16 00:00:00.000,Australian Open Australia Grand Slams,HARD,3,Juan Ignacio Chela,Kristof Vliegen,Juan Ignacio Chela,6-1; 6-4; 6-4,R32,124,4,3,52,95,41,52,25,43,8,8,14,66,95,5,5,53,82,36,53,11,29,7,11,13,47,82
2006-01-16 00:00:00.000,Australian Open Australia Grand Slams,HARD,3,Nicolas Kiefer,Juan Carlos Ferrero,Nicolas Kiefer,6-3; 6-2; 5-7; 6-2,R32,177,13,4,53,103,46,53,28,50,2,3,19,74,103,5,2,81,126,49,81,26,45,9,14,18,75,126
2006-01-16 00:00:00.000,Australian Open Australia Grand Slams,HARD,3,Paul-Henri Mathieu,Luis Horna,Paul-Henri Mathieu,7-6(2); 7-6(7); 6-1,R32,159,0,0,0,0,0,0,0,0,0,0,18,0,0,0,0,0,0,0,0,0,0,0,0,13,0,0
2006-01-16 00:00:00.000,Australian Open Australia Grand Slams,HARD,3,Sebastien Grosjean,Guillermo Coria,Sebastien Grosjean,6-2; 6-2; 3-6; 6-4,R32,172,7,8,55,108,40,55,21,53,5,11,18,61,108,0,23,82,129,50,82,12,47,17,26,17,62,129
2006-01-16 00:00:00.000,Australian Open Australia Grand Slams,HARD,3,Fabrice Santoro,Gaston Gaudio,Fabrice Santoro,6-3; 6-2; 5-7; 1-6; 6-4,R32,227,9,5,95,172,64,95,33,77,18,25,23,97,172,1,3,81,136,51,81,26,55,5,13,23,77,136
2006-01-16 00:00:00.000,Australian Open Australia Grand Slams,HARD,3,David Ferrer,Mario Ancic,David Ferrer,6-3; 6-3; 6-3,R32,113,0,2,60,84,39,60,14,24,2,4,14,53,84,3,5,57,86,31,57,14,29,7,13,13,45,86
2006-01-16 00:00:00.000,Australian Open Australia Grand Slams,HARD,3,Tommy Robredo,James Blake,Tommy Robredo,6-3; 6-4; 6-4,R32,115,9,6,49,86,38,49,24,37,4,5,15,62,86,6,8,50,96,35,50,20,46,9,13,14,55,96
2006-01-16 00:00:00.000,Australian Open Australia Grand Slams,HARD,3,David Nalbandian,Jarkko Nieminen,David Nalbandian,2-6; 6-3; 6-2; 7-5,R32,174,6,3,88,136,55,88,28,48,11,16,19,83,136,3,1,86,126,50,86,18,40,12,19,18,68,126
2006-01-16 00:00:00.000,Australian Open Australia Grand Slams,HARD,3,Ivan Ljubicic,Feliciano Lopez,Ivan Ljubicic,7-5; 7-6(5); 6-0,R32,146,10,4,54,99,45,54,24,45,4,5,15,69,99,12,8,64,114,45,64,19,50,12,17,15,64,114
2006-01-16 00:00:00.000,Australian Open Australia Grand Slams,HARD,3,Thomas Johansson,Gilles Simon,Thomas Johansson,6-3; 6-2; 6-1,R32,91,9,1,41,71,35,41,16,30,4,4,12,51,71,4,2,37,83,26,37,19,46,9,15,12,45,83
2006-01-16 00:00:00.000,Australian Open Australia Grand Slams,HARD,3,Marcos Baghdatis,Denis Gremelmayr,Marcos Baghdatis,6-2; 6-1; 6-2,R32,80,5,3,36,66,24,36,18,30,1,3,12,42,66,0,4,42,68,19,42,9,26,3,11,11,28,68
2006-01-16 00:00:00.000,Australian Open Australia Grand Slams,HARD,3,Andy Roddick,Julien Benneteau,Andy Roddick,6-1; 6-2; 6-2,R32,82,17,1,37,62,32,37,16,25,0,0,12,48,62,5,3,35,59,17,35,9,24,1,7,11,26,59
2006-01-16 00:00:00.000,Australian Open Australia Grand Slams,HARD,3,Roger Federer,Tommy Haas,Roger Federer,6-4; 6-0; 3-6; 4-6; 6-2,R16,178,10,1,77,132,60,77,29,55,7,9,21,89,132,5,0,89,138,56,89,28,49,5,11,22,84,138
2006-01-16 00:00:00.000,Australian Open Australia Grand Slams,HARD,3,Nikolay Davydenko,Dominik Hrbaty,Nikolay Davydenko,4-6; 4-6; 6-4; 6-2; 6-3,R16,210,6,3,110,160,65,110,31,50,8,14,24,96,160,7,6,75,149,54,75,30,74,4,12,23,84,149
2006-01-16 00:00:00.000,Australian Open Australia Grand Slams,HARD,3,Nicolas Kiefer,Juan Ignacio Chela,Nicolas Kiefer,7-6(4); 6-3; 6-3,R16,142,5,3,43,94,36,43,26,51,7,9,15,62,94,2,0,54,94,34,54,21,40,2,7,15,55,94
2006-01-16 00:00:00.000,Australian Open Australia Grand Slams,HARD,3,Sebastien Grosjean,Paul-Henri Mathieu,Sebastien Grosjean,7-5; 6-2; 6-2,R16,127,12,3,31,72,29,31,19,41,1,4,14,48,72,3,4,44,89,23,44,21,45,6,14,14,44,89
2006-01-16 00:00:00.000,Australian Open Australia Grand Slams,HARD,3,Fabrice Santoro,David Ferrer,Fabrice Santoro,6-4; 7-5; 7-5,R16,133,6,0,56,94,35,56,18,38,7,14,17,53,94,0,2,77,106,41,77,10,29,8,18,17,51,106
2006-01-16 00:00:00.000,Australian Open Australia Grand Slams,HARD,3,David Nalbandian,Tommy Robredo,David Nalbandian,6-3; 6-0; 2-6; 6-2,R16,127,3,2,55,84,40,55,19,29,0,2,15,59,84,9,6,81,119,50,81,12,38,15,22,16,62,119
2006-01-16 00:00:00.000,Australian Open Australia Grand Slams,HARD,3,Ivan Ljubicic,Thomas Johansson,Ivan Ljubicic,6-2; 6-4; 6-4,R16,115,12,1,43,81,33,43,27,38,1,1,14,60,81,12,7,42,91,34,42,20,49,3,7,14,54,91
2006-01-16 00:00:00.000,Australian Open Australia Grand Slams,HARD,3,Marcos Baghdatis,Andy Roddick,Marcos Baghdatis,6-4; 1-6; 6-3; 6-4,R16,152,16,1,60,125,43,60,37,65,7,9,18,80,125,15,4,65,108,48,65,24,43,7,10,18,72,108
2006-01-16 00:00:00.000,Australian Open Australia Grand Slams,HARD,3,Roger Federer,Nikolay Davydenko,Roger Federer,6-4; 3-6; 7-6(7); 7-6(5),Q,193,6,0,86,139,64,86,28,53,5,10,22,92,139,1,2,111,144,78,111,14,33,6,10,21,92,144
2006-01-16 00:00:00.000,Australian Open Australia Grand Slams,HARD,3,Nicolas Kiefer,Sebastien Grosjean,Nicolas Kiefer,6-3; 0-6; 6-4; 6-7(1); 8-6,Q,288,4,9,74,164,46,74,46,90,4,13,26,92,164,12,2,84,165,54,84,43,81,7,16,25,97,165
2006-01-16 00:00:00.000,Australian Open Australia Grand Slams,HARD,3,David Nalbandian,Fabrice Santoro,David Nalbandian,7-5; 6-0; 6-0,Q,101,2,0,39,64,29,39,18,25,2,3,12,47,64,4,1,46,76,27,46,6,30,7,15,12,33,76
2006-01-16 00:00:00.000,Australian Open Australia Grand Slams,HARD,3,Marcos Baghdatis,Ivan Ljubicic,Marcos Baghdatis,6-4; 6-2; 4-6; 3-6; 6-3,Q,197,8,4,69,131,55,69,37,62,7,9,23,92,131,14,3,98,154,70,98,30,56,11,15,23,100,154
2006-01-16 00:00:00.000,Australian Open Australia Grand Slams,HARD,3,Roger Federer,Nicolas Kiefer,Roger Federer,6-3; 5-7; 6-0; 6-2,S,160,7,5,70,106,50,70,24,36,3,4,18,74,106,14,7,62,122,44,62,23,60,13,19,17,67,122
2006-01-16 00:00:00.000,Australian Open Australia Grand Slams,HARD,3,Marcos Baghdatis,David Nalbandian,Marcos Baghdatis,3-6; 5-7; 6-3; 6-4; 6-4,S,207,15,2,86,154,60,86,34,68,10,17,25,94,154,5,1,95,141,60,95,23,46,5,13,25,83,141
2006-01-16 00:00:00.000,Australian Open Australia Grand Slams,HARD,3,Roger Federer,Marcos Baghdatis,Roger Federer,5-7; 7-5; 6-0; 6-2,F,166,11,6,77,144,55,77,34,67,7,10,19,89,144,6,2,55,114,39,55,22,59,4,12,19,61,114
2006-01-30 00:00:00.000,Delray Beach FL; U.S.A. ATP World Tour,HARD,2,Andre Agassi,Ricardo Mello,Andre Agassi,6-4; 6-4,R32,67,10,1,27,48,25,27,16,21,0,0,10,41,48,1,1,33,59,19,33,17,26,6,8,10,36,59
2006-01-30 00:00:00.000,Delray Beach FL; U.S.A. ATP World Tour,HARD,2,Ramon Delgado,Bobby Reynolds,Ramon Delgado,4-6; 6-1; 6-4,R32,107,13,3,42,77,37,42,18,35,1,2,14,55,77,6,1,43,74,26,43,22,31,2,5,13,48,74
2006-01-30 00:00:00.000,Delray Beach FL; U.S.A. ATP World Tour,HARD,2,Guillermo Garcia-Lopez,Bjorn Phau,Guillermo Garcia-Lopez,6-1; 6-4,R32,68,3,4,26,56,22,26,17,30,2,2,9,39,56,3,1,24,46,18,24,8,22,2,5,8,26,46
2006-01-30 00:00:00.000,Delray Beach FL; U.S.A. ATP World Tour,HARD,2,Todd Widom,Wesley Moodie,Todd Widom,3-6; 6-4; 6-4,R32,142,5,3,57,99,39,57,21,42,5,9,15,60,99,11,3,58,89,38,58,14,31,7,11,14,52,89
2006-01-30 00:00:00.000,Delray Beach FL; U.S.A. ATP World Tour,HARD,2,Xavier Malisse,Sargis Sargsian,Xavier Malisse,6-2; 6-2,R32,74,9,1,22,45,22,22,10,23,2,3,8,32,45,1,7,43,73,25,43,8,30,7,12,8,33,73
2006-01-30 00:00:00.000,Delray Beach FL; U.S.A. ATP World Tour,HARD,2,Justin Gimelstob,Danai Udomchoke,Justin Gimelstob,6-4; 6-4,R32,82,4,0,36,54,27,36,6,18,4,7,10,33,54,2,2,34,59,19,34,12,25,3,8,10,31,59
2006-01-30 00:00:00.000,Delray Beach FL; U.S.A. ATP World Tour,HARD,2,Oliver Marach,Cyril Saulnier,Oliver Marach,2-0 RET,R32,9,0,0,5,5,4,5,0,0,0,0,1,4,5,0,1,2,6,0,2,2,4,0,1,1,2,6
2006-01-30 00:00:00.000,Delray Beach FL; U.S.A. ATP World Tour,HARD,2,Florian Mayer,Michael Berrer,Florian Mayer,4-6; 6-0; 6-3,R32,65,11,6,46,72,38,46,15,26,2,3,13,53,72,7,3,36,68,25,36,15,32,2,6,12,40,68
2006-01-30 00:00:00.000,Delray Beach FL; U.S.A. ATP World Tour,HARD,2,Gilles Muller,Bjorn Rehnquist,Gilles Muller,7-6(4); 6-4,R32,61,7,1,48,75,40,48,10,27,3,4,11,50,75,6,1,53,76,33,53,13,23,8,10,11,46,76
2006-01-30 00:00:00.000,Delray Beach FL; U.S.A. ATP World Tour,HARD,2,Jeff Salzenstein,Razvan Sabau,Jeff Salzenstein,7-5; 7-6(5),R32,68,13,4,46,78,36,46,19,32,4,5,12,55,78,1,6,64,110,42,64,23,46,13,15,12,65,110
2006-01-30 00:00:00.000,Delray Beach FL; U.S.A. ATP World Tour,HARD,2,Andrei Pavel,Olivier Patience,Andrei Pavel,6-3; 7-6(4),R32,80,6,1,49,77,35,49,16,28,2,3,11,51,77,3,4,38,58,24,38,13,20,0,2,10,37,58
2006-01-30 00:00:00.000,Delray Beach FL; U.S.A. ATP World Tour,HARD,2,Tommy Haas,Igor Kunitsyn,Tommy Haas,7-6(4); 6-2,R32,65,6,2,40,65,28,40,13,25,2,3,10,41,65,4,2,28,59,14,28,19,31,2,5,10,33,59
2006-01-30 00:00:00.000,Delray Beach FL; U.S.A. ATP World Tour,HARD,2,Vincent Spadea,Jimmy Wang,Vincent Spadea,5-7; 6-1; 6-1,R32,127,0,1,58,107,37,58,24,49,11,15,13,61,107,3,3,53,95,28,53,16,42,12,20,13,44,95
2006-01-30 00:00:00.000,Delray Beach FL; U.S.A. ATP World Tour,HARD,2,Robert Kendrick,Kevin Kim,Robert Kendrick,6-4; 7-5,R32,71,11,4,42,70,34,42,12,28,1,2,11,46,70,5,2,34,56,24,34,13,22,2,5,11,37,56
2006-01-30 00:00:00.000,Delray Beach FL; U.S.A. ATP World Tour,HARD,2,Simon Greul,Mardy Fish,Simon Greul,6-3; 6-3,R32,59,3,2,25,45,22,25,14,20,0,0,9,36,45,6,2,26,53,20,26,10,27,3,6,9,30,53
2006-01-30 00:00:00.000,Delray Beach FL; U.S.A. ATP World Tour,HARD,2,Hyung-Taik Lee,Robby Ginepri,Hyung-Taik Lee,5-7; 6-2; 6-4,R32,105,6,2,57,93,42,57,19,36,3,5,15,61,93,10,1,43,75,32,43,17,32,1,5,15,49,75
2006-01-30 00:00:00.000,Delray Beach FL; U.S.A. ATP World Tour,HARD,2,Andre Agassi,Ramon Delgado,Andre Agassi,4-6; 7-6(4); 6-0,R16,118,7,2,53,85,39,53,16,32,3,6,14,55,85,15,4,55,95,36,55,17,40,6,11,14,53,95
2006-01-30 00:00:00.000,Delray Beach FL; U.S.A. ATP World Tour,HARD,2,Guillermo Garcia-Lopez,Todd Widom,Guillermo Garcia-Lopez,6-3; 6-2,R16,65,11,2,43,65,33,43,10,22,4,4,9,43,65,1,4,33,59,19,33,14,26,2,5,8,33,59
2006-01-30 00:00:00.000,Delray Beach FL; U.S.A. ATP World Tour,HARD,2,Xavier Malisse,Justin Gimelstob,Xavier Malisse,6-2; 7-5,R16,85,6,1,33,61,26,33,19,28,2,2,10,45,61,5,2,38,68,27,38,12,30,7,10,10,39,68
2006-01-30 00:00:00.000,Delray Beach FL; U.S.A. ATP World Tour,HARD,2,Florian Mayer,Oliver Marach,Florian Mayer,7-5; 6-3,R16,80,7,3,29,53,26,29,14,24,0,0,10,40,53,4,2,30,67,24,30,16,37,4,7,11,40,67
2006-01-30 00:00:00.000,Delray Beach FL; U.S.A. ATP World Tour,HARD,2,Gilles Muller,Jeff Salzenstein,Gilles Muller,6-3; 6-4,R16,70,11,3,37,65,29,37,17,28,4,4,10,46,65,8,2,26,48,22,26,11,22,1,3,9,33,48
2006-01-30 00:00:00.000,Delray Beach FL; U.S.A. ATP World Tour,HARD,2,Tommy Haas,Andrei Pavel,Tommy Haas,6-7(1); 6-1; 7-5,R16,120,10,6,50,94,36,50,24,44,2,4,15,60,94,9,3,52,93,37,52,16,41,1,7,16,53,93
2006-01-30 00:00:00.000,Delray Beach FL; U.S.A. ATP World Tour,HARD,2,Vincent Spadea,Robert Kendrick,Vincent Spadea,6-4; 6-1,R16,64,2,1,30,54,23,30,16,24,3,3,9,39,54,3,6,38,59,27,38,4,21,10,13,8,31,59
2006-01-30 00:00:00.000,Delray Beach FL; U.S.A. ATP World Tour,HARD,2,Hyung-Taik Lee,Simon Greul,Hyung-Taik Lee,2-6; 6-3; 6-4,R16,117,2,3,57,94,41,57,17,37,6,9,14,58,94,6,1,49,80,33,49,16,31,5,8,13,49,80
2006-01-30 00:00:00.000,Delray Beach FL; U.S.A. ATP World Tour,HARD,2,Guillermo Garcia-Lopez,Andre Agassi,Guillermo Garcia-Lopez,6-4; 6-2,Q,75,14,6,27,64,21,27,20,37,4,5,9,41,64,3,3,31,56,18,31,12,25,4,8,9,30,56
2006-01-30 00:00:00.000,Delray Beach FL; U.S.A. ATP World Tour,HARD,2,Xavier Malisse,Florian Mayer,Xavier Malisse,6-7(4); 6-2; 6-3,Q,109,10,3,57,105,42,57,29,48,7,8,15,71,105,3,3,42,90,28,42,23,48,3,7,14,51,90
2006-01-30 00:00:00.000,Delray Beach FL; U.S.A. ATP World Tour,HARD,2,Tommy Haas,Gilles Muller,Tommy Haas,6-3; 6-2,Q,63,3,1,31,47,27,31,9,16,0,0,9,36,47,6,2,36,57,23,36,9,21,3,6,8,32,57
2006-01-30 00:00:00.000,Delray Beach FL; U.S.A. ATP World Tour,HARD,2,Vincent Spadea,Hyung-Taik Lee,Vincent Spadea,6-3; 6-3,Q,64,4,2,37,53,28,37,11,16,4,5,9,39,53,0,1,34,61,21,34,11,27,3,7,9,32,61
2006-01-30 00:00:00.000,Delray Beach FL; U.S.A. ATP World Tour,HARD,2,Xavier Malisse,Guillermo Garcia-Lopez,Xavier Malisse,7-6(4); 6-1,S,82,2,2,45,70,37,45,12,25,4,5,10,49,70,2,4,36,63,25,36,13,27,4,7,9,38,63
2006-01-30 00:00:00.000,Delray Beach FL; U.S.A. ATP World Tour,HARD,2,Tommy Haas,Vincent Spadea,Tommy Haas,6-3; 6-2,S,74,5,1,44,64,32,44,11,20,4,5,9,43,64,1,3,32,53,16,32,10,21,4,8,8,26,53
2006-01-30 00:00:00.000,Delray Beach FL; U.S.A. ATP World Tour,HARD,2,Tommy Haas,Xavier Malisse,Tommy Haas,6-3; 3-6; 7-6(5),F,122,6,2,58,89,46,58,18,31,3,5,15,64,89,7,3,70,112,51,70,20,42,4,6,15,71,112
2006-01-30 00:00:00.000,Vi±a del Mar Chile ATP World Tour,CLAY,2,Gaston Gaudio,Felipe Parada,Gaston Gaudio,6-1; 6-4,R32,70,8,0,27,46,22,27,15,19,0,0,9,37,46,3,2,40,60,26,40,8,20,8,11,8,34,60
2006-01-30 00:00:00.000,Vi±a del Mar Chile ATP World Tour,CLAY,2,Ruben Ramirez Hidalgo,Nicolas Almagro,Ruben Ramirez Hidalgo,0-6; 6-3; 6-1,R32,93,4,1,39,68,32,39,12,29,5,8,11,44,68,2,0,37,63,24,37,13,26,0,4,11,37,63
2006-01-30 00:00:00.000,Vi±a del Mar Chile ATP World Tour,CLAY,2,Santiago Ventura,Paul Capdeville,Santiago Ventura,6-3; 0-6; 6-3,R32,101,1,1,43,69,25,43,15,26,6,10,12,40,69,5,2,47,80,33,47,16,33,9,13,12,49,80
2006-01-30 00:00:00.000,Vi±a del Mar Chile ATP World Tour,CLAY,2,Albert Montanes,Juan Monaco,Albert Montanes,6-4; 6-2,R32,104,0,0,36,57,22,36,13,21,5,7,9,35,57,3,1,37,76,20,37,17,39,7,12,9,37,76
2006-01-30 00:00:00.000,Vi±a del Mar Chile ATP World Tour,CLAY,2,Jose Acasuso,Ivan Navarro,Jose Acasuso,6-3; 6-2,R32,76,4,1,23,55,19,23,18,32,0,1,9,37,55,4,0,25,45,17,25,5,20,0,4,8,22,45
2006-01-30 00:00:00.000,Vi±a del Mar Chile ATP World Tour,CLAY,2,Gustavo Marcaccio,Luis Horna,Gustavo Marcaccio,7-6(6); 0-6; 6-3,R32,128,9,4,59,100,41,59,20,41,10,14,14,61,100,4,2,73,83,52,73,4,10,5,7,13,56,83
2006-01-30 00:00:00.000,Vi±a del Mar Chile ATP World Tour,CLAY,2,Jorge Aguilar,Guillermo Hormazabal,Jorge Aguilar,6-4; 6-2,R32,66,0,3,38,56,26,38,14,18,0,0,9,40,56,5,1,33,46,26,33,4,13,2,5,9,30,46
2006-01-30 00:00:00.000,Vi±a del Mar Chile ATP World Tour,CLAY,2,Leos Friedl,Carlos Berlocq,Leos Friedl,6-7(5); 6-3; 6-1,R32,164,1,3,58,90,35,58,15,32,1,5,14,50,90,1,5,68,111,41,68,10,43,8,16,14,51,111
2006-01-30 00:00:00.000,Vi±a del Mar Chile ATP World Tour,CLAY,2,Nicolas Massu,Marcos Daniel,Nicolas Massu,6-3; 6-3,R32,72,5,1,40,61,28,40,10,21,0,1,9,38,61,4,0,32,49,20,32,7,17,3,7,9,27,49
2006-01-30 00:00:00.000,Vi±a del Mar Chile ATP World Tour,CLAY,2,Juan Antonio Marin,Hugo Armando,Juan Antonio Marin,6-2; 6-3,R32,67,4,0,27,49,25,27,12,22,1,1,8,37,49,1,3,28,46,17,28,8,18,1,5,9,25,46
2006-01-30 00:00:00.000,Vi±a del Mar Chile ATP World Tour,CLAY,2,Carlos Cuadrado,Tomas Behrend,Carlos Cuadrado,7-5; 6-0,R32,61,1,1,30,45,25,30,8,15,0,1,9,33,45,3,3,27,54,17,27,10,27,5,10,9,27,54
2006-01-30 00:00:00.000,Vi±a del Mar Chile ATP World Tour,CLAY,2,Daniel Gimeno-Traver,Agustin Calleri,Daniel Gimeno-Traver,1-6; 6-3; 6-3,R32,101,3,0,60,96,41,60,13,36,5,9,13,54,96,9,3,45,75,31,45,12,30,5,9,12,43,75
2006-01-30 00:00:00.000,Vi±a del Mar Chile ATP World Tour,CLAY,2,Boris Pashanski,Flavio Saretta,Boris Pashanski,1-6; 7-5; 6-3,R32,144,4,3,66,98,42,66,14,32,6,11,14,56,98,3,7,67,106,39,67,17,39,12,17,14,56,106
2006-01-30 00:00:00.000,Vi±a del Mar Chile ATP World Tour,CLAY,2,Alessio Di Mauro,Adrian Garcia,Alessio Di Mauro,6-7(6); 6-1; 6-4,R32,148,6,1,66,102,40,66,17,36,7,12,15,57,102,2,4,65,101,36,65,14,36,9,17,14,50,101
2006-01-30 00:00:00.000,Vi±a del Mar Chile ATP World Tour,CLAY,2,Juan Martin Del Potro,Albert Portas,Juan Martin Del Potro,6-2; 6-2,R32,55,2,1,30,50,19,30,16,20,3,4,8,35,50,1,3,21,43,14,21,5,22,1,6,8,19,43
2006-01-30 00:00:00.000,Vi±a del Mar Chile ATP World Tour,CLAY,2,Fernando Gonzalez,Vasilis Mazarakis,Fernando Gonzalez,6-1; 6-2,R32,52,7,2,24,43,20,24,10,19,4,5,7,30,43,0,2,32,50,16,32,4,18,4,10,8,20,50
2006-01-30 00:00:00.000,Vi±a del Mar Chile ATP World Tour,CLAY,2,Ruben Ramirez Hidalgo,Gaston Gaudio,Ruben Ramirez Hidalgo,6-7(6); 6-1; 6-4,R16,157,11,2,48,85,37,48,17,37,3,7,14,54,85,2,4,71,104,41,71,10,33,7,15,15,51,104
2006-01-30 00:00:00.000,Vi±a del Mar Chile ATP World Tour,CLAY,2,Albert Montanes,Santiago Ventura,Albert Montanes,4-6; 6-4; 6-3,R16,103,9,5,34,72,28,34,21,38,2,5,14,49,72,3,0,56,88,38,56,15,32,5,10,15,53,88
2006-01-30 00:00:00.000,Vi±a del Mar Chile ATP World Tour,CLAY,2,Jose Acasuso,Gustavo Marcaccio,Jose Acasuso,6-1; 6-1,R16,58,7,1,29,43,21,29,10,14,1,1,7,31,43,0,0,25,41,13,25,3,16,7,12,7,16,41
2006-01-30 00:00:00.000,Vi±a del Mar Chile ATP World Tour,CLAY,2,Leos Friedl,Jorge Aguilar,Leos Friedl,7-6(4); 6-3,R16,98,6,3,45,65,29,45,11,20,4,7,11,40,65,2,1,50,71,27,50,12,21,1,5,10,39,71
2006-01-30 00:00:00.000,Vi±a del Mar Chile ATP World Tour,CLAY,2,Nicolas Massu,Juan Antonio Marin,Nicolas Massu,6-3; 6-4,R16,91,5,0,31,57,23,31,20,26,0,0,10,43,57,3,0,20,55,12,20,21,35,2,4,9,33,55
2006-01-30 00:00:00.000,Vi±a del Mar Chile ATP World Tour,CLAY,2,Carlos Cuadrado,Daniel Gimeno-Traver,Carlos Cuadrado,6-3; 6-3,R16,62,2,3,40,53,31,40,8,13,3,3,9,39,53,4,1,25,50,15,25,14,25,1,4,9,29,50
2006-01-30 00:00:00.000,Vi±a del Mar Chile ATP World Tour,CLAY,2,Boris Pashanski,Alessio Di Mauro,Boris Pashanski,6-7(2); 7-6(4); 6-0,R16,166,5,3,64,107,43,64,24,43,3,6,15,67,107,4,3,56,101,34,56,24,45,5,11,15,58,101
2006-01-30 00:00:00.000,Vi±a del Mar Chile ATP World Tour,CLAY,2,Fernando Gonzalez,Juan Martin Del Potro,Fernando Gonzalez,6-3; 7-6(4),R16,95,2,2,40,80,29,40,18,40,7,11,11,47,80,0,2,52,68,29,52,6,16,1,6,10,35,68
2006-01-30 00:00:00.000,Vi±a del Mar Chile ATP World Tour,CLAY,2,Ruben Ramirez Hidalgo,Albert Montanes,Ruben Ramirez Hidalgo,6-2; 2-6; 6-2,Q,109,6,0,41,79,33,41,16,38,9,12,12,49,79,1,2,43,70,30,43,9,27,4,9,12,39,70
2006-01-30 00:00:00.000,Vi±a del Mar Chile ATP World Tour,CLAY,2,Jose Acasuso,Leos Friedl,Jose Acasuso,3-6; 6-1; 7-5,Q,143,12,1,47,94,37,47,22,47,4,7,14,59,94,6,5,63,97,42,63,12,34,7,12,14,54,97
2006-01-30 00:00:00.000,Vi±a del Mar Chile ATP World Tour,CLAY,2,Nicolas Massu,Carlos Cuadrado,Nicolas Massu,4-6; 7-6(4); 6-3,Q,171,9,3,63,91,51,63,19,28,4,5,16,70,91,1,0,83,111,58,83,15,28,12,13,15,73,111
2006-01-30 00:00:00.000,Vi±a del Mar Chile ATP World Tour,CLAY,2,Fernando Gonzalez,Boris Pashanski,Fernando Gonzalez,6-4; 6-3,Q,89,9,1,30,57,25,30,14,27,3,3,9,39,57,0,2,49,72,34,49,9,23,5,8,10,43,72
2006-01-30 00:00:00.000,Vi±a del Mar Chile ATP World Tour,CLAY,2,Jose Acasuso,Ruben Ramirez Hidalgo,Jose Acasuso,6-2; 6-4,S,96,7,0,37,49,31,37,7,12,1,1,9,38,49,0,1,35,64,22,35,14,29,5,8,9,36,64
2006-01-30 00:00:00.000,Vi±a del Mar Chile ATP World Tour,CLAY,2,Nicolas Massu,Fernando Gonzalez,Nicolas Massu,3-6; 7-6(3); 6-4,S,192,3,1,79,111,56,79,13,32,6,8,15,69,111,2,6,67,114,44,67,26,47,6,8,16,70,114
2006-01-30 00:00:00.000,Vi±a del Mar Chile ATP World Tour,CLAY,2,Jose Acasuso,Nicolas Massu,Jose Acasuso,6-4; 6-3,F,96,4,0,27,53,20,27,17,26,0,0,9,37,53,3,0,38,55,23,38,9,17,1,4,10,32,55
2006-01-30 00:00:00.000,Zagreb Croatia ATP World Tour,HARD,2,Ivan Ljubicic,Andy Murray,Ivan Ljubicic,4-6; 6-2; 6-3,R32,118,15,3,54,93,41,54,19,39,4,6,14,60,93,4,2,41,73,29,41,16,32,2,6,13,45,73
2006-01-30 00:00:00.000,Zagreb Croatia ATP World Tour,HARD,2,Kenneth Carlsen,Jan Hernych,Kenneth Carlsen,6-2; 6-4,R32,68,7,1,33,47,27,33,9,14,0,0,9,36,47,2,1,43,66,26,43,9,23,6,9,9,35,66
2006-01-30 00:00:00.000,Zagreb Croatia ATP World Tour,HARD,2,Mikhail Youzhny,Tomas Zib,Mikhail Youzhny,6-4; 3-6; 6-1,R32,100,10,1,57,87,42,57,18,30,5,6,13,60,87,9,0,40,77,29,40,21,37,3,6,13,50,77
2006-01-30 00:00:00.000,Zagreb Croatia ATP World Tour,HARD,2,Jarkko Nieminen,Potito Starace,Jarkko Nieminen,3-6; 7-5; 6-3,R32,111,3,3,49,82,34,49,18,33,1,4,15,52,82,10,2,64,97,44,64,14,33,5,9,15,58,97
2006-01-30 00:00:00.000,Zagreb Croatia ATP World Tour,HARD,2,Radek Stepanek,Tomas Cakl,Radek Stepanek,6-3; 7-6(2),R32,66,17,2,37,54,33,37,12,17,0,0,10,45,54,10,6,34,76,29,34,17,42,3,5,11,46,76
2006-01-30 00:00:00.000,Zagreb Croatia ATP World Tour,HARD,2,Novak Djokovic,Robin Vik,Novak Djokovic,6-1; 7-5,R32,79,4,2,37,65,27,37,15,28,5,7,10,42,65,3,8,33,68,17,33,16,35,6,11,9,33,68
2006-01-30 00:00:00.000,Zagreb Croatia ATP World Tour,HARD,2,Ilija Bozoljac,Daniele Bracciali,Ilija Bozoljac,6-4; 7-6(5),R32,81,14,4,35,62,33,35,16,27,0,0,11,49,62,10,6,35,74,29,35,19,39,3,4,11,48,74
2006-01-30 00:00:00.000,Zagreb Croatia ATP World Tour,HARD,2,Feliciano Lopez,Robin Soderling,Feliciano Lopez,7-6(4); 4-6; 6-1,R32,100,14,7,53,87,45,53,17,34,0,1,15,62,87,12,3,56,87,46,56,12,31,1,3,14,58,87
2006-01-30 00:00:00.000,Zagreb Croatia ATP World Tour,HARD,2,Marin Cilic,Igor Andreev,Marin Cilic,6-3; 1-6; 6-3,R32,101,5,6,50,96,39,50,22,46,10,12,13,61,96,0,1,48,71,34,48,14,23,6,8,12,48,71
2006-01-30 00:00:00.000,Zagreb Croatia ATP World Tour,HARD,2,Andreas Seppi,Noam Okun,Andreas Seppi,6-2; 6-4,R32,90,4,2,36,52,25,36,9,16,3,5,9,34,52,4,4,42,80,26,42,13,38,18,23,9,39,80
2006-01-30 00:00:00.000,Zagreb Croatia ATP World Tour,HARD,2,Tim Henman,Arnaud Clement,Tim Henman,6-3; 6-3,R32,77,7,1,30,50,26,30,11,20,0,0,9,37,50,5,1,32,57,20,32,14,25,4,7,9,34,57
2006-01-30 00:00:00.000,Zagreb Croatia ATP World Tour,HARD,2,Richard Gasquet,Davide Sanguinetti,Richard Gasquet,6-3; 6-0,R32,68,4,3,38,62,31,38,9,24,3,3,8,40,62,4,2,24,52,14,24,12,28,5,9,7,26,52
2006-01-30 00:00:00.000,Zagreb Croatia ATP World Tour,HARD,2,Mario Ancic,Dmitry Tursunov,Mario Ancic,6-3; 4-6; 6-4,R32,90,21,2,51,76,47,51,12,25,2,3,15,59,76,5,1,47,68,37,47,16,21,0,2,14,53,68
2006-01-30 00:00:00.000,Zagreb Croatia ATP World Tour,HARD,2,Ivo Karlovic,Rainer Schuettler,Ivo Karlovic,7-6(0); 6-3,R32,90,24,2,48,71,45,48,8,23,3,3,11,53,71,5,8,34,73,27,34,19,39,3,4,10,46,73
2006-01-30 00:00:00.000,Zagreb Croatia ATP World Tour,HARD,2,Stefan Koubek,Ivo Minar,Stefan Koubek,7-6(7); 3-6; 6-3,R32,95,7,3,52,90,41,52,23,38,2,3,15,64,90,6,1,64,87,48,64,13,23,2,3,15,61,87
2006-01-30 00:00:00.000,Zagreb Croatia ATP World Tour,HARD,2,Stanislas Wawrinka,David Ferrer,Stanislas Wawrinka,4-6; 6-1; 6-3,R32,109,6,3,53,101,36,53,22,48,7,10,13,58,101,3,2,55,84,31,55,14,29,7,13,13,45,84
2006-01-30 00:00:00.000,Zagreb Croatia ATP World Tour,HARD,2,Ivan Ljubicic,Kenneth Carlsen,Ivan Ljubicic,7-6(5); 6-4,R16,84,8,0,44,60,39,44,11,16,0,0,11,50,60,4,2,42,67,34,42,14,25,4,5,11,48,67
2006-01-30 00:00:00.000,Zagreb Croatia ATP World Tour,HARD,2,Mikhail Youzhny,Jarkko Nieminen,Mikhail Youzhny,2-6; 7-6(3); 7-6(0),R16,119,4,2,68,109,45,68,21,41,5,10,16,66,109,3,3,72,98,47,72,14,26,3,6,16,61,98
2006-01-30 00:00:00.000,Zagreb Croatia ATP World Tour,HARD,2,Novak Djokovic,Radek Stepanek,Novak Djokovic,6-3; 6-4,R16,83,7,3,33,60,26,33,15,27,1,2,10,41,60,4,2,34,53,22,34,9,19,4,7,9,31,53
2006-01-30 00:00:00.000,Zagreb Croatia ATP World Tour,HARD,2,Ilija Bozoljac,Feliciano Lopez,Ilija Bozoljac,7-6(5); 6-2,R16,78,14,0,30,67,27,30,21,37,3,3,10,48,67,10,7,30,68,27,30,16,38,3,5,10,43,68
2006-01-30 00:00:00.000,Zagreb Croatia ATP World Tour,HARD,2,Andreas Seppi,Marin Cilic,Andreas Seppi,4-6; 6-4; 6-4,R16,102,3,2,49,82,35,49,21,33,1,3,15,56,82,10,6,47,86,35,47,21,39,3,6,15,56,86
2006-01-30 00:00:00.000,Zagreb Croatia ATP World Tour,HARD,2,Tim Henman,Richard Gasquet,Tim Henman,6-4; 6-4,R16,85,9,4,43,70,33,43,12,27,5,6,10,45,70,1,4,28,61,23,28,16,33,7,10,10,39,61
2006-01-30 00:00:00.000,Zagreb Croatia ATP World Tour,HARD,2,Ivo Karlovic,Mario Ancic,Ivo Karlovic,7-6(7); 7-6(4),R16,102,14,0,54,76,49,54,14,22,1,1,12,63,76,7,1,50,71,43,50,15,21,2,2,12,58,71
2006-01-30 00:00:00.000,Zagreb Croatia ATP World Tour,HARD,2,Stefan Koubek,Stanislas Wawrinka,Stefan Koubek,6-4; 6-4,R16,86,1,2,35,57,26,35,14,22,0,1,10,40,57,3,4,41,72,29,41,13,31,5,8,10,42,72
2006-01-30 00:00:00.000,Zagreb Croatia ATP World Tour,HARD,2,Ivan Ljubicic,Mikhail Youzhny,Ivan Ljubicic,6-3; 6-2,Q,64,12,2,28,51,23,28,14,23,0,0,9,37,51,1,1,31,52,16,31,13,21,5,8,8,29,52
2006-01-30 00:00:00.000,Zagreb Croatia ATP World Tour,HARD,2,Novak Djokovic,Ilija Bozoljac,Novak Djokovic,6-2; 6-3,Q,60,10,0,34,49,29,34,9,15,2,2,9,38,49,10,2,27,44,20,27,7,17,1,4,8,27,44
2006-01-30 00:00:00.000,Zagreb Croatia ATP World Tour,HARD,2,Tim Henman,Andreas Seppi,Tim Henman,6-3; 6-4,Q,85,1,2,43,73,27,43,19,30,3,4,10,46,73,0,4,26,56,15,26,18,30,7,10,9,33,56
2006-01-30 00:00:00.000,Zagreb Croatia ATP World Tour,HARD,2,Stefan Koubek,Ivo Karlovic,Stefan Koubek,7-6(4); 6-7(6); 6-3,Q,134,3,5,80,119,60,80,25,39,6,6,17,85,119,21,0,62,97,51,62,21,35,4,5,16,72,97
2006-01-30 00:00:00.000,Zagreb Croatia ATP World Tour,HARD,2,Ivan Ljubicic,Novak Djokovic,Ivan Ljubicic,6-7(6); 6-3; 6-4,S,141,16,3,68,102,59,68,15,34,3,3,16,74,102,8,4,65,105,47,65,21,40,8,10,15,68,105
2006-01-30 00:00:00.000,Zagreb Croatia ATP World Tour,HARD,2,Stefan Koubek,Tim Henman,Stefan Koubek,6-3; 3-6; 6-2,S,101,4,1,51,82,36,51,15,31,11,14,13,51,82,1,4,57,84,39,57,7,27,3,8,13,46,84
2006-01-30 00:00:00.000,Zagreb Croatia ATP World Tour,HARD,2,Ivan Ljubicic,Stefan Koubek,Ivan Ljubicic,6-3; 6-4,F,66,10,3,35,51,34,35,8,16,2,2,10,42,51,1,0,29,47,18,29,14,18,2,4,9,32,47
2006-02-13 00:00:00.000,Buenos Aires Argentina ATP World Tour,CLAY,2,Alberto Martin,Albert Portas,Alberto Martin,6-2; 7-5,R32,91,3,1,27,56,24,27,16,29,3,4,10,40,56,4,2,42,78,27,42,15,36,8,12,10,42,78
2006-02-13 00:00:00.000,Buenos Aires Argentina ATP World Tour,CLAY,2,Boris Pashanski,Juan Pablo Brzezicki,Boris Pashanski,6-4; 5-7; 7-5,R32,191,3,2,75,141,49,75,30,66,14,19,17,79,141,5,5,57,101,40,57,20,44,6,12,17,60,101
2006-02-13 00:00:00.000,Buenos Aires Argentina ATP World Tour,CLAY,2,Tomas Behrend,Carlos Berlocq,Tomas Behrend,7-6(1); 6-4,R32,112,3,3,40,75,28,40,16,35,2,5,11,44,75,2,5,41,78,27,41,13,37,2,6,11,40,78
2006-02-13 00:00:00.000,Buenos Aires Argentina ATP World Tour,CLAY,2,Filippo Volandri,Fernando Vicente,Filippo Volandri,6-3; 6-2,R32,55,0,1,28,42,20,28,9,14,0,1,8,29,42,0,0,30,51,15,30,9,21,5,10,9,24,51
2006-02-13 00:00:00.000,Buenos Aires Argentina ATP World Tour,CLAY,2,Jose Acasuso,Albert Montanes,Jose Acasuso,6-1; 6-3,R32,61,5,0,25,45,23,25,9,20,0,0,8,32,45,0,4,26,51,15,26,10,25,6,10,8,25,51
2006-02-13 00:00:00.000,Buenos Aires Argentina ATP World Tour,CLAY,2,Martin Vassallo Arguello,Ricardo Mello,Martin Vassallo Arguello,6-3; 6-3,R32,82,5,1,36,52,29,36,9,16,0,0,9,38,52,2,2,43,64,29,43,9,21,7,10,9,38,64
2006-02-13 00:00:00.000,Buenos Aires Argentina ATP World Tour,CLAY,2,Juan Antonio Marin,Razvan Sabau,Juan Antonio Marin,6-1; 6-1,R32,53,3,1,13,35,10,13,18,22,0,0,7,28,35,0,4,25,47,13,25,6,22,5,10,7,19,47
2006-02-13 00:00:00.000,Buenos Aires Argentina ATP World Tour,CLAY,2,Agustin Calleri,Florent Serra,Agustin Calleri,6-0; 6-4,R32,61,6,0,17,38,14,17,16,21,0,1,8,30,38,1,1,34,52,17,34,7,18,5,10,8,24,52
2006-02-13 00:00:00.000,Buenos Aires Argentina ATP World Tour,CLAY,2,Juan Ignacio Chela,Luis Horna,Juan Ignacio Chela,7-6(1) RET,R32,55,1,1,26,35,21,26,6,9,1,2,6,27,35,3,1,32,45,19,32,6,13,3,4,6,25,45
2006-02-13 00:00:00.000,Buenos Aires Argentina ATP World Tour,CLAY,2,Potito Starace,Juan Monaco,Potito Starace,6-3; 6-3,R32,97,1,2,37,50,29,37,7,13,1,2,9,36,50,1,2,37,67,23,37,12,30,5,9,9,35,67
2006-02-13 00:00:00.000,Buenos Aires Argentina ATP World Tour,CLAY,2,Flavio Saretta,Gorka Fraile,Flavio Saretta,6-0; 4-6; 6-3,R32,12,3,0,43,66,29,43,13,23,5,8,12,42,66,0,0,78,90,42,78,3,12,11,18,13,45,90
2006-02-13 00:00:00.000,Buenos Aires Argentina ATP World Tour,CLAY,2,Juan Carlos Ferrero,Juan Martin Del Potro,Juan Carlos Ferrero,6-2; 4-6; 6-4,R32,137,4,1,58,82,36,58,14,24,6,10,14,50,82,2,2,81,108,44,81,12,27,7,13,14,56,108
2006-02-13 00:00:00.000,Buenos Aires Argentina ATP World Tour,CLAY,2,Carlos Moya,Fabio Fognini,Carlos Moya,6-7(6); 6-4; 6-4,R32,143,2,2,72,105,49,72,18,33,1,3,16,67,105,2,2,57,102,35,57,29,45,4,8,16,64,102
2006-02-13 00:00:00.000,Buenos Aires Argentina ATP World Tour,CLAY,2,Nicolas Massu,Marcos Daniel,Nicolas Massu,6-3; 5-7; 6-1,R32,134,4,1,40,77,27,40,23,37,3,6,14,50,77,3,2,50,76,30,50,12,26,0,6,14,42,76
2006-02-13 00:00:00.000,Buenos Aires Argentina ATP World Tour,CLAY,2,Ruben Ramirez Hidalgo,Eric Prodon,Ruben Ramirez Hidalgo,3-6; 6-4; 6-2,R32,121,5,5,56,96,42,56,18,40,8,10,14,60,96,2,3,55,84,36,55,16,29,6,9,13,52,84
2006-02-13 00:00:00.000,Buenos Aires Argentina ATP World Tour,CLAY,2,Guillermo Coria,Jiri Vanek,Guillermo Coria,6-1; 2-6; 7-6(2),R32,163,2,9,69,102,41,69,14,33,6,12,13,55,102,6,3,65,107,42,65,13,42,15,22,14,55,107
2006-02-13 00:00:00.000,Buenos Aires Argentina ATP World Tour,CLAY,2,Boris Pashanski,Alberto Martin,Boris Pashanski,3-6; 7-6(5); 6-3,R16,148,5,4,73,118,50,73,20,45,8,12,16,70,118,5,5,47,86,34,47,21,39,2,5,14,55,86
2006-02-13 00:00:00.000,Buenos Aires Argentina ATP World Tour,CLAY,2,Filippo Volandri,Tomas Behrend,Filippo Volandri,3-6; 7-6(5); 7-6(2),R16,139,1,0,88,114,55,88,16,26,4,8,17,71,114,0,3,64,114,44,64,27,50,5,7,16,71,114
2006-02-13 00:00:00.000,Buenos Aires Argentina ATP World Tour,CLAY,2,Jose Acasuso,Martin Vassallo Arguello,Jose Acasuso,6-3; 6-1,R16,64,4,2,22,39,20,22,10,17,1,2,8,30,39,1,3,31,46,14,31,4,15,2,7,8,18,46
2006-02-13 00:00:00.000,Buenos Aires Argentina ATP World Tour,CLAY,2,Agustin Calleri,Juan Antonio Marin,Agustin Calleri,6-4; 6-2,R16,87,9,2,28,44,26,28,11,16,0,0,9,37,44,2,0,28,59,20,28,14,31,2,5,9,34,59
2006-02-13 00:00:00.000,Buenos Aires Argentina ATP World Tour,CLAY,2,Potito Starace,Juan Ignacio Chela,Potito Starace,3-6; 7-6(4); 6-2,R16,157,3,1,75,97,57,75,8,22,5,6,14,65,97,6,2,66,105,43,66,22,39,5,7,15,65,105
2006-02-13 00:00:00.000,Buenos Aires Argentina ATP World Tour,CLAY,2,Juan Carlos Ferrero,Flavio Saretta,Juan Carlos Ferrero,4-6; 6-2; 6-3,R16,148,4,0,65,95,42,65,16,30,7,10,14,58,95,3,3,49,80,29,49,17,31,6,11,13,46,80
2006-02-13 00:00:00.000,Buenos Aires Argentina ATP World Tour,CLAY,2,Carlos Moya,Nicolas Massu,Carlos Moya,4-6; 6-3; 7-6(4),R16,162,6,3,66,96,54,66,16,30,2,4,16,70,96,0,2,65,104,46,65,22,39,5,7,15,68,104
2006-02-13 00:00:00.000,Buenos Aires Argentina ATP World Tour,CLAY,2,Ruben Ramirez Hidalgo,Guillermo Coria,Ruben Ramirez Hidalgo,7-5; 6-2,R16,94,5,4,41,72,30,41,12,31,6,9,10,42,72,0,12,31,58,17,31,10,27,4,10,10,27,58
2006-02-13 00:00:00.000,Buenos Aires Argentina ATP World Tour,CLAY,2,Filippo Volandri,Boris Pashanski,Filippo Volandri,6-4; 6-3,Q,93,4,1,50,65,32,50,8,15,4,7,10,40,65,1,3,37,72,20,37,14,35,8,13,9,34,72
2006-02-13 00:00:00.000,Buenos Aires Argentina ATP World Tour,CLAY,2,Agustin Calleri,Jose Acasuso,Agustin Calleri,6-3; 3-6; 6-4,Q,133,3,1,51,86,38,51,15,35,3,7,14,53,86,2,2,48,84,35,48,13,36,1,6,14,48,84
2006-02-13 00:00:00.000,Buenos Aires Argentina ATP World Tour,CLAY,2,Juan Carlos Ferrero,Potito Starace,Juan Carlos Ferrero,6-3; 7-5,Q,102,1,0,49,63,31,49,6,14,5,9,11,37,63,1,0,54,76,27,54,8,22,12,18,10,35,76
2006-02-13 00:00:00.000,Buenos Aires Argentina ATP World Tour,CLAY,2,Carlos Moya,Ruben Ramirez Hidalgo,Carlos Moya,6-2; 6-2,Q,66,7,2,32,56,28,32,9,24,4,5,8,37,56,1,3,33,48,18,33,4,15,6,11,8,22,48
2006-02-13 00:00:00.000,Buenos Aires Argentina ATP World Tour,CLAY,2,Filippo Volandri,Agustin Calleri,Filippo Volandri,6-3; 6-4,S,85,0,0,57,74,34,57,9,17,3,5,10,43,74,0,3,26,50,17,26,9,24,3,7,9,26,50
2006-02-13 00:00:00.000,Buenos Aires Argentina ATP World Tour,CLAY,2,Carlos Moya,Juan Carlos Ferrero,Carlos Moya,3-6; 7-6(3); 6-4,S,155,6,4,62,105,48,62,21,43,4,6,15,69,105,3,2,81,101,58,81,9,20,1,3,16,67,101
2006-02-13 00:00:00.000,Buenos Aires Argentina ATP World Tour,CLAY,2,Carlos Moya,Filippo Volandri,Carlos Moya,7-6(6); 6-4,F,90,3,0,45,65,37,45,10,20,2,3,11,47,65,0,0,58,72,37,58,8,14,3,5,11,45,72
2006-02-13 00:00:00.000,Marseille France ATP World Tour,HARD,2,Rafael Nadal,Olivier Rochus,Rafael Nadal,4-6; 6-2; 7-5,R32,145,3,1,50,81,32,50,17,31,3,8,15,49,81,2,6,62,97,34,62,15,35,6,13,15,49,97
2006-02-13 00:00:00.000,Marseille France ATP World Tour,HARD,2,Gilles Simon,Jarkko Nieminen,Gilles Simon,4-6; 6-3; 6-2,R32,126,8,4,42,85,35,42,25,43,4,5,14,60,85,2,0,65,107,39,65,23,42,10,13,13,62,107
2006-02-13 00:00:00.000,Marseille France ATP World Tour,HARD,2,Paul-Henri Mathieu,Jerome Haehnel,Paul-Henri Mathieu,5-7; 6-3; 6-4,R32,130,7,6,48,99,37,48,23,51,6,10,16,60,99,8,5,57,96,41,57,13,39,1,6,15,54,96
2006-02-13 00:00:00.000,Marseille France ATP World Tour,HARD,2,Radek Stepanek,Tomas Berdych,Radek Stepanek,7-5; 6-4,R32,83,12,2,34,54,30,34,14,20,0,0,11,44,54,6,0,34,66,25,34,20,32,5,7,11,45,66
2006-02-13 00:00:00.000,Marseille France ATP World Tour,HARD,2,Fabrice Santoro,Thomas Johansson,Fabrice Santoro,6-4; 7-6(3),R32,86,3,2,38,73,33,38,18,35,3,3,11,51,73,10,3,42,75,29,42,19,33,1,2,11,48,75
2006-02-13 00:00:00.000,Marseille France ATP World Tour,HARD,2,Greg Rusedski,Nicolas Thomann,Greg Rusedski,6-3; 6-2,R32,73,15,4,38,59,30,38,11,21,3,3,9,41,59,0,2,26,50,14,26,13,24,3,6,8,27,50
2006-02-13 00:00:00.000,Marseille France ATP World Tour,HARD,2,Fernando Verdasco,Jurgen Melzer,Fernando Verdasco,6-4; 7-6(3),R32,84,6,5,49,77,34,49,14,28,4,6,11,48,77,8,2,45,71,29,45,12,26,4,7,11,41,71
2006-02-13 00:00:00.000,Marseille France ATP World Tour,HARD,2,Arnaud Clement,Richard Gasquet,Arnaud Clement,3-6; 6-4; 6-0,R32,114,5,1,48,85,32,48,23,37,5,6,12,55,85,6,3,45,76,30,45,16,31,3,7,13,46,76
2006-02-13 00:00:00.000,Marseille France ATP World Tour,HARD,2,Sebastien Grosjean,Gael Monfils,Sebastien Grosjean,2-6; 7-5; 6-3,R32,133,3,3,46,94,32,46,22,48,2,7,15,54,94,3,1,40,74,24,40,20,34,3,8,14,44,74
2006-02-13 00:00:00.000,Marseille France ATP World Tour,HARD,2,Mikhail Youzhny,Sebastien De Chaunac,Mikhail Youzhny,6-4; 6-3,R32,77,3,0,31,52,26,31,13,21,2,2,9,39,52,2,0,40,67,26,40,14,27,7,10,10,40,67
2006-02-13 00:00:00.000,Marseille France ATP World Tour,HARD,2,Evgeny Korolev,Alexandre Sidorenko,Evgeny Korolev,2-6; 6-4; 6-1,R32,112,8,7,41,82,35,41,20,41,6,8,13,55,82,5,2,34,78,22,34,24,44,1,4,12,46,78
2006-02-13 00:00:00.000,Marseille France ATP World Tour,HARD,2,Nikolay Davydenko,Christophe Rochus,Nikolay Davydenko,6-1; 6-2,R32,70,5,2,24,42,20,24,8,18,1,2,7,28,42,1,3,24,54,15,24,6,30,6,12,8,21,54
2006-02-13 00:00:00.000,Marseille France ATP World Tour,HARD,2,Mario Ancic,Marcos Baghdatis,Mario Ancic,6-2; 6-7(9); 6-4,R32,125,14,2,64,107,56,64,19,43,4,5,15,75,107,7,1,69,108,47,69,22,39,4,8,15,69,108
2006-02-13 00:00:00.000,Marseille France ATP World Tour,HARD,2,Jean-Christophe Faurel,Feliciano Lopez,Jean-Christophe Faurel,6-3; 6-3,R32,61,5,1,27,50,22,27,16,23,0,0,9,38,50,10,4,28,55,19,28,12,27,5,8,9,31,55
2006-02-13 00:00:00.000,Marseille France ATP World Tour,HARD,2,Igor Andreev,Taylor Dent,Igor Andreev,2-6; 6-3; 7-6(0),R32,101,4,2,59,89,40,59,21,30,5,7,15,61,89,6,6,44,75,37,44,16,31,0,1,14,53,75
2006-02-13 00:00:00.000,Marseille France ATP World Tour,HARD,2,Ivan Ljubicic,Paradorn Srichaphan,Ivan Ljubicic,6-3; 6-7(6); 6-3,R32,110,21,3,63,92,53,63,14,29,1,2,16,67,92,5,1,47,85,39,47,17,38,3,6,14,56,85
2006-02-13 00:00:00.000,Marseille France ATP World Tour,HARD,2,Rafael Nadal,Gilles Simon,Rafael Nadal,7-5; 6-4,R16,103,1,2,52,71,36,52,10,19,3,4,11,46,71,9,2,37,60,29,37,10,23,0,3,11,39,60
2006-02-13 00:00:00.000,Marseille France ATP World Tour,HARD,2,Paul-Henri Mathieu,Radek Stepanek,Paul-Henri Mathieu,7-6(0); 6-3,R16,94,5,1,40,67,32,40,15,27,2,2,10,47,67,14,0,43,66,31,43,11,23,0,2,11,42,66
2006-02-13 00:00:00.000,Marseille France ATP World Tour,HARD,2,Fabrice Santoro,Greg Rusedski,Fabrice Santoro,6-3; 6-2,R16,73,2,1,28,55,20,28,20,27,1,1,9,40,55,4,6,33,51,19,33,8,18,2,5,8,27,51
2006-02-13 00:00:00.000,Marseille France ATP World Tour,HARD,2,Arnaud Clement,Fernando Verdasco,Arnaud Clement,7-6(5); 6-3,R16,100,5,3,43,70,30,43,15,27,5,7,10,45,70,6,3,44,73,29,44,12,29,2,6,11,41,73
2006-02-13 00:00:00.000,Marseille France ATP World Tour,HARD,2,Sebastien Grosjean,Mikhail Youzhny,Sebastien Grosjean,6-3; 6-1,R16,74,5,0,32,54,26,32,11,22,4,4,8,37,54,1,3,23,47,16,23,7,24,3,7,8,23,47
2006-02-13 00:00:00.000,Marseille France ATP World Tour,HARD,2,Evgeny Korolev,Nikolay Davydenko,Evgeny Korolev,6-4; 7-6(6),R16,91,6,6,41,75,30,41,15,34,5,8,11,45,75,4,3,44,63,28,44,9,19,2,6,11,37,63
2006-02-13 00:00:00.000,Marseille France ATP World Tour,HARD,2,Mario Ancic,Jean-Christophe Faurel,Mario Ancic,6-3; 6-3,R16,62,12,1,32,58,28,32,13,26,2,2,9,41,58,1,2,39,65,21,39,15,26,8,11,9,36,65
2006-02-13 00:00:00.000,Marseille France ATP World Tour,HARD,2,Ivan Ljubicic,Igor Andreev,Ivan Ljubicic,7-6(5); 6-4,R16,84,18,4,45,70,39,45,14,25,2,2,11,53,70,4,1,43,67,37,43,12,24,1,2,11,49,67
2006-02-13 00:00:00.000,Marseille France ATP World Tour,HARD,2,Rafael Nadal,Paul-Henri Mathieu,Rafael Nadal,7-5; 6-4,Q,122,8,4,55,83,39,55,16,28,6,6,11,55,83,3,6,34,64,27,34,16,30,4,6,11,43,64
2006-02-13 00:00:00.000,Marseille France ATP World Tour,HARD,2,Arnaud Clement,Fabrice Santoro,Arnaud Clement,7-5; 4-6; 7-6(5),Q,162,10,1,66,108,47,66,24,42,2,5,17,71,108,16,0,58,100,47,58,19,42,0,3,17,66,100
2006-02-13 00:00:00.000,Marseille France ATP World Tour,HARD,2,Sebastien Grosjean,Evgeny Korolev,Sebastien Grosjean,7-6(4); 6-3,Q,104,10,1,35,65,31,35,16,30,3,3,10,47,65,5,5,41,83,31,41,18,42,6,8,11,49,83
2006-02-13 00:00:00.000,Marseille France ATP World Tour,HARD,2,Mario Ancic,Ivan Ljubicic,Mario Ancic,7-6(2); 3-6; 6-3,Q,136,17,3,71,106,57,71,16,35,4,5,15,73,106,8,0,50,77,44,50,15,27,0,1,15,59,77
2006-02-13 00:00:00.000,Marseille France ATP World Tour,HARD,2,Arnaud Clement,Rafael Nadal,Arnaud Clement,2-6; 6-3; 7-5,S,115,8,3,54,86,40,54,18,32,1,3,15,58,86,5,1,58,93,37,58,22,35,7,9,14,59,93
2006-02-13 00:00:00.000,Marseille France ATP World Tour,HARD,2,Mario Ancic,Sebastien Grosjean,Mario Ancic,6-3; 3-6; 6-3,S,129,11,2,48,84,40,48,20,36,2,3,14,60,84,2,1,36,80,27,36,24,44,2,4,13,51,80
2006-02-13 00:00:00.000,Marseille France ATP World Tour,HARD,2,Arnaud Clement,Mario Ancic,Arnaud Clement,6-4; 6-2,F,92,4,1,29,59,22,29,18,30,3,3,9,40,59,6,2,28,57,22,28,11,29,2,5,9,33,57
2006-02-13 00:00:00.000,San Jose CA; U.S.A. ATP World Tour,HARD,2,Andy Roddick,Guillermo Garcia-Lopez,Andy Roddick,6-3; 6-4,R32,79,6,2,27,56,20,27,19,29,5,6,10,39,56,7,1,34,59,23,34,12,25,3,6,9,35,59
2006-02-13 00:00:00.000,San Jose CA; U.S.A. ATP World Tour,HARD,2,Kenneth Carlsen,Lukas Dlouhy,Kenneth Carlsen,3-6; 6-2; 6-1,R32,95,2,1,40,69,29,40,13,29,6,9,12,42,69,7,6,53,86,33,53,11,33,9,15,12,44,86
2006-02-13 00:00:00.000,San Jose CA; U.S.A. ATP World Tour,HARD,2,Bjorn Phau,Cyril Saulnier,Bjorn Phau,6-4; 7-5,R32,106,1,3,37,78,26,37,24,41,4,5,11,50,78,4,6,46,88,36,46,16,42,13,16,11,52,88
2006-02-13 00:00:00.000,San Jose CA; U.S.A. ATP World Tour,HARD,2,Brian Wilson,Ivo Karlovic,Brian Wilson,7-6(1); 7-6(5),R32,99,2,4,51,77,42,51,18,26,4,4,12,60,77,11,3,43,77,34,43,20,34,1,1,12,54,77
2006-02-13 00:00:00.000,San Jose CA; U.S.A. ATP World Tour,HARD,2,Mark Philippoussis,Tommy Robredo,Mark Philippoussis,3-6; 7-5; 7-5,R32,139,11,8,47,107,38,47,25,60,5,10,17,63,107,4,2,60,91,39,60,16,31,1,6,16,55,91
2006-02-13 00:00:00.000,San Jose CA; U.S.A. ATP World Tour,HARD,2,Robin Soderling,Andrei Pavel,Robin Soderling,6-3; 6-4,R32,67,6,1,33,51,26,33,12,18,3,5,10,38,51,3,2,35,69,19,35,17,34,6,10,9,36,69
2006-02-13 00:00:00.000,San Jose CA; U.S.A. ATP World Tour,HARD,2,Andy Murray,Mardy Fish,Andy Murray,6-2; 6-2,R32,64,5,1,21,42,16,21,14,21,0,1,8,30,42,3,6,26,59,13,26,14,33,6,11,8,27,59
2006-02-13 00:00:00.000,San Jose CA; U.S.A. ATP World Tour,HARD,2,Jimmy Wang,James Blake,Jimmy Wang,6-3; 7-5,R32,99,5,1,36,89,26,36,27,53,10,12,11,53,89,7,6,38,72,27,38,12,34,5,9,10,39,72
2006-02-13 00:00:00.000,San Jose CA; U.S.A. ATP World Tour,HARD,2,Dmitry Tursunov,Jonas Bjorkman,Dmitry Tursunov,4-6; 6-3; 6-2,R32,111,16,6,51,103,41,51,23,52,7,9,14,64,103,5,2,47,82,30,47,17,35,4,8,13,47,82
2006-02-13 00:00:00.000,San Jose CA; U.S.A. ATP World Tour,HARD,2,Wayne Arthurs,Bobby Reynolds,Wayne Arthurs,4-6; 7-5; 7-5,R32,122,27,3,55,90,46,55,24,35,4,5,17,70,90,13,5,61,104,47,61,24,43,7,9,17,71,104
2006-02-13 00:00:00.000,San Jose CA; U.S.A. ATP World Tour,HARD,2,Sam Warburg,Joachim Johansson,Sam Warburg,6-3; 4-6; 6-3,R32,112,6,4,57,78,39,57,12,21,0,3,14,51,78,5,5,51,92,32,51,19,41,4,9,14,51,92
2006-02-13 00:00:00.000,San Jose CA; U.S.A. ATP World Tour,HARD,2,Lleyton Hewitt,Paul Goldstein,Lleyton Hewitt,6-4; 6-2,R32,58,6,2,22,45,20,22,14,23,0,1,9,34,45,0,0,27,48,19,27,8,21,1,5,9,27,48
2006-02-13 00:00:00.000,San Jose CA; U.S.A. ATP World Tour,HARD,2,Justin Gimelstob,Bjorn Rehnquist,Justin Gimelstob,6-1; 6-4,R32,68,4,2,23,55,16,23,19,32,2,4,9,35,55,1,4,22,53,11,22,14,31,9,14,8,25,53
2006-02-13 00:00:00.000,San Jose CA; U.S.A. ATP World Tour,HARD,2,Kristof Vliegen,Rainer Schuettler,Kristof Vliegen,6-1; 6-3,R32,67,3,2,33,49,23,33,10,16,2,3,8,33,49,5,5,35,60,21,35,8,25,3,8,8,29,60
2006-02-13 00:00:00.000,San Jose CA; U.S.A. ATP World Tour,HARD,2,Vincent Spadea,Sam Querrey,Vincent Spadea,6-7(4); 6-4; 6-2,R32,115,5,2,61,103,46,61,21,42,4,5,15,67,103,15,6,63,103,48,63,14,40,5,9,15,62,103
2006-02-13 00:00:00.000,San Jose CA; U.S.A. ATP World Tour,HARD,2,Travis Rettenmaier,Scoville Jenkins,Travis Rettenmaier,7-5; 3-6; 6-3,R32,120,3,4,53,90,41,53,20,37,4,6,15,61,90,5,4,46,84,35,46,23,38,4,7,15,58,84
2006-02-13 00:00:00.000,San Jose CA; U.S.A. ATP World Tour,HARD,2,Andy Roddick,Kenneth Carlsen,Andy Roddick,6-3; 1-6; 6-3,R16,95,9,1,52,82,39,52,14,30,3,5,13,53,82,8,3,40,66,30,40,15,26,1,3,12,45,66
2006-02-13 00:00:00.000,San Jose CA; U.S.A. ATP World Tour,HARD,2,Bjorn Phau,Brian Wilson,Bjorn Phau,7-5; 7-5,R16,99,2,2,31,63,24,31,18,32,0,2,12,42,63,4,13,53,95,36,53,16,42,11,15,12,52,95
2006-02-13 00:00:00.000,San Jose CA; U.S.A. ATP World Tour,HARD,2,Robin Soderling,Mark Philippoussis,Robin Soderling,6-2; 6-3,R16,61,6,2,32,46,29,32,9,14,2,2,9,38,46,6,1,35,55,26,35,5,20,5,8,8,31,55
2006-02-13 00:00:00.000,San Jose CA; U.S.A. ATP World Tour,HARD,2,Andy Murray,Jimmy Wang,Andy Murray,6-4; 6-2,R16,100,4,1,30,73,22,30,21,43,7,9,9,43,73,1,0,38,70,15,38,17,32,7,12,9,32,70
2006-02-13 00:00:00.000,San Jose CA; U.S.A. ATP World Tour,HARD,2,Wayne Arthurs,Dmitry Tursunov,Wayne Arthurs,6-3; 6-7(5); 6-3,R16,113,21,7,49,99,41,49,26,50,3,5,16,67,99,8,12,49,91,39,49,14,42,2,6,14,53,91
2006-02-13 00:00:00.000,San Jose CA; U.S.A. ATP World Tour,HARD,2,Lleyton Hewitt,Sam Warburg,Lleyton Hewitt,6-4; 6-3,R16,72,10,4,34,59,26,34,10,25,1,3,10,36,59,1,1,39,57,20,39,10,18,3,7,9,30,57
2006-02-13 00:00:00.000,San Jose CA; U.S.A. ATP World Tour,HARD,2,Kristof Vliegen,Justin Gimelstob,Kristof Vliegen,7-6(1); 4-6; 6-1,R16,107,7,1,61,89,46,61,18,28,4,6,15,64,89,7,2,47,82,33,47,19,35,2,5,14,52,82
2006-02-13 00:00:00.000,San Jose CA; U.S.A. ATP World Tour,HARD,2,Vincent Spadea,Travis Rettenmaier,Vincent Spadea,6-2; 6-0,R16,45,3,0,29,36,24,29,4,7,0,0,7,28,36,0,3,25,40,15,25,3,15,4,9,7,18,40
2006-02-13 00:00:00.000,San Jose CA; U.S.A. ATP World Tour,HARD,2,Andy Roddick,Bjorn Phau,Andy Roddick,6-3; 6-2,Q,64,8,3,33,46,31,33,6,13,1,1,9,37,46,2,4,28,58,17,28,15,30,1,4,8,32,58
2006-02-13 00:00:00.000,San Jose CA; U.S.A. ATP World Tour,HARD,2,Andy Murray,Robin Soderling,Andy Murray,4-6; 7-5; 6-4,Q,123,4,2,54,92,43,54,16,38,3,7,16,59,92,13,6,66,106,45,66,17,40,6,11,16,62,106
2006-02-13 00:00:00.000,San Jose CA; U.S.A. ATP World Tour,HARD,2,Lleyton Hewitt,Wayne Arthurs,Lleyton Hewitt,7-6(4); 6-2,Q,69,10,2,28,57,23,28,20,29,0,1,10,43,57,19,6,34,70,25,34,16,36,3,6,10,41,70
2006-02-13 00:00:00.000,San Jose CA; U.S.A. ATP World Tour,HARD,2,Vincent Spadea,Kristof Vliegen,Vincent Spadea,6-1; 2-6; 6-3,Q,103,3,1,47,86,32,47,20,39,8,11,12,52,86,6,2,45,77,27,45,15,32,4,9,12,42,77
2006-02-13 00:00:00.000,San Jose CA; U.S.A. ATP World Tour,HARD,2,Andy Murray,Andy Roddick,Andy Murray,7-5; 7-5,S,69,7,2,47,76,32,47,18,29,3,4,12,50,76,6,2,37,67,28,37,14,30,4,7,12,42,67
2006-02-13 00:00:00.000,San Jose CA; U.S.A. ATP World Tour,HARD,2,Lleyton Hewitt,Vincent Spadea,Lleyton Hewitt,6-3; 6-4,S,72,6,4,38,65,33,38,13,27,3,3,10,46,65,4,1,31,55,26,31,8,24,5,7,9,34,55
2006-02-13 00:00:00.000,San Jose CA; U.S.A. ATP World Tour,HARD,2,Andy Murray,Lleyton Hewitt,Andy Murray,2-6; 6-1; 7-6(3),F,143,8,5,46,86,37,46,12,40,3,8,13,49,86,10,11,52,118,33,52,28,66,10,16,14,61,118
2006-02-20 00:00:00.000,Costa Do Sauipe Brasil ATP World Tour,CLAY,2,Gaston Gaudio,Albert Portas,Gaston Gaudio,6-3; 3-6; 6-3,R32,110,2,2,45,73,32,45,14,28,2,6,13,46,73,6,8,45,83,28,45,17,38,5,11,14,45,83
2006-02-20 00:00:00.000,Costa Do Sauipe Brasil ATP World Tour,CLAY,2,Olivier Patience,Razvan Sabau,Olivier Patience,7-6(5); 6-3,R32,78,10,4,43,68,28,43,12,25,5,8,10,40,68,1,6,40,70,25,40,12,30,6,11,11,37,70
2006-02-20 00:00:00.000,Costa Do Sauipe Brasil ATP World Tour,CLAY,2,Ricardo Mello,Juan Antonio Marin,Ricardo Mello,7-6(9); 3-6; 6-0,R32,140,3,3,39,80,26,39,19,41,1,6,13,45,80,4,1,45,98,27,45,23,53,3,10,14,50,98
2006-02-20 00:00:00.000,Costa Do Sauipe Brasil ATP World Tour,CLAY,2,Boris Pashanski,Tomas Behrend,Boris Pashanski,6-3; 1-6; 6-3,R32,115,3,5,44,82,33,44,18,38,4,7,13,51,82,5,1,46,85,31,46,17,39,7,10,12,48,85
2006-02-20 00:00:00.000,Costa Do Sauipe Brasil ATP World Tour,CLAY,2,Filippo Volandri,Kevin Kim,Filippo Volandri,3-6; 6-3; 6-0,R32,99,0,1,59,77,33,59,11,18,3,7,12,44,77,2,4,49,86,23,49,18,37,7,14,12,41,86
2006-02-20 00:00:00.000,Costa Do Sauipe Brasil ATP World Tour,CLAY,2,Jiri Vanek,Albert Montanes,Jiri Vanek,7-6(6); 6-1,R32,87,11,3,37,57,29,37,11,20,1,3,10,40,57,5,7,38,71,24,38,14,33,5,9,9,38,71
2006-02-20 00:00:00.000,Costa Do Sauipe Brasil ATP World Tour,CLAY,2,Andre Ghem,Gustavo Kuerten,Andre Ghem,3-6; 6-3; 6-4,R32,108,5,2,54,91,39,54,22,37,5,6,14,61,91,8,3,42,79,32,42,20,37,1,3,14,52,79
2006-02-20 00:00:00.000,Costa Do Sauipe Brasil ATP World Tour,CLAY,2,Alberto Martin,Luis Horna,Alberto Martin,6-4; 7-5,R32,94,7,3,43,70,27,43,17,27,2,4,11,44,70,2,2,40,60,24,40,10,20,2,6,11,34,60
2006-02-20 00:00:00.000,Costa Do Sauipe Brasil ATP World Tour,CLAY,2,Juan Ignacio Chela,Daniel Gimeno-Traver,Juan Ignacio Chela,7-6(3); 6-3,R32,123,1,1,43,73,33,43,16,30,5,7,11,49,73,4,2,51,85,30,51,17,34,8,11,10,47,85
2006-02-20 00:00:00.000,Costa Do Sauipe Brasil ATP World Tour,CLAY,2,Potito Starace,Ivan Navarro,Potito Starace,6-3; 3-6; 6-3,R32,120,1,1,61,81,39,61,14,20,5,9,14,53,81,8,5,47,87,36,47,13,40,9,14,13,49,87
2006-02-20 00:00:00.000,Costa Do Sauipe Brasil ATP World Tour,CLAY,2,Juan Monaco,Juan Martin Del Potro,Juan Monaco,7-5; 7-5,R32,116,1,3,39,69,27,39,19,30,2,4,12,46,69,0,2,42,69,26,42,14,27,1,5,12,40,69
2006-02-20 00:00:00.000,Costa Do Sauipe Brasil ATP World Tour,CLAY,2,Florent Serra,Lukas Dlouhy,Florent Serra,6-3; 2-6; 6-4,R32,103,2,2,60,95,39,60,18,35,7,10,14,57,95,10,4,48,75,35,48,11,27,4,7,13,46,75
2006-02-20 00:00:00.000,Costa Do Sauipe Brasil ATP World Tour,CLAY,2,Nicolas Massu,Marcos Daniel,Nicolas Massu,7-6(3); 6-1,R32,102,2,2,37,75,26,37,23,38,7,8,10,49,75,1,1,39,52,26,39,3,13,2,5,9,29,52
2006-02-20 00:00:00.000,Costa Do Sauipe Brasil ATP World Tour,CLAY,2,Fernando Vicente,Carlos Berlocq,Fernando Vicente,6-4; 2-0 RET,R32,65,2,1,20,35,15,20,8,15,0,1,6,23,35,2,4,25,43,14,25,6,18,3,6,6,20,43
2006-02-20 00:00:00.000,Costa Do Sauipe Brasil ATP World Tour,CLAY,2,Nicolas Almagro,Andre Sa,Nicolas Almagro,6-1; 7-6(3),R32,92,9,2,39,50,33,39,7,11,1,2,9,40,50,1,5,46,81,26,46,17,35,6,10,10,43,81
2006-02-20 00:00:00.000,Costa Do Sauipe Brasil ATP World Tour,CLAY,2,Flavio Saretta,Juan Carlos Ferrero,Flavio Saretta,6-4; 6-3,R32,96,7,3,37,57,28,37,8,20,7,9,9,36,57,1,3,33,64,18,33,15,31,4,9,10,33,64
2006-02-20 00:00:00.000,Costa Do Sauipe Brasil ATP World Tour,CLAY,2,Olivier Patience,Gaston Gaudio,Olivier Patience,6-2; 6-2,R16,51,5,0,29,39,24,29,8,10,0,0,8,32,39,4,4,24,42,17,24,5,18,4,8,8,22,42
2006-02-20 00:00:00.000,Costa Do Sauipe Brasil ATP World Tour,CLAY,2,Boris Pashanski,Ricardo Mello,Boris Pashanski,6-2; 6-3,R16,78,3,0,33,49,28,33,10,16,2,2,9,38,49,5,2,36,62,22,36,12,26,8,11,8,34,62
2006-02-20 00:00:00.000,Costa Do Sauipe Brasil ATP World Tour,CLAY,2,Jiri Vanek,Filippo Volandri,Jiri Vanek,6-0; 6-1,R16,54,6,1,25,40,20,25,7,15,3,3,6,27,40,0,1,38,51,14,38,6,13,2,8,7,20,51
2006-02-20 00:00:00.000,Costa Do Sauipe Brasil ATP World Tour,CLAY,2,Alberto Martin,Andre Ghem,Alberto Martin,6-2; 3-6; 6-3,R16,109,4,0,43,66,29,43,18,23,5,7,13,47,66,6,5,50,100,36,50,20,50,6,10,13,56,100
2006-02-20 00:00:00.000,Costa Do Sauipe Brasil ATP World Tour,CLAY,2,Juan Ignacio Chela,Potito Starace,Juan Ignacio Chela,6-4; 7-5,R16,108,0,1,45,69,32,45,13,24,5,7,11,45,69,2,2,55,76,35,55,7,21,5,9,11,42,76
2006-02-20 00:00:00.000,Costa Do Sauipe Brasil ATP World Tour,CLAY,2,Juan Monaco,Florent Serra,Juan Monaco,6-1; 6-1,R16,73,6,0,33,48,24,33,8,15,1,1,7,32,48,0,4,22,46,12,22,7,24,3,8,7,19,46
2006-02-20 00:00:00.000,Costa Do Sauipe Brasil ATP World Tour,CLAY,2,Nicolas Massu,Fernando Vicente,Nicolas Massu,3-6; 7-6(6); 6-3,R16,168,2,2,63,105,43,63,17,42,6,10,14,60,105,2,1,65,97,40,65,16,32,2,7,16,56,97
2006-02-20 00:00:00.000,Costa Do Sauipe Brasil ATP World Tour,CLAY,2,Nicolas Almagro,Flavio Saretta,Nicolas Almagro,7-5; 7-5,R16,115,7,1,34,65,28,34,19,31,1,2,12,47,65,2,3,44,75,30,44,16,31,2,5,12,46,75
2006-02-20 00:00:00.000,Costa Do Sauipe Brasil ATP World Tour,CLAY,2,Olivier Patience,Boris Pashanski,Olivier Patience,4-6; 6-3; 6-2,Q,127,5,2,44,84,30,44,24,40,1,3,14,54,84,6,4,46,93,26,46,27,47,10,14,13,53,93
2006-02-20 00:00:00.000,Costa Do Sauipe Brasil ATP World Tour,CLAY,2,Alberto Martin,Jiri Vanek,Alberto Martin,7-6(5); 6-3,Q,104,2,2,44,75,29,44,15,31,3,7,11,44,75,4,1,37,67,22,37,12,30,3,8,10,34,67
2006-02-20 00:00:00.000,Costa Do Sauipe Brasil ATP World Tour,CLAY,2,Juan Monaco,Juan Ignacio Chela,Juan Monaco,6-3; 6-2,Q,96,1,1,31,57,22,31,16,26,1,2,9,38,57,0,3,30,54,17,30,9,24,5,9,8,26,54
2006-02-20 00:00:00.000,Costa Do Sauipe Brasil ATP World Tour,CLAY,2,Nicolas Massu,Nicolas Almagro,Nicolas Massu,7-6(4); 6-3,Q,105,8,3,50,72,35,50,12,22,3,5,11,47,72,5,4,40,68,25,40,14,28,1,4,10,39,68
2006-02-20 00:00:00.000,Costa Do Sauipe Brasil ATP World Tour,CLAY,2,Alberto Martin,Olivier Patience,Alberto Martin,6-2; 5-7; 7-6(3),S,166,4,6,59,110,43,59,28,51,7,9,16,71,110,9,4,67,126,45,67,28,59,8,11,16,73,126
2006-02-20 00:00:00.000,Costa Do Sauipe Brasil ATP World Tour,CLAY,2,Nicolas Massu,Juan Monaco,Nicolas Massu,2-6; 6-2; 7-5,S,164,5,3,63,108,39,63,25,45,8,10,14,64,108,0,4,49,82,32,49,20,33,3,6,14,52,82
2006-02-20 00:00:00.000,Costa Do Sauipe Brasil ATP World Tour,CLAY,2,Nicolas Massu,Alberto Martin,Nicolas Massu,6-3; 6-4,F,85,1,3,29,52,19,29,14,23,3,6,10,33,52,0,4,24,46,13,24,9,22,2,7,9,22,46
2006-02-20 00:00:00.000,Memphis TN; U.S.A. ATP World Tour,HARD,2,Andy Roddick,Mardy Fish,Andy Roddick,6-3; 6-7(5); 7-6(2),R32,135,12,1,76,110,58,76,21,34,6,6,17,79,110,18,2,52,108,43,52,31,56,6,7,16,74,108
2006-02-20 00:00:00.000,Memphis TN; U.S.A. ATP World Tour,HARD,2,Wayne Arthurs,Tomas Zib,Wayne Arthurs,6-4; 7-6(2),R32,80,29,3,45,66,41,45,9,21,1,1,11,50,66,9,4,39,83,29,39,22,44,4,5,11,51,83
2006-02-20 00:00:00.000,Memphis TN; U.S.A. ATP World Tour,HARD,2,Julien Benneteau,Jimmy Wang,Julien Benneteau,3-6; 6-3; 7-6(2),R32,124,9,5,58,100,45,58,18,42,4,7,15,63,100,2,1,66,101,45,66,19,35,5,8,15,64,101
2006-02-20 00:00:00.000,Memphis TN; U.S.A. ATP World Tour,HARD,2,Xavier Malisse,Bjorn Phau,Xavier Malisse,6-1; 6-4,R32,64,3,0,36,67,28,36,18,31,7,7,9,46,67,5,1,33,56,21,33,12,23,2,5,8,33,56
2006-02-20 00:00:00.000,Memphis TN; U.S.A. ATP World Tour,HARD,2,Dmitry Tursunov,Robby Ginepri,Dmitry Tursunov,7-5; 7-6(4),R32,67,12,0,42,77,32,42,22,35,2,3,12,54,77,10,0,46,74,34,46,17,28,3,5,12,51,74
2006-02-20 00:00:00.000,Memphis TN; U.S.A. ATP World Tour,HARD,2,Cyril Saulnier,Guillermo Garcia-Lopez,Cyril Saulnier,6-3; 6-4,R32,70,9,1,39,64,31,39,13,25,1,1,10,44,64,9,3,28,51,21,28,13,23,1,3,9,34,51
2006-02-20 00:00:00.000,Memphis TN; U.S.A. ATP World Tour,HARD,2,Vincent Spadea,Bobby Reynolds,Vincent Spadea,6-2; 5-7; 7-6(2),R32,125,7,3,53,90,41,53,16,37,4,9,16,57,90,8,9,77,129,47,77,22,52,13,19,16,69,129
2006-02-20 00:00:00.000,Memphis TN; U.S.A. ATP World Tour,HARD,2,Tommy Haas,Justin Gimelstob,Tommy Haas,2-1 RET,R32,3,0,0,6,11,5,6,3,5,0,0,2,8,11,3,0,10,12,6,10,1,2,0,0,1,7,12
2006-02-20 00:00:00.000,Memphis TN; U.S.A. ATP World Tour,HARD,2,Kristof Vliegen,James Blake,Kristof Vliegen,6-4; 6-4,R32,86,5,3,50,73,39,50,9,23,8,8,10,48,73,6,2,46,77,29,46,18,31,6,8,10,47,77
2006-02-20 00:00:00.000,Memphis TN; U.S.A. ATP World Tour,HARD,2,Paul Goldstein,Scoville Jenkins,Paul Goldstein,6-4; 6-3,R32,81,3,0,24,51,17,24,18,27,3,4,9,35,51,5,1,41,56,26,41,7,15,2,6,10,33,56
2006-02-20 00:00:00.000,Memphis TN; U.S.A. ATP World Tour,HARD,2,Ivo Karlovic,Kristian Pless,Ivo Karlovic,6-7(3); 7-6(4); 6-4,R32,117,32,4,73,106,65,73,15,33,3,3,17,80,106,1,4,70,101,55,70,21,31,5,6,17,76,101
2006-02-20 00:00:00.000,Memphis TN; U.S.A. ATP World Tour,HARD,2,Paul Capdeville,Tommy Robredo,Paul Capdeville,4-6; 7-6(3); 6-4,R32,115,4,2,70,106,49,70,20,36,5,8,16,69,106,17,3,59,87,46,59,13,28,3,6,16,59,87
2006-02-20 00:00:00.000,Memphis TN; U.S.A. ATP World Tour,HARD,2,Robin Soderling,Max Mirnyi,Robin Soderling,6-0; 6-1,R32,42,7,1,25,37,23,25,7,12,3,3,7,30,37,2,2,23,38,12,23,3,15,4,9,6,15,38
2006-02-20 00:00:00.000,Memphis TN; U.S.A. ATP World Tour,HARD,2,Kenneth Carlsen,Peter Luczak,Kenneth Carlsen,7-6(4); 6-3,R32,73,11,0,39,60,35,39,13,21,0,0,11,48,60,4,2,54,61,35,54,5,7,1,2,10,40,61
2006-02-20 00:00:00.000,Memphis TN; U.S.A. ATP World Tour,HARD,2,Andy Murray,Rainer Schuettler,Andy Murray,1-6; 7-5; 6-2,R32,111,6,2,34,66,27,34,19,32,0,3,13,46,66,3,3,47,90,32,47,20,43,5,9,14,52,90
2006-02-20 00:00:00.000,Memphis TN; U.S.A. ATP World Tour,HARD,2,Rik De Voest,Jonas Bjorkman,Rik De Voest,6-4; 6-3,R32,66,6,0,40,54,30,40,7,14,3,4,9,37,54,1,3,26,50,18,26,10,24,0,4,10,28,50
2006-02-20 00:00:00.000,Memphis TN; U.S.A. ATP World Tour,HARD,2,Andy Roddick,Wayne Arthurs,Andy Roddick,6-7(4); 7-6(9); 7-6(2),R16,133,20,2,94,126,75,94,18,32,2,3,18,93,126,33,5,75,112,63,75,23,37,1,2,18,86,112
2006-02-20 00:00:00.000,Memphis TN; U.S.A. ATP World Tour,HARD,2,Julien Benneteau,Xavier Malisse,Julien Benneteau,7-6(4); 6-4,R16,91,7,2,55,75,40,55,9,20,7,9,11,49,75,6,1,45,74,33,45,13,29,7,10,11,46,74
2006-02-20 00:00:00.000,Memphis TN; U.S.A. ATP World Tour,HARD,2,Dmitry Tursunov,Cyril Saulnier,Dmitry Tursunov,6-0; 6-7(3); 6-3,R16,102,10,1,39,77,33,39,25,38,0,0,14,58,77,7,5,43,82,35,43,16,39,7,11,13,51,82
2006-02-20 00:00:00.000,Memphis TN; U.S.A. ATP World Tour,HARD,2,Tommy Haas,Vincent Spadea,Tommy Haas,7-6(7); 6-1,R16,75,10,2,44,67,37,44,12,23,4,4,10,49,67,7,4,47,72,32,47,12,25,7,9,9,44,72
2006-02-20 00:00:00.000,Memphis TN; U.S.A. ATP World Tour,HARD,2,Kristof Vliegen,Paul Goldstein,Kristof Vliegen,6-1; 6-4,R16,76,10,2,43,62,32,43,9,19,3,3,9,41,62,3,2,29,58,20,29,13,29,8,11,8,33,58
2006-02-20 00:00:00.000,Memphis TN; U.S.A. ATP World Tour,HARD,2,Paul Capdeville,Ivo Karlovic,Paul Capdeville,7-6(1); 3-6; 7-5,R16,63,6,6,51,104,38,51,31,53,1,4,17,69,104,23,0,54,77,47,54,11,23,0,2,16,58,77
2006-02-20 00:00:00.000,Memphis TN; U.S.A. ATP World Tour,HARD,2,Robin Soderling,Kenneth Carlsen,Robin Soderling,7-6(3); 6-4,R16,85,13,1,44,60,37,44,11,16,0,1,11,48,60,17,1,64,91,46,64,10,27,9,11,11,56,91
2006-02-20 00:00:00.000,Memphis TN; U.S.A. ATP World Tour,HARD,2,Andy Murray,Rik De Voest,Andy Murray,7-6(4); 3-6; 7-5,R16,148,11,4,71,102,46,71,17,31,2,6,16,63,102,9,3,68,130,48,68,31,62,9,13,17,79,130
2006-02-20 00:00:00.000,Memphis TN; U.S.A. ATP World Tour,HARD,2,Julien Benneteau,Andy Roddick,Julien Benneteau,3-6; 6-4; 7-6(4),Q,133,18,4,77,99,56,77,13,22,7,9,15,69,99,14,3,74,104,52,74,15,30,7,9,16,67,104
2006-02-20 00:00:00.000,Memphis TN; U.S.A. ATP World Tour,HARD,2,Tommy Haas,Dmitry Tursunov,Tommy Haas,6-7(7); 6-4; 6-4,Q,117,13,3,57,102,45,57,28,45,6,7,16,73,102,14,4,56,96,44,56,22,40,4,7,16,66,96
2006-02-20 00:00:00.000,Memphis TN; U.S.A. ATP World Tour,HARD,2,Kristof Vliegen,Paul Capdeville,Kristof Vliegen,3-6; 7-6(5); 6-4,Q,132,8,2,60,102,44,60,26,42,5,6,15,70,102,3,1,65,101,45,65,23,36,2,3,16,68,101
2006-02-20 00:00:00.000,Memphis TN; U.S.A. ATP World Tour,HARD,2,Robin Soderling,Andy Murray,Robin Soderling,6-1; 6-4,Q,68,8,4,32,54,25,32,11,22,2,3,9,36,54,3,1,26,60,16,26,13,34,7,11,8,29,60
2006-02-20 00:00:00.000,Memphis TN; U.S.A. ATP World Tour,HARD,2,Tommy Haas,Julien Benneteau,Tommy Haas,6-3; 6-1,S,55,7,1,29,38,27,29,5,9,0,0,8,32,38,6,1,31,51,18,31,7,20,6,10,8,25,51
2006-02-20 00:00:00.000,Memphis TN; U.S.A. ATP World Tour,HARD,2,Robin Soderling,Kristof Vliegen,Robin Soderling,7-5; 2-6; 7-6(5),S,140,5,9,67,121,50,67,27,54,10,12,16,77,121,10,4,83,118,60,83,16,35,7,8,16,76,118
2006-02-20 00:00:00.000,Memphis TN; U.S.A. ATP World Tour,HARD,2,Tommy Haas,Robin Soderling,Tommy Haas,6-3; 6-2,F,61,8,3,36,58,27,36,13,22,4,4,9,40,58,5,1,29,41,19,29,6,12,2,5,8,25,41
2006-02-20 00:00:00.000,Rotterdam The Netherlands ATP World Tour,HARD,2,Arvind Parmar,Paradorn Srichaphan,Arvind Parmar,7-6(3); 5-7; 7-6(7),R32,145,14,3,61,122,54,61,34,61,5,6,18,88,122,11,5,66,110,52,66,31,44,3,3,18,83,110
2006-02-20 00:00:00.000,Rotterdam The Netherlands ATP World Tour,HARD,2,Dominik Meffert,Raemon Sluiter,Dominik Meffert,2-4 RET,R32,34,4,2,16,28,12,16,3,12,4,5,3,15,28,1,0,11,15,9,11,3,4,0,0,3,12,15
2006-02-20 00:00:00.000,Rotterdam The Netherlands ATP World Tour,HARD,2,Christophe Rochus,Jean-Rene Lisnard,Christophe Rochus,3-6; 7-6(3); 6-4,R32,128,4,1,56,93,37,56,22,37,3,7,15,59,93,5,8,56,113,42,56,27,57,14,18,16,69,113
2006-02-20 00:00:00.000,Rotterdam The Netherlands ATP World Tour,HARD,2,Taylor Dent,Tomas Berdych,Taylor Dent,6-4; 7-5,R32,77,8,2,41,60,36,41,9,19,1,1,11,45,60,6,1,38,60,29,38,13,22,2,4,11,42,60
2006-02-20 00:00:00.000,Rotterdam The Netherlands ATP World Tour,HARD,2,David Ferrer,Ivo Minar,David Ferrer,6-2; 6-3,R32,76,1,2,52,86,33,52,20,34,9,9,9,53,86,1,3,26,49,20,26,8,23,4,7,8,28,49
2006-02-20 00:00:00.000,Rotterdam The Netherlands ATP World Tour,HARD,2,Olivier Rochus,Jurgen Melzer,Olivier Rochus,7-6(3); 4-6; 7-6(9),R32,157,0,1,84,126,51,84,24,42,11,16,17,75,126,11,5,76,134,52,76,29,58,8,12,17,81,134
2006-02-20 00:00:00.000,Rotterdam The Netherlands ATP World Tour,HARD,2,Gilles Simon,Wesley Moodie,Gilles Simon,6-3; 6-7(4); 6-3,R32,115,5,1,60,104,44,60,24,44,3,4,16,68,104,9,3,51,78,37,51,18,27,2,5,14,55,78
2006-02-20 00:00:00.000,Rotterdam The Netherlands ATP World Tour,HARD,2,Jarkko Nieminen,Mario Ancic,Jarkko Nieminen,7-5; 7-6(5),R32,86,4,1,48,73,37,48,17,25,0,0,12,54,73,12,3,54,71,42,54,8,17,1,2,12,50,71
2006-02-20 00:00:00.000,Rotterdam The Netherlands ATP World Tour,HARD,2,Radek Stepanek,Michael Lammer,Radek Stepanek,6-4; 6-2,R32,69,11,1,46,56,30,46,5,10,3,5,9,35,56,3,2,43,59,21,43,8,16,4,9,9,29,59
2006-02-20 00:00:00.000,Rotterdam The Netherlands ATP World Tour,HARD,2,Fabrice Santoro,Paul-Henri Mathieu,Fabrice Santoro,6-3; 6-3,R32,79,9,3,35,58,26,35,10,23,4,6,9,36,58,1,1,25,54,13,25,13,29,1,6,9,26,54
2006-02-20 00:00:00.000,Rotterdam The Netherlands ATP World Tour,HARD,2,Novak Djokovic,Andreas Seppi,Novak Djokovic,6-2; 2-6; 7-5,R32,111,5,2,45,83,30,45,18,38,1,6,14,48,83,7,5,39,85,29,39,19,46,4,10,14,48,85
2006-02-20 00:00:00.000,Rotterdam The Netherlands ATP World Tour,HARD,2,Tim Henman,Thomas Johansson,Tim Henman,6-4; 6-4,R32,87,3,1,47,61,34,47,8,14,0,1,10,42,61,6,2,31,66,22,31,18,35,4,7,10,40,66
2006-02-20 00:00:00.000,Rotterdam The Netherlands ATP World Tour,HARD,2,Daniele Bracciali,Igor Andreev,Daniele Bracciali,6-2; 6-3,R32,61,6,2,24,49,21,24,16,25,2,2,9,37,49,3,0,20,42,12,20,12,22,1,4,8,24,42
2006-02-20 00:00:00.000,Rotterdam The Netherlands ATP World Tour,HARD,2,Alex Calatrava,Antal Van Der Duim,Alex Calatrava,6-2; 7-6(2),R32,84,8,1,48,64,38,48,7,16,2,3,10,45,64,5,6,47,72,29,47,11,25,6,9,10,40,72
2006-02-20 00:00:00.000,Rotterdam The Netherlands ATP World Tour,HARD,2,Greg Rusedski,Robin Vik,Greg Rusedski,6-3; 7-5,R32,74,9,2,39,60,31,39,12,21,2,3,11,43,60,4,2,26,54,18,26,14,28,2,5,10,32,54
2006-02-20 00:00:00.000,Rotterdam The Netherlands ATP World Tour,HARD,2,Nikolay Davydenko,Jan Hernych,Nikolay Davydenko,6-3; 6-3,R32,87,4,2,47,69,31,47,14,22,9,10,9,45,69,1,0,46,60,27,46,5,14,5,9,9,32,60
2006-02-20 00:00:00.000,Rotterdam The Netherlands ATP World Tour,HARD,2,Arvind Parmar,Dominik Meffert,Arvind Parmar,6-3; 6-3,R16,66,2,2,24,48,21,24,17,24,1,1,9,38,48,1,4,33,51,25,33,5,18,3,6,9,30,51
2006-02-20 00:00:00.000,Rotterdam The Netherlands ATP World Tour,HARD,2,Christophe Rochus,Taylor Dent,Christophe Rochus,7-6(0) RET,R16,47,0,1,30,47,19,30,9,17,3,5,6,28,47,5,2,31,41,18,31,3,10,3,5,6,21,41
2006-02-20 00:00:00.000,Rotterdam The Netherlands ATP World Tour,HARD,2,Olivier Rochus,David Ferrer,Olivier Rochus,6-4; 6-4,R16,100,0,1,27,55,17,27,17,28,2,5,10,34,55,8,4,56,78,32,56,8,22,2,7,10,40,78
2006-02-20 00:00:00.000,Rotterdam The Netherlands ATP World Tour,HARD,2,Jarkko Nieminen,Gilles Simon,Jarkko Nieminen,7-6(1); 6-1,R16,70,2,2,50,63,36,50,8,13,2,3,10,44,63,1,0,31,56,20,31,13,25,1,4,9,33,56
2006-02-20 00:00:00.000,Rotterdam The Netherlands ATP World Tour,HARD,2,Radek Stepanek,Fabrice Santoro,Radek Stepanek,6-4; 6-1,R16,56,12,1,33,46,27,33,8,13,3,3,8,35,46,1,1,37,53,21,37,7,16,0,4,9,28,53
2006-02-20 00:00:00.000,Rotterdam The Netherlands ATP World Tour,HARD,2,Novak Djokovic,Tim Henman,Novak Djokovic,5-7; 6-3; 6-4,R16,160,5,4,76,123,55,76,24,47,8,9,16,79,123,2,2,70,101,48,70,17,31,11,13,15,65,101
2006-02-20 00:00:00.000,Rotterdam The Netherlands ATP World Tour,HARD,2,Daniele Bracciali,Alex Calatrava,Daniele Bracciali,4-6; 6-2; 7-6(5),R16,138,19,5,46,99,41,46,28,53,3,4,15,69,99,8,1,56,97,38,56,27,41,3,5,15,65,97
2006-02-20 00:00:00.000,Rotterdam The Netherlands ATP World Tour,HARD,2,Nikolay Davydenko,Greg Rusedski,Nikolay Davydenko,6-4; 6-1,R16,54,4,1,31,37,26,31,4,6,0,1,8,30,37,4,4,30,52,17,30,8,22,0,5,9,25,52
2006-02-20 00:00:00.000,Rotterdam The Netherlands ATP World Tour,HARD,2,Christophe Rochus,Arvind Parmar,Christophe Rochus,6-3; 6-3,Q,69,4,1,35,49,28,35,7,14,1,2,9,35,49,1,4,37,57,22,37,7,20,4,8,9,29,57
2006-02-20 00:00:00.000,Rotterdam The Netherlands ATP World Tour,HARD,2,Jarkko Nieminen,Olivier Rochus,Jarkko Nieminen,6-7(4); 6-4; 7-6(3),Q,126,7,5,77,132,55,77,24,55,15,20,17,79,132,3,4,89,122,52,89,17,33,9,15,17,69,122
2006-02-20 00:00:00.000,Rotterdam The Netherlands ATP World Tour,HARD,2,Radek Stepanek,Novak Djokovic,Radek Stepanek,7-5; 4-6; 7-6(2),Q,140,20,6,64,95,51,64,17,31,3,5,17,68,95,3,3,74,107,51,74,20,33,2,4,17,71,107
2006-02-20 00:00:00.000,Rotterdam The Netherlands ATP World Tour,HARD,2,Nikolay Davydenko,Daniele Bracciali,Nikolay Davydenko,6-4; 6-2,Q,73,4,1,32,51,26,32,10,19,2,3,9,36,51,8,4,29,59,21,29,10,30,3,7,9,31,59
2006-02-20 00:00:00.000,Rotterdam The Netherlands ATP World Tour,HARD,2,Christophe Rochus,Jarkko Nieminen,Christophe Rochus,6-4; 6-3,S,67,4,0,40,51,31,40,8,11,0,1,10,39,51,7,1,49,70,31,49,8,21,7,10,9,39,70
2006-02-20 00:00:00.000,Rotterdam The Netherlands ATP World Tour,HARD,2,Radek Stepanek,Nikolay Davydenko,Radek Stepanek,4-6; 6-3; 6-3,S,114,16,4,62,92,46,62,13,30,4,6,14,59,92,3,2,49,83,35,49,15,34,2,6,14,50,83
2006-02-20 00:00:00.000,Rotterdam The Netherlands ATP World Tour,HARD,2,Radek Stepanek,Christophe Rochus,Radek Stepanek,6-0; 6-3,F,46,17,0,26,39,25,26,8,13,0,0,8,33,39,0,3,21,39,13,21,6,18,2,6,7,19,39
2006-02-27 00:00:00.000,Acapulco Mexico ATP World Tour,CLAY,2,Alessio Di Mauro,Guillermo Coria,Alessio Di Mauro,6-2; 6-4,R32,83,3,1,31,59,25,31,11,28,5,7,9,36,59,1,16,24,62,19,24,11,38,1,6,9,30,62
2006-02-27 00:00:00.000,Acapulco Mexico ATP World Tour,CLAY,2,Boris Pashanski,Ivo Minar,Boris Pashanski,2-6; 6-3; 7-5,R32,108,11,4,49,74,36,49,16,25,3,5,14,52,74,10,7,45,90,36,45,24,45,3,6,15,60,90
2006-02-27 00:00:00.000,Acapulco Mexico ATP World Tour,CLAY,2,Tomas Behrend,Jiri Vanek,Tomas Behrend,7-6(4); 5-7; 6-3,R32,138,4,4,50,99,37,50,28,49,2,6,17,65,99,5,7,63,99,48,63,15,36,6,10,16,63,99
2006-02-27 00:00:00.000,Acapulco Mexico ATP World Tour,CLAY,2,Juan Ignacio Chela,Juan Monaco,Juan Ignacio Chela,4-6; 7-6(4); 3-0 RET,R32,124,5,5,52,78,40,52,13,26,1,3,13,53,78,3,1,47,77,33,47,17,30,1,3,12,50,77
2006-02-27 00:00:00.000,Acapulco Mexico ATP World Tour,CLAY,2,Carlos Moya,Miguel Gallardo-Valles,Carlos Moya,3-6; 6-4; 7-5,R32,105,12,5,73,108,54,73,15,35,5,8,16,69,108,4,1,56,84,38,56,16,28,3,6,15,54,84
2006-02-27 00:00:00.000,Acapulco Mexico ATP World Tour,CLAY,2,Albert Montanes,Juan Martin Del Potro,Albert Montanes,6-2; 5-3 RET,R32,67,1,1,25,40,21,25,12,15,1,1,8,33,40,0,2,46,57,24,46,5,11,5,8,8,29,57
2006-02-27 00:00:00.000,Acapulco Mexico ATP World Tour,CLAY,2,Nicolas Almagro,Fernando Vicente,Nicolas Almagro,6-3; 4-6; 6-4,R32,123,6,2,63,88,40,63,16,25,3,7,15,56,88,1,2,59,93,34,59,18,34,8,13,14,52,93
2006-02-27 00:00:00.000,Acapulco Mexico ATP World Tour,CLAY,2,Jose Acasuso,Santiago Gonzalez,Jose Acasuso,6-2; 6-1,R32,62,0,1,19,39,14,19,15,20,0,0,7,29,39,1,6,31,55,23,31,3,24,5,10,8,26,55
2006-02-27 00:00:00.000,Acapulco Mexico ATP World Tour,CLAY,2,Juan Antonio Marin,Florent Serra,Juan Antonio Marin,6-4; 6-7(4); 6-4,R32,166,5,1,65,108,48,65,19,43,5,8,16,67,108,10,3,77,122,51,77,21,45,12,17,16,72,122
2006-02-27 00:00:00.000,Acapulco Mexico ATP World Tour,CLAY,2,Luis Horna,Lukas Dlouhy,Luis Horna,6-4; 6-4,R32,81,4,1,40,57,32,40,7,17,1,2,10,39,57,6,4,43,67,29,43,11,24,5,8,10,40,67
2006-02-27 00:00:00.000,Acapulco Mexico ATP World Tour,CLAY,2,Agustin Calleri,Nicolas Lapentti,Agustin Calleri,6-3; 6-3,R32,86,6,2,23,50,20,23,16,27,4,5,9,36,50,4,1,37,64,24,37,10,27,10,14,9,34,64
2006-02-27 00:00:00.000,Acapulco Mexico ATP World Tour,CLAY,2,Alberto Martin,Filippo Volandri,Alberto Martin,6-0; 2-6; 6-2,R32,94,4,4,41,80,27,41,20,39,6,9,11,47,80,0,1,55,70,28,55,5,15,5,11,11,33,70
2006-02-27 00:00:00.000,Acapulco Mexico ATP World Tour,CLAY,2,Nicolas Massu,Carlos Berlocq,Nicolas Massu,6-2; 7-5,R32,123,3,2,38,64,26,38,14,26,2,4,10,40,64,5,3,44,76,25,44,13,32,9,14,10,38,76
2006-02-27 00:00:00.000,Acapulco Mexico ATP World Tour,CLAY,2,Marcos Daniel,Kevin Kim,Marcos Daniel,7-5; 6-3,R32,80,4,1,40,54,25,40,9,14,1,3,10,34,54,2,7,36,70,25,36,12,34,4,9,11,37,70
2006-02-27 00:00:00.000,Acapulco Mexico ATP World Tour,CLAY,2,Razvan Sabau,Potito Starace,Razvan Sabau,0-6; 7-5; 6-3,R32,113,2,6,59,98,35,59,18,39,9,14,14,53,98,10,1,50,72,35,50,10,22,1,5,13,45,72
2006-02-27 00:00:00.000,Acapulco Mexico ATP World Tour,CLAY,2,Gaston Gaudio,Albert Portas,Gaston Gaudio,7-5; 6-2,R32,89,2,1,40,60,31,40,11,20,1,1,10,42,60,5,2,29,62,21,29,18,33,6,9,10,39,62
2006-02-27 00:00:00.000,Acapulco Mexico ATP World Tour,CLAY,2,Alessio Di Mauro,Boris Pashanski,Alessio Di Mauro,1-6; 6-3; 6-4,R16,119,14,0,45,75,32,45,12,30,2,6,13,44,75,2,1,50,84,29,50,19,34,3,7,13,48,84
2006-02-27 00:00:00.000,Acapulco Mexico ATP World Tour,CLAY,2,Juan Ignacio Chela,Tomas Behrend,Juan Ignacio Chela,6-1; 2-6; 6-2,R16,112,7,2,52,89,39,52,16,37,11,13,12,55,89,6,3,41,72,28,41,11,31,6,10,11,39,72
2006-02-27 00:00:00.000,Acapulco Mexico ATP World Tour,CLAY,2,Albert Montanes,Carlos Moya,Albert Montanes,2-6; 7-6(5); 6-4,R16,139,7,2,75,113,51,75,15,38,10,13,15,66,113,5,2,55,91,43,55,18,36,4,6,15,61,91
2006-02-27 00:00:00.000,Acapulco Mexico ATP World Tour,CLAY,2,Nicolas Almagro,Jose Acasuso,Nicolas Almagro,6-3 RET,R16,36,2,0,13,23,11,13,9,10,0,0,5,20,23,1,1,16,28,11,16,6,12,1,2,4,17,28
2006-02-27 00:00:00.000,Acapulco Mexico ATP World Tour,CLAY,2,Luis Horna,Juan Antonio Marin,Luis Horna,6-3; 7-6(4),R16,131,13,1,55,82,39,55,15,27,6,8,11,54,82,1,0,48,71,32,48,8,23,1,4,10,40,71
2006-02-27 00:00:00.000,Acapulco Mexico ATP World Tour,CLAY,2,Agustin Calleri,Alberto Martin,Agustin Calleri,6-3; 6-2,R16,70,7,3,38,60,32,38,10,22,3,3,9,42,60,2,3,24,50,18,24,9,26,4,7,8,27,50
2006-02-27 00:00:00.000,Acapulco Mexico ATP World Tour,CLAY,2,Marcos Daniel,Nicolas Massu,Marcos Daniel,6-4; 6-4,R16,98,5,0,44,56,32,44,3,12,0,2,10,35,56,2,3,32,64,19,32,14,32,0,4,10,33,64
2006-02-27 00:00:00.000,Acapulco Mexico ATP World Tour,CLAY,2,Gaston Gaudio,Razvan Sabau,Gaston Gaudio,6-3; 3-6; 6-2,R16,119,7,3,59,84,44,59,12,25,2,3,13,56,84,0,3,59,89,39,59,13,30,6,9,13,52,89
2006-02-27 00:00:00.000,Acapulco Mexico ATP World Tour,CLAY,2,Juan Ignacio Chela,Alessio Di Mauro,Juan Ignacio Chela,7-5; 6-2,Q,100,2,3,35,58,25,35,12,23,1,3,10,37,58,4,4,48,66,26,48,6,18,2,7,10,32,66
2006-02-27 00:00:00.000,Acapulco Mexico ATP World Tour,CLAY,2,Nicolas Almagro,Albert Montanes,Nicolas Almagro,6-4; 6-0,Q,64,7,0,27,46,19,27,13,19,2,3,8,32,46,1,4,40,53,20,40,5,13,3,8,8,25,53
2006-02-27 00:00:00.000,Acapulco Mexico ATP World Tour,CLAY,2,Luis Horna,Agustin Calleri,Luis Horna,6-3; 6-4,Q,82,3,1,37,53,29,37,11,16,0,0,10,40,53,8,0,46,74,34,46,10,28,9,11,9,44,74
2006-02-27 00:00:00.000,Acapulco Mexico ATP World Tour,CLAY,2,Gaston Gaudio,Marcos Daniel,Gaston Gaudio,6-4; 2-6; 6-3,Q,134,3,8,58,94,41,58,15,36,8,12,14,56,94,5,1,62,84,40,62,9,22,6,10,13,49,84
2006-02-27 00:00:00.000,Acapulco Mexico ATP World Tour,CLAY,2,Juan Ignacio Chela,Nicolas Almagro,Juan Ignacio Chela,6-2; 6-2,S,81,1,2,42,70,28,42,16,28,5,5,8,44,70,4,0,27,48,15,27,8,21,4,8,8,23,48
2006-02-27 00:00:00.000,Acapulco Mexico ATP World Tour,CLAY,2,Luis Horna,Gaston Gaudio,Luis Horna,4-6; 6-4; 6-3,S,156,9,1,68,101,51,68,14,33,8,10,14,65,101,2,7,68,96,47,68,12,28,5,9,15,59,96
2006-02-27 00:00:00.000,Acapulco Mexico ATP World Tour,CLAY,2,Luis Horna,Juan Ignacio Chela,Luis Horna,7-6(5); 6-4,F,122,7,1,51,82,33,51,19,31,4,6,11,52,82,6,2,49,70,36,49,9,21,4,7,11,45,70
2006-02-27 00:00:00.000,Dubai U.A.E. ATP World Tour,HARD,2,Roger Federer,Stanislas Wawrinka,Roger Federer,7-6(3); 6-3,R32,81,3,0,46,71,33,46,13,25,4,7,11,46,71,2,2,27,62,16,27,20,35,3,7,10,36,62
2006-02-27 00:00:00.000,Dubai U.A.E. ATP World Tour,HARD,2,Mohammad Ghareeb,Omar Awadhy,Mohammad Ghareeb,7-6(4); 6-2,R32,84,11,5,43,66,26,43,9,23,3,8,10,35,66,0,6,40,67,23,40,8,27,3,10,10,31,67
2006-02-27 00:00:00.000,Dubai U.A.E. ATP World Tour,HARD,2,Robin Vik,Janko Tipsarevic,Robin Vik,6-2; 6-4,R32,67,2,6,37,60,31,37,11,23,6,6,9,42,60,4,1,31,45,23,31,5,14,1,4,9,28,45
2006-02-27 00:00:00.000,Dubai U.A.E. ATP World Tour,HARD,2,Tomas Berdych,Christophe Rochus,Tomas Berdych,6-4; 6-2,R32,56,13,0,26,44,23,26,10,18,0,1,9,33,44,2,2,35,52,20,35,7,17,2,6,9,27,52
2006-02-27 00:00:00.000,Dubai U.A.E. ATP World Tour,HARD,2,Marat Safin,Nikolay Davydenko,Marat Safin,4-6; 6-2; 6-2,R32,105,10,2,36,69,31,36,20,33,3,4,13,51,69,3,0,44,80,27,44,20,36,6,10,13,47,80
2006-02-27 00:00:00.000,Dubai U.A.E. ATP World Tour,HARD,2,Olivier Rochus,Fabrice Santoro,Olivier Rochus,6-4; 6-1,R32,74,0,2,25,40,18,25,11,15,0,1,8,29,40,4,0,45,72,26,45,9,27,11,16,9,35,72
2006-02-27 00:00:00.000,Dubai U.A.E. ATP World Tour,HARD,2,Igor Andreev,Andreas Seppi,Igor Andreev,7-6(5); 1-6; 6-4,R32,198,5,4,53,94,37,53,18,41,2,7,14,55,94,3,5,54,103,34,54,29,49,5,9,15,63,103
2006-02-27 00:00:00.000,Dubai U.A.E. ATP World Tour,HARD,2,Mikhail Youzhny,Dominik Hrbaty,Mikhail Youzhny,7-5; 1-6; 6-4,R32,123,2,1,55,94,31,55,19,39,3,9,14,50,94,4,8,52,100,32,52,24,48,5,11,15,56,100
2006-02-27 00:00:00.000,Dubai U.A.E. ATP World Tour,HARD,2,Rainer Schuettler,David Ferrer,Rainer Schuettler,6-2; 3-6; 7-5,R32,136,4,4,58,118,36,58,31,60,9,13,15,67,118,0,2,46,77,33,46,12,31,2,7,14,45,77
2006-02-27 00:00:00.000,Dubai U.A.E. ATP World Tour,HARD,2,Ivo Klec,Daniele Bracciali,Ivo Klec,6-4; 6-4,R32,85,6,2,38,62,28,38,15,24,6,7,10,43,62,1,3,37,79,23,37,20,42,8,11,10,43,79
2006-02-27 00:00:00.000,Dubai U.A.E. ATP World Tour,HARD,2,Bjorn Phau,Giorgio Galimberti,Bjorn Phau,5-7; 6-3; 6-2,R32,136,4,5,49,95,35,49,21,46,4,8,15,56,95,1,10,76,128,46,76,20,52,14,20,14,66,128
2006-02-27 00:00:00.000,Dubai U.A.E. ATP World Tour,HARD,2,Andre Agassi,Greg Rusedski,Andre Agassi,7-6(4); 6-0,R32,75,6,2,38,56,30,38,13,18,1,1,9,43,56,11,6,50,79,38,50,8,29,6,9,9,46,79
2006-02-27 00:00:00.000,Dubai U.A.E. ATP World Tour,HARD,2,Radek Stepanek,John van Lottum,Radek Stepanek,6-3; 7-6(6),R32,93,8,1,40,62,30,40,13,22,3,4,10,43,62,4,2,39,76,25,39,20,37,6,9,11,45,76
2006-02-27 00:00:00.000,Dubai U.A.E. ATP World Tour,HARD,2,Tim Henman,Feliciano Lopez,Tim Henman,6-2; 7-6(6),R32,84,2,2,40,60,32,40,12,20,2,3,10,44,60,6,4,48,80,32,48,14,32,4,7,10,46,80
2006-02-27 00:00:00.000,Dubai U.A.E. ATP World Tour,HARD,2,Younes El Aynaoui,Wesley Moodie,Younes El Aynaoui,6-4; 6-4,R32,78,8,0,32,51,27,32,14,19,2,2,10,41,51,6,4,44,70,30,44,12,26,7,9,10,42,70
2006-02-27 00:00:00.000,Dubai U.A.E. ATP World Tour,HARD,2,Rafael Nadal,Paul-Henri Mathieu,Rafael Nadal,6-7(5); 6-1; 6-2,R32,153,9,3,62,100,47,62,20,38,7,7,14,67,100,2,3,44,82,32,44,17,38,2,6,13,49,82
2006-02-27 00:00:00.000,Dubai U.A.E. ATP World Tour,HARD,2,Roger Federer,Mohammad Ghareeb,Roger Federer,7-6(5); 6-4,R16,88,7,0,45,67,36,45,11,22,0,1,11,47,67,6,4,44,89,34,44,20,45,14,16,11,54,89
2006-02-27 00:00:00.000,Dubai U.A.E. ATP World Tour,HARD,2,Robin Vik,Tomas Berdych,Robin Vik,3-6; 7-6(5); 6-2,R16,125,5,6,62,100,42,62,18,38,4,7,14,60,100,7,4,44,94,33,44,22,50,3,7,15,55,94
2006-02-27 00:00:00.000,Dubai U.A.E. ATP World Tour,HARD,2,Olivier Rochus,Marat Safin,Olivier Rochus,7-6(5); 6-4,R16,88,0,4,47,72,37,47,10,25,1,4,11,47,72,13,1,34,58,24,34,13,24,1,5,11,37,58
2006-02-27 00:00:00.000,Dubai U.A.E. ATP World Tour,HARD,2,Mikhail Youzhny,Igor Andreev,Mikhail Youzhny,6-1; 7-6(4),R16,82,3,1,45,78,30,45,22,33,5,6,10,52,78,5,3,23,49,19,23,11,26,0,3,9,30,49
2006-02-27 00:00:00.000,Dubai U.A.E. ATP World Tour,HARD,2,Rainer Schuettler,Ivo Klec,Rainer Schuettler,7-5; 6-4,R16,88,3,1,30,53,24,30,14,23,1,3,11,38,53,1,3,41,76,30,41,13,35,4,8,11,43,76
2006-02-27 00:00:00.000,Dubai U.A.E. ATP World Tour,HARD,2,Bjorn Phau,Andre Agassi,Bjorn Phau,7-5; 7-5,R16,81,7,1,50,79,37,50,14,29,8,10,12,51,79,4,3,53,79,27,53,18,26,6,10,12,45,79
2006-02-27 00:00:00.000,Dubai U.A.E. ATP World Tour,HARD,2,Tim Henman,Radek Stepanek,Tim Henman,7-5; 2-6; 7-6(3),R16,128,2,0,65,102,46,65,17,37,5,9,16,63,102,6,2,50,87,35,50,23,37,1,4,16,58,87
2006-02-27 00:00:00.000,Dubai U.A.E. ATP World Tour,HARD,2,Rafael Nadal,Younes El Aynaoui,Rafael Nadal,W/O,R16,0,0,0,0,0,0,0,0,0,0,0,0,0,0,0,0,0,0,0,0,0,0,0,0,0,0,0
2006-02-27 00:00:00.000,Dubai U.A.E. ATP World Tour,HARD,2,Roger Federer,Robin Vik,Roger Federer,6-3; 6-2,Q,58,8,1,40,56,31,40,8,16,5,6,9,39,56,2,2,27,44,18,27,6,17,2,6,8,24,44
2006-02-27 00:00:00.000,Dubai U.A.E. ATP World Tour,HARD,2,Mikhail Youzhny,Olivier Rochus,Mikhail Youzhny,6-3; 6-1,Q,68,4,4,28,57,19,28,15,29,7,9,8,34,57,1,2,27,51,12,27,9,24,4,10,8,21,51
2006-02-27 00:00:00.000,Dubai U.A.E. ATP World Tour,HARD,2,Rainer Schuettler,Bjorn Phau,Rainer Schuettler,6-4; 6-1,Q,68,1,0,20,44,18,20,19,24,0,0,9,37,44,1,4,30,53,18,30,12,23,3,6,8,30,53
2006-02-27 00:00:00.000,Dubai U.A.E. ATP World Tour,HARD,2,Rafael Nadal,Tim Henman,Rafael Nadal,7-6(1); 6-1,Q,87,8,1,52,64,39,52,7,12,8,9,10,46,64,4,4,32,55,22,32,10,23,4,7,9,32,55
2006-02-27 00:00:00.000,Dubai U.A.E. ATP World Tour,HARD,2,Roger Federer,Mikhail Youzhny,Roger Federer,6-2; 6-3,S,66,3,0,31,58,23,31,17,27,8,8,9,40,58,4,2,23,54,14,23,18,31,2,5,8,32,54
2006-02-27 00:00:00.000,Dubai U.A.E. ATP World Tour,HARD,2,Rafael Nadal,Rainer Schuettler,Rafael Nadal,6-4; 6-2,S,89,6,3,37,53,29,37,6,16,2,3,9,35,53,2,3,37,61,22,37,11,24,5,9,9,33,61
2006-02-27 00:00:00.000,Dubai U.A.E. ATP World Tour,HARD,2,Rafael Nadal,Roger Federer,Rafael Nadal,2-6; 6-4; 6-4,F,113,1,1,56,80,38,56,13,24,0,3,14,51,80,9,0,41,69,33,41,16,28,2,5,14,49,69
2006-02-27 00:00:00.000,Las Vegas NV; U.S.A. ATP World Tour,HARD,2,Lleyton Hewitt,Florian Mayer,Lleyton Hewitt,5-7; 6-2; 6-4,R32,111,5,3,47,83,35,47,22,36,2,5,15,57,83,5,3,52,97,33,52,20,45,5,10,15,53,97
2006-02-27 00:00:00.000,Las Vegas NV; U.S.A. ATP World Tour,HARD,2,Jan Hernych,Kristian Pless,Jan Hernych,6-3; 6-3,R32,53,1,2,26,46,20,26,12,20,0,1,9,32,46,2,10,31,53,20,31,7,22,3,7,9,27,53
2006-02-27 00:00:00.000,Las Vegas NV; U.S.A. ATP World Tour,HARD,2,Julien Benneteau,Robin Soderling,Julien Benneteau,6-4; 7-6(0),R32,91,2,2,48,68,26,48,16,20,3,6,11,42,68,1,3,45,62,27,45,8,17,2,6,11,35,62
2006-02-27 00:00:00.000,Las Vegas NV; U.S.A. ATP World Tour,HARD,2,Philipp Kohlschreiber,Fernando Verdasco,Philipp Kohlschreiber,6-7(4); 7-5; 6-2,R32,69,7,1,48,87,41,48,22,39,0,1,16,63,87,2,3,64,84,46,64,11,20,1,5,16,57,84
2006-02-27 00:00:00.000,Las Vegas NV; U.S.A. ATP World Tour,HARD,2,Paul Goldstein,Robby Ginepri,Paul Goldstein,6-7(4); 6-3; 6-1,R32,68,1,4,56,100,34,56,23,44,12,15,14,57,100,10,6,53,81,31,53,11,28,3,10,14,42,81
2006-02-27 00:00:00.000,Las Vegas NV; U.S.A. ATP World Tour,HARD,2,Vincent Spadea,Paul Capdeville,Vincent Spadea,6-3; 6-2,R32,64,2,3,34,59,23,34,16,25,3,4,9,39,59,1,2,26,47,15,26,8,21,2,6,8,23,47
2006-02-27 00:00:00.000,Las Vegas NV; U.S.A. ATP World Tour,HARD,2,Xavier Malisse,Max Mirnyi,Xavier Malisse,6-4; 4-6; 6-4,R32,111,9,2,57,93,41,57,18,36,5,8,15,59,93,8,2,56,97,40,56,20,41,6,10,15,60,97
2006-02-27 00:00:00.000,Las Vegas NV; U.S.A. ATP World Tour,HARD,2,Peter Luczak,Dmitry Tursunov,Peter Luczak,6-4; 7-6(7),R32,67,3,1,70,99,42,70,13,29,8,12,11,55,99,11,6,50,81,31,50,11,31,4,9,11,42,81
2006-02-27 00:00:00.000,Las Vegas NV; U.S.A. ATP World Tour,HARD,2,Jonas Bjorkman,Gael Monfils,Jonas Bjorkman,7-6(8); 6-3,R32,112,3,4,45,85,34,45,15,40,1,4,11,49,85,7,8,36,75,22,36,18,39,1,5,10,40,75
2006-02-27 00:00:00.000,Las Vegas NV; U.S.A. ATP World Tour,HARD,2,Ivo Karlovic,Davide Sanguinetti,Ivo Karlovic,6-2; 6-4,R32,63,1,5,34,53,26,34,9,19,3,4,9,35,53,0,1,33,53,18,33,10,20,1,5,9,28,53
2006-02-27 00:00:00.000,Las Vegas NV; U.S.A. ATP World Tour,HARD,2,Mardy Fish,Prakash Amritraj,Mardy Fish,6-4; 7-6(4),R32,101,10,5,53,84,35,53,20,31,6,7,11,55,84,1,4,47,78,29,47,19,31,7,9,11,48,78
2006-02-27 00:00:00.000,Las Vegas NV; U.S.A. ATP World Tour,HARD,2,Tommy Robredo,Andy Murray,Tommy Robredo,6-2; 6-2,R32,54,2,1,26,43,20,26,13,17,0,0,8,33,43,0,4,27,45,17,27,6,18,3,7,8,23,45
2006-02-27 00:00:00.000,Las Vegas NV; U.S.A. ATP World Tour,HARD,2,James Blake,Paradorn Srichaphan,James Blake,7-6(3); 6-0,R32,82,3,6,53,85,36,53,16,32,8,9,9,52,85,1,6,35,66,19,35,15,31,4,8,9,34,66
2006-02-27 00:00:00.000,Las Vegas NV; U.S.A. ATP World Tour,HARD,2,Brian Vahaly,Sam Querrey,Brian Vahaly,3-6; 7-6(3); 6-3,R32,109,1,2,64,92,44,64,21,28,1,2,14,65,92,12,2,55,93,43,55,22,38,4,6,16,65,93
2006-02-27 00:00:00.000,Las Vegas NV; U.S.A. ATP World Tour,HARD,2,Kenneth Carlsen,Tomas Zib,Kenneth Carlsen,6-4; 6-3,R32,69,11,4,28,47,23,28,10,19,1,2,9,33,47,3,1,35,64,21,35,12,29,4,8,10,33,64
2006-02-27 00:00:00.000,Las Vegas NV; U.S.A. ATP World Tour,HARD,2,Nicolas Kiefer,Sargis Sargsian,Nicolas Kiefer,6-3; 6-2,R32,88,4,2,36,59,30,36,12,23,2,2,9,42,59,0,6,33,54,18,33,11,21,4,7,8,29,54
2006-02-27 00:00:00.000,Las Vegas NV; U.S.A. ATP World Tour,HARD,2,Lleyton Hewitt,Jan Hernych,Lleyton Hewitt,6-3; 6-3,R16,71,1,1,30,51,22,30,15,21,0,0,9,37,51,2,3,33,63,21,33,14,30,4,7,9,35,63
2006-02-27 00:00:00.000,Las Vegas NV; U.S.A. ATP World Tour,HARD,2,Philipp Kohlschreiber,Julien Benneteau,Philipp Kohlschreiber,6-3; 6-2,R16,67,4,0,31,43,26,31,8,12,1,1,8,34,43,0,2,34,58,23,34,7,24,6,10,9,30,58
2006-02-27 00:00:00.000,Las Vegas NV; U.S.A. ATP World Tour,HARD,2,Paul Goldstein,Vincent Spadea,Paul Goldstein,6-2; 6-1,R16,63,0,2,34,50,26,34,8,16,3,3,7,34,50,3,3,26,49,14,26,9,23,6,11,8,23,49
2006-02-27 00:00:00.000,Las Vegas NV; U.S.A. ATP World Tour,HARD,2,Xavier Malisse,Peter Luczak,Xavier Malisse,6-4; 4-6; 6-4,R16,122,12,2,53,88,46,53,15,35,3,5,15,61,88,3,3,67,114,46,67,25,47,8,11,15,71,114
2006-02-27 00:00:00.000,Las Vegas NV; U.S.A. ATP World Tour,HARD,2,Ivo Karlovic,Jonas Bjorkman,Ivo Karlovic,3-6; 6-3; 6-4,R16,97,16,2,54,81,45,54,13,27,2,3,14,58,81,2,4,39,70,32,39,20,31,1,3,14,52,70
2006-02-27 00:00:00.000,Las Vegas NV; U.S.A. ATP World Tour,HARD,2,Tommy Robredo,Mardy Fish,Tommy Robredo,6-4; 6-4,R16,67,4,5,30,58,23,30,15,28,4,6,10,38,58,3,3,25,57,16,25,17,32,3,7,10,33,57
2006-02-27 00:00:00.000,Las Vegas NV; U.S.A. ATP World Tour,HARD,2,James Blake,Brian Vahaly,James Blake,6-1; 6-1,R16,51,2,4,25,38,22,25,7,13,1,1,7,29,38,0,5,24,58,10,24,15,34,8,13,7,25,58
2006-02-27 00:00:00.000,Las Vegas NV; U.S.A. ATP World Tour,HARD,2,Kenneth Carlsen,Nicolas Kiefer,Kenneth Carlsen,W/O,R16,0,0,0,0,0,0,0,0,0,0,0,0,0,0,0,0,0,0,0,0,0,0,0,0,0,0,0
2006-02-27 00:00:00.000,Las Vegas NV; U.S.A. ATP World Tour,HARD,2,Lleyton Hewitt,Philipp Kohlschreiber,Lleyton Hewitt,6-2; 6-0,Q,59,1,6,31,48,22,31,10,17,3,4,7,32,48,1,0,29,43,11,29,5,14,2,8,7,16,43
2006-02-27 00:00:00.000,Las Vegas NV; U.S.A. ATP World Tour,HARD,2,Paul Goldstein,Xavier Malisse,Paul Goldstein,6-3; 2-0 RET,Q,5,0,1,27,38,18,27,7,11,0,1,6,25,38,4,0,26,34,14,26,2,8,5,8,5,16,34
2006-02-27 00:00:00.000,Las Vegas NV; U.S.A. ATP World Tour,HARD,2,Ivo Karlovic,Tommy Robredo,Ivo Karlovic,7-6(4); 6-4,Q,89,8,5,38,66,35,38,15,28,0,0,11,50,66,2,2,53,70,38,53,11,17,1,2,11,49,70
2006-02-27 00:00:00.000,Las Vegas NV; U.S.A. ATP World Tour,HARD,2,James Blake,Kenneth Carlsen,James Blake,6-4; 6-4,Q,68,4,2,41,59,36,41,7,18,4,4,10,43,59,5,1,38,60,24,38,14,22,3,5,10,38,60
2006-02-27 00:00:00.000,Las Vegas NV; U.S.A. ATP World Tour,HARD,2,Lleyton Hewitt,Paul Goldstein,Lleyton Hewitt,3-6; 6-1; 6-0,S,93,3,3,39,67,25,39,14,28,2,6,11,39,67,1,2,37,70,19,37,10,33,5,13,11,29,70
2006-02-27 00:00:00.000,Las Vegas NV; U.S.A. ATP World Tour,HARD,2,James Blake,Ivo Karlovic,James Blake,7-6(2); 6-1,S,72,1,3,32,54,28,32,16,22,3,3,10,44,54,5,3,32,59,26,32,9,27,0,2,9,35,59
2006-02-27 00:00:00.000,Las Vegas NV; U.S.A. ATP World Tour,HARD,2,James Blake,Lleyton Hewitt,James Blake,7-5; 2-6; 6-3,F,119,5,4,47,96,32,47,23,49,5,10,14,55,96,3,2,56,95,32,56,19,39,6,12,15,51,95
2006-03-06 00:00:00.000,ATP Masters Series Indian Wells CA; U.S.A. ATP World Tour,HARD,2,Roger Federer,N/A Bye,Roger Federer,,R128,0,0,0,0,0,0,0,0,0,0,0,0,0,0,0,0,0,0,0,0,0,0,0,0,0,0,0
2006-03-06 00:00:00.000,ATP Masters Series Indian Wells CA; U.S.A. ATP World Tour,HARD,2,Nicolas Massu,Agustin Calleri,Nicolas Massu,6-1; 5-7; 7-6(10),R128,162,6,2,74,116,47,74,27,42,7,10,16,74,116,6,3,59,107,37,59,26,48,2,6,15,63,107
2006-03-06 00:00:00.000,ATP Masters Series Indian Wells CA; U.S.A. ATP World Tour,HARD,2,Stanislas Wawrinka,Greg Rusedski,Stanislas Wawrinka,6-2; 6-4,R128,81,4,2,38,58,26,38,11,20,2,3,9,37,58,2,5,33,66,21,33,14,33,8,12,9,35,66
2006-03-06 00:00:00.000,ATP Masters Series Indian Wells CA; U.S.A. ATP World Tour,HARD,2,Olivier Rochus,N/A Bye,Olivier Rochus,,R128,0,0,0,0,0,0,0,0,0,0,0,0,0,0,0,0,0,0,0,0,0,0,0,0,0,0,0
2006-03-06 00:00:00.000,ATP Masters Series Indian Wells CA; U.S.A. ATP World Tour,HARD,2,Dominik Hrbaty,N/A Bye,Dominik Hrbaty,,R128,0,0,0,0,0,0,0,0,0,0,0,0,0,0,0,0,0,0,0,0,0,0,0,0,0,0,0
2006-03-06 00:00:00.000,ATP Masters Series Indian Wells CA; U.S.A. ATP World Tour,HARD,2,Daniele Bracciali,Luis Horna,Daniele Bracciali,6-3; 6-3,R128,77,8,0,19,41,19,19,17,22,0,0,9,36,41,5,5,53,82,32,53,13,29,11,14,9,45,82
2006-03-06 00:00:00.000,ATP Masters Series Indian Wells CA; U.S.A. ATP World Tour,HARD,2,Kevin Kim,Mikhail Youzhny,Kevin Kim,7-5; 6-4,R128,88,2,1,35,60,28,35,14,25,0,2,11,42,60,1,3,58,83,33,58,13,25,8,12,11,46,83
2006-03-06 00:00:00.000,ATP Masters Series Indian Wells CA; U.S.A. ATP World Tour,HARD,2,Richard Gasquet,N/A Bye,Richard Gasquet,,R128,0,0,0,0,0,0,0,0,0,0,0,0,0,0,0,0,0,0,0,0,0,0,0,0,0,0,0
2006-03-06 00:00:00.000,ATP Masters Series Indian Wells CA; U.S.A. ATP World Tour,HARD,2,Nicolas Kiefer,N/A Bye,Nicolas Kiefer,,R128,0,0,0,0,0,0,0,0,0,0,0,0,0,0,0,0,0,0,0,0,0,0,0,0,0,0,0
2006-03-06 00:00:00.000,ATP Masters Series Indian Wells CA; U.S.A. ATP World Tour,HARD,2,Paul-Henri Mathieu,Andreas Seppi,Paul-Henri Mathieu,2-6; 6-4; 6-1,R128,112,6,3,40,72,31,40,16,32,3,6,13,47,72,5,1,48,84,31,48,17,36,7,11,12,48,84
2006-03-06 00:00:00.000,ATP Masters Series Indian Wells CA; U.S.A. ATP World Tour,HARD,2,Davide Sanguinetti,Paul Capdeville,Davide Sanguinetti,6-7(5); 6-2; 6-3,R128,116,7,2,48,81,39,48,24,33,0,1,15,63,81,1,1,58,104,36,58,26,46,6,10,14,62,104
2006-03-06 00:00:00.000,ATP Masters Series Indian Wells CA; U.S.A. ATP World Tour,HARD,2,Mario Ancic,N/A Bye,Mario Ancic,,R128,0,0,0,0,0,0,0,0,0,0,0,0,0,0,0,0,0,0,0,0,0,0,0,0,0,0,0
2006-03-06 00:00:00.000,ATP Masters Series Indian Wells CA; U.S.A. ATP World Tour,HARD,2,Gael Monfils,N/A Bye,Gael Monfils,,R128,0,0,0,0,0,0,0,0,0,0,0,0,0,0,0,0,0,0,0,0,0,0,0,0,0,0,0
2006-03-06 00:00:00.000,ATP Masters Series Indian Wells CA; U.S.A. ATP World Tour,HARD,2,Jeff Morrison,Andrei Pavel,Jeff Morrison,6-7(5); 7-5; 6-3,R128,131,8,2,63,110,44,63,27,47,10,14,17,71,110,1,3,51,101,30,51,29,50,6,12,16,59,101
2006-03-06 00:00:00.000,ATP Masters Series Indian Wells CA; U.S.A. ATP World Tour,HARD,2,Janko Tipsarevic,Sam Warburg,Janko Tipsarevic,6-4; 7-6(4),R128,101,4,0,33,63,28,33,19,30,2,3,11,47,63,2,2,42,74,28,42,18,32,2,4,11,46,74
2006-03-06 00:00:00.000,ATP Masters Series Indian Wells CA; U.S.A. ATP World Tour,HARD,2,Ivan Ljubicic,N/A Bye,Ivan Ljubicic,,R128,0,0,0,0,0,0,0,0,0,0,0,0,0,0,0,0,0,0,0,0,0,0,0,0,0,0,0
2006-03-06 00:00:00.000,ATP Masters Series Indian Wells CA; U.S.A. ATP World Tour,HARD,2,David Nalbandian,N/A Bye,David Nalbandian,,R128,0,0,0,0,0,0,0,0,0,0,0,0,0,0,0,0,0,0,0,0,0,0,0,0,0,0,0
2006-03-06 00:00:00.000,ATP Masters Series Indian Wells CA; U.S.A. ATP World Tour,HARD,2,Justin Gimelstob,Feliciano Lopez,Justin Gimelstob,7-5; 6-3,R128,68,3,4,26,55,22,26,19,29,0,1,11,41,55,2,2,33,59,23,33,12,26,1,4,10,35,59
2006-03-06 00:00:00.000,ATP Masters Series Indian Wells CA; U.S.A. ATP World Tour,HARD,2,Julien Benneteau,Novak Djokovic,Julien Benneteau,6-3; 6-4,R128,93,2,1,40,56,30,40,6,16,2,4,9,36,56,1,2,42,75,25,42,14,33,7,12,10,39,75
2006-03-06 00:00:00.000,ATP Masters Series Indian Wells CA; U.S.A. ATP World Tour,HARD,2,Juan Ignacio Chela,N/A Bye,Juan Ignacio Chela,,R128,0,0,0,0,0,0,0,0,0,0,0,0,0,0,0,0,0,0,0,0,0,0,0,0,0,0,0
2006-03-06 00:00:00.000,ATP Masters Series Indian Wells CA; U.S.A. ATP World Tour,HARD,2,Robby Ginepri,N/A Bye,Robby Ginepri,,R128,0,0,0,0,0,0,0,0,0,0,0,0,0,0,0,0,0,0,0,0,0,0,0,0,0,0,0
2006-03-06 00:00:00.000,ATP Masters Series Indian Wells CA; U.S.A. ATP World Tour,HARD,2,Paradorn Srichaphan,Wesley Moodie,Paradorn Srichaphan,7-6(2); 6-4,R128,77,8,0,34,61,26,34,20,27,0,1,11,46,61,9,3,41,64,30,41,10,23,2,4,11,40,64
2006-03-06 00:00:00.000,ATP Masters Series Indian Wells CA; U.S.A. ATP World Tour,HARD,2,Vincent Spadea,Carlos Berlocq,Vincent Spadea,6-1; 4-1 RET,R128,57,2,1,22,35,18,22,8,13,0,0,6,26,35,0,2,16,30,7,16,5,14,1,5,6,12,30
2006-03-06 00:00:00.000,ATP Masters Series Indian Wells CA; U.S.A. ATP World Tour,HARD,2,Juan Carlos Ferrero,N/A Bye,Juan Carlos Ferrero,,R128,0,0,0,0,0,0,0,0,0,0,0,0,0,0,0,0,0,0,0,0,0,0,0,0,0,0,0
2006-03-06 00:00:00.000,ATP Masters Series Indian Wells CA; U.S.A. ATP World Tour,HARD,2,David Ferrer,N/A Bye,David Ferrer,,R128,0,0,0,0,0,0,0,0,0,0,0,0,0,0,0,0,0,0,0,0,0,0,0,0,0,0,0
2006-03-06 00:00:00.000,ATP Masters Series Indian Wells CA; U.S.A. ATP World Tour,HARD,2,Philipp Kohlschreiber,Florent Serra,Philipp Kohlschreiber,3-6; 6-4; 6-3,R128,130,3,2,62,94,42,62,16,32,9,12,14,58,94,2,2,68,104,47,68,14,36,9,13,14,61,104
2006-03-06 00:00:00.000,ATP Masters Series Indian Wells CA; U.S.A. ATP World Tour,HARD,2,Florian Mayer,Mark Philippoussis,Florian Mayer,6-4; 6-3,R128,77,3,3,44,59,33,44,7,15,4,5,9,40,59,4,3,30,63,17,30,16,33,3,7,10,33,63
2006-03-06 00:00:00.000,ATP Masters Series Indian Wells CA; U.S.A. ATP World Tour,HARD,2,Jarkko Nieminen,N/A Bye,Jarkko Nieminen,,R128,0,0,0,0,0,0,0,0,0,0,0,0,0,0,0,0,0,0,0,0,0,0,0,0,0,0,0
2006-03-06 00:00:00.000,ATP Masters Series Indian Wells CA; U.S.A. ATP World Tour,HARD,2,Carlos Moya,N/A Bye,Carlos Moya,,R128,0,0,0,0,0,0,0,0,0,0,0,0,0,0,0,0,0,0,0,0,0,0,0,0,0,0,0
2006-03-06 00:00:00.000,ATP Masters Series Indian Wells CA; U.S.A. ATP World Tour,HARD,2,Marat Safin,Amer Delic,Marat Safin,6-3; 6-4,R128,91,4,0,34,60,25,34,17,26,1,2,10,42,60,0,0,27,51,16,27,12,24,2,5,9,28,51
2006-03-06 00:00:00.000,ATP Masters Series Indian Wells CA; U.S.A. ATP World Tour,HARD,2,Andy Murray,Vasilis Mazarakis,Andy Murray,6-2; 6-1,R128,47,2,1,25,45,20,25,10,20,1,2,8,30,45,0,2,21,37,12,21,3,16,1,6,7,15,37
2006-03-06 00:00:00.000,ATP Masters Series Indian Wells CA; U.S.A. ATP World Tour,HARD,2,Nikolay Davydenko,N/A Bye,Nikolay Davydenko,,R128,0,0,0,0,0,0,0,0,0,0,0,0,0,0,0,0,0,0,0,0,0,0,0,0,0,0,0
2006-03-06 00:00:00.000,ATP Masters Series Indian Wells CA; U.S.A. ATP World Tour,HARD,2,Andre Agassi,N/A Bye,Andre Agassi,,R128,0,0,0,0,0,0,0,0,0,0,0,0,0,0,0,0,0,0,0,0,0,0,0,0,0,0,0
2006-03-06 00:00:00.000,ATP Masters Series Indian Wells CA; U.S.A. ATP World Tour,HARD,2,Paul Goldstein,Alberto Martin,Paul Goldstein,3-6; 6-1; 6-1,R128,94,3,0,38,71,22,38,22,33,3,5,11,44,71,2,7,52,79,29,52,10,27,6,12,12,39,79
2006-03-06 00:00:00.000,ATP Masters Series Indian Wells CA; U.S.A. ATP World Tour,HARD,2,Arnaud Clement,Glenn Weiner,Arnaud Clement,6-3; 6-2,R128,66,6,1,28,50,23,28,13,22,0,0,9,36,50,4,1,27,48,16,27,12,21,3,6,8,28,48
2006-03-06 00:00:00.000,ATP Masters Series Indian Wells CA; U.S.A. ATP World Tour,HARD,2,Tommy Haas,N/A Bye,Tommy Haas,,R128,0,0,0,0,0,0,0,0,0,0,0,0,0,0,0,0,0,0,0,0,0,0,0,0,0,0,0
2006-03-06 00:00:00.000,ATP Masters Series Indian Wells CA; U.S.A. ATP World Tour,HARD,2,Tommy Robredo,N/A Bye,Tommy Robredo,,R128,0,0,0,0,0,0,0,0,0,0,0,0,0,0,0,0,0,0,0,0,0,0,0,0,0,0,0
2006-03-06 00:00:00.000,ATP Masters Series Indian Wells CA; U.S.A. ATP World Tour,HARD,2,Kenneth Carlsen,Gilles Muller,Kenneth Carlsen,6-3; 4-6; 6-3,R128,148,5,0,59,89,41,59,18,30,7,9,14,59,89,5,3,65,97,41,65,16,32,6,10,14,57,97
2006-03-06 00:00:00.000,ATP Masters Series Indian Wells CA; U.S.A. ATP World Tour,HARD,2,Sam Querrey,Bobby Reynolds,Sam Querrey,6-3; 7-5,R128,86,13,3,47,81,37,47,15,34,8,9,11,52,81,3,2,39,65,26,39,12,26,2,5,10,38,65
2006-03-06 00:00:00.000,ATP Masters Series Indian Wells CA; U.S.A. ATP World Tour,HARD,2,James Blake,N/A Bye,James Blake,,R128,0,0,0,0,0,0,0,0,0,0,0,0,0,0,0,0,0,0,0,0,0,0,0,0,0,0,0
2006-03-06 00:00:00.000,ATP Masters Series Indian Wells CA; U.S.A. ATP World Tour,HARD,2,Fernando Gonzalez,N/A Bye,Fernando Gonzalez,,R128,0,0,0,0,0,0,0,0,0,0,0,0,0,0,0,0,0,0,0,0,0,0,0,0,0,0,0
2006-03-06 00:00:00.000,ATP Masters Series Indian Wells CA; U.S.A. ATP World Tour,HARD,2,Robin Soderling,Jurgen Melzer,Robin Soderling,6-4; 6-4,R128,69,2,2,40,62,28,40,12,22,1,2,10,40,62,4,5,40,64,27,40,11,24,4,7,10,38,64
2006-03-06 00:00:00.000,ATP Masters Series Indian Wells CA; U.S.A. ATP World Tour,HARD,2,Dmitry Tursunov,Tomas Behrend,Dmitry Tursunov,6-4; 6-2,R128,58,7,2,30,49,26,30,12,19,0,0,9,38,49,1,3,26,50,20,26,9,24,3,6,9,29,50
2006-03-06 00:00:00.000,ATP Masters Series Indian Wells CA; U.S.A. ATP World Tour,HARD,2,Igor Andreev,N/A Bye,Igor Andreev,,R128,0,0,0,0,0,0,0,0,0,0,0,0,0,0,0,0,0,0,0,0,0,0,0,0,0,0,0
2006-03-06 00:00:00.000,ATP Masters Series Indian Wells CA; U.S.A. ATP World Tour,HARD,2,Fernando Verdasco,N/A Bye,Fernando Verdasco,,R128,0,0,0,0,0,0,0,0,0,0,0,0,0,0,0,0,0,0,0,0,0,0,0,0,0,0,0
2006-03-06 00:00:00.000,ATP Masters Series Indian Wells CA; U.S.A. ATP World Tour,HARD,2,Ivo Karlovic,Tomas Zib,Ivo Karlovic,7-6(9); 6-4,R128,94,27,0,50,69,42,50,13,19,1,1,11,55,69,1,0,44,67,32,44,18,23,0,1,11,50,67
2006-03-06 00:00:00.000,ATP Masters Series Indian Wells CA; U.S.A. ATP World Tour,HARD,2,Jose Acasuso,Jeff Salzenstein,Jose Acasuso,6-7(2); 6-3; 6-1,R128,115,9,1,51,84,40,51,24,33,4,4,14,64,84,8,13,68,106,51,68,13,38,5,9,14,64,106
2006-03-06 00:00:00.000,ATP Masters Series Indian Wells CA; U.S.A. ATP World Tour,HARD,2,Andy Roddick,N/A Bye,Andy Roddick,,R128,0,0,0,0,0,0,0,0,0,0,0,0,0,0,0,0,0,0,0,0,0,0,0,0,0,0,0
2006-03-06 00:00:00.000,ATP Masters Series Indian Wells CA; U.S.A. ATP World Tour,HARD,2,Gaston Gaudio,N/A Bye,Gaston Gaudio,,R128,0,0,0,0,0,0,0,0,0,0,0,0,0,0,0,0,0,0,0,0,0,0,0,0,0,0,0
2006-03-06 00:00:00.000,ATP Masters Series Indian Wells CA; U.S.A. ATP World Tour,HARD,2,Cyril Saulnier,Max Mirnyi,Cyril Saulnier,6-4; 7-6(5),R128,78,4,2,39,63,32,39,17,24,0,0,11,49,63,18,3,35,62,30,35,18,27,3,4,11,48,62
2006-03-06 00:00:00.000,ATP Masters Series Indian Wells CA; U.S.A. ATP World Tour,HARD,2,Jonas Bjorkman,Christophe Rochus,Jonas Bjorkman,6-2; 3-6; 6-2,R128,114,9,5,53,88,30,53,20,35,3,7,12,50,88,4,2,49,77,27,49,10,28,2,9,13,37,77
2006-03-06 00:00:00.000,ATP Masters Series Indian Wells CA; U.S.A. ATP World Tour,HARD,2,Marcos Baghdatis,N/A Bye,Marcos Baghdatis,,R128,0,0,0,0,0,0,0,0,0,0,0,0,0,0,0,0,0,0,0,0,0,0,0,0,0,0,0
2006-03-06 00:00:00.000,ATP Masters Series Indian Wells CA; U.S.A. ATP World Tour,HARD,2,Tomas Berdych,N/A Bye,Tomas Berdych,,R128,0,0,0,0,0,0,0,0,0,0,0,0,0,0,0,0,0,0,0,0,0,0,0,0,0,0,0
2006-03-06 00:00:00.000,ATP Masters Series Indian Wells CA; U.S.A. ATP World Tour,HARD,2,Tim Henman,Donald Young,Tim Henman,6-3; 6-1,R128,64,1,1,36,58,25,36,14,22,5,5,8,39,58,0,2,30,51,16,30,10,21,0,4,8,26,51
2006-03-06 00:00:00.000,ATP Masters Series Indian Wells CA; U.S.A. ATP World Tour,HARD,2,Rainer Schuettler,Boris Pashanski,Rainer Schuettler,7-6(4); 7-5,R128,117,5,0,43,72,30,43,20,29,2,3,12,50,72,1,2,66,105,42,66,19,39,8,10,12,61,105
2006-03-06 00:00:00.000,ATP Masters Series Indian Wells CA; U.S.A. ATP World Tour,HARD,2,Lleyton Hewitt,N/A Bye,Lleyton Hewitt,,R128,0,0,0,0,0,0,0,0,0,0,0,0,0,0,0,0,0,0,0,0,0,0,0,0,0,0,0
2006-03-06 00:00:00.000,ATP Masters Series Indian Wells CA; U.S.A. ATP World Tour,HARD,2,Radek Stepanek,N/A Bye,Radek Stepanek,,R128,0,0,0,0,0,0,0,0,0,0,0,0,0,0,0,0,0,0,0,0,0,0,0,0,0,0,0
2006-03-06 00:00:00.000,ATP Masters Series Indian Wells CA; U.S.A. ATP World Tour,HARD,2,Xavier Malisse,Fabrice Santoro,Xavier Malisse,6-1; 4-6; 6-4,R128,108,6,1,40,65,28,40,18,25,0,3,13,46,65,1,2,61,105,32,61,22,44,10,16,14,54,105
2006-03-06 00:00:00.000,ATP Masters Series Indian Wells CA; U.S.A. ATP World Tour,HARD,2,Kristof Vliegen,Lars Burgsmuller,Kristof Vliegen,6-4; 4-6; 6-4,R128,124,6,0,52,83,41,52,18,31,3,5,15,59,83,3,2,58,90,40,58,20,32,4,7,15,60,90
2006-03-06 00:00:00.000,ATP Masters Series Indian Wells CA; U.S.A. ATP World Tour,HARD,2,Sebastien Grosjean,N/A Bye,Sebastien Grosjean,,R128,0,0,0,0,0,0,0,0,0,0,0,0,0,0,0,0,0,0,0,0,0,0,0,0,0,0,0
2006-03-06 00:00:00.000,ATP Masters Series Indian Wells CA; U.S.A. ATP World Tour,HARD,2,Filippo Volandri,N/A Bye,Filippo Volandri,,R128,0,0,0,0,0,0,0,0,0,0,0,0,0,0,0,0,0,0,0,0,0,0,0,0,0,0,0
2006-03-06 00:00:00.000,ATP Masters Series Indian Wells CA; U.S.A. ATP World Tour,HARD,2,Mardy Fish,Giovanni Lapentti,Mardy Fish,5-7; 6-3; 6-3,R128,111,11,1,42,78,35,42,20,36,3,6,15,55,78,2,0,64,98,37,64,18,34,10,15,15,55,98
2006-03-06 00:00:00.000,ATP Masters Series Indian Wells CA; U.S.A. ATP World Tour,HARD,2,Jan Hernych,Robin Vik,Jan Hernych,6-1; 6-4,R128,74,1,3,42,59,29,42,8,17,1,3,9,37,59,1,2,42,55,21,42,5,13,4,9,8,26,55
2006-03-06 00:00:00.000,ATP Masters Series Indian Wells CA; U.S.A. ATP World Tour,HARD,2,Rafael Nadal,N/A Bye,Rafael Nadal,,R128,0,0,0,0,0,0,0,0,0,0,0,0,0,0,0,0,0,0,0,0,0,0,0,0,0,0,0
2006-03-06 00:00:00.000,ATP Masters Series Indian Wells CA; U.S.A. ATP World Tour,HARD,2,Roger Federer,Nicolas Massu,Roger Federer,6-3; 7-6(4),R64,94,3,1,40,66,30,40,21,26,1,1,11,51,66,2,1,46,67,30,46,13,21,3,4,10,43,67
2006-03-06 00:00:00.000,ATP Masters Series Indian Wells CA; U.S.A. ATP World Tour,HARD,2,Olivier Rochus,Stanislas Wawrinka,Olivier Rochus,7-6(4); 7-5,R64,105,0,2,50,88,33,50,24,38,3,4,12,57,88,6,3,40,74,28,40,22,34,2,4,12,50,74
2006-03-06 00:00:00.000,ATP Masters Series Indian Wells CA; U.S.A. ATP World Tour,HARD,2,Dominik Hrbaty,Daniele Bracciali,Dominik Hrbaty,7-5; 7-5,R64,80,3,2,44,67,35,44,13,23,2,3,12,48,67,4,5,38,69,24,38,17,31,2,5,12,41,69
2006-03-06 00:00:00.000,ATP Masters Series Indian Wells CA; U.S.A. ATP World Tour,HARD,2,Richard Gasquet,Kevin Kim,Richard Gasquet,6-4; 6-3,R64,68,3,3,43,64,35,43,7,21,3,4,10,42,64,3,6,40,61,27,40,8,21,6,9,9,35,61
2006-03-06 00:00:00.000,ATP Masters Series Indian Wells CA; U.S.A. ATP World Tour,HARD,2,Paul-Henri Mathieu,Nicolas Kiefer,Paul-Henri Mathieu,7-6(5); 4-6; 6-2,R64,156,8,2,42,90,30,42,27,48,2,5,15,57,90,10,2,43,81,29,43,24,38,0,4,15,53,81
2006-03-06 00:00:00.000,ATP Masters Series Indian Wells CA; U.S.A. ATP World Tour,HARD,2,Mario Ancic,Davide Sanguinetti,Mario Ancic,6-3; 7-6(3),R64,88,5,2,41,67,33,41,11,26,3,5,11,44,67,0,0,37,58,25,37,10,21,1,4,10,35,58
2006-03-06 00:00:00.000,ATP Masters Series Indian Wells CA; U.S.A. ATP World Tour,HARD,2,Gael Monfils,Jeff Morrison,Gael Monfils,6-3; 0-6; 6-3,R64,86,4,2,45,70,33,45,9,25,2,5,12,42,70,5,5,44,76,30,44,18,32,2,5,12,48,76
2006-03-06 00:00:00.000,ATP Masters Series Indian Wells CA; U.S.A. ATP World Tour,HARD,2,Ivan Ljubicic,Janko Tipsarevic,Ivan Ljubicic,6-1; 6-4,R64,65,10,2,32,54,23,32,13,22,0,1,9,36,54,0,2,22,45,15,22,10,23,4,8,8,25,45
2006-03-06 00:00:00.000,ATP Masters Series Indian Wells CA; U.S.A. ATP World Tour,HARD,2,David Nalbandian,Justin Gimelstob,David Nalbandian,6-4; 6-4,R64,80,5,3,32,58,24,32,13,26,4,6,10,37,58,3,0,34,60,24,34,10,26,4,8,10,34,60
2006-03-06 00:00:00.000,ATP Masters Series Indian Wells CA; U.S.A. ATP World Tour,HARD,2,Julien Benneteau,Juan Ignacio Chela,Julien Benneteau,6-4; 4-6; 6-3,R64,122,3,1,55,86,38,55,19,31,2,4,15,57,86,4,3,56,87,38,56,17,31,4,7,14,55,87
2006-03-06 00:00:00.000,ATP Masters Series Indian Wells CA; U.S.A. ATP World Tour,HARD,2,Paradorn Srichaphan,Robby Ginepri,Paradorn Srichaphan,7-6(10); 6-3,R64,86,4,2,37,71,27,37,27,34,0,0,11,54,71,0,0,42,66,30,42,16,24,0,1,10,46,66
2006-03-06 00:00:00.000,ATP Masters Series Indian Wells CA; U.S.A. ATP World Tour,HARD,2,Juan Carlos Ferrero,Vincent Spadea,Juan Carlos Ferrero,6-2; 4-6; 7-6(4),R64,138,3,1,61,92,43,61,17,31,4,7,15,60,92,7,3,67,102,44,67,16,35,3,7,15,60,102
2006-03-06 00:00:00.000,ATP Masters Series Indian Wells CA; U.S.A. ATP World Tour,HARD,2,Philipp Kohlschreiber,David Ferrer,Philipp Kohlschreiber,6-2; 6-2,R64,66,3,0,32,50,25,32,11,18,3,3,8,36,50,1,0,38,54,19,38,9,16,4,8,8,28,54
2006-03-06 00:00:00.000,ATP Masters Series Indian Wells CA; U.S.A. ATP World Tour,HARD,2,Jarkko Nieminen,Florian Mayer,Jarkko Nieminen,6-4; 6-4,R64,80,1,1,49,70,36,49,11,21,3,3,10,47,70,3,2,37,67,27,37,15,30,3,5,10,42,67
2006-03-06 00:00:00.000,ATP Masters Series Indian Wells CA; U.S.A. ATP World Tour,HARD,2,Marat Safin,Carlos Moya,Marat Safin,6-7(4); 6-3; 6-4,R64,128,14,2,54,96,45,54,26,42,2,2,16,71,96,5,2,42,93,32,42,32,51,4,6,15,64,93
2006-03-06 00:00:00.000,ATP Masters Series Indian Wells CA; U.S.A. ATP World Tour,HARD,2,Nikolay Davydenko,Andy Murray,Nikolay Davydenko,6-1; 3-6; 6-3,R64,108,1,6,53,73,33,53,8,20,5,9,12,41,73,1,4,57,88,30,57,12,31,6,13,13,42,88
2006-03-06 00:00:00.000,ATP Masters Series Indian Wells CA; U.S.A. ATP World Tour,HARD,2,Andre Agassi,Paul Goldstein,Andre Agassi,6-4; 4-6; 6-2,R64,100,5,1,47,86,34,47,20,39,3,6,14,54,86,0,3,59,82,32,59,13,23,3,8,14,45,82
2006-03-06 00:00:00.000,ATP Masters Series Indian Wells CA; U.S.A. ATP World Tour,HARD,2,Tommy Haas,Arnaud Clement,Tommy Haas,6-3; 1-6; 6-4,R64,114,10,9,47,87,33,47,19,40,3,7,13,52,87,5,1,41,89,27,41,22,48,9,13,13,49,89
2006-03-06 00:00:00.000,ATP Masters Series Indian Wells CA; U.S.A. ATP World Tour,HARD,2,Tommy Robredo,Kenneth Carlsen,Tommy Robredo,6-1; 6-3,R64,58,0,1,36,47,25,36,6,11,1,2,8,31,47,3,1,30,44,16,30,4,14,1,6,8,20,44
2006-03-06 00:00:00.000,ATP Masters Series Indian Wells CA; U.S.A. ATP World Tour,HARD,2,James Blake,Sam Querrey,James Blake,1-6; 6-1; 6-3,R64,90,5,3,41,62,28,41,13,21,1,4,11,41,62,5,2,37,74,21,37,18,37,3,8,12,39,74
2006-03-06 00:00:00.000,ATP Masters Series Indian Wells CA; U.S.A. ATP World Tour,HARD,2,Robin Soderling,Fernando Gonzalez,Robin Soderling,6-4; 6-0,R64,48,2,1,25,40,20,25,10,15,1,2,8,30,40,2,4,18,43,11,18,10,25,3,8,8,21,43
2006-03-06 00:00:00.000,ATP Masters Series Indian Wells CA; U.S.A. ATP World Tour,HARD,2,Igor Andreev,Dmitry Tursunov,Igor Andreev,6-7(2); 6-1; 6-2,R64,127,2,4,53,93,33,53,26,40,6,8,14,59,93,3,6,54,96,33,54,19,42,11,17,13,52,96
2006-03-06 00:00:00.000,ATP Masters Series Indian Wells CA; U.S.A. ATP World Tour,HARD,2,Fernando Verdasco,Ivo Karlovic,Fernando Verdasco,6-3; 3-6; 7-6(5),R64,121,1,2,67,93,48,67,16,26,4,6,15,64,93,16,3,69,100,51,69,16,31,3,5,15,67,100
2006-03-06 00:00:00.000,ATP Masters Series Indian Wells CA; U.S.A. ATP World Tour,HARD,2,Andy Roddick,Jose Acasuso,Andy Roddick,7-6(5); 6-0,R64,76,8,1,30,51,28,30,11,21,0,1,9,39,51,2,2,27,55,16,27,14,28,0,4,9,30,55
2006-03-06 00:00:00.000,ATP Masters Series Indian Wells CA; U.S.A. ATP World Tour,HARD,2,Gaston Gaudio,Cyril Saulnier,Gaston Gaudio,3-6; 6-3; 6-4,R64,124,3,2,55,80,37,55,14,25,3,7,14,51,80,7,3,51,99,34,51,20,48,8,13,14,54,99
2006-03-06 00:00:00.000,ATP Masters Series Indian Wells CA; U.S.A. ATP World Tour,HARD,2,Marcos Baghdatis,Jonas Bjorkman,Marcos Baghdatis,6-4; 6-3,R64,85,7,1,35,56,24,35,13,21,1,3,10,37,56,2,3,31,61,19,31,14,30,7,11,9,33,61
2006-03-06 00:00:00.000,ATP Masters Series Indian Wells CA; U.S.A. ATP World Tour,HARD,2,Tomas Berdych,Tim Henman,Tomas Berdych,6-4; 6-4,R64,88,4,3,29,62,25,29,16,33,4,5,10,41,62,4,2,40,63,28,40,8,23,2,5,10,36,63
2006-03-06 00:00:00.000,ATP Masters Series Indian Wells CA; U.S.A. ATP World Tour,HARD,2,Lleyton Hewitt,Rainer Schuettler,Lleyton Hewitt,7-6(3); 2-6; 6-4,R64,162,7,5,42,103,29,42,35,61,4,7,15,64,103,4,7,54,116,34,54,36,62,9,11,15,70,116
2006-03-06 00:00:00.000,ATP Masters Series Indian Wells CA; U.S.A. ATP World Tour,HARD,2,Xavier Malisse,Radek Stepanek,Xavier Malisse,6-1; 6-1,R64,60,0,0,26,41,20,26,9,15,1,1,7,29,41,1,3,30,50,14,30,7,20,3,8,7,21,50
2006-03-06 00:00:00.000,ATP Masters Series Indian Wells CA; U.S.A. ATP World Tour,HARD,2,Sebastien Grosjean,Kristof Vliegen,Sebastien Grosjean,6-1; 6-3,R64,79,2,1,15,43,13,15,17,28,0,1,8,30,43,2,3,33,58,20,33,7,25,2,7,8,27,58
2006-03-06 00:00:00.000,ATP Masters Series Indian Wells CA; U.S.A. ATP World Tour,HARD,2,Mardy Fish,Filippo Volandri,Mardy Fish,6-3; 6-2,R64,56,7,1,29,48,23,29,12,19,1,2,9,35,48,0,0,39,53,19,39,8,14,1,5,8,27,53
2006-03-06 00:00:00.000,ATP Masters Series Indian Wells CA; U.S.A. ATP World Tour,HARD,2,Rafael Nadal,Jan Hernych,Rafael Nadal,6-4; 6-4,R64,85,3,1,36,59,29,36,13,23,1,1,10,42,59,0,0,34,53,21,34,14,19,1,3,10,35,53
2006-03-06 00:00:00.000,ATP Masters Series Indian Wells CA; U.S.A. ATP World Tour,HARD,2,Roger Federer,Olivier Rochus,Roger Federer,3-6; 6-2; 7-5,R32,114,8,3,54,97,39,54,24,43,5,6,14,63,97,1,4,59,87,39,59,16,28,3,6,15,55,87
2006-03-06 00:00:00.000,ATP Masters Series Indian Wells CA; U.S.A. ATP World Tour,HARD,2,Richard Gasquet,Dominik Hrbaty,Richard Gasquet,6-3; 6-4,R32,77,6,2,33,50,26,33,14,17,0,0,10,40,50,1,1,34,62,23,34,13,28,4,6,9,36,62
2006-03-06 00:00:00.000,ATP Masters Series Indian Wells CA; U.S.A. ATP World Tour,HARD,2,Mario Ancic,Paul-Henri Mathieu,Mario Ancic,7-6(5); 6-3,R32,117,5,2,59,94,42,59,18,35,5,7,11,60,94,4,1,38,64,24,38,15,26,0,3,10,39,64
2006-03-06 00:00:00.000,ATP Masters Series Indian Wells CA; U.S.A. ATP World Tour,HARD,2,Ivan Ljubicic,Gael Monfils,Ivan Ljubicic,6-3; 6-2,R32,70,6,0,22,45,20,22,14,23,1,2,9,34,45,5,2,30,56,17,30,10,26,7,11,8,27,56
2006-03-06 00:00:00.000,ATP Masters Series Indian Wells CA; U.S.A. ATP World Tour,HARD,2,David Nalbandian,Julien Benneteau,David Nalbandian,6-4; 6-1,R32,88,1,2,40,66,20,40,17,26,7,10,9,37,66,4,3,33,57,16,33,8,24,6,12,8,24,57
2006-03-06 00:00:00.000,ATP Masters Series Indian Wells CA; U.S.A. ATP World Tour,HARD,2,Paradorn Srichaphan,Juan Carlos Ferrero,Paradorn Srichaphan,6-2; 6-2,R32,63,7,3,37,58,28,37,10,21,4,5,8,38,58,1,0,37,47,17,37,4,10,3,8,8,21,47
2006-03-06 00:00:00.000,ATP Masters Series Indian Wells CA; U.S.A. ATP World Tour,HARD,2,Jarkko Nieminen,Philipp Kohlschreiber,Jarkko Nieminen,6-1; 3-6; 6-3,R32,98,0,2,50,77,33,50,10,27,10,14,12,43,77,1,5,47,83,26,47,14,36,6,13,13,40,83
2006-03-06 00:00:00.000,ATP Masters Series Indian Wells CA; U.S.A. ATP World Tour,HARD,2,Marat Safin,Nikolay Davydenko,Marat Safin,7-6(5); 3-6; 6-4,R32,146,9,1,73,119,46,73,21,46,15,20,15,67,119,0,6,78,102,51,78,12,24,5,10,16,63,102
2006-03-06 00:00:00.000,ATP Masters Series Indian Wells CA; U.S.A. ATP World Tour,HARD,2,Tommy Haas,Andre Agassi,Tommy Haas,7-5; 6-2,R32,91,5,6,27,55,24,27,13,28,1,3,10,37,55,7,5,52,90,31,52,14,38,8,13,10,45,90
2006-03-06 00:00:00.000,ATP Masters Series Indian Wells CA; U.S.A. ATP World Tour,HARD,2,James Blake,Tommy Robredo,James Blake,6-2; 7-5,R32,74,1,5,42,63,30,42,11,21,0,1,10,41,63,3,2,37,57,24,37,7,20,6,10,10,31,57
2006-03-06 00:00:00.000,ATP Masters Series Indian Wells CA; U.S.A. ATP World Tour,HARD,2,Igor Andreev,Robin Soderling,Igor Andreev,3-6; 7-6(14); 6-4,R32,148,9,4,61,105,42,61,24,44,2,5,15,66,105,8,6,63,123,48,63,27,60,5,8,16,75,123
2006-03-06 00:00:00.000,ATP Masters Series Indian Wells CA; U.S.A. ATP World Tour,HARD,2,Andy Roddick,Fernando Verdasco,Andy Roddick,6-3; 6-4,R32,73,4,2,37,55,31,37,11,18,1,1,10,42,55,3,2,46,60,28,46,9,14,5,7,9,37,60
2006-03-06 00:00:00.000,ATP Masters Series Indian Wells CA; U.S.A. ATP World Tour,HARD,2,Marcos Baghdatis,Gaston Gaudio,Marcos Baghdatis,6-7(5); 6-3; 6-2,R32,141,9,2,49,88,42,49,23,39,0,1,15,65,88,2,8,67,100,45,67,16,33,7,11,14,61,100
2006-03-06 00:00:00.000,ATP Masters Series Indian Wells CA; U.S.A. ATP World Tour,HARD,2,Tomas Berdych,Lleyton Hewitt,Tomas Berdych,7-5; 6-3,R32,98,10,1,33,69,26,33,18,36,3,5,11,44,69,5,6,42,80,21,42,21,38,9,13,10,42,80
2006-03-06 00:00:00.000,ATP Masters Series Indian Wells CA; U.S.A. ATP World Tour,HARD,2,Sebastien Grosjean,Xavier Malisse,Sebastien Grosjean,6-4; 6-7(10); 6-2,R32,147,2,2,65,103,45,65,21,38,2,4,15,66,103,5,6,67,121,47,67,21,54,7,12,15,68,121
2006-03-06 00:00:00.000,ATP Masters Series Indian Wells CA; U.S.A. ATP World Tour,HARD,2,Rafael Nadal,Mardy Fish,Rafael Nadal,6-1; 6-4,R32,88,1,2,29,47,22,29,12,18,0,0,8,34,47,10,3,38,81,23,38,19,43,13,17,9,42,81
2006-03-06 00:00:00.000,ATP Masters Series Indian Wells CA; U.S.A. ATP World Tour,HARD,2,Roger Federer,Richard Gasquet,Roger Federer,6-3; 6-4,R16,57,3,1,32,48,30,32,10,16,0,0,10,40,48,1,1,32,52,23,32,10,20,0,2,9,33,52
2006-03-06 00:00:00.000,ATP Masters Series Indian Wells CA; U.S.A. ATP World Tour,HARD,2,Ivan Ljubicic,Mario Ancic,Ivan Ljubicic,6-3; 6-4,R16,83,4,1,40,61,33,40,11,21,5,5,10,44,61,2,3,36,53,28,36,7,17,1,3,9,35,53
2006-03-06 00:00:00.000,ATP Masters Series Indian Wells CA; U.S.A. ATP World Tour,HARD,2,Paradorn Srichaphan,David Nalbandian,Paradorn Srichaphan,6-7(5); 6-3; 6-2,R16,140,13,5,64,103,46,64,21,39,5,7,15,67,103,2,8,59,101,40,59,19,42,12,17,14,59,101
2006-03-06 00:00:00.000,ATP Masters Series Indian Wells CA; U.S.A. ATP World Tour,HARD,2,Jarkko Nieminen,Marat Safin,Jarkko Nieminen,6-4; 6-3,R16,77,2,1,46,61,31,46,10,15,1,2,10,41,61,2,0,42,62,28,42,6,20,4,7,9,34,62
2006-03-06 00:00:00.000,ATP Masters Series Indian Wells CA; U.S.A. ATP World Tour,HARD,2,James Blake,Tommy Haas,James Blake,6-3; 3-0 RET,R16,45,6,1,22,37,19,22,8,15,2,2,6,27,37,1,2,17,40,11,17,8,23,3,6,6,19,40
2006-03-06 00:00:00.000,ATP Masters Series Indian Wells CA; U.S.A. ATP World Tour,HARD,2,Igor Andreev,Andy Roddick,Igor Andreev,6-4; 6-7(5); 6-1,R16,126,7,2,64,95,48,64,20,31,6,6,15,68,95,4,5,51,89,36,51,19,38,3,6,14,55,89
2006-03-06 00:00:00.000,ATP Masters Series Indian Wells CA; U.S.A. ATP World Tour,HARD,2,Marcos Baghdatis,Tomas Berdych,Marcos Baghdatis,6-4; 6-1,R16,98,10,3,48,84,33,48,19,36,11,11,8,52,84,3,6,32,65,25,32,9,33,8,12,9,34,65
2006-03-06 00:00:00.000,ATP Masters Series Indian Wells CA; U.S.A. ATP World Tour,HARD,2,Rafael Nadal,Sebastien Grosjean,Rafael Nadal,6-4; 6-2,R16,84,2,0,34,50,23,34,11,16,5,7,9,34,50,4,3,34,54,19,34,7,20,3,8,9,26,54
2006-03-06 00:00:00.000,ATP Masters Series Indian Wells CA; U.S.A. ATP World Tour,HARD,2,Roger Federer,Ivan Ljubicic,Roger Federer,6-2; 6-3,Q,67,5,1,37,53,29,37,9,16,1,1,9,38,53,4,1,38,51,23,38,5,13,4,7,8,28,51
2006-03-06 00:00:00.000,ATP Masters Series Indian Wells CA; U.S.A. ATP World Tour,HARD,2,Paradorn Srichaphan,Jarkko Nieminen,Paradorn Srichaphan,7-6(3); 3-6; 7-5,Q,161,4,3,51,105,40,51,37,54,4,5,16,77,105,3,1,95,134,64,95,22,39,11,12,17,86,134
2006-03-06 00:00:00.000,ATP Masters Series Indian Wells CA; U.S.A. ATP World Tour,HARD,2,James Blake,Igor Andreev,James Blake,6-1; 6-4,Q,70,3,1,26,51,19,26,18,25,1,1,9,37,51,0,1,38,63,26,38,8,25,5,8,8,34,63
2006-03-06 00:00:00.000,ATP Masters Series Indian Wells CA; U.S.A. ATP World Tour,HARD,2,Rafael Nadal,Marcos Baghdatis,Rafael Nadal,7-5; 6-0,Q,98,1,1,44,57,32,44,6,13,2,3,9,38,57,4,4,33,70,22,33,13,37,5,10,9,35,70
2006-03-06 00:00:00.000,ATP Masters Series Indian Wells CA; U.S.A. ATP World Tour,HARD,2,Roger Federer,Paradorn Srichaphan,Roger Federer,6-2; 6-3,S,60,3,0,36,50,24,36,10,14,0,1,9,34,50,4,2,38,55,21,38,8,17,3,7,8,29,55
2006-03-06 00:00:00.000,ATP Masters Series Indian Wells CA; U.S.A. ATP World Tour,HARD,2,James Blake,Rafael Nadal,James Blake,7-5; 6-3,S,91,3,1,41,67,29,41,16,26,5,6,11,45,67,2,3,41,62,28,41,8,21,4,7,10,36,62
2006-03-06 00:00:00.000,ATP Masters Series Indian Wells CA; U.S.A. ATP World Tour,HARD,2,Roger Federer,James Blake,Roger Federer,7-5; 6-3; 6-0,F,103,3,1,46,79,37,46,18,33,2,4,14,55,79,3,3,44,89,20,44,22,45,9,16,13,42,89
2006-03-20 00:00:00.000,ATP Masters Series Miami FL; U.S.A. ATP World Tour,HARD,2,Roger Federer,N/A Bye,Roger Federer,,R128,0,0,0,0,0,0,0,0,0,0,0,0,0,0,0,0,0,0,0,0,0,0,0,0,0,0,0
2006-03-20 00:00:00.000,ATP Masters Series Miami FL; U.S.A. ATP World Tour,HARD,2,Arnaud Clement,Peter Luczak,Arnaud Clement,6-1; 6-2,R128,58,9,1,27,40,24,27,8,13,0,0,8,32,40,3,0,27,44,14,27,7,17,1,5,7,21,44
2006-03-20 00:00:00.000,ATP Masters Series Miami FL; U.S.A. ATP World Tour,HARD,2,Luis Horna,Florian Mayer,Luis Horna,6-4; 7-6(5),R128,99,6,5,48,76,35,48,17,28,3,3,11,52,76,11,0,47,77,35,47,12,30,0,1,11,47,77
2006-03-20 00:00:00.000,ATP Masters Series Miami FL; U.S.A. ATP World Tour,HARD,2,Tommy Haas,N/A Bye,Tommy Haas,,R128,0,0,0,0,0,0,0,0,0,0,0,0,0,0,0,0,0,0,0,0,0,0,0,0,0,0,0
2006-03-20 00:00:00.000,ATP Masters Series Miami FL; U.S.A. ATP World Tour,HARD,2,Igor Andreev,N/A Bye,Igor Andreev,,R128,0,0,0,0,0,0,0,0,0,0,0,0,0,0,0,0,0,0,0,0,0,0,0,0,0,0,0
2006-03-20 00:00:00.000,ATP Masters Series Miami FL; U.S.A. ATP World Tour,HARD,2,George Bastl,Daniele Bracciali,George Bastl,6-7(5); 6-1; 6-4,R128,156,11,1,80,130,52,80,30,50,10,10,15,82,130,6,5,46,94,35,46,24,48,5,8,14,59,94
2006-03-20 00:00:00.000,ATP Masters Series Miami FL; U.S.A. ATP World Tour,HARD,2,Dmitry Tursunov,Paul Capdeville,Dmitry Tursunov,6-2; 6-1,R128,54,7,1,21,43,20,21,11,22,0,1,8,31,43,1,4,24,43,12,24,5,19,1,6,7,17,43
2006-03-20 00:00:00.000,ATP Masters Series Miami FL; U.S.A. ATP World Tour,HARD,2,Juan Carlos Ferrero,N/A Bye,Juan Carlos Ferrero,,R128,0,0,0,0,0,0,0,0,0,0,0,0,0,0,0,0,0,0,0,0,0,0,0,0,0,0,0
2006-03-20 00:00:00.000,ATP Masters Series Miami FL; U.S.A. ATP World Tour,HARD,2,James Blake,N/A Bye,James Blake,,R128,0,0,0,0,0,0,0,0,0,0,0,0,0,0,0,0,0,0,0,0,0,0,0,0,0,0,0
2006-03-20 00:00:00.000,ATP Masters Series Miami FL; U.S.A. ATP World Tour,HARD,2,Carlos Berlocq,Donald Young,Carlos Berlocq,6-0; 6-0,R128,49,2,0,21,39,15,21,12,18,2,2,6,27,39,0,3,18,33,6,18,2,15,2,8,6,8,33
2006-03-20 00:00:00.000,ATP Masters Series Miami FL; U.S.A. ATP World Tour,HARD,2,Mark Philippoussis,Davide Sanguinetti,Mark Philippoussis,6-4; 4-6; 6-3,R128,120,15,4,49,97,37,49,27,48,6,8,15,64,97,9,2,44,83,34,44,19,39,2,5,14,53,83
2006-03-20 00:00:00.000,ATP Masters Series Miami FL; U.S.A. ATP World Tour,HARD,2,Jarkko Nieminen,N/A Bye,Jarkko Nieminen,,R128,0,0,0,0,0,0,0,0,0,0,0,0,0,0,0,0,0,0,0,0,0,0,0,0,0,0,0
2006-03-20 00:00:00.000,ATP Masters Series Miami FL; U.S.A. ATP World Tour,HARD,2,Juan Ignacio Chela,N/A Bye,Juan Ignacio Chela,,R128,0,0,0,0,0,0,0,0,0,0,0,0,0,0,0,0,0,0,0,0,0,0,0,0,0,0,0
2006-03-20 00:00:00.000,ATP Masters Series Miami FL; U.S.A. ATP World Tour,HARD,2,Greg Rusedski,Mikhail Youzhny,Greg Rusedski,6-3; 6-1,R128,71,4,5,26,48,19,26,13,22,2,3,8,32,48,4,6,32,61,18,32,12,29,3,8,8,30,61
2006-03-20 00:00:00.000,ATP Masters Series Miami FL; U.S.A. ATP World Tour,HARD,2,Kristof Vliegen,Boris Pashanski,Kristof Vliegen,6-2; 4-6; 6-3,R128,114,14,3,48,78,41,48,16,30,2,3,14,57,78,0,2,49,83,39,49,13,34,3,6,13,52,83
2006-03-20 00:00:00.000,ATP Masters Series Miami FL; U.S.A. ATP World Tour,HARD,2,Gaston Gaudio,N/A Bye,Gaston Gaudio,,R128,0,0,0,0,0,0,0,0,0,0,0,0,0,0,0,0,0,0,0,0,0,0,0,0,0,0,0
2006-03-20 00:00:00.000,ATP Masters Series Miami FL; U.S.A. ATP World Tour,HARD,2,Andy Roddick,N/A Bye,Andy Roddick,,R128,0,0,0,0,0,0,0,0,0,0,0,0,0,0,0,0,0,0,0,0,0,0,0,0,0,0,0
2006-03-20 00:00:00.000,ATP Masters Series Miami FL; U.S.A. ATP World Tour,HARD,2,Alberto Martin,Andrei Pavel,Alberto Martin,6-2; 6-2,R128,65,5,2,25,53,19,25,15,28,3,4,8,34,53,4,4,39,61,24,39,4,22,9,14,8,28,61
2006-03-20 00:00:00.000,ATP Masters Series Miami FL; U.S.A. ATP World Tour,HARD,2,Vincent Spadea,Andreas Seppi,Vincent Spadea,6-1; 6-4,R128,74,4,2,33,57,23,33,16,24,3,4,9,39,57,1,1,26,54,17,26,11,28,4,8,8,28,54
2006-03-20 00:00:00.000,ATP Masters Series Miami FL; U.S.A. ATP World Tour,HARD,2,Fernando Verdasco,N/A Bye,Fernando Verdasco,,R128,0,0,0,0,0,0,0,0,0,0,0,0,0,0,0,0,0,0,0,0,0,0,0,0,0,0,0
2006-03-20 00:00:00.000,ATP Masters Series Miami FL; U.S.A. ATP World Tour,HARD,2,Dominik Hrbaty,N/A Bye,Dominik Hrbaty,,R128,0,0,0,0,0,0,0,0,0,0,0,0,0,0,0,0,0,0,0,0,0,0,0,0,0,0,0
2006-03-20 00:00:00.000,ATP Masters Series Miami FL; U.S.A. ATP World Tour,HARD,2,Simon Greul,Paradorn Srichaphan,Simon Greul,5-7; 6-2; 7-5,R128,143,6,3,53,106,40,53,31,53,8,9,16,71,106,10,7,74,126,55,74,21,52,8,11,16,76,126
2006-03-20 00:00:00.000,ATP Masters Series Miami FL; U.S.A. ATP World Tour,HARD,2,Tim Henman,Marat Safin,Tim Henman,6-3; 6-3,R128,76,3,0,28,49,21,28,12,21,0,1,9,33,49,3,2,36,68,21,36,15,32,5,9,9,36,68
2006-03-20 00:00:00.000,ATP Masters Series Miami FL; U.S.A. ATP World Tour,HARD,2,Lleyton Hewitt,N/A Bye,Lleyton Hewitt,,R128,0,0,0,0,0,0,0,0,0,0,0,0,0,0,0,0,0,0,0,0,0,0,0,0,0,0,0
2006-03-20 00:00:00.000,ATP Masters Series Miami FL; U.S.A. ATP World Tour,HARD,2,David Ferrer,N/A Bye,David Ferrer,,R128,0,0,0,0,0,0,0,0,0,0,0,0,0,0,0,0,0,0,0,0,0,0,0,0,0,0,0
2006-03-20 00:00:00.000,ATP Masters Series Miami FL; U.S.A. ATP World Tour,HARD,2,Albert Montanes,Igor Kunitsyn,Albert Montanes,6-4; 6-2,R128,92,2,0,33,56,23,33,15,23,4,5,9,38,56,0,0,30,52,19,30,8,22,0,4,9,27,52
2006-03-20 00:00:00.000,ATP Masters Series Miami FL; U.S.A. ATP World Tour,HARD,2,Feliciano Lopez,Alex Kuznetsov,Feliciano Lopez,6-4; 4-6; 6-1,R128,102,6,4,36,74,29,36,19,38,2,5,13,48,74,0,5,54,87,30,54,16,33,2,8,14,46,87
2006-03-20 00:00:00.000,ATP Masters Series Miami FL; U.S.A. ATP World Tour,HARD,2,Sebastien Grosjean,N/A Bye,Sebastien Grosjean,,R128,0,0,0,0,0,0,0,0,0,0,0,0,0,0,0,0,0,0,0,0,0,0,0,0,0,0,0
2006-03-20 00:00:00.000,ATP Masters Series Miami FL; U.S.A. ATP World Tour,HARD,2,Olivier Rochus,N/A Bye,Olivier Rochus,,R128,0,0,0,0,0,0,0,0,0,0,0,0,0,0,0,0,0,0,0,0,0,0,0,0,0,0,0
2006-03-20 00:00:00.000,ATP Masters Series Miami FL; U.S.A. ATP World Tour,HARD,2,Max Mirnyi,Gilles Muller,Max Mirnyi,7-6(5); 5-7; 6-4,R128,193,19,9,53,94,50,53,22,41,2,3,17,72,94,13,3,74,112,59,74,18,38,2,3,17,77,112
2006-03-20 00:00:00.000,ATP Masters Series Miami FL; U.S.A. ATP World Tour,HARD,2,Novak Djokovic,Paul-Henri Mathieu,Novak Djokovic,6-1; 6-3,R128,57,8,1,26,36,26,26,6,10,0,0,8,32,36,3,2,30,50,18,30,8,20,3,7,8,26,50
2006-03-20 00:00:00.000,ATP Masters Series Miami FL; U.S.A. ATP World Tour,HARD,2,Guillermo Coria,N/A Bye,Guillermo Coria,,R128,0,0,0,0,0,0,0,0,0,0,0,0,0,0,0,0,0,0,0,0,0,0,0,0,0,0,0
2006-03-20 00:00:00.000,ATP Masters Series Miami FL; U.S.A. ATP World Tour,HARD,2,Nikolay Davydenko,N/A Bye,Nikolay Davydenko,,R128,0,0,0,0,0,0,0,0,0,0,0,0,0,0,0,0,0,0,0,0,0,0,0,0,0,0,0
2006-03-20 00:00:00.000,ATP Masters Series Miami FL; U.S.A. ATP World Tour,HARD,2,Mardy Fish,Jan Hernych,Mardy Fish,6-3; 6-3,R128,81,5,0,41,60,30,41,13,19,4,4,9,43,60,0,1,48,70,28,48,10,22,7,10,9,38,70
2006-03-20 00:00:00.000,ATP Masters Series Miami FL; U.S.A. ATP World Tour,HARD,2,Alex Bogomolov Jr.,Sam Querrey,Alex Bogomolov Jr.,4-6; 6-4; 6-3,R128,88,3,2,45,79,35,45,19,34,0,2,15,54,79,21,0,47,72,39,47,11,25,2,5,14,50,72
2006-03-20 00:00:00.000,ATP Masters Series Miami FL; U.S.A. ATP World Tour,HARD,2,Marcos Baghdatis,N/A Bye,Marcos Baghdatis,,R128,0,0,0,0,0,0,0,0,0,0,0,0,0,0,0,0,0,0,0,0,0,0,0,0,0,0,0
2006-03-20 00:00:00.000,ATP Masters Series Miami FL; U.S.A. ATP World Tour,HARD,2,Mario Ancic,N/A Bye,Mario Ancic,,R128,0,0,0,0,0,0,0,0,0,0,0,0,0,0,0,0,0,0,0,0,0,0,0,0,0,0,0
2006-03-20 00:00:00.000,ATP Masters Series Miami FL; U.S.A. ATP World Tour,HARD,2,Kevin Kim,Jurgen Melzer,Kevin Kim,3-6; 6-2; 6-3,R128,101,7,0,50,85,38,50,19,35,2,4,13,57,85,8,8,33,79,25,33,21,46,4,8,13,46,79
2006-03-20 00:00:00.000,ATP Masters Series Miami FL; U.S.A. ATP World Tour,HARD,2,Florent Serra,Gilles Simon,Florent Serra,6-2; 6-4,R128,68,3,2,27,58,20,27,18,31,2,3,9,38,58,7,1,21,50,15,21,13,29,4,8,9,28,50
2006-03-20 00:00:00.000,ATP Masters Series Miami FL; U.S.A. ATP World Tour,HARD,2,Richard Gasquet,N/A Bye,Richard Gasquet,,R128,0,0,0,0,0,0,0,0,0,0,0,0,0,0,0,0,0,0,0,0,0,0,0,0,0,0,0
2006-03-20 00:00:00.000,ATP Masters Series Miami FL; U.S.A. ATP World Tour,HARD,2,Radek Stepanek,N/A Bye,Radek Stepanek,,R128,0,0,0,0,0,0,0,0,0,0,0,0,0,0,0,0,0,0,0,0,0,0,0,0,0,0,0
2006-03-20 00:00:00.000,ATP Masters Series Miami FL; U.S.A. ATP World Tour,HARD,2,Xavier Malisse,Nicolas Lapentti,Xavier Malisse,3-6; 6-3; 6-0,R128,99,6,4,41,76,31,41,17,35,6,9,12,48,76,8,1,46,68,29,46,6,22,5,11,12,35,68
2006-03-20 00:00:00.000,ATP Masters Series Miami FL; U.S.A. ATP World Tour,HARD,2,Nicolas Massu,Raemon Sluiter,Nicolas Massu,6-4; 6-3,R128,79,6,3,29,54,23,29,13,25,1,2,9,36,54,4,2,31,55,17,31,13,24,2,6,10,30,55
2006-03-20 00:00:00.000,ATP Masters Series Miami FL; U.S.A. ATP World Tour,HARD,2,Tommy Robredo,N/A Bye,Tommy Robredo,,R128,0,0,0,0,0,0,0,0,0,0,0,0,0,0,0,0,0,0,0,0,0,0,0,0,0,0,0
2006-03-20 00:00:00.000,ATP Masters Series Miami FL; U.S.A. ATP World Tour,HARD,2,Tomas Berdych,N/A Bye,Tomas Berdych,,R128,0,0,0,0,0,0,0,0,0,0,0,0,0,0,0,0,0,0,0,0,0,0,0,0,0,0,0
2006-03-20 00:00:00.000,ATP Masters Series Miami FL; U.S.A. ATP World Tour,HARD,2,Jose Acasuso,Tomas Zib,Jose Acasuso,5-7; 6-1; 6-1,R128,100,21,1,38,67,33,38,17,29,3,5,13,50,67,6,7,55,85,31,55,13,30,8,14,13,44,85
2006-03-20 00:00:00.000,ATP Masters Series Miami FL; U.S.A. ATP World Tour,HARD,2,Paul Goldstein,Justin Gimelstob,Paul Goldstein,3-6; 7-6(6); 1-1 RET,R128,126,0,3,55,79,36,55,17,24,4,6,11,53,79,7,6,44,95,31,44,29,51,6,7,12,60,95
2006-03-20 00:00:00.000,ATP Masters Series Miami FL; U.S.A. ATP World Tour,HARD,2,David Nalbandian,N/A Bye,David Nalbandian,,R128,0,0,0,0,0,0,0,0,0,0,0,0,0,0,0,0,0,0,0,0,0,0,0,0,0,0,0
2006-03-20 00:00:00.000,ATP Masters Series Miami FL; U.S.A. ATP World Tour,HARD,2,Ivan Ljubicic,N/A Bye,Ivan Ljubicic,,R128,0,0,0,0,0,0,0,0,0,0,0,0,0,0,0,0,0,0,0,0,0,0,0,0,0,0,0
2006-03-20 00:00:00.000,ATP Masters Series Miami FL; U.S.A. ATP World Tour,HARD,2,Robin Vik,Jonas Bjorkman,Robin Vik,6-4; 6-4,R128,90,4,3,40,67,29,40,13,27,1,3,10,42,67,1,4,31,61,26,31,10,30,6,10,10,36,61
2006-03-20 00:00:00.000,ATP Masters Series Miami FL; U.S.A. ATP World Tour,HARD,2,Michael Llodra,Lukas Dlouhy,Michael Llodra,6-7(4); 6-0; 6-3,R128,106,10,2,55,80,41,55,12,25,2,4,13,53,80,2,5,40,88,24,40,20,48,1,8,14,44,88
2006-03-20 00:00:00.000,ATP Masters Series Miami FL; U.S.A. ATP World Tour,HARD,2,Filippo Volandri,N/A Bye,Filippo Volandri,,R128,0,0,0,0,0,0,0,0,0,0,0,0,0,0,0,0,0,0,0,0,0,0,0,0,0,0,0
2006-03-20 00:00:00.000,ATP Masters Series Miami FL; U.S.A. ATP World Tour,HARD,2,Robby Ginepri,N/A Bye,Robby Ginepri,,R128,0,0,0,0,0,0,0,0,0,0,0,0,0,0,0,0,0,0,0,0,0,0,0,0,0,0,0
2006-03-20 00:00:00.000,ATP Masters Series Miami FL; U.S.A. ATP World Tour,HARD,2,Kenneth Carlsen,Cyril Saulnier,Kenneth Carlsen,3-6; 6-3; 6-0,R128,98,14,2,49,80,38,49,14,31,2,3,12,52,80,4,4,37,64,25,37,12,27,1,5,12,37,64
2006-03-20 00:00:00.000,ATP Masters Series Miami FL; U.S.A. ATP World Tour,HARD,2,Christophe Rochus,Wesley Moodie,Christophe Rochus,2-6; 6-4; 6-4,R128,113,1,4,65,87,43,65,9,22,2,6,14,52,87,12,10,57,86,45,57,9,29,9,13,14,54,86
2006-03-20 00:00:00.000,ATP Masters Series Miami FL; U.S.A. ATP World Tour,HARD,2,Bjorn Phau,N/A Bye,Bjorn Phau,,R128,0,0,0,0,0,0,0,0,0,0,0,0,0,0,0,0,0,0,0,0,0,0,0,0,0,0,0
2006-03-20 00:00:00.000,ATP Masters Series Miami FL; U.S.A. ATP World Tour,HARD,2,Nicolas Kiefer,N/A Bye,Nicolas Kiefer,,R128,0,0,0,0,0,0,0,0,0,0,0,0,0,0,0,0,0,0,0,0,0,0,0,0,0,0,0
2006-03-20 00:00:00.000,ATP Masters Series Miami FL; U.S.A. ATP World Tour,HARD,2,Fabrice Santoro,Ivo Karlovic,Fabrice Santoro,6-3; 7-6(5),R128,94,2,2,57,73,42,57,9,16,0,0,11,51,73,9,1,36,63,30,36,14,27,3,4,10,44,63
2006-03-20 00:00:00.000,ATP Masters Series Miami FL; U.S.A. ATP World Tour,HARD,2,Stanislas Wawrinka,Andy Murray,Stanislas Wawrinka,7-5; 3-6; 6-4,R128,127,1,8,65,105,41,65,16,40,5,11,16,57,105,5,2,49,91,24,49,25,42,7,13,15,49,91
2006-03-20 00:00:00.000,ATP Masters Series Miami FL; U.S.A. ATP World Tour,HARD,2,Fernando Gonzalez,N/A Bye,Fernando Gonzalez,,R128,0,0,0,0,0,0,0,0,0,0,0,0,0,0,0,0,0,0,0,0,0,0,0,0,0,0,0
2006-03-20 00:00:00.000,ATP Masters Series Miami FL; U.S.A. ATP World Tour,HARD,2,Gael Monfils,N/A Bye,Gael Monfils,,R128,0,0,0,0,0,0,0,0,0,0,0,0,0,0,0,0,0,0,0,0,0,0,0,0,0,0,0
2006-03-20 00:00:00.000,ATP Masters Series Miami FL; U.S.A. ATP World Tour,HARD,2,Agustin Calleri,Juan Monaco,Agustin Calleri,6-2; 6-1,R128,62,2,3,29,51,22,29,13,22,1,1,8,35,51,2,0,23,44,11,23,9,21,2,6,7,20,44
2006-03-20 00:00:00.000,ATP Masters Series Miami FL; U.S.A. ATP World Tour,HARD,2,Carlos Moya,Victor Hanescu,Carlos Moya,5-7; 7-5; 6-4,R128,120,2,3,49,89,39,49,27,40,3,4,17,66,89,7,2,62,92,43,62,20,30,2,4,17,63,92
2006-03-20 00:00:00.000,ATP Masters Series Miami FL; U.S.A. ATP World Tour,HARD,2,Rafael Nadal,N/A Bye,Rafael Nadal,,R128,0,0,0,0,0,0,0,0,0,0,0,0,0,0,0,0,0,0,0,0,0,0,0,0,0,0,0
2006-03-20 00:00:00.000,ATP Masters Series Miami FL; U.S.A. ATP World Tour,HARD,2,Roger Federer,Arnaud Clement,Roger Federer,6-2; 6-7(4); 6-0,R64,119,6,2,60,94,44,60,16,34,3,4,13,60,94,2,3,39,75,22,39,19,36,3,9,13,41,75
2006-03-20 00:00:00.000,ATP Masters Series Miami FL; U.S.A. ATP World Tour,HARD,2,Tommy Haas,Luis Horna,Tommy Haas,6-0; 6-3,R64,59,5,3,27,46,23,27,10,19,2,2,8,33,46,5,7,27,42,19,27,3,15,4,8,7,22,42
2006-03-20 00:00:00.000,ATP Masters Series Miami FL; U.S.A. ATP World Tour,HARD,2,Igor Andreev,George Bastl,Igor Andreev,6-4; 6-4,R64,78,4,0,29,51,20,29,17,22,2,4,10,37,51,2,1,36,61,23,36,9,25,3,7,10,32,61
2006-03-20 00:00:00.000,ATP Masters Series Miami FL; U.S.A. ATP World Tour,HARD,2,Dmitry Tursunov,Juan Carlos Ferrero,Dmitry Tursunov,6-3; 7-6(0),R64,87,5,3,40,71,28,40,21,31,3,4,11,49,71,5,4,41,70,28,41,13,29,0,2,10,41,70
2006-03-20 00:00:00.000,ATP Masters Series Miami FL; U.S.A. ATP World Tour,HARD,2,James Blake,Carlos Berlocq,James Blake,6-0; 6-0,R64,54,2,1,21,35,16,21,10,14,2,2,6,26,35,1,4,22,44,11,22,4,22,6,12,6,15,44
2006-03-20 00:00:00.000,ATP Masters Series Miami FL; U.S.A. ATP World Tour,HARD,2,Jarkko Nieminen,Mark Philippoussis,Jarkko Nieminen,6-4; 7-6(3),R64,91,4,2,47,68,31,47,14,21,4,6,11,45,68,10,5,33,73,24,33,17,40,3,6,11,41,73
2006-03-20 00:00:00.000,ATP Masters Series Miami FL; U.S.A. ATP World Tour,HARD,2,Juan Ignacio Chela,Greg Rusedski,Juan Ignacio Chela,6-4; 6-4,R64,81,1,2,31,52,25,31,13,21,1,2,10,38,52,5,6,51,74,33,51,10,23,6,9,10,43,74
2006-03-20 00:00:00.000,ATP Masters Series Miami FL; U.S.A. ATP World Tour,HARD,2,Kristof Vliegen,Gaston Gaudio,Kristof Vliegen,7-5; 7-6(6),R64,114,8,3,53,84,39,53,18,31,2,3,12,57,84,2,5,44,84,32,44,21,40,1,3,12,53,84
2006-03-20 00:00:00.000,ATP Masters Series Miami FL; U.S.A. ATP World Tour,HARD,2,Andy Roddick,Alberto Martin,Andy Roddick,6-3; 6-1,R64,56,10,0,28,42,26,28,7,14,0,0,8,33,42,0,3,30,50,15,30,10,20,3,7,8,25,50
2006-03-20 00:00:00.000,ATP Masters Series Miami FL; U.S.A. ATP World Tour,HARD,2,Fernando Verdasco,Vincent Spadea,Fernando Verdasco,1-6; 6-4; 6-3,R64,100,6,7,43,75,27,43,10,32,2,8,13,37,75,4,4,34,67,23,34,14,33,1,7,13,37,67
2006-03-20 00:00:00.000,ATP Masters Series Miami FL; U.S.A. ATP World Tour,HARD,2,Simon Greul,Dominik Hrbaty,Simon Greul,7-6(6); 6-3,R64,95,7,3,45,87,32,45,18,42,4,8,11,50,87,4,7,40,68,25,40,9,28,5,10,10,34,68
2006-03-20 00:00:00.000,ATP Masters Series Miami FL; U.S.A. ATP World Tour,HARD,2,Tim Henman,Lleyton Hewitt,Tim Henman,7-6(5); 6-3,R64,107,3,1,47,79,36,47,11,32,2,5,11,47,79,3,4,41,73,28,41,11,32,5,9,10,39,73
2006-03-20 00:00:00.000,ATP Masters Series Miami FL; U.S.A. ATP World Tour,HARD,2,David Ferrer,Albert Montanes,David Ferrer,6-1; 6-1,R64,46,1,1,30,39,21,30,6,9,1,2,7,27,39,1,4,15,40,7,15,7,25,5,11,7,14,40
2006-03-20 00:00:00.000,ATP Masters Series Miami FL; U.S.A. ATP World Tour,HARD,2,Sebastien Grosjean,Feliciano Lopez,Sebastien Grosjean,6-3; 7-6(6),R64,91,6,2,34,64,25,34,21,30,1,2,11,46,64,5,3,46,70,35,46,9,24,3,5,10,44,70
2006-03-20 00:00:00.000,ATP Masters Series Miami FL; U.S.A. ATP World Tour,HARD,2,Olivier Rochus,Max Mirnyi,Olivier Rochus,6-4; 3-6; 6-1,R64,118,0,3,78,104,51,78,12,26,14,16,13,63,104,7,5,43,87,33,43,19,44,5,9,13,52,87
2006-03-20 00:00:00.000,ATP Masters Series Miami FL; U.S.A. ATP World Tour,HARD,2,Guillermo Coria,Novak Djokovic,Guillermo Coria,7-5; 6-1,R64,88,1,0,39,52,24,39,10,13,0,2,9,34,52,2,6,43,82,24,43,15,39,12,18,10,39,82
2006-03-20 00:00:00.000,ATP Masters Series Miami FL; U.S.A. ATP World Tour,HARD,2,Nikolay Davydenko,Mardy Fish,Nikolay Davydenko,6-4; 7-5,R64,96,1,3,39,60,29,39,13,21,0,1,11,42,60,6,3,42,85,26,42,22,43,4,7,11,48,85
2006-03-20 00:00:00.000,ATP Masters Series Miami FL; U.S.A. ATP World Tour,HARD,2,Marcos Baghdatis,Alex Bogomolov Jr.,Marcos Baghdatis,6-2; 6-4,R64,63,7,0,27,49,19,27,16,22,0,1,9,35,49,0,4,34,51,19,34,8,17,2,6,9,27,51
2006-03-20 00:00:00.000,ATP Masters Series Miami FL; U.S.A. ATP World Tour,HARD,2,Mario Ancic,Kevin Kim,Mario Ancic,6-3; 2-6; 6-4,R64,104,12,1,53,79,39,53,9,26,1,5,14,48,79,3,5,60,89,39,60,12,29,4,8,13,51,89
2006-03-20 00:00:00.000,ATP Masters Series Miami FL; U.S.A. ATP World Tour,HARD,2,Florent Serra,Richard Gasquet,Florent Serra,7-6(7); 6-3,R64,87,4,0,45,79,33,45,21,34,3,4,11,54,79,7,2,42,64,31,42,12,22,1,3,10,43,64
2006-03-20 00:00:00.000,ATP Masters Series Miami FL; U.S.A. ATP World Tour,HARD,2,Radek Stepanek,Xavier Malisse,Radek Stepanek,6-1; 6-4,R64,69,4,1,37,55,28,37,12,18,2,2,9,40,55,1,0,38,59,22,38,10,21,6,9,8,32,59
2006-03-20 00:00:00.000,ATP Masters Series Miami FL; U.S.A. ATP World Tour,HARD,2,Nicolas Massu,Tommy Robredo,Nicolas Massu,6-4; 6-4,R64,86,1,2,42,58,32,42,8,16,1,2,10,40,58,1,2,43,67,29,43,10,24,6,9,10,39,67
2006-03-20 00:00:00.000,ATP Masters Series Miami FL; U.S.A. ATP World Tour,HARD,2,Tomas Berdych,Jose Acasuso,Tomas Berdych,6-1; 6-2,R64,45,10,1,25,41,24,25,8,16,0,0,8,32,41,3,5,22,43,14,22,8,21,1,5,7,22,43
2006-03-20 00:00:00.000,ATP Masters Series Miami FL; U.S.A. ATP World Tour,HARD,2,David Nalbandian,Paul Goldstein,David Nalbandian,3-6; 7-5; 7-6(2),R64,170,2,6,77,120,50,77,21,43,12,17,16,71,120,1,4,64,122,40,64,32,58,10,15,17,72,122
2006-03-20 00:00:00.000,ATP Masters Series Miami FL; U.S.A. ATP World Tour,HARD,2,Ivan Ljubicic,Robin Vik,Ivan Ljubicic,6-3; 6-7(2); 6-3,R64,126,11,1,61,92,47,61,15,31,2,4,16,62,92,5,3,71,97,49,71,10,26,6,10,14,59,97
2006-03-20 00:00:00.000,ATP Masters Series Miami FL; U.S.A. ATP World Tour,HARD,2,Filippo Volandri,Michael Llodra,Filippo Volandri,3-6; 7-6(5); 6-2,R64,119,1,1,72,106,46,72,17,34,9,12,14,63,106,7,2,61,101,42,61,20,40,9,13,15,62,101
2006-03-20 00:00:00.000,ATP Masters Series Miami FL; U.S.A. ATP World Tour,HARD,2,Robby Ginepri,Kenneth Carlsen,Robby Ginepri,6-2; 7-5,R64,74,3,1,36,48,28,36,8,12,0,1,10,36,48,2,3,39,66,24,39,11,27,3,7,10,35,66
2006-03-20 00:00:00.000,ATP Masters Series Miami FL; U.S.A. ATP World Tour,HARD,2,Christophe Rochus,Bjorn Phau,Christophe Rochus,5-7; 6-4; 6-2,R64,122,3,7,74,111,52,74,16,37,10,13,15,68,111,8,6,49,99,34,49,20,50,6,11,15,54,99
2006-03-20 00:00:00.000,ATP Masters Series Miami FL; U.S.A. ATP World Tour,HARD,2,Nicolas Kiefer,Fabrice Santoro,Nicolas Kiefer,7-6(4); 2-6; 6-4,R64,150,6,2,56,94,37,56,19,38,7,12,15,56,94,7,4,59,119,40,59,27,60,12,16,15,67,119
2006-03-20 00:00:00.000,ATP Masters Series Miami FL; U.S.A. ATP World Tour,HARD,2,Fernando Gonzalez,Stanislas Wawrinka,Fernando Gonzalez,3-6; 6-2; 7-6(1),R64,105,4,1,50,77,36,50,15,27,1,4,14,51,77,3,11,45,85,34,45,18,40,2,6,15,52,85
2006-03-20 00:00:00.000,ATP Masters Series Miami FL; U.S.A. ATP World Tour,HARD,2,Agustin Calleri,Gael Monfils,Agustin Calleri,7-5; 6-4,R64,75,0,3,37,64,29,37,15,27,3,5,11,44,64,3,6,35,63,25,35,10,28,1,5,11,35,63
2006-03-20 00:00:00.000,ATP Masters Series Miami FL; U.S.A. ATP World Tour,HARD,2,Carlos Moya,Rafael Nadal,Carlos Moya,2-6; 6-1; 6-1,R64,103,6,2,42,67,32,42,10,25,0,3,11,42,67,2,3,47,74,27,47,11,27,6,12,11,38,74
2006-03-20 00:00:00.000,ATP Masters Series Miami FL; U.S.A. ATP World Tour,HARD,2,Roger Federer,Tommy Haas,Roger Federer,6-1; 6-3,R32,74,4,2,36,55,29,36,9,19,4,4,8,38,55,2,1,37,55,25,37,4,18,3,7,8,29,55
2006-03-20 00:00:00.000,ATP Masters Series Miami FL; U.S.A. ATP World Tour,HARD,2,Dmitry Tursunov,Igor Andreev,Dmitry Tursunov,6-3; 1-6; 6-4,R32,99,2,3,40,80,23,40,24,40,4,9,13,47,80,3,5,48,71,34,48,6,23,3,8,13,40,71
2006-03-20 00:00:00.000,ATP Masters Series Miami FL; U.S.A. ATP World Tour,HARD,2,James Blake,Jarkko Nieminen,James Blake,6-3; 4-6; 6-1,R32,98,12,1,44,85,32,44,22,41,8,11,13,54,85,2,5,59,100,35,59,16,41,13,19,13,51,100
2006-03-20 00:00:00.000,ATP Masters Series Miami FL; U.S.A. ATP World Tour,HARD,2,Juan Ignacio Chela,Kristof Vliegen,Juan Ignacio Chela,6-3; 7-6(3),R32,95,1,2,42,65,34,42,13,23,3,4,11,47,65,2,2,40,75,26,40,18,35,3,5,10,44,75
2006-03-20 00:00:00.000,ATP Masters Series Miami FL; U.S.A. ATP World Tour,HARD,2,Andy Roddick,Fernando Verdasco,Andy Roddick,6-3; 6-4,R32,69,8,1,39,51,32,39,7,12,2,3,10,39,51,5,3,39,56,28,39,5,17,4,7,9,33,56
2006-03-20 00:00:00.000,ATP Masters Series Miami FL; U.S.A. ATP World Tour,HARD,2,Simon Greul,Tim Henman,Simon Greul,0-6; 6-1; 7-5,R32,107,2,7,41,75,28,41,14,34,3,7,12,42,75,0,1,42,71,24,42,16,29,2,7,13,40,71
2006-03-20 00:00:00.000,ATP Masters Series Miami FL; U.S.A. ATP World Tour,HARD,2,David Ferrer,Sebastien Grosjean,David Ferrer,4-6; 7-5; 6-4,R32,168,1,5,80,116,50,80,16,36,5,11,16,66,116,6,2,48,106,32,48,25,58,11,18,16,57,106
2006-03-20 00:00:00.000,ATP Masters Series Miami FL; U.S.A. ATP World Tour,HARD,2,Olivier Rochus,Guillermo Coria,Olivier Rochus,6-4; 6-3,R32,84,1,4,34,50,26,34,9,16,3,4,9,35,50,0,6,55,67,33,55,1,12,3,7,10,34,67
2006-03-20 00:00:00.000,ATP Masters Series Miami FL; U.S.A. ATP World Tour,HARD,2,Nikolay Davydenko,Marcos Baghdatis,Nikolay Davydenko,2-6; 6-2; 7-5,R32,129,0,2,76,98,45,76,11,22,3,8,14,56,98,11,7,46,92,32,46,17,46,4,10,14,49,92
2006-03-20 00:00:00.000,ATP Masters Series Miami FL; U.S.A. ATP World Tour,HARD,2,Mario Ancic,Florent Serra,Mario Ancic,7-6(4); 6-7(11); 6-2,R32,171,17,4,69,106,56,69,18,37,2,4,16,74,106,4,3,63,116,45,63,29,53,4,8,16,74,116
2006-03-20 00:00:00.000,ATP Masters Series Miami FL; U.S.A. ATP World Tour,HARD,2,Radek Stepanek,Nicolas Massu,Radek Stepanek,6-7(6); 7-6(5); 7-5,R32,191,17,6,84,129,63,84,25,45,5,7,18,88,129,6,0,73,117,48,73,31,44,5,8,18,79,117
2006-03-20 00:00:00.000,ATP Masters Series Miami FL; U.S.A. ATP World Tour,HARD,2,David Nalbandian,Tomas Berdych,David Nalbandian,6-7(3); 6-1; 6-0,R32,125,2,1,65,90,45,65,17,25,2,2,13,62,90,6,8,43,92,30,43,21,49,7,12,12,51,92
2006-03-20 00:00:00.000,ATP Masters Series Miami FL; U.S.A. ATP World Tour,HARD,2,Ivan Ljubicic,Filippo Volandri,Ivan Ljubicic,6-2; 6-3,R32,55,11,0,28,41,24,28,7,13,0,2,9,31,41,0,1,37,54,17,37,7,17,5,10,8,24,54
2006-03-20 00:00:00.000,ATP Masters Series Miami FL; U.S.A. ATP World Tour,HARD,2,Christophe Rochus,Robby Ginepri,Christophe Rochus,4-6; 7-5; 6-3,R32,121,4,7,53,95,38,53,22,42,6,9,15,60,95,13,5,51,111,40,51,24,60,6,11,16,64,111
2006-03-20 00:00:00.000,ATP Masters Series Miami FL; U.S.A. ATP World Tour,HARD,2,Nicolas Kiefer,Fernando Gonzalez,Nicolas Kiefer,6-2; 3-6; 7-5,R32,143,5,4,52,99,36,52,25,47,7,11,14,61,99,5,8,43,85,28,43,20,42,5,11,15,48,85
2006-03-20 00:00:00.000,ATP Masters Series Miami FL; U.S.A. ATP World Tour,HARD,2,Agustin Calleri,Carlos Moya,Agustin Calleri,6-3; 7-6(6),R32,89,6,0,37,62,29,37,16,25,0,2,11,45,62,6,4,43,76,33,43,12,33,6,9,10,45,76
2006-03-20 00:00:00.000,ATP Masters Series Miami FL; U.S.A. ATP World Tour,HARD,2,Roger Federer,Dmitry Tursunov,Roger Federer,6-3; 6-3,R16,58,5,2,29,43,25,29,8,14,0,1,9,33,43,4,3,33,56,22,33,7,23,3,7,9,29,56
2006-03-20 00:00:00.000,ATP Masters Series Miami FL; U.S.A. ATP World Tour,HARD,2,James Blake,Juan Ignacio Chela,James Blake,4-6; 6-1; 6-0,R16,100,5,5,44,84,29,44,25,40,1,2,12,54,84,2,6,38,79,23,38,19,41,6,11,11,42,79
2006-03-20 00:00:00.000,ATP Masters Series Miami FL; U.S.A. ATP World Tour,HARD,2,Andy Roddick,Simon Greul,Andy Roddick,6-3; 3-6; 6-2,R16,94,9,0,43,63,36,43,15,20,1,2,13,51,63,4,5,48,83,31,48,19,35,3,6,13,50,83
2006-03-20 00:00:00.000,ATP Masters Series Miami FL; U.S.A. ATP World Tour,HARD,2,David Ferrer,Olivier Rochus,David Ferrer,6-7(5); 7-6(2); 7-5,R16,198,6,2,96,133,60,96,20,37,6,10,18,80,133,1,1,85,132,51,85,23,47,4,9,18,74,132
2006-03-20 00:00:00.000,ATP Masters Series Miami FL; U.S.A. ATP World Tour,HARD,2,Mario Ancic,Nikolay Davydenko,Mario Ancic,7-5; 6-4,R16,88,9,0,41,58,29,41,11,17,4,6,11,40,58,2,1,48,63,28,48,7,15,2,6,11,35,63
2006-03-20 00:00:00.000,ATP Masters Series Miami FL; U.S.A. ATP World Tour,HARD,2,David Nalbandian,Radek Stepanek,David Nalbandian,6-3; 6-4,R16,90,0,2,46,73,30,46,13,27,4,6,10,43,73,0,7,19,49,13,19,12,30,0,4,9,25,49
2006-03-20 00:00:00.000,ATP Masters Series Miami FL; U.S.A. ATP World Tour,HARD,2,Ivan Ljubicic,Christophe Rochus,Ivan Ljubicic,6-3; 6-1,R16,57,13,0,28,48,23,28,9,20,3,4,8,32,48,0,1,33,41,18,33,1,8,2,7,8,19,41
2006-03-20 00:00:00.000,ATP Masters Series Miami FL; U.S.A. ATP World Tour,HARD,2,Agustin Calleri,Nicolas Kiefer,Agustin Calleri,3-6; 6-3; 7-5,R16,136,11,2,54,95,41,54,25,41,3,4,15,66,95,8,4,53,92,37,53,21,39,3,5,15,58,92
2006-03-20 00:00:00.000,ATP Masters Series Miami FL; U.S.A. ATP World Tour,HARD,2,Roger Federer,James Blake,Roger Federer,7-6(2); 6-4,Q,87,6,1,46,78,32,46,22,32,2,3,11,54,78,4,4,36,71,29,36,17,35,2,4,11,46,71
2006-03-20 00:00:00.000,ATP Masters Series Miami FL; U.S.A. ATP World Tour,HARD,2,David Ferrer,Andy Roddick,David Ferrer,6-3; 4-6; 6-4,Q,112,0,1,54,84,40,54,15,30,2,5,15,55,84,10,2,50,80,39,50,10,30,4,8,14,49,80
2006-03-20 00:00:00.000,ATP Masters Series Miami FL; U.S.A. ATP World Tour,HARD,2,David Nalbandian,Mario Ancic,David Nalbandian,6-2; 6-2,Q,57,3,0,32,41,28,32,6,9,1,1,8,34,41,7,3,23,41,13,23,6,18,0,4,8,19,41
2006-03-20 00:00:00.000,ATP Masters Series Miami FL; U.S.A. ATP World Tour,HARD,2,Ivan Ljubicic,Agustin Calleri,Ivan Ljubicic,7-6(4); 6-3,Q,100,14,3,37,57,36,37,10,20,0,0,10,46,57,2,4,47,83,35,47,18,36,6,8,11,53,83
2006-03-20 00:00:00.000,ATP Masters Series Miami FL; U.S.A. ATP World Tour,HARD,2,Roger Federer,David Ferrer,Roger Federer,6-1; 6-4,S,60,2,1,35,52,27,35,10,17,2,3,9,37,52,0,2,38,52,21,38,6,14,1,5,8,27,52
2006-03-20 00:00:00.000,ATP Masters Series Miami FL; U.S.A. ATP World Tour,HARD,2,Ivan Ljubicic,David Nalbandian,Ivan Ljubicic,6-1; 6-2,S,73,12,0,26,37,25,26,7,11,0,0,8,32,37,1,0,47,66,20,47,12,19,13,17,7,32,66
2006-03-20 00:00:00.000,ATP Masters Series Miami FL; U.S.A. ATP World Tour,HARD,2,Roger Federer,Ivan Ljubicic,Roger Federer,7-6(5); 7-6(4); 7-6(6),F,177,8,3,78,124,58,78,29,46,5,7,18,87,124,21,3,68,121,53,68,31,53,5,7,18,84,121
2006-04-10 00:00:00.000,Houston TX; U.S.A. ATP World Tour,CLAY,2,Andy Roddick,Paul Capdeville,Andy Roddick,6-3; 6-2,R32,59,3,0,30,46,21,30,13,16,0,1,9,34,46,1,2,33,53,20,33,6,20,4,8,8,26,53
2006-04-10 00:00:00.000,Houston TX; U.S.A. ATP World Tour,CLAY,2,Oliver Marach,Juan Antonio Marin,Oliver Marach,6-4; 6-1,R32,80,8,3,30,52,27,30,9,22,3,3,8,36,52,3,1,26,56,20,26,11,30,2,6,9,31,56
2006-04-10 00:00:00.000,Houston TX; U.S.A. ATP World Tour,CLAY,2,Alexander Waske,Jiri Vanek,Alexander Waske,6-4; 2-6; 7-6(2),R32,156,10,7,52,105,41,52,23,53,3,7,15,64,105,2,5,73,104,47,73,18,31,6,9,15,65,104
2006-04-10 00:00:00.000,Houston TX; U.S.A. ATP World Tour,CLAY,2,Tommy Haas,Oscar Hernandez,Tommy Haas,6-1; 6-4,R32,74,5,4,31,55,21,31,16,24,1,2,9,37,55,0,6,32,52,19,32,8,20,3,7,8,27,52
2006-04-10 00:00:00.000,Houston TX; U.S.A. ATP World Tour,CLAY,2,Marcos Baghdatis,Jesse Witten,Marcos Baghdatis,6-4; 7-6(2),R32,77,2,3,39,64,31,39,15,25,2,3,11,46,64,1,0,34,60,27,34,15,26,2,4,11,42,60
2006-04-10 00:00:00.000,Houston TX; U.S.A. ATP World Tour,CLAY,2,Vincent Spadea,Carlos Berlocq,Vincent Spadea,6-1; 6-3,R32,67,2,1,22,45,16,22,13,23,3,5,8,29,45,0,3,28,54,15,28,8,26,4,10,8,23,54
2006-04-10 00:00:00.000,Houston TX; U.S.A. ATP World Tour,CLAY,2,Rainer Schuettler,Gilles Muller,Rainer Schuettler,6-0; 6-3,R32,65,2,2,21,40,17,21,12,19,1,2,8,29,40,2,1,28,56,16,28,9,28,5,10,7,25,56
2006-04-10 00:00:00.000,Houston TX; U.S.A. ATP World Tour,CLAY,2,Mardy Fish,Juan Monaco,Mardy Fish,6-2; 1-6; 7-6(5),R32,149,12,4,65,115,44,65,25,50,15,18,13,69,115,1,0,78,106,50,78,13,28,8,11,14,63,106
2006-04-10 00:00:00.000,Houston TX; U.S.A. ATP World Tour,CLAY,2,Paul Goldstein,Janko Tipsarevic,Paul Goldstein,6-3; 6-3,R32,72,1,1,36,50,27,36,8,14,1,2,9,35,50,3,1,30,56,23,30,7,26,2,6,9,30,56
2006-04-10 00:00:00.000,Houston TX; U.S.A. ATP World Tour,CLAY,2,Scoville Jenkins,Igor Kunitsyn,Scoville Jenkins,7-5; 2-6; 6-3,R32,143,6,5,62,93,44,62,13,31,4,8,15,57,93,3,2,65,98,40,65,18,33,6,10,14,58,98
2006-04-10 00:00:00.000,Houston TX; U.S.A. ATP World Tour,CLAY,2,Tomas Behrend,Razvan Sabau,Tomas Behrend,7-5; 5-7; 7-5,R32,141,7,8,69,124,47,69,25,55,1,7,18,72,124,0,6,77,117,49,77,16,40,8,15,18,65,117
2006-04-10 00:00:00.000,Houston TX; U.S.A. ATP World Tour,CLAY,2,Albert Montanes,Robby Ginepri,Albert Montanes,6-4; 6-4,R32,99,3,3,33,62,28,33,13,29,4,6,10,41,62,4,1,46,68,30,46,6,22,4,8,10,36,68
2006-04-10 00:00:00.000,Houston TX; U.S.A. ATP World Tour,CLAY,2,Marcos Daniel,Luis Horna,Marcos Daniel,6-3; 6-4,R32,83,4,0,34,65,23,34,21,31,2,3,10,44,65,1,3,27,49,20,27,9,22,5,8,9,29,49
2006-04-10 00:00:00.000,Houston TX; U.S.A. ATP World Tour,CLAY,2,Jurgen Melzer,Ivo Minar,Jurgen Melzer,7-6(7); 6-0,R32,67,4,2,30,62,22,30,20,32,1,2,9,42,62,4,4,37,62,23,37,10,25,2,6,9,33,62
2006-04-10 00:00:00.000,Houston TX; U.S.A. ATP World Tour,CLAY,2,Fernando Vicente,Bobby Reynolds,Fernando Vicente,6-2; 6-1,R32,55,2,0,25,42,21,25,12,17,2,2,8,33,42,2,2,27,41,17,27,4,14,1,5,7,21,41
2006-04-10 00:00:00.000,Houston TX; U.S.A. ATP World Tour,CLAY,2,Antony Dupuis,James Blake,Antony Dupuis,7-6(2); 3-6; 6-1,R32,107,9,4,58,93,43,58,20,35,6,8,14,63,93,3,1,38,74,27,38,23,36,1,4,14,50,74
2006-04-10 00:00:00.000,Houston TX; U.S.A. ATP World Tour,CLAY,2,Andy Roddick,Oliver Marach,Andy Roddick,6-3; 6-4,R16,80,5,1,47,67,36,47,12,20,6,6,10,48,67,5,4,27,51,24,27,10,24,1,3,9,34,51
2006-04-10 00:00:00.000,Houston TX; U.S.A. ATP World Tour,CLAY,2,Tommy Haas,Alexander Waske,Tommy Haas,6-1; 7-6(7),R16,84,3,1,36,67,28,36,17,31,1,3,10,45,67,2,4,38,64,25,38,9,26,3,7,9,34,64
2006-04-10 00:00:00.000,Houston TX; U.S.A. ATP World Tour,CLAY,2,Vincent Spadea,Marcos Baghdatis,Vincent Spadea,6-2; 3-1 RET,R16,47,2,0,17,31,13,17,7,14,0,1,6,20,31,1,1,21,39,10,21,7,18,1,5,6,17,39
2006-04-10 00:00:00.000,Houston TX; U.S.A. ATP World Tour,CLAY,2,Mardy Fish,Rainer Schuettler,Mardy Fish,W/O,R16,0,0,0,0,0,0,0,0,0,0,0,0,0,0,0,0,0,0,0,0,0,0,0,0,0,0,0
2006-04-10 00:00:00.000,Houston TX; U.S.A. ATP World Tour,CLAY,2,Paul Goldstein,Scoville Jenkins,Paul Goldstein,6-4; 6-1,R16,79,1,1,37,47,28,37,6,10,1,1,8,34,47,4,4,41,67,21,41,13,26,5,9,9,34,67
2006-04-10 00:00:00.000,Houston TX; U.S.A. ATP World Tour,CLAY,2,Albert Montanes,Tomas Behrend,Albert Montanes,6-2; 6-3,R16,70,5,8,26,52,21,26,13,26,1,2,8,34,52,3,5,41,69,24,41,10,28,0,5,9,34,69
2006-04-10 00:00:00.000,Houston TX; U.S.A. ATP World Tour,CLAY,2,Jurgen Melzer,Marcos Daniel,Jurgen Melzer,7-6(2); 6-4,R16,90,0,3,35,71,25,35,20,36,1,4,11,45,71,3,1,37,62,22,37,14,25,2,6,11,36,62
2006-04-10 00:00:00.000,Houston TX; U.S.A. ATP World Tour,CLAY,2,Fernando Vicente,Antony Dupuis,Fernando Vicente,6-2; 7-5,R16,88,2,1,36,58,25,36,14,22,5,7,10,39,58,3,1,34,69,17,34,18,35,4,9,10,35,69
2006-04-10 00:00:00.000,Houston TX; U.S.A. ATP World Tour,CLAY,2,Tommy Haas,Andy Roddick,Tommy Haas,6-7(1); 6-4; 6-4,Q,131,6,5,59,105,44,59,24,46,6,8,16,68,105,11,3,59,92,43,59,15,33,5,9,16,58,92
2006-04-10 00:00:00.000,Houston TX; U.S.A. ATP World Tour,CLAY,2,Mardy Fish,Vincent Spadea,Mardy Fish,4-6; 7-6(1); 6-2,Q,141,4,3,58,110,38,58,27,52,10,15,15,65,110,1,5,53,103,35,53,22,50,7,13,15,57,103
2006-04-10 00:00:00.000,Houston TX; U.S.A. ATP World Tour,CLAY,2,Paul Goldstein,Albert Montanes,Paul Goldstein,6-3; 6-4,Q,78,1,1,57,77,36,57,10,20,5,7,10,46,77,3,6,27,50,19,27,7,23,0,4,9,26,50
2006-04-10 00:00:00.000,Houston TX; U.S.A. ATP World Tour,CLAY,2,Jurgen Melzer,Fernando Vicente,Jurgen Melzer,7-5; 6-4,Q,97,1,2,61,79,36,61,9,18,8,11,11,45,79,1,2,40,72,23,40,13,32,3,8,11,36,72
2006-04-10 00:00:00.000,Houston TX; U.S.A. ATP World Tour,CLAY,2,Mardy Fish,Tommy Haas,Mardy Fish,4-1 RET,S,18,3,0,10,14,9,10,3,4,0,0,3,12,14,2,0,12,16,6,12,2,4,3,4,2,8,16
2006-04-10 00:00:00.000,Houston TX; U.S.A. ATP World Tour,CLAY,2,Jurgen Melzer,Paul Goldstein,Jurgen Melzer,6-3; 6-4,S,70,5,2,37,56,26,37,10,19,2,5,10,36,56,0,2,30,53,16,30,10,23,5,10,9,26,53
2006-04-10 00:00:00.000,Houston TX; U.S.A. ATP World Tour,CLAY,2,Mardy Fish,Jurgen Melzer,Mardy Fish,3-6; 6-4; 6-3,F,112,6,6,46,81,39,46,17,35,4,6,14,56,81,1,3,58,80,41,58,9,22,6,9,14,50,80
2006-04-10 00:00:00.000,Valencia Spain ATP World Tour,CLAY,2,Jan Hernych,Nikolay Davydenko,Jan Hernych,7-5; 7-5,R32,109,0,3,46,77,30,46,13,31,3,7,12,43,77,0,2,52,73,31,52,6,21,3,9,12,37,73
2006-04-10 00:00:00.000,Valencia Spain ATP World Tour,CLAY,2,Guillermo Garcia-Lopez,Feliciano Lopez,Guillermo Garcia-Lopez,6-3; 6-3,R32,76,3,7,42,71,27,42,9,29,6,11,10,36,71,1,1,33,61,21,33,12,28,3,7,9,33,61
2006-04-10 00:00:00.000,Valencia Spain ATP World Tour,CLAY,2,Potito Starace,Lukas Dlouhy,Potito Starace,6-3; 6-3,R32,52,2,0,40,46,29,40,4,6,0,1,9,33,46,0,4,33,52,20,33,8,19,4,8,9,28,52
2006-04-10 00:00:00.000,Valencia Spain ATP World Tour,CLAY,2,Fernando Verdasco,Alberto Martin,Fernando Verdasco,6-3; 6-4,R32,89,3,1,44,66,30,44,11,22,5,7,10,41,66,4,3,39,64,23,39,10,25,7,11,9,33,64
2006-04-10 00:00:00.000,Valencia Spain ATP World Tour,CLAY,2,Thierry Ascione,David Ferrer,Thierry Ascione,7-6(1) RET,R32,46,0,1,26,42,17,26,7,16,4,6,6,24,42,1,2,29,34,18,29,0,5,0,2,6,18,34
2006-04-10 00:00:00.000,Valencia Spain ATP World Tour,CLAY,2,Andreas Seppi,Ruben Ramirez Hidalgo,Andreas Seppi,6-2; 6-2,R32,66,2,2,25,46,16,25,9,21,2,5,8,25,46,6,0,30,45,25,30,11,15,0,0,9,36,45
2006-04-10 00:00:00.000,Valencia Spain ATP World Tour,CLAY,2,Gilles Simon,Robin Vik,Gilles Simon,6-3; 6-2,R32,65,3,0,24,48,19,24,14,24,0,2,9,33,48,0,5,42,66,24,42,8,24,5,10,8,32,66
2006-04-10 00:00:00.000,Valencia Spain ATP World Tour,CLAY,2,Davide Sanguinetti,Teymuraz Gabashvili,Davide Sanguinetti,6-7(4); 6-4; 6-3,R32,129,3,1,42,108,31,42,34,66,7,11,16,65,108,1,5,57,101,31,57,25,44,10,16,15,56,101
2006-04-10 00:00:00.000,Valencia Spain ATP World Tour,CLAY,2,Filippo Volandri,Albert Portas,Filippo Volandri,6-0; 6-1,R32,45,0,0,26,37,22,26,8,11,1,1,7,30,37,2,3,15,40,10,15,6,25,3,8,6,16,40
2006-04-10 00:00:00.000,Valencia Spain ATP World Tour,CLAY,2,Tomas Zib,Andrei Pavel,Tomas Zib,7-5; 6-3,R32,93,3,1,48,73,32,48,13,25,4,6,10,45,73,3,4,42,77,24,42,15,35,5,10,11,39,77
2006-04-10 00:00:00.000,Valencia Spain ATP World Tour,CLAY,2,Bjorn Phau,Gorka Fraile,Bjorn Phau,7-6(1); 6-7(4); 6-2,R32,135,5,2,60,116,46,60,28,56,5,8,16,74,116,1,1,82,94,51,82,6,12,2,7,16,57,94
2006-04-10 00:00:00.000,Valencia Spain ATP World Tour,CLAY,2,Nicolas Almagro,Juan Carlos Ferrero,Nicolas Almagro,6-7(3); 6-4; 6-4,R32,160,5,5,69,110,50,69,22,41,7,8,16,72,110,4,3,78,109,55,78,12,31,11,14,16,67,109
2006-04-10 00:00:00.000,Valencia Spain ATP World Tour,CLAY,2,Marat Safin,Igor Andreev,Marat Safin,7-6(6); 6-4,R32,111,3,3,48,74,35,48,17,26,4,6,11,52,74,0,3,62,91,38,62,15,29,5,8,11,53,91
2006-04-10 00:00:00.000,Valencia Spain ATP World Tour,CLAY,2,Boris Pashanski,Albert Costa,Boris Pashanski,3-6; 6-3; 6-4,R32,116,0,1,32,56,23,32,11,24,5,7,9,34,56,0,3,35,53,17,35,5,18,4,10,9,22,53
2006-04-10 00:00:00.000,Valencia Spain ATP World Tour,CLAY,2,Florian Mayer,Guillem Burniol,Florian Mayer,6-0; 6-3,R32,51,5,2,36,49,26,36,7,13,7,8,8,33,49,2,2,25,45,13,25,5,20,8,13,7,18,45
2006-04-10 00:00:00.000,Valencia Spain ATP World Tour,CLAY,2,Gaston Gaudio,Raemon Sluiter,Gaston Gaudio,7-6(6); 7-6(3),R32,114,4,6,68,98,51,68,10,30,5,7,12,61,98,10,0,55,89,37,55,17,34,4,6,12,54,89
2006-04-10 00:00:00.000,Valencia Spain ATP World Tour,CLAY,2,Guillermo Garcia-Lopez,Jan Hernych,Guillermo Garcia-Lopez,6-2; 6-4,R16,67,2,4,47,81,27,47,17,34,9,13,10,44,81,2,4,45,74,35,45,13,29,7,9,11,48,74
2006-04-10 00:00:00.000,Valencia Spain ATP World Tour,CLAY,2,Fernando Verdasco,Potito Starace,Fernando Verdasco,6-3; 7-6(4),R16,93,1,3,65,83,46,65,10,18,6,7,11,56,83,3,0,50,70,35,50,10,20,4,6,10,45,70
2006-04-10 00:00:00.000,Valencia Spain ATP World Tour,CLAY,2,Andreas Seppi,Thierry Ascione,Andreas Seppi,1-6; 6-1; 6-2,R16,91,7,3,50,77,35,50,14,27,6,8,11,49,77,2,3,46,69,30,46,9,23,5,9,11,39,69
2006-04-10 00:00:00.000,Valencia Spain ATP World Tour,CLAY,2,Gilles Simon,Davide Sanguinetti,Gilles Simon,3-6; 7-5; 6-3,R16,114,4,1,45,81,32,45,20,36,4,8,15,52,81,0,4,59,108,37,59,24,49,8,13,15,61,108
2006-04-10 00:00:00.000,Valencia Spain ATP World Tour,CLAY,2,Filippo Volandri,Tomas Zib,Filippo Volandri,6-4; 6-4,R16,71,1,1,34,52,28,34,14,18,2,2,10,42,52,4,0,46,69,30,46,11,23,7,9,10,41,69
2006-04-10 00:00:00.000,Valencia Spain ATP World Tour,CLAY,2,Nicolas Almagro,Bjorn Phau,Nicolas Almagro,6-2; 6-1,R16,68,2,1,36,53,29,36,8,17,6,6,8,37,53,2,3,31,61,18,31,12,30,12,16,7,30,61
2006-04-10 00:00:00.000,Valencia Spain ATP World Tour,CLAY,2,Marat Safin,Boris Pashanski,Marat Safin,6-2; 6-2,R16,55,2,1,25,42,22,25,11,17,1,1,8,33,42,1,3,31,51,19,31,7,20,3,7,8,26,51
2006-04-10 00:00:00.000,Valencia Spain ATP World Tour,CLAY,2,Gaston Gaudio,Florian Mayer,Gaston Gaudio,6-4; 6-2,R16,68,4,1,35,49,24,35,9,14,0,2,9,33,49,2,3,35,65,18,35,14,30,4,9,9,32,65
2006-04-10 00:00:00.000,Valencia Spain ATP World Tour,CLAY,2,Fernando Verdasco,Guillermo Garcia-Lopez,Fernando Verdasco,6-7(2); 6-4; 6-3,Q,157,2,1,71,95,48,71,19,24,6,8,16,67,95,1,3,84,114,51,84,17,30,9,13,15,68,114
2006-04-10 00:00:00.000,Valencia Spain ATP World Tour,CLAY,2,Gilles Simon,Andreas Seppi,Gilles Simon,7-6(2); 7-6(4),Q,106,2,2,44,85,34,44,26,41,4,5,12,60,85,6,2,38,77,32,38,23,39,2,3,12,55,77
2006-04-10 00:00:00.000,Valencia Spain ATP World Tour,CLAY,2,Nicolas Almagro,Filippo Volandri,Nicolas Almagro,6-4; 6-1,Q,71,3,1,52,73,35,52,12,21,4,4,9,47,73,0,0,31,49,16,31,10,18,2,5,8,26,49
2006-04-10 00:00:00.000,Valencia Spain ATP World Tour,CLAY,2,Marat Safin,Gaston Gaudio,Marat Safin,6-4; 6-4,Q,81,4,0,41,61,32,41,13,20,4,4,10,45,61,0,3,40,61,25,40,12,21,3,5,10,37,61
2006-04-10 00:00:00.000,Valencia Spain ATP World Tour,CLAY,2,Gilles Simon,Fernando Verdasco,Gilles Simon,6-2; 7-6(5),S,99,5,1,41,65,30,41,12,24,2,4,10,42,65,1,6,47,72,29,47,9,25,6,10,10,38,72
2006-04-10 00:00:00.000,Valencia Spain ATP World Tour,CLAY,2,Nicolas Almagro,Marat Safin,Nicolas Almagro,6-2; 2-6; 6-4,S,134,3,1,56,90,37,56,17,34,8,11,13,54,90,10,3,50,93,38,50,14,43,7,11,13,52,93
2006-04-10 00:00:00.000,Valencia Spain ATP World Tour,CLAY,2,Nicolas Almagro,Gilles Simon,Nicolas Almagro,6-2; 6-3,F,79,7,0,43,66,32,43,12,23,6,6,8,44,66,2,1,25,64,14,25,18,39,6,10,9,32,64
2006-04-17 00:00:00.000,ATP Masters Series Monte Carlo Monaco ATP World Tour,CLAY,2,Roger Federer,Novak Djokovic,Roger Federer,6-3; 2-6; 6-3,R64,109,1,0,39,73,28,39,21,34,0,2,13,49,73,1,4,61,94,36,61,19,33,8,11,13,55,94
2006-04-17 00:00:00.000,ATP Masters Series Monte Carlo Monaco ATP World Tour,CLAY,2,Alberto Martin,Ivo Karlovic,Alberto Martin,6-4; 7-6(3),R64,83,1,1,45,61,34,45,12,16,1,2,11,46,61,6,4,33,71,28,33,16,38,3,5,11,44,71
2006-04-17 00:00:00.000,ATP Masters Series Monte Carlo Monaco ATP World Tour,CLAY,2,Benjamin Balleret,Christophe Rochus,Benjamin Balleret,6-3; 6-3,R64,62,4,5,33,55,24,33,7,22,3,6,9,31,55,0,7,31,50,15,31,6,19,1,7,9,21,50
2006-04-17 00:00:00.000,ATP Masters Series Monte Carlo Monaco ATP World Tour,CLAY,2,Sebastien Grosjean,Fernando Verdasco,Sebastien Grosjean,7-6(6); 6-3,R64,96,4,1,30,73,22,30,18,43,6,9,10,40,73,0,6,52,69,28,52,6,17,4,9,11,34,69
2006-04-17 00:00:00.000,ATP Masters Series Monte Carlo Monaco ATP World Tour,CLAY,2,Juan Carlos Ferrero,Dmitry Tursunov,Juan Carlos Ferrero,6-1; 6-2,R64,58,2,0,37,44,31,37,3,7,2,2,8,34,44,2,8,29,53,18,29,8,24,3,7,7,26,53
2006-04-17 00:00:00.000,ATP Masters Series Monte Carlo Monaco ATP World Tour,CLAY,2,Juan Ignacio Chela,Greg Rusedski,Juan Ignacio Chela,6-4; 6-7(5); 6-1,R64,126,1,3,39,91,32,39,27,52,8,11,14,59,91,5,6,53,99,32,53,19,46,3,10,15,51,99
2006-04-17 00:00:00.000,ATP Masters Series Monte Carlo Monaco ATP World Tour,CLAY,2,Dominik Hrbaty,Daniele Bracciali,Dominik Hrbaty,6-4; 3-6; 6-4,R64,123,2,7,48,85,35,48,13,37,2,7,15,48,85,4,2,44,93,28,44,25,49,8,13,14,53,93
2006-04-17 00:00:00.000,ATP Masters Series Monte Carlo Monaco ATP World Tour,CLAY,2,David Ferrer,Nicolas Massu,David Ferrer,6-0; 4-6; 6-2,R64,120,0,1,43,71,32,43,14,28,2,4,12,46,71,2,3,52,89,35,52,10,37,10,16,12,45,89
2006-04-17 00:00:00.000,ATP Masters Series Monte Carlo Monaco ATP World Tour,CLAY,2,Ivan Ljubicic,Igor Andreev,Ivan Ljubicic,6-3; 4-6; 6-2,R64,102,5,3,46,81,36,46,16,35,2,5,14,52,81,0,1,55,78,31,55,10,23,6,11,13,41,78
2006-04-17 00:00:00.000,ATP Masters Series Monte Carlo Monaco ATP World Tour,CLAY,2,Florent Serra,Paradorn Srichaphan,Florent Serra,6-1; 7-5,R64,71,1,4,28,61,19,28,21,33,2,3,9,40,61,5,4,28,57,18,28,12,29,1,6,10,30,57
2006-04-17 00:00:00.000,ATP Masters Series Monte Carlo Monaco ATP World Tour,CLAY,2,Gilles Simon,Teymuraz Gabashvili,Gilles Simon,6-4; 6-2,R64,73,3,1,25,59,20,25,18,34,8,10,9,38,59,2,2,27,56,17,27,9,29,0,5,9,26,56
2006-04-17 00:00:00.000,ATP Masters Series Monte Carlo Monaco ATP World Tour,CLAY,2,Tomas Berdych,Fabrice Santoro,Tomas Berdych,6-2; 6-4,R64,81,2,4,41,68,32,41,11,27,6,7,9,43,68,2,1,37,63,25,37,8,26,3,7,9,33,63
2006-04-17 00:00:00.000,ATP Masters Series Monte Carlo Monaco ATP World Tour,CLAY,2,Fernando Gonzalez,Carlos Moya,Fernando Gonzalez,6-3; 3-6; 6-1,R64,110,5,2,60,83,45,60,13,23,2,3,13,58,83,1,2,62,92,42,62,12,30,9,12,12,54,92
2006-04-17 00:00:00.000,ATP Masters Series Monte Carlo Monaco ATP World Tour,CLAY,2,Feliciano Lopez,Victor Hanescu,Feliciano Lopez,6-4; 4-6; 7-6(2),R64,123,8,4,57,91,39,57,19,34,1,5,16,58,91,9,2,68,104,45,68,16,36,4,8,16,61,104
2006-04-17 00:00:00.000,ATP Masters Series Monte Carlo Monaco ATP World Tour,CLAY,2,Potito Starace,Nicolas Mahut,Potito Starace,7-6(2); 6-2,R64,96,0,0,49,59,35,49,10,10,0,1,10,45,59,2,4,53,75,34,53,9,22,5,8,10,43,75
2006-04-17 00:00:00.000,ATP Masters Series Monte Carlo Monaco ATP World Tour,CLAY,2,Robin Soderling,Nikolay Davydenko,Robin Soderling,6-3; 2-6; 6-4,R64,112,5,7,46,89,29,46,18,43,5,11,14,47,89,1,4,57,80,32,57,11,23,3,9,13,43,80
2006-04-17 00:00:00.000,ATP Masters Series Monte Carlo Monaco ATP World Tour,CLAY,2,Gaston Gaudio,Tim Henman,Gaston Gaudio,6-1; 6-3,R64,86,0,2,36,58,23,36,10,22,4,6,8,33,58,5,2,27,57,16,27,7,30,4,10,8,23,57
2006-04-17 00:00:00.000,ATP Masters Series Monte Carlo Monaco ATP World Tour,CLAY,2,Jose Acasuso,Filippo Volandri,Jose Acasuso,6-4; 6-2,R64,78,2,2,26,61,17,26,22,35,3,4,9,39,61,0,2,27,42,17,27,6,15,0,4,9,23,42
2006-04-17 00:00:00.000,ATP Masters Series Monte Carlo Monaco ATP World Tour,CLAY,2,Alessio Di Mauro,Stanislas Wawrinka,Alessio Di Mauro,6-2; 6-4,R64,84,5,2,28,57,23,28,17,29,1,1,9,40,57,0,2,33,58,19,33,14,25,4,7,9,33,58
2006-04-17 00:00:00.000,ATP Masters Series Monte Carlo Monaco ATP World Tour,CLAY,2,Radek Stepanek,Evgeny Korolev,Radek Stepanek,6-2; 7-6(5),R64,92,5,1,33,63,26,33,18,30,3,4,10,44,63,5,3,42,77,28,42,17,35,10,13,10,45,77
2006-04-17 00:00:00.000,ATP Masters Series Monte Carlo Monaco ATP World Tour,CLAY,2,Tommy Robredo,Luis Horna,Tommy Robredo,6-3; 6-4,R64,91,3,0,53,72,38,53,12,19,3,3,10,50,72,1,2,32,56,21,32,12,24,4,6,9,33,56
2006-04-17 00:00:00.000,ATP Masters Series Monte Carlo Monaco ATP World Tour,CLAY,2,Olivier Rochus,Gael Monfils,Olivier Rochus,4-6; 6-4; 6-1,R64,146,2,2,50,85,32,50,18,35,2,6,13,50,85,9,7,57,101,35,57,15,44,17,24,14,50,101
2006-04-17 00:00:00.000,ATP Masters Series Monte Carlo Monaco ATP World Tour,CLAY,2,Andreas Seppi,Davide Sanguinetti,Andreas Seppi,2-6; 6-1; 6-4,R64,109,4,3,37,79,29,37,24,42,4,6,13,53,79,5,4,42,89,29,42,22,47,8,11,12,51,89
2006-04-17 00:00:00.000,ATP Masters Series Monte Carlo Monaco ATP World Tour,CLAY,2,David Nalbandian,Xavier Malisse,David Nalbandian,6-4; 6-4,R64,80,1,2,37,61,25,37,16,24,5,6,10,41,61,4,1,32,57,22,32,12,25,4,7,10,34,57
2006-04-17 00:00:00.000,ATP Masters Series Monte Carlo Monaco ATP World Tour,CLAY,2,Guillermo Coria,Mikhail Youzhny,Guillermo Coria,6-3; 6-1,R64,80,0,6,40,61,27,40,10,21,3,4,8,37,61,1,2,28,52,18,28,8,24,2,7,8,26,52
2006-04-17 00:00:00.000,ATP Masters Series Monte Carlo Monaco ATP World Tour,CLAY,2,Paul-Henri Mathieu,Marat Safin,Paul-Henri Mathieu,6-0; 7-5,R64,93,1,0,32,49,24,32,8,17,0,2,9,32,49,0,3,35,68,16,35,14,33,7,13,9,30,68
2006-04-17 00:00:00.000,ATP Masters Series Monte Carlo Monaco ATP World Tour,CLAY,2,Michael Llodra,Boris Pashanski,Michael Llodra,6-3; 6-0,R64,72,3,2,33,63,22,33,16,30,10,11,8,38,63,1,4,22,43,8,22,10,21,4,9,7,18,43
2006-04-17 00:00:00.000,ATP Masters Series Monte Carlo Monaco ATP World Tour,CLAY,2,Nicolas Kiefer,Max Mirnyi,Nicolas Kiefer,6-4; 4-6; 7-6(2),R64,148,9,6,49,89,33,49,27,40,2,6,16,60,89,9,6,66,122,47,66,26,56,10,14,16,73,122
2006-04-17 00:00:00.000,ATP Masters Series Monte Carlo Monaco ATP World Tour,CLAY,2,Kristof Vliegen,Jarkko Nieminen,Kristof Vliegen,1-6; 6-4; 7-6(5),R64,131,7,2,65,113,44,65,23,48,10,14,15,67,113,4,1,56,86,42,56,16,30,6,8,14,58,86
2006-04-17 00:00:00.000,ATP Masters Series Monte Carlo Monaco ATP World Tour,CLAY,2,Jan Hernych,Julien Benneteau,Jan Hernych,7-6(9); 4-6; 7-6(4),R64,198,3,3,82,124,52,82,22,42,5,11,17,74,124,9,6,103,148,61,103,23,45,10,15,17,84,148
2006-04-17 00:00:00.000,ATP Masters Series Monte Carlo Monaco ATP World Tour,CLAY,2,Jean-Rene Lisnard,Andy Murray,Jean-Rene Lisnard,4-6; 7-6(5); 7-5,R64,187,1,6,64,125,41,64,29,61,8,14,17,70,125,3,3,70,130,45,70,26,60,17,23,17,71,130
2006-04-17 00:00:00.000,ATP Masters Series Monte Carlo Monaco ATP World Tour,CLAY,2,Rafael Nadal,Arnaud Clement,Rafael Nadal,6-4; 6-4,R64,96,0,1,48,64,30,48,11,16,6,8,10,41,64,2,5,32,57,20,32,10,25,1,5,10,30,57
2006-04-17 00:00:00.000,ATP Masters Series Monte Carlo Monaco ATP World Tour,CLAY,2,Roger Federer,Alberto Martin,Roger Federer,6-0; 6-1,R32,46,2,1,20,33,18,20,10,13,0,0,7,28,33,0,3,23,37,8,23,5,14,1,6,6,13,37
2006-04-17 00:00:00.000,ATP Masters Series Monte Carlo Monaco ATP World Tour,CLAY,2,Benjamin Balleret,Sebastien Grosjean,Benjamin Balleret,4-6; 7-5; 3-2 RET,R32,113,1,3,53,89,36,53,15,36,9,14,14,51,89,4,1,38,76,27,38,17,38,5,10,13,44,76
2006-04-17 00:00:00.000,ATP Masters Series Monte Carlo Monaco ATP World Tour,CLAY,2,Juan Carlos Ferrero,Juan Ignacio Chela,Juan Carlos Ferrero,6-1; 6-2,R32,73,0,0,33,45,27,33,6,12,1,1,8,33,45,0,2,32,55,15,32,11,23,12,16,7,26,55
2006-04-17 00:00:00.000,ATP Masters Series Monte Carlo Monaco ATP World Tour,CLAY,2,David Ferrer,Dominik Hrbaty,David Ferrer,6-4; 3-6; 6-4,R32,133,0,2,61,89,41,61,9,28,2,7,14,50,89,2,4,51,98,33,51,21,47,7,13,15,54,98
2006-04-17 00:00:00.000,ATP Masters Series Monte Carlo Monaco ATP World Tour,CLAY,2,Ivan Ljubicic,Florent Serra,Ivan Ljubicic,4-6; 6-3; 7-5,R32,112,17,3,55,85,44,55,20,30,6,7,16,64,85,5,1,58,92,44,58,18,34,5,7,15,62,92
2006-04-17 00:00:00.000,ATP Masters Series Monte Carlo Monaco ATP World Tour,CLAY,2,Gilles Simon,Tomas Berdych,Gilles Simon,7-6(2); 6-7(5); 6-4,R32,163,10,2,61,122,48,61,30,61,5,8,17,78,122,4,6,50,106,38,50,30,56,3,7,17,68,106
2006-04-17 00:00:00.000,ATP Masters Series Monte Carlo Monaco ATP World Tour,CLAY,2,Fernando Gonzalez,Feliciano Lopez,Fernando Gonzalez,6-7(4); 6-2; 7-5,R32,134,6,3,56,95,38,56,28,39,5,7,16,66,95,1,2,61,101,34,61,26,40,7,12,16,60,101
2006-04-17 00:00:00.000,ATP Masters Series Monte Carlo Monaco ATP World Tour,CLAY,2,Robin Soderling,Potito Starace,Robin Soderling,6-4; 6-4,R32,86,4,6,36,67,29,36,12,31,7,9,10,41,67,1,0,48,71,28,48,11,23,3,7,10,39,71
2006-04-17 00:00:00.000,ATP Masters Series Monte Carlo Monaco ATP World Tour,CLAY,2,Gaston Gaudio,Jose Acasuso,Gaston Gaudio,6-3; 3-6; 6-4,R32,126,2,5,51,81,30,51,15,30,4,10,14,45,81,6,4,60,103,32,60,19,43,9,16,14,51,103
2006-04-17 00:00:00.000,ATP Masters Series Monte Carlo Monaco ATP World Tour,CLAY,2,Alessio Di Mauro,Radek Stepanek,Alessio Di Mauro,6-2; 2-6; 7-6(4),R32,138,3,1,41,91,25,41,28,50,6,11,14,53,91,8,6,52,90,33,52,22,38,6,11,14,55,90
2006-04-17 00:00:00.000,ATP Masters Series Monte Carlo Monaco ATP World Tour,CLAY,2,Tommy Robredo,Olivier Rochus,Tommy Robredo,7-5; 6-4,R32,105,0,2,53,68,36,53,8,15,2,4,11,44,68,0,1,50,76,31,50,13,26,7,11,11,44,76
2006-04-17 00:00:00.000,ATP Masters Series Monte Carlo Monaco ATP World Tour,CLAY,2,David Nalbandian,Andreas Seppi,David Nalbandian,7-5; 7-5,R32,103,2,4,44,74,30,44,12,30,2,6,12,42,74,4,5,44,80,25,44,16,36,7,13,12,41,80
2006-04-17 00:00:00.000,ATP Masters Series Monte Carlo Monaco ATP World Tour,CLAY,2,Guillermo Coria,Paul-Henri Mathieu,Guillermo Coria,1-6; 7-6(6); 6-4,R32,167,0,20,68,112,41,68,18,44,10,17,14,59,112,3,2,65,106,34,65,25,41,10,16,15,59,106
2006-04-17 00:00:00.000,ATP Masters Series Monte Carlo Monaco ATP World Tour,CLAY,2,Nicolas Kiefer,Michael Llodra,Nicolas Kiefer,7-6(4); 6-4,R32,98,4,1,43,83,31,43,20,40,3,6,11,51,83,3,5,45,73,27,45,12,28,2,6,11,39,73
2006-04-17 00:00:00.000,ATP Masters Series Monte Carlo Monaco ATP World Tour,CLAY,2,Kristof Vliegen,Jan Hernych,Kristof Vliegen,7-5; 6-1,R32,85,1,1,41,65,24,41,14,24,6,8,9,38,65,2,1,31,60,17,31,11,29,2,8,10,28,60
2006-04-17 00:00:00.000,ATP Masters Series Monte Carlo Monaco ATP World Tour,CLAY,2,Rafael Nadal,Jean-Rene Lisnard,Rafael Nadal,6-4; 6-1,R32,88,0,1,34,48,25,34,8,14,3,4,8,33,48,0,3,22,54,13,22,13,32,6,11,9,26,54
2006-04-17 00:00:00.000,ATP Masters Series Monte Carlo Monaco ATP World Tour,CLAY,2,Roger Federer,Benjamin Balleret,Roger Federer,6-3; 6-2,R16,55,3,0,30,44,26,30,11,14,3,3,9,37,44,2,2,34,52,21,34,8,18,3,6,8,29,52
2006-04-17 00:00:00.000,ATP Masters Series Monte Carlo Monaco ATP World Tour,CLAY,2,David Ferrer,Juan Carlos Ferrero,David Ferrer,6-1; 6-7(5); 6-3,R16,142,0,2,67,103,39,67,22,36,8,12,15,61,103,1,1,65,89,34,65,13,24,2,9,13,47,89
2006-04-17 00:00:00.000,ATP Masters Series Monte Carlo Monaco ATP World Tour,CLAY,2,Ivan Ljubicic,Gilles Simon,Ivan Ljubicic,6-3; 6-2,R16,71,4,1,24,46,17,24,11,22,1,3,8,28,46,1,3,31,58,14,31,11,27,2,8,9,25,58
2006-04-17 00:00:00.000,ATP Masters Series Monte Carlo Monaco ATP World Tour,CLAY,2,Fernando Gonzalez,Robin Soderling,Fernando Gonzalez,6-2; 3-1 RET,R16,54,1,2,25,38,20,25,6,13,3,3,6,26,38,1,1,31,42,18,31,5,11,1,4,6,23,42
2006-04-17 00:00:00.000,ATP Masters Series Monte Carlo Monaco ATP World Tour,CLAY,2,Gaston Gaudio,Alessio Di Mauro,Gaston Gaudio,6-2; 6-4,R16,85,1,0,34,50,25,34,11,16,4,5,9,36,50,3,0,35,65,24,35,11,30,4,8,9,35,65
2006-04-17 00:00:00.000,ATP Masters Series Monte Carlo Monaco ATP World Tour,CLAY,2,Tommy Robredo,David Nalbandian,Tommy Robredo,5-7; 6-1; 7-5,R16,170,2,0,103,122,57,103,11,19,11,15,15,68,122,1,9,74,123,49,74,16,49,6,13,16,65,123
2006-04-17 00:00:00.000,ATP Masters Series Monte Carlo Monaco ATP World Tour,CLAY,2,Guillermo Coria,Nicolas Kiefer,Guillermo Coria,6-7(5); 6-4; 6-3,R16,164,0,23,71,116,46,71,11,45,13,20,16,57,116,3,1,44,94,26,44,18,50,5,14,15,44,94
2006-04-17 00:00:00.000,ATP Masters Series Monte Carlo Monaco ATP World Tour,CLAY,2,Rafael Nadal,Kristof Vliegen,Rafael Nadal,6-3; 6-3,R16,105,2,2,50,61,33,50,5,11,2,3,9,38,61,0,0,34,60,18,34,12,26,4,8,9,30,60
2006-04-17 00:00:00.000,ATP Masters Series Monte Carlo Monaco ATP World Tour,CLAY,2,Roger Federer,David Ferrer,Roger Federer,6-1; 6-3,Q,61,3,1,28,45,22,28,8,17,4,5,8,30,45,1,2,31,51,16,31,6,20,9,14,8,22,51
2006-04-17 00:00:00.000,ATP Masters Series Monte Carlo Monaco ATP World Tour,CLAY,2,Fernando Gonzalez,Ivan Ljubicic,Fernando Gonzalez,7-5; 6-1,Q,107,1,1,37,55,24,37,13,18,3,4,9,37,55,2,2,41,79,25,41,14,38,2,7,10,39,79
2006-04-17 00:00:00.000,ATP Masters Series Monte Carlo Monaco ATP World Tour,CLAY,2,Gaston Gaudio,Tommy Robredo,Gaston Gaudio,6-1; 6-3,Q,78,1,2,26,47,21,26,13,21,2,2,8,34,47,1,1,37,61,18,37,12,24,6,10,8,30,61
2006-04-17 00:00:00.000,ATP Masters Series Monte Carlo Monaco ATP World Tour,CLAY,2,Rafael Nadal,Guillermo Coria,Rafael Nadal,6-2; 6-1,Q,70,4,0,33,43,21,33,6,10,6,8,7,27,43,0,8,36,53,12,36,6,17,6,13,8,18,53
2006-04-17 00:00:00.000,ATP Masters Series Monte Carlo Monaco ATP World Tour,CLAY,2,Roger Federer,Fernando Gonzalez,Roger Federer,6-2; 6-4,S,69,3,0,36,52,28,36,11,16,3,3,9,39,52,0,3,37,55,23,37,9,18,3,6,9,32,55
2006-04-17 00:00:00.000,ATP Masters Series Monte Carlo Monaco ATP World Tour,CLAY,2,Rafael Nadal,Gaston Gaudio,Rafael Nadal,5-7; 6-1; 6-1,S,159,0,1,52,80,35,52,15,28,5,8,13,50,80,0,3,54,96,30,54,16,42,13,20,13,46,96
2006-04-17 00:00:00.000,ATP Masters Series Monte Carlo Monaco ATP World Tour,CLAY,2,Rafael Nadal,Roger Federer,Rafael Nadal,6-2; 6-7(2); 6-3; 7-6(5),F,230,1,4,106,152,70,106,24,46,14,18,21,94,152,3,3,86,143,54,86,28,57,7,14,20,82,143
2006-04-24 00:00:00.000,Barcelona Spain ATP World Tour,CLAY,2,Rafael Nadal,N/A Bye,Rafael Nadal,,R64,0,0,0,0,0,0,0,0,0,0,0,0,0,0,0,0,0,0,0,0,0,0,0,0,0,0,0
2006-04-24 00:00:00.000,Barcelona Spain ATP World Tour,CLAY,2,Feliciano Lopez,Ivo Klec,Feliciano Lopez,4-6; 6-4; 6-4,R64,131,4,5,54,111,36,54,21,57,9,15,15,57,111,1,6,44,86,28,44,18,42,10,17,15,46,86
2006-04-24 00:00:00.000,Barcelona Spain ATP World Tour,CLAY,2,Daniel Gimeno-Traver,Novak Djokovic,Daniel Gimeno-Traver,6-4; 3-6; 6-3,R64,133,2,5,70,105,49,70,12,35,7,10,14,61,105,2,1,54,82,37,54,12,28,3,7,14,49,82
2006-04-24 00:00:00.000,Barcelona Spain ATP World Tour,CLAY,2,Ivan Navarro,Paradorn Srichaphan,Ivan Navarro,6-3; 6-4,R64,99,3,0,37,62,30,37,12,25,5,5,9,42,62,1,2,52,80,29,52,16,28,12,15,10,45,80
2006-04-24 00:00:00.000,Barcelona Spain ATP World Tour,CLAY,2,Tomas Berdych,Albert Montanes,Tomas Berdych,4-6; 7-5; 7-5,R64,146,13,5,63,110,45,63,22,47,7,11,17,67,110,5,8,56,102,45,56,16,46,2,7,17,61,102
2006-04-24 00:00:00.000,Barcelona Spain ATP World Tour,CLAY,2,Albert Portas,Oscar Hernandez,Albert Portas,6-2; 6-4,R64,78,7,2,28,59,24,28,19,31,5,5,9,43,59,0,1,43,60,23,43,11,17,7,10,9,34,60
2006-04-24 00:00:00.000,Barcelona Spain ATP World Tour,CLAY,2,Philipp Kohlschreiber,Raemon Sluiter,Philipp Kohlschreiber,7-6(2); 7-6,R64,93,1,1,25,36,20,25,6,11,0,0,6,26,36,6,1,29,47,22,29,12,18,5,5,6,34,47
2006-04-24 00:00:00.000,Barcelona Spain ATP World Tour,CLAY,2,Jarkko Nieminen,N/A Bye,Jarkko Nieminen,,R64,0,0,0,0,0,0,0,0,0,0,0,0,0,0,0,0,0,0,0,0,0,0,0,0,0,0,0
2006-04-24 00:00:00.000,Barcelona Spain ATP World Tour,CLAY,2,Guillermo Coria,N/A Bye,Guillermo Coria,,R64,0,0,0,0,0,0,0,0,0,0,0,0,0,0,0,0,0,0,0,0,0,0,0,0,0,0,0
2006-04-24 00:00:00.000,Barcelona Spain ATP World Tour,CLAY,2,Galo Blanco,Tomas Zib,Galo Blanco,6-7(3); 7-6(3); 6-2,R64,164,12,4,76,127,55,76,22,51,11,14,16,77,127,8,1,64,106,42,64,23,42,4,9,16,65,106
2006-04-24 00:00:00.000,Barcelona Spain ATP World Tour,CLAY,2,Nicolas Almagro,Andrei Pavel,Nicolas Almagro,6-4; 6-2,R64,63,4,1,24,44,21,24,15,20,0,0,9,36,44,0,1,38,52,24,38,5,14,2,5,9,29,52
2006-04-24 00:00:00.000,Barcelona Spain ATP World Tour,CLAY,2,Gael Monfils,Stefano Galvani,Gael Monfils,6-2; 7-5,R64,91,2,1,36,57,25,36,13,21,2,3,10,38,57,1,3,38,59,23,38,8,21,3,7,10,31,59
2006-04-24 00:00:00.000,Barcelona Spain ATP World Tour,CLAY,2,Juan Carlos Ferrero,Kristof Vliegen,Juan Carlos Ferrero,6-1; 6-2,R64,68,1,0,36,46,30,36,4,10,2,2,8,34,46,0,3,26,42,17,26,2,16,3,7,7,19,42
2006-04-24 00:00:00.000,Barcelona Spain ATP World Tour,CLAY,2,Alberto Martin,Bartolome Salva-Vidal,Alberto Martin,6-4; 6-2,R64,89,3,1,31,52,25,31,13,21,2,2,9,38,52,0,4,40,71,26,40,15,31,8,11,9,41,71
2006-04-24 00:00:00.000,Barcelona Spain ATP World Tour,CLAY,2,Albert Costa,Vincent Spadea,Albert Costa,7-6(7); 4-6; 6-1,R64,157,3,6,85,112,56,85,11,27,10,14,15,67,112,7,6,69,130,45,69,26,61,17,22,14,71,130
2006-04-24 00:00:00.000,Barcelona Spain ATP World Tour,CLAY,2,Dominik Hrbaty,N/A Bye,Dominik Hrbaty,,R64,0,0,0,0,0,0,0,0,0,0,0,0,0,0,0,0,0,0,0,0,0,0,0,0,0,0,0
2006-04-24 00:00:00.000,Barcelona Spain ATP World Tour,CLAY,2,Tommy Robredo,N/A Bye,Tommy Robredo,,R64,0,0,0,0,0,0,0,0,0,0,0,0,0,0,0,0,0,0,0,0,0,0,0,0,0,0,0
2006-04-24 00:00:00.000,Barcelona Spain ATP World Tour,CLAY,2,Potito Starace,Lukas Dlouhy,Potito Starace,6-4; 6-2,R64,58,1,0,40,48,32,40,4,8,0,0,9,36,48,0,3,55,62,33,55,4,7,4,7,9,37,62
2006-04-24 00:00:00.000,Barcelona Spain ATP World Tour,CLAY,2,Agustin Calleri,Justin Gimelstob,Agustin Calleri,6-2; 6-1,R64,159,6,0,30,39,23,30,6,9,0,0,7,29,39,2,0,34,56,19,34,8,22,8,13,8,27,56
2006-04-24 00:00:00.000,Barcelona Spain ATP World Tour,CLAY,2,Fernando Verdasco,Robin Vik,Fernando Verdasco,6-3; 6-4,R64,70,2,3,41,55,27,41,8,14,2,4,10,35,55,2,3,35,61,23,35,8,26,4,8,9,31,61
2006-04-24 00:00:00.000,Barcelona Spain ATP World Tour,CLAY,2,Carlos Cuadrado,Dmitry Tursunov,Carlos Cuadrado,4-6; 6-0(3); 6-3,R64,108,6,2,46,77,34,46,16,31,5,8,11,50,77,9,3,44,87,29,44,19,43,10,14,11,48,87
2006-04-24 00:00:00.000,Barcelona Spain ATP World Tour,CLAY,2,Paul-Henri Mathieu,Juan Antonio Marin,Paul-Henri Mathieu,7-6(3); 6-2,R64,100,2,2,43,62,27,43,10,19,0,3,10,37,62,2,2,31,64,19,31,13,33,1,6,10,32,64
2006-04-24 00:00:00.000,Barcelona Spain ATP World Tour,CLAY,2,Filippo Volandri,Andrea Stoppini,Filippo Volandri,6-3; 6-1,R64,59,0,0,27,50,17,27,12,23,0,2,8,29,50,0,4,28,50,15,28,5,22,5,11,8,20,50
2006-04-24 00:00:00.000,Barcelona Spain ATP World Tour,CLAY,2,Radek Stepanek,N/A Bye,Radek Stepanek,,R64,0,0,0,0,0,0,0,0,0,0,0,0,0,0,0,0,0,0,0,0,0,0,0,0,0,0,0
2006-04-24 00:00:00.000,Barcelona Spain ATP World Tour,CLAY,2,David Ferrer,N/A Bye,David Ferrer,,R64,0,0,0,0,0,0,0,0,0,0,0,0,0,0,0,0,0,0,0,0,0,0,0,0,0,0,0
2006-04-24 00:00:00.000,Barcelona Spain ATP World Tour,CLAY,2,Andy Murray,Marcel Granollers,Andy Murray,4-6; 6-4; 6-2,R64,122,1,1,51,94,29,51,23,43,7,12,14,52,94,4,4,44,83,24,44,18,39,4,11,14,42,83
2006-04-24 00:00:00.000,Barcelona Spain ATP World Tour,CLAY,2,Stanislas Wawrinka,Nicolas Lapentti,Stanislas Wawrinka,6-2; 6-7(3); 6-3,R64,142,5,5,56,97,40,56,24,41,7,9,15,64,97,1,1,69,97,44,69,12,28,7,12,14,56,97
2006-04-24 00:00:00.000,Barcelona Spain ATP World Tour,CLAY,2,Teymuraz Gabashvili,Igor Andreev,Teymuraz Gabashvili,4-6; 7-6(6); 7-6,R64,148,4,1,52,63,39,52,8,11,1,2,11,47,63,7,2,59,68,48,59,6,9,3,3,12,54,68
2006-04-24 00:00:00.000,Barcelona Spain ATP World Tour,CLAY,2,Evgeny Korolev,Carlos Moya,Evgeny Korolev,7-5; 6-4,R64,108,2,3,53,80,35,53,11,27,5,8,11,46,80,5,3,33,75,21,33,19,42,6,11,11,40,75
2006-04-24 00:00:00.000,Barcelona Spain ATP World Tour,CLAY,2,Fernando Vicente,Alex Calatrava,Fernando Vicente,7-6(4); 6-4,R64,106,5,3,59,85,43,59,10,26,4,6,11,53,85,5,0,49,79,36,49,13,30,8,11,11,49,79
2006-04-24 00:00:00.000,Barcelona Spain ATP World Tour,CLAY,2,Ivo Karlovic,Max Mirnyi,Ivo Karlovic,6-3; 6-4,R64,67,16,3,38,50,33,38,7,12,0,0,10,40,50,4,3,34,54,22,34,10,20,1,3,9,32,54
2006-04-24 00:00:00.000,Barcelona Spain ATP World Tour,CLAY,2,Nikolay Davydenko,N/A Bye,Nikolay Davydenko,,R64,0,0,0,0,0,0,0,0,0,0,0,0,0,0,0,0,0,0,0,0,0,0,0,0,0,0,0
2006-04-24 00:00:00.000,Barcelona Spain ATP World Tour,CLAY,2,Rafael Nadal,Feliciano Lopez,Rafael Nadal,6-4; 6-2,R32,74,1,1,32,48,21,32,12,16,2,4,9,33,48,6,3,32,54,20,32,7,22,2,7,9,27,54
2006-04-24 00:00:00.000,Barcelona Spain ATP World Tour,CLAY,2,Ivan Navarro,Daniel Gimeno-Traver,Ivan Navarro,7-6(5); 7-5,R32,125,2,2,56,82,41,56,14,26,9,11,12,55,82,6,1,50,86,37,50,15,36,3,6,12,52,86
2006-04-24 00:00:00.000,Barcelona Spain ATP World Tour,CLAY,2,Albert Portas,Tomas Berdych,Albert Portas,7-6(6); 6-3,R32,97,10,3,45,72,36,45,12,27,2,3,11,48,72,4,1,44,65,32,44,9,21,2,4,10,41,65
2006-04-24 00:00:00.000,Barcelona Spain ATP World Tour,CLAY,2,Jarkko Nieminen,Philipp Kohlschreiber,Jarkko Nieminen,6-1; 6-2,R32,73,1,2,37,60,25,37,13,23,9,10,8,38,60,1,1,20,49,9,20,12,29,7,12,7,21,49
2006-04-24 00:00:00.000,Barcelona Spain ATP World Tour,CLAY,2,Guillermo Coria,Galo Blanco,Guillermo Coria,6-7(4); 6-0; 6-2,R32,126,1,16,55,86,37,55,8,31,4,9,13,45,86,2,5,51,96,25,51,14,45,8,18,13,39,96
2006-04-24 00:00:00.000,Barcelona Spain ATP World Tour,CLAY,2,Nicolas Almagro,Gael Monfils,Nicolas Almagro,6-2; 6-4,R32,116,4,2,40,73,28,40,17,33,6,7,9,45,73,3,2,39,69,22,39,15,30,12,16,9,37,69
2006-04-24 00:00:00.000,Barcelona Spain ATP World Tour,CLAY,2,Juan Carlos Ferrero,Alberto Martin,Juan Carlos Ferrero,6-4; 7-6(1),R32,112,1,1,64,84,41,64,10,20,5,7,11,51,84,2,4,28,65,18,28,18,37,3,6,11,36,65
2006-04-24 00:00:00.000,Barcelona Spain ATP World Tour,CLAY,2,Albert Costa,Dominik Hrbaty,Albert Costa,6-3; 7-5,R32,82,2,0,51,66,33,51,6,15,3,6,11,39,66,1,2,34,57,22,34,6,23,4,9,10,28,57
2006-04-24 00:00:00.000,Barcelona Spain ATP World Tour,CLAY,2,Tommy Robredo,Potito Starace,Tommy Robredo,6-4; 6-0,R32,66,1,1,47,55,31,47,4,8,5,6,8,35,55,0,1,30,49,15,30,9,19,6,11,8,24,49
2006-04-24 00:00:00.000,Barcelona Spain ATP World Tour,CLAY,2,Fernando Verdasco,Agustin Calleri,Fernando Verdasco,7-5; 6-4,R32,85,2,5,46,67,37,46,9,21,4,5,11,46,67,3,2,52,71,35,52,8,19,5,8,11,43,71
2006-04-24 00:00:00.000,Barcelona Spain ATP World Tour,CLAY,2,Paul-Henri Mathieu,Carlos Cuadrado,Paul-Henri Mathieu,7-6(4); 6-4,R32,101,1,2,53,72,34,53,13,19,2,3,11,47,72,4,3,51,73,36,51,10,22,5,7,11,46,73
2006-04-24 00:00:00.000,Barcelona Spain ATP World Tour,CLAY,2,Radek Stepanek,Filippo Volandri,Radek Stepanek,3-6; 7-6(0); 6-4,R32,119,4,7,67,110,50,67,19,43,8,11,15,69,110,2,3,68,90,48,68,10,22,2,5,16,58,90
2006-04-24 00:00:00.000,Barcelona Spain ATP World Tour,CLAY,2,David Ferrer,Andy Murray,David Ferrer,4-6(5); 7-6; 6-1,R32,145,21,4,64,114,44,64,24,50,9,12,15,68,114,12,2,52,100,40,52,26,48,8,10,15,66,100
2006-04-24 00:00:00.000,Barcelona Spain ATP World Tour,CLAY,2,Stanislas Wawrinka,Teymuraz Gabashvili,Stanislas Wawrinka,6-4; 6-7(4); 6-4,R32,123,8,3,48,88,35,48,26,40,0,3,16,61,88,8,3,66,105,47,66,15,39,5,10,16,62,105
2006-04-24 00:00:00.000,Barcelona Spain ATP World Tour,CLAY,2,Evgeny Korolev,Fernando Vicente,Evgeny Korolev,6-3; 6-0,R32,62,5,3,48,73,34,48,12,25,7,7,8,46,73,1,0,34,48,18,34,4,14,2,6,7,22,48
2006-04-24 00:00:00.000,Barcelona Spain ATP World Tour,CLAY,2,Ivo Karlovic,Nikolay Davydenko,Ivo Karlovic,6-7(7); 7-5; 6-4,R32,165,19,0,74,114,60,74,22,40,6,6,17,82,114,4,2,103,125,75,103,12,22,9,11,17,87,125
2006-04-24 00:00:00.000,Barcelona Spain ATP World Tour,CLAY,2,Rafael Nadal,Ivan Navarro,Rafael Nadal,6-4; 6-2,R16,89,0,1,39,57,29,39,11,18,1,1,9,40,57,3,4,30,59,20,30,14,29,4,7,9,34,59
2006-04-24 00:00:00.000,Barcelona Spain ATP World Tour,CLAY,2,Jarkko Nieminen,Albert Portas,Jarkko Nieminen,6-3; 6-2,R16,82,4,0,33,53,24,33,8,20,7,9,8,32,53,2,3,41,72,23,41,10,31,9,15,9,33,72
2006-04-24 00:00:00.000,Barcelona Spain ATP World Tour,CLAY,2,Nicolas Almagro,Guillermo Coria,Nicolas Almagro,6-2; 6-0,R16,51,3,0,30,43,23,30,9,13,2,2,7,32,43,0,14,19,41,13,19,3,22,1,6,7,16,41
2006-04-24 00:00:00.000,Barcelona Spain ATP World Tour,CLAY,2,Juan Carlos Ferrero,Albert Costa,Juan Carlos Ferrero,6-1; 5-7; 7-5,R16,127,4,0,73,93,54,73,10,20,4,6,16,64,93,3,1,59,84,37,59,17,25,0,4,15,54,84
2006-04-24 00:00:00.000,Barcelona Spain ATP World Tour,CLAY,2,Tommy Robredo,Fernando Verdasco,Tommy Robredo,6-3; 2-6; 6-2,R16,129,2,2,79,110,49,79,13,31,12,15,13,62,110,1,2,59,74,40,59,4,15,4,8,12,44,74
2006-04-24 00:00:00.000,Barcelona Spain ATP World Tour,CLAY,2,Radek Stepanek,Paul-Henri Mathieu,Radek Stepanek,1-6; 6-3; 6-2,R16,107,8,2,54,76,38,54,10,22,4,6,12,48,76,1,1,50,73,36,50,10,23,4,7,12,46,73
2006-04-24 00:00:00.000,Barcelona Spain ATP World Tour,CLAY,2,Stanislas Wawrinka,David Ferrer,Stanislas Wawrinka,2-6; 6-2; 6-1,R16,101,4,1,43,78,25,43,16,35,9,13,11,41,78,1,3,62,87,30,62,11,25,6,13,12,41,87
2006-04-24 00:00:00.000,Barcelona Spain ATP World Tour,CLAY,2,Ivo Karlovic,Evgeny Korolev,Ivo Karlovic,6-7(4); 7-6(4); 7-6(5),R16,166,24,4,83,130,70,83,24,47,8,8,18,94,130,6,5,75,114,61,75,27,39,7,7,18,88,114
2006-04-24 00:00:00.000,Barcelona Spain ATP World Tour,CLAY,2,Rafael Nadal,Jarkko Nieminen,Rafael Nadal,4-6; 6-4; 6-3,Q,138,1,1,58,83,39,58,12,25,5,9,14,51,83,2,2,57,90,36,57,12,33,7,13,15,48,90
2006-04-24 00:00:00.000,Barcelona Spain ATP World Tour,CLAY,2,Nicolas Almagro,Juan Carlos Ferrero,Nicolas Almagro,6-3; 6-3,Q,86,5,3,43,75,31,43,15,32,10,11,9,46,75,0,0,42,52,25,42,3,10,2,6,9,28,52
2006-04-24 00:00:00.000,Barcelona Spain ATP World Tour,CLAY,2,Tommy Robredo,Radek Stepanek,Tommy Robredo,6-3; 6-2,Q,72,1,0,56,66,38,56,7,10,7,7,9,45,66,6,1,35,48,20,35,6,13,1,4,8,26,48
2006-04-24 00:00:00.000,Barcelona Spain ATP World Tour,CLAY,2,Stanislas Wawrinka,Ivo Karlovic,Stanislas Wawrinka,4-6; 6-3; 6-4,Q,120,7,1,57,94,43,57,20,37,4,5,15,63,94,12,1,51,77,39,51,15,26,2,4,14,54,77
2006-04-24 00:00:00.000,Barcelona Spain ATP World Tour,CLAY,2,Rafael Nadal,Nicolas Almagro,Rafael Nadal,7-6(2); 6-3,S,100,5,1,48,68,38,48,10,20,1,2,11,48,68,7,2,29,62,23,29,15,33,2,4,10,38,62
2006-04-24 00:00:00.000,Barcelona Spain ATP World Tour,CLAY,2,Tommy Robredo,Stanislas Wawrinka,Tommy Robredo,6-4; 6-4,S,94,2,0,47,61,31,47,7,14,3,6,10,38,61,0,5,39,63,26,39,6,24,5,10,10,32,63
2006-04-24 00:00:00.000,Barcelona Spain ATP World Tour,CLAY,2,Rafael Nadal,Tommy Robredo,Rafael Nadal,6-4; 6-4; 6-0,F,139,2,4,61,85,44,61,15,24,3,3,13,59,85,3,0,58,85,33,58,14,27,3,8,13,47,85
2006-04-24 00:00:00.000,Casablanca Morocco ATP World Tour,CLAY,2,Nicolas Massu,Michael Berrer,Nicolas Massu,7-6(4); 6-0,R32,90,4,2,33,64,25,33,21,31,3,3,9,46,64,4,5,32,54,23,32,11,22,1,4,9,34,54
2006-04-24 00:00:00.000,Casablanca Morocco ATP World Tour,CLAY,2,Alessio Di Mauro,Mounir El Aarej,Alessio Di Mauro,6-2; 6-4,R32,71,2,1,37,59,29,37,11,22,3,3,9,40,59,3,1,38,51,26,38,3,13,0,3,9,29,51
2006-04-24 00:00:00.000,Casablanca Morocco ATP World Tour,CLAY,2,Nicolas Mahut,Carlos Berlocq,Nicolas Mahut,6-4; 6-1,R32,86,1,3,24,46,18,24,13,22,0,1,8,31,46,3,3,28,66,17,28,15,38,5,10,9,32,66
2006-04-24 00:00:00.000,Casablanca Morocco ATP World Tour,CLAY,2,Arnaud Clement,Juan Monaco,Arnaud Clement,6-4; 6-1,R32,104,2,1,30,63,21,30,19,33,3,4,9,40,63,1,3,54,85,29,54,14,31,10,14,8,43,85
2006-04-24 00:00:00.000,Casablanca Morocco ATP World Tour,CLAY,2,Bjorn Phau,Andreas Seppi,Bjorn Phau,7-6(4); 6-1,R32,79,3,3,37,69,27,37,17,32,6,7,9,44,69,4,2,35,62,18,35,14,27,1,5,10,32,62
2006-04-24 00:00:00.000,Casablanca Morocco ATP World Tour,CLAY,2,Slimane Saoudi,David Skoch,Slimane Saoudi,6-3; 6-2,R32,65,1,2,42,54,30,42,6,12,0,1,9,36,54,3,3,28,49,16,28,9,21,2,6,8,25,49
2006-04-24 00:00:00.000,Casablanca Morocco ATP World Tour,CLAY,2,Jiri Vanek,Ruben Ramirez Hidalgo,Jiri Vanek,5-7; 6-1; 6-4,R32,117,2,3,48,80,38,48,18,32,4,6,14,56,80,2,2,43,82,26,43,21,39,3,8,15,47,82
2006-04-24 00:00:00.000,Casablanca Morocco ATP World Tour,CLAY,2,Jurgen Melzer,Guillermo Garcia-Lopez,Jurgen Melzer,6-3; 1-6; 6-3,R32,98,5,4,56,92,38,56,16,36,6,10,13,54,92,2,5,44,69,29,44,10,25,0,4,12,39,69
2006-04-24 00:00:00.000,Casablanca Morocco ATP World Tour,CLAY,2,Gilles Simon,Jan Hernych,Gilles Simon,6-1; 4-6; 6-4,R32,100,2,1,47,79,29,47,17,32,1,5,14,46,79,3,5,49,78,26,49,15,29,3,9,13,41,78
2006-04-24 00:00:00.000,Casablanca Morocco ATP World Tour,CLAY,2,Mehdi Tahiri,Oliver Marach,Mehdi Tahiri,3-6; 6-3; 7-6(2),R32,151,2,3,65,88,40,65,13,23,2,6,15,53,88,6,1,51,94,35,51,20,43,5,9,15,55,94
2006-04-24 00:00:00.000,Casablanca Morocco ATP World Tour,CLAY,2,Florian Mayer,Lamine Ouahab,Florian Mayer,6-1; 7-6(4),R32,93,2,1,33,60,28,33,16,27,1,2,10,44,60,1,1,47,61,28,47,8,14,2,5,9,36,61
2006-04-24 00:00:00.000,Casablanca Morocco ATP World Tour,CLAY,2,Christophe Rochus,Tomas Behrend,Christophe Rochus,6-3; 6-4,R32,63,1,2,42,59,22,42,10,17,4,8,9,32,59,2,7,37,61,24,37,1,24,1,8,10,25,61
2006-04-24 00:00:00.000,Casablanca Morocco ATP World Tour,CLAY,2,Daniele Bracciali,Olivier Patience,Daniele Bracciali,6-3; 6-4,R32,64,4,4,28,50,26,28,11,22,1,1,9,37,50,1,2,43,62,27,43,8,19,2,5,10,35,62
2006-04-24 00:00:00.000,Casablanca Morocco ATP World Tour,CLAY,2,Alexander Waske,Gilles Muller,Alexander Waske,6-4; 7-5,R32,93,4,5,34,66,28,34,16,32,2,3,11,44,66,9,8,43,72,28,43,15,29,3,6,11,43,72
2006-04-24 00:00:00.000,Casablanca Morocco ATP World Tour,CLAY,2,Marc Gicquel,Janko Tipsarevic,Marc Gicquel,6-4; 6-1,R32,56,7,2,26,44,22,26,12,18,3,3,8,34,44,4,8,24,53,18,24,10,29,4,8,9,28,53
2006-04-24 00:00:00.000,Casablanca Morocco ATP World Tour,CLAY,2,Luis Horna,Tomislav Peric,Luis Horna,7-5; 6-2,R32,67,2,0,45,56,31,45,10,11,0,0,10,41,56,10,8,27,59,24,27,11,32,6,9,10,35,59
2006-04-24 00:00:00.000,Casablanca Morocco ATP World Tour,CLAY,2,Nicolas Massu,Alessio Di Mauro,Nicolas Massu,6-7(2); 6-3; 6-1,R16,144,3,4,32,85,23,32,32,53,4,7,14,55,85,4,1,56,90,35,56,13,34,9,16,14,48,90
2006-04-24 00:00:00.000,Casablanca Morocco ATP World Tour,CLAY,2,Nicolas Mahut,Arnaud Clement,Nicolas Mahut,6-3; 7-6(6),R16,140,8,5,44,83,26,44,22,39,7,9,10,48,83,3,1,38,71,20,38,18,33,3,7,11,38,71
2006-04-24 00:00:00.000,Casablanca Morocco ATP World Tour,CLAY,2,Bjorn Phau,Slimane Saoudi,Bjorn Phau,6-4; 6-4,R16,71,4,2,41,57,27,41,11,16,0,2,10,38,57,2,4,35,54,22,35,8,19,2,6,10,30,54
2006-04-24 00:00:00.000,Casablanca Morocco ATP World Tour,CLAY,2,Jiri Vanek,Jurgen Melzer,Jiri Vanek,7-6(5); 6-2,R16,89,2,3,36,62,27,36,10,26,5,9,10,37,62,6,3,53,78,32,53,8,25,8,14,10,40,78
2006-04-24 00:00:00.000,Casablanca Morocco ATP World Tour,CLAY,2,Gilles Simon,Mehdi Tahiri,Gilles Simon,6-3; 6-4,R16,89,9,0,31,53,25,31,15,22,0,1,10,40,53,1,2,37,61,24,37,10,24,2,5,9,34,61
2006-04-24 00:00:00.000,Casablanca Morocco ATP World Tour,CLAY,2,Christophe Rochus,Florian Mayer,Christophe Rochus,6-2; 6-1,R16,53,2,0,30,44,24,30,10,14,1,1,8,34,44,3,2,23,44,15,23,5,21,2,6,7,20,44
2006-04-24 00:00:00.000,Casablanca Morocco ATP World Tour,CLAY,2,Daniele Bracciali,Alexander Waske,Daniele Bracciali,6-4; 7-5,R16,96,7,2,41,71,31,41,19,30,7,7,11,50,71,5,3,47,72,29,47,17,25,3,5,11,46,72
2006-04-24 00:00:00.000,Casablanca Morocco ATP World Tour,CLAY,2,Luis Horna,Marc Gicquel,Luis Horna,6-1; 5-7; 6-3,R16,143,7,1,51,84,34,51,20,33,5,8,14,54,84,9,4,39,84,28,39,18,45,4,10,14,46,84
2006-04-24 00:00:00.000,Casablanca Morocco ATP World Tour,CLAY,2,Nicolas Massu,Nicolas Mahut,Nicolas Massu,6-3; 7-6(3),Q,117,4,0,53,68,40,53,9,15,1,2,11,49,68,5,4,43,72,30,43,14,29,4,6,10,44,72
2006-04-24 00:00:00.000,Casablanca Morocco ATP World Tour,CLAY,2,Bjorn Phau,Jiri Vanek,Bjorn Phau,7-5; 6-3,Q,92,3,1,43,77,30,43,13,34,6,9,10,43,77,3,6,46,72,25,46,8,26,3,9,11,33,72
2006-04-24 00:00:00.000,Casablanca Morocco ATP World Tour,CLAY,2,Gilles Simon,Christophe Rochus,Gilles Simon,6-3; 3-6; 6-4,Q,119,4,3,52,107,38,52,21,55,11,16,14,59,107,1,8,51,81,31,51,14,30,2,8,14,45,81
2006-04-24 00:00:00.000,Casablanca Morocco ATP World Tour,CLAY,2,Daniele Bracciali,Luis Horna,Daniele Bracciali,6-7(12); 6-4; 7-6(3),Q,164,19,6,65,131,53,65,33,66,8,9,17,86,131,8,4,80,119,59,80,20,39,4,6,17,79,119
2006-04-24 00:00:00.000,Casablanca Morocco ATP World Tour,CLAY,2,Nicolas Massu,Bjorn Phau,Nicolas Massu,6-2; 6-4,S,91,4,0,38,57,29,38,12,19,3,3,9,41,57,1,3,28,46,20,28,7,18,2,5,9,27,46
2006-04-24 00:00:00.000,Casablanca Morocco ATP World Tour,CLAY,2,Daniele Bracciali,Gilles Simon,Daniele Bracciali,6-0; 3-1 RET,S,45,5,1,17,34,14,17,10,17,3,3,5,24,34,1,1,21,40,11,21,6,19,6,10,5,17,40
2006-04-24 00:00:00.000,Casablanca Morocco ATP World Tour,CLAY,2,Daniele Bracciali,Nicolas Massu,Daniele Bracciali,6-1; 6-4,F,93,9,0,33,57,27,33,13,24,4,4,9,40,57,4,2,31,61,21,31,12,30,8,11,8,33,61
2006-05-01 00:00:00.000,Estoril Portugal ATP World Tour,CLAY,2,David Nalbandian,Nicolas Mahut,David Nalbandian,7-5; 7-5,R32,110,1,3,41,76,28,41,18,35,3,6,12,46,76,5,4,41,77,24,41,18,36,0,5,12,42,77
2006-05-01 00:00:00.000,Estoril Portugal ATP World Tour,CLAY,2,Jeremy Chardy,Jimmy Wang,Jeremy Chardy,7-5; 6-1,R32,102,5,6,54,96,38,54,15,42,9,11,9,53,96,1,5,43,64,20,43,9,21,2,8,10,29,64
2006-05-01 00:00:00.000,Estoril Portugal ATP World Tour,CLAY,2,Frederico Gil,David Luque-Velasco,Frederico Gil,1-6; 7-6(5); 6-4,R32,154,4,4,50,88,34,50,24,38,3,6,14,58,88,0,8,71,110,45,71,23,39,7,9,15,68,110
2006-05-01 00:00:00.000,Estoril Portugal ATP World Tour,CLAY,2,Dmitry Tursunov,Gastao Elias,Dmitry Tursunov,6-2; 6-1,R32,53,4,1,26,43,20,26,11,17,0,0,7,31,43,3,3,15,53,8,15,15,38,5,10,8,23,53
2006-05-01 00:00:00.000,Estoril Portugal ATP World Tour,CLAY,2,Gael Monfils,Razvan Sabau,Gael Monfils,6-1; 6-2,R32,39,8,0,24,35,18,24,8,11,0,1,7,26,35,1,4,24,42,12,24,2,18,4,10,8,14,42
2006-05-01 00:00:00.000,Estoril Portugal ATP World Tour,CLAY,2,Albert Portas,Juan Antonio Marin,Albert Portas,6-3; 6-4,R32,85,1,3,40,57,28,40,7,17,3,5,9,35,57,2,1,27,54,19,27,10,27,4,9,10,29,54
2006-05-01 00:00:00.000,Estoril Portugal ATP World Tour,CLAY,2,Justin Gimelstob,Lukas Dlouhy,Justin Gimelstob,3-6; 7-5; 6-3,R32,131,5,5,47,93,30,47,28,46,4,7,15,58,93,2,3,64,98,40,64,19,34,13,17,15,59,98
2006-05-01 00:00:00.000,Estoril Portugal ATP World Tour,CLAY,2,Nicolas Massu,Raemon Sluiter,Nicolas Massu,6-0; 7-5,R32,84,5,1,35,46,27,35,6,11,1,3,9,33,46,6,2,41,64,23,41,5,23,4,10,9,28,64
2006-05-01 00:00:00.000,Estoril Portugal ATP World Tour,CLAY,2,Carlos Moya,Flavio Saretta,Carlos Moya,6-3; 6-4,R32,105,4,0,29,61,23,29,21,32,4,4,10,44,61,1,3,52,82,31,52,14,30,9,11,9,45,82
2006-05-01 00:00:00.000,Estoril Portugal ATP World Tour,CLAY,2,Gustavo Marcaccio,Tomas Zib,Gustavo Marcaccio,6-4; 6-2,R32,82,2,0,41,61,27,41,11,20,4,5,9,38,61,5,2,24,48,15,24,11,24,2,6,9,26,48
2006-05-01 00:00:00.000,Estoril Portugal ATP World Tour,CLAY,2,Guillermo Garcia-Lopez,Leonardo Azzaro,Guillermo Garcia-Lopez,6-4; 4-6; 6-4,R32,141,6,6,49,94,31,49,26,45,3,7,15,57,94,4,2,68,102,45,68,14,34,11,16,15,59,102
2006-05-01 00:00:00.000,Estoril Portugal ATP World Tour,CLAY,2,Carlos Berlocq,Didac Perez,Carlos Berlocq,6-0; 6-1,R32,55,2,0,33,43,23,33,7,10,3,3,6,30,43,1,6,22,42,13,22,3,20,2,8,7,16,42
2006-05-01 00:00:00.000,Estoril Portugal ATP World Tour,CLAY,2,Gilles Muller,Christophe Rochus,Gilles Muller,6-2; 6-0,R32,45,10,0,29,38,22,29,7,9,3,3,7,29,38,1,1,28,44,13,28,4,16,2,7,7,17,44
2006-05-01 00:00:00.000,Estoril Portugal ATP World Tour,CLAY,2,Nicolas Lapentti,Michal Przysiezny,Nicolas Lapentti,6-7(3); 6-4; 6-4,R32,188,4,4,75,122,54,75,26,47,7,8,16,80,122,5,3,65,122,42,65,34,57,7,10,16,76,122
2006-05-01 00:00:00.000,Estoril Portugal ATP World Tour,CLAY,2,Marat Safin,Fabio Fognini,Marat Safin,6-1; 6-4,R32,71,2,1,29,54,18,29,16,25,3,4,8,34,54,0,3,31,57,15,31,12,26,5,10,9,27,57
2006-05-01 00:00:00.000,Estoril Portugal ATP World Tour,CLAY,2,Nikolay Davydenko,Vincent Spadea,Nikolay Davydenko,7-6(3); 6-3,R32,95,2,4,49,75,32,49,16,26,1,3,11,48,75,2,2,29,62,20,29,14,33,1,4,10,34,62
2006-05-01 00:00:00.000,Estoril Portugal ATP World Tour,CLAY,2,David Nalbandian,Jeremy Chardy,David Nalbandian,6-1; 7-6(0),R16,75,2,6,34,64,27,34,17,30,7,9,10,44,64,1,5,30,49,16,30,9,19,3,7,9,25,49
2006-05-01 00:00:00.000,Estoril Portugal ATP World Tour,CLAY,2,Frederico Gil,Dmitry Tursunov,Frederico Gil,4-6; 6-4; 6-1,R16,139,2,1,69,98,44,69,15,29,9,12,14,59,98,6,6,40,80,27,40,16,40,5,10,13,43,80
2006-05-01 00:00:00.000,Estoril Portugal ATP World Tour,CLAY,2,Albert Portas,Gael Monfils,Albert Portas,3-6; 7-6(3); 6-4,R16,148,1,2,53,106,36,53,23,53,6,11,15,59,106,6,8,50,101,36,50,24,51,6,11,16,60,101
2006-05-01 00:00:00.000,Estoril Portugal ATP World Tour,CLAY,2,Justin Gimelstob,Nicolas Massu,Justin Gimelstob,2-6; 7-6(3); 6-4,R16,157,9,4,55,102,40,55,23,47,5,8,15,63,102,9,1,66,103,41,66,25,37,7,9,15,66,103
2006-05-01 00:00:00.000,Estoril Portugal ATP World Tour,CLAY,2,Carlos Moya,Gustavo Marcaccio,Carlos Moya,6-1; 7-5,R16,94,17,1,40,69,30,40,15,29,5,6,10,45,69,1,3,38,64,18,38,14,26,3,7,9,32,64
2006-05-01 00:00:00.000,Estoril Portugal ATP World Tour,CLAY,2,Guillermo Garcia-Lopez,Carlos Berlocq,Guillermo Garcia-Lopez,6-7(11); 7-5; 7-6(5),R16,206,0,5,78,126,47,78,27,48,1,6,18,74,126,0,4,94,130,53,94,21,36,4,10,18,74,130
2006-05-01 00:00:00.000,Estoril Portugal ATP World Tour,CLAY,2,Gilles Muller,Nicolas Lapentti,Gilles Muller,6-1; 6-4,R16,93,5,2,36,65,28,36,15,29,3,3,9,43,65,1,0,40,62,26,40,8,22,6,9,8,34,62
2006-05-01 00:00:00.000,Estoril Portugal ATP World Tour,CLAY,2,Nikolay Davydenko,Marat Safin,Nikolay Davydenko,4-6; 6-1; 6-2,R16,108,1,2,51,79,38,51,13,28,4,6,13,51,79,5,0,48,75,29,48,10,27,5,10,12,39,75
2006-05-01 00:00:00.000,Estoril Portugal ATP World Tour,CLAY,2,David Nalbandian,Frederico Gil,David Nalbandian,6-1; 6-2,Q,76,2,2,22,42,17,22,14,20,2,2,7,31,42,0,0,53,62,27,53,2,9,7,12,8,29,62
2006-05-01 00:00:00.000,Estoril Portugal ATP World Tour,CLAY,2,Albert Portas,Justin Gimelstob,Albert Portas,6-4; 6-3,Q,82,2,1,34,50,25,34,8,16,3,5,9,33,50,5,2,45,72,26,45,10,27,4,9,10,36,72
2006-05-01 00:00:00.000,Estoril Portugal ATP World Tour,CLAY,2,Carlos Moya,Guillermo Garcia-Lopez,Carlos Moya,7-6(4); 6-4,Q,104,3,1,40,71,31,40,18,31,1,3,11,49,71,4,2,54,76,37,54,10,22,4,7,11,47,76
2006-05-01 00:00:00.000,Estoril Portugal ATP World Tour,CLAY,2,Nikolay Davydenko,Gilles Muller,Nikolay Davydenko,6-4; 6-4,Q,91,1,2,47,67,32,47,14,20,4,4,10,46,67,5,2,48,79,34,48,16,31,11,13,10,50,79
2006-05-01 00:00:00.000,Estoril Portugal ATP World Tour,CLAY,2,David Nalbandian,Albert Portas,David Nalbandian,7-5; 6-1,S,78,4,0,30,52,22,30,16,22,1,2,10,38,52,2,2,25,60,15,25,15,35,4,8,9,30,60
2006-05-01 00:00:00.000,Estoril Portugal ATP World Tour,CLAY,2,Nikolay Davydenko,Carlos Moya,Nikolay Davydenko,3-6; 6-2; 6-2,S,109,1,1,56,79,35,56,13,23,2,5,13,48,79,1,4,53,78,34,53,10,25,5,10,12,44,78
2006-05-01 00:00:00.000,Estoril Portugal ATP World Tour,CLAY,2,David Nalbandian,Nikolay Davydenko,David Nalbandian,6-3; 6-4,F,79,2,4,38,61,26,38,15,23,1,2,10,41,61,1,2,33,52,21,33,8,19,3,6,9,29,52
2006-05-01 00:00:00.000,Munich Germany ATP World Tour,CLAY,2,Denis Gremelmayr,Guillermo Coria,Denis Gremelmayr,3-6; 6-2; 6-3,R32,118,4,1,38,83,24,38,24,45,8,12,13,48,83,0,17,54,91,33,54,16,37,10,16,13,49,91
2006-05-01 00:00:00.000,Munich Germany ATP World Tour,CLAY,2,Alexander Peya,Dieter Kindlmann,Alexander Peya,6-3; 6-4,R32,62,5,3,35,56,25,35,14,21,2,3,10,39,56,0,5,34,53,21,34,9,19,4,7,9,30,53
2006-05-01 00:00:00.000,Munich Germany ATP World Tour,CLAY,2,Ruben Ramirez Hidalgo,Tobias Summerer,Ruben Ramirez Hidalgo,6-1; 6-2,R32,72,3,1,43,61,30,43,10,18,1,1,8,40,61,4,1,32,51,16,32,10,19,4,8,7,26,51
2006-05-01 00:00:00.000,Munich Germany ATP World Tour,CLAY,2,Olivier Rochus,Julio Silva,Olivier Rochus,6-2; 6-0,R32,59,0,0,25,35,19,25,7,10,1,2,7,26,35,3,1,31,49,14,31,4,18,4,10,7,18,49
2006-05-01 00:00:00.000,Munich Germany ATP World Tour,CLAY,2,Ivo Karlovic,Tommy Haas,Ivo Karlovic,6-3; 7-6(3),R32,94,22,1,54,74,43,54,10,20,3,3,11,53,74,2,1,41,58,31,41,9,17,0,1,10,40,58
2006-05-01 00:00:00.000,Munich Germany ATP World Tour,CLAY,2,Bjorn Phau,Tomas Behrend,Bjorn Phau,3-2 RET,R32,22,0,0,4,14,3,4,6,10,1,1,2,9,14,1,1,16,21,10,16,1,5,1,2,3,11,21
2006-05-01 00:00:00.000,Munich Germany ATP World Tour,CLAY,2,Simon Greul,Boris Pashanski,Simon Greul,6-3; 6-7(0); 7-6(8),R32,165,14,5,64,121,49,64,30,57,8,9,16,79,121,5,5,74,127,56,74,23,53,4,7,17,79,127
2006-05-01 00:00:00.000,Munich Germany ATP World Tour,CLAY,2,Jurgen Melzer,Mikhail Youzhny,Jurgen Melzer,6-3; 6-4,R32,75,6,3,53,77,32,53,13,24,7,9,10,45,77,1,2,43,59,26,43,5,16,5,9,9,31,59
2006-05-01 00:00:00.000,Munich Germany ATP World Tour,CLAY,2,Juan Monaco,Paradorn Srichaphan,Juan Monaco,6-4; 6-4,R32,84,3,1,35,60,24,35,16,25,3,4,10,40,60,2,2,37,61,24,37,12,24,3,6,10,36,61
2006-05-01 00:00:00.000,Munich Germany ATP World Tour,CLAY,2,Robin Vik,Rainer Schuettler,Robin Vik,7-6(5); 4-6; 6-3,R32,139,6,2,68,108,45,68,14,40,4,10,16,59,108,1,1,54,96,31,54,18,42,2,8,15,49,96
2006-05-01 00:00:00.000,Munich Germany ATP World Tour,CLAY,2,Alexander Waske,Florian Mayer,Alexander Waske,7-6(4); 6-3,R32,90,7,2,52,71,38,52,10,19,3,4,10,48,71,5,1,50,72,31,50,13,22,4,7,11,44,72
2006-05-01 00:00:00.000,Munich Germany ATP World Tour,CLAY,2,Jarkko Nieminen,Andrei Pavel,Jarkko Nieminen,7-6(7); 7-6(7),R32,109,9,1,63,103,44,63,27,40,9,9,12,71,103,7,1,45,79,36,45,22,34,0,0,12,58,79
2006-05-01 00:00:00.000,Munich Germany ATP World Tour,CLAY,2,Robin Soderling,Florent Serra,Robin Soderling,6-7(6); 7-5; 6-4,R32,151,10,5,66,113,52,66,21,47,6,10,17,73,113,6,4,70,121,47,70,23,51,10,16,17,70,121
2006-05-01 00:00:00.000,Munich Germany ATP World Tour,CLAY,2,Kristof Vliegen,Janko Tipsarevic,Kristof Vliegen,5-7; 6-2; 6-4,R32,115,11,2,53,81,45,53,15,28,5,6,15,60,81,5,2,49,90,38,49,19,41,0,3,15,57,90
2006-05-01 00:00:00.000,Munich Germany ATP World Tour,CLAY,2,Jan Hernych,Andreas Beck,Jan Hernych,7-6(3); 4-6; 6-4,R32,137,10,3,77,104,45,77,16,27,4,9,16,61,104,5,7,57,102,32,57,26,45,7,12,16,58,102
2006-05-01 00:00:00.000,Munich Germany ATP World Tour,CLAY,2,Philipp Kohlschreiber,Mario Ancic,Philipp Kohlschreiber,7-6(3); 7-6(5),R32,112,1,1,50,77,42,50,18,27,0,0,12,60,77,11,0,59,81,47,59,13,22,6,6,12,60,81
2006-05-01 00:00:00.000,Munich Germany ATP World Tour,CLAY,2,Denis Gremelmayr,Alexander Peya,Denis Gremelmayr,6-4; 6-4,R16,80,0,1,33,64,24,33,20,31,3,4,10,44,64,0,2,45,70,28,45,14,25,6,9,10,42,70
2006-05-01 00:00:00.000,Munich Germany ATP World Tour,CLAY,2,Olivier Rochus,Ruben Ramirez Hidalgo,Olivier Rochus,6-2; 7-6(6),R16,97,1,3,45,71,31,45,14,26,3,5,10,45,71,6,2,39,64,26,39,9,25,3,7,10,35,64
2006-05-01 00:00:00.000,Munich Germany ATP World Tour,CLAY,2,Ivo Karlovic,Bjorn Phau,Ivo Karlovic,4-6; 6-3; 7-6(8),R16,137,21,4,64,111,54,64,23,47,2,3,16,77,111,3,4,52,90,40,52,28,38,5,6,15,68,90
2006-05-01 00:00:00.000,Munich Germany ATP World Tour,CLAY,2,Jurgen Melzer,Simon Greul,Jurgen Melzer,6-3; 1-6; 6-4,R16,119,6,1,56,88,37,56,16,32,5,8,13,53,88,2,4,45,87,29,45,23,42,8,11,13,52,87
2006-05-01 00:00:00.000,Munich Germany ATP World Tour,CLAY,2,Robin Vik,Juan Monaco,Robin Vik,7-6(3); 4-6; 6-4,R16,163,2,4,71,108,44,71,18,37,6,13,16,62,108,0,4,66,106,34,66,20,40,3,10,16,54,106
2006-05-01 00:00:00.000,Munich Germany ATP World Tour,CLAY,2,Jarkko Nieminen,Alexander Waske,Jarkko Nieminen,7-6(2); 6-3,R16,112,3,3,43,68,34,43,15,25,2,3,11,49,68,6,4,46,74,32,46,13,28,3,5,10,45,74
2006-05-01 00:00:00.000,Munich Germany ATP World Tour,CLAY,2,Kristof Vliegen,Robin Soderling,Kristof Vliegen,5-7; 6-3; 6-2,R16,107,7,1,49,83,37,49,17,34,3,5,14,54,83,7,3,44,78,30,44,17,34,2,7,15,47,78
2006-05-01 00:00:00.000,Munich Germany ATP World Tour,CLAY,2,Philipp Kohlschreiber,Jan Hernych,Philipp Kohlschreiber,3-6; 6-0; 7-5,R16,111,4,1,61,83,37,61,11,22,5,9,13,48,83,4,7,54,83,34,54,8,29,3,10,14,42,83
2006-05-01 00:00:00.000,Munich Germany ATP World Tour,CLAY,2,Olivier Rochus,Denis Gremelmayr,Olivier Rochus,6-4; 7-5,Q,96,0,2,63,84,39,63,14,21,9,11,11,53,84,4,5,33,61,23,33,11,28,3,7,11,34,61
2006-05-01 00:00:00.000,Munich Germany ATP World Tour,CLAY,2,Jurgen Melzer,Ivo Karlovic,Jurgen Melzer,7-6(4); 6-1,Q,65,2,1,42,59,35,42,13,17,0,0,10,48,59,11,0,35,48,28,35,7,13,1,3,9,35,48
2006-05-01 00:00:00.000,Munich Germany ATP World Tour,CLAY,2,Jarkko Nieminen,Robin Vik,Jarkko Nieminen,7-5; 2-6; 6-2,Q,103,3,0,55,90,35,55,18,35,5,9,14,53,90,2,1,45,78,29,45,13,33,4,9,14,42,78
2006-05-01 00:00:00.000,Munich Germany ATP World Tour,CLAY,2,Kristof Vliegen,Philipp Kohlschreiber,Kristof Vliegen,7-5; 6-4,Q,99,5,1,37,65,28,37,17,28,1,2,11,45,65,3,1,48,73,29,48,15,25,7,10,11,44,73
2006-05-01 00:00:00.000,Munich Germany ATP World Tour,CLAY,2,Olivier Rochus,Jurgen Melzer,Olivier Rochus,6-4; 6-7(1); 6-3,S,137,1,4,65,98,49,65,13,33,3,5,16,62,98,13,3,68,113,47,68,20,45,17,21,15,67,113
2006-05-01 00:00:00.000,Munich Germany ATP World Tour,CLAY,2,Kristof Vliegen,Jarkko Nieminen,Kristof Vliegen,6-1; 6-2,S,68,4,1,34,50,26,34,10,16,3,3,8,36,50,2,1,29,48,18,29,6,19,6,10,7,24,48
2006-05-01 00:00:00.000,Munich Germany ATP World Tour,CLAY,2,Olivier Rochus,Kristof Vliegen,Olivier Rochus,6-4; 6-2,F,82,1,1,31,50,25,31,11,19,2,3,9,36,50,2,4,34,59,18,34,12,25,4,8,9,30,59
2006-05-08 00:00:00.000,ATP Masters Series Rome Italy ATP World Tour,CLAY,2,Roger Federer,Juan Ignacio Chela,Roger Federer,6-2; 6-1,R64,68,3,0,29,51,20,29,15,22,1,2,8,35,51,0,1,23,50,15,23,7,27,5,10,7,22,50
2006-05-08 00:00:00.000,ATP Masters Series Rome Italy ATP World Tour,CLAY,2,Potito Starace,Dmitry Tursunov,Potito Starace,6-4; 6-1,R64,67,1,0,32,48,26,32,10,16,2,2,8,36,48,1,2,20,47,17,20,9,27,2,6,9,26,47
2006-05-08 00:00:00.000,ATP Masters Series Rome Italy ATP World Tour,CLAY,2,Jarkko Nieminen,Sebastien Grosjean,Jarkko Nieminen,6-2; 6-1,R64,69,0,0,21,41,12,21,14,20,1,2,7,26,41,2,1,16,53,10,16,13,37,4,10,8,23,53
2006-05-08 00:00:00.000,ATP Masters Series Rome Italy ATP World Tour,CLAY,2,Radek Stepanek,Feliciano Lopez,Radek Stepanek,6-4; 6-4,R64,88,7,8,41,75,28,41,17,34,10,12,10,45,75,2,3,28,56,16,28,15,28,2,6,10,31,56
2006-05-08 00:00:00.000,ATP Masters Series Rome Italy ATP World Tour,CLAY,2,Jose Acasuso,David Ferrer,Jose Acasuso,7-5; 6-0,R64,80,3,0,28,53,22,28,11,25,0,2,9,33,53,1,5,38,61,20,38,7,23,3,9,9,27,61
2006-05-08 00:00:00.000,ATP Masters Series Rome Italy ATP World Tour,CLAY,2,Nicolas Almagro,Nicolas Massu,Nicolas Almagro,7-5; 6-4,R64,119,3,2,50,68,36,50,11,18,4,5,11,47,68,1,0,50,68,35,50,6,18,5,8,11,41,68
2006-05-08 00:00:00.000,ATP Masters Series Rome Italy ATP World Tour,CLAY,2,Fernando Verdasco,Simone Bolelli,Fernando Verdasco,6-4; 2-6; 6-1,R64,106,2,2,46,67,23,46,12,21,3,8,12,35,67,1,1,45,72,23,45,12,27,3,10,13,35,72
2006-05-08 00:00:00.000,ATP Masters Series Rome Italy ATP World Tour,CLAY,2,Nikolay Davydenko,Boris Pashanski,Nikolay Davydenko,6-1; 6-4,R64,83,3,4,43,63,29,43,8,20,9,11,9,37,63,0,4,27,46,17,27,4,19,4,9,8,21,46
2006-05-08 00:00:00.000,ATP Masters Series Rome Italy ATP World Tour,CLAY,2,David Nalbandian,Fernando Vicente,David Nalbandian,6-2; 3-6; 6-3,R64,117,1,4,48,82,38,48,18,34,7,8,13,56,82,7,1,55,86,38,55,17,31,6,9,13,55,86
2006-05-08 00:00:00.000,ATP Masters Series Rome Italy ATP World Tour,CLAY,2,Paul-Henri Mathieu,Juan Carlos Ferrero,Paul-Henri Mathieu,6-1; 6-3,R64,68,5,3,32,50,29,32,8,18,2,2,8,37,50,1,1,40,47,20,40,3,7,2,6,8,23,47
2006-05-08 00:00:00.000,ATP Masters Series Rome Italy ATP World Tour,CLAY,2,Alberto Martin,Davide Sanguinetti,Alberto Martin,6-4; 6-2,R64,77,0,0,31,57,22,31,17,26,5,6,9,39,57,1,2,29,52,17,29,12,23,3,7,9,29,52
2006-05-08 00:00:00.000,ATP Masters Series Rome Italy ATP World Tour,CLAY,2,Nicolas Kiefer,Daniele Bracciali,Nicolas Kiefer,4-6; 6-2; 6-4,R64,127,4,7,41,91,31,41,25,50,7,10,14,56,91,4,3,34,75,21,34,21,41,3,8,14,42,75
2006-05-08 00:00:00.000,ATP Masters Series Rome Italy ATP World Tour,CLAY,2,Ruben Ramirez Hidalgo,Guillermo Coria,Ruben Ramirez Hidalgo,6-3; 6-2,R64,88,2,1,26,55,21,26,10,29,3,6,9,31,55,0,10,36,55,18,36,5,19,7,13,8,23,55
2006-05-08 00:00:00.000,ATP Masters Series Rome Italy ATP World Tour,CLAY,2,Marat Safin,Teymuraz Gabashvili,Marat Safin,7-5; 3-6; 6-1,R64,150,5,4,59,119,42,59,31,60,10,11,14,73,119,5,3,45,91,30,45,25,46,6,9,14,55,91
2006-05-08 00:00:00.000,ATP Masters Series Rome Italy ATP World Tour,CLAY,2,Mario Ancic,Luis Horna,Mario Ancic,6-4; 6-4,R64,86,7,1,37,52,29,37,9,15,2,3,10,38,52,1,2,53,73,33,53,8,20,5,8,10,41,73
2006-05-08 00:00:00.000,ATP Masters Series Rome Italy ATP World Tour,CLAY,2,Florent Serra,James Blake,Florent Serra,6-4; 7-6(3),R64,101,1,2,57,90,36,57,18,33,7,10,11,54,90,4,2,39,66,27,39,12,27,2,6,11,39,66
2006-05-08 00:00:00.000,ATP Masters Series Rome Italy ATP World Tour,CLAY,2,Andy Roddick,Victor Hanescu,Andy Roddick,6-1; 6-0,R64,51,3,2,12,33,12,12,13,21,2,2,6,25,33,1,3,33,55,11,33,10,22,3,9,7,21,55
2006-05-08 00:00:00.000,ATP Masters Series Rome Italy ATP World Tour,CLAY,2,Marcos Baghdatis,Olivier Rochus,Marcos Baghdatis,7-5; 6-4,R64,116,15,1,43,85,32,43,17,42,8,10,11,49,85,1,2,50,88,27,50,18,38,5,9,11,45,88
2006-05-08 00:00:00.000,ATP Masters Series Rome Italy ATP World Tour,CLAY,2,Stefano Galvani,Jiri Novak,Stefano Galvani,6-3; 6-4,R64,100,0,6,49,84,25,49,20,35,12,16,10,45,84,1,3,38,63,16,38,10,25,6,12,9,26,63
2006-05-08 00:00:00.000,ATP Masters Series Rome Italy ATP World Tour,CLAY,2,Greg Rusedski,Tommy Robredo,Greg Rusedski,5-7; 6-3; 6-4,R64,133,7,4,73,117,54,73,13,44,11,15,16,67,117,1,1,53,78,34,53,14,25,4,9,15,48,78
2006-05-08 00:00:00.000,ATP Masters Series Rome Italy ATP World Tour,CLAY,2,Robby Ginepri,Max Mirnyi,Robby Ginepri,3-6; 6-2; 6-3,R64,118,7,3,54,88,39,54,18,34,6,8,13,57,88,7,5,49,98,34,49,24,49,8,12,13,58,98
2006-05-08 00:00:00.000,ATP Masters Series Rome Italy ATP World Tour,CLAY,2,Gael Monfils,Tommy Haas,Gael Monfils,6-2; 3-6; 6-4,R64,126,4,6,44,97,29,44,24,53,5,9,13,53,97,0,4,50,89,29,50,20,39,9,15,14,49,89
2006-05-08 00:00:00.000,ATP Masters Series Rome Italy ATP World Tour,CLAY,2,Fabrice Santoro,Juan Monaco,Fabrice Santoro,4-6; 6-2; 6-3,R64,137,1,3,52,97,36,52,18,45,6,10,14,54,97,1,0,62,83,39,62,5,21,6,12,13,44,83
2006-05-08 00:00:00.000,ATP Masters Series Rome Italy ATP World Tour,CLAY,2,Dominik Hrbaty,Ivan Ljubicic,Dominik Hrbaty,5-7; 7-6(4); 6-4,R64,169,4,7,64,116,49,64,28,52,10,12,17,77,116,13,5,53,119,37,53,37,66,7,9,17,74,119
2006-05-08 00:00:00.000,ATP Masters Series Rome Italy ATP World Tour,CLAY,2,Xavier Malisse,Gaston Gaudio,Xavier Malisse,4-6; 6-3; 6-3,R64,131,3,0,39,78,28,39,20,39,7,11,14,48,78,2,6,56,100,36,56,18,44,5,11,14,54,100
2006-05-08 00:00:00.000,ATP Masters Series Rome Italy ATP World Tour,CLAY,2,Tomas Berdych,Paradorn Srichaphan,Tomas Berdych,6-1; 6-3,R64,59,5,1,27,41,24,27,10,14,3,3,8,34,41,2,2,34,51,18,34,6,17,4,8,8,24,51
2006-05-08 00:00:00.000,ATP Masters Series Rome Italy ATP World Tour,CLAY,2,Mikhail Youzhny,Andreas Seppi,Mikhail Youzhny,6-2; 7-6(7),R64,100,3,1,38,65,29,38,14,27,3,4,10,43,65,2,3,33,65,22,33,18,32,2,5,10,40,65
2006-05-08 00:00:00.000,ATP Masters Series Rome Italy ATP World Tour,CLAY,2,Fernando Gonzalez,Stanislas Wawrinka,Fernando Gonzalez,6-4; 6-4,R64,94,3,4,45,70,31,45,9,25,5,8,10,40,70,1,2,30,57,21,30,6,27,2,7,10,27,57
2006-05-08 00:00:00.000,ATP Masters Series Rome Italy ATP World Tour,CLAY,2,Thomas Johansson,Fabio Fognini,Thomas Johansson,7-6(3); 6-3,R64,112,3,3,42,74,35,42,15,32,3,5,11,50,74,4,2,47,95,31,47,23,48,5,8,10,54,95
2006-05-08 00:00:00.000,ATP Masters Series Rome Italy ATP World Tour,CLAY,2,Tim Henman,Alessio Di Mauro,Tim Henman,7-5; 7-6(2),R64,117,6,0,47,79,34,47,20,32,7,8,12,54,79,2,1,40,72,28,40,19,32,1,3,12,47,72
2006-05-08 00:00:00.000,ATP Masters Series Rome Italy ATP World Tour,CLAY,2,Filippo Volandri,Andy Murray,Filippo Volandri,6-4; 6-4,R64,95,0,1,33,63,21,33,15,30,0,3,10,36,63,1,4,36,73,20,36,17,37,7,12,10,37,73
2006-05-08 00:00:00.000,ATP Masters Series Rome Italy ATP World Tour,CLAY,2,Rafael Nadal,Carlos Moya,Rafael Nadal,6-1; 2-6; 6-2,R64,114,1,2,57,70,37,57,7,13,2,4,11,44,70,0,2,48,73,32,48,9,25,5,10,12,41,73
2006-05-08 00:00:00.000,ATP Masters Series Rome Italy ATP World Tour,CLAY,2,Roger Federer,Potito Starace,Roger Federer,6-3; 7-6(2),R32,111,2,2,39,80,28,39,21,41,0,3,10,49,80,0,2,56,83,33,56,8,27,6,11,11,41,83
2006-05-08 00:00:00.000,ATP Masters Series Rome Italy ATP World Tour,CLAY,2,Radek Stepanek,Jarkko Nieminen,Radek Stepanek,6-4; 7-6(5),R32,103,4,2,42,70,30,42,14,28,1,3,11,44,70,1,1,56,83,36,56,9,27,3,6,11,45,83
2006-05-08 00:00:00.000,ATP Masters Series Rome Italy ATP World Tour,CLAY,2,Nicolas Almagro,Jose Acasuso,Nicolas Almagro,6-4; 2-6; 6-4,R32,124,3,3,67,94,44,67,14,27,13,16,14,58,94,5,2,47,85,31,47,22,38,4,7,14,53,85
2006-05-08 00:00:00.000,ATP Masters Series Rome Italy ATP World Tour,CLAY,2,Nikolay Davydenko,Fernando Verdasco,Nikolay Davydenko,6-1; 3-6; 6-0,R32,103,1,3,59,82,33,59,15,23,6,9,11,48,82,1,3,48,71,23,48,9,23,3,10,11,32,71
2006-05-08 00:00:00.000,ATP Masters Series Rome Italy ATP World Tour,CLAY,2,David Nalbandian,Paul-Henri Mathieu,David Nalbandian,6-2; 6-4,R32,83,4,1,25,48,19,25,16,23,4,5,9,35,48,0,1,30,56,20,30,11,26,5,9,9,31,56
2006-05-08 00:00:00.000,ATP Masters Series Rome Italy ATP World Tour,CLAY,2,Alberto Martin,Nicolas Kiefer,Alberto Martin,6-3; 7-6(3),R32,110,1,3,49,73,31,49,17,24,2,4,10,48,73,7,3,43,75,27,43,14,32,6,10,11,41,75
2006-05-08 00:00:00.000,ATP Masters Series Rome Italy ATP World Tour,CLAY,2,Ruben Ramirez Hidalgo,Marat Safin,Ruben Ramirez Hidalgo,0-6; 7-6(6); 7-6(3),R32,182,6,1,76,122,47,76,21,46,5,10,15,68,122,6,3,60,117,41,60,30,57,7,9,15,71,117
2006-05-08 00:00:00.000,ATP Masters Series Rome Italy ATP World Tour,CLAY,2,Mario Ancic,Florent Serra,Mario Ancic,3-6; 7-6(10); 6-0,R32,140,13,5,63,104,43,63,23,41,6,10,14,66,104,2,3,47,87,28,47,21,40,4,9,13,49,87
2006-05-08 00:00:00.000,ATP Masters Series Rome Italy ATP World Tour,CLAY,2,Andy Roddick,Marcos Baghdatis,Andy Roddick,3-6; 6-1; 6-2,R32,114,2,7,45,84,29,45,16,39,6,11,12,45,84,1,5,37,84,23,37,14,47,8,16,12,37,84
2006-05-08 00:00:00.000,ATP Masters Series Rome Italy ATP World Tour,CLAY,2,Greg Rusedski,Stefano Galvani,Greg Rusedski,7-6(4); 6-4,R32,106,2,3,53,80,36,53,11,27,3,6,11,47,80,2,6,45,73,30,45,11,28,4,8,11,41,73
2006-05-08 00:00:00.000,ATP Masters Series Rome Italy ATP World Tour,CLAY,2,Gael Monfils,Robby Ginepri,Gael Monfils,6-1; 4-6; 6-4,R32,113,1,9,52,89,37,52,22,37,4,6,14,59,89,2,1,46,73,31,46,14,27,6,10,13,45,73
2006-05-08 00:00:00.000,ATP Masters Series Rome Italy ATP World Tour,CLAY,2,Fabrice Santoro,Dominik Hrbaty,Fabrice Santoro,7-6(2); 6-3,R32,110,1,1,41,81,26,41,23,40,6,8,10,49,81,3,5,44,82,27,44,16,38,3,7,11,43,82
2006-05-08 00:00:00.000,ATP Masters Series Rome Italy ATP World Tour,CLAY,2,Tomas Berdych,Xavier Malisse,Tomas Berdych,6-2; 6-1,R32,64,5,3,23,41,18,23,10,18,0,1,8,28,41,1,1,27,48,12,27,9,21,4,9,7,21,48
2006-05-08 00:00:00.000,ATP Masters Series Rome Italy ATP World Tour,CLAY,2,Fernando Gonzalez,Mikhail Youzhny,Fernando Gonzalez,6-4; 5-7; 6-3,R32,180,3,7,59,117,36,59,31,58,13,18,16,67,117,0,2,73,111,44,73,15,38,10,16,15,59,111
2006-05-08 00:00:00.000,ATP Masters Series Rome Italy ATP World Tour,CLAY,2,Tim Henman,Thomas Johansson,Tim Henman,7-6(8); 6-1,R32,97,4,1,52,75,36,52,13,23,3,5,10,49,75,3,2,37,66,24,37,14,29,5,9,9,38,66
2006-05-08 00:00:00.000,ATP Masters Series Rome Italy ATP World Tour,CLAY,2,Rafael Nadal,Filippo Volandri,Rafael Nadal,6-1; 6-2,R32,71,0,1,34,52,27,34,9,18,4,4,8,36,52,1,1,28,36,10,28,5,8,2,6,7,15,36
2006-05-08 00:00:00.000,ATP Masters Series Rome Italy ATP World Tour,CLAY,2,Roger Federer,Radek Stepanek,Roger Federer,6-1; 6-4,R16,57,2,2,24,46,23,24,14,22,3,3,9,37,46,3,2,35,47,24,35,4,12,4,7,8,28,47
2006-05-08 00:00:00.000,ATP Masters Series Rome Italy ATP World Tour,CLAY,2,Nicolas Almagro,Nikolay Davydenko,Nicolas Almagro,7-6(6) RET,R16,71,2,1,22,46,19,22,14,24,3,3,6,33,46,0,3,34,51,25,34,9,17,7,7,6,34,51
2006-05-08 00:00:00.000,ATP Masters Series Rome Italy ATP World Tour,CLAY,2,David Nalbandian,Alberto Martin,David Nalbandian,7-5; 6-4,R16,108,1,1,39,61,24,39,11,22,3,7,11,35,61,2,2,37,76,22,37,15,39,2,8,11,37,76
2006-05-08 00:00:00.000,ATP Masters Series Rome Italy ATP World Tour,CLAY,2,Mario Ancic,Ruben Ramirez Hidalgo,Mario Ancic,6-3; 6-7(4); 7-5,R16,190,6,4,68,107,48,68,19,39,5,8,16,67,107,6,4,75,119,54,75,18,44,10,16,17,72,119
2006-05-08 00:00:00.000,ATP Masters Series Rome Italy ATP World Tour,CLAY,2,Andy Roddick,Greg Rusedski,Andy Roddick,7-6(4); 6-2,R16,75,5,0,32,51,28,32,16,19,0,0,10,44,51,1,2,47,66,30,47,9,19,2,4,10,39,66
2006-05-08 00:00:00.000,ATP Masters Series Rome Italy ATP World Tour,CLAY,2,Gael Monfils,Fabrice Santoro,Gael Monfils,7-6(7); 6-2,R16,121,5,5,40,78,30,40,10,38,3,7,10,40,78,2,1,49,76,23,49,9,27,9,15,10,32,76
2006-05-08 00:00:00.000,ATP Masters Series Rome Italy ATP World Tour,CLAY,2,Fernando Gonzalez,Tomas Berdych,Fernando Gonzalez,6-2; 6-4,R16,89,4,1,33,56,24,33,16,23,3,3,9,40,56,2,1,25,52,18,25,12,27,1,4,9,30,52
2006-05-08 00:00:00.000,ATP Masters Series Rome Italy ATP World Tour,CLAY,2,Rafael Nadal,Tim Henman,Rafael Nadal,6-2; 6-2,R16,71,1,0,32,41,25,32,7,9,0,0,8,32,41,5,1,34,51,19,34,7,17,0,4,8,26,51
2006-05-08 00:00:00.000,ATP Masters Series Rome Italy ATP World Tour,CLAY,2,Roger Federer,Nicolas Almagro,Roger Federer,6-3; 6-7(2); 7-5,Q,153,9,2,69,111,49,69,24,42,7,9,17,73,111,1,1,85,118,53,85,18,33,7,11,16,71,118
2006-05-08 00:00:00.000,ATP Masters Series Rome Italy ATP World Tour,CLAY,2,David Nalbandian,Mario Ancic,David Nalbandian,6-3; 6-3,Q,84,0,1,23,55,18,23,20,32,2,3,9,38,55,2,1,36,57,24,36,6,21,1,5,9,30,57
2006-05-08 00:00:00.000,ATP Masters Series Rome Italy ATP World Tour,CLAY,2,Gael Monfils,Andy Roddick,Gael Monfils,6-2; 6-3,Q,71,4,5,31,49,22,31,9,18,5,7,8,31,49,2,1,35,57,18,35,8,22,5,11,9,26,57
2006-05-08 00:00:00.000,ATP Masters Series Rome Italy ATP World Tour,CLAY,2,Rafael Nadal,Fernando Gonzalez,Rafael Nadal,6-4; 6-3,Q,102,0,1,45,53,31,45,4,8,2,4,9,35,53,3,1,41,72,22,41,15,31,5,10,10,37,72
2006-05-08 00:00:00.000,ATP Masters Series Rome Italy ATP World Tour,CLAY,2,Roger Federer,David Nalbandian,Roger Federer,6-3; 3-6; 7-6(5),S,163,9,2,56,117,39,56,27,61,11,16,15,66,117,2,8,64,112,40,64,23,48,4,9,15,63,112
2006-05-08 00:00:00.000,ATP Masters Series Rome Italy ATP World Tour,CLAY,2,Rafael Nadal,Gael Monfils,Rafael Nadal,6-2; 6-2,S,77,0,0,39,51,24,39,7,12,2,3,8,31,51,0,4,25,46,13,25,7,21,2,7,8,20,46
2006-05-08 00:00:00.000,ATP Masters Series Rome Italy ATP World Tour,CLAY,2,Rafael Nadal,Roger Federer,Rafael Nadal,6-7(0); 7-6(5); 6-4; 2-6; 7-6(5),F,305,4,1,147,173,101,147,14,26,6,10,27,115,173,10,0,112,180,86,112,35,68,6,9,27,121,180
2006-05-15 00:00:00.000,ATP Masters Series Hamburg Germany ATP World Tour,CLAY,2,Rainer Schuettler,Lukas Dlouhy,Rainer Schuettler,4-6; 6-3; 6-2,R64,104,1,4,60,92,44,60,13,32,6,8,14,57,92,2,5,46,73,30,46,14,27,1,5,13,44,73
2006-05-15 00:00:00.000,ATP Masters Series Hamburg Germany ATP World Tour,CLAY,2,Juan Carlos Ferrero,Olivier Rochus,Juan Carlos Ferrero,7-6(4); 5-7; 6-3,R64,163,4,2,82,100,50,82,10,18,6,11,16,60,100,1,6,80,123,46,80,17,43,7,13,17,63,123
2006-05-15 00:00:00.000,ATP Masters Series Hamburg Germany ATP World Tour,CLAY,2,Flavio Saretta,Marat Safin,Flavio Saretta,5-7; 6-0; 6-4,R64,132,1,1,53,82,32,53,17,29,4,8,14,49,82,7,2,65,98,40,65,13,33,5,12,14,53,98
2006-05-15 00:00:00.000,ATP Masters Series Hamburg Germany ATP World Tour,CLAY,2,David Ferrer,Feliciano Lopez,David Ferrer,6-4; 6-2,R64,80,4,1,32,48,26,32,12,16,3,3,9,38,48,4,4,39,71,27,39,13,32,6,9,9,40,71
2006-05-15 00:00:00.000,ATP Masters Series Hamburg Germany ATP World Tour,CLAY,2,Paul-Henri Mathieu,Thomas Johansson,Paul-Henri Mathieu,6-3; 6-4,R64,87,1,3,30,57,24,30,17,27,2,3,10,41,57,6,1,37,64,25,37,11,27,10,13,9,36,64
2006-05-15 00:00:00.000,ATP Masters Series Hamburg Germany ATP World Tour,CLAY,2,Kristof Vliegen,Richard Gasquet,Kristof Vliegen,6-4; 6-2,R64,97,5,1,32,47,24,32,9,15,0,2,9,33,47,0,6,51,96,30,51,16,45,9,14,9,46,96
2006-05-15 00:00:00.000,ATP Masters Series Hamburg Germany ATP World Tour,CLAY,2,Florent Serra,Tomas Berdych,Florent Serra,6-4; 0-6; 7-5,R64,118,7,2,54,99,36,54,18,45,6,11,14,54,99,6,4,51,85,36,51,16,34,4,8,14,52,85
2006-05-15 00:00:00.000,ATP Masters Series Hamburg Germany ATP World Tour,CLAY,2,Tommy Robredo,Jiri Novak,Tommy Robredo,6-3; 6-2,R64,62,1,1,47,59,35,47,7,12,4,4,9,42,59,0,0,30,47,19,30,6,17,1,4,8,25,47
2006-05-15 00:00:00.000,ATP Masters Series Hamburg Germany ATP World Tour,CLAY,2,Nikolay Davydenko,Nicolas Massu,Nikolay Davydenko,6-3; 6-4,R64,87,2,1,39,50,29,39,8,11,0,1,10,37,50,1,2,35,63,24,35,11,28,6,9,9,35,63
2006-05-15 00:00:00.000,ATP Masters Series Hamburg Germany ATP World Tour,CLAY,2,Andreas Seppi,Stanislas Wawrinka,Andreas Seppi,2-6; 7-6(4); 6-1,R64,118,1,3,57,98,36,57,28,41,7,9,14,64,98,10,5,47,86,35,47,19,39,4,6,13,54,86
2006-05-15 00:00:00.000,ATP Masters Series Hamburg Germany ATP World Tour,CLAY,2,Christophe Rochus,Paradorn Srichaphan,Christophe Rochus,7-5; 6-1,R64,87,1,5,32,61,24,32,17,29,0,1,10,41,61,0,3,37,75,23,37,15,38,4,8,9,38,75
2006-05-15 00:00:00.000,ATP Masters Series Hamburg Germany ATP World Tour,CLAY,2,Jarkko Nieminen,Davide Sanguinetti,Jarkko Nieminen,5-7; 6-1; 6-4,R64,128,1,0,44,83,24,44,22,39,3,8,14,46,83,2,1,49,96,24,49,21,47,6,14,15,45,96
2006-05-15 00:00:00.000,ATP Masters Series Hamburg Germany ATP World Tour,CLAY,2,Mario Ancic,Alexander Waske,Mario Ancic,6-2; 7-5,R64,98,7,1,46,81,33,46,18,35,8,9,10,51,81,5,4,34,51,24,34,6,17,1,5,10,30,51
2006-05-15 00:00:00.000,ATP Masters Series Hamburg Germany ATP World Tour,CLAY,2,Guillermo Garcia-Lopez,Mikhail Youzhny,Guillermo Garcia-Lopez,6-0; 6-4,R64,56,2,0,31,43,24,31,10,12,0,0,8,34,43,1,0,26,46,15,26,8,20,0,4,8,23,46
2006-05-15 00:00:00.000,ATP Masters Series Hamburg Germany ATP World Tour,CLAY,2,Andy Murray,Gael Monfils,Andy Murray,6-4; 6-1,R64,81,1,0,28,53,16,28,13,25,2,5,8,29,53,1,0,34,65,17,34,10,31,9,16,9,27,65
2006-05-15 00:00:00.000,ATP Masters Series Hamburg Germany ATP World Tour,CLAY,2,James Blake,Carlos Moya,James Blake,6-3; 3-6; 7-5,R64,133,3,7,58,106,36,58,24,48,5,10,15,60,106,5,1,64,99,36,64,19,35,8,14,15,55,99
2006-05-15 00:00:00.000,ATP Masters Series Hamburg Germany ATP World Tour,CLAY,2,Fernando Gonzalez,Dmitry Tursunov,Fernando Gonzalez,6-4; 6-3,R64,85,4,3,45,70,29,45,16,25,2,2,9,45,70,4,3,43,70,28,43,12,27,3,6,10,40,70
2006-05-15 00:00:00.000,ATP Masters Series Hamburg Germany ATP World Tour,CLAY,2,Dominik Hrbaty,Florian Mayer,Dominik Hrbaty,6-4; 6-2,R64,86,3,1,33,59,24,33,13,26,6,8,9,37,59,2,1,44,78,28,44,10,34,10,15,9,38,78
2006-05-15 00:00:00.000,ATP Masters Series Hamburg Germany ATP World Tour,CLAY,2,Fernando Verdasco,Juan Ignacio Chela,Fernando Verdasco,1-6; 6-4; 6-2,R64,110,1,1,73,87,48,73,6,14,9,12,13,54,87,1,1,50,76,34,50,13,26,7,10,12,47,76
2006-05-15 00:00:00.000,ATP Masters Series Hamburg Germany ATP World Tour,CLAY,2,Novak Djokovic,Guillermo Coria,Novak Djokovic,6-3; 3-6; 6-3,R64,138,0,1,64,93,35,64,19,29,9,13,14,54,93,0,10,53,84,34,53,12,31,9,14,13,46,84
2006-05-15 00:00:00.000,ATP Masters Series Hamburg Germany ATP World Tour,CLAY,2,Sebastien Grosjean,Robby Ginepri,Sebastien Grosjean,7-5; 7-5,R64,105,4,2,45,72,29,45,15,27,2,5,12,44,72,5,1,55,80,33,55,10,25,4,9,12,43,80
2006-05-15 00:00:00.000,ATP Masters Series Hamburg Germany ATP World Tour,CLAY,2,Filippo Volandri,Boris Pashanski,Filippo Volandri,6-2; 6-2,R64,59,0,2,29,41,27,29,6,12,0,0,8,33,41,0,4,32,57,19,32,9,25,6,10,8,28,57
2006-05-15 00:00:00.000,ATP Masters Series Hamburg Germany ATP World Tour,CLAY,2,Jose Acasuso,Simon Greul,Jose Acasuso,6-2; 6-1,R64,58,1,0,21,42,16,21,14,21,4,4,7,30,42,0,2,26,43,10,26,9,17,2,7,8,19,43
2006-05-15 00:00:00.000,ATP Masters Series Hamburg Germany ATP World Tour,CLAY,2,Ivan Ljubicic,Philipp Kohlschreiber,Ivan Ljubicic,6-7(3); 6-3; 6-3,R64,139,15,2,59,100,50,59,18,41,8,9,15,68,100,3,4,55,92,39,55,20,37,5,9,15,59,92
2006-05-15 00:00:00.000,ATP Masters Series Hamburg Germany ATP World Tour,CLAY,2,Gaston Gaudio,Alberto Martin,Gaston Gaudio,6-2; 3-6; 6-4,R64,133,1,3,48,88,24,48,19,40,9,16,13,43,88,0,3,55,89,26,55,12,34,8,17,14,38,89
2006-05-15 00:00:00.000,ATP Masters Series Hamburg Germany ATP World Tour,CLAY,2,Gilles Simon,Greg Rusedski,Gilles Simon,6-1; 6-1,R64,51,2,2,20,38,17,20,12,18,1,1,7,29,38,1,2,28,45,11,28,8,17,6,11,7,19,45
2006-05-15 00:00:00.000,ATP Masters Series Hamburg Germany ATP World Tour,CLAY,2,Max Mirnyi,Luis Horna,Max Mirnyi,7-6(5); 7-5,R64,112,7,6,41,71,35,41,21,30,0,0,12,56,71,4,1,59,84,43,59,14,25,4,5,12,57,84
2006-05-15 00:00:00.000,ATP Masters Series Hamburg Germany ATP World Tour,CLAY,2,Nicolas Kiefer,Jurgen Melzer,Nicolas Kiefer,6-2; 3-6; 6-3,R64,146,7,7,44,95,31,44,29,51,13,15,13,60,95,2,3,55,86,33,55,17,31,5,9,13,50,86
2006-05-15 00:00:00.000,ATP Masters Series Hamburg Germany ATP World Tour,CLAY,2,Radek Stepanek,Marcos Baghdatis,Radek Stepanek,6-3; 3-1 RET,R64,50,1,1,21,35,17,21,7,14,0,2,7,24,35,2,5,15,33,8,15,6,18,3,7,6,14,33
2006-05-15 00:00:00.000,ATP Masters Series Hamburg Germany ATP World Tour,CLAY,2,Bjorn Phau,Fabrice Santoro,Bjorn Phau,3-6; 6-1; 6-4,R64,112,2,3,55,95,37,55,20,40,5,7,13,57,95,1,4,36,67,22,36,19,31,1,5,13,41,67
2006-05-15 00:00:00.000,ATP Masters Series Hamburg Germany ATP World Tour,CLAY,2,Juan Monaco,Xavier Malisse,Juan Monaco,6-3; 2-0 RET,R64,66,0,1,37,48,26,37,4,11,5,6,6,30,48,1,3,14,30,10,14,3,16,0,3,5,13,30
2006-05-15 00:00:00.000,ATP Masters Series Hamburg Germany ATP World Tour,CLAY,2,Robin Soderling,Tommy Haas,Robin Soderling,6-2; 2-1 RET,R64,53,1,0,13,26,9,13,11,13,0,0,5,20,26,2,1,23,38,14,23,6,15,0,3,6,20,38
2006-05-15 00:00:00.000,ATP Masters Series Hamburg Germany ATP World Tour,CLAY,2,Juan Carlos Ferrero,Rainer Schuettler,Juan Carlos Ferrero,6-3; 3-6; 6-2,R32,110,2,1,48,65,30,48,10,17,1,5,13,40,65,2,4,39,87,25,39,21,48,4,10,13,46,87
2006-05-15 00:00:00.000,ATP Masters Series Hamburg Germany ATP World Tour,CLAY,2,David Ferrer,Flavio Saretta,David Ferrer,6-1; 7-6(9),R32,101,0,0,39,67,25,39,14,28,0,2,10,39,67,0,1,36,68,19,36,15,32,4,8,9,34,68
2006-05-15 00:00:00.000,ATP Masters Series Hamburg Germany ATP World Tour,CLAY,2,Paul-Henri Mathieu,Kristof Vliegen,Paul-Henri Mathieu,6-2; 6-4,R32,70,0,4,29,48,23,29,10,19,2,4,9,33,48,2,0,28,48,14,28,8,20,4,9,9,22,48
2006-05-15 00:00:00.000,ATP Masters Series Hamburg Germany ATP World Tour,CLAY,2,Tommy Robredo,Florent Serra,Tommy Robredo,3-6; 6-3; 6-2,R32,100,4,1,64,78,43,64,6,14,5,8,13,49,78,1,1,50,76,27,50,15,26,0,5,13,42,76
2006-05-15 00:00:00.000,ATP Masters Series Hamburg Germany ATP World Tour,CLAY,2,Nikolay Davydenko,Andreas Seppi,Nikolay Davydenko,6-1; 6-2,R32,63,3,1,34,49,25,34,9,15,0,0,8,34,49,0,1,21,44,10,21,10,23,1,5,7,20,44
2006-05-15 00:00:00.000,ATP Masters Series Hamburg Germany ATP World Tour,CLAY,2,Jarkko Nieminen,Christophe Rochus,Jarkko Nieminen,6-1; 6-0,R32,46,1,0,26,42,20,26,10,16,0,0,7,30,42,0,1,23,35,9,23,4,12,2,7,6,13,35
2006-05-15 00:00:00.000,ATP Masters Series Hamburg Germany ATP World Tour,CLAY,2,Mario Ancic,Guillermo Garcia-Lopez,Mario Ancic,3-6; 6-4; 6-0,R32,120,3,2,50,82,31,50,18,32,3,6,13,49,82,1,5,47,76,32,47,10,29,5,10,12,42,76
2006-05-15 00:00:00.000,ATP Masters Series Hamburg Germany ATP World Tour,CLAY,2,James Blake,Andy Murray,James Blake,6-3; 6-3,R32,65,3,1,27,46,21,27,6,19,2,6,9,27,46,3,1,40,57,17,40,5,17,5,12,9,22,57
2006-05-15 00:00:00.000,ATP Masters Series Hamburg Germany ATP World Tour,CLAY,2,Fernando Gonzalez,Dominik Hrbaty,Fernando Gonzalez,6-7(4); 6-1; 6-3,R32,122,3,4,57,92,41,57,18,35,3,6,14,59,92,2,4,48,83,31,48,13,35,2,9,14,44,83
2006-05-15 00:00:00.000,ATP Masters Series Hamburg Germany ATP World Tour,CLAY,2,Fernando Verdasco,Novak Djokovic,Fernando Verdasco,6-4; 6-3,R32,89,1,1,47,56,28,47,6,9,4,7,9,34,56,1,0,46,60,20,46,7,14,3,9,10,27,60
2006-05-15 00:00:00.000,ATP Masters Series Hamburg Germany ATP World Tour,CLAY,2,Sebastien Grosjean,Filippo Volandri,Sebastien Grosjean,7-5; 7-6(4),R32,126,1,2,42,86,25,42,22,44,6,10,12,47,86,0,3,66,87,34,66,13,21,4,9,12,47,87
2006-05-15 00:00:00.000,ATP Masters Series Hamburg Germany ATP World Tour,CLAY,2,Jose Acasuso,Ivan Ljubicic,Jose Acasuso,6-2; 6-0,R32,63,3,3,19,38,17,19,8,19,1,2,7,25,38,1,0,25,43,9,25,5,18,2,8,7,14,43
2006-05-15 00:00:00.000,ATP Masters Series Hamburg Germany ATP World Tour,CLAY,2,Gilles Simon,Gaston Gaudio,Gilles Simon,6-4; 3-6; 6-4,R32,138,5,2,38,81,24,38,24,43,2,7,15,48,81,3,2,69,100,44,69,11,31,6,11,14,55,100
2006-05-15 00:00:00.000,ATP Masters Series Hamburg Germany ATP World Tour,CLAY,2,Max Mirnyi,Nicolas Kiefer,Max Mirnyi,6-2; 6-2,R32,86,7,0,34,54,25,34,13,20,6,6,8,38,54,1,5,34,63,23,34,9,29,7,11,8,32,63
2006-05-15 00:00:00.000,ATP Masters Series Hamburg Germany ATP World Tour,CLAY,2,Radek Stepanek,Bjorn Phau,Radek Stepanek,6-4; 6-3,R32,74,6,2,41,58,30,41,6,17,3,5,10,36,58,2,1,27,54,17,27,15,27,1,5,9,32,54
2006-05-15 00:00:00.000,ATP Masters Series Hamburg Germany ATP World Tour,CLAY,2,Robin Soderling,Juan Monaco,Robin Soderling,6-4; 6-4,R32,80,0,2,34,58,26,34,11,24,2,4,10,37,58,1,3,40,61,25,40,7,21,4,8,10,32,61
2006-05-15 00:00:00.000,ATP Masters Series Hamburg Germany ATP World Tour,CLAY,2,David Ferrer,Juan Carlos Ferrero,David Ferrer,6-2; 6-4,R16,91,1,3,48,76,28,48,16,28,9,11,9,44,76,0,1,35,52,16,35,8,17,3,8,9,24,52
2006-05-15 00:00:00.000,ATP Masters Series Hamburg Germany ATP World Tour,CLAY,2,Tommy Robredo,Paul-Henri Mathieu,Tommy Robredo,6-3; 6-3,R16,89,0,1,35,47,28,35,5,12,0,1,9,33,47,0,4,48,62,27,48,5,14,3,7,9,32,62
2006-05-15 00:00:00.000,ATP Masters Series Hamburg Germany ATP World Tour,CLAY,2,Nikolay Davydenko,Jarkko Nieminen,Nikolay Davydenko,6-1; 6-3,R16,57,2,1,30,45,21,30,9,15,2,3,8,30,45,1,1,24,42,11,24,7,18,1,6,8,18,42
2006-05-15 00:00:00.000,ATP Masters Series Hamburg Germany ATP World Tour,CLAY,2,Mario Ancic,James Blake,Mario Ancic,4-6; 7-5; 7-6(3),R16,154,10,1,73,115,48,73,20,42,7,12,17,68,115,5,1,57,105,36,57,26,48,6,11,17,62,105
2006-05-15 00:00:00.000,ATP Masters Series Hamburg Germany ATP World Tour,CLAY,2,Fernando Verdasco,Fernando Gonzalez,Fernando Verdasco,3-6; 6-2; 6-3,R16,134,3,4,64,87,39,64,11,23,10,14,13,50,87,5,4,62,102,31,62,20,40,8,14,13,51,102
2006-05-15 00:00:00.000,ATP Masters Series Hamburg Germany ATP World Tour,CLAY,2,Jose Acasuso,Sebastien Grosjean,Jose Acasuso,7-5; 6-4,R16,116,1,3,29,71,20,29,23,42,6,9,11,43,71,3,0,47,73,27,47,10,26,10,15,11,37,73
2006-05-15 00:00:00.000,ATP Masters Series Hamburg Germany ATP World Tour,CLAY,2,Max Mirnyi,Gilles Simon,Max Mirnyi,6-3; 6-2,R16,70,2,3,34,58,27,34,14,24,5,5,9,41,58,0,0,36,46,19,36,7,10,2,5,8,26,46
2006-05-15 00:00:00.000,ATP Masters Series Hamburg Germany ATP World Tour,CLAY,2,Radek Stepanek,Robin Soderling,Radek Stepanek,6-3; 6-2,R16,59,6,0,25,41,20,25,13,16,1,1,8,33,41,0,3,33,53,19,33,9,20,4,8,9,28,53
2006-05-15 00:00:00.000,ATP Masters Series Hamburg Germany ATP World Tour,CLAY,2,Tommy Robredo,David Ferrer,Tommy Robredo,7-6(8); 6-4,Q,119,3,0,62,88,34,62,16,26,4,6,11,50,88,0,3,49,73,26,49,13,24,3,6,11,39,73
2006-05-15 00:00:00.000,ATP Masters Series Hamburg Germany ATP World Tour,CLAY,2,Mario Ancic,Nikolay Davydenko,Mario Ancic,5-7; 7-6(4); 6-3,Q,167,12,4,76,121,53,76,25,45,13,16,17,78,121,1,7,73,102,52,73,16,29,3,6,16,68,102
2006-05-15 00:00:00.000,ATP Masters Series Hamburg Germany ATP World Tour,CLAY,2,Jose Acasuso,Fernando Verdasco,Jose Acasuso,6-1; 6-7(6); 6-3,Q,138,3,2,46,86,32,46,27,40,0,2,15,59,86,3,2,68,89,41,68,10,21,4,9,13,51,89
2006-05-15 00:00:00.000,ATP Masters Series Hamburg Germany ATP World Tour,CLAY,2,Radek Stepanek,Max Mirnyi,Radek Stepanek,7-6(5); 6-1,Q,80,6,1,38,54,34,38,9,16,0,1,10,43,54,4,4,32,58,25,32,10,26,2,5,9,35,58
2006-05-15 00:00:00.000,ATP Masters Series Hamburg Germany ATP World Tour,CLAY,2,Tommy Robredo,Mario Ancic,Tommy Robredo,7-5; 6-4,S,122,1,0,60,77,44,60,8,17,9,10,11,52,77,7,1,47,77,29,47,17,30,5,8,11,46,77
2006-05-15 00:00:00.000,ATP Masters Series Hamburg Germany ATP World Tour,CLAY,2,Radek Stepanek,Jose Acasuso,Radek Stepanek,6-4; 7-6(5),S,100,5,3,42,72,36,42,16,30,1,1,11,52,72,9,3,44,79,32,44,19,35,4,5,11,51,79
2006-05-15 00:00:00.000,ATP Masters Series Hamburg Germany ATP World Tour,CLAY,2,Tommy Robredo,Radek Stepanek,Tommy Robredo,6-1; 6-3; 6-3,F,121,0,1,71,90,48,71,13,19,8,8,13,61,90,4,1,65,101,40,65,14,36,8,13,12,54,101
2006-05-22 00:00:00.000,Poertschach Austria ATP World Tour,CLAY,2,Nikolay Davydenko,Tomas Zib,Nikolay Davydenko,6-3; 6-0,R32,66,8,0,26,33,21,26,1,7,1,3,7,22,33,1,0,24,60,11,24,12,36,6,13,8,23,60
2006-05-22 00:00:00.000,Poertschach Austria ATP World Tour,CLAY,2,Ruben Ramirez Hidalgo,Nicolas Lapentti,Ruben Ramirez Hidalgo,4-6; 6-4; 6-3,R32,191,2,3,68,109,45,68,19,41,7,10,15,64,109,3,1,52,110,40,52,24,58,7,11,14,64,110
2006-05-22 00:00:00.000,Poertschach Austria ATP World Tour,CLAY,2,Potito Starace,Alberto Martin,Potito Starace,7-5; 7-6(5),R32,80,1,1,55,68,49,55,7,13,2,2,12,56,68,1,0,45,62,38,45,12,17,0,1,12,50,62
2006-05-22 00:00:00.000,Poertschach Austria ATP World Tour,CLAY,2,Nicolas Almagro,Christophe Rochus,Nicolas Almagro,6-3; 6-4,R32,61,5,1,37,53,33,37,9,16,0,0,10,42,53,0,4,34,62,25,34,12,28,1,3,9,37,62
2006-05-22 00:00:00.000,Poertschach Austria ATP World Tour,CLAY,2,Richard Gasquet,Dominik Hrbaty,Richard Gasquet,6-0; 4-6; 6-3,R32,86,11,0,53,77,38,53,16,24,0,1,13,54,77,7,3,44,67,29,44,12,23,4,8,12,41,67
2006-05-22 00:00:00.000,Poertschach Austria ATP World Tour,CLAY,2,Jurgen Melzer,Stefan Koubek,Jurgen Melzer,6-4; 7-5,R32,98,3,4,52,91,32,52,21,39,8,11,11,53,91,3,3,36,71,23,36,15,35,9,14,11,38,71
2006-05-22 00:00:00.000,Poertschach Austria ATP World Tour,CLAY,2,Jiri Novak,Bjorn Phau,Jiri Novak,6-3; 6-3,R32,61,3,0,32,46,26,32,8,14,1,2,9,34,46,2,1,26,57,15,26,13,31,5,9,9,28,57
2006-05-22 00:00:00.000,Poertschach Austria ATP World Tour,CLAY,2,Juan Ignacio Chela,Jimmy Wang,Juan Ignacio Chela,6-3; 6-1,R32,66,2,3,26,52,22,26,11,26,3,5,8,33,52,0,0,34,54,15,34,7,20,7,13,8,22,54
2006-05-22 00:00:00.000,Poertschach Austria ATP World Tour,CLAY,2,Luis Horna,Wesley Moodie,Luis Horna,7-6(3); 6-3,R32,84,4,0,48,66,38,48,14,18,1,1,11,52,66,7,1,54,72,37,54,9,18,4,5,10,46,72
2006-05-22 00:00:00.000,Poertschach Austria ATP World Tour,CLAY,2,Andreas Seppi,Lukas Dlouhy,Andreas Seppi,6-3; 6-4,R32,68,2,2,34,60,24,34,15,26,3,5,10,39,60,1,4,39,59,23,39,9,20,2,6,9,32,59
2006-05-22 00:00:00.000,Poertschach Austria ATP World Tour,CLAY,2,Gilles Muller,Leonardo Azzaro,Gilles Muller,6-3; 7-6(6),R32,93,14,2,52,82,41,52,15,30,8,8,11,56,82,3,0,45,64,33,45,13,19,3,4,10,46,64
2006-05-22 00:00:00.000,Poertschach Austria ATP World Tour,CLAY,2,Juan Monaco,Dmitry Tursunov,Juan Monaco,7-6(4); 6-2,R32,93,1,3,38,67,28,38,18,29,1,2,10,46,67,6,3,37,67,24,37,18,30,7,10,10,42,67
2006-05-22 00:00:00.000,Poertschach Austria ATP World Tour,CLAY,2,Gilles Simon,Torsten Popp,Gilles Simon,7-5; 6-4,R32,241,6,2,45,71,28,45,15,26,2,5,11,43,71,2,10,38,75,23,38,18,37,8,13,11,41,75
2006-05-22 00:00:00.000,Poertschach Austria ATP World Tour,CLAY,2,Oliver Marach,Vincent Spadea,Oliver Marach,6-4; 6-3,R32,96,9,2,41,66,30,41,12,25,7,8,9,42,66,0,2,32,58,16,32,14,26,1,5,10,30,58
2006-05-22 00:00:00.000,Poertschach Austria ATP World Tour,CLAY,2,Andrei Pavel,Carlos Berlocq,Andrei Pavel,7-5; 6-2,R32,83,2,1,47,65,35,47,8,18,7,9,10,43,65,2,2,28,53,16,28,10,25,1,6,10,26,53
2006-05-22 00:00:00.000,Poertschach Austria ATP World Tour,CLAY,2,Marcos Daniel,Lleyton Hewitt,Marcos Daniel,3-6; 6-3; 7-6(3),R32,153,5,3,65,108,46,65,17,43,9,14,15,63,108,7,3,64,103,41,64,18,39,1,6,15,59,103
2006-05-22 00:00:00.000,Poertschach Austria ATP World Tour,CLAY,2,Nikolay Davydenko,Ruben Ramirez Hidalgo,Nikolay Davydenko,6-2; 6-4,R16,68,6,1,31,50,25,31,10,19,3,4,9,35,50,1,1,30,49,19,30,7,19,1,5,9,26,49
2006-05-22 00:00:00.000,Poertschach Austria ATP World Tour,CLAY,2,Potito Starace,Nicolas Almagro,Potito Starace,4-6; 6-4; 6-1,R16,106,2,1,85,106,52,85,13,21,8,10,14,65,106,4,1,62,82,37,62,11,20,5,9,13,48,82
2006-05-22 00:00:00.000,Poertschach Austria ATP World Tour,CLAY,2,Jurgen Melzer,Richard Gasquet,Jurgen Melzer,6-0; 1-1 RET,R16,29,4,0,15,23,13,15,5,8,1,1,4,18,23,0,1,16,20,8,16,0,4,1,4,4,8,20
2006-05-22 00:00:00.000,Poertschach Austria ATP World Tour,CLAY,2,Jiri Novak,Juan Ignacio Chela,Jiri Novak,6-1; 3-6; 6-2,R16,89,5,2,54,80,36,54,15,26,2,4,12,51,80,3,2,41,72,27,41,11,31,3,8,12,38,72
2006-05-22 00:00:00.000,Poertschach Austria ATP World Tour,CLAY,2,Luis Horna,Andreas Seppi,Luis Horna,6-1; 6-1,R16,58,7,1,30,44,21,30,9,14,2,2,7,30,44,3,3,25,47,14,25,7,22,3,8,7,21,47
2006-05-22 00:00:00.000,Poertschach Austria ATP World Tour,CLAY,2,Juan Monaco,Gilles Muller,Juan Monaco,6-2; 6-0,R16,53,1,2,25,44,18,25,13,19,1,1,7,31,44,1,5,29,49,14,29,6,20,3,8,7,20,49
2006-05-22 00:00:00.000,Poertschach Austria ATP World Tour,CLAY,2,Oliver Marach,Gilles Simon,Oliver Marach,7-6(3); 6-1,R16,97,4,0,43,68,35,43,12,25,2,3,10,47,68,3,1,30,58,18,30,16,28,2,5,9,34,58
2006-05-22 00:00:00.000,Poertschach Austria ATP World Tour,CLAY,2,Andrei Pavel,Marcos Daniel,Andrei Pavel,7-5; 6-0,R16,70,3,1,34,56,24,34,12,22,3,5,9,36,56,0,1,31,57,16,31,11,26,2,8,9,27,57
2006-05-22 00:00:00.000,Poertschach Austria ATP World Tour,CLAY,2,Nikolay Davydenko,Potito Starace,Nikolay Davydenko,6-2; 6-1,Q,49,6,1,27,39,24,27,8,12,0,0,8,32,39,1,0,30,42,12,30,5,12,1,5,7,17,42
2006-05-22 00:00:00.000,Poertschach Austria ATP World Tour,CLAY,2,Jiri Novak,Jurgen Melzer,Jiri Novak,6-7(7); 6-4; 6-4,Q,141,9,3,93,130,61,93,17,37,13,16,16,78,130,7,4,69,118,44,69,22,49,12,17,16,66,118
2006-05-22 00:00:00.000,Poertschach Austria ATP World Tour,CLAY,2,Luis Horna,Juan Monaco,Luis Horna,6-3; 6-4,Q,89,7,0,36,63,27,36,18,27,7,7,10,45,63,1,0,37,53,26,37,8,16,1,3,9,34,53
2006-05-22 00:00:00.000,Poertschach Austria ATP World Tour,CLAY,2,Andrei Pavel,Oliver Marach,Andrei Pavel,6-4; 6-2,Q,88,5,0,50,63,34,50,9,13,4,4,9,43,63,1,2,35,55,20,35,13,20,3,6,9,33,55
2006-05-22 00:00:00.000,Poertschach Austria ATP World Tour,CLAY,2,Nikolay Davydenko,Jiri Novak,Nikolay Davydenko,6-2; 6-2,S,66,3,0,31,45,23,31,8,14,2,3,8,31,45,0,1,33,55,18,33,8,22,7,12,8,26,55
2006-05-22 00:00:00.000,Poertschach Austria ATP World Tour,CLAY,2,Andrei Pavel,Luis Horna,Andrei Pavel,W/O,S,0,0,0,0,0,0,0,0,0,0,0,0,0,0,0,0,0,0,0,0,0,0,0,0,0,0,0
2006-05-22 00:00:00.000,Poertschach Austria ATP World Tour,CLAY,2,Nikolay Davydenko,Andrei Pavel,Nikolay Davydenko,6-0; 6-3,F,63,5,1,19,36,15,19,13,17,0,0,7,28,36,1,2,39,61,19,39,9,22,1,6,8,28,61
2006-05-29 00:00:00.000,Roland Garros France Grand Slams,CLAY,3,Roger Federer,Diego Hartfield,Roger Federer,7-5; 7-6(2); 6-2,R128,156,5,2,70,106,48,70,22,36,6,9,16,70,106,0,2,92,133,53,92,20,41,15,21,16,73,133
2006-05-29 00:00:00.000,Roland Garros France Grand Slams,CLAY,3,Alejandro Falla,Justin Gimelstob,Alejandro Falla,6-4; 6-4; 6-2,R128,113,3,1,66,83,44,66,8,17,3,6,14,52,83,2,3,55,89,33,55,12,34,3,10,14,45,89
2006-05-29 00:00:00.000,Roland Garros France Grand Slams,CLAY,3,Max Mirnyi,Gilles Muller,Max Mirnyi,6-3; 6-1; 7-6(3),R128,103,6,2,43,77,38,43,24,34,0,0,14,62,77,8,3,61,88,41,61,12,27,8,12,14,53,88
2006-05-29 00:00:00.000,Roland Garros France Grand Slams,CLAY,3,Nicolas Massu,Xavier Malisse,Nicolas Massu,6-1; 7-5; 1-6; 4-6; 9-7,R128,265,6,5,99,180,61,99,44,81,16,23,26,105,180,12,3,90,155,65,90,26,65,10,18,26,91,155
2006-05-29 00:00:00.000,Roland Garros France Grand Slams,CLAY,3,Tomas Berdych,Feliciano Lopez,Tomas Berdych,6-2; 6-4; 6-3,R128,124,7,2,47,86,35,47,28,39,6,6,14,63,86,4,2,50,82,31,50,15,32,7,11,13,46,82
2006-05-29 00:00:00.000,Roland Garros France Grand Slams,CLAY,3,Filippo Volandri,Kristian Pless,Filippo Volandri,6-4; 7-6(0); 6-4,R128,127,0,2,81,104,50,81,13,23,9,14,16,63,104,2,4,68,108,39,68,16,40,9,16,16,55,108
2006-05-29 00:00:00.000,Roland Garros France Grand Slams,CLAY,3,Marc Gicquel,Alessio Di Mauro,Marc Gicquel,7-5; 7-6(6); 6-3,R128,156,3,0,70,111,52,70,24,41,6,8,17,76,111,2,0,53,93,39,53,20,40,0,4,16,59,93
2006-05-29 00:00:00.000,Roland Garros France Grand Slams,CLAY,3,Nicolas Kiefer,Jurgen Melzer,Nicolas Kiefer,7-6(4); 6-3; 6-1,R128,131,9,2,47,85,36,47,26,38,1,1,14,62,85,8,1,65,96,45,65,10,31,10,14,14,55,96
2006-05-29 00:00:00.000,Roland Garros France Grand Slams,CLAY,3,Mario Ancic,Nathan Healey,Mario Ancic,6-3; 4-6; 7-6(3); 6-1,R128,196,10,0,79,135,54,79,41,56,12,13,20,95,135,5,6,78,116,53,78,25,38,2,5,18,78,116
2006-05-29 00:00:00.000,Roland Garros France Grand Slams,CLAY,3,Paul Capdeville,Greg Rusedski,Paul Capdeville,6-3; 6-1; 4-6; 7-6(7),R128,175,2,3,77,141,55,77,33,64,8,11,19,88,141,6,8,90,150,55,90,28,60,6,12,19,83,150
2006-05-29 00:00:00.000,Roland Garros France Grand Slams,CLAY,3,Stefano Galvani,Florian Mayer,Stefano Galvani,4-6; 6-0; 7-6(4); 3-6; 7-5,R128,205,4,9,104,157,71,104,25,53,6,12,24,96,157,3,3,102,167,64,102,33,65,11,19,25,97,167
2006-05-29 00:00:00.000,Roland Garros France Grand Slams,CLAY,3,Albert Montanes,Robby Ginepri,Albert Montanes,6-3; 6-7(2); 6-1; 6-4,R128,147,6,2,73,119,53,73,27,46,5,8,20,80,119,1,1,76,114,43,76,22,38,8,15,18,65,114
2006-05-29 00:00:00.000,Roland Garros France Grand Slams,CLAY,3,Jose Acasuso,Fabrice Santoro,Jose Acasuso,6-3; 6-1; 3-6; 1-6; 11-9,R128,237,10,3,91,161,70,91,30,70,5,11,26,100,161,6,1,92,168,60,92,42,76,7,14,26,102,168
2006-05-29 00:00:00.000,Roland Garros France Grand Slams,CLAY,3,Lukas Dlouhy,Kristof Vliegen,Lukas Dlouhy,4-6; 6-4; 3-6; 7-6(5); 6-2,R128,209,6,5,127,183,81,127,28,56,14,21,25,109,183,11,5,92,152,66,92,28,60,11,18,24,94,152
2006-05-29 00:00:00.000,Roland Garros France Grand Slams,CLAY,3,Ilija Bozoljac,Boris Pashanski,Ilija Bozoljac,6-4; 6-3; 6-4,R128,107,15,3,53,86,44,53,17,33,4,5,14,61,86,4,2,61,98,40,61,17,37,4,9,15,57,98
2006-05-29 00:00:00.000,Roland Garros France Grand Slams,CLAY,3,Tommy Robredo,Tomas Zib,Tommy Robredo,6-4; 6-2; 6-2,R128,121,6,2,64,85,46,64,11,21,1,2,13,57,85,1,3,57,94,34,57,15,37,7,13,13,49,94
2006-05-29 00:00:00.000,Roland Garros France Grand Slams,CLAY,3,David Nalbandian,Stanislas Wawrinka,David Nalbandian,6-2; 7-6(5); 6-4,R128,173,0,4,60,112,41,60,28,52,6,8,15,69,112,6,7,61,127,37,61,29,66,13,18,15,66,127
2006-05-29 00:00:00.000,Roland Garros France Grand Slams,CLAY,3,Richard Gasquet,Jimmy Wang,Richard Gasquet,6-4; 6-1; 7-5,R128,112,12,1,45,79,39,45,20,34,3,4,14,59,79,3,4,65,108,34,65,24,43,9,15,15,58,108
2006-05-29 00:00:00.000,Roland Garros France Grand Slams,CLAY,3,Tim Henman,Kenneth Carlsen,Tim Henman,6-3; 6-4; 4-6; 6-4,R128,161,7,4,86,125,65,86,21,39,6,8,20,86,125,4,1,72,110,50,72,19,38,3,7,19,69,110
2006-05-29 00:00:00.000,Roland Garros France Grand Slams,CLAY,3,Dmitry Tursunov,Jiri Novak,Dmitry Tursunov,6-2; 6-3; 6-2,R128,96,6,2,47,83,40,47,18,36,6,6,13,58,83,1,6,52,88,33,52,14,36,8,13,12,47,88
2006-05-29 00:00:00.000,Roland Garros France Grand Slams,CLAY,3,Sebastien Grosjean,Andrei Pavel,Sebastien Grosjean,6-3; 6-2; 6-3,R128,129,7,0,46,81,36,46,22,35,6,7,13,58,81,1,1,70,100,38,70,13,30,11,17,13,51,100
2006-05-29 00:00:00.000,Roland Garros France Grand Slams,CLAY,3,Martin Vassallo Arguello,Paul Goldstein,Martin Vassallo Arguello,6-2; 6-0; 6-3,R128,111,5,0,63,78,40,63,11,15,4,5,12,51,78,0,6,52,92,22,52,19,40,13,20,11,41,92
2006-05-29 00:00:00.000,Roland Garros France Grand Slams,CLAY,3,Nicolas Lapentti,Wesley Moodie,Nicolas Lapentti,4-6; 7-6(5); 7-6(5); 6-7(5); 6-2,R128,269,5,2,140,166,110,140,13,26,8,10,27,123,166,13,5,144,193,105,144,22,49,6,9,27,127,193
2006-05-29 00:00:00.000,Roland Garros France Grand Slams,CLAY,3,Raemon Sluiter,Jarkko Nieminen,Raemon Sluiter,6-2; 7-6(6); 2-1 RET,R128,98,6,2,35,75,25,35,20,40,3,6,11,45,75,2,2,46,78,24,46,16,32,4,10,12,40,78
2006-05-29 00:00:00.000,Roland Garros France Grand Slams,CLAY,3,Gaston Gaudio,Roko Karanusic,Gaston Gaudio,6-2; 6-2; 6-2,R128,92,1,1,52,77,39,52,15,25,5,5,12,54,77,3,0,43,69,26,43,9,26,3,9,12,35,69
2006-05-29 00:00:00.000,Roland Garros France Grand Slams,CLAY,3,Evgeny Korolev,Andreas Seppi,Evgeny Korolev,6-4; 2-6; 3-6; 7-5; 6-1,R128,168,5,8,77,133,54,77,32,56,3,8,23,86,133,6,7,89,145,64,89,22,56,9,15,23,86,145
2006-05-29 00:00:00.000,Roland Garros France Grand Slams,CLAY,3,Philipp Kohlschreiber,Oliver Marach,Philipp Kohlschreiber,6-3; 7-5; 6-7(6); 6-2,R128,183,12,3,75,118,62,75,26,43,2,2,20,88,118,2,0,94,146,64,94,27,52,13,18,21,91,146
2006-05-29 00:00:00.000,Roland Garros France Grand Slams,CLAY,3,Juan Carlos Ferrero,Juan Martin Del Potro,Juan Carlos Ferrero,6-3; 2-6; 6-2; 6-4,R128,177,5,2,80,123,52,80,21,43,15,19,18,73,123,3,3,94,125,55,94,16,31,6,12,17,71,125
2006-05-29 00:00:00.000,Roland Garros France Grand Slams,CLAY,3,Carlos Moya,Juan Antonio Marin,Carlos Moya,7-5; 6-3; 6-3,R128,133,2,2,60,91,46,60,17,31,3,4,15,63,91,3,3,63,98,41,63,17,35,9,14,15,58,98
2006-05-29 00:00:00.000,Roland Garros France Grand Slams,CLAY,3,Mikhail Youzhny,Sasa Tuksar,Mikhail Youzhny,6-3; 6-3; 3-6; 6-0,R128,137,6,4,74,123,51,74,19,49,10,15,17,70,123,1,2,66,102,35,66,13,36,2,11,16,48,102
2006-05-29 00:00:00.000,Roland Garros France Grand Slams,CLAY,3,Flavio Saretta,Potito Starace,Flavio Saretta,6-7(2); 2-6; 6-4; 7-6(1); 6-3,R128,258,7,2,130,191,85,130,29,61,20,26,26,114,191,1,2,141,173,91,141,13,32,7,13,25,104,173
2006-05-29 00:00:00.000,Roland Garros France Grand Slams,CLAY,3,Nikolay Davydenko,Vincent Spadea,Nikolay Davydenko,7-5; 6-4; 6-4,R128,141,2,3,62,103,44,62,23,41,7,9,16,67,103,6,8,62,109,41,62,21,47,10,15,16,62,109
2006-05-29 00:00:00.000,Roland Garros France Grand Slams,CLAY,3,Alberto Martin,Andy Roddick,Alberto Martin,6-4; 7-5; 1-0 RET,R128,101,4,0,39,60,32,39,13,21,1,2,11,45,60,7,3,41,76,31,41,11,35,5,9,12,42,76
2006-05-29 00:00:00.000,Roland Garros France Grand Slams,CLAY,3,Dieter Kindlmann,Razvan Sabau,Dieter Kindlmann,6-3; 6-2; 6-2,R128,110,1,2,72,95,46,72,13,23,5,7,13,59,95,1,3,69,97,35,69,12,28,8,15,12,47,97
2006-05-29 00:00:00.000,Roland Garros France Grand Slams,CLAY,3,Jiri Vanek,Nicolas Mahut,Jiri Vanek,6-3; 7-6(3); 6-7(5); 7-6(3),R128,242,4,3,128,179,85,128,26,51,13,16,23,111,179,6,1,102,150,69,102,24,48,4,8,22,93,150
2006-05-29 00:00:00.000,Roland Garros France Grand Slams,CLAY,3,Olivier Rochus,Jean-Christophe Faurel,Olivier Rochus,6-1; 6-4; 6-2,R128,97,0,1,47,65,39,47,13,18,0,0,13,52,65,1,2,44,73,26,44,15,29,6,11,12,41,73
2006-05-29 00:00:00.000,Roland Garros France Grand Slams,CLAY,3,Marcos Baghdatis,Albert Portas,Marcos Baghdatis,6-4; 6-4; 6-7(5); 6-1,R128,156,6,4,62,119,50,62,33,57,4,7,20,83,119,4,2,75,125,48,75,24,50,6,13,19,72,125
2006-05-29 00:00:00.000,Roland Garros France Grand Slams,CLAY,3,Julien Benneteau,Janko Tipsarevic,Julien Benneteau,6-2; 6-4; 6-7(5); 6-3,R128,177,9,1,102,134,68,102,17,32,5,8,20,85,134,6,5,87,143,53,87,26,56,5,12,19,79,143
2006-05-29 00:00:00.000,Roland Garros France Grand Slams,CLAY,3,Davide Sanguinetti,Daniele Bracciali,Davide Sanguinetti,3-6; 7-6(10); 6-3; 6-3,R128,167,6,0,75,117,64,75,24,42,2,3,19,88,117,10,1,71,134,50,71,38,63,6,9,20,88,134
2006-05-29 00:00:00.000,Roland Garros France Grand Slams,CLAY,3,Radek Stepanek,Michael Llodra,Radek Stepanek,6-4; 6-4; 6-2,R128,100,3,0,53,82,44,53,19,29,8,8,14,63,82,5,1,51,84,36,51,17,33,6,10,14,53,84
2006-05-29 00:00:00.000,Roland Garros France Grand Slams,CLAY,3,David Ferrer,Guillermo Garcia-Lopez,David Ferrer,7-5; 6-1; 6-0,R128,110,2,0,60,89,42,60,17,29,3,4,13,59,89,2,3,36,74,18,36,13,38,4,11,12,31,74
2006-05-29 00:00:00.000,Roland Garros France Grand Slams,CLAY,3,Jeremy Chardy,Jonas Bjorkman,Jeremy Chardy,6-2; 7-5; 6-2,R128,109,7,3,48,74,38,48,13,26,0,2,14,51,74,6,3,64,95,39,64,12,31,6,13,14,51,95
2006-05-29 00:00:00.000,Roland Garros France Grand Slams,CLAY,3,Ruben Ramirez Hidalgo,Thierry Ascione,Ruben Ramirez Hidalgo,7-6(7); 6-4; 6-7(6); 6-3,R128,177,7,2,99,147,69,99,29,48,6,9,22,98,147,8,5,97,140,61,97,24,43,4,9,21,85,140
2006-05-29 00:00:00.000,Roland Garros France Grand Slams,CLAY,3,Christophe Rochus,Thomas Johansson,Christophe Rochus,3-6; 5-7; 6-4; 6-4; 6-2,R128,189,7,4,96,156,73,96,26,60,4,8,24,99,156,25,4,77,156,61,77,34,79,10,16,25,95,156
2006-05-29 00:00:00.000,Roland Garros France Grand Slams,CLAY,3,Fernando Verdasco,Juan Ignacio Chela,Fernando Verdasco,6-1; 6-3; 6-7(6); 6-4,R128,174,0,3,96,118,64,96,12,22,5,9,19,76,118,2,6,95,143,58,95,15,48,8,17,19,73,143
2006-05-29 00:00:00.000,Roland Garros France Grand Slams,CLAY,3,Juan Monaco,Melle Van Gemerden,Juan Monaco,6-3; 6-2; 6-4,R128,116,7,1,51,79,37,51,18,28,2,4,14,55,79,5,5,63,100,38,63,15,37,15,21,13,53,100
2006-05-29 00:00:00.000,Roland Garros France Grand Slams,CLAY,3,Oscar Hernandez,Gilles Simon,Oscar Hernandez,6-4; 6-2; 6-3,R128,115,0,3,54,80,39,54,13,26,4,6,13,52,80,3,0,53,85,29,53,13,32,6,13,14,42,85
2006-05-29 00:00:00.000,Roland Garros France Grand Slams,CLAY,3,Ivan Ljubicic,Carlos Berlocq,Ivan Ljubicic,6-2; 6-0; 6-3,R128,95,3,2,41,59,31,41,15,18,1,1,11,46,59,2,3,59,101,29,59,19,42,11,18,12,48,101
2006-05-29 00:00:00.000,Roland Garros France Grand Slams,CLAY,3,James Blake,Paradorn Srichaphan,James Blake,6-0; 6-4; 7-6(3),R128,93,5,0,59,85,45,59,16,26,2,4,14,61,85,1,2,47,84,27,47,18,37,2,8,14,45,84
2006-05-29 00:00:00.000,Roland Garros France Grand Slams,CLAY,3,Nicolas Almagro,Wayne Arthurs,Nicolas Almagro,7-5; 6-2; 6-2,R128,95,12,0,60,81,45,60,18,21,2,2,14,63,81,11,4,46,82,34,46,14,36,9,14,14,48,82
2006-05-29 00:00:00.000,Roland Garros France Grand Slams,CLAY,3,Dick Norman,Edgardo Massa,Dick Norman,6-1; 6-3; 6-3,R128,91,7,5,56,74,44,56,10,18,3,4,13,54,74,0,3,66,82,32,66,8,16,6,12,12,40,82
2006-05-29 00:00:00.000,Roland Garros France Grand Slams,CLAY,3,Gael Monfils,Andy Murray,Gael Monfils,6-4; 6-7(2); 1-6; 6-2; 6-1,R128,222,6,10,105,168,67,105,27,63,14,20,22,94,168,0,3,107,162,60,107,27,55,14,23,22,87,162
2006-05-29 00:00:00.000,Roland Garros France Grand Slams,CLAY,3,Tommy Haas,Rainer Schuettler,Tommy Haas,6-4; 6-3; 6-3,R128,101,4,3,40,76,31,40,24,36,3,4,14,55,76,2,2,57,90,32,57,18,33,7,12,14,50,90
2006-05-29 00:00:00.000,Roland Garros France Grand Slams,CLAY,3,Alexander Waske,Fernando Vicente,Alexander Waske,6-4; 4-6; 7-6(6); 7-6(4),R128,206,11,3,99,151,72,99,26,52,6,11,22,98,151,4,3,104,142,68,104,20,38,6,11,22,88,142
2006-05-29 00:00:00.000,Roland Garros France Grand Slams,CLAY,3,Novak Djokovic,Luis Horna,Novak Djokovic,6-3; 5-0 RET,R128,60,6,1,30,36,25,30,4,6,0,0,7,29,36,1,2,32,53,16,32,11,21,4,8,7,27,53
2006-05-29 00:00:00.000,Roland Garros France Grand Slams,CLAY,3,Fernando Gonzalez,Marat Safin,Fernando Gonzalez,6-3; 1-6; 6-3; 6-1,R128,149,7,3,65,99,44,65,17,34,8,12,16,61,99,7,3,76,133,48,76,21,57,19,26,16,69,133
2006-05-29 00:00:00.000,Roland Garros France Grand Slams,CLAY,3,Lleyton Hewitt,Jan Hernych,Lleyton Hewitt,7-6(5); 3-6; 6-2; 6-0,R128,171,4,1,88,137,51,88,26,49,5,10,17,77,137,4,4,74,119,42,74,19,45,5,14,18,61,119
2006-05-29 00:00:00.000,Roland Garros France Grand Slams,CLAY,3,Mathieu Montcourt,Marcos Daniel,Mathieu Montcourt,6-2; 6-4; 1-6; 6-2,R128,146,1,6,70,104,46,70,17,34,8,12,16,63,104,5,0,66,103,39,66,17,37,9,16,17,56,103
2006-05-29 00:00:00.000,Roland Garros France Grand Slams,CLAY,3,Ivo Karlovic,Olivier Patience,Ivo Karlovic,7-6(6); 7-6(1); 7-6(10),R128,147,26,0,86,119,73,86,20,33,1,1,18,93,119,4,1,91,119,71,91,20,28,2,2,18,91,119
2006-05-29 00:00:00.000,Roland Garros France Grand Slams,CLAY,3,Dominik Hrbaty,Sergio Roitman,Dominik Hrbaty,6-4; 6-2; 3-6; 2-6; 6-3,R128,164,6,2,85,141,63,85,24,56,12,17,22,87,141,2,1,81,114,51,81,21,33,6,12,22,72,114
2006-05-29 00:00:00.000,Roland Garros France Grand Slams,CLAY,3,Paul-Henri Mathieu,Bjorn Phau,Paul-Henri Mathieu,6-4; 6-2; 6-1,R128,130,0,2,49,80,30,49,18,31,0,3,13,48,80,1,1,47,96,23,47,19,49,12,20,12,42,96
2006-05-29 00:00:00.000,Roland Garros France Grand Slams,CLAY,3,Florent Serra,Robin Vik,Florent Serra,6-1; 1-6; 7-5; 6-4,R128,135,2,3,61,113,41,61,25,52,7,12,18,66,113,8,3,81,130,49,81,19,49,16,23,18,68,130
2006-05-29 00:00:00.000,Roland Garros France Grand Slams,CLAY,3,Kevin Kim,Julio Silva,Kevin Kim,7-5; 6-2; 6-7(4); 7-6(3),R128,172,10,6,79,128,62,79,24,49,4,9,22,86,128,3,1,112,154,67,112,20,42,14,22,22,87,154
2006-05-29 00:00:00.000,Roland Garros France Grand Slams,CLAY,3,Rafael Nadal,Robin Soderling,Rafael Nadal,6-2; 7-5; 6-1,R128,128,1,3,56,81,42,56,12,25,5,7,13,54,81,2,1,73,100,37,73,11,27,14,22,14,48,100
2006-05-29 00:00:00.000,Roland Garros France Grand Slams,CLAY,3,Roger Federer,Alejandro Falla,Roger Federer,6-1; 6-4; 6-3,R64,86,4,0,46,68,40,46,15,22,3,3,13,55,68,4,1,57,86,33,57,14,29,6,11,13,47,86
2006-05-29 00:00:00.000,Roland Garros France Grand Slams,CLAY,3,Nicolas Massu,Max Mirnyi,Nicolas Massu,6-4; 7-5; 6-4,R64,150,4,1,58,78,51,58,11,20,1,2,16,62,78,9,8,55,97,39,55,22,42,7,11,16,61,97
2006-05-29 00:00:00.000,Roland Garros France Grand Slams,CLAY,3,Tomas Berdych,Filippo Volandri,Tomas Berdych,6-3; 6-1; 6-1,R64,94,6,1,43,75,32,43,17,32,8,10,12,49,75,0,0,53,73,20,53,9,20,6,14,11,29,73
2006-05-29 00:00:00.000,Roland Garros France Grand Slams,CLAY,3,Nicolas Kiefer,Marc Gicquel,Nicolas Kiefer,6-0; 6-1; 5-7; 3-6; 11-9,R64,290,15,4,90,172,65,90,44,82,13,18,27,109,172,8,3,120,203,75,120,36,83,16,25,27,111,203
2006-05-29 00:00:00.000,Roland Garros France Grand Slams,CLAY,3,Mario Ancic,Paul Capdeville,Mario Ancic,7-5; 6-3; 7-6(3),R64,159,8,0,65,96,57,65,15,31,4,5,17,72,96,5,3,89,132,61,89,19,43,10,13,16,80,132
2006-05-29 00:00:00.000,Roland Garros France Grand Slams,CLAY,3,Albert Montanes,Stefano Galvani,Albert Montanes,7-5; 6-1; 3-6; 2-6; 6-4,R64,181,4,2,98,137,70,98,24,39,6,9,23,94,137,2,6,91,152,60,91,37,61,10,14,23,97,152
2006-05-29 00:00:00.000,Roland Garros France Grand Slams,CLAY,3,Lukas Dlouhy,Jose Acasuso,Lukas Dlouhy,4-6; 7-6(2); 6-3; 6-1,R64,139,4,5,81,122,58,81,21,41,4,7,19,79,122,3,1,80,131,50,80,29,51,6,12,19,79,131
2006-05-29 00:00:00.000,Roland Garros France Grand Slams,CLAY,3,Tommy Robredo,Ilija Bozoljac,Tommy Robredo,7-5; 6-2; 3-6; 6-1,R64,128,0,1,77,97,57,77,14,20,2,4,18,71,97,9,2,56,102,39,56,21,46,1,7,18,60,102
2006-05-29 00:00:00.000,Roland Garros France Grand Slams,CLAY,3,David Nalbandian,Richard Gasquet,David Nalbandian,6-2; 3-6; 7-5; 6-0,R64,152,3,3,64,104,43,64,22,40,8,11,17,65,104,7,6,75,125,47,75,20,50,8,16,18,67,125
2006-05-29 00:00:00.000,Roland Garros France Grand Slams,CLAY,3,Dmitry Tursunov,Tim Henman,Dmitry Tursunov,6-3; 6-2; 4-6; 6-4,R64,171,10,9,87,151,65,87,28,64,18,21,19,93,151,3,1,75,118,48,75,19,43,8,14,18,67,118
2006-05-29 00:00:00.000,Roland Garros France Grand Slams,CLAY,3,Martin Vassallo Arguello,Sebastien Grosjean,Martin Vassallo Arguello,1-6; 6-4; 4-6; 7-5; 6-2,R64,238,3,1,121,151,71,121,16,30,10,18,23,87,151,3,0,85,149,61,85,27,64,14,23,24,88,149
2006-05-29 00:00:00.000,Roland Garros France Grand Slams,CLAY,3,Raemon Sluiter,Nicolas Lapentti,Raemon Sluiter,6-1; 6-4; 6-1,R64,104,7,4,47,78,41,47,9,31,7,9,12,50,78,2,1,59,84,29,59,12,25,9,17,12,41,84
2006-05-29 00:00:00.000,Roland Garros France Grand Slams,CLAY,3,Gaston Gaudio,Evgeny Korolev,Gaston Gaudio,6-3; 6-7(5); 6-4; 3-6; 6-4,R64,212,3,3,119,175,79,119,29,56,7,13,26,108,175,5,6,88,140,64,88,25,52,8,15,24,89,140
2006-05-29 00:00:00.000,Roland Garros France Grand Slams,CLAY,3,Juan Carlos Ferrero,Philipp Kohlschreiber,Juan Carlos Ferrero,6-2; 6-4; 6-2,R64,101,3,2,50,72,37,50,9,22,0,2,13,46,72,6,1,46,79,30,46,9,33,7,14,13,39,79
2006-05-29 00:00:00.000,Roland Garros France Grand Slams,CLAY,3,Carlos Moya,Mikhail Youzhny,Carlos Moya,6-3; 6-4; 6-2,R64,114,3,0,53,95,42,53,22,42,3,3,14,64,95,1,2,55,82,35,55,13,27,5,9,13,48,82
2006-05-29 00:00:00.000,Roland Garros France Grand Slams,CLAY,3,Nikolay Davydenko,Flavio Saretta,Nikolay Davydenko,6-2; 4-1 RET,R64,64,0,1,16,30,13,16,11,14,0,0,6,24,30,2,1,39,62,19,39,12,23,4,8,7,31,62
2006-05-29 00:00:00.000,Roland Garros France Grand Slams,CLAY,3,Alberto Martin,Dieter Kindlmann,Alberto Martin,6-3; 6-3; 6-3,R64,114,4,1,62,93,42,62,17,31,5,7,13,59,93,1,1,57,85,35,57,9,28,3,10,14,44,85
2006-05-29 00:00:00.000,Roland Garros France Grand Slams,CLAY,3,Olivier Rochus,Jiri Vanek,Olivier Rochus,6-2; 6-0; 6-2,R64,98,1,0,46,66,33,46,14,20,0,0,11,47,66,7,4,60,96,34,60,9,36,10,17,11,43,96
2006-05-29 00:00:00.000,Roland Garros France Grand Slams,CLAY,3,Julien Benneteau,Marcos Baghdatis,Julien Benneteau,3-6; 6-4; 6-3; 6-7(1); 6-4,R64,226,3,3,116,162,79,116,26,46,4,7,25,105,162,9,3,91,166,63,91,43,75,12,17,25,106,166
2006-05-29 00:00:00.000,Roland Garros France Grand Slams,CLAY,3,Radek Stepanek,Davide Sanguinetti,Radek Stepanek,6-3; 6-3; 6-1,R64,85,12,4,43,71,39,43,16,28,1,1,13,55,71,4,1,50,82,29,50,16,32,4,9,12,45,82
2006-05-29 00:00:00.000,Roland Garros France Grand Slams,CLAY,3,David Ferrer,Jeremy Chardy,David Ferrer,6-1; 6-4; 3-6; 6-1,R64,133,1,5,71,114,49,71,23,43,6,10,17,72,114,2,8,71,116,37,71,18,45,12,20,16,55,116
2006-05-29 00:00:00.000,Roland Garros France Grand Slams,CLAY,3,Ruben Ramirez Hidalgo,Christophe Rochus,Ruben Ramirez Hidalgo,5-2 RET,R64,39,1,0,18,28,14,18,5,10,2,2,4,19,28,0,2,18,31,11,18,5,13,6,7,3,16,31
2006-05-29 00:00:00.000,Roland Garros France Grand Slams,CLAY,3,Juan Monaco,Fernando Verdasco,Juan Monaco,4-6; 6-4; 6-4; 6-1,R64,163,3,2,96,118,59,96,10,22,9,14,18,69,118,2,4,104,139,60,104,14,35,13,22,19,74,139
2006-05-29 00:00:00.000,Roland Garros France Grand Slams,CLAY,3,Ivan Ljubicic,Oscar Hernandez,Ivan Ljubicic,6-3; 6-7(7); 6-1; 6-2,R64,169,8,5,79,123,67,79,20,44,7,7,19,87,123,1,1,73,115,42,73,27,42,2,7,17,69,115
2006-05-29 00:00:00.000,Roland Garros France Grand Slams,CLAY,3,James Blake,Nicolas Almagro,James Blake,6-7(5); 6-2; 6-4; 6-4,R64,158,6,1,65,114,52,65,30,49,0,1,20,82,114,7,2,91,153,63,91,27,62,6,11,20,90,153
2006-05-29 00:00:00.000,Roland Garros France Grand Slams,CLAY,3,Gael Monfils,Dick Norman,Gael Monfils,4-6; 6-3; 6-7(4); 6-0; 7-5,R64,199,7,3,89,142,70,89,29,53,4,7,25,99,142,4,7,100,156,62,100,29,56,8,15,24,91,156
2006-05-29 00:00:00.000,Roland Garros France Grand Slams,CLAY,3,Tommy Haas,Alexander Waske,Tommy Haas,6-4; 7-5; 6-7(6); 6-4,R64,197,16,2,92,149,72,92,31,57,9,10,22,103,149,14,4,89,138,66,89,24,49,3,7,22,90,138
2006-05-29 00:00:00.000,Roland Garros France Grand Slams,CLAY,3,Novak Djokovic,Fernando Gonzalez,Novak Djokovic,6-4; 6-1; 3-6; 4-6; 6-1,R64,183,6,1,105,153,75,105,26,48,12,15,22,101,153,9,4,73,114,53,73,18,41,4,10,21,71,114
2006-05-29 00:00:00.000,Roland Garros France Grand Slams,CLAY,3,Lleyton Hewitt,Mathieu Montcourt,Lleyton Hewitt,7-5; 6-3; 6-3,R64,144,6,3,62,105,43,62,20,43,5,9,15,63,105,1,7,62,97,36,62,11,35,10,18,15,47,97
2006-05-29 00:00:00.000,Roland Garros France Grand Slams,CLAY,3,Dominik Hrbaty,Ivo Karlovic,Dominik Hrbaty,4-6; 6-4; 6-7(2); 7-5; 6-2,R64,204,11,7,91,154,73,91,38,63,8,9,26,111,154,31,1,119,161,89,119,19,42,12,16,26,108,161
2006-05-29 00:00:00.000,Roland Garros France Grand Slams,CLAY,3,Paul-Henri Mathieu,Florent Serra,Paul-Henri Mathieu,6-0; 7-6(5); 7-6(6),R64,153,4,3,65,96,42,65,19,31,2,5,15,61,96,3,1,64,115,40,64,22,51,5,11,15,62,115
2006-05-29 00:00:00.000,Roland Garros France Grand Slams,CLAY,3,Rafael Nadal,Kevin Kim,Rafael Nadal,6-2; 6-1; 6-4,R64,118,2,0,56,76,41,56,15,20,3,3,13,56,76,2,1,53,89,31,53,16,36,10,15,12,47,89
2006-05-29 00:00:00.000,Roland Garros France Grand Slams,CLAY,3,Roger Federer,Nicolas Massu,Roger Federer,6-1; 6-2; 6-7(4); 7-5,R32,155,6,3,70,114,52,70,29,44,5,7,20,81,114,4,5,77,119,51,77,18,42,5,12,19,69,119
2006-05-29 00:00:00.000,Roland Garros France Grand Slams,CLAY,3,Tomas Berdych,Nicolas Kiefer,Tomas Berdych,6-1 RET,R32,29,3,0,11,19,10,11,6,8,0,0,4,16,19,2,2,9,19,7,9,2,10,2,4,3,9,19
2006-05-29 00:00:00.000,Roland Garros France Grand Slams,CLAY,3,Mario Ancic,Albert Montanes,Mario Ancic,6-1; 6-2; 6-4,R32,93,9,1,52,71,42,52,11,19,1,2,13,53,71,0,3,47,73,27,47,7,26,6,12,12,34,73
2006-05-29 00:00:00.000,Roland Garros France Grand Slams,CLAY,3,Tommy Robredo,Lukas Dlouhy,Tommy Robredo,6-1; 6-4; 6-2,R32,97,1,1,77,92,53,77,6,15,7,8,13,59,92,1,5,57,86,31,57,11,29,6,12,12,42,86
2006-05-29 00:00:00.000,Roland Garros France Grand Slams,CLAY,3,David Nalbandian,Dmitry Tursunov,David Nalbandian,2-6; 5-7; 6-4; 6-2; 6-4,R32,191,8,1,97,148,69,97,25,51,5,10,24,94,148,10,3,85,137,60,85,28,52,5,11,24,88,137
2006-05-29 00:00:00.000,Roland Garros France Grand Slams,CLAY,3,Martin Vassallo Arguello,Raemon Sluiter,Martin Vassallo Arguello,2-6; 6-4; 6-3; 3-6; 6-1,R32,186,12,1,101,128,71,101,12,27,7,11,21,83,128,8,8,78,142,57,78,27,64,4,10,22,84,142
2006-05-29 00:00:00.000,Roland Garros France Grand Slams,CLAY,3,Gaston Gaudio,Juan Carlos Ferrero,Gaston Gaudio,7-5; 7-5; 7-6(7),R32,195,3,3,82,118,60,82,18,36,3,7,18,78,118,2,0,98,130,59,98,16,32,14,20,18,75,130
2006-05-29 00:00:00.000,Roland Garros France Grand Slams,CLAY,3,Nikolay Davydenko,Carlos Moya,Nikolay Davydenko,6-1; 7-5; 6-3,R32,123,3,3,55,79,40,55,13,24,5,7,14,53,79,2,1,55,100,31,55,19,45,10,17,14,50,100
2006-05-29 00:00:00.000,Roland Garros France Grand Slams,CLAY,3,Alberto Martin,Olivier Rochus,Alberto Martin,7-5; 4-6; 6-7(5); 6-1; 6-4,R32,239,12,7,123,193,83,123,35,70,16,22,26,118,193,2,2,96,155,57,96,32,59,8,17,25,89,155
2006-05-29 00:00:00.000,Roland Garros France Grand Slams,CLAY,3,Julien Benneteau,Radek Stepanek,Julien Benneteau,5-7; 7-5; 7-6(8); 6-3,R32,213,6,0,97,144,68,97,31,47,3,5,23,99,144,15,5,94,151,74,94,25,57,11,14,22,99,151
2006-05-29 00:00:00.000,Roland Garros France Grand Slams,CLAY,3,Ruben Ramirez Hidalgo,David Ferrer,Ruben Ramirez Hidalgo,7-6(4); 7-5; 6-4,R32,165,3,2,67,112,46,67,20,45,4,8,17,66,112,3,4,66,119,41,66,26,53,9,15,17,67,119
2006-05-29 00:00:00.000,Roland Garros France Grand Slams,CLAY,3,Ivan Ljubicic,Juan Monaco,Ivan Ljubicic,4-6; 5-7; 6-3; 6-4; 6-2,R32,240,13,5,88,163,62,88,36,75,14,20,25,98,163,2,1,102,144,60,102,26,42,8,16,24,86,144
2006-05-29 00:00:00.000,Roland Garros France Grand Slams,CLAY,3,Gael Monfils,James Blake,Gael Monfils,6-2; 6-7(2); 7-6(1); 5-7; 6-4,R32,201,12,3,122,174,81,122,31,52,13,18,27,112,174,3,2,116,177,72,116,35,61,7,14,27,107,177
2006-05-29 00:00:00.000,Roland Garros France Grand Slams,CLAY,3,Novak Djokovic,Tommy Haas,Novak Djokovic,7-5; 6-1; 7-6(4),R32,134,6,3,57,80,43,57,16,23,2,4,15,59,80,5,2,60,101,40,60,19,41,6,12,16,59,101
2006-05-29 00:00:00.000,Roland Garros France Grand Slams,CLAY,3,Lleyton Hewitt,Dominik Hrbaty,Lleyton Hewitt,7-6(5); 6-2; 6-2,R32,126,11,2,63,104,47,63,22,41,6,8,14,69,104,4,4,58,94,37,58,13,36,5,11,14,50,94
2006-05-29 00:00:00.000,Roland Garros France Grand Slams,CLAY,3,Rafael Nadal,Paul-Henri Mathieu,Rafael Nadal,5-7; 6-4; 6-4; 6-4,R32,293,6,1,88,129,54,88,23,41,7,13,21,77,129,4,5,108,168,62,108,27,60,21,29,21,89,168
2006-05-29 00:00:00.000,Roland Garros France Grand Slams,CLAY,3,Roger Federer,Tomas Berdych,Roger Federer,6-3; 6-2; 6-3,R16,107,9,1,50,79,38,50,16,29,2,3,13,54,79,7,3,54,92,39,54,10,38,10,16,13,49,92
2006-05-29 00:00:00.000,Roland Garros France Grand Slams,CLAY,3,Mario Ancic,Tommy Robredo,Mario Ancic,6-4; 4-6; 2-6; 6-4; 7-5,R16,229,8,1,89,147,61,89,30,58,4,9,25,91,147,3,2,112,144,74,112,18,32,5,10,25,92,144
2006-05-29 00:00:00.000,Roland Garros France Grand Slams,CLAY,3,David Nalbandian,Martin Vassallo Arguello,David Nalbandian,6-4; 6-4; 6-4,R16,130,1,4,59,94,39,59,19,35,4,7,15,58,94,6,1,77,96,42,77,10,19,4,10,15,52,96
2006-05-29 00:00:00.000,Roland Garros France Grand Slams,CLAY,3,Nikolay Davydenko,Gaston Gaudio,Nikolay Davydenko,6-3; 6-4; 3-6; 6-3,R16,170,5,3,71,113,46,71,20,42,13,20,19,66,113,1,5,65,115,35,65,25,50,11,20,18,60,115
2006-05-29 00:00:00.000,Roland Garros France Grand Slams,CLAY,3,Julien Benneteau,Alberto Martin,Julien Benneteau,5-1 RET,R16,28,1,0,10,15,9,10,3,5,0,0,3,12,15,0,1,7,16,5,7,2,9,1,3,3,7,16
2006-05-29 00:00:00.000,Roland Garros France Grand Slams,CLAY,3,Ivan Ljubicic,Ruben Ramirez Hidalgo,Ivan Ljubicic,6-3; 3-6; 6-3; 6-2,R16,182,6,1,63,108,46,63,25,45,2,4,18,71,108,3,1,53,109,29,53,34,56,10,15,17,63,109
2006-05-29 00:00:00.000,Roland Garros France Grand Slams,CLAY,3,Novak Djokovic,Gael Monfils,Novak Djokovic,7-6(5); 7-6(5); 6-3,R16,153,7,4,59,101,44,59,28,42,3,6,17,72,101,6,3,48,101,35,48,29,53,5,9,16,64,101
2006-05-29 00:00:00.000,Roland Garros France Grand Slams,CLAY,3,Rafael Nadal,Lleyton Hewitt,Rafael Nadal,6-2; 5-7; 6-4; 6-2,R16,197,1,4,79,113,53,79,21,34,5,9,19,74,113,4,6,62,121,42,62,22,59,13,21,19,64,121
2006-05-29 00:00:00.000,Roland Garros France Grand Slams,CLAY,3,Roger Federer,Mario Ancic,Roger Federer,6-4; 6-3; 6-4,Q,137,4,0,65,104,43,65,28,39,8,9,15,71,104,3,2,64,100,45,64,13,36,14,18,14,58,100
2006-05-29 00:00:00.000,Roland Garros France Grand Slams,CLAY,3,David Nalbandian,Nikolay Davydenko,David Nalbandian,6-3; 6-3; 2-6; 6-4,Q,166,8,4,66,112,44,66,26,46,6,10,18,70,112,9,0,93,129,59,93,16,36,15,21,18,75,129
2006-05-29 00:00:00.000,Roland Garros France Grand Slams,CLAY,3,Ivan Ljubicic,Julien Benneteau,Ivan Ljubicic,6-2; 6-2; 6-3,Q,133,13,0,53,93,37,53,21,40,7,10,13,58,93,1,3,40,70,17,40,12,30,1,9,12,29,70
2006-05-29 00:00:00.000,Roland Garros France Grand Slams,CLAY,3,Rafael Nadal,Novak Djokovic,Rafael Nadal,6-4; 6-4 RET,Q,114,3,0,47,59,30,47,7,12,3,6,10,37,59,2,3,49,67,27,49,4,18,2,7,10,31,67
2006-05-29 00:00:00.000,Roland Garros France Grand Slams,CLAY,3,Roger Federer,David Nalbandian,Roger Federer,3-6; 6-4; 5-2 RET,S,98,4,1,41,72,32,41,15,31,2,5,13,47,72,1,5,49,74,28,49,17,25,4,8,13,45,74
2006-05-29 00:00:00.000,Roland Garros France Grand Slams,CLAY,3,Rafael Nadal,Ivan Ljubicic,Rafael Nadal,6-4; 6-2; 7-6(7),S,169,7,0,65,95,51,65,17,30,1,2,15,68,95,10,5,61,104,42,61,22,43,5,9,15,64,104
2006-05-29 00:00:00.000,Roland Garros France Grand Slams,CLAY,3,Rafael Nadal,Roger Federer,Rafael Nadal,1-6; 6-1; 6-4; 7-6(4),F,182,3,0,85,111,59,85,17,26,7,10,18,76,111,8,1,72,119,49,72,25,47,8,12,18,74,119
2006-06-12 00:00:00.000,Halle Germany ATP World Tour,GRASS,2,Roger Federer,Rohan Bopanna,Roger Federer,7-6(4); 6-2,R32,71,7,0,37,56,32,37,16,19,2,2,10,48,56,9,10,31,76,27,31,20,45,9,11,10,47,76
2006-06-12 00:00:00.000,Halle Germany ATP World Tour,GRASS,2,Richard Gasquet,George Bastl,Richard Gasquet,6-2; 6-3,R32,64,8,1,38,50,31,38,7,12,1,1,9,38,50,2,4,37,58,24,37,7,21,4,7,8,31,58
2006-06-12 00:00:00.000,Halle Germany ATP World Tour,GRASS,2,Marat Safin,Florent Serra,Marat Safin,7-6(4); 6-3,R32,72,5,0,39,66,35,39,13,27,1,2,11,48,66,1,2,37,64,26,37,16,27,1,3,10,42,64
2006-06-12 00:00:00.000,Halle Germany ATP World Tour,GRASS,2,Olivier Rochus,Alexander Waske,Olivier Rochus,2-6; 6-4; 6-3,R32,114,3,4,50,84,37,50,20,34,3,5,14,57,84,14,5,48,80,37,48,16,32,5,7,13,53,80
2006-06-12 00:00:00.000,Halle Germany ATP World Tour,GRASS,2,Andrei Pavel,Marcos Baghdatis,Andrei Pavel,7-6(5); 6-3,R32,82,6,2,39,65,30,39,11,26,1,3,10,41,65,9,2,34,67,22,34,16,33,4,8,11,38,67
2006-06-12 00:00:00.000,Halle Germany ATP World Tour,GRASS,2,Robin Soderling,Rainer Schuettler,Robin Soderling,6-3; 7-6(3),R32,68,6,2,46,67,40,46,11,21,2,2,11,51,67,7,3,34,59,29,34,13,25,2,3,10,42,59
2006-06-12 00:00:00.000,Halle Germany ATP World Tour,GRASS,2,Andreas Seppi,Davide Sanguinetti,Andreas Seppi,7-6(12); 7-5,R32,103,4,2,52,88,40,52,20,36,3,3,12,60,88,5,5,50,88,34,50,25,38,5,6,12,59,88
2006-06-12 00:00:00.000,Halle Germany ATP World Tour,GRASS,2,Tommy Haas,Gilles Simon,Tommy Haas,6-4; 7-5,R32,66,6,2,35,58,29,35,15,23,0,0,11,44,58,6,0,35,59,27,35,15,24,3,5,11,42,59
2006-06-12 00:00:00.000,Halle Germany ATP World Tour,GRASS,2,Kristof Vliegen,Stanislas Wawrinka,Kristof Vliegen,6-2; 6-3,R32,64,3,0,26,37,24,26,8,11,0,0,8,32,37,5,4,24,58,14,24,16,34,2,6,9,30,58
2006-06-12 00:00:00.000,Halle Germany ATP World Tour,GRASS,2,Marco Chiudinelli,Christophe Rochus,Marco Chiudinelli,6-3; 6-4,R32,62,5,2,30,57,22,30,17,27,3,5,10,39,57,2,4,38,58,26,38,5,20,1,5,9,31,58
2006-06-12 00:00:00.000,Halle Germany ATP World Tour,GRASS,2,Florian Mayer,Bjorn Phau,Florian Mayer,7-5; 1-6; 7-6(8),R32,114,7,2,73,104,47,73,12,31,5,10,15,59,104,6,4,63,111,46,63,20,48,2,6,16,66,111
2006-06-12 00:00:00.000,Halle Germany ATP World Tour,GRASS,2,Jarkko Nieminen,Philipp Kohlschreiber,Jarkko Nieminen,7-6(3); 6-4,R32,81,6,0,42,65,30,42,17,23,1,2,11,47,65,9,9,36,65,28,36,14,29,1,3,11,42,65
2006-06-12 00:00:00.000,Halle Germany ATP World Tour,GRASS,2,Tomas Berdych,Benjamin Becker,Tomas Berdych,6-4; 6-3,R32,63,13,1,32,48,27,32,14,16,3,3,10,41,48,10,3,30,54,23,30,12,24,6,8,9,35,54
2006-06-12 00:00:00.000,Halle Germany ATP World Tour,GRASS,2,Jiri Novak,Boris Pashanski,Jiri Novak,7-5; 6-2,R32,70,4,2,35,54,31,35,7,19,0,1,10,38,54,3,9,43,77,28,43,11,34,11,15,10,39,77
2006-06-12 00:00:00.000,Halle Germany ATP World Tour,GRASS,2,Fabrice Santoro,Mikhail Youzhny,Fabrice Santoro,7-6(4); 6-2,R32,90,1,0,34,68,28,34,18,34,0,0,10,46,68,3,0,37,58,23,37,13,21,0,2,10,36,58
2006-06-12 00:00:00.000,Halle Germany ATP World Tour,GRASS,2,Arnaud Clement,Kristian Pless,Arnaud Clement,7-5; 6-3,R32,76,6,0,43,56,31,43,10,13,3,4,10,41,56,4,2,37,68,24,37,14,31,2,6,11,38,68
2006-06-12 00:00:00.000,Halle Germany ATP World Tour,GRASS,2,Roger Federer,Richard Gasquet,Roger Federer,7-6(7); 6-7(7); 6-4,R16,134,10,0,74,113,57,74,22,39,1,2,17,79,113,1,0,75,110,55,75,21,35,2,4,17,76,110
2006-06-12 00:00:00.000,Halle Germany ATP World Tour,GRASS,2,Olivier Rochus,Marat Safin,Olivier Rochus,4-6; 6-4; 6-1,R16,112,1,6,60,95,42,60,17,35,11,13,13,59,95,6,2,60,92,37,60,15,32,5,10,14,52,92
2006-06-12 00:00:00.000,Halle Germany ATP World Tour,GRASS,2,Robin Soderling,Andrei Pavel,Robin Soderling,4-6; 6-3; 6-0,R16,89,12,2,61,88,44,61,14,27,6,7,13,58,88,6,1,48,70,33,48,8,22,4,8,12,41,70
2006-06-12 00:00:00.000,Halle Germany ATP World Tour,GRASS,2,Tommy Haas,Andreas Seppi,Tommy Haas,6-1; 6-2,R16,50,9,0,22,37,20,22,12,15,0,0,8,32,37,0,1,22,47,11,22,13,25,4,8,7,24,47
2006-06-12 00:00:00.000,Halle Germany ATP World Tour,GRASS,2,Kristof Vliegen,Marco Chiudinelli,Kristof Vliegen,7-6(4); 6-0,R16,76,14,2,47,64,35,47,11,17,7,7,9,46,64,1,4,32,56,19,32,12,24,1,4,9,31,56
2006-06-12 00:00:00.000,Halle Germany ATP World Tour,GRASS,2,Florian Mayer,Jarkko Nieminen,Florian Mayer,6-4; 3-6; 6-4,R16,102,7,1,53,82,40,53,12,29,2,5,14,52,82,8,4,71,114,49,71,16,43,12,16,15,65,114
2006-06-12 00:00:00.000,Halle Germany ATP World Tour,GRASS,2,Tomas Berdych,Jiri Novak,Tomas Berdych,6-3; 6-7(5); 7-5,R16,113,15,2,59,90,49,59,23,31,0,0,17,72,90,4,2,74,108,51,74,23,34,4,6,16,74,108
2006-06-12 00:00:00.000,Halle Germany ATP World Tour,GRASS,2,Fabrice Santoro,Arnaud Clement,Fabrice Santoro,6-4; 7-6(2),R16,102,8,2,52,79,39,52,12,27,4,6,11,51,79,3,0,46,67,30,46,12,21,6,9,11,42,67
2006-06-12 00:00:00.000,Halle Germany ATP World Tour,GRASS,2,Roger Federer,Olivier Rochus,Roger Federer,6-7(2); 7-6(9); 7-6(5),Q,165,19,2,88,134,60,88,20,46,7,11,18,80,134,2,6,88,128,56,88,21,40,6,10,18,77,128
2006-06-12 00:00:00.000,Halle Germany ATP World Tour,GRASS,2,Tommy Haas,Robin Soderling,Tommy Haas,7-5; 6-4,Q,73,11,4,36,57,33,36,10,21,0,1,11,43,57,8,3,39,65,24,39,15,26,4,7,11,39,65
2006-06-12 00:00:00.000,Halle Germany ATP World Tour,GRASS,2,Kristof Vliegen,Florian Mayer,Kristof Vliegen,6-3; 6-7(5); 6-4,Q,118,12,6,66,97,55,66,15,31,4,5,16,70,97,3,2,65,97,45,65,19,32,4,7,15,64,97
2006-06-12 00:00:00.000,Halle Germany ATP World Tour,GRASS,2,Tomas Berdych,Fabrice Santoro,Tomas Berdych,7-5; 7-6(3),Q,110,7,0,44,69,36,44,16,25,1,2,12,52,69,9,2,62,101,43,62,18,39,9,11,12,61,101
2006-06-12 00:00:00.000,Halle Germany ATP World Tour,GRASS,2,Roger Federer,Tommy Haas,Roger Federer,6-4; 6-7(4); 6-3,S,137,9,1,65,97,51,65,19,32,3,3,16,70,97,4,6,75,121,55,75,22,46,14,16,15,77,121
2006-06-12 00:00:00.000,Halle Germany ATP World Tour,GRASS,2,Tomas Berdych,Kristof Vliegen,Tomas Berdych,6-3; 6-2,S,60,5,3,32,55,29,32,10,23,5,5,9,39,55,4,3,33,46,23,33,2,13,0,3,8,25,46
2006-06-12 00:00:00.000,Halle Germany ATP World Tour,GRASS,2,Roger Federer,Tomas Berdych,Roger Federer,6-0; 6-7(4); 6-2,F,95,11,3,48,73,40,48,14,25,0,1,13,54,73,10,2,47,83,30,47,16,36,2,8,13,46,83
2006-06-12 00:00:00.000,London / Queen's Club England ATP World Tour,GRASS,2,Rafael Nadal,N/A Bye,Rafael Nadal,,R64,0,0,0,0,0,0,0,0,0,0,0,0,0,0,0,0,0,0,0,0,0,0,0,0,0,0,0
2006-06-12 00:00:00.000,London / Queen's Club England ATP World Tour,GRASS,2,Mardy Fish,Jamie Baker,Mardy Fish,6-1; 6-3,R64,63,11,1,23,41,21,23,12,18,2,2,8,33,41,2,5,36,55,20,36,7,19,4,8,8,27,55
2006-06-12 00:00:00.000,London / Queen's Club England ATP World Tour,GRASS,2,Fernando Verdasco,Simon Greul,Fernando Verdasco,6-3; 6-3,R64,72,3,5,34,51,29,34,10,17,3,3,9,39,51,3,1,35,56,24,35,7,21,1,4,9,31,56
2006-06-12 00:00:00.000,London / Queen's Club England ATP World Tour,GRASS,2,Hyung-Taik Lee,Paul-Henri Mathieu,Hyung-Taik Lee,7-6(2); 6-7(3); 6-4,R64,148,9,1,92,114,68,92,13,22,4,5,17,81,114,14,3,83,130,60,83,26,47,11,13,17,86,130
2006-06-12 00:00:00.000,London / Queen's Club England ATP World Tour,GRASS,2,Max Mirnyi,Thomas Johansson,Max Mirnyi,7-6(6); 3-6; 7-6(4),R64,159,13,6,70,115,51,70,25,45,2,4,16,76,115,12,3,68,111,48,68,27,43,3,4,17,75,111
2006-06-12 00:00:00.000,London / Queen's Club England ATP World Tour,GRASS,2,Daniele Bracciali,Feliciano Lopez,Daniele Bracciali,6-1; 7-6(4),R64,82,4,1,36,68,30,36,18,32,1,2,10,48,68,13,1,31,56,25,31,10,25,0,3,9,35,56
2006-06-12 00:00:00.000,London / Queen's Club England ATP World Tour,GRASS,2,Fernando Vicente,Martin Lee,Fernando Vicente,6-3; 6-2,R64,59,8,0,34,47,29,34,9,13,2,2,9,38,47,3,6,33,66,25,33,12,33,7,10,8,37,66
2006-06-12 00:00:00.000,London / Queen's Club England ATP World Tour,GRASS,2,Lleyton Hewitt,N/A Bye,Lleyton Hewitt,,R64,0,0,0,0,0,0,0,0,0,0,0,0,0,0,0,0,0,0,0,0,0,0,0,0,0,0,0
2006-06-12 00:00:00.000,London / Queen's Club England ATP World Tour,GRASS,2,Nikolay Davydenko,N/A Bye,Nikolay Davydenko,,R64,0,0,0,0,0,0,0,0,0,0,0,0,0,0,0,0,0,0,0,0,0,0,0,0,0,0,0
2006-06-12 00:00:00.000,London / Queen's Club England ATP World Tour,GRASS,2,Jimmy Wang,Jonas Bjorkman,Jimmy Wang,6-3; 6-3,R64,63,0,2,30,49,25,30,12,19,2,2,9,37,49,3,4,26,49,19,26,10,23,0,3,9,29,49
2006-06-12 00:00:00.000,London / Queen's Club England ATP World Tour,GRASS,2,Danai Udomchoke,Tomas Zib,Danai Udomchoke,3-6; 7-5; 6-0,R64,90,13,2,65,85,50,65,8,20,2,3,13,58,85,9,5,49,79,36,49,14,30,4,8,14,50,79
2006-06-12 00:00:00.000,London / Queen's Club England ATP World Tour,GRASS,2,Dmitry Tursunov,Alex Bogdanovic,Dmitry Tursunov,7-6(4); 6-4,R64,76,11,1,37,69,31,37,18,32,0,0,11,49,69,6,4,39,64,28,39,17,25,0,1,11,45,64
2006-06-12 00:00:00.000,London / Queen's Club England ATP World Tour,GRASS,2,Tim Henman,Andre Agassi,Tim Henman,6-4; 6-4,R64,75,7,4,37,64,23,37,18,27,5,6,10,41,64,5,1,31,55,21,31,13,24,0,3,10,34,55
2006-06-12 00:00:00.000,London / Queen's Club England ATP World Tour,GRASS,2,Ramon Delgado,Lukas Dlouhy,Ramon Delgado,6-4; 7-6(3),R64,80,5,0,39,70,27,39,26,31,8,8,11,53,70,9,4,42,68,32,42,15,26,0,1,11,47,68
2006-06-12 00:00:00.000,London / Queen's Club England ATP World Tour,GRASS,2,Nicolas Mahut,Julien Benneteau,Nicolas Mahut,6-4; 6-1,R64,73,9,2,35,51,26,35,9,16,0,1,9,35,51,4,1,33,46,20,33,5,13,4,8,8,25,46
2006-06-12 00:00:00.000,London / Queen's Club England ATP World Tour,GRASS,2,Radek Stepanek,N/A Bye,Radek Stepanek,,R64,0,0,0,0,0,0,0,0,0,0,0,0,0,0,0,0,0,0,0,0,0,0,0,0,0,0,0
2006-06-12 00:00:00.000,London / Queen's Club England ATP World Tour,GRASS,2,Fernando Gonzalez,N/A Bye,Fernando Gonzalez,,R64,0,0,0,0,0,0,0,0,0,0,0,0,0,0,0,0,0,0,0,0,0,0,0,0,0,0,0
2006-06-12 00:00:00.000,London / Queen's Club England ATP World Tour,GRASS,2,Antony Dupuis,Greg Rusedski,Antony Dupuis,5-7; 6-3; 3-2 RET,R64,101,7,0,42,71,31,42,19,29,1,3,13,50,71,14,5,33,69,24,33,21,36,1,4,13,45,69
2006-06-12 00:00:00.000,London / Queen's Club England ATP World Tour,GRASS,2,Mark Philippoussis,Wesley Moodie,Mark Philippoussis,6-3; 6-4,R64,74,12,8,35,68,31,35,16,33,6,6,10,47,68,2,3,32,48,26,32,6,16,2,4,9,32,48
2006-06-12 00:00:00.000,London / Queen's Club England ATP World Tour,GRASS,2,Sebastien Grosjean,Ivo Minar,Sebastien Grosjean,6-3; 7-6(4),R64,80,10,2,49,73,39,49,15,24,3,3,11,54,73,2,3,43,66,33,43,12,23,0,1,10,45,66
2006-06-12 00:00:00.000,London / Queen's Club England ATP World Tour,GRASS,2,Paradorn Srichaphan,Dick Norman,Paradorn Srichaphan,6-4; 7-6(5),R64,79,13,2,41,65,34,41,15,24,1,1,11,49,65,14,11,47,77,32,47,16,30,2,3,11,48,77
2006-06-12 00:00:00.000,London / Queen's Club England ATP World Tour,GRASS,2,Yen-Hsun Lu,Gilles Muller,Yen-Hsun Lu,6-4; 7-6(7),R64,106,1,3,44,75,33,44,19,31,3,4,11,52,75,8,2,47,77,37,47,12,30,2,4,11,49,77
2006-06-12 00:00:00.000,London / Queen's Club England ATP World Tour,GRASS,2,Frank Dancevic,Kenneth Carlsen,Frank Dancevic,4-6; 6-3; 6-3,R64,99,17,3,55,87,42,55,18,32,8,9,14,60,87,12,3,48,81,35,48,18,33,4,7,14,53,81
2006-06-12 00:00:00.000,London / Queen's Club England ATP World Tour,GRASS,2,Andy Roddick,N/A Bye,Andy Roddick,,R64,0,0,0,0,0,0,0,0,0,0,0,0,0,0,0,0,0,0,0,0,0,0,0,0,0,0,0
2006-06-12 00:00:00.000,London / Queen's Club England ATP World Tour,GRASS,2,James Blake,N/A Bye,James Blake,,R64,0,0,0,0,0,0,0,0,0,0,0,0,0,0,0,0,0,0,0,0,0,0,0,0,0,0,0
2006-06-12 00:00:00.000,London / Queen's Club England ATP World Tour,GRASS,2,Justin Gimelstob,Raemon Sluiter,Justin Gimelstob,7-6(7); 6-2,R64,97,16,2,36,67,32,36,19,31,1,1,10,51,67,12,4,51,85,38,51,14,34,11,13,10,52,85
2006-06-12 00:00:00.000,London / Queen's Club England ATP World Tour,GRASS,2,Janko Tipsarevic,Andy Murray,Janko Tipsarevic,7-6(3); 3-6; 6-2,R64,136,0,3,57,98,41,57,18,41,5,9,14,59,98,12,3,60,108,39,60,20,48,5,10,15,59,108
2006-06-12 00:00:00.000,London / Queen's Club England ATP World Tour,GRASS,2,Robby Ginepri,Paul Goldstein,Robby Ginepri,3-6; 7-5; 6-1,R64,95,9,1,58,90,43,58,18,32,4,5,14,61,90,3,1,48,78,39,48,13,30,2,5,14,52,78
2006-06-12 00:00:00.000,London / Queen's Club England ATP World Tour,GRASS,2,Gael Monfils,Jurgen Melzer,Gael Monfils,7-6(2); 7-6(2),R64,85,6,5,42,72,33,42,21,30,0,1,12,54,72,2,4,43,85,33,43,21,42,1,2,12,54,85
2006-06-12 00:00:00.000,London / Queen's Club England ATP World Tour,GRASS,2,Bobby Reynolds,Igor Kunitsyn,Bobby Reynolds,6-4; 6-4,R64,76,16,0,40,55,36,40,6,15,1,1,10,42,55,3,2,48,67,32,48,10,19,6,8,10,42,67
2006-06-12 00:00:00.000,London / Queen's Club England ATP World Tour,GRASS,2,Razvan Sabau,Robin Vik,Razvan Sabau,6-3; 6-3,R64,70,3,3,28,52,23,28,12,24,1,2,9,35,52,4,4,41,68,25,41,11,27,11,15,9,36,68
2006-06-12 00:00:00.000,London / Queen's Club England ATP World Tour,GRASS,2,Ivan Ljubicic,N/A Bye,Ivan Ljubicic,,R64,0,0,0,0,0,0,0,0,0,0,0,0,0,0,0,0,0,0,0,0,0,0,0,0,0,0,0
2006-06-12 00:00:00.000,London / Queen's Club England ATP World Tour,GRASS,2,Rafael Nadal,Mardy Fish,Rafael Nadal,7-6(1); 6-1,R32,76,4,1,40,61,35,40,11,21,2,2,10,46,61,12,8,22,57,20,22,15,35,2,4,9,35,57
2006-06-12 00:00:00.000,London / Queen's Club England ATP World Tour,GRASS,2,Fernando Verdasco,Hyung-Taik Lee,Fernando Verdasco,6-2; 5-7; 6-4,R32,112,3,3,69,86,48,69,8,17,4,7,15,56,86,4,3,76,103,45,76,15,27,7,12,15,60,103
2006-06-12 00:00:00.000,London / Queen's Club England ATP World Tour,GRASS,2,Max Mirnyi,Daniele Bracciali,Max Mirnyi,6-1; 6-3,R32,53,10,0,32,41,26,32,7,9,0,0,8,33,41,8,3,31,51,20,31,6,20,4,8,8,26,51
2006-06-12 00:00:00.000,London / Queen's Club England ATP World Tour,GRASS,2,Lleyton Hewitt,Fernando Vicente,Lleyton Hewitt,4-6; 6-4; 6-2,R32,115,7,3,51,94,37,51,22,43,7,9,14,59,94,4,1,66,88,41,66,10,22,8,12,14,51,88
2006-06-12 00:00:00.000,London / Queen's Club England ATP World Tour,GRASS,2,Jimmy Wang,Nikolay Davydenko,Jimmy Wang,2-6; 6-3; 6-1,R32,94,3,1,46,80,31,46,17,34,6,9,12,48,80,4,4,37,70,27,37,14,33,4,9,12,41,70
2006-06-12 00:00:00.000,London / Queen's Club England ATP World Tour,GRASS,2,Dmitry Tursunov,Danai Udomchoke,Dmitry Tursunov,6-3; 2-6; 6-2,R32,81,5,8,46,84,32,46,19,38,3,6,13,51,84,7,5,35,62,22,35,15,27,2,6,12,37,62
2006-06-12 00:00:00.000,London / Queen's Club England ATP World Tour,GRASS,2,Tim Henman,Ramon Delgado,Tim Henman,6-2; 6-4,R32,63,8,1,31,44,28,31,9,13,0,0,9,37,44,3,2,36,51,23,36,9,15,3,6,9,32,51
2006-06-12 00:00:00.000,London / Queen's Club England ATP World Tour,GRASS,2,Nicolas Mahut,Radek Stepanek,Nicolas Mahut,6-4; 4-6; 6-2,R32,112,10,5,51,81,37,51,13,30,3,7,14,50,81,7,10,61,97,41,61,12,36,15,21,14,53,97
2006-06-12 00:00:00.000,London / Queen's Club England ATP World Tour,GRASS,2,Fernando Gonzalez,Antony Dupuis,Fernando Gonzalez,7-6(5); 7-6(2),R32,94,8,3,50,79,41,50,22,29,4,4,12,63,79,11,0,55,79,47,55,12,24,1,1,12,59,79
2006-06-12 00:00:00.000,London / Queen's Club England ATP World Tour,GRASS,2,Mark Philippoussis,Sebastien Grosjean,Mark Philippoussis,7-6(5); 4-6; 6-3,R32,123,23,4,62,95,53,62,19,33,3,4,16,72,95,11,0,69,94,53,69,14,25,3,4,15,67,94
2006-06-12 00:00:00.000,London / Queen's Club England ATP World Tour,GRASS,2,Paradorn Srichaphan,Yen-Hsun Lu,Paradorn Srichaphan,6-3; 5-7; 6-4,R32,90,12,1,49,81,42,49,22,32,0,1,16,64,81,3,3,51,75,42,51,14,24,0,2,15,56,75
2006-06-12 00:00:00.000,London / Queen's Club England ATP World Tour,GRASS,2,Andy Roddick,Frank Dancevic,Andy Roddick,2-6; 6-4; 6-3,R32,85,11,0,49,66,40,49,7,17,1,3,13,47,66,3,2,67,92,46,67,12,25,9,12,14,58,92
2006-06-12 00:00:00.000,London / Queen's Club England ATP World Tour,GRASS,2,James Blake,Justin Gimelstob,James Blake,7-5; 6-1,R32,69,3,2,37,59,29,37,14,22,4,4,10,43,59,4,2,44,60,28,44,6,16,5,8,9,34,60
2006-06-12 00:00:00.000,London / Queen's Club England ATP World Tour,GRASS,2,Robby Ginepri,Janko Tipsarevic,Robby Ginepri,7-6(4); 6-4,R32,77,6,1,50,76,36,50,16,26,6,7,11,52,76,9,2,47,69,33,47,12,22,5,7,11,45,69
2006-06-12 00:00:00.000,London / Queen's Club England ATP World Tour,GRASS,2,Gael Monfils,Bobby Reynolds,Gael Monfils,6-1; 6-2,R32,49,10,1,31,43,24,31,8,12,0,0,8,32,43,2,3,22,45,12,22,9,23,4,8,7,21,45
2006-06-12 00:00:00.000,London / Queen's Club England ATP World Tour,GRASS,2,Ivan Ljubicic,Razvan Sabau,Ivan Ljubicic,7-6(6); 6-2,R32,78,24,4,34,57,34,34,12,23,0,0,10,46,57,3,1,54,78,39,54,11,24,7,9,10,50,78
2006-06-12 00:00:00.000,London / Queen's Club England ATP World Tour,GRASS,2,Rafael Nadal,Fernando Verdasco,Rafael Nadal,2-6; 7-6(3); 7-6(3),R16,181,2,2,80,112,51,80,15,32,7,13,16,66,112,6,9,89,125,57,89,15,36,12,16,16,72,125
2006-06-12 00:00:00.000,London / Queen's Club England ATP World Tour,GRASS,2,Lleyton Hewitt,Max Mirnyi,Lleyton Hewitt,4-6; 6-1; 7-6(4),R16,116,8,4,59,96,39,59,24,37,4,8,15,63,96,12,3,57,78,39,57,6,21,0,5,14,45,78
2006-06-12 00:00:00.000,London / Queen's Club England ATP World Tour,GRASS,2,Dmitry Tursunov,Jimmy Wang,Dmitry Tursunov,6-3; 3-6; 6-1,R16,83,10,3,38,74,31,38,19,36,2,4,13,50,74,4,2,40,68,26,40,14,28,5,9,12,40,68
2006-06-12 00:00:00.000,London / Queen's Club England ATP World Tour,GRASS,2,Tim Henman,Nicolas Mahut,Tim Henman,6-3; 6-4,R16,75,5,2,31,51,27,31,11,20,0,1,10,38,51,2,1,34,54,21,34,10,20,3,6,9,31,54
2006-06-12 00:00:00.000,London / Queen's Club England ATP World Tour,GRASS,2,Fernando Gonzalez,Mark Philippoussis,Fernando Gonzalez,6-2; 3-6; 6-3,R16,110,4,8,51,95,38,51,23,44,7,8,13,61,95,15,4,37,66,31,37,14,29,1,4,13,45,66
2006-06-12 00:00:00.000,London / Queen's Club England ATP World Tour,GRASS,2,Andy Roddick,Paradorn Srichaphan,Andy Roddick,7-6(5); 6-3,R16,82,8,0,48,75,36,48,18,27,3,3,11,54,75,6,1,43,72,31,43,16,29,6,7,10,47,72
2006-06-12 00:00:00.000,London / Queen's Club England ATP World Tour,GRASS,2,James Blake,Robby Ginepri,James Blake,6-3; 3-6; 6-3,R16,93,11,4,63,107,46,63,20,44,11,13,14,66,107,6,1,53,77,37,53,12,24,3,6,13,49,77
2006-06-12 00:00:00.000,London / Queen's Club England ATP World Tour,GRASS,2,Gael Monfils,Ivan Ljubicic,Gael Monfils,7-6(11); 7-5,R16,103,12,3,55,89,41,55,21,34,3,4,12,62,89,7,6,51,82,41,51,12,31,0,2,12,53,82
2006-06-12 00:00:00.000,London / Queen's Club England ATP World Tour,GRASS,2,Lleyton Hewitt,Rafael Nadal,Lleyton Hewitt,3-6; 6-3 RET,Q,85,9,1,35,56,24,35,11,21,0,2,9,35,56,4,4,39,69,29,39,12,30,11,13,9,41,69
2006-06-12 00:00:00.000,London / Queen's Club England ATP World Tour,GRASS,2,Tim Henman,Dmitry Tursunov,Tim Henman,6-3; 7-6(1),Q,95,4,2,37,64,26,37,8,27,4,9,10,34,64,6,3,41,74,22,41,10,33,3,10,11,32,74
2006-06-12 00:00:00.000,London / Queen's Club England ATP World Tour,GRASS,2,Andy Roddick,Fernando Gonzalez,Andy Roddick,6-4; 6-3,Q,62,13,0,37,47,35,37,5,10,0,0,10,40,47,10,4,41,66,33,41,8,25,7,9,9,41,66
2006-06-12 00:00:00.000,London / Queen's Club England ATP World Tour,GRASS,2,James Blake,Gael Monfils,James Blake,6-1 RET,Q,21,2,0,12,22,9,12,8,10,1,1,4,17,22,1,3,17,24,11,17,1,7,1,3,3,12,24
2006-06-12 00:00:00.000,London / Queen's Club England ATP World Tour,GRASS,2,Lleyton Hewitt,Tim Henman,Lleyton Hewitt,6-3; 3-6; 6-2,S,106,6,2,44,75,31,44,19,31,3,5,13,50,75,4,2,47,76,35,47,13,29,5,9,13,48,76
2006-06-12 00:00:00.000,London / Queen's Club England ATP World Tour,GRASS,2,James Blake,Andy Roddick,James Blake,7-5; 6-4,S,74,8,3,41,65,28,41,16,24,3,4,11,44,65,9,1,58,75,39,58,5,17,3,6,11,44,75
2006-06-12 00:00:00.000,London / Queen's Club England ATP World Tour,GRASS,2,Lleyton Hewitt,James Blake,Lleyton Hewitt,6-4; 6-4,F,186,5,1,36,50,30,36,6,14,0,1,10,36,50,5,1,39,70,28,39,13,31,2,5,10,41,70
2006-06-19 00:00:00.000,Nottingham England ATP World Tour,GRASS,2,Jan Vacek,Thomas Johansson,Jan Vacek,7-6(6); 6-7(11); 6-4,R32,140,9,4,69,113,53,69,29,44,3,4,17,82,113,17,3,67,108,57,67,18,41,0,2,17,75,108
2006-06-19 00:00:00.000,Nottingham England ATP World Tour,GRASS,2,Gilles Simon,Igor Kunitsyn,Gilles Simon,6-4; 6-3,R32,73,5,2,22,51,20,22,17,29,0,1,10,37,51,1,0,44,61,27,44,8,17,7,10,9,35,61
2006-06-19 00:00:00.000,Nottingham England ATP World Tour,GRASS,2,Richard Gasquet,Ivan Navarro,Richard Gasquet,6-3; 3-6; 7-5,R32,96,3,1,49,74,35,49,16,25,0,3,15,51,74,8,7,39,83,32,39,23,44,3,7,15,55,83
2006-06-19 00:00:00.000,Nottingham England ATP World Tour,GRASS,2,Daniele Bracciali,Nicolas Almagro,Daniele Bracciali,1-6; 6-3; 7-6(7),R32,101,11,1,48,94,39,48,26,46,5,7,14,65,94,12,1,48,76,38,48,21,28,1,2,14,59,76
2006-06-19 00:00:00.000,Nottingham England ATP World Tour,GRASS,2,Nicolas Mahut,Xavier Malisse,Nicolas Mahut,3-6; 7-6(8); 7-5,R32,132,19,4,66,100,53,66,20,34,3,5,17,73,100,7,2,60,99,47,60,25,39,3,4,16,72,99
2006-06-19 00:00:00.000,Nottingham England ATP World Tour,GRASS,2,Robin Soderling,Justin Gimelstob,Robin Soderling,7-6(5); 6-7(4); 7-6(7),R32,189,12,2,90,132,64,90,22,42,5,7,18,86,132,13,3,78,149,58,78,37,71,12,14,18,95,149
2006-06-19 00:00:00.000,Nottingham England ATP World Tour,GRASS,2,Janko Tipsarevic,Richard Bloomfield,Janko Tipsarevic,6-4; 3-6; 6-3,R32,93,8,1,43,63,36,43,17,20,0,1,14,53,63,20,2,64,98,53,64,10,34,11,13,14,63,98
2006-06-19 00:00:00.000,Nottingham England ATP World Tour,GRASS,2,Paradorn Srichaphan,Danai Udomchoke,Paradorn Srichaphan,6-3; 7-6(4),R32,61,9,2,36,63,30,36,19,27,3,4,11,49,63,3,1,43,61,32,43,10,18,1,3,10,42,61
2006-06-19 00:00:00.000,Nottingham England ATP World Tour,GRASS,2,Jiri Vanek,Paul-Henri Mathieu,Jiri Vanek,6-4; 6-4,R32,68,11,2,45,57,35,45,6,12,2,3,10,41,57,4,4,38,58,28,38,9,20,1,4,10,37,58
2006-06-19 00:00:00.000,Nottingham England ATP World Tour,GRASS,2,Jonas Bjorkman,Agustin Calleri,Jonas Bjorkman,2-6; 6-1; 6-3,R32,88,4,2,49,67,32,49,7,18,1,5,12,39,67,5,2,43,73,26,43,11,30,2,8,12,37,73
2006-06-19 00:00:00.000,Nottingham England ATP World Tour,GRASS,2,Paul Goldstein,Wesley Moodie,Paul Goldstein,6-1; 7-5,R32,59,1,1,33,47,29,33,8,14,1,1,9,37,47,8,2,36,53,26,36,4,17,4,8,10,30,53
2006-06-19 00:00:00.000,Nottingham England ATP World Tour,GRASS,2,Feliciano Lopez,Olivier Rochus,Feliciano Lopez,6-3; 6-1,R32,50,7,4,23,43,19,23,14,20,1,1,8,33,43,2,5,28,42,15,28,5,14,0,4,8,20,42
2006-06-19 00:00:00.000,Nottingham England ATP World Tour,GRASS,2,Andy Murray,Dmitry Tursunov,Andy Murray,6-4; 6-3,R32,77,6,1,34,62,26,34,17,28,4,4,10,43,62,8,0,31,56,23,31,13,25,5,7,9,36,56
2006-06-19 00:00:00.000,Nottingham England ATP World Tour,GRASS,2,Max Mirnyi,Alex Bogdanovic,Max Mirnyi,4-6; 7-6(4); 6-3,R32,119,18,4,65,92,57,65,14,27,1,2,16,71,92,8,2,72,100,55,72,15,28,3,4,15,70,100
2006-06-19 00:00:00.000,Nottingham England ATP World Tour,GRASS,2,Andreas Seppi,Stanislas Wawrinka,Andreas Seppi,7-6(7); 4-6; 6-4,R32,133,2,4,50,92,40,50,25,42,3,5,16,65,92,11,6,57,112,46,57,28,55,5,7,16,74,112
2006-06-19 00:00:00.000,Nottingham England ATP World Tour,GRASS,2,Dominik Hrbaty,Jimmy Wang,Dominik Hrbaty,6-0; 6-3,R32,56,3,1,19,42,16,19,16,23,1,1,7,32,42,1,3,41,65,15,41,14,24,8,13,8,29,65
2006-06-19 00:00:00.000,Nottingham England ATP World Tour,GRASS,2,Gilles Simon,Jan Vacek,Gilles Simon,4-6; 6-4; 6-3,R16,106,8,4,48,93,32,48,25,45,10,14,15,57,93,1,3,50,88,31,50,19,38,8,13,14,50,88
2006-06-19 00:00:00.000,Nottingham England ATP World Tour,GRASS,2,Richard Gasquet,Daniele Bracciali,Richard Gasquet,7-5; 6-3,R16,82,4,2,43,60,37,43,10,17,2,2,11,47,60,4,0,33,72,25,33,19,39,5,7,10,44,72
2006-06-19 00:00:00.000,Nottingham England ATP World Tour,GRASS,2,Robin Soderling,Nicolas Mahut,Robin Soderling,6-3; 6-2,R16,59,8,2,33,50,26,33,11,17,2,2,9,37,50,3,2,31,50,19,31,8,19,5,8,8,27,50
2006-06-19 00:00:00.000,Nottingham England ATP World Tour,GRASS,2,Janko Tipsarevic,Paradorn Srichaphan,Janko Tipsarevic,7-6(3); 6-7(4); 7-5,R16,136,18,3,67,113,57,67,25,46,6,7,18,82,113,14,9,70,121,55,70,26,51,6,8,18,81,121
2006-06-19 00:00:00.000,Nottingham England ATP World Tour,GRASS,2,Jonas Bjorkman,Jiri Vanek,Jonas Bjorkman,6-3; 6-3,R16,68,4,0,31,47,24,31,13,16,1,1,9,37,47,3,5,55,77,33,55,8,22,4,7,9,41,77
2006-06-19 00:00:00.000,Nottingham England ATP World Tour,GRASS,2,Feliciano Lopez,Paul Goldstein,Feliciano Lopez,3-6; 6-2; 6-3,R16,106,15,3,50,82,41,50,11,32,0,2,13,52,82,3,6,37,83,23,37,25,46,5,9,13,48,83
2006-06-19 00:00:00.000,Nottingham England ATP World Tour,GRASS,2,Andy Murray,Max Mirnyi,Andy Murray,7-6(2); 6-4,R16,85,1,1,52,66,41,52,6,14,1,2,11,47,66,9,2,49,67,35,49,9,18,2,4,11,44,67
2006-06-19 00:00:00.000,Nottingham England ATP World Tour,GRASS,2,Andreas Seppi,Dominik Hrbaty,Andreas Seppi,7-5; 7-5,R16,99,7,4,46,86,31,46,20,40,7,10,12,51,86,5,6,38,68,25,38,11,30,3,8,12,36,68
2006-06-19 00:00:00.000,Nottingham England ATP World Tour,GRASS,2,Richard Gasquet,Gilles Simon,Richard Gasquet,6-3; 6-1,Q,68,3,4,30,52,21,30,11,22,2,3,8,32,52,0,1,31,58,15,31,12,27,4,9,8,27,58
2006-06-19 00:00:00.000,Nottingham England ATP World Tour,GRASS,2,Robin Soderling,Janko Tipsarevic,Robin Soderling,7-6(4); 6-4,Q,83,9,2,38,67,34,38,16,29,2,2,11,50,67,7,0,47,78,36,47,15,31,5,6,11,51,78
2006-06-19 00:00:00.000,Nottingham England ATP World Tour,GRASS,2,Jonas Bjorkman,Feliciano Lopez,Jonas Bjorkman,6-3; 6-4,Q,79,8,1,37,54,32,37,10,17,2,2,10,42,54,10,4,35,66,26,35,13,31,5,7,9,39,66
2006-06-19 00:00:00.000,Nottingham England ATP World Tour,GRASS,2,Andreas Seppi,Andy Murray,Andreas Seppi,7-6(4); 4-6; 6-1,Q,130,2,2,58,101,39,58,21,43,1,5,15,60,101,7,5,53,87,37,53,14,34,7,12,14,51,87
2006-06-19 00:00:00.000,Nottingham England ATP World Tour,GRASS,2,Richard Gasquet,Robin Soderling,Richard Gasquet,7-6(7); 7-6(5),S,96,9,1,64,87,47,64,15,23,3,4,12,62,87,13,6,59,83,51,59,8,24,0,1,12,59,83
2006-06-19 00:00:00.000,Nottingham England ATP World Tour,GRASS,2,Jonas Bjorkman,Andreas Seppi,Jonas Bjorkman,6-3; 6-1,S,71,3,0,22,43,18,22,14,21,0,0,8,32,43,1,4,31,56,20,31,8,25,5,9,8,28,56
2006-06-19 00:00:00.000,Nottingham England ATP World Tour,GRASS,2,Richard Gasquet,Jonas Bjorkman,Richard Gasquet,6-4; 6-3,F,77,4,0,35,50,29,35,9,15,1,1,9,38,50,4,2,45,65,29,45,8,20,4,7,10,37,65
2006-06-19 00:00:00.000,'s-Hertogenbosch The Netherlands ATP World Tour,GRASS,2,Philipp Kohlschreiber,Nikolay Davydenko,Philipp Kohlschreiber,6-2; 6-4,R32,71,4,1,32,51,26,32,12,19,1,1,9,38,51,3,3,38,64,25,38,12,26,7,10,9,37,64
2006-06-19 00:00:00.000,'s-Hertogenbosch The Netherlands ATP World Tour,GRASS,2,Julien Benneteau,Joseph Sirianni,Julien Benneteau,6-4; 6-4,R32,92,7,6,46,73,33,46,10,27,5,7,10,43,73,0,5,38,61,21,38,10,23,1,5,10,31,61
2006-06-19 00:00:00.000,'s-Hertogenbosch The Netherlands ATP World Tour,GRASS,2,Vincent Spadea,Bjorn Phau,Vincent Spadea,4-6; 6-1; 6-4,R32,107,2,1,50,83,39,50,19,33,7,8,14,58,83,7,4,53,96,35,53,23,43,12,15,13,58,96
2006-06-19 00:00:00.000,'s-Hertogenbosch The Netherlands ATP World Tour,GRASS,2,Marcos Baghdatis,Ivo Minar,Marcos Baghdatis,3-6; 6-3; 7-5,R32,112,8,6,56,99,45,56,21,43,5,6,15,66,99,6,4,65,103,48,65,17,38,8,10,15,65,103
2006-06-19 00:00:00.000,'s-Hertogenbosch The Netherlands ATP World Tour,GRASS,2,Mario Ancic,Aisam-Ul-Haq Qureshi,Mario Ancic,7-6(3); 6-7(0); 7-5,R32,163,18,8,65,109,55,65,23,44,3,4,18,78,109,11,6,83,121,59,83,20,38,3,5,18,79,121
2006-06-19 00:00:00.000,'s-Hertogenbosch The Netherlands ATP World Tour,GRASS,2,Raemon Sluiter,Robin Vik,Raemon Sluiter,1-6; 6-3; 6-2,R32,89,10,8,40,73,34,40,14,33,3,5,12,48,73,4,2,46,77,30,46,17,31,4,7,12,47,77
2006-06-19 00:00:00.000,'s-Hertogenbosch The Netherlands ATP World Tour,GRASS,2,Kristof Vliegen,Lukas Dlouhy,Kristof Vliegen,7-5; 6-4,R32,74,9,1,41,60,32,41,12,19,1,2,11,44,60,5,5,41,65,30,41,11,24,4,7,11,41,65
2006-06-19 00:00:00.000,'s-Hertogenbosch The Netherlands ATP World Tour,GRASS,2,Fabrice Santoro,Robby Ginepri,Fabrice Santoro,6-1; 3-2 RET,R32,54,4,2,29,41,21,29,5,12,1,2,6,26,41,3,3,27,50,16,27,7,23,4,8,6,23,50
2006-06-19 00:00:00.000,'s-Hertogenbosch The Netherlands ATP World Tour,GRASS,2,Novak Djokovic,Alexander Waske,Novak Djokovic,6-7(9); 7-6(4); 7-6(4),R32,182,10,9,68,121,59,68,28,53,2,3,18,87,121,18,12,77,126,61,77,28,49,2,3,18,89,126
2006-06-19 00:00:00.000,'s-Hertogenbosch The Netherlands ATP World Tour,GRASS,2,Jan Hernych,Mikhail Ledovskikh,Jan Hernych,6-0; 6-2,R32,57,8,0,34,55,23,34,13,21,5,5,7,36,55,5,7,19,49,13,19,9,30,4,9,7,22,49
2006-06-19 00:00:00.000,'s-Hertogenbosch The Netherlands ATP World Tour,GRASS,2,Hyung-Taik Lee,Arnaud Clement,Hyung-Taik Lee,6-4; 6-4,R32,83,8,3,39,55,33,39,8,16,0,0,10,41,55,4,0,44,60,32,44,7,16,2,4,10,39,60
2006-06-19 00:00:00.000,'s-Hertogenbosch The Netherlands ATP World Tour,GRASS,2,Mischa Zverev,Davide Sanguinetti,Mischa Zverev,7-6(4); 7-6(5),R32,72,3,1,59,75,50,59,9,16,5,6,12,59,75,2,1,58,77,44,58,11,19,2,3,12,55,77
2006-06-19 00:00:00.000,'s-Hertogenbosch The Netherlands ATP World Tour,GRASS,2,Juan Carlos Ferrero,Robin Haase,Juan Carlos Ferrero,6-4; 3-6; 6-2,R32,107,5,1,57,86,41,57,15,29,5,7,13,56,86,8,6,42,86,28,42,24,44,6,10,14,52,86
2006-06-19 00:00:00.000,'s-Hertogenbosch The Netherlands ATP World Tour,GRASS,2,Jurgen Melzer,Gilles Muller,Jurgen Melzer,6-2; 6-2,R32,59,8,1,25,41,20,25,12,16,0,0,8,32,41,2,5,33,59,19,33,10,26,9,13,8,29,59
2006-06-19 00:00:00.000,'s-Hertogenbosch The Netherlands ATP World Tour,GRASS,2,Florent Serra,Rainer Schuettler,Florent Serra,6-4; 6-4,R32,69,4,1,31,54,27,31,14,23,0,0,10,41,54,6,3,39,59,28,39,11,20,4,6,10,39,59
2006-06-19 00:00:00.000,'s-Hertogenbosch The Netherlands ATP World Tour,GRASS,2,Tommy Robredo,Marin Cilic,Tommy Robredo,6-4; 6-4,R32,91,3,2,39,59,30,39,13,20,3,3,10,43,59,4,4,51,87,32,51,18,36,8,10,10,50,87
2006-06-19 00:00:00.000,'s-Hertogenbosch The Netherlands ATP World Tour,GRASS,2,Philipp Kohlschreiber,Julien Benneteau,Philipp Kohlschreiber,7-6(2); 7-5,R16,108,8,5,42,80,33,42,18,38,6,8,12,51,80,4,3,51,77,34,51,11,26,2,5,12,45,77
2006-06-19 00:00:00.000,'s-Hertogenbosch The Netherlands ATP World Tour,GRASS,2,Marcos Baghdatis,Vincent Spadea,Marcos Baghdatis,6-2; 7-6(5),R16,85,8,2,40,69,30,40,18,29,2,2,10,48,69,2,0,52,67,34,52,9,15,2,4,10,43,67
2006-06-19 00:00:00.000,'s-Hertogenbosch The Netherlands ATP World Tour,GRASS,2,Mario Ancic,Raemon Sluiter,Mario Ancic,6-7(7); 7-5; 6-2,R16,146,17,2,64,97,52,64,19,33,2,2,16,71,97,6,5,64,118,49,64,27,54,8,11,16,76,118
2006-06-19 00:00:00.000,'s-Hertogenbosch The Netherlands ATP World Tour,GRASS,2,Fabrice Santoro,Kristof Vliegen,Fabrice Santoro,2-6; 6-1; 6-4,R16,106,5,1,45,75,32,45,18,30,3,5,13,50,75,6,3,63,98,43,63,15,35,9,12,12,58,98
2006-06-19 00:00:00.000,'s-Hertogenbosch The Netherlands ATP World Tour,GRASS,2,Jan Hernych,Novak Djokovic,Jan Hernych,6-2; 6-4,R16,68,1,2,36,54,26,36,12,18,0,0,9,38,54,5,6,30,55,22,30,10,25,3,6,9,32,55
2006-06-19 00:00:00.000,'s-Hertogenbosch The Netherlands ATP World Tour,GRASS,2,Hyung-Taik Lee,Mischa Zverev,Hyung-Taik Lee,6-1; 6-3,R16,49,2,1,28,45,22,28,12,17,4,4,8,34,45,2,2,25,39,15,25,4,14,2,6,8,19,39
2006-06-19 00:00:00.000,'s-Hertogenbosch The Netherlands ATP World Tour,GRASS,2,Juan Carlos Ferrero,Jurgen Melzer,Juan Carlos Ferrero,4-6; 6-3; 6-4,R16,150,4,4,78,122,46,78,26,44,11,14,14,72,122,5,10,64,115,41,64,23,51,9,14,15,64,115
2006-06-19 00:00:00.000,'s-Hertogenbosch The Netherlands ATP World Tour,GRASS,2,Florent Serra,Tommy Robredo,Florent Serra,6-1; 3-6; 6-4,R16,104,2,4,41,86,28,41,23,45,6,9,13,51,86,1,2,51,83,34,51,15,32,13,18,13,49,83
2006-06-19 00:00:00.000,'s-Hertogenbosch The Netherlands ATP World Tour,GRASS,2,Marcos Baghdatis,Philipp Kohlschreiber,Marcos Baghdatis,6-2; 3-0 RET,Q,44,2,1,17,33,13,17,8,16,0,1,6,21,33,0,1,18,32,7,18,5,14,2,6,5,12,32
2006-06-19 00:00:00.000,'s-Hertogenbosch The Netherlands ATP World Tour,GRASS,2,Mario Ancic,Fabrice Santoro,Mario Ancic,6-4; 6-0,Q,64,10,3,27,45,23,27,11,18,4,4,8,34,45,0,3,30,55,17,30,11,25,6,10,8,28,55
2006-06-19 00:00:00.000,'s-Hertogenbosch The Netherlands ATP World Tour,GRASS,2,Jan Hernych,Hyung-Taik Lee,Jan Hernych,6-4; 6-4,Q,0,1,0,9,14,5,9,1,5,2,3,1,6,14,0,0,6,11,3,6,3,5,0,1,2,6,11
2006-06-19 00:00:00.000,'s-Hertogenbosch The Netherlands ATP World Tour,GRASS,2,Florent Serra,Juan Carlos Ferrero,Florent Serra,6-3; 6-7(4); 6-3,Q,132,6,1,71,105,53,71,17,34,8,10,16,70,105,8,1,55,81,39,55,13,26,2,6,14,52,81
2006-06-19 00:00:00.000,'s-Hertogenbosch The Netherlands ATP World Tour,GRASS,2,Mario Ancic,Marcos Baghdatis,Mario Ancic,7-6(4); 6-3,S,120,12,4,47,78,38,47,14,31,2,3,11,52,78,7,5,53,101,37,53,21,48,8,10,10,58,101
2006-06-19 00:00:00.000,'s-Hertogenbosch The Netherlands ATP World Tour,GRASS,2,Jan Hernych,Florent Serra,Jan Hernych,6-2; 7-6(3),S,74,2,1,43,69,28,43,12,26,2,5,10,40,69,0,3,32,59,16,32,11,27,1,6,10,27,59
2006-06-19 00:00:00.000,'s-Hertogenbosch The Netherlands ATP World Tour,GRASS,2,Mario Ancic,Jan Hernych,Mario Ancic,6-0; 5-7; 7-5,F,126,21,5,59,95,47,59,17,36,6,8,15,64,95,3,1,60,79,37,60,12,19,2,7,15,49,79
2006-06-26 00:00:00.000,Wimbledon England Grand Slams,GRASS,3,Roger Federer,Richard Gasquet,Roger Federer,6-3; 6-2; 6-2,R128,74,5,1,47,70,40,47,15,23,1,1,13,55,70,2,1,54,69,30,54,8,15,2,7,12,38,69
2006-06-26 00:00:00.000,Wimbledon England Grand Slams,GRASS,3,Tim Henman,Robin Soderling,Tim Henman,6-7(8); 6-3; 6-2; 1-6; 6-3,R128,195,4,6,82,144,61,82,36,62,4,7,23,97,144,17,10,98,149,72,98,21,51,10,15,22,93,149
2006-06-26 00:00:00.000,Wimbledon England Grand Slams,GRASS,3,Nicolas Mahut,Jurgen Melzer,Nicolas Mahut,6-7(3); 7-5; 6-1; 6-4,R128,152,19,5,81,112,67,81,22,31,4,4,21,89,112,12,9,81,128,57,81,24,47,3,7,20,81,128
2006-06-26 00:00:00.000,Wimbledon England Grand Slams,GRASS,3,Kristof Vliegen,Jiri Novak,Kristof Vliegen,6-4; 7-5; 6-2,R128,107,9,3,61,92,52,61,16,31,3,3,15,68,92,8,2,70,97,43,70,14,27,4,8,15,57,97
2006-06-26 00:00:00.000,Wimbledon England Grand Slams,GRASS,3,Tommy Haas,Jiri Vanek,Tommy Haas,7-6(2); 7-5; 6-4,R128,120,9,5,58,95,48,58,22,37,2,4,17,70,95,11,3,85,121,61,85,11,36,17,21,17,72,121
2006-06-26 00:00:00.000,Wimbledon England Grand Slams,GRASS,3,Richard Bloomfield,Carlos Berlocq,Richard Bloomfield,6-1; 6-2; 6-2,R128,78,10,4,33,64,28,33,22,31,1,1,12,50,64,0,9,37,73,20,37,15,36,8,14,11,35,73
2006-06-26 00:00:00.000,Wimbledon England Grand Slams,GRASS,3,Fabrice Santoro,Wayne Arthurs,Fabrice Santoro,7-6(3); 6-3; 3-6; 6-1,R128,148,6,2,73,110,56,73,22,37,0,1,19,78,110,17,7,68,128,51,68,30,60,8,11,18,81,128
2006-06-26 00:00:00.000,Wimbledon England Grand Slams,GRASS,3,Tomas Berdych,Jan Hernych,Tomas Berdych,6-3; 6-4; 7-5,R128,105,13,3,51,95,40,51,25,44,4,5,16,65,95,2,2,59,85,41,59,10,26,2,6,15,51,85
2006-06-26 00:00:00.000,Wimbledon England Grand Slams,GRASS,3,Tommy Robredo,Simon Greul,Tommy Robredo,6-2; 6-2; 5-7; 7-6(3),R128,142,4,2,89,117,66,89,14,28,4,7,20,80,117,3,4,86,132,55,86,21,46,3,9,20,76,132
2006-06-26 00:00:00.000,Wimbledon England Grand Slams,GRASS,3,Novak Djokovic,Paul Goldstein,Novak Djokovic,6-3; 6-2; 7-6(3),R128,124,8,4,59,98,46,59,19,39,4,6,15,65,98,1,5,43,87,31,43,21,44,3,8,14,52,87
2006-06-26 00:00:00.000,Wimbledon England Grand Slams,GRASS,3,Mikhail Youzhny,Potito Starace,Mikhail Youzhny,6-0; 6-4; 6-1,R128,75,3,1,40,56,31,40,13,16,0,0,11,44,56,1,2,62,93,35,62,8,31,4,11,12,43,93
2006-06-26 00:00:00.000,Wimbledon England Grand Slams,GRASS,3,Igor Kunitsyn,Gael Monfils,Igor Kunitsyn,5-7; 7-6(7); 6-3; 6-4,R128,177,0,1,131,179,83,131,30,48,17,20,22,113,179,13,1,70,123,53,70,29,53,1,5,21,82,123
2006-06-26 00:00:00.000,Wimbledon England Grand Slams,GRASS,3,Agustin Calleri,Paradorn Srichaphan,Agustin Calleri,6-7(3); 7-5; 6-3; 3-6; 6-3,R128,186,12,6,93,150,79,93,29,57,0,2,26,108,150,7,7,82,159,63,82,41,77,9,13,25,104,159
2006-06-26 00:00:00.000,Wimbledon England Grand Slams,GRASS,3,Stanislas Wawrinka,Ivo Karlovic,Stanislas Wawrinka,7-6(5); 3-6; 6-2; 6-7(8); 11-9,R128,232,16,9,90,169,76,90,56,79,3,4,30,132,169,35,16,134,193,107,134,29,59,6,9,31,136,193
2006-06-26 00:00:00.000,Wimbledon England Grand Slams,GRASS,3,Davide Sanguinetti,Kevin Kim,Davide Sanguinetti,6-3; 7-6(10); 6-1,R128,91,11,1,63,99,52,63,19,36,6,7,15,71,99,3,3,56,90,39,56,14,34,3,7,13,53,90
2006-06-26 00:00:00.000,Wimbledon England Grand Slams,GRASS,3,Mario Ancic,Nicolas Almagro,Mario Ancic,7-6(2); 7-5; 7-6(4),R128,157,21,3,75,114,58,75,27,39,2,3,18,85,114,11,6,70,124,55,70,27,54,8,10,18,82,124
2006-06-26 00:00:00.000,Wimbledon England Grand Slams,GRASS,3,David Nalbandian,Wesley Moodie,David Nalbandian,6-3; 6-4; 6-1,R128,97,1,5,47,75,40,47,16,28,2,2,13,56,75,10,2,65,90,40,65,10,25,9,14,13,50,90
2006-06-26 00:00:00.000,Wimbledon England Grand Slams,GRASS,3,Arnaud Clement,Albert Portas,Arnaud Clement,6-3; 6-2; 6-4,R128,91,6,1,51,69,44,51,11,18,3,4,14,55,69,6,1,41,83,31,41,14,42,3,8,13,45,83
2006-06-26 00:00:00.000,Wimbledon England Grand Slams,GRASS,3,Benjamin Becker,Juan Ignacio Chela,Benjamin Becker,6-3; 3-6; 6-3; 6-4,R128,137,21,6,88,136,69,88,20,48,9,10,19,89,136,8,0,67,100,48,67,18,33,2,5,18,66,100
2006-06-26 00:00:00.000,Wimbledon England Grand Slams,GRASS,3,Fernando Verdasco,Vincent Spadea,Fernando Verdasco,3-6; 6-4; 7-6(1); 6-3,R128,152,8,2,88,122,63,88,24,34,8,9,19,87,122,7,5,91,138,67,91,22,47,12,15,21,89,138
2006-06-26 00:00:00.000,Wimbledon England Grand Slams,GRASS,3,Juan Carlos Ferrero,Fernando Vicente,Juan Carlos Ferrero,6-1; 6-3; 6-2,R128,84,8,0,42,58,37,42,12,16,1,1,12,49,58,1,1,62,90,34,62,11,28,8,14,12,45,90
2006-06-26 00:00:00.000,Wimbledon England Grand Slams,GRASS,3,Roko Karanusic,Rainer Schuettler,Roko Karanusic,7-6(7); 4-6; 6-2; 6-1,R128,131,10,1,75,107,62,75,20,32,3,4,19,82,107,3,2,78,112,54,78,14,34,1,5,18,68,112
2006-06-26 00:00:00.000,Wimbledon England Grand Slams,GRASS,3,Xavier Malisse,Benedikt Dorsch,Xavier Malisse,6-2; 7-5; 6-2,R128,102,10,0,61,88,44,61,18,27,5,6,14,62,88,6,0,46,75,26,46,13,29,1,7,14,39,75
2006-06-26 00:00:00.000,Wimbledon England Grand Slams,GRASS,3,Radek Stepanek,Frank Dancevic,Radek Stepanek,7-6(4); 6-3; 6-4,R128,113,10,5,77,106,63,77,13,29,6,6,16,76,106,8,1,63,91,46,63,14,28,3,5,15,60,91
2006-06-26 00:00:00.000,Wimbledon England Grand Slams,GRASS,3,Jonas Bjorkman,Thomas Johansson,Jonas Bjorkman,3-6; 7-6(4); 6-1; 6-1,R128,147,6,0,72,103,54,72,21,31,2,3,17,75,103,8,6,79,126,55,79,19,47,7,12,18,74,126
2006-06-26 00:00:00.000,Wimbledon England Grand Slams,GRASS,3,Lukas Dlouhy,Florent Serra,Lukas Dlouhy,4-6; 6-3; 6-4; 7-5,R128,147,9,7,89,130,66,89,21,41,7,9,21,87,130,7,3,92,150,59,92,32,58,12,16,20,91,150
2006-06-26 00:00:00.000,Wimbledon England Grand Slams,GRASS,3,Stefano Galvani,Alexander Waske,Stefano Galvani,4-6; 7-6(2); 6-4; 3-6; 16-14,R128,296,10,11,135,213,110,135,42,78,11,14,35,152,213,44,13,129,204,103,129,42,75,8,11,36,145,204
2006-06-26 00:00:00.000,Wimbledon England Grand Slams,GRASS,3,Daniele Bracciali,Dominik Hrbaty,Daniele Bracciali,6-2; 6-4; 6-4,R128,94,21,0,40,76,35,40,24,36,1,1,14,59,76,7,6,48,81,37,48,11,33,0,4,14,48,81
2006-06-26 00:00:00.000,Wimbledon England Grand Slams,GRASS,3,Mark Philippoussis,Paul-Henri Mathieu,Mark Philippoussis,5-7; 7-6(5); 6-3; 7-6(12),R128,195,40,6,78,128,69,78,35,50,0,1,23,104,128,7,1,89,150,67,89,36,61,2,3,22,103,150
2006-06-26 00:00:00.000,Wimbledon England Grand Slams,GRASS,3,Max Mirnyi,Ruben Ramirez Hidalgo,Max Mirnyi,6-7(5); 6-4; 6-3; 6-3,R128,153,21,2,73,112,62,73,29,39,5,5,20,91,112,14,3,86,129,58,86,26,43,10,14,20,84,129
2006-06-26 00:00:00.000,Wimbledon England Grand Slams,GRASS,3,Jimmy Wang,Oliver Marach,Jimmy Wang,6-1; 7-6(2); 6-0,R128,115,9,1,50,86,38,50,23,36,5,6,13,61,86,8,4,57,99,34,57,17,42,8,14,12,51,99
2006-06-26 00:00:00.000,Wimbledon England Grand Slams,GRASS,3,James Blake,Kristian Pless,James Blake,6-3; 7-5; 5-7; 6-4,R128,121,11,9,70,122,55,70,30,52,1,3,22,85,122,4,2,85,118,59,85,18,33,3,7,21,77,118
2006-06-26 00:00:00.000,Wimbledon England Grand Slams,GRASS,3,Lleyton Hewitt,Filippo Volandri,Lleyton Hewitt,6-1; 6-1; 6-3,R128,69,12,1,39,67,30,39,21,28,0,0,12,51,67,0,5,35,66,19,35,12,31,5,11,11,31,66
2006-06-26 00:00:00.000,Wimbledon England Grand Slams,GRASS,3,Hyung-Taik Lee,Flavio Saretta,Hyung-Taik Lee,7-6(10); 6-3; 7-5,R128,130,5,1,76,109,55,76,21,33,7,9,16,76,109,12,10,76,130,50,76,28,54,11,16,17,78,130
2006-06-26 00:00:00.000,Wimbledon England Grand Slams,GRASS,3,Tomas Zib,Albert Montanes,Tomas Zib,6-3; 6-4; 7-6(7),R128,122,7,1,67,106,52,67,17,39,4,7,16,69,106,8,5,72,111,46,72,18,39,6,11,15,64,111
2006-06-26 00:00:00.000,Wimbledon England Grand Slams,GRASS,3,Olivier Rochus,Gilles Muller,Olivier Rochus,6-4; 7-5; 6-3,R128,129,2,3,57,92,43,57,25,35,4,4,15,68,92,21,6,73,120,46,73,23,47,12,16,16,69,120
2006-06-26 00:00:00.000,Wimbledon England Grand Slams,GRASS,3,David Ferrer,Simon Stadler,David Ferrer,6-1; 6-4; 6-4,R128,120,1,3,71,100,52,71,13,29,8,9,14,65,100,2,0,59,87,40,59,10,28,9,14,13,50,87
2006-06-26 00:00:00.000,Wimbledon England Grand Slams,GRASS,3,Guillermo Garcia-Lopez,Ivo Minar,Guillermo Garcia-Lopez,7-6(1); 4-6; 7-6(3); 6-2,R128,189,10,4,95,152,66,95,28,57,16,21,21,94,152,5,4,89,143,59,89,26,54,10,16,21,85,143
2006-06-26 00:00:00.000,Wimbledon England Grand Slams,GRASS,3,Marat Safin,Greg Rusedski,Marat Safin,6-4; 6-4; 6-4,R128,93,13,1,48,79,39,48,23,31,1,1,15,62,79,7,5,60,96,45,60,16,36,3,6,15,61,96
2006-06-26 00:00:00.000,Wimbledon England Grand Slams,GRASS,3,Fernando Gonzalez,Luis Horna,Fernando Gonzalez,7-6(3); 7-5; 6-2,R128,110,16,4,52,88,45,52,25,36,1,1,16,70,88,12,2,61,102,46,61,19,41,5,8,16,65,102
2006-06-26 00:00:00.000,Wimbledon England Grand Slams,GRASS,3,Sebastien Grosjean,Gilles Simon,Sebastien Grosjean,6-4; 6-2; 6-4,R128,109,5,3,49,85,39,49,22,36,6,7,14,61,85,4,1,53,92,37,53,16,39,5,10,14,53,92
2006-06-26 00:00:00.000,Wimbledon England Grand Slams,GRASS,3,Jamie Delgado,Michael Berrer,Jamie Delgado,6-4; 6-2; 3-6; 3-6; 6-3,R128,143,12,4,82,129,65,82,21,47,4,7,22,86,129,31,11,81,130,64,81,23,49,9,14,23,87,130
2006-06-26 00:00:00.000,Wimbledon England Grand Slams,GRASS,3,Andrei Pavel,Marcel Granollers,Andrei Pavel,7-6(4); 6-4; 6-4,R128,133,9,4,76,129,55,76,26,53,13,15,16,81,129,9,4,64,108,42,64,21,44,7,11,16,63,108
2006-06-26 00:00:00.000,Wimbledon England Grand Slams,GRASS,3,Marcos Baghdatis,Alan Mackin,Marcos Baghdatis,6-4; 6-7(4); 6-7(4); 7-5; 6-2,R128,261,22,4,109,189,89,109,33,80,7,11,27,122,189,7,10,128,192,80,128,34,64,9,17,27,114,192
2006-06-26 00:00:00.000,Wimbledon England Grand Slams,GRASS,3,Andy Murray,Nicolas Massu,Andy Murray,6-1; 6-4; 6-4,R128,113,5,3,44,85,32,44,26,41,3,4,14,58,85,6,4,62,99,37,62,16,37,8,13,13,53,99
2006-06-26 00:00:00.000,Wimbledon England Grand Slams,GRASS,3,Julien Benneteau,Bjorn Phau,Julien Benneteau,5-7; 6-4; 6-2; 7-6(6),R128,169,6,4,108,137,80,108,11,29,6,9,21,91,137,8,1,81,128,53,81,26,47,6,11,21,79,128
2006-06-26 00:00:00.000,Wimbledon England Grand Slams,GRASS,3,Florian Mayer,Robin Vik,Florian Mayer,6-3; 6-3; 6-3,R128,80,4,0,53,73,39,53,13,20,2,3,13,52,73,6,3,59,89,36,59,11,30,6,12,14,47,89
2006-06-26 00:00:00.000,Wimbledon England Grand Slams,GRASS,3,Andy Roddick,Janko Tipsarevic,Andy Roddick,6-7(5); 6-4; 7-6(6); 6-2,R128,173,28,2,98,151,75,98,30,53,9,9,21,105,151,12,3,58,118,39,58,44,60,1,4,21,83,118
2006-06-26 00:00:00.000,Wimbledon England Grand Slams,GRASS,3,Ivan Ljubicic,Feliciano Lopez,Ivan Ljubicic,6-3; 6-4; 5-7; 3-6; 11-9,R128,243,32,10,115,184,89,115,37,69,4,7,30,126,184,26,9,113,180,94,113,30,67,13,17,30,124,180
2006-06-26 00:00:00.000,Wimbledon England Grand Slams,GRASS,3,Justin Gimelstob,Christophe Rochus,Justin Gimelstob,6-3; 6-4; 6-4,R128,117,18,2,57,107,48,57,25,50,6,6,15,73,107,0,2,60,79,43,60,9,19,3,6,14,52,79
2006-06-26 00:00:00.000,Wimbledon England Grand Slams,GRASS,3,Alberto Martin,Alessio Di Mauro,Alberto Martin,6-3; 6-4; 6-1,R128,94,10,2,49,77,41,49,15,28,0,0,13,56,77,4,3,55,93,29,55,20,38,8,13,13,49,93
2006-06-26 00:00:00.000,Wimbledon England Grand Slams,GRASS,3,Dmitry Tursunov,Danai Udomchoke,Dmitry Tursunov,6-1; 6-4; 6-2,R128,81,9,5,41,68,37,41,17,27,0,0,13,54,68,6,6,72,94,44,72,5,22,11,16,12,49,94
2006-06-26 00:00:00.000,Wimbledon England Grand Slams,GRASS,3,Jarkko Nieminen,Marcos Daniel,Jarkko Nieminen,6-2; 6-4; 7-5,R128,111,6,2,50,90,40,50,21,40,4,6,15,61,90,6,5,66,96,41,66,9,30,5,11,15,50,96
2006-06-26 00:00:00.000,Wimbledon England Grand Slams,GRASS,3,Martin Lee,Dick Norman,Martin Lee,6-2; 7-6(2); 7-6(4),R128,123,14,3,68,111,49,68,25,43,2,4,16,74,111,10,2,66,105,47,66,15,39,9,13,16,62,105
2006-06-26 00:00:00.000,Wimbledon England Grand Slams,GRASS,3,Philipp Kohlschreiber,Razvan Sabau,Philipp Kohlschreiber,6-3; 6-2; 6-4,R128,89,17,5,39,74,38,39,16,35,1,2,14,54,74,4,3,54,81,32,54,12,27,5,10,13,44,81
2006-06-26 00:00:00.000,Wimbledon England Grand Slams,GRASS,3,Alejandro Falla,Nikolay Davydenko,Alejandro Falla,2-6; 7-6(4); 7-6(8); 6-3,R128,170,4,0,105,154,64,105,25,49,5,12,21,89,154,8,5,87,131,55,87,26,44,5,11,20,81,131
2006-06-26 00:00:00.000,Wimbledon England Grand Slams,GRASS,3,Gaston Gaudio,Jean-Christophe Faurel,Gaston Gaudio,7-5; 3-6; 6-2; 6-4,R128,161,9,5,95,142,62,95,23,47,18,23,20,85,142,6,9,80,121,47,80,19,41,5,12,19,66,121
2006-06-26 00:00:00.000,Wimbledon England Grand Slams,GRASS,3,Irakli Labadze,Alexander Peya,Irakli Labadze,6-4; 4-6; 5-7; 6-3; 6-1,R128,173,5,6,82,143,60,82,35,61,7,10,24,95,143,8,7,80,138,55,80,30,58,6,12,24,85,138
2006-06-26 00:00:00.000,Wimbledon England Grand Slams,GRASS,3,Melle Van Gemerden,Josh Goodall,Melle Van Gemerden,6-4; 7-5; 7-5,R128,136,13,7,55,104,40,55,33,49,5,6,17,73,104,13,7,79,130,59,79,20,51,8,12,17,79,130
2006-06-26 00:00:00.000,Wimbledon England Grand Slams,GRASS,3,Mardy Fish,Robby Ginepri,Mardy Fish,6-3; 6-2; 6-4,R128,83,12,2,43,79,34,43,21,36,2,3,14,55,79,7,2,46,72,35,46,9,26,6,11,13,44,72
2006-06-26 00:00:00.000,Wimbledon England Grand Slams,GRASS,3,Andre Agassi,Boris Pashanski,Andre Agassi,2-6; 6-2; 6-4; 6-3,R128,132,17,4,62,100,43,62,25,38,3,5,17,68,100,8,11,69,142,50,69,29,73,8,13,18,79,142
2006-06-26 00:00:00.000,Wimbledon England Grand Slams,GRASS,3,Andreas Seppi,Jamie Baker,Andreas Seppi,6-3; 6-7(3); 6-4; 6-3,R128,177,8,3,81,130,53,81,21,49,6,11,19,74,130,5,4,94,146,57,94,18,52,7,17,21,75,146
2006-06-26 00:00:00.000,Wimbledon England Grand Slams,GRASS,3,Robert Kendrick,Yen-Hsun Lu,Robert Kendrick,7-6(5); 6-3; 6-0,R128,109,13,4,66,93,52,66,13,27,8,9,14,65,93,4,4,62,85,37,62,12,23,4,9,13,49,85
2006-06-26 00:00:00.000,Wimbledon England Grand Slams,GRASS,3,Rafael Nadal,Alex Bogdanovic,Rafael Nadal,6-4; 7-6(3); 6-4,R128,152,3,3,79,108,60,79,14,29,4,5,16,74,108,1,0,82,111,58,82,12,29,6,9,16,70,111
2006-06-26 00:00:00.000,Wimbledon England Grand Slams,GRASS,3,Roger Federer,Tim Henman,Roger Federer,6-4; 6-0; 6-2,R64,85,6,0,44,71,35,44,17,27,2,2,12,52,71,0,3,38,61,21,38,8,23,2,8,12,29,61
2006-06-26 00:00:00.000,Wimbledon England Grand Slams,GRASS,3,Nicolas Mahut,Kristof Vliegen,Nicolas Mahut,6-4; 6-4; 6-3,R64,106,13,4,57,85,48,57,12,28,2,2,14,60,85,9,3,54,76,40,54,9,22,2,6,15,49,76
2006-06-26 00:00:00.000,Wimbledon England Grand Slams,GRASS,3,Tommy Haas,Richard Bloomfield,Tommy Haas,6-3; 6-4; 7-6(4),R64,114,15,6,61,94,51,61,21,33,2,2,16,72,94,15,8,69,118,50,69,22,49,12,14,15,72,118
2006-06-26 00:00:00.000,Wimbledon England Grand Slams,GRASS,3,Tomas Berdych,Fabrice Santoro,Tomas Berdych,6-4; 6-7(6); 2-6; 7-6(5); 6-4,R64,251,15,6,109,189,78,109,37,80,9,15,26,115,189,10,9,115,190,84,115,31,75,10,16,26,115,190
2006-06-26 00:00:00.000,Wimbledon England Grand Slams,GRASS,3,Novak Djokovic,Tommy Robredo,Novak Djokovic,7-6(5); 6-2; 6-4,R64,133,2,3,63,94,46,63,15,31,2,5,15,61,94,1,3,74,107,45,74,12,33,9,15,15,57,107
2006-06-26 00:00:00.000,Wimbledon England Grand Slams,GRASS,3,Mikhail Youzhny,Igor Kunitsyn,Mikhail Youzhny,6-3; 6-1; 3-0 RET,R64,80,10,2,32,53,25,32,12,21,6,7,9,37,53,1,1,57,90,30,57,12,33,14,21,10,42,90
2006-06-26 00:00:00.000,Wimbledon England Grand Slams,GRASS,3,Stanislas Wawrinka,Agustin Calleri,Stanislas Wawrinka,7-6(5); 7-5; 6-3,R64,141,5,8,72,123,52,72,26,51,9,12,16,78,123,5,2,90,131,54,90,20,41,9,15,17,74,131
2006-06-26 00:00:00.000,Wimbledon England Grand Slams,GRASS,3,Mario Ancic,Davide Sanguinetti,Mario Ancic,6-4; 6-2; 6-1,R64,101,12,0,41,67,33,41,18,26,1,2,13,51,67,1,2,49,80,28,49,11,31,6,12,12,39,80
2006-06-26 00:00:00.000,Wimbledon England Grand Slams,GRASS,3,David Nalbandian,Arnaud Clement,David Nalbandian,6-4; 6-4; 6-3,R64,115,4,2,51,86,41,51,17,35,5,6,14,58,86,10,3,57,93,43,57,11,36,3,8,15,54,93
2006-06-26 00:00:00.000,Wimbledon England Grand Slams,GRASS,3,Fernando Verdasco,Benjamin Becker,Fernando Verdasco,6-4; 6-7(7); 4-6; 6-3; 9-7,R64,202,16,3,113,163,89,113,34,50,2,4,29,123,163,22,7,92,154,76,92,36,62,3,7,28,112,154
2006-06-26 00:00:00.000,Wimbledon England Grand Slams,GRASS,3,Juan Carlos Ferrero,Roko Karanusic,Juan Carlos Ferrero,6-3; 7-6(4); 6-3,R64,110,3,1,66,104,47,66,27,38,4,4,16,74,104,9,0,60,83,47,60,11,23,5,7,14,58,83
2006-06-26 00:00:00.000,Wimbledon England Grand Slams,GRASS,3,Radek Stepanek,Xavier Malisse,Radek Stepanek,6-3; 6-7(4); 7-5; 6-1,R64,145,5,2,84,124,59,84,23,40,4,6,21,82,124,6,2,79,111,47,79,19,32,6,12,19,66,111
2006-06-26 00:00:00.000,Wimbledon England Grand Slams,GRASS,3,Jonas Bjorkman,Lukas Dlouhy,Jonas Bjorkman,6-3; 6-4; 4-6; 1-6; 6-4,R64,183,5,7,90,141,60,90,22,51,5,13,23,82,141,9,7,100,145,62,100,19,45,11,19,23,81,145
2006-06-26 00:00:00.000,Wimbledon England Grand Slams,GRASS,3,Daniele Bracciali,Stefano Galvani,Daniele Bracciali,6-3; 6-7(3); 6-3; 6-4,R64,159,29,1,75,130,58,75,31,55,5,7,21,89,130,6,5,68,115,50,68,21,47,3,8,19,71,115
2006-06-26 00:00:00.000,Wimbledon England Grand Slams,GRASS,3,Max Mirnyi,Mark Philippoussis,Max Mirnyi,7-6(6); 6-4; 6-7(5); 6-3,R64,196,21,3,102,157,80,102,28,55,9,10,22,108,157,26,6,86,132,69,86,21,46,5,8,21,90,132
2006-06-26 00:00:00.000,Wimbledon England Grand Slams,GRASS,3,James Blake,Jimmy Wang,James Blake,6-4; 6-2; 4-6; 6-2,R64,134,11,4,84,131,63,84,23,47,20,21,18,86,131,4,4,77,127,51,77,22,50,13,18,18,73,127
2006-06-26 00:00:00.000,Wimbledon England Grand Slams,GRASS,3,Lleyton Hewitt,Hyung-Taik Lee,Lleyton Hewitt,6-7(4); 6-2; 7-6(6); 6-7(5); 6-4,R64,237,19,6,103,185,78,103,41,82,8,11,27,119,185,13,4,128,193,86,128,34,65,14,20,27,120,193
2006-06-26 00:00:00.000,Wimbledon England Grand Slams,GRASS,3,Olivier Rochus,Tomas Zib,Olivier Rochus,6-1; 6-1; 6-0,R64,89,7,1,42,62,33,42,13,20,3,3,10,46,62,5,3,51,89,25,51,13,38,7,15,10,38,89
2006-06-26 00:00:00.000,Wimbledon England Grand Slams,GRASS,3,David Ferrer,Guillermo Garcia-Lopez,David Ferrer,7-6(2); 7-5; 6-3,R64,150,3,7,52,90,42,52,23,38,1,3,17,65,90,6,4,81,126,56,81,15,45,13,17,16,71,126
2006-06-26 00:00:00.000,Wimbledon England Grand Slams,GRASS,3,Fernando Gonzalez,Marat Safin,Fernando Gonzalez,4-6; 6-7(4); 6-4; 6-4; 6-4,R64,202,18,0,105,155,81,105,28,50,4,6,26,109,155,18,4,126,180,92,126,28,54,9,13,26,120,180
2006-06-26 00:00:00.000,Wimbledon England Grand Slams,GRASS,3,Sebastien Grosjean,Jamie Delgado,Sebastien Grosjean,6-3; 3-6; 6-2; 6-3,R64,133,9,7,59,102,45,59,22,43,3,6,18,67,102,10,7,70,118,45,70,19,48,7,13,17,64,118
2006-06-26 00:00:00.000,Wimbledon England Grand Slams,GRASS,3,Marcos Baghdatis,Andrei Pavel,Marcos Baghdatis,3-0 RET,R64,19,1,0,4,11,4,4,4,7,0,0,2,8,11,1,1,2,8,1,2,0,6,1,2,1,1,8
2006-06-26 00:00:00.000,Wimbledon England Grand Slams,GRASS,3,Andy Murray,Julien Benneteau,Andy Murray,7-6(5); 6-4; 4-6; 6-1,R64,173,8,1,61,121,42,61,34,60,6,10,19,76,121,8,10,89,140,57,89,21,51,7,14,20,78,140
2006-06-26 00:00:00.000,Wimbledon England Grand Slams,GRASS,3,Andy Roddick,Florian Mayer,Andy Roddick,6-4; 6-1; 6-2,R64,69,12,0,45,64,39,45,13,19,0,0,13,52,64,6,0,49,68,30,49,8,19,2,7,12,38,68
2006-06-26 00:00:00.000,Wimbledon England Grand Slams,GRASS,3,Ivan Ljubicic,Justin Gimelstob,Ivan Ljubicic,6-3; 7-6(1); 7-5,R64,157,16,3,73,103,56,73,18,30,2,2,16,74,103,17,6,70,131,52,70,29,61,16,19,17,81,131
2006-06-26 00:00:00.000,Wimbledon England Grand Slams,GRASS,3,Dmitry Tursunov,Alberto Martin,Dmitry Tursunov,6-1; 7-5; 6-4,R64,104,11,5,55,85,47,55,18,30,5,5,15,65,85,3,3,57,92,35,57,19,35,11,15,14,54,92
2006-06-26 00:00:00.000,Wimbledon England Grand Slams,GRASS,3,Jarkko Nieminen,Martin Lee,Jarkko Nieminen,6-4; 6-0; 6-3,R64,85,2,5,48,75,38,48,16,27,1,1,12,54,75,6,3,46,86,26,46,17,40,3,9,13,43,86
2006-06-26 00:00:00.000,Wimbledon England Grand Slams,GRASS,3,Philipp Kohlschreiber,Alejandro Falla,Philipp Kohlschreiber,6-4; 6-4; 3-6; 7-6(1),R64,152,11,5,76,125,63,76,29,49,5,6,20,92,125,4,1,86,128,66,86,21,42,4,6,21,87,128
2006-06-26 00:00:00.000,Wimbledon England Grand Slams,GRASS,3,Irakli Labadze,Gaston Gaudio,Irakli Labadze,6-4; 6-2; 6-3,R64,87,14,5,47,72,39,47,15,25,4,5,13,54,72,6,4,51,82,30,51,13,31,4,10,14,43,82
2006-06-26 00:00:00.000,Wimbledon England Grand Slams,GRASS,3,Mardy Fish,Melle Van Gemerden,Mardy Fish,6-2; 6-0; 6-1,R64,82,12,3,35,62,31,35,17,27,0,0,11,48,62,2,10,34,64,19,34,9,30,5,12,10,28,64
2006-06-26 00:00:00.000,Wimbledon England Grand Slams,GRASS,3,Andre Agassi,Andreas Seppi,Andre Agassi,6-4; 7-6(2); 6-4,R64,143,9,4,72,121,54,72,24,49,7,8,16,78,121,10,3,57,107,38,57,26,50,7,10,16,64,107
2006-06-26 00:00:00.000,Wimbledon England Grand Slams,GRASS,3,Rafael Nadal,Robert Kendrick,Rafael Nadal,6-7(4); 3-6; 7-6(2); 7-5; 6-4,R64,226,7,3,115,152,93,115,24,37,1,2,27,117,152,32,8,111,171,90,111,30,60,7,9,28,120,171
2006-06-26 00:00:00.000,Wimbledon England Grand Slams,GRASS,3,Roger Federer,Nicolas Mahut,Roger Federer,6-3; 7-6(2); 6-4,R32,125,7,1,60,93,43,60,26,33,1,2,16,69,93,10,5,58,96,40,58,19,38,5,8,15,59,96
2006-06-26 00:00:00.000,Wimbledon England Grand Slams,GRASS,3,Tomas Berdych,Tommy Haas,Tomas Berdych,2-6; 7-5; 7-6(7); 4-6; 8-6,R32,215,17,5,113,172,79,113,34,59,2,7,28,113,172,24,8,93,166,74,93,41,73,2,6,28,115,166
2006-06-26 00:00:00.000,Wimbledon England Grand Slams,GRASS,3,Novak Djokovic,Mikhail Youzhny,Novak Djokovic,4-6; 6-2; 6-3; 6-3,R32,156,7,3,71,111,56,71,22,40,4,5,18,78,111,6,2,63,98,41,63,20,35,1,6,18,61,98
2006-06-26 00:00:00.000,Wimbledon England Grand Slams,GRASS,3,Mario Ancic,Stanislas Wawrinka,Mario Ancic,7-6(5); 6-7(5); 6-1; 6-3,R32,199,14,6,87,138,73,87,24,51,5,5,20,97,138,2,7,81,145,58,81,32,64,11,15,20,90,145
2006-06-26 00:00:00.000,Wimbledon England Grand Slams,GRASS,3,Fernando Verdasco,David Nalbandian,Fernando Verdasco,7-6(9); 7-6(9); 6-2,R32,167,3,3,95,131,68,95,23,36,18,19,16,91,131,8,4,79,135,54,79,32,56,8,11,16,86,135
2006-06-26 00:00:00.000,Wimbledon England Grand Slams,GRASS,3,Radek Stepanek,Juan Carlos Ferrero,Radek Stepanek,5-7; 6-7(3); 6-4; 6-2; 11-9,R32,243,34,7,108,182,85,108,47,74,8,10,31,132,182,17,0,113,165,85,113,33,52,4,9,31,118,165
2006-06-26 00:00:00.000,Wimbledon England Grand Slams,GRASS,3,Jonas Bjorkman,Daniele Bracciali,Jonas Bjorkman,7-5; 6-2; 6-1,R32,112,4,1,69,89,53,69,11,20,3,4,14,64,89,5,6,59,94,35,59,14,35,9,15,13,49,94
2006-06-26 00:00:00.000,Wimbledon England Grand Slams,GRASS,3,Max Mirnyi,James Blake,Max Mirnyi,6-4; 3-6; 4-6; 6-1; 6-0,R32,166,16,2,89,135,64,89,22,46,9,13,21,86,135,6,6,78,128,54,78,18,50,7,15,21,72,128
2006-06-26 00:00:00.000,Wimbledon England Grand Slams,GRASS,3,Lleyton Hewitt,Olivier Rochus,Lleyton Hewitt,6-1; 6-4; 6-4,R32,119,15,5,36,77,31,36,25,41,1,2,14,56,77,4,4,63,100,40,63,16,37,8,13,13,56,100
2006-06-26 00:00:00.000,Wimbledon England Grand Slams,GRASS,3,David Ferrer,Fernando Gonzalez,David Ferrer,4-6; 2-6; 6-2; 6-3; 6-4,R32,175,11,6,91,128,65,91,23,37,2,7,23,88,128,5,12,78,131,57,78,21,53,7,13,22,78,131
2006-06-26 00:00:00.000,Wimbledon England Grand Slams,GRASS,3,Marcos Baghdatis,Sebastien Grosjean,Marcos Baghdatis,4-6; 6-4; 6-4; 6-1,R32,156,8,3,67,120,51,67,24,53,4,9,19,75,120,13,7,72,111,47,72,13,39,7,15,18,60,111
2006-06-26 00:00:00.000,Wimbledon England Grand Slams,GRASS,3,Andy Murray,Andy Roddick,Andy Murray,7-6(4); 6-4; 6-4,R32,151,6,1,61,115,45,61,34,54,11,12,16,79,115,21,3,78,113,57,78,14,35,9,12,16,71,113
2006-06-26 00:00:00.000,Wimbledon England Grand Slams,GRASS,3,Dmitry Tursunov,Ivan Ljubicic,Dmitry Tursunov,5-7; 4-6; 6-1; 7-6(6); 6-2,R32,225,19,6,78,149,66,78,38,71,4,7,24,104,149,24,10,96,161,71,96,30,65,6,12,25,101,161
2006-06-26 00:00:00.000,Wimbledon England Grand Slams,GRASS,3,Jarkko Nieminen,Philipp Kohlschreiber,Jarkko Nieminen,1-6; 6-2; 6-3; 7-6(4),R32,133,6,2,68,106,49,68,20,38,1,5,18,69,106,6,2,63,112,42,63,27,49,6,11,18,69,112
2006-06-26 00:00:00.000,Wimbledon England Grand Slams,GRASS,3,Irakli Labadze,Mardy Fish,Irakli Labadze,6-2 RET,R32,26,6,1,12,23,10,12,7,11,0,0,4,17,23,3,3,11,25,9,11,4,14,1,3,4,13,25
2006-06-26 00:00:00.000,Wimbledon England Grand Slams,GRASS,3,Rafael Nadal,Andre Agassi,Rafael Nadal,7-6(5); 6-2; 6-4,R32,134,18,2,56,79,49,56,15,23,0,0,15,64,79,7,2,63,108,45,63,22,45,8,11,15,67,108
2006-06-26 00:00:00.000,Wimbledon England Grand Slams,GRASS,3,Roger Federer,Tomas Berdych,Roger Federer,6-3; 6-3; 6-4,R16,83,21,1,49,72,41,49,17,23,1,1,14,58,72,1,3,57,84,36,57,13,27,3,7,14,49,84
2006-06-26 00:00:00.000,Wimbledon England Grand Slams,GRASS,3,Mario Ancic,Novak Djokovic,Mario Ancic,6-4; 4-6; 4-6; 7-5; 6-3,R16,204,31,6,81,138,69,81,32,57,1,3,26,101,138,11,5,86,132,70,86,25,46,5,8,25,95,132
2006-06-26 00:00:00.000,Wimbledon England Grand Slams,GRASS,3,Radek Stepanek,Fernando Verdasco,Radek Stepanek,6-7(4); 6-3; 4-6; 6-4; 6-2,R16,215,21,9,93,150,70,93,34,57,10,13,25,104,150,7,8,126,164,85,126,16,38,9,15,24,101,164
2006-06-26 00:00:00.000,Wimbledon England Grand Slams,GRASS,3,Jonas Bjorkman,Max Mirnyi,Jonas Bjorkman,6-3; 7-6(6); 4-6; 2-6; 6-3,R16,222,8,7,105,166,78,105,31,61,6,10,25,109,166,17,5,99,153,73,99,28,54,8,11,23,101,153
2006-06-26 00:00:00.000,Wimbledon England Grand Slams,GRASS,3,Lleyton Hewitt,David Ferrer,Lleyton Hewitt,6-4; 6-4; 4-6; 7-5,R16,170,11,5,71,123,57,71,25,52,8,12,21,82,123,5,4,81,127,56,81,21,46,6,12,21,77,127
2006-06-26 00:00:00.000,Wimbledon England Grand Slams,GRASS,3,Marcos Baghdatis,Andy Murray,Marcos Baghdatis,6-3; 6-4; 7-6(2),R16,113,7,1,60,92,47,60,21,32,3,4,16,68,92,8,7,48,91,36,48,20,43,2,5,15,56,91
2006-06-26 00:00:00.000,Wimbledon England Grand Slams,GRASS,3,Jarkko Nieminen,Dmitry Tursunov,Jarkko Nieminen,7-5; 6-4; 6-7(2); 6-7(6); 9-7,R16,241,9,5,122,198,91,122,46,76,8,10,31,137,198,21,3,109,186,85,109,42,77,5,10,31,127,186
2006-06-26 00:00:00.000,Wimbledon England Grand Slams,GRASS,3,Rafael Nadal,Irakli Labadze,Rafael Nadal,6-3; 7-6(4); 6-3,R16,132,7,0,54,85,43,54,26,31,0,0,16,69,85,8,7,60,102,42,60,23,42,4,6,14,65,102
2006-06-26 00:00:00.000,Wimbledon England Grand Slams,GRASS,3,Roger Federer,Mario Ancic,Roger Federer,6-4; 6-4; 6-4,Q,107,7,1,50,87,39,50,24,37,2,3,15,63,87,7,1,46,80,33,46,18,34,3,7,15,51,80
2006-06-26 00:00:00.000,Wimbledon England Grand Slams,GRASS,3,Jonas Bjorkman,Radek Stepanek,Jonas Bjorkman,7-6(3); 4-6; 6-7(5); 7-6(7); 6-4,Q,243,9,6,103,176,77,103,40,73,9,15,28,117,176,20,12,112,179,86,112,30,67,4,10,28,116,179
2006-06-26 00:00:00.000,Wimbledon England Grand Slams,GRASS,3,Marcos Baghdatis,Lleyton Hewitt,Marcos Baghdatis,6-1; 5-7; 7-6(5); 6-2,Q,152,20,1,75,129,55,75,25,54,6,10,20,80,129,6,2,63,105,44,63,19,42,0,7,19,63,105
2006-06-26 00:00:00.000,Wimbledon England Grand Slams,GRASS,3,Rafael Nadal,Jarkko Nieminen,Rafael Nadal,6-3; 6-4; 6-4,Q,135,6,2,74,103,56,74,15,29,2,2,15,71,103,5,2,43,85,34,43,19,42,6,9,14,53,85
2006-06-26 00:00:00.000,Wimbledon England Grand Slams,GRASS,3,Roger Federer,Jonas Bjorkman,Roger Federer,6-2; 6-0; 6-2,S,77,9,0,43,59,36,43,10,16,0,0,11,46,59,3,2,39,64,20,39,10,25,2,9,11,30,64
2006-06-26 00:00:00.000,Wimbledon England Grand Slams,GRASS,3,Rafael Nadal,Marcos Baghdatis,Rafael Nadal,6-1; 7-5; 6-3,S,147,4,0,75,103,52,75,16,28,9,9,14,68,103,3,2,49,89,32,49,19,40,6,11,14,51,89
2006-06-26 00:00:00.000,Wimbledon England Grand Slams,GRASS,3,Roger Federer,Rafael Nadal,Roger Federer,6-0; 7-6(5); 6-7(2); 6-3,F,178,13,1,83,119,64,83,20,36,1,3,20,84,119,9,3,94,127,64,94,14,33,4,10,19,78,127
2006-07-10 00:00:00.000,Bastad Sweden ATP World Tour,CLAY,2,Nikolay Davydenko,Alberto Martin,Nikolay Davydenko,6-4; 6-1,R32,70,1,0,32,41,25,32,8,9,0,1,9,33,41,0,2,37,61,20,37,10,24,3,7,8,30,61
2006-07-10 00:00:00.000,Bastad Sweden ATP World Tour,CLAY,2,Yuri Schukin,Ivo Minar,Yuri Schukin,2-6; 6-2; 6-3,R32,89,0,3,44,67,32,44,9,23,2,6,13,41,67,8,2,54,81,33,54,11,27,9,14,12,44,81
2006-07-10 00:00:00.000,Bastad Sweden ATP World Tour,CLAY,2,Nicolas Massu,Mariano Zabaleta,Nicolas Massu,6-4; 3-1 RET,R32,80,2,2,35,49,25,35,9,14,3,3,7,34,49,0,5,26,43,17,26,8,17,2,4,7,25,43
2006-07-10 00:00:00.000,Bastad Sweden ATP World Tour,CLAY,2,Jose Acasuso,Guillermo Coria,Jose Acasuso,2-6; 6-2; 7-5,R32,116,3,2,44,90,29,44,24,46,5,8,14,53,90,1,6,49,77,36,49,11,28,3,7,14,47,77
2006-07-10 00:00:00.000,Bastad Sweden ATP World Tour,CLAY,2,Nicolas Almagro,Tomas Berdych,Nicolas Almagro,6-2; 7-6(7),R32,87,8,3,55,81,36,55,12,26,5,8,10,48,81,1,2,34,66,21,34,15,32,3,8,10,36,66
2006-07-10 00:00:00.000,Bastad Sweden ATP World Tour,CLAY,2,Agustin Calleri,Peter Luczak,Agustin Calleri,3-6; 6-1; 6-2,R32,93,9,5,23,60,21,23,25,37,1,2,12,46,60,6,3,52,90,33,52,16,38,7,11,12,49,90
2006-07-10 00:00:00.000,Bastad Sweden ATP World Tour,CLAY,2,Robin Soderling,Boris Pashanski,Robin Soderling,6-2; 6-3,R32,59,2,2,23,42,20,23,13,19,1,1,8,33,42,1,6,33,57,23,33,7,24,5,9,9,30,57
2006-07-10 00:00:00.000,Bastad Sweden ATP World Tour,CLAY,2,David Ferrer,Mohammad Ghareeb,David Ferrer,6-4; 6-4,R32,76,2,3,29,56,25,29,12,27,2,4,10,37,56,4,4,39,61,24,39,8,22,1,5,10,32,61
2006-07-10 00:00:00.000,Bastad Sweden ATP World Tour,CLAY,2,Juan Carlos Ferrero,Ervin Eleskovic,Juan Carlos Ferrero,6-3; 3-6; 6-3,R32,105,2,1,60,76,39,60,11,16,3,6,14,50,76,4,9,40,84,26,40,20,44,6,10,13,46,84
2006-07-10 00:00:00.000,Bastad Sweden ATP World Tour,CLAY,2,Oliver Marach,Filip Prpic,Oliver Marach,6-3; 6-7(2); 6-2,R32,135,4,4,42,84,33,42,19,42,3,6,14,52,84,4,6,46,93,31,46,19,47,5,12,15,50,93
2006-07-10 00:00:00.000,Bastad Sweden ATP World Tour,CLAY,2,Lukas Dlouhy,Andreas Vinciguerra,Lukas Dlouhy,6-3; 6-2,R32,59,9,2,37,52,32,37,7,15,4,4,9,39,52,2,2,43,63,24,43,9,20,4,7,8,33,63
2006-07-10 00:00:00.000,Bastad Sweden ATP World Tour,CLAY,2,Jarkko Nieminen,Juan Ignacio Chela,Jarkko Nieminen,6-4; 5-7; 6-1,R32,127,5,1,52,89,36,52,12,37,6,11,14,48,89,1,1,54,97,30,54,18,43,9,17,15,48,97
2006-07-10 00:00:00.000,Bastad Sweden ATP World Tour,CLAY,2,Luis Horna,Thomas Johansson,Luis Horna,6-4; 6-2,R32,95,10,1,33,53,26,33,14,20,1,1,9,40,53,4,2,35,61,21,35,15,26,1,4,9,36,61
2006-07-10 00:00:00.000,Bastad Sweden ATP World Tour,CLAY,2,Evgeny Korolev,Florent Serra,Evgeny Korolev,6-3; 3-6; 6-4,R32,111,9,6,65,93,44,65,12,28,4,8,14,56,93,2,3,50,87,29,50,19,37,3,8,14,48,87
2006-07-10 00:00:00.000,Bastad Sweden ATP World Tour,CLAY,2,Alexander Waske,Jonas Bjorkman,Alexander Waske,6-4; 4-6; 6-3,R32,159,5,6,60,110,40,60,21,50,8,12,14,61,110,4,4,48,88,33,48,15,40,9,15,15,48,88
2006-07-10 00:00:00.000,Bastad Sweden ATP World Tour,CLAY,2,Tommy Robredo,Gilles Simon,Tommy Robredo,4-6; 6-1; 6-4,R32,132,1,0,61,76,36,61,8,15,4,9,13,44,76,1,3,66,115,38,66,16,49,15,23,14,54,115
2006-07-10 00:00:00.000,Bastad Sweden ATP World Tour,CLAY,2,Nikolay Davydenko,Yuri Schukin,Nikolay Davydenko,6-0; 3-6; 6-1,R16,104,6,2,49,68,38,49,9,19,7,8,11,47,68,1,0,46,77,29,46,11,31,3,8,11,40,77
2006-07-10 00:00:00.000,Bastad Sweden ATP World Tour,CLAY,2,Nicolas Massu,Jose Acasuso,Nicolas Massu,6-4; 6-2,R16,87,4,0,35,53,28,35,12,18,1,1,9,40,53,3,1,38,63,21,38,14,25,4,7,9,35,63
2006-07-10 00:00:00.000,Bastad Sweden ATP World Tour,CLAY,2,Agustin Calleri,Nicolas Almagro,Agustin Calleri,6-3; 6-4,R16,71,5,2,36,60,28,36,12,24,2,3,10,40,60,1,4,39,59,26,39,8,20,5,8,9,34,59
2006-07-10 00:00:00.000,Bastad Sweden ATP World Tour,CLAY,2,Robin Soderling,David Ferrer,Robin Soderling,6-3; 6-1,R16,70,3,0,27,44,24,27,10,17,1,1,8,34,44,0,7,32,59,17,32,12,27,2,6,8,29,59
2006-07-10 00:00:00.000,Bastad Sweden ATP World Tour,CLAY,2,Juan Carlos Ferrero,Oliver Marach,Juan Carlos Ferrero,6-2; 6-3,R16,95,2,2,30,47,21,30,10,17,0,2,9,31,47,3,1,40,79,23,40,14,39,12,17,8,37,79
2006-07-10 00:00:00.000,Bastad Sweden ATP World Tour,CLAY,2,Jarkko Nieminen,Lukas Dlouhy,Jarkko Nieminen,6-7(2); 6-0; 6-3,R16,93,2,1,55,82,36,55,18,27,2,4,14,54,82,6,6,55,92,37,55,11,37,5,11,13,48,92
2006-07-10 00:00:00.000,Bastad Sweden ATP World Tour,CLAY,2,Evgeny Korolev,Luis Horna,Evgeny Korolev,6-2; 6-3,R16,176,5,3,29,54,23,29,16,25,1,1,9,39,54,1,1,32,55,16,32,14,23,0,3,8,30,55
2006-07-10 00:00:00.000,Bastad Sweden ATP World Tour,CLAY,2,Tommy Robredo,Alexander Waske,Tommy Robredo,6-3; 6-1,R16,72,0,0,35,47,29,35,7,12,0,0,8,36,47,1,5,41,70,23,41,12,29,4,8,8,35,70
2006-07-10 00:00:00.000,Bastad Sweden ATP World Tour,CLAY,2,Nikolay Davydenko,Nicolas Massu,Nikolay Davydenko,6-4; 6-3,Q,84,1,1,32,48,23,32,11,16,0,1,9,34,48,2,4,29,58,19,29,13,29,4,8,10,32,58
2006-07-10 00:00:00.000,Bastad Sweden ATP World Tour,CLAY,2,Agustin Calleri,Robin Soderling,Agustin Calleri,6-4; 6-4,Q,80,6,2,31,58,22,31,18,27,0,1,10,40,58,3,4,46,69,30,46,10,23,5,8,10,40,69
2006-07-10 00:00:00.000,Bastad Sweden ATP World Tour,CLAY,2,Jarkko Nieminen,Juan Carlos Ferrero,Jarkko Nieminen,7-6(5); 6-2,Q,75,4,1,35,60,30,35,16,25,3,3,10,46,60,3,1,42,57,32,42,7,15,0,2,10,39,57
2006-07-10 00:00:00.000,Bastad Sweden ATP World Tour,CLAY,2,Tommy Robredo,Evgeny Korolev,Tommy Robredo,4-6; 6-3; 6-1,Q,111,2,2,54,66,41,54,5,12,3,5,13,46,66,1,5,56,98,32,56,19,42,9,14,13,51,98
2006-07-10 00:00:00.000,Bastad Sweden ATP World Tour,CLAY,2,Nikolay Davydenko,Agustin Calleri,Nikolay Davydenko,6-3; 6-3,S,77,0,1,37,54,25,37,12,17,4,5,9,37,54,2,2,35,61,22,35,10,26,4,8,9,32,61
2006-07-10 00:00:00.000,Bastad Sweden ATP World Tour,CLAY,2,Tommy Robredo,Jarkko Nieminen,Tommy Robredo,3-6; 6-2; 6-4,S,111,0,1,65,78,39,65,9,13,4,8,14,48,78,0,2,59,84,37,59,7,25,5,10,13,44,84
2006-07-10 00:00:00.000,Bastad Sweden ATP World Tour,CLAY,2,Tommy Robredo,Nikolay Davydenko,Tommy Robredo,6-2; 6-1,F,75,0,0,28,44,20,28,10,16,0,0,7,30,44,0,2,45,61,21,45,7,16,9,14,8,28,61
2006-07-10 00:00:00.000,Gstaad Switzerland ATP World Tour,CLAY,2,Ivan Ljubicic,Albert Portas,Ivan Ljubicic,6-3; 7-6(5),R32,100,10,3,39,70,33,39,19,31,1,1,11,52,70,3,6,33,67,26,33,18,34,2,3,10,44,67
2006-07-10 00:00:00.000,Gstaad Switzerland ATP World Tour,CLAY,2,Marco Chiudinelli,Davide Sanguinetti,Marco Chiudinelli,6-3; 6-2,R32,75,4,2,41,67,26,41,15,26,7,9,9,41,67,3,1,23,43,13,23,7,20,0,5,8,20,43
2006-07-10 00:00:00.000,Gstaad Switzerland ATP World Tour,CLAY,2,Ruben Ramirez Hidalgo,Robin Roshardt,Ruben Ramirez Hidalgo,6-1; 6-4,R32,66,3,4,29,46,25,29,7,17,3,4,8,32,46,3,2,40,58,23,40,5,18,4,9,9,28,58
2006-07-10 00:00:00.000,Gstaad Switzerland ATP World Tour,CLAY,2,Feliciano Lopez,Filippo Volandri,Feliciano Lopez,6-4; 6-4,R32,63,12,0,26,54,26,26,16,28,4,4,10,42,54,1,5,41,59,31,41,6,18,1,3,10,37,59
2006-07-10 00:00:00.000,Gstaad Switzerland ATP World Tour,CLAY,2,Dusan Vemic,Paul-Henri Mathieu,Dusan Vemic,3-6; 7-5; 7-6(6),R32,139,12,5,66,106,48,66,23,40,8,10,16,71,106,5,1,57,98,46,57,25,41,6,8,17,71,98
2006-07-10 00:00:00.000,Gstaad Switzerland ATP World Tour,CLAY,2,Marin Cilic,Andreas Seppi,Marin Cilic,6-3; 7-6(6),R32,95,4,3,33,70,24,33,21,37,1,3,11,45,70,6,8,43,87,24,43,24,44,7,10,10,48,87
2006-07-10 00:00:00.000,Gstaad Switzerland ATP World Tour,CLAY,2,Andrei Pavel,Stanislas Wawrinka,Andrei Pavel,6-4; 1-6; 7-6(4),R32,138,3,1,66,107,43,66,25,41,3,5,14,68,107,13,6,56,95,48,56,17,39,3,4,15,65,95
2006-07-10 00:00:00.000,Gstaad Switzerland ATP World Tour,CLAY,2,Max Mirnyi,Carlos Berlocq,Max Mirnyi,6-3; 7-5,R32,80,5,0,31,51,28,31,16,20,0,0,11,44,51,2,6,35,59,25,35,14,24,6,8,10,39,59
2006-07-10 00:00:00.000,Gstaad Switzerland ATP World Tour,CLAY,2,Jiri Novak,Carlos Moya,Jiri Novak,6-3; 6-2,R32,56,4,0,28,47,24,28,14,19,1,1,9,38,47,3,3,28,49,17,28,11,21,2,5,8,28,49
2006-07-10 00:00:00.000,Gstaad Switzerland ATP World Tour,CLAY,2,Philipp Kohlschreiber,Alessio Di Mauro,Philipp Kohlschreiber,6-3; 6-1,R32,58,9,2,22,44,21,22,7,22,0,2,8,28,44,1,4,34,51,16,34,4,17,3,9,8,20,51
2006-07-10 00:00:00.000,Gstaad Switzerland ATP World Tour,CLAY,2,Daniele Bracciali,Flavio Saretta,Daniele Bracciali,5-7; 6-1; 6-4,R32,124,10,1,43,100,34,43,30,57,6,8,14,64,100,4,2,44,92,32,44,22,48,5,10,15,54,92
2006-07-10 00:00:00.000,Gstaad Switzerland ATP World Tour,CLAY,2,Fernando Verdasco,Dick Norman,Fernando Verdasco,6-4; 6-3,R32,60,3,4,37,52,27,37,9,15,1,2,9,36,52,3,5,32,58,18,32,13,26,3,7,10,31,58
2006-07-10 00:00:00.000,Gstaad Switzerland ATP World Tour,CLAY,2,Richard Gasquet,Simon Greul,Richard Gasquet,6-3; 6-3,R32,70,5,4,36,59,27,36,14,23,2,2,9,41,59,3,4,30,50,20,30,8,20,1,4,9,28,50
2006-07-10 00:00:00.000,Gstaad Switzerland ATP World Tour,CLAY,2,Robin Vik,Roman Vogeli,Robin Vik,6-2; 6-1,R32,60,2,1,26,40,22,26,8,14,2,2,7,30,40,4,5,27,55,15,27,10,28,4,9,8,25,55
2006-07-10 00:00:00.000,Gstaad Switzerland ATP World Tour,CLAY,2,Christophe Rochus,Fernando Vicente,Christophe Rochus,6-1; 4-6; 6-2,R32,107,1,3,60,87,39,60,12,27,10,13,13,51,87,4,4,36,78,24,36,16,42,6,12,12,40,78
2006-07-10 00:00:00.000,Gstaad Switzerland ATP World Tour,CLAY,2,Gaston Gaudio,Marcos Daniel,Gaston Gaudio,7-6(4); 6-2,R32,103,2,4,35,62,27,35,15,27,1,3,10,42,62,6,3,37,74,23,37,17,37,7,11,10,40,74
2006-07-10 00:00:00.000,Gstaad Switzerland ATP World Tour,CLAY,2,Ivan Ljubicic,Marco Chiudinelli,Ivan Ljubicic,6-7(6); 6-3; 6-2,R16,133,13,5,40,77,39,40,22,37,0,0,14,61,77,7,5,56,110,40,56,27,54,5,9,15,67,110
2006-07-10 00:00:00.000,Gstaad Switzerland ATP World Tour,CLAY,2,Feliciano Lopez,Ruben Ramirez Hidalgo,Feliciano Lopez,6-7(5); 6-3; 7-6(3),R16,133,16,2,62,94,56,62,20,32,0,0,17,76,94,6,0,63,102,49,63,23,39,5,6,16,72,102
2006-07-10 00:00:00.000,Gstaad Switzerland ATP World Tour,CLAY,2,Marin Cilic,Dusan Vemic,Marin Cilic,2-6; 6-3; 6-4,R16,109,3,5,37,80,26,37,24,43,2,5,14,50,80,7,1,60,85,35,60,16,25,4,7,13,51,85
2006-07-10 00:00:00.000,Gstaad Switzerland ATP World Tour,CLAY,2,Andrei Pavel,Max Mirnyi,Andrei Pavel,6-2; 6-4,R16,141,4,1,35,47,29,35,9,12,2,2,9,38,47,6,5,33,58,22,33,11,25,3,6,9,33,58
2006-07-10 00:00:00.000,Gstaad Switzerland ATP World Tour,CLAY,2,Philipp Kohlschreiber,Jiri Novak,Philipp Kohlschreiber,3-6; 6-7(5); 6-1,R16,111,8,0,48,90,35,48,23,42,5,7,13,58,90,4,0,54,90,36,54,21,36,4,8,15,57,90
2006-07-10 00:00:00.000,Gstaad Switzerland ATP World Tour,CLAY,2,Fernando Verdasco,Daniele Bracciali,Fernando Verdasco,6-3; 6-1,R16,52,4,3,36,46,30,36,5,10,3,3,8,35,46,0,6,31,48,17,31,8,17,2,6,8,25,48
2006-07-10 00:00:00.000,Gstaad Switzerland ATP World Tour,CLAY,2,Richard Gasquet,Robin Vik,Richard Gasquet,6-1; 6-1,R16,53,5,1,23,39,19,23,9,16,1,2,7,28,39,0,8,20,41,10,20,2,21,1,7,7,12,41
2006-07-10 00:00:00.000,Gstaad Switzerland ATP World Tour,CLAY,2,Gaston Gaudio,Christophe Rochus,Gaston Gaudio,6-0; 6-4,R16,68,1,4,23,41,19,23,11,18,0,1,8,30,41,1,0,33,58,17,33,10,25,5,10,8,27,58
2006-07-10 00:00:00.000,Gstaad Switzerland ATP World Tour,CLAY,2,Feliciano Lopez,Ivan Ljubicic,Feliciano Lopez,7-6(4); 6-3,Q,82,10,1,36,70,29,36,22,34,4,4,11,51,70,10,3,37,65,29,37,14,28,1,2,10,43,65
2006-07-10 00:00:00.000,Gstaad Switzerland ATP World Tour,CLAY,2,Marin Cilic,Andrei Pavel,Marin Cilic,6-7(5); 6-3; 7-5,Q,145,11,3,71,120,55,71,24,49,6,6,16,79,120,4,4,61,106,45,61,25,45,5,8,17,70,106
2006-07-10 00:00:00.000,Gstaad Switzerland ATP World Tour,CLAY,2,Philipp Kohlschreiber,Fernando Verdasco,Philipp Kohlschreiber,6-3; 4-6; 6-4,Q,133,4,4,51,99,35,51,26,48,7,10,15,61,99,1,3,74,101,46,74,12,27,9,13,14,58,101
2006-07-10 00:00:00.000,Gstaad Switzerland ATP World Tour,CLAY,2,Richard Gasquet,Gaston Gaudio,Richard Gasquet,6-3; 6-2,Q,82,8,6,42,69,31,42,14,27,8,8,9,45,69,4,4,32,55,23,32,9,23,2,5,8,32,55
2006-07-10 00:00:00.000,Gstaad Switzerland ATP World Tour,CLAY,2,Feliciano Lopez,Marin Cilic,Feliciano Lopez,7-6(2); 6-7(5); 6-3,S,157,27,6,77,116,59,77,18,39,4,6,17,77,116,9,6,64,116,46,64,25,52,9,12,16,71,116
2006-07-10 00:00:00.000,Gstaad Switzerland ATP World Tour,CLAY,2,Richard Gasquet,Philipp Kohlschreiber,Richard Gasquet,6-1; 1-6; 6-2,S,92,7,3,38,61,30,38,11,23,1,3,11,41,61,4,5,32,71,23,32,17,39,5,9,11,40,71
2006-07-10 00:00:00.000,Gstaad Switzerland ATP World Tour,CLAY,2,Richard Gasquet,Feliciano Lopez,Richard Gasquet,7-6(4); 6-7(3); 6-3; 6-3,F,185,9,2,82,120,67,82,27,38,2,2,21,94,120,24,6,89,141,68,89,29,52,6,9,21,97,141
2006-07-10 00:00:00.000,Newport RI; U.S.A. ATP World Tour,GRASS,2,Andy Murray,Ricardo Mello,Andy Murray,6-1; 1-6; 7-6(5),R32,122,2,1,44,82,25,44,21,38,4,9,13,46,82,1,4,63,97,36,63,17,34,7,12,13,53,97
2006-07-10 00:00:00.000,Newport RI; U.S.A. ATP World Tour,GRASS,2,Sam Querrey,Danai Udomchoke,Sam Querrey,6-4; 6-3,R32,61,11,1,42,62,33,42,9,20,3,4,10,42,62,0,7,32,58,21,32,10,26,1,4,9,31,58
2006-07-10 00:00:00.000,Newport RI; U.S.A. ATP World Tour,GRASS,2,Igor Kunitsyn,Bobby Reynolds,Igor Kunitsyn,7-5; 6-2,R32,79,3,2,31,60,24,31,17,29,1,2,10,41,60,5,5,37,71,23,37,16,34,6,10,10,39,71
2006-07-10 00:00:00.000,Newport RI; U.S.A. ATP World Tour,GRASS,2,Robert Kendrick,Vincent Spadea,Robert Kendrick,6-4; 3-6; 6-3,R32,94,7,7,56,80,45,56,10,24,3,4,14,55,80,2,7,50,83,37,50,16,33,3,5,14,53,83
2006-07-10 00:00:00.000,Newport RI; U.S.A. ATP World Tour,GRASS,2,Paul Capdeville,Gilles Muller,Paul Capdeville,7-6(7); 6-2,R32,90,11,3,35,71,30,35,20,36,3,4,10,50,71,5,10,39,76,29,39,16,37,5,8,10,45,76
2006-07-10 00:00:00.000,Newport RI; U.S.A. ATP World Tour,GRASS,2,Kristian Pless,Michael Russell,Kristian Pless,7-6(2) RET,R32,50,5,3,28,47,20,28,8,19,4,7,6,28,47,1,4,28,43,16,28,4,15,2,5,6,20,43
2006-07-10 00:00:00.000,Newport RI; U.S.A. ATP World Tour,GRASS,2,Wayne Arthurs,Kenneth Carlsen,Wayne Arthurs,7-6(5); 7-6(6),R32,100,14,8,48,79,41,48,19,31,0,0,12,60,79,4,7,45,83,37,45,22,38,3,3,12,59,83
2006-07-10 00:00:00.000,Newport RI; U.S.A. ATP World Tour,GRASS,2,Justin Gimelstob,Wesley Whitehouse,Justin Gimelstob,4-6; 6-3; 6-4,R32,122,4,6,50,95,40,50,22,45,3,5,15,62,95,5,6,45,91,31,45,25,46,5,8,14,56,91
2006-07-10 00:00:00.000,Newport RI; U.S.A. ATP World Tour,GRASS,2,Mardy Fish,Cyril Saulnier,Mardy Fish,6-3; 6-1,R32,57,11,3,30,50,25,30,10,20,5,5,8,35,50,0,2,35,52,21,35,5,17,5,9,8,26,52
2006-07-10 00:00:00.000,Newport RI; U.S.A. ATP World Tour,GRASS,2,Thiago Alves,Tomas Behrend,Thiago Alves,6-4; 6-4,R32,69,1,3,36,58,26,36,8,22,6,9,10,34,58,6,9,36,65,21,36,12,29,4,9,10,33,65
2006-07-10 00:00:00.000,Newport RI; U.S.A. ATP World Tour,GRASS,2,Rik De Voest,Lukasz Kubot,Rik De Voest,6-2; 6-2,R32,77,1,0,32,58,19,32,16,26,6,7,8,35,58,2,5,34,60,20,34,9,26,4,9,8,29,60
2006-07-10 00:00:00.000,Newport RI; U.S.A. ATP World Tour,GRASS,2,Mark Philippoussis,Paul Goldstein,Mark Philippoussis,6-4; 6-2,R32,69,14,6,28,49,26,28,12,21,0,0,9,38,49,0,4,40,65,25,40,10,25,5,8,9,35,65
2006-07-10 00:00:00.000,Newport RI; U.S.A. ATP World Tour,GRASS,2,Jurgen Melzer,Razvan Sabau,Jurgen Melzer,7-5; 7-5,R32,92,15,8,34,63,27,34,16,29,0,2,12,43,63,2,7,60,109,36,60,23,49,13,17,12,59,109
2006-07-10 00:00:00.000,Newport RI; U.S.A. ATP World Tour,GRASS,2,Frank Dancevic,Kevin Kim,Frank Dancevic,6-4; 6-3,R32,57,5,0,32,58,27,32,16,26,1,1,10,43,58,0,5,33,63,21,33,16,30,5,7,9,37,63
2006-07-10 00:00:00.000,Newport RI; U.S.A. ATP World Tour,GRASS,2,Alex Bogdanovic,Jesse Levine,Alex Bogdanovic,6-4; 7-5,R32,82,3,2,49,77,33,49,15,28,7,9,11,48,77,4,2,39,65,27,39,12,26,4,8,11,39,65
2006-07-10 00:00:00.000,Newport RI; U.S.A. ATP World Tour,GRASS,2,George Bastl,Ivo Karlovic,George Bastl,6-7(2); 6-4; 4-2 RET,R32,114,4,7,39,79,33,39,24,40,3,4,14,57,79,17,11,56,88,42,56,14,32,5,8,14,56,88
2006-07-10 00:00:00.000,Newport RI; U.S.A. ATP World Tour,GRASS,2,Andy Murray,Sam Querrey,Andy Murray,7-5; 6-2,R16,71,3,4,37,65,24,37,15,28,5,7,10,39,65,8,4,37,63,23,37,6,26,9,14,10,29,63
2006-07-10 00:00:00.000,Newport RI; U.S.A. ATP World Tour,GRASS,2,Robert Kendrick,Igor Kunitsyn,Robert Kendrick,6-4; 6-2,R16,75,7,7,34,66,24,34,17,32,9,10,9,41,66,1,4,36,59,20,36,11,23,3,7,9,31,59
2006-07-10 00:00:00.000,Newport RI; U.S.A. ATP World Tour,GRASS,2,Kristian Pless,Paul Capdeville,Kristian Pless,6-4; 4-6; 6-4,R16,100,7,2,54,95,40,54,18,41,5,8,15,58,95,4,3,47,79,37,47,10,32,0,4,15,47,79
2006-07-10 00:00:00.000,Newport RI; U.S.A. ATP World Tour,GRASS,2,Justin Gimelstob,Wayne Arthurs,Justin Gimelstob,6-3; 7-6(1),R16,91,8,7,37,77,33,37,18,40,6,7,11,51,77,9,2,27,53,22,27,14,26,2,4,10,36,53
2006-07-10 00:00:00.000,Newport RI; U.S.A. ATP World Tour,GRASS,2,Mardy Fish,Thiago Alves,Mardy Fish,6-2; 6-3,R16,66,13,6,23,55,20,23,16,32,0,1,9,36,55,1,3,34,48,17,34,8,14,2,6,8,25,48
2006-07-10 00:00:00.000,Newport RI; U.S.A. ATP World Tour,GRASS,2,Mark Philippoussis,Rik De Voest,Mark Philippoussis,6-3; 6-4,R16,71,8,3,26,53,23,26,19,27,3,3,10,42,53,1,2,31,56,23,31,11,25,1,3,9,34,56
2006-07-10 00:00:00.000,Newport RI; U.S.A. ATP World Tour,GRASS,2,Jurgen Melzer,Frank Dancevic,Jurgen Melzer,6-4; 3-6; 6-4,R16,104,10,4,40,84,27,40,25,44,5,8,14,52,84,6,2,58,86,40,58,13,28,5,9,15,53,86
2006-07-10 00:00:00.000,Newport RI; U.S.A. ATP World Tour,GRASS,2,Alex Bogdanovic,George Bastl,Alex Bogdanovic,6-1; 7-6(6),R16,81,2,1,36,57,29,36,14,21,3,3,9,43,57,9,7,35,67,28,35,12,32,3,6,10,40,67
2006-07-10 00:00:00.000,Newport RI; U.S.A. ATP World Tour,GRASS,2,Andy Murray,Robert Kendrick,Andy Murray,6-0; 6-0,Q,60,4,1,29,39,23,29,4,10,3,3,6,27,39,4,7,37,68,20,37,8,31,12,18,6,28,68
2006-07-10 00:00:00.000,Newport RI; U.S.A. ATP World Tour,GRASS,2,Justin Gimelstob,Kristian Pless,Justin Gimelstob,6-3; 6-1,Q,53,4,2,26,52,20,26,16,26,2,2,8,36,52,0,1,25,42,14,25,8,17,0,4,8,22,42
2006-07-10 00:00:00.000,Newport RI; U.S.A. ATP World Tour,GRASS,2,Mark Philippoussis,Mardy Fish,Mark Philippoussis,7-6(7); 6-3,Q,96,11,4,47,76,39,47,15,29,2,2,11,54,76,14,1,37,68,32,37,15,31,5,6,10,47,68
2006-07-10 00:00:00.000,Newport RI; U.S.A. ATP World Tour,GRASS,2,Jurgen Melzer,Alex Bogdanovic,Jurgen Melzer,3-6; 6-2; 6-1,Q,79,8,5,39,71,29,39,19,32,4,5,12,48,71,1,3,47,67,32,47,9,20,4,8,12,41,67
2006-07-10 00:00:00.000,Newport RI; U.S.A. ATP World Tour,GRASS,2,Justin Gimelstob,Andy Murray,Justin Gimelstob,6-1; 7-6(4),S,90,6,2,33,60,27,33,16,27,0,0,9,43,60,2,2,38,70,24,38,16,32,1,4,10,40,70
2006-07-10 00:00:00.000,Newport RI; U.S.A. ATP World Tour,GRASS,2,Mark Philippoussis,Jurgen Melzer,Mark Philippoussis,6-7(2); 6-2; 6-0,S,108,16,6,47,77,41,47,16,30,0,0,13,57,77,9,5,55,90,33,55,20,35,5,10,13,53,90
2006-07-10 00:00:00.000,Newport RI; U.S.A. ATP World Tour,GRASS,2,Mark Philippoussis,Justin Gimelstob,Mark Philippoussis,6-3; 7-5,F,102,15,6,39,65,34,39,13,26,3,3,11,47,65,8,3,49,83,31,49,16,34,9,11,10,47,83
2006-07-17 00:00:00.000,Amersfoort The Netherlands ATP World Tour,CLAY,2,Guillermo Coria,Robin Haase,Guillermo Coria,6-3; 4-6; 6-4,R32,137,1,14,59,99,48,59,12,40,7,12,15,60,99,1,1,64,111,41,64,19,47,10,16,14,60,111
2006-07-17 00:00:00.000,Amersfoort The Netherlands ATP World Tour,CLAY,2,Sergio Roitman,Marin Cilic,Sergio Roitman,6-3; 6-1,R32,68,4,0,34,45,26,34,6,11,5,6,8,32,45,1,0,35,55,17,35,8,20,2,7,8,25,55
2006-07-17 00:00:00.000,Amersfoort The Netherlands ATP World Tour,CLAY,2,Agustin Calleri,Denis Gremelmayr,Agustin Calleri,6-2; 7-6(5),R32,93,4,4,42,80,30,42,23,38,7,8,10,53,80,0,3,34,67,25,34,14,33,1,4,10,39,67
2006-07-17 00:00:00.000,Amersfoort The Netherlands ATP World Tour,CLAY,2,Daniele Bracciali,Igor Sijsling,Daniele Bracciali,6-7(5); 6-4; 6-2,R32,138,20,4,65,107,50,65,21,42,10,11,15,71,107,8,6,53,106,37,53,25,53,6,10,15,62,106
2006-07-17 00:00:00.000,Amersfoort The Netherlands ATP World Tour,CLAY,2,Novak Djokovic,Boris Pashanski,Novak Djokovic,6-0; 6-3,R32,82,3,2,33,55,21,33,14,22,0,1,8,35,55,0,3,31,60,12,31,15,29,5,10,7,27,60
2006-07-17 00:00:00.000,Amersfoort The Netherlands ATP World Tour,CLAY,2,Tomas Zib,Steve Darcis,Tomas Zib,7-5; 6-3,R32,91,3,1,33,53,25,33,15,20,0,0,10,40,53,2,3,43,80,26,43,22,37,9,12,11,48,80
2006-07-17 00:00:00.000,Amersfoort The Netherlands ATP World Tour,CLAY,2,Marc Gicquel,Fernando Vicente,Marc Gicquel,6-2; 6-4,R32,70,2,2,29,54,22,29,16,25,1,1,9,38,54,5,0,32,44,19,32,7,12,0,3,9,26,44
2006-07-17 00:00:00.000,Amersfoort The Netherlands ATP World Tour,CLAY,2,Thiemo de Bakker,Julien Benneteau,Thiemo de Bakker,6-3; 6-3,R32,84,3,4,28,67,22,28,21,39,5,6,0,43,67,2,2,36,53,19,36,9,17,4,8,0,28,53
2006-07-17 00:00:00.000,Amersfoort The Netherlands ATP World Tour,CLAY,2,Carlos Moya,Guillermo Garcia-Lopez,Carlos Moya,6-4; 7-6(6),R32,114,7,0,45,78,37,45,20,33,1,1,11,57,78,0,1,46,76,33,46,18,30,1,2,11,51,76
2006-07-17 00:00:00.000,Amersfoort The Netherlands ATP World Tour,CLAY,2,Fabio Fognini,Juan-Pablo Guzman,Fabio Fognini,6-3; 1-6; 7-5,R32,126,3,5,58,106,37,58,24,48,4,7,14,61,106,5,1,45,80,31,45,21,35,1,4,14,52,80
2006-07-17 00:00:00.000,Amersfoort The Netherlands ATP World Tour,CLAY,2,Juan Antonio Marin,Davide Sanguinetti,Juan Antonio Marin,6-2; 7-5,R32,107,3,1,31,65,22,31,23,34,0,0,10,45,65,2,0,37,63,28,37,9,26,3,6,10,37,63
2006-07-17 00:00:00.000,Amersfoort The Netherlands ATP World Tour,CLAY,2,Nicolas Massu,Andreas Vinciguerra,Nicolas Massu,7-6(3); 6-3,R32,106,6,7,32,68,24,32,18,36,1,4,11,42,68,1,3,37,58,21,37,8,21,0,4,10,29,58
2006-07-17 00:00:00.000,Amersfoort The Netherlands ATP World Tour,CLAY,2,Alberto Martin,Albert Montanes,Alberto Martin,6-2; 6-2,R32,69,8,3,24,47,19,24,14,23,2,3,8,33,47,0,0,42,63,19,42,10,21,7,12,8,29,63
2006-07-17 00:00:00.000,Amersfoort The Netherlands ATP World Tour,CLAY,2,Edgardo Massa,Ivo Minar,Edgardo Massa,6-4; 6-3,R32,71,1,2,33,56,26,33,14,23,1,2,10,40,56,3,8,38,69,24,38,15,31,5,8,9,39,69
2006-07-17 00:00:00.000,Amersfoort The Netherlands ATP World Tour,CLAY,2,Ruben Ramirez Hidalgo,Carlos Berlocq,Ruben Ramirez Hidalgo,6-7(4); 6-3; 6-3,R32,183,4,4,62,106,41,62,23,44,6,10,15,64,106,8,5,56,101,36,56,18,45,8,15,15,54,101
2006-07-17 00:00:00.000,Amersfoort The Netherlands ATP World Tour,CLAY,2,Paul-Henri Mathieu,Alessio Di Mauro,Paul-Henri Mathieu,6-0; 6-3,R32,76,0,2,32,53,23,32,12,21,1,2,8,35,53,1,1,25,40,12,25,3,15,0,5,7,15,40
2006-07-17 00:00:00.000,Amersfoort The Netherlands ATP World Tour,CLAY,2,Guillermo Coria,Sergio Roitman,Guillermo Coria,7-5; 4-6; 6-2,R16,140,2,15,73,115,51,73,17,42,10,14,15,68,115,5,0,59,86,36,59,12,27,6,12,15,48,86
2006-07-17 00:00:00.000,Amersfoort The Netherlands ATP World Tour,CLAY,2,Agustin Calleri,Daniele Bracciali,Agustin Calleri,2-6; 7-6(2); 6-0,R16,102,12,2,45,76,36,45,17,31,0,2,13,53,76,6,1,49,84,36,49,15,35,1,4,13,51,84
2006-07-17 00:00:00.000,Amersfoort The Netherlands ATP World Tour,CLAY,2,Novak Djokovic,Tomas Zib,Novak Djokovic,6-4; 6-2,R16,86,13,4,41,61,33,41,11,20,4,4,9,44,61,1,2,36,73,24,36,17,37,9,12,9,41,73
2006-07-17 00:00:00.000,Amersfoort The Netherlands ATP World Tour,CLAY,2,Marc Gicquel,Thiemo de Bakker,Marc Gicquel,4-6; 6-3; 6-2,R16,127,9,3,39,83,35,39,22,44,2,3,14,57,83,4,2,56,83,39,56,12,27,5,8,13,51,83
2006-07-17 00:00:00.000,Amersfoort The Netherlands ATP World Tour,CLAY,2,Carlos Moya,Fabio Fognini,Carlos Moya,7-5; 6-3,R16,96,9,3,31,59,23,31,12,28,0,4,11,35,59,1,4,40,82,23,40,15,42,6,12,10,38,82
2006-07-17 00:00:00.000,Amersfoort The Netherlands ATP World Tour,CLAY,2,Nicolas Massu,Juan Antonio Marin,Nicolas Massu,6-4; 7-6(2),R16,146,0,6,39,73,28,39,12,34,7,11,11,40,73,3,1,50,77,28,50,11,27,2,7,11,39,77
2006-07-17 00:00:00.000,Amersfoort The Netherlands ATP World Tour,CLAY,2,Alberto Martin,Edgardo Massa,Alberto Martin,6-2; 6-4,R16,86,0,3,34,58,24,34,14,24,3,4,9,38,58,2,4,45,80,26,45,16,35,8,12,9,42,80
2006-07-17 00:00:00.000,Amersfoort The Netherlands ATP World Tour,CLAY,2,Ruben Ramirez Hidalgo,Paul-Henri Mathieu,Ruben Ramirez Hidalgo,6-4; 6-2,R16,80,3,1,30,52,22,30,10,22,1,3,9,32,52,1,3,27,47,15,27,8,20,0,5,9,23,47
2006-07-17 00:00:00.000,Amersfoort The Netherlands ATP World Tour,CLAY,2,Guillermo Coria,Agustin Calleri,Guillermo Coria,6-3; 7-6(4),Q,95,1,5,47,79,35,47,17,32,1,2,11,52,79,5,2,28,56,22,28,15,28,1,3,10,37,56
2006-07-17 00:00:00.000,Amersfoort The Netherlands ATP World Tour,CLAY,2,Novak Djokovic,Marc Gicquel,Novak Djokovic,6-3; 6-4,Q,75,5,3,37,61,30,37,10,24,2,3,10,40,61,1,2,36,61,27,36,6,25,4,7,9,33,61
2006-07-17 00:00:00.000,Amersfoort The Netherlands ATP World Tour,CLAY,2,Nicolas Massu,Carlos Moya,Nicolas Massu,7-5; 6-4,Q,106,3,1,41,63,25,41,17,22,2,4,11,42,63,3,3,36,67,22,36,15,31,4,8,11,37,67
2006-07-17 00:00:00.000,Amersfoort The Netherlands ATP World Tour,CLAY,2,Ruben Ramirez Hidalgo,Alberto Martin,Ruben Ramirez Hidalgo,6-2; 6-2,Q,63,3,0,29,44,26,29,7,15,0,0,8,33,44,2,2,24,47,14,24,10,23,4,8,8,24,47
2006-07-17 00:00:00.000,Amersfoort The Netherlands ATP World Tour,CLAY,2,Novak Djokovic,Guillermo Coria,Novak Djokovic,6-2; 1-0 RET,S,38,2,0,17,26,12,17,7,9,1,2,5,19,26,0,5,9,21,4,9,3,12,0,3,4,7,21
2006-07-17 00:00:00.000,Amersfoort The Netherlands ATP World Tour,CLAY,2,Nicolas Massu,Ruben Ramirez Hidalgo,Nicolas Massu,6-1; 6-3,S,79,6,0,23,42,21,23,11,19,0,0,8,32,42,4,0,27,49,15,27,10,22,4,8,8,25,49
2006-07-17 00:00:00.000,Amersfoort The Netherlands ATP World Tour,CLAY,2,Novak Djokovic,Nicolas Massu,Novak Djokovic,7-6(5); 6-4,F,162,9,3,36,68,27,36,16,32,2,4,11,43,68,11,4,40,89,27,40,25,49,7,10,11,52,89
2006-07-17 00:00:00.000,Indianapolis IN; U.S.A. ATP World Tour,HARD,2,James Blake,N/A Bye,James Blake,,R64,0,0,0,0,0,0,0,0,0,0,0,0,0,0,0,0,0,0,0,0,0,0,0,0,0,0,0
2006-07-17 00:00:00.000,Indianapolis IN; U.S.A. ATP World Tour,HARD,2,Danai Udomchoke,Tomas Cakl,Danai Udomchoke,6-2; 6-2,R64,68,5,2,33,50,25,33,11,17,3,3,8,36,50,3,9,32,72,17,32,19,40,10,14,8,36,72
2006-07-17 00:00:00.000,Indianapolis IN; U.S.A. ATP World Tour,HARD,2,Wesley Whitehouse,Justin Gimelstob,Wesley Whitehouse,6-3; 7-5,R64,92,3,1,40,66,29,40,14,26,1,3,11,43,66,6,4,30,66,21,30,14,36,1,5,10,35,66
2006-07-17 00:00:00.000,Indianapolis IN; U.S.A. ATP World Tour,HARD,2,Marat Safin,N/A Bye,Marat Safin,,R64,0,0,0,0,0,0,0,0,0,0,0,0,0,0,0,0,0,0,0,0,0,0,0,0,0,0,0
2006-07-17 00:00:00.000,Indianapolis IN; U.S.A. ATP World Tour,HARD,2,Nicolas Mahut,N/A Bye,Nicolas Mahut,,R64,0,0,0,0,0,0,0,0,0,0,0,0,0,0,0,0,0,0,0,0,0,0,0,0,0,0,0
2006-07-17 00:00:00.000,Indianapolis IN; U.S.A. ATP World Tour,HARD,2,Thiago Alves,Bobby Reynolds,Thiago Alves,6-4; 6-4,R64,72,2,2,35,52,27,35,10,17,0,1,10,37,52,9,5,34,64,25,34,14,30,6,9,10,39,64
2006-07-17 00:00:00.000,Indianapolis IN; U.S.A. ATP World Tour,HARD,2,George Bastl,Nathan Healey,George Bastl,6-3; 6-0,R64,68,7,3,23,41,20,23,13,18,0,0,8,33,41,4,5,32,57,19,32,9,25,5,9,7,28,57
2006-07-17 00:00:00.000,Indianapolis IN; U.S.A. ATP World Tour,HARD,2,Tommy Haas,N/A Bye,Tommy Haas,,R64,0,0,0,0,0,0,0,0,0,0,0,0,0,0,0,0,0,0,0,0,0,0,0,0,0,0,0
2006-07-17 00:00:00.000,Indianapolis IN; U.S.A. ATP World Tour,HARD,2,Fernando Gonzalez,N/A Bye,Fernando Gonzalez,,R64,0,0,0,0,0,0,0,0,0,0,0,0,0,0,0,0,0,0,0,0,0,0,0,0,0,0,0
2006-07-17 00:00:00.000,Indianapolis IN; U.S.A. ATP World Tour,HARD,2,Sam Querrey,Janko Tipsarevic,Sam Querrey,6-4; 6-7(4); 6-4,R64,117,19,3,52,100,43,52,28,48,1,2,16,71,100,9,2,56,95,44,56,20,39,1,4,16,64,95
2006-07-17 00:00:00.000,Indianapolis IN; U.S.A. ATP World Tour,HARD,2,Ricardo Mello,Jean-Rene Lisnard,Ricardo Mello,7-5; 7-5,R64,104,2,3,46,80,32,46,12,34,4,8,12,44,80,1,3,28,72,16,28,21,44,2,8,12,37,72
2006-07-17 00:00:00.000,Indianapolis IN; U.S.A. ATP World Tour,HARD,2,Vincent Spadea,N/A Bye,Vincent Spadea,,R64,0,0,0,0,0,0,0,0,0,0,0,0,0,0,0,0,0,0,0,0,0,0,0,0,0,0,0
2006-07-17 00:00:00.000,Indianapolis IN; U.S.A. ATP World Tour,HARD,2,Xavier Malisse,N/A Bye,Xavier Malisse,,R64,0,0,0,0,0,0,0,0,0,0,0,0,0,0,0,0,0,0,0,0,0,0,0,0,0,0,0
2006-07-17 00:00:00.000,Indianapolis IN; U.S.A. ATP World Tour,HARD,2,Hyung-Taik Lee,Mark Philippoussis,Hyung-Taik Lee,6-4; 7-6(3),R64,90,6,0,40,60,32,40,14,20,1,2,11,46,60,12,9,36,75,31,36,15,39,2,4,11,46,75
2006-07-17 00:00:00.000,Indianapolis IN; U.S.A. ATP World Tour,HARD,2,Benjamin Becker,Ivan Navarro,Benjamin Becker,6-2; 4-6; 7-5,R64,109,12,2,51,83,44,51,18,32,1,2,15,62,83,18,2,51,90,40,51,19,39,5,8,15,59,90
2006-07-17 00:00:00.000,Indianapolis IN; U.S.A. ATP World Tour,HARD,2,Dmitry Tursunov,N/A Bye,Dmitry Tursunov,,R64,0,0,0,0,0,0,0,0,0,0,0,0,0,0,0,0,0,0,0,0,0,0,0,0,0,0,0
2006-07-17 00:00:00.000,Indianapolis IN; U.S.A. ATP World Tour,HARD,2,Paradorn Srichaphan,N/A Bye,Paradorn Srichaphan,,R64,0,0,0,0,0,0,0,0,0,0,0,0,0,0,0,0,0,0,0,0,0,0,0,0,0,0,0
2006-07-17 00:00:00.000,Indianapolis IN; U.S.A. ATP World Tour,HARD,2,Wayne Arthurs,Harel Levy,Wayne Arthurs,6-3; 7-5,R64,71,5,4,26,56,22,26,19,30,1,2,11,41,56,1,1,39,57,25,39,11,18,4,7,10,36,57
2006-07-17 00:00:00.000,Indianapolis IN; U.S.A. ATP World Tour,HARD,2,Razvan Sabau,Yen-Hsun Lu,Razvan Sabau,6-3; 6-4,R64,74,6,2,35,55,26,35,11,20,0,1,10,37,55,7,2,33,61,22,33,14,28,5,8,9,36,61
2006-07-17 00:00:00.000,Indianapolis IN; U.S.A. ATP World Tour,HARD,2,Paul Goldstein,N/A Bye,Paul Goldstein,,R64,0,0,0,0,0,0,0,0,0,0,0,0,0,0,0,0,0,0,0,0,0,0,0,0,0,0,0
2006-07-17 00:00:00.000,Indianapolis IN; U.S.A. ATP World Tour,HARD,2,Igor Kunitsyn,N/A Bye,Igor Kunitsyn,,R64,0,0,0,0,0,0,0,0,0,0,0,0,0,0,0,0,0,0,0,0,0,0,0,0,0,0,0
2006-07-17 00:00:00.000,Indianapolis IN; U.S.A. ATP World Tour,HARD,2,Lars Burgsmuller,Zack Fleishman,Lars Burgsmuller,6-2; 6-3,R64,67,4,2,27,45,24,27,12,18,0,0,9,36,45,3,0,33,69,22,33,16,36,3,6,8,38,69
2006-07-17 00:00:00.000,Indianapolis IN; U.S.A. ATP World Tour,HARD,2,Alejandro Falla,Jean-Christophe Faurel,Alejandro Falla,6-4; 6-2,R64,83,1,1,29,59,20,29,17,30,1,3,9,37,59,1,4,28,67,15,28,16,39,12,17,9,31,67
2006-07-17 00:00:00.000,Indianapolis IN; U.S.A. ATP World Tour,HARD,2,Robby Ginepri,N/A Bye,Robby Ginepri,,R64,0,0,0,0,0,0,0,0,0,0,0,0,0,0,0,0,0,0,0,0,0,0,0,0,0,0,0
2006-07-17 00:00:00.000,Indianapolis IN; U.S.A. ATP World Tour,HARD,2,Dominik Hrbaty,N/A Bye,Dominik Hrbaty,,R64,0,0,0,0,0,0,0,0,0,0,0,0,0,0,0,0,0,0,0,0,0,0,0,0,0,0,0
2006-07-17 00:00:00.000,Indianapolis IN; U.S.A. ATP World Tour,HARD,2,Kenneth Carlsen,Andrea Stoppini,Kenneth Carlsen,7-6(5); 6-4,R64,101,9,0,39,65,28,39,23,26,1,1,11,51,65,4,3,59,95,39,59,19,36,8,9,11,58,95
2006-07-17 00:00:00.000,Indianapolis IN; U.S.A. ATP World Tour,HARD,2,Paul Capdeville,Tomas Behrend,Paul Capdeville,6-2; 6-0,R64,43,6,1,15,34,14,15,14,19,0,0,7,28,34,3,3,20,37,9,20,5,17,1,6,7,14,37
2006-07-17 00:00:00.000,Indianapolis IN; U.S.A. ATP World Tour,HARD,2,Gilles Muller,N/A Bye,Gilles Muller,,R64,0,0,0,0,0,0,0,0,0,0,0,0,0,0,0,0,0,0,0,0,0,0,0,0,0,0,0
2006-07-17 00:00:00.000,Indianapolis IN; U.S.A. ATP World Tour,HARD,2,Kevin Kim,N/A Bye,Kevin Kim,,R64,0,0,0,0,0,0,0,0,0,0,0,0,0,0,0,0,0,0,0,0,0,0,0,0,0,0,0
2006-07-17 00:00:00.000,Indianapolis IN; U.S.A. ATP World Tour,HARD,2,Jeff Morrison,Santiago Gonzalez,Jeff Morrison,6-2; 6-2,R64,59,1,2,21,48,17,21,18,27,0,0,8,35,48,2,4,28,56,16,28,14,28,3,7,8,30,56
2006-07-17 00:00:00.000,Indianapolis IN; U.S.A. ATP World Tour,HARD,2,Ramon Delgado,Amer Delic,Ramon Delgado,4-6; 6-2; 7-6(5),R64,137,1,2,53,99,38,53,24,46,4,8,15,62,99,15,8,46,98,33,46,22,52,3,8,15,55,98
2006-07-17 00:00:00.000,Indianapolis IN; U.S.A. ATP World Tour,HARD,2,Andy Roddick,N/A Bye,Andy Roddick,,R64,0,0,0,0,0,0,0,0,0,0,0,0,0,0,0,0,0,0,0,0,0,0,0,0,0,0,0
2006-07-17 00:00:00.000,Indianapolis IN; U.S.A. ATP World Tour,HARD,2,James Blake,Danai Udomchoke,James Blake,7-6(5); 6-4,R32,83,7,3,31,67,24,31,24,36,3,4,11,48,67,3,3,61,87,40,61,10,26,6,8,11,50,87
2006-07-17 00:00:00.000,Indianapolis IN; U.S.A. ATP World Tour,HARD,2,Wesley Whitehouse,Marat Safin,Wesley Whitehouse,6-1; 6-4,R32,74,12,1,30,54,26,30,15,24,2,2,9,41,54,4,2,37,71,25,37,13,34,9,12,8,38,71
2006-07-17 00:00:00.000,Indianapolis IN; U.S.A. ATP World Tour,HARD,2,Nicolas Mahut,Thiago Alves,Nicolas Mahut,6-4; 3-6; 6-3,R32,112,13,5,50,79,40,50,10,29,2,5,14,50,79,2,3,57,80,36,57,13,23,2,6,14,49,80
2006-07-17 00:00:00.000,Indianapolis IN; U.S.A. ATP World Tour,HARD,2,Tommy Haas,George Bastl,Tommy Haas,6-3; 6-3,R32,88,8,8,31,57,24,31,15,26,2,3,9,39,57,8,4,37,72,27,37,11,35,6,10,9,38,72
2006-07-17 00:00:00.000,Indianapolis IN; U.S.A. ATP World Tour,HARD,2,Fernando Gonzalez,Sam Querrey,Fernando Gonzalez,6-3; 6-4,R32,67,6,3,40,68,33,40,14,28,3,3,10,47,68,7,4,23,45,20,23,12,22,1,3,9,32,45
2006-07-17 00:00:00.000,Indianapolis IN; U.S.A. ATP World Tour,HARD,2,Vincent Spadea,Ricardo Mello,Vincent Spadea,6-3; 6-1,R32,52,3,5,26,45,21,26,8,19,1,3,8,29,45,1,5,34,51,18,34,3,17,2,8,8,21,51
2006-07-17 00:00:00.000,Indianapolis IN; U.S.A. ATP World Tour,HARD,2,Xavier Malisse,Hyung-Taik Lee,Xavier Malisse,7-6(4); 6-1,R32,83,12,0,38,68,29,38,18,30,0,0,10,47,68,0,3,37,68,23,37,18,31,4,6,9,41,68
2006-07-17 00:00:00.000,Indianapolis IN; U.S.A. ATP World Tour,HARD,2,Dmitry Tursunov,Benjamin Becker,Dmitry Tursunov,6-3; 5-7; 2-1 RET,R32,110,21,11,41,95,32,41,26,54,13,15,12,58,95,13,5,40,77,30,40,16,37,5,8,12,46,77
2006-07-17 00:00:00.000,Indianapolis IN; U.S.A. ATP World Tour,HARD,2,Paradorn Srichaphan,Wayne Arthurs,Paradorn Srichaphan,7-6(4); 6-7(4); 6-4,R32,131,15,4,58,103,53,58,26,45,1,1,17,79,103,27,5,62,104,55,62,23,42,0,1,17,78,104
2006-07-17 00:00:00.000,Indianapolis IN; U.S.A. ATP World Tour,HARD,2,Paul Goldstein,Razvan Sabau,Paul Goldstein,6-2; 6-1,R32,51,3,3,24,38,21,24,8,14,2,2,7,29,38,1,3,39,56,21,39,3,17,6,11,8,24,56
2006-07-17 00:00:00.000,Indianapolis IN; U.S.A. ATP World Tour,HARD,2,Igor Kunitsyn,Lars Burgsmuller,Igor Kunitsyn,7-5; 6-2,R32,98,0,3,47,74,32,47,15,27,6,7,10,47,74,2,6,39,73,27,39,11,34,8,12,10,38,73
2006-07-17 00:00:00.000,Indianapolis IN; U.S.A. ATP World Tour,HARD,2,Robby Ginepri,Alejandro Falla,Robby Ginepri,4-6; 7-5; 7-5,R32,137,2,6,70,110,46,70,22,40,6,10,17,68,110,6,5,72,131,48,72,27,59,7,12,17,75,131
2006-07-17 00:00:00.000,Indianapolis IN; U.S.A. ATP World Tour,HARD,2,Kenneth Carlsen,Dominik Hrbaty,Kenneth Carlsen,6-3; 6-2,R32,82,3,1,49,75,33,49,13,26,10,11,9,46,75,2,5,30,56,19,30,10,26,2,6,8,29,56
2006-07-17 00:00:00.000,Indianapolis IN; U.S.A. ATP World Tour,HARD,2,Gilles Muller,Paul Capdeville,Gilles Muller,6-2; 6-3,R32,62,12,1,23,40,19,23,11,17,0,1,8,30,40,3,5,27,54,16,27,9,27,2,7,9,25,54
2006-07-17 00:00:00.000,Indianapolis IN; U.S.A. ATP World Tour,HARD,2,Jeff Morrison,Kevin Kim,Jeff Morrison,6-2; 6-2,R32,52,9,2,26,42,21,26,11,16,0,0,8,32,42,1,4,33,52,20,33,7,19,2,6,8,27,52
2006-07-17 00:00:00.000,Indianapolis IN; U.S.A. ATP World Tour,HARD,2,Andy Roddick,Ramon Delgado,Andy Roddick,6-3; 6-2,R32,67,8,0,31,51,25,31,13,20,1,1,9,38,51,3,1,24,46,15,24,10,22,1,4,8,25,46
2006-07-17 00:00:00.000,Indianapolis IN; U.S.A. ATP World Tour,HARD,2,James Blake,Wesley Whitehouse,James Blake,6-7(5); 6-3; 6-4,R16,107,19,5,43,93,37,43,29,50,3,5,16,66,93,11,10,47,100,38,47,26,53,4,8,15,64,100
2006-07-17 00:00:00.000,Indianapolis IN; U.S.A. ATP World Tour,HARD,2,Nicolas Mahut,Tommy Haas,Nicolas Mahut,6-4; 7-5,R16,92,12,3,44,70,37,44,12,26,6,7,11,49,70,5,5,35,70,21,35,22,35,7,10,11,43,70
2006-07-17 00:00:00.000,Indianapolis IN; U.S.A. ATP World Tour,HARD,2,Fernando Gonzalez,Vincent Spadea,Fernando Gonzalez,6-4; 7-6(7),R16,95,10,3,38,68,34,38,15,30,2,3,11,49,68,2,2,38,82,27,38,25,44,11,13,11,52,82
2006-07-17 00:00:00.000,Indianapolis IN; U.S.A. ATP World Tour,HARD,2,Xavier Malisse,Dmitry Tursunov,Xavier Malisse,7-6(4); 3-6; 6-3,R16,133,7,4,54,105,41,54,23,51,8,12,15,64,105,14,4,42,93,32,42,23,51,6,10,15,55,93
2006-07-17 00:00:00.000,Indianapolis IN; U.S.A. ATP World Tour,HARD,2,Paradorn Srichaphan,Paul Goldstein,Paradorn Srichaphan,5-7; 6-3; 7-6(3),R16,140,13,6,54,114,40,54,26,60,4,9,17,66,114,1,2,60,97,38,60,18,37,3,8,16,56,97
2006-07-17 00:00:00.000,Indianapolis IN; U.S.A. ATP World Tour,HARD,2,Robby Ginepri,Igor Kunitsyn,Robby Ginepri,6-2; 6-7(2); 6-1,R16,117,11,0,64,92,45,64,16,28,4,5,14,61,92,2,4,49,87,32,49,18,38,7,12,13,50,87
2006-07-17 00:00:00.000,Indianapolis IN; U.S.A. ATP World Tour,HARD,2,Gilles Muller,Kenneth Carlsen,Gilles Muller,6-1; 6-2,R16,52,5,2,26,45,21,26,11,19,3,4,8,32,45,1,2,19,37,9,19,5,18,1,6,7,14,37
2006-07-17 00:00:00.000,Indianapolis IN; U.S.A. ATP World Tour,HARD,2,Andy Roddick,Jeff Morrison,Andy Roddick,7-6(4); 7-5,R16,98,9,1,47,67,39,47,13,20,0,0,12,52,67,12,3,60,100,45,60,16,40,6,7,12,61,100
2006-07-17 00:00:00.000,Indianapolis IN; U.S.A. ATP World Tour,HARD,2,James Blake,Nicolas Mahut,James Blake,7-6(2); 7-6(5),Q,106,8,0,43,74,37,43,19,31,1,2,12,56,74,6,3,46,82,35,46,19,36,3,4,12,54,82
2006-07-17 00:00:00.000,Indianapolis IN; U.S.A. ATP World Tour,HARD,2,Xavier Malisse,Fernando Gonzalez,Xavier Malisse,7-6(4); 6-4,Q,93,5,0,44,73,32,44,18,29,4,6,11,50,73,2,5,38,62,29,38,9,24,0,3,11,38,62
2006-07-17 00:00:00.000,Indianapolis IN; U.S.A. ATP World Tour,HARD,2,Robby Ginepri,Paradorn Srichaphan,Robby Ginepri,6-4; 6-1,Q,49,1,0,28,39,25,28,7,11,0,0,8,32,39,5,4,26,44,14,26,10,18,0,4,9,24,44
2006-07-17 00:00:00.000,Indianapolis IN; U.S.A. ATP World Tour,HARD,2,Andy Roddick,Gilles Muller,Andy Roddick,6-2; 6-3,Q,63,6,0,31,39,26,31,7,8,3,3,8,33,39,4,8,34,72,24,34,14,38,8,12,9,38,72
2006-07-17 00:00:00.000,Indianapolis IN; U.S.A. ATP World Tour,HARD,2,James Blake,Xavier Malisse,James Blake,6-3; 2-6; 6-1,S,93,9,3,45,89,32,45,21,44,8,11,12,53,89,4,3,31,62,22,31,13,31,2,7,12,35,62
2006-07-17 00:00:00.000,Indianapolis IN; U.S.A. ATP World Tour,HARD,2,Andy Roddick,Robby Ginepri,Andy Roddick,7-5; 6-3,S,67,8,0,40,56,32,40,12,16,0,0,11,44,56,3,0,36,56,22,36,14,20,1,3,10,36,56
2006-07-17 00:00:00.000,Indianapolis IN; U.S.A. ATP World Tour,HARD,2,James Blake,Andy Roddick,James Blake,4-6; 6-4; 7-6(5),F,123,15,9,71,126,57,71,23,55,10,12,16,80,126,18,3,69,93,51,69,16,24,4,6,16,67,93
2006-07-17 00:00:00.000,Stuttgart Germany ATP World Tour,CLAY,2,Gaston Gaudio,N/A Bye,Gaston Gaudio,,R64,0,0,0,0,0,0,0,0,0,0,0,0,0,0,0,0,0,0,0,0,0,0,0,0,0,0,0
2006-07-17 00:00:00.000,Stuttgart Germany ATP World Tour,CLAY,2,Mariano Zabaleta,Alexander Waske,Mariano Zabaleta,6-3; 3-6; 6-3,R64,124,4,3,48,86,36,48,23,38,2,3,14,59,86,6,4,47,85,35,47,20,38,11,13,13,55,85
2006-07-17 00:00:00.000,Stuttgart Germany ATP World Tour,CLAY,2,Albert Portas,Flavio Saretta,Albert Portas,5-7; 6-3; 6-3,R64,141,7,4,40,91,30,40,29,51,3,5,15,59,91,12,2,49,108,37,49,25,59,6,10,15,62,108
2006-07-17 00:00:00.000,Stuttgart Germany ATP World Tour,CLAY,2,Luis Horna,N/A Bye,Luis Horna,,R64,0,0,0,0,0,0,0,0,0,0,0,0,0,0,0,0,0,0,0,0,0,0,0,0,0,0,0
2006-07-17 00:00:00.000,Stuttgart Germany ATP World Tour,CLAY,2,Max Mirnyi,N/A Bye,Max Mirnyi,,R64,0,0,0,0,0,0,0,0,0,0,0,0,0,0,0,0,0,0,0,0,0,0,0,0,0,0,0
2006-07-17 00:00:00.000,Stuttgart Germany ATP World Tour,CLAY,2,Jurgen Melzer,Philipp Kohlschreiber,Jurgen Melzer,W/O,R64,0,0,0,0,0,0,0,0,0,0,0,0,0,0,0,0,0,0,0,0,0,0,0,0,0,0,0
2006-07-17 00:00:00.000,Stuttgart Germany ATP World Tour,CLAY,2,Juan Monaco,Michael Berrer,Juan Monaco,4-6; 7-6(6); 6-4,R64,164,2,4,86,126,45,86,27,40,8,14,16,72,126,4,14,65,106,51,65,13,41,7,13,16,64,106
2006-07-17 00:00:00.000,Stuttgart Germany ATP World Tour,CLAY,2,Kristof Vliegen,N/A Bye,Kristof Vliegen,,R64,0,0,0,0,0,0,0,0,0,0,0,0,0,0,0,0,0,0,0,0,0,0,0,0,0,0,0
2006-07-17 00:00:00.000,Stuttgart Germany ATP World Tour,CLAY,2,Stefan Koubek,N/A Bye,Stefan Koubek,,R64,0,0,0,0,0,0,0,0,0,0,0,0,0,0,0,0,0,0,0,0,0,0,0,0,0,0,0
2006-07-17 00:00:00.000,Stuttgart Germany ATP World Tour,CLAY,2,Teymuraz Gabashvili,Jiri Vanek,Teymuraz Gabashvili,6-3; 4-6; 6-3,R64,112,3,5,44,91,36,44,22,47,7,9,14,58,91,4,4,72,90,49,72,6,18,4,8,14,55,90
2006-07-17 00:00:00.000,Stuttgart Germany ATP World Tour,CLAY,2,Oliver Marach,Torsten Popp,Oliver Marach,6-1; 6-2,R64,74,5,3,19,40,17,19,15,21,0,0,8,32,40,2,10,29,52,18,29,6,23,2,6,7,24,52
2006-07-17 00:00:00.000,Stuttgart Germany ATP World Tour,CLAY,2,Richard Gasquet,N/A Bye,Richard Gasquet,,R64,0,0,0,0,0,0,0,0,0,0,0,0,0,0,0,0,0,0,0,0,0,0,0,0,0,0,0
2006-07-17 00:00:00.000,Stuttgart Germany ATP World Tour,CLAY,2,Mikhail Youzhny,N/A Bye,Mikhail Youzhny,,R64,0,0,0,0,0,0,0,0,0,0,0,0,0,0,0,0,0,0,0,0,0,0,0,0,0,0,0
2006-07-17 00:00:00.000,Stuttgart Germany ATP World Tour,CLAY,2,Simon Greul,Rainer Schuettler,Simon Greul,7-5; 7-5,R64,107,1,5,28,74,20,28,23,46,1,5,12,43,74,3,6,44,84,26,44,17,40,7,13,12,43,84
2006-07-17 00:00:00.000,Stuttgart Germany ATP World Tour,CLAY,2,Andreas Seppi,Dick Norman,Andreas Seppi,7-6(8); 6-4,R64,94,3,10,41,77,32,41,19,36,3,5,11,51,77,9,5,54,80,39,54,9,26,4,7,11,48,80
2006-07-17 00:00:00.000,Stuttgart Germany ATP World Tour,CLAY,2,Jose Acasuso,N/A Bye,Jose Acasuso,,R64,0,0,0,0,0,0,0,0,0,0,0,0,0,0,0,0,0,0,0,0,0,0,0,0,0,0,0
2006-07-17 00:00:00.000,Stuttgart Germany ATP World Tour,CLAY,2,Juan Ignacio Chela,N/A Bye,Juan Ignacio Chela,,R64,0,0,0,0,0,0,0,0,0,0,0,0,0,0,0,0,0,0,0,0,0,0,0,0,0,0,0
2006-07-17 00:00:00.000,Stuttgart Germany ATP World Tour,CLAY,2,Juan Martin Del Potro,Andrei Pavel,Juan Martin Del Potro,3-6; 6-2; 6-2,R64,118,2,3,62,80,37,62,8,18,5,9,12,45,80,1,0,49,83,28,49,15,34,5,12,13,43,83
2006-07-17 00:00:00.000,Stuttgart Germany ATP World Tour,CLAY,2,Florian Mayer,Andreas Beck,Florian Mayer,6-4; 3-6; 6-3,R64,186,8,1,53,80,39,53,14,27,7,11,14,53,80,2,6,60,92,37,60,17,32,5,10,14,54,92
2006-07-17 00:00:00.000,Stuttgart Germany ATP World Tour,CLAY,2,Gilles Simon,N/A Bye,Gilles Simon,,R64,0,0,0,0,0,0,0,0,0,0,0,0,0,0,0,0,0,0,0,0,0,0,0,0,0,0,0
2006-07-17 00:00:00.000,Stuttgart Germany ATP World Tour,CLAY,2,Bjorn Phau,N/A Bye,Bjorn Phau,,R64,0,0,0,0,0,0,0,0,0,0,0,0,0,0,0,0,0,0,0,0,0,0,0,0,0,0,0
2006-07-17 00:00:00.000,Stuttgart Germany ATP World Tour,CLAY,2,Stanislas Wawrinka,Lukas Dlouhy,Stanislas Wawrinka,6-7(1); 6-3; 6-4,R64,134,4,4,72,111,45,72,23,39,7,9,15,68,111,3,7,61,113,38,61,26,52,8,13,16,64,113
2006-07-17 00:00:00.000,Stuttgart Germany ATP World Tour,CLAY,2,Jiri Novak,Simone Bolelli,Jiri Novak,7-6(4); 6-1,R64,80,14,0,44,59,36,44,10,15,3,3,10,46,59,2,0,38,69,22,38,18,31,4,6,9,40,69
2006-07-17 00:00:00.000,Stuttgart Germany ATP World Tour,CLAY,2,David Ferrer,N/A Bye,David Ferrer,,R64,0,0,0,0,0,0,0,0,0,0,0,0,0,0,0,0,0,0,0,0,0,0,0,0,0,0,0
2006-07-17 00:00:00.000,Stuttgart Germany ATP World Tour,CLAY,2,Florent Serra,N/A Bye,Florent Serra,,R64,0,0,0,0,0,0,0,0,0,0,0,0,0,0,0,0,0,0,0,0,0,0,0,0,0,0,0
2006-07-17 00:00:00.000,Stuttgart Germany ATP World Tour,CLAY,2,Nicolas Lapentti,Sebastian Rieschick,Nicolas Lapentti,4-6; 6-3; 6-1,R64,106,7,0,51,78,36,51,12,27,2,5,13,48,78,1,4,45,77,27,45,13,32,1,7,13,40,77
2006-07-17 00:00:00.000,Stuttgart Germany ATP World Tour,CLAY,2,Diego Hartfield,Robin Vik,Diego Hartfield,3-6; 7-6(7); 6-4,R64,140,2,2,71,102,45,71,19,31,4,7,15,64,102,5,9,74,110,49,74,19,36,4,7,16,68,110
2006-07-17 00:00:00.000,Stuttgart Germany ATP World Tour,CLAY,2,Nicolas Almagro,N/A Bye,Nicolas Almagro,,R64,0,0,0,0,0,0,0,0,0,0,0,0,0,0,0,0,0,0,0,0,0,0,0,0,0,0,0
2006-07-17 00:00:00.000,Stuttgart Germany ATP World Tour,CLAY,2,Filippo Volandri,N/A Bye,Filippo Volandri,,R64,0,0,0,0,0,0,0,0,0,0,0,0,0,0,0,0,0,0,0,0,0,0,0,0,0,0,0
2006-07-17 00:00:00.000,Stuttgart Germany ATP World Tour,CLAY,2,Diego Junqueira,Christophe Rochus,Diego Junqueira,6-3; 2-6; 7-6(5),R64,123,3,0,80,99,43,80,10,19,8,14,15,53,99,2,1,61,99,36,61,20,38,8,13,14,56,99
2006-07-17 00:00:00.000,Stuttgart Germany ATP World Tour,CLAY,2,Hugo Armando,Dieter Kindlmann,Hugo Armando,6-4; 6-3,R64,68,9,0,32,49,29,32,12,17,1,1,10,41,49,0,3,34,54,25,34,8,20,2,4,9,33,54
2006-07-17 00:00:00.000,Stuttgart Germany ATP World Tour,CLAY,2,Tomas Berdych,N/A Bye,Tomas Berdych,,R64,0,0,0,0,0,0,0,0,0,0,0,0,0,0,0,0,0,0,0,0,0,0,0,0,0,0,0
2006-07-17 00:00:00.000,Stuttgart Germany ATP World Tour,CLAY,2,Mariano Zabaleta,Gaston Gaudio,Mariano Zabaleta,6-4; 6-0,R32,85,3,1,32,58,23,32,15,26,5,6,8,38,58,0,2,36,69,18,36,15,33,14,19,8,33,69
2006-07-17 00:00:00.000,Stuttgart Germany ATP World Tour,CLAY,2,Luis Horna,Albert Portas,Luis Horna,7-6(4); 6-2,R32,86,5,2,33,59,24,33,19,26,0,1,10,43,59,8,4,40,76,28,40,16,36,12,15,10,44,76
2006-07-17 00:00:00.000,Stuttgart Germany ATP World Tour,CLAY,2,Jurgen Melzer,Max Mirnyi,Jurgen Melzer,6-3; 6-1,R32,71,2,3,30,57,19,30,16,27,3,4,8,35,57,4,1,42,65,21,42,8,23,5,10,8,29,65
2006-07-17 00:00:00.000,Stuttgart Germany ATP World Tour,CLAY,2,Juan Monaco,Kristof Vliegen,Juan Monaco,6-3; 1-0 RET,R32,38,1,0,18,27,13,18,5,9,2,3,5,18,27,1,6,14,30,7,14,7,16,0,3,5,14,30
2006-07-17 00:00:00.000,Stuttgart Germany ATP World Tour,CLAY,2,Stefan Koubek,Teymuraz Gabashvili,Stefan Koubek,7-6(6); 6-2,R32,88,5,4,28,65,18,28,24,37,3,5,10,42,65,0,6,34,70,22,34,17,36,3,7,10,39,70
2006-07-17 00:00:00.000,Stuttgart Germany ATP World Tour,CLAY,2,Oliver Marach,Richard Gasquet,Oliver Marach,6-4; 6-2,R32,84,4,2,35,58,28,35,12,23,1,1,9,40,58,1,2,40,58,24,40,10,18,5,8,9,34,58
2006-07-17 00:00:00.000,Stuttgart Germany ATP World Tour,CLAY,2,Simon Greul,Mikhail Youzhny,Simon Greul,6-7(5); 7-5; 6-4,R32,147,3,3,51,106,39,51,32,55,5,7,17,71,106,4,5,68,116,50,68,22,48,5,9,17,72,116
2006-07-17 00:00:00.000,Stuttgart Germany ATP World Tour,CLAY,2,Jose Acasuso,Andreas Seppi,Jose Acasuso,6-4; 7-6(2),R32,99,7,0,33,66,29,33,21,33,2,2,11,50,66,2,5,46,83,36,46,15,37,10,11,11,51,83
2006-07-17 00:00:00.000,Stuttgart Germany ATP World Tour,CLAY,2,Juan Martin Del Potro,Juan Ignacio Chela,Juan Martin Del Potro,6-2; 4-6; 6-1,R32,122,0,8,78,102,49,78,10,24,10,13,13,59,102,0,4,53,85,28,53,13,32,6,12,12,41,85
2006-07-17 00:00:00.000,Stuttgart Germany ATP World Tour,CLAY,2,Florian Mayer,Gilles Simon,Florian Mayer,7-6(3); 6-2,R32,68,3,1,48,67,38,48,8,19,3,4,10,46,67,0,1,38,65,23,38,15,27,6,9,10,38,65
2006-07-17 00:00:00.000,Stuttgart Germany ATP World Tour,CLAY,2,Stanislas Wawrinka,Bjorn Phau,Stanislas Wawrinka,6-7(3); 6-2; 6-3,R32,120,5,5,53,84,41,53,13,31,0,2,14,54,84,3,1,45,90,29,45,21,45,6,12,15,50,90
2006-07-17 00:00:00.000,Stuttgart Germany ATP World Tour,CLAY,2,David Ferrer,Jiri Novak,David Ferrer,6-3; 6-1,R32,56,4,2,25,49,18,25,15,24,1,2,8,33,49,3,1,27,49,13,27,8,22,4,9,8,21,49
2006-07-17 00:00:00.000,Stuttgart Germany ATP World Tour,CLAY,2,Nicolas Lapentti,Florent Serra,Nicolas Lapentti,5-7; 7-6(3); 6-2,R32,176,4,5,58,102,46,58,22,44,6,9,16,68,102,1,6,47,103,30,47,32,56,6,10,16,62,103
2006-07-17 00:00:00.000,Stuttgart Germany ATP World Tour,CLAY,2,Diego Hartfield,Nicolas Almagro,Diego Hartfield,6-7(2); 7-6(1); 7-5,R32,161,3,3,75,104,57,75,17,29,0,2,18,74,104,13,2,85,133,61,85,23,48,4,7,18,84,133
2006-07-17 00:00:00.000,Stuttgart Germany ATP World Tour,CLAY,2,Diego Junqueira,Filippo Volandri,Diego Junqueira,6-3; 6-4,R32,83,0,2,51,74,36,51,11,23,6,7,10,47,74,0,1,35,57,22,35,12,22,6,9,9,34,57
2006-07-17 00:00:00.000,Stuttgart Germany ATP World Tour,CLAY,2,Tomas Berdych,Hugo Armando,Tomas Berdych,7-5; 6-3,R32,80,10,7,39,61,35,39,9,22,1,2,11,44,61,1,4,45,74,31,45,11,29,3,6,10,42,74
2006-07-17 00:00:00.000,Stuttgart Germany ATP World Tour,CLAY,2,Luis Horna,Mariano Zabaleta,Luis Horna,6-3; 6-7(6); 6-4,R16,161,14,5,68,113,51,68,27,45,10,11,16,78,113,8,3,73,113,55,73,18,40,12,15,15,73,113
2006-07-17 00:00:00.000,Stuttgart Germany ATP World Tour,CLAY,2,Juan Monaco,Jurgen Melzer,Juan Monaco,6-4; 6-7(3); 6-4,R16,148,0,3,68,107,47,68,25,39,3,4,16,72,107,5,3,71,117,51,71,25,46,10,13,16,76,117
2006-07-17 00:00:00.000,Stuttgart Germany ATP World Tour,CLAY,2,Oliver Marach,Stefan Koubek,Oliver Marach,6-4; 6-4,R16,93,5,2,32,65,25,32,17,33,4,5,10,42,65,5,1,30,63,23,30,14,33,2,5,10,37,63
2006-07-17 00:00:00.000,Stuttgart Germany ATP World Tour,CLAY,2,Jose Acasuso,Simon Greul,Jose Acasuso,7-6(4); 2-6; 6-4,R16,142,8,2,45,91,34,45,25,46,5,8,15,59,91,2,1,69,106,48,69,19,37,5,7,15,67,106
2006-07-17 00:00:00.000,Stuttgart Germany ATP World Tour,CLAY,2,Florian Mayer,Juan Martin Del Potro,Florian Mayer,6-1; 6-0,R16,48,4,1,18,35,16,18,12,17,0,0,7,28,35,1,2,32,41,12,32,3,9,5,10,6,15,41
2006-07-17 00:00:00.000,Stuttgart Germany ATP World Tour,CLAY,2,David Ferrer,Stanislas Wawrinka,David Ferrer,6-3; 6-4,R16,84,0,6,28,52,21,28,13,24,3,5,9,34,52,1,2,45,68,22,45,11,23,4,9,10,33,68
2006-07-17 00:00:00.000,Stuttgart Germany ATP World Tour,CLAY,2,Nicolas Lapentti,Diego Hartfield,Nicolas Lapentti,7-6(5); 6-2,R16,126,3,1,47,71,38,47,11,24,8,9,10,49,71,2,3,51,82,33,51,13,31,8,11,10,46,82
2006-07-17 00:00:00.000,Stuttgart Germany ATP World Tour,CLAY,2,Tomas Berdych,Diego Junqueira,Tomas Berdych,6-1; 6-4,R16,77,4,3,38,67,27,38,16,29,9,10,9,43,67,2,2,36,51,19,36,8,15,2,6,8,27,51
2006-07-17 00:00:00.000,Stuttgart Germany ATP World Tour,CLAY,2,Juan Monaco,Luis Horna,Juan Monaco,5-2 RET,Q,33,3,0,13,18,10,13,3,5,0,1,4,13,18,1,0,12,17,5,12,2,5,2,4,3,7,17
2006-07-17 00:00:00.000,Stuttgart Germany ATP World Tour,CLAY,2,Jose Acasuso,Oliver Marach,Jose Acasuso,6-2; 6-3,Q,80,9,2,30,56,25,30,15,26,3,3,9,40,56,4,0,26,50,17,26,12,24,4,7,8,29,50
2006-07-17 00:00:00.000,Stuttgart Germany ATP World Tour,CLAY,2,David Ferrer,Florian Mayer,David Ferrer,6-4; 6-3,Q,66,1,9,33,57,25,33,9,24,5,7,9,34,57,4,1,29,59,23,29,7,30,4,9,10,30,59
2006-07-17 00:00:00.000,Stuttgart Germany ATP World Tour,CLAY,2,Tomas Berdych,Nicolas Lapentti,Tomas Berdych,6-1; 6-2,Q,56,4,0,25,38,19,25,10,13,1,2,8,29,38,1,2,25,41,11,25,5,16,3,8,7,16,41
2006-07-17 00:00:00.000,Stuttgart Germany ATP World Tour,CLAY,2,Jose Acasuso,Juan Monaco,Jose Acasuso,4-6; 6-2; 6-2,S,145,10,2,49,106,32,49,27,57,8,12,13,59,106,0,0,62,80,31,62,9,18,2,9,13,40,80
2006-07-17 00:00:00.000,Stuttgart Germany ATP World Tour,CLAY,2,David Ferrer,Tomas Berdych,David Ferrer,6-3; 7-5,S,80,1,2,33,54,29,33,9,21,2,3,10,38,54,5,5,40,69,26,40,12,29,2,6,11,38,69
2006-07-17 00:00:00.000,Stuttgart Germany ATP World Tour,CLAY,2,David Ferrer,Jose Acasuso,David Ferrer,6-4; 3-6; 6-7(3); 7-5; 6-4,F,300,9,7,123,188,80,123,29,65,9,16,26,109,188,13,6,80,187,58,80,48,107,10,19,27,106,187
2006-07-24 00:00:00.000,Kitzbuhel Austria ATP World Tour,CLAY,2,Nikolay Davydenko,N/A Bye,Nikolay Davydenko,,R64,0,0,0,0,0,0,0,0,0,0,0,0,0,0,0,0,0,0,0,0,0,0,0,0,0,0,0
2006-07-24 00:00:00.000,Kitzbuhel Austria ATP World Tour,CLAY,2,Nicolas Lapentti,Tomas Zib,Nicolas Lapentti,7-6(10); 6-3,R64,130,9,1,45,77,30,45,16,32,2,4,10,46,77,4,5,33,75,21,33,18,42,1,5,11,39,75
2006-07-24 00:00:00.000,Kitzbuhel Austria ATP World Tour,CLAY,2,Stefan Koubek,Juan Antonio Marin,Stefan Koubek,3-6; 6-4; 7-6(1),R64,139,6,5,62,110,41,62,22,48,9,15,16,63,110,6,4,59,95,40,59,15,36,3,8,15,55,95
2006-07-24 00:00:00.000,Kitzbuhel Austria ATP World Tour,CLAY,2,Boris Pashanski,N/A Bye,Boris Pashanski,,R64,0,0,0,0,0,0,0,0,0,0,0,0,0,0,0,0,0,0,0,0,0,0,0,0,0,0,0
2006-07-24 00:00:00.000,Kitzbuhel Austria ATP World Tour,CLAY,2,Max Mirnyi,N/A Bye,Max Mirnyi,,R64,0,0,0,0,0,0,0,0,0,0,0,0,0,0,0,0,0,0,0,0,0,0,0,0,0,0,0
2006-07-24 00:00:00.000,Kitzbuhel Austria ATP World Tour,CLAY,2,Andreas Haider-Maurer,Damian Patriarca,Andreas Haider-Maurer,6-7(5); 6-2; 6-3,R64,100,11,8,52,93,36,52,21,41,4,6,14,57,93,0,5,49,83,34,49,12,34,3,9,15,46,83
2006-07-24 00:00:00.000,Kitzbuhel Austria ATP World Tour,CLAY,2,Alexander Waske,Lukasz Kubot,Alexander Waske,6-3; 3-6; 7-6(6),R64,189,10,4,66,101,48,66,15,35,7,10,15,63,101,8,11,69,111,53,69,12,42,8,11,15,65,111
2006-07-24 00:00:00.000,Kitzbuhel Austria ATP World Tour,CLAY,2,Fernando Verdasco,N/A Bye,Fernando Verdasco,,R64,0,0,0,0,0,0,0,0,0,0,0,0,0,0,0,0,0,0,0,0,0,0,0,0,0,0,0
2006-07-24 00:00:00.000,Kitzbuhel Austria ATP World Tour,CLAY,2,Gaston Gaudio,N/A Bye,Gaston Gaudio,,R64,0,0,0,0,0,0,0,0,0,0,0,0,0,0,0,0,0,0,0,0,0,0,0,0,0,0,0
2006-07-24 00:00:00.000,Kitzbuhel Austria ATP World Tour,CLAY,2,Juan Monaco,Leonardo Azzaro,Juan Monaco,6-4; 6-2,R64,67,3,1,33,51,28,33,10,18,2,2,9,38,51,1,0,31,58,22,31,13,27,4,7,9,35,58
2006-07-24 00:00:00.000,Kitzbuhel Austria ATP World Tour,CLAY,2,Denis Gremelmayr,Michael Berrer,Denis Gremelmayr,6-3; 3-6; 7-6(6),R64,110,6,3,58,89,45,58,16,31,2,4,15,61,89,6,8,62,94,42,62,17,32,5,7,15,59,94
2006-07-24 00:00:00.000,Kitzbuhel Austria ATP World Tour,CLAY,2,Christophe Rochus,N/A Bye,Christophe Rochus,,R64,0,0,0,0,0,0,0,0,0,0,0,0,0,0,0,0,0,0,0,0,0,0,0,0,0,0,0
2006-07-24 00:00:00.000,Kitzbuhel Austria ATP World Tour,CLAY,2,Agustin Calleri,N/A Bye,Agustin Calleri,,R64,0,0,0,0,0,0,0,0,0,0,0,0,0,0,0,0,0,0,0,0,0,0,0,0,0,0,0
2006-07-24 00:00:00.000,Kitzbuhel Austria ATP World Tour,CLAY,2,Rainer Eitzinger,Oliver Marach,Rainer Eitzinger,6-3; 6-0,R64,63,4,3,36,56,28,36,10,20,4,4,8,38,56,1,0,20,42,10,20,11,22,2,6,7,21,42
2006-07-24 00:00:00.000,Kitzbuhel Austria ATP World Tour,CLAY,2,Alex Calatrava,Diego Junqueira,Alex Calatrava,4-6; 6-3; 6-4,R64,137,8,2,58,100,44,58,17,42,5,9,15,61,100,2,1,73,88,46,73,6,15,7,12,14,52,88
2006-07-24 00:00:00.000,Kitzbuhel Austria ATP World Tour,CLAY,2,Nicolas Massu,N/A Bye,Nicolas Massu,,R64,0,0,0,0,0,0,0,0,0,0,0,0,0,0,0,0,0,0,0,0,0,0,0,0,0,0,0
2006-07-24 00:00:00.000,Kitzbuhel Austria ATP World Tour,CLAY,2,Juan Ignacio Chela,N/A Bye,Juan Ignacio Chela,,R64,0,0,0,0,0,0,0,0,0,0,0,0,0,0,0,0,0,0,0,0,0,0,0,0,0,0,0
2006-07-24 00:00:00.000,Kitzbuhel Austria ATP World Tour,CLAY,2,Mariano Zabaleta,Rainer Schuettler,Mariano Zabaleta,6-1 RET,R64,24,1,2,9,15,9,9,3,6,0,0,3,12,15,0,2,11,25,5,11,4,14,4,7,4,9,25
2006-07-24 00:00:00.000,Kitzbuhel Austria ATP World Tour,CLAY,2,Dusan Vemic,Armin Sandbichler,Dusan Vemic,6-3; 6-3,R64,67,11,4,28,52,24,28,14,24,3,3,9,38,52,0,2,36,53,19,36,9,17,1,4,9,28,53
2006-07-24 00:00:00.000,Kitzbuhel Austria ATP World Tour,CLAY,2,Luis Horna,N/A Bye,Luis Horna,,R64,0,0,0,0,0,0,0,0,0,0,0,0,0,0,0,0,0,0,0,0,0,0,0,0,0,0,0
2006-07-24 00:00:00.000,Kitzbuhel Austria ATP World Tour,CLAY,2,Philipp Kohlschreiber,N/A Bye,Philipp Kohlschreiber,,R64,0,0,0,0,0,0,0,0,0,0,0,0,0,0,0,0,0,0,0,0,0,0,0,0,0,0,0
2006-07-24 00:00:00.000,Kitzbuhel Austria ATP World Tour,CLAY,2,Peter Luczak,Ivo Minar,Peter Luczak,6-1; 3-6; 6-1,R64,68,10,1,43,65,34,43,16,22,0,1,12,50,65,9,4,30,61,23,30,13,31,2,6,11,36,61
2006-07-24 00:00:00.000,Kitzbuhel Austria ATP World Tour,CLAY,2,Sergio Roitman,Razvan Sabau,Sergio Roitman,6-4; 6-3,R64,80,5,0,38,60,26,38,8,22,4,7,9,34,60,1,3,39,65,20,39,11,26,5,11,10,31,65
2006-07-24 00:00:00.000,Kitzbuhel Austria ATP World Tour,CLAY,2,Jarkko Nieminen,N/A Bye,Jarkko Nieminen,,R64,0,0,0,0,0,0,0,0,0,0,0,0,0,0,0,0,0,0,0,0,0,0,0,0,0,0,0
2006-07-24 00:00:00.000,Kitzbuhel Austria ATP World Tour,CLAY,2,Mikhail Youzhny,N/A Bye,Mikhail Youzhny,,R64,0,0,0,0,0,0,0,0,0,0,0,0,0,0,0,0,0,0,0,0,0,0,0,0,0,0,0
2006-07-24 00:00:00.000,Kitzbuhel Austria ATP World Tour,CLAY,2,Martin Vassallo Arguello,Dick Norman,Martin Vassallo Arguello,6-0; 6-4,R64,75,0,1,35,52,26,35,10,17,7,7,8,36,52,8,6,50,72,30,50,6,22,7,11,8,36,72
2006-07-24 00:00:00.000,Kitzbuhel Austria ATP World Tour,CLAY,2,Edgardo Massa,Werner Eschauer,Edgardo Massa,3-6; 7-6(6); 6-4,R64,124,2,6,47,90,34,47,26,43,3,6,15,60,90,9,6,44,89,35,44,25,45,1,4,16,60,89
2006-07-24 00:00:00.000,Kitzbuhel Austria ATP World Tour,CLAY,2,Andreas Seppi,N/A Bye,Andreas Seppi,,R64,0,0,0,0,0,0,0,0,0,0,0,0,0,0,0,0,0,0,0,0,0,0,0,0,0,0,0
2006-07-24 00:00:00.000,Kitzbuhel Austria ATP World Tour,CLAY,2,Andrei Pavel,N/A Bye,Andrei Pavel,,R64,0,0,0,0,0,0,0,0,0,0,0,0,0,0,0,0,0,0,0,0,0,0,0,0,0,0,0
2006-07-24 00:00:00.000,Kitzbuhel Austria ATP World Tour,CLAY,2,Marcos Daniel,Albert Montanes,Marcos Daniel,6-4; 6-3,R64,79,7,2,46,65,31,46,9,19,4,6,10,40,65,4,4,28,56,16,28,13,28,3,7,9,29,56
2006-07-24 00:00:00.000,Kitzbuhel Austria ATP World Tour,CLAY,2,Jurgen Melzer,Oscar Hernandez,Jurgen Melzer,6-3; 6-4,R64,76,2,3,34,49,29,34,11,15,0,0,10,40,49,2,1,50,69,29,50,11,19,2,4,9,40,69
2006-07-24 00:00:00.000,Kitzbuhel Austria ATP World Tour,CLAY,2,Tommy Robredo,N/A Bye,Tommy Robredo,,R64,0,0,0,0,0,0,0,0,0,0,0,0,0,0,0,0,0,0,0,0,0,0,0,0,0,0,0
2006-07-24 00:00:00.000,Kitzbuhel Austria ATP World Tour,CLAY,2,Nicolas Lapentti,Nikolay Davydenko,Nicolas Lapentti,6-3; 6-3,R32,97,3,1,40,60,31,40,9,20,2,3,9,40,60,2,3,51,72,29,51,8,21,7,11,9,37,72
2006-07-24 00:00:00.000,Kitzbuhel Austria ATP World Tour,CLAY,2,Stefan Koubek,Boris Pashanski,Stefan Koubek,6-1; 3-6; 6-2,R32,0,0,0,0,0,0,0,0,0,0,0,0,0,0,0,0,0,0,0,0,0,0,0,0,0,0,0
2006-07-24 00:00:00.000,Kitzbuhel Austria ATP World Tour,CLAY,2,Max Mirnyi,Andreas Haider-Maurer,Max Mirnyi,6-2; 6-4,R32,63,7,3,21,44,20,21,16,23,0,0,9,36,44,4,5,29,50,20,29,7,21,1,4,9,27,50
2006-07-24 00:00:00.000,Kitzbuhel Austria ATP World Tour,CLAY,2,Fernando Verdasco,Alexander Waske,Fernando Verdasco,6-3; 6-3,R32,70,3,3,39,56,30,39,10,17,1,1,9,40,56,7,1,25,53,17,25,13,28,4,7,9,30,53
2006-07-24 00:00:00.000,Kitzbuhel Austria ATP World Tour,CLAY,2,Gaston Gaudio,Juan Monaco,Gaston Gaudio,7-6(4); 4-1 RET,R32,94,2,2,35,61,24,35,14,26,3,5,9,38,61,1,2,41,63,25,41,8,22,2,5,8,33,63
2006-07-24 00:00:00.000,Kitzbuhel Austria ATP World Tour,CLAY,2,Denis Gremelmayr,Christophe Rochus,Denis Gremelmayr,7-5; 6-1,R32,69,6,3,35,60,26,35,16,25,0,1,10,42,60,3,2,46,57,26,46,3,11,2,6,9,29,57
2006-07-24 00:00:00.000,Kitzbuhel Austria ATP World Tour,CLAY,2,Agustin Calleri,Rainer Eitzinger,Agustin Calleri,7-6(3); 6-3,R32,90,4,3,30,71,20,30,24,41,3,7,11,44,71,0,3,46,69,24,46,9,23,4,9,10,33,69
2006-07-24 00:00:00.000,Kitzbuhel Austria ATP World Tour,CLAY,2,Nicolas Massu,Alex Calatrava,Nicolas Massu,3-6; 7-5; 7-6(3),R32,186,13,4,58,107,47,58,27,49,9,10,16,74,107,9,3,64,114,41,64,36,50,9,10,17,77,114
2006-07-24 00:00:00.000,Kitzbuhel Austria ATP World Tour,CLAY,2,Juan Ignacio Chela,Mariano Zabaleta,Juan Ignacio Chela,6-7(4); 6-3; 6-3,R32,122,7,3,48,84,41,48,22,36,2,3,15,63,84,3,2,38,76,30,38,20,38,0,4,15,50,76
2006-07-24 00:00:00.000,Kitzbuhel Austria ATP World Tour,CLAY,2,Dusan Vemic,Luis Horna,Dusan Vemic,7-6(3); 5-2 RET,R32,90,9,6,41,70,32,41,15,29,3,3,9,47,70,1,6,46,66,32,46,9,20,2,4,10,41,66
2006-07-24 00:00:00.000,Kitzbuhel Austria ATP World Tour,CLAY,2,Philipp Kohlschreiber,Peter Luczak,Philipp Kohlschreiber,7-6(3); 7-5,R32,101,12,3,43,82,36,43,20,39,8,9,12,56,82,4,1,42,73,32,42,15,31,3,5,12,47,73
2006-07-24 00:00:00.000,Kitzbuhel Austria ATP World Tour,CLAY,2,Jarkko Nieminen,Sergio Roitman,Jarkko Nieminen,6-3; 1-6; 6-4,R32,96,2,3,38,80,30,38,17,42,2,6,13,47,80,5,3,57,83,35,57,12,26,6,10,13,47,83
2006-07-24 00:00:00.000,Kitzbuhel Austria ATP World Tour,CLAY,2,Mikhail Youzhny,Martin Vassallo Arguello,Mikhail Youzhny,0-6; 6-4; 7-6(2),R32,117,2,4,49,84,35,49,14,35,2,7,14,49,84,3,1,64,85,44,64,11,21,1,4,14,55,85
2006-07-24 00:00:00.000,Kitzbuhel Austria ATP World Tour,CLAY,2,Edgardo Massa,Andreas Seppi,Edgardo Massa,7-6(5); 7-6(5),R32,130,3,4,44,79,33,44,14,35,2,5,12,47,79,2,9,61,100,40,61,16,39,8,11,12,56,100
2006-07-24 00:00:00.000,Kitzbuhel Austria ATP World Tour,CLAY,2,Andrei Pavel,Marcos Daniel,Andrei Pavel,6-4; 6-4,R32,81,2,0,26,55,20,26,21,29,0,0,10,41,55,3,2,38,64,24,38,15,26,1,3,10,39,64
2006-07-24 00:00:00.000,Kitzbuhel Austria ATP World Tour,CLAY,2,Jurgen Melzer,Tommy Robredo,Jurgen Melzer,6-2; 7-5,R32,79,6,1,36,58,24,36,15,22,2,3,10,39,58,0,1,50,69,30,50,10,19,6,10,10,40,69
2006-07-24 00:00:00.000,Kitzbuhel Austria ATP World Tour,CLAY,2,Nicolas Lapentti,Stefan Koubek,Nicolas Lapentti,6-3; 6-3,R16,96,2,1,40,67,27,40,12,27,6,9,9,39,67,1,7,32,66,19,32,10,34,5,11,9,29,66
2006-07-24 00:00:00.000,Kitzbuhel Austria ATP World Tour,CLAY,2,Fernando Verdasco,Max Mirnyi,Fernando Verdasco,6-4; 7-5,R16,96,5,2,40,55,33,40,12,15,0,0,11,45,55,9,6,48,85,37,48,14,37,7,9,11,51,85
2006-07-24 00:00:00.000,Kitzbuhel Austria ATP World Tour,CLAY,2,Gaston Gaudio,Denis Gremelmayr,Gaston Gaudio,6-7(1); 7-6(7); 6-0,R16,143,3,3,69,111,50,69,16,42,11,14,15,66,111,6,2,55,96,32,55,23,41,5,11,15,55,96
2006-07-24 00:00:00.000,Kitzbuhel Austria ATP World Tour,CLAY,2,Agustin Calleri,Nicolas Massu,Agustin Calleri,6-2; 7-6(4),R16,112,12,2,37,69,28,37,20,32,4,5,10,48,69,2,4,30,74,22,30,20,44,7,10,10,42,74
2006-07-24 00:00:00.000,Kitzbuhel Austria ATP World Tour,CLAY,2,Juan Ignacio Chela,Dusan Vemic,Juan Ignacio Chela,6-4; 6-0,R16,76,3,1,38,55,27,38,11,17,4,4,8,38,55,5,6,30,53,20,30,7,23,6,10,8,27,53
2006-07-24 00:00:00.000,Kitzbuhel Austria ATP World Tour,CLAY,2,Philipp Kohlschreiber,Jarkko Nieminen,Philipp Kohlschreiber,6-2; 4-6; 6-3,R16,90,6,2,42,69,36,42,18,27,1,2,14,54,69,3,4,44,84,30,44,21,40,5,8,13,51,84
2006-07-24 00:00:00.000,Kitzbuhel Austria ATP World Tour,CLAY,2,Mikhail Youzhny,Edgardo Massa,Mikhail Youzhny,6-4; 6-1,R16,67,2,0,30,41,21,30,6,11,3,5,8,27,41,1,7,42,70,20,42,11,28,9,15,9,31,70
2006-07-24 00:00:00.000,Kitzbuhel Austria ATP World Tour,CLAY,2,Jurgen Melzer,Andrei Pavel,Jurgen Melzer,7-5; 6-3,R16,84,8,3,40,63,33,40,14,23,3,3,11,47,63,4,2,42,67,26,42,14,25,3,5,10,40,67
2006-07-24 00:00:00.000,Kitzbuhel Austria ATP World Tour,CLAY,2,Fernando Verdasco,Nicolas Lapentti,Fernando Verdasco,6-4; 6-4,Q,96,3,2,51,65,35,51,7,14,6,7,10,42,65,2,2,49,61,31,49,4,12,1,4,10,35,61
2006-07-24 00:00:00.000,Kitzbuhel Austria ATP World Tour,CLAY,2,Agustin Calleri,Gaston Gaudio,Agustin Calleri,7-5; 6-0,Q,72,11,2,28,44,25,28,8,16,0,1,9,33,44,0,4,29,58,15,29,14,29,6,11,9,29,58
2006-07-24 00:00:00.000,Kitzbuhel Austria ATP World Tour,CLAY,2,Juan Ignacio Chela,Philipp Kohlschreiber,Juan Ignacio Chela,6-4; 6-4,Q,76,6,0,28,49,26,28,11,21,1,3,10,37,49,2,4,35,63,24,35,11,28,2,6,10,35,63
2006-07-24 00:00:00.000,Kitzbuhel Austria ATP World Tour,CLAY,2,Mikhail Youzhny,Jurgen Melzer,Mikhail Youzhny,6-3; 3-6; 6-3,Q,110,5,3,42,83,35,42,24,41,2,3,14,59,83,8,5,51,89,41,51,14,38,5,7,13,55,89
2006-07-24 00:00:00.000,Kitzbuhel Austria ATP World Tour,CLAY,2,Agustin Calleri,Fernando Verdasco,Agustin Calleri,4-6; 6-1; 6-3,S,123,7,7,50,98,38,50,21,48,6,8,13,59,98,3,4,61,87,38,61,9,26,10,15,13,47,87
2006-07-24 00:00:00.000,Kitzbuhel Austria ATP World Tour,CLAY,2,Juan Ignacio Chela,Mikhail Youzhny,Juan Ignacio Chela,6-2; 4-6; 6-4,S,153,3,3,70,117,45,70,24,47,7,10,14,69,117,1,2,52,99,33,52,19,47,6,11,14,52,99
2006-07-24 00:00:00.000,Kitzbuhel Austria ATP World Tour,CLAY,2,Agustin Calleri,Juan Ignacio Chela,Agustin Calleri,7-6(9); 6-2; 6-3,F,143,11,3,43,95,33,43,31,52,3,5,15,64,95,2,4,50,94,32,50,20,44,4,9,14,52,94
2006-07-24 00:00:00.000,Los Angeles CA; U.S.A. ATP World Tour,HARD,2,Andy Roddick,Rik De Voest,Andy Roddick,6-4; 6-4,R32,67,9,0,39,56,32,39,11,17,5,5,10,43,56,3,4,37,67,27,37,15,30,3,5,10,42,67
2006-07-24 00:00:00.000,Los Angeles CA; U.S.A. ATP World Tour,HARD,2,Scott Oudsema,Benjamin Becker,Scott Oudsema,7-5; 6-3,R32,75,17,1,35,65,27,35,17,30,1,2,11,44,65,11,3,22,53,19,22,16,31,3,6,10,35,53
2006-07-24 00:00:00.000,Los Angeles CA; U.S.A. ATP World Tour,HARD,2,Sam Querrey,Vincent Spadea,Sam Querrey,7-5; 6-4,R32,70,8,3,29,60,26,29,15,31,1,2,11,41,60,4,2,31,62,21,31,20,31,2,5,11,41,62
2006-07-24 00:00:00.000,Los Angeles CA; U.S.A. ATP World Tour,HARD,2,Dmitry Tursunov,Danai Udomchoke,Dmitry Tursunov,7-6(5); 7-6(4),R32,118,16,3,43,88,35,43,23,45,3,5,12,58,88,6,5,56,104,41,56,23,48,9,11,12,64,104
2006-07-24 00:00:00.000,Los Angeles CA; U.S.A. ATP World Tour,HARD,2,Fernando Gonzalez,Gilles Muller,Fernando Gonzalez,7-6(5); 7-6(5),R32,88,6,1,54,73,46,54,13,19,1,1,12,59,73,14,3,43,74,36,43,21,31,2,2,12,57,74
2006-07-24 00:00:00.000,Los Angeles CA; U.S.A. ATP World Tour,HARD,2,Marat Safin,Mardy Fish,Marat Safin,6-4; 7-5,R32,80,8,1,43,62,34,43,12,19,3,4,11,46,62,2,1,27,60,21,27,18,33,4,7,11,39,60
2006-07-24 00:00:00.000,Los Angeles CA; U.S.A. ATP World Tour,HARD,2,George Bastl,Nicolas Mahut,George Bastl,6-3; 7-6(1),R32,98,10,3,34,69,24,34,21,35,0,2,11,45,69,4,2,35,59,21,35,11,24,3,6,10,32,59
2006-07-24 00:00:00.000,Los Angeles CA; U.S.A. ATP World Tour,HARD,2,Andre Agassi,Xavier Malisse,Andre Agassi,7-6(10); 6-0,R32,81,6,0,38,63,29,38,16,25,4,5,9,45,63,4,4,39,75,25,39,15,36,4,8,9,40,75
2006-07-24 00:00:00.000,Los Angeles CA; U.S.A. ATP World Tour,HARD,2,Dominik Hrbaty,Zack Fleishman,Dominik Hrbaty,7-5; 7-5,R32,83,8,4,37,68,29,37,21,31,4,5,12,50,68,8,5,37,76,30,37,15,39,4,7,12,45,76
2006-07-24 00:00:00.000,Los Angeles CA; U.S.A. ATP World Tour,HARD,2,Lars Burgsmuller,Michael Yani,Lars Burgsmuller,6-4; 3-6; 6-3,R32,139,5,4,63,101,43,63,17,38,8,12,14,60,101,9,5,50,95,32,50,19,45,4,9,14,51,95
2006-07-24 00:00:00.000,Los Angeles CA; U.S.A. ATP World Tour,HARD,2,Kenneth Carlsen,Paradorn Srichaphan,Kenneth Carlsen,6-2; 5-7; 7-6(3),R32,125,10,2,54,92,41,54,19,38,1,5,16,60,92,10,7,50,89,37,50,19,39,1,6,16,56,89
2006-07-24 00:00:00.000,Los Angeles CA; U.S.A. ATP World Tour,HARD,2,Robby Ginepri,Justin Gimelstob,Robby Ginepri,6-4; 6-4,R32,78,3,2,32,54,24,32,15,22,3,4,10,39,54,6,1,34,67,23,34,16,33,7,10,10,39,67
2006-07-24 00:00:00.000,Los Angeles CA; U.S.A. ATP World Tour,HARD,2,Tommy Haas,Wayne Arthurs,Tommy Haas,6-4; 6-4,R32,59,5,1,31,46,27,31,13,15,0,0,10,40,46,12,1,34,55,27,34,12,21,2,4,10,39,55
2006-07-24 00:00:00.000,Los Angeles CA; U.S.A. ATP World Tour,HARD,2,Paul Capdeville,Arnaud Clement,Paul Capdeville,6-4; 3-6; 6-4,R32,151,6,5,52,94,32,52,16,42,4,10,14,48,94,2,6,52,106,27,52,28,54,9,16,15,55,106
2006-07-24 00:00:00.000,Los Angeles CA; U.S.A. ATP World Tour,HARD,2,Igor Kunitsyn,Janko Tipsarevic,Igor Kunitsyn,4-6; 6-1; 6-2,R32,119,3,3,36,84,27,36,28,48,5,7,13,55,84,3,2,40,93,25,40,24,53,12,17,12,49,93
2006-07-24 00:00:00.000,Los Angeles CA; U.S.A. ATP World Tour,HARD,2,Paul Goldstein,Lleyton Hewitt,Paul Goldstein,6-4; 6-4,R32,83,8,2,39,67,29,39,13,28,6,8,10,42,67,5,3,26,63,17,26,15,37,4,8,10,32,63
2006-07-24 00:00:00.000,Los Angeles CA; U.S.A. ATP World Tour,HARD,2,Andy Roddick,Scott Oudsema,Andy Roddick,6-7(3); 6-3; 6-2,R16,101,21,2,59,83,49,59,14,24,0,0,15,63,83,9,2,53,90,40,53,17,37,1,4,14,57,90
2006-07-24 00:00:00.000,Los Angeles CA; U.S.A. ATP World Tour,HARD,2,Dmitry Tursunov,Sam Querrey,Dmitry Tursunov,7-5; 6-4,R16,79,12,7,43,77,34,43,19,34,2,2,11,53,77,8,2,35,66,22,35,20,31,3,5,11,42,66
2006-07-24 00:00:00.000,Los Angeles CA; U.S.A. ATP World Tour,HARD,2,Fernando Gonzalez,Marat Safin,Fernando Gonzalez,6-4; 7-5,R16,69,3,2,40,53,31,40,8,13,2,2,9,39,53,8,3,41,59,30,41,5,18,5,8,9,35,59
2006-07-24 00:00:00.000,Los Angeles CA; U.S.A. ATP World Tour,HARD,2,Andre Agassi,George Bastl,Andre Agassi,6-7(4); 6-2; 6-1,R16,102,18,2,50,79,44,50,14,29,3,4,14,58,79,6,4,42,81,28,42,16,39,2,7,13,44,81
2006-07-24 00:00:00.000,Los Angeles CA; U.S.A. ATP World Tour,HARD,2,Dominik Hrbaty,Lars Burgsmuller,Dominik Hrbaty,7-5; 6-4,R16,87,6,2,37,69,29,37,13,32,5,8,11,42,69,1,5,33,68,18,33,17,35,4,9,11,35,68
2006-07-24 00:00:00.000,Los Angeles CA; U.S.A. ATP World Tour,HARD,2,Robby Ginepri,Kenneth Carlsen,Robby Ginepri,7-6(5); 3-6; 6-4,R16,124,5,0,64,86,45,64,13,22,4,8,15,58,86,18,2,58,102,49,58,15,44,4,8,16,64,102
2006-07-24 00:00:00.000,Los Angeles CA; U.S.A. ATP World Tour,HARD,2,Tommy Haas,Paul Capdeville,Tommy Haas,6-3; 4-6; 6-1,R16,94,13,4,37,69,31,37,18,32,1,3,13,49,69,2,2,56,79,36,56,7,23,5,10,13,43,79
2006-07-24 00:00:00.000,Los Angeles CA; U.S.A. ATP World Tour,HARD,2,Paul Goldstein,Igor Kunitsyn,Paul Goldstein,6-4; 6-4,R16,85,4,3,35,53,26,35,7,18,2,5,10,33,53,2,1,45,72,23,45,11,27,4,9,10,34,72
2006-07-24 00:00:00.000,Los Angeles CA; U.S.A. ATP World Tour,HARD,2,Dmitry Tursunov,Andy Roddick,Dmitry Tursunov,W/O,Q,0,0,0,0,0,0,0,0,0,0,0,0,0,0,0,0,0,0,0,0,0,0,0,0,0,0,0
2006-07-24 00:00:00.000,Los Angeles CA; U.S.A. ATP World Tour,HARD,2,Fernando Gonzalez,Andre Agassi,Fernando Gonzalez,6-4; 3-6; 7-5,Q,108,7,0,64,84,49,64,12,20,4,5,15,61,84,6,2,43,89,33,43,27,46,3,5,16,60,89
2006-07-24 00:00:00.000,Los Angeles CA; U.S.A. ATP World Tour,HARD,2,Dominik Hrbaty,Robby Ginepri,Dominik Hrbaty,7-6(0); 6-2,Q,80,1,4,38,65,29,38,13,27,2,4,10,42,65,6,2,41,68,26,41,9,27,1,5,10,35,68
2006-07-24 00:00:00.000,Los Angeles CA; U.S.A. ATP World Tour,HARD,2,Tommy Haas,Paul Goldstein,Tommy Haas,6-3; 6-4,Q,85,8,3,39,66,29,39,17,27,3,3,10,46,66,4,1,30,61,23,30,14,31,3,5,9,37,61
2006-07-24 00:00:00.000,Los Angeles CA; U.S.A. ATP World Tour,HARD,2,Dmitry Tursunov,Fernando Gonzalez,Dmitry Tursunov,6-4; 6-2,S,65,6,0,30,49,24,30,12,19,0,0,9,36,49,3,2,37,51,25,37,5,14,1,4,9,30,51
2006-07-24 00:00:00.000,Los Angeles CA; U.S.A. ATP World Tour,HARD,2,Tommy Haas,Dominik Hrbaty,Tommy Haas,6-2; 7-5,S,74,9,1,28,44,27,28,13,16,0,0,10,40,44,3,2,38,67,27,38,13,29,7,10,10,40,67
2006-07-24 00:00:00.000,Los Angeles CA; U.S.A. ATP World Tour,HARD,2,Tommy Haas,Dmitry Tursunov,Tommy Haas,4-6; 7-5; 6-3,F,124,12,5,55,92,47,55,20,37,2,3,16,67,92,10,4,51,92,40,51,22,41,5,7,15,62,92
2006-07-24 00:00:00.000,Umag Croatia ATP World Tour,CLAY,2,Carlos Berlocq,Stefano Galvani,Carlos Berlocq,6-2; 6-2,R32,68,1,0,34,45,24,34,7,11,3,4,8,31,45,0,4,20,42,11,20,7,22,0,5,8,18,42
2006-07-24 00:00:00.000,Umag Croatia ATP World Tour,CLAY,2,Juan-Pablo Guzman,Guillermo Garcia-Lopez,Juan-Pablo Guzman,4-6; 6-3; 6-4,R32,142,1,6,66,108,44,66,22,42,5,7,15,66,108,5,1,53,87,33,53,20,34,8,11,14,53,87
2006-07-24 00:00:00.000,Umag Croatia ATP World Tour,CLAY,2,Simon Greul,Alessio Di Mauro,Simon Greul,7-5; 7-6(5),R32,135,2,5,47,91,35,47,20,44,6,9,12,55,91,1,3,50,88,38,50,14,38,7,11,12,52,88
2006-07-24 00:00:00.000,Umag Croatia ATP World Tour,CLAY,2,Carlos Moya,Jiri Novak,Carlos Moya,6-4; 6-7(6); 7-6(3),R32,153,10,2,60,118,43,60,36,58,7,8,17,79,118,7,3,75,113,54,75,22,38,4,6,17,76,113
2006-07-24 00:00:00.000,Umag Croatia ATP World Tour,CLAY,2,Novak Djokovic,Luka Belic,Novak Djokovic,6-3; 6-3,R32,60,3,2,34,46,25,34,7,12,0,2,9,32,46,3,2,33,53,21,33,8,20,6,11,9,29,53
2006-07-24 00:00:00.000,Umag Croatia ATP World Tour,CLAY,2,Stefano Ianni,Teymuraz Gabashvili,Stefano Ianni,6-6(4) RET,R32,57,3,4,34,51,22,34,8,17,4,6,6,30,51,1,1,21,35,14,21,8,14,2,4,6,22,35
2006-07-24 00:00:00.000,Umag Croatia ATP World Tour,CLAY,2,Jiri Vanek,Santiago Ventura,Jiri Vanek,7-5; 6-4,R32,80,1,1,46,62,33,46,9,16,2,3,11,42,62,1,2,41,71,24,41,20,30,4,7,11,44,71
2006-07-24 00:00:00.000,Umag Croatia ATP World Tour,CLAY,2,Lukas Dlouhy,Julien Benneteau,Lukas Dlouhy,2-6; 6-3; 6-2,R32,110,4,3,53,85,31,53,22,32,5,8,13,53,85,2,5,47,74,33,47,8,27,5,9,12,41,74
2006-07-24 00:00:00.000,Umag Croatia ATP World Tour,CLAY,2,Stanislas Wawrinka,Alberto Martin,Stanislas Wawrinka,7-6(3); 6-4,R32,114,3,3,42,80,29,42,21,38,2,4,11,50,80,2,3,40,79,27,40,20,39,4,7,11,47,79
2006-07-24 00:00:00.000,Umag Croatia ATP World Tour,CLAY,2,Marin Cilic,Evgeny Korolev,Marin Cilic,6-7(5); 6-4; 6-3,R32,167,10,6,53,106,43,53,24,53,5,8,16,67,106,4,8,53,119,38,53,27,66,10,15,15,65,119
2006-07-24 00:00:00.000,Umag Croatia ATP World Tour,CLAY,2,Juan Martin Del Potro,Raemon Sluiter,Juan Martin Del Potro,6-3; 6-2,R32,59,6,3,36,48,30,36,7,12,2,2,9,37,48,2,1,25,42,17,25,8,17,0,3,8,25,42
2006-07-24 00:00:00.000,Umag Croatia ATP World Tour,CLAY,2,Robin Vik,Guillermo Coria,Robin Vik,6-2; 6-3,R32,70,2,6,29,59,17,29,12,30,2,6,9,29,59,1,12,23,49,11,23,5,26,2,9,8,16,49
2006-07-24 00:00:00.000,Umag Croatia ATP World Tour,CLAY,2,Filippo Volandri,Marc Gicquel,Filippo Volandri,6-1 RET,R32,26,1,3,15,22,12,15,3,7,2,3,4,15,22,1,2,10,22,6,10,2,12,3,6,3,8,22
2006-07-24 00:00:00.000,Umag Croatia ATP World Tour,CLAY,2,Ruben Ramirez Hidalgo,Fernando Vicente,Ruben Ramirez Hidalgo,5-7; 6-0; 6-1,R32,96,2,1,44,68,36,44,14,24,6,8,13,50,68,5,1,45,69,27,45,11,24,6,12,12,38,69
2006-07-24 00:00:00.000,Umag Croatia ATP World Tour,CLAY,2,Jan Hernych,Flavio Cipolla,Jan Hernych,6-2; 6-1,R32,72,1,0,41,52,31,41,3,11,2,3,8,34,52,1,2,31,47,14,31,7,16,4,9,7,21,47
2006-07-24 00:00:00.000,Umag Croatia ATP World Tour,CLAY,2,Albert Portas,Juan Carlos Ferrero,Albert Portas,7-6(4); 6-7(5); 7-5,R32,168,15,7,68,121,52,68,21,53,10,14,18,73,121,6,4,93,133,59,93,19,40,6,11,18,78,133
2006-07-24 00:00:00.000,Umag Croatia ATP World Tour,CLAY,2,Juan-Pablo Guzman,Carlos Berlocq,Juan-Pablo Guzman,3-6; 6-3; 6-2,R16,133,0,3,64,90,43,64,15,26,8,10,13,58,90,3,1,53,84,32,53,17,31,4,8,13,49,84
2006-07-24 00:00:00.000,Umag Croatia ATP World Tour,CLAY,2,Carlos Moya,Simon Greul,Carlos Moya,6-2; 6-1,R16,60,4,1,33,57,26,33,9,24,4,6,8,35,57,0,3,19,37,7,19,5,18,2,8,7,12,37
2006-07-24 00:00:00.000,Umag Croatia ATP World Tour,CLAY,2,Novak Djokovic,Stefano Ianni,Novak Djokovic,6-3; 6-4,R16,172,3,1,35,56,29,35,12,21,3,4,10,41,56,0,4,26,57,19,26,13,31,5,8,9,32,57
2006-07-24 00:00:00.000,Umag Croatia ATP World Tour,CLAY,2,Jiri Vanek,Lukas Dlouhy,Jiri Vanek,7-6(4); 6-4,R16,107,7,7,51,82,33,51,14,31,4,8,11,47,82,4,6,56,88,34,56,12,32,12,17,11,46,88
2006-07-24 00:00:00.000,Umag Croatia ATP World Tour,CLAY,2,Stanislas Wawrinka,Marin Cilic,Stanislas Wawrinka,6-4; 2-6; 6-4,R16,139,5,5,65,95,43,65,12,30,11,15,14,55,95,4,3,55,84,38,55,14,29,2,6,14,52,84
2006-07-24 00:00:00.000,Umag Croatia ATP World Tour,CLAY,2,Juan Martin Del Potro,Robin Vik,Juan Martin Del Potro,2-6; 6-4; 6-3,R16,121,3,4,70,94,40,70,11,24,4,9,14,51,94,3,1,46,72,32,46,10,26,1,6,13,42,72
2006-07-24 00:00:00.000,Umag Croatia ATP World Tour,CLAY,2,Filippo Volandri,Ruben Ramirez Hidalgo,Filippo Volandri,4-6; 7-6(4); 7-6(5),R16,183,0,4,74,117,43,74,23,43,2,9,17,66,117,8,7,59,113,44,59,21,54,5,11,17,65,113
2006-07-24 00:00:00.000,Umag Croatia ATP World Tour,CLAY,2,Albert Portas,Jan Hernych,Albert Portas,5-7; 6-4; 6-2,R16,125,5,5,51,93,41,51,19,42,6,9,15,60,93,3,2,56,88,36,56,15,32,6,11,15,51,88
2006-07-24 00:00:00.000,Umag Croatia ATP World Tour,CLAY,2,Carlos Moya,Juan-Pablo Guzman,Carlos Moya,6-1; 6-4,Q,72,2,3,25,50,23,25,13,25,0,1,9,36,50,2,2,31,55,21,31,7,24,3,7,8,28,55
2006-07-24 00:00:00.000,Umag Croatia ATP World Tour,CLAY,2,Novak Djokovic,Jiri Vanek,Novak Djokovic,6-1; 3-6; 7-5,Q,110,6,6,45,80,29,45,18,35,3,8,14,47,80,3,1,52,79,31,52,10,27,3,10,14,41,79
2006-07-24 00:00:00.000,Umag Croatia ATP World Tour,CLAY,2,Stanislas Wawrinka,Juan Martin Del Potro,Stanislas Wawrinka,6-1; 2-6; 6-4,Q,118,2,1,46,81,31,46,19,35,4,7,13,50,81,1,0,57,67,34,57,4,10,1,5,12,38,67
2006-07-24 00:00:00.000,Umag Croatia ATP World Tour,CLAY,2,Filippo Volandri,Albert Portas,Filippo Volandri,7-6(4); 6-4,Q,98,1,3,59,77,36,59,9,18,4,7,11,45,77,8,3,30,67,21,30,19,37,4,8,11,40,67
2006-07-24 00:00:00.000,Umag Croatia ATP World Tour,CLAY,2,Novak Djokovic,Carlos Moya,Novak Djokovic,6-1; 7-5,S,82,0,3,41,61,30,41,11,20,2,3,10,41,61,3,0,30,50,14,30,12,20,2,6,9,26,50
2006-07-24 00:00:00.000,Umag Croatia ATP World Tour,CLAY,2,Stanislas Wawrinka,Filippo Volandri,Stanislas Wawrinka,7-5; 2-6; 6-4,S,124,4,2,42,81,27,42,14,39,3,10,15,41,81,1,1,63,88,34,63,13,25,4,11,15,47,88
2006-07-24 00:00:00.000,Umag Croatia ATP World Tour,CLAY,2,Stanislas Wawrinka,Novak Djokovic,Stanislas Wawrinka,6-6(1) RET,F,73,0,1,26,45,17,26,9,19,3,5,6,26,45,0,1,29,45,20,29,7,16,7,9,6,27,45
2006-07-31 00:00:00.000,Sopot Poland ATP World Tour,CLAY,2,Nikolay Davydenko,Christophe Rochus,Nikolay Davydenko,6-1; 6-2,R32,54,6,2,26,41,22,26,10,15,0,0,8,32,41,0,1,33,49,19,33,4,16,1,5,7,23,49
2006-07-31 00:00:00.000,Sopot Poland ATP World Tour,CLAY,2,Juan Monaco,Jurgen Melzer,Juan Monaco,2-6; 7-6(2); 6-4,R32,138,1,3,68,89,43,68,7,21,2,9,15,50,89,7,4,72,119,43,72,19,47,12,18,15,62,119
2006-07-31 00:00:00.000,Sopot Poland ATP World Tour,CLAY,2,Carlos Berlocq,Philipp Kohlschreiber,Carlos Berlocq,6-0; 6-2,R32,60,5,0,34,47,27,34,5,13,1,1,7,32,47,1,2,22,44,10,22,8,22,3,8,7,18,44
2006-07-31 00:00:00.000,Sopot Poland ATP World Tour,CLAY,2,Lukas Dlouhy,Ruben Ramirez Hidalgo,Lukas Dlouhy,6-4; 6-2,R32,63,4,1,29,54,23,29,15,25,1,1,9,38,54,1,1,33,50,20,33,9,17,0,3,9,29,50
2006-07-31 00:00:00.000,Sopot Poland ATP World Tour,CLAY,2,Gaston Gaudio,Boris Pashanski,Gaston Gaudio,6-1; 6-7(4); 6-4,R32,141,6,4,69,94,46,69,16,25,5,8,15,62,94,2,7,45,101,30,45,24,56,8,14,14,54,101
2006-07-31 00:00:00.000,Sopot Poland ATP World Tour,CLAY,2,Oliver Marach,Alexander Waske,Oliver Marach,6-4; 7-6(6),R32,100,5,2,36,73,29,36,21,37,2,3,11,50,73,14,4,38,67,31,38,13,29,2,4,11,44,67
2006-07-31 00:00:00.000,Sopot Poland ATP World Tour,CLAY,2,Guillermo Garcia-Lopez,Mariano Zabaleta,Guillermo Garcia-Lopez,7-6(4); 7-5,R32,131,1,3,51,75,34,51,15,24,1,4,12,49,75,5,2,82,118,51,82,12,36,17,21,12,63,118
2006-07-31 00:00:00.000,Sopot Poland ATP World Tour,CLAY,2,Filippo Volandri,Daniel Gimeno-Traver,Filippo Volandri,6-4; 6-1,R32,60,0,1,35,46,27,35,7,11,1,2,9,34,46,1,2,22,48,16,22,8,26,3,7,8,24,48
2006-07-31 00:00:00.000,Sopot Poland ATP World Tour,CLAY,2,Agustin Calleri,Hugo Armando,Agustin Calleri,6-4; 2-6; 7-6(4),R32,132,8,4,58,97,43,58,19,39,6,9,15,62,97,1,1,83,112,54,83,16,29,11,13,15,70,112
2006-07-31 00:00:00.000,Sopot Poland ATP World Tour,CLAY,2,Raemon Sluiter,Grzegorz Panfil,Raemon Sluiter,6-1; 6-3,R32,65,9,3,21,47,18,21,16,26,2,2,7,34,47,4,0,28,45,15,28,7,17,0,4,8,22,45
2006-07-31 00:00:00.000,Sopot Poland ATP World Tour,CLAY,2,Jiri Vanek,Alessio Di Mauro,Jiri Vanek,7-6(3); 6-0,R32,96,0,3,43,55,30,43,4,12,0,2,9,34,55,3,2,39,70,22,39,12,31,5,10,9,34,70
2006-07-31 00:00:00.000,Sopot Poland ATP World Tour,CLAY,2,Michal Przysiezny,Guillermo Coria,Michal Przysiezny,5-6 RET,R32,66,0,2,24,43,12,24,7,19,7,11,6,19,43,0,9,22,37,13,22,4,15,2,5,5,17,37
2006-07-31 00:00:00.000,Sopot Poland ATP World Tour,CLAY,2,Juan Ignacio Chela,Adrian Garcia,Juan Ignacio Chela,6-3; 6-2,R32,78,5,0,44,66,34,44,12,22,2,2,9,46,66,1,0,28,52,16,28,12,24,2,5,8,28,52
2006-07-31 00:00:00.000,Sopot Poland ATP World Tour,CLAY,2,Martin Vassallo Arguello,Marcos Daniel,Martin Vassallo Arguello,6-4; 2-0 RET,R32,80,2,0,17,26,15,17,5,9,0,1,6,20,26,0,3,33,56,18,33,10,23,6,9,6,28,56
2006-07-31 00:00:00.000,Sopot Poland ATP World Tour,CLAY,2,Florian Mayer,Lukasz Kubot,Florian Mayer,6-1; 6-2,R32,52,8,1,26,41,23,26,9,15,0,0,8,32,41,0,7,24,46,13,24,7,22,5,9,7,20,46
2006-07-31 00:00:00.000,Sopot Poland ATP World Tour,CLAY,2,Tommy Robredo,Ivo Minar,Tommy Robredo,7-6(5); 3-6; 6-4,R32,143,1,1,71,99,43,71,12,28,3,8,15,55,99,2,1,86,129,54,86,17,43,10,15,16,71,129
2006-07-31 00:00:00.000,Sopot Poland ATP World Tour,CLAY,2,Nikolay Davydenko,Juan Monaco,Nikolay Davydenko,7-5; 6-7(7); 6-1,R16,165,4,2,74,104,55,74,14,30,4,6,15,69,104,3,4,81,122,53,81,17,41,14,20,16,70,122
2006-07-31 00:00:00.000,Sopot Poland ATP World Tour,CLAY,2,Carlos Berlocq,Lukas Dlouhy,Carlos Berlocq,5-7; 7-5; 6-0,R16,121,0,0,81,95,48,81,9,14,1,4,15,57,95,6,4,54,85,34,54,15,31,2,8,15,49,85
2006-07-31 00:00:00.000,Sopot Poland ATP World Tour,CLAY,2,Oliver Marach,Gaston Gaudio,Oliver Marach,5-7; 6-4; 7-6(4),R16,161,11,3,61,111,42,61,25,50,4,8,17,67,111,5,3,66,102,48,66,17,36,0,4,17,65,102
2006-07-31 00:00:00.000,Sopot Poland ATP World Tour,CLAY,2,Filippo Volandri,Guillermo Garcia-Lopez,Filippo Volandri,6-3; 3-6; 6-4,R16,117,0,3,83,99,51,83,7,16,6,9,14,58,99,3,4,56,87,34,56,18,31,3,7,14,52,87
2006-07-31 00:00:00.000,Sopot Poland ATP World Tour,CLAY,2,Agustin Calleri,Raemon Sluiter,Agustin Calleri,6-4; 6-4,R16,75,9,2,35,64,29,35,15,29,5,5,10,44,64,1,2,22,54,16,22,20,32,0,2,10,36,54
2006-07-31 00:00:00.000,Sopot Poland ATP World Tour,CLAY,2,Michal Przysiezny,Jiri Vanek,Michal Przysiezny,6-3; 6-1,R16,66,1,1,32,49,21,32,12,17,0,1,8,33,49,3,1,40,51,18,40,5,11,3,8,8,23,51
2006-07-31 00:00:00.000,Sopot Poland ATP World Tour,CLAY,2,Juan Ignacio Chela,Martin Vassallo Arguello,Juan Ignacio Chela,6-2; 6-1,R16,75,1,0,19,37,15,19,14,18,1,1,7,29,37,0,0,43,52,21,43,3,9,3,8,8,24,52
2006-07-31 00:00:00.000,Sopot Poland ATP World Tour,CLAY,2,Florian Mayer,Tommy Robredo,Florian Mayer,6-2; 6-4,R16,70,4,1,35,58,27,35,10,23,5,7,9,37,58,1,0,34,53,16,34,9,19,3,8,9,25,53
2006-07-31 00:00:00.000,Sopot Poland ATP World Tour,CLAY,2,Nikolay Davydenko,Carlos Berlocq,Nikolay Davydenko,6-0; 6-4,Q,77,2,1,33,42,26,33,6,9,0,0,8,32,42,2,0,36,62,19,36,12,26,4,8,8,31,62
2006-07-31 00:00:00.000,Sopot Poland ATP World Tour,CLAY,2,Filippo Volandri,Oliver Marach,Filippo Volandri,6-2; 6-3,Q,88,0,0,47,58,26,47,6,11,6,9,8,32,58,0,4,28,72,14,28,17,44,12,19,9,31,72
2006-07-31 00:00:00.000,Sopot Poland ATP World Tour,CLAY,2,Agustin Calleri,Michal Przysiezny,Agustin Calleri,6-4; 6-2,Q,89,5,2,31,50,26,31,11,19,1,1,9,37,50,2,2,33,63,21,33,14,30,4,7,9,35,63
2006-07-31 00:00:00.000,Sopot Poland ATP World Tour,CLAY,2,Florian Mayer,Juan Ignacio Chela,Florian Mayer,6-4; 6-0,Q,61,4,1,31,43,23,31,9,12,0,0,8,32,43,1,3,32,59,17,32,13,27,7,11,8,30,59
2006-07-31 00:00:00.000,Sopot Poland ATP World Tour,CLAY,2,Nikolay Davydenko,Filippo Volandri,Nikolay Davydenko,6-2; 6-4,S,73,1,1,42,60,30,42,5,18,5,8,9,35,60,0,1,39,59,18,39,6,20,5,11,9,24,59
2006-07-31 00:00:00.000,Sopot Poland ATP World Tour,CLAY,2,Florian Mayer,Agustin Calleri,Florian Mayer,6-2; 4-3 RET,S,56,2,1,22,33,20,22,9,11,0,0,7,29,33,4,1,39,58,28,39,4,19,5,8,8,32,58
2006-07-31 00:00:00.000,Sopot Poland ATP World Tour,CLAY,2,Nikolay Davydenko,Florian Mayer,Nikolay Davydenko,7-6(6); 5-7; 6-4,F,154,2,1,66,106,37,66,25,40,6,11,17,62,106,5,4,87,138,58,87,18,51,11,16,17,76,138
2006-07-31 00:00:00.000,Washington DC; U.S.A. ATP World Tour,HARD,2,James Blake,N/A Bye,James Blake,,R64,0,0,0,0,0,0,0,0,0,0,0,0,0,0,0,0,0,0,0,0,0,0,0,0,0,0,0
2006-07-31 00:00:00.000,Washington DC; U.S.A. ATP World Tour,HARD,2,Kevin Kim,Scott Oudsema,Kevin Kim,6-1; 6-3,R64,61,3,1,21,36,21,21,11,15,0,0,8,32,36,3,4,29,50,20,29,4,21,5,9,8,24,50
2006-07-31 00:00:00.000,Washington DC; U.S.A. ATP World Tour,HARD,2,Marat Safin,Igor Kunitsyn,Marat Safin,6-3; 7-6(6),R64,81,10,4,40,70,34,40,21,30,2,2,11,55,70,1,3,37,64,30,37,15,27,3,4,10,45,64
2006-07-31 00:00:00.000,Washington DC; U.S.A. ATP World Tour,HARD,2,Nicolas Mahut,N/A Bye,Nicolas Mahut,,R64,0,0,0,0,0,0,0,0,0,0,0,0,0,0,0,0,0,0,0,0,0,0,0,0,0,0,0
2006-07-31 00:00:00.000,Washington DC; U.S.A. ATP World Tour,HARD,2,Paradorn Srichaphan,N/A Bye,Paradorn Srichaphan,,R64,0,0,0,0,0,0,0,0,0,0,0,0,0,0,0,0,0,0,0,0,0,0,0,0,0,0,0
2006-07-31 00:00:00.000,Washington DC; U.S.A. ATP World Tour,HARD,2,Kenneth Carlsen,Danai Udomchoke,Kenneth Carlsen,6-1; 6-2,R64,72,10,2,25,51,22,25,14,26,4,4,8,36,51,3,3,31,51,17,31,7,20,3,7,7,24,51
2006-07-31 00:00:00.000,Washington DC; U.S.A. ATP World Tour,HARD,2,Wesley Moodie,Sam Querrey,Wesley Moodie,2-6; 7-6(4); 7-6(6),R64,136,10,1,71,105,52,71,20,34,3,5,16,72,105,19,4,61,111,50,61,28,50,5,5,16,78,111
2006-07-31 00:00:00.000,Washington DC; U.S.A. ATP World Tour,HARD,2,Sebastien Grosjean,N/A Bye,Sebastien Grosjean,,R64,0,0,0,0,0,0,0,0,0,0,0,0,0,0,0,0,0,0,0,0,0,0,0,0,0,0,0
2006-07-31 00:00:00.000,Washington DC; U.S.A. ATP World Tour,HARD,2,Lleyton Hewitt,N/A Bye,Lleyton Hewitt,,R64,0,0,0,0,0,0,0,0,0,0,0,0,0,0,0,0,0,0,0,0,0,0,0,0,0,0,0
2006-07-31 00:00:00.000,Washington DC; U.S.A. ATP World Tour,HARD,2,Vincent Spadea,Roko Karanusic,Vincent Spadea,7-5; 1-0 RET,R64,43,4,3,24,36,21,24,3,12,0,2,7,24,36,1,1,26,38,13,26,7,12,3,6,6,20,38
2006-07-31 00:00:00.000,Washington DC; U.S.A. ATP World Tour,HARD,2,Denis Gremelmayr,Wesley Whitehouse,Denis Gremelmayr,6-2; 6-2,R64,52,6,1,32,42,25,32,6,10,2,3,8,31,42,3,3,26,43,14,26,2,17,0,5,8,16,43
2006-07-31 00:00:00.000,Washington DC; U.S.A. ATP World Tour,HARD,2,Bjorn Phau,N/A Bye,Bjorn Phau,,R64,0,0,0,0,0,0,0,0,0,0,0,0,0,0,0,0,0,0,0,0,0,0,0,0,0,0,0
2006-07-31 00:00:00.000,Washington DC; U.S.A. ATP World Tour,HARD,2,Arnaud Clement,N/A Bye,Arnaud Clement,,R64,0,0,0,0,0,0,0,0,0,0,0,0,0,0,0,0,0,0,0,0,0,0,0,0,0,0,0
2006-07-31 00:00:00.000,Washington DC; U.S.A. ATP World Tour,HARD,2,Ryan Sweeting,Justin Gimelstob,Ryan Sweeting,7-6(7); 6-2,R64,99,7,0,35,67,27,35,21,32,6,6,10,48,67,8,3,38,71,28,38,16,33,4,6,10,44,71
2006-07-31 00:00:00.000,Washington DC; U.S.A. ATP World Tour,HARD,2,Gilles Muller,Paul Capdeville,Gilles Muller,3-6; 7-6(7); 4-0 RET,R64,116,15,9,50,84,41,50,14,34,1,2,12,55,84,7,3,55,91,38,55,18,36,4,6,13,56,91
2006-07-31 00:00:00.000,Washington DC; U.S.A. ATP World Tour,HARD,2,Dominik Hrbaty,N/A Bye,Dominik Hrbaty,,R64,0,0,0,0,0,0,0,0,0,0,0,0,0,0,0,0,0,0,0,0,0,0,0,0,0,0,0
2006-07-31 00:00:00.000,Washington DC; U.S.A. ATP World Tour,HARD,2,Andy Murray,N/A Bye,Andy Murray,,R64,0,0,0,0,0,0,0,0,0,0,0,0,0,0,0,0,0,0,0,0,0,0,0,0,0,0,0
2006-07-31 00:00:00.000,Washington DC; U.S.A. ATP World Tour,HARD,2,Ramon Delgado,Peter Luczak,Ramon Delgado,6-4; 6-4,R64,89,17,2,39,64,32,39,14,25,0,0,10,46,64,6,1,32,62,23,32,16,30,2,4,10,39,62
2006-07-31 00:00:00.000,Washington DC; U.S.A. ATP World Tour,HARD,2,Teymuraz Gabashvili,Jean-Christophe Faurel,Teymuraz Gabashvili,6-3; 6-3,R64,68,9,1,23,47,21,23,16,24,0,0,9,37,47,3,2,41,66,27,41,11,25,3,6,9,38,66
2006-07-31 00:00:00.000,Washington DC; U.S.A. ATP World Tour,HARD,2,Feliciano Lopez,N/A Bye,Feliciano Lopez,,R64,0,0,0,0,0,0,0,0,0,0,0,0,0,0,0,0,0,0,0,0,0,0,0,0,0,0,0
2006-07-31 00:00:00.000,Washington DC; U.S.A. ATP World Tour,HARD,2,Mardy Fish,N/A Bye,Mardy Fish,,R64,0,0,0,0,0,0,0,0,0,0,0,0,0,0,0,0,0,0,0,0,0,0,0,0,0,0,0
2006-07-31 00:00:00.000,Washington DC; U.S.A. ATP World Tour,HARD,2,Tomas Zib,Jean-Rene Lisnard,Tomas Zib,7-5; 6-4,R64,107,9,2,43,77,31,43,17,34,6,8,11,48,77,5,6,31,63,24,31,14,32,2,6,11,38,63
2006-07-31 00:00:00.000,Washington DC; U.S.A. ATP World Tour,HARD,2,Andrea Stoppini,Paul Goldstein,Andrea Stoppini,6-3; 6-2,R64,73,4,3,38,62,27,38,8,24,5,8,9,35,62,3,4,31,56,13,31,10,25,4,10,8,23,56
2006-07-31 00:00:00.000,Washington DC; U.S.A. ATP World Tour,HARD,2,Andre Agassi,N/A Bye,Andre Agassi,,R64,0,0,0,0,0,0,0,0,0,0,0,0,0,0,0,0,0,0,0,0,0,0,0,0,0,0,0
2006-07-31 00:00:00.000,Washington DC; U.S.A. ATP World Tour,HARD,2,Dmitry Tursunov,N/A Bye,Dmitry Tursunov,,R64,0,0,0,0,0,0,0,0,0,0,0,0,0,0,0,0,0,0,0,0,0,0,0,0,0,0,0
2006-07-31 00:00:00.000,Washington DC; U.S.A. ATP World Tour,HARD,2,Edgardo Massa,Somdev Devvarman,Edgardo Massa,6-4; 6-0,R64,74,5,5,24,46,20,24,10,22,2,4,8,30,46,0,1,40,66,19,40,9,26,9,15,8,28,66
2006-07-31 00:00:00.000,Washington DC; U.S.A. ATP World Tour,HARD,2,Hyung-Taik Lee,Frank Dancevic,Hyung-Taik Lee,2-6; 6-3; 6-2,R64,86,4,2,47,75,36,47,12,28,6,9,13,48,75,6,4,33,66,22,33,18,33,2,6,12,40,66
2006-07-31 00:00:00.000,Washington DC; U.S.A. ATP World Tour,HARD,2,Julien Benneteau,N/A Bye,Julien Benneteau,,R64,0,0,0,0,0,0,0,0,0,0,0,0,0,0,0,0,0,0,0,0,0,0,0,0,0,0,0
2006-07-31 00:00:00.000,Washington DC; U.S.A. ATP World Tour,HARD,2,Tim Henman,N/A Bye,Tim Henman,,R64,0,0,0,0,0,0,0,0,0,0,0,0,0,0,0,0,0,0,0,0,0,0,0,0,0,0,0
2006-07-31 00:00:00.000,Washington DC; U.S.A. ATP World Tour,HARD,2,Phillip King,Bobby Reynolds,Phillip King,7-6(5); 3-6; 6-3,R64,133,10,4,46,97,37,46,22,51,6,11,15,59,97,7,10,56,109,40,56,25,53,6,11,15,65,109
2006-07-31 00:00:00.000,Washington DC; U.S.A. ATP World Tour,HARD,2,Janko Tipsarevic,Michael Venus,Janko Tipsarevic,6-2; 6-1,R64,51,3,1,20,33,19,20,9,13,0,0,7,28,33,5,2,26,55,17,26,8,29,4,9,8,25,55
2006-07-31 00:00:00.000,Washington DC; U.S.A. ATP World Tour,HARD,2,Jan-Michael Gambill,N/A Bye,Jan-Michael Gambill,,R64,0,0,0,0,0,0,0,0,0,0,0,0,0,0,0,0,0,0,0,0,0,0,0,0,0,0,0
2006-07-31 00:00:00.000,Washington DC; U.S.A. ATP World Tour,HARD,2,James Blake,Kevin Kim,James Blake,7-5; 3-6; 6-2,R32,107,4,4,46,90,32,46,21,44,3,8,15,53,90,3,5,37,90,28,37,23,53,7,13,14,51,90
2006-07-31 00:00:00.000,Washington DC; U.S.A. ATP World Tour,HARD,2,Marat Safin,Nicolas Mahut,Marat Safin,6-3; 5-7; 6-4,R32,128,12,3,53,86,44,53,20,33,1,2,16,64,86,12,8,55,94,44,55,18,39,3,5,15,62,94
2006-07-31 00:00:00.000,Washington DC; U.S.A. ATP World Tour,HARD,2,Kenneth Carlsen,Paradorn Srichaphan,Kenneth Carlsen,4-6; 7-6(6); 6-3,R32,147,10,2,60,92,51,60,14,32,3,5,16,65,92,7,9,45,108,32,45,36,63,5,7,15,68,108
2006-07-31 00:00:00.000,Washington DC; U.S.A. ATP World Tour,HARD,2,Wesley Moodie,Sebastien Grosjean,Wesley Moodie,6-4; 3-6; 6-3,R32,111,7,2,52,74,44,52,11,22,0,1,14,55,74,7,2,44,82,31,44,21,38,4,6,14,52,82
2006-07-31 00:00:00.000,Washington DC; U.S.A. ATP World Tour,HARD,2,Lleyton Hewitt,Vincent Spadea,Lleyton Hewitt,6-7(3); 7-6(5); 6-4,R32,152,10,5,53,105,42,53,25,52,2,6,17,67,105,4,7,67,121,44,67,29,54,11,16,17,73,121
2006-07-31 00:00:00.000,Washington DC; U.S.A. ATP World Tour,HARD,2,Denis Gremelmayr,Bjorn Phau,Denis Gremelmayr,6-4; 6-3,R32,74,5,3,35,67,27,35,16,32,4,5,10,43,67,1,5,22,54,16,22,13,32,3,6,9,29,54
2006-07-31 00:00:00.000,Washington DC; U.S.A. ATP World Tour,HARD,2,Arnaud Clement,Ryan Sweeting,Arnaud Clement,6-2; 6-1,R32,60,5,4,29,58,25,29,15,29,5,5,8,40,58,2,2,18,38,8,18,11,20,2,6,7,19,38
2006-07-31 00:00:00.000,Washington DC; U.S.A. ATP World Tour,HARD,2,Dominik Hrbaty,Gilles Muller,Dominik Hrbaty,4-6; 6-4; 6-3,R32,110,5,4,64,98,48,64,16,34,9,11,14,64,98,21,4,51,85,39,51,16,34,3,7,15,55,85
2006-07-31 00:00:00.000,Washington DC; U.S.A. ATP World Tour,HARD,2,Andy Murray,Ramon Delgado,Andy Murray,6-4; 6-3,R32,92,13,6,33,72,26,33,16,39,2,4,9,42,72,4,4,32,56,17,32,11,24,3,8,10,28,56
2006-07-31 00:00:00.000,Washington DC; U.S.A. ATP World Tour,HARD,2,Feliciano Lopez,Teymuraz Gabashvili,Feliciano Lopez,6-4; 6-4,R32,98,11,1,39,72,29,39,18,33,2,3,10,47,72,6,6,27,63,19,27,19,36,5,8,10,38,63
2006-07-31 00:00:00.000,Washington DC; U.S.A. ATP World Tour,HARD,2,Mardy Fish,Tomas Zib,Mardy Fish,6-4; 6-4,R32,82,13,2,24,52,23,24,18,28,1,1,10,41,52,6,5,38,68,27,38,15,30,3,5,10,42,68
2006-07-31 00:00:00.000,Washington DC; U.S.A. ATP World Tour,HARD,2,Andrea Stoppini,Andre Agassi,Andrea Stoppini,6-4; 6-3,R32,61,8,0,35,57,30,35,13,22,4,4,10,43,57,6,7,27,60,20,27,16,33,6,8,9,36,60
2006-07-31 00:00:00.000,Washington DC; U.S.A. ATP World Tour,HARD,2,Dmitry Tursunov,Edgardo Massa,Dmitry Tursunov,3-6; 6-1; 3-3 RET,R32,84,14,4,33,66,28,33,15,33,1,3,11,43,66,2,3,45,71,29,45,11,26,8,11,11,40,71
2006-07-31 00:00:00.000,Washington DC; U.S.A. ATP World Tour,HARD,2,Hyung-Taik Lee,Julien Benneteau,Hyung-Taik Lee,6-3; 6-4,R32,87,6,1,36,61,26,36,16,25,4,5,10,42,61,8,6,40,68,28,40,9,28,6,9,9,37,68
2006-07-31 00:00:00.000,Washington DC; U.S.A. ATP World Tour,HARD,2,Tim Henman,Phillip King,Tim Henman,6-7(3); 6-3; 7-5,R32,153,10,3,62,109,51,62,29,47,4,4,17,80,109,9,1,53,101,39,53,32,48,4,6,16,71,101
2006-07-31 00:00:00.000,Washington DC; U.S.A. ATP World Tour,HARD,2,Jan-Michael Gambill,Janko Tipsarevic,Jan-Michael Gambill,2-6; 6-3; 6-0,R32,90,17,6,44,75,33,44,17,31,6,8,12,50,75,6,8,30,68,22,30,16,38,4,8,11,38,68
2006-07-31 00:00:00.000,Washington DC; U.S.A. ATP World Tour,HARD,2,Marat Safin,James Blake,Marat Safin,7-6(6); 7-6(5),R16,113,10,2,49,89,37,49,17,40,2,5,12,54,89,3,6,52,93,39,52,14,41,6,9,12,53,93
2006-07-31 00:00:00.000,Washington DC; U.S.A. ATP World Tour,HARD,2,Wesley Moodie,Kenneth Carlsen,Wesley Moodie,6-3; 6-7(5); 7-6(6),R16,173,17,3,100,135,72,100,17,35,7,8,17,89,135,13,4,59,109,47,59,26,50,5,7,16,73,109
2006-07-31 00:00:00.000,Washington DC; U.S.A. ATP World Tour,HARD,2,Lleyton Hewitt,Denis Gremelmayr,Lleyton Hewitt,6-1; 6-4,R16,62,5,0,22,38,18,22,14,16,0,0,8,32,38,5,1,32,64,19,32,15,32,6,10,9,34,64
2006-07-31 00:00:00.000,Washington DC; U.S.A. ATP World Tour,HARD,2,Arnaud Clement,Dominik Hrbaty,Arnaud Clement,6-3; 6-2,R16,74,9,2,37,58,28,37,12,21,2,2,9,40,58,2,2,25,50,14,25,14,25,2,5,8,28,50
2006-07-31 00:00:00.000,Washington DC; U.S.A. ATP World Tour,HARD,2,Andy Murray,Feliciano Lopez,Andy Murray,7-5; 6-2,R16,75,2,6,25,62,22,25,24,37,4,4,10,46,62,6,6,34,58,25,34,10,24,3,6,10,35,58
2006-07-31 00:00:00.000,Washington DC; U.S.A. ATP World Tour,HARD,2,Mardy Fish,Andrea Stoppini,Mardy Fish,6-3; 6-1,R16,54,7,1,20,38,17,20,15,18,0,0,8,32,38,2,3,37,55,16,37,11,18,4,8,8,27,55
2006-07-31 00:00:00.000,Washington DC; U.S.A. ATP World Tour,HARD,2,Dmitry Tursunov,Hyung-Taik Lee,Dmitry Tursunov,6-7(10); 7-5; 6-3,R16,146,14,3,59,114,44,59,34,55,5,7,17,78,114,2,2,87,117,63,87,12,30,9,13,16,75,117
2006-07-31 00:00:00.000,Washington DC; U.S.A. ATP World Tour,HARD,2,Tim Henman,Jan-Michael Gambill,Tim Henman,6-1; 6-3,R16,73,7,0,29,52,22,29,12,23,4,5,8,34,52,6,8,21,57,15,21,12,36,4,9,8,27,57
2006-07-31 00:00:00.000,Washington DC; U.S.A. ATP World Tour,HARD,2,Marat Safin,Wesley Moodie,Marat Safin,7-6(5); 7-6(9),Q,118,7,0,45,76,39,45,25,31,0,0,12,64,76,11,5,70,96,56,70,12,26,3,3,12,68,96
2006-07-31 00:00:00.000,Washington DC; U.S.A. ATP World Tour,HARD,2,Arnaud Clement,Lleyton Hewitt,Arnaud Clement,7-6(1); 6-4,Q,130,11,2,47,91,31,47,25,44,12,14,11,56,91,7,3,34,82,23,34,22,48,5,8,11,45,82
2006-07-31 00:00:00.000,Washington DC; U.S.A. ATP World Tour,HARD,2,Andy Murray,Mardy Fish,Andy Murray,6-2; 6-4,Q,77,0,4,34,59,23,34,15,25,4,5,9,38,59,1,2,24,51,16,24,11,27,2,6,9,27,51
2006-07-31 00:00:00.000,Washington DC; U.S.A. ATP World Tour,HARD,2,Dmitry Tursunov,Tim Henman,Dmitry Tursunov,6-3; 6-2,Q,65,7,4,30,55,24,30,14,25,0,0,9,38,55,2,0,29,54,17,29,14,25,6,9,8,31,54
2006-07-31 00:00:00.000,Washington DC; U.S.A. ATP World Tour,HARD,2,Arnaud Clement,Marat Safin,Arnaud Clement,7-6(5); 7-6(4),S,122,4,1,45,74,36,45,19,29,3,5,12,55,74,9,5,52,90,36,52,19,38,7,9,12,55,90
2006-07-31 00:00:00.000,Washington DC; U.S.A. ATP World Tour,HARD,2,Andy Murray,Dmitry Tursunov,Andy Murray,6-2; 7-5,S,84,1,2,26,58,18,26,20,32,1,2,10,38,58,4,4,32,63,20,32,13,31,5,9,10,33,63
2006-07-31 00:00:00.000,Washington DC; U.S.A. ATP World Tour,HARD,2,Arnaud Clement,Andy Murray,Arnaud Clement,7-6(3); 6-2,F,103,1,2,32,61,22,32,19,29,2,4,10,41,61,9,2,35,67,23,35,14,32,4,8,10,37,67
2006-08-07 00:00:00.000,ATP Masters Series Canada Toronto; Canada ATP World Tour,HARD,2,Roger Federer,Paul-Henri Mathieu,Roger Federer,6-3; 6-4,R64,74,14,0,24,48,21,24,19,24,0,0,10,40,48,2,2,32,60,20,32,16,28,4,6,9,36,60
2006-08-07 00:00:00.000,ATP Masters Series Canada Toronto; Canada ATP World Tour,HARD,2,Sebastien Grosjean,Florent Serra,Sebastien Grosjean,6-3; 6-2,R64,73,3,0,24,53,20,24,18,29,2,3,9,38,53,0,2,26,53,13,26,12,27,1,5,8,25,53
2006-08-07 00:00:00.000,ATP Masters Series Canada Toronto; Canada ATP World Tour,HARD,2,Dmitry Tursunov,Daniele Bracciali,Dmitry Tursunov,4-6; 6-1; 6-4,R64,109,10,1,36,76,30,36,21,40,1,3,14,51,76,5,1,46,84,30,46,21,38,5,9,13,51,84
2006-08-07 00:00:00.000,ATP Masters Series Canada Toronto; Canada ATP World Tour,HARD,2,Tommy Haas,Max Mirnyi,Tommy Haas,6-3; 6-3,R64,73,4,2,33,46,30,33,6,13,0,0,9,36,46,2,3,43,70,27,43,12,27,10,13,9,39,70
2006-08-07 00:00:00.000,ATP Masters Series Canada Toronto; Canada ATP World Tour,HARD,2,Lleyton Hewitt,Juan Ignacio Chela,Lleyton Hewitt,3-6; 6-2; 7-5,R64,156,2,5,58,110,41,58,23,52,10,15,15,64,110,6,1,58,104,39,58,17,46,10,16,14,56,104
2006-08-07 00:00:00.000,ATP Masters Series Canada Toronto; Canada ATP World Tour,HARD,2,Thomas Johansson,Feliciano Lopez,Thomas Johansson,5-7; 6-4; 6-3,R64,122,8,3,60,100,48,60,19,40,9,11,16,67,100,19,6,46,82,40,46,14,36,2,5,15,54,82
2006-08-07 00:00:00.000,ATP Masters Series Canada Toronto; Canada ATP World Tour,HARD,2,Paradorn Srichaphan,Gilles Simon,Paradorn Srichaphan,6-4; 6-2,R64,76,3,3,26,51,22,26,14,25,0,1,9,36,51,2,0,30,62,16,30,15,32,7,11,9,31,62
2006-08-07 00:00:00.000,ATP Masters Series Canada Toronto; Canada ATP World Tour,HARD,2,Xavier Malisse,Nikolay Davydenko,Xavier Malisse,6-3; 7-5,R64,91,5,2,43,66,33,43,13,23,5,6,11,46,66,1,1,41,63,26,41,11,22,1,4,10,37,63
2006-08-07 00:00:00.000,ATP Masters Series Canada Toronto; Canada ATP World Tour,HARD,2,Ivan Ljubicic,Nicolas Almagro,Ivan Ljubicic,7-5; 6-1,R64,88,10,3,33,61,27,33,17,28,3,4,10,44,61,10,5,41,72,26,41,12,31,8,12,9,38,72
2006-08-07 00:00:00.000,ATP Masters Series Canada Toronto; Canada ATP World Tour,HARD,2,Arnaud Clement,Alberto Martin,Arnaud Clement,6-2; 6-1,R64,64,1,1,30,42,26,30,7,12,0,0,8,33,42,3,3,37,61,24,37,6,24,6,10,7,30,61
2006-08-07 00:00:00.000,ATP Masters Series Canada Toronto; Canada ATP World Tour,HARD,2,Juan Carlos Ferrero,Paul Goldstein,Juan Carlos Ferrero,7-5; 6-2,R64,98,9,2,37,66,26,37,16,29,5,7,10,42,66,2,1,40,71,25,40,12,31,6,11,10,37,71
2006-08-07 00:00:00.000,ATP Masters Series Canada Toronto; Canada ATP World Tour,HARD,2,Fernando Gonzalez,Robin Soderling,Fernando Gonzalez,6-3; 4-6; 6-2,R64,117,10,7,65,101,45,65,21,36,7,8,14,66,101,6,1,50,80,33,50,17,30,7,10,13,50,80
2006-08-07 00:00:00.000,ATP Masters Series Canada Toronto; Canada ATP World Tour,HARD,2,Julien Benneteau,Marcos Baghdatis,Julien Benneteau,5-7; 6-2; 6-3,R64,132,2,4,65,94,42,65,17,29,10,14,15,59,94,5,1,40,79,23,40,18,39,4,10,14,41,79
2006-08-07 00:00:00.000,ATP Masters Series Canada Toronto; Canada ATP World Tour,HARD,2,Dominik Hrbaty,Robert Kendrick,Dominik Hrbaty,6-4; 6-4,R64,95,6,4,47,80,31,47,22,33,9,9,10,53,80,10,3,55,89,35,55,17,34,8,10,10,52,89
2006-08-07 00:00:00.000,ATP Masters Series Canada Toronto; Canada ATP World Tour,HARD,2,Jose Acasuso,Bjorn Phau,Jose Acasuso,7-5; 7-6(18),R64,121,4,3,40,86,36,40,31,46,5,5,12,67,86,1,3,43,93,33,43,33,50,4,5,12,66,93
2006-08-07 00:00:00.000,ATP Masters Series Canada Toronto; Canada ATP World Tour,HARD,2,Tommy Robredo,Marat Safin,Tommy Robredo,7-5; 5-7; 6-2,R64,133,4,5,67,106,46,67,17,39,6,10,16,63,106,3,7,37,78,27,37,15,41,1,7,16,42,78
2006-08-07 00:00:00.000,ATP Masters Series Canada Toronto; Canada ATP World Tour,HARD,2,Denis Gremelmayr,Kristof Vliegen,Denis Gremelmayr,7-6(2); 6-2,R64,73,3,0,33,58,25,33,20,25,0,0,10,45,58,5,2,45,67,26,45,16,22,3,5,10,42,67
2006-08-07 00:00:00.000,ATP Masters Series Canada Toronto; Canada ATP World Tour,HARD,2,Carlos Moya,Gaston Gaudio,Carlos Moya,6-1; 6-4,R64,72,8,2,31,60,22,31,20,29,3,3,9,42,60,1,6,41,62,28,41,6,21,5,8,8,34,62
2006-08-07 00:00:00.000,ATP Masters Series Canada Toronto; Canada ATP World Tour,HARD,2,Tim Henman,Jonas Bjorkman,Tim Henman,6-2; 6-3,R64,81,1,0,37,52,25,37,10,15,1,1,8,35,52,1,3,27,56,17,27,13,29,2,6,9,30,56
2006-08-07 00:00:00.000,ATP Masters Series Canada Toronto; Canada ATP World Tour,HARD,2,Andy Murray,David Ferrer,Andy Murray,6-2; 7-6(6),R64,97,7,1,31,68,25,31,18,37,2,4,10,43,68,1,3,43,80,23,43,18,37,10,14,10,41,80
2006-08-07 00:00:00.000,ATP Masters Series Canada Toronto; Canada ATP World Tour,HARD,2,Jarkko Nieminen,Teymuraz Gabashvili,Jarkko Nieminen,6-4; 7-5,R64,76,5,4,41,76,30,41,17,35,8,10,11,47,76,2,2,34,54,22,34,13,20,0,4,11,35,54
2006-08-07 00:00:00.000,ATP Masters Series Canada Toronto; Canada ATP World Tour,HARD,2,Frank Dancevic,Peter Polansky,Frank Dancevic,7-6(3); 6-3,R64,81,8,0,44,69,36,44,15,25,2,2,11,51,69,5,3,53,75,39,53,10,22,7,8,10,49,75
2006-08-07 00:00:00.000,ATP Masters Series Canada Toronto; Canada ATP World Tour,HARD,2,Jan Hernych,Nicolas Mahut,Jan Hernych,6-3; 6-3,R64,81,3,0,34,49,25,34,14,15,2,2,9,39,49,3,3,42,65,26,42,11,23,7,10,9,37,65
2006-08-07 00:00:00.000,ATP Masters Series Canada Toronto; Canada ATP World Tour,HARD,2,Davide Sanguinetti,David Nalbandian,Davide Sanguinetti,6-1; 6-2,R64,59,6,2,26,43,21,26,12,17,1,1,8,33,43,0,2,24,47,10,24,11,23,5,9,7,21,47
2006-08-07 00:00:00.000,ATP Masters Series Canada Toronto; Canada ATP World Tour,HARD,2,James Blake,Philip Bester,James Blake,6-4; 6-1,R64,56,4,2,22,41,18,22,14,19,0,0,8,32,41,1,3,36,57,18,36,11,21,4,8,9,29,57
2006-08-07 00:00:00.000,ATP Masters Series Canada Toronto; Canada ATP World Tour,HARD,2,Richard Gasquet,Fabrice Santoro,Richard Gasquet,6-4; 6-3,R64,70,2,3,30,51,24,30,11,21,0,1,9,35,51,3,5,33,56,24,33,8,23,3,7,10,32,56
2006-08-07 00:00:00.000,ATP Masters Series Canada Toronto; Canada ATP World Tour,HARD,2,Fernando Verdasco,Rajeev Ram,Fernando Verdasco,3-6; 6-1; 6-4,R64,84,5,2,52,68,39,52,11,16,0,1,13,50,68,2,1,51,74,38,51,8,23,0,3,13,46,74
2006-08-07 00:00:00.000,ATP Masters Series Canada Toronto; Canada ATP World Tour,HARD,2,Kevin Kim,Robby Ginepri,Kevin Kim,3-6; 7-5; 6-3,R64,97,3,2,59,86,45,59,15,27,5,7,15,60,86,4,2,53,80,39,53,15,27,0,3,15,54,80
2006-08-07 00:00:00.000,ATP Masters Series Canada Toronto; Canada ATP World Tour,HARD,2,Tomas Berdych,Daniel Nestor,Tomas Berdych,6-4; 7-5,R64,93,4,4,33,55,29,33,12,22,0,1,11,41,55,8,5,38,80,27,38,20,42,4,7,11,47,80
2006-08-07 00:00:00.000,ATP Masters Series Canada Toronto; Canada ATP World Tour,HARD,2,Mikhail Youzhny,Greg Rusedski,Mikhail Youzhny,6-4; 6-2,R64,74,3,2,41,64,33,41,12,23,5,5,9,45,64,2,2,33,51,21,33,9,18,3,6,9,30,51
2006-08-07 00:00:00.000,ATP Masters Series Canada Toronto; Canada ATP World Tour,HARD,2,Hyung-Taik Lee,Alejandro Falla,Hyung-Taik Lee,6-0; 6-7(5); 6-1,R64,109,2,3,49,85,34,49,25,36,5,6,13,59,85,2,2,41,72,25,41,13,31,4,10,12,38,72
2006-08-07 00:00:00.000,ATP Masters Series Canada Toronto; Canada ATP World Tour,HARD,2,Rafael Nadal,Nicolas Massu,Rafael Nadal,6-3; 6-2,R64,109,0,1,33,61,23,33,16,28,7,8,8,39,61,4,5,32,64,23,32,8,32,1,6,9,31,64
2006-08-07 00:00:00.000,ATP Masters Series Canada Toronto; Canada ATP World Tour,HARD,2,Roger Federer,Sebastien Grosjean,Roger Federer,6-3; 6-3,R32,67,3,2,31,56,24,31,16,25,7,8,9,40,56,3,0,29,56,17,29,13,27,3,7,9,30,56
2006-08-07 00:00:00.000,ATP Masters Series Canada Toronto; Canada ATP World Tour,HARD,2,Dmitry Tursunov,Tommy Haas,Dmitry Tursunov,7-5; 2-6; 6-1,R32,112,9,3,44,88,34,44,25,44,3,5,14,59,88,6,7,48,84,33,48,17,36,5,8,13,50,84
2006-08-07 00:00:00.000,ATP Masters Series Canada Toronto; Canada ATP World Tour,HARD,2,Thomas Johansson,Lleyton Hewitt,Thomas Johansson,6-3; 3-2 RET,R32,56,8,2,31,49,24,31,8,18,4,5,7,32,49,6,2,21,42,12,21,11,21,4,7,7,23,42
2006-08-07 00:00:00.000,ATP Masters Series Canada Toronto; Canada ATP World Tour,HARD,2,Xavier Malisse,Paradorn Srichaphan,Xavier Malisse,7-6(3); 6-3,R32,91,1,1,36,70,28,36,23,34,4,4,11,51,70,5,2,34,63,25,34,18,29,1,2,10,43,63
2006-08-07 00:00:00.000,ATP Masters Series Canada Toronto; Canada ATP World Tour,HARD,2,Ivan Ljubicic,Arnaud Clement,Ivan Ljubicic,7-6(6); 6-4,R32,121,10,2,37,73,31,37,19,36,2,3,11,50,73,1,2,47,81,34,47,17,34,4,6,11,51,81
2006-08-07 00:00:00.000,ATP Masters Series Canada Toronto; Canada ATP World Tour,HARD,2,Fernando Gonzalez,Juan Carlos Ferrero,Fernando Gonzalez,6-2; 6-1,R32,58,6,4,25,37,22,25,5,12,0,1,7,27,37,2,2,27,47,12,27,7,20,1,7,8,19,47
2006-08-07 00:00:00.000,ATP Masters Series Canada Toronto; Canada ATP World Tour,HARD,2,Julien Benneteau,Dominik Hrbaty,Julien Benneteau,7-6(2); 5-7; 6-1,R32,149,8,4,71,111,45,71,17,40,7,13,16,62,111,2,6,49,90,26,49,19,41,3,10,15,45,90
2006-08-07 00:00:00.000,ATP Masters Series Canada Toronto; Canada ATP World Tour,HARD,2,Jose Acasuso,Tommy Robredo,Jose Acasuso,2-6; 6-3; 6-4,R32,101,1,3,37,74,32,37,18,37,4,7,14,50,74,7,1,38,66,30,38,13,28,1,4,13,43,66
2006-08-07 00:00:00.000,ATP Masters Series Canada Toronto; Canada ATP World Tour,HARD,2,Carlos Moya,Denis Gremelmayr,Carlos Moya,6-1; 6-4,R32,54,8,0,30,49,26,30,13,19,1,1,9,39,49,3,3,30,53,21,30,9,23,5,8,8,30,53
2006-08-07 00:00:00.000,ATP Masters Series Canada Toronto; Canada ATP World Tour,HARD,2,Andy Murray,Tim Henman,Andy Murray,6-2; 7-6(3),R32,105,0,6,40,72,31,40,10,32,4,7,10,41,72,4,4,53,90,28,53,15,37,12,17,10,43,90
2006-08-07 00:00:00.000,ATP Masters Series Canada Toronto; Canada ATP World Tour,HARD,2,Jarkko Nieminen,Frank Dancevic,Jarkko Nieminen,6-2; 6-3,R32,71,1,0,31,50,21,31,14,19,0,2,9,35,50,1,1,29,50,14,29,9,21,4,9,8,23,50
2006-08-07 00:00:00.000,ATP Masters Series Canada Toronto; Canada ATP World Tour,HARD,2,Davide Sanguinetti,Jan Hernych,Davide Sanguinetti,6-4; 7-6(4),R32,92,5,2,41,78,29,41,20,37,3,6,11,49,78,1,1,49,70,29,49,12,21,4,8,11,41,70
2006-08-07 00:00:00.000,ATP Masters Series Canada Toronto; Canada ATP World Tour,HARD,2,Richard Gasquet,James Blake,Richard Gasquet,6-4; 6-3,R32,73,1,3,37,59,21,37,9,22,4,8,10,30,59,0,0,29,56,16,29,9,27,2,8,9,25,56
2006-08-07 00:00:00.000,ATP Masters Series Canada Toronto; Canada ATP World Tour,HARD,2,Fernando Verdasco,Kevin Kim,Fernando Verdasco,6-3; 6-2,R32,67,6,3,46,60,37,46,5,14,5,5,9,42,60,2,1,30,52,19,30,11,22,1,4,8,30,52
2006-08-07 00:00:00.000,ATP Masters Series Canada Toronto; Canada ATP World Tour,HARD,2,Tomas Berdych,Mikhail Youzhny,Tomas Berdych,7-6(3); 6-4,R32,103,6,1,48,79,34,48,14,31,3,5,11,48,79,7,2,40,72,27,40,16,32,4,7,11,43,72
2006-08-07 00:00:00.000,ATP Masters Series Canada Toronto; Canada ATP World Tour,HARD,2,Rafael Nadal,Hyung-Taik Lee,Rafael Nadal,6-4; 6-3,R32,88,2,1,34,54,26,34,8,20,1,3,9,34,54,1,0,38,61,22,38,8,23,5,10,10,30,61
2006-08-07 00:00:00.000,ATP Masters Series Canada Toronto; Canada ATP World Tour,HARD,2,Roger Federer,Dmitry Tursunov,Roger Federer,6-3; 5-7; 6-0,R16,107,8,1,61,92,45,61,16,31,6,7,14,61,92,1,1,51,82,31,51,17,31,9,13,13,48,82
2006-08-07 00:00:00.000,ATP Masters Series Canada Toronto; Canada ATP World Tour,HARD,2,Xavier Malisse,Thomas Johansson,Xavier Malisse,7-6(7); 6-3,R16,95,3,2,50,73,40,50,13,23,6,7,11,53,73,5,3,46,73,32,46,16,27,6,8,10,48,73
2006-08-07 00:00:00.000,ATP Masters Series Canada Toronto; Canada ATP World Tour,HARD,2,Fernando Gonzalez,Ivan Ljubicic,Fernando Gonzalez,6-4; 6-7(4); 7-6(3),R16,184,7,3,72,115,50,72,30,43,6,7,17,80,115,21,5,81,133,60,81,25,52,9,11,17,85,133
2006-08-07 00:00:00.000,ATP Masters Series Canada Toronto; Canada ATP World Tour,HARD,2,Jose Acasuso,Julien Benneteau,Jose Acasuso,6-3; 7-6(4),R16,94,9,0,32,62,25,32,26,30,3,3,11,51,62,4,2,44,65,35,44,9,21,1,2,10,44,65
2006-08-07 00:00:00.000,ATP Masters Series Canada Toronto; Canada ATP World Tour,HARD,2,Andy Murray,Carlos Moya,Andy Murray,6-2; 6-4,R16,77,0,7,30,55,20,30,14,25,1,3,9,34,55,3,2,30,56,16,30,10,26,3,8,9,26,56
2006-08-07 00:00:00.000,ATP Masters Series Canada Toronto; Canada ATP World Tour,HARD,2,Jarkko Nieminen,Davide Sanguinetti,Jarkko Nieminen,3-6; 6-3; 7-6(10),R16,130,3,2,69,105,42,69,21,36,4,7,15,63,105,6,1,54,103,39,54,21,49,3,6,15,60,103
2006-08-07 00:00:00.000,ATP Masters Series Canada Toronto; Canada ATP World Tour,HARD,2,Richard Gasquet,Fernando Verdasco,Richard Gasquet,6-0; 4-6; 6-2,R16,97,1,2,44,69,31,44,16,25,1,3,12,47,69,4,6,54,76,32,54,7,22,6,12,12,39,76
2006-08-07 00:00:00.000,ATP Masters Series Canada Toronto; Canada ATP World Tour,HARD,2,Tomas Berdych,Rafael Nadal,Tomas Berdych,6-1; 3-6; 6-2,R16,109,3,3,45,72,37,45,13,27,3,4,12,50,72,3,1,45,71,30,45,11,26,2,6,12,41,71
2006-08-07 00:00:00.000,ATP Masters Series Canada Toronto; Canada ATP World Tour,HARD,2,Roger Federer,Xavier Malisse,Roger Federer,7-6(4); 6-7(5); 6-3,Q,147,2,3,70,110,47,70,25,40,5,8,17,72,110,4,2,61,112,41,61,27,51,4,8,16,68,112
2006-08-07 00:00:00.000,ATP Masters Series Canada Toronto; Canada ATP World Tour,HARD,2,Fernando Gonzalez,Jose Acasuso,Fernando Gonzalez,6-1; 7-5,Q,81,3,1,43,63,31,43,13,20,3,4,10,44,63,2,4,37,67,25,37,10,30,8,12,9,35,67
2006-08-07 00:00:00.000,ATP Masters Series Canada Toronto; Canada ATP World Tour,HARD,2,Andy Murray,Jarkko Nieminen,Andy Murray,6-4; 6-7(0); 6-3,Q,148,6,9,41,112,26,41,34,71,9,14,15,60,112,1,6,67,114,40,67,15,47,8,16,16,55,114
2006-08-07 00:00:00.000,ATP Masters Series Canada Toronto; Canada ATP World Tour,HARD,2,Richard Gasquet,Tomas Berdych,Richard Gasquet,6-4; 6-1,Q,65,4,3,24,43,22,24,11,19,0,0,8,33,43,3,2,31,54,17,31,13,23,4,8,9,30,54
2006-08-07 00:00:00.000,ATP Masters Series Canada Toronto; Canada ATP World Tour,HARD,2,Roger Federer,Fernando Gonzalez,Roger Federer,6-1; 5-7; 6-3,S,110,3,3,54,81,39,54,18,27,4,5,14,57,81,1,3,60,88,37,60,17,28,6,10,14,54,88
2006-08-07 00:00:00.000,ATP Masters Series Canada Toronto; Canada ATP World Tour,HARD,2,Richard Gasquet,Andy Murray,Richard Gasquet,6-2; 7-5,S,84,5,3,39,61,32,39,9,22,4,5,10,41,61,1,2,28,61,13,28,20,33,3,7,10,33,61
2006-08-07 00:00:00.000,ATP Masters Series Canada Toronto; Canada ATP World Tour,HARD,2,Roger Federer,Richard Gasquet,Roger Federer,2-6; 6-3; 6-2,F,107,6,4,50,88,37,50,18,38,8,10,13,55,88,2,3,44,77,32,44,15,33,8,11,12,47,77
2006-08-14 00:00:00.000,ATP Masters Series Cincinnati OH; U.S.A. ATP World Tour,HARD,2,Roger Federer,Paradorn Srichaphan,Roger Federer,7-5; 6-4,R64,84,10,3,46,73,35,46,10,27,2,4,11,45,73,5,4,36,70,26,36,12,34,1,5,11,38,70
2006-08-14 00:00:00.000,ATP Masters Series Cincinnati OH; U.S.A. ATP World Tour,HARD,2,Andy Murray,Tim Henman,Andy Murray,4-6; 6-4; 7-5,R64,145,10,5,54,99,41,54,21,45,5,8,16,62,99,5,3,52,96,33,52,24,44,6,10,16,57,96
2006-08-14 00:00:00.000,ATP Masters Series Cincinnati OH; U.S.A. ATP World Tour,HARD,2,Dmitry Tursunov,Sebastien Grosjean,Dmitry Tursunov,4-6; 6-4; 6-3,R64,120,7,2,47,84,34,47,19,37,6,10,14,53,84,3,2,44,89,34,44,14,45,7,13,15,48,89
2006-08-14 00:00:00.000,ATP Masters Series Cincinnati OH; U.S.A. ATP World Tour,HARD,2,Robby Ginepri,Paul-Henri Mathieu,Robby Ginepri,1-6; 6-3; 6-4,R64,110,10,2,61,87,41,61,14,26,6,8,13,55,87,8,4,46,81,36,46,18,35,3,5,13,54,81
2006-08-14 00:00:00.000,ATP Masters Series Cincinnati OH; U.S.A. ATP World Tour,HARD,2,Andy Roddick,Daniele Bracciali,Andy Roddick,6-7(6); 7-6(4); 7-6(5),R64,154,22,3,77,119,61,77,28,42,2,2,18,89,119,19,2,66,122,58,66,33,56,7,7,18,91,122
2006-08-14 00:00:00.000,ATP Masters Series Cincinnati OH; U.S.A. ATP World Tour,HARD,2,Kristof Vliegen,Marc Gicquel,Kristof Vliegen,7-6(7); 7-6(3),R64,115,17,2,57,87,48,57,16,30,2,2,12,64,87,7,2,52,96,40,52,23,44,5,5,12,63,96
2006-08-14 00:00:00.000,ATP Masters Series Cincinnati OH; U.S.A. ATP World Tour,HARD,2,Vincent Spadea,Andreas Seppi,Vincent Spadea,6-4; 6-3,R64,90,1,3,49,94,30,49,25,45,8,9,10,55,94,4,3,34,65,19,34,16,31,7,10,9,35,65
2006-08-14 00:00:00.000,ATP Masters Series Cincinnati OH; U.S.A. ATP World Tour,HARD,2,Juan Ignacio Chela,Nikolay Davydenko,Juan Ignacio Chela,6-4; 2-6; 6-2,R64,100,5,3,49,74,34,49,13,25,3,6,13,47,74,3,1,51,76,34,51,11,25,1,5,13,45,76
2006-08-14 00:00:00.000,ATP Masters Series Cincinnati OH; U.S.A. ATP World Tour,HARD,2,David Nalbandian,Rik De Voest,David Nalbandian,6-0; 6-4,R64,68,1,4,22,45,21,22,13,23,0,0,8,34,45,2,2,22,45,14,22,10,23,1,5,8,24,45
2006-08-14 00:00:00.000,ATP Masters Series Cincinnati OH; U.S.A. ATP World Tour,HARD,2,Stanislas Wawrinka,Jose Acasuso,Stanislas Wawrinka,5-7; 6-4; 6-1,R64,107,8,5,40,76,35,40,20,36,2,4,15,55,76,4,2,29,76,21,29,27,47,2,6,14,48,76
2006-08-14 00:00:00.000,ATP Masters Series Cincinnati OH; U.S.A. ATP World Tour,HARD,2,Mardy Fish,Nicolas Mahut,Mardy Fish,6-1; 6-3,R64,73,12,2,21,42,20,21,12,21,0,0,8,32,42,5,3,30,51,19,30,6,21,3,7,8,25,51
2006-08-14 00:00:00.000,ATP Masters Series Cincinnati OH; U.S.A. ATP World Tour,HARD,2,Fernando Gonzalez,Nicolas Massu,Fernando Gonzalez,6-4; 6-4,R64,82,5,3,46,67,35,46,9,21,3,4,10,44,67,3,3,33,55,24,33,11,22,1,4,10,35,55
2006-08-14 00:00:00.000,ATP Masters Series Cincinnati OH; U.S.A. ATP World Tour,HARD,2,David Ferrer,Carlos Moya,David Ferrer,6-3; 6-1,R64,72,2,1,37,49,27,37,9,12,2,2,8,36,49,3,4,35,74,25,35,12,39,7,11,8,37,74
2006-08-14 00:00:00.000,ATP Masters Series Cincinnati OH; U.S.A. ATP World Tour,HARD,2,Nicolas Almagro,Alberto Martin,Nicolas Almagro,6-3; 6-3,R64,63,10,0,30,48,23,30,11,18,1,2,9,34,48,2,3,34,57,21,34,8,23,2,6,9,29,57
2006-08-14 00:00:00.000,ATP Masters Series Cincinnati OH; U.S.A. ATP World Tour,HARD,2,Gael Monfils,Marat Safin,Gael Monfils,6-4; 7-5,R64,87,3,5,38,84,28,38,27,46,7,7,11,55,84,4,1,33,53,28,33,12,20,1,3,11,40,53
2006-08-14 00:00:00.000,ATP Masters Series Cincinnati OH; U.S.A. ATP World Tour,HARD,2,Marcos Baghdatis,Thomas Johansson,Marcos Baghdatis,7-6(3); 7-6(3),R64,126,10,8,43,88,39,43,25,45,5,5,12,64,88,22,5,58,88,47,58,12,30,4,4,12,59,88
2006-08-14 00:00:00.000,ATP Masters Series Cincinnati OH; U.S.A. ATP World Tour,HARD,2,Tommy Robredo,Richard Gasquet,Tommy Robredo,7-5; 7-5,R64,99,4,2,46,75,37,46,18,29,2,2,12,55,75,2,2,49,78,36,49,14,29,2,4,12,50,78
2006-08-14 00:00:00.000,ATP Masters Series Cincinnati OH; U.S.A. ATP World Tour,HARD,2,Max Mirnyi,Xavier Malisse,Max Mirnyi,7-5; 4-6; 6-3,R64,105,9,2,60,86,49,60,15,26,1,2,16,64,86,6,0,59,90,44,59,15,31,3,5,15,59,90
2006-08-14 00:00:00.000,ATP Masters Series Cincinnati OH; U.S.A. ATP World Tour,HARD,2,Florent Serra,Julien Benneteau,Florent Serra,6-3; 6-3,R64,78,4,2,35,58,27,35,12,23,1,2,9,39,58,2,4,41,61,24,41,7,20,2,6,9,31,61
2006-08-14 00:00:00.000,ATP Masters Series Cincinnati OH; U.S.A. ATP World Tour,HARD,2,Novak Djokovic,Jarkko Nieminen,Novak Djokovic,7-6(5); 6-4,R64,102,5,4,44,82,29,44,25,38,3,3,11,54,82,3,0,51,78,37,51,12,27,1,2,11,49,78
2006-08-14 00:00:00.000,ATP Masters Series Cincinnati OH; U.S.A. ATP World Tour,HARD,2,Dominik Hrbaty,Paul Goldstein,Dominik Hrbaty,6-4; 6-3,R64,71,6,3,30,57,25,30,15,27,4,5,10,40,57,5,2,30,59,21,30,11,29,7,10,9,32,59
2006-08-14 00:00:00.000,ATP Masters Series Cincinnati OH; U.S.A. ATP World Tour,HARD,2,Davide Sanguinetti,Robin Vik,Davide Sanguinetti,6-3; 6-7(4); 6-3,R64,125,15,1,51,86,41,51,17,35,6,8,14,58,86,3,5,68,111,43,68,19,43,9,15,16,62,111
2006-08-14 00:00:00.000,ATP Masters Series Cincinnati OH; U.S.A. ATP World Tour,HARD,2,Mikhail Youzhny,Bjorn Phau,Mikhail Youzhny,6-2; 6-3,R64,60,2,0,23,44,18,23,15,21,0,0,8,33,44,3,4,36,64,19,36,13,28,5,9,9,32,64
2006-08-14 00:00:00.000,ATP Masters Series Cincinnati OH; U.S.A. ATP World Tour,HARD,2,Ivan Ljubicic,Greg Rusedski,Ivan Ljubicic,6-3; 6-4,R64,60,6,1,32,48,30,32,10,16,0,0,10,40,48,5,2,35,51,21,35,11,16,1,3,9,32,51
2006-08-14 00:00:00.000,ATP Masters Series Cincinnati OH; U.S.A. ATP World Tour,HARD,2,James Blake,Fabrice Santoro,James Blake,6-4; 6-4,R64,72,5,1,40,60,31,40,10,20,5,6,10,41,60,5,2,31,54,23,31,10,23,0,3,10,33,54
2006-08-14 00:00:00.000,ATP Masters Series Cincinnati OH; U.S.A. ATP World Tour,HARD,2,Juan Carlos Ferrero,Jonas Bjorkman,Juan Carlos Ferrero,6-6 RET,R64,52,2,0,22,31,21,22,5,9,1,1,6,26,31,1,1,19,34,15,19,11,15,3,3,6,26,34
2006-08-14 00:00:00.000,ATP Masters Series Cincinnati OH; U.S.A. ATP World Tour,HARD,2,Justin Gimelstob,Feliciano Lopez,Justin Gimelstob,6-3; 7-6(4),R64,95,5,3,48,73,38,48,14,25,3,4,11,52,73,6,1,37,72,26,37,19,35,8,10,10,45,72
2006-08-14 00:00:00.000,ATP Masters Series Cincinnati OH; U.S.A. ATP World Tour,HARD,2,Robin Soderling,Tomas Berdych,Robin Soderling,6-4; 6-3,R64,64,4,1,36,58,26,36,14,22,3,4,10,40,58,8,0,34,55,24,34,10,21,3,6,9,34,55
2006-08-14 00:00:00.000,ATP Masters Series Cincinnati OH; U.S.A. ATP World Tour,HARD,2,Tommy Haas,Fernando Verdasco,Tommy Haas,6-3; 6-4,R64,74,8,4,36,57,32,36,10,21,4,4,10,42,57,7,6,49,75,31,49,12,26,5,7,9,43,75
2006-08-14 00:00:00.000,ATP Masters Series Cincinnati OH; U.S.A. ATP World Tour,HARD,2,Gilles Simon,Lukas Dlouhy,Gilles Simon,6-4; 6-4,R64,63,2,3,31,60,22,31,17,29,0,1,10,39,60,2,4,36,57,25,36,9,21,1,4,10,34,57
2006-08-14 00:00:00.000,ATP Masters Series Cincinnati OH; U.S.A. ATP World Tour,HARD,2,Hyung-Taik Lee,Arnaud Clement,Hyung-Taik Lee,6-4; 6-4,R64,92,5,2,38,57,29,38,9,19,5,7,10,38,57,6,2,31,66,21,31,16,35,3,7,10,37,66
2006-08-14 00:00:00.000,ATP Masters Series Cincinnati OH; U.S.A. ATP World Tour,HARD,2,Rafael Nadal,Sam Querrey,Rafael Nadal,6-7(5); 6-2; 6-3,R64,122,4,4,55,88,44,55,21,33,0,0,15,65,88,10,5,42,87,37,42,19,45,5,8,14,56,87
2006-08-14 00:00:00.000,ATP Masters Series Cincinnati OH; U.S.A. ATP World Tour,HARD,2,Andy Murray,Roger Federer,Andy Murray,7-5; 6-4,R32,97,4,3,28,68,17,28,19,40,2,7,11,36,68,6,3,42,76,24,42,13,34,7,14,11,37,76
2006-08-14 00:00:00.000,ATP Masters Series Cincinnati OH; U.S.A. ATP World Tour,HARD,2,Robby Ginepri,Dmitry Tursunov,Robby Ginepri,6-3; 6-4,R32,64,8,1,32,51,28,32,12,19,0,0,10,40,51,8,3,27,55,23,27,13,28,4,6,9,36,55
2006-08-14 00:00:00.000,ATP Masters Series Cincinnati OH; U.S.A. ATP World Tour,HARD,2,Andy Roddick,Kristof Vliegen,Andy Roddick,6-4; 6-4,R32,77,8,1,36,49,33,36,7,13,0,0,10,40,49,9,4,40,68,30,40,12,28,6,8,10,42,68
2006-08-14 00:00:00.000,ATP Masters Series Cincinnati OH; U.S.A. ATP World Tour,HARD,2,Juan Ignacio Chela,Vincent Spadea,Juan Ignacio Chela,6-7(5); 7-5; 6-2,R32,139,5,1,59,100,41,59,22,41,3,7,16,63,100,9,2,62,110,41,62,21,48,8,15,16,62,110
2006-08-14 00:00:00.000,ATP Masters Series Cincinnati OH; U.S.A. ATP World Tour,HARD,2,Stanislas Wawrinka,David Nalbandian,Stanislas Wawrinka,6-4; 6-2,R32,80,4,3,24,57,19,24,21,33,4,4,9,40,57,0,0,30,54,17,30,14,24,2,5,9,31,54
2006-08-14 00:00:00.000,ATP Masters Series Cincinnati OH; U.S.A. ATP World Tour,HARD,2,Fernando Gonzalez,Mardy Fish,Fernando Gonzalez,7-5; 7-5,R32,90,4,0,48,61,35,48,10,13,0,1,12,45,61,12,3,39,82,33,39,16,43,3,6,12,49,82
2006-08-14 00:00:00.000,ATP Masters Series Cincinnati OH; U.S.A. ATP World Tour,HARD,2,David Ferrer,Nicolas Almagro,David Ferrer,4-6; 7-6(1); 6-0,R32,123,2,9,74,120,51,74,22,46,11,13,14,73,120,10,3,38,82,32,38,18,44,3,7,14,50,82
2006-08-14 00:00:00.000,ATP Masters Series Cincinnati OH; U.S.A. ATP World Tour,HARD,2,Marcos Baghdatis,Gael Monfils,Marcos Baghdatis,7-6(8); 2-6; 6-1,R32,138,1,5,34,90,27,34,26,56,3,7,14,53,90,3,7,41,83,30,41,17,42,4,8,13,47,83
2006-08-14 00:00:00.000,ATP Masters Series Cincinnati OH; U.S.A. ATP World Tour,HARD,2,Tommy Robredo,Max Mirnyi,Tommy Robredo,6-4; 6-4,R32,71,0,1,46,57,36,46,7,11,1,1,10,43,57,4,2,35,55,27,35,10,20,2,4,10,37,55
2006-08-14 00:00:00.000,ATP Masters Series Cincinnati OH; U.S.A. ATP World Tour,HARD,2,Florent Serra,Novak Djokovic,Florent Serra,6-4; 6-4,R32,68,3,1,31,56,19,31,19,25,0,1,10,38,56,6,3,33,57,21,33,13,24,1,4,10,34,57
2006-08-14 00:00:00.000,ATP Masters Series Cincinnati OH; U.S.A. ATP World Tour,HARD,2,Dominik Hrbaty,Davide Sanguinetti,Dominik Hrbaty,6-3; 6-2,R32,68,2,3,29,55,22,29,16,26,2,2,9,38,55,5,6,43,72,27,43,11,29,9,12,8,38,72
2006-08-14 00:00:00.000,ATP Masters Series Cincinnati OH; U.S.A. ATP World Tour,HARD,2,Ivan Ljubicic,Mikhail Youzhny,Ivan Ljubicic,6-4; 7-6(5),R32,101,11,3,46,71,37,46,12,25,2,3,11,49,71,5,1,45,76,29,45,19,31,2,4,11,48,76
2006-08-14 00:00:00.000,ATP Masters Series Cincinnati OH; U.S.A. ATP World Tour,HARD,2,Juan Carlos Ferrero,James Blake,Juan Carlos Ferrero,6-2; 6-4,R32,64,3,0,32,51,24,32,13,19,0,0,9,37,51,7,3,26,51,20,26,12,25,5,8,9,32,51
2006-08-14 00:00:00.000,ATP Masters Series Cincinnati OH; U.S.A. ATP World Tour,HARD,2,Robin Soderling,Justin Gimelstob,Robin Soderling,6-3; 2-6; 7-6(6),R32,133,7,2,60,94,40,60,24,34,6,8,15,64,94,10,2,65,105,51,65,18,40,7,8,14,69,105
2006-08-14 00:00:00.000,ATP Masters Series Cincinnati OH; U.S.A. ATP World Tour,HARD,2,Tommy Haas,Gilles Simon,Tommy Haas,6-3; 4-6; 6-4,R32,108,13,5,57,91,40,57,18,34,4,7,15,58,91,2,1,46,87,31,46,19,41,5,9,14,50,87
2006-08-14 00:00:00.000,ATP Masters Series Cincinnati OH; U.S.A. ATP World Tour,HARD,2,Rafael Nadal,Hyung-Taik Lee,Rafael Nadal,6-4; 6-3,R32,79,1,1,32,45,28,32,8,13,0,0,9,36,45,0,0,40,59,23,40,11,19,2,5,10,34,59
2006-08-14 00:00:00.000,ATP Masters Series Cincinnati OH; U.S.A. ATP World Tour,HARD,2,Andy Murray,Robby Ginepri,Andy Murray,7-6(3); 2-6; 6-4,R16,127,10,4,30,86,24,30,29,56,3,7,15,53,86,9,2,67,108,49,67,17,41,6,9,15,66,108
2006-08-14 00:00:00.000,ATP Masters Series Cincinnati OH; U.S.A. ATP World Tour,HARD,2,Andy Roddick,Juan Ignacio Chela,Andy Roddick,6-3; 6-4,R16,73,10,1,34,51,26,34,11,17,0,1,10,37,51,1,0,37,66,22,37,16,29,6,9,9,38,66
2006-08-14 00:00:00.000,ATP Masters Series Cincinnati OH; U.S.A. ATP World Tour,HARD,2,Fernando Gonzalez,Stanislas Wawrinka,Fernando Gonzalez,7-6(2); 7-5,R16,116,5,4,51,71,39,51,10,20,2,3,12,49,71,7,6,48,88,33,48,18,40,4,6,12,51,88
2006-08-14 00:00:00.000,ATP Masters Series Cincinnati OH; U.S.A. ATP World Tour,HARD,2,David Ferrer,Marcos Baghdatis,David Ferrer,7-5; 6-4,R16,90,1,2,43,65,27,43,13,22,3,6,11,40,65,5,3,29,64,22,29,13,35,1,6,11,35,64
2006-08-14 00:00:00.000,ATP Masters Series Cincinnati OH; U.S.A. ATP World Tour,HARD,2,Tommy Robredo,Florent Serra,Tommy Robredo,6-3; 6-1,R16,66,1,3,36,48,26,36,8,12,3,3,8,34,48,1,0,37,60,23,37,8,23,3,7,8,31,60
2006-08-14 00:00:00.000,ATP Masters Series Cincinnati OH; U.S.A. ATP World Tour,HARD,2,Ivan Ljubicic,Dominik Hrbaty,Ivan Ljubicic,7-5; 6-4,R16,105,10,2,35,69,28,35,17,34,3,5,11,45,69,5,3,40,75,25,40,17,35,1,5,11,42,75
2006-08-14 00:00:00.000,ATP Masters Series Cincinnati OH; U.S.A. ATP World Tour,HARD,2,Juan Carlos Ferrero,Robin Soderling,Juan Carlos Ferrero,7-5; 6-4,R16,84,10,0,39,57,34,39,11,18,2,2,11,45,57,3,2,41,63,32,41,11,22,2,4,11,43,63
2006-08-14 00:00:00.000,ATP Masters Series Cincinnati OH; U.S.A. ATP World Tour,HARD,2,Rafael Nadal,Tommy Haas,Rafael Nadal,7-6(5); 6-3,R16,112,5,2,39,62,31,39,16,23,2,3,11,47,62,3,0,42,67,29,42,12,25,3,5,10,41,67
2006-08-14 00:00:00.000,ATP Masters Series Cincinnati OH; U.S.A. ATP World Tour,HARD,2,Andy Roddick,Andy Murray,Andy Roddick,6-3; 6-4,Q,95,16,2,46,69,34,46,10,23,3,4,10,44,69,1,3,35,73,24,35,16,38,8,11,9,40,73
2006-08-14 00:00:00.000,ATP Masters Series Cincinnati OH; U.S.A. ATP World Tour,HARD,2,Fernando Gonzalez,David Ferrer,Fernando Gonzalez,6-2; 6-4,Q,64,5,0,40,51,30,40,4,11,2,4,9,34,51,0,3,30,48,18,30,5,18,1,6,9,23,48
2006-08-14 00:00:00.000,ATP Masters Series Cincinnati OH; U.S.A. ATP World Tour,HARD,2,Tommy Robredo,Ivan Ljubicic,Tommy Robredo,7-6(6); 6-2,Q,102,0,0,53,71,43,53,7,18,6,6,10,50,71,11,2,50,75,35,50,10,25,3,5,10,45,75
2006-08-14 00:00:00.000,ATP Masters Series Cincinnati OH; U.S.A. ATP World Tour,HARD,2,Juan Carlos Ferrero,Rafael Nadal,Juan Carlos Ferrero,7-6(2); 7-6(3),Q,163,3,3,47,81,36,47,20,34,2,3,12,56,81,8,2,46,74,31,46,18,28,1,2,12,49,74
2006-08-14 00:00:00.000,ATP Masters Series Cincinnati OH; U.S.A. ATP World Tour,HARD,2,Andy Roddick,Fernando Gonzalez,Andy Roddick,6-3; 6-3,S,66,12,0,32,51,29,32,9,19,1,1,9,38,51,6,3,34,55,23,34,7,21,4,7,9,30,55
2006-08-14 00:00:00.000,ATP Masters Series Cincinnati OH; U.S.A. ATP World Tour,HARD,2,Juan Carlos Ferrero,Tommy Robredo,Juan Carlos Ferrero,6-3; 6-4,S,97,8,3,39,60,31,39,13,21,2,3,10,44,60,2,1,54,84,32,54,14,30,8,11,9,46,84
2006-08-14 00:00:00.000,ATP Masters Series Cincinnati OH; U.S.A. ATP World Tour,HARD,2,Andy Roddick,Juan Carlos Ferrero,Andy Roddick,6-3; 6-4,F,70,17,2,38,55,28,38,9,17,2,4,10,37,55,9,2,36,54,24,36,5,18,3,7,9,29,54
2006-08-21 00:00:00.000,New Haven CT; U.S.A. ATP World Tour,HARD,2,James Blake,N/A Bye,James Blake,,R64,0,0,0,0,0,0,0,0,0,0,0,0,0,0,0,0,0,0,0,0,0,0,0,0,0,0,0
2006-08-21 00:00:00.000,New Haven CT; U.S.A. ATP World Tour,HARD,2,Ruben Ramirez Hidalgo,Christophe Rochus,Ruben Ramirez Hidalgo,6-3; 7-5,R64,81,13,7,38,73,28,38,19,35,2,3,11,47,73,1,7,47,74,32,47,9,27,6,9,10,41,74
2006-08-21 00:00:00.000,New Haven CT; U.S.A. ATP World Tour,HARD,2,Robin Vik,Fabrice Santoro,Robin Vik,6-4; 6-2,R64,62,3,0,33,50,26,33,12,17,2,2,9,38,50,4,6,34,61,22,34,13,27,2,5,9,35,61
2006-08-21 00:00:00.000,New Haven CT; U.S.A. ATP World Tour,HARD,2,Xavier Malisse,N/A Bye,Xavier Malisse,,R64,0,0,0,0,0,0,0,0,0,0,0,0,0,0,0,0,0,0,0,0,0,0,0,0,0,0,0
2006-08-21 00:00:00.000,New Haven CT; U.S.A. ATP World Tour,HARD,2,Juan Ignacio Chela,N/A Bye,Juan Ignacio Chela,,R64,0,0,0,0,0,0,0,0,0,0,0,0,0,0,0,0,0,0,0,0,0,0,0,0,0,0,0
2006-08-21 00:00:00.000,New Haven CT; U.S.A. ATP World Tour,HARD,2,Andreas Seppi,Bjorn Phau,Andreas Seppi,6-1; 6-1,R64,53,7,3,36,53,26,36,10,17,3,3,7,36,53,4,6,16,40,9,16,6,24,3,8,7,15,40
2006-08-21 00:00:00.000,New Haven CT; U.S.A. ATP World Tour,HARD,2,Nicolas Mahut,Daniele Bracciali,Nicolas Mahut,7-5; 7-6(2),R64,92,12,3,41,66,35,41,20,25,2,2,12,55,66,6,4,39,75,30,39,21,36,1,2,12,51,75
2006-08-21 00:00:00.000,New Haven CT; U.S.A. ATP World Tour,HARD,2,Jose Acasuso,N/A Bye,Jose Acasuso,,R64,0,0,0,0,0,0,0,0,0,0,0,0,0,0,0,0,0,0,0,0,0,0,0,0,0,0,0
2006-08-21 00:00:00.000,New Haven CT; U.S.A. ATP World Tour,HARD,2,Jarkko Nieminen,N/A Bye,Jarkko Nieminen,,R64,0,0,0,0,0,0,0,0,0,0,0,0,0,0,0,0,0,0,0,0,0,0,0,0,0,0,0
2006-08-21 00:00:00.000,New Haven CT; U.S.A. ATP World Tour,HARD,2,Greg Rusedski,Ivo Karlovic,Greg Rusedski,7-6(2); 6-7(7); 6-2,R64,141,15,7,42,98,36,42,39,56,3,4,16,75,98,17,8,66,118,53,66,21,52,8,11,16,74,118
2006-08-21 00:00:00.000,New Haven CT; U.S.A. ATP World Tour,HARD,2,Boris Pashanski,Gilles Muller,Boris Pashanski,6-3; 2-6; 7-6(3),R64,118,4,11,36,86,32,36,25,50,1,3,14,57,86,15,8,57,106,43,57,24,49,8,10,15,67,106
2006-08-21 00:00:00.000,New Haven CT; U.S.A. ATP World Tour,HARD,2,Nicolas Massu,N/A Bye,Nicolas Massu,,R64,0,0,0,0,0,0,0,0,0,0,0,0,0,0,0,0,0,0,0,0,0,0,0,0,0,0,0
2006-08-21 00:00:00.000,New Haven CT; U.S.A. ATP World Tour,HARD,2,Agustin Calleri,N/A Bye,Agustin Calleri,,R64,0,0,0,0,0,0,0,0,0,0,0,0,0,0,0,0,0,0,0,0,0,0,0,0,0,0,0
2006-08-21 00:00:00.000,New Haven CT; U.S.A. ATP World Tour,HARD,2,Max Mirnyi,Paul-Henri Mathieu,Max Mirnyi,6-2; 7-6(6),R64,95,11,2,54,83,39,54,11,29,9,10,10,50,83,2,2,44,70,26,44,14,26,0,3,10,40,70
2006-08-21 00:00:00.000,New Haven CT; U.S.A. ATP World Tour,HARD,2,Mardy Fish,Davide Sanguinetti,Mardy Fish,6-3; 6-3,R64,70,6,2,36,64,28,36,17,28,8,8,9,45,64,3,2,31,53,20,31,11,22,1,4,9,31,53
2006-08-21 00:00:00.000,New Haven CT; U.S.A. ATP World Tour,HARD,2,David Ferrer,N/A Bye,David Ferrer,,R64,0,0,0,0,0,0,0,0,0,0,0,0,0,0,0,0,0,0,0,0,0,0,0,0,0,0,0
2006-08-21 00:00:00.000,New Haven CT; U.S.A. ATP World Tour,HARD,2,Fernando Verdasco,N/A Bye,Fernando Verdasco,,R64,0,0,0,0,0,0,0,0,0,0,0,0,0,0,0,0,0,0,0,0,0,0,0,0,0,0,0
2006-08-21 00:00:00.000,New Haven CT; U.S.A. ATP World Tour,HARD,2,Julien Benneteau,Luis Horna,Julien Benneteau,7-6(3); 2-6; 6-1,R64,138,6,6,57,86,46,57,15,29,8,10,14,61,86,12,4,52,90,40,52,19,38,4,6,13,59,90
2006-08-21 00:00:00.000,New Haven CT; U.S.A. ATP World Tour,HARD,2,Feliciano Lopez,Filippo Volandri,Feliciano Lopez,6-3; 6-4,R64,68,12,1,41,60,36,41,5,19,4,5,10,41,60,0,3,31,54,19,31,13,23,4,7,9,32,54
2006-08-21 00:00:00.000,New Haven CT; U.S.A. ATP World Tour,HARD,2,Jurgen Melzer,N/A Bye,Jurgen Melzer,,R64,0,0,0,0,0,0,0,0,0,0,0,0,0,0,0,0,0,0,0,0,0,0,0,0,0,0,0
2006-08-21 00:00:00.000,New Haven CT; U.S.A. ATP World Tour,HARD,2,Robin Soderling,N/A Bye,Robin Soderling,,R64,0,0,0,0,0,0,0,0,0,0,0,0,0,0,0,0,0,0,0,0,0,0,0,0,0,0,0
2006-08-21 00:00:00.000,New Haven CT; U.S.A. ATP World Tour,HARD,2,Sam Querrey,Alberto Martin,Sam Querrey,6-3; 6-2,R64,61,11,3,36,55,28,36,11,19,2,2,9,39,55,2,3,33,59,21,33,12,26,6,9,8,33,59
2006-08-21 00:00:00.000,New Haven CT; U.S.A. ATP World Tour,HARD,2,Michael Berrer,Ryan Sweeting,Michael Berrer,7-5; 6-2,R64,70,5,3,31,49,23,31,12,18,1,3,10,35,49,0,5,39,66,25,39,10,27,5,10,10,35,66
2006-08-21 00:00:00.000,New Haven CT; U.S.A. ATP World Tour,HARD,2,Marcos Baghdatis,N/A Bye,Marcos Baghdatis,,R64,0,0,0,0,0,0,0,0,0,0,0,0,0,0,0,0,0,0,0,0,0,0,0,0,0,0,0
2006-08-21 00:00:00.000,New Haven CT; U.S.A. ATP World Tour,HARD,2,Olivier Rochus,N/A Bye,Olivier Rochus,,R64,0,0,0,0,0,0,0,0,0,0,0,0,0,0,0,0,0,0,0,0,0,0,0,0,0,0,0
2006-08-21 00:00:00.000,New Haven CT; U.S.A. ATP World Tour,HARD,2,Gilles Simon,Justin Gimelstob,Gilles Simon,4-6; 7-5; 6-1,R64,133,4,3,57,97,43,57,21,40,6,8,15,64,97,1,3,54,106,41,54,19,52,10,14,14,60,106
2006-08-21 00:00:00.000,New Haven CT; U.S.A. ATP World Tour,HARD,2,Marc Gicquel,Jan Hajek,Marc Gicquel,7-6(3); 6-3,R64,75,5,2,31,67,27,31,17,36,4,7,11,44,67,2,5,27,57,18,27,12,30,1,5,10,30,57
2006-08-21 00:00:00.000,New Haven CT; U.S.A. ATP World Tour,HARD,2,Gael Monfils,N/A Bye,Gael Monfils,,R64,0,0,0,0,0,0,0,0,0,0,0,0,0,0,0,0,0,0,0,0,0,0,0,0,0,0,0
2006-08-21 00:00:00.000,New Haven CT; U.S.A. ATP World Tour,HARD,2,Paradorn Srichaphan,N/A Bye,Paradorn Srichaphan,,R64,0,0,0,0,0,0,0,0,0,0,0,0,0,0,0,0,0,0,0,0,0,0,0,0,0,0,0
2006-08-21 00:00:00.000,New Haven CT; U.S.A. ATP World Tour,HARD,2,Stanislas Wawrinka,Nicolas Almagro,Stanislas Wawrinka,6-3; 6-7(5); 6-4,R64,132,12,4,60,100,44,60,28,40,2,3,16,72,100,12,6,52,100,40,52,25,48,3,6,15,65,100
2006-08-21 00:00:00.000,New Haven CT; U.S.A. ATP World Tour,HARD,2,Arnaud Clement,Florent Serra,Arnaud Clement,6-4; 6-1,R64,80,4,1,42,73,29,42,13,31,5,7,9,42,73,0,3,28,49,16,28,5,21,1,6,8,21,49
2006-08-21 00:00:00.000,New Haven CT; U.S.A. ATP World Tour,HARD,2,Nikolay Davydenko,N/A Bye,Nikolay Davydenko,,R64,0,0,0,0,0,0,0,0,0,0,0,0,0,0,0,0,0,0,0,0,0,0,0,0,0,0,0
2006-08-21 00:00:00.000,New Haven CT; U.S.A. ATP World Tour,HARD,2,Ruben Ramirez Hidalgo,James Blake,Ruben Ramirez Hidalgo,2-6; 7-6(6); 7-6(4),R32,142,7,8,69,124,50,69,28,55,13,18,16,78,124,7,2,67,105,50,67,18,38,5,8,16,68,105
2006-08-21 00:00:00.000,New Haven CT; U.S.A. ATP World Tour,HARD,2,Xavier Malisse,Robin Vik,Xavier Malisse,6-1; 4-6; 6-3,R32,109,10,1,46,88,35,46,19,42,4,7,13,54,88,6,3,63,87,31,63,12,24,1,7,13,43,87
2006-08-21 00:00:00.000,New Haven CT; U.S.A. ATP World Tour,HARD,2,Juan Ignacio Chela,Andreas Seppi,Juan Ignacio Chela,6-3; 6-2,R32,68,3,1,30,53,23,30,16,23,1,1,9,39,53,1,2,35,63,27,35,8,28,7,10,8,35,63
2006-08-21 00:00:00.000,New Haven CT; U.S.A. ATP World Tour,HARD,2,Jose Acasuso,Nicolas Mahut,Jose Acasuso,7-5; 3-3 RET,R32,75,7,4,29,54,26,29,12,25,0,0,9,38,54,9,2,36,58,26,36,12,22,3,4,9,38,58
2006-08-21 00:00:00.000,New Haven CT; U.S.A. ATP World Tour,HARD,2,Jarkko Nieminen,Greg Rusedski,Jarkko Nieminen,7-6(2); 6-4,R32,87,6,1,42,69,33,42,16,27,3,4,11,49,69,6,5,50,77,32,50,12,27,4,6,11,44,77
2006-08-21 00:00:00.000,New Haven CT; U.S.A. ATP World Tour,HARD,2,Nicolas Massu,Boris Pashanski,Nicolas Massu,6-3; 7-6(4),R32,78,17,2,42,57,36,42,11,15,1,2,11,47,57,3,4,44,66,31,44,12,22,3,5,10,43,66
2006-08-21 00:00:00.000,New Haven CT; U.S.A. ATP World Tour,HARD,2,Agustin Calleri,Max Mirnyi,Agustin Calleri,7-6(4); 6-3,R32,91,13,3,46,68,37,46,16,22,2,2,11,53,68,10,3,47,75,35,47,15,28,7,8,10,50,75
2006-08-21 00:00:00.000,New Haven CT; U.S.A. ATP World Tour,HARD,2,David Ferrer,Mardy Fish,David Ferrer,6-2; 2-6; 7-6(5),R32,127,1,3,56,94,39,56,19,38,4,7,14,58,94,7,4,51,101,37,51,24,50,6,9,14,61,101
2006-08-21 00:00:00.000,New Haven CT; U.S.A. ATP World Tour,HARD,2,Fernando Verdasco,Julien Benneteau,Fernando Verdasco,7-6(4); 6-4,R32,80,9,3,51,63,42,51,7,12,2,2,11,49,63,3,1,42,65,32,42,11,23,0,1,11,43,65
2006-08-21 00:00:00.000,New Haven CT; U.S.A. ATP World Tour,HARD,2,Jurgen Melzer,Feliciano Lopez,Jurgen Melzer,6-7(3); 7-6(1); 6-4,R32,140,10,4,77,113,54,77,22,36,7,9,17,76,113,9,5,67,113,53,67,22,46,2,5,17,75,113
2006-08-21 00:00:00.000,New Haven CT; U.S.A. ATP World Tour,HARD,2,Robin Soderling,Sam Querrey,Robin Soderling,6-3; 4-6; 6-1,R32,78,3,1,45,68,35,45,16,23,3,4,13,51,68,10,3,44,76,30,44,15,32,2,6,13,45,76
2006-08-21 00:00:00.000,New Haven CT; U.S.A. ATP World Tour,HARD,2,Marcos Baghdatis,Michael Berrer,Marcos Baghdatis,7-6(5); 7-6(6),R32,108,5,3,43,75,33,43,19,32,0,2,12,52,75,2,3,51,84,37,51,19,33,4,6,12,56,84
2006-08-21 00:00:00.000,New Haven CT; U.S.A. ATP World Tour,HARD,2,Olivier Rochus,Gilles Simon,Olivier Rochus,4-6; 6-4; 6-3,R32,124,2,3,48,94,37,48,22,46,6,9,15,59,94,12,2,54,93,36,54,19,39,3,7,14,55,93
2006-08-21 00:00:00.000,New Haven CT; U.S.A. ATP World Tour,HARD,2,Gael Monfils,Marc Gicquel,Gael Monfils,7-6(6); 6-4,R32,88,11,3,47,78,35,47,19,31,6,7,11,54,78,6,2,48,74,37,48,12,26,3,5,11,49,74
2006-08-21 00:00:00.000,New Haven CT; U.S.A. ATP World Tour,HARD,2,Paradorn Srichaphan,Stanislas Wawrinka,Paradorn Srichaphan,7-6(2); 4-6; 6-4,R32,138,8,8,57,107,42,57,27,50,7,10,16,69,107,4,4,54,98,46,54,20,44,5,8,16,66,98
2006-08-21 00:00:00.000,New Haven CT; U.S.A. ATP World Tour,HARD,2,Nikolay Davydenko,Arnaud Clement,Nikolay Davydenko,6-2; 6-1,R32,64,0,1,21,35,20,21,9,14,2,2,7,29,35,1,3,24,49,13,24,11,25,6,11,8,24,49
2006-08-21 00:00:00.000,New Haven CT; U.S.A. ATP World Tour,HARD,2,Xavier Malisse,Ruben Ramirez Hidalgo,Xavier Malisse,6-1; 6-3,R16,66,5,0,24,38,21,24,11,14,0,0,8,32,38,3,3,30,64,17,30,14,34,5,9,8,31,64
2006-08-21 00:00:00.000,New Haven CT; U.S.A. ATP World Tour,HARD,2,Juan Ignacio Chela,Jose Acasuso,Juan Ignacio Chela,7-6(1); 6-2,R16,84,4,0,41,66,33,41,12,25,1,2,10,45,66,4,1,31,69,21,31,18,38,3,6,10,39,69
2006-08-21 00:00:00.000,New Haven CT; U.S.A. ATP World Tour,HARD,2,Nicolas Massu,Jarkko Nieminen,Nicolas Massu,6-3; 6-4,R16,88,6,5,29,65,25,29,21,36,2,2,10,46,65,1,5,29,62,20,29,16,33,2,4,9,36,62
2006-08-21 00:00:00.000,New Haven CT; U.S.A. ATP World Tour,HARD,2,Agustin Calleri,David Ferrer,Agustin Calleri,6-3; 6-1,R16,78,7,3,46,74,33,46,11,28,11,12,8,44,74,0,3,31,50,17,31,7,19,5,10,8,24,50
2006-08-21 00:00:00.000,New Haven CT; U.S.A. ATP World Tour,HARD,2,Jurgen Melzer,Fernando Verdasco,Jurgen Melzer,6-4; 4-1 RET,R16,55,6,3,31,50,24,31,10,19,3,3,7,34,50,3,2,27,40,16,27,6,13,1,4,8,22,40
2006-08-21 00:00:00.000,New Haven CT; U.S.A. ATP World Tour,HARD,2,Robin Soderling,Marcos Baghdatis,Robin Soderling,6-3; 6-7(3); 7-5,R16,137,9,5,66,101,53,66,18,35,3,4,17,71,101,14,1,56,120,42,56,32,64,4,7,16,74,120
2006-08-21 00:00:00.000,New Haven CT; U.S.A. ATP World Tour,HARD,2,Olivier Rochus,Gael Monfils,Olivier Rochus,6-4; 6-3,R16,71,0,1,28,57,21,28,21,29,2,2,10,42,57,9,3,28,47,23,28,7,19,2,4,9,30,47
2006-08-21 00:00:00.000,New Haven CT; U.S.A. ATP World Tour,HARD,2,Nikolay Davydenko,Paradorn Srichaphan,Nikolay Davydenko,6-4; 6-1,R16,62,4,3,28,43,24,28,8,15,0,0,8,32,43,2,4,33,62,19,33,12,29,10,14,9,31,62
2006-08-21 00:00:00.000,New Haven CT; U.S.A. ATP World Tour,HARD,2,Xavier Malisse,Juan Ignacio Chela,Xavier Malisse,4-6; 6-4; 6-2,Q,118,3,3,52,92,40,52,17,40,6,9,14,57,92,2,2,58,95,37,58,17,37,9,14,14,54,95
2006-08-21 00:00:00.000,New Haven CT; U.S.A. ATP World Tour,HARD,2,Agustin Calleri,Nicolas Massu,Agustin Calleri,6-3; 3-6; 6-4,Q,113,11,4,46,79,39,46,17,33,2,4,14,56,79,6,5,46,91,32,46,26,45,5,8,14,58,91
2006-08-21 00:00:00.000,New Haven CT; U.S.A. ATP World Tour,HARD,2,Robin Soderling,Jurgen Melzer,Robin Soderling,6-3; 6-2,Q,54,7,1,37,49,31,37,6,12,2,2,9,37,49,6,0,27,44,17,27,9,17,2,5,8,26,44
2006-08-21 00:00:00.000,New Haven CT; U.S.A. ATP World Tour,HARD,2,Nikolay Davydenko,Olivier Rochus,Nikolay Davydenko,6-4; 6-2,Q,75,3,1,33,49,22,33,10,16,2,4,9,32,49,1,2,35,58,19,35,7,23,3,8,9,26,58
2006-08-21 00:00:00.000,New Haven CT; U.S.A. ATP World Tour,HARD,2,Agustin Calleri,Xavier Malisse,Agustin Calleri,6-2 RET,S,37,6,0,24,35,20,24,4,11,2,2,4,24,35,2,1,12,21,9,12,2,9,3,5,4,11,21
2006-08-21 00:00:00.000,New Haven CT; U.S.A. ATP World Tour,HARD,2,Nikolay Davydenko,Robin Soderling,Nikolay Davydenko,7-6(6); 6-2,S,98,5,1,61,77,39,61,6,16,3,6,10,45,77,4,4,40,73,23,40,15,33,5,10,10,38,73
2006-08-21 00:00:00.000,New Haven CT; U.S.A. ATP World Tour,HARD,2,Nikolay Davydenko,Agustin Calleri,Nikolay Davydenko,6-4; 6-3,F,82,5,2,40,64,32,40,11,24,6,6,9,43,64,5,4,32,58,27,32,7,26,4,7,10,34,58
2006-08-28 00:00:00.000,US Open NY; U.S.A. Grand Slams,HARD,3,Roger Federer,Jimmy Wang,Roger Federer,6-4; 6-1; 6-0,R128,99,7,1,39,64,35,39,11,25,0,1,11,46,64,3,6,50,104,27,50,20,54,10,18,12,47,104
2006-08-28 00:00:00.000,US Open NY; U.S.A. Grand Slams,HARD,3,Tim Henman,Greg Rusedski,Tim Henman,7-6(4); 6-2; 6-3,R128,114,8,1,55,85,41,55,21,30,0,1,15,62,85,6,5,56,92,37,56,17,36,2,6,14,54,92
2006-08-28 00:00:00.000,US Open NY; U.S.A. Grand Slams,HARD,3,Vincent Spadea,Gilles Muller,Vincent Spadea,6-2; 6-4; 6-3,R128,98,4,2,50,84,35,50,20,34,4,5,13,55,84,2,7,61,93,38,61,13,32,5,11,14,51,93
2006-08-28 00:00:00.000,US Open NY; U.S.A. Grand Slams,HARD,3,Jonas Bjorkman,Scoville Jenkins,Jonas Bjorkman,7-5; 6-4; 6-4,R128,135,5,5,57,95,46,57,17,38,6,9,16,63,95,2,6,62,101,39,62,20,39,11,17,16,59,101
2006-08-28 00:00:00.000,US Open NY; U.S.A. Grand Slams,HARD,3,Gaston Gaudio,Andreas Seppi,Gaston Gaudio,6-4; 6-4; 6-2,R128,106,7,2,47,82,37,47,21,35,4,5,14,58,82,8,6,49,88,32,49,18,39,2,7,14,50,88
2006-08-28 00:00:00.000,US Open NY; U.S.A. Grand Slams,HARD,3,Sam Querrey,Philipp Kohlschreiber,Sam Querrey,6-3; 6-4; 6-4,R128,90,7,3,56,85,41,56,21,29,2,2,15,62,85,6,3,48,90,33,48,22,42,6,9,14,55,90
2006-08-28 00:00:00.000,US Open NY; U.S.A. Grand Slams,HARD,3,Marc Gicquel,Christophe Rochus,Marc Gicquel,6-3; 6-3; 6-4,R128,94,21,1,49,80,39,49,16,31,1,3,14,55,80,1,5,49,89,32,49,17,40,2,8,14,49,89
2006-08-28 00:00:00.000,US Open NY; U.S.A. Grand Slams,HARD,3,Juan Carlos Ferrero,George Bastl,Juan Carlos Ferrero,7-5; 6-4; 3-6; 6-3,R128,185,9,4,81,129,60,81,26,48,4,7,20,86,129,15,4,76,122,58,76,19,46,12,17,20,77,122
2006-08-28 00:00:00.000,US Open NY; U.S.A. Grand Slams,HARD,3,Tomas Berdych,Boris Pashanski,Tomas Berdych,6-4; 6-2; 6-1,R128,89,10,2,31,61,28,31,19,30,3,4,12,47,61,0,5,47,88,27,47,16,41,6,13,13,43,88
2006-08-28 00:00:00.000,US Open NY; U.S.A. Grand Slams,HARD,3,Florian Mayer,Stefan Koubek,Florian Mayer,6-4; 6-1; 6-1,R128,71,5,0,36,65,27,36,20,29,1,2,12,47,65,0,3,30,65,17,30,15,35,5,12,12,32,65
2006-08-28 00:00:00.000,US Open NY; U.S.A. Grand Slams,HARD,3,Alejandro Falla,Juan Martin Del Potro,Alejandro Falla,7-6(3); 6-2; 4-6; 7-5,R128,190,6,5,101,153,69,101,25,52,11,16,21,94,153,3,6,79,131,53,79,23,52,8,15,21,76,131
2006-08-28 00:00:00.000,US Open NY; U.S.A. Grand Slams,HARD,3,Dmitry Tursunov,Igor Kunitsyn,Dmitry Tursunov,6-2; 6-3; 6-4,R128,97,8,4,54,93,42,54,20,39,8,10,14,62,93,2,4,46,83,28,46,16,37,7,13,13,44,83
2006-08-28 00:00:00.000,US Open NY; U.S.A. Grand Slams,HARD,3,Carlos Moya,Agustin Calleri,Carlos Moya,7-5; 7-6(5); 6-7(3); 6-3,R128,196,19,9,99,176,74,99,41,77,13,13,23,115,176,19,11,77,138,65,77,30,61,5,7,22,95,138
2006-08-28 00:00:00.000,US Open NY; U.S.A. Grand Slams,HARD,3,Paul-Henri Mathieu,Josh Goodall,Paul-Henri Mathieu,6-3; 6-2; 3-6; 6-3,R128,127,10,5,51,97,48,51,24,46,0,1,18,72,97,14,4,49,101,40,49,22,52,6,10,17,62,101
2006-08-28 00:00:00.000,US Open NY; U.S.A. Grand Slams,HARD,3,Teymuraz Gabashvili,Marcos Daniel,Teymuraz Gabashvili,6-3; 6-2; 3-6; 3-6; 6-3,R128,176,10,4,69,132,55,69,31,63,6,10,22,86,132,6,3,90,143,58,90,29,53,13,19,22,87,143
2006-08-28 00:00:00.000,US Open NY; U.S.A. Grand Slams,HARD,3,James Blake,Juan Monaco,James Blake,6-3; 7-5; 7-6(7),R128,117,7,5,53,101,37,53,28,48,3,7,17,65,101,3,3,74,98,41,74,12,24,6,12,16,53,98
2006-08-28 00:00:00.000,US Open NY; U.S.A. Grand Slams,HARD,3,David Nalbandian,Michael Berrer,David Nalbandian,4-6; 6-7(2); 6-3; 7-5; 6-2,R128,213,15,10,85,152,63,85,39,67,8,12,26,102,152,13,8,99,167,73,99,27,68,7,14,25,100,167
2006-08-28 00:00:00.000,US Open NY; U.S.A. Grand Slams,HARD,3,Marat Safin,Robin Vik,Marat Safin,6-1; 6-1; 3-6; 6-3,R128,108,15,0,53,89,44,53,21,36,6,7,16,65,89,6,2,68,103,45,68,15,35,7,13,16,60,103
2006-08-28 00:00:00.000,US Open NY; U.S.A. Grand Slams,HARD,3,Ryan Sweeting,Guillermo Coria,Ryan Sweeting,3-2 RET,R128,24,3,1,6,11,5,6,0,5,0,1,2,5,11,0,5,6,17,4,6,3,11,0,2,3,7,17
2006-08-28 00:00:00.000,US Open NY; U.S.A. Grand Slams,HARD,3,Olivier Rochus,Olivier Patience,Olivier Rochus,6-0; 6-2; 6-2,R128,76,4,1,40,61,33,40,14,21,3,3,11,47,61,3,1,48,78,22,48,12,30,6,13,11,34,78
2006-08-28 00:00:00.000,US Open NY; U.S.A. Grand Slams,HARD,3,Robby Ginepri,Julien Benneteau,Robby Ginepri,3-6; 6-4; 6-4; 6-4,R128,163,12,2,75,117,48,75,23,42,6,11,20,71,117,7,5,97,142,58,97,24,45,14,20,19,82,142
2006-08-28 00:00:00.000,US Open NY; U.S.A. Grand Slams,HARD,3,Paul Goldstein,Jesse Witten,Paul Goldstein,6-3; 6-4; 2-6; 3-6; 6-1,R128,180,3,5,83,150,51,83,36,67,9,15,22,87,150,14,4,76,141,53,76,32,65,8,15,21,85,141
2006-08-28 00:00:00.000,US Open NY; U.S.A. Grand Slams,HARD,3,Raemon Sluiter,Wayne Odesnik,Raemon Sluiter,6-4; 6-4; 7-5,R128,110,14,4,47,88,41,47,21,41,3,5,16,62,88,19,3,64,99,44,64,18,35,7,12,16,62,99
2006-08-28 00:00:00.000,US Open NY; U.S.A. Grand Slams,HARD,3,Tommy Haas,Alex Kuznetsov,Tommy Haas,6-2; 6-4; 6-0,R128,88,6,1,34,62,27,34,21,28,0,0,12,48,62,12,1,52,79,31,52,10,27,7,13,12,41,79
2006-08-28 00:00:00.000,US Open NY; U.S.A. Grand Slams,HARD,3,Fernando Gonzalez,Jiri Vanek,Fernando Gonzalez,6-2; 6-3; 6-2,R128,91,10,5,62,92,50,62,12,30,8,8,13,62,92,1,1,52,86,26,52,19,34,6,11,12,45,86
2006-08-28 00:00:00.000,US Open NY; U.S.A. Grand Slams,HARD,3,Jan Hajek,Lukas Dlouhy,Jan Hajek,6-3; 6-4; 6-4,R128,99,11,3,59,90,47,59,11,31,3,5,15,58,90,6,8,67,97,44,67,9,30,6,11,14,53,97
2006-08-28 00:00:00.000,US Open NY; U.S.A. Grand Slams,HARD,3,Alessio Di Mauro,Jurgen Melzer,Alessio Di Mauro,5-7; 6-1; 7-5; 7-5,R128,176,18,4,85,159,60,85,39,74,17,20,22,99,159,8,4,81,118,55,81,17,37,5,11,21,72,118
2006-08-28 00:00:00.000,US Open NY; U.S.A. Grand Slams,HARD,3,Andy Murray,Robert Kendrick,Andy Murray,6-2; 1-6; 6-3; 6-3,R128,137,8,6,55,109,37,55,25,54,4,9,16,62,109,9,10,64,118,42,64,19,54,9,17,17,61,118
2006-08-28 00:00:00.000,US Open NY; U.S.A. Grand Slams,HARD,3,Lukasz Kubot,Kristof Vliegen,Lukasz Kubot,2-6; 6-1; 6-4; 1-6; 6-3,R128,181,4,2,87,140,55,87,32,53,7,11,21,87,140,13,1,59,103,47,59,22,44,0,4,20,69,103
2006-08-28 00:00:00.000,US Open NY; U.S.A. Grand Slams,HARD,3,Noam Okun,Potito Starace,Noam Okun,6-2; 6-0; 4-6; 6-2,R128,141,15,3,65,108,45,65,30,43,7,8,16,75,108,4,4,63,108,35,63,23,45,3,10,16,58,108
2006-08-28 00:00:00.000,US Open NY; U.S.A. Grand Slams,HARD,3,Nicolas Mahut,Rainer Schuettler,Nicolas Mahut,6-4; 6-7(5); 6-3; 6-3,R128,186,23,5,77,138,58,77,36,61,6,6,20,94,138,5,4,54,112,37,54,40,58,2,6,20,77,112
2006-08-28 00:00:00.000,US Open NY; U.S.A. Grand Slams,HARD,3,Nikolay Davydenko,Ramon Delgado,Nikolay Davydenko,4-6; 6-4; 7-5; 6-0,R128,142,6,1,60,101,44,60,20,41,5,10,19,64,101,5,7,61,119,37,61,25,58,5,14,19,62,119
2006-08-28 00:00:00.000,US Open NY; U.S.A. Grand Slams,HARD,3,Marcos Baghdatis,Alexander Waske,Marcos Baghdatis,7-6(1); 7-6(7); 6-3,R128,131,10,3,53,97,48,53,31,44,0,1,17,79,97,18,6,64,102,52,64,19,38,1,3,16,71,102
2006-08-28 00:00:00.000,US Open NY; U.S.A. Grand Slams,HARD,3,Andre Agassi,Andrei Pavel,Andre Agassi,6-7(4); 7-6(8); 7-6(6); 6-2,R128,210,17,8,89,154,71,89,29,65,2,5,22,100,154,15,2,113,167,77,113,26,54,6,11,22,103,167
2006-08-28 00:00:00.000,US Open NY; U.S.A. Grand Slams,HARD,3,Benjamin Becker,Filippo Volandri,Benjamin Becker,4-6; 7-6(3); 6-4; 7-6(3),R128,191,15,6,61,135,47,61,43,74,2,6,22,90,135,6,7,104,163,70,104,25,59,8,12,22,95,163
2006-08-28 00:00:00.000,US Open NY; U.S.A. Grand Slams,HARD,3,Sebastien Grosjean,Thomas Johansson,Sebastien Grosjean,6-3; 6-4; 5-7; 6-7(1); 6-2,R128,227,20,2,105,165,79,105,35,60,6,7,26,114,165,12,4,117,185,87,117,29,68,10,14,25,116,185
2006-08-28 00:00:00.000,US Open NY; U.S.A. Grand Slams,HARD,3,Fernando Verdasco,Fabrice Santoro,Fernando Verdasco,6-4; 6-1; 3-6; 6-1,R128,129,1,3,79,99,56,79,15,20,2,3,17,71,99,2,7,58,112,41,58,21,54,10,15,16,62,112
2006-08-28 00:00:00.000,US Open NY; U.S.A. Grand Slams,HARD,3,Thiago Alves,Mariano Zabaleta,Thiago Alves,6-2; 7-5; 6-7(5); 6-3,R128,150,5,2,82,119,57,82,31,37,3,4,21,88,119,9,8,67,121,48,67,29,54,4,9,20,77,121
2006-08-28 00:00:00.000,US Open NY; U.S.A. Grand Slams,HARD,3,Kristian Pless,Alberto Martin,Kristian Pless,3-6; 3-6; 7-6(5); 6-1; 6-2,R128,174,14,8,82,133,58,82,19,51,3,10,22,77,133,7,10,93,159,54,93,35,66,7,16,23,89,159
2006-08-28 00:00:00.000,US Open NY; U.S.A. Grand Slams,HARD,3,Andy Roddick,Florent Serra,Andy Roddick,6-2; 6-1; 6-3,R128,79,9,1,49,69,39,49,11,20,3,4,12,50,69,1,2,47,70,26,47,7,23,8,15,12,33,70
2006-08-28 00:00:00.000,US Open NY; U.S.A. Grand Slams,HARD,3,Lleyton Hewitt,Albert Montanes,Lleyton Hewitt,7-5; 6-4; 6-3,R128,131,8,5,53,88,40,53,22,35,2,3,15,62,88,4,4,59,106,41,59,19,47,5,10,16,60,106
2006-08-28 00:00:00.000,US Open NY; U.S.A. Grand Slams,HARD,3,Jan Hernych,Kevin Kim,Jan Hernych,6-1; 6-4; 3-6; 7-5,R128,123,6,1,80,118,49,80,20,38,7,12,19,69,118,7,6,58,103,38,58,20,45,2,10,19,58,103
2006-08-28 00:00:00.000,US Open NY; U.S.A. Grand Slams,HARD,3,Mardy Fish,Simon Greul,Mardy Fish,6-4; 6-4; 1-6; 6-3,R128,150,17,3,53,109,44,53,25,56,10,15,18,69,109,2,5,64,132,45,64,30,68,10,16,18,75,132
2006-08-28 00:00:00.000,US Open NY; U.S.A. Grand Slams,HARD,3,Novak Djokovic,Donald Young,Novak Djokovic,4-6; 6-3; 6-0; 6-1,R128,101,8,4,70,102,51,70,18,32,7,8,16,69,102,4,8,44,87,24,44,20,43,2,9,16,44,87
2006-08-28 00:00:00.000,US Open NY; U.S.A. Grand Slams,HARD,3,Richard Gasquet,Phillip Simmonds,Richard Gasquet,6-1; 6-3; 6-1,R128,85,2,2,48,74,38,48,17,26,4,4,12,55,74,5,5,40,73,24,40,10,33,6,12,11,34,73
2006-08-28 00:00:00.000,US Open NY; U.S.A. Grand Slams,HARD,3,Gilles Simon,Daniele Bracciali,Gilles Simon,7-5; 6-4; 6-1,R128,110,5,0,57,104,42,57,27,47,6,7,15,69,104,9,5,47,96,36,47,17,49,6,11,14,53,96
2006-08-28 00:00:00.000,US Open NY; U.S.A. Grand Slams,HARD,3,Marco Chiudinelli,Fernando Vicente,Marco Chiudinelli,6-4; 6-1; 6-4,R128,124,5,0,52,92,36,52,26,40,7,8,14,62,92,0,3,65,94,36,65,13,29,9,14,13,49,94
2006-08-28 00:00:00.000,US Open NY; U.S.A. Grand Slams,HARD,3,Feliciano Lopez,Ivan Ljubicic,Feliciano Lopez,6-3; 6-3; 6-3,R128,100,11,0,46,65,43,46,10,19,0,0,13,53,65,13,2,52,87,35,52,18,35,8,13,14,53,87
2006-08-28 00:00:00.000,US Open NY; U.S.A. Grand Slams,HARD,3,Tommy Robredo,Flavio Saretta,Tommy Robredo,6-2; 6-1; 6-2,R128,112,6,4,64,91,46,64,15,27,10,10,12,61,91,5,4,48,76,28,48,12,28,10,16,11,40,76
2006-08-28 00:00:00.000,US Open NY; U.S.A. Grand Slams,HARD,3,Hyung-Taik Lee,Ruben Ramirez Hidalgo,Hyung-Taik Lee,7-5; 6-4; 6-0,R128,118,7,2,49,77,37,49,18,28,3,4,14,55,77,3,6,49,94,29,49,21,45,10,16,14,50,94
2006-08-28 00:00:00.000,US Open NY; U.S.A. Grand Slams,HARD,3,Robin Soderling,Ivo Karlovic,Robin Soderling,6-4; 7-6(3); 7-5,R128,114,10,4,56,95,45,56,31,39,1,1,17,76,95,26,9,67,104,55,67,15,37,2,4,17,70,104
2006-08-28 00:00:00.000,US Open NY; U.S.A. Grand Slams,HARD,3,Stanislas Wawrinka,Juan Ignacio Chela,Stanislas Wawrinka,6-7(3); 6-4; 6-4; 6-4,R128,187,13,7,77,143,58,77,37,66,7,9,21,95,143,1,4,75,128,48,75,32,53,2,7,21,80,128
2006-08-28 00:00:00.000,US Open NY; U.S.A. Grand Slams,HARD,3,Mikhail Youzhny,Dominik Hrbaty,Mikhail Youzhny,7-5; 6-1; 6-3,R128,111,10,1,44,76,36,44,19,32,0,2,14,55,76,3,10,49,93,28,49,18,44,3,10,14,46,93
2006-08-28 00:00:00.000,US Open NY; U.S.A. Grand Slams,HARD,3,Nicolas Massu,Davide Sanguinetti,Nicolas Massu,6-7(4); 6-4; 6-4; 6-4,R128,184,11,5,64,128,55,64,35,64,3,4,21,90,128,16,4,79,142,60,79,31,63,10,14,21,91,142
2006-08-28 00:00:00.000,US Open NY; U.S.A. Grand Slams,HARD,3,Justin Gimelstob,Oliver Marach,Justin Gimelstob,6-2; 6-3; 7-5,R128,111,12,2,44,81,38,44,23,37,0,0,15,61,81,8,4,49,86,36,49,17,37,3,7,14,53,86
2006-08-28 00:00:00.000,US Open NY; U.S.A. Grand Slams,HARD,3,David Ferrer,Nicolas Almagro,David Ferrer,7-6(1); 7-6(6); 6-1,R128,155,6,3,61,102,45,61,27,41,10,13,16,72,102,13,7,64,121,44,64,22,57,12,17,15,66,121
2006-08-28 00:00:00.000,US Open NY; U.S.A. Grand Slams,HARD,3,Xavier Malisse,Jarkko Nieminen,Xavier Malisse,6-4; 7-5; 6-2,R128,114,7,2,58,86,46,58,16,28,0,1,15,62,86,3,4,67,103,38,67,19,36,9,14,15,57,103
2006-08-28 00:00:00.000,US Open NY; U.S.A. Grand Slams,HARD,3,Bjorn Phau,Jeff Morrison,Bjorn Phau,6-3; 7-6(0); 6-4,R128,112,4,4,44,90,34,44,28,46,4,6,15,62,90,8,2,71,121,42,71,24,50,9,14,16,66,121
2006-08-28 00:00:00.000,US Open NY; U.S.A. Grand Slams,HARD,3,Jiri Novak,Arnaud Clement,Jiri Novak,7-5; 6-2; 7-5,R128,140,15,3,56,87,43,56,17,31,3,6,16,60,87,4,3,65,111,37,65,21,46,12,19,16,58,111
2006-08-28 00:00:00.000,US Open NY; U.S.A. Grand Slams,HARD,3,Paradorn Srichaphan,Jose Acasuso,Paradorn Srichaphan,6-3; 3-6; 7-6(5); 6-7(4); 6-3,R128,195,23,9,102,170,83,102,37,68,5,6,26,120,170,29,6,92,149,78,92,31,57,5,7,25,109,149
2006-08-28 00:00:00.000,US Open NY; U.S.A. Grand Slams,HARD,3,Gael Monfils,Michael Russell,Gael Monfils,6-2; 3-6; 7-5; 7-6(4),R128,194,12,4,75,128,54,75,25,53,7,11,20,79,128,2,4,93,139,55,93,28,46,7,13,21,83,139
2006-08-28 00:00:00.000,US Open NY; U.S.A. Grand Slams,HARD,3,Wesley Moodie,Max Mirnyi,Wesley Moodie,6-4; 4-6; 6-4; 6-7(5); 6-4,R128,214,38,7,120,174,88,120,32,54,7,9,26,120,174,6,9,101,151,80,101,27,50,6,10,26,107,151
2006-08-28 00:00:00.000,US Open NY; U.S.A. Grand Slams,HARD,3,Luis Horna,Guillermo Garcia-Lopez,Luis Horna,7-5; 6-4; 6-3,R128,112,16,7,53,98,43,53,24,45,2,3,16,67,98,5,4,54,90,36,54,16,36,4,8,15,52,90
2006-08-28 00:00:00.000,US Open NY; U.S.A. Grand Slams,HARD,3,Rafael Nadal,Mark Philippoussis,Rafael Nadal,6-4; 6-4; 6-4,R128,122,7,1,47,79,41,47,22,32,4,4,15,63,79,19,3,48,87,45,48,10,39,1,4,15,55,87
2006-08-28 00:00:00.000,US Open NY; U.S.A. Grand Slams,HARD,3,Roger Federer,Tim Henman,Roger Federer,6-3; 6-4; 7-5,R64,121,6,1,56,81,46,56,17,25,0,1,16,63,81,2,6,64,113,44,64,21,49,9,13,15,65,113
2006-08-28 00:00:00.000,US Open NY; U.S.A. Grand Slams,HARD,3,Vincent Spadea,Jonas Bjorkman,Vincent Spadea,6-4; 7-6(4); 6-2,R64,145,6,4,75,120,50,75,24,45,11,14,15,74,120,1,8,51,93,31,51,20,42,4,10,15,51,93
2006-08-28 00:00:00.000,US Open NY; U.S.A. Grand Slams,HARD,3,Gaston Gaudio,Sam Querrey,Gaston Gaudio,3-6; 6-2; 6-1; 6-4,R64,122,3,3,61,98,47,61,25,37,8,9,17,72,98,10,7,62,113,40,62,24,51,5,10,17,64,113
2006-08-28 00:00:00.000,US Open NY; U.S.A. Grand Slams,HARD,3,Marc Gicquel,Juan Carlos Ferrero,Marc Gicquel,7-5; 6-3; 6-4,R64,111,9,4,52,96,43,52,27,44,2,2,16,70,96,2,0,65,90,43,65,14,25,10,13,15,57,90
2006-08-28 00:00:00.000,US Open NY; U.S.A. Grand Slams,HARD,3,Tomas Berdych,Florian Mayer,Tomas Berdych,6-1; 3-6; 6-3; 6-3,R64,106,12,4,52,90,46,52,18,38,0,2,17,64,90,4,3,69,104,45,69,13,35,3,9,17,58,104
2006-08-28 00:00:00.000,US Open NY; U.S.A. Grand Slams,HARD,3,Dmitry Tursunov,Alejandro Falla,Dmitry Tursunov,6-3; 7-6(4); 7-5,R64,123,8,3,70,110,50,70,18,40,6,10,17,68,110,7,0,58,103,35,58,20,45,4,10,16,55,103
2006-08-28 00:00:00.000,US Open NY; U.S.A. Grand Slams,HARD,3,Carlos Moya,Paul-Henri Mathieu,Carlos Moya,7-6(5); 7-6(7); 6-4,R64,149,11,2,60,107,50,60,30,47,1,1,17,80,107,9,3,73,110,54,73,24,37,3,4,17,78,110
2006-08-28 00:00:00.000,US Open NY; U.S.A. Grand Slams,HARD,3,James Blake,Teymuraz Gabashvili,James Blake,6-3; 6-4; 7-6(5),R64,115,15,2,62,92,51,62,18,30,4,6,16,69,92,4,2,65,98,44,65,15,33,1,5,15,59,98
2006-08-28 00:00:00.000,US Open NY; U.S.A. Grand Slams,HARD,3,Marat Safin,David Nalbandian,Marat Safin,6-3; 7-5; 2-6; 3-6; 7-6(6),R64,226,15,7,83,154,62,83,37,71,6,10,25,99,154,6,11,99,164,72,99,33,65,6,9,25,105,164
2006-08-28 00:00:00.000,US Open NY; U.S.A. Grand Slams,HARD,3,Olivier Rochus,Ryan Sweeting,Olivier Rochus,6-2; 3-6; 4-6; 6-4; 6-0,R64,157,4,4,78,123,63,78,20,45,6,10,21,83,123,14,4,78,133,50,78,26,55,10,18,22,76,133
2006-08-28 00:00:00.000,US Open NY; U.S.A. Grand Slams,HARD,3,Robby Ginepri,Paul Goldstein,Robby Ginepri,6-2; 6-2; 6-4,R64,103,7,1,54,79,41,54,16,25,3,4,13,57,79,5,4,67,109,43,67,13,42,10,16,13,56,109
2006-08-28 00:00:00.000,US Open NY; U.S.A. Grand Slams,HARD,3,Tommy Haas,Raemon Sluiter,Tommy Haas,6-4; 6-2; 6-3,R64,86,10,6,50,74,38,50,16,24,2,4,14,54,74,5,3,38,76,25,38,17,38,6,12,13,42,76
2006-08-28 00:00:00.000,US Open NY; U.S.A. Grand Slams,HARD,3,Fernando Gonzalez,Jan Hajek,Fernando Gonzalez,6-4; 6-4; 6-2,R64,93,7,2,66,95,48,66,18,29,6,6,14,66,95,5,4,39,92,24,39,31,53,6,10,14,55,92
2006-08-28 00:00:00.000,US Open NY; U.S.A. Grand Slams,HARD,3,Andy Murray,Alessio Di Mauro,Andy Murray,6-0; 6-1; 6-1,R64,74,3,3,33,58,27,33,17,25,3,3,10,44,58,1,2,34,65,16,34,9,31,3,11,10,25,65
2006-08-28 00:00:00.000,US Open NY; U.S.A. Grand Slams,HARD,3,Lukasz Kubot,Noam Okun,Lukasz Kubot,7-6(7); 6-4; 2-6; 2-6; 6-4,R64,260,5,5,105,159,70,105,29,54,5,10,24,99,159,15,5,107,157,74,107,30,50,7,10,24,104,157
2006-08-28 00:00:00.000,US Open NY; U.S.A. Grand Slams,HARD,3,Nikolay Davydenko,Nicolas Mahut,Nikolay Davydenko,6-0 RET,R64,27,0,0,10,15,8,10,4,5,0,0,3,12,15,1,2,19,27,7,19,2,8,3,6,3,9,27
2006-08-28 00:00:00.000,US Open NY; U.S.A. Grand Slams,HARD,3,Andre Agassi,Marcos Baghdatis,Andre Agassi,6-4; 6-4; 3-6; 5-7; 7-5,R64,225,9,2,112,176,77,112,35,64,12,17,26,112,176,21,6,99,181,73,99,35,82,8,14,27,108,181
2006-08-28 00:00:00.000,US Open NY; U.S.A. Grand Slams,HARD,3,Benjamin Becker,Sebastien Grosjean,Benjamin Becker,7-6(3); 6-1; 6-2,R64,113,12,3,52,86,44,52,18,34,4,5,14,62,86,6,4,41,91,27,41,22,50,5,10,13,49,91
2006-08-28 00:00:00.000,US Open NY; U.S.A. Grand Slams,HARD,3,Fernando Verdasco,Thiago Alves,Fernando Verdasco,7-6(3); 6-4; 6-1,R64,113,11,4,70,93,55,70,13,23,9,9,14,68,93,1,5,59,94,37,59,20,35,2,6,15,57,94
2006-08-28 00:00:00.000,US Open NY; U.S.A. Grand Slams,HARD,3,Andy Roddick,Kristian Pless,Andy Roddick,6-3; 7-6(3); 6-3,R64,90,21,1,65,84,60,65,13,19,2,2,16,73,84,12,3,52,84,40,52,18,32,2,4,14,58,84
2006-08-28 00:00:00.000,US Open NY; U.S.A. Grand Slams,HARD,3,Lleyton Hewitt,Jan Hernych,Lleyton Hewitt,6-4; 6-2; 6-2,R64,102,9,5,39,86,29,39,26,47,4,6,13,55,86,1,0,53,68,24,53,7,15,3,10,13,31,68
2006-08-28 00:00:00.000,US Open NY; U.S.A. Grand Slams,HARD,3,Novak Djokovic,Mardy Fish,Novak Djokovic,7-6(5); 6-4; 3-6; 7-6(3),R64,191,9,8,92,148,71,92,33,56,9,10,21,104,148,21,4,72,144,59,72,45,72,6,7,22,104,144
2006-08-28 00:00:00.000,US Open NY; U.S.A. Grand Slams,HARD,3,Richard Gasquet,Gilles Simon,Richard Gasquet,6-0; 6-2; 6-3,R64,106,6,0,51,83,33,51,20,32,6,7,12,53,83,3,1,51,73,26,51,7,22,9,16,11,33,73
2006-08-28 00:00:00.000,US Open NY; U.S.A. Grand Slams,HARD,3,Marco Chiudinelli,Feliciano Lopez,Marco Chiudinelli,3-6; 6-3; 4-6; 6-4; 6-3,R64,183,11,1,87,148,64,87,36,61,7,10,24,100,148,21,2,90,136,65,90,25,46,5,9,23,90,136
2006-08-28 00:00:00.000,US Open NY; U.S.A. Grand Slams,HARD,3,Tommy Robredo,Hyung-Taik Lee,Tommy Robredo,3-6; 6-3; 6-4; 6-1,R64,142,4,1,73,108,45,73,20,35,9,13,17,65,108,1,3,70,110,46,70,15,40,2,10,18,61,110
2006-08-28 00:00:00.000,US Open NY; U.S.A. Grand Slams,HARD,3,Stanislas Wawrinka,Robin Soderling,Stanislas Wawrinka,6-7(4); 2-6; 7-6(4); 6-0; 6-1,R64,192,23,4,100,163,77,100,34,63,9,11,23,111,163,3,4,89,153,60,89,33,64,11,16,22,93,153
2006-08-28 00:00:00.000,US Open NY; U.S.A. Grand Slams,HARD,3,Mikhail Youzhny,Nicolas Massu,Mikhail Youzhny,5-7; 6-7(6); 6-4; 6-3; 6-0,R64,233,9,5,74,148,58,74,38,74,4,9,25,96,148,7,8,94,157,61,94,29,63,7,16,24,90,157
2006-08-28 00:00:00.000,US Open NY; U.S.A. Grand Slams,HARD,3,David Ferrer,Justin Gimelstob,David Ferrer,6-2; 6-4; 6-1,R64,98,0,2,39,67,33,39,18,28,2,2,12,51,67,5,6,47,86,33,47,11,39,5,11,13,44,86
2006-08-28 00:00:00.000,US Open NY; U.S.A. Grand Slams,HARD,3,Xavier Malisse,Bjorn Phau,Xavier Malisse,6-3; 6-0; 6-2,R64,94,3,0,25,55,22,25,22,30,0,1,12,44,55,4,10,47,94,25,47,18,47,7,14,11,43,94
2006-08-28 00:00:00.000,US Open NY; U.S.A. Grand Slams,HARD,3,Jiri Novak,Paradorn Srichaphan,Jiri Novak,7-6(3); 3-6; 6-4; 6-4,R64,154,3,2,96,144,66,96,23,48,11,16,21,89,144,12,5,63,121,52,63,25,58,4,9,20,77,121
2006-08-28 00:00:00.000,US Open NY; U.S.A. Grand Slams,HARD,3,Wesley Moodie,Gael Monfils,Wesley Moodie,6-4; 2-6; 6-2; 7-6(4),R64,147,9,3,81,109,67,81,15,28,2,4,19,82,109,16,6,68,121,49,68,31,53,8,11,19,80,121
2006-08-28 00:00:00.000,US Open NY; U.S.A. Grand Slams,HARD,3,Rafael Nadal,Luis Horna,Rafael Nadal,6-4; 4-6; 6-4; 6-2,R64,163,7,0,67,97,51,67,22,30,2,4,19,73,97,7,6,90,122,64,90,11,32,10,15,19,75,122
2006-08-28 00:00:00.000,US Open NY; U.S.A. Grand Slams,HARD,3,Roger Federer,Vincent Spadea,Roger Federer,6-3; 6-3; 6-0,R32,88,7,0,46,74,38,46,16,28,4,4,12,54,74,2,2,42,75,22,42,17,33,5,11,12,39,75
2006-08-28 00:00:00.000,US Open NY; U.S.A. Grand Slams,HARD,3,Marc Gicquel,Gaston Gaudio,Marc Gicquel,6-0; 4-6; 4-6; 6-1; 7-6(3),R32,196,12,2,90,150,70,90,23,60,9,15,23,93,150,7,9,93,151,55,93,25,58,12,21,22,80,151
2006-08-28 00:00:00.000,US Open NY; U.S.A. Grand Slams,HARD,3,Tomas Berdych,Dmitry Tursunov,Tomas Berdych,6-7(2); 6-3; 3-6; 6-3; 6-4,R32,192,18,2,92,165,74,92,34,73,11,14,25,108,165,21,5,84,156,62,84,38,72,8,13,24,100,156
2006-08-28 00:00:00.000,US Open NY; U.S.A. Grand Slams,HARD,3,James Blake,Carlos Moya,James Blake,6-4; 7-6(6); 2-6; 6-3,R32,154,7,2,73,120,56,73,26,47,3,6,20,82,120,10,5,94,148,68,94,24,54,11,14,19,92,148
2006-08-28 00:00:00.000,US Open NY; U.S.A. Grand Slams,HARD,3,Marat Safin,Olivier Rochus,Marat Safin,6-3; 6-2; 6-3,R32,91,12,2,38,66,32,38,18,28,0,1,13,50,66,1,6,54,81,34,54,11,27,5,11,13,45,81
2006-08-28 00:00:00.000,US Open NY; U.S.A. Grand Slams,HARD,3,Tommy Haas,Robby Ginepri,Tommy Haas,7-6(1); 6-4; 3-6; 3-6; 7-6(1),R32,203,20,10,96,164,77,96,34,68,7,11,26,111,164,15,3,97,154,73,97,31,57,4,6,26,104,154
2006-08-28 00:00:00.000,US Open NY; U.S.A. Grand Slams,HARD,3,Andy Murray,Fernando Gonzalez,Andy Murray,6-3; 3-6; 2-6; 6-3; 6-2,R32,161,4,8,68,119,52,68,27,51,2,7,22,79,119,9,4,94,136,66,94,18,42,11,17,21,84,136
2006-08-28 00:00:00.000,US Open NY; U.S.A. Grand Slams,HARD,3,Nikolay Davydenko,Lukasz Kubot,Nikolay Davydenko,6-4; 6-1; 6-1,R32,100,2,1,54,73,39,54,13,19,6,6,12,52,73,1,4,38,72,22,38,14,34,2,8,12,36,72
2006-08-28 00:00:00.000,US Open NY; U.S.A. Grand Slams,HARD,3,Benjamin Becker,Andre Agassi,Benjamin Becker,7-5; 6-7(4); 6-4; 7-5,R32,181,27,4,77,157,55,77,47,80,8,10,23,102,157,20,6,90,150,61,90,32,60,8,13,23,93,150
2006-08-28 00:00:00.000,US Open NY; U.S.A. Grand Slams,HARD,3,Andy Roddick,Fernando Verdasco,Andy Roddick,6-7(5); 6-3; 6-4; 6-7(4); 6-2,R32,199,14,2,111,162,84,111,29,51,5,7,26,113,162,8,7,116,149,81,116,18,33,1,7,25,99,149
2006-08-28 00:00:00.000,US Open NY; U.S.A. Grand Slams,HARD,3,Lleyton Hewitt,Novak Djokovic,Lleyton Hewitt,6-3; 6-1; 6-2,R32,89,10,3,37,71,29,37,23,34,5,5,12,52,71,3,7,56,83,32,56,10,27,5,11,12,42,83
2006-08-28 00:00:00.000,US Open NY; U.S.A. Grand Slams,HARD,3,Richard Gasquet,Marco Chiudinelli,Richard Gasquet,7-6(2); 6-3; 2-6; 7-6(2),R32,171,11,4,72,135,52,72,36,63,4,8,20,88,135,3,4,78,133,59,78,23,55,5,9,21,82,133
2006-08-28 00:00:00.000,US Open NY; U.S.A. Grand Slams,HARD,3,Tommy Robredo,Stanislas Wawrinka,Tommy Robredo,6-3; 6-4; 6-2,R32,113,4,1,49,71,36,49,10,22,4,7,13,46,71,2,5,52,95,32,52,16,43,11,19,14,48,95
2006-08-28 00:00:00.000,US Open NY; U.S.A. Grand Slams,HARD,3,Mikhail Youzhny,David Ferrer,Mikhail Youzhny,4-6; 6-4; 7-5; 6-4,R32,175,10,7,78,152,60,78,34,74,17,21,21,94,152,3,5,77,123,56,77,17,46,7,13,21,73,123
2006-08-28 00:00:00.000,US Open NY; U.S.A. Grand Slams,HARD,3,Jiri Novak,Xavier Malisse,Jiri Novak,6-7(6); 6-3; 6-4; 6-4,R32,148,6,1,84,126,64,84,24,42,1,3,21,88,126,10,4,71,126,51,71,29,55,9,14,20,80,126
2006-08-28 00:00:00.000,US Open NY; U.S.A. Grand Slams,HARD,3,Rafael Nadal,Wesley Moodie,Rafael Nadal,6-4; 7-6(5); 7-6(4),R32,169,8,3,74,101,57,74,20,27,2,3,17,77,101,11,7,94,134,66,94,19,40,8,10,17,85,134
2006-08-28 00:00:00.000,US Open NY; U.S.A. Grand Slams,HARD,3,Roger Federer,Marc Gicquel,Roger Federer,6-3; 7-6(2); 6-3,R16,104,15,2,61,94,48,61,23,33,5,5,16,71,94,8,0,43,87,33,43,22,44,1,3,14,55,87
2006-08-28 00:00:00.000,US Open NY; U.S.A. Grand Slams,HARD,3,James Blake,Tomas Berdych,James Blake,6-4; 6-3; 6-1,R16,96,14,1,57,95,43,57,21,38,15,15,13,64,95,7,3,56,86,34,56,13,30,4,9,13,47,86
2006-08-28 00:00:00.000,US Open NY; U.S.A. Grand Slams,HARD,3,Tommy Haas,Marat Safin,Tommy Haas,4-6; 6-3; 2-6; 6-2; 7-6(5),R16,190,5,4,101,153,68,101,26,52,6,11,24,94,153,9,2,68,129,48,68,35,61,1,6,23,83,129
2006-08-28 00:00:00.000,US Open NY; U.S.A. Grand Slams,HARD,3,Nikolay Davydenko,Andy Murray,Nikolay Davydenko,6-1; 5-7; 6-3; 6-0,R16,179,3,4,83,123,58,83,16,40,9,12,17,74,123,7,5,51,108,33,51,23,57,7,16,17,56,108
2006-08-28 00:00:00.000,US Open NY; U.S.A. Grand Slams,HARD,3,Andy Roddick,Benjamin Becker,Andy Roddick,6-3; 6-4; 6-3,R16,95,20,0,53,70,46,53,11,17,0,0,14,57,70,9,5,43,87,32,43,18,44,2,6,14,50,87
2006-08-28 00:00:00.000,US Open NY; U.S.A. Grand Slams,HARD,3,Lleyton Hewitt,Richard Gasquet,Lleyton Hewitt,6-4; 6-4; 4-6; 3-6; 6-3,R16,210,17,3,88,164,55,88,43,76,9,15,24,98,164,7,5,94,140,65,94,21,46,7,14,24,86,140
2006-08-28 00:00:00.000,US Open NY; U.S.A. Grand Slams,HARD,3,Mikhail Youzhny,Tommy Robredo,Mikhail Youzhny,6-2; 6-0; 6-1,R16,77,2,1,34,61,28,34,18,27,1,1,11,46,61,2,5,34,59,13,34,9,25,9,16,10,22,59
2006-08-28 00:00:00.000,US Open NY; U.S.A. Grand Slams,HARD,3,Rafael Nadal,Jiri Novak,Rafael Nadal,6-1; 7-6(3); 6-4,R16,129,6,1,54,90,43,54,22,36,1,2,15,65,90,9,5,62,92,42,62,13,30,7,11,14,55,92
2006-08-28 00:00:00.000,US Open NY; U.S.A. Grand Slams,HARD,3,Roger Federer,James Blake,Roger Federer,7-6(7); 6-0; 6-7(9); 6-4,Q,165,9,4,84,137,66,84,24,53,5,8,20,90,137,8,4,91,154,54,91,31,63,10,17,20,85,154
2006-08-28 00:00:00.000,US Open NY; U.S.A. Grand Slams,HARD,3,Nikolay Davydenko,Tommy Haas,Nikolay Davydenko,4-6; 6-7(3); 6-3; 6-4; 6-4,Q,222,6,0,133,172,86,133,23,39,6,10,26,109,172,13,8,90,141,65,90,23,51,2,8,25,88,141
2006-08-28 00:00:00.000,US Open NY; U.S.A. Grand Slams,HARD,3,Andy Roddick,Lleyton Hewitt,Andy Roddick,6-3; 7-5; 6-4,Q,112,17,2,65,89,53,65,13,24,3,4,16,66,89,10,3,39,79,30,39,21,40,0,4,15,51,79
2006-08-28 00:00:00.000,US Open NY; U.S.A. Grand Slams,HARD,3,Mikhail Youzhny,Rafael Nadal,Mikhail Youzhny,6-3; 5-7; 7-6(5); 6-1,Q,195,7,3,84,128,61,84,29,44,9,11,21,90,128,1,1,78,123,52,78,22,45,5,9,19,74,123
2006-08-28 00:00:00.000,US Open NY; U.S.A. Grand Slams,HARD,3,Roger Federer,Nikolay Davydenko,Roger Federer,6-1; 7-5; 6-4,S,101,4,1,54,81,41,54,16,27,1,3,15,57,81,2,2,60,85,31,60,15,25,2,8,14,46,85
2006-08-28 00:00:00.000,US Open NY; U.S.A. Grand Slams,HARD,3,Andy Roddick,Mikhail Youzhny,Andy Roddick,6-7(5); 6-0; 7-6(3); 6-3,S,164,14,1,85,121,67,85,23,36,2,3,20,90,121,6,6,89,132,61,89,15,43,5,10,19,76,132
2006-08-28 00:00:00.000,US Open NY; U.S.A. Grand Slams,HARD,3,Roger Federer,Andy Roddick,Roger Federer,6-2; 4-6; 7-5; 6-1,F,145,17,0,63,103,53,63,20,40,6,8,19,73,103,7,1,80,122,53,80,16,42,10,16,18,69,122
2006-09-11 00:00:00.000,Beijing China ATP World Tour,HARD,2,Ivan Ljubicic,Go Soeda,Ivan Ljubicic,6-4; 6-2,R32,71,11,3,29,51,22,29,14,22,0,1,9,36,51,1,5,27,57,18,27,11,30,6,10,9,29,57
2006-09-11 00:00:00.000,Beijing China ATP World Tour,HARD,2,Kevin Kim,Kristian Pless,Kevin Kim,6-2; 6-4,R32,54,6,1,26,51,21,26,17,25,2,2,9,38,51,8,2,30,51,20,30,11,21,2,5,9,31,51
2006-09-11 00:00:00.000,Beijing China ATP World Tour,HARD,2,Michael Berrer,Gouichi Motomura,Michael Berrer,7-5; 6-4,R32,83,6,1,41,66,30,41,14,25,2,3,11,44,66,2,2,41,66,31,41,9,25,1,4,11,40,66
2006-09-11 00:00:00.000,Beijing China ATP World Tour,HARD,2,Hyung-Taik Lee,Igor Kunitsyn,Hyung-Taik Lee,6-3; 6-4,R32,67,2,2,38,57,30,38,12,19,1,2,10,42,57,5,1,30,51,24,30,6,21,2,5,9,30,51
2006-09-11 00:00:00.000,Beijing China ATP World Tour,HARD,2,Mario Ancic,Feliciano Lopez,Mario Ancic,6-3; 3-6; 6-3,R32,113,8,0,45,77,37,45,20,32,4,5,14,57,77,9,3,51,87,35,51,21,36,3,5,13,56,87
2006-09-11 00:00:00.000,Beijing China ATP World Tour,HARD,2,Stefano Galvani,Yen-Hsun Lu,Stefano Galvani,6-3; 7-6(4),R32,93,1,4,50,72,34,50,12,22,2,4,11,46,72,1,4,44,72,28,44,13,28,5,8,10,41,72
2006-09-11 00:00:00.000,Beijing China ATP World Tour,HARD,2,Alexander Peya,Ramon Delgado,Alexander Peya,6-4; 6-2,R32,65,2,1,32,49,24,32,11,17,1,2,9,35,49,1,3,32,53,19,32,10,21,3,7,9,29,53
2006-09-11 00:00:00.000,Beijing China ATP World Tour,HARD,2,Dominik Hrbaty,Rik De Voest,Dominik Hrbaty,6-1; 6-0,R32,64,3,2,20,36,19,20,8,16,3,3,6,27,36,2,1,41,72,21,41,9,31,11,17,7,30,72
2006-09-11 00:00:00.000,Beijing China ATP World Tour,HARD,2,Ivo Karlovic,Mikhail Ledovskikh,Ivo Karlovic,6-2; 7-6(2),R32,74,25,1,45,57,40,45,6,12,1,1,10,46,57,7,5,31,61,21,31,16,30,1,3,10,37,61
2006-09-11 00:00:00.000,Beijing China ATP World Tour,HARD,2,Danai Udomchoke,Marco Chiudinelli,Danai Udomchoke,0-6; 6-2; 6-3,R32,120,5,2,43,75,32,43,13,32,4,7,11,45,75,10,0,55,102,34,55,21,47,14,18,12,55,102
2006-09-11 00:00:00.000,Beijing China ATP World Tour,HARD,2,Jimmy Wang,Xin-Yuan Yu,Jimmy Wang,6-1; 6-4,R32,71,5,0,31,47,24,31,8,16,4,5,8,32,47,4,2,27,52,16,27,8,25,3,8,9,24,52
2006-09-11 00:00:00.000,Beijing China ATP World Tour,HARD,2,Marcos Baghdatis,Denis Gremelmayr,Marcos Baghdatis,4-6; 6-1; 7-6(5),R32,130,4,5,43,104,34,43,32,61,9,11,15,66,104,2,2,60,90,37,60,19,30,3,6,14,56,90
2006-09-11 00:00:00.000,Beijing China ATP World Tour,HARD,2,Paradorn Srichaphan,Rainer Schuettler,Paradorn Srichaphan,6-3; 6-3,R32,67,7,3,23,53,18,23,21,30,2,2,9,39,53,4,2,33,55,20,33,11,22,5,8,9,31,55
2006-09-11 00:00:00.000,Beijing China ATP World Tour,HARD,2,Satoshi Iwabuchi,Nathan Healey,Satoshi Iwabuchi,6-1; 7-6(5),R32,86,2,0,46,62,32,46,12,16,2,3,10,44,62,4,8,34,60,24,34,10,26,4,7,9,34,60
2006-09-11 00:00:00.000,Beijing China ATP World Tour,HARD,2,Luka Gregorc,Yu Jr. Wang,Luka Gregorc,7-6(6); 6-3,R32,113,8,7,37,64,28,37,11,27,2,5,10,39,64,4,3,60,85,36,60,8,25,3,8,11,44,85
2006-09-11 00:00:00.000,Beijing China ATP World Tour,HARD,2,Nikolay Davydenko,Kenneth Carlsen,Nikolay Davydenko,6-3; 6-4,R32,78,3,2,41,60,27,41,14,19,5,6,10,41,60,1,1,30,50,19,30,10,20,0,3,9,29,50
2006-09-11 00:00:00.000,Beijing China ATP World Tour,HARD,2,Ivan Ljubicic,Kevin Kim,Ivan Ljubicic,6-3; 6-4,R16,67,15,2,35,59,31,35,12,24,1,1,10,43,59,2,4,27,57,21,27,14,30,0,2,9,35,57
2006-09-11 00:00:00.000,Beijing China ATP World Tour,HARD,2,Hyung-Taik Lee,Michael Berrer,Hyung-Taik Lee,4-6; 7-6(4); 7-6(4),R16,144,10,0,73,105,53,73,19,32,4,7,17,72,105,10,7,71,115,56,71,18,44,3,5,17,74,115
2006-09-11 00:00:00.000,Beijing China ATP World Tour,HARD,2,Mario Ancic,Stefano Galvani,Mario Ancic,6-3; 7-5,R16,101,13,1,37,60,28,37,13,23,0,1,11,41,60,1,5,38,73,24,38,19,35,1,4,10,43,73
2006-09-11 00:00:00.000,Beijing China ATP World Tour,HARD,2,Dominik Hrbaty,Alexander Peya,Dominik Hrbaty,6-1; 2-6; 6-0,R16,80,0,4,43,72,25,43,17,29,5,8,11,42,72,6,7,35,58,20,35,8,23,5,11,10,28,58
2006-09-11 00:00:00.000,Beijing China ATP World Tour,HARD,2,Danai Udomchoke,Ivo Karlovic,Danai Udomchoke,6-2; 3-1 RET,R16,42,3,0,26,31,23,26,2,5,0,0,6,25,31,7,0,24,39,15,24,5,15,2,5,6,20,39
2006-09-11 00:00:00.000,Beijing China ATP World Tour,HARD,2,Marcos Baghdatis,Jimmy Wang,Marcos Baghdatis,7-6(4); 6-4,R16,100,10,3,39,82,25,39,27,43,3,4,11,52,82,3,1,47,77,31,47,14,30,4,6,11,45,77
2006-09-11 00:00:00.000,Beijing China ATP World Tour,HARD,2,Paradorn Srichaphan,Satoshi Iwabuchi,Paradorn Srichaphan,6-3; 6-1,R16,54,8,2,20,43,19,20,14,23,0,0,8,33,43,0,2,29,52,16,29,9,23,3,7,8,25,52
2006-09-11 00:00:00.000,Beijing China ATP World Tour,HARD,2,Nikolay Davydenko,Luka Gregorc,Nikolay Davydenko,7-6(2); 6-2,R16,82,5,1,52,68,40,52,8,16,3,4,10,48,68,6,8,43,61,30,43,6,18,1,4,10,36,61
2006-09-11 00:00:00.000,Beijing China ATP World Tour,HARD,2,Hyung-Taik Lee,Ivan Ljubicic,Hyung-Taik Lee,6-3; 7-6(3),Q,101,0,0,51,72,37,51,13,21,1,2,11,50,72,12,2,53,81,37,53,11,28,4,6,10,48,81
2006-09-11 00:00:00.000,Beijing China ATP World Tour,HARD,2,Mario Ancic,Dominik Hrbaty,Mario Ancic,2-6; 7-6(4); 6-4,Q,130,13,0,78,99,53,78,13,21,5,7,15,66,99,2,8,63,100,50,63,17,37,5,6,15,67,100
2006-09-11 00:00:00.000,Beijing China ATP World Tour,HARD,2,Marcos Baghdatis,Danai Udomchoke,Marcos Baghdatis,6-2; 6-1,Q,79,8,5,23,59,22,23,17,36,7,7,8,39,59,0,7,29,55,20,29,5,26,8,12,7,25,55
2006-09-11 00:00:00.000,Beijing China ATP World Tour,HARD,2,Paradorn Srichaphan,Nikolay Davydenko,Paradorn Srichaphan,6-2; 1-0 RET,Q,32,1,0,14,25,10,14,10,11,0,0,5,20,25,2,1,12,19,8,12,2,7,0,2,4,10,19
2006-09-11 00:00:00.000,Beijing China ATP World Tour,HARD,2,Mario Ancic,Hyung-Taik Lee,Mario Ancic,4-6; 6-1; 6-1,S,129,3,3,47,82,30,47,22,35,6,8,12,52,82,3,0,55,84,29,55,14,29,5,11,12,43,84
2006-09-11 00:00:00.000,Beijing China ATP World Tour,HARD,2,Marcos Baghdatis,Paradorn Srichaphan,Marcos Baghdatis,6-2; 3-6; 7-5,S,121,2,3,47,83,40,47,18,36,5,6,14,58,83,6,3,61,95,44,61,15,34,6,9,15,59,95
2006-09-11 00:00:00.000,Beijing China ATP World Tour,HARD,2,Marcos Baghdatis,Mario Ancic,Marcos Baghdatis,6-4; 6-0,F,72,5,1,21,39,18,21,14,18,0,0,8,32,39,5,0,32,54,18,32,8,22,2,6,8,26,54
2006-09-11 00:00:00.000,Bucharest Romania ATP World Tour,CLAY,2,Dmitry Tursunov,Alexander Waske,Dmitry Tursunov,1-6; 7-6(4); 6-4,R32,130,9,2,55,101,39,55,17,46,4,10,15,56,101,10,4,54,85,37,54,14,31,3,7,14,51,85
2006-09-11 00:00:00.000,Bucharest Romania ATP World Tour,CLAY,2,Guillermo Garcia-Lopez,Albert Montanes,Guillermo Garcia-Lopez,3-6; 7-5; 6-1,R32,113,4,2,60,85,35,60,12,25,8,13,14,47,85,1,4,45,85,29,45,14,40,5,12,14,43,85
2006-09-11 00:00:00.000,Bucharest Romania ATP World Tour,CLAY,2,Victor Crivoi,Edgardo Massa,Victor Crivoi,7-5; 4-6; 6-4,R32,126,1,3,58,86,45,58,10,28,2,6,16,55,86,3,4,66,107,44,66,21,41,8,13,16,65,107
2006-09-11 00:00:00.000,Bucharest Romania ATP World Tour,CLAY,2,Paul-Henri Mathieu,Simon Greul,Paul-Henri Mathieu,6-1; 6-1,R32,54,1,0,26,43,18,26,11,17,2,3,7,29,43,0,0,26,39,11,26,2,13,5,11,7,13,39
2006-09-11 00:00:00.000,Bucharest Romania ATP World Tour,CLAY,2,Gilles Simon,Juan Monaco,Gilles Simon,7-5; 3-6; 6-3,R32,152,6,4,49,97,31,49,27,48,7,11,15,58,97,1,4,60,89,39,60,14,29,5,10,15,53,89
2006-09-11 00:00:00.000,Bucharest Romania ATP World Tour,CLAY,2,Jurgen Melzer,Michal Mertinak,Jurgen Melzer,5-7; 6-2; 7-5,R32,138,8,2,62,97,44,62,17,35,4,8,16,61,97,1,1,57,99,30,57,25,42,6,12,16,55,99
2006-09-11 00:00:00.000,Bucharest Romania ATP World Tour,CLAY,2,Christophe Rochus,Alexandr Dolgopolov,Christophe Rochus,6-2; 7-6(5),R32,70,2,3,43,61,33,43,10,18,2,3,10,43,61,5,1,36,62,24,36,12,26,2,4,10,36,62
2006-09-11 00:00:00.000,Bucharest Romania ATP World Tour,CLAY,2,Ruben Ramirez Hidalgo,Victor Ionita,Ruben Ramirez Hidalgo,6-4; 6-4,R32,88,2,0,41,59,30,41,7,18,2,4,10,37,59,2,1,43,63,25,43,10,20,5,9,10,35,63
2006-09-11 00:00:00.000,Bucharest Romania ATP World Tour,CLAY,2,Filippo Volandri,Simone Vagnozzi,Filippo Volandri,3-6; 6-2; 6-2,R32,85,4,2,55,81,33,55,10,26,6,11,13,43,81,1,1,58,73,25,58,9,15,1,8,12,34,73
2006-09-11 00:00:00.000,Bucharest Romania ATP World Tour,CLAY,2,Stefan Koubek,Mariano Zabaleta,Stefan Koubek,4-6; 6-4; 6-3,R32,154,4,5,61,106,36,61,26,45,7,11,15,62,106,0,2,79,121,49,79,16,42,13,18,14,65,121
2006-09-11 00:00:00.000,Bucharest Romania ATP World Tour,CLAY,2,Andrei Pavel,Boris Pashanski,Andrei Pavel,6-3; 6-1,R32,77,4,1,27,49,21,27,15,22,1,1,8,36,49,0,3,33,65,19,33,15,32,6,10,8,34,65
2006-09-11 00:00:00.000,Bucharest Romania ATP World Tour,CLAY,2,Carlos Moya,Luis Horna,Carlos Moya,6-7(4); 7-6(3); 7-5,R32,179,11,3,71,113,57,71,23,42,1,1,18,80,113,2,5,80,128,60,80,26,48,7,8,18,86,128
2006-09-11 00:00:00.000,Bucharest Romania ATP World Tour,CLAY,2,Florian Mayer,Potito Starace,Florian Mayer,6-2; 6-3,R32,69,1,1,37,56,25,37,10,19,3,5,9,35,56,0,1,43,56,22,43,5,13,1,6,8,27,56
2006-09-11 00:00:00.000,Bucharest Romania ATP World Tour,CLAY,2,Sergio Roitman,Alessio Di Mauro,Sergio Roitman,6-3; 6-2,R32,71,1,0,28,41,22,28,11,13,0,0,8,33,41,1,2,34,54,21,34,7,20,1,5,9,28,54
2006-09-11 00:00:00.000,Bucharest Romania ATP World Tour,CLAY,2,Martin Vassallo Arguello,Razvan Sabau,Martin Vassallo Arguello,6-3; 1-6; 6-3,R32,120,8,2,65,94,41,65,16,29,10,13,13,57,94,2,3,36,61,28,36,11,25,0,3,12,39,61
2006-09-11 00:00:00.000,Bucharest Romania ATP World Tour,CLAY,2,Florent Serra,Juan-Martin Aranguren,Florent Serra,6-1; 6-0,R32,135,2,1,24,32,20,24,5,8,0,0,6,25,32,0,1,21,39,7,21,5,18,1,7,7,12,39
2006-09-11 00:00:00.000,Bucharest Romania ATP World Tour,CLAY,2,Guillermo Garcia-Lopez,Dmitry Tursunov,Guillermo Garcia-Lopez,6-2; 3-6; 7-6(3),R16,148,2,3,71,98,48,71,12,27,7,11,14,60,98,8,2,63,111,39,63,23,48,13,18,15,62,111
2006-09-11 00:00:00.000,Bucharest Romania ATP World Tour,CLAY,2,Paul-Henri Mathieu,Victor Crivoi,Paul-Henri Mathieu,6-1; 6-1,R16,69,4,0,26,38,20,26,9,12,0,0,7,29,38,2,1,35,55,18,35,7,20,5,10,7,25,55
2006-09-11 00:00:00.000,Bucharest Romania ATP World Tour,CLAY,2,Jurgen Melzer,Gilles Simon,Jurgen Melzer,3-6; 6-3; 6-4,R16,133,5,2,64,103,38,64,16,39,6,12,14,54,103,2,1,63,98,36,63,13,35,9,16,14,49,98
2006-09-11 00:00:00.000,Bucharest Romania ATP World Tour,CLAY,2,Ruben Ramirez Hidalgo,Christophe Rochus,Ruben Ramirez Hidalgo,3-6; 6-3; 6-1,R16,99,6,2,52,71,36,52,9,19,5,9,13,45,71,1,0,44,70,23,44,13,26,2,8,12,36,70
2006-09-11 00:00:00.000,Bucharest Romania ATP World Tour,CLAY,2,Filippo Volandri,Stefan Koubek,Filippo Volandri,3-6; 6-2; 6-2,R16,108,1,0,57,75,34,57,8,18,1,5,12,42,75,0,8,61,104,35,61,16,43,19,26,13,51,104
2006-09-11 00:00:00.000,Bucharest Romania ATP World Tour,CLAY,2,Carlos Moya,Andrei Pavel,Carlos Moya,6-4; 7-6(5),R16,98,6,1,44,74,35,44,14,30,4,6,11,49,74,1,1,45,65,32,45,9,20,3,6,11,41,65
2006-09-11 00:00:00.000,Bucharest Romania ATP World Tour,CLAY,2,Florian Mayer,Sergio Roitman,Florian Mayer,6-4; 6-1,R16,68,5,1,32,51,24,32,12,19,1,1,8,36,51,4,0,42,57,27,42,4,15,4,8,9,31,57
2006-09-11 00:00:00.000,Bucharest Romania ATP World Tour,CLAY,2,Florent Serra,Martin Vassallo Arguello,Florent Serra,6-4; 6-1,R16,79,1,1,25,42,21,25,12,17,3,3,8,33,42,1,2,48,64,26,48,7,16,5,9,9,33,64
2006-09-11 00:00:00.000,Bucharest Romania ATP World Tour,CLAY,2,Paul-Henri Mathieu,Guillermo Garcia-Lopez,Paul-Henri Mathieu,6-1; 6-4,Q,91,1,1,41,65,26,41,15,24,6,7,9,41,65,0,1,24,46,10,24,14,22,3,7,8,24,46
2006-09-11 00:00:00.000,Bucharest Romania ATP World Tour,CLAY,2,Jurgen Melzer,Ruben Ramirez Hidalgo,Jurgen Melzer,6-4; 6-2,Q,72,3,1,39,54,23,39,8,15,1,4,9,31,54,3,1,37,53,20,37,4,16,0,6,9,24,53
2006-09-11 00:00:00.000,Bucharest Romania ATP World Tour,CLAY,2,Filippo Volandri,Carlos Moya,Filippo Volandri,6-3; 6-3,Q,78,0,1,45,58,34,45,6,13,4,4,9,40,58,4,5,38,65,29,38,8,27,5,8,9,37,65
2006-09-11 00:00:00.000,Bucharest Romania ATP World Tour,CLAY,2,Florent Serra,Florian Mayer,Florent Serra,6-3; 7-6(5),Q,82,3,1,39,67,24,39,15,28,5,9,10,39,67,4,3,41,67,23,41,11,26,2,8,11,34,67
2006-09-11 00:00:00.000,Bucharest Romania ATP World Tour,CLAY,2,Jurgen Melzer,Paul-Henri Mathieu,Jurgen Melzer,6-4 RET,S,49,2,0,20,29,15,20,7,9,2,2,5,22,29,1,0,20,31,15,20,5,11,3,4,5,20,31
2006-09-11 00:00:00.000,Bucharest Romania ATP World Tour,CLAY,2,Filippo Volandri,Florent Serra,Filippo Volandri,7-6(6); 6-4,S,101,1,1,52,72,34,52,16,20,5,6,11,50,72,3,1,49,85,30,49,21,36,9,11,11,51,85
2006-09-11 00:00:00.000,Bucharest Romania ATP World Tour,CLAY,2,Jurgen Melzer,Filippo Volandri,Jurgen Melzer,6-1; 7-5,F,85,7,0,40,59,31,40,13,19,1,1,10,44,59,0,0,45,67,28,45,11,22,5,8,9,39,67
2006-09-25 00:00:00.000,Bangkok Thailand ATP World Tour,HARD,2,Ivan Ljubicic,Fernando Vicente,Ivan Ljubicic,6-3; 3-6; 6-4,R32,115,19,0,40,68,34,40,19,28,0,1,14,53,68,2,4,64,95,44,64,18,31,8,10,14,62,95
2006-09-25 00:00:00.000,Bangkok Thailand ATP World Tour,HARD,2,Benjamin Becker,Marcos Daniel,Benjamin Becker,6-3; 6-2,R32,49,10,2,30,47,29,30,8,17,1,1,9,37,47,3,1,35,46,22,35,3,11,1,4,8,25,46
2006-09-25 00:00:00.000,Bangkok Thailand ATP World Tour,HARD,2,Danai Udomchoke,George Bastl,Danai Udomchoke,6-3; 6-0,R32,73,3,0,25,44,18,25,13,19,1,1,7,31,44,3,2,29,54,20,29,5,25,4,9,8,25,54
2006-09-25 00:00:00.000,Bangkok Thailand ATP World Tour,HARD,2,Robby Ginepri,Kenneth Carlsen,Robby Ginepri,6-3; 6-4,R32,69,4,1,36,49,29,36,9,13,1,2,10,38,49,3,1,40,62,24,40,9,22,5,8,9,33,62
2006-09-25 00:00:00.000,Bangkok Thailand ATP World Tour,HARD,2,Tim Henman,Andy Murray,Tim Henman,6-4; 6-2,R32,87,7,3,44,70,31,44,13,26,6,7,9,44,70,3,2,39,58,24,39,8,19,2,6,9,32,58
2006-09-25 00:00:00.000,Bangkok Thailand ATP World Tour,HARD,2,Alex Bogdanovic,Jimmy Wang,Alex Bogdanovic,6-7(7); 6-4; 6-4,R32,132,6,2,60,100,49,60,21,40,2,3,16,70,100,14,0,56,97,44,56,21,41,2,5,16,65,97
2006-09-25 00:00:00.000,Bangkok Thailand ATP World Tour,HARD,2,Mikhail Ledovskikh,Michael Ryderstedt,Mikhail Ledovskikh,6-1; 7-6(7),R32,89,18,2,42,70,36,42,15,28,4,4,10,51,70,4,1,32,67,24,32,19,35,5,7,9,43,67
2006-09-25 00:00:00.000,Bangkok Thailand ATP World Tour,HARD,2,Paradorn Srichaphan,Feliciano Lopez,Paradorn Srichaphan,6-1; 6-4,R32,56,3,2,26,42,23,26,13,16,0,0,9,36,42,2,5,21,44,17,21,9,23,3,6,8,26,44
2006-09-25 00:00:00.000,Bangkok Thailand ATP World Tour,HARD,2,Jarkko Nieminen,Edgardo Massa,Jarkko Nieminen,6-7(6); 6-3; 6-2,R32,109,4,5,68,111,50,68,24,43,8,9,15,74,111,4,5,37,83,31,37,24,46,5,9,14,55,83
2006-09-25 00:00:00.000,Bangkok Thailand ATP World Tour,HARD,2,Frank Dancevic,Lars Burgsmuller,Frank Dancevic,7-5; 3-6; 7-6(7),R32,171,10,2,78,117,55,78,19,39,6,9,16,74,117,8,6,94,133,68,94,14,39,14,17,17,82,133
2006-09-25 00:00:00.000,Bangkok Thailand ATP World Tour,HARD,2,Benjamin Balleret,Alexander Waske,Benjamin Balleret,7-5; 2-6; 6-1,R32,95,16,0,49,69,36,49,14,20,0,2,14,50,69,11,4,46,90,39,46,16,44,7,10,13,55,90
2006-09-25 00:00:00.000,Bangkok Thailand ATP World Tour,HARD,2,James Blake,Marin Cilic,James Blake,6-1; 6-2,R32,47,3,1,25,41,20,25,10,16,1,2,8,30,41,2,2,29,45,14,29,6,16,3,8,7,20,45
2006-09-25 00:00:00.000,Bangkok Thailand ATP World Tour,HARD,2,Mischa Zverev,Juan Carlos Ferrero,Mischa Zverev,4-6; 6-2; 6-4,R32,102,10,0,68,94,52,68,10,26,4,5,14,62,94,2,2,51,74,37,51,13,23,2,5,14,50,74
2006-09-25 00:00:00.000,Bangkok Thailand ATP World Tour,HARD,2,Rainer Schuettler,Hyung-Taik Lee,Rainer Schuettler,6-1; 6-4,R32,62,6,3,25,45,18,25,14,20,0,1,9,32,45,0,2,44,58,24,44,5,14,7,11,8,29,58
2006-09-25 00:00:00.000,Bangkok Thailand ATP World Tour,HARD,2,Marat Safin,Kevin Kim,Marat Safin,2-6; 6-1; 6-4,R32,89,10,1,44,73,27,44,16,29,4,8,13,43,73,5,2,60,87,37,60,11,27,8,13,12,48,87
2006-09-25 00:00:00.000,Bangkok Thailand ATP World Tour,HARD,2,Julien Benneteau,Satoshi Iwabuchi,Julien Benneteau,6-4; 6-2,R32,81,12,3,43,64,30,43,11,21,7,8,9,41,64,1,2,47,67,28,47,7,20,9,13,9,35,67
2006-09-25 00:00:00.000,Bangkok Thailand ATP World Tour,HARD,2,Ivan Ljubicic,Benjamin Becker,Ivan Ljubicic,7-6(6); 7-5,R16,114,16,4,47,88,39,47,23,41,3,3,12,62,88,8,3,46,76,35,46,19,30,4,5,12,54,76
2006-09-25 00:00:00.000,Bangkok Thailand ATP World Tour,HARD,2,Robby Ginepri,Danai Udomchoke,Robby Ginepri,6-3; 6-3,R16,68,14,0,46,67,31,46,13,21,6,6,9,44,67,4,2,35,54,26,35,5,19,4,7,9,31,54
2006-09-25 00:00:00.000,Bangkok Thailand ATP World Tour,HARD,2,Tim Henman,Alex Bogdanovic,Tim Henman,6-3; 5-7; 6-1,R16,140,7,3,55,91,41,55,19,36,5,7,14,60,91,2,4,59,101,34,59,22,42,9,14,14,56,101
2006-09-25 00:00:00.000,Bangkok Thailand ATP World Tour,HARD,2,Paradorn Srichaphan,Mikhail Ledovskikh,Paradorn Srichaphan,6-4; 5-7; 6-2,R16,131,14,7,48,92,41,48,25,44,6,7,15,66,92,19,4,62,126,48,62,26,64,11,14,15,74,126
2006-09-25 00:00:00.000,Bangkok Thailand ATP World Tour,HARD,2,Jarkko Nieminen,Frank Dancevic,Jarkko Nieminen,2-6; 7-6(3); 6-4,R16,114,8,5,61,102,43,61,22,41,6,9,15,65,102,9,1,65,87,50,65,10,22,6,8,15,60,87
2006-09-25 00:00:00.000,Bangkok Thailand ATP World Tour,HARD,2,James Blake,Benjamin Balleret,James Blake,6-3; 6-2,R16,56,4,5,29,57,22,29,16,28,3,4,9,38,57,3,0,30,49,13,30,12,19,3,7,8,25,49
2006-09-25 00:00:00.000,Bangkok Thailand ATP World Tour,HARD,2,Mischa Zverev,Rainer Schuettler,Mischa Zverev,7-6(7); 7-5,R16,95,5,4,50,73,36,50,12,23,1,3,12,48,73,1,2,42,81,29,42,21,39,7,10,12,50,81
2006-09-25 00:00:00.000,Bangkok Thailand ATP World Tour,HARD,2,Marat Safin,Julien Benneteau,Marat Safin,7-6(5); 6-7(3); 6-2,R16,138,18,0,76,111,55,76,18,35,7,9,16,73,111,7,7,71,105,52,71,12,34,2,6,16,64,105
2006-09-25 00:00:00.000,Bangkok Thailand ATP World Tour,HARD,2,Ivan Ljubicic,Robby Ginepri,Ivan Ljubicic,4-6; 6-3; 6-4,Q,118,14,3,46,76,36,46,22,30,1,2,15,58,76,4,1,61,89,38,61,19,28,8,10,14,57,89
2006-09-25 00:00:00.000,Bangkok Thailand ATP World Tour,HARD,2,Paradorn Srichaphan,Tim Henman,Paradorn Srichaphan,6-7(2); 6-4; 7-6(4),Q,145,12,6,60,101,49,60,24,41,1,3,17,73,101,6,5,61,106,45,61,26,45,5,8,17,71,106
2006-09-25 00:00:00.000,Bangkok Thailand ATP World Tour,HARD,2,James Blake,Jarkko Nieminen,James Blake,6-2; 2-6; 7-5,Q,101,11,5,44,93,31,44,22,49,4,9,14,53,93,7,3,54,87,39,54,9,33,7,13,14,48,87
2006-09-25 00:00:00.000,Bangkok Thailand ATP World Tour,HARD,2,Marat Safin,Mischa Zverev,Marat Safin,7-6(4); 5-7; 7-5,Q,129,4,3,73,113,57,73,19,40,0,2,18,76,113,10,0,75,105,54,75,19,30,6,8,18,73,105
2006-09-25 00:00:00.000,Bangkok Thailand ATP World Tour,HARD,2,Ivan Ljubicic,Paradorn Srichaphan,Ivan Ljubicic,6-3; 6-2,S,77,17,0,39,67,30,39,15,28,4,4,9,45,67,2,1,32,51,19,32,10,19,3,6,8,29,51
2006-09-25 00:00:00.000,Bangkok Thailand ATP World Tour,HARD,2,James Blake,Marat Safin,James Blake,3-6; 6-4; 7-6(3),S,124,6,0,68,109,51,68,17,41,4,8,16,68,109,5,2,74,112,49,74,20,38,9,12,15,69,112
2006-09-25 00:00:00.000,Bangkok Thailand ATP World Tour,HARD,2,James Blake,Ivan Ljubicic,James Blake,6-3; 6-1,F,59,1,0,30,47,21,30,11,17,1,2,8,32,47,2,4,19,45,13,19,7,26,1,6,8,20,45
2006-09-25 00:00:00.000,Mumbai India ATP World Tour,HARD,2,Tommy Robredo,Alexander Peya,Tommy Robredo,6-4; 6-2,R32,98,2,2,35,54,30,35,10,19,5,5,9,40,54,3,3,39,82,25,39,20,43,4,7,9,45,82
2006-09-25 00:00:00.000,Mumbai India ATP World Tour,HARD,2,Michael Berrer,Konstantinos Economidis,Michael Berrer,6-2; 7-6(3),R32,71,8,1,26,55,22,26,21,29,0,1,10,43,55,5,3,40,64,26,40,13,24,4,7,10,39,64
2006-09-25 00:00:00.000,Mumbai India ATP World Tour,HARD,2,Ramon Delgado,Davide Sanguinetti,Ramon Delgado,6-3; 2-1 RET,R32,58,10,1,22,35,21,22,7,13,0,0,6,28,35,1,2,28,46,18,28,8,18,3,5,6,26,46
2006-09-25 00:00:00.000,Mumbai India ATP World Tour,HARD,2,Juan Martin Del Potro,Carlos Moya,Juan Martin Del Potro,6-3; 6-2,R32,64,1,3,40,54,32,40,5,14,1,2,9,37,54,6,1,20,42,12,20,8,22,2,6,8,20,42
2006-09-25 00:00:00.000,Mumbai India ATP World Tour,HARD,2,Dmitry Tursunov,Akash Wagh,Dmitry Tursunov,6-2; 7-5,R32,62,6,5,28,59,24,28,19,31,3,4,10,43,59,7,3,29,58,19,29,12,29,3,7,10,31,58
2006-09-25 00:00:00.000,Mumbai India ATP World Tour,HARD,2,Kristian Pless,Denis Gremelmayr,Kristian Pless,7-5; 7-5,R32,82,4,4,40,68,31,40,15,28,1,3,12,46,68,6,1,44,73,31,44,9,29,3,7,12,40,73
2006-09-25 00:00:00.000,Mumbai India ATP World Tour,HARD,2,James Auckland,Frank Moser,James Auckland,6-1; 6-4,R32,75,7,4,32,54,25,32,12,22,4,5,9,37,54,5,2,37,54,23,37,5,17,3,7,8,28,54
2006-09-25 00:00:00.000,Mumbai India ATP World Tour,HARD,2,Wesley Moodie,Rohan Bopanna,Wesley Moodie,3-6; 7-6(5); 6-4,R32,125,19,4,65,99,50,65,18,34,7,9,15,68,99,15,1,48,98,40,48,29,50,5,7,16,69,98
2006-09-25 00:00:00.000,Mumbai India ATP World Tour,HARD,2,Bjorn Phau,Karan Rastogi,Bjorn Phau,6-0; 6-3,R32,54,13,0,20,33,18,20,10,13,0,0,7,28,33,0,1,35,50,19,35,5,15,9,14,8,24,50
2006-09-25 00:00:00.000,Mumbai India ATP World Tour,HARD,2,Gouichi Motomura,Jasper Smit,Gouichi Motomura,3-6; 6-0; 7-6(5),R32,116,2,0,64,98,39,64,22,34,3,5,13,61,98,9,9,40,82,32,40,20,42,3,7,14,52,82
2006-09-25 00:00:00.000,Mumbai India ATP World Tour,HARD,2,Simon Greul,Yen-Hsun Lu,Simon Greul,7-6(4); 6-3,R32,94,10,6,50,82,41,50,16,32,8,9,11,57,82,3,4,40,63,31,40,10,23,0,2,10,41,63
2006-09-25 00:00:00.000,Mumbai India ATP World Tour,HARD,2,Tomas Berdych,Lukasz Kubot,Tomas Berdych,6-2; 6-2,R32,68,8,2,32,45,26,32,8,13,3,3,8,34,45,4,2,47,68,28,47,7,21,7,11,8,35,68
2006-09-25 00:00:00.000,Mumbai India ATP World Tour,HARD,2,Stefan Koubek,Juan Monaco,Stefan Koubek,7-6(5); 6-4,R32,106,7,2,42,78,34,42,18,36,6,7,11,52,78,1,3,50,79,35,50,15,29,2,4,11,50,79
2006-09-25 00:00:00.000,Mumbai India ATP World Tour,HARD,2,Nicolas Devilder,Rik De Voest,Nicolas Devilder,6-4; 4-6; 6-3,R32,132,7,4,66,106,47,66,19,40,6,8,15,66,106,6,6,53,85,41,53,14,32,10,13,14,55,85
2006-09-25 00:00:00.000,Mumbai India ATP World Tour,HARD,2,Stefano Galvani,Robin Vik,Stefano Galvani,5-7; 6-4; 6-4,R32,144,4,6,59,93,39,59,16,34,5,10,16,55,93,7,3,65,97,45,65,9,32,5,11,16,54,97
2006-09-25 00:00:00.000,Mumbai India ATP World Tour,HARD,2,Mario Ancic,Igor Kunitsyn,Mario Ancic,6-3; 6-2,R32,80,11,0,37,52,28,37,11,15,0,0,9,39,52,0,5,28,60,17,28,16,32,7,10,8,33,60
2006-09-25 00:00:00.000,Mumbai India ATP World Tour,HARD,2,Tommy Robredo,Michael Berrer,Tommy Robredo,5-7; 6-2; 6-4,R16,112,6,2,53,81,40,53,19,28,4,6,15,59,81,7,3,52,83,39,52,14,31,2,6,15,53,83
2006-09-25 00:00:00.000,Mumbai India ATP World Tour,HARD,2,Ramon Delgado,Juan Martin Del Potro,Ramon Delgado,6-3; 4-1 RET,R16,75,4,0,28,47,20,28,13,19,8,8,7,33,47,3,1,31,41,17,31,5,10,1,4,7,22,41
2006-09-25 00:00:00.000,Mumbai India ATP World Tour,HARD,2,Dmitry Tursunov,Kristian Pless,Dmitry Tursunov,6-7(5); 6-3; 6-4,R16,111,16,4,59,103,45,59,27,44,2,3,16,72,103,14,0,57,91,39,57,23,34,5,8,15,62,91
2006-09-25 00:00:00.000,Mumbai India ATP World Tour,HARD,2,James Auckland,Wesley Moodie,James Auckland,7-6(3); 7-6(5),R16,108,16,1,51,82,38,51,20,31,0,0,12,58,82,15,3,51,78,42,51,13,27,2,2,12,55,78
2006-09-25 00:00:00.000,Mumbai India ATP World Tour,HARD,2,Bjorn Phau,Gouichi Motomura,Bjorn Phau,6-3; 6-3,R16,64,5,1,26,45,23,26,13,19,0,0,9,36,45,2,1,38,62,27,38,9,24,4,7,9,36,62
2006-09-25 00:00:00.000,Mumbai India ATP World Tour,HARD,2,Tomas Berdych,Simon Greul,Tomas Berdych,7-6(4); 6-4,R16,89,6,3,30,67,28,30,23,37,2,2,11,51,67,2,1,43,79,31,43,20,36,3,4,11,51,79
2006-09-25 00:00:00.000,Mumbai India ATP World Tour,HARD,2,Stefan Koubek,Nicolas Devilder,Stefan Koubek,7-5; 6-3,R16,91,12,3,36,64,26,36,18,28,4,6,11,44,64,0,4,38,66,23,38,13,28,4,8,10,36,66
2006-09-25 00:00:00.000,Mumbai India ATP World Tour,HARD,2,Mario Ancic,Stefano Galvani,Mario Ancic,6-1; 7-6,R16,85,7,5,34,57,28,34,7,23,4,5,8,35,57,1,1,31,51,19,31,10,20,3,6,8,29,51
2006-09-25 00:00:00.000,Mumbai India ATP World Tour,HARD,2,Tommy Robredo,Ramon Delgado,Tommy Robredo,6-2; 7-6(1),Q,90,5,4,33,64,28,33,18,31,2,3,10,46,64,3,4,32,58,23,32,12,26,2,5,10,35,58
2006-09-25 00:00:00.000,Mumbai India ATP World Tour,HARD,2,Dmitry Tursunov,James Auckland,Dmitry Tursunov,3-6; 6-3; 6-4,Q,97,10,5,46,78,37,46,19,32,3,4,14,56,78,12,4,51,83,38,51,18,32,4,6,14,56,83
2006-09-25 00:00:00.000,Mumbai India ATP World Tour,HARD,2,Tomas Berdych,Bjorn Phau,Tomas Berdych,6-3; 7-5,Q,73,10,2,38,63,30,38,15,25,5,6,11,45,63,5,4,24,64,15,24,22,40,2,5,10,37,64
2006-09-25 00:00:00.000,Mumbai India ATP World Tour,HARD,2,Stefan Koubek,Mario Ancic,Stefan Koubek,3-6; 6-4; 6-3,Q,131,4,4,47,81,38,47,15,34,2,4,14,53,81,5,1,46,80,30,46,21,34,5,8,14,51,80
2006-09-25 00:00:00.000,Mumbai India ATP World Tour,HARD,2,Dmitry Tursunov,Tommy Robredo,Dmitry Tursunov,7-6(2); 3-6; 6-1,S,128,3,4,46,84,35,46,19,38,2,5,14,54,84,6,3,63,89,41,63,11,26,1,5,14,52,89
2006-09-25 00:00:00.000,Mumbai India ATP World Tour,HARD,2,Tomas Berdych,Stefan Koubek,Tomas Berdych,7-6(2); 6-2,S,80,11,1,43,69,32,43,18,26,2,2,10,50,69,4,2,42,61,29,42,9,19,5,7,10,38,61
2006-09-25 00:00:00.000,Mumbai India ATP World Tour,HARD,2,Dmitry Tursunov,Tomas Berdych,Dmitry Tursunov,6-3; 4-6; 7-6(5),F,165,9,11,53,102,38,53,22,49,4,9,16,60,102,7,2,56,96,37,56,20,40,8,13,15,57,96
2006-09-25 00:00:00.000,Palermo Italy ATP World Tour,CLAY,2,Fernando Verdasco,Daniele Bracciali,Fernando Verdasco,5-7; 6-4; 6-4,R32,145,4,3,77,100,52,77,12,23,5,8,16,64,100,7,3,60,112,43,60,22,52,10,14,16,65,112
2006-09-25 00:00:00.000,Palermo Italy ATP World Tour,CLAY,2,Jan Hajek,Bohdan Ulihrach,Jan Hajek,6-3; 7-6(2),R32,79,5,3,45,76,31,45,11,31,10,14,10,42,76,2,2,38,68,20,38,12,30,5,11,11,32,68
2006-09-25 00:00:00.000,Palermo Italy ATP World Tour,CLAY,2,Gianluca Naso,Jiri Vanek,Gianluca Naso,1-2 RET,R32,17,0,1,5,11,4,5,2,6,1,2,2,6,11,0,2,6,9,3,6,1,3,1,1,1,4,9
2006-09-25 00:00:00.000,Palermo Italy ATP World Tour,CLAY,2,Ruben Ramirez Hidalgo,Alessio Di Mauro,Ruben Ramirez Hidalgo,7-6(7); 6-3,R32,127,2,1,39,74,28,39,19,35,3,5,10,47,74,1,1,44,80,24,44,20,36,4,8,11,44,80
2006-09-25 00:00:00.000,Palermo Italy ATP World Tour,CLAY,2,Gilles Simon,Andreas Seppi,Gilles Simon,6-0; 6-7(6); 6-2,R32,125,4,1,46,92,27,46,31,46,6,8,13,58,92,0,13,47,86,30,47,14,39,1,8,13,44,86
2006-09-25 00:00:00.000,Palermo Italy ATP World Tour,CLAY,2,Mariano Zabaleta,Olivier Patience,Mariano Zabaleta,7-5; 3-6; 6-3,R32,136,4,3,66,102,47,66,18,36,2,4,15,65,102,2,1,83,99,54,83,8,16,9,12,15,62,99
2006-09-25 00:00:00.000,Palermo Italy ATP World Tour,CLAY,2,Fabio Fognini,Juan Antonio Marin,Fabio Fognini,7-6(3); 6-3,R32,124,3,4,41,74,33,41,14,33,0,2,10,47,74,2,1,43,81,27,43,17,38,8,12,11,44,81
2006-09-25 00:00:00.000,Palermo Italy ATP World Tour,CLAY,2,Nicolas Lapentti,Paul-Henri Mathieu,Nicolas Lapentti,3-6; 6-2; 6-3,R32,142,4,3,53,86,39,53,13,33,5,8,13,52,86,5,1,50,93,27,50,23,43,7,12,13,50,93
2006-09-25 00:00:00.000,Palermo Italy ATP World Tour,CLAY,2,Oscar Hernandez,Philipp Kohlschreiber,Oscar Hernandez,6-1; 6-1,R32,61,1,1,28,42,22,28,8,14,3,3,7,30,42,3,2,29,51,13,29,8,22,1,6,7,21,51
2006-09-25 00:00:00.000,Palermo Italy ATP World Tour,CLAY,2,Martin Vassallo Arguello,Juan-Pablo Guzman,Martin Vassallo Arguello,2-6; 6-3; 7-5,R32,115,0,5,61,86,44,61,14,25,5,8,15,58,86,2,3,65,96,42,65,17,31,9,12,14,59,96
2006-09-25 00:00:00.000,Palermo Italy ATP World Tour,CLAY,2,Frantisek Cermak,Andrei Pavel,Frantisek Cermak,6-3; 2-6; 7-5,R32,128,5,7,55,104,38,55,23,49,5,9,15,61,104,1,3,60,87,35,60,16,27,4,8,14,51,87
2006-09-25 00:00:00.000,Palermo Italy ATP World Tour,CLAY,2,Nicolas Almagro,Oliver Marach,Nicolas Almagro,6-1; 6-4,R32,71,8,4,28,44,25,28,12,16,0,0,9,37,44,2,1,33,58,22,33,11,25,11,14,8,33,58
2006-09-25 00:00:00.000,Palermo Italy ATP World Tour,CLAY,2,Albert Montanes,Luis Horna,Albert Montanes,5-2 RET,R32,30,4,0,10,13,9,10,3,3,0,0,3,12,13,3,2,20,35,11,20,6,15,6,8,4,17,35
2006-09-25 00:00:00.000,Palermo Italy ATP World Tour,CLAY,2,Potito Starace,Federico Luzzi,Potito Starace,6-1; 6-2,R32,76,0,1,40,51,25,40,7,11,7,8,7,32,51,1,1,22,46,8,22,9,24,1,7,8,17,46
2006-09-25 00:00:00.000,Palermo Italy ATP World Tour,CLAY,2,Sergio Roitman,Francesco Aldi,Sergio Roitman,6-0; 6-1,R32,94,1,1,28,50,20,28,12,22,3,3,6,32,50,0,8,29,46,13,29,3,17,4,10,7,16,46
2006-09-25 00:00:00.000,Palermo Italy ATP World Tour,CLAY,2,Filippo Volandri,Guillermo Garcia-Lopez,Filippo Volandri,7-6(3); 3-6; 6-3,R32,163,2,5,65,102,45,65,17,37,11,15,15,62,102,3,4,78,136,56,78,20,58,18,22,15,76,136
2006-09-25 00:00:00.000,Palermo Italy ATP World Tour,CLAY,2,Fernando Verdasco,Jan Hajek,Fernando Verdasco,6-2; 6-2,R16,66,1,0,39,52,26,39,8,13,3,4,8,34,52,1,2,29,57,15,29,10,28,5,10,8,25,57
2006-09-25 00:00:00.000,Palermo Italy ATP World Tour,CLAY,2,Ruben Ramirez Hidalgo,Gianluca Naso,Ruben Ramirez Hidalgo,6-2; 6-2,R16,160,4,1,23,39,18,23,10,16,0,1,8,28,39,0,1,27,47,13,27,8,20,1,6,8,21,47
2006-09-25 00:00:00.000,Palermo Italy ATP World Tour,CLAY,2,Gilles Simon,Mariano Zabaleta,Gilles Simon,7-5; 6-3,R16,100,0,0,41,57,32,41,9,16,1,3,11,41,57,3,4,43,81,30,43,12,38,7,11,10,42,81
2006-09-25 00:00:00.000,Palermo Italy ATP World Tour,CLAY,2,Nicolas Lapentti,Fabio Fognini,Nicolas Lapentti,2-6; 6-1; 7-6(4),R16,138,4,1,49,99,34,49,31,50,4,7,14,65,99,2,0,40,75,32,40,16,35,2,5,13,48,75
2006-09-25 00:00:00.000,Palermo Italy ATP World Tour,CLAY,2,Martin Vassallo Arguello,Oscar Hernandez,Martin Vassallo Arguello,2-6; 6-4; 6-4,R16,125,5,3,41,72,30,41,16,31,2,6,14,46,72,2,3,56,97,37,56,19,41,7,11,14,56,97
2006-09-25 00:00:00.000,Palermo Italy ATP World Tour,CLAY,2,Nicolas Almagro,Frantisek Cermak,Nicolas Almagro,6-1; 6-2,R16,59,2,4,27,50,24,27,11,23,2,2,8,35,50,2,3,19,36,9,19,7,17,0,4,7,16,36
2006-09-25 00:00:00.000,Palermo Italy ATP World Tour,CLAY,2,Albert Montanes,Potito Starace,Albert Montanes,6-2; 6-2,R16,65,2,3,29,42,21,29,9,13,0,1,8,30,42,1,1,38,57,18,38,8,19,2,7,8,26,57
2006-09-25 00:00:00.000,Palermo Italy ATP World Tour,CLAY,2,Filippo Volandri,Sergio Roitman,Filippo Volandri,6-7(6); 6-1; 6-4,R16,139,0,2,72,98,47,72,13,26,1,3,15,60,98,5,3,82,117,53,82,9,35,12,17,14,62,117
2006-09-25 00:00:00.000,Palermo Italy ATP World Tour,CLAY,2,Ruben Ramirez Hidalgo,Fernando Verdasco,Ruben Ramirez Hidalgo,6-3; 6-4,Q,80,5,3,31,59,26,31,16,28,2,3,10,42,59,1,4,36,53,21,36,7,17,3,6,9,28,53
2006-09-25 00:00:00.000,Palermo Italy ATP World Tour,CLAY,2,Nicolas Lapentti,Gilles Simon,Nicolas Lapentti,6-0; 6-1,Q,72,2,0,22,41,15,22,11,19,4,5,6,26,41,2,0,32,47,13,32,2,15,3,10,7,15,47
2006-09-25 00:00:00.000,Palermo Italy ATP World Tour,CLAY,2,Nicolas Almagro,Martin Vassallo Arguello,Nicolas Almagro,6-2; 6-2,Q,97,6,1,31,56,23,31,16,25,3,3,8,39,56,0,0,49,69,25,49,9,20,6,10,8,34,69
2006-09-25 00:00:00.000,Palermo Italy ATP World Tour,CLAY,2,Filippo Volandri,Albert Montanes,Filippo Volandri,6-4; 6-2,Q,82,1,3,48,65,31,48,7,17,9,11,9,38,65,0,3,24,57,11,24,14,33,3,8,9,25,57
2006-09-25 00:00:00.000,Palermo Italy ATP World Tour,CLAY,2,Nicolas Lapentti,Ruben Ramirez Hidalgo,Nicolas Lapentti,6-2; 6-1,S,63,3,0,20,33,19,20,9,13,0,0,7,28,33,1,1,33,48,17,33,4,15,5,10,8,21,48
2006-09-25 00:00:00.000,Palermo Italy ATP World Tour,CLAY,2,Filippo Volandri,Nicolas Almagro,Filippo Volandri,6-0; 2-1 RET,S,51,0,2,19,30,17,19,4,11,0,0,5,21,30,0,0,11,26,6,11,6,15,5,8,4,12,26
2006-09-25 00:00:00.000,Palermo Italy ATP World Tour,CLAY,2,Filippo Volandri,Nicolas Lapentti,Filippo Volandri,5-7; 6-1; 6-3,F,135,1,1,49,75,26,49,20,26,1,6,14,46,75,2,1,55,88,28,55,14,33,6,14,14,42,88
2006-10-02 00:00:00.000,Metz France ATP World Tour,HARD,2,Marc Gicquel,David Ferrer,Marc Gicquel,6-3; 5-7; 6-4,R32,120,4,3,51,97,39,51,26,46,3,5,16,65,97,3,2,56,97,40,56,22,41,5,8,15,62,97
2006-10-02 00:00:00.000,Metz France ATP World Tour,HARD,2,Guillermo Garcia-Lopez,Davide Sanguinetti,Guillermo Garcia-Lopez,7-6(3); 4-6; 6-0,R32,96,8,3,44,80,36,44,16,36,1,4,14,52,80,3,5,50,94,32,50,18,44,4,9,14,50,94
2006-10-02 00:00:00.000,Metz France ATP World Tour,HARD,2,Paul-Henri Mathieu,Fabrice Santoro,Paul-Henri Mathieu,6-4; 5-7; 6-4,R32,154,3,8,47,99,36,47,25,52,5,9,16,61,99,6,7,43,105,32,43,29,62,7,12,16,61,105
2006-10-02 00:00:00.000,Metz France ATP World Tour,HARD,2,Florent Serra,Robin Soderling,Florent Serra,5-7; 7-6(3); 6-2,R32,107,10,4,57,103,44,57,24,46,5,8,16,68,103,12,5,52,87,36,52,20,35,3,7,16,56,87
2006-10-02 00:00:00.000,Metz France ATP World Tour,HARD,2,Marat Safin,Mikhail Youzhny,Marat Safin,6-1; 6-4,R32,59,5,0,32,51,26,32,10,19,0,0,9,36,51,1,2,30,50,20,30,8,20,3,6,8,28,50
2006-10-02 00:00:00.000,Metz France ATP World Tour,HARD,2,Jurgen Melzer,Albert Montanes,Jurgen Melzer,7-5; 6-2,R32,68,9,2,37,62,28,37,12,25,4,6,10,40,62,1,7,30,66,19,30,13,36,3,8,10,32,66
2006-10-02 00:00:00.000,Metz France ATP World Tour,HARD,2,Mardy Fish,Thierry Ascione,Mardy Fish,4-6; 6-3; 6-2,R32,104,7,4,37,77,29,37,22,40,3,6,14,51,77,1,3,51,81,34,51,12,30,6,11,13,46,81
2006-10-02 00:00:00.000,Metz France ATP World Tour,HARD,2,Ruben Ramirez Hidalgo,Fernando Verdasco,Ruben Ramirez Hidalgo,6-3; 6-3,R32,68,4,2,31,56,27,31,12,25,0,0,9,39,56,0,2,45,55,30,45,2,10,2,5,9,32,55
2006-10-02 00:00:00.000,Metz France ATP World Tour,HARD,2,Cyril Saulnier,Dominik Hrbaty,Cyril Saulnier,4-6; 6-3; 6-3,R32,96,6,2,56,85,40,56,16,29,2,4,14,56,85,2,9,37,78,24,37,22,41,3,7,14,46,78
2006-10-02 00:00:00.000,Metz France ATP World Tour,HARD,2,Tobias Clemens,Olivier Patience,Tobias Clemens,7-5; 6-7(2); 6-3,R32,152,9,5,68,122,51,68,26,54,6,8,16,77,122,3,0,78,116,53,78,18,38,7,12,17,71,116
2006-10-02 00:00:00.000,Metz France ATP World Tour,HARD,2,Daniele Bracciali,Philipp Kohlschreiber,Daniele Bracciali,4-6; 6-3; 7-5,R32,121,9,3,42,86,37,42,26,44,3,4,16,63,86,15,4,53,102,38,53,27,49,9,11,15,65,102
2006-10-02 00:00:00.000,Metz France ATP World Tour,HARD,2,Novak Djokovic,Nicolas Mahut,Novak Djokovic,6-2; 6-3,R32,64,4,1,27,52,21,27,17,25,2,2,9,38,52,4,5,25,45,18,25,7,20,3,6,8,25,45
2006-10-02 00:00:00.000,Metz France ATP World Tour,HARD,2,Richard Gasquet,Sergiy Stakhovsky,Richard Gasquet,6-3; 6-1,R32,60,2,0,27,45,24,27,11,18,2,2,8,35,45,1,1,33,50,16,33,9,17,2,6,8,25,50
2006-10-02 00:00:00.000,Metz France ATP World Tour,HARD,2,Arnaud Clement,Xavier Malisse,Arnaud Clement,7-6(3); 6-2,R32,92,5,1,35,56,26,35,14,21,0,1,10,40,56,9,4,38,67,27,38,9,29,7,10,10,36,67
2006-10-02 00:00:00.000,Metz France ATP World Tour,HARD,2,Sebastien Grosjean,Florian Mayer,Sebastien Grosjean,6-3; 6-4,R32,77,4,1,39,62,29,39,10,23,4,6,10,39,62,4,2,42,67,28,42,7,25,4,8,9,35,67
2006-10-02 00:00:00.000,Metz France ATP World Tour,HARD,2,Julien Benneteau,Juan Carlos Ferrero,Julien Benneteau,6-4; 1-6; 7-6(7),R32,133,8,3,65,108,42,65,22,43,10,14,14,64,108,7,1,47,84,31,47,25,37,1,4,15,56,84
2006-10-02 00:00:00.000,Metz France ATP World Tour,HARD,2,Marc Gicquel,Guillermo Garcia-Lopez,Marc Gicquel,6-2; 6-3,R16,63,4,3,18,47,14,18,20,29,2,2,8,34,47,6,3,40,66,29,40,7,26,9,13,9,36,66
2006-10-02 00:00:00.000,Metz France ATP World Tour,HARD,2,Florent Serra,Paul-Henri Mathieu,Florent Serra,1-6; 6-3; 7-6(2),R16,138,10,4,55,94,44,55,13,39,5,9,14,57,94,11,3,52,97,33,52,27,45,3,6,14,60,97
2006-10-02 00:00:00.000,Metz France ATP World Tour,HARD,2,Jurgen Melzer,Marat Safin,Jurgen Melzer,4-6; 6-2; 7-6(5),R16,124,4,3,70,109,51,70,22,39,10,11,15,73,109,10,1,54,96,39,54,25,42,8,10,15,64,96
2006-10-02 00:00:00.000,Metz France ATP World Tour,HARD,2,Mardy Fish,Ruben Ramirez Hidalgo,Mardy Fish,6-3; 6-3,R16,71,10,3,29,49,27,29,10,20,1,1,9,37,49,2,4,32,61,19,32,14,29,5,8,9,33,61
2006-10-02 00:00:00.000,Metz France ATP World Tour,HARD,2,Tobias Clemens,Cyril Saulnier,Tobias Clemens,7-6(4); 6-7(4); 7-6(5),R16,166,15,6,66,119,50,66,32,53,2,4,18,82,119,11,3,70,123,57,70,26,53,4,6,18,83,123
2006-10-02 00:00:00.000,Metz France ATP World Tour,HARD,2,Novak Djokovic,Daniele Bracciali,Novak Djokovic,6-0; 6-3,R16,60,8,1,32,49,25,32,10,17,2,2,8,35,49,4,6,21,46,14,21,8,25,4,8,7,22,46
2006-10-02 00:00:00.000,Metz France ATP World Tour,HARD,2,Arnaud Clement,Richard Gasquet,Arnaud Clement,6-7(3); 7-6(3); 7-5,R16,177,2,2,73,110,53,73,18,37,2,5,18,71,110,6,2,66,128,48,66,29,62,10,14,18,77,128
2006-10-02 00:00:00.000,Metz France ATP World Tour,HARD,2,Sebastien Grosjean,Julien Benneteau,Sebastien Grosjean,7-5; 6-1,R16,88,3,2,31,60,24,31,17,29,5,7,10,41,60,4,5,42,64,23,42,8,22,4,9,9,31,64
2006-10-02 00:00:00.000,Metz France ATP World Tour,HARD,2,Marc Gicquel,Florent Serra,Marc Gicquel,6-4; 7-5,Q,85,12,1,32,61,28,32,18,29,3,3,11,46,61,10,6,51,84,34,51,17,33,10,12,11,51,84
2006-10-02 00:00:00.000,Metz France ATP World Tour,HARD,2,Jurgen Melzer,Mardy Fish,Jurgen Melzer,1-6; 7-5; 7-5,Q,123,5,4,56,96,40,56,18,40,5,9,15,58,96,18,11,47,102,32,47,29,55,9,13,16,61,102
2006-10-02 00:00:00.000,Metz France ATP World Tour,HARD,2,Novak Djokovic,Tobias Clemens,Novak Djokovic,6-4; 6-1,Q,59,9,1,26,47,22,26,13,21,0,1,9,35,47,1,6,25,50,14,25,12,25,2,6,8,26,50
2006-10-02 00:00:00.000,Metz France ATP World Tour,HARD,2,Sebastien Grosjean,Arnaud Clement,Sebastien Grosjean,6-7(4); 6-3; 6-2,Q,140,10,2,49,98,39,49,27,49,6,8,15,66,98,4,2,46,83,33,46,19,37,6,11,14,52,83
2006-10-02 00:00:00.000,Metz France ATP World Tour,HARD,2,Jurgen Melzer,Marc Gicquel,Jurgen Melzer,7-6(3); 6-3,S,84,7,4,52,80,37,52,12,28,5,7,10,49,80,4,0,27,62,21,27,14,35,1,5,11,35,62
2006-10-02 00:00:00.000,Metz France ATP World Tour,HARD,2,Novak Djokovic,Sebastien Grosjean,Novak Djokovic,6-7(4); 7-6(1); 6-3,S,165,6,2,69,111,50,69,22,42,6,9,17,72,111,10,0,57,107,41,57,25,50,5,9,16,66,107
2006-10-02 00:00:00.000,Metz France ATP World Tour,HARD,2,Novak Djokovic,Jurgen Melzer,Novak Djokovic,4-6; 6-3; 6-2,F,111,10,1,58,88,41,58,16,30,7,9,14,57,88,2,5,45,90,31,45,20,45,7,11,13,51,90
2006-10-02 00:00:00.000,Tokyo Japan ATP World Tour,HARD,2,Roger Federer,N/A Bye,Roger Federer,,R64,0,0,0,0,0,0,0,0,0,0,0,0,0,0,0,0,0,0,0,0,0,0,0,0,0,0,0
2006-10-02 00:00:00.000,Tokyo Japan ATP World Tour,HARD,2,Viktor Troicki,Fernando Vicente,Viktor Troicki,6-7(4); 6-4; 6-2,R64,125,7,1,54,87,39,54,16,33,1,5,15,55,87,3,0,61,92,31,61,21,31,2,9,15,52,92
2006-10-02 00:00:00.000,Tokyo Japan ATP World Tour,HARD,2,Stefan Koubek,Stefano Galvani,Stefan Koubek,6-3; 4-6; 7-5,R64,136,4,6,50,100,32,50,20,50,7,14,16,52,100,0,3,44,88,28,44,16,44,4,12,15,44,88
2006-10-02 00:00:00.000,Tokyo Japan ATP World Tour,HARD,2,Wesley Moodie,N/A Bye,Wesley Moodie,,R64,0,0,0,0,0,0,0,0,0,0,0,0,0,0,0,0,0,0,0,0,0,0,0,0,0,0,0
2006-10-02 00:00:00.000,Tokyo Japan ATP World Tour,HARD,2,Bjorn Phau,N/A Bye,Bjorn Phau,,R64,0,0,0,0,0,0,0,0,0,0,0,0,0,0,0,0,0,0,0,0,0,0,0,0,0,0,0
2006-10-02 00:00:00.000,Tokyo Japan ATP World Tour,HARD,2,Alexander Waske,Tetsuya Chaen,Alexander Waske,6-4; 6-4,R64,67,10,0,33,49,28,33,12,16,0,0,10,40,49,2,2,39,60,21,39,16,21,2,4,10,37,60
2006-10-02 00:00:00.000,Tokyo Japan ATP World Tour,HARD,2,Takao Suzuki,Simon Greul,Takao Suzuki,6-2; 6-2,R64,58,7,1,25,39,22,25,11,14,1,1,8,33,39,2,0,26,50,16,26,11,24,0,4,8,27,50
2006-10-02 00:00:00.000,Tokyo Japan ATP World Tour,HARD,2,Paradorn Srichaphan,N/A Bye,Paradorn Srichaphan,,R64,0,0,0,0,0,0,0,0,0,0,0,0,0,0,0,0,0,0,0,0,0,0,0,0,0,0,0
2006-10-02 00:00:00.000,Tokyo Japan ATP World Tour,HARD,2,Andy Murray,N/A Bye,Andy Murray,,R64,0,0,0,0,0,0,0,0,0,0,0,0,0,0,0,0,0,0,0,0,0,0,0,0,0,0,0
2006-10-02 00:00:00.000,Tokyo Japan ATP World Tour,HARD,2,Jiri Novak,Robin Vik,Jiri Novak,4-6; 6-4; 6-4,R64,107,10,2,54,78,41,54,13,24,1,4,15,54,78,5,6,63,100,46,63,14,37,7,11,15,60,100
2006-10-02 00:00:00.000,Tokyo Japan ATP World Tour,HARD,2,Danai Udomchoke,Marin Cilic,Danai Udomchoke,7-6(3); 6-3,R64,89,3,0,40,76,34,40,20,36,5,5,11,54,76,5,2,32,63,25,32,19,31,3,4,10,44,63
2006-10-02 00:00:00.000,Tokyo Japan ATP World Tour,HARD,2,Benjamin Becker,N/A Bye,Benjamin Becker,,R64,0,0,0,0,0,0,0,0,0,0,0,0,0,0,0,0,0,0,0,0,0,0,0,0,0,0,0
2006-10-02 00:00:00.000,Tokyo Japan ATP World Tour,HARD,2,Juan Monaco,N/A Bye,Juan Monaco,,R64,0,0,0,0,0,0,0,0,0,0,0,0,0,0,0,0,0,0,0,0,0,0,0,0,0,0,0
2006-10-02 00:00:00.000,Tokyo Japan ATP World Tour,HARD,2,Edgardo Massa,Konstantinos Economidis,Edgardo Massa,6-1; 6-3,R64,54,4,0,23,40,19,23,13,17,0,0,8,32,40,4,3,39,62,23,39,8,23,6,10,8,31,62
2006-10-02 00:00:00.000,Tokyo Japan ATP World Tour,HARD,2,Lars Burgsmuller,Wayne Arthurs,Lars Burgsmuller,6-7(5); 7-6(7); 7-6(3),R64,148,10,4,87,121,71,87,22,34,7,7,18,93,121,34,5,68,116,59,68,30,48,3,3,18,89,116
2006-10-02 00:00:00.000,Tokyo Japan ATP World Tour,HARD,2,Jarkko Nieminen,N/A Bye,Jarkko Nieminen,,R64,0,0,0,0,0,0,0,0,0,0,0,0,0,0,0,0,0,0,0,0,0,0,0,0,0,0,0
2006-10-02 00:00:00.000,Tokyo Japan ATP World Tour,HARD,2,Robby Ginepri,N/A Bye,Robby Ginepri,,R64,0,0,0,0,0,0,0,0,0,0,0,0,0,0,0,0,0,0,0,0,0,0,0,0,0,0,0
2006-10-02 00:00:00.000,Tokyo Japan ATP World Tour,HARD,2,Juan Martin Del Potro,Go Soeda,Juan Martin Del Potro,6-3; 6-1,R64,73,3,2,31,47,25,31,10,16,2,2,8,35,47,2,2,27,49,14,27,11,22,3,7,8,25,49
2006-10-02 00:00:00.000,Tokyo Japan ATP World Tour,HARD,2,Frank Dancevic,Marcos Daniel,Frank Dancevic,6-4; 6-4,R64,67,4,0,28,51,23,28,17,23,0,0,10,40,51,5,0,39,63,24,39,15,24,2,4,10,39,63
2006-10-02 00:00:00.000,Tokyo Japan ATP World Tour,HARD,2,Tim Henman,N/A Bye,Tim Henman,,R64,0,0,0,0,0,0,0,0,0,0,0,0,0,0,0,0,0,0,0,0,0,0,0,0,0,0,0
2006-10-02 00:00:00.000,Tokyo Japan ATP World Tour,HARD,2,Paul Goldstein,N/A Bye,Paul Goldstein,,R64,0,0,0,0,0,0,0,0,0,0,0,0,0,0,0,0,0,0,0,0,0,0,0,0,0,0,0
2006-10-02 00:00:00.000,Tokyo Japan ATP World Tour,HARD,2,Rainer Schuettler,Michael Berrer,Rainer Schuettler,6-2; 6-1,R64,56,6,0,22,34,18,22,10,12,0,0,7,28,34,0,4,26,50,11,26,12,24,5,10,8,23,50
2006-10-02 00:00:00.000,Tokyo Japan ATP World Tour,HARD,2,Kenneth Carlsen,Gouichi Motomura,Kenneth Carlsen,6-7(5); 6-3; 6-2,R64,146,11,0,60,88,50,60,18,28,0,0,15,68,88,0,2,56,93,39,56,19,37,5,8,14,58,93
2006-10-02 00:00:00.000,Tokyo Japan ATP World Tour,HARD,2,Mario Ancic,N/A Bye,Mario Ancic,,R64,0,0,0,0,0,0,0,0,0,0,0,0,0,0,0,0,0,0,0,0,0,0,0,0,0,0,0
2006-10-02 00:00:00.000,Tokyo Japan ATP World Tour,HARD,2,Dmitry Tursunov,N/A Bye,Dmitry Tursunov,,R64,0,0,0,0,0,0,0,0,0,0,0,0,0,0,0,0,0,0,0,0,0,0,0,0,0,0,0
2006-10-02 00:00:00.000,Tokyo Japan ATP World Tour,HARD,2,Jimmy Wang,Kevin Kim,Jimmy Wang,6-3; 6-1,R64,60,3,1,25,45,17,25,9,20,2,4,8,26,45,1,5,33,70,12,33,18,37,9,15,8,30,70
2006-10-02 00:00:00.000,Tokyo Japan ATP World Tour,HARD,2,Kristian Pless,Rik De Voest,Kristian Pless,6-3; 6-4,R64,74,6,1,41,65,34,41,14,24,4,4,10,48,65,2,1,41,66,24,41,15,25,5,7,9,39,66
2006-10-02 00:00:00.000,Tokyo Japan ATP World Tour,HARD,2,Hyung-Taik Lee,N/A Bye,Hyung-Taik Lee,,R64,0,0,0,0,0,0,0,0,0,0,0,0,0,0,0,0,0,0,0,0,0,0,0,0,0,0,0
2006-10-02 00:00:00.000,Tokyo Japan ATP World Tour,HARD,2,Vincent Spadea,N/A Bye,Vincent Spadea,,R64,0,0,0,0,0,0,0,0,0,0,0,0,0,0,0,0,0,0,0,0,0,0,0,0,0,0,0
2006-10-02 00:00:00.000,Tokyo Japan ATP World Tour,HARD,2,Satoshi Iwabuchi,Ti Chen,Satoshi Iwabuchi,6-2; 6-1,R64,57,3,1,31,40,23,31,6,9,1,1,7,29,40,2,2,30,49,15,30,6,19,2,7,8,21,49
2006-10-02 00:00:00.000,Tokyo Japan ATP World Tour,HARD,2,Yen-Hsun Lu,Ramon Delgado,Yen-Hsun Lu,6-2; 6-3,R64,59,11,0,23,37,20,23,10,14,2,3,8,30,37,4,5,35,58,20,35,8,23,3,8,9,28,58
2006-10-02 00:00:00.000,Tokyo Japan ATP World Tour,HARD,2,Tommy Robredo,N/A Bye,Tommy Robredo,,R64,0,0,0,0,0,0,0,0,0,0,0,0,0,0,0,0,0,0,0,0,0,0,0,0,0,0,0
2006-10-02 00:00:00.000,Tokyo Japan ATP World Tour,HARD,2,Roger Federer,Viktor Troicki,Roger Federer,7-6(2); 7-6(3),R32,101,6,1,53,82,39,53,18,29,1,2,12,57,82,9,1,51,84,35,51,19,33,2,3,12,54,84
2006-10-02 00:00:00.000,Tokyo Japan ATP World Tour,HARD,2,Wesley Moodie,Stefan Koubek,Wesley Moodie,6-3; 6-4,R32,75,10,1,47,67,34,47,11,20,2,3,10,45,67,1,1,39,57,22,39,12,18,5,8,9,34,57
2006-10-02 00:00:00.000,Tokyo Japan ATP World Tour,HARD,2,Alexander Waske,Bjorn Phau,Alexander Waske,6-4; 6-4,R32,80,5,3,30,54,25,30,15,24,0,0,10,40,54,4,3,28,58,19,28,20,30,2,4,10,39,58
2006-10-02 00:00:00.000,Tokyo Japan ATP World Tour,HARD,2,Takao Suzuki,Paradorn Srichaphan,Takao Suzuki,7-6(4); 6-7(5); 6-4,R32,131,19,4,63,103,53,63,26,40,1,1,17,79,103,9,3,55,93,45,55,28,38,2,3,17,73,93
2006-10-02 00:00:00.000,Tokyo Japan ATP World Tour,HARD,2,Jiri Novak,Andy Murray,Jiri Novak,6-3; 7-6(1),R32,82,5,1,45,68,32,45,16,23,4,5,10,48,68,5,5,34,69,26,34,14,35,3,6,11,40,69
2006-10-02 00:00:00.000,Tokyo Japan ATP World Tour,HARD,2,Benjamin Becker,Danai Udomchoke,Benjamin Becker,6-2; 6-1,R32,69,5,0,17,41,13,17,17,24,0,0,7,30,41,2,5,58,87,33,58,8,29,11,16,8,41,87
2006-10-02 00:00:00.000,Tokyo Japan ATP World Tour,HARD,2,Juan Monaco,Edgardo Massa,Juan Monaco,7-6(4); 6-3,R32,74,10,4,47,76,36,47,18,29,2,2,11,54,76,4,3,38,61,30,38,11,23,1,2,10,41,61
2006-10-02 00:00:00.000,Tokyo Japan ATP World Tour,HARD,2,Jarkko Nieminen,Lars Burgsmuller,Jarkko Nieminen,7-5; 7-6(2),R32,93,3,4,41,67,33,41,13,26,2,5,12,46,67,5,4,41,71,27,41,16,30,3,7,12,43,71
2006-10-02 00:00:00.000,Tokyo Japan ATP World Tour,HARD,2,Juan Martin Del Potro,Robby Ginepri,Juan Martin Del Potro,6-2; 6-2,R32,64,4,3,34,51,28,34,6,17,5,6,8,34,51,6,1,39,58,20,39,6,19,6,11,8,26,58
2006-10-02 00:00:00.000,Tokyo Japan ATP World Tour,HARD,2,Tim Henman,Frank Dancevic,Tim Henman,6-2; 6-1,R32,55,9,1,26,43,22,26,11,17,1,1,8,33,43,1,0,21,37,11,21,6,16,0,4,7,17,37
2006-10-02 00:00:00.000,Tokyo Japan ATP World Tour,HARD,2,Rainer Schuettler,Paul Goldstein,Rainer Schuettler,6-3; 6-2,R32,77,5,1,37,49,28,37,8,12,1,2,9,36,49,1,1,27,55,17,27,10,28,3,7,8,27,55
2006-10-02 00:00:00.000,Tokyo Japan ATP World Tour,HARD,2,Mario Ancic,Kenneth Carlsen,Mario Ancic,6-1; 6-4,R32,81,11,2,34,57,26,34,14,23,4,4,9,40,57,6,0,39,53,25,39,5,14,3,6,8,30,53
2006-10-02 00:00:00.000,Tokyo Japan ATP World Tour,HARD,2,Dmitry Tursunov,Jimmy Wang,Dmitry Tursunov,6-3; 5-7; 7-5,R32,139,9,9,42,102,30,42,30,60,5,10,16,60,102,0,3,60,108,37,60,20,48,9,16,17,57,108
2006-10-02 00:00:00.000,Tokyo Japan ATP World Tour,HARD,2,Hyung-Taik Lee,Kristian Pless,Hyung-Taik Lee,7-5; 6-1,R32,61,5,1,45,53,35,45,3,8,1,1,9,38,53,5,0,44,62,27,44,6,18,1,5,10,33,62
2006-10-02 00:00:00.000,Tokyo Japan ATP World Tour,HARD,2,Vincent Spadea,Satoshi Iwabuchi,Vincent Spadea,2-6; 6-2; 6-0,R32,70,4,2,40,69,31,40,12,29,5,8,11,43,69,1,2,43,70,27,43,8,27,4,10,11,35,70
2006-10-02 00:00:00.000,Tokyo Japan ATP World Tour,HARD,2,Tommy Robredo,Yen-Hsun Lu,Tommy Robredo,6-4; 6-1,R32,77,3,1,27,48,19,27,14,21,1,3,9,33,48,1,3,31,59,19,31,8,28,5,10,8,27,59
2006-10-02 00:00:00.000,Tokyo Japan ATP World Tour,HARD,2,Roger Federer,Wesley Moodie,Roger Federer,6-2; 6-1,R16,52,5,0,27,40,23,27,10,13,0,0,8,33,40,4,2,24,44,14,24,7,20,4,8,7,21,44
2006-10-02 00:00:00.000,Tokyo Japan ATP World Tour,HARD,2,Takao Suzuki,Alexander Waske,Takao Suzuki,6-7(4); 7-6(10); 6-1,R16,150,19,2,72,112,56,72,27,40,3,3,16,83,112,18,2,67,101,52,67,21,34,4,6,15,73,101
2006-10-02 00:00:00.000,Tokyo Japan ATP World Tour,HARD,2,Benjamin Becker,Jiri Novak,Benjamin Becker,3-6; 6-3; 7-6(4),R16,107,11,3,50,92,43,50,22,42,3,5,15,65,92,14,1,65,103,51,65,18,38,3,5,15,69,103
2006-10-02 00:00:00.000,Tokyo Japan ATP World Tour,HARD,2,Jarkko Nieminen,Juan Monaco,Jarkko Nieminen,6-2; 6-3,R16,65,5,0,37,51,29,37,8,14,0,0,9,37,51,0,0,28,51,15,28,15,23,3,6,8,30,51
2006-10-02 00:00:00.000,Tokyo Japan ATP World Tour,HARD,2,Tim Henman,Juan Martin Del Potro,Tim Henman,7-6(3); 6-3,R16,100,7,3,39,67,29,39,18,28,1,2,11,47,67,2,1,59,83,33,59,15,24,5,7,10,48,83
2006-10-02 00:00:00.000,Tokyo Japan ATP World Tour,HARD,2,Mario Ancic,Rainer Schuettler,Mario Ancic,6-2; 4-6; 6-4,R16,121,7,1,59,83,38,59,14,24,6,9,14,52,83,3,0,46,84,30,46,20,38,4,9,14,50,84
2006-10-02 00:00:00.000,Tokyo Japan ATP World Tour,HARD,2,Hyung-Taik Lee,Dmitry Tursunov,Hyung-Taik Lee,6-4; 2-6; 6-4,R16,98,6,0,51,66,41,51,6,15,2,5,14,47,66,6,1,52,86,35,52,19,34,3,6,14,54,86
2006-10-02 00:00:00.000,Tokyo Japan ATP World Tour,HARD,2,Tommy Robredo,Vincent Spadea,Tommy Robredo,6-4; 7-6(9),R16,129,5,4,58,99,41,58,21,41,12,13,11,62,99,1,3,45,83,29,45,21,38,4,6,11,50,83
2006-10-02 00:00:00.000,Tokyo Japan ATP World Tour,HARD,2,Roger Federer,Takao Suzuki,Roger Federer,4-6; 7-5; 7-6(3),Q,124,15,0,60,88,52,60,17,28,2,3,17,69,88,6,3,68,111,50,68,24,43,1,2,17,74,111
2006-10-02 00:00:00.000,Tokyo Japan ATP World Tour,HARD,2,Benjamin Becker,Jarkko Nieminen,Benjamin Becker,6-7(5); 7-6(6); 6-4,Q,128,10,4,56,108,45,56,30,52,2,4,17,75,108,9,3,62,112,47,62,27,50,5,8,17,74,112
2006-10-02 00:00:00.000,Tokyo Japan ATP World Tour,HARD,2,Tim Henman,Mario Ancic,Tim Henman,6-2; 6-2,Q,62,4,0,32,43,25,32,8,11,3,3,8,33,43,4,2,37,55,23,37,6,18,1,5,8,29,55
2006-10-02 00:00:00.000,Tokyo Japan ATP World Tour,HARD,2,Hyung-Taik Lee,Tommy Robredo,Hyung-Taik Lee,7-6(3); 4-6; 6-1,Q,133,3,2,64,97,48,64,19,33,1,2,15,67,97,4,1,64,93,44,64,16,29,3,5,14,60,93
2006-10-02 00:00:00.000,Tokyo Japan ATP World Tour,HARD,2,Roger Federer,Benjamin Becker,Roger Federer,6-3; 6-4,S,60,8,0,29,49,29,29,12,20,1,1,10,41,49,4,1,31,57,21,31,17,26,2,4,9,38,57
2006-10-02 00:00:00.000,Tokyo Japan ATP World Tour,HARD,2,Tim Henman,Hyung-Taik Lee,Tim Henman,6-4; 7-6(5),S,93,5,1,39,70,31,39,18,31,2,3,11,49,70,2,1,50,69,32,50,13,19,2,4,11,45,69
2006-10-02 00:00:00.000,Tokyo Japan ATP World Tour,HARD,2,Roger Federer,Tim Henman,Roger Federer,6-3; 6-3,F,67,4,2,27,48,20,27,17,21,0,0,9,37,48,0,6,44,65,29,44,7,21,8,11,9,36,65
2006-10-09 00:00:00.000,Moscow Russia ATP World Tour,HARD,2,Nikolay Davydenko,Jiri Vanek,Nikolay Davydenko,6-0; 6-0,R32,37,5,1,16,27,16,16,8,11,0,0,6,24,27,0,1,21,40,6,21,6,19,4,10,6,12,40
2006-10-09 00:00:00.000,Moscow Russia ATP World Tour,HARD,2,Teymuraz Gabashvili,Gilles Muller,Teymuraz Gabashvili,7-6(3); 6-3,R32,74,7,1,34,61,30,34,19,27,1,1,11,49,61,7,0,42,61,30,42,12,19,2,3,10,42,61
2006-10-09 00:00:00.000,Moscow Russia ATP World Tour,HARD,2,Max Mirnyi,Kevin Kim,Max Mirnyi,6-0 RET,R32,20,10,1,8,16,8,8,5,8,2,2,3,13,16,0,1,10,18,2,10,3,8,0,3,3,5,18
2006-10-09 00:00:00.000,Moscow Russia ATP World Tour,HARD,2,Julien Benneteau,Sergio Roitman,Julien Benneteau,6-3; 6-0,R32,50,5,3,25,41,20,25,10,16,1,1,7,30,41,3,0,25,45,15,25,5,20,4,9,8,20,45
2006-10-09 00:00:00.000,Moscow Russia ATP World Tour,HARD,2,Philipp Kohlschreiber,Mikhail Youzhny,Philipp Kohlschreiber,6-2; 7-5,R32,79,3,2,28,62,23,28,22,34,3,3,10,45,62,4,1,35,56,26,35,9,21,2,5,10,35,56
2006-10-09 00:00:00.000,Moscow Russia ATP World Tour,HARD,2,Evgeny Korolev,Denis Istomin,Evgeny Korolev,7-6(2); 6-7(5); 6-3,R32,136,7,3,68,116,55,68,27,48,8,9,17,82,116,7,1,62,105,46,62,25,43,6,8,16,71,105
2006-10-09 00:00:00.000,Moscow Russia ATP World Tour,HARD,2,Konstantin Kravchuk,Hyung-Taik Lee,Konstantin Kravchuk,6-4; 6-4,R32,61,10,3,31,53,25,31,14,22,1,2,10,39,53,0,0,45,61,30,45,6,16,2,5,10,36,61
2006-10-09 00:00:00.000,Moscow Russia ATP World Tour,HARD,2,Fabrice Santoro,Wesley Moodie,Fabrice Santoro,6-3; 6-2,R32,62,2,1,29,46,24,29,13,17,0,0,9,37,46,5,1,34,48,20,34,7,14,1,4,8,27,48
2006-10-09 00:00:00.000,Moscow Russia ATP World Tour,HARD,2,Janko Tipsarevic,Paul-Henri Mathieu,Janko Tipsarevic,7-6(8); 6-4,R32,106,12,2,50,72,46,50,9,22,1,1,11,55,72,9,1,37,76,30,37,24,39,2,3,11,54,76
2006-10-09 00:00:00.000,Moscow Russia ATP World Tour,HARD,2,Robin Vik,Jiri Novak,Robin Vik,6-4; 6-3,R32,58,2,3,31,46,29,31,8,15,1,1,9,37,46,3,4,35,58,28,35,7,23,2,5,10,35,58
2006-10-09 00:00:00.000,Moscow Russia ATP World Tour,HARD,2,Marat Safin,Nicolas Mahut,Marat Safin,6-3; 6-4,R32,61,11,1,28,48,25,28,15,20,0,0,10,40,48,4,2,32,48,24,32,7,16,0,2,9,31,48
2006-10-09 00:00:00.000,Moscow Russia ATP World Tour,HARD,2,Daniele Bracciali,Fernando Verdasco,Daniele Bracciali,6-7(4); 6-4 RET,R32,93,7,2,33,70,24,33,25,37,4,4,11,49,70,15,1,53,75,40,53,12,22,3,4,11,52,75
2006-10-09 00:00:00.000,Moscow Russia ATP World Tour,HARD,2,Jan Hernych,Filippo Volandri,Jan Hernych,6-1; 6-4,R32,62,1,1,40,60,28,40,13,20,1,1,9,41,60,0,4,21,44,14,21,12,23,0,3,8,26,44
2006-10-09 00:00:00.000,Moscow Russia ATP World Tour,HARD,2,Igor Kunitsyn,Rainer Schuettler,Igor Kunitsyn,6-3; 6-2,R32,74,6,0,30,45,27,30,8,15,3,3,8,35,45,2,2,40,63,25,40,9,23,3,7,9,34,63
2006-10-09 00:00:00.000,Moscow Russia ATP World Tour,HARD,2,Arnaud Clement,Mischa Zverev,Arnaud Clement,4-6; 6-3; 6-2,R32,111,3,3,49,89,36,49,22,40,1,4,14,58,89,11,1,58,84,36,58,10,26,4,9,13,46,84
2006-10-09 00:00:00.000,Moscow Russia ATP World Tour,HARD,2,Sergiy Stakhovsky,Dmitry Tursunov,Sergiy Stakhovsky,7-5; 4-6; 7-6(4),R32,121,11,4,61,105,48,61,23,44,6,8,17,71,105,17,2,49,91,43,49,24,42,1,3,17,67,91
2006-10-09 00:00:00.000,Moscow Russia ATP World Tour,HARD,2,Nikolay Davydenko,Teymuraz Gabashvili,Nikolay Davydenko,6-4; 6-2,R16,76,7,3,39,54,32,39,7,15,1,1,9,39,54,8,2,27,58,17,27,16,31,5,8,9,33,58
2006-10-09 00:00:00.000,Moscow Russia ATP World Tour,HARD,2,Max Mirnyi,Julien Benneteau,Max Mirnyi,6-2; 2-6; 7-6(2),R16,130,18,8,54,89,43,54,16,35,5,7,14,59,89,4,2,66,92,43,66,16,26,5,7,14,59,92
2006-10-09 00:00:00.000,Moscow Russia ATP World Tour,HARD,2,Philipp Kohlschreiber,Evgeny Korolev,Philipp Kohlschreiber,6-3; 6-2,R16,61,8,1,24,51,20,24,19,27,2,2,9,39,51,3,2,27,47,21,27,7,20,4,7,8,28,47
2006-10-09 00:00:00.000,Moscow Russia ATP World Tour,HARD,2,Fabrice Santoro,Konstantin Kravchuk,Fabrice Santoro,6-1; 6-1,R16,49,1,0,19,37,15,19,13,18,0,0,7,28,37,1,2,25,49,10,25,10,24,6,11,7,20,49
2006-10-09 00:00:00.000,Moscow Russia ATP World Tour,HARD,2,Janko Tipsarevic,Robin Vik,Janko Tipsarevic,6-4; 6-4,R16,73,13,1,35,50,31,35,10,15,0,0,10,41,50,11,2,34,62,23,34,15,28,4,6,10,38,62
2006-10-09 00:00:00.000,Moscow Russia ATP World Tour,HARD,2,Marat Safin,Daniele Bracciali,Marat Safin,3-6; 6-1; 6-4,R16,103,7,1,47,67,37,47,13,20,0,1,13,50,67,5,3,41,83,30,41,20,42,5,8,13,50,83
2006-10-09 00:00:00.000,Moscow Russia ATP World Tour,HARD,2,Igor Kunitsyn,Jan Hernych,Igor Kunitsyn,6-4; 4-6; 6-2,R16,107,3,2,52,87,35,52,18,35,3,6,14,53,87,5,0,59,78,38,59,7,19,2,7,14,45,78
2006-10-09 00:00:00.000,Moscow Russia ATP World Tour,HARD,2,Arnaud Clement,Sergiy Stakhovsky,Arnaud Clement,6-3; 5-7; 6-4,R16,155,7,2,64,114,45,64,26,50,9,11,16,71,114,14,4,67,99,54,67,9,32,8,11,15,63,99
2006-10-09 00:00:00.000,Moscow Russia ATP World Tour,HARD,2,Nikolay Davydenko,Max Mirnyi,Nikolay Davydenko,6-3; 7-5,Q,88,0,1,40,62,29,40,13,22,5,6,10,42,62,5,3,34,68,23,34,14,34,3,7,11,37,68
2006-10-09 00:00:00.000,Moscow Russia ATP World Tour,HARD,2,Fabrice Santoro,Philipp Kohlschreiber,Fabrice Santoro,6-3; 7-5,Q,97,5,1,48,75,36,48,18,27,5,5,11,54,75,6,3,45,76,30,45,16,31,9,11,10,46,76
2006-10-09 00:00:00.000,Moscow Russia ATP World Tour,HARD,2,Marat Safin,Janko Tipsarevic,Marat Safin,7-6(5); 3-6; 6-4,Q,150,14,1,69,103,46,69,17,34,4,8,16,63,103,7,0,73,118,49,73,20,45,9,12,15,69,118
2006-10-09 00:00:00.000,Moscow Russia ATP World Tour,HARD,2,Igor Kunitsyn,Arnaud Clement,Igor Kunitsyn,6-4; 6-2,Q,78,6,0,30,50,25,30,13,20,3,3,9,38,50,7,0,45,63,28,45,8,18,5,8,9,36,63
2006-10-09 00:00:00.000,Moscow Russia ATP World Tour,HARD,2,Nikolay Davydenko,Fabrice Santoro,Nikolay Davydenko,6-4; 6-1,S,70,6,3,35,51,26,35,9,16,2,3,8,35,51,2,3,39,64,20,39,12,25,3,8,9,32,64
2006-10-09 00:00:00.000,Moscow Russia ATP World Tour,HARD,2,Marat Safin,Igor Kunitsyn,Marat Safin,6-4; 6-3,S,74,4,0,38,51,30,38,9,13,2,3,10,39,51,0,2,29,59,19,29,15,30,7,10,9,34,59
2006-10-09 00:00:00.000,Moscow Russia ATP World Tour,HARD,2,Nikolay Davydenko,Marat Safin,Nikolay Davydenko,6-4; 5-7; 6-4,F,140,2,2,59,83,47,59,12,24,1,4,16,59,83,7,3,67,114,46,67,21,47,8,12,16,67,114
2006-10-09 00:00:00.000,Stockholm Sweden ATP World Tour,HARD,2,Rafael Nadal,Raemon Sluiter,Rafael Nadal,6-4; 6-2,R32,92,5,1,29,59,22,29,20,30,4,4,9,42,59,8,3,33,55,24,33,9,22,2,5,9,33,55
2006-10-09 00:00:00.000,Stockholm Sweden ATP World Tour,HARD,2,Joachim Johansson,Davide Sanguinetti,Joachim Johansson,6-4; 6-4,R32,70,11,3,36,58,31,36,11,22,0,0,10,42,58,3,2,35,63,22,35,18,28,3,5,10,40,63
2006-10-09 00:00:00.000,Stockholm Sweden ATP World Tour,HARD,2,Frank Dancevic,Guillermo Garcia-Lopez,Frank Dancevic,6-4; 6-1,R32,58,8,0,39,55,27,39,11,16,1,2,9,38,55,3,3,37,54,22,37,6,17,1,5,8,28,54
2006-10-09 00:00:00.000,Stockholm Sweden ATP World Tour,HARD,2,Kristof Vliegen,Nicolas Massu,Kristof Vliegen,6-2; 6-4,R32,80,3,0,27,51,21,27,16,24,1,2,9,37,51,0,2,28,55,16,28,12,27,5,9,9,28,55
2006-10-09 00:00:00.000,Stockholm Sweden ATP World Tour,HARD,2,David Ferrer,Andreas Seppi,David Ferrer,6-1; 6-4,R32,77,2,2,33,59,24,33,15,26,2,3,9,39,59,0,7,32,58,17,32,10,26,3,7,8,27,58
2006-10-09 00:00:00.000,Stockholm Sweden ATP World Tour,HARD,2,Feliciano Lopez,Juan Monaco,Feliciano Lopez,2-1 RET,R32,25,4,1,11,20,7,11,5,9,2,2,2,12,20,0,1,3,6,3,3,1,3,0,0,1,4,6
2006-10-09 00:00:00.000,Stockholm Sweden ATP World Tour,HARD,2,Marc Gicquel,Jonathan Marray,Marc Gicquel,6-4; 7-6(3),R32,84,3,0,50,70,41,50,13,20,3,3,11,54,70,5,3,44,70,35,44,12,26,0,1,11,47,70
2006-10-09 00:00:00.000,Stockholm Sweden ATP World Tour,HARD,2,Jarkko Nieminen,Michael Llodra,Jarkko Nieminen,6-4; 6-4,R32,69,2,1,32,57,25,32,17,25,2,2,10,42,57,8,1,30,54,24,30,13,24,1,3,10,37,54
2006-10-09 00:00:00.000,Stockholm Sweden ATP World Tour,HARD,2,Robin Soderling,Christophe Rochus,Robin Soderling,6-1; 6-2,R32,56,9,2,28,46,24,28,11,18,0,0,8,35,46,0,2,28,47,15,28,7,19,3,7,7,22,47
2006-10-09 00:00:00.000,Stockholm Sweden ATP World Tour,HARD,2,Jonas Bjorkman,Peter Wessels,Jonas Bjorkman,7-5; 6-2,R32,75,5,4,37,61,27,37,11,24,2,5,10,38,61,3,3,31,56,17,31,7,25,4,10,10,24,56
2006-10-09 00:00:00.000,Stockholm Sweden ATP World Tour,HARD,2,Andreas Vinciguerra,Nicolas Devilder,Andreas Vinciguerra,6-4; 6-1,R32,81,4,2,36,58,24,36,12,22,4,5,8,36,58,3,1,31,57,17,31,9,26,4,9,9,26,57
2006-10-09 00:00:00.000,Stockholm Sweden ATP World Tour,HARD,2,Tomas Berdych,Bjorn Phau,Tomas Berdych,6-3; 6-2,R32,61,3,1,34,47,27,34,7,13,0,1,9,34,47,1,1,26,57,18,26,12,31,4,8,8,30,57
2006-10-09 00:00:00.000,Stockholm Sweden ATP World Tour,HARD,2,Olivier Rochus,Vincent Spadea,Olivier Rochus,6-3; 6-4,R32,102,1,4,32,57,25,32,12,25,4,5,9,37,57,1,1,51,94,31,51,18,43,12,16,10,49,94
2006-10-09 00:00:00.000,Stockholm Sweden ATP World Tour,HARD,2,Paradorn Srichaphan,Mardy Fish,Paradorn Srichaphan,7-6(5); 3-6; 6-1,R32,119,5,3,44,82,33,44,24,38,2,4,14,57,82,7,6,46,104,32,46,30,58,5,8,14,62,104
2006-10-09 00:00:00.000,Stockholm Sweden ATP World Tour,HARD,2,Simon Greul,Ervin Eleskovic,Simon Greul,6-4; 6-2,R32,58,12,3,27,49,22,27,15,22,1,1,9,37,49,5,5,30,54,21,30,10,24,1,4,9,31,54
2006-10-09 00:00:00.000,Stockholm Sweden ATP World Tour,HARD,2,James Blake,Thomas Johansson,James Blake,6-3; 6-2,R32,60,6,1,30,54,25,30,14,24,1,1,9,39,54,3,1,25,48,18,25,8,23,3,6,8,26,48
2006-10-09 00:00:00.000,Stockholm Sweden ATP World Tour,HARD,2,Joachim Johansson,Rafael Nadal,Joachim Johansson,6-4; 7-6(4),R16,112,17,4,49,84,37,49,19,35,6,7,11,56,84,3,0,33,59,26,33,17,26,1,3,11,43,59
2006-10-09 00:00:00.000,Stockholm Sweden ATP World Tour,HARD,2,Kristof Vliegen,Frank Dancevic,Kristof Vliegen,3-6; 6-3; 6-4,R16,103,8,1,42,80,30,42,27,38,5,6,14,57,80,3,1,46,79,34,46,18,33,1,3,14,52,79
2006-10-09 00:00:00.000,Stockholm Sweden ATP World Tour,HARD,2,Feliciano Lopez,David Ferrer,Feliciano Lopez,3-6; 6-3; 6-2,R16,91,12,1,51,80,40,51,15,29,4,5,13,55,80,4,3,38,68,27,38,18,30,0,3,13,45,68
2006-10-09 00:00:00.000,Stockholm Sweden ATP World Tour,HARD,2,Jarkko Nieminen,Marc Gicquel,Jarkko Nieminen,6-3; 6-2,R16,65,5,1,28,59,24,28,18,31,4,4,9,42,59,1,1,26,49,20,26,9,23,2,5,8,29,49
2006-10-09 00:00:00.000,Stockholm Sweden ATP World Tour,HARD,2,Robin Soderling,Jonas Bjorkman,Robin Soderling,6-0; 6-2,R16,49,4,2,24,34,23,24,5,10,0,0,7,28,34,1,5,25,46,16,25,2,21,5,10,7,18,46
2006-10-09 00:00:00.000,Stockholm Sweden ATP World Tour,HARD,2,Tomas Berdych,Andreas Vinciguerra,Tomas Berdych,4-6; 7-5; 7-5,R16,135,10,0,62,89,46,62,16,27,2,5,17,62,89,6,2,73,107,48,73,18,34,6,10,17,66,107
2006-10-09 00:00:00.000,Stockholm Sweden ATP World Tour,HARD,2,Olivier Rochus,Paradorn Srichaphan,Olivier Rochus,6-2; 6-7(5); 6-2,R16,134,1,1,64,102,44,64,21,38,14,16,14,65,102,8,4,53,87,35,53,16,34,4,10,14,51,87
2006-10-09 00:00:00.000,Stockholm Sweden ATP World Tour,HARD,2,James Blake,Simon Greul,James Blake,6-3; 6-2,R16,71,1,0,32,57,24,32,15,25,3,3,9,39,57,3,1,49,70,32,49,7,21,5,8,8,39,70
2006-10-09 00:00:00.000,Stockholm Sweden ATP World Tour,HARD,2,Joachim Johansson,Kristof Vliegen,Joachim Johansson,6-7(5); 7-6(5); 7-6(7),Q,173,24,4,96,137,74,96,18,41,8,9,18,92,137,24,3,80,120,67,80,18,40,1,2,18,85,120
2006-10-09 00:00:00.000,Stockholm Sweden ATP World Tour,HARD,2,Jarkko Nieminen,Feliciano Lopez,Jarkko Nieminen,6-3; 7-5,Q,71,5,0,46,62,36,46,8,16,2,3,11,44,62,7,3,34,60,24,34,11,26,2,5,10,35,60
2006-10-09 00:00:00.000,Stockholm Sweden ATP World Tour,HARD,2,Robin Soderling,Tomas Berdych,Robin Soderling,6-2; 6-3,Q,56,5,2,29,44,26,29,10,15,0,0,9,36,44,3,3,26,50,20,26,9,24,5,8,8,29,50
2006-10-09 00:00:00.000,Stockholm Sweden ATP World Tour,HARD,2,James Blake,Olivier Rochus,James Blake,6-7(3); 6-4; 6-2,Q,119,16,0,54,90,42,54,22,36,3,4,15,64,90,1,3,63,101,37,63,23,38,5,9,15,60,101
2006-10-09 00:00:00.000,Stockholm Sweden ATP World Tour,HARD,2,Jarkko Nieminen,Joachim Johansson,Jarkko Nieminen,7-6(8); 6-7(5); 6-3,S,135,15,0,82,116,63,82,22,34,5,5,17,85,116,15,3,62,97,52,62,22,35,0,1,16,74,97
2006-10-09 00:00:00.000,Stockholm Sweden ATP World Tour,HARD,2,James Blake,Robin Soderling,James Blake,7-5; 7-6(4),S,89,5,2,51,71,40,51,14,20,0,1,12,54,71,8,2,43,80,34,43,18,37,4,6,12,52,80
2006-10-09 00:00:00.000,Stockholm Sweden ATP World Tour,HARD,2,James Blake,Jarkko Nieminen,James Blake,6-4; 6-2,F,56,4,1,21,45,21,21,12,24,0,1,9,33,45,3,0,40,58,26,40,7,18,2,6,9,33,58
2006-10-09 00:00:00.000,Vienna Austria ATP World Tour,HARD,2,Ivan Ljubicic,Agustin Calleri,Ivan Ljubicic,7-6(3); 6-2,R32,76,8,1,36,55,32,36,12,19,0,0,10,44,55,6,0,38,64,29,38,11,26,4,6,10,40,64
2006-10-09 00:00:00.000,Vienna Austria ATP World Tour,HARD,2,Florian Mayer,Alessio Di Mauro,Florian Mayer,6-2; 6-0,R32,44,5,0,28,34,24,28,4,6,0,0,7,28,34,0,4,25,40,12,25,3,15,0,5,7,15,40
2006-10-09 00:00:00.000,Vienna Austria ATP World Tour,HARD,2,Stanislas Wawrinka,Marin Cilic,Stanislas Wawrinka,6-4; 6-1,R32,79,4,1,41,67,31,41,11,26,4,5,9,42,67,3,3,24,50,16,24,9,26,5,9,8,25,50
2006-10-09 00:00:00.000,Vienna Austria ATP World Tour,HARD,2,Novak Djokovic,Tomas Zib,Novak Djokovic,6-3; 6-4,R32,66,16,2,37,61,34,37,10,24,3,3,10,44,61,2,0,25,49,21,25,11,24,1,3,9,32,49
2006-10-09 00:00:00.000,Vienna Austria ATP World Tour,HARD,2,Marcos Baghdatis,Ruben Ramirez Hidalgo,Marcos Baghdatis,6-3; 3-6; 6-4,R32,143,8,2,60,99,40,60,21,39,8,11,14,61,99,6,4,48,88,34,48,19,40,8,12,14,53,88
2006-10-09 00:00:00.000,Vienna Austria ATP World Tour,HARD,2,Stefan Koubek,Denis Gremelmayr,Stefan Koubek,6-1; 6-0,R32,44,3,0,25,44,21,25,11,19,1,1,7,32,44,0,4,18,37,9,18,4,19,1,6,6,13,37
2006-10-09 00:00:00.000,Vienna Austria ATP World Tour,HARD,2,Dominik Hrbaty,Simone Bolelli,Dominik Hrbaty,6-2; 6-4,R32,76,4,6,31,67,26,31,18,36,2,2,9,44,67,3,1,37,58,21,37,11,21,6,9,9,32,58
2006-10-09 00:00:00.000,Vienna Austria ATP World Tour,HARD,2,Tommy Haas,Martin Fischer,Tommy Haas,7-6(3); 6-2,R32,85,5,1,44,68,33,44,13,24,4,6,10,46,68,0,1,46,69,25,46,11,23,4,8,10,36,69
2006-10-09 00:00:00.000,Vienna Austria ATP World Tour,HARD,2,Jurgen Melzer,Juan Carlos Ferrero,Jurgen Melzer,5-7; 7-6(5); 6-3,R32,150,8,3,60,106,48,60,22,46,2,4,17,70,106,0,2,60,101,41,60,26,41,7,9,16,67,101
2006-10-09 00:00:00.000,Vienna Austria ATP World Tour,HARD,2,Lukasz Kubot,Sebastien Grosjean,Lukasz Kubot,6-4; 6-3,R32,105,4,2,41,64,30,41,11,23,3,4,10,41,64,2,1,45,67,28,45,9,22,5,8,9,37,67
2006-10-09 00:00:00.000,Vienna Austria ATP World Tour,HARD,2,Richard Gasquet,Alejandro Falla,Richard Gasquet,7-6(4); 6-3,R32,109,1,2,59,82,43,59,7,23,7,10,10,50,82,2,0,34,73,22,34,17,39,6,11,11,39,73
2006-10-09 00:00:00.000,Vienna Austria ATP World Tour,HARD,2,Andy Roddick,Jose Acasuso,Andy Roddick,6-0; 7-6(2),R32,63,19,2,39,50,36,39,6,11,0,0,9,42,50,9,2,43,73,28,43,14,30,4,7,9,42,73
2006-10-09 00:00:00.000,Vienna Austria ATP World Tour,HARD,2,Fernando Gonzalez,Gilles Simon,Fernando Gonzalez,7-6(6); 6-4,R32,99,7,2,46,68,34,46,15,22,2,4,11,49,68,1,3,58,84,38,58,13,26,8,11,11,51,84
2006-10-09 00:00:00.000,Vienna Austria ATP World Tour,HARD,2,Carlos Moya,Nicolas Almagro,Carlos Moya,3-6; 6-3; 7-6(3),R32,104,13,2,49,83,42,49,20,34,5,6,15,62,83,16,4,57,93,46,57,18,36,6,7,15,64,93
2006-10-09 00:00:00.000,Vienna Austria ATP World Tour,HARD,2,Oliver Marach,Rainer Eitzinger,Oliver Marach,2-6; 7-5; 7-6(6),R32,161,8,5,76,132,50,76,23,56,5,10,16,73,132,6,2,44,90,35,44,24,46,5,9,16,59,90
2006-10-09 00:00:00.000,Vienna Austria ATP World Tour,HARD,2,David Nalbandian,Juan Ignacio Chela,David Nalbandian,6-7(6); 6-2; 6-2,R32,123,4,3,52,88,37,52,23,36,3,4,14,60,88,4,1,68,101,39,68,18,33,1,6,14,57,101
2006-10-09 00:00:00.000,Vienna Austria ATP World Tour,HARD,2,Ivan Ljubicic,Florian Mayer,Ivan Ljubicic,6-3; 6-3,R16,67,14,1,32,50,30,32,8,18,1,1,9,38,50,1,0,38,58,25,38,8,20,2,5,9,33,58
2006-10-09 00:00:00.000,Vienna Austria ATP World Tour,HARD,2,Stanislas Wawrinka,Novak Djokovic,Stanislas Wawrinka,6-3; 6-3,R16,62,7,1,28,50,23,28,14,22,2,2,9,37,50,1,2,26,45,17,26,8,19,0,3,9,25,45
2006-10-09 00:00:00.000,Vienna Austria ATP World Tour,HARD,2,Stefan Koubek,Marcos Baghdatis,Stefan Koubek,1-6; 7-6(3); 6-2,R16,121,0,2,41,81,29,41,20,40,4,8,13,49,81,5,4,53,91,36,53,17,38,5,9,14,53,91
2006-10-09 00:00:00.000,Vienna Austria ATP World Tour,HARD,2,Dominik Hrbaty,Tommy Haas,Dominik Hrbaty,6-3; 4-6; 6-0,R16,87,12,4,47,75,40,47,14,28,4,5,13,54,75,2,3,46,67,33,46,9,21,2,6,12,42,67
2006-10-09 00:00:00.000,Vienna Austria ATP World Tour,HARD,2,Jurgen Melzer,Lukasz Kubot,Jurgen Melzer,6-4; 3-6; 6-1,R16,129,7,1,62,93,39,62,15,31,7,11,13,54,93,4,2,49,72,27,49,12,23,4,10,13,39,72
2006-10-09 00:00:00.000,Vienna Austria ATP World Tour,HARD,2,Andy Roddick,Richard Gasquet,Andy Roddick,6-7(5); 6-1; 6-3,R16,100,8,0,53,75,46,53,14,22,0,0,14,60,75,7,1,55,83,40,55,14,28,1,5,14,54,83
2006-10-09 00:00:00.000,Vienna Austria ATP World Tour,HARD,2,Fernando Gonzalez,Carlos Moya,Fernando Gonzalez,6-3; 6-4,R16,56,3,0,34,51,27,34,13,17,0,0,10,40,51,4,3,34,48,22,34,9,14,3,5,9,31,48
2006-10-09 00:00:00.000,Vienna Austria ATP World Tour,HARD,2,David Nalbandian,Oliver Marach,David Nalbandian,6-2; 6-3,R16,87,5,1,35,66,28,35,13,31,6,7,9,41,66,1,3,24,56,15,24,13,32,3,7,8,28,56
2006-10-09 00:00:00.000,Vienna Austria ATP World Tour,HARD,2,Ivan Ljubicic,Stanislas Wawrinka,Ivan Ljubicic,6-3; 6-2,Q,66,11,3,27,46,24,27,12,19,0,0,9,36,46,2,1,29,51,19,29,10,22,2,5,8,29,51
2006-10-09 00:00:00.000,Vienna Austria ATP World Tour,HARD,2,Dominik Hrbaty,Stefan Koubek,Dominik Hrbaty,6-1; 5-7; 6-2,Q,122,4,7,48,97,32,48,28,49,11,14,13,60,97,2,6,40,87,23,40,20,47,1,8,14,43,87
2006-10-09 00:00:00.000,Vienna Austria ATP World Tour,HARD,2,Andy Roddick,Jurgen Melzer,Andy Roddick,6-4; 6-3,Q,73,11,0,33,55,28,33,11,22,1,2,10,39,55,1,1,38,58,17,38,16,20,2,5,9,33,58
2006-10-09 00:00:00.000,Vienna Austria ATP World Tour,HARD,2,Fernando Gonzalez,David Nalbandian,Fernando Gonzalez,3-6; 6-3; 6-1,Q,108,11,3,57,82,39,57,13,25,6,8,12,52,82,1,0,60,87,32,60,15,27,8,13,13,47,87
2006-10-09 00:00:00.000,Vienna Austria ATP World Tour,HARD,2,Ivan Ljubicic,Dominik Hrbaty,Ivan Ljubicic,6-1; 6-4,S,65,12,1,32,40,28,32,4,8,0,0,8,32,40,3,4,38,61,22,38,11,23,4,8,9,33,61
2006-10-09 00:00:00.000,Vienna Austria ATP World Tour,HARD,2,Fernando Gonzalez,Andy Roddick,Fernando Gonzalez,6-4; 3-6; 7-6(5),S,127,9,3,63,90,51,63,15,27,0,1,15,66,90,12,0,76,111,50,76,25,35,4,5,16,75,111
2006-10-09 00:00:00.000,Vienna Austria ATP World Tour,HARD,2,Ivan Ljubicic,Fernando Gonzalez,Ivan Ljubicic,6-3; 6-4; 7-5,F,135,17,1,52,83,46,52,21,31,4,4,16,67,83,2,3,81,120,55,81,15,39,7,10,15,70,120
2006-10-16 00:00:00.000,ATP Masters Series Madrid Spain ATP World Tour,HARD,2,Roger Federer,N/A Bye,Roger Federer,,R64,0,0,0,0,0,0,0,0,0,0,0,0,0,0,0,0,0,0,0,0,0,0,0,0,0,0,0
2006-10-16 00:00:00.000,ATP Masters Series Madrid Spain ATP World Tour,HARD,2,Nicolas Massu,Gaston Gaudio,Nicolas Massu,4-6; 6-3 RET,R64,88,4,4,28,57,20,28,15,29,1,4,10,35,57,0,5,35,56,25,35,8,21,1,4,9,33,56
2006-10-16 00:00:00.000,ATP Masters Series Madrid Spain ATP World Tour,HARD,2,Robin Soderling,Olivier Rochus,Robin Soderling,6-3; 6-4,R64,62,11,2,33,53,27,33,13,20,0,0,10,40,53,2,1,35,53,22,35,10,18,6,8,9,32,53
2006-10-16 00:00:00.000,ATP Masters Series Madrid Spain ATP World Tour,HARD,2,Juan Carlos Ferrero,N/A Bye,Juan Carlos Ferrero,,R64,0,0,0,0,0,0,0,0,0,0,0,0,0,0,0,0,0,0,0,0,0,0,0,0,0,0,0
2006-10-16 00:00:00.000,ATP Masters Series Madrid Spain ATP World Tour,HARD,2,Mario Ancic,N/A Bye,Mario Ancic,,R64,0,0,0,0,0,0,0,0,0,0,0,0,0,0,0,0,0,0,0,0,0,0,0,0,0,0,0
2006-10-16 00:00:00.000,ATP Masters Series Madrid Spain ATP World Tour,HARD,2,Robby Ginepri,Feliciano Lopez,Robby Ginepri,6-1; 3-6; 6-3,R64,110,7,2,52,89,35,52,22,37,10,11,13,57,89,7,4,40,76,30,40,17,36,3,6,12,47,76
2006-10-16 00:00:00.000,ATP Masters Series Madrid Spain ATP World Tour,HARD,2,Juan Ignacio Chela,Carlos Moya,Juan Ignacio Chela,6-3; 6-2,R64,58,3,1,29,45,24,29,13,16,2,2,9,37,45,1,1,30,46,21,30,6,16,3,6,8,27,46
2006-10-16 00:00:00.000,ATP Masters Series Madrid Spain ATP World Tour,HARD,2,Tommy Robredo,N/A Bye,Tommy Robredo,,R64,0,0,0,0,0,0,0,0,0,0,0,0,0,0,0,0,0,0,0,0,0,0,0,0,0,0,0
2006-10-16 00:00:00.000,ATP Masters Series Madrid Spain ATP World Tour,HARD,2,David Nalbandian,N/A Bye,David Nalbandian,,R64,0,0,0,0,0,0,0,0,0,0,0,0,0,0,0,0,0,0,0,0,0,0,0,0,0,0,0
2006-10-16 00:00:00.000,ATP Masters Series Madrid Spain ATP World Tour,HARD,2,Julien Benneteau,Alejandro Falla,Julien Benneteau,6-2; 6-1,R64,58,2,1,37,50,27,37,9,13,4,4,8,36,50,0,0,25,41,12,25,8,16,2,6,7,20,41
2006-10-16 00:00:00.000,ATP Masters Series Madrid Spain ATP World Tour,HARD,2,Tim Henman,Fernando Verdasco,Tim Henman,7-5; 6-3,R64,91,6,3,43,66,32,43,17,23,5,5,11,49,66,3,3,42,59,30,42,7,17,2,4,10,37,59
2006-10-16 00:00:00.000,ATP Masters Series Madrid Spain ATP World Tour,HARD,2,David Ferrer,N/A Bye,David Ferrer,,R64,0,0,0,0,0,0,0,0,0,0,0,0,0,0,0,0,0,0,0,0,0,0,0,0,0,0,0
2006-10-16 00:00:00.000,ATP Masters Series Madrid Spain ATP World Tour,HARD,2,Marcos Baghdatis,N/A Bye,Marcos Baghdatis,,R64,0,0,0,0,0,0,0,0,0,0,0,0,0,0,0,0,0,0,0,0,0,0,0,0,0,0,0
2006-10-16 00:00:00.000,ATP Masters Series Madrid Spain ATP World Tour,HARD,2,Marat Safin,Jose Acasuso,Marat Safin,7-6(5); 6-7(4); 6-3,R64,135,16,0,70,109,56,70,18,39,3,5,17,74,109,15,3,57,101,47,57,22,44,4,7,16,69,101
2006-10-16 00:00:00.000,ATP Masters Series Madrid Spain ATP World Tour,HARD,2,Kristof Vliegen,Dmitry Tursunov,Kristof Vliegen,6-3; 6-1,R64,61,6,3,26,45,22,26,12,19,3,3,8,34,45,5,4,34,63,21,34,11,29,6,10,8,32,63
2006-10-16 00:00:00.000,ATP Masters Series Madrid Spain ATP World Tour,HARD,2,James Blake,N/A Bye,James Blake,,R64,0,0,0,0,0,0,0,0,0,0,0,0,0,0,0,0,0,0,0,0,0,0,0,0,0,0,0
2006-10-16 00:00:00.000,ATP Masters Series Madrid Spain ATP World Tour,HARD,2,Nikolay Davydenko,N/A Bye,Nikolay Davydenko,,R64,0,0,0,0,0,0,0,0,0,0,0,0,0,0,0,0,0,0,0,0,0,0,0,0,0,0,0
2006-10-16 00:00:00.000,ATP Masters Series Madrid Spain ATP World Tour,HARD,2,Joachim Johansson,Juan Martin Del Potro,Joachim Johansson,6-4; 6-4,R64,75,17,3,44,63,34,44,11,19,8,8,10,45,63,3,0,45,57,30,45,9,12,4,6,10,39,57
2006-10-16 00:00:00.000,ATP Masters Series Madrid Spain ATP World Tour,HARD,2,Paradorn Srichaphan,Gorka Fraile,Paradorn Srichaphan,6-2; 6-2,R64,55,4,1,25,45,20,25,13,20,0,0,8,33,45,1,0,35,49,20,35,4,14,0,4,8,24,49
2006-10-16 00:00:00.000,ATP Masters Series Madrid Spain ATP World Tour,HARD,2,Fernando Gonzalez,N/A Bye,Fernando Gonzalez,,R64,0,0,0,0,0,0,0,0,0,0,0,0,0,0,0,0,0,0,0,0,0,0,0,0,0,0,0
2006-10-16 00:00:00.000,ATP Masters Series Madrid Spain ATP World Tour,HARD,2,Novak Djokovic,N/A Bye,Novak Djokovic,,R64,0,0,0,0,0,0,0,0,0,0,0,0,0,0,0,0,0,0,0,0,0,0,0,0,0,0,0
2006-10-16 00:00:00.000,ATP Masters Series Madrid Spain ATP World Tour,HARD,2,Richard Gasquet,Jarkko Nieminen,Richard Gasquet,6-2; 6-3,R64,64,5,0,33,54,22,33,16,21,1,1,9,38,54,2,1,33,55,20,33,9,22,3,6,8,29,55
2006-10-16 00:00:00.000,ATP Masters Series Madrid Spain ATP World Tour,HARD,2,Andy Murray,Ivan Navarro,Andy Murray,6-2; 6-4,R64,78,3,2,30,50,26,30,11,20,1,1,9,37,50,5,1,43,67,28,43,9,24,3,6,9,37,67
2006-10-16 00:00:00.000,ATP Masters Series Madrid Spain ATP World Tour,HARD,2,Ivan Ljubicic,N/A Bye,Ivan Ljubicic,,R64,0,0,0,0,0,0,0,0,0,0,0,0,0,0,0,0,0,0,0,0,0,0,0,0,0,0,0
2006-10-16 00:00:00.000,ATP Masters Series Madrid Spain ATP World Tour,HARD,2,Andy Roddick,N/A Bye,Andy Roddick,,R64,0,0,0,0,0,0,0,0,0,0,0,0,0,0,0,0,0,0,0,0,0,0,0,0,0,0,0
2006-10-16 00:00:00.000,ATP Masters Series Madrid Spain ATP World Tour,HARD,2,Sebastien Grosjean,Jonas Bjorkman,Sebastien Grosjean,6-4; 7-5,R64,78,3,0,40,56,33,40,12,16,3,3,11,45,56,3,3,43,61,32,43,9,18,0,2,11,41,61
2006-10-16 00:00:00.000,ATP Masters Series Madrid Spain ATP World Tour,HARD,2,Agustin Calleri,Florent Serra,Agustin Calleri,7-6(3); 6-3,R64,79,13,3,43,60,35,43,5,17,2,4,10,40,60,4,2,48,80,28,48,15,32,2,6,11,43,80
2006-10-16 00:00:00.000,ATP Masters Series Madrid Spain ATP World Tour,HARD,2,Tomas Berdych,N/A Bye,Tomas Berdych,,R64,0,0,0,0,0,0,0,0,0,0,0,0,0,0,0,0,0,0,0,0,0,0,0,0,0,0,0
2006-10-16 00:00:00.000,ATP Masters Series Madrid Spain ATP World Tour,HARD,2,Tommy Haas,N/A Bye,Tommy Haas,,R64,0,0,0,0,0,0,0,0,0,0,0,0,0,0,0,0,0,0,0,0,0,0,0,0,0,0,0
2006-10-16 00:00:00.000,ATP Masters Series Madrid Spain ATP World Tour,HARD,2,Dominik Hrbaty,Gael Monfils,Dominik Hrbaty,3-6; 2-2 RET,R64,52,1,3,22,46,14,22,15,24,1,2,6,29,46,9,2,30,46,22,30,10,16,3,3,7,32,46
2006-10-16 00:00:00.000,ATP Masters Series Madrid Spain ATP World Tour,HARD,2,Mardy Fish,Xavier Malisse,Mardy Fish,5-7; 6-3; 7-5,R64,109,14,4,51,94,43,51,24,43,2,3,17,67,94,16,1,50,78,44,50,15,28,0,2,16,59,78
2006-10-16 00:00:00.000,ATP Masters Series Madrid Spain ATP World Tour,HARD,2,Rafael Nadal,N/A Bye,Rafael Nadal,,R64,0,0,0,0,0,0,0,0,0,0,0,0,0,0,0,0,0,0,0,0,0,0,0,0,0,0,0
2006-10-16 00:00:00.000,ATP Masters Series Madrid Spain ATP World Tour,HARD,2,Roger Federer,Nicolas Massu,Roger Federer,6-3; 6-2,R32,85,7,0,31,57,24,31,16,26,3,3,9,40,57,2,2,34,55,22,34,8,21,3,6,8,30,55
2006-10-16 00:00:00.000,ATP Masters Series Madrid Spain ATP World Tour,HARD,2,Robin Soderling,Juan Carlos Ferrero,Robin Soderling,6-3; 6-2,R32,79,10,4,40,58,34,40,8,18,5,5,9,42,58,3,2,41,64,25,41,8,23,4,7,8,33,64
2006-10-16 00:00:00.000,ATP Masters Series Madrid Spain ATP World Tour,HARD,2,Robby Ginepri,Mario Ancic,Robby Ginepri,7-6(5); 7-6(5),R32,114,6,2,55,89,36,55,23,34,6,8,12,59,89,3,1,47,77,35,47,17,30,4,6,12,52,77
2006-10-16 00:00:00.000,ATP Masters Series Madrid Spain ATP World Tour,HARD,2,Tommy Robredo,Juan Ignacio Chela,Tommy Robredo,7-6(2); 7-6(3),R32,131,8,4,71,101,54,71,10,30,4,6,12,64,101,1,1,69,97,50,69,9,28,8,10,12,59,97
2006-10-16 00:00:00.000,ATP Masters Series Madrid Spain ATP World Tour,HARD,2,David Nalbandian,Julien Benneteau,David Nalbandian,6-7(4); 6-2; 7-5,R32,136,7,4,75,105,52,75,16,30,2,4,16,68,105,8,2,69,97,46,69,13,28,4,9,16,59,97
2006-10-16 00:00:00.000,ATP Masters Series Madrid Spain ATP World Tour,HARD,2,Tim Henman,David Ferrer,Tim Henman,6-1; 4-6; 6-1,R32,105,3,4,45,80,31,45,18,35,5,8,12,49,80,2,1,48,76,24,48,11,28,3,10,12,35,76
2006-10-16 00:00:00.000,ATP Masters Series Madrid Spain ATP World Tour,HARD,2,Marat Safin,Marcos Baghdatis,Marat Safin,6-4; 6-3,R32,76,6,0,35,51,29,35,9,16,2,2,9,38,51,3,7,37,70,29,37,12,33,1,4,10,41,70
2006-10-16 00:00:00.000,ATP Masters Series Madrid Spain ATP World Tour,HARD,2,Kristof Vliegen,James Blake,Kristof Vliegen,6-4; 3-6; 7-6(5),R32,126,8,1,73,104,52,73,15,31,7,11,15,67,104,7,4,57,98,42,57,19,41,6,10,16,61,98
2006-10-16 00:00:00.000,ATP Masters Series Madrid Spain ATP World Tour,HARD,2,Joachim Johansson,Nikolay Davydenko,Joachim Johansson,6-4; 6-7(5); 6-3,R32,111,23,2,69,97,59,69,12,28,3,4,16,71,97,8,6,62,95,49,62,17,33,11,14,15,66,95
2006-10-16 00:00:00.000,ATP Masters Series Madrid Spain ATP World Tour,HARD,2,Fernando Gonzalez,Paradorn Srichaphan,Fernando Gonzalez,7-5; 6-7(5); 6-4,R32,145,10,3,76,118,53,76,24,42,8,10,17,77,118,8,8,70,107,51,70,17,37,4,8,17,68,107
2006-10-16 00:00:00.000,ATP Masters Series Madrid Spain ATP World Tour,HARD,2,Novak Djokovic,Richard Gasquet,Novak Djokovic,7-6(2); 1-6; 6-1,R32,98,9,3,47,72,38,47,13,25,3,6,13,51,72,5,3,51,82,37,51,15,31,2,5,13,52,82
2006-10-16 00:00:00.000,ATP Masters Series Madrid Spain ATP World Tour,HARD,2,Andy Murray,Ivan Ljubicic,Andy Murray,6-4; 3-6; 6-3,R32,133,8,6,37,88,32,37,28,51,5,6,14,60,88,12,7,41,91,37,41,21,50,2,4,14,58,91
2006-10-16 00:00:00.000,ATP Masters Series Madrid Spain ATP World Tour,HARD,2,Andy Roddick,Sebastien Grosjean,Andy Roddick,6-4; 7-6(3),R32,88,9,3,47,68,39,47,11,21,0,0,11,50,68,11,1,52,79,36,52,12,27,3,4,11,48,79
2006-10-16 00:00:00.000,ATP Masters Series Madrid Spain ATP World Tour,HARD,2,Tomas Berdych,Agustin Calleri,Tomas Berdych,7-6(2); 6-3,R32,93,8,2,38,68,28,38,16,30,3,5,10,44,68,8,7,34,77,28,34,14,43,4,8,11,42,77
2006-10-16 00:00:00.000,ATP Masters Series Madrid Spain ATP World Tour,HARD,2,Tommy Haas,Dominik Hrbaty,Tommy Haas,6-3; 7-6(6),R32,94,7,3,43,70,31,43,17,27,8,10,11,48,70,4,2,41,80,28,41,17,39,7,10,10,45,80
2006-10-16 00:00:00.000,ATP Masters Series Madrid Spain ATP World Tour,HARD,2,Rafael Nadal,Mardy Fish,Rafael Nadal,6-4; 6-2,R32,82,3,0,31,48,23,31,14,17,2,2,9,37,48,6,1,29,58,20,29,14,29,7,10,9,34,58
2006-10-16 00:00:00.000,ATP Masters Series Madrid Spain ATP World Tour,HARD,2,Roger Federer,Robin Soderling,Roger Federer,7-6(5); 7-6(8),R16,108,13,0,60,79,51,60,13,19,2,2,12,64,79,8,3,62,102,50,62,19,40,8,8,12,69,102
2006-10-16 00:00:00.000,ATP Masters Series Madrid Spain ATP World Tour,HARD,2,Robby Ginepri,Tommy Robredo,Robby Ginepri,6-3; 7-6(3),R16,90,3,2,43,62,35,43,10,19,0,1,11,45,62,4,2,45,66,27,45,14,21,2,4,10,41,66
2006-10-16 00:00:00.000,ATP Masters Series Madrid Spain ATP World Tour,HARD,2,David Nalbandian,Tim Henman,David Nalbandian,6-2; 2-6; 7-5,R16,100,5,2,57,76,40,57,9,19,3,6,14,49,76,9,2,55,84,35,55,16,29,4,8,14,51,84
2006-10-16 00:00:00.000,ATP Masters Series Madrid Spain ATP World Tour,HARD,2,Marat Safin,Kristof Vliegen,Marat Safin,6-3; 6-2,R16,66,2,0,32,50,23,32,12,18,2,3,9,35,50,2,0,35,59,18,35,13,24,4,8,8,31,59
2006-10-16 00:00:00.000,ATP Masters Series Madrid Spain ATP World Tour,HARD,2,Fernando Gonzalez,Joachim Johansson,Fernando Gonzalez,W/O,R16,0,0,0,0,0,0,0,0,0,0,0,0,0,0,0,0,0,0,0,0,0,0,0,0,0,0,0
2006-10-16 00:00:00.000,ATP Masters Series Madrid Spain ATP World Tour,HARD,2,Novak Djokovic,Andy Murray,Novak Djokovic,1-6; 7-5; 6-3,R16,131,3,3,49,90,35,49,21,41,4,7,14,56,90,5,2,39,86,27,39,27,47,3,6,14,54,86
2006-10-16 00:00:00.000,ATP Masters Series Madrid Spain ATP World Tour,HARD,2,Tomas Berdych,Andy Roddick,Tomas Berdych,7-6(7); 6-3,R16,81,23,2,46,65,41,46,11,19,0,0,11,52,65,12,4,44,63,36,44,11,19,3,4,10,47,63
2006-10-16 00:00:00.000,ATP Masters Series Madrid Spain ATP World Tour,HARD,2,Rafael Nadal,Tommy Haas,Rafael Nadal,6-4; 6-3,R16,87,4,3,30,49,27,30,11,19,1,1,9,38,49,3,3,36,60,25,36,9,24,4,7,10,34,60
2006-10-16 00:00:00.000,ATP Masters Series Madrid Spain ATP World Tour,HARD,2,Roger Federer,Robby Ginepri,Roger Federer,6-3; 7-6(4),Q,82,6,1,49,76,37,49,17,27,1,1,11,54,76,2,0,44,66,34,44,10,22,0,1,10,44,66
2006-10-16 00:00:00.000,ATP Masters Series Madrid Spain ATP World Tour,HARD,2,David Nalbandian,Marat Safin,David Nalbandian,6-4; 6-7(6); 7-6(2),Q,177,3,5,75,124,53,75,30,49,7,10,17,83,124,19,2,74,125,52,74,25,51,9,13,17,77,125
2006-10-16 00:00:00.000,ATP Masters Series Madrid Spain ATP World Tour,HARD,2,Fernando Gonzalez,Novak Djokovic,Fernando Gonzalez,7-5; 5-7; 7-5,Q,141,8,4,55,97,45,55,22,42,2,5,18,67,97,5,3,75,108,52,75,16,33,7,11,18,68,108
2006-10-16 00:00:00.000,ATP Masters Series Madrid Spain ATP World Tour,HARD,2,Tomas Berdych,Rafael Nadal,Tomas Berdych,6-3; 7-6(6),Q,107,9,4,47,78,35,47,17,31,2,2,11,52,78,4,2,43,64,31,43,11,21,0,1,10,42,64
2006-10-16 00:00:00.000,ATP Masters Series Madrid Spain ATP World Tour,HARD,2,Roger Federer,David Nalbandian,Roger Federer,6-4; 6-0,S,59,9,0,27,41,21,27,8,14,0,1,8,29,41,1,2,38,54,21,38,3,16,5,10,8,24,54
2006-10-16 00:00:00.000,ATP Masters Series Madrid Spain ATP World Tour,HARD,2,Fernando Gonzalez,Tomas Berdych,Fernando Gonzalez,6-3; 6-1,S,53,10,1,28,39,25,28,7,11,0,0,8,32,39,4,3,32,47,17,32,6,15,3,7,8,23,47
2006-10-16 00:00:00.000,ATP Masters Series Madrid Spain ATP World Tour,HARD,2,Roger Federer,Fernando Gonzalez,Roger Federer,7-5; 6-1; 6-0,F,108,11,2,45,81,36,45,24,36,2,2,13,60,81,4,0,50,79,26,50,15,29,7,13,12,41,79
2006-10-23 00:00:00.000,Basel Switzerland ATP World Tour,HARD,2,Roger Federer,Tomas Zib,Roger Federer,6-1; 6-2,R32,50,11,0,27,38,24,27,8,11,0,0,8,32,38,0,3,25,47,13,25,9,22,4,8,7,22,47
2006-10-23 00:00:00.000,Basel Switzerland ATP World Tour,HARD,2,Guillermo Garcia-Lopez,Julian Reister,Guillermo Garcia-Lopez,7-6(4); 6-2,R32,77,4,4,36,66,24,36,16,30,6,8,10,40,66,3,1,43,65,25,43,10,22,2,6,10,35,65
2006-10-23 00:00:00.000,Basel Switzerland ATP World Tour,HARD,2,Jiri Novak,Jan Hajek,Jiri Novak,6-7(5); 3-0 RET,R32,70,6,2,31,53,20,31,5,22,1,5,7,25,53,4,2,28,57,12,28,14,29,3,9,8,26,57
2006-10-23 00:00:00.000,Basel Switzerland ATP World Tour,HARD,2,David Ferrer,Marco Chiudinelli,David Ferrer,6-7(1); 6-3; 6-4,R32,134,5,4,69,111,49,69,28,42,6,6,16,77,111,6,4,53,93,42,53,21,40,1,3,15,63,93
2006-10-23 00:00:00.000,Basel Switzerland ATP World Tour,HARD,2,Juan Ignacio Chela,Filippo Volandri,Juan Ignacio Chela,6-4; 7-5,R32,72,2,0,41,66,28,41,18,25,3,4,11,46,66,1,2,28,55,17,28,20,27,3,6,11,37,55
2006-10-23 00:00:00.000,Basel Switzerland ATP World Tour,HARD,2,Paradorn Srichaphan,Benjamin Becker,Paradorn Srichaphan,7-6(4); 7-6(4),R32,88,12,5,52,82,40,52,17,30,3,4,12,57,82,17,2,49,76,41,49,11,27,1,2,12,52,76
2006-10-23 00:00:00.000,Basel Switzerland ATP World Tour,HARD,2,Philipp Kohlschreiber,Nicolas Thomann,Philipp Kohlschreiber,6-1; 7-5,R32,84,8,3,39,69,23,39,21,30,8,9,10,44,69,5,0,31,60,21,31,14,29,5,9,9,35,60
2006-10-23 00:00:00.000,Basel Switzerland ATP World Tour,HARD,2,Jose Acasuso,Albert Montanes,Jose Acasuso,6-4; 6-3,R32,61,7,0,23,46,18,23,18,23,0,0,9,36,46,5,3,29,60,23,29,13,31,1,4,10,36,60
2006-10-23 00:00:00.000,Basel Switzerland ATP World Tour,HARD,2,Juan Martin Del Potro,Tobias Clemens,Juan Martin Del Potro,3-6; 6-3; 6-2,R32,103,4,1,56,77,43,56,10,21,1,3,13,53,77,6,3,46,82,33,46,16,36,6,10,13,49,82
2006-10-23 00:00:00.000,Basel Switzerland ATP World Tour,HARD,2,George Bastl,Lars Burgsmuller,George Bastl,6-1; 6-4,R32,80,9,3,44,61,34,44,7,17,3,3,9,41,61,0,2,28,53,16,28,13,25,1,4,8,29,53
2006-10-23 00:00:00.000,Basel Switzerland ATP World Tour,HARD,2,Mardy Fish,Jiri Vanek,Mardy Fish,6-4; 6-3,R32,56,13,0,26,50,26,26,16,24,1,1,10,42,50,1,4,24,50,19,24,11,26,1,3,9,30,50
2006-10-23 00:00:00.000,Basel Switzerland ATP World Tour,HARD,2,Fernando Gonzalez,Simone Bolelli,Fernando Gonzalez,7-6(3); 6-7(2); 7-6(3),R32,141,22,2,80,120,63,80,22,40,3,4,18,85,120,10,1,79,119,66,79,20,40,4,5,18,86,119
2006-10-23 00:00:00.000,Basel Switzerland ATP World Tour,HARD,2,Stanislas Wawrinka,Agustin Calleri,Stanislas Wawrinka,7-6(6); 6-2,R32,78,7,0,27,55,23,27,19,28,0,1,10,42,55,8,1,33,62,25,33,13,29,2,5,10,38,62
2006-10-23 00:00:00.000,Basel Switzerland ATP World Tour,HARD,2,Tim Henman,Christophe Rochus,Tim Henman,6-2; 6-3,R32,72,11,1,23,43,22,23,12,20,0,1,9,34,43,0,3,38,64,24,38,9,26,5,9,8,33,64
2006-10-23 00:00:00.000,Basel Switzerland ATP World Tour,HARD,2,Feliciano Lopez,Ruben Ramirez Hidalgo,Feliciano Lopez,3-6; 7-6(5); 6-1,R32,106,7,4,43,74,34,43,18,31,0,2,13,52,74,3,7,48,98,32,48,27,50,7,11,15,59,98
2006-10-23 00:00:00.000,Basel Switzerland ATP World Tour,HARD,2,David Nalbandian,Roko Karanusic,David Nalbandian,6-2; 6-4,R32,64,6,3,37,59,27,37,12,22,3,4,9,39,59,6,1,38,57,22,38,7,19,2,6,9,29,57
2006-10-23 00:00:00.000,Basel Switzerland ATP World Tour,HARD,2,Roger Federer,Guillermo Garcia-Lopez,Roger Federer,6-2; 6-0,R16,53,4,1,21,37,18,21,10,16,0,0,7,28,37,2,4,30,55,16,30,8,25,6,11,7,24,55
2006-10-23 00:00:00.000,Basel Switzerland ATP World Tour,HARD,2,David Ferrer,Jiri Novak,David Ferrer,2-6; 6-3; 6-3,R16,102,4,3,44,73,34,44,13,29,0,3,13,47,73,4,2,55,84,33,55,16,29,5,9,13,49,84
2006-10-23 00:00:00.000,Basel Switzerland ATP World Tour,HARD,2,Paradorn Srichaphan,Juan Ignacio Chela,Paradorn Srichaphan,6-4; 6-3,R16,77,7,3,25,56,19,25,23,31,2,2,10,42,56,1,4,49,77,32,49,13,28,8,10,9,45,77
2006-10-23 00:00:00.000,Basel Switzerland ATP World Tour,HARD,2,Jose Acasuso,Philipp Kohlschreiber,Jose Acasuso,7-6(2); 6-1,R16,81,7,2,30,63,28,30,19,33,4,4,10,47,63,5,1,31,59,26,31,12,28,3,5,9,38,59
2006-10-23 00:00:00.000,Basel Switzerland ATP World Tour,HARD,2,Juan Martin Del Potro,George Bastl,Juan Martin Del Potro,6-3; 6-2,R16,77,2,4,31,53,25,31,12,22,3,3,8,37,53,4,2,33,53,18,33,9,20,3,7,9,27,53
2006-10-23 00:00:00.000,Basel Switzerland ATP World Tour,HARD,2,Fernando Gonzalez,Mardy Fish,Fernando Gonzalez,6-7(5); 6-4; 7-6(8),R16,157,8,5,81,125,62,81,24,44,5,7,17,86,125,13,3,69,125,52,69,30,56,8,11,17,82,125
2006-10-23 00:00:00.000,Basel Switzerland ATP World Tour,HARD,2,Stanislas Wawrinka,Tim Henman,Stanislas Wawrinka,2-6; 7-6(4); 6-4,R16,135,9,2,57,92,40,57,22,35,3,6,15,62,92,15,5,58,99,43,58,21,41,3,5,15,64,99
2006-10-23 00:00:00.000,Basel Switzerland ATP World Tour,HARD,2,David Nalbandian,Feliciano Lopez,David Nalbandian,6-7(4); 6-3; 7-6(7),R16,141,7,2,62,108,46,62,30,46,1,2,16,76,108,20,6,70,113,53,70,21,43,4,7,17,74,113
2006-10-23 00:00:00.000,Basel Switzerland ATP World Tour,HARD,2,Roger Federer,David Ferrer,Roger Federer,6-3; 7-6(14),Q,87,2,1,41,67,31,41,17,26,0,2,11,48,67,3,5,40,68,28,40,13,28,1,4,10,41,68
2006-10-23 00:00:00.000,Basel Switzerland ATP World Tour,HARD,2,Paradorn Srichaphan,Jose Acasuso,Paradorn Srichaphan,7-6(2); 6-3,Q,87,7,1,28,62,25,28,24,34,1,1,10,49,62,8,1,39,71,27,39,18,32,3,5,11,45,71
2006-10-23 00:00:00.000,Basel Switzerland ATP World Tour,HARD,2,Fernando Gonzalez,Juan Martin Del Potro,Fernando Gonzalez,5-7; 6-4; 6-4,Q,133,10,2,61,102,48,61,20,41,4,6,16,68,102,4,4,69,97,47,69,17,28,8,11,16,64,97
2006-10-23 00:00:00.000,Basel Switzerland ATP World Tour,HARD,2,Stanislas Wawrinka,David Nalbandian,Stanislas Wawrinka,7-6(7); 6-2,Q,92,13,1,31,60,28,31,18,29,0,0,10,46,60,2,2,54,79,37,54,11,25,7,9,10,48,79
2006-10-23 00:00:00.000,Basel Switzerland ATP World Tour,HARD,2,Roger Federer,Paradorn Srichaphan,Roger Federer,6-4; 3-6; 7-6(5),S,118,8,0,60,83,48,60,16,23,0,1,15,64,83,6,3,58,110,46,58,29,52,6,7,16,75,110
2006-10-23 00:00:00.000,Basel Switzerland ATP World Tour,HARD,2,Fernando Gonzalez,Stanislas Wawrinka,Fernando Gonzalez,6-4; 6-4,S,79,4,0,40,58,32,40,10,18,3,3,10,42,58,2,2,31,57,22,31,15,26,4,6,10,37,57
2006-10-23 00:00:00.000,Basel Switzerland ATP World Tour,HARD,2,Roger Federer,Fernando Gonzalez,Roger Federer,6-3; 6-2; 7-6(3),F,119,14,1,67,86,56,67,13,19,2,2,15,69,86,6,5,67,121,49,67,21,54,8,11,14,70,121
2006-10-23 00:00:00.000,Lyon France ATP World Tour,HARD,2,Arnaud Clement,Marcos Baghdatis,Arnaud Clement,6-2; 5-7; 6-3,R32,124,8,1,49,80,34,49,19,31,4,8,15,53,80,7,11,48,100,36,48,16,52,4,10,14,52,100
2006-10-23 00:00:00.000,Lyon France ATP World Tour,HARD,2,Michael Llodra,Michal Mertinak,Michael Llodra,4-6; 7-6(4); 6-2,R32,129,13,1,68,100,57,68,13,32,4,5,15,70,100,9,1,65,98,42,65,23,33,4,6,15,65,98
2006-10-23 00:00:00.000,Lyon France ATP World Tour,HARD,2,Florian Mayer,Nicolas Mahut,Florian Mayer,7-6(5); 6-3,R32,84,12,0,42,72,33,42,18,30,0,0,11,51,72,11,4,40,63,30,40,12,23,1,2,10,42,63
2006-10-23 00:00:00.000,Lyon France ATP World Tour,HARD,2,Nicolas Almagro,Oliver Marach,Nicolas Almagro,2-6; 7-5; 6-1,R32,107,15,6,49,101,42,49,21,52,6,9,14,63,101,3,3,40,78,24,40,20,38,6,10,13,44,78
2006-10-23 00:00:00.000,Lyon France ATP World Tour,HARD,2,Richard Gasquet,Marat Safin,Richard Gasquet,6-4; 7-6(5),R32,102,8,5,53,79,44,53,13,26,2,2,11,57,79,11,2,55,88,43,55,15,33,7,8,11,58,88
2006-10-23 00:00:00.000,Lyon France ATP World Tour,HARD,2,Dick Norman,Olivier Patience,Dick Norman,6-4; 7-5,R32,91,15,5,40,66,34,40,13,26,3,3,11,47,66,6,0,51,73,33,51,12,22,4,6,11,45,73
2006-10-23 00:00:00.000,Lyon France ATP World Tour,HARD,2,Nicolas Massu,Kevin Kim,Nicolas Massu,7-6(6); 7-5,R32,108,7,1,42,72,34,42,19,30,0,0,12,53,72,3,3,45,89,30,45,28,44,4,5,12,58,89
2006-10-23 00:00:00.000,Lyon France ATP World Tour,HARD,2,Robin Soderling,Thierry Ascione,Robin Soderling,6-3; 6-1,R32,65,7,1,27,44,24,27,10,17,4,4,8,34,44,5,2,38,65,22,38,11,27,9,13,8,33,65
2006-10-23 00:00:00.000,Lyon France ATP World Tour,HARD,2,Sebastien Grosjean,Paul-Henri Mathieu,Sebastien Grosjean,6-3; 7-6(3),R32,99,6,3,41,76,34,41,18,35,3,4,11,52,76,2,1,33,63,25,33,17,30,6,8,10,42,63
2006-10-23 00:00:00.000,Lyon France ATP World Tour,HARD,2,Cyril Saulnier,Alejandro Falla,Cyril Saulnier,6-7(9); 6-3; 6-2,R32,132,7,4,73,108,54,73,17,35,10,11,14,71,108,1,3,59,101,34,59,22,42,3,8,15,56,101
2006-10-23 00:00:00.000,Lyon France ATP World Tour,HARD,2,Marc Gicquel,Andreas Seppi,Marc Gicquel,6-4; 6-3,R32,76,7,0,34,56,27,34,10,22,3,5,9,37,56,1,6,30,65,20,30,12,35,6,11,10,32,65
2006-10-23 00:00:00.000,Lyon France ATP World Tour,HARD,2,Dominik Hrbaty,Florent Serra,Dominik Hrbaty,3-6; 6-3; 6-3,R32,102,8,7,50,92,40,50,16,42,4,6,13,56,92,7,1,56,88,36,56,15,32,7,11,14,51,88
2006-10-23 00:00:00.000,Lyon France ATP World Tour,HARD,2,Xavier Malisse,Vincent Spadea,Xavier Malisse,6-3; 4-6; 6-1,R32,122,10,2,50,87,37,50,16,37,4,7,13,53,87,2,3,64,106,36,64,19,42,14,20,13,55,106
2006-10-23 00:00:00.000,Lyon France ATP World Tour,HARD,2,Julien Benneteau,Julien Mathieu,Julien Benneteau,7-5; 6-4,R32,96,9,2,45,67,30,45,13,22,2,3,11,43,67,6,1,64,94,42,64,11,30,9,12,11,53,94
2006-10-23 00:00:00.000,Lyon France ATP World Tour,HARD,2,Robby Ginepri,Gilles Simon,Robby Ginepri,7-6(3); 7-6(5),R32,103,6,4,70,93,49,70,10,23,7,10,12,59,93,7,3,39,80,28,39,21,41,2,5,12,49,80
2006-10-23 00:00:00.000,Lyon France ATP World Tour,HARD,2,Simon Greul,Gaston Gaudio,Simon Greul,6-0; 6-2,R32,55,6,2,22,41,19,22,12,19,1,1,7,31,41,2,5,26,49,15,26,7,23,5,10,7,22,49
2006-10-23 00:00:00.000,Lyon France ATP World Tour,HARD,2,Arnaud Clement,Michael Llodra,Arnaud Clement,2-6; 6-1; 7-6(2),R16,112,8,0,60,87,44,60,15,27,4,6,13,59,87,15,0,58,81,43,58,8,23,0,3,14,51,81
2006-10-23 00:00:00.000,Lyon France ATP World Tour,HARD,2,Nicolas Almagro,Florian Mayer,Nicolas Almagro,7-6(5); 6-4,R16,74,11,2,42,77,34,42,22,35,5,5,11,56,77,3,2,47,68,31,47,15,21,0,1,11,46,68
2006-10-23 00:00:00.000,Lyon France ATP World Tour,HARD,2,Richard Gasquet,Dick Norman,Richard Gasquet,6-3; 6-4,R16,87,6,2,36,62,32,36,13,26,4,4,10,45,62,12,3,42,74,31,42,13,32,6,8,9,44,74
2006-10-23 00:00:00.000,Lyon France ATP World Tour,HARD,2,Robin Soderling,Nicolas Massu,Robin Soderling,7-5; 6-3,R16,112,10,3,42,65,36,42,11,23,3,3,11,47,65,7,3,42,81,29,42,18,39,7,9,10,47,81
2006-10-23 00:00:00.000,Lyon France ATP World Tour,HARD,2,Sebastien Grosjean,Cyril Saulnier,Sebastien Grosjean,7-6(5); 6-2,R16,97,15,1,39,68,33,39,15,29,5,6,10,48,68,3,0,51,77,36,51,9,26,5,8,10,45,77
2006-10-23 00:00:00.000,Lyon France ATP World Tour,HARD,2,Marc Gicquel,Dominik Hrbaty,Marc Gicquel,6-3; 6-3,R16,76,10,1,32,47,26,32,11,15,0,0,9,37,47,2,4,36,63,24,36,11,27,4,7,9,35,63
2006-10-23 00:00:00.000,Lyon France ATP World Tour,HARD,2,Xavier Malisse,Julien Benneteau,Xavier Malisse,6-2; 7-6(5),R16,100,7,2,55,82,38,55,17,27,8,9,10,55,82,4,3,40,62,26,40,11,22,3,6,10,37,62
2006-10-23 00:00:00.000,Lyon France ATP World Tour,HARD,2,Robby Ginepri,Simon Greul,Robby Ginepri,6-1; 6-2,R16,56,6,0,34,43,25,34,7,9,0,0,8,32,43,1,1,28,60,16,28,13,32,4,8,7,29,60
2006-10-23 00:00:00.000,Lyon France ATP World Tour,HARD,2,Arnaud Clement,Nicolas Almagro,Arnaud Clement,6-3; 6-2,Q,58,10,0,34,49,31,34,7,15,2,2,9,38,49,6,2,29,48,23,29,5,19,1,4,8,28,48
2006-10-23 00:00:00.000,Lyon France ATP World Tour,HARD,2,Richard Gasquet,Robin Soderling,Richard Gasquet,4-6; 6-3; 6-3,Q,111,12,1,63,90,45,63,11,27,5,8,14,56,90,11,4,66,93,44,66,10,27,9,14,14,54,93
2006-10-23 00:00:00.000,Lyon France ATP World Tour,HARD,2,Marc Gicquel,Sebastien Grosjean,Marc Gicquel,7-5; 1-6; 7-6(5),Q,128,10,2,52,90,41,52,17,38,3,6,15,58,90,12,4,57,100,45,57,21,43,5,7,16,66,100
2006-10-23 00:00:00.000,Lyon France ATP World Tour,HARD,2,Xavier Malisse,Robby Ginepri,Xavier Malisse,6-4; 6-3,Q,80,6,2,36,54,28,36,8,18,2,3,9,36,54,4,0,47,65,28,47,5,18,5,9,10,33,65
2006-10-23 00:00:00.000,Lyon France ATP World Tour,HARD,2,Richard Gasquet,Arnaud Clement,Richard Gasquet,6-7(6); 6-4; 6-1,S,139,12,1,73,114,54,73,22,41,5,5,15,76,114,7,2,50,80,40,50,14,30,2,5,14,54,80
2006-10-23 00:00:00.000,Lyon France ATP World Tour,HARD,2,Marc Gicquel,Xavier Malisse,Marc Gicquel,6-4; 1-6; 7-6(5),S,146,9,0,69,104,40,69,22,35,11,15,14,62,104,10,3,69,115,46,69,26,46,8,11,15,72,115
2006-10-23 00:00:00.000,Lyon France ATP World Tour,HARD,2,Richard Gasquet,Marc Gicquel,Richard Gasquet,6-3; 6-1,F,72,6,0,30,39,27,30,6,9,1,1,8,33,39,2,0,33,63,19,33,14,30,6,10,8,33,63
2006-10-23 00:00:00.000,St. Petersburg Russia ATP World Tour,HARD,2,Nikolay Davydenko,Fabrice Santoro,Nikolay Davydenko,6-3; 6-1,R32,61,3,2,32,48,24,32,10,16,0,0,8,34,48,3,3,30,50,14,30,10,20,4,8,8,24,50
2006-10-23 00:00:00.000,St. Petersburg Russia ATP World Tour,HARD,2,Wesley Moodie,Teymuraz Gabashvili,Wesley Moodie,2-6; 7-5; 6-3,R32,101,10,3,56,76,40,56,12,20,2,5,15,52,76,7,5,44,84,34,44,19,40,5,8,14,53,84
2006-10-23 00:00:00.000,St. Petersburg Russia ATP World Tour,HARD,2,Thomas Johansson,Frank Dancevic,Thomas Johansson,6-0; 6-7(3); 6-3,R32,96,12,2,40,70,32,40,19,30,2,4,13,51,70,5,3,60,99,42,60,12,39,10,17,14,54,99
2006-10-23 00:00:00.000,St. Petersburg Russia ATP World Tour,HARD,2,Mikhail Youzhny,Rainer Schuettler,Mikhail Youzhny,7-6(6); 6-4,R32,99,8,0,47,77,33,47,19,30,5,6,11,52,77,2,1,41,68,27,41,17,27,0,2,11,44,68
2006-10-23 00:00:00.000,St. Petersburg Russia ATP World Tour,HARD,2,Tommy Haas,Nenad Zimonjic,Tommy Haas,6-2; 6-7(6); 6-2,R32,129,7,3,61,93,48,61,16,32,2,2,14,64,93,11,4,52,108,35,52,27,56,6,10,14,62,108
2006-10-23 00:00:00.000,St. Petersburg Russia ATP World Tour,HARD,2,Igor Kunitsyn,Bjorn Phau,Igor Kunitsyn,7-6(6); 6-3,R32,95,2,2,41,88,26,41,31,47,7,8,11,57,88,5,2,30,60,22,30,15,30,1,3,10,37,60
2006-10-23 00:00:00.000,St. Petersburg Russia ATP World Tour,HARD,2,Potito Starace,Daniele Bracciali,Potito Starace,6-3; 6-3,R32,68,3,0,39,58,29,39,11,19,5,5,9,40,58,6,4,25,51,20,25,11,26,2,5,9,31,51
2006-10-23 00:00:00.000,St. Petersburg Russia ATP World Tour,HARD,2,Jarkko Nieminen,Janko Tipsarevic,Jarkko Nieminen,7-5; 6-2,R32,87,8,0,36,61,26,36,16,25,4,5,10,42,61,4,0,47,78,30,47,13,31,4,8,10,43,78
2006-10-23 00:00:00.000,St. Petersburg Russia ATP World Tour,HARD,2,Max Mirnyi,Dmitry Tursunov,Max Mirnyi,4-6; 6-3; 6-4,R32,118,16,4,56,94,45,56,16,38,4,6,15,61,94,7,11,46,88,35,46,20,42,4,7,14,55,88
2006-10-23 00:00:00.000,St. Petersburg Russia ATP World Tour,HARD,2,Andrei Pavel,Marin Cilic,Andrei Pavel,6-4; 7-5,R32,96,3,1,44,61,33,44,11,17,3,4,11,44,61,4,0,44,89,31,44,22,45,16,19,11,53,89
2006-10-23 00:00:00.000,St. Petersburg Russia ATP World Tour,HARD,2,Raemon Sluiter,Lukasz Kubot,Raemon Sluiter,6-4; 3-6; 6-3,R32,103,18,2,48,83,38,48,18,35,3,6,14,56,83,1,3,48,77,29,48,17,29,2,6,14,46,77
2006-10-23 00:00:00.000,St. Petersburg Russia ATP World Tour,HARD,2,Mario Ancic,Paul Goldstein,Mario Ancic,7-5; 6-1,R32,72,10,1,27,49,23,27,16,22,1,2,10,39,49,0,0,28,49,18,28,11,21,6,10,9,29,49
2006-10-23 00:00:00.000,St. Petersburg Russia ATP World Tour,HARD,2,Lukas Dlouhy,Jurgen Melzer,Lukas Dlouhy,3-6; 6-4; 6-3,R32,93,6,3,50,94,36,50,23,44,5,8,14,59,94,6,3,55,87,37,55,14,32,3,7,14,51,87
2006-10-23 00:00:00.000,St. Petersburg Russia ATP World Tour,HARD,2,Ernests Gulbis,Robin Vik,Ernests Gulbis,6-4; 3-6; 7-6(4),R32,131,11,3,63,102,49,63,16,39,9,12,15,65,102,2,3,71,109,51,71,19,38,5,8,16,70,109
2006-10-23 00:00:00.000,St. Petersburg Russia ATP World Tour,HARD,2,Jan Hernych,Evgeny Korolev,Jan Hernych,6-7(5); 6-4; 7-6(7),R32,140,5,1,72,116,55,72,21,44,5,7,17,76,116,5,1,75,111,58,75,16,36,0,3,17,74,111
2006-10-23 00:00:00.000,St. Petersburg Russia ATP World Tour,HARD,2,Wayne Arthurs,Tommy Robredo,Wayne Arthurs,6-3; 2-6; 6-4,R32,89,11,1,45,71,36,45,12,26,5,9,14,48,71,3,3,51,71,32,51,12,20,3,7,13,44,71
2006-10-23 00:00:00.000,St. Petersburg Russia ATP World Tour,HARD,2,Wesley Moodie,Nikolay Davydenko,Wesley Moodie,2-6; 3-3 RET,R16,52,4,0,24,34,17,24,5,10,0,2,7,22,34,1,0,20,34,16,20,12,14,0,0,7,28,34
2006-10-23 00:00:00.000,St. Petersburg Russia ATP World Tour,HARD,2,Thomas Johansson,Mikhail Youzhny,Thomas Johansson,W/O,R16,0,0,0,0,0,0,0,0,0,0,0,0,0,0,0,0,0,0,0,0,0,0,0,0,0,0,0
2006-10-23 00:00:00.000,St. Petersburg Russia ATP World Tour,HARD,2,Igor Kunitsyn,Tommy Haas,Igor Kunitsyn,7-6(4); 4-6; 6-2,R16,122,2,0,51,88,34,51,21,37,2,6,15,55,88,13,9,58,97,37,58,19,39,0,5,15,56,97
2006-10-23 00:00:00.000,St. Petersburg Russia ATP World Tour,HARD,2,Potito Starace,Jarkko Nieminen,Potito Starace,7-5; 3-2 RET,R16,57,8,0,32,52,26,32,11,20,2,3,9,37,52,5,1,25,45,20,25,9,20,1,3,8,29,45
2006-10-23 00:00:00.000,St. Petersburg Russia ATP World Tour,HARD,2,Max Mirnyi,Andrei Pavel,Max Mirnyi,6-3; 7-5,R16,86,16,2,38,58,30,38,15,20,0,0,11,45,58,2,2,52,73,33,52,11,21,3,5,10,44,73
2006-10-23 00:00:00.000,St. Petersburg Russia ATP World Tour,HARD,2,Mario Ancic,Raemon Sluiter,Mario Ancic,6-3; 6-4,R16,65,9,2,28,48,24,28,13,20,1,2,10,37,48,3,3,27,47,19,27,10,20,2,5,9,29,47
2006-10-23 00:00:00.000,St. Petersburg Russia ATP World Tour,HARD,2,Ernests Gulbis,Lukas Dlouhy,Ernests Gulbis,5-7; 6-3; 6-3,R16,103,8,4,52,91,43,52,19,39,3,4,15,62,91,3,5,48,78,34,48,16,30,0,3,15,50,78
2006-10-23 00:00:00.000,St. Petersburg Russia ATP World Tour,HARD,2,Jan Hernych,Wayne Arthurs,Jan Hernych,6-4; 6-4,R16,82,2,1,33,56,25,33,19,23,1,1,10,44,56,10,6,40,69,26,40,16,29,4,6,10,42,69
2006-10-23 00:00:00.000,St. Petersburg Russia ATP World Tour,HARD,2,Thomas Johansson,Wesley Moodie,Thomas Johansson,6-3; 3-6; 6-3,Q,102,7,2,46,74,37,46,19,28,1,2,14,56,74,7,2,55,81,42,55,13,26,2,4,13,55,81
2006-10-23 00:00:00.000,St. Petersburg Russia ATP World Tour,HARD,2,Igor Kunitsyn,Potito Starace,Igor Kunitsyn,6-3; 6-2,Q,68,0,1,28,50,24,28,12,22,4,5,9,36,50,5,3,31,52,18,31,8,21,8,12,8,26,52
2006-10-23 00:00:00.000,St. Petersburg Russia ATP World Tour,HARD,2,Mario Ancic,Max Mirnyi,Mario Ancic,6-4; 7-5,Q,93,3,1,43,68,33,43,17,25,2,2,11,50,68,2,1,31,55,23,31,15,24,1,3,11,38,55
2006-10-23 00:00:00.000,St. Petersburg Russia ATP World Tour,HARD,2,Ernests Gulbis,Jan Hernych,Ernests Gulbis,7-6(6); 6-7(4); 6-2,Q,139,9,0,69,106,53,69,21,37,7,8,16,74,106,2,2,83,116,57,83,18,33,6,9,16,75,116
2006-10-23 00:00:00.000,St. Petersburg Russia ATP World Tour,HARD,2,Thomas Johansson,Igor Kunitsyn,Thomas Johansson,6-3; 7-6(3),S,101,8,3,43,83,37,43,16,40,5,7,11,53,83,3,1,38,70,26,38,14,32,0,3,10,40,70
2006-10-23 00:00:00.000,St. Petersburg Russia ATP World Tour,HARD,2,Mario Ancic,Ernests Gulbis,Mario Ancic,6-2; 6-3,S,93,5,3,41,65,31,41,12,24,6,6,9,43,65,4,1,32,45,20,32,4,13,4,7,8,24,45
2006-10-23 00:00:00.000,St. Petersburg Russia ATP World Tour,HARD,2,Mario Ancic,Thomas Johansson,Mario Ancic,7-5; 7-6(2),F,106,5,0,40,61,34,40,14,21,0,1,12,48,61,8,1,43,80,26,43,23,37,0,2,12,49,80
2006-10-30 00:00:00.000,ATP Masters Series Paris France ATP World Tour,HARD,2,Teymuraz Gabashvili,N/A Bye,Teymuraz Gabashvili,,R64,0,0,0,0,0,0,0,0,0,0,0,0,0,0,0,0,0,0,0,0,0,0,0,0,0,0,0
2006-10-30 00:00:00.000,ATP Masters Series Paris France ATP World Tour,HARD,2,Thomas Johansson,Vincent Spadea,Thomas Johansson,7-6(4); 7-6(1),R64,95,11,1,48,86,38,48,22,38,5,6,12,60,86,6,4,39,74,31,39,19,35,0,1,12,50,74
2006-10-30 00:00:00.000,ATP Masters Series Paris France ATP World Tour,HARD,2,Daniele Bracciali,Gilles Simon,Daniele Bracciali,6-3; 6-4,R64,77,3,0,29,50,24,29,10,21,2,3,9,34,50,2,2,30,64,19,30,17,34,5,9,10,36,64
2006-10-30 00:00:00.000,ATP Masters Series Paris France ATP World Tour,HARD,2,Jarkko Nieminen,N/A Bye,Jarkko Nieminen,,R64,0,0,0,0,0,0,0,0,0,0,0,0,0,0,0,0,0,0,0,0,0,0,0,0,0,0,0
2006-10-30 00:00:00.000,ATP Masters Series Paris France ATP World Tour,HARD,2,Novak Djokovic,N/A Bye,Novak Djokovic,,R64,0,0,0,0,0,0,0,0,0,0,0,0,0,0,0,0,0,0,0,0,0,0,0,0,0,0,0
2006-10-30 00:00:00.000,ATP Masters Series Paris France ATP World Tour,HARD,2,Paul-Henri Mathieu,Andreas Seppi,Paul-Henri Mathieu,6-2; 6-4,R64,76,8,3,24,50,20,24,14,26,0,2,9,34,50,1,1,33,54,16,33,11,21,5,10,9,27,54
2006-10-30 00:00:00.000,ATP Masters Series Paris France ATP World Tour,HARD,2,Sebastien Grosjean,Xavier Malisse,Sebastien Grosjean,6-1; 7-6(7),R64,85,6,0,31,64,24,31,21,33,1,3,10,45,64,2,0,34,62,20,34,17,28,5,9,9,37,62
2006-10-30 00:00:00.000,ATP Masters Series Paris France ATP World Tour,HARD,2,Tommy Robredo,N/A Bye,Tommy Robredo,,R64,0,0,0,0,0,0,0,0,0,0,0,0,0,0,0,0,0,0,0,0,0,0,0,0,0,0,0
2006-10-30 00:00:00.000,ATP Masters Series Paris France ATP World Tour,HARD,2,Nikolay Davydenko,N/A Bye,Nikolay Davydenko,,R64,0,0,0,0,0,0,0,0,0,0,0,0,0,0,0,0,0,0,0,0,0,0,0,0,0,0,0
2006-10-30 00:00:00.000,ATP Masters Series Paris France ATP World Tour,HARD,2,Christophe Rochus,Jose Acasuso,Christophe Rochus,4-6; 7-6(4); 6-4,R64,136,4,4,60,97,46,60,20,37,2,4,16,66,97,18,2,71,117,51,71,22,46,11,13,16,73,117
2006-10-30 00:00:00.000,ATP Masters Series Paris France ATP World Tour,HARD,2,Nicolas Almagro,Jonas Bjorkman,Nicolas Almagro,6-7(4); 7-6(7); 7-6(2),R64,186,14,4,77,137,63,77,28,60,4,5,18,91,137,12,1,75,131,56,75,29,56,1,2,18,85,131
2006-10-30 00:00:00.000,ATP Masters Series Paris France ATP World Tour,HARD,2,Dmitry Tursunov,N/A Bye,Dmitry Tursunov,,R64,0,0,0,0,0,0,0,0,0,0,0,0,0,0,0,0,0,0,0,0,0,0,0,0,0,0,0
2006-10-30 00:00:00.000,ATP Masters Series Paris France ATP World Tour,HARD,2,Mario Ancic,N/A Bye,Mario Ancic,,R64,0,0,0,0,0,0,0,0,0,0,0,0,0,0,0,0,0,0,0,0,0,0,0,0,0,0,0
2006-10-30 00:00:00.000,ATP Masters Series Paris France ATP World Tour,HARD,2,Kristof Vliegen,Florent Serra,Kristof Vliegen,3-6; 6-3; 7-6(4),R64,118,15,4,64,90,47,64,15,26,2,4,15,62,90,3,3,58,98,37,58,24,40,2,4,15,61,98
2006-10-30 00:00:00.000,ATP Masters Series Paris France ATP World Tour,HARD,2,Julien Benneteau,Fabrice Santoro,Julien Benneteau,5-7; 6-3; 7-6(5),R64,164,8,5,81,124,54,81,22,43,9,13,16,76,124,7,5,60,114,42,60,26,54,9,14,17,68,114
2006-10-30 00:00:00.000,ATP Masters Series Paris France ATP World Tour,HARD,2,Fernando Gonzalez,N/A Bye,Fernando Gonzalez,,R64,0,0,0,0,0,0,0,0,0,0,0,0,0,0,0,0,0,0,0,0,0,0,0,0,0,0,0
2006-10-30 00:00:00.000,ATP Masters Series Paris France ATP World Tour,HARD,2,Tomas Berdych,N/A Bye,Tomas Berdych,,R64,0,0,0,0,0,0,0,0,0,0,0,0,0,0,0,0,0,0,0,0,0,0,0,0,0,0,0
2006-10-30 00:00:00.000,ATP Masters Series Paris France ATP World Tour,HARD,2,Olivier Rochus,Janko Tipsarevic,Olivier Rochus,6-4; 7-5,R64,92,5,4,50,74,38,50,10,24,2,3,11,48,74,12,2,38,68,31,38,10,30,2,5,11,41,68
2006-10-30 00:00:00.000,ATP Masters Series Paris France ATP World Tour,HARD,2,Robby Ginepri,Max Mirnyi,Robby Ginepri,6-4; 5-7; 6-2,R64,102,5,2,57,93,38,57,26,36,4,5,15,64,93,14,0,52,75,42,52,10,23,3,6,15,52,75
2006-10-30 00:00:00.000,ATP Masters Series Paris France ATP World Tour,HARD,2,David Ferrer,N/A Bye,David Ferrer,,R64,0,0,0,0,0,0,0,0,0,0,0,0,0,0,0,0,0,0,0,0,0,0,0,0,0,0,0
2006-10-30 00:00:00.000,ATP Masters Series Paris France ATP World Tour,HARD,2,Andy Murray,N/A Bye,Andy Murray,,R64,0,0,0,0,0,0,0,0,0,0,0,0,0,0,0,0,0,0,0,0,0,0,0,0,0,0,0
2006-10-30 00:00:00.000,ATP Masters Series Paris France ATP World Tour,HARD,2,Juan Ignacio Chela,Paradorn Srichaphan,Juan Ignacio Chela,6-3; 3-0 RET,R64,42,1,2,22,34,17,22,8,12,2,2,6,25,34,2,4,20,37,14,20,6,17,3,6,6,20,37
2006-10-30 00:00:00.000,ATP Masters Series Paris France ATP World Tour,HARD,2,Igor Andreev,Gael Monfils,Igor Andreev,7-5; 6-4,R64,80,0,2,50,69,38,50,9,19,5,6,11,47,69,6,6,44,77,31,44,15,33,5,8,11,46,77
2006-10-30 00:00:00.000,ATP Masters Series Paris France ATP World Tour,HARD,2,Dominik Hrbaty,N/A Bye,Dominik Hrbaty,,R64,0,0,0,0,0,0,0,0,0,0,0,0,0,0,0,0,0,0,0,0,0,0,0,0,0,0,0
2006-10-30 00:00:00.000,ATP Masters Series Paris France ATP World Tour,HARD,2,James Blake,N/A Bye,James Blake,,R64,0,0,0,0,0,0,0,0,0,0,0,0,0,0,0,0,0,0,0,0,0,0,0,0,0,0,0
2006-10-30 00:00:00.000,ATP Masters Series Paris France ATP World Tour,HARD,2,Arnaud Clement,Nicolas Massu,Arnaud Clement,6-1; 6-4,R64,66,7,0,19,45,17,19,20,26,0,0,9,37,45,5,1,31,50,22,31,7,19,4,7,8,29,50
2006-10-30 00:00:00.000,ATP Masters Series Paris France ATP World Tour,HARD,2,Michael Llodra,Fernando Verdasco,Michael Llodra,6-4; 7-6(4),R64,98,10,1,46,68,38,46,8,22,0,2,11,46,68,5,5,57,74,40,57,5,17,5,8,11,45,74
2006-10-30 00:00:00.000,ATP Masters Series Paris France ATP World Tour,HARD,2,Tommy Haas,N/A Bye,Tommy Haas,,R64,0,0,0,0,0,0,0,0,0,0,0,0,0,0,0,0,0,0,0,0,0,0,0,0,0,0,0
2006-10-30 00:00:00.000,ATP Masters Series Paris France ATP World Tour,HARD,2,Richard Gasquet,N/A Bye,Richard Gasquet,,R64,0,0,0,0,0,0,0,0,0,0,0,0,0,0,0,0,0,0,0,0,0,0,0,0,0,0,0
2006-10-30 00:00:00.000,ATP Masters Series Paris France ATP World Tour,HARD,2,Stanislas Wawrinka,Marc Gicquel,Stanislas Wawrinka,7-6(6); 6-7(4); 7-6(2),R64,161,21,4,62,115,56,62,30,53,1,1,18,86,115,8,1,71,137,51,71,41,66,9,9,18,92,137
2006-10-30 00:00:00.000,ATP Masters Series Paris France ATP World Tour,HARD,2,Marat Safin,Nicolas Mahut,Marat Safin,6-1; 7-6(5),R64,75,17,1,48,63,38,48,9,15,3,3,10,47,63,5,1,34,53,26,34,8,19,2,4,9,34,53
2006-10-30 00:00:00.000,ATP Masters Series Paris France ATP World Tour,HARD,2,Robin Soderling,N/A Bye,Robin Soderling,,R64,0,0,0,0,0,0,0,0,0,0,0,0,0,0,0,0,0,0,0,0,0,0,0,0,0,0,0
2006-10-30 00:00:00.000,ATP Masters Series Paris France ATP World Tour,HARD,2,Teymuraz Gabashvili,Thomas Johansson,Teymuraz Gabashvili,7-6(3); 4-6; 6-3,R32,126,10,3,52,97,40,52,27,45,4,6,16,67,97,21,3,51,106,39,51,30,55,10,12,15,69,106
2006-10-30 00:00:00.000,ATP Masters Series Paris France ATP World Tour,HARD,2,Jarkko Nieminen,Daniele Bracciali,Jarkko Nieminen,6-3; 6-4,R32,63,3,0,25,50,22,25,15,25,1,2,10,37,50,2,3,33,58,21,33,11,25,2,5,9,32,58
2006-10-30 00:00:00.000,ATP Masters Series Paris France ATP World Tour,HARD,2,Paul-Henri Mathieu,Novak Djokovic,Paul-Henri Mathieu,7-6(11); 7-6(4),R32,161,13,3,55,110,43,55,26,55,9,12,12,69,110,6,0,49,87,36,49,18,38,4,7,12,54,87
2006-10-30 00:00:00.000,ATP Masters Series Paris France ATP World Tour,HARD,2,Tommy Robredo,Sebastien Grosjean,Tommy Robredo,3-6; 7-5; 6-4,R32,135,1,2,71,98,42,71,12,27,4,10,15,54,98,4,3,58,90,40,58,9,32,4,11,16,49,90
2006-10-30 00:00:00.000,ATP Masters Series Paris France ATP World Tour,HARD,2,Nikolay Davydenko,Christophe Rochus,Nikolay Davydenko,6-0; 6-0,R32,35,9,0,21,29,20,21,4,8,0,0,6,24,29,0,0,21,34,5,21,3,13,2,8,6,8,34
2006-10-30 00:00:00.000,ATP Masters Series Paris France ATP World Tour,HARD,2,Dmitry Tursunov,Nicolas Almagro,Dmitry Tursunov,6-3; 5-4 RET,R32,62,16,1,30,56,25,30,15,26,3,3,9,40,56,7,4,25,49,18,25,14,24,2,4,9,32,49
2006-10-30 00:00:00.000,ATP Masters Series Paris France ATP World Tour,HARD,2,Mario Ancic,Kristof Vliegen,Mario Ancic,3-6; 7-6(4); 6-3,R32,144,15,1,71,108,53,71,18,37,5,7,16,71,108,9,1,60,94,47,60,19,34,4,5,14,66,94
2006-10-30 00:00:00.000,ATP Masters Series Paris France ATP World Tour,HARD,2,Julien Benneteau,Fernando Gonzalez,Julien Benneteau,3-6; 6-4; 7-5,R32,128,5,3,58,87,41,58,13,29,6,9,15,54,87,9,4,61,105,43,61,20,44,5,9,16,63,105
2006-10-30 00:00:00.000,ATP Masters Series Paris France ATP World Tour,HARD,2,Tomas Berdych,Olivier Rochus,Tomas Berdych,6-7(4); 6-4; 6-2,R32,126,21,2,60,88,46,60,16,28,3,4,15,62,88,6,2,55,101,41,55,22,46,9,13,15,63,101
2006-10-30 00:00:00.000,ATP Masters Series Paris France ATP World Tour,HARD,2,Robby Ginepri,David Ferrer,Robby Ginepri,6-3; 6-4,R32,67,2,0,38,59,26,38,11,21,0,2,9,37,59,3,1,30,54,17,30,10,24,2,7,10,27,54
2006-10-30 00:00:00.000,ATP Masters Series Paris France ATP World Tour,HARD,2,Andy Murray,Juan Ignacio Chela,Andy Murray,7-5; 6-0,R32,78,6,3,30,49,23,30,13,19,1,2,9,36,49,0,1,42,70,20,42,14,28,9,14,9,34,70
2006-10-30 00:00:00.000,ATP Masters Series Paris France ATP World Tour,HARD,2,Dominik Hrbaty,Igor Andreev,Dominik Hrbaty,6-4; 6-3,R32,64,3,4,33,51,29,33,9,18,1,1,9,38,51,5,4,41,63,29,41,7,22,2,5,10,36,63
2006-10-30 00:00:00.000,ATP Masters Series Paris France ATP World Tour,HARD,2,James Blake,Arnaud Clement,James Blake,6-4; 3-6; 6-4,R32,118,16,4,48,89,38,48,20,41,3,6,15,58,89,2,2,47,84,35,47,19,37,3,6,14,54,84
2006-10-30 00:00:00.000,ATP Masters Series Paris France ATP World Tour,HARD,2,Tommy Haas,Michael Llodra,Tommy Haas,7-6(7); 7-6(2),R32,112,8,7,53,97,41,53,21,44,5,7,12,62,97,10,5,50,83,34,50,18,33,1,3,12,52,83
2006-10-30 00:00:00.000,ATP Masters Series Paris France ATP World Tour,HARD,2,Richard Gasquet,Stanislas Wawrinka,Richard Gasquet,7-5; 6-1,R32,66,3,1,41,51,33,41,7,10,0,0,10,40,51,4,0,37,57,24,37,9,20,4,7,9,33,57
2006-10-30 00:00:00.000,ATP Masters Series Paris France ATP World Tour,HARD,2,Marat Safin,Robin Soderling,Marat Safin,3-6; 6-3; 6-4,R32,110,8,2,59,82,42,59,12,23,4,6,14,54,82,4,2,67,99,47,67,14,32,7,10,14,61,99
2006-10-30 00:00:00.000,ATP Masters Series Paris France ATP World Tour,HARD,2,Jarkko Nieminen,Teymuraz Gabashvili,Jarkko Nieminen,4-6; 7-6(6); 6-2,R16,111,12,1,53,92,43,53,22,39,3,4,15,65,92,8,6,53,97,40,53,23,44,2,4,15,63,97
2006-10-30 00:00:00.000,ATP Masters Series Paris France ATP World Tour,HARD,2,Tommy Robredo,Paul-Henri Mathieu,Tommy Robredo,6-4; 7-6(1),R16,98,5,0,43,55,35,43,10,12,0,1,11,45,55,0,2,46,69,29,46,15,23,2,4,11,44,69
2006-10-30 00:00:00.000,ATP Masters Series Paris France ATP World Tour,HARD,2,Nikolay Davydenko,Dmitry Tursunov,Nikolay Davydenko,6-2; 6-2,R16,72,4,1,32,49,25,32,11,17,3,3,8,36,49,1,1,36,60,22,36,8,24,8,12,8,30,60
2006-10-30 00:00:00.000,ATP Masters Series Paris France ATP World Tour,HARD,2,Mario Ancic,Julien Benneteau,Mario Ancic,6-3; 6-1,R16,68,5,1,28,43,22,28,12,15,1,1,8,34,43,1,0,42,51,22,42,4,9,5,9,8,26,51
2006-10-30 00:00:00.000,ATP Masters Series Paris France ATP World Tour,HARD,2,Tomas Berdych,Robby Ginepri,Tomas Berdych,6-3; 6-3,R16,66,5,0,39,59,29,39,13,20,4,4,9,42,59,7,2,33,56,24,33,7,23,2,5,9,31,56
2006-10-30 00:00:00.000,ATP Masters Series Paris France ATP World Tour,HARD,2,Dominik Hrbaty,Andy Murray,Dominik Hrbaty,7-6(6); 6-0,R16,88,3,4,28,56,19,28,11,28,1,5,9,30,56,9,6,29,69,19,29,11,40,11,18,9,30,69
2006-10-30 00:00:00.000,ATP Masters Series Paris France ATP World Tour,HARD,2,Tommy Haas,James Blake,Tommy Haas,6-4; 6-2,R16,60,7,0,30,49,28,30,9,19,2,2,9,37,49,3,3,36,55,24,36,10,19,4,7,9,34,55
2006-10-30 00:00:00.000,ATP Masters Series Paris France ATP World Tour,HARD,2,Marat Safin,Richard Gasquet,Marat Safin,W/O,R16,0,0,0,0,0,0,0,0,0,0,0,0,0,0,0,0,0,0,0,0,0,0,0,0,0,0,0
2006-10-30 00:00:00.000,ATP Masters Series Paris France ATP World Tour,HARD,2,Tommy Robredo,Jarkko Nieminen,Tommy Robredo,6-7(4); 7-6(4); 6-4,Q,165,6,2,69,129,46,69,32,60,5,8,17,78,129,3,1,67,114,50,67,23,47,5,9,17,73,114
2006-10-30 00:00:00.000,ATP Masters Series Paris France ATP World Tour,HARD,2,Nikolay Davydenko,Mario Ancic,Nikolay Davydenko,6-3; 6-3,Q,84,2,2,30,53,26,30,13,23,0,0,9,39,53,2,2,37,64,28,37,9,27,3,6,9,37,64
2006-10-30 00:00:00.000,ATP Masters Series Paris France ATP World Tour,HARD,2,Dominik Hrbaty,Tomas Berdych,Dominik Hrbaty,6-4; 1-6; 6-2,Q,94,3,1,36,69,31,36,13,33,4,7,12,44,69,5,3,54,79,32,54,14,25,3,7,13,46,79
2006-10-30 00:00:00.000,ATP Masters Series Paris France ATP World Tour,HARD,2,Tommy Haas,Marat Safin,Tommy Haas,7-6(1); 3-6; 6-3,Q,112,9,4,49,87,43,49,21,38,2,3,15,64,87,11,0,60,88,42,60,19,28,1,2,15,61,88
2006-10-30 00:00:00.000,ATP Masters Series Paris France ATP World Tour,HARD,2,Nikolay Davydenko,Tommy Robredo,Nikolay Davydenko,6-3; 5-7; 6-2,S,116,4,2,45,71,39,45,13,26,1,3,14,52,71,7,2,61,91,42,61,11,30,3,8,15,53,91
2006-10-30 00:00:00.000,ATP Masters Series Paris France ATP World Tour,HARD,2,Dominik Hrbaty,Tommy Haas,Dominik Hrbaty,6-4; 1-0 RET,S,49,5,1,14,32,11,14,9,18,2,3,5,20,32,3,1,25,39,17,25,4,14,4,7,6,21,39
2006-10-30 00:00:00.000,ATP Masters Series Paris France ATP World Tour,HARD,2,Nikolay Davydenko,Dominik Hrbaty,Nikolay Davydenko,6-1; 6-2; 6-2,F,99,7,4,54,81,44,54,14,27,7,7,12,58,81,5,3,44,72,21,44,13,28,7,13,11,34,72
