event_time,event_name,surface,num_of_sets,playerA,playerB,winner,score,round,duration_minutes,a_aces,a_double_faults,a_first_serve_hits,a_first_serve_total,a_first_serve_won,a_first_serve_played,a_second_serve_won,a_second_serve_played,a_break_points_saved,a_break_points_total,a_service_games,a_service_points_won,a_service_points_total,b_aces,b_double_faults,b_first_serve_hits,b_first_serve_total,b_first_serve_won,b_first_serve_played,b_second_serve_won,b_second_serve_played,b_break_points_saved,b_break_points_total,b_service_games,b_service_points_won,b_service_points_total
2002-12-30 00:00:00.000,Adelaide Australia ATP World Tour,HARD,2,Franco Squillari,Wayne Ferreira,Franco Squillari,7-6(4); 6-2,R32,90,5,4,33,71,25,33,21,38,6,7,10,46,71,6,2,41,81,29,41,17,40,4,7,10,46,81
2002-12-30 00:00:00.000,Adelaide Australia ATP World Tour,HARD,2,Richard Krajicek,Scott Draper,Richard Krajicek,7-6(4); 6-4,R32,60,16,3,40,66,32,40,20,26,3,3,11,52,66,3,0,39,56,32,39,12,17,1,2,11,44,56
2002-12-30 00:00:00.000,Adelaide Australia ATP World Tour,HARD,2,Brian Vahaly,Adam Kennedy,Brian Vahaly,4-6; 6-2; 6-0,R32,65,2,1,50,71,31,50,14,21,1,3,12,45,71,11,9,44,83,27,44,15,39,4,10,12,42,83
2002-12-30 00:00:00.000,Adelaide Australia ATP World Tour,HARD,2,Vincent Spadea,Todd Reid,Vincent Spadea,3-6; 6-3; 6-3,R32,69,14,10,33,77,24,33,22,44,4,8,13,46,77,1,2,62,96,40,62,11,34,5,11,14,51,96
2002-12-30 00:00:00.000,Adelaide Australia ATP World Tour,HARD,2,Kristof Vliegen,Thomas Enqvist,Kristof Vliegen,3-6; 6-4; 6-3,R32,93,7,4,52,78,37,52,17,26,2,4,14,54,78,5,4,49,80,36,49,16,31,0,3,14,52,80
2002-12-30 00:00:00.000,Adelaide Australia ATP World Tour,HARD,2,Arvind Parmar,Harel Levy,Arvind Parmar,6-7(5); 6-4; 6-1,R32,145,4,3,64,96,43,64,24,32,1,2,15,67,96,3,0,58,96,38,58,22,38,9,13,14,60,96
2002-12-30 00:00:00.000,Adelaide Australia ATP World Tour,HARD,2,Richard Gasquet,Arnaud Di Pasquale,Richard Gasquet,3-6; 6-3; 6-4,R32,127,5,4,45,90,34,45,26,45,7,9,14,60,90,9,5,47,90,31,47,24,43,3,6,14,55,90
2002-12-30 00:00:00.000,Adelaide Australia ATP World Tour,HARD,2,Alberto Martin,Jurgen Melzer,Alberto Martin,6-1; 6-3,R32,64,0,4,44,62,33,44,9,18,7,7,8,42,62,2,4,33,48,21,33,4,15,5,9,8,25,48
2002-12-30 00:00:00.000,Adelaide Australia ATP World Tour,HARD,2,Mariano Zabaleta,Alexander Waske,Mariano Zabaleta,6-1; 6-4,R32,54,6,0,25,42,24,25,9,17,0,1,9,33,42,4,1,24,45,13,24,10,21,5,9,8,23,45
2002-12-30 00:00:00.000,Adelaide Australia ATP World Tour,HARD,2,Martin Verkerk,Florent Serra,Martin Verkerk,6-3; 6-4,R32,75,10,2,35,50,30,35,8,15,0,1,10,38,50,2,2,48,76,31,48,11,28,2,5,9,42,76
2002-12-30 00:00:00.000,Adelaide Australia ATP World Tour,HARD,2,Nikolay Davydenko,Irakli Labadze,Nikolay Davydenko,6-2; 7-6(5),R32,68,2,3,36,63,29,36,16,27,3,4,10,45,63,2,5,47,78,34,47,10,31,7,10,10,44,78
2002-12-30 00:00:00.000,Adelaide Australia ATP World Tour,HARD,2,Ivan Ljubicic,Jeff Morrison,Ivan Ljubicic,6-4; 6-3,R32,75,3,2,25,56,21,25,20,31,0,0,10,41,56,4,6,26,55,19,26,16,29,3,5,9,35,55
2002-12-30 00:00:00.000,Adelaide Australia ATP World Tour,HARD,2,Adrian Voinea,Olivier Rochus,Adrian Voinea,6-1; 4-6; 7-6(4),R32,124,7,5,48,96,32,48,23,48,7,12,15,55,96,5,6,52,95,30,52,18,43,3,9,14,48,95
2002-12-30 00:00:00.000,Adelaide Australia ATP World Tour,HARD,2,Alex Kim,Attila Savolt,Alex Kim,2-6; 6-3; 6-3,R32,65,7,2,52,85,35,52,13,33,5,9,13,48,85,5,3,48,71,28,48,11,23,1,6,13,39,71
2002-12-30 00:00:00.000,Adelaide Australia ATP World Tour,HARD,2,Antony Dupuis,Karol Beck,Antony Dupuis,6-4; 6-3,R32,70,9,5,33,58,29,33,11,25,2,2,9,40,58,5,4,33,52,23,33,9,19,1,4,10,32,52
2002-12-30 00:00:00.000,Adelaide Australia ATP World Tour,HARD,2,Max Mirnyi,Stefano Galvani,Max Mirnyi,7-6(5); 6-2,R32,73,9,1,34,59,29,34,17,25,0,0,10,46,59,6,3,37,57,27,37,12,20,0,2,10,39,57
2002-12-30 00:00:00.000,Adelaide Australia ATP World Tour,HARD,2,Richard Krajicek,Franco Squillari,Richard Krajicek,6-4; 6-3,R16,68,10,6,33,63,28,33,16,30,3,3,10,44,63,1,4,24,52,20,24,14,28,0,2,9,34,52
2002-12-30 00:00:00.000,Adelaide Australia ATP World Tour,HARD,2,Brian Vahaly,Vincent Spadea,Brian Vahaly,7-6(1); 6-2,R16,85,0,3,46,64,33,46,8,18,1,3,10,41,64,2,5,41,68,25,41,10,27,2,6,10,35,68
2002-12-30 00:00:00.000,Adelaide Australia ATP World Tour,HARD,2,Kristof Vliegen,Arvind Parmar,Kristof Vliegen,6-2; 6-2,R16,51,3,0,29,43,21,29,12,14,0,0,8,33,43,0,3,26,47,16,26,9,21,2,6,8,25,47
2002-12-30 00:00:00.000,Adelaide Australia ATP World Tour,HARD,2,Alberto Martin,Richard Gasquet,Alberto Martin,7-5; 6-1,R16,68,3,5,31,52,25,31,11,21,3,4,9,36,52,4,5,34,63,19,34,14,29,5,10,10,33,63
2002-12-30 00:00:00.000,Adelaide Australia ATP World Tour,HARD,2,Mariano Zabaleta,Martin Verkerk,Mariano Zabaleta,6-4; 6-4,R16,67,3,1,29,46,27,29,10,17,0,1,10,37,46,4,3,38,61,25,38,10,23,1,4,10,35,61
2002-12-30 00:00:00.000,Adelaide Australia ATP World Tour,HARD,2,Nikolay Davydenko,Ivan Ljubicic,Nikolay Davydenko,4-6; 6-4; 7-6(9),R16,158,6,5,55,102,42,55,21,47,6,11,16,63,102,10,8,53,103,40,53,20,50,5,10,16,60,103
2002-12-30 00:00:00.000,Adelaide Australia ATP World Tour,HARD,2,Adrian Voinea,Alex Kim,Adrian Voinea,6-4; 6-1,R16,73,12,3,36,60,30,36,9,24,2,3,9,39,60,1,0,32,44,15,32,9,12,2,6,8,24,44
2002-12-30 00:00:00.000,Adelaide Australia ATP World Tour,HARD,2,Antony Dupuis,Max Mirnyi,Antony Dupuis,7-6(3); 6-3,R16,76,8,1,36,60,32,36,17,24,0,0,11,49,60,9,1,37,62,31,37,13,25,2,3,10,44,62
2002-12-30 00:00:00.000,Adelaide Australia ATP World Tour,HARD,2,Richard Krajicek,Brian Vahaly,Richard Krajicek,6-1; 6-3,Q,57,12,3,25,53,23,25,12,28,1,1,8,35,53,0,2,36,48,20,36,5,12,2,6,8,25,48
2002-12-30 00:00:00.000,Adelaide Australia ATP World Tour,HARD,2,Kristof Vliegen,Alberto Martin,Kristof Vliegen,6-3; 6-4,Q,69,2,2,37,57,26,37,14,20,1,2,10,40,57,0,6,32,55,22,32,10,23,2,5,9,32,55
2002-12-30 00:00:00.000,Adelaide Australia ATP World Tour,HARD,2,Nikolay Davydenko,Mariano Zabaleta,Nikolay Davydenko,7-6(3); 6-1,Q,91,2,4,36,62,25,36,17,26,2,2,9,42,62,0,5,39,72,23,39,15,33,5,8,10,38,72
2002-12-30 00:00:00.000,Adelaide Australia ATP World Tour,HARD,2,Adrian Voinea,Antony Dupuis,Adrian Voinea,7-6(6); 6-4,Q,90,1,4,48,73,38,48,16,25,1,2,11,54,73,12,3,37,73,26,37,23,36,2,4,11,49,73
2002-12-30 00:00:00.000,Adelaide Australia ATP World Tour,HARD,2,Kristof Vliegen,Richard Krajicek,Kristof Vliegen,7-6(1); 4-6; 6-3,S,111,6,3,62,109,47,62,26,47,5,6,16,73,109,24,7,44,94,38,44,27,50,2,3,15,65,94
2002-12-30 00:00:00.000,Adelaide Australia ATP World Tour,HARD,2,Nikolay Davydenko,Adrian Voinea,Nikolay Davydenko,6-2; 6-1,S,57,6,0,32,46,20,32,9,14,1,2,7,29,46,1,3,27,54,11,27,9,27,3,9,8,20,54
2002-12-30 00:00:00.000,Adelaide Australia ATP World Tour,HARD,2,Nikolay Davydenko,Kristof Vliegen,Nikolay Davydenko,6-2; 7-6(3),F,76,0,1,53,70,34,53,13,17,2,3,10,47,70,5,2,41,60,30,41,7,19,1,4,10,37,60
2002-12-30 00:00:00.000,Chennai India ATP World Tour,HARD,2,Guillermo Canas,Dick Norman,Guillermo Canas,4-6; 6-2; 6-3,R32,113,5,3,47,78,35,47,20,31,2,4,14,55,78,7,7,51,95,33,51,22,44,5,9,13,55,95
2002-12-30 00:00:00.000,Chennai India ATP World Tour,HARD,2,Jiri Vanek,Prakash Amritraj,Jiri Vanek,6-2; 6-2,R32,62,7,1,31,52,25,31,11,21,2,2,8,36,52,2,4,28,47,18,28,7,19,2,6,8,25,47
2002-12-30 00:00:00.000,Chennai India ATP World Tour,HARD,2,Karol Kucera,Justin Gimelstob,Karol Kucera,3-6; 7-6(3); 6-3,R32,126,3,7,47,95,34,47,29,48,3,4,14,63,95,11,5,63,103,47,63,18,40,2,4,16,65,103
2002-12-30 00:00:00.000,Chennai India ATP World Tour,HARD,2,Cecil Mamiit,Lars Burgsmuller,Cecil Mamiit,6-0; 6-3,R32,64,3,3,38,57,28,38,11,19,6,6,8,39,57,2,3,27,43,14,27,7,16,3,7,7,21,43
2002-12-30 00:00:00.000,Chennai India ATP World Tour,HARD,2,Juan Ignacio Chela,Leander Paes,Juan Ignacio Chela,7-6(5); 7-5,R32,108,4,6,45,85,33,45,20,40,4,7,12,53,85,0,8,59,101,36,59,21,42,8,12,12,57,101
2002-12-30 00:00:00.000,Chennai India ATP World Tour,HARD,2,Zeljko Krajan,Rohan Bopanna,Zeljko Krajan,6-4; 7-6(3),R32,82,4,1,48,70,36,48,13,22,3,5,11,49,70,8,1,27,68,25,27,18,41,6,9,11,43,68
2002-12-30 00:00:00.000,Chennai India ATP World Tour,HARD,2,Albert Portas,Jerome Golmard,Albert Portas,1-1 RET,R32,12,2,1,4,10,4,4,3,6,0,0,1,7,10,0,0,2,4,2,2,2,2,0,0,1,4,4
2002-12-30 00:00:00.000,Chennai India ATP World Tour,HARD,2,Tomas Behrend,Andrei Pavel,Tomas Behrend,6-3; 6-3,R32,70,4,3,35,63,25,35,16,28,3,4,9,41,63,2,0,35,56,21,35,8,21,2,6,9,29,56
2002-12-30 00:00:00.000,Chennai India ATP World Tour,HARD,2,Rainer Schuettler,Julian Knowle,Rainer Schuettler,6-4; 6-1,R32,82,4,1,28,48,26,28,12,20,1,1,9,38,48,4,8,29,63,22,29,13,34,9,12,8,35,63
2002-12-30 00:00:00.000,Chennai India ATP World Tour,HARD,2,Mark Philippoussis,Michael Kohlmann,Mark Philippoussis,7-6(3); 6-3,R32,79,8,9,38,68,30,38,16,30,1,3,11,46,68,10,2,38,65,28,38,10,27,1,4,10,38,65
2002-12-30 00:00:00.000,Chennai India ATP World Tour,HARD,2,Jean-Rene Lisnard,Kristian Pless,Jean-Rene Lisnard,6-2; 7-5,R32,65,1,1,36,56,27,36,12,20,2,3,10,39,56,0,7,34,64,21,34,12,30,3,7,10,33,64
2002-12-30 00:00:00.000,Chennai India ATP World Tour,HARD,2,Noam Okun,Juan Balcells,Noam Okun,7-5; 6-4,R32,90,1,4,46,73,30,46,20,27,3,3,11,50,73,2,3,42,58,32,42,9,16,2,4,11,41,58
2002-12-30 00:00:00.000,Chennai India ATP World Tour,HARD,2,Albert Montanes,Michael Llodra,Albert Montanes,7-6(5); 1-6; 6-4,R32,106,0,4,56,93,41,56,18,37,3,7,15,59,93,4,3,53,84,42,53,16,31,3,5,14,58,84
2002-12-30 00:00:00.000,Chennai India ATP World Tour,HARD,2,Sargis Sargsian,Julien Varlet,Sargis Sargsian,6-1; 7-5,R32,82,5,3,43,63,28,43,9,20,2,4,9,37,63,0,1,42,55,22,42,4,13,1,7,10,26,55
2002-12-30 00:00:00.000,Chennai India ATP World Tour,HARD,2,John van Lottum,Olivier Patience,John van Lottum,6-2; 7-6(4),R32,71,6,0,39,60,33,39,13,21,1,1,10,46,60,0,2,30,55,23,30,15,25,2,4,10,38,55
2002-12-30 00:00:00.000,Chennai India ATP World Tour,HARD,2,Paradorn Srichaphan,Jan Vacek,Paradorn Srichaphan,7-5; 6-2,R32,76,2,1,34,64,25,34,17,30,5,6,10,42,64,2,2,31,57,21,31,9,26,2,6,10,30,57
2002-12-30 00:00:00.000,Chennai India ATP World Tour,HARD,2,Guillermo Canas,Jiri Vanek,Guillermo Canas,6-4; 6-2,R16,70,1,3,36,56,28,36,7,20,3,5,9,35,56,5,4,35,58,21,35,7,23,3,8,9,28,58
2002-12-30 00:00:00.000,Chennai India ATP World Tour,HARD,2,Karol Kucera,Cecil Mamiit,Karol Kucera,7-6(6); 3-6; 6-3,R16,150,1,3,56,95,39,56,16,39,4,10,15,55,95,3,2,55,102,32,55,25,47,3,9,15,57,102
2002-12-30 00:00:00.000,Chennai India ATP World Tour,HARD,2,Juan Ignacio Chela,Zeljko Krajan,Juan Ignacio Chela,3-6; 6-3; 2-0 RET,R16,96,10,4,37,59,28,37,10,22,2,4,10,38,59,0,1,37,69,24,37,16,32,5,8,10,40,69
2002-12-30 00:00:00.000,Chennai India ATP World Tour,HARD,2,Tomas Behrend,Albert Portas,Tomas Behrend,7-6(4); 6-1,R16,68,5,4,35,57,24,35,13,22,1,3,10,37,57,0,2,28,54,16,28,11,26,3,7,9,27,54
2002-12-30 00:00:00.000,Chennai India ATP World Tour,HARD,2,Rainer Schuettler,Mark Philippoussis,Rainer Schuettler,6-2; 6-1,R16,51,2,2,19,34,17,19,11,15,0,0,7,28,34,1,6,20,46,12,20,7,26,2,7,8,19,46
2002-12-30 00:00:00.000,Chennai India ATP World Tour,HARD,2,Jean-Rene Lisnard,Noam Okun,Jean-Rene Lisnard,6-0; 2-6; 6-2,R16,112,1,2,49,79,37,49,13,30,4,6,11,50,79,0,2,43,72,21,43,15,29,6,11,11,36,72
2002-12-30 00:00:00.000,Chennai India ATP World Tour,HARD,2,Sargis Sargsian,Albert Montanes,Sargis Sargsian,6-4; 6-3,R16,72,5,3,35,58,30,35,13,23,0,0,10,43,58,4,1,29,53,23,29,11,24,3,5,9,34,53
2002-12-30 00:00:00.000,Chennai India ATP World Tour,HARD,2,Paradorn Srichaphan,John van Lottum,Paradorn Srichaphan,6-2; 6-4,R16,63,4,1,29,46,23,29,10,17,0,1,9,33,46,0,2,34,52,21,34,7,18,4,8,9,28,52
2002-12-30 00:00:00.000,Chennai India ATP World Tour,HARD,2,Karol Kucera,Guillermo Canas,Karol Kucera,6-1; 7-5,Q,99,1,4,42,67,25,42,18,25,7,8,9,43,67,0,2,40,68,23,40,12,28,4,9,10,35,68
2002-12-30 00:00:00.000,Chennai India ATP World Tour,HARD,2,Juan Ignacio Chela,Tomas Behrend,Juan Ignacio Chela,6-4; 6-3,Q,80,3,0,33,66,24,33,22,33,8,9,10,46,66,3,3,30,51,20,30,10,21,4,7,9,30,51
2002-12-30 00:00:00.000,Chennai India ATP World Tour,HARD,2,Jean-Rene Lisnard,Rainer Schuettler,Jean-Rene Lisnard,6-2; 7-5,Q,90,2,1,50,75,25,50,17,25,8,11,10,42,75,0,2,51,70,25,51,8,19,7,13,10,33,70
2002-12-30 00:00:00.000,Chennai India ATP World Tour,HARD,2,Paradorn Srichaphan,Sargis Sargsian,Paradorn Srichaphan,6-4; 6-4,Q,83,7,2,30,52,24,30,10,22,1,3,10,34,52,3,7,48,80,32,48,9,32,4,8,10,41,80
2002-12-30 00:00:00.000,Chennai India ATP World Tour,HARD,2,Karol Kucera,Juan Ignacio Chela,Karol Kucera,6-3; 7-5,S,90,2,0,39,66,24,39,17,27,2,5,11,41,66,2,2,35,61,19,35,11,26,3,8,10,30,61
2002-12-30 00:00:00.000,Chennai India ATP World Tour,HARD,2,Paradorn Srichaphan,Jean-Rene Lisnard,Paradorn Srichaphan,6-2; 6-1,S,50,2,3,22,42,19,22,12,20,0,0,7,31,42,0,0,20,47,7,20,14,27,3,8,8,21,47
2002-12-30 00:00:00.000,Chennai India ATP World Tour,HARD,2,Paradorn Srichaphan,Karol Kucera,Paradorn Srichaphan,6-3; 6-1,F,68,5,6,22,53,19,22,17,31,2,2,8,36,53,2,1,33,51,17,33,8,18,3,7,8,25,51
2002-12-30 00:00:00.000,Doha Qatar ATP World Tour,HARD,2,Roger Federer,Andrei Stoliarov,Roger Federer,6-2; 6-7(4); 6-4,R32,116,16,5,65,107,52,65,21,42,4,4,15,73,107,1,2,58,100,39,58,26,42,5,8,15,65,100
2002-12-30 00:00:00.000,Doha Qatar ATP World Tour,HARD,2,Michel Kratochvil,Sultan Khalfan,Michel Kratochvil,6-0; 6-4,R32,63,0,3,36,53,25,36,11,17,3,4,8,36,53,0,3,33,53,19,33,4,20,1,6,8,23,53
2002-12-30 00:00:00.000,Doha Qatar ATP World Tour,HARD,2,David Ferrer,Raemon Sluiter,David Ferrer,6-3; 6-7(2); 6-4,R32,127,11,4,60,105,44,60,19,45,3,6,15,63,105,5,6,57,107,32,57,29,50,4,10,16,61,107
2002-12-30 00:00:00.000,Doha Qatar ATP World Tour,HARD,2,Jan-Michael Gambill,Ivo Heuberger,Jan-Michael Gambill,6-1; 7-5,R32,79,4,2,29,51,20,29,10,22,0,3,10,30,51,4,8,28,57,14,28,11,29,3,9,9,25,57
2002-12-30 00:00:00.000,Doha Qatar ATP World Tour,HARD,2,Fernando Vicente,Yevgeny Kafelnikov,Fernando Vicente,6-2; 7-5,R32,98,2,6,48,79,36,48,12,31,6,7,10,48,79,1,4,23,64,17,23,19,41,4,8,10,36,64
2002-12-30 00:00:00.000,Doha Qatar ATP World Tour,HARD,2,Markus Hantschk,Kenneth Carlsen,Markus Hantschk,7-6(3); 6-1,R32,93,1,0,40,62,32,40,14,22,1,1,10,46,62,4,0,27,50,21,27,11,23,2,4,9,32,50
2002-12-30 00:00:00.000,Doha Qatar ATP World Tour,HARD,2,Radek Stepanek,Feliciano Lopez,Radek Stepanek,6-7(4); 6-3; 6-2,R32,112,7,2,60,91,42,60,23,31,1,1,15,65,91,8,4,50,92,39,50,17,42,2,5,14,56,92
2002-12-30 00:00:00.000,Doha Qatar ATP World Tour,HARD,2,Mikhail Youzhny,David Sanchez,Mikhail Youzhny,4-6; 6-4; 6-4,R32,166,0,2,72,130,46,72,27,58,12,16,15,73,130,1,0,46,89,29,46,22,43,6,11,15,51,89
2002-12-30 00:00:00.000,Doha Qatar ATP World Tour,HARD,2,Fabrice Santoro,Felix Mantilla,Fabrice Santoro,6-3; 6-3,R32,78,0,3,36,62,25,36,14,26,6,7,9,39,62,0,7,44,63,24,44,7,19,3,7,9,31,63
2002-12-30 00:00:00.000,Doha Qatar ATP World Tour,HARD,2,Christophe Rochus,Yves Allegro,Christophe Rochus,6-3; 6-2,R32,60,0,3,39,52,27,39,8,13,1,3,9,35,52,6,6,26,49,14,26,7,23,3,8,8,21,49
2002-12-30 00:00:00.000,Doha Qatar ATP World Tour,HARD,2,Hicham Arazi,David Prinosil,Hicham Arazi,6-2; 6-3,R32,68,3,1,35,52,27,35,10,17,4,5,9,37,52,5,2,37,58,19,37,10,21,5,9,8,29,58
2002-12-30 00:00:00.000,Doha Qatar ATP World Tour,HARD,2,Younes El Aynaoui,Julien Boutter,Younes El Aynaoui,6-4; 6-4,R32,79,6,3,39,56,33,39,9,17,2,2,10,42,56,12,3,42,71,31,42,13,29,8,10,10,44,71
2002-12-30 00:00:00.000,Doha Qatar ATP World Tour,HARD,2,Stefan Koubek,Nicolas Escude,Stefan Koubek,7-6(5); 6-2,R32,92,6,2,36,62,29,36,15,26,1,2,10,44,62,7,1,59,84,34,59,11,25,5,8,10,45,84
2002-12-30 00:00:00.000,Doha Qatar ATP World Tour,HARD,2,Vladimir Voltchkov,Hyung-Taik Lee,Vladimir Voltchkov,6-4; 3-6; 7-5,R32,132,6,3,70,103,49,70,18,33,10,11,15,67,103,8,1,59,87,45,59,19,28,2,4,16,64,87
2002-12-30 00:00:00.000,Doha Qatar ATP World Tour,HARD,2,Andreas Vinciguerra,Karim Alami,Andreas Vinciguerra,2-6; 6-4; 6-1,R32,92,2,1,58,78,38,58,13,20,1,4,13,51,78,5,0,45,74,31,45,11,29,3,7,12,42,74
2002-12-30 00:00:00.000,Doha Qatar ATP World Tour,HARD,2,Albert Costa,Andrea Gaudenzi,Albert Costa,6-3; 6-4,R32,90,11,2,38,68,30,38,18,30,7,7,10,48,68,2,6,27,57,19,27,16,30,2,4,9,35,57
2002-12-30 00:00:00.000,Doha Qatar ATP World Tour,HARD,2,Roger Federer,Michel Kratochvil,Roger Federer,6-4; 6-4,R16,68,9,2,36,60,29,36,12,24,3,4,10,41,60,0,6,34,58,26,34,10,24,5,8,10,36,58
2002-12-30 00:00:00.000,Doha Qatar ATP World Tour,HARD,2,Jan-Michael Gambill,David Ferrer,Jan-Michael Gambill,7-6(5); 6-4,R16,129,14,3,50,70,40,50,9,20,5,7,11,49,70,0,1,36,69,26,36,19,33,7,10,11,45,69
2002-12-30 00:00:00.000,Doha Qatar ATP World Tour,HARD,2,Fernando Vicente,Markus Hantschk,Fernando Vicente,7-5; 7-6(3),R16,124,3,3,44,78,31,44,22,34,5,7,12,53,78,4,1,63,89,36,63,17,26,4,7,12,53,89
2002-12-30 00:00:00.000,Doha Qatar ATP World Tour,HARD,2,Mikhail Youzhny,Radek Stepanek,Mikhail Youzhny,6-3; 6-1,R16,61,0,3,27,40,24,27,9,13,0,0,8,33,40,4,0,29,57,18,29,13,28,3,7,8,31,57
2002-12-30 00:00:00.000,Doha Qatar ATP World Tour,HARD,2,Fabrice Santoro,Christophe Rochus,Fabrice Santoro,7-5; 6-7(8); 7-5,R16,184,8,4,84,142,49,84,25,58,14,22,18,74,142,0,2,111,143,50,111,17,32,10,20,18,67,143
2002-12-30 00:00:00.000,Doha Qatar ATP World Tour,HARD,2,Younes El Aynaoui,Hicham Arazi,Younes El Aynaoui,6-4; 7-6(1),R16,67,8,1,49,70,38,49,9,21,4,6,11,47,70,6,2,43,70,28,43,11,27,3,6,11,39,70
2002-12-30 00:00:00.000,Doha Qatar ATP World Tour,HARD,2,Stefan Koubek,Vladimir Voltchkov,Stefan Koubek,6-1; 6-1,R16,66,0,1,27,42,21,27,9,15,1,1,7,30,42,1,2,26,36,12,26,2,10,3,8,7,14,36
2002-12-30 00:00:00.000,Doha Qatar ATP World Tour,HARD,2,Andreas Vinciguerra,Albert Costa,Andreas Vinciguerra,3-6; 7-6(5); 7-5,R16,131,10,2,57,93,48,57,22,36,5,6,16,70,93,7,2,68,95,54,68,17,27,3,4,17,71,95
2002-12-30 00:00:00.000,Doha Qatar ATP World Tour,HARD,2,Jan-Michael Gambill,Roger Federer,Jan-Michael Gambill,6-4; 7-5,Q,94,4,3,43,69,33,43,14,26,5,6,11,47,69,2,4,44,78,29,44,16,34,6,9,11,45,78
2002-12-30 00:00:00.000,Doha Qatar ATP World Tour,HARD,2,Mikhail Youzhny,Fernando Vicente,Mikhail Youzhny,7-6(7); 6-3,Q,109,2,1,47,77,35,47,18,30,2,2,11,53,77,5,1,40,68,28,40,17,28,4,5,10,45,68
2002-12-30 00:00:00.000,Doha Qatar ATP World Tour,HARD,2,Younes El Aynaoui,Fabrice Santoro,Younes El Aynaoui,3-6; 6-3; 6-3,Q,123,7,1,54,82,37,54,10,28,7,11,13,47,82,0,3,58,96,32,58,19,38,9,15,14,51,96
2002-12-30 00:00:00.000,Doha Qatar ATP World Tour,HARD,2,Stefan Koubek,Andreas Vinciguerra,Stefan Koubek,6-3; 6-4,Q,66,6,0,26,56,21,26,23,30,2,2,10,44,56,3,1,40,59,26,40,8,19,1,3,9,34,59
2002-12-30 00:00:00.000,Doha Qatar ATP World Tour,HARD,2,Jan-Michael Gambill,Mikhail Youzhny,Jan-Michael Gambill,6-4; 6-2,S,82,7,5,29,62,25,29,14,33,5,6,9,39,62,1,4,40,57,26,40,5,17,5,9,9,31,57
2002-12-30 00:00:00.000,Doha Qatar ATP World Tour,HARD,2,Stefan Koubek,Younes El Aynaoui,Stefan Koubek,7-6(1); 7-6(5),S,102,7,0,51,77,38,51,18,26,2,2,12,56,77,5,1,55,81,40,55,16,26,2,2,12,56,81
2002-12-30 00:00:00.000,Doha Qatar ATP World Tour,HARD,2,Stefan Koubek,Jan-Michael Gambill,Stefan Koubek,6-4; 6-4,F,83,5,2,31,52,24,31,16,21,0,0,10,40,52,10,2,38,55,29,38,8,17,0,2,10,37,55
2003-01-06 00:00:00.000,Auckland New Zealand ATP World Tour,HARD,2,Jiri Novak,Robert Kendrick,Jiri Novak,6-2; 6-3,R32,55,0,3,31,45,28,31,7,14,0,0,8,35,45,10,4,35,64,27,35,7,29,10,14,9,34,64
2003-01-06 00:00:00.000,Auckland New Zealand ATP World Tour,HARD,2,Robby Ginepri,Agustin Calleri,Robby Ginepri,7-6(5); 7-5,R32,89,6,6,45,80,35,45,18,35,2,4,12,53,80,8,7,38,75,32,38,16,37,3,6,12,48,75
2003-01-06 00:00:00.000,Auckland New Zealand ATP World Tour,HARD,2,Kenneth Carlsen,Andre Sa,Kenneth Carlsen,6-7(7); 7-5; 6-4,R32,157,9,1,70,108,49,70,26,38,4,6,17,75,108,7,0,64,107,42,64,28,43,4,8,17,70,107
2003-01-06 00:00:00.000,Auckland New Zealand ATP World Tour,HARD,2,Felix Mantilla,Jose Acasuso,Felix Mantilla,6-3; 7-5,R32,68,5,3,32,55,27,32,13,23,0,1,11,40,55,6,3,30,54,20,30,11,24,1,4,10,31,54
2003-01-06 00:00:00.000,Auckland New Zealand ATP World Tour,HARD,2,Fernando Gonzalez,Feliciano Lopez,Fernando Gonzalez,3-6; 7-6(5); 6-2,R32,99,10,3,59,78,44,59,14,19,2,3,14,58,78,13,6,61,107,43,61,26,46,7,9,15,69,107
2003-01-06 00:00:00.000,Auckland New Zealand ATP World Tour,HARD,2,David Ferrer,Alberto Martin,David Ferrer,6-3; 6-2,R32,72,4,3,37,71,29,37,17,34,6,6,9,46,71,0,1,31,50,18,31,10,19,3,6,8,28,50
2003-01-06 00:00:00.000,Auckland New Zealand ATP World Tour,HARD,2,Dominik Hrbaty,Simon Rea,Dominik Hrbaty,6-4; 6-2,R32,70,7,2,28,47,23,28,13,19,0,1,9,36,47,1,7,48,81,28,48,13,33,7,11,9,41,81
2003-01-06 00:00:00.000,Auckland New Zealand ATP World Tour,HARD,2,Jan-Michael Gambill,Michel Kratochvil,Jan-Michael Gambill,6-1; 6-3,R32,63,12,0,30,48,23,30,12,18,4,4,8,35,48,0,2,20,50,11,20,15,30,1,5,8,26,50
2003-01-06 00:00:00.000,Auckland New Zealand ATP World Tour,HARD,2,Guillermo Coria,David Sanchez,Guillermo Coria,2-6; 6-2; 6-4,R32,117,1,3,52,91,36,52,14,39,13,17,13,50,91,2,0,51,82,29,51,17,31,7,12,13,46,82
2003-01-06 00:00:00.000,Auckland New Zealand ATP World Tour,HARD,2,Fernando Vicente,Luis Horna,Fernando Vicente,3-6; 7-6(5); 6-2,R32,133,13,1,50,89,39,50,25,39,4,5,14,64,89,3,4,89,120,57,89,15,31,8,10,15,72,120
2003-01-06 00:00:00.000,Auckland New Zealand ATP World Tour,HARD,2,Michael Russell,Radek Stepanek,Michael Russell,7-6(4); 6-4,R32,86,2,4,53,73,37,53,11,20,8,10,11,48,73,9,6,46,79,31,46,13,33,5,8,11,44,79
2003-01-06 00:00:00.000,Auckland New Zealand ATP World Tour,HARD,2,Gustavo Kuerten,Martin Verkerk,Gustavo Kuerten,7-6(5); 6-4,R32,88,8,2,43,77,37,43,16,34,2,3,11,53,77,10,6,28,68,17,28,26,40,3,5,11,43,68
2003-01-06 00:00:00.000,Auckland New Zealand ATP World Tour,HARD,2,Raemon Sluiter,Davide Sanguinetti,Raemon Sluiter,6-3; 6-3,R32,65,7,3,32,60,26,32,16,28,6,6,9,42,60,4,1,36,71,26,36,14,35,3,6,9,40,71
2003-01-06 00:00:00.000,Auckland New Zealand ATP World Tour,HARD,2,Stefan Koubek,Mark Nielsen,Stefan Koubek,6-3; 6-2,R32,72,1,4,31,49,24,31,6,18,2,4,8,30,49,1,11,31,68,20,31,11,37,5,11,9,31,68
2003-01-06 00:00:00.000,Auckland New Zealand ATP World Tour,HARD,2,Vincent Spadea,Antony Dupuis,Vincent Spadea,6-3; 6-4,R32,70,6,1,27,53,22,27,18,26,0,0,10,40,53,6,5,30,59,22,30,14,29,1,3,9,36,59
2003-01-06 00:00:00.000,Auckland New Zealand ATP World Tour,HARD,2,Mariano Zabaleta,David Nalbandian,Mariano Zabaleta,2-6; 7-6(3); 6-3,R32,123,5,3,48,89,32,48,21,41,5,10,15,53,89,4,6,65,96,37,65,19,31,3,7,14,56,96
2003-01-06 00:00:00.000,Auckland New Zealand ATP World Tour,HARD,2,Jiri Novak,Robby Ginepri,Jiri Novak,1-6; 7-6(6); 6-3,R16,95,1,6,66,96,39,66,12,30,10,16,13,51,96,12,12,65,100,45,65,10,35,7,13,15,55,100
2003-01-06 00:00:00.000,Auckland New Zealand ATP World Tour,HARD,2,Felix Mantilla,Kenneth Carlsen,Felix Mantilla,6-4; 6-4,R16,72,0,1,21,51,15,21,23,30,0,1,10,38,51,4,1,32,51,21,32,12,19,3,6,10,33,51
2003-01-06 00:00:00.000,Auckland New Zealand ATP World Tour,HARD,2,David Ferrer,Fernando Gonzalez,David Ferrer,6-4; 6-3,R16,65,2,6,29,57,24,29,14,28,2,3,9,38,57,2,2,50,70,30,50,8,20,5,9,10,38,70
2003-01-06 00:00:00.000,Auckland New Zealand ATP World Tour,HARD,2,Dominik Hrbaty,Jan-Michael Gambill,Dominik Hrbaty,6-3; 6-7(6); 7-6(4),R16,138,10,1,73,106,50,73,20,33,4,6,16,70,106,20,4,71,119,52,71,23,48,7,11,17,75,119
2003-01-06 00:00:00.000,Auckland New Zealand ATP World Tour,HARD,2,Guillermo Coria,Fernando Vicente,Guillermo Coria,6-2; 6-2,R16,59,3,1,32,48,23,32,12,16,2,2,8,35,48,2,3,28,54,17,28,12,26,5,9,8,29,54
2003-01-06 00:00:00.000,Auckland New Zealand ATP World Tour,HARD,2,Gustavo Kuerten,Michael Russell,Gustavo Kuerten,4-6; 6-4; 6-2,R16,88,6,5,42,83,33,42,22,41,6,9,14,55,83,0,5,53,85,33,53,14,32,10,15,14,47,85
2003-01-06 00:00:00.000,Auckland New Zealand ATP World Tour,HARD,2,Stefan Koubek,Raemon Sluiter,Stefan Koubek,6-3; 3-6; 6-1,R16,78,6,3,37,71,31,37,22,34,1,2,13,53,71,6,9,45,88,33,45,18,43,6,9,12,51,88
2003-01-06 00:00:00.000,Auckland New Zealand ATP World Tour,HARD,2,Mariano Zabaleta,Vincent Spadea,Mariano Zabaleta,6-4; 6-3,R16,71,2,3,23,44,19,23,12,21,0,2,9,31,44,4,7,33,65,19,33,14,32,3,8,10,33,65
2003-01-06 00:00:00.000,Auckland New Zealand ATP World Tour,HARD,2,Felix Mantilla,Jiri Novak,Felix Mantilla,6-7(5); 6-2; 7-6(3),Q,131,5,3,41,90,33,41,28,49,1,4,16,61,90,4,2,68,114,36,68,29,46,5,10,16,65,114
2003-01-06 00:00:00.000,Auckland New Zealand ATP World Tour,HARD,2,Dominik Hrbaty,David Ferrer,Dominik Hrbaty,7-5; 6-3,Q,76,4,4,41,70,33,41,14,29,5,6,11,47,70,1,6,24,60,20,24,17,36,1,4,10,37,60
2003-01-06 00:00:00.000,Auckland New Zealand ATP World Tour,HARD,2,Gustavo Kuerten,Guillermo Coria,Gustavo Kuerten,7-5; 4-6; 6-2,Q,94,12,1,52,85,34,52,20,33,0,3,15,54,85,6,2,58,88,39,58,12,30,3,8,15,51,88
2003-01-06 00:00:00.000,Auckland New Zealand ATP World Tour,HARD,2,Mariano Zabaleta,Stefan Koubek,Mariano Zabaleta,6-2; 6-1,Q,55,3,2,22,45,17,22,15,23,2,2,7,32,45,4,4,37,58,20,37,8,21,8,13,8,28,58
2003-01-06 00:00:00.000,Auckland New Zealand ATP World Tour,HARD,2,Dominik Hrbaty,Felix Mantilla,Dominik Hrbaty,6-2; 6-2,S,59,5,1,33,53,21,33,15,20,5,5,8,36,53,2,2,16,42,8,16,15,26,0,4,8,23,42
2003-01-06 00:00:00.000,Auckland New Zealand ATP World Tour,HARD,2,Gustavo Kuerten,Mariano Zabaleta,Gustavo Kuerten,6-3; 6-3,S,80,3,2,25,58,18,25,20,33,4,5,9,38,58,2,3,33,63,21,33,14,30,5,9,9,35,63
2003-01-06 00:00:00.000,Auckland New Zealand ATP World Tour,HARD,2,Gustavo Kuerten,Dominik Hrbaty,Gustavo Kuerten,6-3; 7-5,F,81,5,4,30,64,28,30,17,34,2,2,10,45,64,3,4,43,68,32,43,8,25,4,7,11,40,68
2003-01-06 00:00:00.000,Sydney Australia ATP World Tour,HARD,2,Marat Safin,Olivier Rochus,Marat Safin,6-1; 6-4,R32,65,5,0,32,53,28,32,10,21,0,1,9,38,53,0,2,34,62,19,34,14,28,6,10,8,33,62
2003-01-06 00:00:00.000,Sydney Australia ATP World Tour,HARD,2,Jarkko Nieminen,Peter Luczak,Jarkko Nieminen,6-0; 3-6; 7-5,R32,108,2,3,44,75,34,44,16,31,4,6,13,50,75,3,2,55,101,35,55,20,46,7,12,14,55,101
2003-01-06 00:00:00.000,Sydney Australia ATP World Tour,HARD,2,Hyung-Taik Lee,Nicolas Lapentti,Hyung-Taik Lee,6-2; 6-0,R32,58,1,2,24,39,19,24,10,15,2,2,7,29,39,3,7,34,58,19,34,5,24,9,14,7,24,58
2003-01-06 00:00:00.000,Sydney Australia ATP World Tour,HARD,2,Andy Roddick,Tommy Robredo,Andy Roddick,6-2; 6-2,R32,58,6,0,22,41,18,22,15,19,2,2,8,33,41,2,2,26,50,15,26,11,24,2,6,8,26,50
2003-01-06 00:00:00.000,Sydney Australia ATP World Tour,HARD,2,Franco Squillari,Roger Federer,Franco Squillari,6-2; 6-3,R32,54,4,1,32,47,24,32,10,15,1,1,8,34,47,3,5,42,63,26,42,7,21,4,8,9,33,63
2003-01-06 00:00:00.000,Sydney Australia ATP World Tour,HARD,2,Nikolay Davydenko,Raphael Durek,Nikolay Davydenko,6-3; 6-4,R32,66,0,2,34,52,21,34,10,18,2,5,9,31,52,1,0,50,71,23,50,10,21,4,10,10,33,71
2003-01-06 00:00:00.000,Sydney Australia ATP World Tour,HARD,2,Wayne Ferreira,Thomas Enqvist,Wayne Ferreira,6-2; 6-4,R32,67,13,0,31,57,24,31,15,26,6,7,9,39,57,1,1,27,55,17,27,13,28,5,9,9,30,55
2003-01-06 00:00:00.000,Sydney Australia ATP World Tour,HARD,2,Juan Ignacio Chela,Albert Costa,Juan Ignacio Chela,7-6(4); 6-1,R32,68,2,3,41,70,33,41,17,29,3,4,10,50,70,0,0,41,51,25,41,7,10,1,4,9,32,51
2003-01-06 00:00:00.000,Sydney Australia ATP World Tour,HARD,2,Gaston Gaudio,Todd Reid,Gaston Gaudio,6-7(5); 6-2; 7-5,R32,80,8,7,60,104,44,60,25,44,4,6,16,69,104,2,2,78,124,51,78,19,46,10,15,16,70,124
2003-01-06 00:00:00.000,Sydney Australia ATP World Tour,HARD,2,Rainer Schuettler,Ivan Ljubicic,Rainer Schuettler,6-2; 7-6(1),R32,60,1,2,47,61,30,47,8,14,1,4,10,38,61,1,5,48,82,28,48,12,34,10,15,10,40,82
2003-01-06 00:00:00.000,Sydney Australia ATP World Tour,HARD,2,Mardy Fish,Richard Krajicek,Mardy Fish,7-6(0); 6-4,R32,62,7,4,36,68,33,36,14,32,2,4,11,47,68,9,5,36,70,26,36,16,34,1,4,11,42,70
2003-01-06 00:00:00.000,Sydney Australia ATP World Tour,HARD,2,Carlos Moya,James Blake,Carlos Moya,6-3; 6-7(6); 6-3,R32,68,5,0,55,87,40,55,20,32,3,4,14,60,87,4,7,76,117,53,76,15,41,9,14,16,68,117
2003-01-06 00:00:00.000,Sydney Australia ATP World Tour,HARD,2,Paradorn Srichaphan,Scott Draper,Paradorn Srichaphan,6-4; 3-6; 6-1,R32,65,9,3,41,83,32,41,24,42,5,6,13,56,83,8,3,60,95,39,60,18,35,4,7,13,57,95
2003-01-06 00:00:00.000,Sydney Australia ATP World Tour,HARD,2,Max Mirnyi,Xavier Malisse,Max Mirnyi,7-6(5); 6-7(5); 6-3,R32,126,8,6,75,118,57,75,20,43,6,9,17,77,118,12,8,73,118,51,73,22,45,11,15,16,73,118
2003-01-06 00:00:00.000,Sydney Australia ATP World Tour,HARD,2,Mikhail Youzhny,Adrian Voinea,Mikhail Youzhny,3-6; 2-1 RET,R32,54,0,0,25,40,18,25,6,15,3,5,6,24,40,3,2,18,37,13,18,9,19,1,2,6,22,37
2003-01-06 00:00:00.000,Sydney Australia ATP World Tour,HARD,2,Juan Carlos Ferrero,Jaymon Crabb,Juan Carlos Ferrero,5-7; 7-5; 6-3,R32,131,6,4,63,96,42,63,20,33,1,4,16,62,96,6,7,68,113,46,68,21,45,8,13,17,67,113
2003-01-06 00:00:00.000,Sydney Australia ATP World Tour,HARD,2,Marat Safin,Jarkko Nieminen,Marat Safin,3-6; 6-1; 6-2,R16,91,7,3,43,81,34,43,18,38,7,8,12,52,81,1,1,48,69,28,48,14,21,5,9,12,42,69
2003-01-06 00:00:00.000,Sydney Australia ATP World Tour,HARD,2,Hyung-Taik Lee,Andy Roddick,Hyung-Taik Lee,7-6(5); 7-5,R16,161,4,2,55,82,39,55,15,27,3,5,12,54,82,10,5,53,89,35,53,18,36,6,9,12,53,89
2003-01-06 00:00:00.000,Sydney Australia ATP World Tour,HARD,2,Franco Squillari,Nikolay Davydenko,Franco Squillari,6-1; 6-4,R16,62,2,0,33,51,24,33,14,18,1,1,9,38,51,3,2,44,55,24,44,6,11,6,9,8,30,55
2003-01-06 00:00:00.000,Sydney Australia ATP World Tour,HARD,2,Wayne Ferreira,Juan Ignacio Chela,Wayne Ferreira,6-7(5); 6-4; 6-4,R16,135,4,3,68,119,49,68,27,51,9,11,16,76,119,4,2,86,118,57,86,16,32,14,18,16,73,118
2003-01-06 00:00:00.000,Sydney Australia ATP World Tour,HARD,2,Rainer Schuettler,Gaston Gaudio,Rainer Schuettler,7-6(5); 6-0,R16,90,2,2,31,57,23,31,12,26,3,6,9,35,57,0,3,42,68,18,42,11,26,4,10,9,29,68
2003-01-06 00:00:00.000,Sydney Australia ATP World Tour,HARD,2,Mardy Fish,Carlos Moya,Mardy Fish,7-6(4); 4-6; 6-4,R16,126,12,1,55,97,42,55,21,42,4,8,16,63,97,6,11,57,108,46,57,22,51,5,9,16,68,108
2003-01-06 00:00:00.000,Sydney Australia ATP World Tour,HARD,2,Paradorn Srichaphan,Max Mirnyi,Paradorn Srichaphan,3-6; 6-4; 6-4,R16,103,7,6,46,77,36,46,19,31,5,7,14,55,77,6,1,57,85,44,57,11,28,0,3,15,55,85
2003-01-06 00:00:00.000,Sydney Australia ATP World Tour,HARD,2,Juan Carlos Ferrero,Mikhail Youzhny,Juan Carlos Ferrero,6-3; 6-2,R16,63,5,1,27,49,19,27,17,22,2,3,9,36,49,0,2,28,56,17,28,10,28,5,9,8,27,56
2003-01-06 00:00:00.000,Sydney Australia ATP World Tour,HARD,2,Hyung-Taik Lee,Marat Safin,Hyung-Taik Lee,W/O,Q,0,0,0,0,0,0,0,0,0,0,0,0,0,0,0,0,0,0,0,0,0,0,0,0,0,0,0
2003-01-06 00:00:00.000,Sydney Australia ATP World Tour,HARD,2,Wayne Ferreira,Franco Squillari,Wayne Ferreira,6-0; 6-4,Q,61,3,1,23,40,22,23,10,17,0,0,8,32,40,3,3,29,62,17,29,15,33,5,9,8,32,62
2003-01-06 00:00:00.000,Sydney Australia ATP World Tour,HARD,2,Rainer Schuettler,Mardy Fish,Rainer Schuettler,7-6(5); 6-4,Q,92,2,2,44,65,35,44,13,21,6,7,11,48,65,11,1,44,79,35,44,14,35,1,3,11,49,79
2003-01-06 00:00:00.000,Sydney Australia ATP World Tour,HARD,2,Juan Carlos Ferrero,Paradorn Srichaphan,Juan Carlos Ferrero,6-3; 6-1,Q,67,5,2,38,55,30,38,7,17,4,4,8,37,55,4,0,31,57,21,31,8,26,6,10,8,29,57
2003-01-06 00:00:00.000,Sydney Australia ATP World Tour,HARD,2,Hyung-Taik Lee,Wayne Ferreira,Hyung-Taik Lee,6-3; 6-3,S,61,3,1,33,43,30,33,6,10,0,0,9,36,43,4,1,34,55,24,34,10,21,4,7,9,34,55
2003-01-06 00:00:00.000,Sydney Australia ATP World Tour,HARD,2,Juan Carlos Ferrero,Rainer Schuettler,Juan Carlos Ferrero,3-6; 6-3; 6-2,S,66,3,1,56,86,40,56,13,30,8,11,13,53,86,8,5,52,86,32,52,16,34,4,9,13,48,86
2003-01-06 00:00:00.000,Sydney Australia ATP World Tour,HARD,2,Hyung-Taik Lee,Juan Carlos Ferrero,Hyung-Taik Lee,4-6; 7-6(6); 7-6(4),F,164,8,2,78,112,56,78,22,34,4,7,17,78,112,11,6,80,131,60,80,25,51,7,9,17,85,131
2003-01-13 00:00:00.000,Australian Open Australia Grand Slams,HARD,3,Lleyton Hewitt,Magnus Larsson,Lleyton Hewitt,6-3; 3-6; 6-1; 6-7(3); 6-2,R128,193,14,7,72,138,56,72,42,66,4,5,23,98,138,10,8,93,148,67,93,25,55,6,11,22,92,148
2003-01-13 00:00:00.000,Australian Open Australia Grand Slams,HARD,3,Todd Larkham,Cecil Mamiit,Todd Larkham,6-7(5); 6-3; 7-6(5); 6-4,R128,212,2,4,122,162,71,122,20,40,6,13,22,91,162,1,5,75,134,49,75,23,59,6,15,21,72,134
2003-01-13 00:00:00.000,Australian Open Australia Grand Slams,HARD,3,Radek Stepanek,Kenneth Carlsen,Radek Stepanek,6-0; 7-5; 6-1,R128,110,3,2,43,77,33,43,19,34,6,8,13,52,77,2,3,39,73,21,39,10,34,5,13,12,31,73
2003-01-13 00:00:00.000,Australian Open Australia Grand Slams,HARD,3,Gustavo Kuerten,Hicham Arazi,Gustavo Kuerten,6-4; 7-6(8); 6-3,R128,143,14,2,68,106,55,68,18,38,5,7,16,73,106,2,1,59,101,40,59,20,42,5,9,15,60,101
2003-01-13 00:00:00.000,Australian Open Australia Grand Slams,HARD,3,Younes El Aynaoui,Justin Gimelstob,Younes El Aynaoui,2-6; 4-6; 6-4; 1-0 RET,R128,116,4,6,66,103,47,66,15,37,8,12,15,62,103,9,3,49,81,40,49,16,32,4,6,14,56,81
2003-01-13 00:00:00.000,Australian Open Australia Grand Slams,HARD,3,Vadim Kutsenko,Ivan Ljubicic,Vadim Kutsenko,6-3; 6-4; 1-6; 4-6; 6-3,R128,182,5,2,79,156,55,79,37,77,7,12,23,92,156,23,5,71,130,55,71,27,59,1,6,22,82,130
2003-01-13 00:00:00.000,Australian Open Australia Grand Slams,HARD,3,Robby Ginepri,Marc Rosset,Robby Ginepri,6-3; 6-4; 6-2,R128,98,9,2,62,85,48,62,11,23,5,6,14,59,85,7,13,44,94,33,44,17,50,14,19,13,50,94
2003-01-13 00:00:00.000,Australian Open Australia Grand Slams,HARD,3,Feliciano Lopez,Alex Corretja,Feliciano Lopez,6-7(3); 7-6(9); 7-6(6); 6-3,R128,184,17,4,89,154,68,89,45,65,4,5,23,113,154,12,5,89,145,66,89,40,56,2,4,22,106,145
2003-01-13 00:00:00.000,Australian Open Australia Grand Slams,HARD,3,Andy Roddick,Zeljko Krajan,Andy Roddick,6-7(9); 6-2; 7-6(0); 6-3,R128,165,19,2,91,140,70,91,27,49,10,12,21,97,140,10,7,83,127,56,83,25,44,4,9,20,81,127
2003-01-13 00:00:00.000,Australian Open Australia Grand Slams,HARD,3,Adrian Voinea,Andre Sa,Adrian Voinea,6-2; 7-6(2); 6-4,R128,126,11,3,58,104,47,58,23,46,6,8,15,70,104,1,2,75,107,46,75,15,32,12,17,15,61,107
2003-01-13 00:00:00.000,Australian Open Australia Grand Slams,HARD,3,Fernando Vicente,Luis Horna,Fernando Vicente,3-6; 4-6; 6-3; 7-6(3); 6-1,R128,160,26,3,86,139,63,86,35,53,2,6,24,98,139,0,6,107,141,72,107,15,34,6,11,23,87,141
2003-01-13 00:00:00.000,Australian Open Australia Grand Slams,HARD,3,Juan Ignacio Chela,Karol Beck,Juan Ignacio Chela,6-4; 3-6; 6-1; 6-0,R128,142,5,4,59,108,46,59,23,49,5,7,16,69,108,7,11,55,111,36,55,21,56,10,17,16,57,111
2003-01-13 00:00:00.000,Australian Open Australia Grand Slams,HARD,3,Mikhail Youzhny,Richard Gasquet,Mikhail Youzhny,3-6; 6-0; 6-1; 6-4,R128,125,4,4,61,97,46,61,18,36,6,8,16,64,97,0,6,49,98,31,49,19,49,5,12,16,50,98
2003-01-13 00:00:00.000,Australian Open Australia Grand Slams,HARD,3,Joseph Sirianni,Max Mirnyi,Joseph Sirianni,6-3; 6-4; 6-4,R128,125,5,5,55,98,44,55,24,43,4,4,15,68,98,3,0,65,92,42,65,16,27,6,9,14,58,92
2003-01-13 00:00:00.000,Australian Open Australia Grand Slams,HARD,3,Olivier Rochus,Arnaud Di Pasquale,Olivier Rochus,4-6; 4-6; 6-3; 6-3; 6-4,R128,187,2,5,128,160,73,128,16,32,15,24,24,89,160,6,12,101,148,58,101,20,47,10,21,24,78,148
2003-01-13 00:00:00.000,Australian Open Australia Grand Slams,HARD,3,Jiri Novak,Vincent Spadea,Jiri Novak,6-2; 2-6; 6-2; 7-6(3),R128,122,7,2,75,107,56,75,18,32,5,9,18,74,107,5,7,68,112,42,68,20,44,5,11,18,62,112
2003-01-13 00:00:00.000,Australian Open Australia Grand Slams,HARD,3,Marat Safin,Raemon Sluiter,Marat Safin,6-4; 4-6; 6-3; 6-4,R128,153,13,2,69,123,51,69,32,54,9,12,20,83,123,5,3,74,117,50,74,18,43,7,12,19,68,117
2003-01-13 00:00:00.000,Australian Open Australia Grand Slams,HARD,3,Albert Montanes,Mariano Puerta,Albert Montanes,6-2; 6-4; 6-4,R128,102,15,1,51,80,41,51,19,29,2,2,14,60,80,4,5,60,88,41,60,12,28,5,9,14,53,88
2003-01-13 00:00:00.000,Australian Open Australia Grand Slams,HARD,3,Richard Krajicek,Todd Reid,Richard Krajicek,3-6; 6-2; 6-2; 6-1,R128,110,19,4,38,84,37,38,24,46,2,3,16,61,84,3,5,75,110,47,75,13,35,12,18,16,60,110
2003-01-13 00:00:00.000,Australian Open Australia Grand Slams,HARD,3,Rainer Schuettler,Albert Portas,Rainer Schuettler,6-3; 6-2; 6-0,R128,93,4,1,36,62,25,36,18,26,0,2,12,43,62,3,7,44,82,22,44,13,38,8,16,11,35,82
2003-01-13 00:00:00.000,Australian Open Australia Grand Slams,HARD,3,James Blake,Jiri Vanek,James Blake,7-6(2); 6-4; 6-4,R128,111,6,4,55,103,44,55,26,48,4,6,16,70,103,8,3,49,98,34,49,27,49,4,8,16,61,98
2003-01-13 00:00:00.000,Australian Open Australia Grand Slams,HARD,3,Jose Acasuso,Gregory Carraz,Jose Acasuso,5-7; 4-3 RET,R128,64,3,3,34,57,24,34,15,23,1,2,9,39,57,13,4,33,53,27,33,13,20,1,2,10,40,53
2003-01-13 00:00:00.000,Australian Open Australia Grand Slams,HARD,3,Alberto Martin,Alex Bogomolov Jr.,Alberto Martin,6-2; 6-4; 6-7(3); 4-6; 6-1,R128,191,1,5,97,149,62,97,27,52,4,10,24,89,149,1,5,97,140,56,97,18,43,6,16,23,74,140
2003-01-13 00:00:00.000,Australian Open Australia Grand Slams,HARD,3,Fernando Gonzalez,Julien Varlet,Fernando Gonzalez,6-2; 3-6; 4-6; 6-3; 6-4,R128,177,13,12,86,150,64,86,33,64,4,7,23,97,150,5,3,109,147,69,109,23,38,7,12,23,92,147
2003-01-13 00:00:00.000,Australian Open Australia Grand Slams,HARD,3,David Nalbandian,Jerome Golmard,David Nalbandian,3-6; 6-3; 6-1 RET,R128,93,4,3,34,70,27,34,20,36,0,3,13,47,70,2,5,50,83,30,50,15,33,4,9,12,45,83
2003-01-13 00:00:00.000,Australian Open Australia Grand Slams,HARD,3,Jaymon Crabb,Andrew Ilie,Jaymon Crabb,6-3; 3-6; 7-6(3); 6-4,R128,138,4,1,85,137,59,85,33,52,12,15,20,92,137,11,4,74,122,53,74,23,48,3,7,20,76,122
2003-01-13 00:00:00.000,Australian Open Australia Grand Slams,HARD,3,Antony Dupuis,Jacobo Diaz,Antony Dupuis,6-4; 6-3; 6-3,R128,100,11,2,37,74,33,37,25,37,0,0,14,58,74,6,6,54,89,36,54,18,35,4,8,14,54,89
2003-01-13 00:00:00.000,Australian Open Australia Grand Slams,HARD,3,Xavier Malisse,Dominik Hrbaty,Xavier Malisse,6-2; 6-3; 6-2,R128,97,4,5,30,77,26,30,26,47,2,4,13,52,77,4,6,44,78,26,44,12,34,4,11,12,38,78
2003-01-13 00:00:00.000,Australian Open Australia Grand Slams,HARD,3,Andreas Vinciguerra,Stefan Koubek,Andreas Vinciguerra,6-4; 6-4; 6-1,R128,81,4,1,49,80,36,49,16,31,3,5,13,52,80,3,3,47,79,26,47,15,32,2,9,14,41,79
2003-01-13 00:00:00.000,Australian Open Australia Grand Slams,HARD,3,Julian Knowle,Ryan Henry,Julian Knowle,5-7; 6-4; 6-2; 7-5,R128,166,0,7,69,115,45,69,27,46,3,8,21,72,115,10,5,74,131,49,74,27,57,3,11,21,76,131
2003-01-13 00:00:00.000,Australian Open Australia Grand Slams,HARD,3,Lars Burgsmuller,Juan Balcells,Lars Burgsmuller,6-4; 7-5; 7-5,R128,123,4,4,64,98,50,64,22,34,4,5,17,72,98,4,4,77,111,50,77,18,34,5,9,17,68,111
2003-01-13 00:00:00.000,Australian Open Australia Grand Slams,HARD,3,Roger Federer,Flavio Saretta,Roger Federer,7-6(4); 7-5; 6-3,R128,168,8,8,70,126,48,70,28,56,9,12,16,76,126,3,2,67,139,47,67,29,72,11,17,17,76,139
2003-01-13 00:00:00.000,Australian Open Australia Grand Slams,HARD,3,Carlos Moya,Dick Norman,Carlos Moya,7-5; 6-3; 6-4,R128,106,8,2,47,88,38,47,28,41,2,3,16,66,88,9,4,60,105,42,60,21,45,7,11,15,63,105
2003-01-13 00:00:00.000,Australian Open Australia Grand Slams,HARD,3,Mardy Fish,Joachim Johansson,Mardy Fish,6-3; 7-5; 6-2,R128,104,17,2,46,83,38,46,25,37,3,3,15,63,83,9,4,47,89,36,47,17,42,8,12,14,53,89
2003-01-13 00:00:00.000,Australian Open Australia Grand Slams,HARD,3,Michel Kratochvil,Davide Sanguinetti,Michel Kratochvil,6-3; 6-0; 6-3,R128,80,4,4,40,68,31,40,15,28,1,3,12,46,68,4,3,44,77,17,44,17,33,5,13,12,34,77
2003-01-13 00:00:00.000,Australian Open Australia Grand Slams,HARD,3,Wayne Ferreira,Tommy Robredo,Wayne Ferreira,5-7; 6-0; 6-3; 6-4,R128,123,6,4,63,102,51,63,21,39,1,4,19,72,102,5,3,87,119,51,87,15,32,8,15,18,66,119
2003-01-13 00:00:00.000,Australian Open Australia Grand Slams,HARD,3,Gaston Gaudio,Thomas Enqvist,Gaston Gaudio,7-5; 7-5; 6-2,R128,147,5,5,66,113,47,66,20,47,11,15,16,67,113,7,5,60,104,34,60,19,44,5,13,16,53,104
2003-01-13 00:00:00.000,Australian Open Australia Grand Slams,HARD,3,Sargis Sargsian,Agustin Calleri,Sargis Sargsian,6-4; 3-6; 7-6(4); 6-0,R128,157,6,8,61,106,42,61,25,45,4,8,18,67,106,7,5,64,128,40,64,29,64,5,12,19,69,128
2003-01-13 00:00:00.000,Australian Open Australia Grand Slams,HARD,3,Mark Philippoussis,Martin Verkerk,Mark Philippoussis,6-4; 6-4; 6-7(5); 6-3,R128,165,23,8,77,119,71,77,22,42,4,4,21,93,119,23,3,84,134,64,84,27,50,8,11,20,91,134
2003-01-13 00:00:00.000,Australian Open Australia Grand Slams,HARD,3,Paradorn Srichaphan,Jurgen Melzer,Paradorn Srichaphan,7-5; 6-4; 1-6; 6-0,R128,138,9,1,57,90,46,57,22,33,4,6,17,68,90,7,7,73,145,46,73,36,72,16,21,18,82,145
2003-01-13 00:00:00.000,Australian Open Australia Grand Slams,HARD,3,Sjeng Schalken,Jack Brasington,Sjeng Schalken,6-4; 6-2; 7-6(5),R128,125,2,3,51,86,37,51,23,35,1,3,15,60,86,1,7,65,109,40,65,22,44,5,10,15,62,109
2003-01-13 00:00:00.000,Australian Open Australia Grand Slams,HARD,3,Mario Ancic,Alexander Waske,Mario Ancic,6-3; 6-4; 7-6(4),R128,143,4,3,44,92,35,44,29,48,5,7,16,64,92,5,4,74,110,43,74,18,36,9,13,15,61,110
2003-01-13 00:00:00.000,Australian Open Australia Grand Slams,HARD,3,Peter Luczak,Attila Savolt,Peter Luczak,7-5; 6-2; 6-4,R128,121,6,5,57,81,51,57,13,24,0,0,15,64,81,5,7,53,92,34,53,21,39,2,6,15,55,92
2003-01-13 00:00:00.000,Australian Open Australia Grand Slams,HARD,3,Renzo Furlan,Andrei Pavel,Renzo Furlan,4-1 RET,R128,13,1,0,6,10,4,6,4,4,0,0,2,8,10,0,0,13,16,6,13,0,3,1,3,3,6,16
2003-01-13 00:00:00.000,Australian Open Australia Grand Slams,HARD,3,Fabrice Santoro,Bjorn Phau,Fabrice Santoro,6-4; 6-3; 6-4,R128,106,1,0,45,82,36,45,23,37,2,4,15,59,82,1,1,56,86,34,56,15,30,3,8,14,49,86
2003-01-13 00:00:00.000,Australian Open Australia Grand Slams,HARD,3,Wayne Arthurs,Marcos Daniel,Wayne Arthurs,6-7(5); 3-6; 7-6(5); 6-4; 6-4,R128,213,32,9,82,145,75,82,36,63,1,2,26,111,145,6,5,129,199,91,129,41,70,13,15,27,132,199
2003-01-13 00:00:00.000,Australian Open Australia Grand Slams,HARD,3,Jean-Rene Lisnard,Andrea Gaudenzi,Jean-Rene Lisnard,6-4; 2-6; 6-1; 4-6; 6-1,R128,185,3,5,78,129,52,78,28,51,6,11,21,80,129,1,7,83,137,53,83,24,54,12,20,21,77,137
2003-01-13 00:00:00.000,Australian Open Australia Grand Slams,HARD,3,Juan Carlos Ferrero,Franco Squillari,Juan Carlos Ferrero,7-6(5); 3-6; 6-2; 6-3,R128,156,6,3,71,111,49,71,23,40,4,8,19,72,111,11,7,72,128,50,72,24,56,12,18,19,74,128
2003-01-13 00:00:00.000,Australian Open Australia Grand Slams,HARD,3,Albert Costa,David Prinosil,Albert Costa,6-4; 6-1; 3-6; 7-6(5),R128,185,3,4,81,126,56,81,20,45,10,15,19,76,126,5,11,91,150,58,91,27,59,14,21,19,85,150
2003-01-13 00:00:00.000,Australian Open Australia Grand Slams,HARD,3,Scott Draper,Alex Kim,Scott Draper,7-5; 6-3; 3-6; 6-3,R128,133,8,3,65,115,47,65,27,50,8,12,20,74,115,3,8,74,123,47,74,26,49,5,11,19,73,123
2003-01-13 00:00:00.000,Australian Open Australia Grand Slams,HARD,3,Felix Mantilla,Mariano Zabaleta,Felix Mantilla,4-6; 7-5; 6-3; 4-6; 6-4,R128,219,4,12,100,163,76,100,29,63,7,11,26,105,163,15,2,100,152,70,100,26,52,8,13,25,96,152
2003-01-13 00:00:00.000,Australian Open Australia Grand Slams,HARD,3,Jan-Michael Gambill,Michael Llodra,Jan-Michael Gambill,6-2; 7-5; 6-7(3); 4-6; 6-2,R128,187,20,7,94,158,72,94,37,64,11,12,25,109,158,18,12,90,159,68,90,37,69,9,14,25,105,159
2003-01-13 00:00:00.000,Australian Open Australia Grand Slams,HARD,3,Nicolas Lapentti,Julien Benneteau,Nicolas Lapentti,6-0; 6-4; 6-0,R128,107,4,1,74,95,49,74,10,21,4,5,11,59,95,1,2,40,63,18,40,7,23,4,12,11,25,63
2003-01-13 00:00:00.000,Australian Open Australia Grand Slams,HARD,3,David Sanchez,Kristian Pless,David Sanchez,5-7; 6-3; 1-6; 6-4; 10-8,R128,195,8,14,99,177,71,99,37,78,11,18,28,108,177,14,9,96,170,70,96,35,74,7,14,28,105,170
2003-01-13 00:00:00.000,Australian Open Australia Grand Slams,HARD,3,Karol Kucera,Jan Vacek,Karol Kucera,6-2; 6-1; 6-4,R128,99,3,2,50,69,36,50,7,19,2,5,12,43,69,0,3,52,88,26,52,13,36,6,15,13,39,88
2003-01-13 00:00:00.000,Australian Open Australia Grand Slams,HARD,3,Sebastien Grosjean,Fernando Meligeni,Sebastien Grosjean,6-4; 6-2; 6-3,R128,108,3,2,49,77,39,49,20,28,1,1,14,59,77,3,3,45,83,30,45,18,38,5,9,13,48,83
2003-01-13 00:00:00.000,Australian Open Australia Grand Slams,HARD,3,Guillermo Canas,Vladimir Voltchkov,Guillermo Canas,6-3; 7-5; 6-3,R128,122,8,0,62,92,48,62,15,30,4,5,15,63,92,2,3,59,92,40,59,12,33,3,8,15,52,92
2003-01-13 00:00:00.000,Australian Open Australia Grand Slams,HARD,3,Guillermo Coria,Francisco Clavet,Guillermo Coria,6-4; 7-5; 6-1,R128,129,7,1,56,86,42,56,15,30,6,9,15,57,86,2,2,59,89,28,59,17,30,6,13,14,45,89
2003-01-13 00:00:00.000,Australian Open Australia Grand Slams,HARD,3,Jarkko Nieminen,Nikolay Davydenko,Jarkko Nieminen,6-3; 3-6; 3-6; 6-2; 7-5,R128,187,3,5,116,165,81,116,25,49,16,19,24,106,165,15,6,95,160,65,95,35,65,17,21,23,100,160
2003-01-13 00:00:00.000,Australian Open Australia Grand Slams,HARD,3,Yevgeny Kafelnikov,Jeff Morrison,Yevgeny Kafelnikov,7-6(5); 6-3; 4-6; 6-3,R128,157,3,4,66,117,42,66,33,51,3,7,20,75,117,18,6,82,163,55,82,36,81,12,18,20,91,163
2003-01-13 00:00:00.000,Australian Open Australia Grand Slams,HARD,3,Nicolas Escude,Gouichi Motomura,Nicolas Escude,6-1; 2-6; 6-3; 6-2,R128,140,6,5,48,85,37,48,23,37,2,5,16,60,85,0,6,59,122,37,59,25,63,7,14,16,62,122
2003-01-13 00:00:00.000,Australian Open Australia Grand Slams,HARD,3,Christophe Rochus,Irakli Labadze,Christophe Rochus,6-2; 6-3; 6-4,R128,104,2,4,71,102,48,71,14,31,11,14,14,62,102,4,14,47,97,29,47,17,50,10,17,13,46,97
2003-01-13 00:00:00.000,Australian Open Australia Grand Slams,HARD,3,Hyung-Taik Lee,David Ferrer,Hyung-Taik Lee,5-7; 6-2; 6-2; 6-3,R128,136,8,1,78,114,56,78,24,36,9,11,19,80,114,6,5,69,119,47,69,21,50,12,18,18,68,119
2003-01-13 00:00:00.000,Australian Open Australia Grand Slams,HARD,3,Andre Agassi,Brian Vahaly,Andre Agassi,7-5; 6-3; 6-3,R128,131,2,3,56,87,35,56,18,31,2,6,15,53,87,3,3,63,102,34,63,16,39,7,15,15,50,102
2003-01-13 00:00:00.000,Australian Open Australia Grand Slams,HARD,3,Lleyton Hewitt,Todd Larkham,Lleyton Hewitt,6-1; 6-0; 6-1,R64,74,9,3,32,51,29,32,12,19,3,3,10,41,51,1,3,38,56,17,38,3,18,5,13,10,20,56
2003-01-13 00:00:00.000,Australian Open Australia Grand Slams,HARD,3,Radek Stepanek,Gustavo Kuerten,Radek Stepanek,5-7; 6-3; 7-5; 4-6; 6-3,R64,227,24,7,105,168,82,105,30,63,6,10,26,112,168,13,2,85,174,60,85,48,89,8,14,26,108,174
2003-01-13 00:00:00.000,Australian Open Australia Grand Slams,HARD,3,Younes El Aynaoui,Vadim Kutsenko,Younes El Aynaoui,6-2; 6-1; 6-4,R64,108,15,1,45,76,41,45,10,31,2,3,12,51,76,2,3,47,92,25,47,19,45,3,10,13,44,92
2003-01-13 00:00:00.000,Australian Open Australia Grand Slams,HARD,3,Feliciano Lopez,Robby Ginepri,Feliciano Lopez,6-2; 6-4; 6-2,R64,78,9,5,45,77,36,45,17,32,2,3,13,53,77,4,5,58,80,33,58,9,22,6,12,13,42,80
2003-01-13 00:00:00.000,Australian Open Australia Grand Slams,HARD,3,Andy Roddick,Adrian Voinea,Andy Roddick,6-2; 6-2; 6-2,R64,77,13,1,40,61,35,40,13,21,0,0,12,48,61,7,5,55,88,32,55,15,33,9,15,12,47,88
2003-01-13 00:00:00.000,Australian Open Australia Grand Slams,HARD,3,Fernando Vicente,Juan Ignacio Chela,Fernando Vicente,6-3; 6-3; 2-6; 6-3,R64,144,3,6,56,106,40,56,23,50,7,11,17,63,106,2,1,55,103,34,55,24,48,0,7,18,58,103
2003-01-13 00:00:00.000,Australian Open Australia Grand Slams,HARD,3,Mikhail Youzhny,Joseph Sirianni,Mikhail Youzhny,6-2; 6-3; 6-3,R64,120,6,2,46,83,32,46,19,37,5,8,13,51,83,0,8,41,90,24,41,16,49,10,18,13,40,90
2003-01-13 00:00:00.000,Australian Open Australia Grand Slams,HARD,3,Jiri Novak,Olivier Rochus,Jiri Novak,7-6(3); 7-6(5); 4-6; 4-6; 6-3,R64,214,11,6,120,184,82,120,41,64,14,18,27,123,184,2,2,143,199,90,143,32,56,16,19,26,122,199
2003-01-13 00:00:00.000,Australian Open Australia Grand Slams,HARD,3,Marat Safin,Albert Montanes,Marat Safin,6-3; 4-6; 6-4; 6-1,R64,130,7,4,57,100,46,57,19,43,2,6,18,65,100,5,9,69,114,42,69,18,45,8,16,18,60,114
2003-01-13 00:00:00.000,Australian Open Australia Grand Slams,HARD,3,Rainer Schuettler,Richard Krajicek,Rainer Schuettler,6-3; 7-5; 6-4,R64,127,6,7,52,103,34,52,29,51,3,7,16,63,103,10,7,50,111,36,50,23,61,15,22,15,59,111
2003-01-13 00:00:00.000,Australian Open Australia Grand Slams,HARD,3,James Blake,Jose Acasuso,James Blake,6-1; 6-4; 6-4,R64,87,8,7,54,91,43,54,19,37,4,5,14,62,91,4,3,38,71,26,38,15,33,3,8,13,41,71
2003-01-13 00:00:00.000,Australian Open Australia Grand Slams,HARD,3,Alberto Martin,Fernando Gonzalez,Alberto Martin,6-7(5); 6-3; 6-1; 7-6(4),R64,182,10,9,108,159,79,108,25,51,9,10,20,104,159,10,7,88,138,59,88,22,50,6,11,20,81,138
2003-01-13 00:00:00.000,Australian Open Australia Grand Slams,HARD,3,David Nalbandian,Jaymon Crabb,David Nalbandian,6-1; 7-6(3); 6-3,R64,111,6,6,52,100,34,52,23,48,8,12,13,57,100,4,6,61,97,34,61,11,36,7,16,15,45,97
2003-01-13 00:00:00.000,Australian Open Australia Grand Slams,HARD,3,Xavier Malisse,Antony Dupuis,Xavier Malisse,6-3; 5-7; 7-6(6); 7-5,R64,172,18,5,59,128,47,59,46,69,3,6,23,93,128,12,2,73,124,59,73,29,51,4,8,22,88,124
2003-01-13 00:00:00.000,Australian Open Australia Grand Slams,HARD,3,Andreas Vinciguerra,Julian Knowle,Andreas Vinciguerra,6-2; 0-1 RET,R64,31,2,0,17,28,14,17,6,11,3,3,4,20,28,1,2,19,32,14,19,4,13,2,4,5,18,32
2003-01-13 00:00:00.000,Australian Open Australia Grand Slams,HARD,3,Roger Federer,Lars Burgsmuller,Roger Federer,6-3; 6-0; 6-3,R64,104,3,4,32,72,24,32,25,40,0,1,12,49,72,1,6,46,87,21,46,21,41,3,10,12,42,87
2003-01-13 00:00:00.000,Australian Open Australia Grand Slams,HARD,3,Mardy Fish,Carlos Moya,Mardy Fish,3-6; 7-6(8); 6-4; 4-6; 6-2,R64,179,17,1,68,128,59,68,35,60,0,3,24,94,128,7,5,107,168,77,107,29,61,5,9,25,106,168
2003-01-13 00:00:00.000,Australian Open Australia Grand Slams,HARD,3,Wayne Ferreira,Michel Kratochvil,Wayne Ferreira,6-2; 6-2; 7-5,R64,115,8,3,55,91,43,55,18,36,7,8,14,61,91,1,3,50,100,29,50,23,50,12,18,14,52,100
2003-01-13 00:00:00.000,Australian Open Australia Grand Slams,HARD,3,Sargis Sargsian,Gaston Gaudio,Sargis Sargsian,2-6; 7-5; 6-2; 6-2,R64,172,6,4,65,120,43,65,26,55,6,11,18,69,120,7,7,69,115,38,69,23,46,9,17,18,61,115
2003-01-13 00:00:00.000,Australian Open Australia Grand Slams,HARD,3,Mark Philippoussis,Paradorn Srichaphan,Mark Philippoussis,3-6; 6-1; 1-6; 7-5; 6-3,R64,159,13,5,81,131,62,81,26,50,4,7,22,88,131,17,5,60,110,50,60,29,50,0,4,22,79,110
2003-01-13 00:00:00.000,Australian Open Australia Grand Slams,HARD,3,Mario Ancic,Sjeng Schalken,Mario Ancic,6-3; 1-6; 6-7(10); 6-4; 6-4,R64,249,5,7,101,193,72,101,43,92,16,21,24,115,193,3,1,108,149,76,108,18,41,8,14,24,94,149
2003-01-13 00:00:00.000,Australian Open Australia Grand Slams,HARD,3,Peter Luczak,Renzo Furlan,Peter Luczak,7-6(2); 4-6; 6-0; 6-2,R64,156,14,3,81,121,59,81,17,40,11,14,18,76,121,8,2,77,126,45,77,22,49,5,12,18,67,126
2003-01-13 00:00:00.000,Australian Open Australia Grand Slams,HARD,3,Fabrice Santoro,Wayne Arthurs,Fabrice Santoro,6-3; 6-1 RET,R64,48,0,0,24,37,23,24,9,13,0,0,8,32,37,1,3,29,45,15,29,9,16,2,6,8,24,45
2003-01-13 00:00:00.000,Australian Open Australia Grand Slams,HARD,3,Juan Carlos Ferrero,Jean-Rene Lisnard,Juan Carlos Ferrero,6-0; 6-4; 6-2,R64,89,6,1,46,64,33,46,14,18,0,1,12,47,64,2,0,55,80,25,55,13,25,8,15,12,38,80
2003-01-13 00:00:00.000,Australian Open Australia Grand Slams,HARD,3,Albert Costa,Scott Draper,Albert Costa,6-4; 6-7(9); 6-2; 6-3,R64,177,10,3,84,130,61,84,21,46,6,10,20,82,130,11,2,78,127,47,78,22,49,10,18,19,69,127
2003-01-13 00:00:00.000,Australian Open Australia Grand Slams,HARD,3,Felix Mantilla,Jan-Michael Gambill,Felix Mantilla,5-7; 6-4; 4-6; 6-3; 6-2,R64,195,0,1,97,134,60,97,20,37,7,14,24,80,134,22,4,92,150,63,92,19,58,8,18,25,82,150
2003-01-13 00:00:00.000,Australian Open Australia Grand Slams,HARD,3,Nicolas Lapentti,David Sanchez,Nicolas Lapentti,6-1; 6-0; 2-6; 6-2,R64,148,5,6,76,112,52,76,17,36,8,10,15,69,112,1,6,58,100,32,58,18,42,7,14,14,50,100
2003-01-13 00:00:00.000,Australian Open Australia Grand Slams,HARD,3,Sebastien Grosjean,Karol Kucera,Sebastien Grosjean,7-6(2); 2-6; 6-3; 7-6(1),R64,185,4,2,60,119,48,60,34,59,2,6,20,82,119,2,5,71,128,54,71,28,57,5,9,21,82,128
2003-01-13 00:00:00.000,Australian Open Australia Grand Slams,HARD,3,Guillermo Coria,Guillermo Canas,Guillermo Coria,6-2; 4-6; 6-4; 6-4,R64,174,1,2,83,135,52,83,30,52,12,16,19,82,135,3,4,79,122,49,79,19,43,4,11,19,68,122
2003-01-13 00:00:00.000,Australian Open Australia Grand Slams,HARD,3,Jarkko Nieminen,Yevgeny Kafelnikov,Jarkko Nieminen,6-3; 6-3; 3-6; 4-6; 6-1,R64,166,1,2,85,124,61,85,19,39,8,13,22,80,124,11,8,91,161,62,91,28,70,7,15,22,90,161
2003-01-13 00:00:00.000,Australian Open Australia Grand Slams,HARD,3,Nicolas Escude,Christophe Rochus,Nicolas Escude,1-6; 6-2; 6-2; 6-4,R64,117,13,4,62,96,48,62,17,34,3,6,17,65,96,0,0,79,98,49,79,9,19,4,9,16,58,98
2003-01-13 00:00:00.000,Australian Open Australia Grand Slams,HARD,3,Andre Agassi,Hyung-Taik Lee,Andre Agassi,6-1; 6-0; 6-0,R64,80,5,2,35,55,31,35,9,20,4,4,9,40,55,3,2,39,69,14,39,12,30,5,14,10,26,69
2003-01-13 00:00:00.000,Australian Open Australia Grand Slams,HARD,3,Lleyton Hewitt,Radek Stepanek,Lleyton Hewitt,6-3; 6-2; 6-0,R32,90,4,5,37,71,31,37,20,34,2,3,12,51,71,4,0,37,65,21,37,8,28,2,9,11,29,65
2003-01-13 00:00:00.000,Australian Open Australia Grand Slams,HARD,3,Younes El Aynaoui,Feliciano Lopez,Younes El Aynaoui,5-7; 6-2; 7-6(3); 7-6(8),R32,190,10,5,86,140,64,86,26,54,6,10,22,90,140,6,10,98,167,62,98,35,69,12,17,22,97,167
2003-01-13 00:00:00.000,Australian Open Australia Grand Slams,HARD,3,Andy Roddick,Fernando Vicente,Andy Roddick,6-2; 6-3; 6-2,R32,79,9,2,38,61,34,38,18,23,0,0,13,52,61,6,0,35,72,21,35,19,37,5,10,12,40,72
2003-01-13 00:00:00.000,Australian Open Australia Grand Slams,HARD,3,Mikhail Youzhny,Jiri Novak,Mikhail Youzhny,6-1; 3-6; 6-3; 6-2,R32,124,6,5,60,106,42,60,28,46,4,6,17,70,106,4,5,67,98,43,67,12,31,5,11,16,55,98
2003-01-13 00:00:00.000,Australian Open Australia Grand Slams,HARD,3,Rainer Schuettler,Marat Safin,Rainer Schuettler,W/O,R32,0,0,0,0,0,0,0,0,0,0,0,0,0,0,0,0,0,0,0,0,0,0,0,0,0,0,0
2003-01-13 00:00:00.000,Australian Open Australia Grand Slams,HARD,3,James Blake,Alberto Martin,James Blake,6-3; 4-6; 6-2; 6-2,R32,152,5,3,65,103,49,65,20,38,3,6,18,69,103,2,7,93,147,55,93,22,54,9,16,17,77,147
2003-01-13 00:00:00.000,Australian Open Australia Grand Slams,HARD,3,David Nalbandian,Xavier Malisse,David Nalbandian,4-6; 6-2; 6-0; 3-0 RET,R32,107,4,2,46,80,34,46,18,34,2,5,14,52,80,4,2,47,93,25,47,16,46,9,17,13,41,93
2003-01-13 00:00:00.000,Australian Open Australia Grand Slams,HARD,3,Roger Federer,Andreas Vinciguerra,Roger Federer,6-3; 6-4; 6-2,R32,96,9,0,45,72,37,45,18,27,2,3,14,55,72,4,6,54,95,35,54,16,41,5,10,13,51,95
2003-01-13 00:00:00.000,Australian Open Australia Grand Slams,HARD,3,Wayne Ferreira,Mardy Fish,Wayne Ferreira,2-6; 3-6; 6-1; 6-4; 6-0,R32,147,12,2,75,124,55,75,25,49,7,11,20,80,124,11,3,67,116,49,67,21,49,7,14,20,70,116
2003-01-13 00:00:00.000,Australian Open Australia Grand Slams,HARD,3,Sargis Sargsian,Mark Philippoussis,Sargis Sargsian,5-7; 7-5; 6-0; 6-4,R32,196,8,4,83,131,54,83,30,48,7,10,20,84,131,11,6,73,144,50,73,30,71,10,17,20,80,144
2003-01-13 00:00:00.000,Australian Open Australia Grand Slams,HARD,3,Mario Ancic,Peter Luczak,Mario Ancic,2-6; 7-6(2); 6-4; 6-2,R32,169,11,8,74,129,58,74,27,55,2,4,19,85,129,8,5,74,121,54,74,22,47,2,5,19,76,121
2003-01-13 00:00:00.000,Australian Open Australia Grand Slams,HARD,3,Juan Carlos Ferrero,Fabrice Santoro,Juan Carlos Ferrero,4-6; 6-3; 4-6; 6-2; 7-5,R32,214,11,5,70,126,57,70,33,56,2,5,24,90,126,10,14,115,197,75,115,37,82,20,26,25,112,197
2003-01-13 00:00:00.000,Australian Open Australia Grand Slams,HARD,3,Felix Mantilla,Albert Costa,Felix Mantilla,3-6; 6-3; 4-6; 6-1; 6-3,R32,198,8,7,95,139,65,95,23,44,9,12,22,88,139,14,7,86,139,59,86,25,53,3,9,22,84,139
2003-01-13 00:00:00.000,Australian Open Australia Grand Slams,HARD,3,Sebastien Grosjean,Nicolas Lapentti,Sebastien Grosjean,6-1; 6-3; 6-3,R32,135,8,1,55,101,39,55,24,46,8,9,13,63,101,3,1,37,74,22,37,16,37,1,7,12,38,74
2003-01-13 00:00:00.000,Australian Open Australia Grand Slams,HARD,3,Guillermo Coria,Jarkko Nieminen,Guillermo Coria,7-5; 6-2; 6-2,R32,110,4,1,48,88,30,48,27,40,3,5,14,57,88,1,2,53,77,27,53,10,24,2,9,14,37,77
2003-01-13 00:00:00.000,Australian Open Australia Grand Slams,HARD,3,Andre Agassi,Nicolas Escude,Andre Agassi,6-2; 3-6; 6-3; 6-4,R32,168,8,3,91,131,59,91,20,40,16,20,18,79,131,10,5,59,124,39,59,31,65,4,11,18,70,124
2003-01-13 00:00:00.000,Australian Open Australia Grand Slams,HARD,3,Younes El Aynaoui,Lleyton Hewitt,Younes El Aynaoui,6-7(4); 7-6(4); 7-6(5); 6-4,R16,210,33,5,101,145,83,101,25,44,3,3,23,108,145,14,7,69,147,61,69,46,78,3,4,23,107,147
2003-01-13 00:00:00.000,Australian Open Australia Grand Slams,HARD,3,Andy Roddick,Mikhail Youzhny,Andy Roddick,6-7(4); 3-6; 7-5; 6-3; 6-2,R16,194,22,2,101,156,81,101,27,55,5,7,25,108,156,14,3,91,166,60,91,43,75,7,12,25,103,166
2003-01-13 00:00:00.000,Australian Open Australia Grand Slams,HARD,3,Rainer Schuettler,James Blake,Rainer Schuettler,6-3; 6-4; 1-6; 6-3,R16,115,1,3,58,94,44,58,17,36,1,6,18,61,94,4,3,56,100,36,56,20,44,2,8,17,56,100
2003-01-13 00:00:00.000,Australian Open Australia Grand Slams,HARD,3,David Nalbandian,Roger Federer,David Nalbandian,6-4; 3-6; 6-1; 1-6; 6-3,R16,178,3,2,79,133,50,79,30,54,10,17,21,80,133,9,9,77,148,58,77,26,71,9,17,21,84,148
2003-01-13 00:00:00.000,Australian Open Australia Grand Slams,HARD,3,Wayne Ferreira,Sargis Sargsian,Wayne Ferreira,6-3; 6-4; 3-6; 6-3,R16,152,12,5,65,115,49,65,21,50,3,7,19,70,115,4,5,82,125,50,82,21,43,11,17,18,71,125
2003-01-13 00:00:00.000,Australian Open Australia Grand Slams,HARD,3,Juan Carlos Ferrero,Mario Ancic,Juan Carlos Ferrero,6-0; 6-3; 6-2,R16,101,3,3,44,78,31,44,17,34,4,6,11,48,78,4,3,44,69,24,44,2,25,3,12,12,26,69
2003-01-13 00:00:00.000,Australian Open Australia Grand Slams,HARD,3,Sebastien Grosjean,Felix Mantilla,Sebastien Grosjean,3-6; 2-6; 6-3; 6-3; 6-3,R16,217,10,3,60,138,43,60,37,78,11,19,22,80,138,2,6,116,165,66,116,22,49,10,19,22,88,165
2003-01-13 00:00:00.000,Australian Open Australia Grand Slams,HARD,3,Andre Agassi,Guillermo Coria,Andre Agassi,6-1; 3-1 RET,R16,48,1,0,23,34,18,23,6,11,1,1,5,24,34,0,1,26,41,12,26,7,15,4,8,6,19,41
2003-01-13 00:00:00.000,Australian Open Australia Grand Slams,HARD,3,Andy Roddick,Younes El Aynaoui,Andy Roddick,4-6; 7-6(5); 4-6; 6-4; 21-19,Q,300,27,2,143,231,114,143,61,88,6,9,41,175,231,25,8,179,253,141,179,37,74,10,13,41,178,253
2003-01-13 00:00:00.000,Australian Open Australia Grand Slams,HARD,3,Rainer Schuettler,David Nalbandian,Rainer Schuettler,6-3; 5-7; 6-1; 6-0,Q,138,3,6,53,105,40,53,31,52,5,7,17,71,105,3,4,61,107,33,61,23,46,2,10,17,56,107
2003-01-13 00:00:00.000,Australian Open Australia Grand Slams,HARD,3,Wayne Ferreira,Juan Carlos Ferrero,Wayne Ferreira,7-6(4); 7-6(5); 6-1,Q,131,12,4,54,102,43,54,26,48,3,6,15,69,102,6,2,70,115,47,70,21,45,8,14,16,68,115
2003-01-13 00:00:00.000,Australian Open Australia Grand Slams,HARD,3,Andre Agassi,Sebastien Grosjean,Andre Agassi,6-3; 6-2; 6-2,Q,120,3,1,49,75,38,49,16,26,2,2,12,54,75,5,5,52,111,35,52,20,59,12,18,13,55,111
2003-01-13 00:00:00.000,Australian Open Australia Grand Slams,HARD,3,Rainer Schuettler,Andy Roddick,Rainer Schuettler,7-5; 2-6; 6-3; 6-3,S,139,6,4,54,102,41,54,30,48,3,6,19,71,102,11,4,76,123,52,76,21,47,8,13,19,73,123
2003-01-13 00:00:00.000,Australian Open Australia Grand Slams,HARD,3,Andre Agassi,Wayne Ferreira,Andre Agassi,6-2; 6-2; 6-3,S,88,6,3,52,71,44,52,8,19,3,3,12,52,71,8,3,49,81,31,49,12,32,5,11,13,43,81
2003-01-13 00:00:00.000,Australian Open Australia Grand Slams,HARD,3,Andre Agassi,Rainer Schuettler,Andre Agassi,6-2; 6-2; 6-1,F,76,7,1,39,58,29,39,14,19,0,1,11,43,58,4,4,33,65,19,33,9,32,5,13,12,28,65
2003-01-27 00:00:00.000,Milan Italy ATP World Tour,HARD,2,Radek Stepanek,Jiri Novak,Radek Stepanek,6-4; 6-3,R32,64,7,0,27,50,22,27,15,23,0,0,9,37,50,3,2,39,60,25,39,10,21,4,7,10,35,60
2003-01-27 00:00:00.000,Milan Italy ATP World Tour,HARD,2,Richard Krajicek,Nikolay Davydenko,Richard Krajicek,7-5; 6-2,R32,74,13,3,37,60,31,37,13,23,4,4,10,44,60,2,2,45,69,28,45,12,24,5,8,10,40,69
2003-01-27 00:00:00.000,Milan Italy ATP World Tour,HARD,2,Antony Dupuis,Vladimir Voltchkov,Antony Dupuis,4-6; 6-3; 6-4,R32,119,24,2,68,103,52,68,15,35,8,10,15,67,103,13,2,52,83,39,52,14,31,1,4,14,53,83
2003-01-27 00:00:00.000,Milan Italy ATP World Tour,HARD,2,Jarkko Nieminen,Michel Kratochvil,Jarkko Nieminen,6-4; 3-6; 6-1,R32,101,8,4,59,89,45,59,14,30,6,7,13,59,89,7,4,59,93,42,59,13,34,8,11,13,55,93
2003-01-27 00:00:00.000,Milan Italy ATP World Tour,HARD,2,Andrea Gaudenzi,Younes El Aynaoui,Andrea Gaudenzi,7-5; 6-3,R32,74,8,0,47,63,36,47,10,16,0,0,11,46,63,14,0,48,62,30,48,9,14,5,7,10,39,62
2003-01-27 00:00:00.000,Milan Italy ATP World Tour,HARD,2,Jonas Bjorkman,Tomas Zib,Jonas Bjorkman,7-5; 6-3,R32,72,15,2,46,71,38,46,13,25,5,5,11,51,71,7,1,39,62,29,39,11,23,1,3,10,40,62
2003-01-27 00:00:00.000,Milan Italy ATP World Tour,HARD,2,Kristian Pless,Hicham Arazi,Kristian Pless,6-3; 1-6; 6-3,R32,84,11,2,49,72,37,49,12,23,1,3,13,49,72,9,0,44,74,32,44,18,30,7,9,12,50,74
2003-01-27 00:00:00.000,Milan Italy ATP World Tour,HARD,2,Yevgeny Kafelnikov,Marcelo Charpentier,Yevgeny Kafelnikov,6-2; 7-5,R32,72,4,1,27,51,23,27,16,24,0,1,10,39,51,1,3,41,58,26,41,7,17,2,6,10,33,58
2003-01-27 00:00:00.000,Milan Italy ATP World Tour,HARD,2,Dominik Hrbaty,Nicolas Escude,Dominik Hrbaty,6-4; 1-6; 6-3,R32,97,10,1,55,76,38,55,9,21,4,7,13,47,76,9,2,52,90,39,52,16,38,4,7,13,55,90
2003-01-27 00:00:00.000,Milan Italy ATP World Tour,HARD,2,Ivan Ljubicic,Olivier Rochus,Ivan Ljubicic,7-5; 6-3,R32,76,18,5,30,69,26,30,24,39,7,7,11,50,69,2,4,37,65,28,37,13,28,4,6,10,41,65
2003-01-27 00:00:00.000,Milan Italy ATP World Tour,HARD,2,Julien Varlet,Feliciano Lopez,Julien Varlet,6-3; 6-4,R32,57,6,2,39,50,32,39,9,11,0,0,10,41,50,10,1,36,55,27,36,8,19,3,5,9,35,55
2003-01-27 00:00:00.000,Milan Italy ATP World Tour,HARD,2,Xavier Malisse,Andre Sa,Xavier Malisse,6-4; 6-4,R32,82,14,1,46,77,32,46,17,31,5,6,10,49,77,4,1,47,66,27,47,11,19,2,5,10,38,66
2003-01-27 00:00:00.000,Milan Italy ATP World Tour,HARD,2,Davide Sanguinetti,Giorgio Galimberti,Davide Sanguinetti,6-2; 6-4,R32,69,4,2,38,60,30,38,10,22,2,3,9,40,60,0,3,39,67,25,39,9,28,8,12,9,34,67
2003-01-27 00:00:00.000,Milan Italy ATP World Tour,HARD,2,Max Mirnyi,Kenneth Carlsen,Max Mirnyi,7-5; 2-6; 4-0 RET,R32,86,11,1,52,74,40,52,10,22,3,5,12,50,74,9,3,49,72,32,49,12,23,0,3,12,44,72
2003-01-27 00:00:00.000,Milan Italy ATP World Tour,HARD,2,Martin Verkerk,Adrian Voinea,Martin Verkerk,6-3; 6-7(3); 6-4,R32,119,21,3,52,78,47,52,19,26,0,0,16,66,78,14,2,70,104,48,70,21,34,7,9,15,69,104
2003-01-27 00:00:00.000,Milan Italy ATP World Tour,HARD,2,Thomas Enqvist,Sjeng Schalken,Thomas Enqvist,6-4; 6-3,R32,78,8,4,34,56,29,34,11,22,1,2,10,40,56,10,2,48,61,29,48,7,13,4,7,9,36,61
2003-01-27 00:00:00.000,Milan Italy ATP World Tour,HARD,2,Richard Krajicek,Radek Stepanek,Richard Krajicek,3-6; 6-3; 7-6(13),R16,128,22,6,57,105,50,57,26,48,6,8,15,76,105,9,2,63,88,52,63,13,25,0,2,15,65,88
2003-01-27 00:00:00.000,Milan Italy ATP World Tour,HARD,2,Jarkko Nieminen,Antony Dupuis,Jarkko Nieminen,7-6(4); 2-6; 6-4,R16,124,5,2,64,97,47,64,18,33,2,4,15,65,97,16,2,60,93,49,60,16,33,1,2,15,65,93
2003-01-27 00:00:00.000,Milan Italy ATP World Tour,HARD,2,Jonas Bjorkman,Andrea Gaudenzi,Jonas Bjorkman,6-2; 6-1,R16,56,2,0,32,44,25,32,8,12,3,3,8,33,44,2,1,24,44,13,24,7,20,2,6,7,20,44
2003-01-27 00:00:00.000,Milan Italy ATP World Tour,HARD,2,Yevgeny Kafelnikov,Kristian Pless,Yevgeny Kafelnikov,6-4; 6-3,R16,66,7,0,39,55,28,39,13,16,3,4,10,41,55,8,3,43,74,25,43,15,31,4,7,9,40,74
2003-01-27 00:00:00.000,Milan Italy ATP World Tour,HARD,2,Ivan Ljubicic,Dominik Hrbaty,Ivan Ljubicic,6-7(3); 7-6(6); 6-4,R16,118,31,7,60,105,51,60,29,45,2,2,17,80,105,3,3,59,98,49,59,25,39,0,1,17,74,98
2003-01-27 00:00:00.000,Milan Italy ATP World Tour,HARD,2,Julien Varlet,Xavier Malisse,Julien Varlet,2-6; 7-5; 7-6(6),R16,125,9,1,79,109,53,79,14,30,3,6,16,67,109,11,2,53,90,47,53,19,37,1,3,16,66,90
2003-01-27 00:00:00.000,Milan Italy ATP World Tour,HARD,2,Davide Sanguinetti,Max Mirnyi,Davide Sanguinetti,1-6; 6-3; 7-6(9),R16,99,7,2,59,92,45,59,15,33,5,8,14,60,92,15,2,59,85,41,59,17,26,1,3,14,58,85
2003-01-27 00:00:00.000,Milan Italy ATP World Tour,HARD,2,Martin Verkerk,Thomas Enqvist,Martin Verkerk,6-3; 6-4,R16,53,23,2,31,50,29,31,11,19,0,0,10,40,50,7,1,29,45,24,29,8,16,1,3,9,32,45
2003-01-27 00:00:00.000,Milan Italy ATP World Tour,HARD,2,Jarkko Nieminen,Richard Krajicek,Jarkko Nieminen,7-6(7); 7-5,Q,80,2,2,68,92,44,68,12,24,6,8,12,56,92,11,6,44,83,37,44,14,39,4,7,12,51,83
2003-01-27 00:00:00.000,Milan Italy ATP World Tour,HARD,2,Yevgeny Kafelnikov,Jonas Bjorkman,Yevgeny Kafelnikov,6-3; 6-4,Q,81,7,6,26,59,22,26,13,33,2,5,10,35,59,4,1,41,71,22,41,14,30,9,14,9,36,71
2003-01-27 00:00:00.000,Milan Italy ATP World Tour,HARD,2,Ivan Ljubicic,Julien Varlet,Ivan Ljubicic,6-4; 6-1,Q,67,18,0,25,34,23,25,9,9,0,0,8,32,34,1,1,47,59,26,47,5,12,5,9,9,31,59
2003-01-27 00:00:00.000,Milan Italy ATP World Tour,HARD,2,Martin Verkerk,Davide Sanguinetti,Martin Verkerk,7-5; 6-3,Q,78,14,1,43,66,36,43,11,23,3,3,11,47,66,3,0,41,59,29,41,10,18,3,5,10,39,59
2003-01-27 00:00:00.000,Milan Italy ATP World Tour,HARD,2,Yevgeny Kafelnikov,Jarkko Nieminen,Yevgeny Kafelnikov,7-6(8); 6-3,S,86,4,3,38,66,28,38,12,28,3,6,10,40,66,6,0,66,87,36,66,8,21,9,14,11,44,87
2003-01-27 00:00:00.000,Milan Italy ATP World Tour,HARD,2,Martin Verkerk,Ivan Ljubicic,Martin Verkerk,3-6; 7-5; 7-6(1),S,120,21,3,54,90,43,54,24,36,1,2,16,67,90,27,8,57,97,51,57,19,40,1,2,17,70,97
2003-01-27 00:00:00.000,Milan Italy ATP World Tour,HARD,2,Martin Verkerk,Yevgeny Kafelnikov,Martin Verkerk,6-4; 5-7; 7-5,F,122,30,3,66,95,50,66,20,29,4,5,17,70,95,10,2,65,108,52,65,19,43,6,8,17,71,108
2003-02-10 00:00:00.000,Marseille France ATP World Tour,HARD,2,Roger Federer,Ivan Ljubicic,Roger Federer,7-6(3) RET,R32,51,5,2,24,38,21,24,10,14,0,0,6,31,38,7,6,23,43,18,23,12,20,1,1,6,30,43
2003-02-10 00:00:00.000,Marseille France ATP World Tour,HARD,2,Jarkko Nieminen,Radek Stepanek,Jarkko Nieminen,6-2; 4-6; 7-6(1),R32,90,3,1,71,91,56,71,11,20,2,3,15,67,91,10,0,58,83,43,58,15,25,2,4,15,58,83
2003-02-10 00:00:00.000,Marseille France ATP World Tour,HARD,2,Raemon Sluiter,Thomas Enqvist,Raemon Sluiter,7-6(4); 7-6(6),R32,97,10,3,48,76,37,48,15,28,1,3,12,52,76,10,7,49,90,35,49,20,41,6,8,12,55,90
2003-02-10 00:00:00.000,Marseille France ATP World Tour,HARD,2,Cyril Saulnier,Fabrice Santoro,Cyril Saulnier,2-6; 6-4; 6-1,R32,118,11,3,54,93,39,54,20,39,7,10,13,59,93,5,2,52,75,36,52,8,23,4,8,12,44,75
2003-02-10 00:00:00.000,Marseille France ATP World Tour,HARD,2,Sebastien Grosjean,Alex Calatrava,Sebastien Grosjean,6-2; 6-1,R32,47,12,1,27,39,25,27,8,12,0,0,8,33,39,1,0,23,36,11,23,7,13,1,5,7,18,36
2003-02-10 00:00:00.000,Marseille France ATP World Tour,HARD,2,Karol Kucera,Michel Kratochvil,Karol Kucera,3-6; 6-4; 4-1 RET,R32,124,10,7,50,93,34,50,23,43,6,8,12,57,93,4,4,49,87,34,49,18,38,3,6,12,52,87
2003-02-10 00:00:00.000,Marseille France ATP World Tour,HARD,2,Richard Gasquet,Feliciano Lopez,Richard Gasquet,6-7(4); 6-4; 6-4,R32,114,6,2,53,91,42,53,27,38,3,4,16,69,91,7,0,67,109,46,67,28,42,6,9,16,74,109
2003-02-10 00:00:00.000,Marseille France ATP World Tour,HARD,2,Olivier Rochus,Yevgeny Kafelnikov,Olivier Rochus,7-6(5); 6-4,R32,98,3,5,52,92,34,52,18,40,4,7,11,52,92,7,7,40,76,29,40,13,36,3,7,11,42,76
2003-02-10 00:00:00.000,Marseille France ATP World Tour,HARD,2,Jonas Bjorkman,Younes El Aynaoui,Jonas Bjorkman,6-2; 6-4,R32,63,3,2,35,53,28,35,11,18,3,3,9,39,53,9,2,30,49,19,30,10,19,1,4,9,29,49
2003-02-10 00:00:00.000,Marseille France ATP World Tour,HARD,2,Adrian Voinea,Wayne Arthurs,Adrian Voinea,6-4; 7-6(4),R32,67,14,3,40,63,35,40,15,23,1,1,11,50,63,15,0,42,62,37,42,9,20,2,3,11,46,62
2003-02-10 00:00:00.000,Marseille France ATP World Tour,HARD,2,Dominik Hrbaty,Hicham Arazi,Dominik Hrbaty,6-1; 6-3,R32,52,7,1,25,41,21,25,11,16,0,0,8,32,41,3,0,26,48,16,26,8,22,2,6,8,24,48
2003-02-10 00:00:00.000,Marseille France ATP World Tour,HARD,2,Olivier Mutis,Christian Vinck,Olivier Mutis,6-4; 2-6; 7-5,R32,110,6,5,53,112,34,53,32,59,11,15,15,66,112,4,2,38,83,28,38,26,45,2,6,15,54,83
2003-02-10 00:00:00.000,Marseille France ATP World Tour,HARD,2,Max Mirnyi,Tommy Robredo,Max Mirnyi,7-6(6); 1-6; 7-6(5),R32,118,15,2,69,98,53,69,13,29,3,6,15,66,98,5,2,84,107,61,84,14,23,0,1,16,75,107
2003-02-10 00:00:00.000,Marseille France ATP World Tour,HARD,2,Rodolphe Cadart,Irakli Labadze,Rodolphe Cadart,6-4; 6-3,R32,86,2,3,40,63,25,40,13,23,4,6,9,38,63,2,4,26,58,15,26,15,32,4,9,10,30,58
2003-02-10 00:00:00.000,Marseille France ATP World Tour,HARD,2,Mario Ancic,Antony Dupuis,Mario Ancic,6-7(4); 6-4; 6-4,R32,114,11,2,60,95,44,60,21,35,2,4,16,65,95,10,3,56,88,44,56,15,32,2,6,16,59,88
2003-02-10 00:00:00.000,Marseille France ATP World Tour,HARD,2,Nicolas Escude,Jiri Novak,Nicolas Escude,6-2; 6-1,R32,56,7,1,27,45,23,27,11,18,1,1,8,34,45,1,4,27,47,15,27,6,20,4,8,7,21,47
2003-02-10 00:00:00.000,Marseille France ATP World Tour,HARD,2,Roger Federer,Jarkko Nieminen,Roger Federer,6-3; 6-3,R16,67,10,2,39,66,28,39,15,27,10,11,9,43,66,3,0,38,55,23,38,7,17,5,9,9,30,55
2003-02-10 00:00:00.000,Marseille France ATP World Tour,HARD,2,Raemon Sluiter,Cyril Saulnier,Raemon Sluiter,7-5; 6-7(1); 6-2,R16,113,11,3,59,85,48,59,17,26,0,0,16,65,85,12,4,57,96,45,57,21,39,5,8,16,66,96
2003-02-10 00:00:00.000,Marseille France ATP World Tour,HARD,2,Karol Kucera,Sebastien Grosjean,Karol Kucera,7-6(4); 6-1,R16,86,4,0,41,59,30,41,5,18,0,3,10,35,59,1,1,37,65,20,37,12,28,6,11,9,32,65
2003-02-10 00:00:00.000,Marseille France ATP World Tour,HARD,2,Olivier Rochus,Richard Gasquet,Olivier Rochus,6-7(1); 5-0 RET,R16,82,1,3,35,55,23,35,9,20,0,2,9,32,55,2,5,37,63,23,37,9,26,3,7,8,32,63
2003-02-10 00:00:00.000,Marseille France ATP World Tour,HARD,2,Jonas Bjorkman,Adrian Voinea,Jonas Bjorkman,7-6(6); 6-7(6); 6-3,R16,131,4,1,61,102,50,61,18,41,2,4,16,68,102,16,2,71,106,50,71,16,35,2,6,17,66,106
2003-02-10 00:00:00.000,Marseille France ATP World Tour,HARD,2,Dominik Hrbaty,Olivier Mutis,Dominik Hrbaty,6-3; 6-4,R16,73,8,1,40,59,27,40,16,19,0,0,10,43,59,6,4,43,86,30,43,20,43,8,10,9,50,86
2003-02-10 00:00:00.000,Marseille France ATP World Tour,HARD,2,Rodolphe Cadart,Max Mirnyi,Rodolphe Cadart,7-6(5); 6-2,R16,87,3,1,40,69,30,40,18,29,5,5,10,48,69,5,3,36,55,29,36,8,19,0,2,10,37,55
2003-02-10 00:00:00.000,Marseille France ATP World Tour,HARD,2,Nicolas Escude,Mario Ancic,Nicolas Escude,6-2; 3-6; 7-6(10),R16,145,7,3,62,102,49,62,18,40,7,9,14,67,102,9,6,50,100,40,50,26,50,4,7,15,66,100
2003-02-10 00:00:00.000,Marseille France ATP World Tour,HARD,2,Roger Federer,Raemon Sluiter,Roger Federer,6-4; 4-6; 6-4,Q,108,12,8,57,93,41,57,21,36,11,13,15,62,93,4,0,58,92,36,58,23,34,6,9,15,59,92
2003-02-10 00:00:00.000,Marseille France ATP World Tour,HARD,2,Karol Kucera,Olivier Rochus,Karol Kucera,6-3; 6-3,Q,68,10,0,39,52,33,39,8,13,2,2,9,41,52,0,3,36,65,24,36,13,29,3,6,9,37,65
2003-02-10 00:00:00.000,Marseille France ATP World Tour,HARD,2,Jonas Bjorkman,Dominik Hrbaty,Jonas Bjorkman,7-6(7); 6-4,Q,88,9,2,54,79,41,54,12,25,2,3,11,53,79,4,1,37,69,28,37,19,32,1,3,11,47,69
2003-02-10 00:00:00.000,Marseille France ATP World Tour,HARD,2,Nicolas Escude,Rodolphe Cadart,Nicolas Escude,7-5; 6-3,Q,88,4,5,35,60,29,35,15,25,0,0,11,44,60,1,3,37,56,26,37,11,19,1,3,10,37,56
2003-02-10 00:00:00.000,Marseille France ATP World Tour,HARD,2,Roger Federer,Karol Kucera,Roger Federer,7-6(5); 6-3,S,86,3,1,41,57,32,41,12,16,0,0,10,44,57,4,1,49,75,35,49,11,26,4,6,11,46,75
2003-02-10 00:00:00.000,Marseille France ATP World Tour,HARD,2,Jonas Bjorkman,Nicolas Escude,Jonas Bjorkman,W/O,S,0,0,0,0,0,0,0,0,0,0,0,0,0,0,0,0,0,0,0,0,0,0,0,0,0,0,0
2003-02-10 00:00:00.000,Marseille France ATP World Tour,HARD,2,Roger Federer,Jonas Bjorkman,Roger Federer,6-2; 7-6(6),F,84,5,2,41,63,35,41,10,22,1,2,10,45,63,8,2,60,80,37,60,9,20,7,10,10,46,80
2003-02-10 00:00:00.000,San Jose CA; U.S.A. ATP World Tour,HARD,2,Andre Agassi,Michael Chang,Andre Agassi,6-4; 6-2,R32,63,9,3,25,43,24,25,12,18,0,0,9,36,43,7,1,28,51,19,28,11,23,1,4,9,30,51
2003-02-10 00:00:00.000,San Jose CA; U.S.A. ATP World Tour,HARD,2,Mark Philippoussis,Jean-Rene Lisnard,Mark Philippoussis,3-6; 6-3; 6-3,R32,90,14,7,40,80,33,40,19,40,4,7,14,52,80,2,1,44,74,27,44,17,30,4,8,13,44,74
2003-02-10 00:00:00.000,San Jose CA; U.S.A. ATP World Tour,HARD,2,Vladimir Voltchkov,Jan Vacek,Vladimir Voltchkov,6-4; 6-2,R32,73,2,1,30,59,25,30,18,29,4,4,9,43,59,2,1,31,62,19,31,15,31,4,7,9,34,62
2003-02-10 00:00:00.000,San Jose CA; U.S.A. ATP World Tour,HARD,2,Todd Martin,Brian Vahaly,Todd Martin,6-4; 6-3,R32,82,9,4,27,54,22,27,17,27,1,1,9,39,54,6,4,39,68,27,39,14,29,7,10,10,41,68
2003-02-10 00:00:00.000,San Jose CA; U.S.A. ATP World Tour,HARD,2,James Blake,Wayne Black,James Blake,6-2; 6-4,R32,51,6,1,25,45,21,25,14,20,0,1,9,35,45,0,1,29,56,17,29,12,27,1,5,9,29,56
2003-02-10 00:00:00.000,San Jose CA; U.S.A. ATP World Tour,HARD,2,Hyung-Taik Lee,Taylor Dent,Hyung-Taik Lee,6-2; 7-6(5),R32,76,3,2,37,60,30,37,16,23,0,0,10,46,60,4,3,29,57,21,29,17,28,0,2,10,38,57
2003-02-10 00:00:00.000,San Jose CA; U.S.A. ATP World Tour,HARD,2,Robby Ginepri,Kristian Pless,Robby Ginepri,4-6; 6-1; 6-4,R32,76,8,5,63,82,48,63,8,19,0,1,14,56,82,12,9,39,76,30,39,19,37,2,5,13,49,76
2003-02-10 00:00:00.000,San Jose CA; U.S.A. ATP World Tour,HARD,2,Nikolay Davydenko,Jeff Morrison,Nikolay Davydenko,6-3; 2-6; 7-6(1),R32,108,3,1,70,89,48,70,10,19,2,6,15,58,89,5,2,48,85,38,48,17,37,3,6,14,55,85
2003-02-10 00:00:00.000,San Jose CA; U.S.A. ATP World Tour,HARD,2,Davide Sanguinetti,Zeljko Krajan,Davide Sanguinetti,6-2; 6-7(7); 6-1,R32,111,16,2,59,98,50,59,17,39,3,3,14,67,98,3,4,44,89,29,44,26,45,7,11,13,55,89
2003-02-10 00:00:00.000,San Jose CA; U.S.A. ATP World Tour,HARD,2,Mardy Fish,Dmitry Tursunov,Mardy Fish,6-2; 4-6; 7-6(3),R32,131,12,6,54,98,45,54,19,44,6,8,15,64,98,4,7,42,102,31,42,30,60,1,4,15,61,102
2003-02-10 00:00:00.000,San Jose CA; U.S.A. ATP World Tour,HARD,2,Vincent Spadea,Lars Burgsmuller,Vincent Spadea,6-3; 6-4,R32,76,2,4,27,50,24,27,16,23,0,0,10,40,50,2,1,40,73,28,40,15,33,7,9,9,43,73
2003-02-10 00:00:00.000,San Jose CA; U.S.A. ATP World Tour,HARD,2,Jan-Michael Gambill,Todd Reid,Jan-Michael Gambill,6-2; 6-0,R32,45,9,1,28,42,22,28,9,14,1,1,7,31,42,2,0,26,36,8,26,5,10,2,7,7,13,36
2003-02-10 00:00:00.000,San Jose CA; U.S.A. ATP World Tour,HARD,2,Kenneth Carlsen,Magnus Norman,Kenneth Carlsen,7-5; 3-6; 7-6(3),R32,163,4,6,60,104,46,60,22,44,3,6,16,68,104,11,2,75,112,51,75,20,37,3,6,17,71,112
2003-02-10 00:00:00.000,San Jose CA; U.S.A. ATP World Tour,HARD,2,Paul Goldstein,Juan Balcells,Paul Goldstein,6-2; 2-6; 6-3,R32,92,0,1,55,81,42,55,11,26,2,4,13,53,81,2,1,66,83,36,66,12,17,3,6,12,48,83
2003-02-10 00:00:00.000,San Jose CA; U.S.A. ATP World Tour,HARD,2,Zack Fleishman,Michael Llodra,Zack Fleishman,6-7(4); 6-1; 6-1,R32,93,17,3,45,82,35,45,24,37,2,2,13,59,82,11,9,46,95,35,46,17,49,11,16,13,52,95
2003-02-10 00:00:00.000,San Jose CA; U.S.A. ATP World Tour,HARD,2,Justin Gimelstob,Paradorn Srichaphan,Justin Gimelstob,7-5; 6-2,R32,75,7,1,36,64,26,36,15,28,4,6,10,41,64,4,6,27,63,17,27,14,36,4,9,10,31,63
2003-02-10 00:00:00.000,San Jose CA; U.S.A. ATP World Tour,HARD,2,Andre Agassi,Mark Philippoussis,Andre Agassi,6-4; 6-1,R16,60,4,0,25,36,23,25,9,11,0,0,8,32,36,6,9,25,61,18,25,15,36,8,12,9,33,61
2003-02-10 00:00:00.000,San Jose CA; U.S.A. ATP World Tour,HARD,2,Vladimir Voltchkov,Todd Martin,Vladimir Voltchkov,W/O,R16,0,0,0,0,0,0,0,0,0,0,0,0,0,0,0,0,0,0,0,0,0,0,0,0,0,0,0
2003-02-10 00:00:00.000,San Jose CA; U.S.A. ATP World Tour,HARD,2,James Blake,Hyung-Taik Lee,James Blake,6-3; 6-2,R16,59,9,3,43,67,34,43,12,24,5,5,9,46,67,1,1,26,44,17,26,7,18,1,4,8,24,44
2003-02-10 00:00:00.000,San Jose CA; U.S.A. ATP World Tour,HARD,2,Nikolay Davydenko,Robby Ginepri,Nikolay Davydenko,6-4; 3-6; 6-3,R16,111,5,0,58,89,41,58,16,31,8,11,14,57,89,3,3,49,86,32,49,20,37,3,7,14,52,86
2003-02-10 00:00:00.000,San Jose CA; U.S.A. ATP World Tour,HARD,2,Davide Sanguinetti,Mardy Fish,Davide Sanguinetti,7-6(1); 7-5,R16,88,7,1,45,79,34,45,22,34,2,2,12,56,79,5,1,39,67,31,39,16,28,3,4,12,47,67
2003-02-10 00:00:00.000,San Jose CA; U.S.A. ATP World Tour,HARD,2,Vincent Spadea,Jan-Michael Gambill,Vincent Spadea,6-3; 6-3,R16,81,5,4,37,65,27,37,15,28,3,4,9,42,65,6,2,27,58,19,27,12,31,2,6,9,31,58
2003-02-10 00:00:00.000,San Jose CA; U.S.A. ATP World Tour,HARD,2,Kenneth Carlsen,Paul Goldstein,Kenneth Carlsen,6-2; 3-6; 7-5,R16,143,7,2,45,83,31,45,20,38,2,5,14,51,83,3,4,59,111,32,59,30,52,6,11,15,62,111
2003-02-10 00:00:00.000,San Jose CA; U.S.A. ATP World Tour,HARD,2,Justin Gimelstob,Zack Fleishman,Justin Gimelstob,6-1; 6-4,R16,60,5,1,24,48,19,24,12,24,2,3,8,31,48,3,2,28,51,19,28,5,23,1,6,9,24,51
2003-02-10 00:00:00.000,San Jose CA; U.S.A. ATP World Tour,HARD,2,Andre Agassi,Vladimir Voltchkov,Andre Agassi,6-7(3); 7-6(6); 6-1,Q,149,13,2,65,107,46,65,28,42,7,8,15,74,107,20,6,70,128,55,70,21,58,12,16,16,76,128
2003-02-10 00:00:00.000,San Jose CA; U.S.A. ATP World Tour,HARD,2,James Blake,Nikolay Davydenko,James Blake,7-5; 6-2,Q,68,3,2,35,58,24,35,15,23,2,3,10,39,58,2,0,46,67,26,46,11,21,6,10,10,37,67
2003-02-10 00:00:00.000,San Jose CA; U.S.A. ATP World Tour,HARD,2,Davide Sanguinetti,Vincent Spadea,Davide Sanguinetti,6-1; 7-5,Q,63,7,2,37,55,23,37,12,18,1,2,9,35,55,3,3,33,54,19,33,9,21,3,8,10,28,54
2003-02-10 00:00:00.000,San Jose CA; U.S.A. ATP World Tour,HARD,2,Justin Gimelstob,Kenneth Carlsen,Justin Gimelstob,6-3; 6-4,Q,75,7,2,39,61,31,39,12,22,1,1,10,43,61,4,3,31,51,22,31,10,20,0,2,9,32,51
2003-02-10 00:00:00.000,San Jose CA; U.S.A. ATP World Tour,HARD,2,Andre Agassi,James Blake,Andre Agassi,6-4; 6-2,S,65,4,2,27,50,22,27,13,23,2,3,9,35,50,3,1,27,59,15,27,15,32,3,7,9,30,59
2003-02-10 00:00:00.000,San Jose CA; U.S.A. ATP World Tour,HARD,2,Davide Sanguinetti,Justin Gimelstob,Davide Sanguinetti,6-4; 6-7(2); 6-3,S,143,8,2,78,120,49,78,25,42,1,4,16,74,120,11,5,57,108,42,57,21,51,6,11,15,63,108
2003-02-10 00:00:00.000,San Jose CA; U.S.A. ATP World Tour,HARD,2,Andre Agassi,Davide Sanguinetti,Andre Agassi,6-3; 6-1,F,62,2,3,28,50,23,28,10,22,2,3,8,33,50,5,2,26,47,12,26,10,21,2,7,8,22,47
2003-02-10 00:00:00.000,Vi±a del Mar Chile ATP World Tour,CLAY,2,Gaston Gaudio,Nicolas Massu,Gaston Gaudio,6-0; 2-6; 6-1,R32,108,4,0,34,56,26,34,14,22,2,4,11,40,56,5,4,42,76,25,42,13,34,7,12,10,38,76
2003-02-10 00:00:00.000,Vi±a del Mar Chile ATP World Tour,CLAY,2,Hermes Gamonal,Jacobo Diaz,Hermes Gamonal,7-5; 5-7; 6-3,R32,126,5,2,68,94,46,68,15,26,4,8,17,61,94,3,6,53,96,35,53,20,43,3,8,16,55,96
2003-02-10 00:00:00.000,Vi±a del Mar Chile ATP World Tour,CLAY,2,Marcos Daniel,Fernando Meligeni,Marcos Daniel,7-5; 6-4,R32,88,0,2,54,70,33,54,7,16,6,10,11,40,70,5,1,40,67,19,40,12,27,4,10,11,31,67
2003-02-10 00:00:00.000,Vi±a del Mar Chile ATP World Tour,CLAY,2,Felix Mantilla,Alberto Martin,Felix Mantilla,6-1; 6-4,R32,73,4,3,31,51,22,31,11,20,0,2,9,33,51,1,4,20,44,14,20,7,24,2,7,8,21,44
2003-02-10 00:00:00.000,Vi±a del Mar Chile ATP World Tour,CLAY,2,Marcelo Rios,Adrian Garcia,Marcelo Rios,6-3; 6-2,R32,55,3,1,35,47,31,35,6,12,0,0,9,37,47,2,2,39,52,24,39,4,13,6,9,8,28,52
2003-02-10 00:00:00.000,Vi±a del Mar Chile ATP World Tour,CLAY,2,Albert Portas,Frantisek Cermak,Albert Portas,7-5; 1-6; 7-5,R32,125,6,7,51,89,39,51,13,38,3,8,16,52,89,6,1,79,105,52,79,12,26,8,12,15,64,105
2003-02-10 00:00:00.000,Vi±a del Mar Chile ATP World Tour,CLAY,2,Mariano Puerta,Flavio Saretta,Mariano Puerta,6-3; 6-0,R32,57,0,2,26,45,19,26,13,19,1,2,8,32,45,2,2,30,45,14,30,6,15,2,7,7,20,45
2003-02-10 00:00:00.000,Vi±a del Mar Chile ATP World Tour,CLAY,2,Agustin Calleri,Cecil Mamiit,Agustin Calleri,0-6; 6-3; 6-4,R32,110,2,3,36,74,26,36,21,38,4,7,13,47,74,0,1,52,76,35,52,13,24,5,7,12,48,76
2003-02-10 00:00:00.000,Vi±a del Mar Chile ATP World Tour,CLAY,2,David Ferrer,Alex Kim,David Ferrer,6-2; 6-3,R32,53,1,1,27,41,21,27,10,14,1,3,9,31,41,0,2,33,53,17,33,8,20,3,8,8,25,53
2003-02-10 00:00:00.000,Vi±a del Mar Chile ATP World Tour,CLAY,2,Andrea Gaudenzi,Markus Hipfl,Andrea Gaudenzi,4-6; 6-3; 6-0,R32,118,2,5,49,78,38,49,17,29,4,5,13,55,78,1,1,66,90,41,66,11,24,8,12,12,52,90
2003-02-10 00:00:00.000,Vi±a del Mar Chile ATP World Tour,CLAY,2,David Sanchez,Sebastian Prieto,David Sanchez,6-4; 7-5,R32,101,1,0,30,59,19,30,18,29,0,3,11,37,59,2,3,56,89,31,56,14,33,10,15,11,45,89
2003-02-10 00:00:00.000,Vi±a del Mar Chile ATP World Tour,CLAY,2,Jose Acasuso,Luis Horna,Jose Acasuso,6-4; 6-3,R32,70,4,0,47,61,34,47,8,14,5,5,9,42,61,2,3,45,60,30,45,6,15,2,5,10,36,60
2003-02-10 00:00:00.000,Vi±a del Mar Chile ATP World Tour,CLAY,2,Fernando Vicente,Oscar Serrano,Fernando Vicente,3-6; 6-2; 6-4,R32,98,3,1,44,84,38,44,16,40,2,4,13,54,84,2,0,51,73,36,51,10,22,1,5,14,46,73
2003-02-10 00:00:00.000,Vi±a del Mar Chile ATP World Tour,CLAY,2,Albert Montanes,Julio Peralta,Albert Montanes,7-5; 6-4,R32,91,10,2,56,66,42,56,4,10,1,2,11,46,66,3,3,43,77,27,43,17,34,4,7,11,44,77
2003-02-10 00:00:00.000,Vi±a del Mar Chile ATP World Tour,CLAY,2,Jiri Vanek,Attila Savolt,Jiri Vanek,7-6(8); 6-3,R32,99,10,0,44,65,37,44,14,21,0,0,11,51,65,6,7,44,72,32,44,14,28,0,1,10,46,72
2003-02-10 00:00:00.000,Vi±a del Mar Chile ATP World Tour,CLAY,2,Franco Squillari,Ruben Ramirez Hidalgo,Franco Squillari,7-5; 4-6; 6-2,R32,138,5,3,65,103,43,65,21,38,8,11,15,64,103,2,2,53,91,31,53,21,38,5,10,15,52,91
2003-02-10 00:00:00.000,Vi±a del Mar Chile ATP World Tour,CLAY,2,Gaston Gaudio,Hermes Gamonal,Gaston Gaudio,6-3; 6-4,R16,97,3,1,41,64,27,41,11,23,4,6,9,38,64,3,2,48,69,26,48,9,21,5,10,10,35,69
2003-02-10 00:00:00.000,Vi±a del Mar Chile ATP World Tour,CLAY,2,Felix Mantilla,Marcos Daniel,Felix Mantilla,6-2; 6-3,R16,82,2,2,37,62,26,37,14,25,3,4,9,40,62,5,3,31,58,20,31,8,27,5,9,8,28,58
2003-02-10 00:00:00.000,Vi±a del Mar Chile ATP World Tour,CLAY,2,Marcelo Rios,Albert Portas,Marcelo Rios,6-4; 7-6(3),R16,88,5,1,52,69,39,52,7,17,5,7,11,46,69,3,2,57,83,40,57,7,26,6,9,11,47,83
2003-02-10 00:00:00.000,Vi±a del Mar Chile ATP World Tour,CLAY,2,Agustin Calleri,Mariano Puerta,Agustin Calleri,3-6; 6-2; 6-2,R16,107,14,4,47,88,35,47,20,41,11,13,12,55,88,3,1,55,77,32,55,10,22,1,6,13,42,77
2003-02-10 00:00:00.000,Vi±a del Mar Chile ATP World Tour,CLAY,2,Andrea Gaudenzi,David Ferrer,Andrea Gaudenzi,5-7; 6-4; 6-0,R16,116,1,0,59,89,41,59,16,30,6,9,14,57,89,1,4,61,93,39,61,13,32,7,13,14,52,93
2003-02-10 00:00:00.000,Vi±a del Mar Chile ATP World Tour,CLAY,2,David Sanchez,Jose Acasuso,David Sanchez,4-6; 6-0; 6-1,R16,99,2,3,52,80,38,52,16,28,4,6,12,54,80,3,3,36,58,21,36,7,22,1,7,11,28,58
2003-02-10 00:00:00.000,Vi±a del Mar Chile ATP World Tour,CLAY,2,Albert Montanes,Fernando Vicente,Albert Montanes,6-7(3); 6-1; 6-2,R16,114,5,4,62,92,52,62,11,30,8,10,14,63,92,3,1,54,85,29,54,16,31,7,13,13,45,85
2003-02-10 00:00:00.000,Vi±a del Mar Chile ATP World Tour,CLAY,2,Jiri Vanek,Franco Squillari,Jiri Vanek,7-6(2); 7-6(5),R16,124,5,2,67,105,45,67,14,38,7,10,12,59,105,8,3,47,78,31,47,16,31,3,6,12,47,78
2003-02-10 00:00:00.000,Vi±a del Mar Chile ATP World Tour,CLAY,2,Gaston Gaudio,Felix Mantilla,Gaston Gaudio,6-2; 3-6; 6-3,Q,127,6,1,53,72,39,53,11,19,4,6,13,50,72,11,1,46,81,31,46,18,35,2,6,13,49,81
2003-02-10 00:00:00.000,Vi±a del Mar Chile ATP World Tour,CLAY,2,Marcelo Rios,Agustin Calleri,Marcelo Rios,6-4; 7-6(2),Q,108,0,3,52,74,34,52,13,22,4,7,11,47,74,4,3,48,85,32,48,14,37,9,13,11,46,85
2003-02-10 00:00:00.000,Vi±a del Mar Chile ATP World Tour,CLAY,2,David Sanchez,Andrea Gaudenzi,David Sanchez,6-7(2); 6-1; 6-2,Q,152,5,1,48,88,31,48,20,40,3,6,13,51,88,2,3,66,110,34,66,19,44,7,15,14,53,110
2003-02-10 00:00:00.000,Vi±a del Mar Chile ATP World Tour,CLAY,2,Albert Montanes,Jiri Vanek,Albert Montanes,6-0; 6-4,Q,64,3,4,23,42,20,23,13,19,0,0,8,33,42,8,3,35,71,18,35,19,36,9,13,8,37,71
2003-02-10 00:00:00.000,Vi±a del Mar Chile ATP World Tour,CLAY,2,Marcelo Rios,Gaston Gaudio,Marcelo Rios,6-3; 6-2,S,66,6,1,32,45,27,32,6,13,0,1,9,33,45,0,0,40,50,21,40,5,10,5,9,8,26,50
2003-02-10 00:00:00.000,Vi±a del Mar Chile ATP World Tour,CLAY,2,David Sanchez,Albert Montanes,David Sanchez,7-6(4); 3-6; 6-1,S,128,4,2,56,87,39,56,13,31,4,8,14,52,87,3,3,54,93,34,54,18,39,3,8,14,52,93
2003-02-10 00:00:00.000,Vi±a del Mar Chile ATP World Tour,CLAY,2,David Sanchez,Marcelo Rios,David Sanchez,1-6; 6-3; 6-3,F,102,1,2,42,70,32,42,11,28,4,7,12,43,70,2,2,57,86,31,57,19,29,6,10,13,50,86
2003-02-17 00:00:00.000,Buenos Aires Argentina ATP World Tour,CLAY,2,Carlos Moya,David Ferrer,Carlos Moya,6-3; 6-3,R32,69,1,1,35,60,26,35,14,25,7,8,9,40,60,1,1,35,62,21,35,13,27,8,12,9,34,62
2003-02-17 00:00:00.000,Buenos Aires Argentina ATP World Tour,CLAY,2,Edgardo Massa,Alberto Martin,Edgardo Massa,6-4; 6-4,R32,91,3,2,32,70,26,32,22,38,9,9,10,48,70,3,2,45,72,30,45,15,27,5,7,10,45,72
2003-02-17 00:00:00.000,Buenos Aires Argentina ATP World Tour,CLAY,2,Luis Horna,Eric Prodon,Luis Horna,6-3; 6-2,R32,57,5,1,38,46,33,38,4,8,1,1,9,37,46,2,1,43,62,26,43,7,19,8,11,8,33,62
2003-02-17 00:00:00.000,Buenos Aires Argentina ATP World Tour,CLAY,2,Nicolas Lapentti,Andrea Gaudenzi,Nicolas Lapentti,6-4; 6-1,R32,76,6,2,27,47,19,27,11,20,0,1,8,30,47,2,4,28,54,19,28,7,26,3,8,9,26,54
2003-02-17 00:00:00.000,Buenos Aires Argentina ATP World Tour,CLAY,2,Fernando Gonzalez,David Sanchez,Fernando Gonzalez,7-6(4); 6-3,R32,100,11,11,45,83,37,45,17,38,6,7,11,54,83,2,2,48,72,32,48,11,24,2,4,10,43,72
2003-02-17 00:00:00.000,Buenos Aires Argentina ATP World Tour,CLAY,2,Felix Mantilla,Albert Portas,Felix Mantilla,6-3; 6-1,R32,60,4,2,33,46,25,33,8,13,1,2,8,33,46,6,4,27,49,15,27,7,22,3,8,8,22,49
2003-02-17 00:00:00.000,Buenos Aires Argentina ATP World Tour,CLAY,2,Flavio Saretta,Gaston Etlis,Flavio Saretta,7-6(3); 6-3,R32,111,2,2,46,70,33,46,16,24,3,4,11,49,70,1,6,40,85,28,40,20,45,7,9,10,48,85
2003-02-17 00:00:00.000,Buenos Aires Argentina ATP World Tour,CLAY,2,Gustavo Kuerten,Ivan Miranda,Gustavo Kuerten,6-2; 6-4,R32,76,5,3,26,56,24,26,16,30,3,3,9,40,56,2,1,45,68,29,45,9,23,2,5,9,38,68
2003-02-17 00:00:00.000,Buenos Aires Argentina ATP World Tour,CLAY,2,Juan Ignacio Chela,Marcelo Charpentier,Juan Ignacio Chela,2-6; 6-3; 6-1,R32,97,5,4,39,80,27,39,25,41,3,5,12,52,80,2,6,48,77,31,48,15,29,4,8,12,46,77
2003-02-17 00:00:00.000,Buenos Aires Argentina ATP World Tour,CLAY,2,Agustin Calleri,Nicolas Massu,Agustin Calleri,6-4; 2-6; 6-4,R32,150,10,6,44,76,40,44,15,32,5,7,14,55,76,5,2,69,108,46,69,19,39,6,8,14,65,108
2003-02-17 00:00:00.000,Buenos Aires Argentina ATP World Tour,CLAY,2,Fernando Meligeni,Albert Montanes,Fernando Meligeni,6-4; 6-1,R32,72,4,3,28,53,22,28,14,25,4,5,9,36,53,4,6,27,58,18,27,10,31,8,12,8,28,58
2003-02-17 00:00:00.000,Buenos Aires Argentina ATP World Tour,CLAY,2,Gaston Gaudio,Mariano Puerta,Gaston Gaudio,6-4; 6-2,R32,75,5,2,31,49,26,31,8,18,1,2,9,34,49,2,1,36,56,19,36,11,20,8,12,9,30,56
2003-02-17 00:00:00.000,Buenos Aires Argentina ATP World Tour,CLAY,2,Guillermo Coria,Jose Acasuso,Guillermo Coria,6-3; 3-6; 6-2,R32,127,0,6,53,84,42,53,13,31,4,6,13,55,84,0,0,59,89,36,59,15,30,8,12,13,51,89
2003-02-17 00:00:00.000,Buenos Aires Argentina ATP World Tour,CLAY,2,Mariano Zabaleta,Attila Savolt,Mariano Zabaleta,6-3; 6-4,R32,95,4,4,32,58,24,32,14,26,2,3,10,38,58,4,5,30,59,17,30,15,29,5,8,9,32,59
2003-02-17 00:00:00.000,Buenos Aires Argentina ATP World Tour,CLAY,2,Franco Squillari,Andre Sa,Franco Squillari,2-6; 6-3; 6-2,R32,101,1,3,40,72,25,40,15,32,2,7,13,40,72,2,5,49,77,28,49,11,28,7,13,12,39,77
2003-02-17 00:00:00.000,Buenos Aires Argentina ATP World Tour,CLAY,2,David Nalbandian,Fernando Vicente,David Nalbandian,6-3; 7-5,R32,76,0,3,39,65,31,39,14,26,0,1,11,45,65,0,2,40,60,27,40,10,20,3,6,10,37,60
2003-02-17 00:00:00.000,Buenos Aires Argentina ATP World Tour,CLAY,2,Carlos Moya,Edgardo Massa,Carlos Moya,6-2; 6-2,R16,58,5,3,35,59,24,35,16,24,3,3,8,40,59,3,3,35,56,19,35,10,21,1,5,8,29,56
2003-02-17 00:00:00.000,Buenos Aires Argentina ATP World Tour,CLAY,2,Luis Horna,Nicolas Lapentti,Luis Horna,6-3; 6-4,R16,74,1,3,49,65,36,49,8,16,3,3,10,44,65,1,0,33,51,22,33,10,18,0,2,9,32,51
2003-02-17 00:00:00.000,Buenos Aires Argentina ATP World Tour,CLAY,2,Felix Mantilla,Fernando Gonzalez,Felix Mantilla,W/O,R16,0,0,0,0,0,0,0,0,0,0,0,0,0,0,0,0,0,0,0,0,0,0,0,0,0,0,0
2003-02-17 00:00:00.000,Buenos Aires Argentina ATP World Tour,CLAY,2,Gustavo Kuerten,Flavio Saretta,Gustavo Kuerten,6-4; 6-7(5); 7-5,R16,159,12,4,72,123,50,72,29,51,9,12,17,79,123,6,5,65,111,49,65,16,46,12,17,17,65,111
2003-02-17 00:00:00.000,Buenos Aires Argentina ATP World Tour,CLAY,2,Juan Ignacio Chela,Agustin Calleri,Juan Ignacio Chela,7-5; 7-5,R16,105,6,5,46,77,35,46,14,31,6,8,12,49,77,6,3,37,84,22,37,26,47,6,10,12,48,84
2003-02-17 00:00:00.000,Buenos Aires Argentina ATP World Tour,CLAY,2,Gaston Gaudio,Fernando Meligeni,Gaston Gaudio,7-6(4); 4-6; 6-0,R16,164,0,5,86,124,55,86,18,38,11,13,14,73,124,3,6,45,98,29,45,27,53,8,12,14,56,98
2003-02-17 00:00:00.000,Buenos Aires Argentina ATP World Tour,CLAY,2,Guillermo Coria,Mariano Zabaleta,Guillermo Coria,6-4; 2-6; 6-3,R16,114,0,3,52,74,34,52,13,22,4,7,13,47,74,1,3,54,83,36,54,15,29,3,7,14,51,83
2003-02-17 00:00:00.000,Buenos Aires Argentina ATP World Tour,CLAY,2,David Nalbandian,Franco Squillari,David Nalbandian,6-1; 6-3,R16,74,1,1,28,52,21,28,12,24,0,1,8,33,52,1,3,26,63,19,26,12,37,8,13,8,31,63
2003-02-17 00:00:00.000,Buenos Aires Argentina ATP World Tour,CLAY,2,Carlos Moya,Luis Horna,Carlos Moya,6-7(4); 6-3; 7-5,Q,137,5,2,60,97,47,60,21,37,1,3,17,68,97,1,3,87,116,53,87,17,29,18,22,16,70,116
2003-02-17 00:00:00.000,Buenos Aires Argentina ATP World Tour,CLAY,2,Gustavo Kuerten,Felix Mantilla,Gustavo Kuerten,6-2; 6-7(4); 6-1,Q,111,20,1,64,98,48,64,16,34,7,8,14,64,98,3,3,53,83,35,53,10,30,5,10,13,45,83
2003-02-17 00:00:00.000,Buenos Aires Argentina ATP World Tour,CLAY,2,Gaston Gaudio,Juan Ignacio Chela,Gaston Gaudio,6-3; 6-4,Q,96,0,1,38,66,28,38,15,28,3,4,10,43,66,1,1,40,66,25,40,12,26,3,6,9,37,66
2003-02-17 00:00:00.000,Buenos Aires Argentina ATP World Tour,CLAY,2,Guillermo Coria,David Nalbandian,Guillermo Coria,3-6; 6-3; 7-6(5),Q,140,2,5,67,102,42,67,12,35,3,10,15,54,102,1,8,49,96,27,49,22,47,5,12,15,49,96
2003-02-17 00:00:00.000,Buenos Aires Argentina ATP World Tour,CLAY,2,Carlos Moya,Gustavo Kuerten,Carlos Moya,7-6(8); 6-1,S,80,4,1,36,56,28,36,11,20,0,1,9,39,56,4,4,34,69,20,34,18,35,5,9,10,38,69
2003-02-17 00:00:00.000,Buenos Aires Argentina ATP World Tour,CLAY,2,Guillermo Coria,Gaston Gaudio,Guillermo Coria,6-3; 1-6; 6-3,S,109,1,1,51,76,29,51,15,25,2,6,13,44,76,3,1,41,61,26,41,11,20,0,4,12,37,61
2003-02-17 00:00:00.000,Buenos Aires Argentina ATP World Tour,CLAY,2,Carlos Moya,Guillermo Coria,Carlos Moya,6-3; 4-6; 6-4,F,115,6,1,59,82,45,59,9,23,2,5,15,54,82,1,0,71,94,50,71,7,23,9,13,14,57,94
2003-02-17 00:00:00.000,Memphis TN; U.S.A. ATP World Tour,HARD,2,Andy Roddick,Cecil Mamiit,Andy Roddick,6-4; 6-4,R32,53,11,1,40,51,32,40,9,11,0,0,10,41,51,4,2,45,61,33,45,7,16,4,6,10,40,61
2003-02-17 00:00:00.000,Memphis TN; U.S.A. ATP World Tour,HARD,2,Hyung-Taik Lee,Justin Gimelstob,Hyung-Taik Lee,6-3; 6-4,R32,140,5,1,35,57,26,35,13,22,2,3,10,39,57,6,2,28,61,19,28,15,33,4,7,9,34,61
2003-02-17 00:00:00.000,Memphis TN; U.S.A. ATP World Tour,HARD,2,Robby Ginepri,Sargis Sargsian,Robby Ginepri,6-3; 6-4,R32,76,3,0,43,60,30,43,14,17,2,2,10,44,60,2,2,35,71,24,35,18,36,5,7,9,42,71
2003-02-17 00:00:00.000,Memphis TN; U.S.A. ATP World Tour,HARD,2,Davide Sanguinetti,Todd Martin,Davide Sanguinetti,7-6(1); 6-3,R32,84,4,2,37,65,35,37,16,28,2,2,11,51,65,5,2,38,65,27,38,15,27,2,3,10,42,65
2003-02-17 00:00:00.000,Memphis TN; U.S.A. ATP World Tour,HARD,2,James Blake,Jiri Vanek,James Blake,6-3; 6-0,R32,39,9,1,25,39,22,25,10,14,0,0,8,32,39,2,3,25,44,15,25,6,19,4,8,7,21,44
2003-02-17 00:00:00.000,Memphis TN; U.S.A. ATP World Tour,HARD,2,Irakli Labadze,Jean-Rene Lisnard,Irakli Labadze,7-5; 6-4,R32,83,6,6,43,68,33,43,12,25,2,3,11,45,68,1,5,35,69,27,35,13,34,3,6,11,40,69
2003-02-17 00:00:00.000,Memphis TN; U.S.A. ATP World Tour,HARD,2,Brian Vahaly,Lars Burgsmuller,Brian Vahaly,6-3; 6-4,R32,75,5,0,40,63,29,40,16,23,7,7,10,45,63,4,3,29,59,22,29,15,30,5,7,9,37,59
2003-02-17 00:00:00.000,Memphis TN; U.S.A. ATP World Tour,HARD,2,Eric Taino,Kenneth Carlsen,Eric Taino,6-7(4); 6-4; 6-4,R32,185,9,1,58,97,42,58,27,39,4,4,16,69,97,17,3,53,87,47,53,15,34,0,2,16,62,87
2003-02-17 00:00:00.000,Memphis TN; U.S.A. ATP World Tour,HARD,2,Jan-Michael Gambill,Zeljko Krajan,Jan-Michael Gambill,4-6; 6-3; 6-4,R32,121,13,6,57,98,36,57,23,41,10,14,15,59,98,4,5,48,80,28,48,18,32,4,9,14,46,80
2003-02-17 00:00:00.000,Memphis TN; U.S.A. ATP World Tour,HARD,2,Taylor Dent,Mark Philippoussis,Taylor Dent,7-6(15); 6-1,R32,78,9,1,37,66,34,37,17,29,0,1,10,51,66,14,5,46,77,34,46,14,31,3,6,9,48,77
2003-02-17 00:00:00.000,Memphis TN; U.S.A. ATP World Tour,HARD,2,Vladimir Voltchkov,Bob Bryan,Vladimir Voltchkov,6-3; 6-3,R32,55,7,0,41,49,33,41,5,8,0,0,9,38,49,5,2,31,51,24,31,5,20,2,5,9,29,51
2003-02-17 00:00:00.000,Memphis TN; U.S.A. ATP World Tour,HARD,2,Jeff Morrison,Wayne Ferreira,Jeff Morrison,7-5; 6-4,R32,68,9,4,37,62,34,37,15,25,1,1,11,49,62,8,2,43,69,33,43,11,26,3,5,11,44,69
2003-02-17 00:00:00.000,Memphis TN; U.S.A. ATP World Tour,HARD,2,Magnus Norman,Nikolay Davydenko,Magnus Norman,4-6 RET,R32,45,2,1,18,34,11,18,7,16,2,4,5,18,34,1,1,19,28,13,19,4,9,0,1,5,17,28
2003-02-17 00:00:00.000,Memphis TN; U.S.A. ATP World Tour,HARD,2,Vincent Spadea,Brian Baker,Vincent Spadea,6-2; 6-0,R32,50,4,5,24,47,16,24,16,23,3,3,7,32,47,1,5,29,47,14,29,6,18,2,7,7,20,47
2003-02-17 00:00:00.000,Memphis TN; U.S.A. ATP World Tour,HARD,2,Mardy Fish,Julien Varlet,Mardy Fish,3-6; 7-6(5); 6-4,R32,142,20,7,44,91,38,44,21,47,2,6,15,59,91,5,2,88,113,56,88,10,25,3,7,16,66,113
2003-02-17 00:00:00.000,Memphis TN; U.S.A. ATP World Tour,HARD,2,Paradorn Srichaphan,Michael Chang,Paradorn Srichaphan,6-4; 6-2,R32,56,11,0,32,49,28,32,10,17,1,1,9,38,49,2,2,30,49,21,30,9,19,0,3,9,30,49
2003-02-17 00:00:00.000,Memphis TN; U.S.A. ATP World Tour,HARD,2,Andy Roddick,Hyung-Taik Lee,Andy Roddick,5-7; 6-4; 7-6(3),R16,122,25,3,67,99,58,67,15,32,6,7,17,73,99,9,3,69,104,54,69,18,35,0,1,17,72,104
2003-02-17 00:00:00.000,Memphis TN; U.S.A. ATP World Tour,HARD,2,Robby Ginepri,Davide Sanguinetti,Robby Ginepri,6-3; 7-6(5),R16,71,5,3,52,77,37,52,13,25,6,8,11,50,77,5,1,46,69,30,46,10,23,4,7,10,40,69
2003-02-17 00:00:00.000,Memphis TN; U.S.A. ATP World Tour,HARD,2,Irakli Labadze,James Blake,Irakli Labadze,7-6(2); 7-5,R16,86,7,9,43,75,35,43,17,32,2,3,12,52,75,4,6,52,80,34,52,16,28,6,8,12,50,80
2003-02-17 00:00:00.000,Memphis TN; U.S.A. ATP World Tour,HARD,2,Brian Vahaly,Eric Taino,Brian Vahaly,6-2; 6-4,R16,58,10,2,39,51,29,39,9,12,1,1,9,38,51,5,4,29,51,22,29,7,22,2,5,9,29,51
2003-02-17 00:00:00.000,Memphis TN; U.S.A. ATP World Tour,HARD,2,Taylor Dent,Jan-Michael Gambill,Taylor Dent,7-6(8); 7-6(4),R16,109,16,3,47,77,41,47,21,30,2,2,12,62,77,13,5,62,97,50,62,14,35,5,5,12,64,97
2003-02-17 00:00:00.000,Memphis TN; U.S.A. ATP World Tour,HARD,2,Vladimir Voltchkov,Jeff Morrison,Vladimir Voltchkov,6-2; 4-6; 6-4,R16,94,4,5,50,80,37,50,15,30,3,6,14,52,80,12,3,60,98,39,60,16,38,8,13,14,55,98
2003-02-17 00:00:00.000,Memphis TN; U.S.A. ATP World Tour,HARD,2,Vincent Spadea,Magnus Norman,Vincent Spadea,6-4; 6-4,R16,76,5,2,31,61,26,31,18,30,1,1,10,44,61,5,0,41,63,27,41,12,22,1,3,10,39,63
2003-02-17 00:00:00.000,Memphis TN; U.S.A. ATP World Tour,HARD,2,Mardy Fish,Paradorn Srichaphan,Mardy Fish,6-7(4); 7-6(5); 6-1,R16,138,12,4,73,120,56,73,23,47,5,6,16,79,120,5,8,61,108,48,61,21,47,2,5,15,69,108
2003-02-17 00:00:00.000,Memphis TN; U.S.A. ATP World Tour,HARD,2,Andy Roddick,Robby Ginepri,Andy Roddick,6-4; 6-4,Q,70,13,1,41,63,35,41,10,22,4,4,10,45,63,8,6,43,67,31,43,10,24,3,5,10,41,67
2003-02-17 00:00:00.000,Memphis TN; U.S.A. ATP World Tour,HARD,2,Brian Vahaly,Irakli Labadze,Brian Vahaly,6-3; 4-6; 6-4,Q,122,2,4,59,98,39,59,23,39,4,6,15,62,98,10,11,49,94,40,49,17,45,4,7,14,57,94
2003-02-17 00:00:00.000,Memphis TN; U.S.A. ATP World Tour,HARD,2,Taylor Dent,Vladimir Voltchkov,Taylor Dent,7-6(1); 6-2,Q,83,12,4,33,73,29,33,20,40,5,6,10,49,73,7,1,47,75,26,47,16,28,3,6,10,42,75
2003-02-17 00:00:00.000,Memphis TN; U.S.A. ATP World Tour,HARD,2,Vincent Spadea,Mardy Fish,Vincent Spadea,6-2; 4-6; 6-3,Q,111,4,3,55,88,41,55,19,33,3,4,14,60,88,4,4,44,89,32,44,22,45,5,8,13,54,89
2003-02-17 00:00:00.000,Memphis TN; U.S.A. ATP World Tour,HARD,2,Andy Roddick,Brian Vahaly,Andy Roddick,7-5; 6-1,S,56,14,1,32,49,29,32,12,17,0,0,10,41,49,10,8,27,47,22,27,7,20,0,3,9,29,47
2003-02-17 00:00:00.000,Memphis TN; U.S.A. ATP World Tour,HARD,2,Taylor Dent,Vincent Spadea,Taylor Dent,6-2; 6-4,S,75,11,7,30,58,27,30,15,28,4,4,9,42,58,1,1,41,70,23,41,14,29,6,9,9,37,70
2003-02-17 00:00:00.000,Memphis TN; U.S.A. ATP World Tour,HARD,2,Taylor Dent,Andy Roddick,Taylor Dent,6-1; 6-4,F,60,11,4,19,49,17,19,22,30,3,3,9,39,49,7,3,34,53,23,34,7,19,1,4,8,30,53
2003-02-17 00:00:00.000,Rotterdam The Netherlands ATP World Tour,HARD,2,Juan Carlos Ferrero,Wayne Arthurs,Juan Carlos Ferrero,7-6(4); 7-6(5),R32,87,11,1,43,70,39,43,20,27,0,0,12,59,70,22,7,43,86,37,43,24,43,4,4,12,61,86
2003-02-17 00:00:00.000,Rotterdam The Netherlands ATP World Tour,HARD,2,Jonas Bjorkman,Peter Wessels,Jonas Bjorkman,6-2; 6-2,R32,68,5,3,26,45,21,26,10,19,1,2,8,31,45,4,4,27,57,16,27,10,30,9,14,8,26,57
2003-02-17 00:00:00.000,Rotterdam The Netherlands ATP World Tour,HARD,2,Raemon Sluiter,Martin Verkerk,Raemon Sluiter,3-6; 6-4; 7-6(3),R32,116,7,1,61,82,51,61,12,21,1,2,15,63,82,15,10,62,108,47,62,26,46,6,7,16,73,108
2003-02-17 00:00:00.000,Rotterdam The Netherlands ATP World Tour,HARD,2,Jarkko Nieminen,Alex Corretja,Jarkko Nieminen,6-4; 6-0,R32,61,1,0,25,41,20,25,10,16,1,2,8,30,41,2,3,26,49,16,26,7,23,4,9,8,23,49
2003-02-17 00:00:00.000,Rotterdam The Netherlands ATP World Tour,HARD,2,Nicolas Escude,Albert Costa,Nicolas Escude,6-3; 6-3,R32,80,11,1,32,53,29,32,10,21,2,2,9,39,53,1,2,36,62,24,36,12,26,3,6,9,36,62
2003-02-17 00:00:00.000,Rotterdam The Netherlands ATP World Tour,HARD,2,Richard Krajicek,Tommy Robredo,Richard Krajicek,7-6(5); 6-7(5); 6-2,R32,118,23,7,54,108,48,54,27,54,2,3,16,75,108,5,0,71,96,49,71,19,25,4,7,16,68,96
2003-02-17 00:00:00.000,Rotterdam The Netherlands ATP World Tour,HARD,2,Dominik Hrbaty,Adrian Voinea,Dominik Hrbaty,6-4; 6-2,R32,68,5,4,34,61,23,34,20,27,4,4,9,43,61,5,4,37,64,25,37,11,27,5,8,9,36,64
2003-02-17 00:00:00.000,Rotterdam The Netherlands ATP World Tour,HARD,2,Sebastien Grosjean,Renzo Furlan,Sebastien Grosjean,6-3; 6-4,R32,78,2,0,27,57,20,27,20,30,1,2,10,40,57,3,0,31,54,21,31,10,23,1,4,9,31,54
2003-02-17 00:00:00.000,Rotterdam The Netherlands ATP World Tour,HARD,2,Ivan Ljubicic,Tim Henman,Ivan Ljubicic,6-4; 6-2,R32,72,13,3,29,47,24,29,12,18,0,0,9,36,47,3,2,35,57,23,35,10,22,5,8,9,33,57
2003-02-17 00:00:00.000,Rotterdam The Netherlands ATP World Tour,HARD,2,Max Mirnyi,Mario Ancic,Max Mirnyi,6-7(5); 7-6(5); 6-4,R32,118,7,9,63,104,56,63,23,41,2,2,17,79,104,10,3,64,96,55,64,19,32,0,1,17,74,96
2003-02-17 00:00:00.000,Rotterdam The Netherlands ATP World Tour,HARD,2,Yevgeny Kafelnikov,Feliciano Lopez,Yevgeny Kafelnikov,6-2; 6-0,R32,43,8,3,17,36,15,17,13,19,0,0,7,28,36,4,2,26,40,16,26,2,14,2,7,7,18,40
2003-02-17 00:00:00.000,Rotterdam The Netherlands ATP World Tour,HARD,2,Marat Safin,Xavier Malisse,Marat Safin,7-5; 6-3,R32,71,2,2,36,56,28,36,14,20,1,1,10,42,56,3,3,32,61,24,32,14,29,3,6,11,38,61
2003-02-17 00:00:00.000,Rotterdam The Netherlands ATP World Tour,HARD,2,Sjeng Schalken,Christophe Rochus,Sjeng Schalken,6-3; 6-3,R32,55,8,1,30,44,26,30,11,14,0,0,9,37,44,1,1,40,56,25,40,7,16,3,6,9,32,56
2003-02-17 00:00:00.000,Rotterdam The Netherlands ATP World Tour,HARD,2,Olivier Rochus,Stefan Koubek,Olivier Rochus,6-2; 6-1,R32,46,1,1,22,35,21,22,8,13,0,0,7,29,35,5,3,30,50,16,30,8,20,2,7,8,24,50
2003-02-17 00:00:00.000,Rotterdam The Netherlands ATP World Tour,HARD,2,Fabrice Santoro,Andrei Pavel,Fabrice Santoro,6-4; 4-6; 6-2,R32,110,5,1,54,75,41,54,13,21,1,3,14,54,75,9,1,56,90,35,56,16,34,4,8,14,51,90
2003-02-17 00:00:00.000,Rotterdam The Netherlands ATP World Tour,HARD,2,Roger Federer,Thomas Enqvist,Roger Federer,3-6; 6-3; 6-4,R32,97,9,5,38,71,35,38,18,33,3,5,14,53,71,8,9,44,93,31,44,25,49,4,7,14,56,93
2003-02-17 00:00:00.000,Rotterdam The Netherlands ATP World Tour,HARD,2,Juan Carlos Ferrero,Jonas Bjorkman,Juan Carlos Ferrero,3-6; 6-4; 6-1,R16,110,8,3,57,86,41,57,16,29,4,6,13,57,86,2,2,39,77,27,39,17,38,3,7,13,44,77
2003-02-17 00:00:00.000,Rotterdam The Netherlands ATP World Tour,HARD,2,Raemon Sluiter,Jarkko Nieminen,Raemon Sluiter,7-6(7); 2-6; 6-3,R16,120,8,3,84,122,59,84,19,38,13,16,15,78,122,7,2,53,84,41,53,18,31,1,3,14,59,84
2003-02-17 00:00:00.000,Rotterdam The Netherlands ATP World Tour,HARD,2,Nicolas Escude,Richard Krajicek,Nicolas Escude,6-3; 6-7(1); 7-6(4),R16,140,5,7,72,126,54,72,23,54,4,7,17,77,126,18,10,48,105,37,48,26,57,2,6,16,63,105
2003-02-17 00:00:00.000,Rotterdam The Netherlands ATP World Tour,HARD,2,Sebastien Grosjean,Dominik Hrbaty,Sebastien Grosjean,7-5; 6-3,R16,77,5,1,26,54,22,26,18,28,3,4,10,40,54,5,0,41,68,28,41,13,27,4,8,11,41,68
2003-02-17 00:00:00.000,Rotterdam The Netherlands ATP World Tour,HARD,2,Max Mirnyi,Ivan Ljubicic,Max Mirnyi,4-2 RET,R16,22,6,1,9,14,8,9,4,5,0,0,3,12,14,0,2,10,19,8,10,2,9,0,1,3,10,19
2003-02-17 00:00:00.000,Rotterdam The Netherlands ATP World Tour,HARD,2,Yevgeny Kafelnikov,Marat Safin,Yevgeny Kafelnikov,4-6; 7-6(5); 6-4,R16,127,4,6,44,105,30,44,32,61,6,10,16,62,105,11,0,59,93,38,59,19,34,5,9,16,57,93
2003-02-17 00:00:00.000,Rotterdam The Netherlands ATP World Tour,HARD,2,Sjeng Schalken,Olivier Rochus,Sjeng Schalken,7-5; 6-2,R16,68,9,4,32,57,26,32,13,25,4,5,10,39,57,4,2,31,51,22,31,7,20,1,5,10,29,51
2003-02-17 00:00:00.000,Rotterdam The Netherlands ATP World Tour,HARD,2,Roger Federer,Fabrice Santoro,Roger Federer,6-0; 6-4,R16,58,1,2,24,40,20,24,12,16,0,0,8,32,40,2,0,29,49,15,29,9,20,1,5,8,24,49
2003-02-17 00:00:00.000,Rotterdam The Netherlands ATP World Tour,HARD,2,Raemon Sluiter,Juan Carlos Ferrero,Raemon Sluiter,1-2 RET,Q,18,0,0,3,10,2,3,4,7,2,2,1,6,10,2,0,7,11,6,7,2,4,0,0,2,8,11
2003-02-17 00:00:00.000,Rotterdam The Netherlands ATP World Tour,HARD,2,Sebastien Grosjean,Nicolas Escude,Sebastien Grosjean,5-7; 7-6(3); 4-4 RET,Q,139,8,0,66,103,43,66,18,37,3,7,16,61,103,10,6,59,107,46,59,20,48,5,8,16,66,107
2003-02-17 00:00:00.000,Rotterdam The Netherlands ATP World Tour,HARD,2,Max Mirnyi,Yevgeny Kafelnikov,Max Mirnyi,7-6(5); 7-6(4),Q,98,21,5,56,91,44,56,22,35,5,5,12,66,91,5,5,50,89,37,50,24,39,2,2,12,61,89
2003-02-17 00:00:00.000,Rotterdam The Netherlands ATP World Tour,HARD,2,Roger Federer,Sjeng Schalken,Roger Federer,6-2; 6-4,Q,66,9,3,33,57,25,33,11,24,1,3,9,36,57,0,3,21,47,12,21,10,26,1,6,9,22,47
2003-02-17 00:00:00.000,Rotterdam The Netherlands ATP World Tour,HARD,2,Raemon Sluiter,Sebastien Grosjean,Raemon Sluiter,6-3; 6-3,S,63,8,2,33,51,26,33,7,18,3,5,9,33,51,2,0,26,48,12,26,10,22,5,10,9,22,48
2003-02-17 00:00:00.000,Rotterdam The Netherlands ATP World Tour,HARD,2,Max Mirnyi,Roger Federer,Max Mirnyi,5-7; 6-3; 6-4,S,101,13,5,51,86,42,51,20,35,5,7,16,62,86,5,3,48,78,37,48,17,30,3,6,15,54,78
2003-02-17 00:00:00.000,Rotterdam The Netherlands ATP World Tour,HARD,2,Max Mirnyi,Raemon Sluiter,Max Mirnyi,7-6(3); 6-4,F,73,7,2,36,62,31,36,17,26,1,1,11,48,62,7,1,42,66,31,42,15,24,0,1,11,46,66
2003-02-24 00:00:00.000,Acapulco Mexico ATP World Tour,CLAY,2,Carlos Moya,Flavio Saretta,Carlos Moya,6-0; 6-2,R32,49,7,1,21,33,20,21,8,12,0,0,7,28,33,1,2,28,48,13,28,7,20,4,9,7,20,48
2003-02-24 00:00:00.000,Acapulco Mexico ATP World Tour,CLAY,2,Ricardo Mello,Francisco Clavet,Ricardo Mello,6-4; 4-6; 6-1,R32,120,3,4,46,76,33,46,15,30,6,9,13,48,76,2,3,55,92,33,55,17,37,8,14,14,50,92
2003-02-24 00:00:00.000,Acapulco Mexico ATP World Tour,CLAY,2,Fernando Vicente,Alberto Martin,Fernando Vicente,6-2; 6-1,R32,62,2,0,19,38,15,19,10,19,0,1,7,25,38,0,4,35,51,20,35,3,16,3,9,8,23,51
2003-02-24 00:00:00.000,Acapulco Mexico ATP World Tour,CLAY,2,Felix Mantilla,Juan Ignacio Chela,Felix Mantilla,7-6(4); 7-6(1),R32,99,1,2,49,79,30,49,14,30,3,8,12,44,79,3,3,44,75,23,44,11,31,2,7,12,34,75
2003-02-24 00:00:00.000,Acapulco Mexico ATP World Tour,CLAY,2,Gaston Gaudio,David Sanchez,Gaston Gaudio,1-6; 6-4; 6-4,R32,130,1,6,54,87,34,54,18,33,6,10,14,52,87,10,3,57,102,39,57,20,45,11,14,13,59,102
2003-02-24 00:00:00.000,Acapulco Mexico ATP World Tour,CLAY,2,Agustin Calleri,Miguel Gallardo-Valles,Agustin Calleri,6-1; 6-3,R32,68,11,3,23,42,18,23,12,19,0,1,8,30,42,0,2,40,63,22,40,8,23,8,13,8,30,63
2003-02-24 00:00:00.000,Acapulco Mexico ATP World Tour,CLAY,2,Juan Antonio Marin,Fernando Meligeni,Juan Antonio Marin,6-1; 6-4,R32,64,2,0,19,42,17,19,13,23,0,2,9,30,42,4,4,27,55,16,27,9,28,7,12,8,25,55
2003-02-24 00:00:00.000,Acapulco Mexico ATP World Tour,CLAY,2,Marcelo Rios,Franco Squillari,Marcelo Rios,2-6; 6-0; 6-4,R32,117,3,1,51,69,38,51,7,18,1,3,12,45,69,3,5,53,108,30,53,28,55,13,17,12,58,108
2003-02-24 00:00:00.000,Acapulco Mexico ATP World Tour,CLAY,2,Gustavo Kuerten,Nicolas Coutelot,Gustavo Kuerten,6-7(2); 7-6(10); 6-2,R32,146,7,2,53,108,43,53,33,55,4,5,16,76,108,9,1,66,124,46,66,32,58,7,10,16,78,124
2003-02-24 00:00:00.000,Acapulco Mexico ATP World Tour,CLAY,2,David Ferrer,Albert Portas,David Ferrer,6-1; 6-4,R32,64,7,5,40,64,32,40,12,24,9,9,9,44,64,6,2,35,56,24,35,5,21,1,4,8,29,56
2003-02-24 00:00:00.000,Acapulco Mexico ATP World Tour,CLAY,2,Sargis Sargsian,Albert Montanes,Sargis Sargsian,6-3; 6-0,R32,52,5,2,31,43,27,31,7,12,0,0,8,34,43,6,2,25,49,14,25,11,24,4,8,7,25,49
2003-02-24 00:00:00.000,Acapulco Mexico ATP World Tour,CLAY,2,Fernando Gonzalez,Ruben Ramirez Hidalgo,Fernando Gonzalez,6-1; 3-6; 7-6(6),R32,111,11,14,40,92,36,40,28,52,5,7,14,64,92,7,2,52,80,38,52,17,28,2,5,14,55,80
2003-02-24 00:00:00.000,Acapulco Mexico ATP World Tour,CLAY,2,Luis Horna,Nicolas Lapentti,Luis Horna,6-2; 6-1,R32,50,2,1,29,39,24,29,8,10,0,0,8,32,39,0,4,24,44,15,24,7,20,6,10,7,22,44
2003-02-24 00:00:00.000,Acapulco Mexico ATP World Tour,CLAY,2,Ivan Miranda,Andre Sa,Ivan Miranda,7-5; 4-6; 7-6(1),R32,125,3,2,55,93,42,55,25,38,2,5,17,67,93,4,5,62,103,45,62,20,41,1,4,17,65,103
2003-02-24 00:00:00.000,Acapulco Mexico ATP World Tour,CLAY,2,Mariano Zabaleta,Filippo Volandri,Mariano Zabaleta,6-1; 6-2,R32,63,2,1,21,41,17,21,13,20,3,3,7,30,41,0,2,31,55,14,31,11,24,6,11,8,25,55
2003-02-24 00:00:00.000,Acapulco Mexico ATP World Tour,CLAY,2,David Nalbandian,Nicolas Massu,David Nalbandian,2-6; 6-1; 6-4,R32,127,5,3,48,84,33,48,22,36,2,4,13,55,84,4,4,33,75,22,33,23,42,1,4,12,45,75
2003-02-24 00:00:00.000,Acapulco Mexico ATP World Tour,CLAY,2,Carlos Moya,Ricardo Mello,Carlos Moya,4-6; 6-3; 6-2,R16,101,7,2,44,70,34,44,16,26,0,2,14,50,70,3,3,41,78,27,41,19,37,4,8,13,46,78
2003-02-24 00:00:00.000,Acapulco Mexico ATP World Tour,CLAY,2,Felix Mantilla,Fernando Vicente,Felix Mantilla,6-3; 6-4,R16,83,1,2,37,62,28,37,14,25,1,2,10,42,62,8,6,29,61,21,29,14,32,7,10,9,35,61
2003-02-24 00:00:00.000,Acapulco Mexico ATP World Tour,CLAY,2,Agustin Calleri,Gaston Gaudio,Agustin Calleri,7-6(5); 7-6(5),R16,113,14,4,39,86,35,39,23,47,6,8,12,58,86,5,1,52,83,38,52,19,31,5,7,12,57,83
2003-02-24 00:00:00.000,Acapulco Mexico ATP World Tour,CLAY,2,Marcelo Rios,Juan Antonio Marin,Marcelo Rios,6-3; 6-1,R16,48,2,2,24,43,21,24,10,19,0,1,8,31,43,2,3,19,43,11,19,8,24,1,6,8,19,43
2003-02-24 00:00:00.000,Acapulco Mexico ATP World Tour,CLAY,2,Gustavo Kuerten,David Ferrer,Gustavo Kuerten,5-7; 6-1; 6-2,R16,112,6,3,45,85,37,45,13,40,4,7,13,50,85,7,5,58,99,34,58,17,41,5,12,14,51,99
2003-02-24 00:00:00.000,Acapulco Mexico ATP World Tour,CLAY,2,Fernando Gonzalez,Sargis Sargsian,Fernando Gonzalez,6-3; 4-6; 7-6(5),R16,137,25,10,62,109,46,62,29,47,5,6,16,75,109,15,5,71,105,52,71,19,34,8,9,15,71,105
2003-02-24 00:00:00.000,Acapulco Mexico ATP World Tour,CLAY,2,Ivan Miranda,Luis Horna,Ivan Miranda,2-6; 6-3; 6-2,R16,96,9,2,48,80,36,48,15,32,1,3,13,51,80,4,2,52,72,36,52,9,20,4,7,12,45,72
2003-02-24 00:00:00.000,Acapulco Mexico ATP World Tour,CLAY,2,Mariano Zabaleta,David Nalbandian,Mariano Zabaleta,6-7(5); 6-0; 6-0,R16,117,4,4,49,75,38,49,14,26,0,1,12,52,75,5,6,60,93,31,60,14,33,6,13,12,45,93
2003-02-24 00:00:00.000,Acapulco Mexico ATP World Tour,CLAY,2,Felix Mantilla,Carlos Moya,Felix Mantilla,6-4; 7-6(4),Q,101,0,2,49,76,37,49,16,27,4,5,11,53,76,9,3,38,74,28,38,19,36,2,4,11,47,74
2003-02-24 00:00:00.000,Acapulco Mexico ATP World Tour,CLAY,2,Agustin Calleri,Marcelo Rios,Agustin Calleri,6-3; 7-5,Q,73,11,2,33,56,25,33,13,23,4,6,10,38,56,7,8,54,80,33,54,9,26,12,17,11,42,80
2003-02-24 00:00:00.000,Acapulco Mexico ATP World Tour,CLAY,2,Gustavo Kuerten,Fernando Gonzalez,Gustavo Kuerten,6-4 RET,Q,38,4,2,17,25,13,17,3,8,0,1,5,16,25,1,0,17,27,12,17,3,10,2,4,5,15,27
2003-02-24 00:00:00.000,Acapulco Mexico ATP World Tour,CLAY,2,Mariano Zabaleta,Ivan Miranda,Mariano Zabaleta,7-5; 6-3,Q,86,2,2,37,56,29,37,14,19,3,3,10,43,56,9,0,45,67,28,45,13,22,5,8,11,41,67
2003-02-24 00:00:00.000,Acapulco Mexico ATP World Tour,CLAY,2,Agustin Calleri,Felix Mantilla,Agustin Calleri,6-2; 6-2,S,66,5,1,26,46,25,26,10,20,1,1,8,35,46,0,1,27,46,17,27,6,19,2,6,8,23,46
2003-02-24 00:00:00.000,Acapulco Mexico ATP World Tour,CLAY,2,Mariano Zabaleta,Gustavo Kuerten,Mariano Zabaleta,7-6(4); 6-7(3); 7-5,S,176,0,1,68,114,47,68,28,46,3,7,18,75,114,10,2,69,117,50,69,22,48,7,12,18,72,117
2003-02-24 00:00:00.000,Acapulco Mexico ATP World Tour,CLAY,2,Agustin Calleri,Mariano Zabaleta,Agustin Calleri,7-5; 3-6; 6-3,F,155,5,3,60,105,43,60,22,45,10,13,15,65,105,3,1,49,90,35,49,20,41,0,4,15,55,90
2003-02-24 00:00:00.000,Copenhagen Denmark ATP World Tour,HARD,2,Olivier Rochus,Jarkko Nieminen,Olivier Rochus,6-3; 6-2,R32,63,1,0,35,47,24,35,6,12,0,2,9,30,47,5,0,23,46,11,23,11,23,5,10,8,22,46
2003-02-24 00:00:00.000,Copenhagen Denmark ATP World Tour,HARD,2,Lars Burgsmuller,Jurgen Melzer,Lars Burgsmuller,6-4; 6-4,R32,92,4,2,29,60,23,29,19,31,1,2,10,42,60,4,1,45,88,31,45,19,43,10,13,10,50,88
2003-02-24 00:00:00.000,Copenhagen Denmark ATP World Tour,HARD,2,Jiri Vanek,Rasmus Norby,Jiri Vanek,6-4; 2-6; 6-3,R32,128,4,3,39,69,31,39,15,30,3,6,13,46,69,4,7,57,108,39,57,22,51,6,10,14,61,108
2003-02-24 00:00:00.000,Copenhagen Denmark ATP World Tour,HARD,2,Tomas Behrend,Mario Ancic,Tomas Behrend,6-4; 6-7(7); 7-6(2),R32,145,9,7,67,111,54,67,28,44,2,3,17,82,111,18,2,70,118,52,70,27,48,4,6,17,79,118
2003-02-24 00:00:00.000,Copenhagen Denmark ATP World Tour,HARD,2,Radek Stepanek,Arnaud Di Pasquale,Radek Stepanek,7-6(3); 3-6; 6-3,R32,110,11,2,61,94,44,61,14,33,6,10,15,58,94,8,9,57,90,42,57,10,33,3,7,15,52,90
2003-02-24 00:00:00.000,Copenhagen Denmark ATP World Tour,HARD,2,Magnus Larsson,Frederik Nielsen,Magnus Larsson,6-1; 6-1,R32,40,4,1,32,40,25,32,3,8,2,3,7,28,40,2,0,22,41,8,22,6,19,5,11,7,14,41
2003-02-24 00:00:00.000,Copenhagen Denmark ATP World Tour,HARD,2,Karol Beck,Justin Gimelstob,Karol Beck,6-4; 6-3,R32,71,9,2,32,57,25,32,12,25,1,3,10,37,57,5,2,23,55,17,23,11,32,0,4,9,28,55
2003-02-24 00:00:00.000,Copenhagen Denmark ATP World Tour,HARD,2,Antony Dupuis,Martin Verkerk,Antony Dupuis,6-4; 6-4,R32,62,10,2,29,48,27,29,14,19,0,0,10,41,48,9,1,37,56,28,37,9,19,2,4,10,37,56
2003-02-24 00:00:00.000,Copenhagen Denmark ATP World Tour,HARD,2,Michel Kratochvil,Kenneth Carlsen,Michel Kratochvil,6-7(3); 6-3; 6-4,R32,134,5,2,61,103,45,61,26,42,11,12,16,71,103,10,4,60,93,48,60,12,33,2,5,15,60,93
2003-02-24 00:00:00.000,Copenhagen Denmark ATP World Tour,HARD,2,Jean-Rene Lisnard,Gilles Muller,Jean-Rene Lisnard,7-5; 6-4,R32,192,2,7,38,77,27,38,19,39,6,8,11,46,77,3,3,30,61,17,30,21,31,2,6,11,38,61
2003-02-24 00:00:00.000,Copenhagen Denmark ATP World Tour,HARD,2,Marc Rosset,Massimo Dell'Acqua,Marc Rosset,7-6(6); 7-6(4),R32,104,16,5,50,83,43,50,17,33,3,4,12,60,83,14,3,54,80,41,54,13,26,1,2,12,54,80
2003-02-24 00:00:00.000,Copenhagen Denmark ATP World Tour,HARD,2,Karol Kucera,Kristof Vliegen,Karol Kucera,6-2; 6-3,R32,72,5,4,26,61,20,26,23,35,4,4,9,43,61,1,2,21,43,15,21,11,22,3,6,8,26,43
2003-02-24 00:00:00.000,Copenhagen Denmark ATP World Tour,HARD,2,Magnus Norman,Raemon Sluiter,Magnus Norman,7-6(4); 7-5,R32,84,9,2,46,76,34,46,18,30,0,1,12,52,76,10,3,50,69,40,50,7,19,4,6,12,47,69
2003-02-24 00:00:00.000,Copenhagen Denmark ATP World Tour,HARD,2,Kristian Pless,Cecil Mamiit,Kristian Pless,6-2; 6-0,R32,48,5,2,20,37,17,20,12,17,1,1,7,29,37,1,1,37,48,20,37,1,11,6,11,7,21,48
2003-02-24 00:00:00.000,Copenhagen Denmark ATP World Tour,HARD,2,Andreas Vinciguerra,Brian Vahaly,Andreas Vinciguerra,6-4; 6-4,R32,64,6,0,35,50,30,35,10,15,0,0,10,40,50,2,5,43,65,28,43,11,22,5,7,10,39,65
2003-02-24 00:00:00.000,Copenhagen Denmark ATP World Tour,HARD,2,Wayne Arthurs,Olivier Mutis,Wayne Arthurs,7-6(5); 6-2,R32,68,17,5,42,67,33,42,13,25,2,2,10,46,67,1,7,44,67,29,44,12,23,2,4,10,41,67
2003-02-24 00:00:00.000,Copenhagen Denmark ATP World Tour,HARD,2,Olivier Rochus,Lars Burgsmuller,Olivier Rochus,6-1; 6-2,R16,61,3,1,26,44,19,26,12,18,1,2,8,31,44,1,4,19,49,11,19,12,30,8,13,7,23,49
2003-02-24 00:00:00.000,Copenhagen Denmark ATP World Tour,HARD,2,Tomas Behrend,Jiri Vanek,Tomas Behrend,6-7(4); 6-3; 6-3,R16,128,6,4,55,91,40,55,22,36,2,4,15,62,91,9,1,54,107,42,54,22,53,8,13,15,64,107
2003-02-24 00:00:00.000,Copenhagen Denmark ATP World Tour,HARD,2,Radek Stepanek,Magnus Larsson,Radek Stepanek,6-4; 1-6; 6-1,R16,86,11,2,45,76,36,45,13,31,3,5,12,49,76,10,3,45,68,36,45,7,23,4,7,12,43,68
2003-02-24 00:00:00.000,Copenhagen Denmark ATP World Tour,HARD,2,Karol Beck,Antony Dupuis,Karol Beck,4-6; 7-6(5); 1-0 RET,R16,113,6,2,38,74,27,38,12,36,6,11,11,39,74,8,4,51,88,30,51,15,37,5,10,12,45,88
2003-02-24 00:00:00.000,Copenhagen Denmark ATP World Tour,HARD,2,Michel Kratochvil,Jean-Rene Lisnard,Michel Kratochvil,7-6(5); 7-6(6),R16,128,3,5,50,87,39,50,18,37,2,5,12,57,87,3,3,65,99,40,65,19,34,4,7,12,59,99
2003-02-24 00:00:00.000,Copenhagen Denmark ATP World Tour,HARD,2,Karol Kucera,Marc Rosset,Karol Kucera,7-6(5); 6-3,R16,98,8,0,35,62,28,35,18,27,1,2,10,46,62,10,6,48,75,34,48,10,27,1,4,11,44,75
2003-02-24 00:00:00.000,Copenhagen Denmark ATP World Tour,HARD,2,Magnus Norman,Kristian Pless,Magnus Norman,6-4; 7-6(6),R16,86,8,1,36,70,29,36,22,34,1,1,11,51,70,9,2,43,71,34,43,15,28,0,1,11,49,71
2003-02-24 00:00:00.000,Copenhagen Denmark ATP World Tour,HARD,2,Wayne Arthurs,Andreas Vinciguerra,Wayne Arthurs,6-7(4); 6-4; 7-6(6),R16,109,35,4,57,89,53,57,26,32,0,0,17,79,89,13,3,69,106,56,69,25,37,4,5,17,81,106
2003-02-24 00:00:00.000,Copenhagen Denmark ATP World Tour,HARD,2,Olivier Rochus,Tomas Behrend,Olivier Rochus,6-4; 6-1,Q,68,1,2,18,42,17,18,16,24,0,0,8,33,42,8,0,34,64,23,34,12,30,3,7,9,35,64
2003-02-24 00:00:00.000,Copenhagen Denmark ATP World Tour,HARD,2,Radek Stepanek,Karol Beck,Radek Stepanek,6-4; 1-6; 6-2,Q,103,8,2,42,73,33,42,16,31,5,7,12,49,73,4,7,55,94,41,55,18,39,8,11,13,59,94
2003-02-24 00:00:00.000,Copenhagen Denmark ATP World Tour,HARD,2,Karol Kucera,Michel Kratochvil,Karol Kucera,7-5; 6-2,Q,86,6,2,28,49,23,28,14,21,0,1,10,37,49,2,2,42,75,24,42,15,33,5,9,10,39,75
2003-02-24 00:00:00.000,Copenhagen Denmark ATP World Tour,HARD,2,Wayne Arthurs,Magnus Norman,Wayne Arthurs,6-7(7); 7-5; 6-4,Q,137,22,5,61,110,50,61,28,49,2,2,17,78,110,7,2,70,108,55,70,20,38,4,6,17,75,108
2003-02-24 00:00:00.000,Copenhagen Denmark ATP World Tour,HARD,2,Olivier Rochus,Radek Stepanek,Olivier Rochus,6-3; 6-7(2); 6-4,S,129,1,7,54,98,42,54,25,44,2,4,16,67,98,11,7,59,95,43,59,16,36,5,9,15,59,95
2003-02-24 00:00:00.000,Copenhagen Denmark ATP World Tour,HARD,2,Karol Kucera,Wayne Arthurs,Karol Kucera,6-2; 6-4,S,60,4,0,21,39,20,21,16,18,0,0,9,36,39,2,1,30,52,26,30,5,22,1,4,9,31,52
2003-02-24 00:00:00.000,Copenhagen Denmark ATP World Tour,HARD,2,Karol Kucera,Olivier Rochus,Karol Kucera,7-6(4); 6-4,F,100,8,5,33,67,27,33,19,34,3,5,11,46,67,1,4,42,82,22,42,25,40,7,10,11,47,82
2003-02-24 00:00:00.000,Dubai U.A.E. ATP World Tour,HARD,2,Roger Federer,Irakli Labadze,Roger Federer,6-3; 6-3,R32,63,2,2,31,50,25,31,10,19,3,4,9,35,50,4,8,31,66,19,31,17,35,7,11,9,36,66
2003-02-24 00:00:00.000,Dubai U.A.E. ATP World Tour,HARD,2,Maximilian Abel,Ivo Heuberger,Maximilian Abel,0-1 RET,R32,3,0,0,1,3,1,1,1,2,0,0,0,2,3,0,0,3,4,3,3,1,1,0,0,1,4,4
2003-02-24 00:00:00.000,Dubai U.A.E. ATP World Tour,HARD,2,Hicham Arazi,Jan Vacek,Hicham Arazi,6-2; 6-1,R32,126,2,0,28,50,17,28,16,22,4,5,8,33,50,2,2,26,44,12,26,5,18,6,11,7,17,44
2003-02-24 00:00:00.000,Dubai U.A.E. ATP World Tour,HARD,2,Yevgeny Kafelnikov,John van Lottum,Yevgeny Kafelnikov,6-2; 4-6; 6-3,R32,92,6,3,46,79,36,46,16,33,5,8,14,52,79,10,7,38,76,27,38,16,38,5,10,13,43,76
2003-02-24 00:00:00.000,Dubai U.A.E. ATP World Tour,HARD,2,Attila Savolt,Tim Henman,Attila Savolt,5-7; 7-6(3); 6-4,R32,163,4,4,53,99,41,53,27,46,6,10,17,68,99,5,8,61,103,48,61,15,42,2,6,17,63,103
2003-02-24 00:00:00.000,Dubai U.A.E. ATP World Tour,HARD,2,Ivan Ljubicic,Wayne Black,Ivan Ljubicic,7-5; 6-3,R32,0,14,9,41,77,36,41,15,36,4,4,11,51,77,5,1,31,61,21,31,18,30,4,6,10,39,61
2003-02-24 00:00:00.000,Dubai U.A.E. ATP World Tour,HARD,2,Max Mirnyi,Adrian Voinea,Max Mirnyi,6-4; 6-2,R32,52,13,3,28,47,22,28,12,19,0,1,9,34,47,5,2,28,51,17,28,10,23,0,4,9,27,51
2003-02-24 00:00:00.000,Dubai U.A.E. ATP World Tour,HARD,2,Rainer Schuettler,Zeljko Krajan,Rainer Schuettler,6-4; 2-6; 6-3,R32,110,2,4,49,87,34,49,18,38,4,7,13,52,87,2,2,47,80,31,47,17,33,2,6,14,48,80
2003-02-24 00:00:00.000,Dubai U.A.E. ATP World Tour,HARD,2,Sjeng Schalken,Mikhail Youzhny,Sjeng Schalken,7-5; 6-0,R32,67,2,1,25,49,22,25,15,24,2,3,9,37,49,1,3,26,51,16,26,8,25,3,8,9,24,51
2003-02-24 00:00:00.000,Dubai U.A.E. ATP World Tour,HARD,2,Fabrice Santoro,Stefan Koubek,Fabrice Santoro,6-7(1); 6-2; 6-0,R32,128,1,3,47,79,34,47,19,32,3,4,13,53,79,0,2,50,89,30,50,18,39,9,15,13,48,89
2003-02-24 00:00:00.000,Dubai U.A.E. ATP World Tour,HARD,2,Andrei Stoliarov,Goran Ivanisevic,Andrei Stoliarov,6-6(0) RET,R32,6,4,2,19,34,13,19,7,15,1,3,6,20,34,7,4,13,39,10,13,12,26,6,8,6,22,39
2003-02-24 00:00:00.000,Dubai U.A.E. ATP World Tour,HARD,2,Jiri Novak,Dominik Hrbaty,Jiri Novak,6-1; 3-6; 6-3,R32,69,4,1,57,80,43,57,11,23,5,7,13,54,80,3,2,54,83,35,54,11,29,8,12,12,46,83
2003-02-24 00:00:00.000,Dubai U.A.E. ATP World Tour,HARD,2,Younes El Aynaoui,Omar Awadhy,Younes El Aynaoui,6-0; 6-3,R32,121,2,1,29,44,24,29,9,15,2,2,8,33,44,0,2,24,42,11,24,8,18,2,6,7,19,42
2003-02-24 00:00:00.000,Dubai U.A.E. ATP World Tour,HARD,2,Feliciano Lopez,Vadim Kutsenko,Feliciano Lopez,7-6(5); 6-2,R32,60,12,4,36,59,34,36,11,23,1,1,10,45,59,2,8,35,65,23,35,16,30,4,6,10,39,65
2003-02-24 00:00:00.000,Dubai U.A.E. ATP World Tour,HARD,2,Tommy Robredo,Jonas Bjorkman,Tommy Robredo,6-2; 6-3,R32,80,4,4,28,57,20,28,17,29,2,3,8,37,57,1,2,31,56,20,31,7,25,7,12,9,27,56
2003-02-24 00:00:00.000,Dubai U.A.E. ATP World Tour,HARD,2,Marat Safin,Alexander Waske,Marat Safin,6-4; 6-2,R32,71,8,1,29,50,23,29,17,21,3,3,9,40,50,5,4,33,62,21,33,12,29,2,5,9,33,62
2003-02-24 00:00:00.000,Dubai U.A.E. ATP World Tour,HARD,2,Roger Federer,Maximilian Abel,Roger Federer,6-4; 7-5,R16,79,3,2,37,56,32,37,10,19,0,1,11,42,56,2,5,55,81,35,55,12,26,11,14,11,47,81
2003-02-24 00:00:00.000,Dubai U.A.E. ATP World Tour,HARD,2,Hicham Arazi,Yevgeny Kafelnikov,Hicham Arazi,6-4; 4-6; 6-3,R16,92,6,4,47,81,37,47,20,34,4,6,14,57,81,4,1,63,85,40,63,12,22,3,7,15,52,85
2003-02-24 00:00:00.000,Dubai U.A.E. ATP World Tour,HARD,2,Ivan Ljubicic,Attila Savolt,Ivan Ljubicic,6-4; 6-4,R16,78,18,4,33,61,27,33,16,28,0,0,10,43,61,2,3,30,58,23,30,15,28,3,5,10,38,58
2003-02-24 00:00:00.000,Dubai U.A.E. ATP World Tour,HARD,2,Rainer Schuettler,Max Mirnyi,Rainer Schuettler,7-6(6); 4-6; 7-6(8),R16,159,2,2,53,110,36,53,36,57,3,8,17,72,110,10,15,83,143,61,83,26,60,9,13,17,87,143
2003-02-24 00:00:00.000,Dubai U.A.E. ATP World Tour,HARD,2,Sjeng Schalken,Fabrice Santoro,Sjeng Schalken,3-6; 7-6(2); 7-6(5),R16,177,1,1,66,100,50,66,20,34,3,6,16,70,100,8,2,85,153,57,85,34,68,21,23,17,91,153
2003-02-24 00:00:00.000,Dubai U.A.E. ATP World Tour,HARD,2,Jiri Novak,Andrei Stoliarov,Jiri Novak,6-1; 6-1,R16,44,2,3,20,39,19,20,10,19,0,0,7,29,39,3,2,16,42,7,16,9,26,4,9,7,16,42
2003-02-24 00:00:00.000,Dubai U.A.E. ATP World Tour,HARD,2,Feliciano Lopez,Younes El Aynaoui,Feliciano Lopez,7-6(2); 7-6(5),R16,93,6,2,45,75,35,45,23,30,3,3,12,58,75,10,0,56,80,42,56,14,24,2,2,12,56,80
2003-02-24 00:00:00.000,Dubai U.A.E. ATP World Tour,HARD,2,Tommy Robredo,Marat Safin,Tommy Robredo,7-5; 4-6; 7-6(3),R16,171,3,5,89,146,52,89,33,57,10,13,17,85,146,7,2,69,107,47,69,21,38,3,6,17,68,107
2003-02-24 00:00:00.000,Dubai U.A.E. ATP World Tour,HARD,2,Roger Federer,Hicham Arazi,Roger Federer,7-5; 6-3,Q,78,4,1,53,77,36,53,13,24,6,8,11,49,77,1,1,39,63,26,39,10,24,2,6,10,36,63
2003-02-24 00:00:00.000,Dubai U.A.E. ATP World Tour,HARD,2,Ivan Ljubicic,Rainer Schuettler,Ivan Ljubicic,6-3; 6-4,Q,67,11,2,31,57,24,31,18,26,1,1,10,42,57,0,4,33,55,23,33,11,22,3,5,9,34,55
2003-02-24 00:00:00.000,Dubai U.A.E. ATP World Tour,HARD,2,Jiri Novak,Sjeng Schalken,Jiri Novak,6-4; 6-4,Q,67,5,1,37,54,30,37,8,17,2,3,10,38,54,3,0,41,58,23,41,12,17,1,4,10,35,58
2003-02-24 00:00:00.000,Dubai U.A.E. ATP World Tour,HARD,2,Tommy Robredo,Feliciano Lopez,Tommy Robredo,6-7(4); 6-3; 6-4,Q,111,2,3,70,91,54,70,12,21,0,0,16,66,91,8,3,63,104,49,63,18,41,5,7,15,67,104
2003-02-24 00:00:00.000,Dubai U.A.E. ATP World Tour,HARD,2,Roger Federer,Ivan Ljubicic,Roger Federer,6-3; 6-2,S,55,3,1,29,44,24,29,12,15,0,0,9,36,44,3,2,29,51,15,29,13,22,2,5,8,28,51
2003-02-24 00:00:00.000,Dubai U.A.E. ATP World Tour,HARD,2,Jiri Novak,Tommy Robredo,Jiri Novak,6-4; 6-1,S,66,2,1,33,53,23,33,9,20,7,9,8,32,53,2,4,41,62,24,41,4,21,4,10,9,28,62
2003-02-24 00:00:00.000,Dubai U.A.E. ATP World Tour,HARD,2,Roger Federer,Jiri Novak,Roger Federer,6-1; 7-6(2),F,76,3,4,23,59,16,23,21,36,0,2,10,37,59,0,1,39,63,19,39,13,24,5,9,9,32,63
2003-03-03 00:00:00.000,Delray Beach FL; U.S.A. ATP World Tour,HARD,2,Mardy Fish,Andy Roddick,Mardy Fish,7-6(4); 4-3 RET,R32,83,9,2,37,72,30,37,18,35,6,7,10,48,72,7,2,36,59,33,36,8,23,3,4,9,41,59
2003-03-03 00:00:00.000,Delray Beach FL; U.S.A. ATP World Tour,HARD,2,Fernando Meligeni,Attila Savolt,Fernando Meligeni,6-3; 6-4,R32,82,3,3,35,57,27,35,12,22,0,1,10,39,57,3,4,35,61,26,35,8,26,4,7,9,34,61
2003-03-03 00:00:00.000,Delray Beach FL; U.S.A. ATP World Tour,HARD,2,Alberto Martin,Brian Vahaly,Alberto Martin,6-4; 3-6; 6-3,R32,121,0,1,51,69,38,51,10,18,2,5,14,48,69,4,1,58,79,28,58,17,21,2,6,14,45,79
2003-03-03 00:00:00.000,Delray Beach FL; U.S.A. ATP World Tour,HARD,2,Irakli Labadze,Raemon Sluiter,Irakli Labadze,7-6(6); 7-5,R32,102,15,6,47,78,39,47,16,31,3,4,12,55,78,7,5,48,93,36,48,23,45,8,10,12,59,93
2003-03-03 00:00:00.000,Delray Beach FL; U.S.A. ATP World Tour,HARD,2,Marcelo Rios,Jeff Morrison,Marcelo Rios,6-3; 6-3,R32,59,3,1,32,55,27,32,13,23,5,6,9,40,55,1,3,34,58,21,34,11,24,4,8,9,32,58
2003-03-03 00:00:00.000,Delray Beach FL; U.S.A. ATP World Tour,HARD,2,Martin Verkerk,Ricardo Mello,Martin Verkerk,7-6(5); 6-4,R32,77,12,0,51,68,42,51,11,17,1,1,11,53,68,5,2,51,70,38,51,11,19,4,5,11,49,70
2003-03-03 00:00:00.000,Delray Beach FL; U.S.A. ATP World Tour,HARD,2,Hyung-Taik Lee,Andre Sa,Hyung-Taik Lee,7-5; 6-2,R32,97,1,2,41,71,28,41,17,30,7,8,10,45,71,2,4,40,74,25,40,15,34,6,10,10,40,74
2003-03-03 00:00:00.000,Delray Beach FL; U.S.A. ATP World Tour,HARD,2,Michel Kratochvil,Arnaud Clement,Michel Kratochvil,6-3; 7-6(5),R32,113,0,2,46,81,33,46,19,35,4,6,11,52,81,8,4,43,73,30,43,11,30,3,6,10,41,73
2003-03-03 00:00:00.000,Delray Beach FL; U.S.A. ATP World Tour,HARD,2,Vincent Spadea,Michael Llodra,Vincent Spadea,6-3; 6-0,R32,51,1,2,17,33,12,17,10,16,2,4,7,22,33,1,5,33,54,12,33,7,21,3,10,8,19,54
2003-03-03 00:00:00.000,Delray Beach FL; U.S.A. ATP World Tour,HARD,2,Flavio Saretta,Paul Goldstein,Flavio Saretta,6-4; 6-4,R32,94,3,1,43,67,30,43,13,24,5,6,10,43,67,1,3,36,68,24,36,15,32,4,7,10,39,68
2003-03-03 00:00:00.000,Delray Beach FL; U.S.A. ATP World Tour,HARD,2,Justin Gimelstob,Alex Bogomolov Jr.,Justin Gimelstob,6-4; 6-0,R32,160,5,1,24,47,19,24,15,23,0,0,8,34,47,0,2,42,58,23,42,5,16,6,10,8,28,58
2003-03-03 00:00:00.000,Delray Beach FL; U.S.A. ATP World Tour,HARD,2,Jan-Michael Gambill,Nicolas Kiefer,Jan-Michael Gambill,6-2; 6-4,R32,76,9,6,26,57,21,26,19,31,3,3,9,40,57,3,6,28,52,22,28,7,24,4,7,9,29,52
2003-03-03 00:00:00.000,Delray Beach FL; U.S.A. ATP World Tour,HARD,2,Robert Kendrick,Stefan Koubek,Robert Kendrick,6-4; 6-4,R32,73,8,3,35,53,31,35,10,18,0,0,10,41,53,3,2,55,82,36,55,13,27,13,15,10,49,82
2003-03-03 00:00:00.000,Delray Beach FL; U.S.A. ATP World Tour,HARD,2,Jean-Rene Lisnard,Lars Burgsmuller,Jean-Rene Lisnard,6-2; 4-6; 6-2,R32,95,2,3,37,66,29,37,19,29,0,2,13,48,66,3,1,50,80,35,50,11,30,1,6,13,46,80
2003-03-03 00:00:00.000,Delray Beach FL; U.S.A. ATP World Tour,HARD,2,Vladimir Voltchkov,Alex Kim,Vladimir Voltchkov,6-4; 6-4,R32,84,5,0,44,65,35,44,10,21,3,3,10,45,65,2,3,42,70,27,42,15,28,6,8,10,42,70
2003-03-03 00:00:00.000,Delray Beach FL; U.S.A. ATP World Tour,HARD,2,Sargis Sargsian,Guillermo Coria,Sargis Sargsian,7-5; 6-2,R32,75,6,3,32,57,27,32,15,25,0,0,10,42,57,1,0,36,53,24,36,7,17,2,5,10,31,53
2003-03-03 00:00:00.000,Delray Beach FL; U.S.A. ATP World Tour,HARD,2,Mardy Fish,Fernando Meligeni,Mardy Fish,6-2; 7-6(4),R16,90,7,4,31,60,27,31,16,29,0,0,10,43,60,0,2,53,76,32,53,12,23,6,8,10,44,76
2003-03-03 00:00:00.000,Delray Beach FL; U.S.A. ATP World Tour,HARD,2,Alberto Martin,Irakli Labadze,Alberto Martin,6-4; 6-2,R16,65,0,0,27,48,24,27,14,21,2,2,9,38,48,5,3,32,53,22,32,10,21,3,6,9,32,53
2003-03-03 00:00:00.000,Delray Beach FL; U.S.A. ATP World Tour,HARD,2,Marcelo Rios,Martin Verkerk,Marcelo Rios,2-6; 6-4; 7-5,R16,112,6,3,49,86,38,49,20,37,3,5,15,58,86,10,7,58,94,45,58,17,36,4,6,15,62,94
2003-03-03 00:00:00.000,Delray Beach FL; U.S.A. ATP World Tour,HARD,2,Hyung-Taik Lee,Michel Kratochvil,Hyung-Taik Lee,6-2; 6-3,R16,62,8,0,25,43,20,25,13,18,0,1,9,33,43,4,3,32,52,19,32,8,20,5,9,8,27,52
2003-03-03 00:00:00.000,Delray Beach FL; U.S.A. ATP World Tour,HARD,2,Flavio Saretta,Vincent Spadea,Flavio Saretta,6-4; 3-6; 6-4,R16,117,4,5,48,86,29,48,17,38,3,9,14,46,86,8,9,45,86,34,45,11,41,3,10,15,45,86
2003-03-03 00:00:00.000,Delray Beach FL; U.S.A. ATP World Tour,HARD,2,Jan-Michael Gambill,Justin Gimelstob,Jan-Michael Gambill,7-5; 7-5,R16,111,11,1,47,71,41,47,13,24,4,4,12,54,71,8,3,51,91,37,51,20,40,9,11,12,57,91
2003-03-03 00:00:00.000,Delray Beach FL; U.S.A. ATP World Tour,HARD,2,Robert Kendrick,Jean-Rene Lisnard,Robert Kendrick,7-5; 7-5,R16,102,16,8,61,99,42,61,16,38,13,15,12,58,99,1,5,57,80,36,57,10,23,6,10,12,46,80
2003-03-03 00:00:00.000,Delray Beach FL; U.S.A. ATP World Tour,HARD,2,Vladimir Voltchkov,Sargis Sargsian,Vladimir Voltchkov,5-7; 6-4; 1-0 RET,R16,119,5,2,50,70,32,50,11,20,2,5,12,43,70,3,6,39,75,27,39,16,36,5,8,11,43,75
2003-03-03 00:00:00.000,Delray Beach FL; U.S.A. ATP World Tour,HARD,2,Mardy Fish,Alberto Martin,Mardy Fish,6-3; 6-3,Q,77,7,0,22,49,20,22,17,27,0,0,9,37,49,1,3,36,65,22,36,14,29,9,12,9,36,65
2003-03-03 00:00:00.000,Delray Beach FL; U.S.A. ATP World Tour,HARD,2,Marcelo Rios,Hyung-Taik Lee,Marcelo Rios,6-3; 6-4,Q,80,6,0,36,60,24,36,14,24,6,8,9,38,60,0,3,31,68,18,31,17,37,5,10,10,35,68
2003-03-03 00:00:00.000,Delray Beach FL; U.S.A. ATP World Tour,HARD,2,Jan-Michael Gambill,Flavio Saretta,Jan-Michael Gambill,4-6; 7-6(3); 6-0,Q,136,12,8,40,90,31,40,25,50,2,6,14,56,90,4,8,58,105,36,58,19,47,6,12,14,55,105
2003-03-03 00:00:00.000,Delray Beach FL; U.S.A. ATP World Tour,HARD,2,Robert Kendrick,Vladimir Voltchkov,Robert Kendrick,6-0; 6-4,Q,55,8,3,28,48,22,28,10,20,2,3,8,32,48,0,3,46,52,21,46,2,6,5,10,8,23,52
2003-03-03 00:00:00.000,Delray Beach FL; U.S.A. ATP World Tour,HARD,2,Mardy Fish,Marcelo Rios,Mardy Fish,6-3; 6-4,S,68,11,1,32,61,29,32,16,29,3,3,10,45,61,4,3,34,53,22,34,11,19,3,5,9,33,53
2003-03-03 00:00:00.000,Delray Beach FL; U.S.A. ATP World Tour,HARD,2,Jan-Michael Gambill,Robert Kendrick,Jan-Michael Gambill,6-3; 2-6; 7-6(5),S,112,11,6,49,85,37,49,18,36,0,3,14,55,85,12,8,55,92,41,55,17,37,3,6,15,58,92
2003-03-03 00:00:00.000,Delray Beach FL; U.S.A. ATP World Tour,HARD,2,Jan-Michael Gambill,Mardy Fish,Jan-Michael Gambill,6-0; 7-6(5),F,84,11,5,42,76,31,42,20,34,6,6,9,51,76,10,3,32,57,22,32,13,25,0,3,9,35,57
2003-03-03 00:00:00.000,Scottsdale AZ; U.S.A. ATP World Tour,HARD,2,Lleyton Hewitt,Fernando Vicente,Lleyton Hewitt,6-4; 6-3,R32,79,6,4,25,52,21,25,13,27,4,6,9,34,52,2,1,37,68,26,37,11,31,8,13,10,37,68
2003-03-03 00:00:00.000,Scottsdale AZ; U.S.A. ATP World Tour,HARD,2,Wayne Ferreira,Wayne Arthurs,Wayne Ferreira,7-5; 6-7(5); 6-2,R32,110,10,3,53,100,44,53,28,47,5,6,16,72,100,14,4,59,102,44,59,18,43,6,10,16,62,102
2003-03-03 00:00:00.000,Scottsdale AZ; U.S.A. ATP World Tour,HARD,2,Arnaud Di Pasquale,Luis Horna,Arnaud Di Pasquale,6-2; 3-6; 6-3,R32,112,1,5,42,81,31,42,23,39,4,6,13,54,81,4,1,73,95,42,73,12,22,10,14,13,54,95
2003-03-03 00:00:00.000,Scottsdale AZ; U.S.A. ATP World Tour,HARD,2,Alex Corretja,Dmitry Tursunov,Alex Corretja,6-4; 6-2,R32,75,6,1,27,52,18,27,16,25,4,6,9,34,52,7,4,32,64,19,32,12,32,3,8,9,31,64
2003-03-03 00:00:00.000,Scottsdale AZ; U.S.A. ATP World Tour,HARD,2,Giovanni Lapentti,Paradorn Srichaphan,Giovanni Lapentti,7-6(2); 6-2,R32,73,8,1,33,58,27,33,16,25,0,1,10,43,58,1,6,27,66,19,27,19,39,4,7,10,38,66
2003-03-03 00:00:00.000,Scottsdale AZ; U.S.A. ATP World Tour,HARD,2,David Sanchez,Nicolas Massu,David Sanchez,3-6; 6-3; 6-4,R32,121,3,6,39,81,23,39,23,42,7,12,14,46,81,5,4,43,82,28,43,17,39,5,11,14,45,82
2003-03-03 00:00:00.000,Scottsdale AZ; U.S.A. ATP World Tour,HARD,2,Taylor Dent,Andrei Pavel,Taylor Dent,6-3; 7-5,R32,76,10,10,40,75,33,40,17,35,9,10,11,50,75,1,3,39,60,23,39,12,21,4,7,10,35,60
2003-03-03 00:00:00.000,Scottsdale AZ; U.S.A. ATP World Tour,HARD,2,Cecil Mamiit,Xavier Malisse,Cecil Mamiit,7-6(5); 7-6(3),R32,122,2,3,57,107,36,57,27,50,17,20,12,63,107,6,3,46,89,33,46,20,43,7,10,12,53,89
2003-03-03 00:00:00.000,Scottsdale AZ; U.S.A. ATP World Tour,HARD,2,Mark Philippoussis,Juan Ignacio Chela,Mark Philippoussis,7-6(2); 3-6; 6-1,R32,93,12,6,44,86,39,44,22,42,3,4,14,61,86,1,1,65,80,47,65,9,15,2,4,14,56,80
2003-03-03 00:00:00.000,Scottsdale AZ; U.S.A. ATP World Tour,HARD,2,Scott Draper,Jonas Bjorkman,Scott Draper,6-3; 7-6(5),R32,76,4,1,38,65,30,38,17,27,1,2,11,47,65,10,4,40,71,29,40,14,31,2,4,10,43,71
2003-03-03 00:00:00.000,Scottsdale AZ; U.S.A. ATP World Tour,HARD,2,Franco Squillari,Davide Sanguinetti,Franco Squillari,6-3; 6-2,R32,74,2,2,32,63,24,32,17,31,8,9,9,41,63,3,3,33,61,23,33,9,28,5,9,8,32,61
2003-03-03 00:00:00.000,Scottsdale AZ; U.S.A. ATP World Tour,HARD,2,David Nalbandian,Agustin Calleri,David Nalbandian,7-6(3); 6-3,R32,84,1,5,47,80,32,47,23,33,4,4,11,55,80,7,3,34,62,27,34,13,28,1,2,10,40,62
2003-03-03 00:00:00.000,Scottsdale AZ; U.S.A. ATP World Tour,HARD,2,Rainer Schuettler,Harel Levy,Rainer Schuettler,2-6; 7-5; 6-1,R32,117,6,3,83,118,51,83,16,35,15,19,14,67,118,1,0,42,79,25,42,19,37,3,8,13,44,79
2003-03-03 00:00:00.000,Scottsdale AZ; U.S.A. ATP World Tour,HARD,2,Mariano Zabaleta,Robby Ginepri,Mariano Zabaleta,7-6(6); 6-3,R32,81,0,2,36,64,25,36,23,28,1,2,11,48,64,4,2,44,70,28,44,16,26,4,6,10,44,70
2003-03-03 00:00:00.000,Scottsdale AZ; U.S.A. ATP World Tour,HARD,2,James Blake,Jay Gooding,James Blake,6-2; 6-2,R32,45,7,2,29,41,24,29,9,12,0,0,8,33,41,2,0,30,50,15,30,10,20,3,7,8,25,50
2003-03-03 00:00:00.000,Scottsdale AZ; U.S.A. ATP World Tour,HARD,2,Thomas Enqvist,Andre Agassi,Thomas Enqvist,6-7(6); 6-4; 6-1,R32,102,18,8,48,92,40,48,21,44,2,3,14,61,92,6,5,66,110,44,66,21,44,8,13,15,65,110
2003-03-03 00:00:00.000,Scottsdale AZ; U.S.A. ATP World Tour,HARD,2,Lleyton Hewitt,Wayne Ferreira,Lleyton Hewitt,7-5; 6-1,R16,70,4,3,25,52,21,25,17,27,1,1,9,38,52,6,2,32,64,21,32,15,32,6,10,10,36,64
2003-03-03 00:00:00.000,Scottsdale AZ; U.S.A. ATP World Tour,HARD,2,Alex Corretja,Arnaud Di Pasquale,Alex Corretja,7-6(5); 3-6; 6-1,R16,131,3,4,51,89,36,51,21,38,3,6,14,57,89,3,6,62,99,42,62,15,37,3,7,14,57,99
2003-03-03 00:00:00.000,Scottsdale AZ; U.S.A. ATP World Tour,HARD,2,David Sanchez,Giovanni Lapentti,David Sanchez,6-3; 7-6(5),R16,106,1,8,47,89,30,47,24,42,7,8,10,54,89,2,3,54,88,38,54,13,34,11,14,11,51,88
2003-03-03 00:00:00.000,Scottsdale AZ; U.S.A. ATP World Tour,HARD,2,Taylor Dent,Cecil Mamiit,Taylor Dent,4-6; 6-2; 6-0,R16,88,8,7,36,64,30,36,11,28,1,4,12,41,64,0,3,50,77,24,50,10,27,3,10,12,34,77
2003-03-03 00:00:00.000,Scottsdale AZ; U.S.A. ATP World Tour,HARD,2,Mark Philippoussis,Scott Draper,Mark Philippoussis,6-0; 6-4,R16,61,11,4,30,55,25,30,14,25,4,4,8,39,55,2,5,23,46,16,23,7,23,3,7,8,23,46
2003-03-03 00:00:00.000,Scottsdale AZ; U.S.A. ATP World Tour,HARD,2,David Nalbandian,Franco Squillari,David Nalbandian,6-2; 7-6(5),R16,105,3,5,36,76,26,36,21,40,6,8,10,47,76,4,8,43,84,26,43,19,41,7,11,10,45,84
2003-03-03 00:00:00.000,Scottsdale AZ; U.S.A. ATP World Tour,HARD,2,Mariano Zabaleta,Rainer Schuettler,Mariano Zabaleta,6-3; 2-6; 6-4,R16,113,1,1,44,79,28,44,13,35,2,7,13,41,79,4,2,53,87,29,53,16,34,2,8,14,45,87
2003-03-03 00:00:00.000,Scottsdale AZ; U.S.A. ATP World Tour,HARD,2,James Blake,Thomas Enqvist,James Blake,7-6(5); 6-7(1); 6-2,R16,113,9,5,53,91,46,53,21,38,0,1,16,67,91,5,11,61,116,45,61,28,55,9,12,16,73,116
2003-03-03 00:00:00.000,Scottsdale AZ; U.S.A. ATP World Tour,HARD,2,Lleyton Hewitt,Alex Corretja,Lleyton Hewitt,6-4; 6-2,Q,87,9,1,26,68,19,26,24,42,4,5,9,43,68,4,1,32,46,20,32,5,14,3,7,9,25,46
2003-03-03 00:00:00.000,Scottsdale AZ; U.S.A. ATP World Tour,HARD,2,Taylor Dent,David Sanchez,Taylor Dent,6-1; 6-3,Q,66,4,2,32,57,26,32,9,25,3,4,8,35,57,2,6,31,59,19,31,7,28,4,9,8,26,59
2003-03-03 00:00:00.000,Scottsdale AZ; U.S.A. ATP World Tour,HARD,2,Mark Philippoussis,David Nalbandian,Mark Philippoussis,0-6; 6-3; 6-4,Q,92,16,3,35,74,30,35,18,39,2,5,13,48,74,0,1,37,67,28,37,18,30,0,2,12,46,67
2003-03-03 00:00:00.000,Scottsdale AZ; U.S.A. ATP World Tour,HARD,2,Mariano Zabaleta,James Blake,Mariano Zabaleta,3-6; 6-4; 6-4,Q,111,4,3,56,88,37,56,11,32,2,7,14,48,88,4,1,64,101,44,64,12,37,12,18,15,56,101
2003-03-03 00:00:00.000,Scottsdale AZ; U.S.A. ATP World Tour,HARD,2,Lleyton Hewitt,Taylor Dent,Lleyton Hewitt,6-2; 6-4,S,68,4,1,25,48,18,25,16,23,0,1,9,34,48,5,5,31,55,23,31,8,24,0,4,9,31,55
2003-03-03 00:00:00.000,Scottsdale AZ; U.S.A. ATP World Tour,HARD,2,Mark Philippoussis,Mariano Zabaleta,Mark Philippoussis,6-3; 7-6(8),S,109,10,5,35,81,26,35,25,46,3,4,11,51,81,3,1,39,76,23,39,21,37,6,8,10,44,76
2003-03-03 00:00:00.000,Scottsdale AZ; U.S.A. ATP World Tour,HARD,2,Lleyton Hewitt,Mark Philippoussis,Lleyton Hewitt,6-4; 6-4,F,85,2,2,22,55,20,22,23,33,2,2,10,43,55,10,2,39,61,27,39,12,22,6,8,10,39,61
2003-03-10 00:00:00.000,ATP Masters Series Indian Wells California; USA ATP World Tour,HARD,2,Lleyton Hewitt,Younes El Aynaoui,Lleyton Hewitt,4-6; 7-5; 6-2,R64,138,9,3,59,96,41,59,22,37,4,6,15,63,96,3,5,56,97,38,56,21,41,6,10,15,59,97
2003-03-10 00:00:00.000,ATP Masters Series Indian Wells California; USA ATP World Tour,HARD,2,Yevgeny Kafelnikov,Radek Stepanek,Yevgeny Kafelnikov,4-6; 6-1; 6-1,R64,105,6,4,53,85,39,53,11,32,5,8,12,50,85,4,4,45,81,25,45,13,36,4,11,12,38,81
2003-03-10 00:00:00.000,ATP Masters Series Indian Wells California; USA ATP World Tour,HARD,2,Guillermo Coria,Davide Sanguinetti,Guillermo Coria,6-0; 2-6; 6-0,R64,88,6,3,37,60,27,37,12,23,1,3,10,39,60,0,2,31,62,18,31,11,31,2,8,10,29,62
2003-03-10 00:00:00.000,ATP Masters Series Indian Wells California; USA ATP World Tour,HARD,2,Alex Corretja,Jose Acasuso,Alex Corretja,7-6(2); 7-6(7),R64,143,7,4,51,105,37,51,26,54,10,13,12,63,105,4,2,49,83,33,49,16,34,5,8,12,49,83
2003-03-10 00:00:00.000,ATP Masters Series Indian Wells California; USA ATP World Tour,HARD,2,Jiri Novak,Karol Beck,Jiri Novak,6-4; 7-5,R64,77,3,3,39,65,26,39,17,26,1,3,11,43,65,2,2,37,63,27,37,10,26,4,8,11,37,63
2003-03-10 00:00:00.000,ATP Masters Series Indian Wells California; USA ATP World Tour,HARD,2,Robby Ginepri,Hyung-Taik Lee,Robby Ginepri,7-6(2); 4-6; 6-4,R64,123,10,5,73,108,46,73,16,35,3,9,16,62,108,1,4,69,100,40,69,14,31,7,13,16,54,100
2003-03-10 00:00:00.000,ATP Masters Series Indian Wells California; USA ATP World Tour,HARD,2,Mark Philippoussis,Andrei Pavel,Mark Philippoussis,6-3; 6-4,R64,71,12,1,29,52,25,29,17,23,1,1,10,42,52,3,0,42,62,30,42,8,20,5,7,9,38,62
2003-03-10 00:00:00.000,ATP Masters Series Indian Wells California; USA ATP World Tour,HARD,2,Marat Safin,Stefan Koubek,Marat Safin,3-6; 6-3; 7-5,R64,123,9,2,41,82,32,41,28,41,4,6,15,60,82,2,1,57,96,41,57,19,39,6,9,15,60,96
2003-03-10 00:00:00.000,ATP Masters Series Indian Wells California; USA ATP World Tour,HARD,2,Juan Carlos Ferrero,Sargis Sargsian,Juan Carlos Ferrero,6-4; 6-7(5); 6-4,R64,140,4,4,58,96,41,58,23,38,5,8,16,64,96,3,5,55,101,38,55,21,46,5,10,16,59,101
2003-03-10 00:00:00.000,ATP Masters Series Indian Wells California; USA ATP World Tour,HARD,2,Brian Vahaly,Fernando Gonzalez,Brian Vahaly,2-6; 6-3; 6-4,R64,97,1,6,55,86,37,55,17,31,3,6,14,54,86,5,7,37,73,30,37,16,36,4,7,13,46,73
2003-03-10 00:00:00.000,ATP Masters Series Indian Wells California; USA ATP World Tour,HARD,2,Tommy Robredo,Jarkko Nieminen,Tommy Robredo,6-2; 0-1 RET,R64,26,3,0,13,18,12,13,4,5,0,0,4,16,18,0,0,11,24,9,11,6,13,0,2,5,15,24
2003-03-10 00:00:00.000,ATP Masters Series Indian Wells California; USA ATP World Tour,HARD,2,Sjeng Schalken,Fernando Vicente,Sjeng Schalken,6-2; 6-3,R64,68,2,1,28,44,26,28,10,16,0,0,9,36,44,2,3,28,48,20,28,9,20,3,6,8,29,48
2003-03-10 00:00:00.000,ATP Masters Series Indian Wells California; USA ATP World Tour,HARD,2,Vincent Spadea,Paradorn Srichaphan,Vincent Spadea,6-3; 6-4,R64,88,3,3,36,69,26,36,18,33,7,8,10,44,69,4,1,31,51,22,31,8,20,1,4,9,30,51
2003-03-10 00:00:00.000,ATP Masters Series Indian Wells California; USA ATP World Tour,HARD,2,Nicolas Kiefer,Mario Ancic,Nicolas Kiefer,6-2; 6-4,R64,79,2,1,21,46,19,21,17,25,0,0,9,36,46,2,0,35,53,22,35,8,18,4,7,9,30,53
2003-03-10 00:00:00.000,ATP Masters Series Indian Wells California; USA ATP World Tour,HARD,2,Olivier Rochus,Fabrice Santoro,Olivier Rochus,6-1; 2-6; 6-3,R64,95,1,1,41,72,25,41,19,31,3,6,12,44,72,3,0,32,66,18,32,16,34,1,6,12,34,66
2003-03-10 00:00:00.000,ATP Masters Series Indian Wells California; USA ATP World Tour,HARD,2,Albert Costa,Richard Krajicek,Albert Costa,7-6(5); 7-6(4),R64,104,8,0,40,74,32,40,24,34,0,1,12,56,74,19,6,46,83,37,46,19,37,5,6,12,56,83
2003-03-10 00:00:00.000,ATP Masters Series Indian Wells California; USA ATP World Tour,HARD,2,Carlos Moya,Michael Chang,Carlos Moya,6-0; 6-3,R64,63,6,4,30,56,26,30,12,26,7,7,8,38,56,1,2,23,40,11,23,7,17,2,6,7,18,40
2003-03-10 00:00:00.000,ATP Masters Series Indian Wells California; USA ATP World Tour,HARD,2,Arnaud Clement,Michel Kratochvil,Arnaud Clement,6-2; 3-6; 6-2,R64,67,7,3,43,81,31,43,15,38,3,7,13,46,81,1,6,51,82,32,51,9,31,7,13,12,41,82
2003-03-10 00:00:00.000,ATP Masters Series Indian Wells California; USA ATP World Tour,HARD,2,James Blake,Todd Martin,James Blake,6-1; 3-6; 7-5,R64,111,9,2,53,88,39,53,14,35,5,10,14,53,88,1,5,44,79,29,44,13,35,4,11,14,42,79
2003-03-10 00:00:00.000,ATP Masters Series Indian Wells California; USA ATP World Tour,HARD,2,Juan Ignacio Chela,David Nalbandian,Juan Ignacio Chela,4-6; 6-4; 7-5,R64,119,3,5,69,95,43,69,10,26,4,10,16,53,95,2,6,54,106,30,54,26,52,8,15,16,56,106
2003-03-10 00:00:00.000,ATP Masters Series Indian Wells California; USA ATP World Tour,HARD,2,Tim Henman,Jan-Michael Gambill,Tim Henman,7-5; 6-2,R64,95,3,3,39,60,33,39,11,21,1,1,10,44,60,3,3,26,70,17,26,21,44,3,6,10,38,70
2003-03-10 00:00:00.000,ATP Masters Series Indian Wells California; USA ATP World Tour,HARD,2,Agustin Calleri,Nicolas Lapentti,Agustin Calleri,6-4; 6-3,R64,77,4,4,34,63,28,34,15,29,5,5,9,43,63,5,3,28,56,20,28,14,28,1,4,10,34,56
2003-03-10 00:00:00.000,ATP Masters Series Indian Wells California; USA ATP World Tour,HARD,2,Gustavo Kuerten,Goran Ivanisevic,Gustavo Kuerten,6-2; 6-4,R64,55,6,2,20,48,16,20,18,28,0,1,9,34,48,4,5,31,48,25,31,2,17,3,7,9,27,48
2003-03-10 00:00:00.000,ATP Masters Series Indian Wells California; USA ATP World Tour,HARD,2,Roger Federer,Felix Mantilla,Roger Federer,6-7(4); 6-4; 4-1 RET,R64,108,12,4,53,81,42,53,15,28,4,5,13,57,81,1,1,62,94,40,62,17,32,4,8,14,57,94
2003-03-10 00:00:00.000,ATP Masters Series Indian Wells California; USA ATP World Tour,HARD,2,Andy Roddick,Thomas Enqvist,Andy Roddick,6-4; 6-4,R64,68,15,0,35,56,29,35,13,21,0,0,10,42,56,6,5,28,61,22,28,16,33,4,6,10,38,61
2003-03-10 00:00:00.000,ATP Masters Series Indian Wells California; USA ATP World Tour,HARD,2,Feliciano Lopez,Dominik Hrbaty,Feliciano Lopez,6-2; 7-6(2),R64,75,7,2,31,64,30,31,18,33,4,4,10,48,64,3,2,52,64,31,52,8,12,2,4,10,39,64
2003-03-10 00:00:00.000,ATP Masters Series Indian Wells California; USA ATP World Tour,HARD,2,Xavier Malisse,David Ferrer,Xavier Malisse,6-1; 6-0,R64,43,5,0,20,32,16,20,9,12,0,0,6,25,32,0,8,26,51,14,26,5,25,3,9,7,19,51
2003-03-10 00:00:00.000,ATP Masters Series Indian Wells California; USA ATP World Tour,HARD,2,Sebastien Grosjean,David Sanchez,Sebastien Grosjean,6-3; 6-2,R64,63,6,0,23,48,18,23,16,25,2,3,9,34,48,1,3,29,42,19,29,3,13,2,6,8,22,42
2003-03-10 00:00:00.000,ATP Masters Series Indian Wells California; USA ATP World Tour,HARD,2,Rainer Schuettler,Wayne Arthurs,Rainer Schuettler,6-4; 7-6(3),R64,97,3,5,37,69,27,37,22,32,3,4,11,49,69,11,6,39,78,27,39,20,39,2,4,11,47,78
2003-03-10 00:00:00.000,ATP Masters Series Indian Wells California; USA ATP World Tour,HARD,2,Mariano Zabaleta,Mikhail Youzhny,Mariano Zabaleta,7-6(5); 6-1,R64,91,1,1,34,70,25,34,19,36,4,6,10,44,70,4,2,35,60,20,35,11,25,8,12,9,31,60
2003-03-10 00:00:00.000,ATP Masters Series Indian Wells California; USA ATP World Tour,HARD,2,Max Mirnyi,Wayne Ferreira,Max Mirnyi,7-6(5); 6-3,R64,75,9,6,39,63,35,39,12,24,0,0,10,47,63,3,4,42,66,28,42,14,24,1,3,11,42,66
2003-03-10 00:00:00.000,ATP Masters Series Indian Wells California; USA ATP World Tour,HARD,2,Marcelo Rios,Gaston Gaudio,Marcelo Rios,4-0 RET,R64,14,1,0,4,8,4,4,4,4,0,0,2,8,8,0,0,8,9,1,8,0,1,0,2,2,1,9
2003-03-10 00:00:00.000,ATP Masters Series Indian Wells California; USA ATP World Tour,HARD,2,Lleyton Hewitt,Yevgeny Kafelnikov,Lleyton Hewitt,6-3; 6-2,R32,85,9,1,30,63,20,30,18,33,3,5,9,38,63,1,2,29,52,15,29,9,23,4,9,8,24,52
2003-03-10 00:00:00.000,ATP Masters Series Indian Wells California; USA ATP World Tour,HARD,2,Guillermo Coria,Alex Corretja,Guillermo Coria,6-2; 6-1,R32,69,0,1,19,35,17,19,11,16,0,0,7,28,35,3,3,32,57,15,32,11,25,3,8,8,26,57
2003-03-10 00:00:00.000,ATP Masters Series Indian Wells California; USA ATP World Tour,HARD,2,Robby Ginepri,Jiri Novak,Robby Ginepri,W/O,R32,0,0,0,0,0,0,0,0,0,0,0,0,0,0,0,0,0,0,0,0,0,0,0,0,0,0,0
2003-03-10 00:00:00.000,ATP Masters Series Indian Wells California; USA ATP World Tour,HARD,2,Marat Safin,Mark Philippoussis,Marat Safin,6-4; 6-3,R32,75,2,2,25,51,19,25,19,26,0,0,9,38,51,2,4,32,59,24,32,11,27,8,11,10,35,59
2003-03-10 00:00:00.000,ATP Masters Series Indian Wells California; USA ATP World Tour,HARD,2,Brian Vahaly,Juan Carlos Ferrero,Brian Vahaly,6-4; 3-6; 6-3,R32,110,3,6,54,83,37,54,16,29,3,6,14,53,83,3,1,46,76,33,46,12,30,4,8,14,45,76
2003-03-10 00:00:00.000,ATP Masters Series Indian Wells California; USA ATP World Tour,HARD,2,Tommy Robredo,Sjeng Schalken,Tommy Robredo,5-7; 6-2; 6-0,R32,121,5,2,52,83,33,52,16,31,1,4,13,49,83,3,2,58,93,37,58,9,35,5,12,13,46,93
2003-03-10 00:00:00.000,ATP Masters Series Indian Wells California; USA ATP World Tour,HARD,2,Vincent Spadea,Nicolas Kiefer,Vincent Spadea,6-3; 6-2,R32,84,7,2,23,50,19,23,14,27,1,2,8,33,50,4,6,30,57,18,30,10,27,8,13,9,28,57
2003-03-10 00:00:00.000,ATP Masters Series Indian Wells California; USA ATP World Tour,HARD,2,Olivier Rochus,Albert Costa,Olivier Rochus,5-7; 6-4; 6-4,R32,154,0,1,59,103,37,59,25,44,7,11,16,62,103,8,5,47,99,36,47,24,52,3,8,16,60,99
2003-03-10 00:00:00.000,ATP Masters Series Indian Wells California; USA ATP World Tour,HARD,2,Carlos Moya,Arnaud Clement,Carlos Moya,6-0; 6-2,R32,56,2,1,22,37,17,22,11,15,0,0,7,28,37,0,4,22,48,12,22,9,26,6,11,7,21,48
2003-03-10 00:00:00.000,ATP Masters Series Indian Wells California; USA ATP World Tour,HARD,2,James Blake,Juan Ignacio Chela,James Blake,6-1; 6-4,R32,55,4,0,32,51,27,32,9,19,1,2,9,36,51,4,2,35,54,22,35,6,19,3,7,8,28,54
2003-03-10 00:00:00.000,ATP Masters Series Indian Wells California; USA ATP World Tour,HARD,2,Agustin Calleri,Tim Henman,Agustin Calleri,6-4; 7-6(4),R32,122,2,5,37,73,30,37,21,36,1,2,11,51,73,5,7,52,91,37,52,18,39,11,13,11,55,91
2003-03-10 00:00:00.000,ATP Masters Series Indian Wells California; USA ATP World Tour,HARD,2,Gustavo Kuerten,Roger Federer,Gustavo Kuerten,7-5; 7-6(3),R32,105,6,1,45,87,32,45,25,42,6,8,12,57,87,4,3,43,76,30,43,16,33,4,7,12,46,76
2003-03-10 00:00:00.000,ATP Masters Series Indian Wells California; USA ATP World Tour,HARD,2,Andy Roddick,Feliciano Lopez,Andy Roddick,6-4; 6-3,R32,54,7,3,28,45,24,28,12,17,0,0,9,36,45,7,5,21,50,14,21,18,29,4,7,10,32,50
2003-03-10 00:00:00.000,ATP Masters Series Indian Wells California; USA ATP World Tour,HARD,2,Sebastien Grosjean,Xavier Malisse,Sebastien Grosjean,6-3; 6-3,R32,78,4,2,28,57,25,28,16,29,3,3,9,41,57,0,5,26,58,17,26,18,32,2,5,9,35,58
2003-03-10 00:00:00.000,ATP Masters Series Indian Wells California; USA ATP World Tour,HARD,2,Rainer Schuettler,Mariano Zabaleta,Rainer Schuettler,6-3; 6-3,R32,73,1,3,38,56,27,38,8,18,4,6,9,35,56,0,2,26,49,13,26,9,23,0,5,9,22,49
2003-03-10 00:00:00.000,ATP Masters Series Indian Wells California; USA ATP World Tour,HARD,2,Max Mirnyi,Marcelo Rios,Max Mirnyi,6-3; 6-3,R32,62,9,2,28,51,24,28,13,23,0,0,9,37,51,2,4,51,70,31,51,8,19,6,9,9,39,70
2003-03-10 00:00:00.000,ATP Masters Series Indian Wells California; USA ATP World Tour,HARD,2,Lleyton Hewitt,Guillermo Coria,Lleyton Hewitt,6-7(3); 6-4; 6-3,R16,155,9,0,50,93,41,50,22,43,3,6,16,63,93,2,1,73,107,45,73,19,34,10,15,15,64,107
2003-03-10 00:00:00.000,ATP Masters Series Indian Wells California; USA ATP World Tour,HARD,2,Robby Ginepri,Marat Safin,Robby Ginepri,6-0; 6-1,R16,57,3,3,35,56,27,35,9,21,6,6,7,36,56,3,3,23,40,10,23,4,17,4,9,6,14,40
2003-03-10 00:00:00.000,ATP Masters Series Indian Wells California; USA ATP World Tour,HARD,2,Brian Vahaly,Tommy Robredo,Brian Vahaly,6-2; 7-5,R16,92,0,6,47,61,29,47,6,14,4,7,10,35,61,2,4,39,67,19,39,11,28,4,10,10,30,67
2003-03-10 00:00:00.000,ATP Masters Series Indian Wells California; USA ATP World Tour,HARD,2,Vincent Spadea,Olivier Rochus,Vincent Spadea,6-4; 4-6; 6-2,R16,117,9,9,43,83,33,43,17,40,3,6,14,50,83,1,2,46,88,31,46,20,42,0,5,14,51,88
2003-03-10 00:00:00.000,ATP Masters Series Indian Wells California; USA ATP World Tour,HARD,2,James Blake,Carlos Moya,James Blake,5-7; 6-3; 6-2,R16,114,5,4,55,91,35,55,22,36,4,8,15,57,91,6,4,46,93,28,46,21,47,7,13,14,49,93
2003-03-10 00:00:00.000,ATP Masters Series Indian Wells California; USA ATP World Tour,HARD,2,Gustavo Kuerten,Agustin Calleri,Gustavo Kuerten,6-4; 7-6(5),R16,102,6,1,28,70,24,28,23,42,0,1,11,47,70,6,2,29,73,24,29,24,44,4,6,11,48,73
2003-03-10 00:00:00.000,ATP Masters Series Indian Wells California; USA ATP World Tour,HARD,2,Andy Roddick,Sebastien Grosjean,Andy Roddick,7-6(5); 2-6; 7-6(1),R16,141,10,4,68,109,52,68,21,41,5,7,16,73,109,8,1,61,104,48,61,25,43,2,2,16,73,104
2003-03-10 00:00:00.000,ATP Masters Series Indian Wells California; USA ATP World Tour,HARD,2,Rainer Schuettler,Max Mirnyi,Rainer Schuettler,6-3; 6-4,R16,70,1,3,29,55,24,29,15,26,1,2,10,39,55,3,2,30,50,21,30,9,20,3,6,9,30,50
2003-03-10 00:00:00.000,ATP Masters Series Indian Wells California; USA ATP World Tour,HARD,2,Lleyton Hewitt,Robby Ginepri,Lleyton Hewitt,6-4; 6-2,Q,75,5,3,31,56,25,31,15,25,4,4,9,40,56,3,1,34,55,22,34,11,21,3,6,9,33,55
2003-03-10 00:00:00.000,ATP Masters Series Indian Wells California; USA ATP World Tour,HARD,2,Vincent Spadea,Brian Vahaly,Vincent Spadea,6-3; 6-2,Q,71,8,2,34,58,26,34,15,24,1,1,9,41,58,3,0,29,48,19,29,8,19,4,7,8,27,48
2003-03-10 00:00:00.000,ATP Masters Series Indian Wells California; USA ATP World Tour,HARD,2,Gustavo Kuerten,James Blake,Gustavo Kuerten,4-6; 6-4; 6-0,Q,94,7,1,51,80,39,51,13,29,2,4,13,52,80,3,1,45,72,28,45,13,27,3,8,13,41,72
2003-03-10 00:00:00.000,ATP Masters Series Indian Wells California; USA ATP World Tour,HARD,2,Rainer Schuettler,Andy Roddick,Rainer Schuettler,6-3; 6-2,Q,60,1,1,35,50,28,35,9,15,3,3,9,37,50,4,4,28,48,21,28,7,20,1,4,8,28,48
2003-03-10 00:00:00.000,ATP Masters Series Indian Wells California; USA ATP World Tour,HARD,2,Lleyton Hewitt,Vincent Spadea,Lleyton Hewitt,7-6(5); 6-1,S,97,6,2,35,61,30,35,13,26,0,1,10,43,61,1,5,35,68,22,35,16,33,4,7,9,38,68
2003-03-10 00:00:00.000,ATP Masters Series Indian Wells California; USA ATP World Tour,HARD,2,Gustavo Kuerten,Rainer Schuettler,Gustavo Kuerten,6-2; 3-6; 6-2,S,190,8,0,51,79,39,51,13,28,3,5,12,52,79,1,3,55,81,33,55,10,26,4,9,13,43,81
2003-03-10 00:00:00.000,ATP Masters Series Indian Wells California; USA ATP World Tour,HARD,2,Lleyton Hewitt,Gustavo Kuerten,Lleyton Hewitt,6-1; 6-1,F,61,3,0,22,40,19,22,11,18,2,2,7,30,40,2,1,27,50,15,27,8,23,8,13,7,23,50
2003-03-17 00:00:00.000,ATP Masters Series Miami FL; U.S.A. ATP World Tour,HARD,2,Lleyton Hewitt,N/A Bye,Lleyton Hewitt,,R128,0,0,0,0,0,0,0,0,0,0,0,0,0,0,0,0,0,0,0,0,0,0,0,0,0,0,0
2003-03-17 00:00:00.000,ATP Masters Series Miami FL; U.S.A. ATP World Tour,HARD,2,Francisco Clavet,Vladimir Voltchkov,Francisco Clavet,6-0; 3-0 RET,R128,45,3,3,20,28,15,20,5,8,0,0,5,20,28,1,0,29,43,11,29,6,14,6,10,4,17,43
2003-03-17 00:00:00.000,ATP Masters Series Miami FL; U.S.A. ATP World Tour,HARD,2,Hyung-Taik Lee,Paul-Henri Mathieu,Hyung-Taik Lee,6-1; 1-6; 6-1,R128,72,4,2,39,63,25,39,15,24,5,8,11,40,63,1,6,35,54,17,35,7,19,3,8,10,24,54
2003-03-17 00:00:00.000,ATP Masters Series Miami FL; U.S.A. ATP World Tour,HARD,2,Xavier Malisse,N/A Bye,Xavier Malisse,,R128,0,0,0,0,0,0,0,0,0,0,0,0,0,0,0,0,0,0,0,0,0,0,0,0,0,0,0
2003-03-17 00:00:00.000,ATP Masters Series Miami FL; U.S.A. ATP World Tour,HARD,2,James Blake,N/A Bye,James Blake,,R128,0,0,0,0,0,0,0,0,0,0,0,0,0,0,0,0,0,0,0,0,0,0,0,0,0,0,0
2003-03-17 00:00:00.000,ATP Masters Series Miami FL; U.S.A. ATP World Tour,HARD,2,Fernando Meligeni,Michel Kratochvil,Fernando Meligeni,6-1; 6-4,R128,76,4,4,32,61,22,32,19,29,3,4,9,41,61,1,4,34,49,20,34,6,15,5,9,8,26,49
2003-03-17 00:00:00.000,ATP Masters Series Miami FL; U.S.A. ATP World Tour,HARD,2,Robby Ginepri,Wayne Arthurs,Robby Ginepri,7-5; 6-3,R128,65,4,2,32,57,25,32,18,25,1,2,11,43,57,9,5,28,61,20,28,15,33,3,6,10,35,61
2003-03-17 00:00:00.000,ATP Masters Series Miami FL; U.S.A. ATP World Tour,HARD,2,Alex Corretja,N/A Bye,Alex Corretja,,R128,0,0,0,0,0,0,0,0,0,0,0,0,0,0,0,0,0,0,0,0,0,0,0,0,0,0,0
2003-03-17 00:00:00.000,ATP Masters Series Miami FL; U.S.A. ATP World Tour,HARD,2,Sebastien Grosjean,N/A Bye,Sebastien Grosjean,,R128,0,0,0,0,0,0,0,0,0,0,0,0,0,0,0,0,0,0,0,0,0,0,0,0,0,0,0
2003-03-17 00:00:00.000,ATP Masters Series Miami FL; U.S.A. ATP World Tour,HARD,2,Mardy Fish,Adrian Voinea,Mardy Fish,0-6; 6-4; 6-2,R128,89,8,8,38,74,28,38,14,36,5,9,12,42,74,3,3,33,70,23,33,19,37,4,8,12,42,70
2003-03-17 00:00:00.000,ATP Masters Series Miami FL; U.S.A. ATP World Tour,HARD,2,Nicolas Escude,Dominik Hrbaty,Nicolas Escude,7-6(2); 4-6; 6-4,R128,150,5,3,57,105,37,57,28,48,10,15,16,65,105,2,3,78,120,48,78,19,42,12,17,16,67,120
2003-03-17 00:00:00.000,ATP Masters Series Miami FL; U.S.A. ATP World Tour,HARD,2,Tim Henman,N/A Bye,Tim Henman,,R128,0,0,0,0,0,0,0,0,0,0,0,0,0,0,0,0,0,0,0,0,0,0,0,0,0,0,0
2003-03-17 00:00:00.000,ATP Masters Series Miami FL; U.S.A. ATP World Tour,HARD,2,Max Mirnyi,N/A Bye,Max Mirnyi,,R128,0,0,0,0,0,0,0,0,0,0,0,0,0,0,0,0,0,0,0,0,0,0,0,0,0,0,0
2003-03-17 00:00:00.000,ATP Masters Series Miami FL; U.S.A. ATP World Tour,HARD,2,Fernando Verdasco,Karol Kucera,Fernando Verdasco,6-2; 4-0 RET,R128,55,0,1,22,32,18,22,6,10,0,0,6,24,32,0,7,17,41,9,17,10,24,3,7,6,19,41
2003-03-17 00:00:00.000,ATP Masters Series Miami FL; U.S.A. ATP World Tour,HARD,2,Vincent Spadea,Christophe Rochus,Vincent Spadea,6-3; 6-4,R128,72,4,4,30,63,24,30,15,33,2,4,10,39,63,2,1,31,54,16,31,14,23,2,6,9,30,54
2003-03-17 00:00:00.000,ATP Masters Series Miami FL; U.S.A. ATP World Tour,HARD,2,Carlos Moya,N/A Bye,Carlos Moya,,R128,0,0,0,0,0,0,0,0,0,0,0,0,0,0,0,0,0,0,0,0,0,0,0,0,0,0,0
2003-03-17 00:00:00.000,ATP Masters Series Miami FL; U.S.A. ATP World Tour,HARD,2,Juan Carlos Ferrero,N/A Bye,Juan Carlos Ferrero,,R128,0,0,0,0,0,0,0,0,0,0,0,0,0,0,0,0,0,0,0,0,0,0,0,0,0,0,0
2003-03-17 00:00:00.000,ATP Masters Series Miami FL; U.S.A. ATP World Tour,HARD,2,Fernando Vicente,Andrei Stoliarov,Fernando Vicente,6-4; 7-5,R128,93,4,2,56,78,39,56,12,22,6,6,11,51,78,1,2,28,55,22,28,16,27,0,2,11,38,55
2003-03-17 00:00:00.000,ATP Masters Series Miami FL; U.S.A. ATP World Tour,HARD,2,Taylor Dent,Richard Krajicek,Taylor Dent,6-4; 6-3,R128,69,8,9,39,65,35,39,11,26,4,4,10,46,65,7,3,24,52,20,24,14,28,3,5,9,34,52
2003-03-17 00:00:00.000,ATP Masters Series Miami FL; U.S.A. ATP World Tour,HARD,2,Marcelo Rios,N/A Bye,Marcelo Rios,,R128,0,0,0,0,0,0,0,0,0,0,0,0,0,0,0,0,0,0,0,0,0,0,0,0,0,0,0
2003-03-17 00:00:00.000,ATP Masters Series Miami FL; U.S.A. ATP World Tour,HARD,2,Yevgeny Kafelnikov,N/A Bye,Yevgeny Kafelnikov,,R128,0,0,0,0,0,0,0,0,0,0,0,0,0,0,0,0,0,0,0,0,0,0,0,0,0,0,0
2003-03-17 00:00:00.000,ATP Masters Series Miami FL; U.S.A. ATP World Tour,HARD,2,Jonas Bjorkman,Andre Sa,Jonas Bjorkman,3-6; 6-4; 6-4,R128,134,3,3,52,100,35,52,25,48,11,15,15,60,100,0,3,41,76,30,41,17,35,1,5,14,47,76
2003-03-17 00:00:00.000,ATP Masters Series Miami FL; U.S.A. ATP World Tour,HARD,2,Jose Acasuso,David Ferrer,Jose Acasuso,6-3; 6-4,R128,82,0,1,29,61,19,29,18,32,2,4,10,37,61,1,3,50,72,28,50,9,22,3,7,9,37,72
2003-03-17 00:00:00.000,ATP Masters Series Miami FL; U.S.A. ATP World Tour,HARD,2,Paradorn Srichaphan,N/A Bye,Paradorn Srichaphan,,R128,0,0,0,0,0,0,0,0,0,0,0,0,0,0,0,0,0,0,0,0,0,0,0,0,0,0,0
2003-03-17 00:00:00.000,ATP Masters Series Miami FL; U.S.A. ATP World Tour,HARD,2,Rainer Schuettler,N/A Bye,Rainer Schuettler,,R128,0,0,0,0,0,0,0,0,0,0,0,0,0,0,0,0,0,0,0,0,0,0,0,0,0,0,0
2003-03-17 00:00:00.000,ATP Masters Series Miami FL; U.S.A. ATP World Tour,HARD,2,Jan-Michael Gambill,Stefan Koubek,Jan-Michael Gambill,2-6; 6-3; 6-2,R128,100,13,2,52,93,41,52,18,41,10,12,13,59,93,2,1,37,63,28,37,13,26,0,3,12,41,63
2003-03-17 00:00:00.000,ATP Masters Series Miami FL; U.S.A. ATP World Tour,HARD,2,Radek Stepanek,Alex Bogomolov Jr.,Radek Stepanek,6-2; 6-3,R128,61,4,1,29,42,23,29,7,13,0,1,8,30,42,1,2,39,59,20,39,10,20,6,11,9,30,59
2003-03-17 00:00:00.000,ATP Masters Series Miami FL; U.S.A. ATP World Tour,HARD,2,Mikhail Youzhny,N/A Bye,Mikhail Youzhny,,R128,0,0,0,0,0,0,0,0,0,0,0,0,0,0,0,0,0,0,0,0,0,0,0,0,0,0,0
2003-03-17 00:00:00.000,ATP Masters Series Miami FL; U.S.A. ATP World Tour,HARD,2,Andrei Pavel,N/A Bye,Andrei Pavel,,R128,0,0,0,0,0,0,0,0,0,0,0,0,0,0,0,0,0,0,0,0,0,0,0,0,0,0,0
2003-03-17 00:00:00.000,ATP Masters Series Miami FL; U.S.A. ATP World Tour,HARD,2,Todd Martin,Mariano Zabaleta,Todd Martin,6-4; 6-4,R128,87,3,3,33,51,26,33,9,18,0,2,10,35,51,3,3,38,64,24,38,10,26,5,9,10,34,64
2003-03-17 00:00:00.000,ATP Masters Series Miami FL; U.S.A. ATP World Tour,HARD,2,Cyril Saulnier,Ivan Ljubicic,Cyril Saulnier,7-6(4); 6-4,R128,91,7,3,46,73,34,46,17,27,3,5,11,51,73,14,4,39,73,27,39,18,34,4,7,11,45,73
2003-03-17 00:00:00.000,ATP Masters Series Miami FL; U.S.A. ATP World Tour,HARD,2,Andy Roddick,N/A Bye,Andy Roddick,,R128,0,0,0,0,0,0,0,0,0,0,0,0,0,0,0,0,0,0,0,0,0,0,0,0,0,0,0
2003-03-17 00:00:00.000,ATP Masters Series Miami FL; U.S.A. ATP World Tour,HARD,2,Marat Safin,N/A Bye,Marat Safin,,R128,0,0,0,0,0,0,0,0,0,0,0,0,0,0,0,0,0,0,0,0,0,0,0,0,0,0,0
2003-03-17 00:00:00.000,ATP Masters Series Miami FL; U.S.A. ATP World Tour,HARD,2,Davide Sanguinetti,Albert Montanes,Davide Sanguinetti,6-4; 6-1,R128,70,6,4,22,45,18,22,11,23,2,4,8,29,45,2,3,36,72,22,36,10,36,6,12,9,32,72
2003-03-17 00:00:00.000,ATP Masters Series Miami FL; U.S.A. ATP World Tour,HARD,2,Antony Dupuis,Raemon Sluiter,Antony Dupuis,6-3; 6-4,R128,78,12,6,29,62,22,29,20,33,5,6,10,42,62,8,1,28,53,18,28,14,25,3,6,9,32,53
2003-03-17 00:00:00.000,ATP Masters Series Miami FL; U.S.A. ATP World Tour,HARD,2,Guillermo Coria,N/A Bye,Guillermo Coria,,R128,0,0,0,0,0,0,0,0,0,0,0,0,0,0,0,0,0,0,0,0,0,0,0,0,0,0,0
2003-03-17 00:00:00.000,ATP Masters Series Miami FL; U.S.A. ATP World Tour,HARD,2,Gaston Gaudio,N/A Bye,Gaston Gaudio,,R128,0,0,0,0,0,0,0,0,0,0,0,0,0,0,0,0,0,0,0,0,0,0,0,0,0,0,0
2003-03-17 00:00:00.000,ATP Masters Series Miami FL; U.S.A. ATP World Tour,HARD,2,Nicolas Massu,Kenneth Carlsen,Nicolas Massu,6-4; 6-3,R128,96,2,3,31,44,28,31,6,13,1,2,9,34,44,5,4,33,66,22,33,14,33,5,9,10,36,66
2003-03-17 00:00:00.000,ATP Masters Series Miami FL; U.S.A. ATP World Tour,HARD,2,Olivier Rochus,Jan Vacek,Olivier Rochus,3-6; 7-5; 6-1,R128,122,2,4,44,84,32,44,19,40,2,6,14,51,84,4,8,61,107,40,61,15,46,9,15,14,55,107
2003-03-17 00:00:00.000,ATP Masters Series Miami FL; U.S.A. ATP World Tour,HARD,2,Albert Costa,N/A Bye,Albert Costa,,R128,0,0,0,0,0,0,0,0,0,0,0,0,0,0,0,0,0,0,0,0,0,0,0,0,0,0,0
2003-03-17 00:00:00.000,ATP Masters Series Miami FL; U.S.A. ATP World Tour,HARD,2,Sjeng Schalken,N/A Bye,Sjeng Schalken,,R128,0,0,0,0,0,0,0,0,0,0,0,0,0,0,0,0,0,0,0,0,0,0,0,0,0,0,0
2003-03-17 00:00:00.000,ATP Masters Series Miami FL; U.S.A. ATP World Tour,HARD,2,Jean-Rene Lisnard,Richard Gasquet,Jean-Rene Lisnard,3-6; 6-1; 2-1 RET,R128,74,4,0,38,51,28,38,8,13,5,6,9,36,51,2,3,44,72,29,44,10,28,9,12,10,39,72
2003-03-17 00:00:00.000,ATP Masters Series Miami FL; U.S.A. ATP World Tour,HARD,2,Franco Squillari,Mario Ancic,Franco Squillari,6-7(5); 7-6(4); 6-4,R128,186,4,10,60,117,47,60,28,57,6,9,17,75,117,13,8,75,131,54,75,24,56,5,9,17,78,131
2003-03-17 00:00:00.000,ATP Masters Series Miami FL; U.S.A. ATP World Tour,HARD,2,Tommy Robredo,N/A Bye,Tommy Robredo,,R128,0,0,0,0,0,0,0,0,0,0,0,0,0,0,0,0,0,0,0,0,0,0,0,0,0,0,0
2003-03-17 00:00:00.000,ATP Masters Series Miami FL; U.S.A. ATP World Tour,HARD,2,Juan Ignacio Chela,N/A Bye,Juan Ignacio Chela,,R128,0,0,0,0,0,0,0,0,0,0,0,0,0,0,0,0,0,0,0,0,0,0,0,0,0,0,0
2003-03-17 00:00:00.000,ATP Masters Series Miami FL; U.S.A. ATP World Tour,HARD,2,Martin Verkerk,Sargis Sargsian,Martin Verkerk,5-7; 7-5; 7-6(1),R128,157,23,13,68,111,51,68,19,43,6,10,18,70,111,5,7,69,121,48,69,24,52,9,13,18,72,121
2003-03-17 00:00:00.000,ATP Masters Series Miami FL; U.S.A. ATP World Tour,HARD,2,Luis Horna,Nikolay Davydenko,Luis Horna,6-3; 6-4,R128,79,2,0,50,59,35,50,6,9,2,3,10,41,59,0,1,45,64,28,45,8,19,4,7,9,36,64
2003-03-17 00:00:00.000,ATP Masters Series Miami FL; U.S.A. ATP World Tour,HARD,2,Roger Federer,N/A Bye,Roger Federer,,R128,0,0,0,0,0,0,0,0,0,0,0,0,0,0,0,0,0,0,0,0,0,0,0,0,0,0,0
2003-03-17 00:00:00.000,ATP Masters Series Miami FL; U.S.A. ATP World Tour,HARD,2,Jiri Novak,N/A Bye,Jiri Novak,,R128,0,0,0,0,0,0,0,0,0,0,0,0,0,0,0,0,0,0,0,0,0,0,0,0,0,0,0
2003-03-17 00:00:00.000,ATP Masters Series Miami FL; U.S.A. ATP World Tour,HARD,2,Nicolas Lapentti,Karol Beck,Nicolas Lapentti,4-6; 6-4; 7-6(4),R128,0,9,2,53,107,40,53,26,54,4,8,16,66,107,5,10,65,126,49,65,26,61,17,21,16,75,126
2003-03-17 00:00:00.000,ATP Masters Series Miami FL; U.S.A. ATP World Tour,HARD,2,Felix Mantilla,Lars Burgsmuller,Felix Mantilla,6-3; 6-1,R128,74,3,1,26,53,17,26,19,27,2,2,8,36,53,8,5,29,54,20,29,8,25,6,10,8,28,54
2003-03-17 00:00:00.000,ATP Masters Series Miami FL; U.S.A. ATP World Tour,HARD,2,Wayne Ferreira,N/A Bye,Wayne Ferreira,,R128,0,0,0,0,0,0,0,0,0,0,0,0,0,0,0,0,0,0,0,0,0,0,0,0,0,0,0
2003-03-17 00:00:00.000,ATP Masters Series Miami FL; U.S.A. ATP World Tour,HARD,2,Younes El Aynaoui,N/A Bye,Younes El Aynaoui,,R128,0,0,0,0,0,0,0,0,0,0,0,0,0,0,0,0,0,0,0,0,0,0,0,0,0,0,0
2003-03-17 00:00:00.000,ATP Masters Series Miami FL; U.S.A. ATP World Tour,HARD,2,Agustin Calleri,David Sanchez,Agustin Calleri,6-1; 6-4,R128,77,10,2,36,62,27,36,11,26,7,8,9,38,62,3,5,33,57,22,33,6,24,1,5,8,28,57
2003-03-17 00:00:00.000,ATP Masters Series Miami FL; U.S.A. ATP World Tour,HARD,2,Flavio Saretta,Alberto Martin,Flavio Saretta,6-3; 6-1,R128,62,0,3,22,44,18,22,15,22,0,0,8,33,44,2,3,24,47,17,24,8,23,3,7,8,25,47
2003-03-17 00:00:00.000,ATP Masters Series Miami FL; U.S.A. ATP World Tour,HARD,2,David Nalbandian,N/A Bye,David Nalbandian,,R128,0,0,0,0,0,0,0,0,0,0,0,0,0,0,0,0,0,0,0,0,0,0,0,0,0,0,0
2003-03-17 00:00:00.000,ATP Masters Series Miami FL; U.S.A. ATP World Tour,HARD,2,Gustavo Kuerten,N/A Bye,Gustavo Kuerten,,R128,0,0,0,0,0,0,0,0,0,0,0,0,0,0,0,0,0,0,0,0,0,0,0,0,0,0,0
2003-03-17 00:00:00.000,ATP Masters Series Miami FL; U.S.A. ATP World Tour,HARD,2,Thomas Enqvist,Michael Llodra,Thomas Enqvist,6-4; 6-7(5); 6-3,R128,123,5,4,52,98,42,52,25,46,1,2,16,67,98,13,8,50,101,41,50,23,51,2,5,15,64,101
2003-03-17 00:00:00.000,ATP Masters Series Miami FL; U.S.A. ATP World Tour,HARD,2,Mark Philippoussis,Feliciano Lopez,Mark Philippoussis,7-6(5); 6-4,R128,81,17,5,36,65,34,36,15,29,2,2,11,49,65,10,4,42,74,32,42,15,32,0,1,11,47,74
2003-03-17 00:00:00.000,ATP Masters Series Miami FL; U.S.A. ATP World Tour,HARD,2,Fernando Gonzalez,N/A Bye,Fernando Gonzalez,,R128,0,0,0,0,0,0,0,0,0,0,0,0,0,0,0,0,0,0,0,0,0,0,0,0,0,0,0
2003-03-17 00:00:00.000,ATP Masters Series Miami FL; U.S.A. ATP World Tour,HARD,2,Jarkko Nieminen,N/A Bye,Jarkko Nieminen,,R128,0,0,0,0,0,0,0,0,0,0,0,0,0,0,0,0,0,0,0,0,0,0,0,0,0,0,0
2003-03-17 00:00:00.000,ATP Masters Series Miami FL; U.S.A. ATP World Tour,HARD,2,Arnaud Clement,Peter Luczak,Arnaud Clement,6-4; 6-4,R128,91,9,2,34,59,31,34,9,25,3,4,10,40,59,4,2,36,68,28,36,13,32,5,8,10,41,68
2003-03-17 00:00:00.000,ATP Masters Series Miami FL; U.S.A. ATP World Tour,HARD,2,Michael Chang,Nicolas Kiefer,Michael Chang,6-2; 6-2,R128,63,7,0,26,44,24,26,10,18,0,0,8,34,44,4,0,20,42,10,20,11,22,2,6,8,21,42
2003-03-17 00:00:00.000,ATP Masters Series Miami FL; U.S.A. ATP World Tour,HARD,2,Andre Agassi,N/A Bye,Andre Agassi,,R128,0,0,0,0,0,0,0,0,0,0,0,0,0,0,0,0,0,0,0,0,0,0,0,0,0,0,0
2003-03-17 00:00:00.000,ATP Masters Series Miami FL; U.S.A. ATP World Tour,HARD,2,Francisco Clavet,Lleyton Hewitt,Francisco Clavet,6-4; 6-4,R64,96,0,2,34,65,23,34,14,31,3,6,10,37,65,2,3,22,60,17,22,15,38,1,6,10,32,60
2003-03-17 00:00:00.000,ATP Masters Series Miami FL; U.S.A. ATP World Tour,HARD,2,Hyung-Taik Lee,Xavier Malisse,Hyung-Taik Lee,6-7(6); 6-2; 6-1,R64,120,2,2,50,83,34,50,22,33,3,5,13,56,83,12,6,47,99,31,47,21,52,4,11,14,52,99
2003-03-17 00:00:00.000,ATP Masters Series Miami FL; U.S.A. ATP World Tour,HARD,2,James Blake,Fernando Meligeni,James Blake,7-6(5); 6-2,R64,90,1,1,40,68,27,40,16,28,1,3,10,43,68,2,1,34,71,23,34,16,37,6,10,10,39,71
2003-03-17 00:00:00.000,ATP Masters Series Miami FL; U.S.A. ATP World Tour,HARD,2,Robby Ginepri,Alex Corretja,Robby Ginepri,4-6; 7-6(5); 6-2,R64,123,13,1,55,86,39,55,20,31,2,5,15,59,86,3,7,54,95,38,54,20,41,9,13,15,58,95
2003-03-17 00:00:00.000,ATP Masters Series Miami FL; U.S.A. ATP World Tour,HARD,2,Mardy Fish,Sebastien Grosjean,Mardy Fish,6-4; 7-6(3),R64,100,8,2,37,69,31,37,19,32,3,4,11,50,69,6,1,54,82,36,54,14,28,2,4,11,50,82
2003-03-17 00:00:00.000,ATP Masters Series Miami FL; U.S.A. ATP World Tour,HARD,2,Nicolas Escude,Tim Henman,Nicolas Escude,6-3; 6-4,R64,83,5,2,39,56,29,39,9,17,1,2,10,38,56,1,6,30,56,18,30,15,26,1,4,9,33,56
2003-03-17 00:00:00.000,ATP Masters Series Miami FL; U.S.A. ATP World Tour,HARD,2,Fernando Verdasco,Max Mirnyi,Fernando Verdasco,1-6; 7-6(5); 6-4,R64,131,5,3,86,107,52,86,13,21,7,10,14,65,107,12,4,48,98,37,48,27,50,5,7,15,64,98
2003-03-17 00:00:00.000,ATP Masters Series Miami FL; U.S.A. ATP World Tour,HARD,2,Carlos Moya,Vincent Spadea,Carlos Moya,6-4; 5-7; 6-4,R64,121,12,0,58,92,47,58,19,34,3,4,16,66,92,3,7,44,95,35,44,28,51,0,2,16,63,95
2003-03-17 00:00:00.000,ATP Masters Series Miami FL; U.S.A. ATP World Tour,HARD,2,Juan Carlos Ferrero,Fernando Vicente,Juan Carlos Ferrero,6-2; 6-2,R64,54,8,1,28,43,25,28,8,15,0,0,8,33,43,3,2,20,46,12,20,10,26,1,5,8,22,46
2003-03-17 00:00:00.000,ATP Masters Series Miami FL; U.S.A. ATP World Tour,HARD,2,Marcelo Rios,Taylor Dent,Marcelo Rios,6-1; 6-1,R64,59,3,0,32,47,24,32,8,15,2,2,7,32,47,0,5,29,49,16,29,5,20,4,9,7,21,49
2003-03-17 00:00:00.000,ATP Masters Series Miami FL; U.S.A. ATP World Tour,HARD,2,Yevgeny Kafelnikov,Jonas Bjorkman,Yevgeny Kafelnikov,6-3; 6-3,R64,78,3,1,34,55,27,34,11,21,1,2,9,38,55,7,2,32,65,20,32,15,33,5,9,9,35,65
2003-03-17 00:00:00.000,ATP Masters Series Miami FL; U.S.A. ATP World Tour,HARD,2,Paradorn Srichaphan,Jose Acasuso,Paradorn Srichaphan,6-4; 7-6(5),R64,103,4,3,34,69,31,34,18,35,1,2,11,49,69,8,3,39,75,28,39,19,36,4,6,11,47,75
2003-03-17 00:00:00.000,ATP Masters Series Miami FL; U.S.A. ATP World Tour,HARD,2,Rainer Schuettler,Jan-Michael Gambill,Rainer Schuettler,6-2; 6-3,R64,86,0,1,28,47,20,28,12,19,1,2,8,32,47,7,1,28,71,16,28,20,43,9,14,9,36,71
2003-03-17 00:00:00.000,ATP Masters Series Miami FL; U.S.A. ATP World Tour,HARD,2,Radek Stepanek,Mikhail Youzhny,Radek Stepanek,6-3; 6-3,R64,75,2,3,18,50,17,18,18,32,3,4,9,35,50,0,4,37,69,21,37,14,32,10,14,9,35,69
2003-03-17 00:00:00.000,ATP Masters Series Miami FL; U.S.A. ATP World Tour,HARD,2,Todd Martin,Andrei Pavel,Todd Martin,6-7(2); 6-4; 2-0 RET,R64,104,10,2,47,73,37,47,15,26,4,5,12,52,73,8,4,46,78,31,46,16,32,0,3,12,47,78
2003-03-17 00:00:00.000,ATP Masters Series Miami FL; U.S.A. ATP World Tour,HARD,2,Andy Roddick,Cyril Saulnier,Andy Roddick,6-7(1); 7-6(2); 6-4,R64,131,9,3,71,120,55,71,28,49,7,7,17,83,120,10,4,58,100,43,58,31,42,2,3,17,74,100
2003-03-17 00:00:00.000,ATP Masters Series Miami FL; U.S.A. ATP World Tour,HARD,2,Davide Sanguinetti,Marat Safin,Davide Sanguinetti,7-6(9); 7-5,R64,120,3,4,57,92,42,57,19,35,4,6,12,61,92,7,2,39,76,31,39,20,37,5,8,12,51,76
2003-03-17 00:00:00.000,ATP Masters Series Miami FL; U.S.A. ATP World Tour,HARD,2,Guillermo Coria,Antony Dupuis,Guillermo Coria,6-0; 6-4,R64,69,3,0,26,41,19,26,12,15,1,2,8,31,41,4,2,24,50,15,24,6,26,4,9,8,21,50
2003-03-17 00:00:00.000,ATP Masters Series Miami FL; U.S.A. ATP World Tour,HARD,2,Nicolas Massu,Gaston Gaudio,Nicolas Massu,6-4; 5-7; 6-3,R64,177,6,6,63,113,48,63,20,50,10,13,15,68,113,4,6,56,94,36,56,19,38,6,11,16,55,94
2003-03-17 00:00:00.000,ATP Masters Series Miami FL; U.S.A. ATP World Tour,HARD,2,Albert Costa,Olivier Rochus,Albert Costa,6-3; 6-2,R64,84,7,4,38,67,29,38,16,29,6,6,9,45,67,1,0,29,57,16,29,15,28,1,4,8,31,57
2003-03-17 00:00:00.000,ATP Masters Series Miami FL; U.S.A. ATP World Tour,HARD,2,Sjeng Schalken,Jean-Rene Lisnard,Sjeng Schalken,6-3; 6-4,R64,74,0,1,35,51,23,35,10,16,0,2,10,33,51,0,4,31,54,18,31,11,23,0,4,9,29,54
2003-03-17 00:00:00.000,ATP Masters Series Miami FL; U.S.A. ATP World Tour,HARD,2,Franco Squillari,Tommy Robredo,Franco Squillari,6-3; 6-4,R64,105,2,1,45,73,31,45,10,28,6,9,10,41,73,1,4,46,63,25,46,6,17,6,11,9,31,63
2003-03-17 00:00:00.000,ATP Masters Series Miami FL; U.S.A. ATP World Tour,HARD,2,Juan Ignacio Chela,Martin Verkerk,Juan Ignacio Chela,6-7(5); 6-3; 6-4,R64,123,10,1,60,93,50,60,20,33,4,5,16,70,93,14,5,64,104,48,64,17,40,2,5,15,65,104
2003-03-17 00:00:00.000,ATP Masters Series Miami FL; U.S.A. ATP World Tour,HARD,2,Roger Federer,Luis Horna,Roger Federer,6-2; 7-5,R64,81,7,4,34,58,28,34,15,24,3,4,10,43,58,3,3,39,63,24,39,9,24,3,7,10,33,63
2003-03-17 00:00:00.000,ATP Masters Series Miami FL; U.S.A. ATP World Tour,HARD,2,Nicolas Lapentti,Jiri Novak,Nicolas Lapentti,2-6; 6-3; 6-4,R64,128,10,6,61,107,41,61,24,46,13,16,14,65,107,3,1,41,72,31,41,16,31,3,6,13,47,72
2003-03-17 00:00:00.000,ATP Masters Series Miami FL; U.S.A. ATP World Tour,HARD,2,Wayne Ferreira,Felix Mantilla,Wayne Ferreira,6-4; 6-1,R64,61,10,2,30,47,24,30,10,17,1,1,8,34,47,0,3,22,47,14,22,12,25,2,6,9,26,47
2003-03-17 00:00:00.000,ATP Masters Series Miami FL; U.S.A. ATP World Tour,HARD,2,Younes El Aynaoui,Agustin Calleri,Younes El Aynaoui,6-1; 6-4,R64,64,6,1,29,49,25,29,13,20,3,3,9,38,49,4,3,25,48,15,25,11,23,2,5,8,26,48
2003-03-17 00:00:00.000,ATP Masters Series Miami FL; U.S.A. ATP World Tour,HARD,2,David Nalbandian,Flavio Saretta,David Nalbandian,4-6; 6-4; 6-1,R64,112,3,4,42,72,30,42,19,30,2,4,13,49,72,3,3,46,83,28,46,19,37,4,9,14,47,83
2003-03-17 00:00:00.000,ATP Masters Series Miami FL; U.S.A. ATP World Tour,HARD,2,Thomas Enqvist,Gustavo Kuerten,Thomas Enqvist,6-3; 6-4,R64,70,7,5,27,59,20,27,22,32,1,1,10,42,59,12,1,28,52,24,28,11,24,1,3,9,35,52
2003-03-17 00:00:00.000,ATP Masters Series Miami FL; U.S.A. ATP World Tour,HARD,2,Mark Philippoussis,Fernando Gonzalez,Mark Philippoussis,7-6(5); 6-4,R64,78,16,2,37,59,33,37,14,22,0,0,11,47,59,5,5,43,63,32,43,11,20,0,1,11,43,63
2003-03-17 00:00:00.000,ATP Masters Series Miami FL; U.S.A. ATP World Tour,HARD,2,Jarkko Nieminen,Arnaud Clement,Jarkko Nieminen,6-2; 6-1,R64,62,5,0,29,39,22,29,5,10,1,2,7,27,39,0,2,23,46,13,23,5,23,3,9,8,18,46
2003-03-17 00:00:00.000,ATP Masters Series Miami FL; U.S.A. ATP World Tour,HARD,2,Andre Agassi,Michael Chang,Andre Agassi,6-4; 6-2,R64,87,6,0,34,59,27,34,16,25,2,2,9,43,59,4,1,33,63,23,33,13,30,2,5,9,36,63
2003-03-17 00:00:00.000,ATP Masters Series Miami FL; U.S.A. ATP World Tour,HARD,2,Hyung-Taik Lee,Francisco Clavet,Hyung-Taik Lee,4-6; 6-2; 6-1,R32,102,2,2,42,74,33,42,15,32,9,12,13,48,74,2,0,53,82,30,53,10,29,6,12,12,40,82
2003-03-17 00:00:00.000,ATP Masters Series Miami FL; U.S.A. ATP World Tour,HARD,2,Robby Ginepri,James Blake,Robby Ginepri,6-3; 6-2,R32,56,7,0,32,54,23,32,13,22,3,4,9,36,54,1,2,24,41,12,24,8,17,3,7,8,20,41
2003-03-17 00:00:00.000,ATP Masters Series Miami FL; U.S.A. ATP World Tour,HARD,2,Nicolas Escude,Mardy Fish,Nicolas Escude,7-5; 6-3,R32,97,13,3,45,79,37,45,15,34,8,8,11,52,79,6,5,29,58,26,29,12,29,1,3,10,38,58
2003-03-17 00:00:00.000,ATP Masters Series Miami FL; U.S.A. ATP World Tour,HARD,2,Carlos Moya,Fernando Verdasco,Carlos Moya,7-6(5); 6-3,R32,83,3,1,28,54,24,28,17,26,0,1,10,41,54,2,3,51,75,28,51,15,24,4,7,11,43,75
2003-03-17 00:00:00.000,ATP Masters Series Miami FL; U.S.A. ATP World Tour,HARD,2,Marcelo Rios,Juan Carlos Ferrero,Marcelo Rios,6-3; 7-6(2),R32,98,6,4,47,69,35,47,12,22,2,3,11,47,69,4,2,55,89,35,55,15,34,7,9,10,50,89
2003-03-17 00:00:00.000,ATP Masters Series Miami FL; U.S.A. ATP World Tour,HARD,2,Paradorn Srichaphan,Yevgeny Kafelnikov,Paradorn Srichaphan,6-3; 6-7(7); 6-3,R32,143,8,5,56,111,40,56,25,55,11,14,16,65,111,7,1,61,100,37,61,18,39,7,12,14,55,100
2003-03-17 00:00:00.000,ATP Masters Series Miami FL; U.S.A. ATP World Tour,HARD,2,Radek Stepanek,Rainer Schuettler,Radek Stepanek,6-4; 6-4,R32,87,3,1,34,61,26,34,17,27,4,5,10,43,61,0,3,43,69,26,43,12,26,3,6,10,38,69
2003-03-17 00:00:00.000,ATP Masters Series Miami FL; U.S.A. ATP World Tour,HARD,2,Todd Martin,Andy Roddick,Todd Martin,7-6(3); 6-4,R32,105,12,7,48,84,37,48,20,36,4,5,11,57,84,10,4,43,69,34,43,11,26,1,3,11,45,69
2003-03-17 00:00:00.000,ATP Masters Series Miami FL; U.S.A. ATP World Tour,HARD,2,Guillermo Coria,Davide Sanguinetti,Guillermo Coria,6-3; 7-6(4),R32,110,5,2,50,77,35,50,15,27,5,7,11,50,77,0,1,33,68,22,33,16,35,5,8,10,38,68
2003-03-17 00:00:00.000,ATP Masters Series Miami FL; U.S.A. ATP World Tour,HARD,2,Albert Costa,Nicolas Massu,Albert Costa,7-6(6); 6-2,R32,119,5,1,33,65,26,33,21,32,5,6,10,47,65,7,0,37,68,26,37,16,31,4,7,10,42,68
2003-03-17 00:00:00.000,ATP Masters Series Miami FL; U.S.A. ATP World Tour,HARD,2,Sjeng Schalken,Franco Squillari,Sjeng Schalken,6-4; 7-5,R32,100,1,3,43,63,30,43,10,20,4,7,11,40,63,1,3,33,68,18,33,17,35,1,6,11,35,68
2003-03-17 00:00:00.000,ATP Masters Series Miami FL; U.S.A. ATP World Tour,HARD,2,Roger Federer,Juan Ignacio Chela,Roger Federer,6-1; 3-6; 6-1,R32,75,9,2,43,66,33,43,14,23,1,2,12,47,66,3,4,38,63,22,38,13,25,1,5,11,35,63
2003-03-17 00:00:00.000,ATP Masters Series Miami FL; U.S.A. ATP World Tour,HARD,2,Nicolas Lapentti,Wayne Ferreira,Nicolas Lapentti,6-4; 6-2,R32,81,4,0,42,64,30,42,14,22,10,10,9,44,64,5,0,34,52,20,34,10,18,1,4,9,30,52
2003-03-17 00:00:00.000,ATP Masters Series Miami FL; U.S.A. ATP World Tour,HARD,2,Younes El Aynaoui,David Nalbandian,Younes El Aynaoui,6-3; 4-6; 6-4,R32,120,12,2,53,77,42,53,13,24,0,2,14,55,77,6,4,56,100,35,56,23,44,5,9,15,58,100
2003-03-17 00:00:00.000,ATP Masters Series Miami FL; U.S.A. ATP World Tour,HARD,2,Mark Philippoussis,Thomas Enqvist,Mark Philippoussis,6-7(6); 7-6(3); 6-3,R32,148,24,4,58,102,48,58,27,44,4,5,16,75,102,18,6,69,122,53,69,28,53,9,12,17,81,122
2003-03-17 00:00:00.000,ATP Masters Series Miami FL; U.S.A. ATP World Tour,HARD,2,Andre Agassi,Jarkko Nieminen,Andre Agassi,6-2; 6-0,R32,59,3,1,32,51,24,32,10,19,3,3,7,34,51,2,2,28,47,16,28,5,19,3,8,7,21,47
2003-03-17 00:00:00.000,ATP Masters Series Miami FL; U.S.A. ATP World Tour,HARD,2,Robby Ginepri,Hyung-Taik Lee,Robby Ginepri,6-3; 6-2,R16,58,8,2,27,49,20,27,13,22,0,1,9,33,49,1,2,29,47,20,29,6,18,4,8,8,26,47
2003-03-17 00:00:00.000,ATP Masters Series Miami FL; U.S.A. ATP World Tour,HARD,2,Carlos Moya,Nicolas Escude,Carlos Moya,6-4; 7-6(8),R16,118,13,1,43,80,29,43,25,37,7,9,11,54,80,4,6,41,87,30,41,24,46,6,9,11,54,87
2003-03-17 00:00:00.000,ATP Masters Series Miami FL; U.S.A. ATP World Tour,HARD,2,Paradorn Srichaphan,Marcelo Rios,Paradorn Srichaphan,W/O,R16,0,0,0,0,0,0,0,0,0,0,0,0,0,0,0,0,0,0,0,0,0,0,0,0,0,0,0
2003-03-17 00:00:00.000,ATP Masters Series Miami FL; U.S.A. ATP World Tour,HARD,2,Todd Martin,Radek Stepanek,Todd Martin,6-3; 6-2,R16,86,4,1,37,70,28,37,17,33,6,6,9,45,70,5,5,27,47,23,27,4,20,0,3,8,27,47
2003-03-17 00:00:00.000,ATP Masters Series Miami FL; U.S.A. ATP World Tour,HARD,2,Albert Costa,Guillermo Coria,Albert Costa,7-5; 3-6; 6-3,R16,160,5,2,58,109,41,58,28,51,5,7,15,69,109,4,3,72,98,51,72,11,26,4,7,15,62,98
2003-03-17 00:00:00.000,ATP Masters Series Miami FL; U.S.A. ATP World Tour,HARD,2,Roger Federer,Sjeng Schalken,Roger Federer,6-3; 6-2,R16,77,1,3,28,64,21,28,22,36,3,3,9,43,64,0,4,39,64,29,39,7,25,7,10,8,36,64
2003-03-17 00:00:00.000,ATP Masters Series Miami FL; U.S.A. ATP World Tour,HARD,2,Younes El Aynaoui,Nicolas Lapentti,Younes El Aynaoui,6-0; 7-6(7),R16,95,9,2,31,51,27,31,12,20,1,2,9,39,51,5,2,43,71,25,43,12,28,3,7,9,37,71
2003-03-17 00:00:00.000,ATP Masters Series Miami FL; U.S.A. ATP World Tour,HARD,2,Andre Agassi,Mark Philippoussis,Andre Agassi,4-6; 6-3; 6-2,R16,112,4,2,48,69,37,48,13,21,0,2,14,50,69,11,3,44,88,33,44,19,44,10,14,13,52,88
2003-03-17 00:00:00.000,ATP Masters Series Miami FL; U.S.A. ATP World Tour,HARD,2,Carlos Moya,Robby Ginepri,Carlos Moya,6-7(5); 6-3; 7-6(4),Q,142,11,8,58,121,43,58,36,63,2,4,17,79,121,8,3,66,110,46,66,22,44,3,6,16,68,110
2003-03-17 00:00:00.000,ATP Masters Series Miami FL; U.S.A. ATP World Tour,HARD,2,Paradorn Srichaphan,Todd Martin,Paradorn Srichaphan,6-3; 6-7(5); 7-5,Q,138,10,10,59,110,48,59,25,51,8,10,17,73,110,9,6,55,97,42,55,20,42,1,5,16,62,97
2003-03-17 00:00:00.000,ATP Masters Series Miami FL; U.S.A. ATP World Tour,HARD,2,Albert Costa,Roger Federer,Albert Costa,7-6(4); 4-6; 7-6(7),Q,192,4,3,68,122,50,68,28,54,10,14,17,78,122,13,5,78,127,58,78,23,49,5,8,17,81,127
2003-03-17 00:00:00.000,ATP Masters Series Miami FL; U.S.A. ATP World Tour,HARD,2,Andre Agassi,Younes El Aynaoui,Andre Agassi,7-6(6); 4-6; 6-1,Q,123,7,2,60,89,48,60,16,29,3,5,15,64,89,15,8,62,98,49,62,13,36,2,5,14,62,98
2003-03-17 00:00:00.000,ATP Masters Series Miami FL; U.S.A. ATP World Tour,HARD,2,Carlos Moya,Paradorn Srichaphan,Carlos Moya,6-4; 6-2,S,74,5,2,29,57,23,29,17,28,4,4,9,40,57,3,1,27,56,17,27,16,29,3,6,9,33,56
2003-03-17 00:00:00.000,ATP Masters Series Miami FL; U.S.A. ATP World Tour,HARD,2,Andre Agassi,Albert Costa,Andre Agassi,6-2; 6-4,S,103,6,6,32,54,22,32,15,22,5,6,9,37,54,10,6,41,86,26,41,18,45,9,13,9,44,86
2003-03-17 00:00:00.000,ATP Masters Series Miami FL; U.S.A. ATP World Tour,HARD,2,Andre Agassi,Carlos Moya,Andre Agassi,6-3; 6-3,F,71,8,1,39,55,31,39,9,16,3,3,9,40,55,3,1,26,53,13,26,16,27,3,6,9,29,53
2003-04-07 00:00:00.000,Casablanca Morocco ATP World Tour,CLAY,2,Younes El Aynaoui,Albert Montanes,Younes El Aynaoui,3-6; 6-3; 6-2,R32,99,10,3,38,70,31,38,18,32,1,3,13,49,70,2,7,45,82,35,45,16,37,3,7,13,51,82
2003-04-07 00:00:00.000,Casablanca Morocco ATP World Tour,CLAY,2,Magnus Norman,Jiri Vanek,Magnus Norman,6-4; 4-6; 7-5,R32,134,6,3,49,93,35,49,25,44,5,8,16,60,93,6,1,47,93,34,47,24,46,3,7,16,58,93
2003-04-07 00:00:00.000,Casablanca Morocco ATP World Tour,CLAY,2,Zeljko Krajan,Albert Portas,Zeljko Krajan,7-6(4); 6-4,R32,103,6,4,41,77,30,41,15,36,7,11,11,45,77,4,10,37,88,24,37,22,51,8,13,11,46,88
2003-04-07 00:00:00.000,Casablanca Morocco ATP World Tour,CLAY,2,Nicolas Massu,Fernando Vicente,Nicolas Massu,0-6; 6-3; 7-6(5),R32,139,0,5,44,84,30,44,15,40,5,11,13,45,84,3,3,69,102,41,69,17,33,9,14,14,58,102
2003-04-07 00:00:00.000,Casablanca Morocco ATP World Tour,CLAY,2,Fernando Meligeni,Arnaud Clement,Fernando Meligeni,6-4; 5-7; 6-2,R32,113,9,6,48,93,35,48,31,45,7,8,15,66,93,3,7,38,86,28,38,27,48,0,3,15,55,86
2003-04-07 00:00:00.000,Casablanca Morocco ATP World Tour,CLAY,2,Hicham Arazi,Mehdi Tahiri,Hicham Arazi,6-1; 7-6(12),R32,127,0,3,28,71,20,28,24,43,1,3,9,44,71,2,3,72,100,38,72,14,28,9,14,10,52,100
2003-04-07 00:00:00.000,Casablanca Morocco ATP World Tour,CLAY,2,Olivier Mutis,Dennis van Scheppingen,Olivier Mutis,6-4; 5-7; 6-3,R32,108,6,5,46,95,33,46,31,49,3,4,15,64,95,4,3,70,103,48,70,16,33,8,11,16,64,103
2003-04-07 00:00:00.000,Casablanca Morocco ATP World Tour,CLAY,2,Eric Prodon,Ruben Ramirez Hidalgo,Eric Prodon,7-6(5); 6-2,R32,125,5,0,32,64,23,32,17,32,1,3,10,40,64,4,3,40,65,26,40,10,25,6,10,10,36,65
2003-04-07 00:00:00.000,Casablanca Morocco ATP World Tour,CLAY,2,Federico Browne,Olivier Rochus,Federico Browne,7-6(4); 6-3,R32,92,4,1,42,63,34,42,9,21,1,3,10,43,63,1,3,49,74,30,49,12,25,5,9,11,42,74
2003-04-07 00:00:00.000,Casablanca Morocco ATP World Tour,CLAY,2,Franco Squillari,Talal Ouahabi,Franco Squillari,6-1; 6-3,R32,70,1,3,32,53,19,32,13,21,0,1,8,32,53,2,3,43,65,22,43,9,22,7,12,8,31,65
2003-04-07 00:00:00.000,Casablanca Morocco ATP World Tour,CLAY,2,Attila Savolt,Oscar Hernandez,Attila Savolt,2-6; 6-3; 7-6(5),R32,142,8,7,52,105,41,52,25,53,8,11,15,66,105,2,0,49,80,40,49,17,31,6,8,14,57,80
2003-04-07 00:00:00.000,Casablanca Morocco ATP World Tour,CLAY,2,Dominik Hrbaty,Mounir El Aarej,Dominik Hrbaty,6-3; 7-6(5),R32,71,3,3,40,67,30,40,13,27,1,3,10,43,67,1,1,39,68,27,39,11,29,2,6,11,38,68
2003-04-07 00:00:00.000,Casablanca Morocco ATP World Tour,CLAY,2,Luis Horna,Andre Sa,Luis Horna,6-4; 6-0,R32,60,3,2,30,47,26,30,7,17,3,4,8,33,47,0,6,21,40,11,21,5,19,2,7,8,16,40
2003-04-07 00:00:00.000,Casablanca Morocco ATP World Tour,CLAY,2,Julien Boutter,Davide Sanguinetti,Julien Boutter,7-5; 7-6(0),R32,92,7,3,38,68,27,38,20,30,3,6,12,47,68,3,5,42,79,26,42,19,37,6,10,12,45,79
2003-04-07 00:00:00.000,Casablanca Morocco ATP World Tour,CLAY,2,Flavio Saretta,Antony Dupuis,Flavio Saretta,6-4; 6-1,R32,86,6,3,29,50,22,29,12,21,3,4,8,34,50,5,4,25,62,15,25,18,37,6,11,9,33,62
2003-04-07 00:00:00.000,Casablanca Morocco ATP World Tour,CLAY,2,Jean-Rene Lisnard,Paul-Henri Mathieu,Jean-Rene Lisnard,6-2; 6-4,R32,96,2,5,35,69,22,35,13,34,6,10,9,35,69,0,5,32,70,17,32,13,38,4,11,9,30,70
2003-04-07 00:00:00.000,Casablanca Morocco ATP World Tour,CLAY,2,Younes El Aynaoui,Magnus Norman,Younes El Aynaoui,6-4; 3-6; 6-3,R16,121,6,5,52,82,45,52,14,30,4,5,14,59,82,4,3,43,84,32,43,23,41,4,6,14,55,84
2003-04-07 00:00:00.000,Casablanca Morocco ATP World Tour,CLAY,2,Nicolas Massu,Zeljko Krajan,Nicolas Massu,2-6; 6-1; 6-4,R16,133,3,5,52,81,31,52,14,29,5,10,13,45,81,1,3,45,77,29,45,11,32,3,9,12,40,77
2003-04-07 00:00:00.000,Casablanca Morocco ATP World Tour,CLAY,2,Hicham Arazi,Fernando Meligeni,Hicham Arazi,6-3; 6-0,R16,72,0,0,34,52,22,34,12,18,3,3,7,34,52,2,3,25,56,14,25,12,31,5,10,8,26,56
2003-04-07 00:00:00.000,Casablanca Morocco ATP World Tour,CLAY,2,Olivier Mutis,Eric Prodon,Olivier Mutis,6-3; 6-3,R16,55,2,3,25,44,22,25,9,19,0,2,9,31,44,1,3,39,61,22,39,5,22,5,10,9,27,61
2003-04-07 00:00:00.000,Casablanca Morocco ATP World Tour,CLAY,2,Federico Browne,Franco Squillari,Federico Browne,1-6; 7-6; 6-4,R16,0,0,0,0,0,0,0,0,0,0,0,0,0,0,0,0,0,0,0,0,0,0,0,0,0,0,0
2003-04-07 00:00:00.000,Casablanca Morocco ATP World Tour,CLAY,2,Dominik Hrbaty,Attila Savolt,Dominik Hrbaty,6-3; 6-2,R16,71,0,0,38,59,28,38,11,21,6,7,9,39,59,4,3,24,50,15,24,11,26,4,8,8,26,50
2003-04-07 00:00:00.000,Casablanca Morocco ATP World Tour,CLAY,2,Julien Boutter,Luis Horna,Julien Boutter,6-7(4); 6-3; 6-4,R16,121,18,13,57,104,46,57,25,47,6,7,16,71,104,3,5,62,83,44,62,13,21,0,3,15,57,83
2003-04-07 00:00:00.000,Casablanca Morocco ATP World Tour,CLAY,2,Flavio Saretta,Jean-Rene Lisnard,Flavio Saretta,7-5; 6-4,R16,130,3,4,43,64,29,43,10,21,3,6,11,39,64,1,2,60,98,31,60,20,38,9,14,11,51,98
2003-04-07 00:00:00.000,Casablanca Morocco ATP World Tour,CLAY,2,Younes El Aynaoui,Nicolas Massu,Younes El Aynaoui,4-6; 6-3; 7-5,Q,158,8,4,57,113,43,57,28,56,7,9,16,71,113,1,7,55,86,40,55,13,31,1,4,15,53,86
2003-04-07 00:00:00.000,Casablanca Morocco ATP World Tour,CLAY,2,Hicham Arazi,Olivier Mutis,Hicham Arazi,3-6; 7-6(9); 6-4,Q,131,3,5,60,100,41,60,18,40,3,9,16,59,100,1,6,44,101,28,44,31,57,2,7,15,59,101
2003-04-07 00:00:00.000,Casablanca Morocco ATP World Tour,CLAY,2,Dominik Hrbaty,Federico Browne,Dominik Hrbaty,6-7(5); 6-3; 6-0,Q,118,2,3,48,84,36,48,25,36,2,3,14,61,84,9,6,53,97,35,53,20,44,4,9,13,55,97
2003-04-07 00:00:00.000,Casablanca Morocco ATP World Tour,CLAY,2,Julien Boutter,Flavio Saretta,Julien Boutter,7-5; 7-6(5),Q,124,3,6,47,93,34,47,28,46,8,9,12,62,93,1,3,47,74,33,47,15,27,3,5,12,48,74
2003-04-07 00:00:00.000,Casablanca Morocco ATP World Tour,CLAY,2,Younes El Aynaoui,Hicham Arazi,Younes El Aynaoui,6-2; 3-6; 6-3,S,109,14,2,47,78,32,47,16,31,8,12,13,48,78,3,1,63,92,32,63,14,29,9,15,13,46,92
2003-04-07 00:00:00.000,Casablanca Morocco ATP World Tour,CLAY,2,Julien Boutter,Dominik Hrbaty,Julien Boutter,6-3; 6-4,S,70,5,5,41,61,29,41,10,20,1,3,10,39,61,4,3,34,51,19,34,9,17,4,8,9,28,51
2003-04-07 00:00:00.000,Casablanca Morocco ATP World Tour,CLAY,2,Julien Boutter,Younes El Aynaoui,Julien Boutter,6-2; 2-6; 6-1,F,98,1,7,43,71,34,43,13,28,5,7,12,47,71,1,4,48,74,29,48,13,26,10,14,11,42,74
2003-04-07 00:00:00.000,Estoril Portugal ATP World Tour,CLAY,2,John van Lottum,Jiri Novak,John van Lottum,6-7(5); 6-4; 7-5,R32,153,3,15,56,116,40,56,26,60,8,13,17,66,116,6,4,58,113,36,58,25,55,3,10,17,61,113
2003-04-07 00:00:00.000,Estoril Portugal ATP World Tour,CLAY,2,Galo Blanco,Fernando Verdasco,Galo Blanco,7-6(3); 1-6; 6-4,R32,118,5,10,50,97,39,50,25,47,6,8,14,64,97,4,0,66,81,50,66,11,15,3,4,15,61,81
2003-04-07 00:00:00.000,Estoril Portugal ATP World Tour,CLAY,2,Harel Levy,Martin Verkerk,Harel Levy,6-3; 7-6(4),R32,90,1,2,34,66,28,34,16,32,2,3,10,44,66,3,7,41,84,30,41,17,43,3,6,11,47,84
2003-04-07 00:00:00.000,Estoril Portugal ATP World Tour,CLAY,2,Tommy Robredo,Andrea Gaudenzi,Tommy Robredo,6-3; 6-1,R32,59,2,3,24,44,18,24,12,20,1,2,8,30,44,2,8,31,53,17,31,8,22,1,6,8,25,53
2003-04-07 00:00:00.000,Estoril Portugal ATP World Tour,CLAY,2,Fernando Gonzalez,David Ferrer,Fernando Gonzalez,6-2; 4-6; 6-4,R32,100,5,8,41,83,31,41,25,42,4,6,14,56,83,0,7,61,98,36,61,22,37,7,11,14,58,98
2003-04-07 00:00:00.000,Estoril Portugal ATP World Tour,CLAY,2,Jose Acasuso,David Sanchez,Jose Acasuso,6-3; 6-4,R32,88,6,2,37,64,24,37,12,27,5,8,9,36,64,1,3,30,54,16,30,8,24,5,11,10,24,54
2003-04-07 00:00:00.000,Estoril Portugal ATP World Tour,CLAY,2,Agustin Calleri,Diogo Rocha,Agustin Calleri,6-1; 6-0,R32,42,6,1,15,29,13,15,8,14,0,1,6,21,29,0,2,16,39,5,16,6,23,2,9,7,11,39
2003-04-07 00:00:00.000,Estoril Portugal ATP World Tour,CLAY,2,Jarkko Nieminen,Helder Lopes,Jarkko Nieminen,4-6; 6-1; 6-1,R32,95,2,2,58,76,35,58,12,18,5,8,12,47,76,5,4,31,79,18,31,20,48,9,16,12,38,79
2003-04-07 00:00:00.000,Estoril Portugal ATP World Tour,CLAY,2,Yevgeny Kafelnikov,Irakli Labadze,Yevgeny Kafelnikov,6-1; 6-0,R32,47,2,2,22,37,20,22,7,15,0,1,7,27,37,1,6,17,43,8,17,7,26,1,7,6,15,43
2003-04-07 00:00:00.000,Estoril Portugal ATP World Tour,CLAY,2,Adrian Voinea,Wayne Arthurs,Adrian Voinea,3-6; 7-5; 7-6(1),R32,124,6,4,47,104,42,47,29,57,4,6,16,71,104,15,10,47,97,41,47,25,50,4,6,17,66,97
2003-04-07 00:00:00.000,Estoril Portugal ATP World Tour,CLAY,2,Alexander Waske,Gaston Etlis,Alexander Waske,6-2; 5-7; 6-4,R32,135,3,6,59,98,41,59,22,39,2,4,15,63,98,6,7,61,104,43,61,18,43,7,11,15,61,104
2003-04-07 00:00:00.000,Estoril Portugal ATP World Tour,CLAY,2,Nikolay Davydenko,Sjeng Schalken,Nikolay Davydenko,6-3; 6-2,R32,72,0,0,33,55,22,33,13,22,2,4,9,35,55,0,3,41,57,22,41,4,16,7,12,8,26,57
2003-04-07 00:00:00.000,Estoril Portugal ATP World Tour,CLAY,2,Max Mirnyi,Alberto Martin,Max Mirnyi,6-0; 4-6; 7-5,R32,102,5,4,59,81,47,59,11,22,2,3,14,58,81,0,6,67,93,45,67,10,26,6,10,14,55,93
2003-04-07 00:00:00.000,Estoril Portugal ATP World Tour,CLAY,2,Victor Hanescu,Christophe Rochus,Victor Hanescu,6-3; 6-2,R32,60,1,0,44,53,35,44,2,9,0,0,9,37,53,0,2,49,61,29,49,4,12,3,6,8,33,61
2003-04-07 00:00:00.000,Estoril Portugal ATP World Tour,CLAY,2,Bernardo Mota,Raemon Sluiter,Bernardo Mota,7-6(1); 3-6; 7-6(3),R32,138,3,3,70,103,51,70,15,33,5,9,16,66,103,9,4,62,104,46,62,21,42,1,4,17,67,104
2003-04-07 00:00:00.000,Estoril Portugal ATP World Tour,CLAY,2,Feliciano Lopez,Rainer Schuettler,Feliciano Lopez,6-1; 4-6; 7-5,R32,102,4,4,51,90,37,51,21,39,6,7,14,58,90,3,3,55,88,38,55,17,33,2,6,15,55,88
2003-04-07 00:00:00.000,Estoril Portugal ATP World Tour,CLAY,2,Galo Blanco,John van Lottum,Galo Blanco,6-1; 6-3,R16,67,1,4,27,60,15,27,20,33,4,6,8,35,60,0,3,24,42,10,24,6,18,1,7,8,16,42
2003-04-07 00:00:00.000,Estoril Portugal ATP World Tour,CLAY,2,Tommy Robredo,Harel Levy,Tommy Robredo,6-3; 6-1,R16,53,1,1,29,43,24,29,9,14,0,0,8,33,43,2,1,38,58,24,38,6,20,5,9,8,30,58
2003-04-07 00:00:00.000,Estoril Portugal ATP World Tour,CLAY,2,Fernando Gonzalez,Jose Acasuso,Fernando Gonzalez,6-1; 6-3,R16,49,2,2,27,44,23,27,11,17,1,1,8,34,44,4,4,27,45,15,27,7,18,1,5,8,22,45
2003-04-07 00:00:00.000,Estoril Portugal ATP World Tour,CLAY,2,Agustin Calleri,Jarkko Nieminen,Agustin Calleri,6-3; 6-4,R16,70,8,5,46,74,36,46,13,28,6,7,10,49,74,0,1,41,54,25,41,5,13,4,7,9,30,54
2003-04-07 00:00:00.000,Estoril Portugal ATP World Tour,CLAY,2,Yevgeny Kafelnikov,Adrian Voinea,Yevgeny Kafelnikov,6-3; 6-0,R16,52,1,0,21,35,17,21,11,14,0,0,7,28,35,1,6,23,51,15,23,9,28,1,6,8,24,51
2003-04-07 00:00:00.000,Estoril Portugal ATP World Tour,CLAY,2,Nikolay Davydenko,Alexander Waske,Nikolay Davydenko,6-3; 7-6(3),R16,90,3,2,53,76,31,53,15,23,6,8,11,46,76,1,2,43,70,25,43,15,27,9,12,10,40,70
2003-04-07 00:00:00.000,Estoril Portugal ATP World Tour,CLAY,2,Max Mirnyi,Victor Hanescu,Max Mirnyi,3-6; 6-3; 6-4,R16,112,11,5,57,96,44,57,20,39,4,5,14,64,96,2,3,70,93,50,70,11,23,9,11,14,61,93
2003-04-07 00:00:00.000,Estoril Portugal ATP World Tour,CLAY,2,Feliciano Lopez,Bernardo Mota,Feliciano Lopez,6-3; 6-4,R16,63,8,3,30,54,24,30,15,24,2,3,10,39,54,4,1,36,56,23,36,9,20,0,3,9,32,56
2003-04-07 00:00:00.000,Estoril Portugal ATP World Tour,CLAY,2,Tommy Robredo,Galo Blanco,Tommy Robredo,6-2; 6-3,Q,65,2,2,29,44,21,29,10,15,0,1,8,31,44,1,7,42,64,25,42,7,22,4,9,9,32,64
2003-04-07 00:00:00.000,Estoril Portugal ATP World Tour,CLAY,2,Agustin Calleri,Fernando Gonzalez,Agustin Calleri,7-5; 6-1,Q,77,5,6,29,57,24,29,15,28,3,4,9,39,57,4,7,39,65,26,39,7,26,3,8,10,33,65
2003-04-07 00:00:00.000,Estoril Portugal ATP World Tour,CLAY,2,Nikolay Davydenko,Yevgeny Kafelnikov,Nikolay Davydenko,6-2; 6-4,Q,66,4,3,35,57,22,35,13,22,5,7,9,35,57,1,3,26,45,16,26,6,19,4,9,9,22,45
2003-04-07 00:00:00.000,Estoril Portugal ATP World Tour,CLAY,2,Max Mirnyi,Feliciano Lopez,Max Mirnyi,7-6(0); 6-4,Q,99,9,4,42,79,31,42,21,37,6,7,11,52,79,5,6,68,99,43,68,13,31,10,12,11,56,99
2003-04-07 00:00:00.000,Estoril Portugal ATP World Tour,CLAY,2,Agustin Calleri,Tommy Robredo,Agustin Calleri,6-4; 6-2,S,76,3,4,32,58,28,32,10,26,5,6,9,38,58,0,5,49,67,30,49,4,18,3,7,9,34,67
2003-04-07 00:00:00.000,Estoril Portugal ATP World Tour,CLAY,2,Nikolay Davydenko,Max Mirnyi,Nikolay Davydenko,6-4; 3-6; 6-3,S,109,1,2,65,86,45,65,10,21,7,10,14,55,86,6,8,60,101,41,60,18,41,8,12,14,59,101
2003-04-07 00:00:00.000,Estoril Portugal ATP World Tour,CLAY,2,Nikolay Davydenko,Agustin Calleri,Nikolay Davydenko,6-4; 6-3,F,76,1,3,41,63,28,41,12,22,0,1,10,40,63,1,2,23,52,17,23,15,29,2,5,9,32,52
2003-04-14 00:00:00.000,ATP Masters Series Monte Carlo Monaco ATP World Tour,CLAY,2,Juan Carlos Ferrero,Wayne Arthurs,Juan Carlos Ferrero,6-4; 6-1,R64,62,4,2,28,49,18,28,17,21,2,2,8,35,49,9,4,25,54,16,25,14,29,3,7,9,30,54
2003-04-14 00:00:00.000,ATP Masters Series Monte Carlo Monaco ATP World Tour,CLAY,2,Felix Mantilla,Sargis Sargsian,Felix Mantilla,6-0; 7-5,R64,72,1,3,25,49,20,25,15,24,0,1,9,35,49,1,1,36,65,19,36,12,29,4,9,9,31,65
2003-04-14 00:00:00.000,ATP Masters Series Monte Carlo Monaco ATP World Tour,CLAY,2,Luis Horna,Paul-Henri Mathieu,Luis Horna,6-4; 6-4,R64,87,4,1,43,65,28,43,11,22,4,6,10,39,65,6,0,30,60,22,30,13,30,5,9,10,35,60
2003-04-14 00:00:00.000,ATP Masters Series Monte Carlo Monaco ATP World Tour,CLAY,2,Gaston Gaudio,David Ferrer,Gaston Gaudio,7-5; 6-2,R64,74,4,1,31,54,21,31,16,23,2,3,10,37,54,2,2,38,61,25,38,8,23,2,6,10,33,61
2003-04-14 00:00:00.000,ATP Masters Series Monte Carlo Monaco ATP World Tour,CLAY,2,Feliciano Lopez,Alex Corretja,Feliciano Lopez,7-6(4); 6-3,R64,92,12,5,40,81,32,40,22,41,12,13,11,54,81,2,3,37,64,29,37,12,27,1,3,10,41,64
2003-04-14 00:00:00.000,ATP Masters Series Monte Carlo Monaco ATP World Tour,CLAY,2,Fernando Vicente,Nicolas Escude,Fernando Vicente,6-4; 6-3,R64,82,3,0,24,52,17,24,16,28,3,5,9,33,52,7,4,38,71,24,38,12,33,4,9,10,36,71
2003-04-14 00:00:00.000,ATP Masters Series Monte Carlo Monaco ATP World Tour,CLAY,2,Alberto Martin,Olivier Rochus,Alberto Martin,6-3; 3-6; 6-2,R64,113,3,1,49,84,33,49,18,35,2,5,13,51,84,0,5,51,85,26,51,19,34,7,12,13,45,85
2003-04-14 00:00:00.000,ATP Masters Series Monte Carlo Monaco ATP World Tour,CLAY,2,Rainer Schuettler,Fabrice Santoro,Rainer Schuettler,6-1; 6-2,R64,64,1,1,29,47,23,29,10,18,4,5,8,33,47,0,2,22,48,10,22,10,26,2,7,7,20,48
2003-04-14 00:00:00.000,ATP Masters Series Monte Carlo Monaco ATP World Tour,CLAY,2,Albert Portas,Andy Roddick,Albert Portas,7-6(5); 6-3,R64,79,4,3,44,71,36,44,16,27,1,1,11,52,71,3,1,44,64,30,44,13,20,1,2,10,43,64
2003-04-14 00:00:00.000,ATP Masters Series Monte Carlo Monaco ATP World Tour,CLAY,2,Ivan Ljubicic,Mariano Zabaleta,Ivan Ljubicic,6-3; 7-6(8),R64,100,8,4,45,77,37,45,16,32,0,0,11,53,77,2,4,27,66,24,27,23,39,3,4,10,47,66
2003-04-14 00:00:00.000,ATP Masters Series Monte Carlo Monaco ATP World Tour,CLAY,2,Vincent Spadea,Mikhail Youzhny,Vincent Spadea,6-1; 6-2,R64,66,1,4,19,48,12,19,16,29,2,4,8,28,48,1,2,31,56,13,31,8,25,5,11,7,21,56
2003-04-14 00:00:00.000,ATP Masters Series Monte Carlo Monaco ATP World Tour,CLAY,2,Arnaud Clement,Fernando Gonzalez,Arnaud Clement,6-4; 6-3,R64,83,2,3,42,63,29,42,9,21,4,7,10,38,63,4,6,34,59,22,34,8,25,6,11,9,30,59
2003-04-14 00:00:00.000,ATP Masters Series Monte Carlo Monaco ATP World Tour,CLAY,2,Gustavo Kuerten,Mardy Fish,Gustavo Kuerten,3-6; 6-1; 6-0,R64,93,5,3,31,66,23,31,21,35,3,4,11,44,66,6,6,36,80,24,36,20,44,12,17,11,44,80
2003-04-14 00:00:00.000,ATP Masters Series Monte Carlo Monaco ATP World Tour,CLAY,2,Magnus Norman,Nicolas Lapentti,Magnus Norman,6-3; 6-3,R64,65,3,5,28,53,21,28,13,25,2,3,9,34,53,2,2,29,48,20,29,7,19,1,5,9,27,48
2003-04-14 00:00:00.000,ATP Masters Series Monte Carlo Monaco ATP World Tour,CLAY,2,Filippo Volandri,Radek Stepanek,Filippo Volandri,6-4; 6-3,R64,70,1,3,36,57,23,36,14,21,0,2,10,37,57,3,3,32,59,20,32,11,27,4,8,9,31,59
2003-04-14 00:00:00.000,ATP Masters Series Monte Carlo Monaco ATP World Tour,CLAY,2,David Nalbandian,Richard Gasquet,David Nalbandian,6-4; 6-0,R64,65,0,1,33,56,20,33,15,23,4,5,8,35,56,1,2,26,44,16,26,2,18,4,9,8,18,44
2003-04-14 00:00:00.000,ATP Masters Series Monte Carlo Monaco ATP World Tour,CLAY,2,Jiri Novak,Stefan Koubek,Jiri Novak,6-4; 6-4,R64,71,0,1,41,67,26,41,13,26,7,11,10,39,67,0,0,37,65,13,37,17,28,5,11,10,30,65
2003-04-14 00:00:00.000,ATP Masters Series Monte Carlo Monaco ATP World Tour,CLAY,2,Juan Ignacio Chela,Agustin Calleri,Juan Ignacio Chela,6-4; 6-1,R64,70,2,2,37,59,28,37,11,22,2,3,9,39,59,3,5,26,51,16,26,10,25,6,10,8,26,51
2003-04-14 00:00:00.000,ATP Masters Series Monte Carlo Monaco ATP World Tour,CLAY,2,Jarkko Nieminen,Taylor Dent,Jarkko Nieminen,7-6(3); 6-2,R64,76,1,2,45,54,30,45,5,9,1,4,10,35,54,3,7,35,66,21,35,12,31,6,11,10,33,66
2003-04-14 00:00:00.000,ATP Masters Series Monte Carlo Monaco ATP World Tour,CLAY,2,Yevgeny Kafelnikov,Younes El Aynaoui,Yevgeny Kafelnikov,6-2; 6-7(4); 6-1,R64,101,0,3,47,74,38,47,19,27,1,1,13,57,74,6,5,54,90,39,54,12,36,1,6,14,51,90
2003-04-14 00:00:00.000,ATP Masters Series Monte Carlo Monaco ATP World Tour,CLAY,2,James Blake,Dominik Hrbaty,James Blake,6-3; 3-6; 6-2,R64,93,2,2,47,81,33,47,18,34,4,7,13,51,81,2,8,48,82,30,48,14,34,3,8,13,44,82
2003-04-14 00:00:00.000,ATP Masters Series Monte Carlo Monaco ATP World Tour,CLAY,2,Guillermo Coria,Jose Acasuso,Guillermo Coria,6-2; 6-2,R64,72,2,1,37,47,30,37,5,10,3,3,8,35,47,1,1,28,61,15,28,15,33,6,10,8,30,61
2003-04-14 00:00:00.000,ATP Masters Series Monte Carlo Monaco ATP World Tour,CLAY,2,Rafael Nadal,Karol Kucera,Rafael Nadal,6-1; 6-2,R64,63,0,2,31,47,25,31,10,16,3,3,8,35,47,3,8,23,43,13,23,6,20,2,6,7,19,43
2003-04-14 00:00:00.000,ATP Masters Series Monte Carlo Monaco ATP World Tour,CLAY,2,Albert Costa,Nikolay Davydenko,Albert Costa,6-2; 6-2,R64,66,3,4,29,51,20,29,11,22,5,6,8,31,51,0,1,30,42,17,30,3,12,4,9,8,20,42
2003-04-14 00:00:00.000,ATP Masters Series Monte Carlo Monaco ATP World Tour,CLAY,2,Paradorn Srichaphan,Peter Luczak,Paradorn Srichaphan,7-5; 3-6; 7-6(4),R64,141,3,6,52,104,40,52,26,52,4,8,17,66,104,2,7,64,109,40,64,28,45,6,9,16,68,109
2003-04-14 00:00:00.000,ATP Masters Series Monte Carlo Monaco ATP World Tour,CLAY,2,Julien Boutter,Max Mirnyi,Julien Boutter,7-6(6); 3-6; 6-3,R64,126,16,10,61,103,45,61,24,42,4,5,15,69,103,7,3,73,107,49,73,21,34,9,10,15,70,107
2003-04-14 00:00:00.000,ATP Masters Series Monte Carlo Monaco ATP World Tour,CLAY,2,Hyung-Taik Lee,David Sanchez,Hyung-Taik Lee,6-1; 6-3,R64,75,0,2,29,49,21,29,9,20,3,5,8,30,49,1,2,32,65,14,32,15,33,8,14,8,29,65
2003-04-14 00:00:00.000,ATP Masters Series Monte Carlo Monaco ATP World Tour,CLAY,2,Sjeng Schalken,Davide Sanguinetti,Sjeng Schalken,6-4; 3-1 RET,R64,67,1,3,21,40,15,21,13,19,1,2,7,28,40,1,5,20,56,14,20,14,36,4,7,7,28,56
2003-04-14 00:00:00.000,ATP Masters Series Monte Carlo Monaco ATP World Tour,CLAY,2,Tommy Robredo,Martin Verkerk,Tommy Robredo,3-6; 6-3; 6-4,R64,115,1,1,58,79,39,58,12,21,1,4,14,51,79,9,8,54,92,39,54,16,38,11,15,14,55,92
2003-04-14 00:00:00.000,ATP Masters Series Monte Carlo Monaco ATP World Tour,CLAY,2,Julien Benneteau,Raemon Sluiter,Julien Benneteau,3-6; 6-1; 7-6(1),R64,122,2,3,53,84,35,53,22,31,3,5,14,57,84,6,3,65,108,46,65,18,43,4,7,14,64,108
2003-04-14 00:00:00.000,ATP Masters Series Monte Carlo Monaco ATP World Tour,CLAY,2,Wayne Ferreira,Jonas Bjorkman,Wayne Ferreira,6-4; 2-6; 7-5,R64,132,4,6,59,107,41,59,25,48,4,6,15,66,107,2,3,54,98,38,54,24,44,9,11,15,62,98
2003-04-14 00:00:00.000,ATP Masters Series Monte Carlo Monaco ATP World Tour,CLAY,2,Carlos Moya,Xavier Malisse,Carlos Moya,6-3; 6-3,R64,73,2,3,30,60,20,30,15,30,8,11,9,35,60,1,2,26,53,14,26,10,27,7,13,9,24,53
2003-04-14 00:00:00.000,ATP Masters Series Monte Carlo Monaco ATP World Tour,CLAY,2,Juan Carlos Ferrero,Felix Mantilla,Juan Carlos Ferrero,3-6; 6-2; 7-5,R32,134,7,4,59,97,44,59,15,38,6,9,14,59,97,1,1,51,93,32,51,22,42,3,8,15,54,93
2003-04-14 00:00:00.000,ATP Masters Series Monte Carlo Monaco ATP World Tour,CLAY,2,Gaston Gaudio,Luis Horna,Gaston Gaudio,6-4; 6-1,R32,71,3,2,24,43,20,24,11,19,0,1,8,31,43,2,5,32,57,19,32,8,25,1,6,9,27,57
2003-04-14 00:00:00.000,ATP Masters Series Monte Carlo Monaco ATP World Tour,CLAY,2,Fernando Vicente,Feliciano Lopez,Fernando Vicente,7-6(6); 6-1,R32,74,4,3,36,66,29,36,19,30,1,2,10,48,66,4,5,34,61,25,34,14,27,6,9,9,39,61
2003-04-14 00:00:00.000,ATP Masters Series Monte Carlo Monaco ATP World Tour,CLAY,2,Alberto Martin,Rainer Schuettler,Alberto Martin,6-2; 6-4,R32,81,1,4,44,71,28,44,13,27,5,7,9,41,71,2,4,45,60,25,45,3,15,4,9,9,28,60
2003-04-14 00:00:00.000,ATP Masters Series Monte Carlo Monaco ATP World Tour,CLAY,2,Ivan Ljubicic,Albert Portas,Ivan Ljubicic,6-4; 6-3,R32,91,2,1,38,72,28,38,19,34,7,7,9,47,72,1,9,40,71,27,40,10,31,7,10,10,37,71
2003-04-14 00:00:00.000,ATP Masters Series Monte Carlo Monaco ATP World Tour,CLAY,2,Vincent Spadea,Arnaud Clement,Vincent Spadea,6-7(4); 6-1; 6-2,R32,136,3,3,48,84,31,48,24,36,7,9,13,55,84,7,0,45,85,27,45,20,40,1,8,14,47,85
2003-04-14 00:00:00.000,ATP Masters Series Monte Carlo Monaco ATP World Tour,CLAY,2,Magnus Norman,Gustavo Kuerten,Magnus Norman,1-6; 7-5; 6-2,R32,119,3,6,57,95,40,57,16,38,9,13,14,56,95,3,3,45,84,27,45,22,39,3,7,13,49,84
2003-04-14 00:00:00.000,ATP Masters Series Monte Carlo Monaco ATP World Tour,CLAY,2,Filippo Volandri,David Nalbandian,Filippo Volandri,6-2; 7-6(6),R32,91,0,4,44,74,28,44,15,30,5,8,10,43,74,1,1,35,67,16,35,16,32,0,5,10,32,67
2003-04-14 00:00:00.000,ATP Masters Series Monte Carlo Monaco ATP World Tour,CLAY,2,Juan Ignacio Chela,Jiri Novak,Juan Ignacio Chela,6-4; 6-2,R32,64,3,4,31,54,23,31,11,23,1,3,9,34,54,1,4,26,51,16,26,9,25,4,9,9,25,51
2003-04-14 00:00:00.000,ATP Masters Series Monte Carlo Monaco ATP World Tour,CLAY,2,Jarkko Nieminen,Yevgeny Kafelnikov,Jarkko Nieminen,3-6; 6-2; 6-2,R32,119,0,2,76,97,41,76,12,21,11,15,12,53,97,4,4,50,83,29,50,14,33,4,11,13,43,83
2003-04-14 00:00:00.000,ATP Masters Series Monte Carlo Monaco ATP World Tour,CLAY,2,Guillermo Coria,James Blake,Guillermo Coria,6-0; 6-7(3); 6-3,R32,118,0,3,72,95,49,72,8,23,2,5,14,57,95,1,1,43,93,21,43,23,50,1,8,13,44,93
2003-04-14 00:00:00.000,ATP Masters Series Monte Carlo Monaco ATP World Tour,CLAY,2,Rafael Nadal,Albert Costa,Rafael Nadal,7-5; 6-3,R32,120,1,1,70,96,40,70,14,26,14,17,11,54,96,1,3,34,67,19,34,14,33,7,12,10,33,67
2003-04-14 00:00:00.000,ATP Masters Series Monte Carlo Monaco ATP World Tour,CLAY,2,Julien Boutter,Paradorn Srichaphan,Julien Boutter,6-4; 4-6; 6-4,R32,119,7,1,51,85,42,51,18,34,3,5,15,60,85,5,5,52,98,36,52,24,46,4,7,15,60,98
2003-04-14 00:00:00.000,ATP Masters Series Monte Carlo Monaco ATP World Tour,CLAY,2,Sjeng Schalken,Hyung-Taik Lee,Sjeng Schalken,7-5; 6-2,R32,90,2,3,34,65,25,34,17,31,4,6,10,42,65,1,4,37,69,21,37,13,32,2,7,10,34,69
2003-04-14 00:00:00.000,ATP Masters Series Monte Carlo Monaco ATP World Tour,CLAY,2,Tommy Robredo,Julien Benneteau,Tommy Robredo,6-2; 6-2,R32,68,2,2,30,50,23,30,10,20,2,3,8,33,50,0,1,36,64,17,36,12,28,10,15,8,29,64
2003-04-14 00:00:00.000,ATP Masters Series Monte Carlo Monaco ATP World Tour,CLAY,2,Carlos Moya,Wayne Ferreira,Carlos Moya,6-4; 6-4,R32,82,1,4,36,73,23,36,20,37,8,11,10,43,73,6,5,41,71,24,41,13,30,6,11,10,37,71
2003-04-14 00:00:00.000,ATP Masters Series Monte Carlo Monaco ATP World Tour,CLAY,2,Juan Carlos Ferrero,Gaston Gaudio,Juan Carlos Ferrero,3-6; 7-5; 6-2,R16,159,3,4,56,91,40,56,18,35,9,12,14,58,91,4,5,71,116,47,71,19,45,14,19,15,66,116
2003-04-14 00:00:00.000,ATP Masters Series Monte Carlo Monaco ATP World Tour,CLAY,2,Alberto Martin,Fernando Vicente,Alberto Martin,6-4; 7-6(5),R16,107,0,1,56,83,31,56,14,27,10,14,11,45,83,2,6,45,76,24,45,14,31,7,12,11,38,76
2003-04-14 00:00:00.000,ATP Masters Series Monte Carlo Monaco ATP World Tour,CLAY,2,Vincent Spadea,Ivan Ljubicic,Vincent Spadea,1-6; 6-4; 7-6(8),R16,131,2,1,49,90,30,49,27,41,3,8,14,57,90,11,1,48,87,37,48,19,39,3,7,15,56,87
2003-04-14 00:00:00.000,ATP Masters Series Monte Carlo Monaco ATP World Tour,CLAY,2,Filippo Volandri,Magnus Norman,Filippo Volandri,7-5; 6-3,R16,85,1,3,51,70,33,51,10,19,6,9,11,43,70,3,1,35,59,20,35,11,24,3,8,10,31,59
2003-04-14 00:00:00.000,ATP Masters Series Monte Carlo Monaco ATP World Tour,CLAY,2,Juan Ignacio Chela,Jarkko Nieminen,Juan Ignacio Chela,6-1; 6-1,R16,59,4,6,18,42,14,18,16,24,2,2,7,30,42,0,1,29,39,11,29,4,10,3,8,7,15,39
2003-04-14 00:00:00.000,ATP Masters Series Monte Carlo Monaco ATP World Tour,CLAY,2,Guillermo Coria,Rafael Nadal,Guillermo Coria,7-6(3); 6-2,R16,94,0,0,37,66,23,37,15,29,5,8,10,38,66,0,2,34,56,17,34,10,22,3,8,10,27,56
2003-04-14 00:00:00.000,ATP Masters Series Monte Carlo Monaco ATP World Tour,CLAY,2,Julien Boutter,Sjeng Schalken,Julien Boutter,7-6(3); 6-4,R16,105,7,3,46,82,35,46,21,36,7,8,11,56,82,3,4,55,78,38,55,11,23,6,8,11,49,78
2003-04-14 00:00:00.000,ATP Masters Series Monte Carlo Monaco ATP World Tour,CLAY,2,Carlos Moya,Tommy Robredo,Carlos Moya,6-2; 6-4,R16,75,2,2,28,59,22,28,20,31,6,6,9,42,59,0,1,49,66,29,49,9,17,4,7,9,38,66
2003-04-14 00:00:00.000,ATP Masters Series Monte Carlo Monaco ATP World Tour,CLAY,2,Juan Carlos Ferrero,Alberto Martin,Juan Carlos Ferrero,6-0; 6-2,Q,64,0,0,31,49,21,31,13,18,5,5,7,34,49,0,0,19,41,9,19,7,22,6,11,7,16,41
2003-04-14 00:00:00.000,ATP Masters Series Monte Carlo Monaco ATP World Tour,CLAY,2,Vincent Spadea,Filippo Volandri,Vincent Spadea,6-1; 6-3,Q,69,2,0,22,41,16,22,13,19,1,2,8,29,41,0,5,36,61,19,36,9,25,3,8,8,28,61
2003-04-14 00:00:00.000,ATP Masters Series Monte Carlo Monaco ATP World Tour,CLAY,2,Guillermo Coria,Juan Ignacio Chela,Guillermo Coria,6-1; 6-1,Q,58,0,1,26,37,18,26,7,11,0,1,7,25,37,2,4,21,47,9,21,8,26,5,11,7,17,47
2003-04-14 00:00:00.000,ATP Masters Series Monte Carlo Monaco ATP World Tour,CLAY,2,Carlos Moya,Julien Boutter,Carlos Moya,7-6(4); 6-2,Q,80,2,5,34,68,25,34,17,34,2,4,10,42,68,2,2,36,59,18,36,15,23,1,5,10,33,59
2003-04-14 00:00:00.000,ATP Masters Series Monte Carlo Monaco ATP World Tour,CLAY,2,Juan Carlos Ferrero,Vincent Spadea,Juan Carlos Ferrero,6-3; 6-4,S,78,1,2,35,58,18,35,11,23,1,5,9,29,58,0,1,30,58,12,30,12,28,1,8,10,24,58
2003-04-14 00:00:00.000,ATP Masters Series Monte Carlo Monaco ATP World Tour,CLAY,2,Guillermo Coria,Carlos Moya,Guillermo Coria,7-6(3); 6-2,S,112,1,1,56,82,42,56,14,26,7,7,10,56,82,3,3,46,89,34,46,18,43,5,7,10,52,89
2003-04-14 00:00:00.000,ATP Masters Series Monte Carlo Monaco ATP World Tour,CLAY,2,Juan Carlos Ferrero,Guillermo Coria,Juan Carlos Ferrero,6-2; 6-2,F,76,0,1,35,52,21,35,9,17,3,5,8,30,52,0,2,38,51,17,38,3,13,5,11,8,20,51
2003-04-21 00:00:00.000,Barcelona Spain ATP World Tour,CLAY,2,Juan Carlos Ferrero,N/A Bye,Juan Carlos Ferrero,,R64,0,0,0,0,0,0,0,0,0,0,0,0,0,0,0,0,0,0,0,0,0,0,0,0,0,0,0
2003-04-21 00:00:00.000,Barcelona Spain ATP World Tour,CLAY,2,Franco Squillari,Vladimir Voltchkov,Franco Squillari,6-4; 4-6; 7-5,R64,122,5,8,49,88,30,49,19,39,6,13,16,49,88,1,3,67,93,34,67,11,26,3,11,16,45,93
2003-04-21 00:00:00.000,Barcelona Spain ATP World Tour,CLAY,2,Filippo Volandri,Marc Lopez,Filippo Volandri,6-4; 6-4,R64,83,1,0,48,63,35,48,8,15,2,3,10,43,63,0,4,28,63,20,28,17,35,0,3,10,37,63
2003-04-21 00:00:00.000,Barcelona Spain ATP World Tour,CLAY,2,Galo Blanco,Max Mirnyi,Galo Blanco,6-4; 7-6(4),R64,95,1,4,48,72,34,48,14,24,2,4,11,48,72,4,4,38,69,27,38,14,31,2,5,11,41,69
2003-04-21 00:00:00.000,Barcelona Spain ATP World Tour,CLAY,2,Younes El Aynaoui,Nicolas Lapentti,Younes El Aynaoui,6-3; 2-6; 7-6(5),R64,127,9,1,65,97,45,65,15,32,2,4,14,60,97,3,1,57,83,42,57,14,26,2,4,15,56,83
2003-04-21 00:00:00.000,Barcelona Spain ATP World Tour,CLAY,2,Albert Portas,David Ferrer,Albert Portas,6-4; 6-3,R64,82,7,1,45,66,32,45,10,21,2,3,9,42,66,0,3,33,63,17,33,15,30,0,4,10,32,63
2003-04-21 00:00:00.000,Barcelona Spain ATP World Tour,CLAY,2,Felix Mantilla,Mariano Puerta,Felix Mantilla,7-6(8); 6-3,R64,102,7,2,35,62,29,35,18,27,2,2,10,47,62,5,2,49,78,35,49,13,29,3,5,11,48,78
2003-04-21 00:00:00.000,Barcelona Spain ATP World Tour,CLAY,2,Gustavo Kuerten,N/A Bye,Gustavo Kuerten,,R64,0,0,0,0,0,0,0,0,0,0,0,0,0,0,0,0,0,0,0,0,0,0,0,0,0,0,0
2003-04-21 00:00:00.000,Barcelona Spain ATP World Tour,CLAY,2,Marat Safin,N/A Bye,Marat Safin,,R64,0,0,0,0,0,0,0,0,0,0,0,0,0,0,0,0,0,0,0,0,0,0,0,0,0,0,0
2003-04-21 00:00:00.000,Barcelona Spain ATP World Tour,CLAY,2,Salvador Navarro,Karol Beck,Salvador Navarro,6-4; 6-7(2); 7-6(4),R64,160,4,3,70,118,47,70,24,48,6,11,17,71,118,2,5,58,118,40,58,28,60,10,16,17,68,118
2003-04-21 00:00:00.000,Barcelona Spain ATP World Tour,CLAY,2,Jarkko Nieminen,Olivier Rochus,Jarkko Nieminen,7-5; 7-5,R64,100,1,0,63,72,40,63,5,9,0,3,12,45,72,1,1,51,78,32,51,10,27,5,10,12,42,78
2003-04-21 00:00:00.000,Barcelona Spain ATP World Tour,CLAY,2,Xavier Malisse,Hicham Arazi,Xavier Malisse,7-5 RET,R64,40,4,0,20,34,16,20,9,14,1,1,6,25,34,0,0,27,37,18,27,5,10,4,5,6,23,37
2003-04-21 00:00:00.000,Barcelona Spain ATP World Tour,CLAY,2,Gaston Gaudio,Fernando Vicente,Gaston Gaudio,4-6; 6-2; 6-4,R64,127,2,2,54,84,34,54,13,30,5,11,14,47,84,8,1,47,90,28,47,14,43,15,23,14,42,90
2003-04-21 00:00:00.000,Barcelona Spain ATP World Tour,CLAY,2,Arnaud Clement,Antony Dupuis,Arnaud Clement,4-6; 7-6(7); 7-6(3),R64,184,8,2,56,109,43,56,32,53,5,7,17,75,109,10,2,89,137,58,89,28,48,4,5,17,86,137
2003-04-21 00:00:00.000,Barcelona Spain ATP World Tour,CLAY,2,David Sanchez,Cyril Saulnier,David Sanchez,3-6; 5-0 RET,R64,57,4,0,25,39,15,25,9,14,3,5,7,24,39,0,0,29,43,19,29,6,14,1,4,7,25,43
2003-04-21 00:00:00.000,Barcelona Spain ATP World Tour,CLAY,2,Paradorn Srichaphan,N/A Bye,Paradorn Srichaphan,,R64,0,0,0,0,0,0,0,0,0,0,0,0,0,0,0,0,0,0,0,0,0,0,0,0,0,0,0
2003-04-21 00:00:00.000,Barcelona Spain ATP World Tour,CLAY,2,Alex Corretja,N/A Bye,Alex Corretja,,R64,0,0,0,0,0,0,0,0,0,0,0,0,0,0,0,0,0,0,0,0,0,0,0,0,0,0,0
2003-04-21 00:00:00.000,Barcelona Spain ATP World Tour,CLAY,2,Rafael Nadal,Juan Antonio Marin,Rafael Nadal,6-0 RET,R64,42,0,0,10,17,7,10,5,7,0,0,3,12,17,0,0,12,19,2,12,3,7,0,3,3,5,19
2003-04-21 00:00:00.000,Barcelona Spain ATP World Tour,CLAY,2,Feliciano Lopez,Gaston Etlis,Feliciano Lopez,6-4; 6-4,R64,79,8,2,40,63,29,40,8,23,2,6,10,37,63,5,5,37,65,23,37,9,28,4,10,10,32,65
2003-04-21 00:00:00.000,Barcelona Spain ATP World Tour,CLAY,2,Tommy Robredo,Fabrice Santoro,Tommy Robredo,6-3; 6-2,R64,65,0,1,40,54,25,40,11,14,2,3,9,36,54,1,2,25,47,15,25,11,22,2,6,8,26,47
2003-04-21 00:00:00.000,Barcelona Spain ATP World Tour,CLAY,2,Agustin Calleri,Magnus Norman,Agustin Calleri,6-2; 7-5,R64,111,0,2,37,66,27,37,15,29,2,3,10,42,66,2,0,62,89,37,62,9,27,9,13,10,46,89
2003-04-21 00:00:00.000,Barcelona Spain ATP World Tour,CLAY,2,Juan Ignacio Chela,Alberto Martin,Juan Ignacio Chela,7-5; 5-7; 6-0,R64,137,3,3,63,100,44,63,19,37,8,11,15,63,100,1,5,67,99,36,67,18,32,8,14,15,54,99
2003-04-21 00:00:00.000,Barcelona Spain ATP World Tour,CLAY,2,Mariano Zabaleta,Raemon Sluiter,Mariano Zabaleta,6-2; 6-0,R64,69,2,4,32,54,24,32,11,22,2,2,7,35,54,3,0,38,55,14,38,8,17,2,7,7,22,55
2003-04-21 00:00:00.000,Barcelona Spain ATP World Tour,CLAY,2,Albert Costa,N/A Bye,Albert Costa,,R64,0,0,0,0,0,0,0,0,0,0,0,0,0,0,0,0,0,0,0,0,0,0,0,0,0,0,0
2003-04-21 00:00:00.000,Barcelona Spain ATP World Tour,CLAY,2,David Nalbandian,N/A Bye,David Nalbandian,,R64,0,0,0,0,0,0,0,0,0,0,0,0,0,0,0,0,0,0,0,0,0,0,0,0,0,0,0
2003-04-21 00:00:00.000,Barcelona Spain ATP World Tour,CLAY,2,Nikolay Davydenko,Albert Montanes,Nikolay Davydenko,6-1; 6-2,R64,56,5,1,27,46,18,27,16,19,5,6,8,34,46,2,2,20,41,11,20,6,21,3,8,7,17,41
2003-04-21 00:00:00.000,Barcelona Spain ATP World Tour,CLAY,2,Paul-Henri Mathieu,Werner Eschauer,Paul-Henri Mathieu,0-6; 6-4; 6-3,R64,120,2,2,36,76,24,36,16,40,2,7,12,40,76,3,1,46,74,27,46,14,28,3,8,13,41,74
2003-04-21 00:00:00.000,Barcelona Spain ATP World Tour,CLAY,2,Jose Acasuso,Fernando Gonzalez,Jose Acasuso,6-1; 3-6; 6-3,R64,105,3,2,49,78,30,49,22,29,6,9,13,52,78,4,4,62,87,39,62,8,25,8,13,12,47,87
2003-04-21 00:00:00.000,Barcelona Spain ATP World Tour,CLAY,2,Guillermo Coria,Fernando Verdasco,Guillermo Coria,6-2; 6-2,R64,70,0,0,36,56,26,36,9,20,4,5,8,35,56,0,2,28,42,11,28,7,14,1,6,8,18,42
2003-04-21 00:00:00.000,Barcelona Spain ATP World Tour,CLAY,2,Dominik Hrbaty,Didac Perez,Dominik Hrbaty,6-1; 6-0,R64,44,2,0,19,35,15,19,10,16,0,0,6,25,35,1,5,25,43,9,25,7,18,3,9,7,16,43
2003-04-21 00:00:00.000,Barcelona Spain ATP World Tour,CLAY,2,Adrian Voinea,Martin Verkerk,Adrian Voinea,7-6(4); 6-4,R64,82,3,3,31,65,25,31,21,34,1,3,11,46,65,10,3,34,64,24,34,20,30,1,4,11,44,64
2003-04-21 00:00:00.000,Barcelona Spain ATP World Tour,CLAY,2,Carlos Moya,N/A Bye,Carlos Moya,,R64,0,0,0,0,0,0,0,0,0,0,0,0,0,0,0,0,0,0,0,0,0,0,0,0,0,0,0
2003-04-21 00:00:00.000,Barcelona Spain ATP World Tour,CLAY,2,Juan Carlos Ferrero,Franco Squillari,Juan Carlos Ferrero,6-4; 6-3,R32,76,2,0,35,52,27,35,7,17,0,1,9,34,52,5,2,33,61,20,33,13,28,5,9,10,33,61
2003-04-21 00:00:00.000,Barcelona Spain ATP World Tour,CLAY,2,Filippo Volandri,Galo Blanco,Filippo Volandri,4-6; 6-3; 6-4,R32,144,2,0,76,109,43,76,22,33,11,14,15,65,109,3,0,65,99,43,65,14,34,11,15,14,57,99
2003-04-21 00:00:00.000,Barcelona Spain ATP World Tour,CLAY,2,Younes El Aynaoui,Albert Portas,Younes El Aynaoui,6-4; 6-4,R32,71,9,1,39,54,34,39,7,15,1,1,10,41,54,5,1,39,63,27,39,14,24,3,5,10,41,63
2003-04-21 00:00:00.000,Barcelona Spain ATP World Tour,CLAY,2,Gustavo Kuerten,Felix Mantilla,Gustavo Kuerten,7-6(1); 6-3,R32,88,7,1,45,76,31,45,17,31,2,5,11,48,76,2,3,38,66,20,38,13,28,2,6,10,33,66
2003-04-21 00:00:00.000,Barcelona Spain ATP World Tour,CLAY,2,Marat Safin,Salvador Navarro,Marat Safin,7-5; 6-2,R32,82,5,0,37,63,28,37,14,26,6,7,10,42,63,3,1,30,55,18,30,11,25,1,5,10,29,55
2003-04-21 00:00:00.000,Barcelona Spain ATP World Tour,CLAY,2,Jarkko Nieminen,Xavier Malisse,Jarkko Nieminen,6-3; 4-6; 6-0,R32,99,0,1,64,77,40,64,7,13,2,5,13,47,77,4,4,63,94,32,63,16,31,12,18,12,48,94
2003-04-21 00:00:00.000,Barcelona Spain ATP World Tour,CLAY,2,Gaston Gaudio,Arnaud Clement,Gaston Gaudio,6-4; 6-3,R32,105,3,2,35,50,27,35,4,15,2,4,9,31,50,3,4,48,86,29,48,14,38,8,13,10,43,86
2003-04-21 00:00:00.000,Barcelona Spain ATP World Tour,CLAY,2,David Sanchez,Paradorn Srichaphan,David Sanchez,6-0; 6-2,R32,54,3,0,24,35,20,24,8,11,0,0,7,28,35,0,3,34,50,17,34,6,16,2,7,7,23,50
2003-04-21 00:00:00.000,Barcelona Spain ATP World Tour,CLAY,2,Alex Corretja,Rafael Nadal,Alex Corretja,3-6; 6-2; 6-1,R32,127,3,2,51,83,30,51,17,32,9,13,12,47,83,3,1,57,78,31,57,6,21,7,14,12,37,78
2003-04-21 00:00:00.000,Barcelona Spain ATP World Tour,CLAY,2,Tommy Robredo,Feliciano Lopez,Tommy Robredo,6-4; 7-5,R32,72,4,3,42,58,36,42,7,16,1,2,11,43,58,3,3,38,60,28,38,10,22,2,5,11,38,60
2003-04-21 00:00:00.000,Barcelona Spain ATP World Tour,CLAY,2,Agustin Calleri,Juan Ignacio Chela,Agustin Calleri,7-6(5); 6-2,R32,87,4,1,35,59,29,35,11,24,1,3,10,40,59,1,4,40,75,24,40,17,35,6,10,10,41,75
2003-04-21 00:00:00.000,Barcelona Spain ATP World Tour,CLAY,2,Albert Costa,Mariano Zabaleta,Albert Costa,6-3; 7-5,R32,117,1,0,51,75,32,51,12,24,8,11,11,44,75,2,2,41,71,22,41,13,30,5,10,10,35,71
2003-04-21 00:00:00.000,Barcelona Spain ATP World Tour,CLAY,2,Nikolay Davydenko,David Nalbandian,Nikolay Davydenko,6-3; 7-6(4),R32,101,5,5,59,84,34,59,13,25,7,11,11,47,84,0,3,40,69,23,40,10,29,4,9,10,33,69
2003-04-21 00:00:00.000,Barcelona Spain ATP World Tour,CLAY,2,Jose Acasuso,Paul-Henri Mathieu,Jose Acasuso,6-2; 6-2,R32,62,3,0,23,42,18,23,14,19,0,0,8,32,42,0,0,26,41,19,26,3,15,2,6,8,22,41
2003-04-21 00:00:00.000,Barcelona Spain ATP World Tour,CLAY,2,Dominik Hrbaty,Guillermo Coria,Dominik Hrbaty,4-3 RET,R32,36,0,2,15,24,11,15,5,9,3,3,3,16,24,0,1,18,28,11,18,6,10,2,3,4,17,28
2003-04-21 00:00:00.000,Barcelona Spain ATP World Tour,CLAY,2,Carlos Moya,Adrian Voinea,Carlos Moya,7-6(3); 6-3,R32,0,5,1,36,60,30,36,17,24,1,2,11,47,60,0,2,43,69,26,43,14,26,5,7,10,40,69
2003-04-21 00:00:00.000,Barcelona Spain ATP World Tour,CLAY,2,Juan Carlos Ferrero,Filippo Volandri,Juan Carlos Ferrero,6-4; 6-4,R16,80,4,2,35,53,27,35,11,18,1,2,10,38,53,2,1,47,68,26,47,13,21,4,7,10,39,68
2003-04-21 00:00:00.000,Barcelona Spain ATP World Tour,CLAY,2,Gustavo Kuerten,Younes El Aynaoui,Gustavo Kuerten,W/O,R16,0,0,0,0,0,0,0,0,0,0,0,0,0,0,0,0,0,0,0,0,0,0,0,0,0,0,0
2003-04-21 00:00:00.000,Barcelona Spain ATP World Tour,CLAY,2,Marat Safin,Jarkko Nieminen,Marat Safin,6-3; 6-3,R16,84,3,2,38,66,25,38,16,28,9,11,9,41,66,0,0,49,61,24,49,5,12,4,9,9,29,61
2003-04-21 00:00:00.000,Barcelona Spain ATP World Tour,CLAY,2,Gaston Gaudio,David Sanchez,Gaston Gaudio,7-5; 4-6; 6-1,R16,136,0,3,43,74,30,43,18,31,2,5,14,48,74,2,3,59,112,40,59,21,53,11,17,15,61,112
2003-04-21 00:00:00.000,Barcelona Spain ATP World Tour,CLAY,2,Tommy Robredo,Alex Corretja,Tommy Robredo,7-6(4); 6-7(1); 6-2,R16,164,0,2,83,105,55,83,13,22,6,8,16,68,105,4,3,63,110,45,63,26,47,9,13,16,71,110
2003-04-21 00:00:00.000,Barcelona Spain ATP World Tour,CLAY,2,Agustin Calleri,Albert Costa,Agustin Calleri,6-4; 6-2,R16,85,8,2,32,57,27,32,14,25,2,2,9,41,57,1,2,47,62,30,47,6,15,3,6,9,36,62
2003-04-21 00:00:00.000,Barcelona Spain ATP World Tour,CLAY,2,Nikolay Davydenko,Jose Acasuso,Nikolay Davydenko,6-4; 6-3,R16,82,3,1,39,51,32,39,6,12,2,3,10,38,51,3,2,36,68,22,36,16,32,10,13,9,38,68
2003-04-21 00:00:00.000,Barcelona Spain ATP World Tour,CLAY,2,Carlos Moya,Dominik Hrbaty,Carlos Moya,6-1; 6-7(5); 6-3,R16,120,2,4,55,98,42,55,22,43,2,3,15,64,98,1,3,56,96,36,56,21,40,7,11,13,57,96
2003-04-21 00:00:00.000,Barcelona Spain ATP World Tour,CLAY,2,Juan Carlos Ferrero,Gustavo Kuerten,Juan Carlos Ferrero,6-4; 6-4,Q,84,4,2,46,71,35,46,10,25,5,6,10,45,71,6,1,30,59,22,30,14,29,1,4,10,36,59
2003-04-21 00:00:00.000,Barcelona Spain ATP World Tour,CLAY,2,Marat Safin,Gaston Gaudio,Marat Safin,6-4; 4-6; 7-5,Q,163,7,2,74,123,51,74,18,49,7,13,16,69,123,0,0,67,98,45,67,9,31,5,12,16,54,98
2003-04-21 00:00:00.000,Barcelona Spain ATP World Tour,CLAY,2,Agustin Calleri,Tommy Robredo,Agustin Calleri,6-7(1); 6-4; 6-4,Q,147,5,8,52,109,40,52,28,57,6,8,16,68,109,0,0,91,105,56,91,8,14,6,10,16,64,105
2003-04-21 00:00:00.000,Barcelona Spain ATP World Tour,CLAY,2,Carlos Moya,Nikolay Davydenko,Carlos Moya,6-3; 6-4,Q,81,4,0,55,77,36,55,12,22,7,8,10,48,77,2,1,31,51,21,31,9,20,1,4,9,30,51
2003-04-21 00:00:00.000,Barcelona Spain ATP World Tour,CLAY,2,Marat Safin,Juan Carlos Ferrero,Marat Safin,6-4; 6-3,S,67,12,1,38,54,29,38,10,16,0,1,10,39,54,4,4,36,54,25,36,5,18,1,4,9,30,54
2003-04-21 00:00:00.000,Barcelona Spain ATP World Tour,CLAY,2,Carlos Moya,Agustin Calleri,Carlos Moya,7-6(2); 6-2,S,84,4,1,37,63,29,37,15,26,3,4,10,44,63,8,3,31,65,23,31,15,34,3,6,10,38,65
2003-04-21 00:00:00.000,Barcelona Spain ATP World Tour,CLAY,2,Carlos Moya,Marat Safin,Carlos Moya,5-7; 6-2; 6-2; 3-0 RET,F,128,8,2,50,87,39,50,24,37,2,3,15,63,87,2,3,69,107,44,69,16,38,13,19,16,60,107
2003-04-21 00:00:00.000,Houston TX; U.S.A. ATP World Tour,CLAY,2,Andre Agassi,Zeljko Krajan,Andre Agassi,6-2; 6-0,R32,47,3,2,22,37,18,22,11,15,1,1,7,29,37,1,4,28,41,15,28,3,13,2,7,7,18,41
2003-04-21 00:00:00.000,Houston TX; U.S.A. ATP World Tour,CLAY,2,Irakli Labadze,Brian Vahaly,Irakli Labadze,6-3; 6-7(2); 6-3,R32,137,5,5,54,99,39,54,26,45,1,3,16,65,99,1,3,69,100,42,69,18,31,5,9,14,60,100
2003-04-21 00:00:00.000,Houston TX; U.S.A. ATP World Tour,CLAY,2,Ricardo Mello,Andre Sa,Ricardo Mello,7-6(2); 6-0,R32,83,2,2,39,60,23,39,13,21,2,5,9,36,60,0,3,37,63,19,37,8,26,3,9,9,27,63
2003-04-21 00:00:00.000,Houston TX; U.S.A. ATP World Tour,CLAY,2,Todd Martin,Hyung-Taik Lee,Todd Martin,6-3; 6-4,R32,90,13,1,56,90,39,56,19,34,8,8,10,58,90,1,2,31,45,24,31,6,14,0,2,9,30,45
2003-04-21 00:00:00.000,Houston TX; U.S.A. ATP World Tour,CLAY,2,Jurgen Melzer,Taylor Dent,Jurgen Melzer,4-6; 7-6(4); 6-3,R32,116,3,3,74,104,49,74,16,30,7,10,15,65,104,6,8,69,109,49,69,16,40,7,11,16,65,109
2003-04-21 00:00:00.000,Houston TX; U.S.A. ATP World Tour,CLAY,2,Kenneth Carlsen,Thomas Blake,Kenneth Carlsen,7-6(5); 6-1,R32,98,3,2,32,73,30,32,20,41,4,5,10,50,73,9,1,44,72,30,44,12,28,4,7,9,42,72
2003-04-21 00:00:00.000,Houston TX; U.S.A. ATP World Tour,CLAY,2,Mardy Fish,Sergio Roitman,Mardy Fish,6-3; 6-3,R32,63,5,3,20,44,18,20,18,24,0,0,9,36,44,1,1,27,51,16,27,15,24,0,3,9,31,51
2003-04-21 00:00:00.000,Houston TX; U.S.A. ATP World Tour,CLAY,2,Luis Horna,Jan-Michael Gambill,Luis Horna,6-2; 6-4,R32,74,2,6,38,56,30,38,8,18,0,1,9,38,56,7,4,31,62,18,31,15,31,4,8,9,33,62
2003-04-21 00:00:00.000,Houston TX; U.S.A. ATP World Tour,CLAY,2,Flavio Saretta,Cecil Mamiit,Flavio Saretta,6-3; 6-1,R32,71,1,2,35,50,25,35,7,15,2,3,8,32,50,0,4,35,53,16,35,7,18,2,7,8,23,53
2003-04-21 00:00:00.000,Houston TX; U.S.A. ATP World Tour,CLAY,2,Olivier Mutis,Hugo Armando,Olivier Mutis,6-7(1); 6-4; 6-1,R32,122,6,3,55,103,40,55,25,48,4,5,15,65,103,2,3,59,95,43,59,15,36,6,10,14,58,95
2003-04-21 00:00:00.000,Houston TX; U.S.A. ATP World Tour,CLAY,2,Attila Savolt,Nicolas Kiefer,Attila Savolt,6-3; 6-2,R32,74,7,1,20,44,19,20,15,24,0,1,9,34,44,1,8,22,52,12,22,15,30,4,8,8,27,52
2003-04-21 00:00:00.000,Houston TX; U.S.A. ATP World Tour,CLAY,2,James Blake,Alexander Waske,James Blake,6-4; 6-4,R32,79,5,4,38,60,28,38,11,22,1,2,10,39,60,4,4,45,64,29,45,9,19,1,4,10,38,64
2003-04-21 00:00:00.000,Houston TX; U.S.A. ATP World Tour,CLAY,2,Vincent Spadea,Jack Brasington,Vincent Spadea,6-3; 6-3,R32,67,1,2,27,49,21,27,15,22,0,0,9,36,49,2,2,39,61,27,39,8,22,1,4,9,35,61
2003-04-21 00:00:00.000,Houston TX; U.S.A. ATP World Tour,CLAY,2,Fernando Meligeni,Justin Gimelstob,Fernando Meligeni,6-2; 6-4,R32,88,8,1,36,53,30,36,8,17,1,1,9,38,53,5,3,35,75,25,35,16,40,5,8,9,41,75
2003-04-21 00:00:00.000,Houston TX; U.S.A. ATP World Tour,CLAY,2,Paul Goldstein,Thomas Enqvist,Paul Goldstein,6-1; 7-6(7),R32,84,1,2,42,60,26,42,6,18,5,9,9,32,60,3,2,40,67,19,40,9,27,6,13,10,28,67
2003-04-21 00:00:00.000,Houston TX; U.S.A. ATP World Tour,CLAY,2,Andy Roddick,Jeff Morrison,Andy Roddick,6-3; 6-1,R32,51,6,2,27,41,25,27,7,14,0,0,8,32,41,4,2,22,50,15,22,9,28,4,8,8,24,50
2003-04-21 00:00:00.000,Houston TX; U.S.A. ATP World Tour,CLAY,2,Andre Agassi,Irakli Labadze,Andre Agassi,6-0; 6-2,R16,51,1,4,25,41,20,25,9,16,2,2,7,29,41,1,7,19,44,11,19,8,25,3,8,7,19,44
2003-04-21 00:00:00.000,Houston TX; U.S.A. ATP World Tour,CLAY,2,Ricardo Mello,Todd Martin,Ricardo Mello,7-6(6); 6-1,R16,87,1,3,45,76,27,45,21,31,4,5,10,48,76,4,3,36,64,23,36,13,28,2,5,9,36,64
2003-04-21 00:00:00.000,Houston TX; U.S.A. ATP World Tour,CLAY,2,Jurgen Melzer,Kenneth Carlsen,Jurgen Melzer,5-7; 6-3; 6-4,R16,134,4,6,56,103,37,56,21,47,7,12,16,58,103,5,5,46,88,28,46,23,42,4,10,15,51,88
2003-04-21 00:00:00.000,Houston TX; U.S.A. ATP World Tour,CLAY,2,Mardy Fish,Luis Horna,Mardy Fish,6-2; 6-4,R16,79,11,2,31,55,24,31,16,24,8,9,9,40,55,0,4,50,73,32,50,6,23,3,7,9,38,73
2003-04-21 00:00:00.000,Houston TX; U.S.A. ATP World Tour,CLAY,2,Olivier Mutis,Flavio Saretta,Olivier Mutis,6-2; 6-0,R16,55,7,1,24,46,20,24,12,22,2,2,7,32,46,1,1,15,36,8,15,6,21,2,7,7,14,36
2003-04-21 00:00:00.000,Houston TX; U.S.A. ATP World Tour,CLAY,2,James Blake,Attila Savolt,James Blake,6-2; 7-6(2),R16,80,3,2,47,65,35,47,10,18,3,4,10,45,65,5,1,34,57,24,34,11,23,3,6,10,35,57
2003-04-21 00:00:00.000,Houston TX; U.S.A. ATP World Tour,CLAY,2,Fernando Meligeni,Vincent Spadea,Fernando Meligeni,4-6; 7-6(6); 6-3,R16,137,5,5,65,103,49,65,13,38,9,14,16,62,103,2,5,54,101,34,54,24,47,4,9,15,58,101
2003-04-21 00:00:00.000,Houston TX; U.S.A. ATP World Tour,CLAY,2,Andy Roddick,Paul Goldstein,Andy Roddick,7-5; 6-4,R16,83,8,2,42,66,32,42,11,24,5,7,11,43,66,2,1,55,78,32,55,12,23,7,11,11,44,78
2003-04-21 00:00:00.000,Houston TX; U.S.A. ATP World Tour,CLAY,2,Andre Agassi,Ricardo Mello,Andre Agassi,6-0; 6-1,Q,43,5,0,19,31,17,19,9,12,2,2,6,26,31,0,5,27,44,10,27,5,17,2,8,7,15,44
2003-04-21 00:00:00.000,Houston TX; U.S.A. ATP World Tour,CLAY,2,Jurgen Melzer,Mardy Fish,Jurgen Melzer,7-5; 2-6; 7-5,Q,140,1,2,54,94,34,54,21,40,1,6,16,55,94,15,5,53,119,39,53,28,66,15,20,16,67,119
2003-04-21 00:00:00.000,Houston TX; U.S.A. ATP World Tour,CLAY,2,Olivier Mutis,James Blake,Olivier Mutis,6-4; 6-7(3); 6-1,Q,130,8,5,59,111,36,59,26,52,6,11,15,62,111,4,4,61,99,30,61,18,38,7,15,14,48,99
2003-04-21 00:00:00.000,Houston TX; U.S.A. ATP World Tour,CLAY,2,Andy Roddick,Fernando Meligeni,Andy Roddick,6-3; 4-6; 6-4,Q,124,5,4,56,89,42,56,18,33,5,7,15,60,89,1,2,68,105,44,68,19,37,8,11,14,63,105
2003-04-21 00:00:00.000,Houston TX; U.S.A. ATP World Tour,CLAY,2,Andre Agassi,Jurgen Melzer,Andre Agassi,6-4; 6-1,S,65,2,2,27,43,22,27,9,16,2,3,8,31,43,3,6,41,69,21,41,12,28,7,12,9,33,69
2003-04-21 00:00:00.000,Houston TX; U.S.A. ATP World Tour,CLAY,2,Andy Roddick,Olivier Mutis,Andy Roddick,4-6; 6-1; 6-2,S,110,12,3,51,85,36,51,20,34,4,5,13,56,85,6,3,45,84,33,45,12,39,6,10,12,45,84
2003-04-21 00:00:00.000,Houston TX; U.S.A. ATP World Tour,CLAY,2,Andre Agassi,Andy Roddick,Andre Agassi,3-6; 6-3; 6-4,F,95,5,0,58,77,40,58,12,19,3,5,14,52,77,11,2,47,84,32,47,20,37,0,3,14,52,84
2003-04-28 00:00:00.000,Munich Germany ATP World Tour,CLAY,2,Roger Federer,Zeljko Krajan,Roger Federer,6-4; 6-3,R32,65,6,6,36,63,25,36,14,27,3,5,10,39,63,0,4,35,49,22,35,4,14,1,5,9,26,49
2003-04-28 00:00:00.000,Munich Germany ATP World Tour,CLAY,2,Raemon Sluiter,Renzo Furlan,Raemon Sluiter,7-5; 6-4,R32,84,10,1,39,62,32,39,15,23,2,2,11,47,62,4,1,51,71,35,51,11,20,8,10,11,46,71
2003-04-28 00:00:00.000,Munich Germany ATP World Tour,CLAY,2,Harel Levy,Kenneth Carlsen,Harel Levy,6-3; 6-1,R32,76,0,0,39,57,28,39,8,18,3,4,8,36,57,2,1,20,51,13,20,10,31,3,8,8,23,51
2003-04-28 00:00:00.000,Munich Germany ATP World Tour,CLAY,2,Mikhail Youzhny,Jan Frode Andersen,Mikhail Youzhny,4-6; 7-5; 6-3,R32,11,1,1,71,94,53,71,12,23,1,2,15,65,94,1,3,76,118,52,76,20,42,7,10,16,72,118
2003-04-28 00:00:00.000,Munich Germany ATP World Tour,CLAY,2,Rainer Schuettler,Jurgen Melzer,Rainer Schuettler,6-4; 6-3,R32,88,1,1,39,56,23,39,8,17,2,5,9,31,56,3,2,50,78,27,50,9,28,8,14,10,36,78
2003-04-28 00:00:00.000,Munich Germany ATP World Tour,CLAY,2,Nikolay Davydenko,Cecil Mamiit,Nikolay Davydenko,7-5; 6-1,R32,73,2,0,27,49,20,27,15,22,3,4,9,35,49,2,3,38,61,23,38,8,23,6,11,10,31,61
2003-04-28 00:00:00.000,Munich Germany ATP World Tour,CLAY,2,Stefan Koubek,Bjorn Phau,Stefan Koubek,7-5; 6-4,R32,86,1,2,38,70,22,38,15,32,6,11,11,37,70,1,3,27,65,14,27,11,38,7,14,11,25,65
2003-04-28 00:00:00.000,Munich Germany ATP World Tour,CLAY,2,Tim Henman,Nicolas Lapentti,Tim Henman,7-5; 4-6; 6-1,R32,128,1,0,61,92,45,61,16,31,6,8,14,61,92,2,3,41,83,22,41,26,42,2,7,15,48,83
2003-04-28 00:00:00.000,Munich Germany ATP World Tour,CLAY,2,Yevgeny Kafelnikov,Olivier Rochus,Yevgeny Kafelnikov,6-3; 6-2,R32,61,3,3,23,45,19,23,13,22,2,3,8,32,45,1,1,31,55,15,31,11,24,2,7,9,26,55
2003-04-28 00:00:00.000,Munich Germany ATP World Tour,CLAY,2,Alexander Waske,Adrian Voinea,Alexander Waske,7-5; 7-6(2),R32,111,5,3,56,90,40,56,19,34,4,5,12,59,90,3,2,45,77,29,45,19,32,2,4,12,48,77
2003-04-28 00:00:00.000,Munich Germany ATP World Tour,CLAY,2,Wayne Arthurs,Tomas Behrend,Wayne Arthurs,7-6(4); 7-5,R32,92,25,3,48,76,40,48,15,28,3,3,12,55,76,6,2,42,76,33,42,19,34,1,2,12,52,76
2003-04-28 00:00:00.000,Munich Germany ATP World Tour,CLAY,2,Sjeng Schalken,Lars Burgsmuller,Sjeng Schalken,6-3; 6-1,R32,56,6,1,29,42,25,29,8,13,1,1,8,33,42,1,4,26,44,15,26,7,18,0,4,8,22,44
2003-04-28 00:00:00.000,Munich Germany ATP World Tour,CLAY,2,Jarkko Nieminen,Irakli Labadze,Jarkko Nieminen,6-2; 6-3,R32,53,1,0,35,47,28,35,10,12,3,3,9,38,47,1,1,29,45,17,29,10,16,0,3,8,27,45
2003-04-28 00:00:00.000,Munich Germany ATP World Tour,CLAY,2,Jean-Rene Lisnard,Martin Verkerk,Jean-Rene Lisnard,6-2; 6-4,R32,78,1,2,58,80,35,58,13,22,7,8,9,48,80,2,3,33,52,22,33,6,19,2,6,9,28,52
2003-04-28 00:00:00.000,Munich Germany ATP World Tour,CLAY,2,Radek Stepanek,Olivier Mutis,Radek Stepanek,6-3; 6-2,R32,62,8,0,33,46,27,33,11,13,2,2,9,38,46,1,5,36,74,23,36,16,38,12,15,8,39,74
2003-04-28 00:00:00.000,Munich Germany ATP World Tour,CLAY,2,Paradorn Srichaphan,Michael Kohlmann,Paradorn Srichaphan,6-4; 6-1,R32,66,2,3,28,49,23,28,10,21,2,3,8,33,49,4,1,35,57,16,35,10,22,4,9,9,26,57
2003-04-28 00:00:00.000,Munich Germany ATP World Tour,CLAY,2,Roger Federer,Raemon Sluiter,Roger Federer,6-4; 6-3,R16,59,1,1,31,52,22,31,14,21,0,1,10,36,52,1,0,31,55,21,31,9,24,3,6,9,30,55
2003-04-28 00:00:00.000,Munich Germany ATP World Tour,CLAY,2,Mikhail Youzhny,Harel Levy,Mikhail Youzhny,3-6; 6-4; 6-1,R16,98,4,2,57,83,42,57,13,26,4,6,13,55,83,3,0,49,78,32,49,14,29,2,6,13,46,78
2003-04-28 00:00:00.000,Munich Germany ATP World Tour,CLAY,2,Rainer Schuettler,Nikolay Davydenko,Rainer Schuettler,4-6; 6-2; 6-3,R16,140,0,2,62,108,36,62,23,46,9,13,14,59,108,1,2,62,87,36,62,10,25,9,15,13,46,87
2003-04-28 00:00:00.000,Munich Germany ATP World Tour,CLAY,2,Stefan Koubek,Tim Henman,Stefan Koubek,6-4; 6-0,R16,65,0,2,24,43,17,24,15,19,2,3,8,32,43,3,1,31,55,15,31,11,24,5,10,8,26,55
2003-04-28 00:00:00.000,Munich Germany ATP World Tour,CLAY,2,Yevgeny Kafelnikov,Alexander Waske,Yevgeny Kafelnikov,7-5; 4-6; 6-3,R16,157,1,3,69,104,44,69,22,35,5,8,16,66,104,12,4,69,106,41,69,20,37,7,11,15,61,106
2003-04-28 00:00:00.000,Munich Germany ATP World Tour,CLAY,2,Sjeng Schalken,Wayne Arthurs,Sjeng Schalken,7-6(4); 6-3,R16,81,3,0,60,74,42,60,12,14,3,3,11,54,74,12,3,32,58,28,32,14,26,0,1,10,42,58
2003-04-28 00:00:00.000,Munich Germany ATP World Tour,CLAY,2,Jarkko Nieminen,Jean-Rene Lisnard,Jarkko Nieminen,6-3; 6-0,R16,60,2,0,34,45,25,34,9,11,3,3,8,34,45,2,1,27,47,14,27,8,20,1,5,7,22,47
2003-04-28 00:00:00.000,Munich Germany ATP World Tour,CLAY,2,Radek Stepanek,Paradorn Srichaphan,Radek Stepanek,6-3; 6-2,R16,70,3,3,35,50,26,35,9,15,1,1,8,35,50,1,1,34,62,17,34,16,28,4,8,9,33,62
2003-04-28 00:00:00.000,Munich Germany ATP World Tour,CLAY,2,Roger Federer,Mikhail Youzhny,Roger Federer,6-2; 6-3,Q,61,3,0,31,49,26,31,12,18,1,1,9,38,49,0,1,29,53,16,29,14,24,5,8,8,30,53
2003-04-28 00:00:00.000,Munich Germany ATP World Tour,CLAY,2,Stefan Koubek,Rainer Schuettler,Stefan Koubek,6-3; 6-4,Q,68,2,2,41,68,27,41,16,27,5,6,10,43,68,1,1,33,46,21,33,6,13,1,4,9,27,46
2003-04-28 00:00:00.000,Munich Germany ATP World Tour,CLAY,2,Yevgeny Kafelnikov,Sjeng Schalken,Yevgeny Kafelnikov,6-7(2); 7-5; 6-3,Q,155,2,1,88,124,49,88,22,36,3,7,17,71,124,10,1,64,99,43,64,14,35,3,9,16,57,99
2003-04-28 00:00:00.000,Munich Germany ATP World Tour,CLAY,2,Jarkko Nieminen,Radek Stepanek,Jarkko Nieminen,6-1; 6-1,Q,49,1,0,22,38,14,22,12,16,2,3,7,26,38,2,3,20,42,10,20,4,22,4,10,7,14,42
2003-04-28 00:00:00.000,Munich Germany ATP World Tour,CLAY,2,Roger Federer,Stefan Koubek,Roger Federer,6-2; 6-1,S,55,2,1,37,54,25,37,12,17,6,6,8,37,54,1,4,35,46,19,35,2,11,3,7,7,21,46
2003-04-28 00:00:00.000,Munich Germany ATP World Tour,CLAY,2,Jarkko Nieminen,Yevgeny Kafelnikov,Jarkko Nieminen,6-4; 0-1 RET,S,49,0,0,34,37,16,34,3,3,4,7,6,19,37,0,0,25,32,13,25,2,7,3,6,5,15,32
2003-04-28 00:00:00.000,Munich Germany ATP World Tour,CLAY,2,Roger Federer,Jarkko Nieminen,Roger Federer,6-1; 6-4,F,56,4,1,28,50,21,28,12,22,1,3,9,33,50,0,0,37,46,18,37,3,9,4,9,8,21,46
2003-04-28 00:00:00.000,Valencia Spain ATP World Tour,CLAY,2,Juan Carlos Ferrero,Guillermo Garcia-Lopez,Juan Carlos Ferrero,6-4; 6-4,R32,85,5,1,38,60,27,38,13,22,0,1,10,40,60,6,1,38,77,26,38,17,39,8,11,10,43,77
2003-04-28 00:00:00.000,Valencia Spain ATP World Tour,CLAY,2,Albert Portas,Karol Beck,Albert Portas,6-2; 6-2,R32,51,8,1,28,41,24,28,9,13,2,2,8,33,41,8,6,33,59,20,33,11,26,2,6,8,31,59
2003-04-28 00:00:00.000,Valencia Spain ATP World Tour,CLAY,2,Dominik Hrbaty,Magnus Norman,Dominik Hrbaty,7-5; 4-6; 7-5,R32,151,2,8,52,107,35,52,33,55,2,6,17,68,107,5,2,67,123,48,67,22,56,7,12,17,70,123
2003-04-28 00:00:00.000,Valencia Spain ATP World Tour,CLAY,2,Agustin Calleri,Igor Kunitsyn,Agustin Calleri,6-4; 6-0,R32,69,5,4,22,48,15,22,16,26,2,4,8,31,48,0,2,26,57,13,26,10,31,2,8,8,23,57
2003-04-28 00:00:00.000,Valencia Spain ATP World Tour,CLAY,2,Gaston Gaudio,Andre Sa,Gaston Gaudio,6-1; 6-1,R32,57,4,1,36,54,25,36,10,18,3,4,7,35,54,0,3,23,44,10,23,6,21,4,10,7,16,44
2003-04-28 00:00:00.000,Valencia Spain ATP World Tour,CLAY,2,Galo Blanco,Alex Calatrava,Galo Blanco,6-3; 6-1,R32,81,2,2,42,70,27,42,14,28,11,13,8,41,70,3,2,23,49,13,23,7,26,4,10,8,20,49
2003-04-28 00:00:00.000,Valencia Spain ATP World Tour,CLAY,2,Frantisek Cermak,Fernando Verdasco,Frantisek Cermak,7-6(7); 6-0,R32,74,4,2,40,54,28,40,12,14,0,1,9,40,54,1,3,30,56,16,30,14,26,0,4,9,30,56
2003-04-28 00:00:00.000,Valencia Spain ATP World Tour,CLAY,2,Flavio Saretta,Mariano Zabaleta,Flavio Saretta,6-1; 6-3,R32,65,4,0,30,50,25,30,11,20,2,2,8,36,50,3,5,23,48,16,23,8,25,1,5,8,24,48
2003-04-28 00:00:00.000,Valencia Spain ATP World Tour,CLAY,2,David Sanchez,Olivier Patience,David Sanchez,3-6; 6-4; 6-2,R32,131,5,5,49,86,30,49,19,37,11,15,13,49,86,5,3,64,98,37,64,13,34,7,13,14,50,98
2003-04-28 00:00:00.000,Valencia Spain ATP World Tour,CLAY,2,Nicolas Massu,Alberto Martin,Nicolas Massu,6-2; 7-6(4),R32,110,2,2,47,67,34,47,10,20,2,3,10,44,67,2,5,39,67,28,39,11,28,4,7,10,39,67
2003-04-28 00:00:00.000,Valencia Spain ATP World Tour,CLAY,2,Fernando Vicente,Feliciano Lopez,Fernando Vicente,7-6(1); 3-6; 6-3,R32,120,9,3,55,100,44,55,26,45,3,4,15,70,100,1,6,58,95,42,58,22,37,2,3,15,64,95
2003-04-28 00:00:00.000,Valencia Spain ATP World Tour,CLAY,2,Antony Dupuis,Alex Corretja,Antony Dupuis,5-7; 6-3; 6-4,R32,146,6,2,51,95,33,51,25,44,4,8,15,58,95,7,3,53,95,35,53,21,42,3,9,16,56,95
2003-04-28 00:00:00.000,Valencia Spain ATP World Tour,CLAY,2,Markus Hipfl,Jose Acasuso,Markus Hipfl,6-4; 7-6(7),R32,130,0,4,86,114,56,86,13,28,17,18,11,69,114,9,1,37,66,28,37,18,29,2,4,11,46,66
2003-04-28 00:00:00.000,Valencia Spain ATP World Tour,CLAY,2,Christophe Rochus,Albert Montanes,Christophe Rochus,3-6; 7-6(3); 6-2,R32,119,3,4,62,109,41,62,21,47,8,13,15,62,109,4,5,45,81,31,45,14,36,2,7,14,45,81
2003-04-28 00:00:00.000,Valencia Spain ATP World Tour,CLAY,2,Sargis Sargsian,David Ferrer,Sargis Sargsian,6-4; 6-1,R32,56,4,1,31,47,23,31,12,16,2,3,9,35,47,2,3,28,51,18,28,7,23,4,8,8,25,51
2003-04-28 00:00:00.000,Valencia Spain ATP World Tour,CLAY,2,Franco Squillari,Marat Safin,Franco Squillari,6-4; 5-7; 6-2,R32,127,6,5,57,101,45,57,15,44,5,9,15,60,101,8,1,60,100,38,60,16,40,7,13,15,54,100
2003-04-28 00:00:00.000,Valencia Spain ATP World Tour,CLAY,2,Juan Carlos Ferrero,Albert Portas,Juan Carlos Ferrero,6-4; 6-4,R16,71,0,2,28,55,24,28,18,27,1,1,10,42,55,8,0,28,58,22,28,14,30,2,4,10,36,58
2003-04-28 00:00:00.000,Valencia Spain ATP World Tour,CLAY,2,Agustin Calleri,Dominik Hrbaty,Agustin Calleri,6-1; 5-7; 6-2,R16,104,11,2,38,76,30,38,22,38,2,3,13,52,76,3,1,43,80,33,43,14,37,8,13,14,47,80
2003-04-28 00:00:00.000,Valencia Spain ATP World Tour,CLAY,2,Gaston Gaudio,Galo Blanco,Gaston Gaudio,3-6; 6-4; 6-4,R16,145,6,5,83,129,55,83,22,46,7,9,14,77,129,4,3,46,87,35,46,22,41,4,7,15,57,87
2003-04-28 00:00:00.000,Valencia Spain ATP World Tour,CLAY,2,Flavio Saretta,Frantisek Cermak,Flavio Saretta,7-6(3); 6-4,R16,118,2,1,45,84,30,45,19,39,8,12,11,49,84,4,1,50,87,30,50,14,37,4,9,11,44,87
2003-04-28 00:00:00.000,Valencia Spain ATP World Tour,CLAY,2,Nicolas Massu,David Sanchez,Nicolas Massu,6-4; 6-3,R16,111,3,3,46,76,29,46,13,30,9,12,9,42,76,3,7,37,65,22,37,6,28,4,10,10,28,65
2003-04-28 00:00:00.000,Valencia Spain ATP World Tour,CLAY,2,Fernando Vicente,Antony Dupuis,Fernando Vicente,6-7(6); 6-1; 6-3,R16,128,9,1,57,104,42,57,27,47,4,4,14,69,104,4,6,41,92,27,41,27,51,3,7,14,54,92
2003-04-28 00:00:00.000,Valencia Spain ATP World Tour,CLAY,2,Christophe Rochus,Markus Hipfl,Christophe Rochus,6-4; 6-0,R16,57,3,0,27,44,21,27,11,17,1,2,8,32,44,2,0,45,59,22,45,6,14,2,7,8,28,59
2003-04-28 00:00:00.000,Valencia Spain ATP World Tour,CLAY,2,Sargis Sargsian,Franco Squillari,Sargis Sargsian,7-5; 3-6; 6-3,R16,134,6,5,55,103,41,55,26,48,13,15,15,67,103,2,4,36,82,26,36,31,46,4,7,15,57,82
2003-04-28 00:00:00.000,Valencia Spain ATP World Tour,CLAY,2,Juan Carlos Ferrero,Agustin Calleri,Juan Carlos Ferrero,6-3; 6-4,Q,99,5,2,42,69,29,42,15,27,10,12,10,44,69,10,5,45,79,28,45,12,34,11,15,9,40,79
2003-04-28 00:00:00.000,Valencia Spain ATP World Tour,CLAY,2,Flavio Saretta,Gaston Gaudio,Flavio Saretta,3-6; 7-6(3); 6-3,Q,165,5,1,52,100,32,52,24,48,8,12,14,56,100,2,4,85,121,53,85,15,36,6,11,16,68,121
2003-04-28 00:00:00.000,Valencia Spain ATP World Tour,CLAY,2,Fernando Vicente,Nicolas Massu,Fernando Vicente,6-3; 6-4,Q,69,3,0,29,49,24,29,16,20,0,0,10,40,49,4,2,31,45,21,31,9,14,0,2,9,30,45
2003-04-28 00:00:00.000,Valencia Spain ATP World Tour,CLAY,2,Christophe Rochus,Sargis Sargsian,Christophe Rochus,6-2; 6-2,Q,66,0,1,39,55,29,39,8,16,4,4,8,37,55,1,2,15,46,7,15,16,31,1,5,8,23,46
2003-04-28 00:00:00.000,Valencia Spain ATP World Tour,CLAY,2,Juan Carlos Ferrero,Flavio Saretta,Juan Carlos Ferrero,7-6(3); 6-2,S,85,3,4,35,64,27,35,18,29,1,2,10,45,64,2,2,25,51,20,25,12,26,0,3,10,32,51
2003-04-28 00:00:00.000,Valencia Spain ATP World Tour,CLAY,2,Christophe Rochus,Fernando Vicente,Christophe Rochus,6-3; 6-2,S,69,2,2,44,59,33,44,9,15,3,3,9,42,59,1,3,31,55,18,31,12,24,4,7,8,30,55
2003-04-28 00:00:00.000,Valencia Spain ATP World Tour,CLAY,2,Juan Carlos Ferrero,Christophe Rochus,Juan Carlos Ferrero,6-2; 6-4,F,66,2,2,33,51,26,33,12,18,0,0,9,38,51,1,1,38,63,23,38,13,25,4,7,9,36,63
2003-05-05 00:00:00.000,ATP Masters Series Rome Italy ATP World Tour,CLAY,2,David Ferrer,Andre Agassi,David Ferrer,0-6; 7-6(3); 6-4,R64,115,7,7,69,115,49,69,19,46,7,11,14,68,115,5,3,54,81,42,54,13,27,1,3,14,55,81
2003-05-05 00:00:00.000,ATP Masters Series Rome Italy ATP World Tour,CLAY,2,Ivan Ljubicic,Xavier Malisse,Ivan Ljubicic,6-2; 6-4,R64,74,4,0,21,51,17,21,20,30,2,2,9,37,51,3,2,30,66,21,30,16,36,3,6,9,37,66
2003-05-05 00:00:00.000,ATP Masters Series Rome Italy ATP World Tour,CLAY,2,Victor Hanescu,Mikhail Youzhny,Victor Hanescu,7-6(1); 6-3,R64,87,3,0,51,71,36,51,13,20,4,4,10,49,71,1,2,35,61,24,35,17,26,1,3,11,41,61
2003-05-05 00:00:00.000,ATP Masters Series Rome Italy ATP World Tour,CLAY,2,Guillermo Coria,Tim Henman,Guillermo Coria,6-2; 6-1,R64,88,0,0,36,43,27,36,4,7,0,0,7,31,43,1,3,32,67,15,32,17,35,6,11,8,32,67
2003-05-05 00:00:00.000,ATP Masters Series Rome Italy ATP World Tour,CLAY,2,Felix Mantilla,David Nalbandian,Felix Mantilla,6-3; 1-6; 6-0,R64,107,4,7,43,78,32,43,12,35,4,8,11,44,78,1,5,32,74,15,32,21,42,7,13,11,36,74
2003-05-05 00:00:00.000,ATP Masters Series Rome Italy ATP World Tour,CLAY,2,Mardy Fish,Fabrice Santoro,Mardy Fish,7-5; 7-5,R64,108,10,5,36,80,29,36,25,44,7,8,12,54,80,4,0,42,73,27,42,18,31,8,11,12,45,73
2003-05-05 00:00:00.000,ATP Masters Series Rome Italy ATP World Tour,CLAY,2,Arnaud Clement,Davide Sanguinetti,Arnaud Clement,6-1; 6-3,R64,87,5,0,32,61,20,32,18,29,10,11,8,38,61,0,5,30,60,19,30,9,30,8,13,8,28,60
2003-05-05 00:00:00.000,ATP Masters Series Rome Italy ATP World Tour,CLAY,2,Albert Costa,Zeljko Krajan,Albert Costa,6-4; 7-5,R64,102,2,1,35,66,25,35,18,31,4,6,11,43,66,5,2,38,58,22,38,12,20,1,5,11,34,58
2003-05-05 00:00:00.000,ATP Masters Series Rome Italy ATP World Tour,CLAY,2,Carlos Moya,Fernando Vicente,Carlos Moya,6-2; 6-4,R64,59,9,1,31,52,24,31,14,21,2,3,9,38,52,1,1,26,50,17,26,9,24,1,5,9,26,50
2003-05-05 00:00:00.000,ATP Masters Series Rome Italy ATP World Tour,CLAY,2,Max Mirnyi,Nicolas Lapentti,Max Mirnyi,4-6; 7-6(3); 6-3,R64,132,12,4,66,99,49,66,21,33,2,3,16,70,99,4,2,63,88,46,63,19,25,6,7,15,65,88
2003-05-05 00:00:00.000,ATP Masters Series Rome Italy ATP World Tour,CLAY,2,Giorgio Galimberti,Brian Vahaly,Giorgio Galimberti,7-5; 4-6; 6-3,R64,140,7,3,61,103,43,61,21,42,6,9,16,64,103,2,3,77,106,50,77,12,29,7,11,15,62,106
2003-05-05 00:00:00.000,ATP Masters Series Rome Italy ATP World Tour,CLAY,2,Yevgeny Kafelnikov,Younes El Aynaoui,Yevgeny Kafelnikov,6-1; 1-6; 6-4,R64,100,1,1,48,64,35,48,7,16,1,4,12,42,64,11,4,58,88,39,58,11,30,6,10,12,50,88
2003-05-05 00:00:00.000,ATP Masters Series Rome Italy ATP World Tour,CLAY,2,Jarkko Nieminen,Paradorn Srichaphan,Jarkko Nieminen,6-1; 6-2,R64,62,1,0,39,52,24,39,9,13,5,6,8,33,52,1,2,34,45,16,34,3,11,5,10,7,19,45
2003-05-05 00:00:00.000,ATP Masters Series Rome Italy ATP World Tour,CLAY,2,Nikolay Davydenko,Karol Kucera,Nikolay Davydenko,2-6; 6-1; 7-5,R64,131,1,3,57,86,32,57,14,29,8,13,14,46,86,4,6,48,85,36,48,10,37,3,9,13,46,85
2003-05-05 00:00:00.000,ATP Masters Series Rome Italy ATP World Tour,CLAY,2,Martin Verkerk,Vincent Spadea,Martin Verkerk,6-3; 7-6(2),R64,106,6,5,36,67,25,36,19,31,3,5,10,44,67,2,3,41,78,27,41,15,37,5,9,11,42,78
2003-05-05 00:00:00.000,ATP Masters Series Rome Italy ATP World Tour,CLAY,2,Andy Roddick,Andrea Gaudenzi,Andy Roddick,6-2; 6-3,R64,67,9,2,30,49,27,30,11,19,1,1,9,38,49,1,4,22,50,16,22,12,28,3,6,8,28,50
2003-05-05 00:00:00.000,ATP Masters Series Rome Italy ATP World Tour,CLAY,2,Filippo Volandri,Nicolas Massu,Filippo Volandri,1-6; 6-2; 6-1,R64,103,1,1,45,66,27,45,10,21,3,7,11,37,66,3,0,41,64,24,41,8,23,0,6,11,32,64
2003-05-05 00:00:00.000,ATP Masters Series Rome Italy ATP World Tour,CLAY,2,Raemon Sluiter,Jan-Michael Gambill,Raemon Sluiter,6-4; 4-6; 6-2,R64,109,6,0,50,87,34,50,26,37,3,5,14,60,87,6,1,36,80,31,36,18,44,0,4,14,49,80
2003-05-05 00:00:00.000,ATP Masters Series Rome Italy ATP World Tour,CLAY,2,Radek Stepanek,James Blake,Radek Stepanek,6-2; 1-6; 6-3,R64,93,5,6,43,75,25,43,17,32,7,11,12,42,75,1,1,38,76,25,38,18,38,4,9,12,43,76
2003-05-05 00:00:00.000,ATP Masters Series Rome Italy ATP World Tour,CLAY,2,Alberto Martin,Sjeng Schalken,Alberto Martin,2-6; 6-3; 6-1,R64,106,1,5,49,77,32,49,17,28,5,7,12,49,77,1,2,55,79,33,55,12,24,3,7,12,45,79
2003-05-05 00:00:00.000,ATP Masters Series Rome Italy ATP World Tour,CLAY,2,Tommy Robredo,Sebastien Grosjean,Tommy Robredo,6-7(4); 6-4; 6-3,R64,159,2,3,78,101,53,78,11,23,2,5,16,64,101,2,1,65,117,45,65,21,52,4,9,15,66,117
2003-05-05 00:00:00.000,ATP Masters Series Rome Italy ATP World Tour,CLAY,2,Juan Ignacio Chela,Olivier Rochus,Juan Ignacio Chela,6-1; 6-1,R64,48,4,1,28,35,22,28,6,7,0,0,7,28,35,1,0,41,46,17,41,2,5,3,8,7,19,46
2003-05-05 00:00:00.000,ATP Masters Series Rome Italy ATP World Tour,CLAY,2,Mariano Zabaleta,David Sanchez,Mariano Zabaleta,6-4; 6-2,R64,80,2,3,35,56,25,35,17,21,1,1,9,42,56,3,4,39,71,25,39,14,32,4,7,9,39,71
2003-05-05 00:00:00.000,ATP Masters Series Rome Italy ATP World Tour,CLAY,2,Roger Federer,Paul-Henri Mathieu,Roger Federer,6-3; 7-5,R64,87,5,4,34,60,25,34,15,26,5,7,10,40,60,1,6,39,65,23,39,10,26,6,11,11,33,65
2003-05-05 00:00:00.000,ATP Masters Series Rome Italy ATP World Tour,CLAY,2,Jiri Novak,Wayne Arthurs,Jiri Novak,6-3; 6-3,R64,63,3,0,29,47,23,29,13,18,0,0,9,36,47,8,5,30,58,24,30,10,28,4,7,9,34,58
2003-05-05 00:00:00.000,ATP Masters Series Rome Italy ATP World Tour,CLAY,2,Dominik Hrbaty,Thomas Enqvist,Dominik Hrbaty,6-3; 6-3,R64,63,6,4,43,58,32,43,7,15,4,5,9,39,58,5,4,32,51,24,32,4,19,2,6,9,28,51
2003-05-05 00:00:00.000,ATP Masters Series Rome Italy ATP World Tour,CLAY,2,Wayne Ferreira,Feliciano Lopez,Wayne Ferreira,3-6; 6-4; 6-3,R64,111,5,4,30,72,26,30,26,42,2,4,14,52,72,6,5,55,107,41,55,23,52,8,11,14,64,107
2003-05-05 00:00:00.000,ATP Masters Series Rome Italy ATP World Tour,CLAY,2,Rainer Schuettler,Magnus Norman,Rainer Schuettler,7-6(7); 7-5,R64,118,2,4,44,87,31,44,23,43,1,4,12,54,87,2,1,46,75,35,46,9,29,2,6,12,44,75
2003-05-05 00:00:00.000,ATP Masters Series Rome Italy ATP World Tour,CLAY,2,Gaston Gaudio,Gustavo Kuerten,Gaston Gaudio,6-3; 2-6; 6-4,R64,101,5,4,59,84,39,59,15,25,5,8,14,54,84,12,2,35,65,29,35,16,30,1,4,13,45,65
2003-05-05 00:00:00.000,ATP Masters Series Rome Italy ATP World Tour,CLAY,2,Agustin Calleri,Stefan Koubek,Agustin Calleri,6-2; 6-2,R64,52,7,2,25,41,21,25,10,16,3,4,8,31,41,2,2,25,43,11,25,6,18,3,8,8,17,43
2003-05-05 00:00:00.000,ATP Masters Series Rome Italy ATP World Tour,CLAY,2,Alex Corretja,Albert Portas,Alex Corretja,3-6; 6-2; 6-2,R64,107,5,6,43,79,32,43,17,36,4,7,13,49,79,10,5,40,72,31,40,9,32,2,7,12,40,72
2003-05-05 00:00:00.000,ATP Masters Series Rome Italy ATP World Tour,CLAY,2,Juan Carlos Ferrero,Mark Philippoussis,Juan Carlos Ferrero,7-6(3); 6-4,R64,109,7,3,42,70,32,42,21,28,5,5,11,53,70,13,2,36,73,29,36,19,37,4,5,11,48,73
2003-05-05 00:00:00.000,ATP Masters Series Rome Italy ATP World Tour,CLAY,2,Ivan Ljubicic,David Ferrer,Ivan Ljubicic,6-2; 6-3,R32,77,7,3,28,47,22,28,7,19,2,3,8,29,47,1,7,37,70,18,37,16,33,8,13,9,34,70
2003-05-05 00:00:00.000,ATP Masters Series Rome Italy ATP World Tour,CLAY,2,Guillermo Coria,Victor Hanescu,Guillermo Coria,6-1; 7-6(6),R32,101,3,1,50,72,34,50,11,22,4,6,10,45,72,0,1,38,69,24,38,15,31,7,11,9,39,69
2003-05-05 00:00:00.000,ATP Masters Series Rome Italy ATP World Tour,CLAY,2,Felix Mantilla,Mardy Fish,Felix Mantilla,6-4; 6-3,R32,79,0,4,39,59,27,39,12,20,1,2,10,39,59,2,1,32,57,22,32,9,25,1,4,9,31,57
2003-05-05 00:00:00.000,ATP Masters Series Rome Italy ATP World Tour,CLAY,2,Albert Costa,Arnaud Clement,Albert Costa,6-7(3); 6-2; 6-4,R32,185,10,0,70,114,49,70,20,44,6,9,15,69,114,8,4,38,94,26,38,29,56,3,9,15,55,94
2003-05-05 00:00:00.000,ATP Masters Series Rome Italy ATP World Tour,CLAY,2,Carlos Moya,Max Mirnyi,Carlos Moya,6-4; 6-4,R32,70,2,1,36,57,29,36,12,21,2,2,10,41,57,2,5,27,60,22,27,19,33,6,8,10,41,60
2003-05-05 00:00:00.000,ATP Masters Series Rome Italy ATP World Tour,CLAY,2,Yevgeny Kafelnikov,Giorgio Galimberti,Yevgeny Kafelnikov,7-5; 6-1,R32,78,1,3,39,54,26,39,8,15,1,4,10,34,54,1,4,36,57,17,36,6,21,2,8,9,23,57
2003-05-05 00:00:00.000,ATP Masters Series Rome Italy ATP World Tour,CLAY,2,Jarkko Nieminen,Nikolay Davydenko,Jarkko Nieminen,7-5; 4-6; 6-1,R32,136,4,2,87,116,54,87,17,29,12,15,15,71,116,4,3,63,96,42,63,14,33,3,8,14,56,96
2003-05-05 00:00:00.000,ATP Masters Series Rome Italy ATP World Tour,CLAY,2,Martin Verkerk,Andy Roddick,Martin Verkerk,6-7(6); 6-3; 6-4,R32,114,19,8,50,91,46,50,22,41,2,3,16,68,91,12,2,52,100,42,52,25,48,4,7,15,67,100
2003-05-05 00:00:00.000,ATP Masters Series Rome Italy ATP World Tour,CLAY,2,Filippo Volandri,Raemon Sluiter,Filippo Volandri,6-1; 7-5,R32,75,3,3,54,67,37,54,5,13,3,5,10,42,67,5,2,42,60,21,42,8,18,5,10,9,29,60
2003-05-05 00:00:00.000,ATP Masters Series Rome Italy ATP World Tour,CLAY,2,Radek Stepanek,Alberto Martin,Radek Stepanek,6-4; 6-3,R32,74,6,2,29,49,27,29,11,20,1,1,9,38,49,0,2,38,55,25,38,8,17,1,4,10,33,55
2003-05-05 00:00:00.000,ATP Masters Series Rome Italy ATP World Tour,CLAY,2,Tommy Robredo,Juan Ignacio Chela,Tommy Robredo,6-2; 6-0,R32,53,1,1,34,40,27,34,3,6,1,1,7,30,40,0,10,20,44,12,20,5,24,1,6,7,17,44
2003-05-05 00:00:00.000,ATP Masters Series Rome Italy ATP World Tour,CLAY,2,Roger Federer,Mariano Zabaleta,Roger Federer,7-6(4); 6-2,R32,108,14,1,51,73,38,51,11,22,7,8,10,49,73,0,3,54,95,34,54,18,41,13,16,10,52,95
2003-05-05 00:00:00.000,ATP Masters Series Rome Italy ATP World Tour,CLAY,2,Jiri Novak,Dominik Hrbaty,Jiri Novak,6-1; 6-4,R32,58,0,0,28,46,21,28,13,18,0,1,9,34,46,2,5,28,48,16,28,8,20,2,6,8,24,48
2003-05-05 00:00:00.000,ATP Masters Series Rome Italy ATP World Tour,CLAY,2,Rainer Schuettler,Wayne Ferreira,Rainer Schuettler,7-6(4); 6-2,R32,90,2,2,32,58,26,32,17,26,0,1,10,43,58,4,2,28,74,19,28,22,46,4,7,10,41,74
2003-05-05 00:00:00.000,ATP Masters Series Rome Italy ATP World Tour,CLAY,2,Gaston Gaudio,Agustin Calleri,Gaston Gaudio,6-4; 6-2,R32,86,0,0,32,54,21,32,18,22,1,1,9,39,54,3,7,23,57,19,23,13,34,4,7,9,32,57
2003-05-05 00:00:00.000,ATP Masters Series Rome Italy ATP World Tour,CLAY,2,Juan Carlos Ferrero,Alex Corretja,Juan Carlos Ferrero,6-4; 6-4,R32,114,3,3,48,74,33,48,12,26,6,8,10,45,74,2,2,34,81,23,34,18,47,7,11,10,41,81
2003-05-05 00:00:00.000,ATP Masters Series Rome Italy ATP World Tour,CLAY,2,Ivan Ljubicic,Guillermo Coria,Ivan Ljubicic,6-4; 6-3,R16,74,4,1,23,48,21,23,16,25,0,1,10,37,48,4,2,42,57,24,42,7,15,3,6,9,31,57
2003-05-05 00:00:00.000,ATP Masters Series Rome Italy ATP World Tour,CLAY,2,Felix Mantilla,Albert Costa,Felix Mantilla,7-5; 4-6; 6-1,R16,139,7,3,45,77,36,45,17,32,2,5,15,53,77,3,2,47,86,35,47,14,39,5,10,14,49,86
2003-05-05 00:00:00.000,ATP Masters Series Rome Italy ATP World Tour,CLAY,2,Yevgeny Kafelnikov,Carlos Moya,Yevgeny Kafelnikov,6-4; 7-6(4),R16,114,3,2,55,86,32,55,17,31,8,11,11,49,86,0,1,33,65,20,33,18,32,3,7,11,38,65
2003-05-05 00:00:00.000,ATP Masters Series Rome Italy ATP World Tour,CLAY,2,Martin Verkerk,Jarkko Nieminen,Martin Verkerk,6-0; 6-3,R16,64,8,3,20,40,19,20,11,20,3,3,7,30,40,0,1,43,70,24,43,10,27,15,20,8,34,70
2003-05-05 00:00:00.000,ATP Masters Series Rome Italy ATP World Tour,CLAY,2,Filippo Volandri,Radek Stepanek,Filippo Volandri,6-3; 6-4,R16,85,1,4,35,62,26,35,13,27,3,5,10,39,62,2,4,32,61,22,32,11,29,3,7,9,33,61
2003-05-05 00:00:00.000,ATP Masters Series Rome Italy ATP World Tour,CLAY,2,Roger Federer,Tommy Robredo,Roger Federer,6-1; 6-1,R16,49,1,2,24,38,20,24,9,14,0,0,7,29,38,0,1,32,46,16,32,3,14,1,6,7,19,46
2003-05-05 00:00:00.000,ATP Masters Series Rome Italy ATP World Tour,CLAY,2,Rainer Schuettler,Jiri Novak,Rainer Schuettler,6-4; 7-6(2),R16,104,2,3,43,71,31,43,15,28,7,10,11,46,71,3,1,54,78,31,54,10,24,4,8,11,41,78
2003-05-05 00:00:00.000,ATP Masters Series Rome Italy ATP World Tour,CLAY,2,Juan Carlos Ferrero,Gaston Gaudio,Juan Carlos Ferrero,5-7; 6-0; 6-2,R16,162,4,2,58,95,38,58,19,37,9,12,13,57,95,1,5,71,113,38,71,18,42,16,23,13,56,113
2003-05-05 00:00:00.000,ATP Masters Series Rome Italy ATP World Tour,CLAY,2,Felix Mantilla,Ivan Ljubicic,Felix Mantilla,3-6; 6-3; 6-4,Q,111,4,2,56,79,41,56,16,23,2,4,14,57,79,16,1,43,72,38,43,12,29,2,5,14,50,72
2003-05-05 00:00:00.000,ATP Masters Series Rome Italy ATP World Tour,CLAY,2,Yevgeny Kafelnikov,Martin Verkerk,Yevgeny Kafelnikov,6-3; 7-5,Q,98,3,3,38,70,24,38,21,32,2,4,11,45,70,7,7,38,70,25,38,13,32,6,10,10,38,70
2003-05-05 00:00:00.000,ATP Masters Series Rome Italy ATP World Tour,CLAY,2,Roger Federer,Filippo Volandri,Roger Federer,6-3; 5-7; 6-2,Q,122,6,0,47,82,37,47,18,35,1,4,15,55,82,0,5,77,109,50,77,10,32,10,15,14,60,109
2003-05-05 00:00:00.000,ATP Masters Series Rome Italy ATP World Tour,CLAY,2,Juan Carlos Ferrero,Rainer Schuettler,Juan Carlos Ferrero,6-4; 6-4,Q,80,2,2,31,59,24,31,14,28,3,5,10,38,59,1,3,39,62,29,39,7,23,4,8,10,36,62
2003-05-05 00:00:00.000,ATP Masters Series Rome Italy ATP World Tour,CLAY,2,Felix Mantilla,Yevgeny Kafelnikov,Felix Mantilla,4-6; 7-6(3); 6-4,S,161,4,0,89,118,53,89,14,29,12,17,16,67,118,3,2,62,112,39,62,23,50,7,12,16,62,112
2003-05-05 00:00:00.000,ATP Masters Series Rome Italy ATP World Tour,CLAY,2,Roger Federer,Juan Carlos Ferrero,Roger Federer,6-4; 4-2 RET,S,57,3,1,16,40,14,16,17,24,1,1,7,31,40,2,2,28,45,18,28,7,17,4,7,7,25,45
2003-05-05 00:00:00.000,ATP Masters Series Rome Italy ATP World Tour,CLAY,2,Felix Mantilla,Roger Federer,Felix Mantilla,7-5; 6-2; 7-6(8),F,161,0,4,108,139,67,108,15,31,14,17,16,82,139,8,7,51,104,35,51,26,53,5,11,16,61,104
2003-05-12 00:00:00.000,ATP Masters Series Hamburg Germany ATP World Tour,CLAY,2,Lleyton Hewitt,Markus Hantschk,Lleyton Hewitt,6-1; 4-6; 6-4,R64,143,1,2,44,86,31,44,25,42,8,9,13,56,86,3,2,54,98,38,54,18,44,5,9,14,56,98
2003-05-12 00:00:00.000,ATP Masters Series Hamburg Germany ATP World Tour,CLAY,2,Arnaud Clement,Nicolas Lapentti,Arnaud Clement,6-4; 6-2,R64,82,1,2,41,51,30,41,6,10,1,2,9,36,51,1,1,29,58,16,29,12,29,3,7,9,28,58
2003-05-12 00:00:00.000,ATP Masters Series Hamburg Germany ATP World Tour,CLAY,2,Felix Mantilla,Alberto Martin,Felix Mantilla,6-0; 6-4,R64,86,1,0,34,45,24,34,6,11,2,3,8,30,45,0,5,38,65,20,38,10,27,6,11,8,30,65
2003-05-12 00:00:00.000,ATP Masters Series Hamburg Germany ATP World Tour,CLAY,2,Fernando Gonzalez,Olivier Mutis,Fernando Gonzalez,6-2; 2-6; 7-5,R64,112,0,4,49,82,33,49,17,33,2,6,14,50,82,3,7,40,87,30,40,20,47,6,11,14,50,87
2003-05-12 00:00:00.000,ATP Masters Series Hamburg Germany ATP World Tour,CLAY,2,Rainer Schuettler,David Ferrer,Rainer Schuettler,7-5; 6-1,R64,84,0,0,41,72,26,41,18,31,6,8,10,44,72,0,4,26,51,14,26,10,25,1,6,9,24,51
2003-05-12 00:00:00.000,ATP Masters Series Hamburg Germany ATP World Tour,CLAY,2,Lars Burgsmuller,Hugo Armando,Lars Burgsmuller,6-4; 6-4,R64,88,7,0,40,66,32,40,10,26,5,6,10,42,66,1,3,33,59,21,33,13,26,4,7,10,34,59
2003-05-12 00:00:00.000,ATP Masters Series Hamburg Germany ATP World Tour,CLAY,2,Antony Dupuis,Fabrice Santoro,Antony Dupuis,6-3; 6-3,R64,81,4,1,33,57,23,33,15,24,1,2,9,38,57,2,1,32,68,19,32,17,36,10,14,9,36,68
2003-05-12 00:00:00.000,ATP Masters Series Hamburg Germany ATP World Tour,CLAY,2,David Nalbandian,Jean-Rene Lisnard,David Nalbandian,6-3; 6-3,R64,74,3,4,27,56,19,27,15,29,3,5,9,34,56,0,4,27,54,15,27,9,27,4,9,9,24,54
2003-05-12 00:00:00.000,ATP Masters Series Hamburg Germany ATP World Tour,CLAY,2,Andy Roddick,Ivan Ljubicic,Andy Roddick,6-4; 6-4,R64,74,5,2,28,55,23,28,20,27,1,1,10,43,55,3,1,35,63,26,35,15,28,3,5,10,41,63
2003-05-12 00:00:00.000,ATP Masters Series Hamburg Germany ATP World Tour,CLAY,2,Agustin Calleri,Hyung-Taik Lee,Agustin Calleri,3-6; 7-6(1); 7-5,R64,146,15,6,61,110,41,61,26,49,9,14,16,67,110,4,4,77,129,52,77,22,52,14,19,17,74,129
2003-05-12 00:00:00.000,ATP Masters Series Hamburg Germany ATP World Tour,CLAY,2,Mariano Zabaleta,Karol Kucera,Mariano Zabaleta,7-5; 6-4,R64,101,4,1,31,56,26,31,17,25,2,3,11,43,56,5,6,53,88,36,53,13,35,8,11,11,49,88
2003-05-12 00:00:00.000,ATP Masters Series Hamburg Germany ATP World Tour,CLAY,2,Tommy Robredo,Radek Stepanek,Tommy Robredo,6-4; 6-3,R64,69,3,2,48,62,34,48,3,14,5,7,9,37,62,2,5,38,58,18,38,11,20,5,10,10,29,58
2003-05-12 00:00:00.000,ATP Masters Series Hamburg Germany ATP World Tour,CLAY,2,Gustavo Kuerten,Juan Ignacio Chela,Gustavo Kuerten,6-2; 6-4,R64,71,3,3,38,65,31,38,14,27,4,4,9,45,65,6,4,29,52,21,29,10,23,2,5,9,31,52
2003-05-12 00:00:00.000,ATP Masters Series Hamburg Germany ATP World Tour,CLAY,2,Nikolay Davydenko,Adrian Voinea,Nikolay Davydenko,6-0; 6-2,R64,43,4,1,22,34,18,22,10,12,0,0,7,28,34,0,0,27,38,10,27,5,11,0,5,7,15,38
2003-05-12 00:00:00.000,ATP Masters Series Hamburg Germany ATP World Tour,CLAY,2,Wayne Ferreira,Alexander Waske,Wayne Ferreira,6-3; 6-2,R64,77,5,2,22,47,17,22,20,25,2,2,9,37,47,5,5,50,85,28,50,17,35,11,14,8,45,85
2003-05-12 00:00:00.000,ATP Masters Series Hamburg Germany ATP World Tour,CLAY,2,Feliciano Lopez,Paradorn Srichaphan,Feliciano Lopez,6-4; 6-3,R64,72,2,1,44,68,21,44,11,24,4,10,10,32,68,1,3,25,48,5,25,10,23,5,13,9,15,48
2003-05-12 00:00:00.000,ATP Masters Series Hamburg Germany ATP World Tour,CLAY,2,Mikhail Youzhny,Jiri Novak,Mikhail Youzhny,6-1; 6-4,R64,76,2,0,37,66,24,37,15,29,3,4,8,39,66,2,4,44,69,25,44,8,25,6,11,9,33,69
2003-05-12 00:00:00.000,ATP Masters Series Hamburg Germany ATP World Tour,CLAY,2,Karol Beck,Wayne Arthurs,Karol Beck,6-4; 3-6; 6-3,R64,84,6,4,42,76,31,42,22,34,5,8,14,53,76,10,7,43,76,32,43,17,33,2,6,14,49,76
2003-05-12 00:00:00.000,ATP Masters Series Hamburg Germany ATP World Tour,CLAY,2,Jarkko Nieminen,Stefan Koubek,Jarkko Nieminen,6-4; 0-6; 6-1,R64,83,2,1,48,72,30,48,11,24,2,6,11,41,72,6,3,41,75,28,41,14,34,2,7,12,42,75
2003-05-12 00:00:00.000,ATP Masters Series Hamburg Germany ATP World Tour,CLAY,2,Guillermo Coria,Vincent Spadea,Guillermo Coria,6-2; 6-2,R64,71,0,2,32,44,24,32,8,12,0,0,8,32,44,1,2,28,55,17,28,12,27,6,10,8,29,55
2003-05-12 00:00:00.000,ATP Masters Series Hamburg Germany ATP World Tour,CLAY,2,Xavier Malisse,Alex Corretja,Xavier Malisse,7-6(3); 4-6; 6-3,R64,143,11,3,45,96,33,45,24,51,4,9,16,57,96,2,3,64,101,36,64,20,37,2,7,15,56,101
2003-05-12 00:00:00.000,ATP Masters Series Hamburg Germany ATP World Tour,CLAY,2,Mark Philippoussis,Raemon Sluiter,Mark Philippoussis,6-4; 7-5,R64,74,12,1,36,62,28,36,13,26,6,9,11,41,62,10,6,43,68,24,43,11,25,2,7,11,35,68
2003-05-12 00:00:00.000,ATP Masters Series Hamburg Germany ATP World Tour,CLAY,2,Sargis Sargsian,Dominik Hrbaty,Sargis Sargsian,6-7(4); 6-4; 6-4,R64,129,2,6,60,106,39,60,26,46,6,10,16,65,106,7,7,55,101,36,55,24,46,5,11,16,60,101
2003-05-12 00:00:00.000,ATP Masters Series Hamburg Germany ATP World Tour,CLAY,2,Roger Federer,Max Mirnyi,Roger Federer,6-3; 6-3,R64,57,3,0,37,54,27,37,13,17,5,5,9,40,54,2,6,27,46,21,27,6,19,2,5,9,27,46
2003-05-12 00:00:00.000,ATP Masters Series Hamburg Germany ATP World Tour,CLAY,2,Albert Costa,Nicolas Kiefer,Albert Costa,6-4; 6-4,R64,93,2,0,35,58,25,35,16,23,1,2,10,41,58,4,7,30,58,24,30,10,28,3,6,10,34,58
2003-05-12 00:00:00.000,ATP Masters Series Hamburg Germany ATP World Tour,CLAY,2,Olivier Rochus,Younes El Aynaoui,Olivier Rochus,7-6(7); 6-4,R64,103,2,2,58,80,41,58,13,22,4,5,11,54,80,12,4,66,96,43,66,14,30,12,14,11,57,96
2003-05-12 00:00:00.000,ATP Masters Series Hamburg Germany ATP World Tour,CLAY,2,Tim Henman,Jan-Michael Gambill,Tim Henman,7-5; 6-4,R64,89,4,1,42,59,28,42,13,17,0,2,11,41,59,2,3,53,76,33,53,10,23,5,9,11,43,76
2003-05-12 00:00:00.000,ATP Masters Series Hamburg Germany ATP World Tour,CLAY,2,Sebastien Grosjean,Filippo Volandri,Sebastien Grosjean,6-3; 6-4,R64,89,0,0,41,79,28,41,21,38,7,8,10,49,79,0,3,41,59,26,41,7,18,1,4,9,33,59
2003-05-12 00:00:00.000,ATP Masters Series Hamburg Germany ATP World Tour,CLAY,2,Gaston Gaudio,James Blake,Gaston Gaudio,6-7(3); 6-1; 6-2,R64,110,3,1,54,83,37,54,18,29,0,2,14,55,83,10,4,57,101,34,57,22,44,10,16,13,56,101
2003-05-12 00:00:00.000,ATP Masters Series Hamburg Germany ATP World Tour,CLAY,2,David Sanchez,Mardy Fish,David Sanchez,5-7; 6-4; 6-2,R64,128,3,3,47,92,36,47,22,45,1,5,15,58,92,6,5,55,118,38,55,25,63,8,14,15,63,118
2003-05-12 00:00:00.000,ATP Masters Series Hamburg Germany ATP World Tour,CLAY,2,Rafael Nadal,Paul-Henri Mathieu,Rafael Nadal,7-5; 6-4,R64,102,2,1,66,81,44,66,6,15,8,10,11,50,81,2,1,38,57,26,38,9,19,3,7,11,35,57
2003-05-12 00:00:00.000,ATP Masters Series Hamburg Germany ATP World Tour,CLAY,2,Carlos Moya,Scott Draper,Carlos Moya,6-3; 5-7; 6-3,R64,111,10,0,53,100,43,53,18,47,9,13,15,61,100,3,2,56,102,36,56,19,46,6,12,15,55,102
2003-05-12 00:00:00.000,ATP Masters Series Hamburg Germany ATP World Tour,CLAY,2,Lleyton Hewitt,Arnaud Clement,Lleyton Hewitt,6-7(7); 6-4; 7-6(6),R32,216,4,8,68,134,43,68,24,66,12,19,17,67,134,3,2,66,123,44,66,16,57,9,17,17,60,123
2003-05-12 00:00:00.000,ATP Masters Series Hamburg Germany ATP World Tour,CLAY,2,Fernando Gonzalez,Felix Mantilla,Fernando Gonzalez,6-2; 6-1,R32,58,6,3,24,43,19,24,11,19,3,3,7,30,43,0,2,33,51,17,33,5,18,3,8,8,22,51
2003-05-12 00:00:00.000,ATP Masters Series Hamburg Germany ATP World Tour,CLAY,2,Rainer Schuettler,Lars Burgsmuller,Rainer Schuettler,6-4; 4-6; 6-4,R32,145,2,0,60,93,40,60,20,33,3,5,15,60,93,3,2,59,99,38,59,24,40,4,7,15,62,99
2003-05-12 00:00:00.000,ATP Masters Series Hamburg Germany ATP World Tour,CLAY,2,David Nalbandian,Antony Dupuis,David Nalbandian,5-7; 6-2; 6-3,R32,134,2,3,52,92,40,52,20,40,6,8,15,60,92,9,2,62,92,43,62,12,30,2,6,14,55,92
2003-05-12 00:00:00.000,ATP Masters Series Hamburg Germany ATP World Tour,CLAY,2,Agustin Calleri,Andy Roddick,Agustin Calleri,3-6; 6-2; 6-3,R32,96,9,2,45,80,35,45,20,35,5,6,13,55,80,3,2,37,72,29,37,19,35,3,6,13,48,72
2003-05-12 00:00:00.000,ATP Masters Series Hamburg Germany ATP World Tour,CLAY,2,Mariano Zabaleta,Tommy Robredo,Mariano Zabaleta,3-6; 6-3; 6-1,R32,97,1,1,55,71,39,55,9,16,1,3,12,48,71,4,6,53,99,32,53,21,46,6,11,13,53,99
2003-05-12 00:00:00.000,ATP Masters Series Hamburg Germany ATP World Tour,CLAY,2,Gustavo Kuerten,Nikolay Davydenko,Gustavo Kuerten,7-5; 6-0,R32,81,1,1,28,61,21,28,14,33,6,9,9,35,61,1,4,40,67,20,40,7,27,5,12,9,27,67
2003-05-12 00:00:00.000,ATP Masters Series Hamburg Germany ATP World Tour,CLAY,2,Wayne Ferreira,Feliciano Lopez,Wayne Ferreira,6-1; 6-2,R32,48,8,0,32,48,26,32,8,16,0,0,8,34,48,2,1,22,39,11,22,10,17,5,9,7,21,39
2003-05-12 00:00:00.000,ATP Masters Series Hamburg Germany ATP World Tour,CLAY,2,Mikhail Youzhny,Karol Beck,Mikhail Youzhny,6-7(7); 6-4; 6-2,R32,124,1,2,61,103,40,61,22,42,4,8,15,62,103,2,6,36,91,23,36,25,55,7,14,15,48,91
2003-05-12 00:00:00.000,ATP Masters Series Hamburg Germany ATP World Tour,CLAY,2,Guillermo Coria,Jarkko Nieminen,Guillermo Coria,6-3; 6-4,R32,81,1,0,43,66,27,43,15,23,7,9,10,42,66,0,0,41,55,22,41,6,14,3,7,9,28,55
2003-05-12 00:00:00.000,ATP Masters Series Hamburg Germany ATP World Tour,CLAY,2,Mark Philippoussis,Xavier Malisse,Mark Philippoussis,6-3; 7-6(4),R32,98,5,1,46,74,35,46,12,28,0,3,11,47,74,6,4,40,76,27,40,14,36,5,9,10,41,76
2003-05-12 00:00:00.000,ATP Masters Series Hamburg Germany ATP World Tour,CLAY,2,Roger Federer,Sargis Sargsian,Roger Federer,6-1; 6-1,R32,52,2,0,26,43,18,26,11,17,1,2,7,29,43,1,2,30,47,12,30,5,17,3,9,7,17,47
2003-05-12 00:00:00.000,ATP Masters Series Hamburg Germany ATP World Tour,CLAY,2,Olivier Rochus,Albert Costa,Olivier Rochus,3-6; 6-3; 7-6(3),R32,170,0,4,65,101,43,65,21,36,5,8,15,64,101,4,3,72,110,49,72,20,38,4,7,15,69,110
2003-05-12 00:00:00.000,ATP Masters Series Hamburg Germany ATP World Tour,CLAY,2,Tim Henman,Sebastien Grosjean,Tim Henman,6-0; 3-6; 6-2,R32,115,2,3,48,75,36,48,14,27,4,5,11,50,75,5,0,42,82,23,42,22,40,2,7,12,45,82
2003-05-12 00:00:00.000,ATP Masters Series Hamburg Germany ATP World Tour,CLAY,2,Gaston Gaudio,David Sanchez,Gaston Gaudio,6-7(8); 6-3; 6-1,R32,129,3,2,49,99,28,49,32,50,7,11,14,60,99,2,6,57,93,30,57,15,36,6,14,14,45,93
2003-05-12 00:00:00.000,ATP Masters Series Hamburg Germany ATP World Tour,CLAY,2,Rafael Nadal,Carlos Moya,Rafael Nadal,7-5; 6-4,R32,89,1,0,53,63,30,53,7,10,2,5,11,37,63,3,0,36,64,25,36,11,28,4,9,11,36,64
2003-05-12 00:00:00.000,ATP Masters Series Hamburg Germany ATP World Tour,CLAY,2,Fernando Gonzalez,Lleyton Hewitt,Fernando Gonzalez,6-1; 3-6; 6-0,R16,96,8,4,49,75,34,49,10,26,3,5,11,44,75,0,3,43,67,19,43,13,24,4,10,11,32,67
2003-05-12 00:00:00.000,ATP Masters Series Hamburg Germany ATP World Tour,CLAY,2,David Nalbandian,Rainer Schuettler,David Nalbandian,7-6(3); 6-2,R16,99,3,2,42,68,29,42,14,26,5,7,10,43,68,0,4,42,75,22,42,18,33,4,8,10,40,75
2003-05-12 00:00:00.000,ATP Masters Series Hamburg Germany ATP World Tour,CLAY,2,Agustin Calleri,Mariano Zabaleta,Agustin Calleri,6-3; 6-0,R16,48,3,2,22,36,21,22,8,14,0,0,7,29,36,0,3,25,45,13,25,6,20,4,9,8,19,45
2003-05-12 00:00:00.000,ATP Masters Series Hamburg Germany ATP World Tour,CLAY,2,Wayne Ferreira,Gustavo Kuerten,Wayne Ferreira,7-6(4); 6-4,R16,94,8,0,45,83,35,45,18,38,4,5,11,53,83,0,3,44,69,30,44,13,25,4,6,11,43,69
2003-05-12 00:00:00.000,ATP Masters Series Hamburg Germany ATP World Tour,CLAY,2,Guillermo Coria,Mikhail Youzhny,Guillermo Coria,6-3; 6-3,R16,76,0,1,35,53,23,35,9,18,2,4,9,32,53,0,1,35,58,18,35,10,23,5,10,9,28,58
2003-05-12 00:00:00.000,ATP Masters Series Hamburg Germany ATP World Tour,CLAY,2,Mark Philippoussis,Roger Federer,Mark Philippoussis,6-3; 2-6; 6-3,R16,124,3,6,57,105,40,57,18,48,11,16,13,58,105,1,5,52,85,33,52,13,33,6,12,13,46,85
2003-05-12 00:00:00.000,ATP Masters Series Hamburg Germany ATP World Tour,CLAY,2,Olivier Rochus,Tim Henman,Olivier Rochus,6-4; 6-3,R16,68,0,0,36,47,25,36,7,11,3,5,9,32,47,4,2,36,52,19,36,7,16,2,7,10,26,52
2003-05-12 00:00:00.000,ATP Masters Series Hamburg Germany ATP World Tour,CLAY,2,Gaston Gaudio,Rafael Nadal,Gaston Gaudio,6-2; 6-2,R16,59,3,1,25,40,22,25,10,15,0,0,8,32,40,1,2,35,48,18,35,7,13,2,6,8,25,48
2003-05-12 00:00:00.000,ATP Masters Series Hamburg Germany ATP World Tour,CLAY,2,David Nalbandian,Fernando Gonzalez,David Nalbandian,5-7; 6-3; 6-4,Q,140,2,2,73,98,42,73,13,25,6,12,16,55,98,6,4,60,104,36,60,19,44,6,13,15,55,104
2003-05-12 00:00:00.000,ATP Masters Series Hamburg Germany ATP World Tour,CLAY,2,Agustin Calleri,Wayne Ferreira,Agustin Calleri,7-5; 6-2,Q,83,4,1,37,67,29,37,15,30,3,4,10,44,67,4,3,38,67,24,38,12,29,4,8,10,36,67
2003-05-12 00:00:00.000,ATP Masters Series Hamburg Germany ATP World Tour,CLAY,2,Guillermo Coria,Mark Philippoussis,Guillermo Coria,6-2; 6-0,Q,57,1,0,28,38,19,28,9,10,0,1,7,28,38,3,2,20,48,10,20,7,28,9,15,7,17,48
2003-05-12 00:00:00.000,ATP Masters Series Hamburg Germany ATP World Tour,CLAY,2,Gaston Gaudio,Olivier Rochus,Gaston Gaudio,6-1; 6-1,Q,54,3,1,20,38,19,20,10,18,2,2,7,29,38,0,2,27,39,13,27,2,12,2,7,7,15,39
2003-05-12 00:00:00.000,ATP Masters Series Hamburg Germany ATP World Tour,CLAY,2,Agustin Calleri,David Nalbandian,Agustin Calleri,6-4; 6-1,S,79,5,3,28,62,23,28,18,34,8,8,8,41,62,4,3,33,65,22,33,12,32,3,7,9,34,65
2003-05-12 00:00:00.000,ATP Masters Series Hamburg Germany ATP World Tour,CLAY,2,Guillermo Coria,Gaston Gaudio,Guillermo Coria,6-3; 6-7(3); 6-0,S,150,2,2,62,95,37,62,22,33,4,7,14,59,95,2,1,59,88,35,59,9,29,4,11,13,44,88
2003-05-12 00:00:00.000,ATP Masters Series Hamburg Germany ATP World Tour,CLAY,2,Guillermo Coria,Agustin Calleri,Guillermo Coria,6-3; 6-4; 6-4,F,134,2,2,60,92,39,60,22,32,4,6,15,61,92,4,6,45,84,32,45,17,39,6,11,14,49,84
2003-05-19 00:00:00.000,St. Poelten Austria ATP World Tour,CLAY,2,Andy Roddick,Alberto Martin,Andy Roddick,6-1; 7-6(5),R32,86,5,2,38,57,31,38,9,19,2,4,10,40,57,1,4,51,74,27,51,13,23,9,13,9,40,74
2003-05-19 00:00:00.000,St. Poelten Austria ATP World Tour,CLAY,2,Philipp Kohlschreiber,Jurgen Melzer,Philipp Kohlschreiber,6-4; 0-6; 6-2,R32,95,1,4,50,77,33,50,11,27,4,8,12,44,77,5,2,45,78,30,45,15,33,7,11,12,45,78
2003-05-19 00:00:00.000,St. Poelten Austria ATP World Tour,CLAY,2,Brian Vahaly,Kenneth Carlsen,Brian Vahaly,7-5; 5-7; 6-3,R32,150,2,0,75,98,48,75,17,23,3,7,17,65,98,2,4,67,115,40,67,24,48,7,12,16,64,115
2003-05-19 00:00:00.000,St. Poelten Austria ATP World Tour,CLAY,2,Richard Krajicek,Jan-Michael Gambill,Richard Krajicek,7-5; 3-6; 6-3,R32,118,13,2,45,86,35,45,20,41,4,7,15,55,86,9,3,52,93,37,52,19,41,4,8,15,56,93
2003-05-19 00:00:00.000,St. Poelten Austria ATP World Tour,CLAY,2,Mario Ancic,Taylor Dent,Mario Ancic,2-6; 7-6(3); 6-4,R32,130,6,3,54,101,36,54,24,47,5,9,15,60,101,3,4,58,95,40,58,18,37,5,8,15,58,95
2003-05-19 00:00:00.000,St. Poelten Austria ATP World Tour,CLAY,2,Jean-Rene Lisnard,Michel Kratochvil,Jean-Rene Lisnard,6-3; 6-4,R32,79,1,2,24,51,16,24,14,27,2,5,9,30,51,0,3,39,61,19,39,8,22,1,7,10,27,61
2003-05-19 00:00:00.000,St. Poelten Austria ATP World Tour,CLAY,2,Davide Sanguinetti,Sargis Sargsian,Davide Sanguinetti,7-5; 7-6(5),R32,121,1,1,49,82,35,49,17,33,4,6,12,52,82,2,3,46,75,30,46,16,29,3,6,12,46,75
2003-05-19 00:00:00.000,St. Poelten Austria ATP World Tour,CLAY,2,David Sanchez,Markus Hipfl,David Sanchez,6-1; 6-0,R32,57,2,0,26,38,18,26,9,12,3,4,7,27,38,0,1,32,45,14,32,2,13,3,9,6,16,45
2003-05-19 00:00:00.000,St. Poelten Austria ATP World Tour,CLAY,2,Martin Verkerk,Karol Kucera,Martin Verkerk,6-2; 6-1,R32,60,4,6,27,46,20,27,9,19,4,5,7,29,46,2,5,27,55,11,27,12,28,6,12,8,23,55
2003-05-19 00:00:00.000,St. Poelten Austria ATP World Tour,CLAY,2,Dominik Hrbaty,Luis Horna,Dominik Hrbaty,6-3; 7-5,R32,105,4,6,35,66,28,35,13,31,5,7,10,41,66,2,4,58,85,33,58,10,27,10,15,11,43,85
2003-05-19 00:00:00.000,St. Poelten Austria ATP World Tour,CLAY,2,Flavio Saretta,Andre Sa,Flavio Saretta,6-2; 6-2,R32,70,2,0,22,49,14,22,16,27,4,6,8,30,49,0,6,26,50,14,26,7,24,6,12,8,21,50
2003-05-19 00:00:00.000,St. Poelten Austria ATP World Tour,CLAY,2,Irakli Labadze,Jan Weinzierl,Irakli Labadze,6-4; 4-6; 6-4,R32,118,5,12,70,101,47,70,8,31,12,17,15,55,101,4,3,49,81,32,49,10,32,2,8,15,42,81
2003-05-19 00:00:00.000,St. Poelten Austria ATP World Tour,CLAY,2,Nikolay Davydenko,Karol Beck,Nikolay Davydenko,6-4; 6-2,R32,66,5,0,28,49,22,28,13,21,1,2,9,35,49,1,2,31,66,24,31,13,35,5,9,9,37,66
2003-05-19 00:00:00.000,St. Poelten Austria ATP World Tour,CLAY,2,Hyung-Taik Lee,Hugo Armando,Hyung-Taik Lee,4-6; 6-4; 6-3,R32,124,4,2,53,81,39,53,11,28,2,6,15,50,81,4,1,62,88,35,62,15,26,4,9,14,50,88
2003-05-19 00:00:00.000,St. Poelten Austria ATP World Tour,CLAY,2,Antony Dupuis,Olivier Mutis,Antony Dupuis,6-3; 6-1,R32,58,2,0,32,45,21,32,10,13,0,1,8,31,45,0,3,31,48,15,31,6,17,2,7,8,21,48
2003-05-19 00:00:00.000,St. Poelten Austria ATP World Tour,CLAY,2,Albert Costa,Nenad Zimonjic,Albert Costa,6-7(4); 6-1; 6-3,R32,117,3,1,49,80,35,49,24,31,2,3,14,59,80,10,4,63,92,45,63,6,29,4,9,14,51,92
2003-05-19 00:00:00.000,St. Poelten Austria ATP World Tour,CLAY,2,Andy Roddick,Philipp Kohlschreiber,Andy Roddick,6-3; 6-4,R16,54,11,0,30,50,26,30,12,20,0,1,10,38,50,1,1,28,47,17,28,12,19,1,4,9,29,47
2003-05-19 00:00:00.000,St. Poelten Austria ATP World Tour,CLAY,2,Richard Krajicek,Brian Vahaly,Richard Krajicek,6-2; 2-6; 6-3,R16,102,6,4,43,87,31,43,21,44,7,10,13,52,87,0,1,62,79,38,62,9,17,4,8,12,47,79
2003-05-19 00:00:00.000,St. Poelten Austria ATP World Tour,CLAY,2,Mario Ancic,Jean-Rene Lisnard,Mario Ancic,6-4; 7-5,R16,104,3,3,45,76,29,45,15,31,6,9,11,44,76,0,4,47,75,26,47,14,28,11,16,11,40,75
2003-05-19 00:00:00.000,St. Poelten Austria ATP World Tour,CLAY,2,David Sanchez,Davide Sanguinetti,David Sanchez,6-4; 6-4,R16,102,1,0,56,88,33,56,16,32,6,9,10,49,88,2,1,44,73,26,44,10,29,7,12,10,36,73
2003-05-19 00:00:00.000,St. Poelten Austria ATP World Tour,CLAY,2,Martin Verkerk,Dominik Hrbaty,Martin Verkerk,6-4; 7-5,R16,81,6,4,35,65,26,35,16,30,3,5,11,42,65,2,3,40,71,26,40,14,31,6,10,11,40,71
2003-05-19 00:00:00.000,St. Poelten Austria ATP World Tour,CLAY,2,Flavio Saretta,Irakli Labadze,Flavio Saretta,6-1; 6-1,R16,67,5,2,27,49,21,27,14,22,3,3,7,35,49,3,5,35,64,17,35,12,29,6,11,7,29,64
2003-05-19 00:00:00.000,St. Poelten Austria ATP World Tour,CLAY,2,Nikolay Davydenko,Hyung-Taik Lee,Nikolay Davydenko,6-4; 6-3,R16,81,3,3,41,67,28,41,16,26,10,11,9,44,67,1,0,53,65,32,53,4,12,5,9,10,36,65
2003-05-19 00:00:00.000,St. Poelten Austria ATP World Tour,CLAY,2,Antony Dupuis,Albert Costa,Antony Dupuis,6-4; 2-6; 6-2,R16,123,9,1,49,77,38,49,14,28,3,5,13,52,77,1,1,64,95,39,64,17,31,7,10,13,56,95
2003-05-19 00:00:00.000,St. Poelten Austria ATP World Tour,CLAY,2,Andy Roddick,Richard Krajicek,Andy Roddick,7-5; 6-1,Q,64,9,1,44,59,31,44,10,15,3,4,10,41,59,2,3,36,63,23,36,11,27,3,7,9,34,63
2003-05-19 00:00:00.000,St. Poelten Austria ATP World Tour,CLAY,2,David Sanchez,Mario Ancic,David Sanchez,6-1; 6-4,Q,64,1,3,29,49,19,29,8,20,1,4,8,27,49,1,5,22,50,11,22,8,28,1,8,9,19,50
2003-05-19 00:00:00.000,St. Poelten Austria ATP World Tour,CLAY,2,Martin Verkerk,Flavio Saretta,Martin Verkerk,7-6(4); 7-6(2),Q,113,7,4,43,77,33,43,23,34,1,2,12,56,77,1,3,47,83,32,47,22,36,1,2,12,54,83
2003-05-19 00:00:00.000,St. Poelten Austria ATP World Tour,CLAY,2,Nikolay Davydenko,Antony Dupuis,Nikolay Davydenko,7-5; 6-1,Q,100,5,2,45,67,31,45,9,22,6,8,9,40,67,2,1,48,79,25,48,13,31,5,11,10,38,79
2003-05-19 00:00:00.000,St. Poelten Austria ATP World Tour,CLAY,2,Andy Roddick,David Sanchez,Andy Roddick,6-2; 2-0 RET,S,49,1,0,19,35,16,19,9,16,0,0,5,25,35,3,3,25,38,14,25,4,13,3,6,5,18,38
2003-05-19 00:00:00.000,St. Poelten Austria ATP World Tour,CLAY,2,Nikolay Davydenko,Martin Verkerk,Nikolay Davydenko,7-5; 6-1,S,93,2,3,46,64,31,46,12,18,4,4,9,43,64,4,5,38,70,26,38,11,32,3,7,10,37,70
2003-05-19 00:00:00.000,St. Poelten Austria ATP World Tour,CLAY,2,Andy Roddick,Nikolay Davydenko,Andy Roddick,6-3; 6-2,F,64,3,1,33,52,25,33,11,19,1,2,9,36,52,1,1,42,50,21,42,4,8,3,7,8,25,50
2003-05-26 00:00:00.000,Roland Garros France Grand Slams,CLAY,3,Lleyton Hewitt,Brian Vahaly,Lleyton Hewitt,6-4; 6-1; 6-7(6); 6-3,R128,193,2,12,54,115,43,54,30,61,3,7,18,73,115,1,6,105,164,53,105,29,59,10,20,20,82,164
2003-05-26 00:00:00.000,Roland Garros France Grand Slams,CLAY,3,Nikolay Davydenko,Greg Rusedski,Nikolay Davydenko,6-3; 7-5; 6-2,R128,116,1,1,60,95,43,60,21,35,4,5,15,64,95,5,3,48,86,31,48,17,38,7,12,14,48,86
2003-05-26 00:00:00.000,Roland Garros France Grand Slams,CLAY,3,Jonas Bjorkman,Max Mirnyi,Jonas Bjorkman,6-1; 6-2; 6-4,R128,102,2,1,41,80,30,41,28,39,1,1,13,58,80,15,4,44,81,34,44,9,37,4,9,12,43,81
2003-05-26 00:00:00.000,Roland Garros France Grand Slams,CLAY,3,Tommy Robredo,Giovanni Lapentti,Tommy Robredo,3-6; 7-6(3); 3-6; 3-1 RET,R128,163,5,4,78,110,51,78,10,32,10,16,16,61,110,3,8,74,128,48,74,27,54,9,14,18,75,128
2003-05-26 00:00:00.000,Roland Garros France Grand Slams,CLAY,3,Gaston Gaudio,Paul-Henri Mathieu,Gaston Gaudio,7-5; 6-3; 6-3,R128,131,6,4,50,90,40,50,22,40,4,5,15,62,90,1,2,43,92,34,43,21,49,4,9,15,55,92
2003-05-26 00:00:00.000,Roland Garros France Grand Slams,CLAY,3,Olivier Mutis,Jerome Golmard,Olivier Mutis,6-2; 6-7(5); 6-2; 6-3,R128,151,12,4,53,107,44,53,32,54,1,4,19,76,107,6,15,64,130,41,64,28,66,11,19,18,69,130
2003-05-26 00:00:00.000,Roland Garros France Grand Slams,CLAY,3,Hicham Arazi,Raemon Sluiter,Hicham Arazi,6-2; 7-6(3); 2-6; 6-0,R128,142,5,4,68,117,52,68,24,49,7,10,17,76,117,10,5,61,123,38,61,30,62,6,12,17,68,123
2003-05-26 00:00:00.000,Roland Garros France Grand Slams,CLAY,3,Gustavo Kuerten,Marc Rosset,Gustavo Kuerten,6-2; 6-7(3); 6-3; 7-6(3),R128,183,12,9,74,147,59,74,40,73,7,9,21,99,147,15,15,72,139,59,72,26,67,8,13,20,85,139
2003-05-26 00:00:00.000,Roland Garros France Grand Slams,CLAY,3,Albert Costa,Sergio Roitman,Albert Costa,6-7(3); 2-6; 7-5; 6-2; 6-2,R128,218,8,5,112,158,80,112,20,46,10,15,24,100,158,7,6,91,162,60,91,30,71,11,19,24,90,162
2003-05-26 00:00:00.000,Roland Garros France Grand Slams,CLAY,3,Radek Stepanek,Wayne Arthurs,Radek Stepanek,6-1; 4-6; 6-1; 7-6(2),R128,140,9,1,83,114,61,83,21,31,2,3,18,82,114,20,10,73,134,50,73,25,61,10,15,18,75,134
2003-05-26 00:00:00.000,Roland Garros France Grand Slams,CLAY,3,Nicolas Lapentti,Richard Gasquet,Nicolas Lapentti,6-3; 7-6(4); 3-0 RET,R128,132,5,0,40,78,32,40,19,38,3,4,11,51,78,2,5,38,79,26,38,18,41,4,9,13,44,79
2003-05-26 00:00:00.000,Roland Garros France Grand Slams,CLAY,3,Franco Squillari,Agustin Calleri,Franco Squillari,7-5; 7-6(2); 6-3,R128,139,10,3,64,107,47,64,25,43,8,10,16,72,107,4,3,60,107,43,60,22,47,3,8,17,65,107
2003-05-26 00:00:00.000,Roland Garros France Grand Slams,CLAY,3,Arnaud Clement,Thomas Enqvist,Arnaud Clement,6-3; 6-4; 6-2,R128,138,11,2,43,88,31,43,23,45,2,5,14,54,88,3,10,49,100,31,49,19,51,6,13,13,50,100
2003-05-26 00:00:00.000,Roland Garros France Grand Slams,CLAY,3,Lars Burgsmuller,Mardy Fish,Lars Burgsmuller,7-6(3); 6-2; 4-6; 6-1,R128,158,7,3,72,115,56,72,26,43,4,6,19,82,115,16,8,62,129,48,62,29,67,3,8,18,77,129
2003-05-26 00:00:00.000,Roland Garros France Grand Slams,CLAY,3,Nicolas Coutelot,Davide Sanguinetti,Nicolas Coutelot,6-3; 6-3; 6-4,R128,94,3,8,49,78,44,49,13,29,1,2,14,57,78,5,5,55,96,36,55,18,41,6,11,14,54,96
2003-05-26 00:00:00.000,Roland Garros France Grand Slams,CLAY,3,David Nalbandian,Albert Montanes,David Nalbandian,6-4; 6-3; 3-6; 7-5,R128,163,11,9,75,133,54,75,24,58,13,19,20,78,133,4,9,76,132,54,76,16,56,9,17,20,70,132
2003-05-26 00:00:00.000,Roland Garros France Grand Slams,CLAY,3,Juan Carlos Ferrero,Michel Kratochvil,Juan Carlos Ferrero,7-5; 7-5; 6-4,R128,143,6,5,48,95,35,48,26,47,1,4,17,61,95,3,2,66,114,41,66,25,48,7,13,17,66,114
2003-05-26 00:00:00.000,Roland Garros France Grand Slams,CLAY,3,Nicolas Massu,Magnus Norman,Nicolas Massu,6-4; 6-1; 6-3,R128,161,4,5,44,73,33,44,17,29,4,6,13,50,73,7,2,60,124,37,60,24,64,14,21,13,61,124
2003-05-26 00:00:00.000,Roland Garros France Grand Slams,CLAY,3,Todd Martin,Jose Acasuso,Todd Martin,4-6; 6-3; 6-4; 6-2,R128,146,7,7,53,96,43,53,23,43,1,5,19,66,96,9,11,73,129,49,73,19,56,9,16,18,68,129
2003-05-26 00:00:00.000,Roland Garros France Grand Slams,CLAY,3,Tim Henman,Vladimir Voltchkov,Tim Henman,6-2; 6-3; 6-1,R128,100,7,3,51,84,41,51,15,33,5,6,12,56,84,1,4,47,74,24,47,10,27,4,11,12,34,74
2003-05-26 00:00:00.000,Roland Garros France Grand Slams,CLAY,3,Felix Mantilla,Hyung-Taik Lee,Felix Mantilla,7-6(3); 6-4; 7-6(4),R128,153,2,1,98,129,63,98,13,31,14,20,17,76,129,4,2,82,116,46,82,17,34,6,13,17,63,116
2003-05-26 00:00:00.000,Roland Garros France Grand Slams,CLAY,3,Federico Browne,Olivier Rochus,Federico Browne,4-6; 2-6; 6-1; 6-1; 6-3,R128,164,11,3,87,120,66,87,17,33,8,11,21,83,120,0,3,80,128,44,80,28,48,9,15,20,72,128
2003-05-26 00:00:00.000,Roland Garros France Grand Slams,CLAY,3,Fernando Vicente,Alexander Waske,Fernando Vicente,3-6; 6-2; 7-5; 1-6; 6-3,R128,182,9,10,83,158,62,83,29,75,8,14,23,91,158,13,9,71,134,50,71,32,63,7,13,22,82,134
2003-05-26 00:00:00.000,Roland Garros France Grand Slams,CLAY,3,Sebastien Grosjean,Adrian Voinea,Sebastien Grosjean,6-4; 7-6(3); 3-6; 6-3,R128,197,1,1,66,139,45,66,35,73,8,15,20,80,139,5,8,72,143,37,72,41,71,16,24,20,78,143
2003-05-26 00:00:00.000,Roland Garros France Grand Slams,CLAY,3,Sjeng Schalken,Scott Draper,Sjeng Schalken,6-2; 6-4; 3-6; 6-4,R128,140,7,6,75,117,48,75,24,42,7,11,18,72,117,4,2,66,112,40,66,22,46,9,16,19,62,112
2003-05-26 00:00:00.000,Roland Garros France Grand Slams,CLAY,3,Fabrice Santoro,Michael Chang,Fabrice Santoro,7-5; 6-1; 6-1,R128,125,4,0,52,84,38,52,18,32,3,4,13,56,84,1,2,47,91,27,47,17,44,5,12,13,44,91
2003-05-26 00:00:00.000,Roland Garros France Grand Slams,CLAY,3,Albert Portas,Thierry Ascione,Albert Portas,3-6; 6-2; 6-4; 6-4,R128,153,5,5,84,113,52,84,11,29,3,11,18,63,113,1,5,110,140,54,110,10,30,17,28,19,64,140
2003-05-26 00:00:00.000,Roland Garros France Grand Slams,CLAY,3,Fernando Gonzalez,Jan-Michael Gambill,Fernando Gonzalez,6-0; 6-2; 6-3,R128,92,4,2,46,65,35,46,12,19,1,1,11,47,65,3,4,43,79,26,43,12,36,7,14,12,38,79
2003-05-26 00:00:00.000,Roland Garros France Grand Slams,CLAY,3,Jarkko Nieminen,Nicolas Escude,Jarkko Nieminen,7-6(3); 6-7(4); 6-3; 6-1,R128,187,2,0,112,154,79,112,19,42,12,14,20,98,154,11,6,69,133,52,69,27,64,3,9,20,79,133
2003-05-26 00:00:00.000,Roland Garros France Grand Slams,CLAY,3,Julien Varlet,Kenneth Carlsen,Julien Varlet,6-1; 4-6; 6-3; 7-6(5),R128,160,3,7,84,122,58,84,25,38,9,12,19,83,122,9,6,71,126,47,71,26,55,8,14,19,73,126
2003-05-26 00:00:00.000,Roland Garros France Grand Slams,CLAY,3,Victor Hanescu,Michael Llodra,Victor Hanescu,6-4; 6-3; 6-2,R128,85,7,4,44,69,33,44,16,25,1,3,13,49,69,4,3,56,92,36,56,10,36,5,12,14,46,92
2003-05-26 00:00:00.000,Roland Garros France Grand Slams,CLAY,3,Sargis Sargsian,Andy Roddick,Sargis Sargsian,6-7(3); 6-1; 6-2; 6-4,R128,140,11,2,68,108,57,68,22,40,4,5,19,79,108,7,5,62,119,43,62,25,57,9,15,18,68,119
2003-05-26 00:00:00.000,Roland Garros France Grand Slams,CLAY,3,Luis Horna,Roger Federer,Luis Horna,7-6(6); 6-2; 7-6(3),R128,131,4,2,86,111,60,86,15,25,4,6,16,75,111,10,4,59,103,45,59,18,44,4,8,16,63,103
2003-05-26 00:00:00.000,Roland Garros France Grand Slams,CLAY,3,Martin Verkerk,Zeljko Krajan,Martin Verkerk,6-3; 6-4; 6-4,R128,99,10,4,47,82,37,47,23,35,0,1,15,60,82,6,1,46,73,27,46,17,27,1,5,14,44,73
2003-05-26 00:00:00.000,Roland Garros France Grand Slams,CLAY,3,John van Lottum,Dick Norman,John van Lottum,6-3; 3-6; 2-6; 6-3; 6-4,R128,188,5,10,80,158,57,80,36,78,14,20,23,93,158,16,8,94,156,57,94,35,62,9,15,22,92,156
2003-05-26 00:00:00.000,Roland Garros France Grand Slams,CLAY,3,Vincent Spadea,Irakli Labadze,Vincent Spadea,6-1; 3-6; 5-7; 6-4; 6-1,R128,199,3,1,80,141,54,80,31,61,13,20,23,85,141,7,15,105,162,67,105,18,57,18,28,22,85,162
2003-05-26 00:00:00.000,Roland Garros France Grand Slams,CLAY,3,Wayne Ferreira,Tomas Behrend,Wayne Ferreira,6-4; 6-2; 6-3,R128,98,10,2,40,81,36,40,26,41,2,2,14,62,81,1,7,52,89,34,52,17,37,3,7,13,51,89
2003-05-26 00:00:00.000,Roland Garros France Grand Slams,CLAY,3,David Ferrer,Jurgen Melzer,David Ferrer,6-2; 6-2; 7-6(2),R128,105,2,4,54,93,38,54,26,39,4,5,14,64,93,0,5,47,87,29,47,20,40,1,6,14,49,87
2003-05-26 00:00:00.000,Roland Garros France Grand Slams,CLAY,3,Jean-Rene Lisnard,Mariano Delfino,Jean-Rene Lisnard,6-1; 6-4; 4-6; 6-4,R128,187,3,2,61,119,40,61,32,58,7,11,18,72,119,2,5,100,152,54,100,28,52,15,23,19,82,152
2003-05-26 00:00:00.000,Roland Garros France Grand Slams,CLAY,3,Rainer Schuettler,Cecil Mamiit,Rainer Schuettler,6-1; 2-6; 6-4; 6-2,R128,151,4,4,63,105,39,63,24,42,0,5,17,63,105,0,6,48,100,25,48,25,52,6,14,16,50,100
2003-05-26 00:00:00.000,Roland Garros France Grand Slams,CLAY,3,Jiri Novak,Julien Benneteau,Jiri Novak,6-2; 6-3; 6-2,R128,83,1,0,50,74,38,50,13,24,5,7,13,51,74,0,5,41,67,22,41,11,26,5,12,12,33,67
2003-05-26 00:00:00.000,Roland Garros France Grand Slams,CLAY,3,Marc Lopez,Nicolas Mahut,Marc Lopez,7-5; 6-1; 7-6(5),R128,156,0,1,86,108,54,86,11,22,8,11,15,65,108,5,7,48,97,33,48,21,49,3,10,16,54,97
2003-05-26 00:00:00.000,Roland Garros France Grand Slams,CLAY,3,Ivan Ljubicic,Karol Kucera,Ivan Ljubicic,6-2; 6-3; 6-2,R128,100,15,3,51,83,38,51,20,32,1,1,13,58,83,2,12,49,79,34,49,10,30,8,13,12,44,79
2003-05-26 00:00:00.000,Roland Garros France Grand Slams,CLAY,3,James Blake,Taylor Dent,James Blake,6-4; 6-3; 7-6(3),R128,115,2,4,65,105,45,65,20,40,7,10,15,65,105,6,6,63,113,39,63,24,50,7,13,16,63,113
2003-05-26 00:00:00.000,Roland Garros France Grand Slams,CLAY,3,Juan Ignacio Chela,Cyril Saulnier,Juan Ignacio Chela,3-6; 7-6(3); 6-3; 7-5,R128,207,6,10,68,128,51,68,28,60,4,10,20,79,128,6,9,93,168,61,93,30,75,17,25,22,91,168
2003-05-26 00:00:00.000,Roland Garros France Grand Slams,CLAY,3,Giorgio Galimberti,Ivo Heuberger,Giorgio Galimberti,7-6(5); 4-6; 6-2; 6-2,R128,160,0,5,88,132,60,88,23,44,3,6,19,83,132,16,6,57,126,46,57,26,69,8,14,19,72,126
2003-05-26 00:00:00.000,Roland Garros France Grand Slams,CLAY,3,Mark Philippoussis,Alex Kim,Mark Philippoussis,2-6; 6-7(1); 7-5; 6-2; 6-2,R128,185,25,6,84,145,59,84,32,61,4,9,24,91,145,5,9,92,157,60,92,33,65,10,18,24,93,157
2003-05-26 00:00:00.000,Roland Garros France Grand Slams,CLAY,3,Carlos Moya,Filippo Volandri,Carlos Moya,7-6(7); 4-6; 6-2; 6-3,R128,158,10,5,65,135,44,65,38,70,8,12,19,82,135,1,5,100,137,64,100,14,37,7,14,20,78,137
2003-05-26 00:00:00.000,Roland Garros France Grand Slams,CLAY,3,Guillermo Coria,Andre Sa,Guillermo Coria,6-3; 6-1; 6-1,R128,94,4,2,38,57,29,38,12,19,3,4,11,41,57,0,4,52,86,26,52,13,34,9,17,12,39,86
2003-05-26 00:00:00.000,Roland Garros France Grand Slams,CLAY,3,Nicolas Kiefer,Todd Larkham,Nicolas Kiefer,6-3; 6-3; 4-6; 2-6; 6-3,R128,223,11,10,75,151,55,75,32,76,11,19,23,87,151,7,9,106,170,62,106,30,64,15,24,22,92,170
2003-05-26 00:00:00.000,Roland Garros France Grand Slams,CLAY,3,Attila Savolt,Andreas Vinciguerra,Attila Savolt,7-5; 7-6(4); 4-6; 6-0,R128,185,16,12,71,128,55,71,28,57,6,10,20,83,128,1,8,67,131,45,67,29,64,16,23,20,74,131
2003-05-26 00:00:00.000,Roland Garros France Grand Slams,CLAY,3,Mikhail Youzhny,David Sanchez,Mikhail Youzhny,6-3; 6-0; 6-0,R128,93,4,0,36,71,23,36,22,35,5,7,10,45,71,1,1,33,73,14,33,11,40,8,18,11,25,73
2003-05-26 00:00:00.000,Roland Garros France Grand Slams,CLAY,3,Younes El Aynaoui,Antony Dupuis,Younes El Aynaoui,6-4; 6-4; 6-4,R128,143,6,3,57,99,43,57,22,42,5,7,15,65,99,7,2,58,98,38,58,20,40,6,11,15,58,98
2003-05-26 00:00:00.000,Roland Garros France Grand Slams,CLAY,3,Christophe Rochus,Hermes Gamonal,Christophe Rochus,7-5; 6-3; 6-3,R128,130,1,4,94,122,57,94,12,28,16,21,15,69,122,3,5,64,92,35,64,9,28,9,18,15,44,92
2003-05-26 00:00:00.000,Roland Garros France Grand Slams,CLAY,3,Mariano Zabaleta,Feliciano Lopez,Mariano Zabaleta,6-2; 7-6(8); 6-0,R128,96,1,5,52,79,41,52,16,27,0,1,13,57,79,4,6,48,84,27,48,17,36,3,9,13,44,84
2003-05-26 00:00:00.000,Roland Garros France Grand Slams,CLAY,3,Dominik Hrbaty,Paradorn Srichaphan,Dominik Hrbaty,6-4; 3-6; 6-0; 7-5,R128,133,3,2,67,112,50,67,22,45,5,8,18,72,112,2,14,44,114,29,44,34,70,7,14,19,63,114
2003-05-26 00:00:00.000,Roland Garros France Grand Slams,CLAY,3,Galo Blanco,Alex Corretja,Galo Blanco,5-7; 6-3; 6-0; 7-5,R128,188,12,5,66,120,45,66,25,54,6,12,19,70,120,8,6,56,126,32,56,30,70,8,19,20,62,126
2003-05-26 00:00:00.000,Roland Garros France Grand Slams,CLAY,3,Mariano Puerta,Justin Gimelstob,Mariano Puerta,6-2; 4-6; 7-6(1); 6-1,R128,149,5,4,70,104,51,70,17,34,4,9,18,68,104,6,8,59,115,37,59,17,56,3,12,19,54,115
2003-05-26 00:00:00.000,Roland Garros France Grand Slams,CLAY,3,Flavio Saretta,Alberto Martin,Flavio Saretta,7-6(4); 6-0; 6-0,R128,102,5,3,42,70,30,42,18,28,1,2,12,48,70,1,7,53,86,23,53,14,33,12,19,12,37,86
2003-05-26 00:00:00.000,Roland Garros France Grand Slams,CLAY,3,Yevgeny Kafelnikov,Julien Boutter,Yevgeny Kafelnikov,6-1; 6-2; 6-4,R128,99,3,3,46,71,39,46,12,25,0,1,13,51,71,9,10,43,87,27,43,15,44,7,13,12,42,87
2003-05-26 00:00:00.000,Roland Garros France Grand Slams,CLAY,3,Xavier Malisse,Alex Calatrava,Xavier Malisse,7-5; 6-4; 6-2,R128,137,17,2,56,92,45,56,18,36,4,6,15,63,92,4,5,70,127,36,70,31,57,14,20,15,67,127
2003-05-26 00:00:00.000,Roland Garros France Grand Slams,CLAY,3,Stefan Koubek,Alexander Popp,Stefan Koubek,7-5; 6-2; 6-3,R128,99,2,4,58,94,39,58,20,36,4,7,15,59,94,0,9,51,88,28,51,16,37,6,13,14,44,88
2003-05-26 00:00:00.000,Roland Garros France Grand Slams,CLAY,3,Mario Ancic,Marcelo Rios,Mario Ancic,6-1; 1-0 RET,R128,36,1,0,8,23,7,8,11,15,2,2,4,18,23,0,1,16,31,9,16,4,15,2,5,4,13,31
2003-05-26 00:00:00.000,Roland Garros France Grand Slams,CLAY,3,Andre Agassi,Karol Beck,Andre Agassi,6-2; 6-3; 6-3,R128,95,4,5,37,82,26,37,29,45,2,3,13,55,82,6,3,45,80,26,45,15,35,6,12,13,41,80
2003-05-26 00:00:00.000,Roland Garros France Grand Slams,CLAY,3,Lleyton Hewitt,Nikolay Davydenko,Lleyton Hewitt,6-3; 4-6; 6-3; 7-6(5),R64,210,6,10,65,142,43,65,31,77,8,17,20,74,142,6,6,91,142,46,91,22,51,13,24,20,68,142
2003-05-26 00:00:00.000,Roland Garros France Grand Slams,CLAY,3,Tommy Robredo,Jonas Bjorkman,Tommy Robredo,7-6(2); 6-3; 6-4,R64,135,5,5,65,108,53,65,21,43,7,8,16,74,108,3,0,44,89,35,44,23,45,2,5,15,58,89
2003-05-26 00:00:00.000,Roland Garros France Grand Slams,CLAY,3,Gaston Gaudio,Olivier Mutis,Gaston Gaudio,6-2; 1-6; 6-2; 6-2,R64,138,3,0,49,80,33,49,17,31,3,7,15,50,80,7,5,51,116,35,51,21,65,9,17,16,56,116
2003-05-26 00:00:00.000,Roland Garros France Grand Slams,CLAY,3,Gustavo Kuerten,Hicham Arazi,Gustavo Kuerten,6-1; 6-0; 6-1,R64,82,7,0,31,59,25,31,17,28,2,2,10,42,59,0,0,36,72,13,36,15,36,7,15,10,28,72
2003-05-26 00:00:00.000,Roland Garros France Grand Slams,CLAY,3,Albert Costa,Radek Stepanek,Albert Costa,6-3; 5-7; 6-4; 3-6; 6-4,R64,218,9,4,90,150,64,90,36,60,6,10,25,100,150,11,4,98,151,71,98,23,53,4,9,25,94,151
2003-05-26 00:00:00.000,Roland Garros France Grand Slams,CLAY,3,Nicolas Lapentti,Franco Squillari,Nicolas Lapentti,4-6; 6-1; 6-4; 6-3,R64,184,7,0,66,110,50,66,22,44,10,13,18,72,110,3,7,66,128,41,66,29,62,12,19,18,70,128
2003-05-26 00:00:00.000,Roland Garros France Grand Slams,CLAY,3,Arnaud Clement,Lars Burgsmuller,Arnaud Clement,6-3; 6-3; 6-3,R64,132,3,1,44,84,34,44,23,40,1,2,14,57,84,1,4,43,78,29,43,14,35,5,10,13,43,78
2003-05-26 00:00:00.000,Roland Garros France Grand Slams,CLAY,3,Nicolas Coutelot,David Nalbandian,Nicolas Coutelot,6-3; 6-3; 4-6; 2-6; 6-1,R64,171,13,2,68,135,49,68,32,67,7,13,22,81,135,2,2,58,109,33,58,27,51,1,9,21,60,109
2003-05-26 00:00:00.000,Roland Garros France Grand Slams,CLAY,3,Juan Carlos Ferrero,Nicolas Massu,Juan Carlos Ferrero,6-2; 3-0 RET,R64,42,1,1,10,26,9,10,11,16,0,0,5,20,26,5,3,16,34,12,16,3,18,2,6,6,15,34
2003-05-26 00:00:00.000,Roland Garros France Grand Slams,CLAY,3,Tim Henman,Todd Martin,Tim Henman,7-6(5); 5-7; 6-1; 7-5,R64,207,9,3,103,153,71,103,23,50,5,10,22,94,153,5,5,81,151,56,81,29,70,8,15,21,85,151
2003-05-26 00:00:00.000,Roland Garros France Grand Slams,CLAY,3,Felix Mantilla,Federico Browne,Felix Mantilla,6-3; 4-6; 6-3; 6-1,R64,138,6,3,73,105,55,73,13,32,10,13,17,68,105,3,2,75,109,43,75,14,34,3,11,18,57,109
2003-05-26 00:00:00.000,Roland Garros France Grand Slams,CLAY,3,Fernando Vicente,Sebastien Grosjean,Fernando Vicente,7-6(3); 6-3; 6-3,R64,132,9,3,45,92,38,45,29,47,3,4,15,67,92,3,0,49,91,35,49,20,42,0,4,15,55,91
2003-05-26 00:00:00.000,Roland Garros France Grand Slams,CLAY,3,Sjeng Schalken,Fabrice Santoro,Sjeng Schalken,6-1; 6-3; 6-4,R64,111,0,1,52,76,38,52,14,24,4,6,13,52,76,3,0,46,80,22,46,16,34,2,9,13,38,80
2003-05-26 00:00:00.000,Roland Garros France Grand Slams,CLAY,3,Fernando Gonzalez,Albert Portas,Fernando Gonzalez,6-3; 4-6; 6-4; 6-2,R64,147,12,3,63,104,45,63,21,41,0,4,19,66,104,2,5,75,114,47,75,19,39,8,15,18,66,114
2003-05-26 00:00:00.000,Roland Garros France Grand Slams,CLAY,3,Jarkko Nieminen,Julien Varlet,Jarkko Nieminen,1-6; 1-6; 7-6(4); 6-2; 6-4,R64,192,4,2,97,137,60,97,16,40,11,20,22,76,137,2,5,94,141,57,94,27,47,6,13,22,84,141
2003-05-26 00:00:00.000,Roland Garros France Grand Slams,CLAY,3,Victor Hanescu,Sargis Sargsian,Victor Hanescu,6-3; 7-5; 3-6; 6-2,R64,145,3,2,78,115,54,78,21,37,5,8,19,75,115,2,4,79,117,53,79,16,38,11,17,19,69,117
2003-05-26 00:00:00.000,Roland Garros France Grand Slams,CLAY,3,Martin Verkerk,Luis Horna,Martin Verkerk,4-6; 6-4; 4-6; 7-5; 6-2,R64,170,22,9,78,136,63,78,25,58,6,12,25,88,136,2,3,97,134,64,97,19,37,4,12,25,83,134
2003-05-26 00:00:00.000,Roland Garros France Grand Slams,CLAY,3,Vincent Spadea,John van Lottum,Vincent Spadea,7-5; 6-1; 2-6; 6-1,R64,115,5,4,54,86,45,54,20,32,0,2,17,65,86,7,10,59,106,40,59,20,47,7,13,17,60,106
2003-05-26 00:00:00.000,Roland Garros France Grand Slams,CLAY,3,Wayne Ferreira,David Ferrer,Wayne Ferreira,4-6; 6-4; 6-1; 6-3,R64,158,6,5,58,123,44,58,28,65,7,11,18,72,123,1,6,71,129,39,71,27,58,6,14,18,66,129
2003-05-26 00:00:00.000,Roland Garros France Grand Slams,CLAY,3,Rainer Schuettler,Jean-Rene Lisnard,Rainer Schuettler,4-6; 6-2; 6-4; 6-0,R64,166,2,11,81,127,52,81,22,46,9,13,18,74,127,4,5,48,109,32,48,23,61,6,14,16,55,109
2003-05-26 00:00:00.000,Roland Garros France Grand Slams,CLAY,3,Jiri Novak,Marc Lopez,Jiri Novak,6-4; 3-6; 0-6; 6-1; 6-3,R64,167,6,4,81,119,53,81,18,38,2,8,20,71,119,0,5,70,131,44,70,31,61,10,17,21,75,131
2003-05-26 00:00:00.000,Roland Garros France Grand Slams,CLAY,3,Ivan Ljubicic,James Blake,Ivan Ljubicic,6-3; 4-6; 7-6(2); 6-4,R64,145,15,1,58,111,49,58,33,53,1,4,21,82,111,3,1,80,126,56,80,23,46,3,7,20,79,126
2003-05-26 00:00:00.000,Roland Garros France Grand Slams,CLAY,3,Juan Ignacio Chela,Giorgio Galimberti,Juan Ignacio Chela,6-2; 5-7; 6-2; 6-1,R64,142,7,5,61,104,44,61,24,43,5,9,18,68,104,3,8,67,117,35,67,22,50,9,18,17,57,117
2003-05-26 00:00:00.000,Roland Garros France Grand Slams,CLAY,3,Carlos Moya,Mark Philippoussis,Carlos Moya,6-2; 6-4; 7-6(7),R64,128,15,7,48,98,42,48,26,50,7,9,15,68,98,6,4,64,100,40,64,18,36,1,6,15,58,100
2003-05-26 00:00:00.000,Roland Garros France Grand Slams,CLAY,3,Guillermo Coria,Nicolas Kiefer,Guillermo Coria,6-3; 5-7; 6-3; 6-1,R64,190,1,6,67,104,48,67,21,37,7,11,18,69,104,7,7,48,121,31,48,30,73,10,19,19,61,121
2003-05-26 00:00:00.000,Roland Garros France Grand Slams,CLAY,3,Attila Savolt,Mikhail Youzhny,Attila Savolt,3-6; 6-4; 5-7; 6-2; 6-4,R64,259,0,12,72,168,53,72,43,96,9,16,25,96,168,8,6,76,162,48,76,47,86,14,22,24,95,162
2003-05-26 00:00:00.000,Roland Garros France Grand Slams,CLAY,3,Younes El Aynaoui,Christophe Rochus,Younes El Aynaoui,6-4; 6-4; 6-3,R64,103,14,5,41,72,38,41,19,31,1,1,14,57,72,0,2,75,101,45,75,16,26,9,13,15,61,101
2003-05-26 00:00:00.000,Roland Garros France Grand Slams,CLAY,3,Mariano Zabaleta,Dominik Hrbaty,Mariano Zabaleta,6-2; 6-4; 6-2,R64,117,7,3,47,87,28,47,20,40,3,8,13,48,87,2,6,52,99,27,52,15,47,13,23,13,42,99
2003-05-26 00:00:00.000,Roland Garros France Grand Slams,CLAY,3,Galo Blanco,Mariano Puerta,Galo Blanco,6-2; 6-2; 6-4,R64,101,9,1,40,70,34,40,20,30,2,2,13,54,70,4,4,34,68,25,34,15,34,5,10,13,40,68
2003-05-26 00:00:00.000,Roland Garros France Grand Slams,CLAY,3,Flavio Saretta,Yevgeny Kafelnikov,Flavio Saretta,6-4; 3-6; 6-0; 6-7(0); 6-4,R64,235,8,2,94,148,57,94,36,54,7,11,23,93,148,1,9,96,169,64,96,31,73,13,21,24,95,169
2003-05-26 00:00:00.000,Roland Garros France Grand Slams,CLAY,3,Xavier Malisse,Stefan Koubek,Xavier Malisse,3-6; 4-6; 6-4; 7-5; 8-6,R64,234,7,5,92,177,62,92,38,85,15,25,27,100,177,7,4,86,173,51,86,47,87,15,26,28,98,173
2003-05-26 00:00:00.000,Roland Garros France Grand Slams,CLAY,3,Andre Agassi,Mario Ancic,Andre Agassi,5-7; 1-6; 6-4; 6-2; 7-5,R64,193,8,4,83,145,53,83,29,62,4,13,24,82,145,12,10,80,150,50,80,34,70,10,20,25,84,150
2003-05-26 00:00:00.000,Roland Garros France Grand Slams,CLAY,3,Tommy Robredo,Lleyton Hewitt,Tommy Robredo,4-6; 1-6; 6-3; 6-2; 6-3,R32,204,4,2,94,134,57,94,19,40,4,10,21,76,134,3,12,69,145,49,69,33,76,14,22,22,82,145
2003-05-26 00:00:00.000,Roland Garros France Grand Slams,CLAY,3,Gustavo Kuerten,Gaston Gaudio,Gustavo Kuerten,7-6(1); 7-5; 5-7; 6-3,R32,216,12,3,72,159,57,72,42,87,7,11,23,99,159,4,9,86,138,62,86,20,52,7,12,22,82,138
2003-05-26 00:00:00.000,Roland Garros France Grand Slams,CLAY,3,Albert Costa,Nicolas Lapentti,Albert Costa,4-6; 4-6; 6-3; 6-4; 6-4,R32,279,2,6,108,174,75,108,32,66,12,16,25,107,174,9,6,84,149,55,84,40,65,11,16,24,95,149
2003-05-26 00:00:00.000,Roland Garros France Grand Slams,CLAY,3,Arnaud Clement,Nicolas Coutelot,Arnaud Clement,6-4; 6-3; 6-2,R32,126,4,2,47,75,36,47,18,28,2,3,13,54,75,5,10,49,107,28,49,27,58,13,19,14,55,107
2003-05-26 00:00:00.000,Roland Garros France Grand Slams,CLAY,3,Juan Carlos Ferrero,Tim Henman,Juan Carlos Ferrero,4-6; 6-2; 6-4; 6-2,R32,170,6,0,62,105,42,62,30,43,2,4,18,72,105,6,6,65,124,44,65,26,59,12,18,18,70,124
2003-05-26 00:00:00.000,Roland Garros France Grand Slams,CLAY,3,Felix Mantilla,Fernando Vicente,Felix Mantilla,7-6(3); 6-3; 6-3,R32,132,0,2,69,99,46,69,18,30,4,7,15,64,99,5,2,51,97,31,51,21,46,5,11,15,52,97
2003-05-26 00:00:00.000,Roland Garros France Grand Slams,CLAY,3,Fernando Gonzalez,Sjeng Schalken,Fernando Gonzalez,7-6(4); 6-3; 3-1 RET,R32,97,13,7,52,77,38,52,11,25,0,3,13,49,77,2,4,48,74,29,48,12,26,4,9,12,41,74
2003-05-26 00:00:00.000,Roland Garros France Grand Slams,CLAY,3,Jarkko Nieminen,Victor Hanescu,Jarkko Nieminen,6-7(1); 6-4; 6-2; 3-6; 6-3,R32,205,5,4,116,170,71,116,23,54,8,16,24,94,170,7,5,89,160,57,89,29,71,9,20,24,86,160
2003-05-26 00:00:00.000,Roland Garros France Grand Slams,CLAY,3,Martin Verkerk,Vincent Spadea,Martin Verkerk,5-7; 6-4; 6-2; 7-5,R32,176,12,11,64,118,52,64,23,54,7,12,21,75,118,4,4,68,124,42,68,28,56,9,17,21,70,124
2003-05-26 00:00:00.000,Roland Garros France Grand Slams,CLAY,3,Rainer Schuettler,Wayne Ferreira,Rainer Schuettler,6-3; 1-6; 7-6(3); 2-3 RET,R32,173,3,3,76,130,43,76,34,54,16,21,16,77,130,7,0,55,112,33,55,35,57,5,9,17,68,112
2003-05-26 00:00:00.000,Roland Garros France Grand Slams,CLAY,3,Jiri Novak,Ivan Ljubicic,Jiri Novak,6-4; 7-5; 3-6; 6-2,R32,156,9,1,79,115,58,79,19,36,8,11,19,77,115,21,7,72,136,55,72,25,64,11,17,20,80,136
2003-05-26 00:00:00.000,Roland Garros France Grand Slams,CLAY,3,Carlos Moya,Juan Ignacio Chela,Carlos Moya,6-2; 6-3; 3-6; 2-6; 6-3,R32,186,9,14,69,148,51,69,32,79,4,11,22,83,148,5,16,55,131,38,55,34,76,5,13,21,72,131
2003-05-26 00:00:00.000,Roland Garros France Grand Slams,CLAY,3,Guillermo Coria,Attila Savolt,Guillermo Coria,6-4; 6-1; 6-1,R32,120,1,0,37,60,27,37,19,23,2,3,12,46,60,5,4,33,87,20,33,22,54,9,16,12,42,87
2003-05-26 00:00:00.000,Roland Garros France Grand Slams,CLAY,3,Mariano Zabaleta,Younes El Aynaoui,Mariano Zabaleta,6-2; 6-4; 3-6; 7-6(2),R32,170,1,2,96,129,69,96,17,33,5,8,19,86,129,9,7,82,132,57,82,22,50,8,13,20,79,132
2003-05-26 00:00:00.000,Roland Garros France Grand Slams,CLAY,3,Flavio Saretta,Galo Blanco,Flavio Saretta,7-6(3); 6-2; 2-2 RET,R32,126,11,4,47,95,31,47,28,48,6,9,13,59,95,5,4,37,76,24,37,19,39,1,5,12,43,76
2003-05-26 00:00:00.000,Roland Garros France Grand Slams,CLAY,3,Andre Agassi,Xavier Malisse,Andre Agassi,6-4; 7-5; 7-5,R32,129,3,1,76,108,51,76,22,32,9,10,17,73,108,13,5,46,99,35,46,28,53,6,10,17,63,99
2003-05-26 00:00:00.000,Roland Garros France Grand Slams,CLAY,3,Tommy Robredo,Gustavo Kuerten,Tommy Robredo,6-4; 1-6; 7-6(2); 6-4,R16,166,0,4,89,122,58,89,18,33,4,9,19,76,122,5,6,81,147,54,81,31,66,14,19,20,85,147
2003-05-26 00:00:00.000,Roland Garros France Grand Slams,CLAY,3,Albert Costa,Arnaud Clement,Albert Costa,6-2; 7-5; 7-5,R16,187,11,2,74,115,52,74,20,41,12,14,16,72,115,4,3,58,118,36,58,29,60,9,15,16,65,118
2003-05-26 00:00:00.000,Roland Garros France Grand Slams,CLAY,3,Juan Carlos Ferrero,Felix Mantilla,Juan Carlos Ferrero,6-2; 6-1; 6-1,R16,100,5,3,30,57,26,30,18,27,1,2,11,44,57,1,2,49,88,26,49,12,39,9,17,11,38,88
2003-05-26 00:00:00.000,Roland Garros France Grand Slams,CLAY,3,Fernando Gonzalez,Jarkko Nieminen,Fernando Gonzalez,6-3; 6-3; 6-2,R16,92,5,2,39,70,30,39,19,31,0,1,13,49,70,4,1,61,85,34,61,11,24,3,9,13,45,85
2003-05-26 00:00:00.000,Roland Garros France Grand Slams,CLAY,3,Martin Verkerk,Rainer Schuettler,Martin Verkerk,6-3; 6-3; 7-5,R16,121,22,4,57,93,47,57,16,36,8,10,15,63,93,0,3,55,90,38,55,12,35,9,15,15,50,90
2003-05-26 00:00:00.000,Roland Garros France Grand Slams,CLAY,3,Carlos Moya,Jiri Novak,Carlos Moya,7-5; 6-3; 6-2,R16,103,13,7,48,97,39,48,26,49,8,9,15,65,97,2,5,54,97,33,54,20,43,7,12,14,53,97
2003-05-26 00:00:00.000,Roland Garros France Grand Slams,CLAY,3,Guillermo Coria,Mariano Zabaleta,Guillermo Coria,6-4; 7-6(4); 5-7; 6-7(4); 6-3,R16,281,0,5,136,204,83,136,36,68,12,20,27,119,204,7,7,95,173,62,95,38,78,4,14,28,100,173
2003-05-26 00:00:00.000,Roland Garros France Grand Slams,CLAY,3,Andre Agassi,Flavio Saretta,Andre Agassi,6-2; 6-1; 7-5,R16,104,5,2,49,72,37,49,11,23,1,3,13,48,72,0,1,62,87,33,62,8,25,9,17,14,41,87
2003-05-26 00:00:00.000,Roland Garros France Grand Slams,CLAY,3,Albert Costa,Tommy Robredo,Albert Costa,2-6; 3-6; 6-4; 7-5; 6-2,Q,209,4,5,96,142,64,96,22,46,10,17,24,86,142,4,6,113,147,70,113,15,34,9,16,23,85,147
2003-05-26 00:00:00.000,Roland Garros France Grand Slams,CLAY,3,Juan Carlos Ferrero,Fernando Gonzalez,Juan Carlos Ferrero,6-1; 3-6; 6-1; 5-7; 6-4,Q,209,13,4,81,141,55,81,37,60,3,8,23,92,141,5,15,80,166,51,80,38,86,21,29,22,89,166
2003-05-26 00:00:00.000,Roland Garros France Grand Slams,CLAY,3,Martin Verkerk,Carlos Moya,Martin Verkerk,6-3; 6-4; 5-7; 4-6; 8-6,Q,232,27,12,114,191,88,114,38,77,10,12,28,126,191,12,7,84,158,66,84,42,74,6,9,27,108,158
2003-05-26 00:00:00.000,Roland Garros France Grand Slams,CLAY,3,Guillermo Coria,Andre Agassi,Guillermo Coria,4-6; 6-3; 6-2; 6-4,Q,152,3,3,100,129,58,100,14,29,8,14,19,72,129,1,4,73,112,43,73,14,39,6,15,18,57,112
2003-05-26 00:00:00.000,Roland Garros France Grand Slams,CLAY,3,Juan Carlos Ferrero,Albert Costa,Juan Carlos Ferrero,6-3; 7-6(5); 6-4,S,164,7,4,54,97,41,54,22,43,2,4,15,63,97,6,7,63,116,42,63,23,53,8,13,16,65,116
2003-05-26 00:00:00.000,Roland Garros France Grand Slams,CLAY,3,Martin Verkerk,Guillermo Coria,Martin Verkerk,7-6(4); 6-4; 7-6(0),S,160,19,7,69,108,54,69,19,39,2,4,17,73,108,1,3,86,112,54,86,14,26,7,10,17,68,112
2003-05-26 00:00:00.000,Roland Garros France Grand Slams,CLAY,3,Juan Carlos Ferrero,Martin Verkerk,Juan Carlos Ferrero,6-1; 6-3; 6-2,F,129,2,5,39,70,32,39,17,31,3,4,12,49,70,12,7,47,100,31,47,16,53,15,22,12,47,100
2003-06-09 00:00:00.000,Halle Germany ATP World Tour,GRASS,2,Roger Federer,Sargis Sargsian,Roger Federer,7-5; 6-1,R32,81,6,1,36,61,27,36,14,25,1,2,10,41,61,3,10,36,73,24,36,14,37,5,9,9,38,73
2003-06-09 00:00:00.000,Halle Germany ATP World Tour,GRASS,2,Fernando Vicente,Hyung-Taik Lee,Fernando Vicente,6-4; 6-0,R32,72,3,1,47,75,30,47,17,28,9,9,8,47,75,1,1,31,47,18,31,7,16,2,6,8,25,47
2003-06-09 00:00:00.000,Halle Germany ATP World Tour,GRASS,2,Lars Burgsmuller,Jean-Claude Scherrer,Lars Burgsmuller,6-4; 5-7; 6-4,R32,139,5,4,59,105,51,59,22,46,3,4,16,73,105,5,1,63,102,43,63,25,39,9,11,16,68,102
2003-06-09 00:00:00.000,Halle Germany ATP World Tour,GRASS,2,Younes El Aynaoui,Christopher Koderisch,Younes El Aynaoui,6-1; 6-2,R32,49,3,0,27,42,21,27,11,15,0,0,8,32,42,2,3,30,53,15,30,10,23,4,8,7,25,53
2003-06-09 00:00:00.000,Halle Germany ATP World Tour,GRASS,2,Jiri Novak,Hendrik Dreekmann,Jiri Novak,6-2; 6-4,R32,63,5,0,35,45,30,35,7,10,0,0,9,37,45,4,3,42,67,26,42,11,25,6,9,9,37,67
2003-06-09 00:00:00.000,Halle Germany ATP World Tour,GRASS,2,Stefan Koubek,Yves Allegro,Stefan Koubek,6-4; 6-3,R32,73,3,2,33,65,24,33,17,32,4,6,10,41,65,3,9,29,58,22,29,8,29,5,9,9,30,58
2003-06-09 00:00:00.000,Halle Germany ATP World Tour,GRASS,2,Jonas Bjorkman,Maximilian Abel,Jonas Bjorkman,6-3; 6-4,R32,77,9,5,41,65,35,41,9,24,6,7,10,44,65,2,4,35,61,24,35,11,26,4,7,9,35,61
2003-06-09 00:00:00.000,Halle Germany ATP World Tour,GRASS,2,Mikhail Youzhny,Paul-Henri Mathieu,Mikhail Youzhny,1-6; 6-1; 5-2 RET,R32,91,8,2,34,55,24,34,14,21,3,5,10,38,55,4,5,43,80,31,43,14,37,2,6,11,45,80
2003-06-09 00:00:00.000,Halle Germany ATP World Tour,GRASS,2,Arnaud Clement,Frederic Niemeyer,Arnaud Clement,6-3; 6-0,R32,50,0,0,20,37,17,20,12,17,1,1,7,29,37,9,6,24,42,17,24,3,18,2,7,8,20,42
2003-06-09 00:00:00.000,Halle Germany ATP World Tour,GRASS,2,Ivan Ljubicic,David Prinosil,Ivan Ljubicic,7-6(5); 6-2,R32,82,10,5,44,65,35,44,10,21,3,3,10,45,65,4,6,34,63,24,34,14,29,0,2,10,38,63
2003-06-09 00:00:00.000,Halle Germany ATP World Tour,GRASS,2,Fabrice Santoro,Brian Vahaly,Fabrice Santoro,6-2; 4-6; 6-3,R32,115,0,1,68,87,50,68,7,19,8,10,14,57,87,1,2,57,83,37,57,15,26,10,14,13,52,83
2003-06-09 00:00:00.000,Halle Germany ATP World Tour,GRASS,2,Karol Kucera,Yevgeny Kafelnikov,Karol Kucera,6-1; 6-7(8); 7-6(5),R32,184,10,2,84,134,56,84,27,50,11,13,15,83,134,5,9,70,127,50,70,24,57,5,10,16,74,127
2003-06-09 00:00:00.000,Halle Germany ATP World Tour,GRASS,2,Feliciano Lopez,Nikolay Davydenko,Feliciano Lopez,7-6(5); 6-3,R32,73,6,4,36,54,32,36,12,18,0,0,10,44,54,3,3,37,73,24,37,23,36,5,7,11,47,73
2003-06-09 00:00:00.000,Halle Germany ATP World Tour,GRASS,2,Nicolas Kiefer,Olivier Rochus,Nicolas Kiefer,6-3; 6-0,R32,59,7,3,19,42,18,19,14,23,0,0,8,32,42,0,1,25,43,14,25,7,18,4,8,7,21,43
2003-06-09 00:00:00.000,Halle Germany ATP World Tour,GRASS,2,Radek Stepanek,Nicolas Escude,Radek Stepanek,3-6; 6-3; 3-0 RET,R32,85,5,1,44,58,31,44,9,14,1,2,10,40,58,5,3,44,75,28,44,16,31,7,10,11,44,75
2003-06-09 00:00:00.000,Halle Germany ATP World Tour,GRASS,2,Rainer Schuettler,Kenneth Carlsen,Rainer Schuettler,6-3; 6-4,R32,81,1,1,30,51,24,30,13,21,0,2,10,37,51,4,5,31,66,21,31,15,35,8,12,9,36,66
2003-06-09 00:00:00.000,Halle Germany ATP World Tour,GRASS,2,Roger Federer,Fernando Vicente,Roger Federer,4-6; 6-2; 6-1,R16,84,11,2,55,76,39,55,13,21,3,4,13,52,76,1,0,39,72,26,39,16,33,5,9,12,42,72
2003-06-09 00:00:00.000,Halle Germany ATP World Tour,GRASS,2,Younes El Aynaoui,Lars Burgsmuller,Younes El Aynaoui,6-3; 6-3,R16,75,8,0,38,58,30,38,8,20,6,7,9,38,58,4,3,29,57,20,29,10,28,3,7,9,30,57
2003-06-09 00:00:00.000,Halle Germany ATP World Tour,GRASS,2,Jiri Novak,Stefan Koubek,Jiri Novak,6-4; 6-3,R16,65,4,2,45,58,32,45,6,13,2,3,9,38,58,2,0,38,58,19,38,10,20,5,9,10,29,58
2003-06-09 00:00:00.000,Halle Germany ATP World Tour,GRASS,2,Mikhail Youzhny,Jonas Bjorkman,Mikhail Youzhny,6-4; 7-5,R16,102,3,1,46,81,32,46,19,35,3,4,11,51,81,7,1,38,64,28,38,13,26,3,6,11,41,64
2003-06-09 00:00:00.000,Halle Germany ATP World Tour,GRASS,2,Arnaud Clement,Ivan Ljubicic,Arnaud Clement,6-4; 6-2,R16,65,5,2,25,44,22,25,14,19,0,0,9,36,44,10,4,31,48,25,31,5,17,0,3,9,30,48
2003-06-09 00:00:00.000,Halle Germany ATP World Tour,GRASS,2,Karol Kucera,Fabrice Santoro,Karol Kucera,6-3; 6-3,R16,71,1,1,31,54,21,31,14,23,3,5,9,35,54,0,0,44,49,21,44,3,5,0,5,9,24,49
2003-06-09 00:00:00.000,Halle Germany ATP World Tour,GRASS,2,Nicolas Kiefer,Feliciano Lopez,Nicolas Kiefer,6-1; 3-6; 7-5,R16,112,5,5,49,90,40,49,19,41,9,11,14,59,90,11,6,45,78,34,45,12,33,3,7,14,46,78
2003-06-09 00:00:00.000,Halle Germany ATP World Tour,GRASS,2,Radek Stepanek,Rainer Schuettler,Radek Stepanek,6-4; 6-7(6); 6-3,R16,128,8,1,62,98,51,62,20,36,0,0,16,71,98,5,2,61,98,49,61,17,37,4,6,15,66,98
2003-06-09 00:00:00.000,Halle Germany ATP World Tour,GRASS,2,Roger Federer,Younes El Aynaoui,Roger Federer,7-5; 7-6(3),Q,80,9,1,48,69,35,48,12,21,1,3,12,47,69,7,2,55,79,34,55,10,24,1,4,12,44,79
2003-06-09 00:00:00.000,Halle Germany ATP World Tour,GRASS,2,Mikhail Youzhny,Jiri Novak,Mikhail Youzhny,6-4; 6-4,Q,85,2,3,36,68,24,36,17,32,3,5,10,41,68,1,3,61,80,38,61,7,19,7,11,10,45,80
2003-06-09 00:00:00.000,Halle Germany ATP World Tour,GRASS,2,Arnaud Clement,Karol Kucera,Arnaud Clement,7-5; 6-7(5); 7-6(6),Q,203,13,3,96,139,68,96,19,43,9,12,18,87,139,7,7,75,129,55,75,24,54,5,9,18,79,129
2003-06-09 00:00:00.000,Halle Germany ATP World Tour,GRASS,2,Nicolas Kiefer,Radek Stepanek,Nicolas Kiefer,7-5; 6-3,Q,85,5,4,36,67,33,36,15,31,0,0,11,48,67,7,4,37,58,28,37,10,21,2,4,10,38,58
2003-06-09 00:00:00.000,Halle Germany ATP World Tour,GRASS,2,Roger Federer,Mikhail Youzhny,Roger Federer,4-6; 7-6(4); 6-2,S,145,12,4,60,90,47,60,14,30,2,4,15,61,90,4,2,96,145,56,96,25,49,18,21,15,81,145
2003-06-09 00:00:00.000,Halle Germany ATP World Tour,GRASS,2,Nicolas Kiefer,Arnaud Clement,Nicolas Kiefer,4-6; 7-6(4); 6-4,S,169,15,4,61,112,49,61,27,51,3,4,16,76,112,5,4,56,107,45,56,25,51,8,9,16,70,107
2003-06-09 00:00:00.000,Halle Germany ATP World Tour,GRASS,2,Roger Federer,Nicolas Kiefer,Roger Federer,6-1; 6-3,F,69,3,1,26,45,23,26,12,19,0,0,8,35,45,3,1,27,50,15,27,10,23,1,5,8,25,50
2003-06-09 00:00:00.000,London / Queen's Club England ATP World Tour,GRASS,2,Lleyton Hewitt,N/A Bye,Lleyton Hewitt,,R64,0,0,0,0,0,0,0,0,0,0,0,0,0,0,0,0,0,0,0,0,0,0,0,0,0,0,0
2003-06-09 00:00:00.000,London / Queen's Club England ATP World Tour,GRASS,2,Raemon Sluiter,Adrian Voinea,Raemon Sluiter,7-6(3); 6-3,R64,81,4,4,53,81,34,53,14,28,5,8,11,48,81,3,4,47,70,28,47,10,23,3,7,10,38,70
2003-06-09 00:00:00.000,London / Queen's Club England ATP World Tour,GRASS,2,Andre Sa,Gilles Elseneer,Andre Sa,6-2; 7-6(1),R64,80,1,2,39,70,23,39,23,31,6,7,10,46,70,4,1,44,65,25,44,11,21,3,6,10,36,65
2003-06-09 00:00:00.000,London / Queen's Club England ATP World Tour,GRASS,2,Dick Norman,Mardy Fish,Dick Norman,7-6(5); 7-6(3),R64,107,18,7,57,92,46,57,17,35,6,7,12,63,92,10,3,35,83,28,35,29,48,2,3,12,57,83
2003-06-09 00:00:00.000,London / Queen's Club England ATP World Tour,GRASS,2,Jan-Michael Gambill,Thomas Enqvist,Jan-Michael Gambill,7-6(5); 7-6(5),R64,101,12,5,46,81,41,46,15,35,0,2,12,56,81,7,4,48,79,36,48,18,31,1,3,12,54,79
2003-06-09 00:00:00.000,London / Queen's Club England ATP World Tour,GRASS,2,Todd Reid,Nicolas Mahut,Todd Reid,6-3; 7-5,R64,67,9,2,44,65,32,44,12,21,1,2,11,44,65,5,4,39,65,22,39,15,26,6,9,10,37,65
2003-06-09 00:00:00.000,London / Queen's Club England ATP World Tour,GRASS,2,Michel Kratochvil,Gregory Carraz,Michel Kratochvil,6-3; 7-5,R64,67,3,1,39,61,31,39,13,22,2,3,11,44,61,10,6,36,62,23,36,16,26,6,9,10,39,62
2003-06-09 00:00:00.000,London / Queen's Club England ATP World Tour,GRASS,2,Sebastien Grosjean,N/A Bye,Sebastien Grosjean,,R64,0,0,0,0,0,0,0,0,0,0,0,0,0,0,0,0,0,0,0,0,0,0,0,0,0,0,0
2003-06-09 00:00:00.000,London / Queen's Club England ATP World Tour,GRASS,2,Paradorn Srichaphan,N/A Bye,Paradorn Srichaphan,,R64,0,0,0,0,0,0,0,0,0,0,0,0,0,0,0,0,0,0,0,0,0,0,0,0,0,0,0
2003-06-09 00:00:00.000,London / Queen's Club England ATP World Tour,GRASS,2,Mario Ancic,Julian Knowle,Mario Ancic,6-2; 6-1,R64,56,9,2,25,47,19,25,14,22,0,0,8,33,47,0,4,19,38,12,19,7,19,0,4,7,19,38
2003-06-09 00:00:00.000,London / Queen's Club England ATP World Tour,GRASS,2,Alex Bogdanovic,Arvind Parmar,Alex Bogdanovic,6-7(3); 6-4; 7-6(2),R64,143,8,4,84,125,52,84,28,41,12,14,17,80,125,6,1,81,116,59,81,14,35,10,13,17,73,116
2003-06-09 00:00:00.000,London / Queen's Club England ATP World Tour,GRASS,2,Antony Dupuis,Wayne Arthurs,Antony Dupuis,6-4; 7-6(8),R64,89,5,2,52,78,38,52,17,26,4,5,11,55,78,15,5,49,81,34,49,18,32,3,5,11,52,81
2003-06-09 00:00:00.000,London / Queen's Club England ATP World Tour,GRASS,2,Max Mirnyi,George Bastl,Max Mirnyi,6-3; 6-4,R64,64,6,2,34,49,31,34,9,15,0,0,10,40,49,1,2,37,52,27,37,7,15,3,5,9,34,52
2003-06-09 00:00:00.000,London / Queen's Club England ATP World Tour,GRASS,2,Cyril Saulnier,Scott Draper,Cyril Saulnier,6-4; 6-4,R64,79,6,0,35,61,30,35,15,26,2,2,10,45,61,9,3,37,57,26,37,11,20,3,5,10,37,57
2003-06-09 00:00:00.000,London / Queen's Club England ATP World Tour,GRASS,2,Davide Sanguinetti,Alexander Waske,Davide Sanguinetti,7-6(5); 7-6(1),R64,94,6,3,43,71,37,43,18,28,0,0,12,55,71,18,4,50,78,33,50,20,28,0,0,12,53,78
2003-06-09 00:00:00.000,London / Queen's Club England ATP World Tour,GRASS,2,Tim Henman,N/A Bye,Tim Henman,,R64,0,0,0,0,0,0,0,0,0,0,0,0,0,0,0,0,0,0,0,0,0,0,0,0,0,0,0
2003-06-09 00:00:00.000,London / Queen's Club England ATP World Tour,GRASS,2,Sjeng Schalken,N/A Bye,Sjeng Schalken,,R64,0,0,0,0,0,0,0,0,0,0,0,0,0,0,0,0,0,0,0,0,0,0,0,0,0,0,0
2003-06-09 00:00:00.000,London / Queen's Club England ATP World Tour,GRASS,2,Todd Martin,Ricardo Mello,Todd Martin,6-2; 6-1,R64,47,4,7,32,51,27,32,9,19,3,3,8,36,51,1,1,26,35,13,26,4,9,0,4,7,17,35
2003-06-09 00:00:00.000,London / Queen's Club England ATP World Tour,GRASS,2,Cecil Mamiit,Olivier Mutis,Cecil Mamiit,6-4; 4-6; 6-3,R64,101,5,4,60,88,39,60,13,28,5,10,15,52,88,1,6,50,102,28,50,24,52,10,16,14,52,102
2003-06-09 00:00:00.000,London / Queen's Club England ATP World Tour,GRASS,2,Taylor Dent,Robert Kendrick,Taylor Dent,6-2; 7-5,R64,77,3,11,38,67,29,38,14,29,4,5,10,43,67,2,8,35,76,20,35,19,41,8,12,10,39,76
2003-06-09 00:00:00.000,London / Queen's Club England ATP World Tour,GRASS,2,Greg Rusedski,Robby Ginepri,Greg Rusedski,7-6(5); 3-6; 6-0,R64,91,17,5,49,75,41,49,14,26,3,5,13,55,75,6,3,69,103,42,69,18,34,6,10,14,60,103
2003-06-09 00:00:00.000,London / Queen's Club England ATP World Tour,GRASS,2,Hicham Arazi,Andrei Stoliarov,Hicham Arazi,7-6(2); 3-6; 6-3,R64,114,10,4,50,87,35,50,18,37,3,7,15,53,87,4,3,63,98,45,63,12,35,4,8,15,57,98
2003-06-09 00:00:00.000,London / Queen's Club England ATP World Tour,GRASS,2,Rik De Voest,Petr Luxa,Rik De Voest,6-3; 6-4,R64,77,1,1,57,75,38,57,10,18,9,10,10,48,75,1,2,37,58,23,37,10,21,3,6,9,33,58
2003-06-09 00:00:00.000,London / Queen's Club England ATP World Tour,GRASS,2,Andy Roddick,N/A Bye,Andy Roddick,,R64,0,0,0,0,0,0,0,0,0,0,0,0,0,0,0,0,0,0,0,0,0,0,0,0,0,0,0
2003-06-09 00:00:00.000,London / Queen's Club England ATP World Tour,GRASS,2,Xavier Malisse,N/A Bye,Xavier Malisse,,R64,0,0,0,0,0,0,0,0,0,0,0,0,0,0,0,0,0,0,0,0,0,0,0,0,0,0,0
2003-06-09 00:00:00.000,London / Queen's Club England ATP World Tour,GRASS,2,Ivo Karlovic,Justin Gimelstob,Ivo Karlovic,7-6(4); 4-6; 7-6(3),R64,137,14,6,67,100,59,67,18,33,1,2,17,77,100,11,8,66,109,54,66,24,43,1,1,17,78,109
2003-06-09 00:00:00.000,London / Queen's Club England ATP World Tour,GRASS,2,Marc Rosset,John van Lottum,Marc Rosset,7-6(3); 7-5,R64,81,13,2,44,70,38,44,14,26,4,5,12,52,70,3,2,38,66,31,38,14,28,0,2,12,45,66
2003-06-09 00:00:00.000,London / Queen's Club England ATP World Tour,GRASS,2,Jarkko Nieminen,Karol Beck,Jarkko Nieminen,6-2; 6-1,R64,48,2,0,34,47,25,34,9,13,2,2,8,34,47,0,5,25,49,17,25,7,24,1,5,7,24,49
2003-06-09 00:00:00.000,London / Queen's Club England ATP World Tour,GRASS,2,Richard Krajicek,Mark Philippoussis,Richard Krajicek,7-6(4); 6-3,R64,78,10,3,44,72,36,44,17,28,5,5,11,53,72,9,7,35,64,28,35,16,29,4,5,10,44,64
2003-06-09 00:00:00.000,London / Queen's Club England ATP World Tour,GRASS,2,Jan Vacek,Goran Ivanisevic,Jan Vacek,6-2; 6-2,R64,49,3,2,23,37,21,23,9,14,0,1,8,30,37,0,4,29,54,16,29,8,25,4,9,8,24,54
2003-06-09 00:00:00.000,London / Queen's Club England ATP World Tour,GRASS,2,Peter Luczak,Vladimir Voltchkov,Peter Luczak,6-3; 4-6; 6-2,R64,114,4,5,59,94,34,59,22,35,8,11,13,56,94,6,9,48,86,34,48,11,38,3,9,14,45,86
2003-06-09 00:00:00.000,London / Queen's Club England ATP World Tour,GRASS,2,Andre Agassi,N/A Bye,Andre Agassi,,R64,0,0,0,0,0,0,0,0,0,0,0,0,0,0,0,0,0,0,0,0,0,0,0,0,0,0,0
2003-06-09 00:00:00.000,London / Queen's Club England ATP World Tour,GRASS,2,Lleyton Hewitt,Raemon Sluiter,Lleyton Hewitt,7-6(6); 3-6; 7-6(3),R32,135,15,2,69,114,51,69,22,45,6,10,17,73,114,6,3,73,111,53,73,17,38,3,5,16,70,111
2003-06-09 00:00:00.000,London / Queen's Club England ATP World Tour,GRASS,2,Dick Norman,Andre Sa,Dick Norman,6-3; 7-6(7),R32,85,9,6,48,71,38,48,11,23,1,2,11,49,71,0,0,39,62,24,39,16,23,2,4,10,40,62
2003-06-09 00:00:00.000,London / Queen's Club England ATP World Tour,GRASS,2,Todd Reid,Jan-Michael Gambill,Todd Reid,6-1; 7-5,R32,75,4,2,49,67,35,49,11,18,2,2,10,46,67,7,1,33,59,22,33,12,26,4,7,9,34,59
2003-06-09 00:00:00.000,London / Queen's Club England ATP World Tour,GRASS,2,Sebastien Grosjean,Michel Kratochvil,Sebastien Grosjean,6-3; 6-4,R32,66,8,1,36,55,26,36,14,19,1,2,10,40,55,0,5,36,62,24,36,11,26,1,4,9,35,62
2003-06-09 00:00:00.000,London / Queen's Club England ATP World Tour,GRASS,2,Mario Ancic,Paradorn Srichaphan,Mario Ancic,6-3; 6-3,R32,68,7,3,23,51,21,23,14,28,0,1,9,35,51,4,3,42,67,24,42,11,25,8,12,9,35,67
2003-06-09 00:00:00.000,London / Queen's Club England ATP World Tour,GRASS,2,Antony Dupuis,Alex Bogdanovic,Antony Dupuis,3-6; 7-6(6); 7-6(9),R32,154,10,4,70,118,55,70,27,48,6,8,16,82,118,8,5,91,136,68,91,20,45,19,20,17,88,136
2003-06-09 00:00:00.000,London / Queen's Club England ATP World Tour,GRASS,2,Cyril Saulnier,Max Mirnyi,Cyril Saulnier,7-6(2); 6-4,R32,79,4,1,46,73,35,46,17,27,2,2,11,52,73,13,0,42,65,33,42,13,23,5,6,11,46,65
2003-06-09 00:00:00.000,London / Queen's Club England ATP World Tour,GRASS,2,Tim Henman,Davide Sanguinetti,Tim Henman,3-6; 6-3; 7-6(3),R32,132,3,7,59,95,42,59,18,36,4,7,15,60,95,0,1,74,105,46,74,17,31,7,10,15,63,105
2003-06-09 00:00:00.000,London / Queen's Club England ATP World Tour,GRASS,2,Sjeng Schalken,Todd Martin,Sjeng Schalken,W/O,R32,0,0,0,0,0,0,0,0,0,0,0,0,0,0,0,0,0,0,0,0,0,0,0,0,0,0,0
2003-06-09 00:00:00.000,London / Queen's Club England ATP World Tour,GRASS,2,Taylor Dent,Cecil Mamiit,Taylor Dent,6-4; 6-4,R32,66,5,4,31,56,22,31,17,25,3,5,10,39,56,2,4,37,62,24,37,9,25,5,9,10,33,62
2003-06-09 00:00:00.000,London / Queen's Club England ATP World Tour,GRASS,2,Greg Rusedski,Hicham Arazi,Greg Rusedski,6-4; 6-4,R32,66,15,2,40,59,34,40,12,19,6,6,10,46,59,1,0,33,58,22,33,16,25,3,5,10,38,58
2003-06-09 00:00:00.000,London / Queen's Club England ATP World Tour,GRASS,2,Andy Roddick,Rik De Voest,Andy Roddick,6-3; 6-2,R32,52,11,1,31,53,26,31,15,22,2,2,9,41,53,2,0,36,53,23,36,8,17,1,4,8,31,53
2003-06-09 00:00:00.000,London / Queen's Club England ATP World Tour,GRASS,2,Xavier Malisse,Ivo Karlovic,Xavier Malisse,6-3; 7-6(3),R32,77,8,2,30,56,29,30,20,26,0,0,11,49,56,14,11,48,89,39,48,15,41,12,13,10,54,89
2003-06-09 00:00:00.000,London / Queen's Club England ATP World Tour,GRASS,2,Marc Rosset,Jarkko Nieminen,Marc Rosset,7-5; 7-5,R32,79,5,5,34,66,29,34,17,32,7,9,12,46,66,2,3,51,74,37,51,7,23,4,8,12,44,74
2003-06-09 00:00:00.000,London / Queen's Club England ATP World Tour,GRASS,2,Richard Krajicek,Jan Vacek,Richard Krajicek,7-5; 2-6; 6-3,R32,111,14,8,54,95,47,54,13,41,4,6,14,60,95,6,2,74,111,52,74,16,37,7,10,15,68,111
2003-06-09 00:00:00.000,London / Queen's Club England ATP World Tour,GRASS,2,Andre Agassi,Peter Luczak,Andre Agassi,7-6(5); 6-4,R32,81,8,2,42,61,34,42,11,19,1,2,11,45,61,13,4,62,88,41,62,12,26,8,10,11,53,88
2003-06-09 00:00:00.000,London / Queen's Club England ATP World Tour,GRASS,2,Lleyton Hewitt,Dick Norman,Lleyton Hewitt,7-6(4); 3-6; 6-4,R16,124,10,1,62,103,46,62,28,41,11,12,15,74,103,21,3,66,94,51,66,14,28,1,2,16,65,94
2003-06-09 00:00:00.000,London / Queen's Club England ATP World Tour,GRASS,2,Sebastien Grosjean,Todd Reid,Sebastien Grosjean,6-1; 6-4,R16,67,5,3,31,54,26,31,9,23,5,6,8,35,54,2,1,48,69,22,48,12,21,10,15,9,34,69
2003-06-09 00:00:00.000,London / Queen's Club England ATP World Tour,GRASS,2,Antony Dupuis,Mario Ancic,Antony Dupuis,7-6(3); 7-6(6),R16,98,4,3,52,82,45,52,13,30,1,2,12,58,82,10,7,37,75,31,37,23,38,1,2,12,54,75
2003-06-09 00:00:00.000,London / Queen's Club England ATP World Tour,GRASS,2,Tim Henman,Cyril Saulnier,Tim Henman,6-7(5); 6-3; 6-3,R16,128,9,8,62,104,45,62,19,42,6,9,15,64,104,2,5,57,99,39,57,15,42,4,10,15,54,99
2003-06-09 00:00:00.000,London / Queen's Club England ATP World Tour,GRASS,2,Taylor Dent,Sjeng Schalken,Taylor Dent,7-6(6); 6-4,R16,97,8,6,44,75,34,44,21,31,4,4,11,55,75,2,1,49,76,38,49,12,27,1,2,11,50,76
2003-06-09 00:00:00.000,London / Queen's Club England ATP World Tour,GRASS,2,Andy Roddick,Greg Rusedski,Andy Roddick,6-3; 4-6; 6-4,R16,91,11,3,44,74,37,44,20,30,1,3,15,57,74,6,4,52,83,40,52,14,31,3,6,14,54,83
2003-06-09 00:00:00.000,London / Queen's Club England ATP World Tour,GRASS,2,Xavier Malisse,Marc Rosset,Xavier Malisse,7-6(4); 7-5,R16,87,11,6,35,67,29,35,18,32,0,2,12,47,67,8,8,45,71,32,45,12,26,3,6,12,44,71
2003-06-09 00:00:00.000,London / Queen's Club England ATP World Tour,GRASS,2,Andre Agassi,Richard Krajicek,Andre Agassi,6-1; 6-2,R16,48,2,0,28,46,20,28,12,18,1,2,8,32,46,4,5,18,39,9,18,6,21,1,6,7,15,39
2003-06-09 00:00:00.000,London / Queen's Club England ATP World Tour,GRASS,2,Sebastien Grosjean,Lleyton Hewitt,Sebastien Grosjean,6-3; 6-4,Q,89,5,1,30,61,18,30,20,31,1,3,10,38,61,2,5,39,74,24,39,17,35,9,13,9,41,74
2003-06-09 00:00:00.000,London / Queen's Club England ATP World Tour,GRASS,2,Tim Henman,Antony Dupuis,Tim Henman,6-1; 6-4,Q,82,3,3,42,68,28,42,14,26,5,6,9,42,68,1,4,27,50,17,27,8,23,5,9,8,25,50
2003-06-09 00:00:00.000,London / Queen's Club England ATP World Tour,GRASS,2,Andy Roddick,Taylor Dent,Andy Roddick,6-3; 7-6(3),Q,76,2,3,50,76,40,50,15,26,4,5,11,55,76,4,0,35,57,25,35,13,22,1,3,10,38,57
2003-06-09 00:00:00.000,London / Queen's Club England ATP World Tour,GRASS,2,Andre Agassi,Xavier Malisse,Andre Agassi,6-4; 7-5,Q,61,3,0,32,55,29,32,15,23,0,0,11,44,55,16,2,32,55,27,32,12,23,1,3,11,39,55
2003-06-09 00:00:00.000,London / Queen's Club England ATP World Tour,GRASS,2,Sebastien Grosjean,Tim Henman,Sebastien Grosjean,6-3; 6-4,S,93,5,1,39,75,30,39,18,36,5,6,10,48,75,2,2,44,72,27,44,14,28,7,10,9,41,72
2003-06-09 00:00:00.000,London / Queen's Club England ATP World Tour,GRASS,2,Andy Roddick,Andre Agassi,Andy Roddick,6-1; 6-7(5); 7-6(6),S,117,27,2,61,95,51,61,21,34,2,3,16,72,95,4,3,72,100,50,72,15,28,1,4,15,65,100
2003-06-09 00:00:00.000,London / Queen's Club England ATP World Tour,GRASS,2,Andy Roddick,Sebastien Grosjean,Andy Roddick,6-3; 6-3,F,60,10,1,38,54,28,38,10,16,1,1,9,38,54,4,1,22,51,13,22,15,29,3,6,9,28,51
2003-06-16 00:00:00.000,Nottingham England ATP World Tour,GRASS,2,Younes El Aynaoui,Alexander Waske,Younes El Aynaoui,7-6(2); 6-4,R32,79,9,3,52,67,42,52,9,15,2,3,11,51,67,11,7,49,72,33,49,10,23,4,6,11,43,72
2003-06-16 00:00:00.000,Nottingham England ATP World Tour,GRASS,2,Wayne Arthurs,Bob Bryan,Wayne Arthurs,7-6(17); 7-5,R32,81,22,3,52,78,45,52,18,26,0,0,12,63,78,17,5,59,80,48,59,11,21,0,1,12,59,80
2003-06-16 00:00:00.000,Nottingham England ATP World Tour,GRASS,2,Hicham Arazi,Sargis Sargsian,Hicham Arazi,6-4; 3-6; 6-3,R32,118,1,1,62,89,41,62,17,27,3,5,14,58,89,4,2,48,86,31,48,23,38,5,8,14,54,86
2003-06-16 00:00:00.000,Nottingham England ATP World Tour,GRASS,2,Max Mirnyi,Robby Ginepri,Max Mirnyi,6-3; 6-4,R32,66,2,1,33,59,27,33,15,26,4,5,10,42,59,3,1,35,56,21,35,10,21,3,6,9,31,56
2003-06-16 00:00:00.000,Nottingham England ATP World Tour,GRASS,2,Greg Rusedski,Jarkko Nieminen,Greg Rusedski,6-4; 6-4,R32,67,11,3,36,59,31,36,13,23,2,2,10,44,59,2,0,41,58,28,41,10,17,2,4,10,38,58
2003-06-16 00:00:00.000,Nottingham England ATP World Tour,GRASS,2,Olivier Rochus,Irakli Labadze,Olivier Rochus,6-0; 4-1 RET,R32,36,2,0,17,26,13,17,8,9,1,1,5,21,26,1,2,23,38,11,23,4,15,4,9,6,15,38
2003-06-16 00:00:00.000,Nottingham England ATP World Tour,GRASS,2,Vladimir Voltchkov,Justin Gimelstob,Vladimir Voltchkov,6-1; 7-5,R32,75,2,1,37,64,22,37,16,27,5,7,9,38,64,3,3,32,58,20,32,9,26,5,11,10,29,58
2003-06-16 00:00:00.000,Nottingham England ATP World Tour,GRASS,2,Alex Bogdanovic,Jan-Michael Gambill,Alex Bogdanovic,6-4; 5-7; 6-4,R32,116,10,4,58,91,45,58,17,33,4,7,16,62,91,11,4,59,94,46,59,12,35,7,11,16,58,94
2003-06-16 00:00:00.000,Nottingham England ATP World Tour,GRASS,2,Mardy Fish,Hyung-Taik Lee,Mardy Fish,6-4; 3-6; 6-1,R32,103,17,9,47,84,38,47,18,37,9,11,13,56,84,2,3,56,85,36,56,13,29,8,12,13,49,85
2003-06-16 00:00:00.000,Nottingham England ATP World Tour,GRASS,2,Michel Kratochvil,Stefan Koubek,Michel Kratochvil,6-4; 6-3,R32,68,3,3,38,67,27,38,14,29,6,7,9,41,67,2,5,38,63,26,38,8,25,5,9,10,34,63
2003-06-16 00:00:00.000,Nottingham England ATP World Tour,GRASS,2,Andre Sa,Jamie Delgado,Andre Sa,6-7(4); 7-6(2); 7-6(4),R32,168,12,8,80,133,59,80,22,53,3,9,18,81,133,6,6,60,116,37,60,30,56,2,8,18,67,116
2003-06-16 00:00:00.000,Nottingham England ATP World Tour,GRASS,2,Alexander Popp,Vincent Spadea,Alexander Popp,7-5; 6-4,R32,86,3,1,37,61,28,37,18,24,1,1,11,46,61,7,8,43,85,29,43,22,42,10,12,11,51,85
2003-06-16 00:00:00.000,Nottingham England ATP World Tour,GRASS,2,Taylor Dent,Brian Vahaly,Taylor Dent,6-3; 6-4,R32,72,1,7,43,72,29,43,15,29,7,9,10,44,72,2,2,41,58,26,41,5,17,6,10,9,31,58
2003-06-16 00:00:00.000,Nottingham England ATP World Tour,GRASS,2,Nenad Zimonjic,Jonathan Marray,Nenad Zimonjic,6-2; 6-4,R32,67,4,3,38,54,29,38,10,16,1,1,9,39,54,7,9,35,65,23,35,14,30,3,6,9,37,65
2003-06-16 00:00:00.000,Nottingham England ATP World Tour,GRASS,2,Arvind Parmar,Paul-Henri Mathieu,Arvind Parmar,6-4; 7-6(4),R32,100,11,4,49,75,38,49,15,26,7,8,11,53,75,4,2,45,94,29,45,26,49,4,6,11,55,94
2003-06-16 00:00:00.000,Nottingham England ATP World Tour,GRASS,2,Jonas Bjorkman,Mikhail Youzhny,Jonas Bjorkman,6-2; 6-0,R32,57,3,2,27,44,22,27,10,17,7,7,7,32,44,1,4,30,43,15,30,2,13,3,8,7,17,43
2003-06-16 00:00:00.000,Nottingham England ATP World Tour,GRASS,2,Wayne Arthurs,Younes El Aynaoui,Wayne Arthurs,6-4; 7-6(6),R16,64,11,1,38,56,35,38,14,18,0,0,11,49,56,6,2,52,67,41,52,6,15,2,3,11,47,67
2003-06-16 00:00:00.000,Nottingham England ATP World Tour,GRASS,2,Hicham Arazi,Max Mirnyi,Hicham Arazi,7-6(4); 6-2,R16,79,2,1,43,71,34,43,18,28,5,5,10,52,71,9,2,44,62,34,44,9,18,2,4,10,43,62
2003-06-16 00:00:00.000,Nottingham England ATP World Tour,GRASS,2,Greg Rusedski,Olivier Rochus,Greg Rusedski,6-4; 6-1,R16,58,13,2,30,44,27,30,10,14,1,1,9,37,44,0,1,35,57,18,35,12,22,10,13,8,30,57
2003-06-16 00:00:00.000,Nottingham England ATP World Tour,GRASS,2,Vladimir Voltchkov,Alex Bogdanovic,Vladimir Voltchkov,6-4; 6-2,R16,61,9,2,29,52,26,29,11,23,1,2,9,37,52,1,1,41,51,24,41,4,10,4,8,9,28,51
2003-06-16 00:00:00.000,Nottingham England ATP World Tour,GRASS,2,Mardy Fish,Michel Kratochvil,Mardy Fish,6-3; 6-4,R16,72,13,4,41,63,29,41,14,22,2,2,10,43,63,2,3,37,52,25,37,7,15,3,5,9,32,52
2003-06-16 00:00:00.000,Nottingham England ATP World Tour,GRASS,2,Alexander Popp,Andre Sa,Alexander Popp,7-6(4); 3-6; 6-3,R16,115,4,4,55,87,48,55,15,32,1,3,15,63,87,3,5,71,111,51,71,21,40,6,8,15,72,111
2003-06-16 00:00:00.000,Nottingham England ATP World Tour,GRASS,2,Taylor Dent,Nenad Zimonjic,Taylor Dent,7-6(2); 6-4,R16,67,2,2,49,65,37,49,11,16,2,3,11,48,65,8,3,48,71,33,48,12,23,3,5,11,45,71
2003-06-16 00:00:00.000,Nottingham England ATP World Tour,GRASS,2,Jonas Bjorkman,Arvind Parmar,Jonas Bjorkman,7-6(5); 6-2,R16,86,4,4,32,65,25,32,20,33,1,1,10,45,65,3,2,50,72,34,50,9,22,4,6,10,43,72
2003-06-16 00:00:00.000,Nottingham England ATP World Tour,GRASS,2,Hicham Arazi,Wayne Arthurs,Hicham Arazi,6-4; 6-3,Q,66,2,2,41,54,36,41,4,13,2,2,9,40,54,6,7,36,65,26,36,12,29,3,6,10,38,65
2003-06-16 00:00:00.000,Nottingham England ATP World Tour,GRASS,2,Greg Rusedski,Vladimir Voltchkov,Greg Rusedski,4-6; 7-6(4); 7-6(4),Q,137,10,11,66,112,55,66,19,46,4,6,17,74,112,8,3,63,104,49,63,24,41,3,4,17,73,104
2003-06-16 00:00:00.000,Nottingham England ATP World Tour,GRASS,2,Mardy Fish,Alexander Popp,Mardy Fish,4-6; 7-6(4); 6-4,Q,146,15,5,54,103,44,54,28,49,2,3,16,72,103,1,6,69,118,50,69,29,49,8,9,16,79,118
2003-06-16 00:00:00.000,Nottingham England ATP World Tour,GRASS,2,Jonas Bjorkman,Taylor Dent,Jonas Bjorkman,W/O,Q,0,0,0,0,0,0,0,0,0,0,0,0,0,0,0,0,0,0,0,0,0,0,0,0,0,0,0
2003-06-16 00:00:00.000,Nottingham England ATP World Tour,GRASS,2,Greg Rusedski,Hicham Arazi,Greg Rusedski,7-5; 7-5,S,85,11,1,44,73,34,44,18,29,2,3,12,52,73,1,3,38,69,28,38,16,31,5,8,12,44,69
2003-06-16 00:00:00.000,Nottingham England ATP World Tour,GRASS,2,Mardy Fish,Jonas Bjorkman,Mardy Fish,6-7(5); 6-3; 6-4,S,136,15,7,64,113,57,64,17,49,10,12,16,74,113,3,5,53,101,37,53,29,48,7,11,15,66,101
2003-06-16 00:00:00.000,Nottingham England ATP World Tour,GRASS,2,Greg Rusedski,Mardy Fish,Greg Rusedski,6-3; 6-2,F,57,7,2,32,44,29,32,7,12,0,0,9,36,44,3,2,25,48,20,25,6,23,2,5,8,26,48
2003-06-16 00:00:00.000,'s-Hertogenbosch The Netherlands ATP World Tour,GRASS,2,Jiri Novak,Jurgen Melzer,Jiri Novak,6-1; 6-3,R32,54,2,1,31,41,23,31,7,10,2,3,8,30,41,7,3,36,61,20,36,9,25,7,12,8,29,61
2003-06-16 00:00:00.000,'s-Hertogenbosch The Netherlands ATP World Tour,GRASS,2,Olivier Mutis,Richard Krajicek,Olivier Mutis,6-4; 7-6(4),R32,94,4,3,42,89,31,42,26,47,9,10,11,57,89,8,13,51,92,38,51,17,41,3,5,11,55,92
2003-06-16 00:00:00.000,'s-Hertogenbosch The Netherlands ATP World Tour,GRASS,2,Jan Vacek,Antony Dupuis,Jan Vacek,7-6(2); 6-3,R32,109,4,1,41,68,32,41,14,27,3,4,10,46,68,5,3,44,77,27,44,18,33,3,6,11,45,77
2003-06-16 00:00:00.000,'s-Hertogenbosch The Netherlands ATP World Tour,GRASS,2,Sebastien Grosjean,Philipp Petzschner,Sebastien Grosjean,6-2; 5-7; 6-3,R32,118,5,3,45,102,30,45,36,57,5,7,15,66,102,5,8,45,86,37,45,18,41,3,7,14,55,86
2003-06-16 00:00:00.000,'s-Hertogenbosch The Netherlands ATP World Tour,GRASS,2,Lars Burgsmuller,Martin Verkerk,Lars Burgsmuller,3-6; 6-4; 7-6(11),R32,132,5,2,58,99,44,58,20,41,2,6,16,64,99,20,10,64,107,50,64,16,43,8,11,15,66,107
2003-06-16 00:00:00.000,'s-Hertogenbosch The Netherlands ATP World Tour,GRASS,2,Fernando Vicente,Davide Sanguinetti,Fernando Vicente,0-6; 7-6(10); 6-2,R32,112,2,3,65,104,35,65,20,39,5,10,13,55,104,5,4,50,96,34,50,19,46,7,11,13,53,96
2003-06-16 00:00:00.000,'s-Hertogenbosch The Netherlands ATP World Tour,GRASS,2,Dennis van Scheppingen,Feliciano Lopez,Dennis van Scheppingen,3-6; 6-4; 6-3,R32,82,6,2,42,72,38,42,17,30,0,1,14,55,72,9,5,42,76,38,42,15,34,2,4,14,53,76
2003-06-16 00:00:00.000,'s-Hertogenbosch The Netherlands ATP World Tour,GRASS,2,Arnaud Clement,Fred Hemmes,Arnaud Clement,6-2; 6-3,R32,69,2,2,23,45,19,23,16,22,1,2,9,35,45,3,4,36,60,18,36,12,24,5,9,8,30,60
2003-06-16 00:00:00.000,'s-Hertogenbosch The Netherlands ATP World Tour,GRASS,2,Tommy Robredo,Frank Moser,Tommy Robredo,5-7; 7-6(1); 6-2,R32,139,1,2,57,97,41,57,25,40,4,7,16,66,97,6,6,53,114,42,53,21,61,4,8,16,63,114
2003-06-16 00:00:00.000,'s-Hertogenbosch The Netherlands ATP World Tour,GRASS,2,Kenneth Carlsen,Yves Allegro,Kenneth Carlsen,6-4; 6-3,R32,96,1,4,36,70,26,36,17,34,8,9,9,43,70,3,6,38,78,29,38,12,40,10,14,10,41,78
2003-06-16 00:00:00.000,'s-Hertogenbosch The Netherlands ATP World Tour,GRASS,2,Christophe Rochus,Mario Ancic,Christophe Rochus,6-2; 6-3,R32,61,0,1,26,48,18,26,16,22,1,1,8,34,48,3,8,25,52,16,25,13,27,3,7,9,29,52
2003-06-16 00:00:00.000,'s-Hertogenbosch The Netherlands ATP World Tour,GRASS,2,Sjeng Schalken,Albert Portas,Sjeng Schalken,6-2; 6-2,R32,49,3,2,22,39,17,22,13,17,0,1,8,30,39,3,3,27,44,14,27,5,17,1,6,8,19,44
2003-06-16 00:00:00.000,'s-Hertogenbosch The Netherlands ATP World Tour,GRASS,2,John van Lottum,Jose Acasuso,John van Lottum,6-3; 6-2,R32,57,6,1,23,51,18,23,21,28,1,1,9,39,51,1,3,26,52,19,26,11,26,2,5,8,30,52
2003-06-16 00:00:00.000,'s-Hertogenbosch The Netherlands ATP World Tour,GRASS,2,Frantisek Cermak,Nicolas Kiefer,Frantisek Cermak,6-3 RET,R32,48,4,3,16,33,14,16,8,17,1,1,5,22,33,0,1,17,31,7,17,11,14,2,3,4,18,31
2003-06-16 00:00:00.000,'s-Hertogenbosch The Netherlands ATP World Tour,GRASS,2,Raemon Sluiter,Karol Beck,Raemon Sluiter,6-3; 7-5,R32,76,4,5,33,66,21,33,20,33,2,4,10,41,66,4,4,36,72,24,36,13,36,4,9,11,37,72
2003-06-16 00:00:00.000,'s-Hertogenbosch The Netherlands ATP World Tour,GRASS,2,Paradorn Srichaphan,Paul Logtens,Paradorn Srichaphan,6-4; 4-6; 6-4,R32,107,4,2,43,80,29,43,25,37,6,10,15,54,80,3,7,64,97,40,64,15,33,5,10,15,55,97
2003-06-16 00:00:00.000,'s-Hertogenbosch The Netherlands ATP World Tour,GRASS,2,Jiri Novak,Olivier Mutis,Jiri Novak,6-2; 6-4,R16,49,2,2,36,47,29,36,7,11,0,0,9,36,47,2,0,29,48,19,29,10,19,2,5,9,29,48
2003-06-16 00:00:00.000,'s-Hertogenbosch The Netherlands ATP World Tour,GRASS,2,Jan Vacek,Sebastien Grosjean,Jan Vacek,6-4; 3-6; 6-2,R16,104,2,3,46,86,31,46,23,40,6,8,13,54,86,4,5,44,92,26,44,26,48,4,8,14,52,92
2003-06-16 00:00:00.000,'s-Hertogenbosch The Netherlands ATP World Tour,GRASS,2,Fernando Vicente,Lars Burgsmuller,Fernando Vicente,4-6; 6-4; 6-4,R16,131,4,3,51,98,40,51,24,47,4,5,15,64,98,4,4,55,100,43,55,21,45,5,7,15,64,100
2003-06-16 00:00:00.000,'s-Hertogenbosch The Netherlands ATP World Tour,GRASS,2,Arnaud Clement,Dennis van Scheppingen,Arnaud Clement,7-6(4); 6-7(5); 6-3,R16,154,3,2,69,133,44,69,35,64,7,11,17,79,133,6,2,65,96,38,65,16,31,1,6,16,54,96
2003-06-16 00:00:00.000,'s-Hertogenbosch The Netherlands ATP World Tour,GRASS,2,Tommy Robredo,Kenneth Carlsen,Tommy Robredo,6-4; 2-6; 6-3,R16,99,0,4,51,84,34,51,15,33,4,8,14,49,84,5,9,40,75,31,40,15,35,2,6,13,46,75
2003-06-16 00:00:00.000,'s-Hertogenbosch The Netherlands ATP World Tour,GRASS,2,Sjeng Schalken,Christophe Rochus,Sjeng Schalken,6-0; 6-0,R16,53,3,2,22,43,18,22,12,21,2,2,6,30,43,0,1,34,54,11,34,8,20,7,13,6,19,54
2003-06-16 00:00:00.000,'s-Hertogenbosch The Netherlands ATP World Tour,GRASS,2,John van Lottum,Frantisek Cermak,John van Lottum,6-4; 6-3,R16,68,3,2,26,52,23,26,13,26,1,2,9,36,52,1,2,37,64,24,37,12,27,4,8,10,36,64
2003-06-16 00:00:00.000,'s-Hertogenbosch The Netherlands ATP World Tour,GRASS,2,Raemon Sluiter,Paradorn Srichaphan,Raemon Sluiter,7-5; 6-4,R16,73,4,7,41,65,31,41,8,24,4,7,11,39,65,4,5,33,64,26,33,8,31,2,7,11,34,64
2003-06-16 00:00:00.000,'s-Hertogenbosch The Netherlands ATP World Tour,GRASS,2,Jan Vacek,Jiri Novak,Jan Vacek,6-4; 6-4,Q,66,2,2,42,67,29,42,14,25,4,5,10,43,67,0,0,37,58,25,37,11,21,1,4,10,36,58
2003-06-16 00:00:00.000,'s-Hertogenbosch The Netherlands ATP World Tour,GRASS,2,Arnaud Clement,Fernando Vicente,Arnaud Clement,4-6; 6-3; 6-0,Q,93,5,0,48,75,38,48,16,27,5,6,13,54,75,2,3,50,74,31,50,9,24,5,9,12,40,74
2003-06-16 00:00:00.000,'s-Hertogenbosch The Netherlands ATP World Tour,GRASS,2,Sjeng Schalken,Tommy Robredo,Sjeng Schalken,7-5; 6-4,Q,81,2,1,41,60,28,41,13,19,1,3,11,41,60,1,2,45,67,28,45,11,22,2,6,11,39,67
2003-06-16 00:00:00.000,'s-Hertogenbosch The Netherlands ATP World Tour,GRASS,2,Raemon Sluiter,John van Lottum,Raemon Sluiter,6-4; 7-5,Q,73,7,1,49,60,38,49,6,11,0,1,11,44,60,4,6,30,68,19,30,22,38,4,7,11,41,68
2003-06-16 00:00:00.000,'s-Hertogenbosch The Netherlands ATP World Tour,GRASS,2,Arnaud Clement,Jan Vacek,Arnaud Clement,6-3; 6-4,S,94,0,3,48,75,34,48,18,27,6,6,10,52,75,6,5,37,70,28,37,13,33,8,10,9,41,70
2003-06-16 00:00:00.000,'s-Hertogenbosch The Netherlands ATP World Tour,GRASS,2,Sjeng Schalken,Raemon Sluiter,Sjeng Schalken,6-3; 6-4,S,68,2,3,27,51,20,27,15,24,0,2,10,35,51,3,4,34,55,23,34,5,21,3,7,9,28,55
2003-06-16 00:00:00.000,'s-Hertogenbosch The Netherlands ATP World Tour,GRASS,2,Sjeng Schalken,Arnaud Clement,Sjeng Schalken,6-3; 6-4,F,97,1,0,38,54,23,38,13,16,3,4,9,36,54,4,4,38,69,26,38,12,31,4,8,10,38,69
2003-06-23 00:00:00.000,Wimbledon England Grand Slams,GRASS,3,Ivo Karlovic,Lleyton Hewitt,Ivo Karlovic,1-6; 7-6(5); 6-3; 6-4,R128,144,19,8,83,129,66,83,23,46,10,13,20,89,129,10,8,60,113,47,60,30,53,1,3,18,77,113
2003-06-23 00:00:00.000,Wimbledon England Grand Slams,GRASS,3,Paul Baccanello,Ivo Heuberger,Paul Baccanello,7-6(8); 6-3; 3-6; 7-6(2),R128,161,18,5,81,119,68,81,27,38,0,1,21,95,119,16,5,82,141,60,82,39,59,5,6,21,99,141
2003-06-23 00:00:00.000,Wimbledon England Grand Slams,GRASS,3,Ivan Ljubicic,Taylor Dent,Ivan Ljubicic,7-5; 3-6; 6-3; 7-5,R128,152,16,5,72,127,57,72,29,55,6,8,21,86,127,14,9,81,131,60,81,23,50,10,14,21,83,131
2003-06-23 00:00:00.000,Wimbledon England Grand Slams,GRASS,3,Max Mirnyi,Vincent Spadea,Max Mirnyi,6-2; 6-4; 6-4,R128,98,11,5,46,72,38,46,15,26,0,1,14,53,72,3,5,66,106,38,66,21,40,10,15,14,59,106
2003-06-23 00:00:00.000,Wimbledon England Grand Slams,GRASS,3,Jurgen Melzer,Fernando Gonzalez,Jurgen Melzer,6-3; 6-4; 7-6(6),R128,103,14,6,59,106,52,59,25,47,8,8,16,77,106,9,5,55,97,39,55,26,42,8,10,15,65,97
2003-06-23 00:00:00.000,Wimbledon England Grand Slams,GRASS,3,Jonas Bjorkman,Petr Luxa,Jonas Bjorkman,6-3; 7-6(6); 6-2,R128,134,4,3,59,105,46,59,25,46,9,10,15,71,105,3,3,75,110,51,75,14,35,8,12,14,65,110
2003-06-23 00:00:00.000,Wimbledon England Grand Slams,GRASS,3,Justin Gimelstob,Irakli Labadze,Justin Gimelstob,6-2; 6-2; 6-4,R128,77,14,2,39,70,35,39,14,31,2,4,13,49,70,1,2,67,84,31,67,9,17,7,14,13,40,84
2003-06-23 00:00:00.000,Wimbledon England Grand Slams,GRASS,3,Arnaud Clement,Robby Ginepri,Arnaud Clement,6-3; 4-6; 7-6(2); 6-7(3); 10-8,R128,273,9,8,98,187,73,98,51,89,8,12,30,124,187,15,12,111,224,74,111,60,113,19,25,31,134,224
2003-06-23 00:00:00.000,Wimbledon England Grand Slams,GRASS,3,Paradorn Srichaphan,Dominik Hrbaty,Paradorn Srichaphan,6-3; 6-4; 4-6; 3-6; 6-3,R128,158,10,7,78,136,64,78,32,58,4,7,24,96,136,7,5,86,139,64,86,27,53,5,9,23,91,139
2003-06-23 00:00:00.000,Wimbledon England Grand Slams,GRASS,3,Olivier Mutis,Franco Squillari,Olivier Mutis,4-6; 0-6; 6-4; 7-6(1); 6-3,R128,148,12,7,89,155,62,89,32,66,5,12,24,94,155,5,8,79,132,60,79,27,53,3,8,23,87,132
2003-06-23 00:00:00.000,Wimbledon England Grand Slams,GRASS,3,Rafael Nadal,Mario Ancic,Rafael Nadal,6-3; 6-4; 4-6; 6-4,R128,184,2,0,98,131,65,98,21,33,11,14,20,86,131,15,6,73,134,58,73,20,61,11,16,19,78,134
2003-06-23 00:00:00.000,Wimbledon England Grand Slams,GRASS,3,Lee Childs,Nikolay Davydenko,Lee Childs,2-6; 7-6(2); 1-6; 7-6(5); 6-2,R128,200,14,6,101,168,70,101,34,67,12,17,23,104,168,10,7,105,165,72,105,31,60,6,9,24,103,165
2003-06-23 00:00:00.000,Wimbledon England Grand Slams,GRASS,3,Tommy Robredo,Jose Acasuso,Tommy Robredo,3-6; 6-3; 7-6(6); 6-4,R128,156,7,2,81,122,64,81,23,41,5,7,20,87,122,11,8,73,135,63,73,24,62,9,12,20,87,135
2003-06-23 00:00:00.000,Wimbledon England Grand Slams,GRASS,3,Brian Vahaly,Filippo Volandri,Brian Vahaly,2-6; 6-1; 6-4; 6-4,R128,145,2,5,81,128,56,81,21,47,9,13,18,77,128,0,10,80,137,51,80,25,57,18,24,17,76,137
2003-06-23 00:00:00.000,Wimbledon England Grand Slams,GRASS,3,Greg Rusedski,Alexander Waske,Greg Rusedski,7-6(6); 7-5; 7-6(7),R128,137,31,5,77,114,65,77,24,37,4,4,18,89,114,19,4,85,121,65,85,20,36,2,3,18,85,121
2003-06-23 00:00:00.000,Wimbledon England Grand Slams,GRASS,3,Andy Roddick,Davide Sanguinetti,Andy Roddick,6-2; 6-3; 6-3,R128,80,15,2,50,75,40,50,15,25,3,3,13,55,75,4,0,47,75,29,47,13,28,4,9,13,42,75
2003-06-23 00:00:00.000,Wimbledon England Grand Slams,GRASS,3,Roger Federer,Hyung-Taik Lee,Roger Federer,6-3; 6-3; 7-6(2),R128,105,15,3,64,99,48,64,19,35,7,9,15,67,99,2,4,67,97,43,67,11,30,6,11,15,54,97
2003-06-23 00:00:00.000,Wimbledon England Grand Slams,GRASS,3,Stefan Koubek,Christophe Rochus,Stefan Koubek,4-6; 6-3; 6-1; 6-1,R128,99,6,7,69,98,48,69,14,29,4,7,16,62,98,3,5,65,108,41,65,13,43,6,15,17,54,108
2003-06-23 00:00:00.000,Wimbledon England Grand Slams,GRASS,3,Jan-Michael Gambill,Igor Kunitsyn,Jan-Michael Gambill,6-3; 6-2; 6-4,R128,103,15,0,49,86,40,49,21,37,5,5,14,61,86,6,2,43,68,30,43,13,25,1,5,13,43,68
2003-06-23 00:00:00.000,Wimbledon England Grand Slams,GRASS,3,Mardy Fish,Gaston Gaudio,Mardy Fish,6-2; 4-6; 6-3; 6-3,R128,126,16,9,61,119,47,61,29,58,8,11,18,76,119,3,8,70,114,40,70,21,44,9,16,18,61,114
2003-06-23 00:00:00.000,Wimbledon England Grand Slams,GRASS,3,Agustin Calleri,Adrian Voinea,Agustin Calleri,6-2; 7-5; 1-0 RET,R128,98,7,6,34,73,27,34,22,39,6,6,10,49,73,1,6,36,71,26,36,13,35,7,11,11,39,71
2003-06-23 00:00:00.000,Wimbledon England Grand Slams,GRASS,3,Flavio Saretta,Alan Mackin,Flavio Saretta,6-2; 6-4; 6-2,R128,117,4,1,51,91,30,51,27,40,7,10,13,57,91,1,4,49,85,25,49,13,36,5,13,13,38,85
2003-06-23 00:00:00.000,Wimbledon England Grand Slams,GRASS,3,Feliciano Lopez,Robert Kendrick,Feliciano Lopez,6-3; 6-4; 7-6(4),R128,122,7,4,69,115,55,69,26,46,8,8,16,81,115,7,4,70,115,45,70,26,45,10,12,15,71,115
2003-06-23 00:00:00.000,Wimbledon England Grand Slams,GRASS,3,Mikhail Youzhny,Karol Beck,Mikhail Youzhny,6-4; 6-2; 6-3,R128,107,1,0,49,82,35,49,21,33,5,6,13,56,82,10,8,49,104,32,49,23,55,16,22,14,55,104
2003-06-23 00:00:00.000,Wimbledon England Grand Slams,GRASS,3,Rainer Schuettler,Michel Kratochvil,Rainer Schuettler,6-3; 6-4; 6-7(4); 7-5,R128,195,5,5,122,168,75,122,19,46,14,20,22,94,168,11,12,80,141,51,80,26,61,8,17,21,77,141
2003-06-23 00:00:00.000,Wimbledon England Grand Slams,GRASS,3,Fabrice Santoro,Andreas Vinciguerra,Fabrice Santoro,4-6; 6-3; 2-6; 6-2; 6-2,R128,158,2,2,93,133,63,93,21,40,5,10,22,84,133,4,11,94,145,60,94,20,51,13,20,21,80,145
2003-06-23 00:00:00.000,Wimbledon England Grand Slams,GRASS,3,Todd Martin,Fernando Vicente,Todd Martin,6-7(4); 6-4; 2-6; 7-6(6); 6-4,R128,201,21,6,107,162,83,107,26,55,10,15,26,109,162,11,4,124,178,92,124,25,54,10,15,26,117,178
2003-06-23 00:00:00.000,Wimbledon England Grand Slams,GRASS,3,Gustavo Kuerten,John van Lottum,Gustavo Kuerten,2-6; 3-2 RET,R128,65,1,0,23,52,14,23,16,29,5,7,7,30,52,6,2,23,41,18,23,11,18,5,5,6,29,41
2003-06-23 00:00:00.000,Wimbledon England Grand Slams,GRASS,3,Juan Ignacio Chela,Tomas Behrend,Juan Ignacio Chela,6-4; 6-2; 6-3,R128,92,7,0,59,77,44,59,11,18,1,1,13,55,77,3,2,71,96,42,71,11,25,10,15,14,53,96
2003-06-23 00:00:00.000,Wimbledon England Grand Slams,GRASS,3,Victor Hanescu,Albert Portas,Victor Hanescu,7-6(4); 6-0; 6-0,R128,79,10,8,51,80,41,51,13,29,2,3,12,54,80,1,3,47,71,23,47,11,24,0,7,12,34,71
2003-06-23 00:00:00.000,Wimbledon England Grand Slams,GRASS,3,Nicolas Lapentti,Kenneth Carlsen,Nicolas Lapentti,6-3; 6-4; 3-6; 6-4,R128,163,10,2,72,111,59,72,18,39,7,9,19,77,111,15,6,85,132,61,85,22,47,11,15,19,83,132
2003-06-23 00:00:00.000,Wimbledon England Grand Slams,GRASS,3,Sjeng Schalken,Arvind Parmar,Sjeng Schalken,6-3; 6-4; 6-1,R128,91,2,4,53,74,43,53,13,21,1,1,13,56,74,4,0,57,80,33,57,10,23,8,13,13,43,80
2003-06-23 00:00:00.000,Wimbledon England Grand Slams,GRASS,3,David Nalbandian,Vladimir Voltchkov,David Nalbandian,7-5; 6-4; 6-2,R128,121,7,4,56,97,33,56,25,41,3,7,15,58,97,6,2,60,104,30,60,20,44,4,12,15,50,104
2003-06-23 00:00:00.000,Wimbledon England Grand Slams,GRASS,3,Andre Sa,Mariano Puerta,Andre Sa,6-2; 3-2 RET,R128,53,2,0,29,42,21,29,10,13,1,1,7,31,42,1,2,28,39,18,28,5,11,3,5,6,23,39
2003-06-23 00:00:00.000,Wimbledon England Grand Slams,GRASS,3,Takao Suzuki,Dick Norman,Takao Suzuki,7-6(8); 6-4; 7-6(3),R128,145,13,6,74,115,62,74,24,41,3,3,17,86,115,23,12,65,119,57,65,28,54,6,7,17,85,119
2003-06-23 00:00:00.000,Wimbledon England Grand Slams,GRASS,3,Karol Kucera,Wayne Ferreira,Karol Kucera,6-1; 6-2; 6-4,R128,98,9,1,58,78,47,58,9,20,4,4,13,56,78,5,3,64,92,37,64,12,28,8,13,12,49,92
2003-06-23 00:00:00.000,Wimbledon England Grand Slams,GRASS,3,Robin Soderling,Martin Verkerk,Robin Soderling,6-3; 6-4; 6-7(5); 6-1,R128,121,19,7,71,110,60,71,24,39,0,1,20,84,110,24,13,74,123,52,74,24,49,8,13,18,76,123
2003-06-23 00:00:00.000,Wimbledon England Grand Slams,GRASS,3,Gilles Elseneer,Nicolas Kiefer,Gilles Elseneer,3-6; 6-3; 6-4; 6-4,R128,153,16,3,62,112,49,62,24,50,7,11,19,73,112,6,9,76,127,49,76,22,51,5,11,19,71,127
2003-06-23 00:00:00.000,Wimbledon England Grand Slams,GRASS,3,Michael Llodra,David Sanchez,Michael Llodra,6-3; 6-4; 6-7(8); 6-3,R128,165,12,5,98,143,76,98,22,45,3,4,21,98,143,6,7,119,171,78,119,25,52,17,21,19,103,171
2003-06-23 00:00:00.000,Wimbledon England Grand Slams,GRASS,3,Tim Henman,Tomas Zib,Tim Henman,6-2; 7-6(11); 3-6; 6-1,R128,176,17,8,55,108,46,55,27,53,4,9,18,73,108,2,7,66,135,40,66,33,69,11,19,18,73,135
2003-06-23 00:00:00.000,Wimbledon England Grand Slams,GRASS,3,Sebastien Grosjean,Thomas Enqvist,Sebastien Grosjean,4-6; 6-3; 6-4; 7-6(4),R128,156,27,1,73,125,62,73,33,52,8,9,21,95,125,11,10,69,120,57,69,27,51,6,8,20,84,120
2003-06-23 00:00:00.000,Wimbledon England Grand Slams,GRASS,3,Wayne Arthurs,Alberto Martin,Wayne Arthurs,7-6(3); 6-1; 7-6(4),R128,114,21,2,54,90,46,54,24,36,1,1,15,70,90,4,6,82,112,56,82,14,30,7,10,16,70,112
2003-06-23 00:00:00.000,Wimbledon England Grand Slams,GRASS,3,Wesley Moodie,Marc Rosset,Wesley Moodie,6-4; 6-4; 6-4,R128,102,23,2,60,83,44,60,15,23,0,1,15,59,83,6,16,50,93,35,50,21,43,11,15,15,56,93
2003-06-23 00:00:00.000,Wimbledon England Grand Slams,GRASS,3,Frederic Niemeyer,Felix Mantilla,Frederic Niemeyer,6-4; 7-6(6); 4-6; 7-6(3),R128,159,31,10,77,132,70,77,31,55,1,2,22,101,132,7,8,94,145,73,94,28,51,6,7,22,101,145
2003-06-23 00:00:00.000,Wimbledon England Grand Slams,GRASS,3,James Blake,Todd Larkham,James Blake,6-3; 6-1; 6-1,R128,73,5,2,49,76,36,49,18,27,3,3,12,54,76,2,6,36,65,21,36,11,29,4,10,11,32,65
2003-06-23 00:00:00.000,Wimbledon England Grand Slams,GRASS,3,Sargis Sargsian,Alex Bogdanovic,Sargis Sargsian,6-1; 6-3; 6-2,R128,94,10,2,43,61,39,43,11,18,1,1,12,50,61,5,5,72,122,41,72,21,50,19,25,12,62,122
2003-06-23 00:00:00.000,Wimbledon England Grand Slams,GRASS,3,Nicolas Escude,Konstantinos Economidis,Nicolas Escude,7-6(7); 6-4; 7-6(5),R128,115,13,2,51,93,48,51,27,42,0,1,17,75,93,6,3,68,101,53,68,18,33,2,4,17,71,101
2003-06-23 00:00:00.000,Wimbledon England Grand Slams,GRASS,3,Juan Carlos Ferrero,Jean-Rene Lisnard,Juan Carlos Ferrero,6-2; 6-1; 6-3,R128,81,6,2,43,71,31,43,18,28,1,2,12,49,71,2,4,33,69,20,33,15,36,3,10,12,35,69
2003-06-23 00:00:00.000,Wimbledon England Grand Slams,GRASS,3,Olivier Rochus,Guillermo Coria,Olivier Rochus,7-5; 7-6(4); 6-3,R128,123,2,0,73,106,50,73,21,33,4,6,17,71,106,8,4,68,106,47,68,15,38,4,8,16,62,106
2003-06-23 00:00:00.000,Wimbledon England Grand Slams,GRASS,3,Antony Dupuis,Richard Bloomfield,Antony Dupuis,6-4; 7-6(6); 6-3,R128,119,18,2,62,95,53,62,17,33,3,4,16,70,95,12,3,55,102,40,55,24,47,5,8,15,64,102
2003-06-23 00:00:00.000,Wimbledon England Grand Slams,GRASS,3,Stefano Galvani,Julien Boutter,Stefano Galvani,6-3; 2-6; 1-6; 6-2; 8-6,R128,163,7,5,75,129,50,75,30,54,7,14,23,80,129,24,17,69,129,51,69,29,60,4,11,23,80,129
2003-06-23 00:00:00.000,Wimbledon England Grand Slams,GRASS,3,Jarkko Nieminen,Fernando Verdasco,Jarkko Nieminen,6-7(8); 6-4; 4-6; 6-3; 6-3,R128,196,10,5,109,170,82,109,28,61,10,14,25,110,170,7,8,128,180,84,128,24,52,14,21,25,108,180
2003-06-23 00:00:00.000,Wimbledon England Grand Slams,GRASS,3,Raemon Sluiter,Yevgeny Kafelnikov,Raemon Sluiter,7-5; 3-6; 2-6; 6-2; 6-3,R128,161,17,6,94,151,65,94,34,57,6,9,23,99,151,10,7,74,130,57,74,29,56,5,9,23,86,130
2003-06-23 00:00:00.000,Wimbledon England Grand Slams,GRASS,3,Alexander Popp,Hicham Arazi,Alexander Popp,6-4; 7-6(5); 6-3,R128,131,6,4,67,106,46,67,22,39,6,9,15,68,106,1,0,71,111,43,71,20,40,5,11,16,63,111
2003-06-23 00:00:00.000,Wimbledon England Grand Slams,GRASS,3,David Ferrer,Martin Lee,David Ferrer,1-6; 6-3; 6-1; 6-2,R128,107,3,9,49,90,35,49,19,41,4,8,15,54,90,4,4,64,108,36,64,16,44,9,17,16,52,108
2003-06-23 00:00:00.000,Wimbledon England Grand Slams,GRASS,3,Jiri Novak,Luis Horna,Jiri Novak,3-6; 7-6(1); 6-1; 6-1,R128,121,13,2,77,101,57,77,11,24,3,6,17,68,101,6,5,65,103,43,65,15,38,4,11,18,58,103
2003-06-23 00:00:00.000,Wimbledon England Grand Slams,GRASS,3,Cyril Saulnier,Xavier Malisse,Cyril Saulnier,6-4; 6-3; 6-2,R128,93,7,3,43,77,36,43,21,34,0,0,14,57,77,6,3,36,79,25,36,23,43,3,7,13,48,79
2003-06-23 00:00:00.000,Wimbledon England Grand Slams,GRASS,3,Mark Philippoussis,Mariano Zabaleta,Mark Philippoussis,6-3; 4-6; 6-3; 6-2,R128,131,21,10,56,99,44,56,23,43,4,7,18,67,99,7,5,80,126,49,80,21,46,9,16,18,70,126
2003-06-23 00:00:00.000,Wimbledon England Grand Slams,GRASS,3,Scott Draper,Paul-Henri Mathieu,Scott Draper,7-6(5); 4-6; 6-3; 6-4,R128,169,32,4,104,150,77,104,22,46,11,13,21,99,150,8,9,75,143,52,75,37,68,15,18,20,89,143
2003-06-23 00:00:00.000,Wimbledon England Grand Slams,GRASS,3,Radek Stepanek,Michal Mertinak,Radek Stepanek,7-6(6); 6-4; 6-4,R128,140,11,7,58,103,49,58,26,45,4,5,16,75,103,6,3,71,116,49,71,26,45,10,13,16,75,116
2003-06-23 00:00:00.000,Wimbledon England Grand Slams,GRASS,3,Younes El Aynaoui,Mark Hilton,Younes El Aynaoui,6-3; 6-2; 6-4,R128,96,17,3,43,67,40,43,13,24,0,1,14,53,67,1,13,45,87,30,45,18,42,7,12,13,48,87
2003-06-23 00:00:00.000,Wimbledon England Grand Slams,GRASS,3,Nicolas Massu,Zeljko Krajan,Nicolas Massu,6-1; 6-1; 6-1,R128,72,8,4,28,54,25,28,17,26,4,4,10,42,54,4,8,41,67,24,41,4,26,6,14,11,28,67
2003-06-23 00:00:00.000,Wimbledon England Grand Slams,GRASS,3,Lars Burgsmuller,Albert Montanes,Lars Burgsmuller,6-3; 7-6(5); 4-6; 6-2,R128,144,12,8,62,117,48,62,32,55,6,9,19,80,117,3,3,84,138,54,84,27,54,9,15,20,81,138
2003-06-23 00:00:00.000,Wimbledon England Grand Slams,GRASS,3,Andre Agassi,Jamie Delgado,Andre Agassi,6-4; 6-0; 5-7; 6-4,R128,120,16,4,62,104,52,62,22,42,4,6,19,74,104,12,7,64,109,46,64,18,45,4,10,19,64,109
2003-06-23 00:00:00.000,Wimbledon England Grand Slams,GRASS,3,Ivo Karlovic,Paul Baccanello,Ivo Karlovic,6-4; 7-6(3); 5-7; 6-2,R64,155,25,7,86,125,71,86,21,39,3,4,21,92,125,4,7,96,141,69,96,20,45,14,17,21,89,141
2003-06-23 00:00:00.000,Wimbledon England Grand Slams,GRASS,3,Max Mirnyi,Ivan Ljubicic,Max Mirnyi,6-3; 6-4; 2-6; 6-2,R64,118,19,5,76,103,59,76,16,27,3,5,18,75,103,14,2,62,99,44,62,15,37,3,7,17,59,99
2003-06-23 00:00:00.000,Wimbledon England Grand Slams,GRASS,3,Jonas Bjorkman,Jurgen Melzer,Jonas Bjorkman,6-4; 6-2; 2-6; 6-3,R64,122,7,4,73,104,56,73,20,31,8,10,18,76,104,5,2,65,102,46,65,15,37,3,7,17,61,102
2003-06-23 00:00:00.000,Wimbledon England Grand Slams,GRASS,3,Justin Gimelstob,Arnaud Clement,Justin Gimelstob,2-6; 6-3; 6-4; 6-7(2); 6-1,R64,196,24,10,98,160,73,98,28,62,12,15,24,101,160,5,1,86,134,62,86,23,48,5,10,22,85,134
2003-06-23 00:00:00.000,Wimbledon England Grand Slams,GRASS,3,Paradorn Srichaphan,Olivier Mutis,Paradorn Srichaphan,4-6; 1-6; 7-6(4); 7-5; 7-5,R64,217,15,6,101,178,74,101,32,77,6,14,27,106,178,5,9,96,177,62,96,45,81,13,19,26,107,177
2003-06-23 00:00:00.000,Wimbledon England Grand Slams,GRASS,3,Rafael Nadal,Lee Childs,Rafael Nadal,6-2; 6-4; 6-3,R64,121,3,2,50,78,39,50,16,28,2,4,14,55,78,9,5,52,89,36,52,14,37,13,19,13,50,89
2003-06-23 00:00:00.000,Wimbledon England Grand Slams,GRASS,3,Tommy Robredo,Brian Vahaly,Tommy Robredo,6-4; 6-4; 6-2,R64,98,6,2,56,87,47,56,17,31,10,10,14,64,87,1,4,56,89,37,56,14,33,4,8,14,51,89
2003-06-23 00:00:00.000,Wimbledon England Grand Slams,GRASS,3,Andy Roddick,Greg Rusedski,Andy Roddick,7-6(4); 7-6(1); 7-5,R64,123,14,4,71,108,61,71,19,37,1,2,18,80,108,15,1,67,112,50,67,26,45,6,8,18,76,112
2003-06-23 00:00:00.000,Wimbledon England Grand Slams,GRASS,3,Roger Federer,Stefan Koubek,Roger Federer,7-5; 6-1; 6-1,R64,77,6,3,44,73,35,44,16,29,2,3,13,51,73,0,3,45,75,20,45,15,30,5,12,13,35,75
2003-06-23 00:00:00.000,Wimbledon England Grand Slams,GRASS,3,Mardy Fish,Jan-Michael Gambill,Mardy Fish,6-4; 6-4; 6-1,R64,89,15,3,42,73,37,42,18,31,0,1,14,55,73,8,1,48,71,33,48,10,23,4,9,13,43,71
2003-06-23 00:00:00.000,Wimbledon England Grand Slams,GRASS,3,Flavio Saretta,Agustin Calleri,Flavio Saretta,6-4; 6-7(13); 6-2; 6-7(5); 10-8,R64,268,13,10,123,203,94,123,39,80,11,17,30,133,203,10,11,132,226,92,132,39,94,17,27,30,131,226
2003-06-23 00:00:00.000,Wimbledon England Grand Slams,GRASS,3,Feliciano Lopez,Mikhail Youzhny,Feliciano Lopez,7-6(5); 6-3; 6-2,R64,105,24,3,62,106,49,62,20,44,6,7,15,69,106,3,8,63,97,37,63,15,34,7,11,14,52,97
2003-06-23 00:00:00.000,Wimbledon England Grand Slams,GRASS,3,Rainer Schuettler,Fabrice Santoro,Rainer Schuettler,6-2; 6-3; 6-3,R64,106,3,0,60,81,45,60,12,21,3,3,13,57,81,0,1,60,89,37,60,10,29,5,10,13,47,89
2003-06-23 00:00:00.000,Wimbledon England Grand Slams,GRASS,3,Todd Martin,Gustavo Kuerten,Todd Martin,7-6(4); 6-4; 6-4,R64,114,20,6,66,94,57,66,14,28,3,3,16,71,94,9,3,63,109,45,63,26,46,4,6,16,71,109
2003-06-23 00:00:00.000,Wimbledon England Grand Slams,GRASS,3,Victor Hanescu,Juan Ignacio Chela,Victor Hanescu,6-2; 6-1; 6-4,R64,88,5,1,56,81,42,56,15,25,6,6,13,57,81,3,3,44,82,28,44,17,38,6,11,12,45,82
2003-06-23 00:00:00.000,Wimbledon England Grand Slams,GRASS,3,Sjeng Schalken,Nicolas Lapentti,Sjeng Schalken,6-2; 3-6; 6-7(3); 7-6(4); 6-3,R64,237,5,5,118,162,74,118,25,44,3,8,25,99,162,14,2,100,155,68,100,27,55,2,9,25,95,155
2003-06-23 00:00:00.000,Wimbledon England Grand Slams,GRASS,3,David Nalbandian,Andre Sa,David Nalbandian,6-2; 7-5; 6-2,R64,111,4,8,41,84,33,41,19,43,2,6,14,52,84,2,4,61,96,34,61,12,35,5,14,14,46,96
2003-06-23 00:00:00.000,Wimbledon England Grand Slams,GRASS,3,Karol Kucera,Takao Suzuki,Karol Kucera,6-3; 7-5; 6-2,R64,126,4,6,54,95,42,54,24,41,5,6,15,66,95,3,1,44,81,28,44,19,37,4,9,14,47,81
2003-06-23 00:00:00.000,Wimbledon England Grand Slams,GRASS,3,Robin Soderling,Gilles Elseneer,Robin Soderling,2-6; 7-6(8); 6-4; 6-3,R64,120,12,7,62,109,47,62,30,47,3,6,19,77,109,14,6,80,115,64,80,16,35,1,5,20,80,115
2003-06-23 00:00:00.000,Wimbledon England Grand Slams,GRASS,3,Tim Henman,Michael Llodra,Tim Henman,6-4; 6-4; 6-3,R64,115,3,6,64,98,49,64,16,34,9,11,15,65,98,4,4,51,82,27,51,17,31,3,8,14,44,82
2003-06-23 00:00:00.000,Wimbledon England Grand Slams,GRASS,3,Sebastien Grosjean,Wayne Arthurs,Sebastien Grosjean,6-3; 6-4; 6-7(12); 6-3,R64,140,13,0,68,119,54,68,38,51,0,0,21,92,119,14,4,58,107,48,58,31,49,1,4,19,79,107
2003-06-23 00:00:00.000,Wimbledon England Grand Slams,GRASS,3,Wesley Moodie,Frederic Niemeyer,Wesley Moodie,7-6(8); 4-6; 2-6; 6-1; 7-5,R64,194,26,10,119,176,93,119,24,57,8,11,25,117,176,19,12,86,157,64,86,42,71,10,13,24,106,157
2003-06-23 00:00:00.000,Wimbledon England Grand Slams,GRASS,3,Sargis Sargsian,James Blake,Sargis Sargsian,6-2; 7-6(3); 6-2,R64,114,4,4,42,84,32,42,23,42,6,9,14,55,84,1,10,56,110,36,56,19,54,9,16,14,55,110
2003-06-23 00:00:00.000,Wimbledon England Grand Slams,GRASS,3,Juan Carlos Ferrero,Nicolas Escude,Juan Carlos Ferrero,6-7(5); 6-3; 6-3 RET,R64,152,7,8,69,112,50,69,19,43,6,9,15,69,112,11,10,70,118,47,70,18,48,10,16,15,65,118
2003-06-23 00:00:00.000,Wimbledon England Grand Slams,GRASS,3,Olivier Rochus,Antony Dupuis,Olivier Rochus,2-6; 6-3; 4-6; 7-6(5); 6-4,R64,189,5,5,102,166,71,102,34,64,10,14,24,105,166,27,6,100,166,74,100,33,66,12,16,25,107,166
2003-06-23 00:00:00.000,Wimbledon England Grand Slams,GRASS,3,Jarkko Nieminen,Stefano Galvani,Jarkko Nieminen,6-4; 5-7; 6-4; 7-6(3),R64,174,7,1,116,160,72,116,29,44,11,14,22,101,160,13,4,92,143,65,92,25,51,6,10,22,90,143
2003-06-23 00:00:00.000,Wimbledon England Grand Slams,GRASS,3,Alexander Popp,Raemon Sluiter,Alexander Popp,7-6(4); 4-6; 6-3; 6-7(5); 6-2,R64,184,17,7,120,175,92,120,21,55,6,10,26,113,175,11,4,84,140,66,84,28,56,5,11,25,94,140
2003-06-23 00:00:00.000,Wimbledon England Grand Slams,GRASS,3,Jiri Novak,David Ferrer,Jiri Novak,6-2; 7-5; 6-3,R64,89,2,2,59,84,43,59,10,25,3,6,15,53,84,1,6,58,95,30,58,17,37,4,11,14,47,95
2003-06-23 00:00:00.000,Wimbledon England Grand Slams,GRASS,3,Mark Philippoussis,Cyril Saulnier,Mark Philippoussis,6-3; 6-2; 7-6(2),R64,106,19,5,55,86,48,55,16,31,3,4,15,64,86,9,2,68,99,42,68,14,31,4,8,14,56,99
2003-06-23 00:00:00.000,Wimbledon England Grand Slams,GRASS,3,Radek Stepanek,Scott Draper,Radek Stepanek,7-6(6); 6-3; 6-1,R64,101,11,2,56,79,44,56,17,23,1,2,14,61,79,6,4,55,96,34,55,24,41,5,10,14,58,96
2003-06-23 00:00:00.000,Wimbledon England Grand Slams,GRASS,3,Younes El Aynaoui,Nicolas Massu,Younes El Aynaoui,7-6(5); 3-6; 7-6(4); 6-4,R64,211,16,4,104,144,77,104,16,40,9,12,21,93,144,14,6,90,152,67,90,32,62,6,9,22,99,152
2003-06-23 00:00:00.000,Wimbledon England Grand Slams,GRASS,3,Andre Agassi,Lars Burgsmuller,Andre Agassi,6-3; 7-6(4); 6-3,R64,111,4,2,59,83,48,59,13,24,2,3,14,61,83,8,2,61,100,39,61,20,39,4,9,16,59,100
2003-06-23 00:00:00.000,Wimbledon England Grand Slams,GRASS,3,Max Mirnyi,Ivo Karlovic,Max Mirnyi,7-6(5); 3-6; 6-3; 7-6(4),R32,143,7,3,87,126,72,87,27,39,3,4,21,99,126,25,4,77,121,68,77,24,44,1,2,21,92,121
2003-06-23 00:00:00.000,Wimbledon England Grand Slams,GRASS,3,Jonas Bjorkman,Justin Gimelstob,Jonas Bjorkman,6-1; 6-3; 6-3,R32,96,6,4,52,79,42,52,14,27,3,4,13,56,79,6,3,37,74,25,37,11,37,6,12,12,36,74
2003-06-23 00:00:00.000,Wimbledon England Grand Slams,GRASS,3,Paradorn Srichaphan,Rafael Nadal,Paradorn Srichaphan,6-4; 6-4; 6-2,R32,116,7,4,53,82,38,53,17,29,1,3,14,55,82,2,3,73,100,46,73,7,27,9,15,14,53,100
2003-06-23 00:00:00.000,Wimbledon England Grand Slams,GRASS,3,Andy Roddick,Tommy Robredo,Andy Roddick,7-6(5); 6-4; 6-4,R32,114,9,3,70,96,56,70,17,26,1,1,16,73,96,5,5,66,104,53,66,17,38,1,3,16,70,104
2003-06-23 00:00:00.000,Wimbledon England Grand Slams,GRASS,3,Roger Federer,Mardy Fish,Roger Federer,6-3; 6-1; 4-6; 6-1,R32,120,13,4,59,110,43,59,31,51,5,6,17,74,110,9,6,56,102,38,56,19,46,6,12,16,57,102
2003-06-23 00:00:00.000,Wimbledon England Grand Slams,GRASS,3,Feliciano Lopez,Flavio Saretta,Feliciano Lopez,6-4; 6-4; 6-4,R32,101,18,6,51,88,43,51,20,37,7,8,15,63,88,6,6,56,95,37,56,22,39,8,12,15,59,95
2003-06-23 00:00:00.000,Wimbledon England Grand Slams,GRASS,3,Rainer Schuettler,Todd Martin,Rainer Schuettler,4-6; 7-5; 6-7(1); 6-1; 7-5,R32,210,8,1,107,156,83,107,22,49,3,7,27,105,156,13,9,112,173,77,112,28,61,14,21,26,105,173
2003-06-23 00:00:00.000,Wimbledon England Grand Slams,GRASS,3,Sjeng Schalken,Victor Hanescu,Sjeng Schalken,6-2; 6-4; 7-6(3),R32,113,6,0,66,95,52,66,15,29,1,2,15,67,95,4,2,49,92,30,49,23,43,2,6,15,53,92
2003-06-23 00:00:00.000,Wimbledon England Grand Slams,GRASS,3,David Nalbandian,Karol Kucera,David Nalbandian,6-4; 5-7; 6-7(1); 6-4; 6-2,R32,263,2,9,104,180,68,104,36,76,13,20,26,104,180,7,11,105,167,72,105,21,62,13,23,26,93,167
2003-06-23 00:00:00.000,Wimbledon England Grand Slams,GRASS,3,Tim Henman,Robin Soderling,Tim Henman,6-3; 6-1; 6-4,R32,94,12,2,47,67,35,47,13,20,2,4,13,48,67,5,7,55,93,34,55,10,38,10,17,13,44,93
2003-06-23 00:00:00.000,Wimbledon England Grand Slams,GRASS,3,Sebastien Grosjean,Wesley Moodie,Sebastien Grosjean,6-7(5); 6-2; 6-4; 6-4,R32,164,15,3,65,115,55,65,31,50,3,3,20,86,115,8,5,115,157,72,115,23,42,15,19,20,95,157
2003-06-23 00:00:00.000,Wimbledon England Grand Slams,GRASS,3,Juan Carlos Ferrero,Sargis Sargsian,Juan Carlos Ferrero,6-4; 6-4; 2-6; 6-4,R32,137,10,10,75,120,55,75,23,45,5,8,19,78,120,9,4,58,97,48,58,18,39,4,8,19,66,97
2003-06-23 00:00:00.000,Wimbledon England Grand Slams,GRASS,3,Olivier Rochus,Jarkko Nieminen,Olivier Rochus,7-6(5); 6-3; 6-1,R32,114,6,5,58,93,43,58,13,35,4,8,14,56,93,6,3,73,111,41,73,15,38,9,17,14,56,111
2003-06-23 00:00:00.000,Wimbledon England Grand Slams,GRASS,3,Alexander Popp,Jiri Novak,Alexander Popp,6-3; 6-4; 7-6(3),R32,94,6,6,54,88,45,54,20,34,2,4,16,65,88,0,1,77,95,45,77,11,18,1,5,15,56,95
2003-06-23 00:00:00.000,Wimbledon England Grand Slams,GRASS,3,Mark Philippoussis,Radek Stepanek,Mark Philippoussis,4-6; 7-6(7); 6-4; 7-6(6),R32,215,33,12,83,148,74,83,33,65,4,5,22,107,148,15,8,131,192,85,131,35,61,12,13,22,120,192
2003-06-23 00:00:00.000,Wimbledon England Grand Slams,GRASS,3,Andre Agassi,Younes El Aynaoui,Andre Agassi,5-7; 6-4; 7-6(4); 7-6(4),R32,193,13,4,92,144,73,92,33,52,8,9,23,106,144,19,3,113,160,79,113,28,47,6,7,23,107,160
2003-06-23 00:00:00.000,Wimbledon England Grand Slams,GRASS,3,Jonas Bjorkman,Max Mirnyi,Jonas Bjorkman,6-4; 3-6; 6-3; 7-6(4),R16,176,9,6,93,138,69,93,20,45,6,9,20,89,138,14,5,79,134,58,79,27,55,8,12,20,85,134
2003-06-23 00:00:00.000,Wimbledon England Grand Slams,GRASS,3,Andy Roddick,Paradorn Srichaphan,Andy Roddick,6-4; 3-6; 6-3; 6-2,R16,114,14,2,64,102,56,64,20,38,6,7,18,76,102,6,2,71,105,49,71,17,34,4,8,18,66,105
2003-06-23 00:00:00.000,Wimbledon England Grand Slams,GRASS,3,Roger Federer,Feliciano Lopez,Roger Federer,7-6(5); 6-4; 6-4,R16,126,9,2,69,104,48,69,17,35,3,6,16,65,104,13,3,80,127,51,80,24,47,13,18,16,75,127
2003-06-23 00:00:00.000,Wimbledon England Grand Slams,GRASS,3,Sjeng Schalken,Rainer Schuettler,Sjeng Schalken,7-5; 6-4; 7-5,R16,161,6,6,87,119,59,87,19,32,7,8,17,78,119,4,2,71,131,49,71,27,60,11,15,17,76,131
2003-06-23 00:00:00.000,Wimbledon England Grand Slams,GRASS,3,Tim Henman,David Nalbandian,Tim Henman,6-2; 6-7(4); 7-5; 6-3,R16,181,5,7,79,119,57,79,18,40,1,6,20,75,119,1,5,100,140,56,100,19,40,10,20,21,75,140
2003-06-23 00:00:00.000,Wimbledon England Grand Slams,GRASS,3,Sebastien Grosjean,Juan Carlos Ferrero,Sebastien Grosjean,6-2; 4-6; 7-6(2); 7-6(3),R16,195,19,4,80,142,65,80,30,62,4,7,21,95,142,6,5,84,143,60,84,29,59,8,12,21,89,143
2003-06-23 00:00:00.000,Wimbledon England Grand Slams,GRASS,3,Alexander Popp,Olivier Rochus,Alexander Popp,5-7; 6-3; 6-4; 6-2,R16,142,12,2,76,117,55,76,23,41,3,6,20,78,117,4,6,69,131,45,69,30,62,3,9,19,75,131
2003-06-23 00:00:00.000,Wimbledon England Grand Slams,GRASS,3,Mark Philippoussis,Andre Agassi,Mark Philippoussis,6-3; 2-6; 6-7(4); 6-3; 6-4,R16,193,46,12,100,157,82,100,25,57,9,11,25,107,157,10,2,110,165,76,110,31,55,18,21,23,107,165
2003-06-23 00:00:00.000,Wimbledon England Grand Slams,GRASS,3,Andy Roddick,Jonas Bjorkman,Andy Roddick,6-4; 6-2; 6-4,Q,92,14,1,50,70,44,50,11,20,0,1,14,55,70,4,6,56,92,40,56,15,36,6,11,14,55,92
2003-06-23 00:00:00.000,Wimbledon England Grand Slams,GRASS,3,Roger Federer,Sjeng Schalken,Roger Federer,6-3; 6-4; 6-4,Q,98,13,5,62,92,50,62,15,30,3,4,15,65,92,1,2,74,102,45,74,12,28,7,11,14,57,102
2003-06-23 00:00:00.000,Wimbledon England Grand Slams,GRASS,3,Sebastien Grosjean,Tim Henman,Sebastien Grosjean,7-6(8); 3-6; 6-3; 6-4,Q,194,12,1,69,124,52,69,29,55,6,11,20,81,124,2,5,82,138,49,82,30,56,3,9,20,79,138
2003-06-23 00:00:00.000,Wimbledon England Grand Slams,GRASS,3,Mark Philippoussis,Alexander Popp,Mark Philippoussis,4-6; 4-6; 6-3; 6-3; 8-6,Q,207,34,7,90,137,80,90,25,47,5,7,26,105,137,14,9,108,176,83,108,30,68,15,19,26,113,176
2003-06-23 00:00:00.000,Wimbledon England Grand Slams,GRASS,3,Roger Federer,Andy Roddick,Roger Federer,7-6(6); 6-3; 6-3,S,103,17,0,51,84,42,51,25,33,2,2,15,67,84,4,0,57,99,42,57,21,42,5,8,15,63,99
2003-06-23 00:00:00.000,Wimbledon England Grand Slams,GRASS,3,Mark Philippoussis,Sebastien Grosjean,Mark Philippoussis,7-6(3); 6-3; 6-3,S,116,11,3,47,85,42,47,24,38,2,2,15,66,85,5,3,47,89,35,47,24,42,5,8,15,59,89
2003-06-23 00:00:00.000,Wimbledon England Grand Slams,GRASS,3,Roger Federer,Mark Philippoussis,Roger Federer,7-6(5); 6-2; 7-6(3),F,116,21,2,53,93,47,53,27,40,0,0,16,74,93,14,4,70,102,54,70,14,32,3,5,16,68,102
2003-07-07 00:00:00.000,Bastad Sweden ATP World Tour,CLAY,2,Carlos Moya,Dominik Hrbaty,Carlos Moya,6-2; 6-7(2); 6-3,R32,121,11,1,54,101,44,54,23,47,7,8,15,67,101,2,7,52,103,38,52,23,51,6,10,14,61,103
2003-07-07 00:00:00.000,Bastad Sweden ATP World Tour,CLAY,2,Robin Soderling,Markus Hipfl,Robin Soderling,7-5; 6-1,R32,82,7,2,43,78,30,43,13,35,8,12,10,43,78,0,1,36,51,16,36,4,15,3,10,9,20,51
2003-07-07 00:00:00.000,Bastad Sweden ATP World Tour,CLAY,2,Jonas Bjorkman,Mariano Puerta,Jonas Bjorkman,7-6(4); 6-4,R32,103,5,2,39,79,31,39,19,40,2,4,11,50,79,2,3,49,76,33,49,13,27,4,7,11,46,76
2003-07-07 00:00:00.000,Bastad Sweden ATP World Tour,CLAY,2,David Ferrer,Fernando Vicente,David Ferrer,6-4; 6-3,R32,73,1,2,36,58,25,36,15,22,2,3,10,40,58,2,3,28,55,19,28,13,27,3,6,9,32,55
2003-07-07 00:00:00.000,Bastad Sweden ATP World Tour,CLAY,2,Mikhail Youzhny,Olivier Rochus,Mikhail Youzhny,7-6(4); 7-6(1),R32,100,6,3,49,86,35,49,23,37,3,5,12,58,86,1,0,47,78,33,47,17,31,4,6,12,50,78
2003-07-07 00:00:00.000,Bastad Sweden ATP World Tour,CLAY,2,Franco Squillari,Ladislav Svarc,Franco Squillari,6-4; 6-3,R32,76,4,1,35,55,26,35,11,20,2,3,9,37,55,3,0,41,64,25,41,11,23,9,13,10,36,64
2003-07-07 00:00:00.000,Bastad Sweden ATP World Tour,CLAY,2,Bjorn Rehnquist,Henrik Andersson,Bjorn Rehnquist,6-3; 6-1,R32,65,1,2,37,48,30,37,4,11,2,2,8,34,48,2,0,35,55,17,35,10,20,7,11,8,27,55
2003-07-07 00:00:00.000,Bastad Sweden ATP World Tour,CLAY,2,Mariano Zabaleta,Nicolas Massu,Mariano Zabaleta,2-6; 6-3; 6-3,R32,131,3,2,42,75,32,42,16,33,3,6,13,48,75,1,3,47,82,31,47,17,35,3,7,13,48,82
2003-07-07 00:00:00.000,Bastad Sweden ATP World Tour,CLAY,2,Nicolas Lapentti,Luis Horna,Nicolas Lapentti,6-4; 7-5,R32,110,7,2,52,76,41,52,11,24,7,8,11,52,76,4,1,50,73,27,50,16,23,4,7,11,43,73
2003-07-07 00:00:00.000,Bastad Sweden ATP World Tour,CLAY,2,Adrian Voinea,Filip Prpic,Adrian Voinea,7-6(2); 6-2,R32,79,6,4,52,83,37,52,14,31,3,5,10,51,83,2,3,43,70,27,43,10,27,5,9,10,37,70
2003-07-07 00:00:00.000,Bastad Sweden ATP World Tour,CLAY,2,Albert Portas,Rogier Wassen,Albert Portas,6-4; 6-4,R32,79,1,2,36,55,27,36,12,19,1,2,10,39,55,4,2,42,67,26,42,12,25,5,8,10,38,67
2003-07-07 00:00:00.000,Bastad Sweden ATP World Tour,CLAY,2,Rafael Nadal,Younes El Aynaoui,Rafael Nadal,6-3; 4-6; 6-3,R32,102,0,1,61,81,48,61,10,20,1,2,14,58,81,8,5,44,75,32,44,17,31,2,5,14,49,75
2003-07-07 00:00:00.000,Bastad Sweden ATP World Tour,CLAY,2,Olivier Mutis,Alberto Martin,Olivier Mutis,7-6(3); 6-3,R32,96,3,5,37,76,26,37,22,39,3,6,11,48,76,1,10,45,74,26,45,12,29,8,12,10,38,74
2003-07-07 00:00:00.000,Bastad Sweden ATP World Tour,CLAY,2,Filippo Volandri,Federico Browne,Filippo Volandri,6-1; 6-1,R32,46,2,0,28,37,23,28,6,9,1,1,7,29,37,0,3,30,48,14,30,7,18,6,11,7,21,48
2003-07-07 00:00:00.000,Bastad Sweden ATP World Tour,CLAY,2,Hicham Arazi,Magnus Norman,Hicham Arazi,7-5; 6-4,R32,96,6,2,43,70,29,43,15,27,4,6,11,44,70,4,0,38,65,25,38,11,27,6,10,11,36,65
2003-07-07 00:00:00.000,Bastad Sweden ATP World Tour,CLAY,2,Tommy Robredo,Marcus Sarstrand,Tommy Robredo,6-3; 6-2,R32,59,7,2,38,59,24,38,12,21,0,2,9,36,59,1,3,31,52,17,31,7,21,4,9,8,24,52
2003-07-07 00:00:00.000,Bastad Sweden ATP World Tour,CLAY,2,Carlos Moya,Robin Soderling,Carlos Moya,6-3; 6-4,R16,74,7,0,35,64,26,35,12,29,3,5,9,38,64,0,4,31,58,20,31,8,27,0,5,10,28,58
2003-07-07 00:00:00.000,Bastad Sweden ATP World Tour,CLAY,2,Jonas Bjorkman,David Ferrer,Jonas Bjorkman,6-2; 6-1,R16,53,1,1,26,43,21,26,12,17,0,0,8,33,43,0,6,23,46,12,23,10,23,6,10,7,22,46
2003-07-07 00:00:00.000,Bastad Sweden ATP World Tour,CLAY,2,Mikhail Youzhny,Franco Squillari,Mikhail Youzhny,6-1; 5-7; 6-2,R16,98,3,6,54,84,39,54,15,30,5,7,14,54,84,6,7,45,77,27,45,15,32,4,9,13,42,77
2003-07-07 00:00:00.000,Bastad Sweden ATP World Tour,CLAY,2,Mariano Zabaleta,Bjorn Rehnquist,Mariano Zabaleta,6-1; 6-2,R16,58,0,1,32,53,23,32,13,21,4,4,8,36,53,0,5,30,41,16,30,3,11,0,4,7,19,41
2003-07-07 00:00:00.000,Bastad Sweden ATP World Tour,CLAY,2,Nicolas Lapentti,Adrian Voinea,Nicolas Lapentti,6-4; 7-6(5),R16,117,1,1,48,77,30,48,19,29,1,3,11,49,77,1,7,42,81,30,42,18,39,5,8,11,48,81
2003-07-07 00:00:00.000,Bastad Sweden ATP World Tour,CLAY,2,Rafael Nadal,Albert Portas,Rafael Nadal,6-0; 6-4,R16,71,0,1,32,44,26,32,8,12,2,2,8,34,44,1,2,26,50,13,26,12,24,3,7,8,25,50
2003-07-07 00:00:00.000,Bastad Sweden ATP World Tour,CLAY,2,Filippo Volandri,Olivier Mutis,Filippo Volandri,6-3; 6-0,R16,48,0,1,31,46,24,31,9,15,2,3,8,33,46,1,1,18,44,9,18,10,26,1,6,7,19,44
2003-07-07 00:00:00.000,Bastad Sweden ATP World Tour,CLAY,2,Tommy Robredo,Hicham Arazi,Tommy Robredo,4-6; 6-2; 6-4,R16,133,4,2,76,104,46,76,10,28,10,16,14,56,104,1,1,59,100,29,59,19,41,12,20,14,48,100
2003-07-07 00:00:00.000,Bastad Sweden ATP World Tour,CLAY,2,Carlos Moya,Jonas Bjorkman,Carlos Moya,6-4; 6-3,Q,70,3,2,23,50,19,23,15,27,1,2,9,34,50,6,5,28,60,19,28,15,32,5,9,10,34,60
2003-07-07 00:00:00.000,Bastad Sweden ATP World Tour,CLAY,2,Mariano Zabaleta,Mikhail Youzhny,Mariano Zabaleta,4-6; 7-5; 6-1,Q,113,7,0,55,86,40,55,17,31,4,7,15,57,86,1,6,52,88,35,52,14,36,5,10,14,49,88
2003-07-07 00:00:00.000,Bastad Sweden ATP World Tour,CLAY,2,Nicolas Lapentti,Rafael Nadal,Nicolas Lapentti,3-6; 6-3; 7-6(6),Q,176,7,2,65,105,52,65,20,40,7,8,15,72,105,1,2,80,100,56,80,10,20,9,10,15,66,100
2003-07-07 00:00:00.000,Bastad Sweden ATP World Tour,CLAY,2,Tommy Robredo,Filippo Volandri,Tommy Robredo,6-4; 6-4,Q,111,1,2,40,54,22,40,11,14,0,2,10,33,54,0,4,49,78,30,49,11,29,2,6,10,41,78
2003-07-07 00:00:00.000,Bastad Sweden ATP World Tour,CLAY,2,Mariano Zabaleta,Carlos Moya,Mariano Zabaleta,2-6; 6-3; 6-4,S,124,2,1,70,109,46,70,18,39,14,16,14,64,109,4,2,58,86,40,58,15,28,5,7,13,55,86
2003-07-07 00:00:00.000,Bastad Sweden ATP World Tour,CLAY,2,Nicolas Lapentti,Tommy Robredo,Nicolas Lapentti,6-4; 6-2,S,78,3,0,50,69,32,50,8,19,5,7,9,40,69,1,2,33,52,18,33,5,19,2,7,9,23,52
2003-07-07 00:00:00.000,Bastad Sweden ATP World Tour,CLAY,2,Mariano Zabaleta,Nicolas Lapentti,Mariano Zabaleta,6-3; 6-4,F,93,1,1,32,56,25,32,14,24,1,2,10,39,56,4,1,40,59,25,40,9,19,4,7,9,34,59
2003-07-07 00:00:00.000,Gstaad Switzerland ATP World Tour,CLAY,2,Roger Federer,Marc Lopez,Roger Federer,6-3; 6-7(4); 6-3,R32,124,16,3,48,88,40,48,27,40,1,3,16,67,88,1,2,81,108,49,81,15,27,6,10,14,64,108
2003-07-07 00:00:00.000,Gstaad Switzerland ATP World Tour,CLAY,2,Jean-Rene Lisnard,Stanislas Wawrinka,Jean-Rene Lisnard,2-6; 6-1; 7-5,R32,118,1,6,48,96,33,48,25,48,3,6,14,58,96,0,6,52,80,35,52,12,28,4,8,13,47,80
2003-07-07 00:00:00.000,Gstaad Switzerland ATP World Tour,CLAY,2,David Sanchez,Karol Beck,David Sanchez,6-4; 7-5,R32,87,3,5,43,72,29,43,14,29,5,7,11,43,72,8,3,38,69,28,38,11,31,2,6,11,39,69
2003-07-07 00:00:00.000,Gstaad Switzerland ATP World Tour,CLAY,2,Alex Corretja,John van Lottum,Alex Corretja,6-1; 6-2,R32,63,7,2,20,43,18,20,15,23,0,0,8,33,43,1,6,26,54,16,26,11,28,3,7,7,27,54
2003-07-07 00:00:00.000,Gstaad Switzerland ATP World Tour,CLAY,2,Gaston Gaudio,Kristof Vliegen,Gaston Gaudio,6-3; 6-4,R32,66,6,2,34,56,25,34,17,22,4,4,9,42,56,3,1,23,50,20,23,13,27,1,4,10,33,50
2003-07-07 00:00:00.000,Gstaad Switzerland ATP World Tour,CLAY,2,Lars Burgsmuller,Zeljko Krajan,Lars Burgsmuller,6-2; 6-7(6); 6-1,R32,123,10,10,53,95,43,53,18,42,4,6,13,61,95,3,6,61,99,40,61,9,38,3,10,14,49,99
2003-07-07 00:00:00.000,Gstaad Switzerland ATP World Tour,CLAY,2,Stefan Koubek,Galo Blanco,Stefan Koubek,6-1; 1-6; 6-3,R32,89,8,2,44,72,34,44,14,28,5,7,12,48,72,2,1,46,77,30,46,15,31,7,10,11,45,77
2003-07-07 00:00:00.000,Gstaad Switzerland ATP World Tour,CLAY,2,Antony Dupuis,Nikolay Davydenko,Antony Dupuis,7-6(1); 7-6(4),R32,96,16,2,56,80,45,56,12,24,2,2,12,57,80,9,5,42,72,34,42,17,30,1,1,12,51,72
2003-07-07 00:00:00.000,Gstaad Switzerland ATP World Tour,CLAY,2,Juan Ignacio Chela,Andre Sa,Juan Ignacio Chela,6-0; 6-2,R32,54,7,4,22,44,16,22,15,22,1,1,7,31,44,0,1,32,45,16,32,3,13,2,7,7,19,45
2003-07-07 00:00:00.000,Gstaad Switzerland ATP World Tour,CLAY,2,Feliciano Lopez,Irakli Labadze,Feliciano Lopez,6-0; 6-2,R32,37,8,0,20,36,18,20,11,16,0,0,7,29,36,1,5,27,42,14,27,3,15,1,6,7,17,42
2003-07-07 00:00:00.000,Gstaad Switzerland ATP World Tour,CLAY,2,Paul-Henri Mathieu,Philipp Kohlschreiber,Paul-Henri Mathieu,6-3; 6-1,R32,83,5,2,30,64,23,30,19,34,5,5,8,42,64,3,0,25,52,15,25,12,27,6,10,8,27,52
2003-07-07 00:00:00.000,Gstaad Switzerland ATP World Tour,CLAY,2,Jiri Novak,Sargis Sargsian,Jiri Novak,6-3; 6-3,R32,57,4,1,36,48,30,36,9,12,2,2,9,39,48,3,2,31,48,21,31,8,17,2,5,9,29,48
2003-07-07 00:00:00.000,Gstaad Switzerland ATP World Tour,CLAY,2,Radek Stepanek,Hugo Armando,Radek Stepanek,6-3; 6-3,R32,68,13,0,32,44,30,32,7,12,1,1,9,37,44,3,3,43,66,30,43,7,23,3,6,9,37,66
2003-07-07 00:00:00.000,Gstaad Switzerland ATP World Tour,CLAY,2,Michel Kratochvil,Tomas Behrend,Michel Kratochvil,6-4; 6-7(6); 6-2,R32,141,4,1,50,107,40,50,29,57,3,5,15,69,107,11,3,58,89,40,58,14,31,1,6,15,54,89
2003-07-07 00:00:00.000,Gstaad Switzerland ATP World Tour,CLAY,2,Christophe Rochus,Michael Lammer,Christophe Rochus,6-3; 7-5,R32,88,1,3,44,69,28,44,16,25,7,9,11,44,69,3,7,32,77,22,32,19,45,7,11,10,41,77
2003-07-07 00:00:00.000,Gstaad Switzerland ATP World Tour,CLAY,2,Rainer Schuettler,Wayne Arthurs,Rainer Schuettler,6-2; 6-3,R32,59,6,1,26,42,23,26,13,16,0,0,9,36,42,4,6,26,57,18,26,12,31,9,12,8,30,57
2003-07-07 00:00:00.000,Gstaad Switzerland ATP World Tour,CLAY,2,Roger Federer,Jean-Rene Lisnard,Roger Federer,6-1; 6-2,R16,54,9,2,20,42,15,20,18,22,1,1,8,33,42,1,6,22,49,13,22,10,27,5,9,7,23,49
2003-07-07 00:00:00.000,Gstaad Switzerland ATP World Tour,CLAY,2,David Sanchez,Alex Corretja,David Sanchez,6-4; 6-4,R16,90,3,4,39,64,28,39,17,25,4,5,10,45,64,5,6,30,62,22,30,13,32,7,10,10,35,62
2003-07-07 00:00:00.000,Gstaad Switzerland ATP World Tour,CLAY,2,Gaston Gaudio,Lars Burgsmuller,Gaston Gaudio,4-6; 6-2; 6-4,R16,109,4,3,48,83,37,48,19,35,0,2,14,56,83,15,10,56,92,38,56,17,36,5,9,14,55,92
2003-07-07 00:00:00.000,Gstaad Switzerland ATP World Tour,CLAY,2,Stefan Koubek,Antony Dupuis,Stefan Koubek,6-1; 6-2,R16,60,2,3,32,55,27,32,11,23,4,4,8,38,55,7,4,18,47,12,18,10,29,6,10,7,22,47
2003-07-07 00:00:00.000,Gstaad Switzerland ATP World Tour,CLAY,2,Juan Ignacio Chela,Feliciano Lopez,Juan Ignacio Chela,6-4; 6-7(2); 7-6(3),R16,126,3,3,67,99,52,67,19,32,4,5,17,71,99,11,6,60,113,46,60,28,53,4,6,17,74,113
2003-07-07 00:00:00.000,Gstaad Switzerland ATP World Tour,CLAY,2,Jiri Novak,Paul-Henri Mathieu,Jiri Novak,1-6; 6-2; 6-3,R16,107,2,2,34,62,25,34,17,28,1,3,12,42,62,3,3,40,81,25,40,21,41,9,12,12,46,81
2003-07-07 00:00:00.000,Gstaad Switzerland ATP World Tour,CLAY,2,Radek Stepanek,Michel Kratochvil,Radek Stepanek,6-3; 7-6(5),R16,95,12,0,37,64,28,37,15,27,0,2,10,43,64,2,8,34,70,28,34,11,36,2,6,11,39,70
2003-07-07 00:00:00.000,Gstaad Switzerland ATP World Tour,CLAY,2,Rainer Schuettler,Christophe Rochus,Rainer Schuettler,6-3; 7-6(6),R16,88,8,7,45,77,30,45,14,32,4,7,11,44,77,0,6,38,72,23,38,16,34,2,6,10,39,72
2003-07-07 00:00:00.000,Gstaad Switzerland ATP World Tour,CLAY,2,Roger Federer,David Sanchez,Roger Federer,W/O,Q,0,0,0,0,0,0,0,0,0,0,0,0,0,0,0,0,0,0,0,0,0,0,0,0,0,0,0
2003-07-07 00:00:00.000,Gstaad Switzerland ATP World Tour,CLAY,2,Gaston Gaudio,Stefan Koubek,Gaston Gaudio,6-3; 6-1,Q,63,4,3,25,45,21,25,9,20,0,1,8,30,45,4,3,32,60,16,32,11,28,13,18,8,27,60
2003-07-07 00:00:00.000,Gstaad Switzerland ATP World Tour,CLAY,2,Jiri Novak,Juan Ignacio Chela,Jiri Novak,6-3; 6-3,Q,74,2,2,35,70,28,35,16,35,8,9,9,44,70,2,6,35,63,21,35,12,28,6,10,9,33,63
2003-07-07 00:00:00.000,Gstaad Switzerland ATP World Tour,CLAY,2,Radek Stepanek,Rainer Schuettler,Radek Stepanek,6-4; 6-2,Q,67,9,1,40,55,32,40,9,15,2,2,9,41,55,3,4,36,65,21,36,16,29,3,6,9,37,65
2003-07-07 00:00:00.000,Gstaad Switzerland ATP World Tour,CLAY,2,Roger Federer,Gaston Gaudio,Roger Federer,6-1; 7-6(6),S,88,12,2,39,61,33,39,11,22,1,2,10,44,61,0,4,49,68,28,49,10,19,8,11,9,38,68
2003-07-07 00:00:00.000,Gstaad Switzerland ATP World Tour,CLAY,2,Jiri Novak,Radek Stepanek,Jiri Novak,7-5; 6-1,S,76,5,3,37,55,27,37,10,18,0,2,10,37,55,2,5,36,71,23,36,12,35,2,7,9,35,71
2003-07-07 00:00:00.000,Gstaad Switzerland ATP World Tour,CLAY,2,Jiri Novak,Roger Federer,Jiri Novak,5-7; 6-3; 6-3; 1-6; 6-3,F,169,3,4,91,142,62,91,28,51,7,12,23,90,142,19,11,83,148,59,83,30,65,10,16,23,89,148
2003-07-07 00:00:00.000,Newport RI; U.S.A. ATP World Tour,GRASS,2,Gregory Carraz,James Blake,Gregory Carraz,7-6(4); 5-7; 6-4,R32,135,10,14,48,103,37,48,27,55,2,7,17,64,103,11,8,59,106,47,59,18,47,8,13,17,65,106
2003-07-07 00:00:00.000,Newport RI; U.S.A. ATP World Tour,GRASS,2,Chris Guccione,Stefano Pescosolido,Chris Guccione,7-6(2); 7-6(4),R32,83,17,7,53,89,42,53,18,36,6,8,12,60,89,8,5,45,76,36,45,16,31,0,2,12,52,76
2003-07-07 00:00:00.000,Newport RI; U.S.A. ATP World Tour,GRASS,2,Zack Fleishman,Joachim Johansson,Zack Fleishman,6-3; 6-4,R32,74,5,5,36,76,29,36,20,40,7,8,10,49,76,7,13,23,57,20,23,12,34,4,7,9,32,57
2003-07-07 00:00:00.000,Newport RI; U.S.A. ATP World Tour,GRASS,2,Justin Gimelstob,Jeff Morrison,Justin Gimelstob,6-4; 4-6; 7-6(13),R32,146,4,6,73,125,57,73,27,52,9,11,16,84,125,14,6,68,111,51,68,23,43,1,3,16,74,111
2003-07-07 00:00:00.000,Newport RI; U.S.A. ATP World Tour,GRASS,2,Robby Ginepri,Prakash Amritraj,Robby Ginepri,6-1; 6-4,R32,57,7,1,27,38,23,27,9,11,0,0,8,32,38,4,5,34,59,22,34,9,25,2,6,9,31,59
2003-07-07 00:00:00.000,Newport RI; U.S.A. ATP World Tour,GRASS,2,Dennis van Scheppingen,Alexander Waske,Dennis van Scheppingen,6-2 RET,R32,22,5,0,16,20,13,16,4,4,0,0,4,17,20,8,0,14,22,7,14,5,8,1,3,4,12,22
2003-07-07 00:00:00.000,Newport RI; U.S.A. ATP World Tour,GRASS,2,Andrei Stoliarov,Robert Kendrick,Andrei Stoliarov,6-2; 6-4,R32,70,4,0,34,58,26,34,16,24,6,6,9,42,58,11,8,33,69,20,33,20,36,13,16,9,40,69
2003-07-07 00:00:00.000,Newport RI; U.S.A. ATP World Tour,GRASS,2,Ivan Miranda,Brian Vahaly,Ivan Miranda,7-6(6); 6-3,R32,77,5,1,36,65,29,36,13,29,3,5,10,42,65,5,3,47,71,30,47,11,24,1,5,11,41,71
2003-07-07 00:00:00.000,Newport RI; U.S.A. ATP World Tour,GRASS,2,Scott Draper,Raemon Sluiter,Scott Draper,6-3; 3-2 RET,R32,35,6,1,17,31,17,17,11,14,0,0,7,28,31,2,4,18,37,13,18,11,19,3,5,7,24,37
2003-07-07 00:00:00.000,Newport RI; U.S.A. ATP World Tour,GRASS,2,Cyril Saulnier,Ivo Heuberger,Cyril Saulnier,6-3; 6-1,R32,57,2,2,25,47,21,25,14,22,1,1,8,35,47,4,3,29,56,18,29,10,27,3,7,8,28,56
2003-07-07 00:00:00.000,Newport RI; U.S.A. ATP World Tour,GRASS,2,Bob Bryan,Dustin Brown,Bob Bryan,6-7(5); 6-3; 6-4,R32,89,11,4,61,88,54,61,15,27,3,4,16,69,88,18,7,58,115,50,58,22,57,7,10,15,72,115
2003-07-07 00:00:00.000,Newport RI; U.S.A. ATP World Tour,GRASS,2,Dusan Vemic,Mardy Fish,Dusan Vemic,7-6(3); 7-5,R32,116,8,2,45,70,34,45,18,25,1,2,12,52,70,11,8,38,86,32,38,23,48,1,3,12,55,86
2003-07-07 00:00:00.000,Newport RI; U.S.A. ATP World Tour,GRASS,2,Jurgen Melzer,Nicolas Thomann,Jurgen Melzer,6-3; 6-7(3); 6-4,R32,124,19,13,64,109,50,64,18,45,4,7,16,68,109,5,7,55,98,36,55,20,43,3,8,15,56,98
2003-07-07 00:00:00.000,Newport RI; U.S.A. ATP World Tour,GRASS,2,Julian Knowle,Cecil Mamiit,Julian Knowle,6-4; 6-2,R32,69,0,4,28,54,24,28,17,26,0,0,9,41,54,1,0,25,46,19,25,10,21,0,3,9,29,46
2003-07-07 00:00:00.000,Newport RI; U.S.A. ATP World Tour,GRASS,2,Alex Kim,Thomas Shimada,Alex Kim,7-5; 6-3,R32,70,3,2,45,73,32,45,16,28,5,6,11,48,73,3,1,29,51,18,29,14,22,1,4,10,32,51
2003-07-07 00:00:00.000,Newport RI; U.S.A. ATP World Tour,GRASS,2,Jeff Salzenstein,George Bastl,Jeff Salzenstein,6-1; 6-3,R32,65,4,4,30,47,23,30,5,17,1,3,8,28,47,0,1,38,60,18,38,8,22,3,9,8,26,60
2003-07-07 00:00:00.000,Newport RI; U.S.A. ATP World Tour,GRASS,2,Gregory Carraz,Chris Guccione,Gregory Carraz,6-7(5); 7-6(5); 6-4,R16,112,15,3,69,102,60,69,21,33,1,1,17,81,102,22,7,63,104,53,63,25,41,3,4,17,78,104
2003-07-07 00:00:00.000,Newport RI; U.S.A. ATP World Tour,GRASS,2,Justin Gimelstob,Zack Fleishman,Justin Gimelstob,1-6; 6-3; 6-3,R16,96,1,4,44,76,31,44,14,32,7,11,12,45,76,2,6,67,97,40,67,14,30,10,15,13,54,97
2003-07-07 00:00:00.000,Newport RI; U.S.A. ATP World Tour,GRASS,2,Robby Ginepri,Dennis van Scheppingen,Robby Ginepri,6-4; 7-6(3),R16,62,11,1,37,64,28,37,15,27,0,2,11,43,64,5,3,45,65,33,45,9,20,4,7,11,42,65
2003-07-07 00:00:00.000,Newport RI; U.S.A. ATP World Tour,GRASS,2,Ivan Miranda,Andrei Stoliarov,Ivan Miranda,7-6(3); 6-1,R16,96,3,0,39,58,27,39,14,19,4,5,9,41,58,6,2,50,82,30,50,13,32,4,8,10,43,82
2003-07-07 00:00:00.000,Newport RI; U.S.A. ATP World Tour,GRASS,2,Cyril Saulnier,Scott Draper,Cyril Saulnier,6-2; 6-3,R16,55,8,4,32,56,29,32,12,24,3,3,9,41,56,3,3,25,45,17,25,9,20,2,5,8,26,45
2003-07-07 00:00:00.000,Newport RI; U.S.A. ATP World Tour,GRASS,2,Bob Bryan,Dusan Vemic,Bob Bryan,6-4; 6-2,R16,63,1,0,27,42,25,27,11,15,0,0,9,36,42,8,6,32,55,23,32,9,23,4,7,9,32,55
2003-07-07 00:00:00.000,Newport RI; U.S.A. ATP World Tour,GRASS,2,Jurgen Melzer,Julian Knowle,Jurgen Melzer,6-3; 5-7; 6-4,R16,155,11,7,58,99,40,58,25,41,2,4,16,65,99,5,7,58,109,44,58,21,51,11,14,15,65,109
2003-07-07 00:00:00.000,Newport RI; U.S.A. ATP World Tour,GRASS,2,Jeff Salzenstein,Alex Kim,Jeff Salzenstein,6-1; 5-7; 6-3,R16,108,6,3,36,71,31,36,22,35,2,3,14,53,71,1,3,56,80,33,56,12,24,3,7,14,45,80
2003-07-07 00:00:00.000,Newport RI; U.S.A. ATP World Tour,GRASS,2,Gregory Carraz,Justin Gimelstob,Gregory Carraz,2-6; 6-1; 7-6(3),Q,114,8,7,57,93,44,57,15,36,3,5,13,59,93,7,5,49,87,33,49,23,38,7,10,14,56,87
2003-07-07 00:00:00.000,Newport RI; U.S.A. ATP World Tour,GRASS,2,Robby Ginepri,Ivan Miranda,Robby Ginepri,7-5; 6-2,Q,69,10,1,38,63,28,38,16,25,3,4,10,44,63,1,1,35,65,21,35,14,30,5,9,10,35,65
2003-07-07 00:00:00.000,Newport RI; U.S.A. ATP World Tour,GRASS,2,Bob Bryan,Cyril Saulnier,Bob Bryan,6-4; 6-3,Q,57,11,2,44,57,36,44,7,13,1,1,10,43,57,5,1,29,51,17,29,13,22,0,2,9,30,51
2003-07-07 00:00:00.000,Newport RI; U.S.A. ATP World Tour,GRASS,2,Jurgen Melzer,Jeff Salzenstein,Jurgen Melzer,7-5; 7-6(7),Q,108,7,12,50,86,38,50,15,36,7,9,12,53,86,2,2,56,90,38,56,14,34,5,8,12,52,90
2003-07-07 00:00:00.000,Newport RI; U.S.A. ATP World Tour,GRASS,2,Robby Ginepri,Gregory Carraz,Robby Ginepri,6-3; 7-6(5),S,81,11,6,50,88,36,50,20,38,7,8,11,56,88,7,3,37,61,29,37,10,24,1,3,10,39,61
2003-07-07 00:00:00.000,Newport RI; U.S.A. ATP World Tour,GRASS,2,Jurgen Melzer,Bob Bryan,Jurgen Melzer,6-0; 4-6; 7-6(5),S,107,17,2,51,89,41,51,22,38,1,2,14,63,89,13,3,67,97,48,67,13,30,3,6,14,61,97
2003-07-07 00:00:00.000,Newport RI; U.S.A. ATP World Tour,GRASS,2,Robby Ginepri,Jurgen Melzer,Robby Ginepri,6-4; 6-7(3); 6-1,F,99,14,5,57,86,48,57,11,29,1,2,15,59,86,7,5,42,84,32,42,20,42,3,7,14,52,84
2003-07-14 00:00:00.000,Amersfoort The Netherlands ATP World Tour,CLAY,2,Giorgio Galimberti,Martin Verkerk,Giorgio Galimberti,3-6; 6-1; 6-4,R32,104,3,3,53,90,40,53,19,37,5,6,13,59,90,13,5,30,75,24,30,24,45,5,8,13,48,75
2003-07-14 00:00:00.000,Amersfoort The Netherlands ATP World Tour,CLAY,2,Albert Montanes,Jurgen Melzer,Albert Montanes,5-1 RET,R32,29,3,1,10,19,10,10,5,9,2,2,3,15,19,0,1,11,22,7,11,3,11,1,3,3,10,22
2003-07-14 00:00:00.000,Amersfoort The Netherlands ATP World Tour,CLAY,2,Markus Hipfl,Adrian Voinea,Markus Hipfl,2-6; 6-4; 6-3,R32,93,1,2,54,75,38,54,12,21,1,5,14,50,75,9,6,36,74,28,36,17,38,3,7,13,45,74
2003-07-14 00:00:00.000,Amersfoort The Netherlands ATP World Tour,CLAY,2,John van Lottum,Fernando Vicente,John van Lottum,7-6(3); 6-0,R32,82,3,0,30,56,22,30,16,26,2,3,9,38,56,2,3,37,77,20,37,20,40,10,14,9,40,77
2003-07-14 00:00:00.000,Amersfoort The Netherlands ATP World Tour,CLAY,2,Juan Ignacio Chela,Mariano Puerta,Juan Ignacio Chela,6-3; 6-1,R32,55,5,2,28,44,23,28,10,16,3,3,8,33,44,0,5,24,43,10,24,9,19,1,5,8,19,43
2003-07-14 00:00:00.000,Amersfoort The Netherlands ATP World Tour,CLAY,2,Ruben Ramirez Hidalgo,Francisco Clavet,Ruben Ramirez Hidalgo,6-4; 6-2,R32,85,2,1,29,44,23,29,7,15,1,4,9,30,44,2,3,57,79,27,57,8,22,11,17,9,35,79
2003-07-14 00:00:00.000,Amersfoort The Netherlands ATP World Tour,CLAY,2,Stanislas Wawrinka,Hugo Armando,Stanislas Wawrinka,6-4; 6-4,R32,78,5,3,49,72,39,49,9,23,5,5,10,48,72,0,0,48,61,29,48,9,13,3,5,10,38,61
2003-07-14 00:00:00.000,Amersfoort The Netherlands ATP World Tour,CLAY,2,Raemon Sluiter,Alexander Waske,Raemon Sluiter,6-4; 6-3,R32,64,11,1,33,50,28,33,13,17,1,1,10,41,50,11,1,38,67,27,38,15,29,6,8,9,42,67
2003-07-14 00:00:00.000,Amersfoort The Netherlands ATP World Tour,CLAY,2,Nicolas Massu,Hicham Arazi,Nicolas Massu,4-6; 6-4; 7-6(6),R32,179,5,5,56,106,39,56,22,50,4,9,16,61,106,9,4,65,105,47,65,13,40,3,8,16,60,105
2003-07-14 00:00:00.000,Amersfoort The Netherlands ATP World Tour,CLAY,2,Andre Sa,Jaroslav Levinsky,Andre Sa,6-2; 4-6; 7-6(2),R32,133,5,5,79,122,54,79,20,43,10,14,15,74,122,1,3,76,106,46,76,13,30,11,16,15,59,106
2003-07-14 00:00:00.000,Amersfoort The Netherlands ATP World Tour,CLAY,2,Dennis van Scheppingen,Irakli Labadze,Dennis van Scheppingen,7-6(3); 1-0 RET,R32,50,5,7,37,57,27,37,9,20,3,4,7,36,57,3,3,24,38,16,24,7,14,1,2,6,23,38
2003-07-14 00:00:00.000,Amersfoort The Netherlands ATP World Tour,CLAY,2,Franco Squillari,Zeljko Krajan,Franco Squillari,6-3; 1-0 RET,R32,49,1,2,21,43,16,21,7,22,2,4,5,23,43,1,2,12,25,6,12,3,13,0,4,5,9,25
2003-07-14 00:00:00.000,Amersfoort The Netherlands ATP World Tour,CLAY,2,Luis Horna,Albert Portas,Luis Horna,6-3; 7-5,R32,100,3,4,39,70,27,39,16,31,7,9,10,43,70,5,4,44,78,24,44,15,34,6,11,11,39,78
2003-07-14 00:00:00.000,Amersfoort The Netherlands ATP World Tour,CLAY,2,Christophe Rochus,Kristof Vliegen,Christophe Rochus,6-4; 4-6; 7-5,R32,114,2,4,62,85,42,62,14,23,2,6,16,56,85,2,4,78,111,49,78,16,33,15,20,16,65,111
2003-07-14 00:00:00.000,Amersfoort The Netherlands ATP World Tour,CLAY,2,Oscar Hernandez,Fred Hemmes,Oscar Hernandez,6-1; 6-1,R32,56,2,0,26,41,19,26,8,15,1,2,7,27,41,1,5,22,40,8,22,6,18,1,7,7,14,40
2003-07-14 00:00:00.000,Amersfoort The Netherlands ATP World Tour,CLAY,2,Jean-Rene Lisnard,Gaston Gaudio,Jean-Rene Lisnard,6-0; 7-6(5),R32,99,1,3,31,61,23,31,15,30,3,5,9,38,61,0,4,44,70,25,44,10,26,3,8,9,35,70
2003-07-14 00:00:00.000,Amersfoort The Netherlands ATP World Tour,CLAY,2,Albert Montanes,Giorgio Galimberti,Albert Montanes,6-4; 6-3,R16,61,2,3,27,47,22,27,15,20,1,1,9,37,47,1,2,37,63,23,37,12,26,3,6,10,35,63
2003-07-14 00:00:00.000,Amersfoort The Netherlands ATP World Tour,CLAY,2,Markus Hipfl,John van Lottum,Markus Hipfl,6-1; 1-6; 6-4,R16,141,3,2,58,82,36,58,11,24,5,9,12,47,82,1,1,44,63,25,44,9,19,2,7,12,34,63
2003-07-14 00:00:00.000,Amersfoort The Netherlands ATP World Tour,CLAY,2,Ruben Ramirez Hidalgo,Juan Ignacio Chela,Ruben Ramirez Hidalgo,6-1; 6-1,R16,57,1,2,29,49,21,29,12,20,4,4,7,33,49,1,3,24,37,12,24,4,13,3,8,7,16,37
2003-07-14 00:00:00.000,Amersfoort The Netherlands ATP World Tour,CLAY,2,Raemon Sluiter,Stanislas Wawrinka,Raemon Sluiter,6-1; 6-4,R16,115,5,3,38,70,28,38,17,32,2,3,9,45,70,1,0,39,54,20,39,7,15,3,7,8,27,54
2003-07-14 00:00:00.000,Amersfoort The Netherlands ATP World Tour,CLAY,2,Nicolas Massu,Andre Sa,Nicolas Massu,6-2; 6-2,R16,74,3,1,32,49,24,32,12,17,3,3,8,36,49,0,5,30,52,15,30,10,22,5,9,8,25,52
2003-07-14 00:00:00.000,Amersfoort The Netherlands ATP World Tour,CLAY,2,Dennis van Scheppingen,Franco Squillari,Dennis van Scheppingen,4-6; 6-4; 6-4,R16,131,5,2,62,107,41,62,25,45,6,8,15,66,107,13,7,54,101,36,54,26,47,5,8,15,62,101
2003-07-14 00:00:00.000,Amersfoort The Netherlands ATP World Tour,CLAY,2,Luis Horna,Christophe Rochus,Luis Horna,6-4; 6-4,R16,101,4,2,39,68,29,39,17,29,4,4,10,46,68,3,3,42,68,33,42,10,26,4,6,10,43,68
2003-07-14 00:00:00.000,Amersfoort The Netherlands ATP World Tour,CLAY,2,Oscar Hernandez,Jean-Rene Lisnard,Oscar Hernandez,7-6(7); 1-6; 7-6(4),R16,175,0,0,83,120,57,83,14,37,6,11,16,71,120,1,6,51,107,40,51,26,56,1,3,15,66,107
2003-07-14 00:00:00.000,Amersfoort The Netherlands ATP World Tour,CLAY,2,Albert Montanes,Markus Hipfl,Albert Montanes,6-2; 6-3,Q,66,6,1,37,51,23,37,12,14,3,3,8,35,51,0,2,42,55,22,42,6,13,2,6,9,28,55
2003-07-14 00:00:00.000,Amersfoort The Netherlands ATP World Tour,CLAY,2,Raemon Sluiter,Ruben Ramirez Hidalgo,Raemon Sluiter,7-6(4); 6-7(2); 6-2,Q,141,7,4,67,108,53,67,22,41,7,8,16,75,108,6,4,74,119,51,74,22,45,4,7,16,73,119
2003-07-14 00:00:00.000,Amersfoort The Netherlands ATP World Tour,CLAY,2,Nicolas Massu,Dennis van Scheppingen,Nicolas Massu,6-2; 7-5,Q,86,8,0,43,56,30,43,10,13,1,2,10,40,56,2,4,44,69,26,44,12,25,5,9,10,38,69
2003-07-14 00:00:00.000,Amersfoort The Netherlands ATP World Tour,CLAY,2,Luis Horna,Oscar Hernandez,Luis Horna,6-7(5); 6-3; 6-3,Q,149,4,2,69,96,51,69,13,27,2,4,15,64,96,0,1,84,121,48,84,21,37,13,18,15,69,121
2003-07-14 00:00:00.000,Amersfoort The Netherlands ATP World Tour,CLAY,2,Raemon Sluiter,Albert Montanes,Raemon Sluiter,7-6(4); 1-6; 6-3,S,106,5,4,55,91,41,55,22,36,4,6,14,63,91,7,2,57,83,45,57,15,26,2,3,14,60,83
2003-07-14 00:00:00.000,Amersfoort The Netherlands ATP World Tour,CLAY,2,Nicolas Massu,Luis Horna,Nicolas Massu,6-3; 4-0 RET,S,67,4,3,29,44,21,29,7,15,5,6,6,28,44,2,6,24,40,12,24,5,16,3,8,7,17,40
2003-07-14 00:00:00.000,Amersfoort The Netherlands ATP World Tour,CLAY,2,Nicolas Massu,Raemon Sluiter,Nicolas Massu,6-4; 7-6(3); 6-2,F,145,7,3,60,92,43,60,20,32,2,3,15,63,92,10,1,57,104,40,57,22,47,4,8,15,62,104
2003-07-14 00:00:00.000,Stuttgart Germany ATP World Tour,CLAY,2,Carlos Moya,N/A Bye,Carlos Moya,,R64,0,0,0,0,0,0,0,0,0,0,0,0,0,0,0,0,0,0,0,0,0,0,0,0,0,0,0
2003-07-14 00:00:00.000,Stuttgart Germany ATP World Tour,CLAY,2,Tomas Behrend,Julien Boutter,Tomas Behrend,3-6; 6-2; 6-1,R64,81,4,3,53,71,38,53,12,18,5,6,12,50,71,1,4,52,67,36,52,4,15,2,6,12,40,67
2003-07-14 00:00:00.000,Stuttgart Germany ATP World Tour,CLAY,2,Marc Lopez,Potito Starace,Marc Lopez,6-3; 7-5,R64,106,0,2,55,70,34,55,9,15,2,5,11,43,70,1,4,57,74,30,57,6,17,10,15,10,36,74
2003-07-14 00:00:00.000,Stuttgart Germany ATP World Tour,CLAY,2,Max Mirnyi,N/A Bye,Max Mirnyi,,R64,0,0,0,0,0,0,0,0,0,0,0,0,0,0,0,0,0,0,0,0,0,0,0,0,0,0,0
2003-07-14 00:00:00.000,Stuttgart Germany ATP World Tour,CLAY,2,Jarkko Nieminen,N/A Bye,Jarkko Nieminen,,R64,0,0,0,0,0,0,0,0,0,0,0,0,0,0,0,0,0,0,0,0,0,0,0,0,0,0,0
2003-07-14 00:00:00.000,Stuttgart Germany ATP World Tour,CLAY,2,Alberto Martin,Ramon Delgado,Alberto Martin,7-6(1); 6-3,R64,94,1,3,38,66,28,38,15,28,0,2,11,43,66,5,2,52,72,30,52,10,20,2,5,10,40,72
2003-07-14 00:00:00.000,Stuttgart Germany ATP World Tour,CLAY,2,Rafael Nadal,Philipp Petzschner,Rafael Nadal,7-5; 6-1,R64,82,0,1,42,59,33,42,11,17,1,1,10,44,59,3,5,26,52,21,26,9,26,1,4,9,30,52
2003-07-14 00:00:00.000,Stuttgart Germany ATP World Tour,CLAY,2,Fernando Gonzalez,N/A Bye,Fernando Gonzalez,,R64,0,0,0,0,0,0,0,0,0,0,0,0,0,0,0,0,0,0,0,0,0,0,0,0,0,0,0
2003-07-14 00:00:00.000,Stuttgart Germany ATP World Tour,CLAY,2,Sebastien Grosjean,N/A Bye,Sebastien Grosjean,,R64,0,0,0,0,0,0,0,0,0,0,0,0,0,0,0,0,0,0,0,0,0,0,0,0,0,0,0
2003-07-14 00:00:00.000,Stuttgart Germany ATP World Tour,CLAY,2,Filippo Volandri,David Sanchez,Filippo Volandri,6-0; 3-0 RET,R64,30,0,0,17,20,14,17,2,3,0,0,4,16,20,0,1,15,27,4,15,2,12,1,6,5,6,27
2003-07-14 00:00:00.000,Stuttgart Germany ATP World Tour,CLAY,2,Olivier Mutis,Renzo Furlan,Olivier Mutis,6-4; 6-1,R64,70,5,1,23,53,17,23,18,30,1,2,9,35,53,1,3,28,52,17,28,11,24,4,8,8,28,52
2003-07-14 00:00:00.000,Stuttgart Germany ATP World Tour,CLAY,2,Nikolay Davydenko,N/A Bye,Nikolay Davydenko,,R64,0,0,0,0,0,0,0,0,0,0,0,0,0,0,0,0,0,0,0,0,0,0,0,0,0,0,0
2003-07-14 00:00:00.000,Stuttgart Germany ATP World Tour,CLAY,2,Tommy Robredo,N/A Bye,Tommy Robredo,,R64,0,0,0,0,0,0,0,0,0,0,0,0,0,0,0,0,0,0,0,0,0,0,0,0,0,0,0
2003-07-14 00:00:00.000,Stuttgart Germany ATP World Tour,CLAY,2,Lars Burgsmuller,Magnus Norman,Lars Burgsmuller,6-4; 7-5,R64,83,7,1,37,62,31,37,15,25,1,1,11,46,62,4,1,33,60,25,33,15,27,1,3,11,40,60
2003-07-14 00:00:00.000,Stuttgart Germany ATP World Tour,CLAY,2,Jiri Vanek,Simon Greul,Jiri Vanek,4-6; 6-1; 6-3,R64,107,13,2,57,93,39,57,24,36,3,4,13,63,93,1,5,42,83,24,42,23,41,4,8,13,47,83
2003-07-14 00:00:00.000,Stuttgart Germany ATP World Tour,CLAY,2,Albert Costa,N/A Bye,Albert Costa,,R64,0,0,0,0,0,0,0,0,0,0,0,0,0,0,0,0,0,0,0,0,0,0,0,0,0,0,0
2003-07-14 00:00:00.000,Stuttgart Germany ATP World Tour,CLAY,2,Felix Mantilla,N/A Bye,Felix Mantilla,,R64,0,0,0,0,0,0,0,0,0,0,0,0,0,0,0,0,0,0,0,0,0,0,0,0,0,0,0
2003-07-14 00:00:00.000,Stuttgart Germany ATP World Tour,CLAY,2,Feliciano Lopez,Ricardo Mello,Feliciano Lopez,6-1; 6-4,R64,58,8,0,31,48,26,31,12,17,2,2,9,38,48,2,2,34,57,18,34,12,23,3,6,8,30,57
2003-07-14 00:00:00.000,Stuttgart Germany ATP World Tour,CLAY,2,Gaston Etlis,Alexander Popp,Gaston Etlis,6-3; 6-2,R64,68,2,3,23,53,16,23,18,30,3,4,9,34,53,0,4,36,55,19,36,8,19,3,7,8,27,55
2003-07-14 00:00:00.000,Stuttgart Germany ATP World Tour,CLAY,2,Younes El Aynaoui,N/A Bye,Younes El Aynaoui,,R64,0,0,0,0,0,0,0,0,0,0,0,0,0,0,0,0,0,0,0,0,0,0,0,0,0,0,0
2003-07-14 00:00:00.000,Stuttgart Germany ATP World Tour,CLAY,2,Alex Corretja,N/A Bye,Alex Corretja,,R64,0,0,0,0,0,0,0,0,0,0,0,0,0,0,0,0,0,0,0,0,0,0,0,0,0,0,0
2003-07-14 00:00:00.000,Stuttgart Germany ATP World Tour,CLAY,2,Olivier Rochus,Michel Kratochvil,Olivier Rochus,3-6; 6-2; 6-3,R64,102,2,5,41,76,30,41,20,35,4,6,13,50,76,4,5,45,84,25,45,24,39,5,9,13,49,84
2003-07-14 00:00:00.000,Stuttgart Germany ATP World Tour,CLAY,2,Maximilian Abel,Antony Dupuis,Maximilian Abel,2-6; 6-3; 7-6(5),R64,120,4,6,51,98,39,51,25,47,10,12,15,64,98,6,6,51,96,38,51,27,45,2,3,14,65,96
2003-07-14 00:00:00.000,Stuttgart Germany ATP World Tour,CLAY,2,Rainer Schuettler,N/A Bye,Rainer Schuettler,,R64,0,0,0,0,0,0,0,0,0,0,0,0,0,0,0,0,0,0,0,0,0,0,0,0,0,0,0
2003-07-14 00:00:00.000,Stuttgart Germany ATP World Tour,CLAY,2,Jiri Novak,N/A Bye,Jiri Novak,,R64,0,0,0,0,0,0,0,0,0,0,0,0,0,0,0,0,0,0,0,0,0,0,0,0,0,0,0
2003-07-14 00:00:00.000,Stuttgart Germany ATP World Tour,CLAY,2,Sargis Sargsian,Flavio Saretta,Sargis Sargsian,6-4; 6-2,R64,87,3,1,40,59,32,40,10,19,3,3,9,42,59,2,3,41,69,29,41,9,28,7,10,9,38,69
2003-07-14 00:00:00.000,Stuttgart Germany ATP World Tour,CLAY,2,Nicolas Lapentti,Stefan Koubek,Nicolas Lapentti,6-4; 6-2,R64,69,2,1,28,51,26,28,12,23,3,3,9,38,51,0,1,34,56,20,34,13,22,2,5,9,33,56
2003-07-14 00:00:00.000,Stuttgart Germany ATP World Tour,CLAY,2,Mikhail Youzhny,N/A Bye,Mikhail Youzhny,,R64,0,0,0,0,0,0,0,0,0,0,0,0,0,0,0,0,0,0,0,0,0,0,0,0,0,0,0
2003-07-14 00:00:00.000,Stuttgart Germany ATP World Tour,CLAY,2,Ivan Ljubicic,N/A Bye,Ivan Ljubicic,,R64,0,0,0,0,0,0,0,0,0,0,0,0,0,0,0,0,0,0,0,0,0,0,0,0,0,0,0
2003-07-14 00:00:00.000,Stuttgart Germany ATP World Tour,CLAY,2,David Ferrer,Mariano Zabaleta,David Ferrer,7-6(3); 6-4,R64,91,2,2,43,66,32,43,15,23,6,8,11,47,66,2,2,58,78,36,58,9,20,5,8,11,45,78
2003-07-14 00:00:00.000,Stuttgart Germany ATP World Tour,CLAY,2,Paul-Henri Mathieu,Tomas Zib,Paul-Henri Mathieu,6-1; 6-2,R64,58,10,2,26,40,24,26,8,14,0,0,8,32,40,1,0,27,44,13,27,8,17,4,8,7,21,44
2003-07-14 00:00:00.000,Stuttgart Germany ATP World Tour,CLAY,2,Guillermo Coria,N/A Bye,Guillermo Coria,,R64,0,0,0,0,0,0,0,0,0,0,0,0,0,0,0,0,0,0,0,0,0,0,0,0,0,0,0
2003-07-14 00:00:00.000,Stuttgart Germany ATP World Tour,CLAY,2,Tomas Behrend,Carlos Moya,Tomas Behrend,7-6(5); 7-6(2),R32,102,13,4,57,92,42,57,17,35,4,6,12,59,92,7,3,48,89,35,48,21,41,5,7,12,56,89
2003-07-14 00:00:00.000,Stuttgart Germany ATP World Tour,CLAY,2,Max Mirnyi,Marc Lopez,Max Mirnyi,6-4; 6-3,R32,72,6,1,28,51,24,28,17,23,0,0,10,41,51,1,0,41,57,28,41,8,16,2,4,9,36,57
2003-07-14 00:00:00.000,Stuttgart Germany ATP World Tour,CLAY,2,Jarkko Nieminen,Alberto Martin,Jarkko Nieminen,6-2; 4-6; 6-4,R32,105,4,1,62,86,41,62,15,24,5,8,14,56,86,0,1,45,77,30,45,16,32,5,10,14,46,77
2003-07-14 00:00:00.000,Stuttgart Germany ATP World Tour,CLAY,2,Fernando Gonzalez,Rafael Nadal,Fernando Gonzalez,6-2; 3-6; 6-2,R32,89,7,5,43,79,34,43,19,36,2,3,12,53,79,4,1,52,66,35,52,6,14,1,5,13,41,66
2003-07-14 00:00:00.000,Stuttgart Germany ATP World Tour,CLAY,2,Filippo Volandri,Sebastien Grosjean,Filippo Volandri,6-2; 6-1,R32,53,0,1,28,39,24,28,6,11,2,2,7,30,39,2,1,20,45,11,20,9,25,4,9,8,20,45
2003-07-14 00:00:00.000,Stuttgart Germany ATP World Tour,CLAY,2,Nikolay Davydenko,Olivier Mutis,Nikolay Davydenko,6-0; 7-6(3),R32,98,4,4,47,82,31,47,16,35,7,10,9,47,82,2,0,37,67,16,37,14,30,8,14,9,30,67
2003-07-14 00:00:00.000,Stuttgart Germany ATP World Tour,CLAY,2,Tommy Robredo,Lars Burgsmuller,Tommy Robredo,6-7(7); 6-3; 7-5,R32,196,3,3,64,94,38,64,14,30,2,8,16,52,94,2,8,72,117,37,72,19,45,6,15,17,56,117
2003-07-14 00:00:00.000,Stuttgart Germany ATP World Tour,CLAY,2,Jiri Vanek,Albert Costa,Jiri Vanek,7-6(4); 6-3,R32,105,14,2,31,62,25,31,18,31,1,3,11,43,62,8,3,53,73,37,53,6,20,6,9,10,43,73
2003-07-14 00:00:00.000,Stuttgart Germany ATP World Tour,CLAY,2,Feliciano Lopez,Felix Mantilla,Feliciano Lopez,1-6; 6-3; 7-6(7),R32,117,13,2,62,94,43,62,16,32,5,9,14,59,94,4,1,54,87,36,54,19,33,5,8,14,55,87
2003-07-14 00:00:00.000,Stuttgart Germany ATP World Tour,CLAY,2,Younes El Aynaoui,Gaston Etlis,Younes El Aynaoui,7-6(4); 6-4,R32,91,16,2,37,61,34,37,16,24,0,0,11,50,61,4,5,50,84,34,50,20,34,6,7,11,54,84
2003-07-14 00:00:00.000,Stuttgart Germany ATP World Tour,CLAY,2,Alex Corretja,Olivier Rochus,Alex Corretja,4-6; 6-1; 7-5,R32,155,12,4,51,100,36,51,24,49,6,10,15,60,100,1,1,80,121,48,80,15,41,14,20,14,63,121
2003-07-14 00:00:00.000,Stuttgart Germany ATP World Tour,CLAY,2,Rainer Schuettler,Maximilian Abel,Rainer Schuettler,6-2; 6-4,R32,69,2,1,29,51,21,29,15,22,1,2,9,36,51,0,2,40,63,23,40,11,23,3,7,9,34,63
2003-07-14 00:00:00.000,Stuttgart Germany ATP World Tour,CLAY,2,Jiri Novak,Sargis Sargsian,Jiri Novak,6-4; 6-4,R32,65,1,0,42,56,29,42,11,14,2,3,10,40,56,6,1,42,57,24,42,10,15,2,5,10,34,57
2003-07-14 00:00:00.000,Stuttgart Germany ATP World Tour,CLAY,2,Mikhail Youzhny,Nicolas Lapentti,Mikhail Youzhny,6-3; 2-6; 6-3,R32,128,3,4,53,89,34,53,16,36,7,12,13,50,89,5,3,47,82,29,47,14,35,6,12,13,43,82
2003-07-14 00:00:00.000,Stuttgart Germany ATP World Tour,CLAY,2,David Ferrer,Ivan Ljubicic,David Ferrer,7-6(3); 6-1,R32,93,7,4,78,108,52,78,14,30,17,18,10,66,108,5,1,26,56,18,26,13,30,2,5,9,31,56
2003-07-14 00:00:00.000,Stuttgart Germany ATP World Tour,CLAY,2,Guillermo Coria,Paul-Henri Mathieu,Guillermo Coria,7-5; 6-3,R32,108,4,2,33,57,27,33,13,24,1,2,10,40,57,0,4,33,86,18,33,29,53,5,9,11,47,86
2003-07-14 00:00:00.000,Stuttgart Germany ATP World Tour,CLAY,2,Tomas Behrend,Max Mirnyi,Tomas Behrend,6-4; 6-4,R16,76,1,0,48,61,38,48,8,13,2,2,10,46,61,6,3,30,56,25,30,12,26,2,4,10,37,56
2003-07-14 00:00:00.000,Stuttgart Germany ATP World Tour,CLAY,2,Fernando Gonzalez,Jarkko Nieminen,Fernando Gonzalez,7-6(2); 6-7(5); 6-3,R16,113,8,6,78,113,61,78,18,35,2,3,17,79,113,3,0,70,95,53,70,13,25,2,4,16,66,95
2003-07-14 00:00:00.000,Stuttgart Germany ATP World Tour,CLAY,2,Filippo Volandri,Nikolay Davydenko,Filippo Volandri,6-3; 3-6; 6-1,R16,93,0,3,58,79,36,58,9,21,6,10,13,45,79,1,0,65,77,31,65,6,12,4,10,12,37,77
2003-07-14 00:00:00.000,Stuttgart Germany ATP World Tour,CLAY,2,Tommy Robredo,Jiri Vanek,Tommy Robredo,6-2; 6-7(6); 6-3,R16,116,2,2,68,100,44,68,19,32,5,7,15,63,100,6,4,48,85,36,48,15,37,3,8,14,51,85
2003-07-14 00:00:00.000,Stuttgart Germany ATP World Tour,CLAY,2,Feliciano Lopez,Younes El Aynaoui,Feliciano Lopez,3-6; 6-4; 6-3,R16,92,5,3,40,77,29,40,25,37,4,7,14,54,77,8,3,70,93,43,70,13,23,7,11,14,56,93
2003-07-14 00:00:00.000,Stuttgart Germany ATP World Tour,CLAY,2,Rainer Schuettler,Alex Corretja,Rainer Schuettler,6-4; 6-4,R16,95,1,1,22,63,18,22,22,41,3,5,10,40,63,2,2,34,59,25,34,8,25,1,5,10,33,59
2003-07-14 00:00:00.000,Stuttgart Germany ATP World Tour,CLAY,2,Mikhail Youzhny,Jiri Novak,Mikhail Youzhny,7-6(1); 6-4,R16,84,2,1,38,70,30,38,17,32,6,7,11,47,70,5,1,57,74,37,57,9,17,4,6,11,46,74
2003-07-14 00:00:00.000,Stuttgart Germany ATP World Tour,CLAY,2,Guillermo Coria,David Ferrer,Guillermo Coria,6-1; 6-1,R16,62,0,0,28,40,20,28,10,12,2,2,7,30,40,1,0,32,52,16,32,6,20,9,14,7,22,52
2003-07-14 00:00:00.000,Stuttgart Germany ATP World Tour,CLAY,2,Fernando Gonzalez,Tomas Behrend,Fernando Gonzalez,7-5; 6-3,Q,70,7,1,40,55,28,40,9,15,1,3,10,37,55,4,2,39,61,24,39,9,22,1,6,11,33,61
2003-07-14 00:00:00.000,Stuttgart Germany ATP World Tour,CLAY,2,Tommy Robredo,Filippo Volandri,Tommy Robredo,6-4; 6-2,Q,60,2,3,44,60,26,44,10,16,7,9,9,36,60,1,2,36,46,17,36,5,10,4,9,9,22,46
2003-07-14 00:00:00.000,Stuttgart Germany ATP World Tour,CLAY,2,Feliciano Lopez,Rainer Schuettler,Feliciano Lopez,6-2; 6-4,Q,62,4,0,39,51,33,39,6,12,1,1,9,39,51,2,1,37,54,25,37,7,17,5,8,9,32,54
2003-07-14 00:00:00.000,Stuttgart Germany ATP World Tour,CLAY,2,Guillermo Coria,Mikhail Youzhny,Guillermo Coria,6-0; 6-0,Q,41,3,0,16,26,14,16,10,10,0,0,6,24,26,1,2,23,40,9,23,4,17,3,9,6,13,40
2003-07-14 00:00:00.000,Stuttgart Germany ATP World Tour,CLAY,2,Tommy Robredo,Fernando Gonzalez,Tommy Robredo,6-2; 4-1 RET,S,42,2,1,33,38,28,33,2,5,0,0,7,30,38,0,4,27,38,16,27,3,11,5,8,6,19,38
2003-07-14 00:00:00.000,Stuttgart Germany ATP World Tour,CLAY,2,Guillermo Coria,Feliciano Lopez,Guillermo Coria,6-4; 6-0,S,59,7,2,28,42,22,28,8,14,0,1,8,30,42,5,2,29,55,19,29,6,26,5,10,8,25,55
2003-07-14 00:00:00.000,Stuttgart Germany ATP World Tour,CLAY,2,Guillermo Coria,Tommy Robredo,Guillermo Coria,6-2; 6-2; 6-1,F,100,3,5,45,73,34,45,14,28,3,5,12,48,73,2,7,50,78,21,50,11,28,5,13,11,32,78
2003-07-21 00:00:00.000,Indianapolis IN; U.S.A. ATP World Tour,HARD,2,Andy Roddick,N/A Bye,Andy Roddick,,R64,0,0,0,0,0,0,0,0,0,0,0,0,0,0,0,0,0,0,0,0,0,0,0,0,0,0,0
2003-07-21 00:00:00.000,Indianapolis IN; U.S.A. ATP World Tour,HARD,2,Cyril Saulnier,Matthew Behrmann,Cyril Saulnier,6-0; 6-3,R64,58,2,4,24,54,21,24,15,30,5,6,8,36,54,1,4,22,45,11,22,8,23,3,8,7,19,45
2003-07-21 00:00:00.000,Indianapolis IN; U.S.A. ATP World Tour,HARD,2,Gregory Carraz,Noam Okun,Gregory Carraz,4-6; 6-3; 6-4,R64,112,10,6,61,105,42,61,26,44,9,11,15,68,105,6,2,58,84,42,58,12,26,3,6,14,54,84
2003-07-21 00:00:00.000,Indianapolis IN; U.S.A. ATP World Tour,HARD,2,Kenneth Carlsen,N/A Bye,Kenneth Carlsen,,R64,0,0,0,0,0,0,0,0,0,0,0,0,0,0,0,0,0,0,0,0,0,0,0,0,0,0,0
2003-07-21 00:00:00.000,Indianapolis IN; U.S.A. ATP World Tour,HARD,2,Xavier Malisse,N/A Bye,Xavier Malisse,,R64,0,0,0,0,0,0,0,0,0,0,0,0,0,0,0,0,0,0,0,0,0,0,0,0,0,0,0
2003-07-21 00:00:00.000,Indianapolis IN; U.S.A. ATP World Tour,HARD,2,Rajeev Ram,Igor Levine,Rajeev Ram,6-1; 6-3,R64,65,4,7,22,51,19,22,14,29,1,2,8,33,51,0,5,24,49,15,24,7,25,4,9,8,22,49
2003-07-21 00:00:00.000,Indianapolis IN; U.S.A. ATP World Tour,HARD,2,Thomas Enqvist,Jan Vacek,Thomas Enqvist,7-6(5); 3-6; 6-3,R64,138,11,5,50,98,41,50,29,48,7,8,15,70,98,9,5,62,118,46,62,29,56,6,7,15,75,118
2003-07-21 00:00:00.000,Indianapolis IN; U.S.A. ATP World Tour,HARD,2,Jan-Michael Gambill,N/A Bye,Jan-Michael Gambill,,R64,0,0,0,0,0,0,0,0,0,0,0,0,0,0,0,0,0,0,0,0,0,0,0,0,0,0,0
2003-07-21 00:00:00.000,Indianapolis IN; U.S.A. ATP World Tour,HARD,2,Sjeng Schalken,N/A Bye,Sjeng Schalken,,R64,0,0,0,0,0,0,0,0,0,0,0,0,0,0,0,0,0,0,0,0,0,0,0,0,0,0,0
2003-07-21 00:00:00.000,Indianapolis IN; U.S.A. ATP World Tour,HARD,2,Ivan Miranda,Julien Benneteau,Ivan Miranda,6-1; 6-0,R64,49,6,1,21,34,18,21,10,13,0,0,7,28,34,2,4,19,40,9,19,6,21,4,9,6,15,40
2003-07-21 00:00:00.000,Indianapolis IN; U.S.A. ATP World Tour,HARD,2,Eric Taino,Michael Chang,Eric Taino,3-6; 6-3; 7-5,R64,133,5,3,47,101,37,47,30,54,4,5,15,67,101,11,0,48,82,38,48,18,34,1,3,15,56,82
2003-07-21 00:00:00.000,Indianapolis IN; U.S.A. ATP World Tour,HARD,2,Lars Burgsmuller,N/A Bye,Lars Burgsmuller,,R64,0,0,0,0,0,0,0,0,0,0,0,0,0,0,0,0,0,0,0,0,0,0,0,0,0,0,0
2003-07-21 00:00:00.000,Indianapolis IN; U.S.A. ATP World Tour,HARD,2,Mario Ancic,N/A Bye,Mario Ancic,,R64,0,0,0,0,0,0,0,0,0,0,0,0,0,0,0,0,0,0,0,0,0,0,0,0,0,0,0
2003-07-21 00:00:00.000,Indianapolis IN; U.S.A. ATP World Tour,HARD,2,Ivo Heuberger,Harel Levy,Ivo Heuberger,6-1; 6-1,R64,55,3,3,25,49,19,25,14,24,1,1,7,33,49,0,0,25,40,9,25,6,15,4,9,7,15,40
2003-07-21 00:00:00.000,Indianapolis IN; U.S.A. ATP World Tour,HARD,2,Peter Luczak,Andy Ram,Peter Luczak,6-1; 3-6; 6-4,R64,97,6,5,52,74,38,52,7,22,3,6,13,45,74,10,5,27,80,21,27,25,53,8,13,13,46,80
2003-07-21 00:00:00.000,Indianapolis IN; U.S.A. ATP World Tour,HARD,2,Robby Ginepri,N/A Bye,Robby Ginepri,,R64,0,0,0,0,0,0,0,0,0,0,0,0,0,0,0,0,0,0,0,0,0,0,0,0,0,0,0
2003-07-21 00:00:00.000,Indianapolis IN; U.S.A. ATP World Tour,HARD,2,Hyung-Taik Lee,N/A Bye,Hyung-Taik Lee,,R64,0,0,0,0,0,0,0,0,0,0,0,0,0,0,0,0,0,0,0,0,0,0,0,0,0,0,0
2003-07-21 00:00:00.000,Indianapolis IN; U.S.A. ATP World Tour,HARD,2,Nicolas Thomann,Diego Ayala,Nicolas Thomann,6-4; 6-4,R64,70,4,0,22,47,20,22,20,25,0,0,10,40,47,9,3,29,62,24,29,14,33,1,3,10,38,62
2003-07-21 00:00:00.000,Indianapolis IN; U.S.A. ATP World Tour,HARD,2,Wesley Moodie,Ramon Delgado,Wesley Moodie,6-4; 2-6; 6-4,R64,154,18,4,51,79,42,51,14,28,4,6,14,56,79,4,2,61,81,45,61,10,20,3,5,14,55,81
2003-07-21 00:00:00.000,Indianapolis IN; U.S.A. ATP World Tour,HARD,2,Brian Vahaly,N/A Bye,Brian Vahaly,,R64,0,0,0,0,0,0,0,0,0,0,0,0,0,0,0,0,0,0,0,0,0,0,0,0,0,0,0
2003-07-21 00:00:00.000,Indianapolis IN; U.S.A. ATP World Tour,HARD,2,Nicolas Kiefer,N/A Bye,Nicolas Kiefer,,R64,0,0,0,0,0,0,0,0,0,0,0,0,0,0,0,0,0,0,0,0,0,0,0,0,0,0,0
2003-07-21 00:00:00.000,Indianapolis IN; U.S.A. ATP World Tour,HARD,2,Prakash Amritraj,Sergio Roitman,Prakash Amritraj,6-3; 3-6; 7-5,R64,118,8,4,54,86,41,54,12,32,3,7,15,53,86,5,2,50,86,37,50,13,36,5,10,15,50,86
2003-07-21 00:00:00.000,Indianapolis IN; U.S.A. ATP World Tour,HARD,2,Janko Tipsarevic,Nenad Zimonjic,Janko Tipsarevic,7-6(5); 6-4,R64,80,3,0,36,62,28,36,17,26,1,3,11,45,62,10,4,46,68,38,46,6,22,2,5,11,44,68
2003-07-21 00:00:00.000,Indianapolis IN; U.S.A. ATP World Tour,HARD,2,Yevgeny Kafelnikov,N/A Bye,Yevgeny Kafelnikov,,R64,0,0,0,0,0,0,0,0,0,0,0,0,0,0,0,0,0,0,0,0,0,0,0,0,0,0,0
2003-07-21 00:00:00.000,Indianapolis IN; U.S.A. ATP World Tour,HARD,2,Mardy Fish,N/A Bye,Mardy Fish,,R64,0,0,0,0,0,0,0,0,0,0,0,0,0,0,0,0,0,0,0,0,0,0,0,0,0,0,0
2003-07-21 00:00:00.000,Indianapolis IN; U.S.A. ATP World Tour,HARD,2,Chris Guccione,Cecil Mamiit,Chris Guccione,6-1; 6-3,R64,54,13,0,30,49,26,30,9,19,5,5,8,35,49,0,2,34,53,23,34,4,19,2,6,8,27,53
2003-07-21 00:00:00.000,Indianapolis IN; U.S.A. ATP World Tour,HARD,2,Scott Draper,Bobby Reynolds,Scott Draper,7-5; 6-3,R64,68,9,1,38,60,29,38,16,22,2,2,11,45,60,5,3,27,60,19,27,17,33,3,5,10,36,60
2003-07-21 00:00:00.000,Indianapolis IN; U.S.A. ATP World Tour,HARD,2,Greg Rusedski,N/A Bye,Greg Rusedski,,R64,0,0,0,0,0,0,0,0,0,0,0,0,0,0,0,0,0,0,0,0,0,0,0,0,0,0,0
2003-07-21 00:00:00.000,Indianapolis IN; U.S.A. ATP World Tour,HARD,2,Justin Gimelstob,N/A Bye,Justin Gimelstob,,R64,0,0,0,0,0,0,0,0,0,0,0,0,0,0,0,0,0,0,0,0,0,0,0,0,0,0,0
2003-07-21 00:00:00.000,Indianapolis IN; U.S.A. ATP World Tour,HARD,2,Alex Bogomolov Jr.,Alex Kim,Alex Bogomolov Jr.,6-3; 1-6; 6-4,R64,42,4,5,45,83,29,45,14,38,3,8,13,43,83,3,4,40,69,27,40,13,29,0,5,13,40,69
2003-07-21 00:00:00.000,Indianapolis IN; U.S.A. ATP World Tour,HARD,2,Amer Delic,Ricardo Mello,Amer Delic,6-7(3); 6-4; 7-5,R64,115,20,4,64,101,48,64,20,37,1,3,17,68,101,3,5,71,109,48,71,22,38,9,13,17,70,109
2003-07-21 00:00:00.000,Indianapolis IN; U.S.A. ATP World Tour,HARD,2,Paradorn Srichaphan,N/A Bye,Paradorn Srichaphan,,R64,0,0,0,0,0,0,0,0,0,0,0,0,0,0,0,0,0,0,0,0,0,0,0,0,0,0,0
2003-07-21 00:00:00.000,Indianapolis IN; U.S.A. ATP World Tour,HARD,2,Andy Roddick,Cyril Saulnier,Andy Roddick,6-7(5); 6-3; 7-6(4),R32,129,17,0,67,103,58,67,18,36,1,2,17,76,103,13,3,58,117,45,58,31,59,10,12,16,76,117
2003-07-21 00:00:00.000,Indianapolis IN; U.S.A. ATP World Tour,HARD,2,Gregory Carraz,Kenneth Carlsen,Gregory Carraz,6-4; 3-6; 7-6(5),R32,140,18,13,57,100,43,57,21,43,6,9,15,64,100,18,1,62,95,45,62,19,33,1,4,16,64,95
2003-07-21 00:00:00.000,Indianapolis IN; U.S.A. ATP World Tour,HARD,2,Xavier Malisse,Rajeev Ram,Xavier Malisse,6-2; 6-4,R32,64,8,1,28,45,22,28,12,17,1,2,9,34,45,5,7,28,58,20,28,11,30,6,10,9,31,58
2003-07-21 00:00:00.000,Indianapolis IN; U.S.A. ATP World Tour,HARD,2,Jan-Michael Gambill,Thomas Enqvist,Jan-Michael Gambill,6-2; 6-2,R32,60,13,0,36,51,31,36,6,15,3,3,8,37,51,4,5,25,51,15,25,11,26,0,4,8,26,51
2003-07-21 00:00:00.000,Indianapolis IN; U.S.A. ATP World Tour,HARD,2,Sjeng Schalken,Ivan Miranda,Sjeng Schalken,6-3; 6-1,R32,62,1,1,30,43,24,30,8,13,0,0,8,32,43,1,4,24,57,16,24,15,33,6,10,8,31,57
2003-07-21 00:00:00.000,Indianapolis IN; U.S.A. ATP World Tour,HARD,2,Lars Burgsmuller,Eric Taino,Lars Burgsmuller,6-3; 6-4,R32,68,5,2,31,49,28,31,13,18,1,1,10,41,49,3,2,38,63,25,38,12,25,6,8,9,37,63
2003-07-21 00:00:00.000,Indianapolis IN; U.S.A. ATP World Tour,HARD,2,Ivo Heuberger,Mario Ancic,Ivo Heuberger,6-3; 2-6; 7-5,R32,118,5,4,48,79,38,48,15,31,3,5,14,53,79,9,8,60,108,39,60,28,48,8,11,15,67,108
2003-07-21 00:00:00.000,Indianapolis IN; U.S.A. ATP World Tour,HARD,2,Robby Ginepri,Peter Luczak,Robby Ginepri,6-3; 6-3,R32,61,12,3,22,41,22,22,14,19,0,0,9,36,41,2,6,28,63,20,28,14,35,4,7,9,34,63
2003-07-21 00:00:00.000,Indianapolis IN; U.S.A. ATP World Tour,HARD,2,Nicolas Thomann,Hyung-Taik Lee,Nicolas Thomann,6-4; 7-5,R32,86,5,2,39,57,34,39,12,18,1,1,11,46,57,7,3,44,70,30,44,14,26,4,6,11,44,70
2003-07-21 00:00:00.000,Indianapolis IN; U.S.A. ATP World Tour,HARD,2,Wesley Moodie,Brian Vahaly,Wesley Moodie,6-3; 4-6; 7-6(1),R32,129,13,5,64,101,51,64,18,37,7,9,16,69,101,1,4,58,102,36,58,27,44,6,8,15,63,102
2003-07-21 00:00:00.000,Indianapolis IN; U.S.A. ATP World Tour,HARD,2,Nicolas Kiefer,Prakash Amritraj,Nicolas Kiefer,6-3; 6-1,R32,78,7,0,24,54,19,24,19,30,4,4,8,38,54,6,0,37,57,22,37,7,20,3,7,8,29,57
2003-07-21 00:00:00.000,Indianapolis IN; U.S.A. ATP World Tour,HARD,2,Yevgeny Kafelnikov,Janko Tipsarevic,Yevgeny Kafelnikov,7-5; 6-3,R32,82,1,5,37,69,29,37,15,32,4,6,11,44,69,8,3,35,73,25,35,16,38,6,10,10,41,73
2003-07-21 00:00:00.000,Indianapolis IN; U.S.A. ATP World Tour,HARD,2,Mardy Fish,Chris Guccione,Mardy Fish,7-5; 6-7(5); 6-4,R32,114,15,5,71,104,56,71,15,33,2,3,17,71,104,20,8,59,103,49,59,21,44,4,7,17,70,103
2003-07-21 00:00:00.000,Indianapolis IN; U.S.A. ATP World Tour,HARD,2,Scott Draper,Greg Rusedski,Scott Draper,3-6; 7-6(4); 7-6(4),R32,117,5,2,62,104,49,62,26,42,3,5,17,75,104,15,4,64,102,51,64,23,38,4,4,16,74,102
2003-07-21 00:00:00.000,Indianapolis IN; U.S.A. ATP World Tour,HARD,2,Alex Bogomolov Jr.,Justin Gimelstob,Alex Bogomolov Jr.,6-2; 6-4,R32,82,4,2,39,57,28,39,10,18,5,6,9,38,57,5,3,33,69,21,33,15,36,6,10,9,36,69
2003-07-21 00:00:00.000,Indianapolis IN; U.S.A. ATP World Tour,HARD,2,Paradorn Srichaphan,Amer Delic,Paradorn Srichaphan,6-7(5); 7-6(3); 6-1,R32,112,12,4,54,106,45,54,35,52,6,7,16,80,106,10,6,66,100,49,66,15,34,6,9,15,64,100
2003-07-21 00:00:00.000,Indianapolis IN; U.S.A. ATP World Tour,HARD,2,Andy Roddick,Gregory Carraz,Andy Roddick,6-3; 6-4,R16,62,8,1,28,51,21,28,17,23,0,1,10,38,51,8,8,26,57,23,26,9,31,4,7,9,32,57
2003-07-21 00:00:00.000,Indianapolis IN; U.S.A. ATP World Tour,HARD,2,Xavier Malisse,Jan-Michael Gambill,Xavier Malisse,6-4; 6-2,R16,65,8,1,25,48,21,25,14,23,1,2,9,35,48,2,3,28,53,17,28,12,25,2,6,9,29,53
2003-07-21 00:00:00.000,Indianapolis IN; U.S.A. ATP World Tour,HARD,2,Sjeng Schalken,Lars Burgsmuller,Sjeng Schalken,6-4; 6-2,R16,69,4,1,40,55,30,40,8,15,1,1,9,38,55,4,5,28,58,19,28,13,30,4,7,9,32,58
2003-07-21 00:00:00.000,Indianapolis IN; U.S.A. ATP World Tour,HARD,2,Robby Ginepri,Ivo Heuberger,Robby Ginepri,6-1; 6-3,R16,53,3,2,31,52,24,31,13,21,2,2,8,37,52,3,1,26,46,17,26,6,20,1,5,8,23,46
2003-07-21 00:00:00.000,Indianapolis IN; U.S.A. ATP World Tour,HARD,2,Nicolas Thomann,Wesley Moodie,Nicolas Thomann,6-3; 6-4,R16,75,3,3,31,54,28,31,12,23,2,3,10,40,54,7,2,39,57,26,39,8,18,4,7,9,34,57
2003-07-21 00:00:00.000,Indianapolis IN; U.S.A. ATP World Tour,HARD,2,Nicolas Kiefer,Yevgeny Kafelnikov,Nicolas Kiefer,6-3; 6-4,R16,94,10,0,40,84,27,40,24,44,10,11,10,51,84,2,5,31,49,20,31,6,18,0,3,9,26,49
2003-07-21 00:00:00.000,Indianapolis IN; U.S.A. ATP World Tour,HARD,2,Scott Draper,Mardy Fish,Scott Draper,3-6; 7-6(3); 6-3,R16,111,7,4,62,109,43,62,26,47,5,8,16,69,109,10,3,48,77,38,48,17,29,2,4,14,55,77
2003-07-21 00:00:00.000,Indianapolis IN; U.S.A. ATP World Tour,HARD,2,Paradorn Srichaphan,Alex Bogomolov Jr.,Paradorn Srichaphan,6-4; 6-3,R16,61,10,1,27,47,24,27,16,20,0,0,10,40,47,0,4,31,55,23,31,10,24,1,3,9,33,55
2003-07-21 00:00:00.000,Indianapolis IN; U.S.A. ATP World Tour,HARD,2,Andy Roddick,Xavier Malisse,Andy Roddick,6-4; 6-1,Q,59,12,3,34,51,29,34,10,17,1,1,9,39,51,5,0,28,47,19,28,7,19,3,6,8,26,47
2003-07-21 00:00:00.000,Indianapolis IN; U.S.A. ATP World Tour,HARD,2,Sjeng Schalken,Robby Ginepri,Sjeng Schalken,1-6; 6-1; 6-2,Q,92,7,7,56,89,37,56,14,33,5,7,11,51,89,7,4,31,70,22,31,19,39,3,7,11,41,70
2003-07-21 00:00:00.000,Indianapolis IN; U.S.A. ATP World Tour,HARD,2,Nicolas Thomann,Nicolas Kiefer,Nicolas Thomann,7-6(2); 7-5,Q,113,12,6,34,70,29,34,22,36,1,2,12,51,70,8,2,34,76,28,34,22,42,5,7,12,50,76
2003-07-21 00:00:00.000,Indianapolis IN; U.S.A. ATP World Tour,HARD,2,Paradorn Srichaphan,Scott Draper,Paradorn Srichaphan,6-4; 6-2,Q,58,1,1,33,58,24,33,14,25,5,6,9,38,58,3,0,30,43,20,30,5,13,0,4,9,25,43
2003-07-21 00:00:00.000,Indianapolis IN; U.S.A. ATP World Tour,HARD,2,Andy Roddick,Sjeng Schalken,Andy Roddick,6-3; 6-2,S,63,5,2,21,45,18,21,16,24,0,1,9,34,45,1,1,33,57,20,33,9,24,6,10,8,29,57
2003-07-21 00:00:00.000,Indianapolis IN; U.S.A. ATP World Tour,HARD,2,Paradorn Srichaphan,Nicolas Thomann,Paradorn Srichaphan,4-6; 7-6(5); 6-3,S,137,17,5,57,96,45,57,22,39,6,8,15,67,96,6,5,53,107,41,53,27,54,7,10,16,68,107
2003-07-21 00:00:00.000,Indianapolis IN; U.S.A. ATP World Tour,HARD,2,Andy Roddick,Paradorn Srichaphan,Andy Roddick,7-6(2); 6-4,F,83,15,3,32,62,29,32,22,30,1,1,11,51,62,5,3,29,68,21,29,25,39,3,4,11,46,68
2003-07-21 00:00:00.000,Kitzbuhel Austria ATP World Tour,CLAY,2,Juan Carlos Ferrero,N/A Bye,Juan Carlos Ferrero,,R64,0,0,0,0,0,0,0,0,0,0,0,0,0,0,0,0,0,0,0,0,0,0,0,0,0,0,0
2003-07-21 00:00:00.000,Kitzbuhel Austria ATP World Tour,CLAY,2,Fernando Verdasco,Antony Dupuis,Fernando Verdasco,1-6; 7-6(5); 6-4,R64,118,4,4,54,81,40,54,16,27,1,3,14,56,81,5,2,59,97,46,59,21,38,3,4,15,67,97
2003-07-21 00:00:00.000,Kitzbuhel Austria ATP World Tour,CLAY,2,Gaston Etlis,Franco Squillari,Gaston Etlis,7-5; 4-6; 6-1,R64,126,3,3,52,96,36,52,27,44,5,7,15,63,96,3,8,62,99,41,62,16,37,6,10,14,57,99
2003-07-21 00:00:00.000,Kitzbuhel Austria ATP World Tour,CLAY,2,Flavio Saretta,N/A Bye,Flavio Saretta,,R64,0,0,0,0,0,0,0,0,0,0,0,0,0,0,0,0,0,0,0,0,0,0,0,0,0,0,0
2003-07-21 00:00:00.000,Kitzbuhel Austria ATP World Tour,CLAY,2,Mariano Zabaleta,N/A Bye,Mariano Zabaleta,,R64,0,0,0,0,0,0,0,0,0,0,0,0,0,0,0,0,0,0,0,0,0,0,0,0,0,0,0
2003-07-21 00:00:00.000,Kitzbuhel Austria ATP World Tour,CLAY,2,Victor Hanescu,Markus Hipfl,Victor Hanescu,6-4; 6-0,R64,51,1,1,23,41,20,23,12,18,0,0,8,32,41,1,4,26,44,15,26,8,18,5,9,8,23,44
2003-07-21 00:00:00.000,Kitzbuhel Austria ATP World Tour,CLAY,2,Michel Kratochvil,Julien Boutter,Michel Kratochvil,6-3; 6-3,R64,71,5,5,37,58,29,37,11,21,7,8,9,40,58,3,5,35,62,17,35,14,27,3,7,9,31,62
2003-07-21 00:00:00.000,Kitzbuhel Austria ATP World Tour,CLAY,2,Younes El Aynaoui,N/A Bye,Younes El Aynaoui,,R64,0,0,0,0,0,0,0,0,0,0,0,0,0,0,0,0,0,0,0,0,0,0,0,0,0,0,0
2003-07-21 00:00:00.000,Kitzbuhel Austria ATP World Tour,CLAY,2,Albert Costa,N/A Bye,Albert Costa,,R64,0,0,0,0,0,0,0,0,0,0,0,0,0,0,0,0,0,0,0,0,0,0,0,0,0,0,0
2003-07-21 00:00:00.000,Kitzbuhel Austria ATP World Tour,CLAY,2,Nicolas Massu,Stefan Koubek,Nicolas Massu,6-4; 3-6; 6-4,R64,150,2,2,57,92,38,57,20,35,3,5,14,58,92,2,3,62,107,35,62,31,45,7,10,15,66,107
2003-07-21 00:00:00.000,Kitzbuhel Austria ATP World Tour,CLAY,2,Albert Portas,Bohdan Ulihrach,Albert Portas,6-4; 6-2,R64,81,4,0,31,55,27,31,13,24,1,1,9,40,55,4,1,39,77,24,39,20,38,7,10,9,44,77
2003-07-21 00:00:00.000,Kitzbuhel Austria ATP World Tour,CLAY,2,Sargis Sargsian,N/A Bye,Sargis Sargsian,,R64,0,0,0,0,0,0,0,0,0,0,0,0,0,0,0,0,0,0,0,0,0,0,0,0,0,0,0
2003-07-21 00:00:00.000,Kitzbuhel Austria ATP World Tour,CLAY,2,Nikolay Davydenko,N/A Bye,Nikolay Davydenko,,R64,0,0,0,0,0,0,0,0,0,0,0,0,0,0,0,0,0,0,0,0,0,0,0,0,0,0,0
2003-07-21 00:00:00.000,Kitzbuhel Austria ATP World Tour,CLAY,2,Alexander Peya,Galo Blanco,Alexander Peya,4-6; 6-3; 7-6(6),R64,118,3,5,73,113,50,73,19,40,6,10,16,69,113,2,6,51,84,34,51,19,33,1,5,15,53,84
2003-07-21 00:00:00.000,Kitzbuhel Austria ATP World Tour,CLAY,2,Nicolas Lapentti,Wayne Arthurs,Nicolas Lapentti,7-6(8); 6-3,R64,85,6,2,40,66,35,40,18,26,0,0,11,53,66,6,3,30,58,23,30,21,28,2,3,10,44,58
2003-07-21 00:00:00.000,Kitzbuhel Austria ATP World Tour,CLAY,2,Mikhail Youzhny,N/A Bye,Mikhail Youzhny,,R64,0,0,0,0,0,0,0,0,0,0,0,0,0,0,0,0,0,0,0,0,0,0,0,0,0,0,0
2003-07-21 00:00:00.000,Kitzbuhel Austria ATP World Tour,CLAY,2,Gaston Gaudio,N/A Bye,Gaston Gaudio,,R64,0,0,0,0,0,0,0,0,0,0,0,0,0,0,0,0,0,0,0,0,0,0,0,0,0,0,0
2003-07-21 00:00:00.000,Kitzbuhel Austria ATP World Tour,CLAY,2,Tomas Behrend,Oscar Hernandez,Tomas Behrend,6-4; 3-6; 6-3,R64,115,3,9,48,94,37,48,24,46,6,7,14,61,94,5,4,49,81,38,49,17,32,0,2,14,55,81
2003-07-21 00:00:00.000,Kitzbuhel Austria ATP World Tour,CLAY,2,Werner Eschauer,Alexander Waske,Werner Eschauer,6-7(3); 6-1; 6-3,R64,85,11,4,52,78,42,52,15,26,2,3,14,57,78,5,6,45,77,32,45,16,32,1,6,14,48,77
2003-07-21 00:00:00.000,Kitzbuhel Austria ATP World Tour,CLAY,2,Alex Corretja,N/A Bye,Alex Corretja,,R64,0,0,0,0,0,0,0,0,0,0,0,0,0,0,0,0,0,0,0,0,0,0,0,0,0,0,0
2003-07-21 00:00:00.000,Kitzbuhel Austria ATP World Tour,CLAY,2,Feliciano Lopez,N/A Bye,Feliciano Lopez,,R64,0,0,0,0,0,0,0,0,0,0,0,0,0,0,0,0,0,0,0,0,0,0,0,0,0,0,0
2003-07-21 00:00:00.000,Kitzbuhel Austria ATP World Tour,CLAY,2,Florin Mergea,Robin Vik,Florin Mergea,6-3; 3-6; 6-2,R64,85,1,9,43,73,38,43,12,30,2,4,13,50,73,3,6,47,74,35,47,11,27,4,8,13,46,74
2003-07-21 00:00:00.000,Kitzbuhel Austria ATP World Tour,CLAY,2,Paul-Henri Mathieu,Ingo Neumuller,Paul-Henri Mathieu,6-2; 6-2,R64,76,3,3,15,44,12,15,17,29,0,1,8,29,44,0,1,22,54,9,22,16,32,4,9,8,25,54
2003-07-21 00:00:00.000,Kitzbuhel Austria ATP World Tour,CLAY,2,Rainer Schuettler,N/A Bye,Rainer Schuettler,,R64,0,0,0,0,0,0,0,0,0,0,0,0,0,0,0,0,0,0,0,0,0,0,0,0,0,0,0
2003-07-21 00:00:00.000,Kitzbuhel Austria ATP World Tour,CLAY,2,Juan Ignacio Chela,N/A Bye,Juan Ignacio Chela,,R64,0,0,0,0,0,0,0,0,0,0,0,0,0,0,0,0,0,0,0,0,0,0,0,0,0,0,0
2003-07-21 00:00:00.000,Kitzbuhel Austria ATP World Tour,CLAY,2,Frantisek Cermak,Jurgen Melzer,Frantisek Cermak,7-5; 6-2,R64,74,4,3,32,53,24,32,11,21,0,2,10,35,53,3,3,30,66,22,30,12,36,3,8,10,34,66
2003-07-21 00:00:00.000,Kitzbuhel Austria ATP World Tour,CLAY,2,Luis Horna,Daniel Koellerer,Luis Horna,6-3; 6-2,R64,78,9,2,28,56,23,28,14,28,1,2,9,37,56,1,2,36,53,21,36,6,17,3,7,8,27,53
2003-07-21 00:00:00.000,Kitzbuhel Austria ATP World Tour,CLAY,2,Max Mirnyi,N/A Bye,Max Mirnyi,,R64,0,0,0,0,0,0,0,0,0,0,0,0,0,0,0,0,0,0,0,0,0,0,0,0,0,0,0
2003-07-21 00:00:00.000,Kitzbuhel Austria ATP World Tour,CLAY,2,David Sanchez,N/A Bye,David Sanchez,,R64,0,0,0,0,0,0,0,0,0,0,0,0,0,0,0,0,0,0,0,0,0,0,0,0,0,0,0
2003-07-21 00:00:00.000,Kitzbuhel Austria ATP World Tour,CLAY,2,Olivier Mutis,Andreas Seppi,Olivier Mutis,6-3; 6-4,R64,103,6,3,40,71,28,40,16,31,4,6,10,44,71,1,2,31,54,18,31,11,23,2,6,9,29,54
2003-07-21 00:00:00.000,Kitzbuhel Austria ATP World Tour,CLAY,2,Andreas Vinciguerra,Oliver Gross,Andreas Vinciguerra,6-4; 6-4,R64,72,2,1,43,68,29,43,14,25,5,6,10,43,68,3,3,43,64,28,43,8,21,2,5,10,36,64
2003-07-21 00:00:00.000,Kitzbuhel Austria ATP World Tour,CLAY,2,Guillermo Coria,N/A Bye,Guillermo Coria,,R64,0,0,0,0,0,0,0,0,0,0,0,0,0,0,0,0,0,0,0,0,0,0,0,0,0,0,0
2003-07-21 00:00:00.000,Kitzbuhel Austria ATP World Tour,CLAY,2,Juan Carlos Ferrero,Fernando Verdasco,Juan Carlos Ferrero,7-6(3); 7-6(2),R32,112,4,3,47,85,31,47,20,38,7,10,12,51,85,4,5,72,93,46,72,6,21,5,8,12,52,93
2003-07-21 00:00:00.000,Kitzbuhel Austria ATP World Tour,CLAY,2,Flavio Saretta,Gaston Etlis,Flavio Saretta,7-6(3); 6-1,R32,89,6,6,26,58,17,26,22,32,2,3,9,39,58,5,7,47,87,29,47,14,40,7,11,10,43,87
2003-07-21 00:00:00.000,Kitzbuhel Austria ATP World Tour,CLAY,2,Mariano Zabaleta,Victor Hanescu,Mariano Zabaleta,6-2; 7-5,R32,80,3,1,41,58,29,41,10,17,1,3,10,39,58,5,5,46,70,27,46,9,24,9,14,10,36,70
2003-07-21 00:00:00.000,Kitzbuhel Austria ATP World Tour,CLAY,2,Younes El Aynaoui,Michel Kratochvil,Younes El Aynaoui,6-7(4); 6-1; 7-6(3),R32,192,1,0,66,91,33,66,15,25,3,10,15,48,91,1,2,79,110,33,79,16,31,3,13,16,49,110
2003-07-21 00:00:00.000,Kitzbuhel Austria ATP World Tour,CLAY,2,Nicolas Massu,Albert Costa,Nicolas Massu,6-7(9); 7-5; 7-6(0),R32,213,12,5,62,124,49,62,37,62,4,6,18,86,124,12,3,82,125,59,82,26,43,4,7,18,85,125
2003-07-21 00:00:00.000,Kitzbuhel Austria ATP World Tour,CLAY,2,Sargis Sargsian,Albert Portas,Sargis Sargsian,7-6(4); 6-1,R32,91,3,6,40,77,29,40,22,37,9,10,10,51,77,0,4,33,64,21,33,16,31,7,10,9,37,64
2003-07-21 00:00:00.000,Kitzbuhel Austria ATP World Tour,CLAY,2,Nikolay Davydenko,Alexander Peya,Nikolay Davydenko,6-2; 6-3,R32,68,0,1,37,53,22,37,10,16,3,5,8,32,53,1,4,28,59,16,28,10,31,4,10,9,26,59
2003-07-21 00:00:00.000,Kitzbuhel Austria ATP World Tour,CLAY,2,Nicolas Lapentti,Mikhail Youzhny,Nicolas Lapentti,6-3; 6-3,R32,81,4,2,42,63,30,42,12,21,6,7,9,42,63,1,6,30,59,23,30,8,29,0,4,9,31,59
2003-07-21 00:00:00.000,Kitzbuhel Austria ATP World Tour,CLAY,2,Gaston Gaudio,Tomas Behrend,Gaston Gaudio,6-4; 6-3,R32,89,3,2,35,64,27,35,9,29,4,7,9,36,64,3,5,43,71,24,43,8,28,4,10,10,32,71
2003-07-21 00:00:00.000,Kitzbuhel Austria ATP World Tour,CLAY,2,Werner Eschauer,Alex Corretja,Werner Eschauer,6-4; 6-4,R32,103,3,2,43,78,34,43,18,35,4,4,10,52,78,5,4,28,54,22,28,15,26,2,4,10,37,54
2003-07-21 00:00:00.000,Kitzbuhel Austria ATP World Tour,CLAY,2,Feliciano Lopez,Florin Mergea,Feliciano Lopez,6-3; 6-4,R32,57,8,3,26,46,23,26,13,20,0,0,9,36,46,3,2,36,55,24,36,9,19,5,8,10,33,55
2003-07-21 00:00:00.000,Kitzbuhel Austria ATP World Tour,CLAY,2,Paul-Henri Mathieu,Rainer Schuettler,Paul-Henri Mathieu,6-4; 3-6; 6-3,R32,106,4,7,38,82,29,38,17,44,3,8,14,46,82,3,3,44,76,28,44,14,32,1,7,14,42,76
2003-07-21 00:00:00.000,Kitzbuhel Austria ATP World Tour,CLAY,2,Juan Ignacio Chela,Frantisek Cermak,Juan Ignacio Chela,6-1; 6-3,R32,65,2,4,21,44,18,21,11,23,0,1,8,29,44,0,1,24,48,12,24,7,24,2,7,8,19,48
2003-07-21 00:00:00.000,Kitzbuhel Austria ATP World Tour,CLAY,2,Max Mirnyi,Luis Horna,Max Mirnyi,6-3; 6-2,R32,70,16,0,42,56,33,42,7,14,9,9,8,40,56,2,0,39,60,22,39,11,21,4,8,9,33,60
2003-07-21 00:00:00.000,Kitzbuhel Austria ATP World Tour,CLAY,2,Olivier Mutis,David Sanchez,Olivier Mutis,6-2; 6-4,R32,75,4,2,26,62,22,26,17,36,3,4,9,39,62,2,2,24,53,13,24,15,29,0,4,9,28,53
2003-07-21 00:00:00.000,Kitzbuhel Austria ATP World Tour,CLAY,2,Guillermo Coria,Andreas Vinciguerra,Guillermo Coria,6-4; 6-3,R32,87,3,4,34,68,25,34,23,34,5,5,10,48,68,3,0,34,60,25,34,14,26,4,6,9,39,60
2003-07-21 00:00:00.000,Kitzbuhel Austria ATP World Tour,CLAY,2,Juan Carlos Ferrero,Flavio Saretta,Juan Carlos Ferrero,7-6(4); 6-3,R16,100,1,1,34,66,24,34,20,32,2,3,10,44,66,5,4,40,77,33,40,13,37,6,9,11,46,77
2003-07-21 00:00:00.000,Kitzbuhel Austria ATP World Tour,CLAY,2,Mariano Zabaleta,Younes El Aynaoui,Mariano Zabaleta,W/O,R16,0,0,0,0,0,0,0,0,0,0,0,0,0,0,0,0,0,0,0,0,0,0,0,0,0,0,0
2003-07-21 00:00:00.000,Kitzbuhel Austria ATP World Tour,CLAY,2,Nicolas Massu,Sargis Sargsian,Nicolas Massu,6-2; 6-2,R16,76,0,0,23,43,15,23,14,20,0,1,8,29,43,2,3,28,48,15,28,5,20,2,7,8,20,48
2003-07-21 00:00:00.000,Kitzbuhel Austria ATP World Tour,CLAY,2,Nicolas Lapentti,Nikolay Davydenko,Nicolas Lapentti,6-3; 6-3,R16,68,1,1,30,47,22,30,10,17,2,3,8,32,47,0,2,30,45,12,30,7,15,1,6,8,19,45
2003-07-21 00:00:00.000,Kitzbuhel Austria ATP World Tour,CLAY,2,Gaston Gaudio,Werner Eschauer,Gaston Gaudio,6-4; 3-6; 6-4,R16,143,0,6,57,103,38,57,24,46,11,14,14,62,103,3,2,41,85,30,41,22,44,7,11,15,52,85
2003-07-21 00:00:00.000,Kitzbuhel Austria ATP World Tour,CLAY,2,Feliciano Lopez,Paul-Henri Mathieu,Feliciano Lopez,3-6; 6-3; 3-0 RET,R16,94,8,1,36,66,27,36,15,30,3,5,10,42,66,2,8,31,67,23,31,15,36,3,7,11,38,67
2003-07-21 00:00:00.000,Kitzbuhel Austria ATP World Tour,CLAY,2,Juan Ignacio Chela,Max Mirnyi,Juan Ignacio Chela,6-4; 3-6; 7-6(6),R16,146,5,10,51,93,36,51,20,42,4,8,15,56,93,9,10,57,98,38,57,21,41,5,9,16,59,98
2003-07-21 00:00:00.000,Kitzbuhel Austria ATP World Tour,CLAY,2,Guillermo Coria,Olivier Mutis,Guillermo Coria,6-1; 6-0,R16,47,1,1,24,41,19,24,12,17,3,3,7,31,41,0,0,10,35,4,10,8,25,4,9,6,12,35
2003-07-21 00:00:00.000,Kitzbuhel Austria ATP World Tour,CLAY,2,Mariano Zabaleta,Juan Carlos Ferrero,Mariano Zabaleta,6-1; 6-4,Q,60,3,2,24,46,20,24,13,22,0,1,9,33,46,2,4,25,47,15,25,8,22,1,5,8,23,47
2003-07-21 00:00:00.000,Kitzbuhel Austria ATP World Tour,CLAY,2,Nicolas Massu,Nicolas Lapentti,Nicolas Massu,7-5; 6-4,Q,134,5,5,45,81,34,45,16,36,10,12,11,50,81,2,2,37,66,24,37,13,29,3,7,11,37,66
2003-07-21 00:00:00.000,Kitzbuhel Austria ATP World Tour,CLAY,2,Feliciano Lopez,Gaston Gaudio,Feliciano Lopez,6-2; 6-7(2); 7-5,Q,132,8,1,62,101,37,62,29,39,5,7,16,66,101,1,6,68,101,47,68,16,33,5,10,16,63,101
2003-07-21 00:00:00.000,Kitzbuhel Austria ATP World Tour,CLAY,2,Guillermo Coria,Juan Ignacio Chela,Guillermo Coria,6-3; 6-2,Q,70,6,0,33,48,27,33,8,15,0,1,9,35,48,2,7,31,60,18,31,11,29,4,8,8,29,60
2003-07-21 00:00:00.000,Kitzbuhel Austria ATP World Tour,CLAY,2,Nicolas Massu,Mariano Zabaleta,Nicolas Massu,6-2; 6-1,S,72,3,2,36,52,28,36,9,16,1,1,8,37,52,5,1,22,46,13,22,10,24,4,8,7,23,46
2003-07-21 00:00:00.000,Kitzbuhel Austria ATP World Tour,CLAY,2,Guillermo Coria,Feliciano Lopez,Guillermo Coria,6-1; 6-2,S,59,2,2,30,42,27,30,5,12,0,0,8,32,42,4,1,26,52,14,26,12,26,2,6,7,26,52
2003-07-21 00:00:00.000,Kitzbuhel Austria ATP World Tour,CLAY,2,Guillermo Coria,Nicolas Massu,Guillermo Coria,6-1; 6-4; 6-2,F,127,7,0,47,67,36,47,17,20,0,0,13,53,67,4,9,53,92,37,53,12,39,5,10,12,49,92
2003-07-21 00:00:00.000,Umag Croatia ATP World Tour,CLAY,2,Carlos Moya,Jiri Vanek,Carlos Moya,7-6(1); 6-4,R32,86,9,3,44,75,39,44,14,31,3,4,11,53,75,4,5,36,70,28,36,15,34,3,5,11,43,70
2003-07-21 00:00:00.000,Umag Croatia ATP World Tour,CLAY,2,Federico Browne,Zeljko Krajan,Federico Browne,7-6(10); 6-2,R32,94,1,1,43,68,29,43,13,25,1,3,10,42,68,1,5,38,69,24,38,14,31,1,5,10,38,69
2003-07-21 00:00:00.000,Umag Croatia ATP World Tour,CLAY,2,Jean-Rene Lisnard,Julian Knowle,Jean-Rene Lisnard,6-4; 6-3,R32,97,1,3,34,61,25,34,16,27,4,5,10,41,61,2,7,39,63,26,39,9,24,2,5,9,35,63
2003-07-21 00:00:00.000,Umag Croatia ATP World Tour,CLAY,2,David Ferrer,Hicham Arazi,David Ferrer,6-0; 3-1 RET,R32,40,1,2,29,37,21,29,4,8,5,5,5,25,37,0,0,11,31,6,11,5,20,3,7,5,11,31
2003-07-21 00:00:00.000,Umag Croatia ATP World Tour,CLAY,2,Sasa Tuksar,Albert Montanes,Sasa Tuksar,7-5 RET,R32,58,3,2,26,50,22,26,8,24,7,8,6,30,50,2,3,20,31,14,20,4,11,0,2,6,18,31
2003-07-21 00:00:00.000,Umag Croatia ATP World Tour,CLAY,2,Magnus Norman,Ruben Ramirez Hidalgo,Magnus Norman,4-6; 6-3; 7-5,R32,139,7,6,53,95,38,53,21,42,3,6,15,59,95,6,4,62,99,38,62,21,37,11,16,16,59,99
2003-07-21 00:00:00.000,Umag Croatia ATP World Tour,CLAY,2,Mariano Puerta,Juan Antonio Marin,Mariano Puerta,6-3; 7-5,R32,90,1,1,43,60,31,43,9,17,4,6,11,40,60,6,3,37,66,23,37,14,29,5,9,10,37,66
2003-07-21 00:00:00.000,Umag Croatia ATP World Tour,CLAY,2,Rafael Nadal,Adrian Voinea,Rafael Nadal,6-3; 1-0 RET,R32,37,1,2,15,23,11,15,5,8,0,1,5,16,23,7,6,27,44,18,27,4,17,5,8,5,22,44
2003-07-21 00:00:00.000,Umag Croatia ATP World Tour,CLAY,2,Dominik Hrbaty,Fernando Vicente,Dominik Hrbaty,6-3; 6-0,R32,50,2,0,24,33,22,24,6,9,0,0,7,28,33,5,3,27,49,17,27,5,22,4,9,8,22,49
2003-07-21 00:00:00.000,Umag Croatia ATP World Tour,CLAY,2,Mario Radic,Giorgio Galimberti,Mario Radic,1-6; 6-4; 6-4,R32,114,6,7,50,95,36,50,23,45,4,7,14,59,95,2,8,39,73,31,39,18,34,2,4,13,49,73
2003-07-21 00:00:00.000,Umag Croatia ATP World Tour,CLAY,2,Ivo Karlovic,Christophe Rochus,Ivo Karlovic,7-5; 6-4,R32,76,11,4,28,59,24,28,18,31,2,3,11,42,59,0,5,33,58,22,33,14,25,3,6,11,36,58
2003-07-21 00:00:00.000,Umag Croatia ATP World Tour,CLAY,2,Alberto Martin,Olivier Rochus,Alberto Martin,6-3; 6-2,R32,73,7,5,40,62,28,40,10,22,3,5,9,38,62,1,8,27,62,18,27,10,35,9,14,8,28,62
2003-07-21 00:00:00.000,Umag Croatia ATP World Tour,CLAY,2,Filippo Volandri,Attila Savolt,Filippo Volandri,6-3; 6-0,R32,64,1,4,26,53,22,26,13,27,3,3,7,35,53,2,2,30,49,18,30,5,19,5,10,8,23,49
2003-07-21 00:00:00.000,Umag Croatia ATP World Tour,CLAY,2,Stanislas Wawrinka,Roko Karanusic,Stanislas Wawrinka,6-4; 6-4,R32,81,4,2,53,82,36,53,16,29,10,11,10,52,82,1,5,30,60,22,30,13,30,5,8,10,35,60
2003-07-21 00:00:00.000,Umag Croatia ATP World Tour,CLAY,2,Kristof Vliegen,Michal Mertinak,Kristof Vliegen,6-0; 2-6; 6-3,R32,95,8,2,48,77,38,48,12,29,3,5,12,50,77,0,1,42,71,29,42,11,29,3,7,11,40,71
2003-07-21 00:00:00.000,Umag Croatia ATP World Tour,CLAY,2,Fernando Gonzalez,Lovro Zovko,Fernando Gonzalez,6-4; 6-4,R32,78,8,5,33,56,26,33,15,23,3,4,10,41,56,5,2,40,76,28,40,14,36,7,10,10,42,76
2003-07-21 00:00:00.000,Umag Croatia ATP World Tour,CLAY,2,Carlos Moya,Federico Browne,Carlos Moya,6-2; 6-4,R16,62,4,2,30,52,23,30,13,22,1,2,9,36,52,2,4,37,57,22,37,7,20,4,8,9,29,57
2003-07-21 00:00:00.000,Umag Croatia ATP World Tour,CLAY,2,David Ferrer,Jean-Rene Lisnard,David Ferrer,6-3; 4-6; 7-5,R16,163,0,5,83,120,48,83,19,37,7,13,16,67,120,2,6,57,120,38,57,24,63,12,19,15,62,120
2003-07-21 00:00:00.000,Umag Croatia ATP World Tour,CLAY,2,Magnus Norman,Sasa Tuksar,Magnus Norman,7-6(8); 7-6(3),R16,134,6,4,45,91,39,45,21,46,5,7,12,60,91,1,3,45,88,28,45,27,43,4,6,12,55,88
2003-07-21 00:00:00.000,Umag Croatia ATP World Tour,CLAY,2,Rafael Nadal,Mariano Puerta,Rafael Nadal,6-2; 6-4,R16,80,8,1,45,62,34,45,8,17,4,4,9,42,62,1,2,30,55,20,30,12,25,3,6,9,32,55
2003-07-21 00:00:00.000,Umag Croatia ATP World Tour,CLAY,2,Dominik Hrbaty,Mario Radic,Dominik Hrbaty,7-6(3); 7-6(4),R16,87,4,3,54,83,38,54,15,29,4,7,12,53,83,7,1,52,86,34,52,15,34,4,7,12,49,86
2003-07-21 00:00:00.000,Umag Croatia ATP World Tour,CLAY,2,Alberto Martin,Ivo Karlovic,Alberto Martin,2-6; 6-3; 7-6(2),R16,126,1,6,66,102,46,66,18,36,7,11,15,64,102,12,9,52,86,38,52,18,34,5,8,14,56,86
2003-07-21 00:00:00.000,Umag Croatia ATP World Tour,CLAY,2,Filippo Volandri,Stanislas Wawrinka,Filippo Volandri,6-4; 6-3,R16,76,0,3,42,66,30,42,12,24,6,8,10,42,66,2,4,35,63,21,35,11,28,5,9,9,32,63
2003-07-21 00:00:00.000,Umag Croatia ATP World Tour,CLAY,2,Fernando Gonzalez,Kristof Vliegen,Fernando Gonzalez,3-0 RET,R16,16,0,2,1,8,1,1,4,7,0,0,1,5,8,0,1,10,13,4,10,0,3,1,3,2,4,13
2003-07-21 00:00:00.000,Umag Croatia ATP World Tour,CLAY,2,Carlos Moya,David Ferrer,Carlos Moya,6-1; 6-2,Q,55,5,1,24,49,19,24,13,25,3,3,7,32,49,0,8,28,58,14,28,13,30,6,11,8,27,58
2003-07-21 00:00:00.000,Umag Croatia ATP World Tour,CLAY,2,Rafael Nadal,Magnus Norman,Rafael Nadal,6-3; 6-4,Q,93,0,2,38,68,27,38,18,30,7,8,10,45,68,1,3,24,54,17,24,14,30,2,5,9,31,54
2003-07-21 00:00:00.000,Umag Croatia ATP World Tour,CLAY,2,Dominik Hrbaty,Alberto Martin,Dominik Hrbaty,7-5; 6-2,Q,89,2,4,43,76,28,43,18,33,5,7,10,46,76,1,5,30,58,17,30,13,28,2,7,10,30,58
2003-07-21 00:00:00.000,Umag Croatia ATP World Tour,CLAY,2,Filippo Volandri,Fernando Gonzalez,Filippo Volandri,4-6; 6-2; 7-6(4),Q,136,0,3,80,112,51,80,16,32,10,15,15,67,112,6,6,48,103,28,48,27,55,9,15,15,55,103
2003-07-21 00:00:00.000,Umag Croatia ATP World Tour,CLAY,2,Carlos Moya,Rafael Nadal,Carlos Moya,6-4; 6-4,S,79,4,2,34,54,29,34,12,20,0,0,10,41,54,0,1,47,65,30,47,9,18,2,4,10,39,65
2003-07-21 00:00:00.000,Umag Croatia ATP World Tour,CLAY,2,Filippo Volandri,Dominik Hrbaty,Filippo Volandri,7-6(6); 6-1,S,81,0,1,44,65,30,44,14,21,1,2,10,44,65,1,0,47,73,27,47,12,26,4,7,9,39,73
2003-07-21 00:00:00.000,Umag Croatia ATP World Tour,CLAY,2,Carlos Moya,Filippo Volandri,Carlos Moya,6-4; 3-6; 7-5,F,134,7,1,65,123,40,65,26,58,8,14,15,66,123,0,2,72,106,43,72,12,34,7,14,16,55,106
2003-07-28 00:00:00.000,Los Angeles CA; U.S.A. ATP World Tour,HARD,2,Lleyton Hewitt,Cecil Mamiit,Lleyton Hewitt,6-0; 7-5,R32,86,5,5,31,63,24,31,15,32,3,5,9,39,63,1,2,40,60,19,40,7,20,7,13,9,26,60
2003-07-28 00:00:00.000,Los Angeles CA; U.S.A. ATP World Tour,HARD,2,Michael Joyce,Jan-Michael Gambill,Michael Joyce,7-6(5); 2-6; 7-6(4),R32,174,12,5,79,143,55,79,34,64,12,15,16,89,143,26,4,63,104,51,63,23,41,3,4,16,74,104
2003-07-28 00:00:00.000,Los Angeles CA; U.S.A. ATP World Tour,HARD,2,Kenneth Carlsen,Bobby Reynolds,Kenneth Carlsen,6-2; 4-6; 7-6(3),R32,137,13,1,50,82,39,50,21,32,1,3,15,60,82,9,9,65,115,40,65,27,50,14,17,15,67,115
2003-07-28 00:00:00.000,Los Angeles CA; U.S.A. ATP World Tour,HARD,2,Prakash Amritraj,Marat Safin,Prakash Amritraj,5-3 RET,R32,45,0,2,17,31,13,17,7,14,2,2,4,20,31,3,2,21,38,13,21,8,17,7,8,4,21,38
2003-07-28 00:00:00.000,Los Angeles CA; U.S.A. ATP World Tour,HARD,2,Sjeng Schalken,Denis Golovanov,Sjeng Schalken,6-4; 6-4,R32,73,4,3,34,59,24,34,14,25,3,6,10,38,59,2,5,33,65,22,33,10,32,6,11,10,32,65
2003-07-28 00:00:00.000,Los Angeles CA; U.S.A. ATP World Tour,HARD,2,Nicolas Kiefer,Nicolas Thomann,Nicolas Kiefer,6-1; 6-4,R32,88,18,1,36,59,31,36,12,23,1,1,9,43,59,4,7,34,66,22,34,12,32,11,14,8,34,66
2003-07-28 00:00:00.000,Los Angeles CA; U.S.A. ATP World Tour,HARD,2,Jan Vacek,Kevin Kim,Jan Vacek,2-6; 6-1; 6-4,R32,95,7,2,38,89,28,38,28,51,8,10,13,56,89,7,1,45,68,31,45,12,23,0,3,12,43,68
2003-07-28 00:00:00.000,Los Angeles CA; U.S.A. ATP World Tour,HARD,2,Vincent Spadea,Justin Gimelstob,Vincent Spadea,6-4; 6-3,R32,70,3,7,28,61,23,28,18,33,4,5,10,41,61,4,5,34,59,25,34,8,25,5,8,9,33,59
2003-07-28 00:00:00.000,Los Angeles CA; U.S.A. ATP World Tour,HARD,2,Mark Philippoussis,Adam Kennedy,Mark Philippoussis,6-3; 6-2,R32,60,12,1,24,41,22,24,14,17,0,0,9,36,41,4,1,42,58,25,42,9,16,3,6,8,34,58
2003-07-28 00:00:00.000,Los Angeles CA; U.S.A. ATP World Tour,HARD,2,Michael Chang,Zack Fleishman,Michael Chang,6-1; 6-1,R32,50,4,1,26,39,21,26,6,13,0,1,7,27,39,4,4,30,52,17,30,4,22,4,10,7,21,52
2003-07-28 00:00:00.000,Los Angeles CA; U.S.A. ATP World Tour,HARD,2,Eric Taino,Hyung-Taik Lee,Eric Taino,3-6; 7-6(5); 6-2,R32,127,9,2,40,90,34,40,26,50,5,7,14,60,90,14,0,59,98,42,59,22,39,4,7,15,64,98
2003-07-28 00:00:00.000,Los Angeles CA; U.S.A. ATP World Tour,HARD,2,Gustavo Kuerten,Frederic Niemeyer,Gustavo Kuerten,3-6; 7-6(2); 6-4,R32,116,19,3,62,101,47,62,21,39,3,4,15,68,101,25,14,62,113,50,62,23,51,6,7,16,73,113
2003-07-28 00:00:00.000,Los Angeles CA; U.S.A. ATP World Tour,HARD,2,Wayne Ferreira,Robert Yim,Wayne Ferreira,6-4; 6-4,R32,56,8,1,36,50,28,36,10,14,2,3,10,38,50,2,3,41,63,28,41,10,22,3,6,10,38,63
2003-07-28 00:00:00.000,Los Angeles CA; U.S.A. ATP World Tour,HARD,2,Alex Bogomolov Jr.,Ricardo Mello,Alex Bogomolov Jr.,6-3; 6-2,R32,66,3,3,37,54,28,37,8,17,1,2,9,36,54,2,3,32,56,15,32,14,24,6,10,8,29,56
2003-07-28 00:00:00.000,Los Angeles CA; U.S.A. ATP World Tour,HARD,2,Robby Ginepri,Andrew Ilie,Robby Ginepri,6-1; 6-1,R32,35,5,1,22,35,19,22,10,13,0,0,7,29,35,3,4,22,38,12,22,3,16,0,5,7,15,38
2003-07-28 00:00:00.000,Los Angeles CA; U.S.A. ATP World Tour,HARD,2,Sebastien Grosjean,Xavier Malisse,Sebastien Grosjean,4-6; 7-5; 6-3,R32,115,4,2,50,94,40,50,24,44,6,7,16,64,94,10,3,59,88,46,59,16,29,5,7,15,62,88
2003-07-28 00:00:00.000,Los Angeles CA; U.S.A. ATP World Tour,HARD,2,Lleyton Hewitt,Michael Joyce,Lleyton Hewitt,6-3; 6-0,R16,71,14,2,31,46,26,31,6,15,4,5,7,32,46,1,5,36,71,15,36,15,35,8,14,8,30,71
2003-07-28 00:00:00.000,Los Angeles CA; U.S.A. ATP World Tour,HARD,2,Kenneth Carlsen,Prakash Amritraj,Kenneth Carlsen,6-4; 6-2,R16,65,4,2,34,47,27,34,9,13,0,0,9,36,47,4,1,37,53,23,37,6,16,3,6,9,29,53
2003-07-28 00:00:00.000,Los Angeles CA; U.S.A. ATP World Tour,HARD,2,Nicolas Kiefer,Sjeng Schalken,Nicolas Kiefer,6-4; 6-4,R16,82,7,1,36,58,29,36,11,22,2,3,10,40,58,1,1,40,56,23,40,10,16,1,4,10,33,56
2003-07-28 00:00:00.000,Los Angeles CA; U.S.A. ATP World Tour,HARD,2,Vincent Spadea,Jan Vacek,Vincent Spadea,7-5; 2-6; 6-2,R16,120,3,6,43,97,32,43,32,54,6,8,14,64,97,3,4,39,83,27,39,26,44,0,3,14,53,83
2003-07-28 00:00:00.000,Los Angeles CA; U.S.A. ATP World Tour,HARD,2,Mark Philippoussis,Michael Chang,Mark Philippoussis,6-2; 6-4,R16,74,8,3,20,45,16,20,17,25,0,1,9,33,45,4,0,31,56,20,31,8,25,2,6,9,28,56
2003-07-28 00:00:00.000,Los Angeles CA; U.S.A. ATP World Tour,HARD,2,Gustavo Kuerten,Eric Taino,Gustavo Kuerten,6-3; 7-6(5),R16,87,13,1,40,74,30,40,19,34,5,6,11,49,74,9,5,38,73,28,38,17,35,4,6,10,45,73
2003-07-28 00:00:00.000,Los Angeles CA; U.S.A. ATP World Tour,HARD,2,Wayne Ferreira,Alex Bogomolov Jr.,Wayne Ferreira,7-6(1); 6-3,R16,77,12,3,51,87,39,51,20,36,6,6,11,59,87,2,4,38,58,30,38,10,20,3,4,10,40,58
2003-07-28 00:00:00.000,Los Angeles CA; U.S.A. ATP World Tour,HARD,2,Sebastien Grosjean,Robby Ginepri,Sebastien Grosjean,6-2; 6-3,R16,69,7,0,29,56,26,29,13,27,3,3,8,39,56,4,7,24,51,17,24,10,27,3,7,9,27,51
2003-07-28 00:00:00.000,Los Angeles CA; U.S.A. ATP World Tour,HARD,2,Lleyton Hewitt,Kenneth Carlsen,Lleyton Hewitt,6-7(3); 6-4; 6-3,Q,141,4,5,41,91,35,41,35,50,2,2,16,70,91,15,5,64,104,48,64,20,40,8,10,15,68,104
2003-07-28 00:00:00.000,Los Angeles CA; U.S.A. ATP World Tour,HARD,2,Nicolas Kiefer,Vincent Spadea,Nicolas Kiefer,1-6; 7-5; 6-3,Q,125,7,3,48,92,35,48,25,44,3,5,14,60,92,4,3,47,78,36,47,18,31,2,4,14,54,78
2003-07-28 00:00:00.000,Los Angeles CA; U.S.A. ATP World Tour,HARD,2,Mark Philippoussis,Gustavo Kuerten,Mark Philippoussis,6-3; 3-6; 7-6(5),Q,116,22,4,66,109,53,66,22,43,8,9,15,75,109,12,2,59,85,48,59,16,26,1,2,15,64,85
2003-07-28 00:00:00.000,Los Angeles CA; U.S.A. ATP World Tour,HARD,2,Wayne Ferreira,Sebastien Grosjean,Wayne Ferreira,7-6(4); 6-7(4); 6-2,Q,123,7,4,72,99,59,72,16,27,0,0,16,75,99,10,0,57,114,44,57,29,57,3,5,16,73,114
2003-07-28 00:00:00.000,Los Angeles CA; U.S.A. ATP World Tour,HARD,2,Lleyton Hewitt,Nicolas Kiefer,Lleyton Hewitt,6-2; 6-4,S,81,4,2,29,56,20,29,14,27,1,3,9,34,56,7,1,31,55,17,31,10,24,2,7,9,27,55
2003-07-28 00:00:00.000,Los Angeles CA; U.S.A. ATP World Tour,HARD,2,Wayne Ferreira,Mark Philippoussis,Wayne Ferreira,6-4; 7-5,S,81,6,2,46,63,34,46,12,17,3,4,11,46,63,12,1,47,73,31,47,12,26,5,8,11,43,73
2003-07-28 00:00:00.000,Los Angeles CA; U.S.A. ATP World Tour,HARD,2,Wayne Ferreira,Lleyton Hewitt,Wayne Ferreira,6-3; 4-6; 7-5,F,148,19,4,70,117,54,70,18,47,10,12,16,72,117,13,6,52,119,40,52,31,67,12,15,15,71,119
2003-07-28 00:00:00.000,Sopot Sopot; Poland ATP World Tour,CLAY,2,Juan Carlos Ferrero,Bartlomiej Dabrowski,Juan Carlos Ferrero,6-3; 6-1,R32,65,0,2,21,44,18,21,15,23,0,0,8,33,44,0,2,19,48,11,19,12,29,2,6,8,23,48
2003-07-28 00:00:00.000,Sopot Sopot; Poland ATP World Tour,CLAY,2,Frantisek Cermak,Filip Urban,Frantisek Cermak,6-4; 6-2,R32,70,3,2,39,58,27,39,9,19,4,6,9,36,58,2,1,34,51,19,34,6,17,4,9,9,25,51
2003-07-28 00:00:00.000,Sopot Sopot; Poland ATP World Tour,CLAY,2,Luis Horna,Attila Savolt,Luis Horna,6-1; 6-1,R32,42,5,0,22,34,18,22,11,12,3,3,7,29,34,0,1,25,40,7,25,9,15,1,6,7,16,40
2003-07-28 00:00:00.000,Sopot Sopot; Poland ATP World Tour,CLAY,2,Dominik Hrbaty,Mariusz Fyrstenberg,Dominik Hrbaty,7-5; 6-3,R32,75,3,2,40,67,29,40,12,27,3,6,11,41,67,2,5,40,60,22,40,9,20,3,8,10,31,60
2003-07-28 00:00:00.000,Sopot Sopot; Poland ATP World Tour,CLAY,2,Guillermo Coria,Victor Hanescu,Guillermo Coria,6-3; 6-4,R32,79,3,2,28,45,25,28,10,17,3,4,9,35,45,1,5,50,76,30,50,11,26,2,6,10,41,76
2003-07-28 00:00:00.000,Sopot Sopot; Poland ATP World Tour,CLAY,2,Christophe Rochus,Federico Browne,Christophe Rochus,6-3; 6-3,R32,0,0,1,40,62,27,40,11,22,3,5,9,38,62,2,1,25,56,13,25,13,31,4,9,9,26,56
2003-07-28 00:00:00.000,Sopot Sopot; Poland ATP World Tour,CLAY,2,Marc-Kevin Goellner,Michel Kratochvil,Marc-Kevin Goellner,6-4; 4-6; 6-3,R32,136,16,6,59,116,49,59,22,57,11,14,15,71,116,3,2,54,90,33,54,21,36,6,10,14,54,90
2003-07-28 00:00:00.000,Sopot Sopot; Poland ATP World Tour,CLAY,2,Olivier Mutis,Adrian Voinea,Olivier Mutis,6-2; 6-4,R32,56,0,0,19,44,15,19,21,25,0,0,9,36,44,1,2,32,53,22,32,8,21,1,4,9,30,53
2003-07-28 00:00:00.000,Sopot Sopot; Poland ATP World Tour,CLAY,2,David Sanchez,Magnus Norman,David Sanchez,6-4; 6-2,R32,79,2,2,35,57,25,35,15,22,2,3,9,40,57,2,4,33,57,21,33,10,24,4,8,9,31,57
2003-07-28 00:00:00.000,Sopot Sopot; Poland ATP World Tour,CLAY,2,Andreas Vinciguerra,Giorgio Galimberti,Andreas Vinciguerra,6-3; 6-2,R32,48,4,1,29,48,26,29,12,19,0,0,9,38,48,1,2,28,46,17,28,8,18,2,5,8,25,46
2003-07-28 00:00:00.000,Sopot Sopot; Poland ATP World Tour,CLAY,2,David Ferrer,Bohdan Ulihrach,David Ferrer,7-6(2); 6-2,R32,80,1,2,54,71,38,54,9,17,1,2,10,47,71,0,2,52,68,31,52,5,16,4,7,10,36,68
2003-07-28 00:00:00.000,Sopot Sopot; Poland ATP World Tour,CLAY,2,David Nalbandian,Marc Rosset,David Nalbandian,6-2; 6-4,R32,86,2,2,27,51,25,27,12,24,0,0,9,37,51,4,8,43,68,30,43,7,25,7,10,9,37,68
2003-07-28 00:00:00.000,Sopot Sopot; Poland ATP World Tour,CLAY,2,Mariano Puerta,Filippo Volandri,Mariano Puerta,6-4; 6-0,R32,48,1,3,29,41,27,29,6,12,0,0,8,33,41,2,3,43,53,23,43,3,10,5,9,8,26,53
2003-07-28 00:00:00.000,Sopot Sopot; Poland ATP World Tour,CLAY,2,Ruben Ramirez Hidalgo,Julian Knowle,Ruben Ramirez Hidalgo,7-5; 3-6; 6-1,R32,121,9,3,51,85,34,51,20,34,3,7,14,54,85,1,1,53,93,30,53,18,40,2,8,14,48,93
2003-07-28 00:00:00.000,Sopot Sopot; Poland ATP World Tour,CLAY,2,Galo Blanco,Marcin Matkowski,Galo Blanco,6-0; 6-1,R32,44,1,0,25,33,20,25,5,8,1,1,6,25,33,0,6,12,36,3,12,7,24,1,7,7,10,36
2003-07-28 00:00:00.000,Sopot Sopot; Poland ATP World Tour,CLAY,2,Albert Portas,Carlos Moya,Albert Portas,7-6(4); 6-7(6); 7-5,R32,151,3,2,89,141,59,89,34,52,8,10,18,93,141,11,5,72,124,57,72,26,52,8,11,18,83,124
2003-07-28 00:00:00.000,Sopot Sopot; Poland ATP World Tour,CLAY,2,Juan Carlos Ferrero,Frantisek Cermak,Juan Carlos Ferrero,4-6; 7-5; 6-2,R16,116,3,3,61,88,43,61,14,27,6,9,15,57,88,4,0,49,89,30,49,22,40,7,12,15,52,89
2003-07-28 00:00:00.000,Sopot Sopot; Poland ATP World Tour,CLAY,2,Luis Horna,Dominik Hrbaty,Luis Horna,6-3; 6-1,R16,0,5,0,25,42,20,25,12,17,0,0,8,32,42,4,3,34,53,24,34,4,19,5,9,8,28,53
2003-07-28 00:00:00.000,Sopot Sopot; Poland ATP World Tour,CLAY,2,Guillermo Coria,Christophe Rochus,Guillermo Coria,6-1; 6-0,R16,55,2,0,23,35,18,23,8,12,2,2,6,26,35,1,3,21,51,8,21,11,30,2,8,7,19,51
2003-07-28 00:00:00.000,Sopot Sopot; Poland ATP World Tour,CLAY,2,Olivier Mutis,Marc-Kevin Goellner,Olivier Mutis,6-4; 6-2,R16,69,2,0,28,49,19,28,15,21,3,4,9,34,49,6,9,29,65,21,29,12,36,6,10,9,33,65
2003-07-28 00:00:00.000,Sopot Sopot; Poland ATP World Tour,CLAY,2,Andreas Vinciguerra,David Sanchez,Andreas Vinciguerra,6-3; 6-4,R16,80,2,4,45,75,29,45,14,30,8,10,10,43,75,0,0,31,47,20,31,3,16,0,4,9,23,47
2003-07-28 00:00:00.000,Sopot Sopot; Poland ATP World Tour,CLAY,2,David Ferrer,David Nalbandian,David Ferrer,6-4; 4-6; 6-3,R16,127,2,0,56,89,36,56,15,33,3,8,15,51,89,2,4,50,87,33,50,14,37,5,11,14,47,87
2003-07-28 00:00:00.000,Sopot Sopot; Poland ATP World Tour,CLAY,2,Ruben Ramirez Hidalgo,Mariano Puerta,Ruben Ramirez Hidalgo,6-3; 6-3,R16,63,11,0,26,52,22,26,16,26,0,0,9,38,52,1,2,35,56,23,35,10,21,0,3,9,33,56
2003-07-28 00:00:00.000,Sopot Sopot; Poland ATP World Tour,CLAY,2,Galo Blanco,Albert Portas,Galo Blanco,3-6; 6-1; 6-4,R16,131,3,3,50,87,34,50,18,37,3,6,13,52,87,2,8,61,109,38,61,18,48,6,11,13,56,109
2003-07-28 00:00:00.000,Sopot Sopot; Poland ATP World Tour,CLAY,2,Luis Horna,Juan Carlos Ferrero,Luis Horna,6-1; 7-6(1),Q,88,7,5,30,71,24,30,24,41,0,0,10,48,71,3,2,50,68,30,50,9,18,4,6,9,39,68
2003-07-28 00:00:00.000,Sopot Sopot; Poland ATP World Tour,CLAY,2,Guillermo Coria,Olivier Mutis,Guillermo Coria,6-3; 6-4,Q,78,6,5,39,69,27,39,17,30,3,4,10,44,69,0,3,34,67,23,34,14,33,7,10,9,37,67
2003-07-28 00:00:00.000,Sopot Sopot; Poland ATP World Tour,CLAY,2,David Ferrer,Andreas Vinciguerra,David Ferrer,6-1; 6-2,Q,71,1,4,42,66,30,42,12,24,6,6,8,42,66,3,2,29,47,16,29,7,18,3,7,7,23,47
2003-07-28 00:00:00.000,Sopot Sopot; Poland ATP World Tour,CLAY,2,Ruben Ramirez Hidalgo,Galo Blanco,Ruben Ramirez Hidalgo,6-7(7); 6-4; 6-0,Q,120,5,4,53,80,40,53,19,27,1,2,14,59,80,2,1,51,83,36,51,13,32,0,5,14,49,83
2003-07-28 00:00:00.000,Sopot Sopot; Poland ATP World Tour,CLAY,2,Guillermo Coria,Luis Horna,Guillermo Coria,6-2; 6-2,S,57,2,1,29,39,23,29,7,10,0,1,8,30,39,2,4,28,46,15,28,6,18,3,8,8,21,46
2003-07-28 00:00:00.000,Sopot Sopot; Poland ATP World Tour,CLAY,2,David Ferrer,Ruben Ramirez Hidalgo,David Ferrer,6-7(2); 6-3; 6-4,S,118,0,6,58,99,39,58,20,41,4,9,16,59,99,2,6,50,89,36,50,12,39,5,12,15,48,89
2003-07-28 00:00:00.000,Sopot Sopot; Poland ATP World Tour,CLAY,2,Guillermo Coria,David Ferrer,Guillermo Coria,7-5; 6-1,F,75,3,0,28,44,21,28,10,16,1,3,9,31,44,0,0,34,60,17,34,8,26,5,11,10,25,60
2003-07-28 00:00:00.000,Washington DC; U.S.A. ATP World Tour,HARD,2,Andre Agassi,N/A Bye,Andre Agassi,,R64,0,0,0,0,0,0,0,0,0,0,0,0,0,0,0,0,0,0,0,0,0,0,0,0,0,0,0
2003-07-28 00:00:00.000,Washington DC; U.S.A. ATP World Tour,HARD,2,Ivo Heuberger,Thomas Blake,Ivo Heuberger,6-3; 6-3,R64,57,5,2,25,49,22,25,13,24,0,1,9,35,49,3,4,40,54,25,40,5,14,1,5,9,30,54
2003-07-28 00:00:00.000,Washington DC; U.S.A. ATP World Tour,HARD,2,Jiri Vanek,Hermes Gamonal,Jiri Vanek,7-6(5); 6-3,R64,80,8,4,40,71,31,40,17,31,2,3,10,48,71,1,4,49,69,30,49,11,20,2,5,11,41,69
2003-07-28 00:00:00.000,Washington DC; U.S.A. ATP World Tour,HARD,2,Sargis Sargsian,N/A Bye,Sargis Sargsian,,R64,0,0,0,0,0,0,0,0,0,0,0,0,0,0,0,0,0,0,0,0,0,0,0,0,0,0,0
2003-07-28 00:00:00.000,Washington DC; U.S.A. ATP World Tour,HARD,2,Arnaud Clement,N/A Bye,Arnaud Clement,,R64,0,0,0,0,0,0,0,0,0,0,0,0,0,0,0,0,0,0,0,0,0,0,0,0,0,0,0
2003-07-28 00:00:00.000,Washington DC; U.S.A. ATP World Tour,HARD,2,Lars Burgsmuller,Robert Kendrick,Lars Burgsmuller,6-3; 6-2,R64,59,6,2,28,42,26,28,8,14,1,1,8,34,42,3,5,26,54,15,26,11,28,3,7,9,26,54
2003-07-28 00:00:00.000,Washington DC; U.S.A. ATP World Tour,HARD,2,Gregory Carraz,Harel Levy,Gregory Carraz,7-6(2); 6-4,R64,74,12,3,51,70,42,51,10,19,1,1,11,52,70,4,0,28,56,23,28,19,28,0,1,11,42,56
2003-07-28 00:00:00.000,Washington DC; U.S.A. ATP World Tour,HARD,2,James Blake,N/A Bye,James Blake,,R64,0,0,0,0,0,0,0,0,0,0,0,0,0,0,0,0,0,0,0,0,0,0,0,0,0,0,0
2003-07-28 00:00:00.000,Washington DC; U.S.A. ATP World Tour,HARD,2,Fernando Gonzalez,N/A Bye,Fernando Gonzalez,,R64,0,0,0,0,0,0,0,0,0,0,0,0,0,0,0,0,0,0,0,0,0,0,0,0,0,0,0
2003-07-28 00:00:00.000,Washington DC; U.S.A. ATP World Tour,HARD,2,Julien Benneteau,Ramon Delgado,Julien Benneteau,2-6; 7-6(4); 6-3,R64,115,5,3,60,91,38,60,19,31,3,6,15,57,91,4,1,70,97,49,70,13,27,12,14,14,62,97
2003-07-28 00:00:00.000,Washington DC; U.S.A. ATP World Tour,HARD,2,Jeff Morrison,Gilles Elseneer,Jeff Morrison,6-3; 7-6(8),R64,85,8,1,42,70,30,42,16,28,2,5,11,46,70,4,3,41,82,27,41,18,41,8,12,10,45,82
2003-07-28 00:00:00.000,Washington DC; U.S.A. ATP World Tour,HARD,2,Mario Ancic,N/A Bye,Mario Ancic,,R64,0,0,0,0,0,0,0,0,0,0,0,0,0,0,0,0,0,0,0,0,0,0,0,0,0,0,0
2003-07-28 00:00:00.000,Washington DC; U.S.A. ATP World Tour,HARD,2,Noam Okun,N/A Bye,Noam Okun,,R64,0,0,0,0,0,0,0,0,0,0,0,0,0,0,0,0,0,0,0,0,0,0,0,0,0,0,0
2003-07-28 00:00:00.000,Washington DC; U.S.A. ATP World Tour,HARD,2,Mike Bryan,Andrew Carlson,Mike Bryan,6-1; 6-3,R64,51,4,2,30,46,24,30,7,16,2,3,8,31,46,8,5,30,50,17,30,6,20,3,8,8,23,50
2003-07-28 00:00:00.000,Washington DC; U.S.A. ATP World Tour,HARD,2,Alex Kim,Miles MacLagan,Alex Kim,6-4; 3-6; 7-6(3),R64,123,5,5,62,92,44,62,17,30,4,7,15,61,92,8,2,84,110,57,84,11,26,6,9,16,68,110
2003-07-28 00:00:00.000,Washington DC; U.S.A. ATP World Tour,HARD,2,Max Mirnyi,N/A Bye,Max Mirnyi,,R64,0,0,0,0,0,0,0,0,0,0,0,0,0,0,0,0,0,0,0,0,0,0,0,0,0,0,0
2003-07-28 00:00:00.000,Washington DC; U.S.A. ATP World Tour,HARD,2,Nikolay Davydenko,N/A Bye,Nikolay Davydenko,,R64,0,0,0,0,0,0,0,0,0,0,0,0,0,0,0,0,0,0,0,0,0,0,0,0,0,0,0
2003-07-28 00:00:00.000,Washington DC; U.S.A. ATP World Tour,HARD,2,Simon Larose,Florent Serra,Simon Larose,2-6; 7-6(4); 6-2,R64,131,6,2,58,90,42,58,17,32,1,4,14,59,90,4,2,92,124,56,92,18,32,15,18,14,74,124
2003-07-28 00:00:00.000,Washington DC; U.S.A. ATP World Tour,HARD,2,Paul Goldstein,Brian Baker,Paul Goldstein,6-2; 6-2,R64,51,9,2,31,47,25,31,10,16,0,0,8,35,47,2,0,31,42,19,31,2,11,1,5,8,21,42
2003-07-28 00:00:00.000,Washington DC; U.S.A. ATP World Tour,HARD,2,Tim Henman,N/A Bye,Tim Henman,,R64,0,0,0,0,0,0,0,0,0,0,0,0,0,0,0,0,0,0,0,0,0,0,0,0,0,0,0
2003-07-28 00:00:00.000,Washington DC; U.S.A. ATP World Tour,HARD,2,Brian Vahaly,N/A Bye,Brian Vahaly,,R64,0,0,0,0,0,0,0,0,0,0,0,0,0,0,0,0,0,0,0,0,0,0,0,0,0,0,0
2003-07-28 00:00:00.000,Washington DC; U.S.A. ATP World Tour,HARD,2,Sergio Roitman,Peter Luczak,Sergio Roitman,6-3; 7-5,R64,89,3,1,42,74,30,42,19,32,4,5,10,49,74,2,2,51,77,33,51,9,26,7,11,11,42,77
2003-07-28 00:00:00.000,Washington DC; U.S.A. ATP World Tour,HARD,2,Cyril Saulnier,Wesley Moodie,Cyril Saulnier,7-6(1); 4-6; 7-5,R64,106,11,2,54,91,46,54,25,37,1,2,17,71,91,15,3,67,89,55,67,14,22,1,2,17,69,89
2003-07-28 00:00:00.000,Washington DC; U.S.A. ATP World Tour,HARD,2,Paradorn Srichaphan,N/A Bye,Paradorn Srichaphan,,R64,0,0,0,0,0,0,0,0,0,0,0,0,0,0,0,0,0,0,0,0,0,0,0,0,0,0,0
2003-07-28 00:00:00.000,Washington DC; U.S.A. ATP World Tour,HARD,2,Yevgeny Kafelnikov,N/A Bye,Yevgeny Kafelnikov,,R64,0,0,0,0,0,0,0,0,0,0,0,0,0,0,0,0,0,0,0,0,0,0,0,0,0,0,0
2003-07-28 00:00:00.000,Washington DC; U.S.A. ATP World Tour,HARD,2,Thomas Enqvist,Jaymon Crabb,Thomas Enqvist,6-4; 6-3,R64,56,11,1,26,39,25,26,11,13,0,0,9,36,39,4,3,46,69,34,46,5,23,4,7,10,39,69
2003-07-28 00:00:00.000,Washington DC; U.S.A. ATP World Tour,HARD,2,Scott Draper,Todd Martin,Scott Draper,6-3; 6-4,R64,69,11,2,40,67,31,40,14,27,2,2,10,45,67,7,3,28,50,23,28,10,22,2,4,9,33,50
2003-07-28 00:00:00.000,Washington DC; U.S.A. ATP World Tour,HARD,2,Mardy Fish,N/A Bye,Mardy Fish,,R64,0,0,0,0,0,0,0,0,0,0,0,0,0,0,0,0,0,0,0,0,0,0,0,0,0,0,0
2003-07-28 00:00:00.000,Washington DC; U.S.A. ATP World Tour,HARD,2,Greg Rusedski,N/A Bye,Greg Rusedski,,R64,0,0,0,0,0,0,0,0,0,0,0,0,0,0,0,0,0,0,0,0,0,0,0,0,0,0,0
2003-07-28 00:00:00.000,Washington DC; U.S.A. ATP World Tour,HARD,2,Ivan Miranda,Karol Beck,Ivan Miranda,3-6; 6-3; 7-6(3),R64,114,3,1,71,97,54,71,15,26,8,9,15,69,97,15,3,62,96,53,62,12,34,1,2,15,65,96
2003-07-28 00:00:00.000,Washington DC; U.S.A. ATP World Tour,HARD,2,Bob Bryan,Amer Delic,Bob Bryan,7-6(4); 6-4,R64,61,5,0,35,54,33,35,15,19,0,0,11,48,54,14,4,37,63,31,37,13,26,0,1,11,44,63
2003-07-28 00:00:00.000,Washington DC; U.S.A. ATP World Tour,HARD,2,Andy Roddick,N/A Bye,Andy Roddick,,R64,0,0,0,0,0,0,0,0,0,0,0,0,0,0,0,0,0,0,0,0,0,0,0,0,0,0,0
2003-07-28 00:00:00.000,Washington DC; U.S.A. ATP World Tour,HARD,2,Andre Agassi,Ivo Heuberger,Andre Agassi,6-3; 6-1,R32,60,8,3,32,52,29,32,8,20,1,1,8,37,52,13,0,21,45,17,21,8,24,1,5,8,25,45
2003-07-28 00:00:00.000,Washington DC; U.S.A. ATP World Tour,HARD,2,Sargis Sargsian,Jiri Vanek,Sargis Sargsian,6-3; 6-4,R32,61,4,2,42,56,33,42,7,14,0,1,10,40,56,6,2,33,54,22,33,10,21,3,6,9,32,54
2003-07-28 00:00:00.000,Washington DC; U.S.A. ATP World Tour,HARD,2,Lars Burgsmuller,Arnaud Clement,Lars Burgsmuller,3-6; 7-5; 6-1,R32,128,5,4,49,95,35,49,26,46,8,10,14,61,95,3,0,55,94,34,55,22,39,2,6,14,56,94
2003-07-28 00:00:00.000,Washington DC; U.S.A. ATP World Tour,HARD,2,James Blake,Gregory Carraz,James Blake,7-6(6); 6-4,R32,76,9,3,48,73,40,48,15,25,4,4,11,55,73,6,5,47,70,37,47,12,23,1,2,11,49,70
2003-07-28 00:00:00.000,Washington DC; U.S.A. ATP World Tour,HARD,2,Fernando Gonzalez,Julien Benneteau,Fernando Gonzalez,6-2; 6-4,R32,59,9,1,21,49,18,21,19,28,1,1,9,37,49,3,1,41,54,29,41,4,13,0,3,9,33,54
2003-07-28 00:00:00.000,Washington DC; U.S.A. ATP World Tour,HARD,2,Mario Ancic,Jeff Morrison,Mario Ancic,6-2; 6-7(3); 6-2,R32,115,4,7,63,103,41,63,23,40,5,6,14,64,103,3,3,64,91,39,64,14,27,4,9,14,53,91
2003-07-28 00:00:00.000,Washington DC; U.S.A. ATP World Tour,HARD,2,Mike Bryan,Noam Okun,Mike Bryan,6-1; 6-7(9); 7-6(4),R32,126,3,2,67,97,52,67,16,30,1,3,16,68,97,11,6,66,104,47,66,18,38,4,8,15,65,104
2003-07-28 00:00:00.000,Washington DC; U.S.A. ATP World Tour,HARD,2,Max Mirnyi,Alex Kim,Max Mirnyi,4-6; 6-3; 6-4,R32,117,14,3,67,100,50,67,19,33,7,8,15,69,100,4,1,65,95,43,65,18,30,8,10,14,61,95
2003-07-28 00:00:00.000,Washington DC; U.S.A. ATP World Tour,HARD,2,Nikolay Davydenko,Simon Larose,Nikolay Davydenko,6-4; 6-3,R32,68,3,2,27,47,25,27,10,20,2,3,9,35,47,4,2,41,62,25,41,7,21,2,6,10,32,62
2003-07-28 00:00:00.000,Washington DC; U.S.A. ATP World Tour,HARD,2,Tim Henman,Paul Goldstein,Tim Henman,5-7; 6-4; 6-3,R32,132,8,4,50,87,35,50,21,37,3,6,15,56,87,4,5,72,119,43,72,24,47,13,18,16,67,119
2003-07-28 00:00:00.000,Washington DC; U.S.A. ATP World Tour,HARD,2,Brian Vahaly,Sergio Roitman,Brian Vahaly,6-4; 3-6; 6-0,R32,102,7,1,56,75,41,56,10,19,2,3,12,51,75,3,3,53,94,38,53,16,41,7,11,13,54,94
2003-07-28 00:00:00.000,Washington DC; U.S.A. ATP World Tour,HARD,2,Paradorn Srichaphan,Cyril Saulnier,Paradorn Srichaphan,6-4; 6-7(6); 6-1,R32,118,15,4,57,97,47,57,21,40,5,6,15,68,97,10,3,53,95,37,53,22,42,5,9,14,59,95
2003-07-28 00:00:00.000,Washington DC; U.S.A. ATP World Tour,HARD,2,Yevgeny Kafelnikov,Thomas Enqvist,Yevgeny Kafelnikov,6-3; 2-6; 6-3,R32,107,8,2,47,77,33,47,13,30,5,9,13,46,77,14,11,53,97,38,53,14,44,9,14,13,52,97
2003-07-28 00:00:00.000,Washington DC; U.S.A. ATP World Tour,HARD,2,Mardy Fish,Scott Draper,Mardy Fish,6-2; 7-5,R32,69,15,3,37,57,31,37,12,20,3,3,10,43,57,4,1,36,58,23,36,13,22,2,5,10,36,58
2003-07-28 00:00:00.000,Washington DC; U.S.A. ATP World Tour,HARD,2,Greg Rusedski,Ivan Miranda,Greg Rusedski,6-2; 6-4,R32,66,11,1,35,50,27,35,11,15,0,0,9,38,50,2,0,36,61,24,36,10,25,2,5,9,34,61
2003-07-28 00:00:00.000,Washington DC; U.S.A. ATP World Tour,HARD,2,Andy Roddick,Bob Bryan,Andy Roddick,7-6(5); 6-4,R32,74,12,2,36,61,33,36,16,25,0,0,11,49,61,12,1,45,61,36,45,8,16,0,1,11,44,61
2003-07-28 00:00:00.000,Washington DC; U.S.A. ATP World Tour,HARD,2,Andre Agassi,Sargis Sargsian,Andre Agassi,6-3; 6-2,R16,58,2,1,26,48,22,26,14,22,0,0,9,36,48,3,1,31,47,18,31,7,16,1,4,8,25,47
2003-07-28 00:00:00.000,Washington DC; U.S.A. ATP World Tour,HARD,2,James Blake,Lars Burgsmuller,James Blake,3-6; 7-5; 6-4,R16,121,12,3,54,89,37,54,19,35,5,10,16,56,89,3,7,56,101,37,56,21,45,7,12,15,58,101
2003-07-28 00:00:00.000,Washington DC; U.S.A. ATP World Tour,HARD,2,Fernando Gonzalez,Mario Ancic,Fernando Gonzalez,7-5; 7-6(5),R16,97,4,8,47,79,38,47,15,32,6,9,12,53,79,10,3,55,90,35,55,18,35,9,13,12,53,90
2003-07-28 00:00:00.000,Washington DC; U.S.A. ATP World Tour,HARD,2,Max Mirnyi,Mike Bryan,Max Mirnyi,6-1; 6-3,R16,58,10,1,24,41,22,24,11,17,0,0,8,33,41,1,1,40,63,25,40,8,23,3,7,8,33,63
2003-07-28 00:00:00.000,Washington DC; U.S.A. ATP World Tour,HARD,2,Tim Henman,Nikolay Davydenko,Tim Henman,6-3; 6-4,R16,93,0,2,35,65,29,35,13,30,2,3,10,42,65,3,1,46,65,27,46,10,19,5,8,9,37,65
2003-07-28 00:00:00.000,Washington DC; U.S.A. ATP World Tour,HARD,2,Paradorn Srichaphan,Brian Vahaly,Paradorn Srichaphan,7-6(3); 6-4,R16,84,12,2,40,69,33,40,15,29,2,3,11,48,69,4,0,44,62,32,44,9,18,1,3,11,41,62
2003-07-28 00:00:00.000,Washington DC; U.S.A. ATP World Tour,HARD,2,Mardy Fish,Yevgeny Kafelnikov,Mardy Fish,6-4; 3-6; 6-3,R16,106,18,2,36,80,27,36,29,44,5,7,14,56,80,5,5,49,95,37,49,21,46,6,9,14,58,95
2003-07-28 00:00:00.000,Washington DC; U.S.A. ATP World Tour,HARD,2,Andy Roddick,Greg Rusedski,Andy Roddick,6-3; 7-6(4),R16,72,12,1,46,66,38,46,14,20,3,3,11,52,66,9,0,38,57,30,38,14,19,2,3,10,44,57
2003-07-28 00:00:00.000,Washington DC; U.S.A. ATP World Tour,HARD,2,Andre Agassi,James Blake,Andre Agassi,3-6; 7-5; 6-3,Q,109,12,2,48,89,38,48,20,41,5,7,15,58,89,9,4,55,95,41,55,19,40,5,8,15,60,95
2003-07-28 00:00:00.000,Washington DC; U.S.A. ATP World Tour,HARD,2,Fernando Gonzalez,Max Mirnyi,Fernando Gonzalez,7-6(3); 6-2,Q,67,2,4,45,61,37,45,10,16,1,1,10,47,61,6,3,41,58,31,41,7,17,1,3,10,38,58
2003-07-28 00:00:00.000,Washington DC; U.S.A. ATP World Tour,HARD,2,Tim Henman,Paradorn Srichaphan,Tim Henman,7-6(5); 7-5,Q,97,7,4,33,68,28,33,24,35,1,2,12,52,68,9,3,52,83,40,52,13,31,4,6,12,53,83
2003-07-28 00:00:00.000,Washington DC; U.S.A. ATP World Tour,HARD,2,Andy Roddick,Mardy Fish,Andy Roddick,6-1; 6-4,Q,50,13,0,32,44,27,32,9,12,0,0,9,36,44,8,4,29,49,17,29,9,20,3,6,8,26,49
2003-07-28 00:00:00.000,Washington DC; U.S.A. ATP World Tour,HARD,2,Fernando Gonzalez,Andre Agassi,Fernando Gonzalez,3-6; 6-4; 7-6(5),S,120,10,8,61,108,39,61,27,47,4,7,15,66,108,15,2,58,90,47,58,14,32,0,3,16,61,90
2003-07-28 00:00:00.000,Washington DC; U.S.A. ATP World Tour,HARD,2,Tim Henman,Andy Roddick,Tim Henman,1-6; 6-3; 7-6(1),S,109,8,2,48,84,39,48,19,36,5,7,14,58,84,11,2,41,75,33,41,22,34,1,2,14,55,75
2003-07-28 00:00:00.000,Washington DC; U.S.A. ATP World Tour,HARD,2,Tim Henman,Fernando Gonzalez,Tim Henman,6-3; 6-4,F,97,5,3,34,63,23,34,18,29,1,2,10,41,63,3,3,49,84,25,49,21,35,8,11,9,46,84
2003-08-04 00:00:00.000,ATP Masters Series Canada Montreal; Canada ATP World Tour,HARD,2,Andre Agassi,Frederic Niemeyer,Andre Agassi,6-4; 6-2,R64,68,4,3,26,51,22,26,14,25,1,2,9,36,51,8,11,24,57,18,24,13,33,7,11,9,31,57
2003-08-04 00:00:00.000,ATP Masters Series Canada Montreal; Canada ATP World Tour,HARD,2,Nikolay Davydenko,Frank Dancevic,Nikolay Davydenko,7-6(3); 4-6; 6-3,R64,147,5,4,61,107,42,61,26,46,9,13,16,68,107,8,5,52,106,38,52,24,54,9,13,15,62,106
2003-08-04 00:00:00.000,ATP Masters Series Canada Montreal; Canada ATP World Tour,HARD,2,Jose Acasuso,Fabrice Santoro,Jose Acasuso,2-6; 6-3; 6-4,R64,110,5,5,45,100,31,45,24,55,11,15,14,55,100,5,2,40,63,30,40,12,23,1,5,13,42,63
2003-08-04 00:00:00.000,ATP Masters Series Canada Montreal; Canada ATP World Tour,HARD,2,Simon Larose,Gustavo Kuerten,Simon Larose,7-5; 7-6(2),R64,88,7,2,43,69,34,43,18,26,1,2,12,52,69,5,1,52,78,34,52,13,26,4,6,12,47,78
2003-08-04 00:00:00.000,ATP Masters Series Canada Montreal; Canada ATP World Tour,HARD,2,Jiri Novak,Mario Ancic,Jiri Novak,7-5; 3-6; 6-3,R64,113,4,3,71,106,49,71,16,35,9,12,15,65,106,6,5,51,86,34,51,15,35,4,8,15,49,86
2003-08-04 00:00:00.000,ATP Masters Series Canada Montreal; Canada ATP World Tour,HARD,2,James Blake,Radek Stepanek,James Blake,7-6(3); 6-4,R64,89,3,6,41,77,32,41,18,36,7,8,11,50,77,4,4,46,70,31,46,12,24,2,4,11,43,70
2003-08-04 00:00:00.000,ATP Masters Series Canada Montreal; Canada ATP World Tour,HARD,2,Yevgeny Kafelnikov,Gregory Carraz,Yevgeny Kafelnikov,1-6; 6-2; 6-4,R64,82,1,2,45,65,34,45,9,20,1,4,13,43,65,11,8,43,76,33,43,13,33,3,6,12,46,76
2003-08-04 00:00:00.000,ATP Masters Series Canada Montreal; Canada ATP World Tour,HARD,2,Rainer Schuettler,Mikhail Youzhny,Rainer Schuettler,6-2; 6-4,R64,97,1,1,38,62,27,38,11,24,4,6,9,38,62,1,3,30,64,16,30,14,34,4,9,9,30,64
2003-08-04 00:00:00.000,ATP Masters Series Canada Montreal; Canada ATP World Tour,HARD,2,Arnaud Clement,Carlos Moya,Arnaud Clement,7-6(4); 4-6; 6-3,R64,156,5,4,43,102,30,43,31,59,9,14,15,61,102,8,7,57,114,40,57,22,57,4,10,16,62,114
2003-08-04 00:00:00.000,ATP Masters Series Canada Montreal; Canada ATP World Tour,HARD,2,Vincent Spadea,Raemon Sluiter,Vincent Spadea,6-3; 6-4,R64,63,8,4,34,52,30,34,11,18,0,0,10,41,52,4,3,31,57,23,31,12,26,2,4,9,35,57
2003-08-04 00:00:00.000,ATP Masters Series Canada Montreal; Canada ATP World Tour,HARD,2,David Nalbandian,Jarkko Nieminen,David Nalbandian,7-6(5); 7-6(5),R64,131,6,4,44,77,35,44,14,33,4,7,12,49,77,5,5,49,93,31,49,21,44,8,11,12,52,93
2003-08-04 00:00:00.000,ATP Masters Series Canada Montreal; Canada ATP World Tour,HARD,2,Tim Henman,Fernando Gonzalez,Tim Henman,6-2 RET,R64,36,0,0,16,22,12,16,4,6,0,0,4,16,22,0,2,24,28,12,24,2,4,4,6,4,14,28
2003-08-04 00:00:00.000,ATP Masters Series Canada Montreal; Canada ATP World Tour,HARD,2,Mariano Zabaleta,Sjeng Schalken,Mariano Zabaleta,6-1; 6-1,R64,54,1,2,23,39,17,23,12,16,2,2,7,29,39,2,0,40,51,18,40,4,11,5,10,7,22,51
2003-08-04 00:00:00.000,ATP Masters Series Canada Montreal; Canada ATP World Tour,HARD,2,Karol Beck,Michael Llodra,Karol Beck,6-7(6); 7-6(3); 6-1,R64,143,12,4,62,114,52,62,30,52,5,5,16,82,114,11,2,70,113,47,70,24,43,8,10,15,71,113
2003-08-04 00:00:00.000,ATP Masters Series Canada Montreal; Canada ATP World Tour,HARD,2,Paul-Henri Mathieu,Scott Draper,Paul-Henri Mathieu,7-6(5); 6-4,R64,95,4,1,35,70,25,35,22,35,2,4,11,47,70,10,1,36,68,31,36,12,32,3,6,11,43,68
2003-08-04 00:00:00.000,ATP Masters Series Canada Montreal; Canada ATP World Tour,HARD,2,Feliciano Lopez,Guillermo Coria,Feliciano Lopez,6-3 RET,R64,37,3,0,17,26,13,17,5,9,1,1,4,18,26,4,0,19,32,12,19,6,13,2,4,5,18,32
2003-08-04 00:00:00.000,ATP Masters Series Canada Montreal; Canada ATP World Tour,HARD,2,Lleyton Hewitt,Bob Bryan,Lleyton Hewitt,6-2; 6-2,R64,51,5,2,21,38,20,21,12,17,0,0,8,32,38,4,0,29,47,20,29,3,18,0,4,8,23,47
2003-08-04 00:00:00.000,ATP Masters Series Canada Montreal; Canada ATP World Tour,HARD,2,Max Mirnyi,Nicolas Massu,Max Mirnyi,6-4; 7-6(4),R64,104,11,2,45,65,34,45,11,20,1,2,11,45,65,3,2,52,70,34,52,8,18,0,2,11,42,70
2003-08-04 00:00:00.000,ATP Masters Series Canada Montreal; Canada ATP World Tour,HARD,2,Daniel Nestor,Robby Ginepri,Daniel Nestor,3-6; 6-3; 6-4,R64,119,19,10,57,107,43,57,27,50,11,12,14,70,107,15,5,41,80,32,41,21,39,3,5,14,53,80
2003-08-04 00:00:00.000,ATP Masters Series Canada Montreal; Canada ATP World Tour,HARD,2,Paradorn Srichaphan,Alberto Martin,Paradorn Srichaphan,6-0; 7-6(5),R64,84,4,2,30,53,23,30,17,23,2,3,9,40,53,2,3,40,66,27,40,10,26,3,7,9,37,66
2003-08-04 00:00:00.000,ATP Masters Series Canada Montreal; Canada ATP World Tour,HARD,2,Tommy Robredo,Hyung-Taik Lee,Tommy Robredo,6-4; 7-6(0),R64,106,4,5,55,86,36,55,13,31,6,10,11,49,86,0,1,41,65,20,41,12,24,3,8,11,32,65
2003-08-04 00:00:00.000,ATP Masters Series Canada Montreal; Canada ATP World Tour,HARD,2,Wayne Black,Wayne Ferreira,Wayne Black,6-4; 2-1 RET,R64,50,2,0,14,29,11,14,12,15,0,1,6,23,29,6,2,29,48,19,29,8,19,4,7,7,27,48
2003-08-04 00:00:00.000,ATP Masters Series Canada Montreal; Canada ATP World Tour,HARD,2,Greg Rusedski,Nicolas Lapentti,Greg Rusedski,7-5; 6-3,R64,72,17,4,37,60,31,37,14,23,2,2,11,45,60,1,0,36,55,25,36,11,19,2,4,10,36,55
2003-08-04 00:00:00.000,ATP Masters Series Canada Montreal; Canada ATP World Tour,HARD,2,Roger Federer,Gaston Gaudio,Roger Federer,6-4; 3-6; 7-5,R64,125,11,5,51,92,38,51,22,41,7,10,15,60,92,0,1,58,93,36,58,20,35,3,7,16,56,93
2003-08-04 00:00:00.000,ATP Masters Series Canada Montreal; Canada ATP World Tour,HARD,2,Andy Roddick,Xavier Malisse,Andy Roddick,3-6; 6-0; 6-2,R64,90,5,2,33,66,27,33,19,33,2,4,12,46,66,5,3,26,71,18,26,21,45,3,8,11,39,71
2003-08-04 00:00:00.000,ATP Masters Series Canada Montreal; Canada ATP World Tour,HARD,2,Juan Ignacio Chela,Agustin Calleri,Juan Ignacio Chela,5-7; 6-4; 6-3,R64,147,4,8,60,102,45,60,19,42,3,6,16,64,102,11,11,67,120,52,67,18,53,12,16,15,70,120
2003-08-04 00:00:00.000,ATP Masters Series Canada Montreal; Canada ATP World Tour,HARD,2,Ramon Delgado,Ivan Ljubicic,Ramon Delgado,7-6(0); 7-6(3),R64,108,2,2,54,81,42,54,19,27,5,5,12,61,81,16,5,40,78,32,40,21,38,2,2,12,53,78
2003-08-04 00:00:00.000,ATP Masters Series Canada Montreal; Canada ATP World Tour,HARD,2,Sebastien Grosjean,Fernando Vicente,Sebastien Grosjean,6-3; 6-3,R64,68,8,3,26,48,23,26,14,22,2,2,9,37,48,1,2,25,50,17,25,11,25,2,5,9,28,50
2003-08-04 00:00:00.000,ATP Masters Series Canada Montreal; Canada ATP World Tour,HARD,2,Martin Verkerk,Sargis Sargsian,Martin Verkerk,6-2; 4-6; 7-5,R64,125,22,5,53,90,42,53,17,37,8,10,15,59,90,2,2,65,95,44,65,13,30,1,5,15,57,95
2003-08-04 00:00:00.000,ATP Masters Series Canada Montreal; Canada ATP World Tour,HARD,2,Karol Kucera,Jan-Michael Gambill,Karol Kucera,7-6(3); 7-6(3),R64,126,10,4,45,80,35,45,22,35,4,5,12,57,80,7,6,60,97,46,60,16,37,7,8,12,62,97
2003-08-04 00:00:00.000,ATP Masters Series Canada Montreal; Canada ATP World Tour,HARD,2,Younes El Aynaoui,Mardy Fish,Younes El Aynaoui,6-3; 6-7(8); 6-3,R64,145,10,6,60,110,45,60,28,50,4,5,16,73,110,11,2,47,100,34,47,28,53,5,8,14,62,100
2003-08-04 00:00:00.000,ATP Masters Series Canada Montreal; Canada ATP World Tour,HARD,2,Juan Carlos Ferrero,Cyril Saulnier,Juan Carlos Ferrero,6-4; 6-4,R64,87,11,2,31,51,26,31,15,20,0,0,10,41,51,2,4,31,70,23,31,20,39,4,6,10,43,70
2003-08-04 00:00:00.000,ATP Masters Series Canada Montreal; Canada ATP World Tour,HARD,2,Andre Agassi,Nikolay Davydenko,Andre Agassi,7-6(3); 6-2,R32,86,6,0,30,59,26,30,17,29,2,3,10,43,59,6,2,39,70,25,39,15,31,7,10,10,40,70
2003-08-04 00:00:00.000,ATP Masters Series Canada Montreal; Canada ATP World Tour,HARD,2,Simon Larose,Jose Acasuso,Simon Larose,7-6(5); 1-6; 7-5,R32,137,17,7,56,102,40,56,25,46,2,5,15,65,102,17,8,60,112,48,60,24,52,5,7,16,72,112
2003-08-04 00:00:00.000,ATP Masters Series Canada Montreal; Canada ATP World Tour,HARD,2,Jiri Novak,James Blake,Jiri Novak,7-6(5); 6-3,R32,133,2,1,53,78,40,53,13,25,4,5,11,53,78,4,3,45,80,31,45,18,35,4,6,10,49,80
2003-08-04 00:00:00.000,ATP Masters Series Canada Montreal; Canada ATP World Tour,HARD,2,Rainer Schuettler,Yevgeny Kafelnikov,Rainer Schuettler,6-1; 6-4,R32,59,3,4,35,58,25,35,13,23,3,4,9,38,58,1,2,19,40,10,19,11,21,0,4,8,21,40
2003-08-04 00:00:00.000,ATP Masters Series Canada Montreal; Canada ATP World Tour,HARD,2,Vincent Spadea,Arnaud Clement,Vincent Spadea,6-0; 6-7(5); 7-5,R32,143,5,5,53,101,40,53,25,48,4,6,15,65,101,6,1,54,101,34,54,24,47,3,9,15,58,101
2003-08-04 00:00:00.000,ATP Masters Series Canada Montreal; Canada ATP World Tour,HARD,2,David Nalbandian,Tim Henman,David Nalbandian,6-4; 6-4,R32,88,0,4,35,55,25,35,12,20,1,3,10,37,55,3,1,31,61,22,31,12,30,4,8,10,34,61
2003-08-04 00:00:00.000,ATP Masters Series Canada Montreal; Canada ATP World Tour,HARD,2,Karol Beck,Mariano Zabaleta,Karol Beck,6-1; 6-1,R32,64,8,1,31,57,27,31,11,26,6,6,7,38,57,1,7,24,49,12,24,8,25,4,9,7,20,49
2003-08-04 00:00:00.000,ATP Masters Series Canada Montreal; Canada ATP World Tour,HARD,2,Feliciano Lopez,Paul-Henri Mathieu,Feliciano Lopez,6-4; 3-6; 7-5,R32,145,15,7,44,82,33,44,20,38,4,7,15,53,82,5,8,69,126,49,69,25,57,11,15,16,74,126
2003-08-04 00:00:00.000,ATP Masters Series Canada Montreal; Canada ATP World Tour,HARD,2,Max Mirnyi,Lleyton Hewitt,Max Mirnyi,7-5; 6-7(4); 7-5,R32,150,10,2,71,112,55,71,26,41,2,3,18,81,112,10,4,64,121,47,64,35,57,5,8,18,82,121
2003-08-04 00:00:00.000,ATP Masters Series Canada Montreal; Canada ATP World Tour,HARD,2,Paradorn Srichaphan,Daniel Nestor,Paradorn Srichaphan,7-5; 6-4,R32,77,9,3,36,67,28,36,20,31,4,4,11,48,67,8,6,33,64,26,33,16,31,3,5,11,42,64
2003-08-04 00:00:00.000,ATP Masters Series Canada Montreal; Canada ATP World Tour,HARD,2,Tommy Robredo,Wayne Black,Tommy Robredo,6-0; 6-2,R32,50,2,1,29,43,21,29,9,14,1,1,7,30,43,0,6,27,45,16,27,4,18,0,5,7,20,45
2003-08-04 00:00:00.000,ATP Masters Series Canada Montreal; Canada ATP World Tour,HARD,2,Roger Federer,Greg Rusedski,Roger Federer,6-4; 6-3,R32,65,1,1,27,52,21,27,16,25,0,1,10,37,52,1,3,33,59,22,33,11,26,1,4,9,33,59
2003-08-04 00:00:00.000,ATP Masters Series Canada Montreal; Canada ATP World Tour,HARD,2,Andy Roddick,Juan Ignacio Chela,Andy Roddick,7-6(6); 6-2,R32,90,4,2,35,61,28,35,16,26,0,1,10,44,61,2,8,43,81,31,43,15,38,5,8,10,46,81
2003-08-04 00:00:00.000,ATP Masters Series Canada Montreal; Canada ATP World Tour,HARD,2,Sebastien Grosjean,Ramon Delgado,Sebastien Grosjean,6-3; 6-2,R32,65,8,0,31,59,22,31,17,28,6,7,9,39,59,2,3,30,43,18,30,5,13,3,7,8,23,43
2003-08-04 00:00:00.000,ATP Masters Series Canada Montreal; Canada ATP World Tour,HARD,2,Karol Kucera,Martin Verkerk,Karol Kucera,7-6(8); 7-6(3),R32,126,9,4,42,75,37,42,22,33,0,1,12,59,75,18,9,70,109,52,70,17,39,8,9,12,69,109
2003-08-04 00:00:00.000,ATP Masters Series Canada Montreal; Canada ATP World Tour,HARD,2,Juan Carlos Ferrero,Younes El Aynaoui,Juan Carlos Ferrero,6-3; 6-4,R32,75,12,0,31,48,26,31,15,17,0,0,10,41,48,9,4,41,65,28,41,11,24,7,9,9,39,65
2003-08-04 00:00:00.000,ATP Masters Series Canada Montreal; Canada ATP World Tour,HARD,2,Andre Agassi,Simon Larose,Andre Agassi,6-4; 6-2,R16,62,7,2,28,48,24,28,10,20,2,3,9,34,48,5,4,29,54,18,29,9,25,5,9,9,27,54
2003-08-04 00:00:00.000,ATP Masters Series Canada Montreal; Canada ATP World Tour,HARD,2,Rainer Schuettler,Jiri Novak,Rainer Schuettler,7-5; 6-0,R16,66,6,0,28,42,23,28,11,14,0,1,9,34,42,5,2,38,65,21,38,10,27,4,9,9,31,65
2003-08-04 00:00:00.000,ATP Masters Series Canada Montreal; Canada ATP World Tour,HARD,2,David Nalbandian,Vincent Spadea,David Nalbandian,6-4; 6-2,R16,90,1,5,35,66,31,35,12,31,3,3,9,43,66,3,5,31,51,23,31,7,20,5,8,9,30,51
2003-08-04 00:00:00.000,ATP Masters Series Canada Montreal; Canada ATP World Tour,HARD,2,Feliciano Lopez,Karol Beck,Feliciano Lopez,6-4; 7-6(3),R16,100,9,2,41,76,33,41,21,35,4,4,11,54,76,5,3,49,87,36,49,19,38,4,5,11,55,87
2003-08-04 00:00:00.000,ATP Masters Series Canada Montreal; Canada ATP World Tour,HARD,2,Max Mirnyi,Paradorn Srichaphan,Max Mirnyi,6-3; 6-2,R16,61,5,0,34,49,26,34,11,15,0,0,9,37,49,3,1,23,49,13,23,15,26,4,7,8,28,49
2003-08-04 00:00:00.000,ATP Masters Series Canada Montreal; Canada ATP World Tour,HARD,2,Roger Federer,Tommy Robredo,Roger Federer,6-4; 6-3,R16,67,4,1,29,56,24,29,20,27,6,6,10,44,56,3,0,40,53,28,40,7,13,0,2,9,35,53
2003-08-04 00:00:00.000,ATP Masters Series Canada Montreal; Canada ATP World Tour,HARD,2,Andy Roddick,Sebastien Grosjean,Andy Roddick,6-3; 6-3,R16,75,10,4,34,61,28,34,13,27,7,7,9,41,61,3,2,25,60,16,25,18,35,2,5,9,34,60
2003-08-04 00:00:00.000,ATP Masters Series Canada Montreal; Canada ATP World Tour,HARD,2,Karol Kucera,Juan Carlos Ferrero,Karol Kucera,6-3; 7-5,R16,88,8,2,32,60,23,32,13,28,2,6,11,36,60,0,2,38,60,19,38,10,22,3,9,10,29,60
2003-08-04 00:00:00.000,ATP Masters Series Canada Montreal; Canada ATP World Tour,HARD,2,Rainer Schuettler,Andre Agassi,Rainer Schuettler,2-6; 6-2; 6-3,Q,111,5,5,43,79,29,43,20,36,5,9,13,49,79,2,0,48,86,27,48,18,38,5,10,12,45,86
2003-08-04 00:00:00.000,ATP Masters Series Canada Montreal; Canada ATP World Tour,HARD,2,David Nalbandian,Feliciano Lopez,David Nalbandian,6-4; 6-4,Q,80,4,3,33,55,27,33,15,22,3,3,10,42,55,11,6,39,67,31,39,10,28,3,5,10,41,67
2003-08-04 00:00:00.000,ATP Masters Series Canada Montreal; Canada ATP World Tour,HARD,2,Roger Federer,Max Mirnyi,Roger Federer,6-2; 7-6(3),Q,76,8,0,37,57,31,37,12,20,0,0,10,43,57,3,4,40,62,29,40,8,22,4,6,10,37,62
2003-08-04 00:00:00.000,ATP Masters Series Canada Montreal; Canada ATP World Tour,HARD,2,Andy Roddick,Karol Kucera,Andy Roddick,7-6(5); 6-3,Q,94,7,1,42,61,30,42,13,19,0,1,10,43,61,5,10,35,73,26,35,17,38,4,7,11,43,73
2003-08-04 00:00:00.000,ATP Masters Series Canada Montreal; Canada ATP World Tour,HARD,2,David Nalbandian,Rainer Schuettler,David Nalbandian,3-6; 6-2; 6-2,S,105,4,1,45,65,37,45,11,20,1,2,12,48,65,2,1,42,77,24,42,22,35,5,9,13,46,77
2003-08-04 00:00:00.000,ATP Masters Series Canada Montreal; Canada ATP World Tour,HARD,2,Andy Roddick,Roger Federer,Andy Roddick,6-4; 3-6; 7-6(3),S,116,9,2,41,85,32,41,28,44,0,2,15,60,85,9,10,56,100,47,56,19,44,7,9,16,66,100
2003-08-04 00:00:00.000,ATP Masters Series Canada Montreal; Canada ATP World Tour,HARD,2,Andy Roddick,David Nalbandian,Andy Roddick,6-1; 6-3,F,63,6,1,26,42,21,26,10,16,1,2,8,31,42,1,1,25,47,15,25,7,22,3,8,8,22,47
2003-08-11 00:00:00.000,ATP Masters Series Cincinnati Ohio; USA ATP World Tour,HARD,2,Thomas Enqvist,Felix Mantilla,Thomas Enqvist,6-3; 7-6(5),R64,73,17,3,42,64,38,42,10,22,2,3,11,48,64,6,1,43,62,29,43,10,19,0,2,10,39,62
2003-08-11 00:00:00.000,ATP Masters Series Cincinnati Ohio; USA ATP World Tour,HARD,2,Max Mirnyi,Alex Corretja,Max Mirnyi,3-6; 6-3; 7-6(2),R64,128,13,2,72,92,53,72,11,20,6,7,15,64,92,7,4,54,89,39,54,23,35,4,5,15,62,89
2003-08-11 00:00:00.000,ATP Masters Series Cincinnati Ohio; USA ATP World Tour,HARD,2,Hicham Arazi,Michael Chang,Hicham Arazi,4-6; 7-6(7); 6-0,R64,139,4,9,40,83,32,40,22,43,4,8,14,54,83,4,5,58,106,35,58,22,48,6,12,14,57,106
2003-08-11 00:00:00.000,ATP Masters Series Cincinnati Ohio; USA ATP World Tour,HARD,2,Paul-Henri Mathieu,Tommy Robredo,Paul-Henri Mathieu,6-4; 4-6; 6-3,R64,120,2,7,41,87,34,41,20,46,4,8,15,54,87,10,5,55,85,40,55,12,30,6,11,14,52,85
2003-08-11 00:00:00.000,ATP Masters Series Cincinnati Ohio; USA ATP World Tour,HARD,2,Wesley Moodie,Sebastien Grosjean,Wesley Moodie,6-3; 6-7(9); 6-3,R64,131,19,4,72,99,57,72,18,27,1,1,16,75,99,6,4,69,110,48,69,23,41,4,6,14,71,110
2003-08-11 00:00:00.000,ATP Masters Series Cincinnati Ohio; USA ATP World Tour,HARD,2,Mikhail Youzhny,Agustin Calleri,Mikhail Youzhny,6-3; 6-3,R64,74,6,1,30,60,21,30,15,30,6,8,9,36,60,7,5,29,57,20,29,7,28,4,9,9,27,57
2003-08-11 00:00:00.000,ATP Masters Series Cincinnati Ohio; USA ATP World Tour,HARD,2,Yevgeny Kafelnikov,Jan-Michael Gambill,Yevgeny Kafelnikov,6-4; 6-4,R64,75,5,2,37,61,28,37,15,24,2,3,10,43,61,15,1,35,61,28,35,9,26,3,6,10,37,61
2003-08-11 00:00:00.000,ATP Masters Series Cincinnati Ohio; USA ATP World Tour,HARD,2,Guillermo Coria,Tim Henman,Guillermo Coria,6-3; 4-6; 6-4,R64,132,2,4,71,103,46,71,18,32,5,7,15,64,103,1,3,35,75,25,35,24,40,1,4,14,49,75
2003-08-11 00:00:00.000,ATP Masters Series Cincinnati Ohio; USA ATP World Tour,HARD,2,Fabrice Santoro,Carlos Moya,Fabrice Santoro,3-6; 6-3; 6-4,R64,109,6,4,59,93,41,59,19,34,9,11,14,60,93,5,3,52,89,32,52,21,37,5,8,14,53,89
2003-08-11 00:00:00.000,ATP Masters Series Cincinnati Ohio; USA ATP World Tour,HARD,2,Flavio Saretta,David Sanchez,Flavio Saretta,6-7(2); 6-1; 6-2,R64,141,9,8,73,117,48,73,18,44,9,13,14,66,117,1,0,72,112,38,72,14,40,14,22,13,52,112
2003-08-11 00:00:00.000,ATP Masters Series Cincinnati Ohio; USA ATP World Tour,HARD,2,Younes El Aynaoui,Vincent Spadea,Younes El Aynaoui,7-5; 6-4,R64,83,11,2,38,65,27,38,16,27,1,2,11,43,65,3,2,39,63,28,39,12,24,2,5,11,40,63
2003-08-11 00:00:00.000,ATP Masters Series Cincinnati Ohio; USA ATP World Tour,HARD,2,Mariano Zabaleta,Gustavo Kuerten,Mariano Zabaleta,6-4; 6-0,R64,56,4,2,20,39,16,20,14,19,0,1,8,30,39,1,4,29,51,18,29,6,22,5,10,8,24,51
2003-08-11 00:00:00.000,ATP Masters Series Cincinnati Ohio; USA ATP World Tour,HARD,2,Sjeng Schalken,Hyung-Taik Lee,Sjeng Schalken,6-4; 6-3,R64,92,3,2,37,58,26,37,14,21,2,3,9,40,58,0,2,40,65,23,40,10,25,4,8,10,33,65
2003-08-11 00:00:00.000,ATP Masters Series Cincinnati Ohio; USA ATP World Tour,HARD,2,James Blake,Wayne Ferreira,James Blake,6-1; 7-6(0),R64,67,7,0,39,61,33,39,13,22,2,2,10,46,61,2,1,29,57,21,29,12,28,0,2,9,33,57
2003-08-11 00:00:00.000,ATP Masters Series Cincinnati Ohio; USA ATP World Tour,HARD,2,Ivan Ljubicic,Nicolas Lapentti,Ivan Ljubicic,3-6; 7-5; 6-3,R64,115,23,9,49,82,41,49,18,33,2,3,15,59,82,5,1,62,86,42,62,16,24,4,6,15,58,86
2003-08-11 00:00:00.000,ATP Masters Series Cincinnati Ohio; USA ATP World Tour,HARD,2,Andy Roddick,Fernando Verdasco,Andy Roddick,6-3; 6-2,R64,53,9,1,27,44,21,27,13,17,0,1,9,34,44,4,1,33,48,17,33,6,15,4,8,8,23,48
2003-08-11 00:00:00.000,ATP Masters Series Cincinnati Ohio; USA ATP World Tour,HARD,2,Xavier Malisse,Lleyton Hewitt,Xavier Malisse,3-6; 6-4; 6-2,R64,103,10,6,29,80,23,29,25,51,4,8,14,48,80,9,8,37,81,28,37,18,44,7,12,13,46,81
2003-08-11 00:00:00.000,ATP Masters Series Cincinnati Ohio; USA ATP World Tour,HARD,2,Mardy Fish,Mark Philippoussis,Mardy Fish,1-6; 6-3; 6-4,R64,89,9,2,34,64,29,34,16,30,1,3,13,45,64,16,10,35,69,29,35,17,34,1,3,13,46,69
2003-08-11 00:00:00.000,ATP Masters Series Cincinnati Ohio; USA ATP World Tour,HARD,2,Arnaud Clement,Albert Costa,Arnaud Clement,7-6(5); 6-4,R64,118,9,2,44,72,30,44,18,28,4,6,11,48,72,2,3,51,77,35,51,13,26,6,9,11,48,77
2003-08-11 00:00:00.000,ATP Masters Series Cincinnati Ohio; USA ATP World Tour,HARD,2,Greg Rusedski,Jiri Novak,Greg Rusedski,2-6; 7-6(3); 6-4,R64,120,6,4,64,103,44,64,20,39,6,10,15,64,103,3,1,59,95,43,59,16,36,2,5,15,59,95
2003-08-11 00:00:00.000,ATP Masters Series Cincinnati Ohio; USA ATP World Tour,HARD,2,Fernando Gonzalez,Brian Vahaly,Fernando Gonzalez,7-5; 6-2,R64,73,1,3,30,66,23,30,19,36,6,8,10,42,66,2,1,37,55,21,37,10,18,1,6,10,31,55
2003-08-11 00:00:00.000,ATP Masters Series Cincinnati Ohio; USA ATP World Tour,HARD,2,Juan Ignacio Chela,Karol Kucera,Juan Ignacio Chela,6-1; 6-1,R64,56,1,2,27,53,20,27,15,26,4,4,7,35,53,1,5,21,38,11,21,3,17,4,9,7,14,38
2003-08-11 00:00:00.000,ATP Masters Series Cincinnati Ohio; USA ATP World Tour,HARD,2,David Nalbandian,Wayne Arthurs,David Nalbandian,6-0; 6-4,R64,47,7,0,22,38,20,22,12,16,0,0,8,32,38,8,3,22,44,13,22,10,22,2,6,8,23,44
2003-08-11 00:00:00.000,ATP Masters Series Cincinnati Ohio; USA ATP World Tour,HARD,2,Roger Federer,Scott Draper,Roger Federer,4-6; 6-3; 7-6(10),R64,122,14,4,69,108,58,69,22,39,9,10,16,80,108,6,1,65,106,48,65,24,41,7,8,15,72,106
2003-08-11 00:00:00.000,ATP Masters Series Cincinnati Ohio; USA ATP World Tour,HARD,2,Rainer Schuettler,Stefan Koubek,Rainer Schuettler,6-2; 7-5,R64,86,4,4,41,68,30,41,12,27,3,4,10,42,68,2,3,29,59,18,29,16,30,4,8,10,34,59
2003-08-11 00:00:00.000,ATP Masters Series Cincinnati Ohio; USA ATP World Tour,HARD,2,Jarkko Nieminen,Fernando Vicente,Jarkko Nieminen,7-5; 3-6; 6-4,R64,117,3,4,39,80,27,39,24,41,4,8,15,51,80,11,2,67,105,46,67,15,38,12,17,16,61,105
2003-08-11 00:00:00.000,ATP Masters Series Cincinnati Ohio; USA ATP World Tour,HARD,2,Todd Martin,Jose Acasuso,Todd Martin,6-3; 6-4,R64,94,5,3,25,61,22,25,22,36,1,1,10,44,61,6,4,31,57,25,31,11,26,2,4,9,36,57
2003-08-11 00:00:00.000,ATP Masters Series Cincinnati Ohio; USA ATP World Tour,HARD,2,Feliciano Lopez,Paradorn Srichaphan,Feliciano Lopez,6-7(1); 6-4; 7-6(5),R64,132,9,6,60,110,46,60,32,50,4,4,17,78,110,11,4,58,93,48,58,24,35,1,2,17,72,93
2003-08-11 00:00:00.000,ATP Masters Series Cincinnati Ohio; USA ATP World Tour,HARD,2,Noam Okun,Martin Verkerk,Noam Okun,3-6; 6-3; 6-1,R64,90,7,5,37,67,31,37,17,30,2,3,12,48,67,8,8,36,74,27,36,18,38,3,7,13,45,74
2003-08-11 00:00:00.000,ATP Masters Series Cincinnati Ohio; USA ATP World Tour,HARD,2,Robby Ginepri,Radek Stepanek,Robby Ginepri,6-1; 3-6; 6-0,R64,68,3,2,36,56,28,36,13,20,1,3,11,41,56,6,6,33,66,22,33,12,33,1,7,11,34,66
2003-08-11 00:00:00.000,ATP Masters Series Cincinnati Ohio; USA ATP World Tour,HARD,2,Gaston Gaudio,Robert Kendrick,Gaston Gaudio,6-4; 6-4,R64,66,2,2,29,50,23,29,14,21,0,1,10,37,50,8,2,35,62,25,35,14,27,4,7,10,39,62
2003-08-11 00:00:00.000,ATP Masters Series Cincinnati Ohio; USA ATP World Tour,HARD,2,Juan Carlos Ferrero,Nikolay Davydenko,Juan Carlos Ferrero,6-0; 6-2,R64,55,3,2,27,40,23,27,7,13,2,2,7,30,40,2,4,25,44,12,25,6,19,4,9,7,18,44
2003-08-11 00:00:00.000,ATP Masters Series Cincinnati Ohio; USA ATP World Tour,HARD,2,Max Mirnyi,Thomas Enqvist,Max Mirnyi,7-6(2); 6-4,R32,80,11,2,51,65,41,51,7,14,1,2,11,48,65,10,4,36,61,27,36,15,25,1,3,11,42,61
2003-08-11 00:00:00.000,ATP Masters Series Cincinnati Ohio; USA ATP World Tour,HARD,2,Hicham Arazi,Paul-Henri Mathieu,Hicham Arazi,6-2; 6-1,R32,58,4,0,22,38,18,22,10,16,1,2,7,28,38,1,5,12,44,7,12,10,32,1,7,8,17,44
2003-08-11 00:00:00.000,ATP Masters Series Cincinnati Ohio; USA ATP World Tour,HARD,2,Mikhail Youzhny,Wesley Moodie,Mikhail Youzhny,6-4; 7-6(4),R32,93,4,3,35,71,23,35,21,36,1,4,11,44,71,9,4,46,77,28,46,15,31,6,10,11,43,77
2003-08-11 00:00:00.000,ATP Masters Series Cincinnati Ohio; USA ATP World Tour,HARD,2,Guillermo Coria,Yevgeny Kafelnikov,Guillermo Coria,6-0; 5-4 RET,R32,68,8,0,28,35,24,28,5,7,0,0,7,29,35,3,4,51,78,29,51,10,27,8,12,8,39,78
2003-08-11 00:00:00.000,ATP Masters Series Cincinnati Ohio; USA ATP World Tour,HARD,2,Flavio Saretta,Fabrice Santoro,Flavio Saretta,7-5; 6-3,R32,91,6,1,31,59,25,31,17,28,5,6,10,42,59,2,3,35,70,27,35,14,35,3,7,11,41,70
2003-08-11 00:00:00.000,ATP Masters Series Cincinnati Ohio; USA ATP World Tour,HARD,2,Mariano Zabaleta,Younes El Aynaoui,Mariano Zabaleta,6-7(4); 6-4; 7-5,R32,161,10,1,86,117,69,86,16,31,7,7,17,85,117,16,2,93,121,68,93,14,28,14,16,17,82,121
2003-08-11 00:00:00.000,ATP Masters Series Cincinnati Ohio; USA ATP World Tour,HARD,2,James Blake,Sjeng Schalken,James Blake,6-1; 6-4,R32,65,2,1,33,54,26,33,9,21,1,2,9,35,54,1,2,35,52,18,35,9,17,4,8,8,27,52
2003-08-11 00:00:00.000,ATP Masters Series Cincinnati Ohio; USA ATP World Tour,HARD,2,Andy Roddick,Ivan Ljubicic,Andy Roddick,6-1; 6-4,R32,57,10,1,35,51,29,35,7,16,0,0,9,36,51,3,3,20,44,14,20,10,24,1,4,8,24,44
2003-08-11 00:00:00.000,ATP Masters Series Cincinnati Ohio; USA ATP World Tour,HARD,2,Mardy Fish,Xavier Malisse,Mardy Fish,7-5; 6-7(5); 6-1,R32,135,12,5,46,102,40,46,34,56,7,7,16,74,102,15,5,56,102,48,56,19,46,3,6,15,67,102
2003-08-11 00:00:00.000,ATP Masters Series Cincinnati Ohio; USA ATP World Tour,HARD,2,Arnaud Clement,Greg Rusedski,Arnaud Clement,7-6(2); 5-7; 6-2,R32,143,5,3,63,107,45,63,25,44,9,12,16,70,107,17,6,67,104,49,67,13,37,3,7,16,62,104
2003-08-11 00:00:00.000,ATP Masters Series Cincinnati Ohio; USA ATP World Tour,HARD,2,Juan Ignacio Chela,Fernando Gonzalez,Juan Ignacio Chela,6-2; 6-4,R32,62,7,3,32,49,28,32,9,17,1,1,9,37,49,7,1,36,55,19,36,11,19,1,4,9,30,55
2003-08-11 00:00:00.000,ATP Masters Series Cincinnati Ohio; USA ATP World Tour,HARD,2,David Nalbandian,Roger Federer,David Nalbandian,7-6(4); 7-6(5),R32,126,3,6,48,94,33,48,23,46,3,6,12,56,94,14,6,43,90,35,43,18,47,5,8,12,53,90
2003-08-11 00:00:00.000,ATP Masters Series Cincinnati Ohio; USA ATP World Tour,HARD,2,Rainer Schuettler,Jarkko Nieminen,Rainer Schuettler,3-6; 6-3; 7-6(4),R32,131,16,5,80,122,62,80,14,42,4,5,15,76,122,8,0,56,92,45,56,21,36,5,6,15,66,92
2003-08-11 00:00:00.000,ATP Masters Series Cincinnati Ohio; USA ATP World Tour,HARD,2,Todd Martin,Feliciano Lopez,Todd Martin,7-6(3); 6-4,R32,97,11,7,44,72,36,44,14,28,1,2,11,50,72,6,4,39,70,30,39,14,31,3,5,11,44,70
2003-08-11 00:00:00.000,ATP Masters Series Cincinnati Ohio; USA ATP World Tour,HARD,2,Robby Ginepri,Noam Okun,Robby Ginepri,7-6(5); 6-4,R32,87,7,0,38,63,28,38,17,25,1,2,11,45,63,4,0,43,70,33,43,12,27,1,3,11,45,70
2003-08-11 00:00:00.000,ATP Masters Series Cincinnati Ohio; USA ATP World Tour,HARD,2,Gaston Gaudio,Juan Carlos Ferrero,Gaston Gaudio,6-7(3); 7-6(5); 6-4,R32,161,6,2,71,105,50,71,23,34,1,3,17,73,105,17,10,62,120,44,62,34,58,6,9,17,78,120
2003-08-11 00:00:00.000,ATP Masters Series Cincinnati Ohio; USA ATP World Tour,HARD,2,Max Mirnyi,Hicham Arazi,Max Mirnyi,6-4; 6-7(7); 6-4,R16,143,18,5,69,103,57,69,13,34,3,4,16,70,103,2,2,62,107,45,62,25,45,6,9,16,70,107
2003-08-11 00:00:00.000,ATP Masters Series Cincinnati Ohio; USA ATP World Tour,HARD,2,Guillermo Coria,Mikhail Youzhny,Guillermo Coria,6-2; 6-1,R16,75,2,1,40,57,25,40,11,17,4,5,8,36,57,2,2,27,52,14,27,9,25,7,12,7,23,52
2003-08-11 00:00:00.000,ATP Masters Series Cincinnati Ohio; USA ATP World Tour,HARD,2,Mariano Zabaleta,Flavio Saretta,Mariano Zabaleta,6-7(5); 6-2; 6-4,R16,162,6,6,76,111,53,76,15,35,5,8,15,68,111,12,6,61,106,40,61,21,45,5,11,15,61,106
2003-08-11 00:00:00.000,ATP Masters Series Cincinnati Ohio; USA ATP World Tour,HARD,2,Andy Roddick,James Blake,Andy Roddick,7-6(2); 6-2,R16,78,9,5,46,78,40,46,14,32,4,4,10,54,78,9,1,29,54,21,29,15,25,1,3,10,36,54
2003-08-11 00:00:00.000,ATP Masters Series Cincinnati Ohio; USA ATP World Tour,HARD,2,Mardy Fish,Arnaud Clement,Mardy Fish,6-2; 6-2,R16,63,6,1,17,40,16,17,16,23,0,0,8,32,40,7,3,25,53,16,25,12,28,5,9,8,28,53
2003-08-11 00:00:00.000,ATP Masters Series Cincinnati Ohio; USA ATP World Tour,HARD,2,David Nalbandian,Juan Ignacio Chela,David Nalbandian,6-4; 6-4,R16,84,3,0,36,53,27,36,9,17,0,2,10,36,53,1,7,44,74,27,44,12,30,6,10,10,39,74
2003-08-11 00:00:00.000,ATP Masters Series Cincinnati Ohio; USA ATP World Tour,HARD,2,Rainer Schuettler,Todd Martin,Rainer Schuettler,7-5; 3-6; 6-3,R16,131,10,3,43,79,38,43,22,36,0,1,15,60,79,10,8,53,97,42,53,21,44,4,6,15,63,97
2003-08-11 00:00:00.000,ATP Masters Series Cincinnati Ohio; USA ATP World Tour,HARD,2,Robby Ginepri,Gaston Gaudio,Robby Ginepri,6-1; 7-6(4),R16,85,9,1,40,62,28,40,16,22,1,2,10,44,62,2,1,32,67,21,32,18,35,5,8,9,39,67
2003-08-11 00:00:00.000,ATP Masters Series Cincinnati Ohio; USA ATP World Tour,HARD,2,Max Mirnyi,Guillermo Coria,Max Mirnyi,6-2; 7-5,Q,67,7,2,35,54,31,35,10,19,0,0,10,41,54,2,1,41,53,26,41,8,12,4,7,10,34,53
2003-08-11 00:00:00.000,ATP Masters Series Cincinnati Ohio; USA ATP World Tour,HARD,2,Andy Roddick,Mariano Zabaleta,Andy Roddick,6-1; 6-2,Q,60,7,1,27,43,21,27,11,16,0,0,8,32,43,2,3,32,53,17,32,8,21,2,6,7,25,53
2003-08-11 00:00:00.000,ATP Masters Series Cincinnati Ohio; USA ATP World Tour,HARD,2,Mardy Fish,David Nalbandian,Mardy Fish,7-6(3); 6-3,Q,85,6,0,37,64,30,37,18,27,2,2,11,48,64,6,3,41,62,29,41,14,21,3,4,10,43,62
2003-08-11 00:00:00.000,ATP Masters Series Cincinnati Ohio; USA ATP World Tour,HARD,2,Rainer Schuettler,Robby Ginepri,Rainer Schuettler,6-2; 6-3,Q,68,5,2,26,48,22,26,13,22,2,2,8,35,48,4,0,29,54,20,29,8,25,0,4,9,28,54
2003-08-11 00:00:00.000,ATP Masters Series Cincinnati Ohio; USA ATP World Tour,HARD,2,Andy Roddick,Max Mirnyi,Andy Roddick,7-6(5); 6-4,S,81,14,0,48,66,37,48,14,18,1,1,11,51,66,9,2,44,64,37,44,9,20,0,1,11,46,64
2003-08-11 00:00:00.000,ATP Masters Series Cincinnati Ohio; USA ATP World Tour,HARD,2,Mardy Fish,Rainer Schuettler,Mardy Fish,7-6(4); 7-6(6),S,121,14,4,50,95,42,50,25,45,6,6,12,67,95,5,3,42,81,35,42,24,39,2,2,12,59,81
2003-08-11 00:00:00.000,ATP Masters Series Cincinnati Ohio; USA ATP World Tour,HARD,2,Andy Roddick,Mardy Fish,Andy Roddick,4-6; 7-6(3); 7-6(4),F,149,13,6,66,111,55,66,25,45,5,6,17,80,111,8,9,69,131,55,69,31,62,5,5,17,86,131
2003-08-18 00:00:00.000,Long Island New York; USA ATP World Tour,HARD,2,Paradorn Srichaphan,Nikolay Davydenko,Paradorn Srichaphan,6-3; 6-4,R32,75,0,3,37,65,25,37,16,28,3,4,10,41,65,1,1,41,54,24,41,8,13,3,6,9,32,54
2003-08-18 00:00:00.000,Long Island New York; USA ATP World Tour,HARD,2,Sargis Sargsian,Alex Corretja,Sargis Sargsian,7-5; 6-2,R32,88,4,4,37,58,26,37,11,21,4,6,10,37,58,1,2,26,54,12,26,15,28,0,5,10,27,54
2003-08-18 00:00:00.000,Long Island New York; USA ATP World Tour,HARD,2,Jeff Morrison,Arnaud Clement,Jeff Morrison,6-4; 6-4,R32,77,14,1,52,74,38,52,11,22,5,5,10,49,74,4,2,32,60,25,32,13,28,2,4,10,38,60
2003-08-18 00:00:00.000,Long Island New York; USA ATP World Tour,HARD,2,Mikhail Youzhny,Felix Mantilla,Mikhail Youzhny,6-2; 6-1,R32,61,4,1,18,41,17,18,13,23,1,1,7,30,41,0,5,39,59,19,39,9,20,5,10,8,28,59
2003-08-18 00:00:00.000,Long Island New York; USA ATP World Tour,HARD,2,Juan Ignacio Chela,Fernando Gonzalez,Juan Ignacio Chela,4-6; 7-6(8); 6-0,R32,111,12,5,57,86,46,57,16,29,1,2,14,62,86,4,4,67,102,47,67,17,35,6,9,14,64,102
2003-08-18 00:00:00.000,Long Island New York; USA ATP World Tour,HARD,2,Olivier Rochus,Fernando Vicente,Olivier Rochus,7-6(5); 6-1,R32,86,1,3,54,80,35,54,13,26,8,9,10,48,80,7,2,41,68,26,41,10,27,4,7,9,36,68
2003-08-18 00:00:00.000,Long Island New York; USA ATP World Tour,HARD,2,Nicolas Kiefer,Paul-Henri Mathieu,Nicolas Kiefer,4-6; 7-6(4); 6-3,R32,142,14,9,51,95,41,51,25,44,2,4,16,66,95,10,6,58,102,48,58,20,44,6,8,15,68,102
2003-08-18 00:00:00.000,Long Island New York; USA ATP World Tour,HARD,2,Flavio Saretta,Albert Costa,Flavio Saretta,3-0 RET,R32,9,2,0,6,9,5,6,3,3,0,0,2,8,9,0,0,2,8,1,2,2,6,0,1,1,3,8
2003-08-18 00:00:00.000,Long Island New York; USA ATP World Tour,HARD,2,Agustin Calleri,Jan-Michael Gambill,Agustin Calleri,6-4; 7-5,R32,94,9,5,29,71,25,29,24,42,6,7,11,49,71,3,4,41,79,28,41,19,38,3,6,11,47,79
2003-08-18 00:00:00.000,Long Island New York; USA ATP World Tour,HARD,2,Jarkko Nieminen,Feliciano Lopez,Jarkko Nieminen,6-3; 1-1 RET,R32,39,2,1,21,36,18,21,10,15,4,4,6,28,36,3,1,22,43,14,22,10,21,3,4,5,24,43
2003-08-18 00:00:00.000,Long Island New York; USA ATP World Tour,HARD,2,James Blake,Jonas Bjorkman,James Blake,6-1; 7-6(4),R32,81,4,3,34,63,25,34,18,29,2,4,10,43,63,1,6,31,67,22,31,13,36,3,7,9,35,67
2003-08-18 00:00:00.000,Long Island New York; USA ATP World Tour,HARD,2,Tommy Robredo,Jose Acasuso,Tommy Robredo,2-6; 6-3; 7-5,R32,106,2,5,47,82,32,47,20,35,2,6,15,52,82,6,5,48,85,36,48,19,37,7,11,14,55,85
2003-08-18 00:00:00.000,Long Island New York; USA ATP World Tour,HARD,2,Younes El Aynaoui,Fernando Verdasco,Younes El Aynaoui,6-7(4); 6-4; 6-0,R32,99,5,1,58,87,44,58,17,29,6,6,14,61,87,9,10,57,100,35,57,24,43,4,8,14,59,100
2003-08-18 00:00:00.000,Long Island New York; USA ATP World Tour,HARD,2,Rik De Voest,Michael Chang,Rik De Voest,6-2; 6-3,R32,75,2,1,25,45,21,25,13,20,0,0,8,34,45,1,2,31,69,19,31,18,38,5,9,9,37,69
2003-08-18 00:00:00.000,Long Island New York; USA ATP World Tour,HARD,2,Karol Beck,David Sanchez,Karol Beck,2-6; 6-4; 6-3,R32,102,5,5,41,78,30,41,18,37,2,6,14,48,78,2,3,47,90,35,47,18,43,6,10,13,53,90
2003-08-18 00:00:00.000,Long Island New York; USA ATP World Tour,HARD,2,Gustavo Kuerten,Dominik Hrbaty,Gustavo Kuerten,6-4; 7-6(3),R32,92,9,0,45,77,36,45,19,32,2,2,11,55,77,8,1,41,78,29,41,22,37,6,7,11,51,78
2003-08-18 00:00:00.000,Long Island New York; USA ATP World Tour,HARD,2,Paradorn Srichaphan,Sargis Sargsian,Paradorn Srichaphan,6-3; 6-4,R16,88,9,3,29,58,22,29,16,29,1,3,10,38,58,5,6,43,74,29,43,9,31,7,11,9,38,74
2003-08-18 00:00:00.000,Long Island New York; USA ATP World Tour,HARD,2,Jeff Morrison,Mikhail Youzhny,Jeff Morrison,7-6(7); 6-3,R16,95,12,3,42,81,31,42,22,39,7,9,11,53,81,2,3,39,74,31,39,14,35,1,4,10,45,74
2003-08-18 00:00:00.000,Long Island New York; USA ATP World Tour,HARD,2,Juan Ignacio Chela,Olivier Rochus,Juan Ignacio Chela,7-6(3); 6-1,R16,98,10,7,40,72,35,40,11,32,4,6,10,46,72,0,3,34,65,22,34,13,31,2,6,9,35,65
2003-08-18 00:00:00.000,Long Island New York; USA ATP World Tour,HARD,2,Nicolas Kiefer,Flavio Saretta,Nicolas Kiefer,6-3; 6-1,R16,60,8,2,23,49,19,23,13,26,0,1,8,32,49,2,8,25,43,14,25,5,18,2,7,8,19,43
2003-08-18 00:00:00.000,Long Island New York; USA ATP World Tour,HARD,2,Jarkko Nieminen,Agustin Calleri,Jarkko Nieminen,6-1; 6-4,R16,66,3,1,34,53,26,34,12,19,3,3,9,38,53,6,4,22,52,16,22,13,30,1,4,8,29,52
2003-08-18 00:00:00.000,Long Island New York; USA ATP World Tour,HARD,2,James Blake,Tommy Robredo,James Blake,6-3; 6-4,R16,61,6,2,42,61,28,42,12,19,2,4,10,40,61,4,4,40,57,20,40,10,17,2,6,9,30,57
2003-08-18 00:00:00.000,Long Island New York; USA ATP World Tour,HARD,2,Younes El Aynaoui,Rik De Voest,Younes El Aynaoui,7-6(3); 3-0,R16,61,6,2,31,51,28,31,11,20,3,3,8,39,51,0,4,25,48,20,25,9,23,1,2,7,29,48
2003-08-18 00:00:00.000,Long Island New York; USA ATP World Tour,HARD,2,Gustavo Kuerten,Karol Beck,Gustavo Kuerten,7-5; 6-3,R16,71,4,3,25,50,20,25,16,25,0,2,10,36,50,6,10,31,66,23,31,14,35,9,14,11,37,66
2003-08-18 00:00:00.000,Long Island New York; USA ATP World Tour,HARD,2,Paradorn Srichaphan,Jeff Morrison,Paradorn Srichaphan,6-4; 6-3,Q,62,4,3,38,58,29,38,13,20,2,2,10,42,58,7,3,29,58,21,29,15,29,2,4,9,36,58
2003-08-18 00:00:00.000,Long Island New York; USA ATP World Tour,HARD,2,Nicolas Kiefer,Juan Ignacio Chela,Nicolas Kiefer,6-1; 3-0 RET,Q,49,8,1,20,38,19,20,7,18,4,4,5,26,38,0,6,16,35,11,16,3,19,2,6,5,14,35
2003-08-18 00:00:00.000,Long Island New York; USA ATP World Tour,HARD,2,James Blake,Jarkko Nieminen,James Blake,4-6; 6-2; 6-3,Q,90,12,2,52,79,42,52,15,27,1,2,14,57,79,0,5,43,83,29,43,20,40,6,9,13,49,83
2003-08-18 00:00:00.000,Long Island New York; USA ATP World Tour,HARD,2,Younes El Aynaoui,Gustavo Kuerten,Younes El Aynaoui,7-6(4); 6-4,Q,81,15,2,51,70,46,51,8,19,3,3,11,54,70,8,2,41,69,32,41,15,28,0,1,11,47,69
2003-08-18 00:00:00.000,Long Island New York; USA ATP World Tour,HARD,2,Paradorn Srichaphan,Nicolas Kiefer,Paradorn Srichaphan,6-0; 6-2,S,57,4,1,20,33,19,20,9,13,0,0,7,28,33,1,5,22,41,12,22,5,19,2,7,7,17,41
2003-08-18 00:00:00.000,Long Island New York; USA ATP World Tour,HARD,2,James Blake,Younes El Aynaoui,James Blake,6-3; 6-1,S,59,2,3,24,40,21,24,9,16,0,1,8,30,40,3,1,43,63,21,43,8,20,7,12,8,29,63
2003-08-18 00:00:00.000,Long Island New York; USA ATP World Tour,HARD,2,Paradorn Srichaphan,James Blake,Paradorn Srichaphan,6-2; 6-4,F,70,2,3,26,56,19,26,17,30,4,6,9,36,56,3,2,36,62,22,36,7,26,4,9,9,29,62
2003-08-25 00:00:00.000,US Open NY; U.S.A. Grand Slams,HARD,3,Andre Agassi,Alex Corretja,Andre Agassi,6-1; 6-2; 6-2,R128,85,5,2,40,65,30,40,20,25,3,3,12,50,65,3,3,37,66,19,37,13,29,5,11,11,32,66
2003-08-25 00:00:00.000,US Open NY; U.S.A. Grand Slams,HARD,3,Andreas Vinciguerra,Robert Kendrick,Andreas Vinciguerra,7-6(4); 6-7(2); 7-5; 1-6; 6-1,R128,161,6,6,86,148,68,86,30,62,6,11,25,98,148,23,17,79,148,58,79,34,69,5,11,25,92,148
2003-08-25 00:00:00.000,US Open NY; U.S.A. Grand Slams,HARD,3,Kenneth Carlsen,Jeff Morrison,Kenneth Carlsen,6-2; 3-6; 6-3; 6-4,R128,140,9,3,63,111,46,63,27,48,6,9,18,73,111,9,5,50,107,34,50,27,57,5,11,18,61,107
2003-08-25 00:00:00.000,US Open NY; U.S.A. Grand Slams,HARD,3,Yevgeny Kafelnikov,Kristof Vliegen,Yevgeny Kafelnikov,3-6; 7-6(1); 6-2; 6-2,R128,138,2,2,70,99,52,70,16,29,2,6,19,68,99,18,0,71,118,49,71,18,47,4,10,18,67,118
2003-08-25 00:00:00.000,US Open NY; U.S.A. Grand Slams,HARD,3,Nikolay Davydenko,Max Mirnyi,Nikolay Davydenko,7-6(3); 2-6; 6-2; 7-6(6),R128,165,2,0,105,120,76,105,9,15,1,4,20,85,120,11,5,79,127,58,79,31,48,9,12,20,89,127
2003-08-25 00:00:00.000,US Open NY; U.S.A. Grand Slams,HARD,3,Taylor Dent,Robin Soderling,Taylor Dent,7-6(1); 6-3; 3-6; 6-4,R128,132,19,15,68,114,54,68,20,46,1,5,20,74,114,8,9,82,140,55,82,28,58,8,13,20,83,140
2003-08-25 00:00:00.000,US Open NY; U.S.A. Grand Slams,HARD,3,Stefan Koubek,Giorgio Galimberti,Stefan Koubek,5-7; 6-2; 6-2; 7-6(4),R128,159,6,7,88,136,58,88,29,48,5,9,20,87,136,2,11,87,165,54,87,36,78,16,23,20,90,165
2003-08-25 00:00:00.000,US Open NY; U.S.A. Grand Slams,HARD,3,Fernando Gonzalez,Michael Chang,Fernando Gonzalez,6-3; 7-5; 5-7; 6-4,R128,147,16,7,72,137,61,72,34,65,6,8,22,95,137,9,3,62,107,48,62,25,45,2,6,21,73,107
2003-08-25 00:00:00.000,US Open NY; U.S.A. Grand Slams,HARD,3,Ramon Delgado,Sebastien Grosjean,Ramon Delgado,6-4; 6-7(3); 4-6; 7-6(7); 6-4,R128,252,8,3,127,188,88,127,30,61,6,10,27,118,188,18,6,77,170,61,77,53,93,8,13,27,114,170
2003-08-25 00:00:00.000,US Open NY; U.S.A. Grand Slams,HARD,3,Jonas Bjorkman,Filippo Volandri,Jonas Bjorkman,6-1; 6-4; 6-0,R128,92,4,5,40,88,32,40,27,48,6,6,12,59,88,0,9,31,65,19,31,13,34,2,8,11,32,65
2003-08-25 00:00:00.000,US Open NY; U.S.A. Grand Slams,HARD,3,Karol Kucera,Alexander Popp,Karol Kucera,6-2; 7-5; 6-3,R128,125,5,6,53,92,43,53,17,39,2,5,15,60,92,0,7,56,94,34,56,13,38,6,13,14,47,94
2003-08-25 00:00:00.000,US Open NY; U.S.A. Grand Slams,HARD,3,Mardy Fish,Joachim Johansson,Mardy Fish,6-3; 6-2; 6-4,R128,101,12,2,44,80,36,44,25,36,3,3,14,61,80,4,8,48,86,36,48,13,38,4,8,13,49,86
2003-08-25 00:00:00.000,US Open NY; U.S.A. Grand Slams,HARD,3,Arnaud Clement,Brian Vahaly,Arnaud Clement,6-7(6); 7-6(6); 6-3; 6-4,R128,205,11,7,92,163,69,92,32,71,8,13,22,101,163,11,3,84,130,55,84,24,46,9,16,21,79,130
2003-08-25 00:00:00.000,US Open NY; U.S.A. Grand Slams,HARD,3,Gregory Carraz,Greg Rusedski,Gregory Carraz,6-4; 4-6; 6-2; 5-7; 6-4,R128,168,23,13,80,149,66,80,38,69,4,7,25,104,149,19,15,96,154,71,96,30,58,8,13,25,101,154
2003-08-25 00:00:00.000,US Open NY; U.S.A. Grand Slams,HARD,3,Bohdan Ulihrach,Maximilian Abel,Bohdan Ulihrach,4-6; 6-4; 6-3; 6-1,R128,117,5,3,69,100,52,69,18,31,4,6,18,70,100,6,7,72,124,47,72,23,52,8,14,18,70,124
2003-08-25 00:00:00.000,US Open NY; U.S.A. Grand Slams,HARD,3,Guillermo Coria,Mariano Puerta,Guillermo Coria,6-4; 6-3; 6-1,R128,104,6,1,48,77,37,48,21,29,3,3,13,58,77,1,2,39,78,27,39,17,39,7,12,13,44,78
2003-08-25 00:00:00.000,US Open NY; U.S.A. Grand Slams,HARD,3,Juan Carlos Ferrero,Jan Vacek,Juan Carlos Ferrero,6-2; 4-6; 6-3; 6-2,R128,133,5,7,59,104,48,59,26,45,3,5,18,74,104,4,3,66,112,43,66,21,46,8,14,17,64,112
2003-08-25 00:00:00.000,US Open NY; U.S.A. Grand Slams,HARD,3,Jurgen Melzer,Brian Baker,Jurgen Melzer,6-3; 6-3; 5-7; 6-3,R128,151,21,4,76,137,56,76,30,61,11,14,20,86,137,7,10,61,116,42,61,26,55,2,8,19,68,116
2003-08-25 00:00:00.000,US Open NY; U.S.A. Grand Slams,HARD,3,Tomas Berdych,Tomas Behrend,Tomas Berdych,5-7; 6-3; 6-2; 6-3,R128,127,23,4,61,103,49,61,26,42,8,10,19,75,103,6,8,83,131,54,83,20,48,17,23,19,74,131
2003-08-25 00:00:00.000,US Open NY; U.S.A. Grand Slams,HARD,3,Juan Ignacio Chela,Roko Karanusic,Juan Ignacio Chela,6-4; 7-6(2); 6-3,R128,113,7,7,60,99,52,60,20,39,6,7,16,72,99,4,3,56,96,41,56,22,40,9,12,15,63,96
2003-08-25 00:00:00.000,US Open NY; U.S.A. Grand Slams,HARD,3,Wayne Ferreira,Ivan Miranda,Wayne Ferreira,6-4; 6-3; 6-1,R128,92,8,3,43,77,37,43,20,34,1,1,13,57,77,2,1,55,98,33,55,20,43,7,12,13,53,98
2003-08-25 00:00:00.000,US Open NY; U.S.A. Grand Slams,HARD,3,Robby Ginepri,David Ferrer,Robby Ginepri,6-2; 6-3; 6-3,R128,94,2,3,53,87,31,53,23,34,2,4,13,54,87,0,8,53,92,25,53,18,39,7,14,13,43,92
2003-08-25 00:00:00.000,US Open NY; U.S.A. Grand Slams,HARD,3,Todd Martin,Robert Yim,Todd Martin,6-1; 7-6(7); 6-2,R128,101,12,5,48,83,39,48,21,35,1,3,14,60,83,2,7,39,83,24,39,21,44,3,9,13,45,83
2003-08-25 00:00:00.000,US Open NY; U.S.A. Grand Slams,HARD,3,Martin Verkerk,Alex Bogomolov Jr.,Martin Verkerk,7-6(4); 4-6; 3-6; 7-6(9); 1-0 RET,R128,219,33,8,79,145,67,79,31,66,5,9,21,98,145,12,6,100,169,74,100,35,69,4,7,23,109,169
2003-08-25 00:00:00.000,US Open NY; U.S.A. Grand Slams,HARD,3,Paradorn Srichaphan,Cyril Saulnier,Paradorn Srichaphan,2-6; 6-2; 6-3; 7-6(4),R128,159,13,8,55,115,47,55,32,60,4,7,19,79,115,9,7,64,133,45,64,35,69,9,13,18,80,133
2003-08-25 00:00:00.000,US Open NY; U.S.A. Grand Slams,HARD,3,Dominik Hrbaty,Justin Gimelstob,Dominik Hrbaty,6-3; 6-4; 6-2,R128,101,6,4,44,78,38,44,17,34,1,2,14,55,78,5,8,45,89,33,45,16,44,6,11,13,49,89
2003-08-25 00:00:00.000,US Open NY; U.S.A. Grand Slams,HARD,3,Davide Sanguinetti,Ruben Ramirez Hidalgo,Davide Sanguinetti,4-6; 6-0; 3-6; 6-1; 6-1,R128,156,6,4,63,115,47,63,29,52,8,11,19,76,115,9,10,67,128,45,67,22,61,4,13,20,67,128
2003-08-25 00:00:00.000,US Open NY; U.S.A. Grand Slams,HARD,3,Fernando Verdasco,Tommy Robredo,Fernando Verdasco,6-3; 6-4; 6-2,R128,96,7,6,41,75,35,41,23,34,3,4,14,58,75,0,8,54,95,30,54,21,41,8,13,13,51,95
2003-08-25 00:00:00.000,US Open NY; U.S.A. Grand Slams,HARD,3,Radek Stepanek,Feliciano Lopez,Radek Stepanek,6-4; 6-4; 6-4,R128,123,10,2,49,77,41,49,18,28,3,4,15,59,77,7,6,45,95,34,45,24,50,3,7,15,58,95
2003-08-25 00:00:00.000,US Open NY; U.S.A. Grand Slams,HARD,3,Fabrice Santoro,Julien Benneteau,Fabrice Santoro,0-6; 7-5; 6-2; 6-2,R128,143,5,4,74,103,47,74,14,29,8,13,17,61,103,4,5,64,102,38,64,17,38,5,12,17,55,102
2003-08-25 00:00:00.000,US Open NY; U.S.A. Grand Slams,HARD,3,Hyung-Taik Lee,Vladimir Voltchkov,Hyung-Taik Lee,6-3; 6-4; 7-6(3),R128,104,5,3,55,86,41,55,25,31,1,2,16,66,86,12,8,59,99,42,59,14,40,5,8,15,56,99
2003-08-25 00:00:00.000,US Open NY; U.S.A. Grand Slams,HARD,3,Lleyton Hewitt,Victor Hanescu,Lleyton Hewitt,6-3; 6-2; 6-2,R128,90,3,2,31,58,26,31,20,27,0,1,12,46,58,2,4,59,89,35,59,12,30,5,12,13,47,89
2003-08-25 00:00:00.000,US Open NY; U.S.A. Grand Slams,HARD,3,Rainer Schuettler,Wayne Arthurs,Rainer Schuettler,4-6; 6-3; 6-2; 6-4,R128,125,7,3,68,98,53,68,21,30,3,4,19,74,98,19,5,69,113,50,69,20,44,9,13,18,70,113
2003-08-25 00:00:00.000,US Open NY; U.S.A. Grand Slams,HARD,3,Nicolas Kiefer,Franco Squillari,Nicolas Kiefer,6-3; 5-0 RET,R128,51,2,2,14,35,13,14,16,21,0,0,7,29,35,1,6,16,38,13,16,5,22,0,4,7,18,38
2003-08-25 00:00:00.000,US Open NY; U.S.A. Grand Slams,HARD,3,Alberto Martin,Olivier Mutis,Alberto Martin,6-0; 6-3; 6-1,R128,85,3,8,39,65,30,39,14,26,3,5,11,44,65,1,6,29,76,16,29,13,47,3,12,11,29,76
2003-08-25 00:00:00.000,US Open NY; U.S.A. Grand Slams,HARD,3,Albert Costa,Raemon Sluiter,Albert Costa,7-6(5); 7-6(3); 2-6; 6-3,R128,186,12,3,78,129,52,78,30,51,2,6,21,82,129,9,10,77,126,60,77,23,49,6,9,20,83,126
2003-08-25 00:00:00.000,US Open NY; U.S.A. Grand Slams,HARD,3,Ivo Karlovic,Felix Mantilla,Ivo Karlovic,6-4; 6-4; 6-4,R128,96,24,5,48,83,40,48,24,35,3,3,15,64,83,1,2,56,88,39,56,18,32,4,7,15,57,88
2003-08-25 00:00:00.000,US Open NY; U.S.A. Grand Slams,HARD,3,Hicham Arazi,Jeff Salzenstein,Hicham Arazi,6-1; 7-6(4); 6-3,R128,95,2,1,60,91,47,60,21,31,2,2,15,68,91,5,3,50,75,36,50,11,25,0,3,13,47,75
2003-08-25 00:00:00.000,US Open NY; U.S.A. Grand Slams,HARD,3,Lars Burgsmuller,Luis Horna,Lars Burgsmuller,6-4; 4-6; 3-6; 7-5; 6-1,R128,187,20,8,67,125,47,67,33,58,1,8,24,80,125,8,10,92,162,60,92,31,70,10,19,24,91,162
2003-08-25 00:00:00.000,US Open NY; U.S.A. Grand Slams,HARD,3,Sjeng Schalken,Julien Boutter,Sjeng Schalken,6-2; 6-3; 6-2,R128,91,3,1,51,73,36,51,17,22,2,2,13,53,73,4,8,41,75,24,41,17,34,7,12,12,41,75
2003-08-25 00:00:00.000,US Open NY; U.S.A. Grand Slams,HARD,3,Dmitry Tursunov,Gustavo Kuerten,Dmitry Tursunov,5-7; 6-2; 6-2; 4-6; 7-6(1),R128,165,13,5,80,146,60,80,38,66,9,13,25,98,146,16,2,78,142,63,78,29,64,4,10,25,92,142
2003-08-25 00:00:00.000,US Open NY; U.S.A. Grand Slams,HARD,3,John van Lottum,Christophe Rochus,John van Lottum,6-0; 6-2; 6-2,R128,75,6,4,34,66,28,34,19,32,2,2,11,47,66,0,8,38,74,22,38,12,36,4,11,11,34,74
2003-08-25 00:00:00.000,US Open NY; U.S.A. Grand Slams,HARD,3,Xavier Malisse,Olivier Rochus,Xavier Malisse,6-3; 6-4; 6-2,R128,99,19,3,43,81,33,43,25,38,1,2,14,58,81,0,2,60,92,36,60,13,32,6,11,13,49,92
2003-08-25 00:00:00.000,US Open NY; U.S.A. Grand Slams,HARD,3,Agustin Calleri,Werner Eschauer,Agustin Calleri,7-6(4); 7-6(2); 1-6; 6-4,R128,162,13,6,70,126,56,70,34,56,5,8,20,90,126,10,4,69,121,59,69,28,52,6,8,21,87,121
2003-08-25 00:00:00.000,US Open NY; U.S.A. Grand Slams,HARD,3,Flavio Saretta,Vincent Spadea,Flavio Saretta,6-3; 6-1; 5-7; 7-6(8),R128,215,8,13,75,139,55,75,27,64,6,12,20,82,139,3,10,77,153,47,77,31,76,8,17,20,78,153
2003-08-25 00:00:00.000,US Open NY; U.S.A. Grand Slams,HARD,3,Nicolas Lapentti,Karol Beck,Nicolas Lapentti,4-6; 6-3; 7-5; 3-6; 6-4,R128,223,16,6,105,170,67,105,27,65,11,20,25,94,170,12,9,68,147,45,68,38,79,2,12,25,83,147
2003-08-25 00:00:00.000,US Open NY; U.S.A. Grand Slams,HARD,3,Ivan Ljubicic,Paul-Henri Mathieu,Ivan Ljubicic,6-4; 6-2; 7-5,R128,128,24,8,45,99,38,45,27,54,3,5,15,65,99,4,9,43,97,27,43,26,54,6,12,15,53,97
2003-08-25 00:00:00.000,US Open NY; U.S.A. Grand Slams,HARD,3,Andy Roddick,Tim Henman,Andy Roddick,6-3; 7-6(2); 6-3,R128,124,6,3,60,89,43,60,19,29,3,5,14,62,89,2,6,66,103,41,66,15,37,8,14,16,56,103
2003-08-25 00:00:00.000,US Open NY; U.S.A. Grand Slams,HARD,3,Carlos Moya,Scott Draper,Carlos Moya,4-6; 6-4; 7-5; 7-6(6),R128,153,26,5,86,139,68,86,33,53,9,11,22,101,139,7,3,78,127,57,78,33,49,1,4,22,90,127
2003-08-25 00:00:00.000,US Open NY; U.S.A. Grand Slams,HARD,3,Wesley Moodie,Albert Montanes,Wesley Moodie,7-6(3); 6-2; 6-2,R128,92,11,3,41,72,37,41,23,31,0,0,14,60,72,5,4,49,93,34,49,19,44,6,10,14,53,93
2003-08-25 00:00:00.000,US Open NY; U.S.A. Grand Slams,HARD,3,Thomas Enqvist,Albert Portas,Thomas Enqvist,6-2; 6-3; 6-1,R128,78,9,6,27,67,26,27,23,40,2,2,12,49,67,9,6,42,78,28,42,12,36,3,9,12,40,78
2003-08-25 00:00:00.000,US Open NY; U.S.A. Grand Slams,HARD,3,Nicolas Massu,Gaston Gaudio,Nicolas Massu,6-3; 6-3; 6-2,R128,131,6,5,66,101,42,66,22,35,5,6,13,64,101,6,5,48,87,29,48,17,39,3,9,13,46,87
2003-08-25 00:00:00.000,US Open NY; U.S.A. Grand Slams,HARD,3,Younes El Aynaoui,Alex Kim,Younes El Aynaoui,7-5; 7-6(5); 6-3,R128,144,21,4,87,117,67,87,12,30,8,10,17,79,117,2,4,87,131,60,87,18,44,11,15,16,78,131
2003-08-25 00:00:00.000,US Open NY; U.S.A. Grand Slams,HARD,3,Rafael Nadal,Fernando Vicente,Rafael Nadal,6-4; 6-3; 6-3,R128,133,2,4,46,82,37,46,23,36,3,3,14,60,82,9,8,65,111,44,65,19,46,14,18,14,63,111
2003-08-25 00:00:00.000,US Open NY; U.S.A. Grand Slams,HARD,3,Jan-Michael Gambill,David Sanchez,Jan-Michael Gambill,7-6(3); 6-2; 6-2,R128,125,13,4,51,99,42,51,25,48,5,6,14,67,99,5,4,50,97,37,50,16,47,5,10,14,53,97
2003-08-25 00:00:00.000,US Open NY; U.S.A. Grand Slams,HARD,3,Jiri Novak,Mario Ancic,Jiri Novak,3-6; 6-3; 5-7; 6-2; 6-2,R128,179,6,6,76,134,59,76,33,58,8,11,23,92,134,26,7,86,155,66,86,26,69,7,13,23,92,155
2003-08-25 00:00:00.000,US Open NY; U.S.A. Grand Slams,HARD,3,David Nalbandian,Philipp Kohlschreiber,David Nalbandian,6-4; 7-6(4); 6-3,R128,141,6,1,58,96,41,58,24,38,1,4,16,65,96,9,4,57,120,39,57,29,63,13,18,15,68,120
2003-08-25 00:00:00.000,US Open NY; U.S.A. Grand Slams,HARD,3,Jarkko Nieminen,Nicolas Mahut,Jarkko Nieminen,6-2; 6-4; 7-5,R128,109,8,4,54,94,42,54,16,40,7,10,15,58,94,17,11,58,108,38,58,19,50,8,15,15,57,108
2003-08-25 00:00:00.000,US Open NY; U.S.A. Grand Slams,HARD,3,Antony Dupuis,Mikhail Youzhny,Antony Dupuis,5-7; 6-4; 3-6; 6-3; 7-5,R128,209,9,2,99,168,70,99,40,69,9,13,26,110,168,9,6,109,155,74,109,27,46,9,14,26,101,155
2003-08-25 00:00:00.000,US Open NY; U.S.A. Grand Slams,HARD,3,Mark Philippoussis,Janko Tipsarevic,Mark Philippoussis,6-2; 7-6(4); 6-4,R128,110,20,7,55,94,41,55,23,39,5,7,15,64,94,7,2,49,86,29,49,22,37,3,8,15,51,86
2003-08-25 00:00:00.000,US Open NY; U.S.A. Grand Slams,HARD,3,James Blake,Mariano Zabaleta,James Blake,7-6(4); 6-3; 6-2,R128,109,8,3,68,100,51,68,19,32,4,6,15,70,100,3,6,66,106,41,66,18,40,10,15,14,59,106
2003-08-25 00:00:00.000,US Open NY; U.S.A. Grand Slams,HARD,3,Sargis Sargsian,Amer Delic,Sargis Sargsian,4-6; 6-3; 6-7(3); 6-2; 7-5,R128,195,2,11,103,148,74,103,24,45,8,13,26,98,148,18,3,110,176,72,110,31,66,13,21,25,103,176
2003-08-25 00:00:00.000,US Open NY; U.S.A. Grand Slams,HARD,3,Jean-Rene Lisnard,Magnus Norman,Jean-Rene Lisnard,6-2; 6-2; 6-7(4); 0-6; 7-6(4),R128,221,4,16,60,166,44,60,50,106,8,16,23,94,166,8,15,90,161,63,90,28,71,11,20,23,91,161
2003-08-25 00:00:00.000,US Open NY; U.S.A. Grand Slams,HARD,3,Roger Federer,Jose Acasuso,Roger Federer,5-7; 6-3; 6-3; 2-0 RET,R128,126,15,3,55,76,47,55,14,21,2,4,16,61,76,9,3,75,129,48,75,25,54,12,17,16,73,129
2003-08-25 00:00:00.000,US Open NY; U.S.A. Grand Slams,HARD,3,Andre Agassi,Andreas Vinciguerra,Andre Agassi,7-6(1); 6-1; 6-4,R64,111,5,1,53,87,40,53,23,34,2,4,15,63,87,10,3,74,111,47,74,13,37,10,15,14,60,111
2003-08-25 00:00:00.000,US Open NY; U.S.A. Grand Slams,HARD,3,Yevgeny Kafelnikov,Kenneth Carlsen,Yevgeny Kafelnikov,4-6; 6-2; 6-3; 6-3,R64,147,4,1,67,107,48,67,27,40,5,7,18,75,107,17,4,66,120,48,66,21,54,2,8,18,69,120
2003-08-25 00:00:00.000,US Open NY; U.S.A. Grand Slams,HARD,3,Taylor Dent,Nikolay Davydenko,Taylor Dent,6-3; 6-4; 7-6(7),R64,123,8,12,65,107,53,65,23,42,5,5,16,76,107,1,1,101,113,64,101,7,12,4,6,15,71,113
2003-08-25 00:00:00.000,US Open NY; U.S.A. Grand Slams,HARD,3,Fernando Gonzalez,Stefan Koubek,Fernando Gonzalez,7-6(1); 6-1; 6-2,R64,89,7,6,51,81,40,51,16,30,1,3,14,56,81,1,7,71,98,40,71,10,27,5,11,13,50,98
2003-08-25 00:00:00.000,US Open NY; U.S.A. Grand Slams,HARD,3,Jonas Bjorkman,Ramon Delgado,Jonas Bjorkman,4-6; 6-4; 6-4; 3-6; 6-3,R64,197,17,1,67,128,59,67,35,61,2,4,24,94,128,15,10,112,187,72,112,45,75,15,18,24,117,187
2003-08-25 00:00:00.000,US Open NY; U.S.A. Grand Slams,HARD,3,Karol Kucera,Mardy Fish,Karol Kucera,6-4; 7-6(7); 6-4,R64,155,11,5,59,108,45,59,24,49,6,9,16,69,108,10,10,49,98,36,49,24,49,1,6,16,60,98
2003-08-25 00:00:00.000,US Open NY; U.S.A. Grand Slams,HARD,3,Gregory Carraz,Arnaud Clement,Gregory Carraz,3-6; 1-6; 6-2; 7-6(3); 6-1,R64,193,25,12,79,147,62,79,29,68,4,9,22,91,147,6,2,68,128,50,68,30,60,4,9,21,80,128
2003-08-25 00:00:00.000,US Open NY; U.S.A. Grand Slams,HARD,3,Guillermo Coria,Bohdan Ulihrach,Guillermo Coria,6-2; 6-1; 6-4,R64,90,9,3,48,72,38,48,15,24,3,3,13,53,72,6,4,42,83,28,42,19,41,11,16,12,47,83
2003-08-25 00:00:00.000,US Open NY; U.S.A. Grand Slams,HARD,3,Juan Carlos Ferrero,Jurgen Melzer,Juan Carlos Ferrero,1-6; 7-6(2); 6-2; 6-4,R64,145,9,6,61,105,47,61,28,44,3,5,18,75,105,19,10,69,140,57,69,27,71,10,13,19,84,140
2003-08-25 00:00:00.000,US Open NY; U.S.A. Grand Slams,HARD,3,Juan Ignacio Chela,Tomas Berdych,Juan Ignacio Chela,2-6; 6-1; 6-4; 6-3,R64,128,6,10,69,113,48,69,23,44,7,11,17,71,113,4,7,48,111,30,48,28,63,6,13,17,58,111
2003-08-25 00:00:00.000,US Open NY; U.S.A. Grand Slams,HARD,3,Robby Ginepri,Wayne Ferreira,Robby Ginepri,6-2; 6-4; 6-7(0); 6-2,R64,130,7,3,80,119,56,80,23,39,2,4,19,79,119,9,2,67,116,44,67,23,49,6,13,19,67,116
2003-08-25 00:00:00.000,US Open NY; U.S.A. Grand Slams,HARD,3,Todd Martin,Martin Verkerk,Todd Martin,6-3; 6-4; 6-7(5); 7-6(9),R64,180,17,10,101,146,81,101,25,45,2,3,22,106,146,26,12,73,131,64,73,29,58,4,7,21,93,131
2003-08-25 00:00:00.000,US Open NY; U.S.A. Grand Slams,HARD,3,Paradorn Srichaphan,Dominik Hrbaty,Paradorn Srichaphan,6-4; 6-4; 6-3,R64,101,12,2,52,80,41,52,18,28,0,0,14,59,80,11,3,51,89,37,51,19,38,2,6,15,56,89
2003-08-25 00:00:00.000,US Open NY; U.S.A. Grand Slams,HARD,3,Fernando Verdasco,Davide Sanguinetti,Fernando Verdasco,7-6(6); 7-6(5); 4-6; 6-3,R64,165,11,9,81,136,60,81,31,55,4,8,22,91,136,7,3,92,148,63,92,27,56,6,10,21,90,148
2003-08-25 00:00:00.000,US Open NY; U.S.A. Grand Slams,HARD,3,Radek Stepanek,Fabrice Santoro,Radek Stepanek,6-2; 6-4; 6-7(6); 6-3,R64,191,18,8,79,140,61,79,29,61,7,10,19,90,140,3,9,71,135,47,71,27,64,5,13,20,74,135
2003-08-25 00:00:00.000,US Open NY; U.S.A. Grand Slams,HARD,3,Lleyton Hewitt,Hyung-Taik Lee,Lleyton Hewitt,5-7; 6-2; 6-2; 6-4,R64,160,7,7,59,120,42,59,33,61,7,11,19,75,120,5,3,64,114,43,64,21,50,10,18,19,64,114
2003-08-25 00:00:00.000,US Open NY; U.S.A. Grand Slams,HARD,3,Rainer Schuettler,Nicolas Kiefer,Rainer Schuettler,6-1; 7-5; 2-6; 6-4,R64,183,8,4,71,123,44,71,33,52,5,8,18,77,123,9,3,64,133,44,64,33,69,7,13,19,77,133
2003-08-25 00:00:00.000,US Open NY; U.S.A. Grand Slams,HARD,3,Alberto Martin,Albert Costa,Alberto Martin,6-3; 6-3; 3-6; 6-2,R64,151,3,6,55,99,43,55,26,44,5,7,18,69,99,7,3,73,117,49,73,18,44,11,16,17,67,117
2003-08-25 00:00:00.000,US Open NY; U.S.A. Grand Slams,HARD,3,Ivo Karlovic,Hicham Arazi,Ivo Karlovic,3-6; 7-6(5); 7-6(4); 7-6(6),R64,176,30,14,82,145,73,82,36,63,6,7,22,109,145,3,1,81,136,64,81,42,55,1,1,23,106,136
2003-08-25 00:00:00.000,US Open NY; U.S.A. Grand Slams,HARD,3,Sjeng Schalken,Lars Burgsmuller,Sjeng Schalken,4-6; 2-6; 6-2; 6-2; 6-0,R64,169,4,6,70,112,45,70,25,42,4,9,20,70,112,6,3,57,112,36,57,28,55,6,15,20,64,112
2003-08-25 00:00:00.000,US Open NY; U.S.A. Grand Slams,HARD,3,Dmitry Tursunov,John van Lottum,Dmitry Tursunov,6-4; 3-6; 6-3; 5-7; 6-2,R64,201,30,8,90,159,71,90,30,69,7,11,24,101,159,9,11,101,174,66,101,38,73,18,24,24,104,174
2003-08-25 00:00:00.000,US Open NY; U.S.A. Grand Slams,HARD,3,Xavier Malisse,Agustin Calleri,Xavier Malisse,6-2; 6-7(3); 6-3; 3-6; 6-3,R64,179,10,6,58,134,50,58,37,76,4,9,24,87,134,11,5,73,138,55,73,30,65,7,15,23,85,138
2003-08-25 00:00:00.000,US Open NY; U.S.A. Grand Slams,HARD,3,Flavio Saretta,Nicolas Lapentti,Flavio Saretta,6-2; 6-4; 6-0,R64,81,6,2,35,58,33,35,15,23,0,0,12,48,58,2,2,43,62,25,43,6,19,3,9,12,31,62
2003-08-25 00:00:00.000,US Open NY; U.S.A. Grand Slams,HARD,3,Andy Roddick,Ivan Ljubicic,Andy Roddick,6-3; 6-7(4); 6-3; 7-6(8),R64,183,22,3,95,143,72,95,30,48,9,10,22,102,143,22,6,80,144,64,80,29,64,10,13,20,93,144
2003-08-25 00:00:00.000,US Open NY; U.S.A. Grand Slams,HARD,3,Carlos Moya,Wesley Moodie,Carlos Moya,6-2; 7-6(6); 6-3,R64,128,7,2,47,97,38,47,30,50,6,8,15,68,97,4,5,71,107,46,71,13,36,6,11,14,59,107
2003-08-25 00:00:00.000,US Open NY; U.S.A. Grand Slams,HARD,3,Nicolas Massu,Thomas Enqvist,Nicolas Massu,6-3; 6-2; 7-5,R64,138,4,2,51,82,36,51,16,31,1,4,14,52,82,4,14,52,112,38,52,16,60,5,13,15,54,112
2003-08-25 00:00:00.000,US Open NY; U.S.A. Grand Slams,HARD,3,Younes El Aynaoui,Rafael Nadal,Younes El Aynaoui,7-6(6); 6-3; 7-6(6),R64,163,15,2,76,112,58,76,21,36,3,5,17,79,112,3,6,83,109,59,83,13,26,9,12,16,72,109
2003-08-25 00:00:00.000,US Open NY; U.S.A. Grand Slams,HARD,3,Jiri Novak,Jan-Michael Gambill,Jiri Novak,6-4; 6-4; 6-4,R64,122,8,2,56,85,47,56,11,29,3,5,15,58,85,8,2,45,104,32,45,27,59,7,12,15,59,104
2003-08-25 00:00:00.000,US Open NY; U.S.A. Grand Slams,HARD,3,David Nalbandian,Jarkko Nieminen,David Nalbandian,5-7; 6-3; 6-1; 4-6; 7-6(3),R64,218,5,5,75,150,58,75,43,75,6,10,25,101,150,9,7,82,168,60,82,42,86,9,15,25,102,168
2003-08-25 00:00:00.000,US Open NY; U.S.A. Grand Slams,HARD,3,Mark Philippoussis,Antony Dupuis,Mark Philippoussis,6-2; 6-3; 6-4,R64,119,21,10,45,90,40,45,23,45,6,6,14,63,90,6,3,52,92,37,52,16,40,9,13,13,53,92
2003-08-25 00:00:00.000,US Open NY; U.S.A. Grand Slams,HARD,3,James Blake,Sargis Sargsian,James Blake,6-3; 6-4; 4-6; 7-6(6),R64,175,6,6,92,133,64,92,19,41,10,15,20,83,133,5,6,114,169,68,114,25,55,12,19,21,93,169
2003-08-25 00:00:00.000,US Open NY; U.S.A. Grand Slams,HARD,3,Roger Federer,Jean-Rene Lisnard,Roger Federer,6-1; 6-2; 6-0,R64,77,5,2,41,61,34,41,12,20,1,1,11,46,61,0,8,33,76,16,33,18,43,7,14,10,34,76
2003-08-25 00:00:00.000,US Open NY; U.S.A. Grand Slams,HARD,3,Andre Agassi,Yevgeny Kafelnikov,Andre Agassi,6-3; 7-6(4); 6-4,R32,115,6,2,57,96,39,57,20,39,6,10,15,59,96,10,5,47,98,32,47,19,51,4,11,16,51,98
2003-08-25 00:00:00.000,US Open NY; U.S.A. Grand Slams,HARD,3,Taylor Dent,Fernando Gonzalez,Taylor Dent,7-6(9); 6-7(3); 3-6; 7-6(4); 6-4,R32,200,26,15,100,181,84,100,45,81,15,19,28,129,181,11,10,118,170,92,118,31,52,5,8,27,123,170
2003-08-25 00:00:00.000,US Open NY; U.S.A. Grand Slams,HARD,3,Jonas Bjorkman,Karol Kucera,Jonas Bjorkman,6-4; 4-6; 6-7(3); 6-4; 6-4,R32,278,5,9,104,196,69,104,41,92,16,23,26,110,196,16,9,105,183,65,105,37,78,16,25,26,102,183
2003-08-25 00:00:00.000,US Open NY; U.S.A. Grand Slams,HARD,3,Guillermo Coria,Gregory Carraz,Guillermo Coria,7-5; 6-1; 7-5,R32,133,3,2,70,104,49,70,25,34,10,10,16,74,104,9,10,71,108,48,71,16,37,7,11,15,64,108
2003-08-25 00:00:00.000,US Open NY; U.S.A. Grand Slams,HARD,3,Juan Carlos Ferrero,Juan Ignacio Chela,Juan Carlos Ferrero,7-5; 7-5; 6-1,R32,129,3,3,50,97,33,50,25,47,9,14,15,58,97,3,7,62,98,34,62,11,36,3,13,16,45,98
2003-08-25 00:00:00.000,US Open NY; U.S.A. Grand Slams,HARD,3,Todd Martin,Robby Ginepri,Todd Martin,6-7(2); 7-6(4); 6-4; 6-4,R32,180,15,3,97,140,73,97,25,43,4,6,22,98,140,21,7,99,161,71,99,30,62,11,15,22,101,161
2003-08-25 00:00:00.000,US Open NY; U.S.A. Grand Slams,HARD,3,Paradorn Srichaphan,Fernando Verdasco,Paradorn Srichaphan,6-3; 6-4; 6-3,R32,86,5,4,40,73,36,40,22,33,1,1,14,58,73,7,5,49,82,34,49,16,33,2,6,14,50,82
2003-08-25 00:00:00.000,US Open NY; U.S.A. Grand Slams,HARD,3,Lleyton Hewitt,Radek Stepanek,Lleyton Hewitt,6-1; 3-0 RET,R32,42,5,3,16,31,15,16,7,15,4,4,5,22,31,1,3,17,27,5,17,2,10,1,5,5,7,27
2003-08-25 00:00:00.000,US Open NY; U.S.A. Grand Slams,HARD,3,Rainer Schuettler,Alberto Martin,Rainer Schuettler,6-1; 6-4; 6-2,R32,101,5,1,48,71,40,48,14,23,2,2,13,54,71,0,1,54,72,32,54,8,18,3,8,12,40,72
2003-08-25 00:00:00.000,US Open NY; U.S.A. Grand Slams,HARD,3,Sjeng Schalken,Ivo Karlovic,Sjeng Schalken,7-6(8); 7-6(5); 7-6(3),R32,140,2,2,93,120,74,93,17,27,4,5,18,91,120,24,6,71,108,59,71,22,37,1,2,18,81,108
2003-08-25 00:00:00.000,US Open NY; U.S.A. Grand Slams,HARD,3,Xavier Malisse,Dmitry Tursunov,Xavier Malisse,7-5; 6-4; 7-6(8),R32,119,9,2,51,103,39,51,27,52,1,5,17,66,103,7,5,67,111,43,67,17,44,4,10,17,60,111
2003-08-25 00:00:00.000,US Open NY; U.S.A. Grand Slams,HARD,3,Andy Roddick,Flavio Saretta,Andy Roddick,6-1; 6-3; 6-3,R32,86,10,1,33,65,28,33,27,32,2,2,13,55,65,8,4,41,77,28,41,14,36,10,15,12,42,77
2003-08-25 00:00:00.000,US Open NY; U.S.A. Grand Slams,HARD,3,Carlos Moya,Nicolas Massu,Carlos Moya,7-5; 6-4; 3-6; 6-3,R32,174,11,3,54,106,40,54,31,52,0,4,20,71,106,6,10,71,132,50,71,24,61,8,14,20,74,132
2003-08-25 00:00:00.000,US Open NY; U.S.A. Grand Slams,HARD,3,Younes El Aynaoui,Jiri Novak,Younes El Aynaoui,7-6(1); 5-7; 3-6; 6-3; 7-6(5),R32,208,27,1,129,170,96,129,18,41,6,10,27,114,170,7,7,109,171,81,109,34,62,11,14,27,115,171
2003-08-25 00:00:00.000,US Open NY; U.S.A. Grand Slams,HARD,3,David Nalbandian,Mark Philippoussis,David Nalbandian,7-5; 6-7(10); 6-3; 6-2,R32,193,5,4,66,130,52,66,40,64,4,6,21,92,130,34,9,95,148,71,95,16,53,10,16,20,87,148
2003-08-25 00:00:00.000,US Open NY; U.S.A. Grand Slams,HARD,3,Roger Federer,James Blake,Roger Federer,6-3; 7-6(4); 6-3,R32,119,10,3,62,101,47,62,25,39,3,4,16,72,101,5,6,78,128,53,78,23,50,20,23,14,76,128
2003-08-25 00:00:00.000,US Open NY; U.S.A. Grand Slams,HARD,3,Andre Agassi,Taylor Dent,Andre Agassi,6-7(5); 6-4; 7-5 RET,R16,143,2,5,74,126,50,74,26,52,7,11,17,76,126,9,12,54,111,34,54,30,57,6,12,17,64,111
2003-08-25 00:00:00.000,US Open NY; U.S.A. Grand Slams,HARD,3,Guillermo Coria,Jonas Bjorkman,Guillermo Coria,6-2; 6-3; 4-6; 6-2,R16,169,7,3,69,107,49,69,23,38,3,5,17,72,107,9,5,84,146,47,84,32,62,18,25,18,79,146
2003-08-25 00:00:00.000,US Open NY; U.S.A. Grand Slams,HARD,3,Juan Carlos Ferrero,Todd Martin,Juan Carlos Ferrero,6-2; 6-4; 3-6; 5-7; 6-3,R16,203,12,5,90,139,67,90,28,49,10,13,24,95,139,24,11,88,164,67,88,34,76,12,17,24,101,164
2003-08-25 00:00:00.000,US Open NY; U.S.A. Grand Slams,HARD,3,Lleyton Hewitt,Paradorn Srichaphan,Lleyton Hewitt,4-6; 6-2; 6-4; 6-2,R16,144,6,3,56,99,40,56,25,43,2,6,18,65,99,6,8,70,116,44,70,17,46,8,16,18,61,116
2003-08-25 00:00:00.000,US Open NY; U.S.A. Grand Slams,HARD,3,Sjeng Schalken,Rainer Schuettler,Sjeng Schalken,6-1; 4-6; 6-3; 6-4,R16,151,3,1,71,105,47,71,24,34,5,7,18,71,105,10,3,61,117,39,61,27,56,7,13,18,66,117
2003-08-25 00:00:00.000,US Open NY; U.S.A. Grand Slams,HARD,3,Andy Roddick,Xavier Malisse,Andy Roddick,6-3; 6-4; 7-6(5),R16,119,9,0,57,90,52,57,21,33,5,5,16,73,90,12,4,56,107,44,56,25,51,6,8,15,69,107
2003-08-25 00:00:00.000,US Open NY; U.S.A. Grand Slams,HARD,3,Younes El Aynaoui,Carlos Moya,Younes El Aynaoui,7-6(4); 7-6(7); 4-6; 6-4,R16,189,18,3,95,150,78,95,27,55,7,8,22,105,150,10,7,81,133,60,81,35,52,3,4,22,95,133
2003-08-25 00:00:00.000,US Open NY; U.S.A. Grand Slams,HARD,3,David Nalbandian,Roger Federer,David Nalbandian,3-6; 7-6(1); 6-4; 6-3,R16,172,3,4,67,112,45,67,28,45,5,9,19,73,112,16,4,78,143,52,78,28,65,10,16,21,80,143
2003-08-25 00:00:00.000,US Open NY; U.S.A. Grand Slams,HARD,3,Andre Agassi,Guillermo Coria,Andre Agassi,6-4; 6-3; 7-5,Q,125,7,3,49,93,40,49,24,44,1,3,16,64,93,9,3,67,106,41,67,20,39,9,14,15,61,106
2003-08-25 00:00:00.000,US Open NY; U.S.A. Grand Slams,HARD,3,Juan Carlos Ferrero,Lleyton Hewitt,Juan Carlos Ferrero,4-6; 6-3; 7-6(5); 6-1,Q,167,21,4,74,127,55,74,31,53,10,13,20,86,127,8,4,61,117,42,61,28,56,7,12,18,70,117
2003-08-25 00:00:00.000,US Open NY; U.S.A. Grand Slams,HARD,3,Andy Roddick,Sjeng Schalken,Andy Roddick,6-4; 6-2; 6-3,Q,84,15,0,50,75,44,50,13,25,5,6,14,57,75,1,2,53,73,29,53,10,20,3,8,13,39,73
2003-08-25 00:00:00.000,US Open NY; U.S.A. Grand Slams,HARD,3,David Nalbandian,Younes El Aynaoui,David Nalbandian,7-6(2); 6-2; 3-6; 7-5,Q,178,5,4,83,116,65,83,18,33,3,7,20,83,116,16,5,96,146,64,96,20,50,12,18,21,84,146
2003-08-25 00:00:00.000,US Open NY; U.S.A. Grand Slams,HARD,3,Juan Carlos Ferrero,Andre Agassi,Juan Carlos Ferrero,6-4; 6-3; 3-6; 6-4,S,154,10,8,76,130,57,76,23,54,8,12,19,80,130,12,9,67,130,50,67,27,63,8,14,19,77,130
2003-08-25 00:00:00.000,US Open NY; U.S.A. Grand Slams,HARD,3,Andy Roddick,David Nalbandian,Andy Roddick,6-7(4); 3-6; 7-6(7); 6-1; 6-3,S,211,38,7,95,152,77,95,33,57,6,7,24,110,152,5,2,130,175,84,130,29,45,9,13,25,113,175
2003-08-25 00:00:00.000,US Open NY; U.S.A. Grand Slams,HARD,3,Andy Roddick,Juan Carlos Ferrero,Andy Roddick,6-3; 7-6(2); 6-3,F,101,23,2,55,87,49,55,19,32,3,3,16,68,87,7,1,57,90,42,57,15,33,3,5,14,57,90
2003-09-08 00:00:00.000,Bucharest Romania ATP World Tour,CLAY,2,Igor Andreev,Nikolay Davydenko,Igor Andreev,7-5; 6-7(1); 6-0,R32,136,1,3,73,100,51,73,12,27,4,6,15,63,100,1,4,81,104,48,81,10,23,5,11,15,58,104
2003-09-08 00:00:00.000,Bucharest Romania ATP World Tour,CLAY,2,Jose Acasuso,Andreas Seppi,Jose Acasuso,2-6; 6-3; 6-4,R32,100,2,3,56,90,39,56,18,34,10,13,14,57,90,4,2,48,82,30,48,20,34,6,9,13,50,82
2003-09-08 00:00:00.000,Bucharest Romania ATP World Tour,CLAY,2,John van Lottum,Albert Montanes,John van Lottum,3-6; 6-2; 6-0,R32,84,3,3,37,68,29,37,13,31,0,3,11,42,68,1,1,45,63,22,45,8,18,3,10,12,30,63
2003-09-08 00:00:00.000,Bucharest Romania ATP World Tour,CLAY,2,Galo Blanco,David Ferrer,Galo Blanco,6-2; 6-3,R32,61,0,0,29,51,19,29,13,22,3,5,9,32,51,0,3,22,41,11,22,6,19,0,5,8,17,41
2003-09-08 00:00:00.000,Bucharest Romania ATP World Tour,CLAY,2,David Sanchez,Alex Corretja,David Sanchez,6-2; 6-3,R32,99,0,2,32,52,19,32,14,20,4,5,8,33,52,0,2,32,71,18,32,17,39,5,10,9,35,71
2003-09-08 00:00:00.000,Bucharest Romania ATP World Tour,CLAY,2,Jurgen Melzer,Karol Beck,Jurgen Melzer,4-6; 6-1; 7-6(9),R32,126,8,5,44,99,33,44,28,55,4,8,15,61,99,6,9,52,108,33,52,27,56,6,11,14,60,108
2003-09-08 00:00:00.000,Bucharest Romania ATP World Tour,CLAY,2,Albert Portas,Gabriel Moraru,Albert Portas,6-3; 6-1,R32,63,5,3,20,50,15,20,19,30,1,2,8,34,50,1,1,32,52,18,32,5,20,5,10,8,23,52
2003-09-08 00:00:00.000,Bucharest Romania ATP World Tour,CLAY,2,Paul-Henri Mathieu,Stefan Koubek,Paul-Henri Mathieu,6-2; 6-3,R32,84,1,2,25,53,18,25,18,28,1,1,8,36,53,2,2,37,63,21,37,12,26,9,13,9,33,63
2003-09-08 00:00:00.000,Bucharest Romania ATP World Tour,CLAY,2,Alberto Martin,Olivier Mutis,Alberto Martin,6-3; 6-2,R32,68,1,3,30,53,22,30,12,23,2,4,9,34,53,0,4,29,52,17,29,8,23,4,9,8,25,52
2003-09-08 00:00:00.000,Bucharest Romania ATP World Tour,CLAY,2,Razvan Sabau,Ruben Ramirez Hidalgo,Razvan Sabau,6-3; 6-1,R32,74,0,1,24,53,17,24,17,29,1,2,8,34,53,2,1,31,47,17,31,5,16,4,9,8,22,47
2003-09-08 00:00:00.000,Bucharest Romania ATP World Tour,CLAY,2,Ion Moldovan,Tomas Behrend,Ion Moldovan,6-4; 6-1,R32,63,3,1,27,53,25,27,15,26,2,2,9,40,53,1,1,28,44,17,28,6,16,2,5,8,23,44
2003-09-08 00:00:00.000,Bucharest Romania ATP World Tour,CLAY,2,Sargis Sargsian,Franco Squillari,Sargis Sargsian,6-2; 6-2,R32,70,2,4,30,53,21,30,14,23,2,3,8,35,53,1,1,21,44,9,21,10,23,3,8,8,19,44
2003-09-08 00:00:00.000,Bucharest Romania ATP World Tour,CLAY,2,Christophe Rochus,Fernando Vicente,Christophe Rochus,6-3; 6-0,R32,60,1,0,38,53,23,38,10,15,4,5,8,33,53,2,3,25,46,14,25,5,21,2,7,7,19,46
2003-09-08 00:00:00.000,Bucharest Romania ATP World Tour,CLAY,2,Victor Hanescu,Alexander Waske,Victor Hanescu,4-6; 6-4; 7-6(7),R32,141,7,0,61,95,49,61,23,34,3,4,16,72,95,9,3,67,107,57,67,19,40,5,6,16,76,107
2003-09-08 00:00:00.000,Bucharest Romania ATP World Tour,CLAY,2,Frantisek Cermak,Lars Burgsmuller,Frantisek Cermak,6-7(3); 6-4; 6-2,R32,138,1,6,47,101,35,47,30,54,6,9,15,65,101,6,4,43,94,26,43,28,51,7,13,15,54,94
2003-09-08 00:00:00.000,Bucharest Romania ATP World Tour,CLAY,2,Nicolas Massu,Luis Horna,Nicolas Massu,7-6(4); 6-3,R32,109,4,1,41,61,29,41,14,20,0,2,11,43,61,4,5,44,78,28,44,14,34,2,5,10,42,78
2003-09-08 00:00:00.000,Bucharest Romania ATP World Tour,CLAY,2,Jose Acasuso,Igor Andreev,Jose Acasuso,6-2; 4-6; 6-2,R16,0,4,5,48,86,36,48,18,38,10,13,13,54,86,0,2,53,80,29,53,13,27,3,9,13,42,80
2003-09-08 00:00:00.000,Bucharest Romania ATP World Tour,CLAY,2,John van Lottum,Galo Blanco,John van Lottum,6-1; 7-6(6),R16,97,2,0,46,72,37,46,11,26,6,7,10,48,72,2,2,39,68,22,39,15,29,4,7,9,37,68
2003-09-08 00:00:00.000,Bucharest Romania ATP World Tour,CLAY,2,David Sanchez,Jurgen Melzer,David Sanchez,7-6(2); 6-4,R16,88,3,1,31,57,23,31,23,26,0,1,11,46,57,4,4,50,79,33,50,15,29,5,7,11,48,79
2003-09-08 00:00:00.000,Bucharest Romania ATP World Tour,CLAY,2,Paul-Henri Mathieu,Albert Portas,Paul-Henri Mathieu,6-2; 6-1,R16,56,4,0,20,38,18,20,14,18,0,0,8,32,38,1,4,21,40,12,21,6,19,5,9,7,18,40
2003-09-08 00:00:00.000,Bucharest Romania ATP World Tour,CLAY,2,Razvan Sabau,Alberto Martin,Razvan Sabau,6-4; 0-6; 6-4,R16,125,4,2,69,107,42,69,18,38,5,8,13,60,107,4,3,49,68,36,49,10,19,1,3,13,46,68
2003-09-08 00:00:00.000,Bucharest Romania ATP World Tour,CLAY,2,Sargis Sargsian,Ion Moldovan,Sargis Sargsian,7-5; 6-1,R16,72,2,1,39,53,31,39,6,14,1,3,10,37,53,1,3,28,50,17,28,6,22,1,6,9,23,50
2003-09-08 00:00:00.000,Bucharest Romania ATP World Tour,CLAY,2,Victor Hanescu,Christophe Rochus,Victor Hanescu,6-3; 6-4,R16,77,6,1,51,76,39,51,12,25,4,4,10,51,76,2,1,37,56,21,37,12,19,2,4,9,33,56
2003-09-08 00:00:00.000,Bucharest Romania ATP World Tour,CLAY,2,Nicolas Massu,Frantisek Cermak,Nicolas Massu,6-3; 6-3,R16,99,2,2,39,60,24,39,15,21,8,10,9,39,60,4,1,30,63,17,30,12,33,7,12,9,29,63
2003-09-08 00:00:00.000,Bucharest Romania ATP World Tour,CLAY,2,Jose Acasuso,John van Lottum,Jose Acasuso,4-6; 6-2; 6-3,Q,185,3,5,45,88,32,45,28,43,3,5,14,60,88,5,2,51,94,33,51,21,43,10,14,13,54,94
2003-09-08 00:00:00.000,Bucharest Romania ATP World Tour,CLAY,2,David Sanchez,Paul-Henri Mathieu,David Sanchez,6-4; 3-6; 6-3,Q,145,4,3,45,90,29,45,25,45,4,8,14,54,90,2,0,39,85,21,39,28,46,2,7,14,49,85
2003-09-08 00:00:00.000,Bucharest Romania ATP World Tour,CLAY,2,Razvan Sabau,Sargis Sargsian,Razvan Sabau,2-6; 6-3; 6-4,Q,123,1,2,53,82,30,53,14,29,7,13,14,44,82,4,5,66,93,40,66,8,27,12,18,13,48,93
2003-09-08 00:00:00.000,Bucharest Romania ATP World Tour,CLAY,2,Nicolas Massu,Victor Hanescu,Nicolas Massu,6-4; 6-1,Q,94,3,0,34,53,24,34,9,19,4,6,8,33,53,0,2,43,62,19,43,10,19,7,13,9,29,62
2003-09-08 00:00:00.000,Bucharest Romania ATP World Tour,CLAY,2,David Sanchez,Jose Acasuso,David Sanchez,6-7(4); 7-6(6); 6-3,S,162,1,4,75,118,49,75,24,43,7,11,17,73,118,5,5,58,111,39,58,27,53,5,10,16,66,111
2003-09-08 00:00:00.000,Bucharest Romania ATP World Tour,CLAY,2,Nicolas Massu,Razvan Sabau,Nicolas Massu,6-1; 6-4,S,82,2,3,34,51,28,34,6,17,4,5,8,34,51,3,2,37,58,19,37,8,21,4,9,9,27,58
2003-09-08 00:00:00.000,Bucharest Romania ATP World Tour,CLAY,2,David Sanchez,Nicolas Massu,David Sanchez,6-2; 6-2,F,80,1,0,29,49,19,29,13,20,4,5,8,32,49,2,0,31,48,16,31,4,17,2,7,8,20,48
2003-09-08 00:00:00.000,Costa Do Sauipe Brasil ATP World Tour,HARD,2,Rainer Schuettler,Andre Sa,Rainer Schuettler,6-2; 6-0,R32,62,6,0,29,48,22,29,11,19,4,4,7,33,48,2,0,24,45,11,24,9,21,4,9,7,20,45
2003-09-08 00:00:00.000,Costa Do Sauipe Brasil ATP World Tour,HARD,2,Paul Goldstein,Federico Browne,Paul Goldstein,6-2; 6-0,R32,53,5,0,15,35,14,15,14,20,0,0,7,28,35,0,6,21,54,12,21,10,33,5,10,7,22,54
2003-09-08 00:00:00.000,Costa Do Sauipe Brasil ATP World Tour,HARD,2,Ramon Delgado,Mariano Puerta,Ramon Delgado,6-3; 5-1 RET,R32,62,9,1,32,52,26,32,11,20,3,3,8,37,52,3,2,26,45,15,26,11,19,4,7,7,26,45
2003-09-08 00:00:00.000,Costa Do Sauipe Brasil ATP World Tour,HARD,2,Flavio Saretta,Marcos Daniel,Flavio Saretta,6-4; 6-3,R32,86,7,1,30,46,24,30,10,16,0,1,9,34,46,2,2,48,77,29,48,11,29,3,7,10,40,77
2003-09-08 00:00:00.000,Costa Do Sauipe Brasil ATP World Tour,HARD,2,Gustavo Kuerten,Magnus Norman,Gustavo Kuerten,6-3; 6-2,R32,60,11,1,37,56,29,37,10,19,0,0,9,39,56,5,4,17,42,13,17,11,25,1,4,8,24,42
2003-09-08 00:00:00.000,Costa Do Sauipe Brasil ATP World Tour,HARD,2,Werner Eschauer,Julio Silva,Werner Eschauer,5-7; 7-6(2); 7-6(1),R32,197,10,3,68,137,51,68,35,69,6,10,18,86,137,4,0,76,123,51,76,25,47,9,12,18,76,123
2003-09-08 00:00:00.000,Costa Do Sauipe Brasil ATP World Tour,HARD,2,Ricardo Mello,Paul Capdeville,Ricardo Mello,6-7(4); 6-0; 6-1,R32,100,1,1,48,74,34,48,17,26,2,4,13,51,74,4,11,40,77,22,40,13,37,3,10,12,35,77
2003-09-08 00:00:00.000,Costa Do Sauipe Brasil ATP World Tour,HARD,2,Juan Ignacio Chela,Todd Larkham,Juan Ignacio Chela,6-4; 2-6; 6-1,R32,104,4,2,45,73,29,45,12,28,5,11,13,41,73,1,4,49,71,24,49,10,22,7,14,12,34,71
2003-09-08 00:00:00.000,Costa Do Sauipe Brasil ATP World Tour,HARD,2,Kenneth Carlsen,Franco Ferreiro,Kenneth Carlsen,4-6; 6-4; 7-6(11),R32,0,7,4,55,96,45,55,20,41,2,6,16,65,96,6,10,62,115,43,62,30,53,7,11,16,73,115
2003-09-08 00:00:00.000,Costa Do Sauipe Brasil ATP World Tour,HARD,2,Wesley Moodie,Ivan Miranda,Wesley Moodie,6-4; 6-4,R32,65,10,1,38,53,30,38,11,15,1,1,10,41,53,1,1,36,57,27,36,9,21,1,3,10,36,57
2003-09-08 00:00:00.000,Costa Do Sauipe Brasil ATP World Tour,HARD,2,Gaston Etlis,Brian Vahaly,Gaston Etlis,1-6; 6-2; 6-3,R32,26,1,6,49,85,31,49,14,36,10,15,12,45,85,2,4,49,67,29,49,6,18,9,15,12,35,67
2003-09-08 00:00:00.000,Costa Do Sauipe Brasil ATP World Tour,HARD,2,Eric Taino,Fernando Gonzalez,Eric Taino,7-6(5); 7-5,R32,82,11,4,34,64,30,34,20,30,0,1,12,50,64,14,9,34,75,27,34,22,41,1,3,12,49,75
2003-09-08 00:00:00.000,Costa Do Sauipe Brasil ATP World Tour,HARD,2,Vincent Spadea,Guillermo Canas,Vincent Spadea,6-4; 7-5,R32,97,2,2,34,70,24,34,18,36,7,10,11,42,70,3,6,41,64,25,41,8,23,4,9,11,33,64
2003-09-08 00:00:00.000,Costa Do Sauipe Brasil ATP World Tour,HARD,2,Hermes Gamonal,Michael Quintero,Hermes Gamonal,7-6(0); 6-2,R32,97,4,2,54,74,35,54,11,20,3,5,10,46,74,1,1,35,60,21,35,11,25,4,8,10,32,60
2003-09-08 00:00:00.000,Costa Do Sauipe Brasil ATP World Tour,HARD,2,Gregory Carraz,Alexander Popp,Gregory Carraz,6-1; 4-6; 6-1,R32,116,9,3,36,62,28,36,19,26,0,1,12,47,62,1,7,44,74,25,44,17,30,2,7,12,42,74
2003-09-08 00:00:00.000,Costa Do Sauipe Brasil ATP World Tour,HARD,2,Sjeng Schalken,Cyril Saulnier,Sjeng Schalken,7-6(4); 2-6; 6-3,R32,127,3,0,53,81,37,53,13,28,1,6,15,50,81,4,1,42,91,30,42,26,49,3,7,14,56,91
2003-09-08 00:00:00.000,Costa Do Sauipe Brasil ATP World Tour,HARD,2,Rainer Schuettler,Paul Goldstein,Rainer Schuettler,6-0; 6-1,R16,61,2,2,23,41,21,23,9,18,0,0,7,30,41,0,4,24,48,11,24,9,24,5,10,6,20,48
2003-09-08 00:00:00.000,Costa Do Sauipe Brasil ATP World Tour,HARD,2,Ramon Delgado,Flavio Saretta,Ramon Delgado,2-6; 6-3; 6-4,R16,115,6,2,55,88,35,55,19,33,7,10,14,54,88,8,2,31,70,23,31,21,39,1,4,13,44,70
2003-09-08 00:00:00.000,Costa Do Sauipe Brasil ATP World Tour,HARD,2,Gustavo Kuerten,Werner Eschauer,Gustavo Kuerten,6-2; 6-1,R16,54,9,1,22,38,18,22,10,16,0,0,7,28,38,3,3,30,55,18,30,6,25,2,7,8,24,55
2003-09-08 00:00:00.000,Costa Do Sauipe Brasil ATP World Tour,HARD,2,Ricardo Mello,Juan Ignacio Chela,Ricardo Mello,2-6; 6-2; 6-4,R16,114,2,2,63,87,37,63,15,24,7,10,13,52,87,5,4,45,70,33,45,11,25,2,6,13,44,70
2003-09-08 00:00:00.000,Costa Do Sauipe Brasil ATP World Tour,HARD,2,Kenneth Carlsen,Wesley Moodie,Kenneth Carlsen,7-5; 6-7(5); 6-3,R16,116,13,2,53,84,47,53,21,31,1,1,16,68,84,11,2,79,102,56,79,11,23,5,8,17,67,102
2003-09-08 00:00:00.000,Costa Do Sauipe Brasil ATP World Tour,HARD,2,Gaston Etlis,Eric Taino,Gaston Etlis,7-5; 4-6; 7-6(5),R16,171,18,5,55,114,41,55,34,59,5,8,17,75,114,7,4,58,109,40,58,30,51,4,7,17,70,109
2003-09-08 00:00:00.000,Costa Do Sauipe Brasil ATP World Tour,HARD,2,Vincent Spadea,Hermes Gamonal,Vincent Spadea,6-1; 2-6; 3-1 RET,R16,91,6,3,32,64,19,32,18,32,7,10,10,37,64,0,0,58,72,31,58,6,14,2,6,9,37,72
2003-09-08 00:00:00.000,Costa Do Sauipe Brasil ATP World Tour,HARD,2,Sjeng Schalken,Gregory Carraz,Sjeng Schalken,7-5; 6-4,R16,77,4,1,44,57,37,44,7,13,1,2,11,44,57,4,4,34,59,20,34,17,25,2,5,11,37,59
2003-09-08 00:00:00.000,Costa Do Sauipe Brasil ATP World Tour,HARD,2,Rainer Schuettler,Ramon Delgado,Rainer Schuettler,6-1; 6-3,Q,57,4,0,21,39,16,21,13,18,0,1,8,29,39,0,8,25,48,13,25,7,23,2,7,8,20,48
2003-09-08 00:00:00.000,Costa Do Sauipe Brasil ATP World Tour,HARD,2,Gustavo Kuerten,Ricardo Mello,Gustavo Kuerten,6-2; 6-2,Q,66,9,0,30,50,25,30,10,20,3,3,8,35,50,1,3,27,49,19,27,6,22,3,7,8,25,49
2003-09-08 00:00:00.000,Costa Do Sauipe Brasil ATP World Tour,HARD,2,Gaston Etlis,Kenneth Carlsen,Gaston Etlis,6-4; 6-7(2); 6-3,Q,161,3,2,71,109,54,71,24,38,6,6,16,78,109,9,4,61,101,47,61,20,40,3,5,15,67,101
2003-09-08 00:00:00.000,Costa Do Sauipe Brasil ATP World Tour,HARD,2,Sjeng Schalken,Vincent Spadea,Sjeng Schalken,7-6(0); 6-2,Q,94,3,1,41,68,29,41,16,27,8,10,10,45,68,2,2,41,60,26,41,7,19,0,4,10,33,60
2003-09-08 00:00:00.000,Costa Do Sauipe Brasil ATP World Tour,HARD,2,Rainer Schuettler,Gustavo Kuerten,Rainer Schuettler,6-4; 2-6; 7-5,S,138,7,6,50,89,34,50,21,39,8,12,15,55,89,14,2,53,101,44,53,16,48,8,12,15,60,101
2003-09-08 00:00:00.000,Costa Do Sauipe Brasil ATP World Tour,HARD,2,Sjeng Schalken,Gaston Etlis,Sjeng Schalken,6-1; 2-0 RET,S,33,1,0,17,19,14,17,2,2,0,0,4,16,19,2,4,19,30,10,19,1,11,1,5,5,11,30
2003-09-08 00:00:00.000,Costa Do Sauipe Brasil ATP World Tour,HARD,2,Sjeng Schalken,Rainer Schuettler,Sjeng Schalken,6-2; 6-4,F,78,1,1,36,52,25,36,12,16,3,4,9,37,52,3,2,37,60,28,37,5,23,5,9,9,33,60
2003-09-22 00:00:00.000,Bangkok Thailand ATP World Tour,HARD,2,Juan Carlos Ferrero,Dick Norman,Juan Carlos Ferrero,7-5; 7-6(5),R32,97,7,2,53,83,40,53,14,30,5,7,12,54,83,17,7,45,74,37,45,12,29,5,8,12,49,74
2003-09-22 00:00:00.000,Bangkok Thailand ATP World Tour,HARD,2,Alex Bogomolov Jr.,Giorgio Galimberti,Alex Bogomolov Jr.,6-3; 6-3,R32,57,1,1,32,46,23,32,8,14,1,3,9,31,46,1,2,27,57,16,27,11,30,3,8,9,27,57
2003-09-22 00:00:00.000,Bangkok Thailand ATP World Tour,HARD,2,Alexander Popp,Werner Eschauer,Alexander Popp,7-5; 6-3,R32,78,3,6,53,82,35,53,17,29,7,8,11,52,82,3,3,30,51,20,30,9,21,1,4,10,29,51
2003-09-22 00:00:00.000,Bangkok Thailand ATP World Tour,HARD,2,Gregory Carraz,Fabrice Santoro,Gregory Carraz,3-6; 7-6(8); 6-1,R32,128,14,10,74,108,49,74,13,34,7,13,15,62,108,2,3,51,88,33,51,14,37,4,10,13,47,88
2003-09-22 00:00:00.000,Bangkok Thailand ATP World Tour,HARD,2,Paradorn Srichaphan,Vladimir Voltchkov,Paradorn Srichaphan,0-6; 6-3; 6-2,R32,106,10,0,51,91,35,51,18,40,4,7,12,53,91,1,3,43,72,32,43,10,29,2,5,11,42,72
2003-09-22 00:00:00.000,Bangkok Thailand ATP World Tour,HARD,2,Kenneth Carlsen,Andy Ram,Kenneth Carlsen,3-6; 6-3; 7-6(5),R32,132,7,1,52,93,39,52,22,41,2,5,15,61,93,14,3,35,86,35,35,26,51,7,10,15,61,86
2003-09-22 00:00:00.000,Bangkok Thailand ATP World Tour,HARD,2,Mario Ancic,Marco Chiudinelli,Mario Ancic,6-4; 4-6; 6-3,R32,103,11,3,47,68,42,47,9,21,1,3,14,51,68,3,2,49,91,35,49,19,42,6,10,15,54,91
2003-09-22 00:00:00.000,Bangkok Thailand ATP World Tour,HARD,2,Ivan Ljubicic,Cyril Saulnier,Ivan Ljubicic,5-7; 6-3; 7-6(4),R32,134,20,3,57,105,46,57,27,48,2,4,17,73,105,11,2,61,105,46,61,21,44,4,6,16,67,105
2003-09-22 00:00:00.000,Bangkok Thailand ATP World Tour,HARD,2,Jarkko Nieminen,Danai Udomchoke,Jarkko Nieminen,6-4; 6-1,R32,60,6,3,27,47,24,27,7,20,2,4,9,31,47,2,2,30,53,15,30,9,23,7,12,8,24,53
2003-09-22 00:00:00.000,Bangkok Thailand ATP World Tour,HARD,2,Bohdan Ulihrach,Davide Sanguinetti,Bohdan Ulihrach,6-2; 6-3,R32,50,1,2,25,42,22,25,10,17,0,0,8,32,42,2,0,36,55,22,36,8,19,3,7,9,30,55
2003-09-22 00:00:00.000,Bangkok Thailand ATP World Tour,HARD,2,Brian Vahaly,Jaymon Crabb,Brian Vahaly,7-5; 2-1 RET,R32,61,3,2,27,36,20,27,6,9,0,1,7,26,36,1,1,43,55,24,43,6,12,4,7,8,30,55
2003-09-22 00:00:00.000,Bangkok Thailand ATP World Tour,HARD,2,Carlos Moya,Petr Luxa,Carlos Moya,6-4; 6-3,R32,83,2,4,36,68,29,36,11,32,6,9,10,40,68,4,3,37,63,21,37,10,26,1,6,9,31,63
2003-09-22 00:00:00.000,Bangkok Thailand ATP World Tour,HARD,2,Taylor Dent,Wesley Moodie,Taylor Dent,6-1; 6-4,R32,58,7,2,23,47,20,23,14,24,1,2,9,34,47,3,2,36,52,19,36,8,16,1,5,8,27,52
2003-09-22 00:00:00.000,Bangkok Thailand ATP World Tour,HARD,2,Thierry Ascione,Ivan Miranda,Thierry Ascione,6-3; 6-2,R32,58,8,3,30,55,27,30,12,25,0,0,9,39,55,0,1,30,45,16,30,9,15,1,4,8,25,45
2003-09-22 00:00:00.000,Bangkok Thailand ATP World Tour,HARD,2,Nicolas Thomann,Prakash Amritraj,Nicolas Thomann,5-7; 6-3; 6-3,R32,117,11,2,49,97,41,49,27,48,9,10,15,68,97,13,0,51,92,37,51,23,41,3,6,15,60,92
2003-09-22 00:00:00.000,Bangkok Thailand ATP World Tour,HARD,2,Jonathan Erlich,Sonchat Ratiwatana,Jonathan Erlich,7-5; 1-6; 6-4,R32,121,4,5,51,95,34,51,22,44,3,7,15,56,95,3,3,62,93,43,62,14,31,5,8,14,57,93
2003-09-22 00:00:00.000,Bangkok Thailand ATP World Tour,HARD,2,Juan Carlos Ferrero,Alex Bogomolov Jr.,Juan Carlos Ferrero,6-3; 6-7(4); 6-1,R16,125,8,0,57,92,40,57,21,35,3,6,15,61,92,3,6,59,97,35,59,17,38,6,12,13,52,97
2003-09-22 00:00:00.000,Bangkok Thailand ATP World Tour,HARD,2,Gregory Carraz,Alexander Popp,Gregory Carraz,7-5; 6-2,R16,77,4,1,41,58,30,41,8,17,0,2,10,38,58,5,6,42,67,26,42,7,25,4,9,10,33,67
2003-09-22 00:00:00.000,Bangkok Thailand ATP World Tour,HARD,2,Paradorn Srichaphan,Kenneth Carlsen,Paradorn Srichaphan,6-3; 7-6(5),R16,127,6,4,57,99,46,57,18,42,8,8,11,64,99,4,0,44,76,33,44,15,32,7,8,10,48,76
2003-09-22 00:00:00.000,Bangkok Thailand ATP World Tour,HARD,2,Ivan Ljubicic,Mario Ancic,Ivan Ljubicic,6-1; 6-4,R16,85,6,3,36,64,25,36,19,28,6,6,9,44,64,3,6,40,63,28,40,7,23,3,6,8,35,63
2003-09-22 00:00:00.000,Bangkok Thailand ATP World Tour,HARD,2,Jarkko Nieminen,Bohdan Ulihrach,Jarkko Nieminen,6-4; 6-2,R16,54,2,0,40,51,31,40,6,11,2,2,9,37,51,4,3,38,60,25,38,10,22,4,7,9,35,60
2003-09-22 00:00:00.000,Bangkok Thailand ATP World Tour,HARD,2,Carlos Moya,Brian Vahaly,Carlos Moya,7-5; 6-4,R16,86,3,0,34,63,24,34,21,29,3,4,11,45,63,4,1,51,72,33,51,11,21,6,9,11,44,72
2003-09-22 00:00:00.000,Bangkok Thailand ATP World Tour,HARD,2,Taylor Dent,Thierry Ascione,Taylor Dent,6-1; 6-2,R16,52,6,4,25,46,23,25,9,21,0,0,8,32,46,1,2,31,44,15,31,5,13,2,6,7,20,44
2003-09-22 00:00:00.000,Bangkok Thailand ATP World Tour,HARD,2,Nicolas Thomann,Jonathan Erlich,Nicolas Thomann,6-4; 6-0,R16,70,5,1,38,56,28,38,9,18,1,2,8,37,56,5,6,36,54,19,36,5,18,2,7,8,24,54
2003-09-22 00:00:00.000,Bangkok Thailand ATP World Tour,HARD,2,Juan Carlos Ferrero,Gregory Carraz,Juan Carlos Ferrero,6-4; 3-6; 7-6(2),Q,124,13,3,59,88,44,59,19,29,3,5,15,63,88,13,9,58,98,47,58,19,40,7,9,16,66,98
2003-09-22 00:00:00.000,Bangkok Thailand ATP World Tour,HARD,2,Ivan Ljubicic,Paradorn Srichaphan,Ivan Ljubicic,4-6; 7-6(4); 7-5,Q,130,22,1,64,94,53,64,18,30,2,4,17,71,94,6,0,64,94,51,64,18,30,1,3,17,69,94
2003-09-22 00:00:00.000,Bangkok Thailand ATP World Tour,HARD,2,Jarkko Nieminen,Carlos Moya,Jarkko Nieminen,6-7(5); 6-4; 6-4,Q,131,3,2,57,94,42,57,26,37,2,3,16,68,94,10,4,70,124,50,70,26,54,9,12,16,76,124
2003-09-22 00:00:00.000,Bangkok Thailand ATP World Tour,HARD,2,Taylor Dent,Nicolas Thomann,Taylor Dent,6-3 RET,Q,36,3,4,10,23,8,10,7,13,2,3,4,15,23,1,7,11,31,8,11,6,20,0,3,5,14,31
2003-09-22 00:00:00.000,Bangkok Thailand ATP World Tour,HARD,2,Juan Carlos Ferrero,Ivan Ljubicic,Juan Carlos Ferrero,6-3; 6-3,S,77,2,2,33,55,23,33,14,22,2,3,9,37,55,5,1,27,51,15,27,12,24,2,6,9,27,51
2003-09-22 00:00:00.000,Bangkok Thailand ATP World Tour,HARD,2,Taylor Dent,Jarkko Nieminen,Taylor Dent,7-6(3); 6-2,S,78,11,9,42,72,35,42,13,30,7,9,10,48,72,3,2,48,71,30,48,7,23,3,7,10,37,71
2003-09-22 00:00:00.000,Bangkok Thailand ATP World Tour,HARD,2,Taylor Dent,Juan Carlos Ferrero,Taylor Dent,6-3; 7-6(5),F,99,8,6,40,82,30,40,25,42,7,8,11,55,82,2,1,43,73,34,43,13,30,3,5,10,47,73
2003-09-22 00:00:00.000,Palermo Italy ATP World Tour,CLAY,2,Nicolas Massu,Christophe Rochus,Nicolas Massu,6-4; 6-2,R32,96,6,1,36,60,25,36,13,24,5,6,9,38,60,0,2,33,63,20,33,12,30,3,7,9,32,63
2003-09-22 00:00:00.000,Palermo Italy ATP World Tour,CLAY,2,Jose Acasuso,Juan Giner,Jose Acasuso,6-3; 6-2,R32,57,2,0,25,45,21,25,16,20,0,0,9,37,45,2,2,25,42,19,25,5,17,1,4,8,24,42
2003-09-22 00:00:00.000,Palermo Italy ATP World Tour,CLAY,2,Tomas Behrend,Martin Vassallo Arguello,Tomas Behrend,6-3; 6-4,R32,97,1,3,31,49,24,31,5,18,3,6,9,29,49,0,2,44,85,25,44,16,41,7,13,10,41,85
2003-09-22 00:00:00.000,Palermo Italy ATP World Tour,CLAY,2,Albert Montanes,Ruben Ramirez Hidalgo,Albert Montanes,6-2; 6-4,R32,76,1,0,50,50,36,50,0,0,1,2,9,36,50,0,0,45,51,27,45,2,6,3,7,9,29,51
2003-09-22 00:00:00.000,Palermo Italy ATP World Tour,CLAY,2,Oscar Hernandez,David Sanchez,Oscar Hernandez,6-2; 0-6; 7-6(8),R32,139,0,2,80,110,47,80,12,30,10,16,13,59,110,2,2,52,90,35,52,17,38,5,10,13,52,90
2003-09-22 00:00:00.000,Palermo Italy ATP World Tour,CLAY,2,Tomas Tenconi,Irakli Labadze,Tomas Tenconi,6-0; 6-2,R32,51,4,3,24,43,16,24,12,19,2,3,7,28,43,0,4,28,38,10,28,1,10,3,9,7,11,38
2003-09-22 00:00:00.000,Palermo Italy ATP World Tour,CLAY,2,Mariano Puerta,Jurgen Melzer,Mariano Puerta,6-2; 4-6; 6-4,R32,110,3,4,40,78,31,40,17,38,2,6,14,48,78,5,5,41,87,29,41,18,46,6,12,14,47,87
2003-09-22 00:00:00.000,Palermo Italy ATP World Tour,CLAY,2,Luis Horna,Andrei Pavel,Luis Horna,7-6(6); 7-5,R32,106,4,1,45,77,35,45,16,32,2,4,12,51,77,5,1,46,84,33,46,17,38,8,11,12,50,84
2003-09-22 00:00:00.000,Palermo Italy ATP World Tour,CLAY,2,Alberto Martin,David Ferrer,Alberto Martin,7-6(4); 6-2,R32,85,0,2,39,63,26,39,11,24,1,4,10,37,63,0,3,38,59,19,38,10,21,1,6,10,29,59
2003-09-22 00:00:00.000,Palermo Italy ATP World Tour,CLAY,2,Galo Blanco,Kristof Vliegen,Galo Blanco,7-5; 7-5,R32,100,3,1,63,74,41,63,6,11,7,10,12,47,74,3,1,53,70,30,53,9,17,5,10,12,39,70
2003-09-22 00:00:00.000,Palermo Italy ATP World Tour,CLAY,2,Franco Squillari,Alessio Di Mauro,Franco Squillari,6-4; 6-3,R32,94,3,3,30,60,27,30,14,30,6,7,10,41,60,2,2,29,58,18,29,14,29,4,7,9,32,58
2003-09-22 00:00:00.000,Palermo Italy ATP World Tour,CLAY,2,Filippo Volandri,Francesco Aldi,Filippo Volandri,6-2; 7-5,R32,110,2,3,57,81,33,57,13,24,7,10,10,46,81,0,9,45,71,25,45,9,26,8,14,10,34,71
2003-09-22 00:00:00.000,Palermo Italy ATP World Tour,CLAY,2,Paul-Henri Mathieu,Albert Portas,Paul-Henri Mathieu,4-6; 6-3; 7-6(5),R32,172,5,7,62,124,40,62,25,62,7,14,16,65,124,13,8,61,116,36,61,23,55,10,17,15,59,116
2003-09-22 00:00:00.000,Palermo Italy ATP World Tour,CLAY,2,Nicolas Almagro,Alex Corretja,Nicolas Almagro,3-1 RET,R32,23,0,0,4,11,4,4,4,7,0,0,2,8,11,0,0,15,16,7,15,0,1,2,3,2,7,16
2003-09-22 00:00:00.000,Palermo Italy ATP World Tour,CLAY,2,Victor Hanescu,Igor Andreev,Victor Hanescu,6-3; 6-3,R32,79,3,0,46,70,32,46,14,24,10,10,9,46,70,2,4,35,55,23,35,9,20,3,6,9,32,55
2003-09-22 00:00:00.000,Palermo Italy ATP World Tour,CLAY,2,Diego Veronelli,Nikolay Davydenko,Diego Veronelli,6-4; 6-4,R32,83,4,1,34,57,23,34,9,23,1,5,10,32,57,1,6,40,62,24,40,4,22,1,7,10,28,62
2003-09-22 00:00:00.000,Palermo Italy ATP World Tour,CLAY,2,Nicolas Massu,Jose Acasuso,Nicolas Massu,6-2; 3-1,R16,48,4,1,16,30,15,16,10,14,1,1,6,25,30,3,1,20,31,10,20,4,11,0,3,6,14,31
2003-09-22 00:00:00.000,Palermo Italy ATP World Tour,CLAY,2,Albert Montanes,Tomas Behrend,Albert Montanes,6-0; 6-4,R16,55,4,0,33,47,24,33,10,14,1,1,8,34,47,0,2,38,52,20,38,6,14,4,8,8,26,52
2003-09-22 00:00:00.000,Palermo Italy ATP World Tour,CLAY,2,Oscar Hernandez,Tomas Tenconi,Oscar Hernandez,7-6(3); 6-3,R16,131,2,1,64,87,44,64,10,23,8,10,11,54,87,2,3,48,90,33,48,18,42,9,12,10,51,90
2003-09-22 00:00:00.000,Palermo Italy ATP World Tour,CLAY,2,Luis Horna,Mariano Puerta,Luis Horna,6-4; 6-2,R16,84,9,2,40,66,33,40,12,26,4,4,9,45,66,6,3,37,62,25,37,11,25,5,8,9,36,62
2003-09-22 00:00:00.000,Palermo Italy ATP World Tour,CLAY,2,Alberto Martin,Galo Blanco,Alberto Martin,4-0 RET,R16,24,0,0,6,9,5,6,3,3,0,0,2,8,9,0,4,10,19,6,10,1,9,5,7,2,7,19
2003-09-22 00:00:00.000,Palermo Italy ATP World Tour,CLAY,2,Franco Squillari,Filippo Volandri,Franco Squillari,W/O,R16,0,0,0,0,0,0,0,0,0,0,0,0,0,0,0,0,0,0,0,0,0,0,0,0,0,0,0
2003-09-22 00:00:00.000,Palermo Italy ATP World Tour,CLAY,2,Paul-Henri Mathieu,Nicolas Almagro,Paul-Henri Mathieu,7-6(6); 3-6; 6-3,R16,0,6,1,53,101,38,53,23,48,6,10,15,61,101,9,5,56,101,42,56,18,45,7,11,15,60,101
2003-09-22 00:00:00.000,Palermo Italy ATP World Tour,CLAY,2,Diego Veronelli,Victor Hanescu,Diego Veronelli,6-4; 6-2,R16,62,2,1,25,48,20,25,17,23,0,0,9,37,48,1,3,36,53,25,36,6,17,2,5,9,31,53
2003-09-22 00:00:00.000,Palermo Italy ATP World Tour,CLAY,2,Nicolas Massu,Albert Montanes,Nicolas Massu,6-4; 1-6; 6-4,Q,133,0,4,47,77,33,47,14,30,5,9,13,47,77,0,6,55,87,34,55,16,32,4,8,14,50,87
2003-09-22 00:00:00.000,Palermo Italy ATP World Tour,CLAY,2,Luis Horna,Oscar Hernandez,Luis Horna,3-6; 7-6(7); 6-1,Q,108,7,6,64,112,46,64,20,48,5,8,15,66,112,3,2,60,94,37,60,20,34,8,11,13,57,94
2003-09-22 00:00:00.000,Palermo Italy ATP World Tour,CLAY,2,Alberto Martin,Franco Squillari,Alberto Martin,7-6(3); 6-4,Q,112,0,2,47,78,31,47,17,31,3,6,11,48,78,4,4,38,70,23,38,16,32,3,7,11,39,70
2003-09-22 00:00:00.000,Palermo Italy ATP World Tour,CLAY,2,Paul-Henri Mathieu,Diego Veronelli,Paul-Henri Mathieu,4-6; 7-6(5); 6-3,Q,158,7,3,54,93,39,54,17,39,3,8,15,56,93,5,6,68,125,44,68,22,57,9,15,16,66,125
2003-09-22 00:00:00.000,Palermo Italy ATP World Tour,CLAY,2,Nicolas Massu,Luis Horna,Nicolas Massu,6-2; 6-2,S,77,2,0,22,40,19,22,10,18,1,2,8,29,40,1,2,30,50,17,30,6,20,3,8,8,23,50
2003-09-22 00:00:00.000,Palermo Italy ATP World Tour,CLAY,2,Paul-Henri Mathieu,Alberto Martin,Paul-Henri Mathieu,7-6(5); 7-6(5),S,146,2,4,45,95,28,45,33,50,3,5,12,61,95,0,6,62,86,40,62,12,24,4,6,12,52,86
2003-09-22 00:00:00.000,Palermo Italy ATP World Tour,CLAY,2,Nicolas Massu,Paul-Henri Mathieu,Nicolas Massu,1-6; 6-2; 7-6(0),F,169,2,1,49,83,26,49,16,34,3,9,13,42,83,1,2,39,84,19,39,24,45,3,9,14,43,84
2003-09-22 00:00:00.000,Shanghai China ATP World Tour,HARD,2,Jiri Novak,Dennis van Scheppingen,Jiri Novak,6-2; 7-6(6),R32,70,6,0,38,59,32,38,15,21,1,1,10,47,59,6,5,52,84,39,52,11,32,5,7,10,50,84
2003-09-22 00:00:00.000,Shanghai China ATP World Tour,HARD,2,Robert Kendrick,Bjorn Phau,Robert Kendrick,6-7(4); 7-6(3); 7-6(5),R32,129,11,4,72,118,56,72,24,46,3,5,18,80,118,9,5,59,110,49,59,29,51,0,2,18,78,110
2003-09-22 00:00:00.000,Shanghai China ATP World Tour,HARD,2,Fernando Verdasco,Jan Vacek,Fernando Verdasco,6-4; 6-2,R32,61,6,1,24,43,22,24,14,19,0,0,9,36,43,0,2,27,58,19,27,16,31,7,10,9,35,58
2003-09-22 00:00:00.000,Shanghai China ATP World Tour,HARD,2,Magnus Norman,Ben-Qiang Zhu,Magnus Norman,6-3; 6-4,R32,81,7,0,29,54,24,29,17,25,0,0,10,41,54,2,2,27,60,22,27,16,33,9,11,9,38,60
2003-09-22 00:00:00.000,Shanghai China ATP World Tour,HARD,2,Wayne Arthurs,Peter Luczak,Wayne Arthurs,5-7; 6-4; 6-2,R32,96,27,5,46,79,42,46,18,33,2,3,15,60,79,3,6,53,80,44,53,12,27,4,7,15,56,80
2003-09-22 00:00:00.000,Shanghai China ATP World Tour,HARD,2,Takao Suzuki,Lars Burgsmuller,Takao Suzuki,6-4; 6-1,R32,67,5,3,31,52,27,31,10,21,5,5,8,37,52,2,3,26,57,14,26,18,31,1,5,9,32,57
2003-09-22 00:00:00.000,Shanghai China ATP World Tour,HARD,2,Ivo Karlovic,Cecil Mamiit,Ivo Karlovic,6-7(3); 6-2; 7-6(5),R32,132,26,8,65,101,57,65,18,36,6,7,16,75,101,1,2,76,108,51,76,20,32,6,9,16,71,108
2003-09-22 00:00:00.000,Shanghai China ATP World Tour,HARD,2,Nicolas Kiefer,Thomas Enqvist,Nicolas Kiefer,1-6; 6-3; 6-3,R32,104,10,6,44,79,34,44,16,35,7,9,12,50,79,8,4,38,71,32,38,14,33,3,6,13,46,71
2003-09-22 00:00:00.000,Shanghai China ATP World Tour,HARD,2,Eric Taino,Hyung-Taik Lee,Eric Taino,6-3; 7-6(4),R32,76,10,1,31,62,28,31,16,31,4,5,10,44,62,4,3,43,63,29,43,10,20,2,5,11,39,63
2003-09-22 00:00:00.000,Shanghai China ATP World Tour,HARD,2,Guillermo Canas,Alex Kim,Guillermo Canas,7-6(8); 7-6(0),R32,112,8,5,50,80,38,50,19,30,5,7,12,57,80,1,4,43,84,29,43,23,41,3,5,12,52,84
2003-09-22 00:00:00.000,Shanghai China ATP World Tour,HARD,2,Jeff Salzenstein,Ivo Heuberger,Jeff Salzenstein,6-3; 7-6(3),R32,66,9,1,43,59,38,43,10,16,2,3,11,48,59,6,1,36,59,26,36,11,23,1,3,10,37,59
2003-09-22 00:00:00.000,Shanghai China ATP World Tour,HARD,2,Mark Philippoussis,Andreas Vinciguerra,Mark Philippoussis,6-4; 7-6(2),R32,89,12,5,30,69,26,30,25,39,1,1,11,51,69,7,3,51,84,36,51,15,33,3,4,11,51,84
2003-09-22 00:00:00.000,Shanghai China ATP World Tour,HARD,2,Robin Soderling,John van Lottum,Robin Soderling,6-2; 6-0,R32,45,7,1,17,34,16,17,13,17,0,0,7,29,34,2,4,26,42,14,26,4,16,3,8,7,18,42
2003-09-22 00:00:00.000,Shanghai China ATP World Tour,HARD,2,Justin Gimelstob,Alexander Waske,Justin Gimelstob,6-3; 7-6(4),R32,91,9,4,37,67,32,37,19,30,2,2,11,51,67,7,4,43,72,31,43,15,29,4,5,10,46,72
2003-09-22 00:00:00.000,Shanghai China ATP World Tour,HARD,2,Scott Draper,Federico Browne,Scott Draper,6-3; 6-4,R32,68,2,1,32,53,25,32,13,21,2,3,10,38,53,4,5,29,59,18,29,13,30,4,7,9,31,59
2003-09-22 00:00:00.000,Shanghai China ATP World Tour,HARD,2,Martin Verkerk,Shao-Xuan Zeng,Martin Verkerk,6-2; 6-3,R32,62,9,4,30,45,25,30,9,15,2,2,8,34,45,4,5,34,65,25,34,8,31,5,9,9,33,65
2003-09-22 00:00:00.000,Shanghai China ATP World Tour,HARD,2,Jiri Novak,Robert Kendrick,Jiri Novak,6-7(3); 6-1; 6-2,R16,90,6,3,57,85,44,57,12,28,2,3,14,56,85,11,4,53,84,33,53,16,31,6,11,13,49,84
2003-09-22 00:00:00.000,Shanghai China ATP World Tour,HARD,2,Magnus Norman,Fernando Verdasco,Magnus Norman,7-5; 7-6(5),R16,91,8,4,45,80,33,45,22,35,0,1,12,55,80,9,2,38,67,28,38,20,29,1,3,12,48,67
2003-09-22 00:00:00.000,Shanghai China ATP World Tour,HARD,2,Wayne Arthurs,Takao Suzuki,Wayne Arthurs,6-1; 6-2,R16,51,14,6,31,52,25,31,10,21,1,1,8,35,52,1,3,22,41,9,22,11,19,2,6,7,20,41
2003-09-22 00:00:00.000,Shanghai China ATP World Tour,HARD,2,Ivo Karlovic,Nicolas Kiefer,Ivo Karlovic,6-1; 7-6(5),R16,80,15,3,36,61,31,36,14,25,3,4,10,45,61,2,5,32,61,23,32,12,29,3,6,9,35,61
2003-09-22 00:00:00.000,Shanghai China ATP World Tour,HARD,2,Guillermo Canas,Eric Taino,Guillermo Canas,6-7(1); 6-4; 7-6(3),R16,186,15,13,71,133,58,71,23,62,8,11,17,81,133,4,6,45,116,37,45,35,71,6,10,17,72,116
2003-09-22 00:00:00.000,Shanghai China ATP World Tour,HARD,2,Mark Philippoussis,Jeff Salzenstein,Mark Philippoussis,6-1; 7-5,R16,64,18,3,31,56,27,31,14,25,3,3,9,41,56,7,0,33,53,23,33,9,20,0,4,10,32,53
2003-09-22 00:00:00.000,Shanghai China ATP World Tour,HARD,2,Robin Soderling,Justin Gimelstob,Robin Soderling,6-4; 6-4,R16,100,7,2,38,63,27,38,16,25,2,3,10,43,63,3,0,41,73,26,41,14,32,11,14,10,40,73
2003-09-22 00:00:00.000,Shanghai China ATP World Tour,HARD,2,Scott Draper,Martin Verkerk,Scott Draper,6-7(4); 1-0 RET,R16,57,3,1,26,37,20,26,9,11,0,0,6,29,37,13,4,36,58,27,36,11,22,3,4,7,38,58
2003-09-22 00:00:00.000,Shanghai China ATP World Tour,HARD,2,Jiri Novak,Magnus Norman,Jiri Novak,2-1 RET,Q,20,1,0,6,11,5,6,2,5,0,0,1,7,11,0,2,3,13,3,3,4,10,3,4,2,7,13
2003-09-22 00:00:00.000,Shanghai China ATP World Tour,HARD,2,Wayne Arthurs,Ivo Karlovic,Wayne Arthurs,6-4; 3-6; 7-6(2),Q,100,12,2,49,81,41,49,23,32,1,2,15,64,81,19,3,55,87,47,55,20,32,2,3,16,67,87
2003-09-22 00:00:00.000,Shanghai China ATP World Tour,HARD,2,Mark Philippoussis,Guillermo Canas,Mark Philippoussis,6-3; 7-6(4),Q,93,15,1,51,78,43,51,11,27,9,9,11,54,78,1,5,49,69,37,49,9,20,7,8,10,46,69
2003-09-22 00:00:00.000,Shanghai China ATP World Tour,HARD,2,Robin Soderling,Scott Draper,Robin Soderling,6-7(2); 7-6(3); 7-6(1),Q,144,16,3,70,117,58,70,25,47,7,8,18,83,117,12,4,68,123,52,68,33,55,9,10,18,85,123
2003-09-22 00:00:00.000,Shanghai China ATP World Tour,HARD,2,Jiri Novak,Wayne Arthurs,Jiri Novak,6-7(7); 6-3; 6-2,S,103,9,3,71,99,55,71,16,28,2,2,15,71,99,11,5,58,85,42,58,15,27,3,6,14,57,85
2003-09-22 00:00:00.000,Shanghai China ATP World Tour,HARD,2,Mark Philippoussis,Robin Soderling,Mark Philippoussis,6-4; 6-4,S,67,9,4,25,51,22,25,13,26,1,3,10,35,51,7,4,42,64,25,42,10,22,3,7,10,35,64
2003-09-22 00:00:00.000,Shanghai China ATP World Tour,HARD,2,Mark Philippoussis,Jiri Novak,Mark Philippoussis,6-2; 6-1,F,46,9,2,22,38,21,22,12,16,0,0,8,33,38,3,1,22,38,13,22,5,16,2,6,7,18,38
2003-09-29 00:00:00.000,Metz France ATP World Tour,HARD,2,Tommy Robredo,Jurgen Melzer,Tommy Robredo,6-2; 7-6(5),R32,85,1,3,42,64,35,42,11,22,6,7,10,46,64,4,1,54,82,33,54,13,28,9,12,10,46,82
2003-09-29 00:00:00.000,Metz France ATP World Tour,HARD,2,Jean-Rene Lisnard,Cristiano Caratti,Jean-Rene Lisnard,6-3; 5-7; 6-4,R32,128,5,7,45,96,29,45,23,51,3,10,16,52,96,2,3,63,100,35,63,11,37,9,17,15,46,100
2003-09-29 00:00:00.000,Metz France ATP World Tour,HARD,2,Victor Hanescu,Pavel Snobel,Victor Hanescu,6-4; 6-1,R32,66,3,2,36,53,31,36,9,17,5,5,9,40,53,4,0,37,57,21,37,9,20,6,9,8,30,57
2003-09-29 00:00:00.000,Metz France ATP World Tour,HARD,2,Andrei Pavel,Dominik Hrbaty,Andrei Pavel,4-6; 6-4; 7-6(3),R32,119,12,3,71,116,45,71,25,45,7,10,16,70,116,9,3,69,94,52,69,11,25,4,7,16,63,94
2003-09-29 00:00:00.000,Metz France ATP World Tour,HARD,2,Fernando Gonzalez,Christophe Rochus,Fernando Gonzalez,6-4; 6-4,R32,74,10,4,40,67,33,40,13,27,5,6,10,46,67,3,3,49,69,31,49,10,20,2,5,10,41,69
2003-09-29 00:00:00.000,Metz France ATP World Tour,HARD,2,Tomas Behrend,Mariano Puerta,Tomas Behrend,7-5; 6-4,R32,69,12,5,44,63,38,44,8,19,1,1,11,46,63,12,5,41,69,33,41,11,28,6,8,11,44,69
2003-09-29 00:00:00.000,Metz France ATP World Tour,HARD,2,David Ferrer,Karol Beck,David Ferrer,6-1; 6-2,R32,53,6,1,42,62,30,42,11,20,4,4,8,41,62,4,4,22,39,10,22,8,17,2,6,7,18,39
2003-09-29 00:00:00.000,Metz France ATP World Tour,HARD,2,Hicham Arazi,Ruben Ramirez Hidalgo,Hicham Arazi,6-3; 6-0,R32,56,2,2,20,46,16,20,15,26,0,0,7,31,46,3,3,22,43,12,22,7,21,3,8,8,19,43
2003-09-29 00:00:00.000,Metz France ATP World Tour,HARD,2,Philipp Petzschner,Antony Dupuis,Philipp Petzschner,7-6(1); 6-4,R32,94,11,3,31,66,27,31,24,35,1,1,11,51,66,7,0,48,86,33,48,23,38,9,10,11,56,86
2003-09-29 00:00:00.000,Metz France ATP World Tour,HARD,2,Thierry Ascione,Vladimir Voltchkov,Thierry Ascione,6-2; 6-4,R32,59,13,2,35,50,28,35,8,15,4,5,9,36,50,4,4,25,54,17,25,9,29,2,6,9,26,54
2003-09-29 00:00:00.000,Metz France ATP World Tour,HARD,2,Davide Sanguinetti,Thomas Enqvist,Davide Sanguinetti,7-5; 6-3,R32,78,7,0,40,56,32,40,8,16,1,2,10,40,56,4,12,43,84,28,43,16,41,7,11,11,44,84
2003-09-29 00:00:00.000,Metz France ATP World Tour,HARD,2,Arnaud Clement,Michael Llodra,Arnaud Clement,7-5; 6-1,R32,87,1,1,37,61,26,37,17,24,5,6,10,43,61,7,4,39,67,23,39,11,28,7,11,9,34,67
2003-09-29 00:00:00.000,Metz France ATP World Tour,HARD,2,Fabrice Santoro,Diego Veronelli,Fabrice Santoro,6-3; 6-0,R32,62,1,0,23,45,16,23,15,22,0,1,8,31,45,2,3,34,62,17,34,12,28,10,15,7,29,62
2003-09-29 00:00:00.000,Metz France ATP World Tour,HARD,2,Olivier Mutis,Richard Gasquet,Olivier Mutis,4-6; 6-4; 7-5,R32,124,6,1,56,104,46,56,26,48,7,8,16,72,104,5,4,57,94,40,57,23,37,5,7,16,63,94
2003-09-29 00:00:00.000,Metz France ATP World Tour,HARD,2,Alexander Popp,Fernando Vicente,Alexander Popp,6-3; 6-1,R32,58,3,1,28,37,25,28,7,9,0,0,8,32,37,1,1,43,66,22,43,11,23,7,11,8,33,66
2003-09-29 00:00:00.000,Metz France ATP World Tour,HARD,2,Nicolas Mahut,Younes El Aynaoui,Nicolas Mahut,7-6(4); 4-6; 7-6(2),R32,134,12,7,66,108,51,66,27,42,2,4,17,78,108,13,3,71,106,56,71,19,35,2,3,17,75,106
2003-09-29 00:00:00.000,Metz France ATP World Tour,HARD,2,Tommy Robredo,Jean-Rene Lisnard,Tommy Robredo,6-2; 6-2,R16,78,3,1,49,59,35,49,5,10,3,3,8,40,59,1,5,28,62,19,28,12,34,5,9,8,31,62
2003-09-29 00:00:00.000,Metz France ATP World Tour,HARD,2,Andrei Pavel,Victor Hanescu,Andrei Pavel,6-4; 3-6; 6-3,R16,105,4,1,50,72,42,50,14,22,2,3,14,56,72,4,2,60,91,43,60,16,31,5,7,14,59,91
2003-09-29 00:00:00.000,Metz France ATP World Tour,HARD,2,Fernando Gonzalez,Tomas Behrend,Fernando Gonzalez,6-2; 6-7(6); 7-6(5),R16,113,18,3,62,92,53,62,21,30,2,3,16,74,92,13,2,78,107,56,78,18,29,6,9,16,74,107
2003-09-29 00:00:00.000,Metz France ATP World Tour,HARD,2,David Ferrer,Hicham Arazi,David Ferrer,6-4; 5-7; 6-0,R16,103,4,0,46,80,37,46,17,34,3,5,14,54,80,0,1,55,73,34,55,7,18,0,5,14,41,73
2003-09-29 00:00:00.000,Metz France ATP World Tour,HARD,2,Philipp Petzschner,Thierry Ascione,Philipp Petzschner,6-4; 7-6(4),R16,77,11,1,39,69,35,39,16,30,2,2,11,51,69,2,4,46,71,33,46,15,25,1,2,11,48,71
2003-09-29 00:00:00.000,Metz France ATP World Tour,HARD,2,Arnaud Clement,Davide Sanguinetti,Arnaud Clement,7-5; 7-5,R16,102,11,2,45,77,34,45,18,32,6,7,12,52,77,7,2,44,78,32,44,16,34,8,11,12,48,78
2003-09-29 00:00:00.000,Metz France ATP World Tour,HARD,2,Fabrice Santoro,Olivier Mutis,Fabrice Santoro,7-6(4); 6-4,R16,95,4,4,37,61,27,37,17,24,0,1,11,44,61,4,0,43,81,30,43,18,38,2,4,11,48,81
2003-09-29 00:00:00.000,Metz France ATP World Tour,HARD,2,Alexander Popp,Nicolas Mahut,Alexander Popp,7-6(2); 5-7; 6-4,R16,152,8,6,83,125,56,83,20,42,6,9,17,76,125,12,4,86,115,62,86,11,29,6,9,17,73,115
2003-09-29 00:00:00.000,Metz France ATP World Tour,HARD,2,Andrei Pavel,Tommy Robredo,Andrei Pavel,7-6(3); 4-6; 6-1,Q,115,6,2,60,91,48,60,18,31,2,3,15,66,91,1,2,76,99,47,76,14,23,10,12,14,61,99
2003-09-29 00:00:00.000,Metz France ATP World Tour,HARD,2,Fernando Gonzalez,David Ferrer,Fernando Gonzalez,7-5; 6-2,Q,68,8,2,39,60,31,39,8,21,3,5,10,39,60,1,1,32,53,19,32,8,21,0,5,10,27,53
2003-09-29 00:00:00.000,Metz France ATP World Tour,HARD,2,Arnaud Clement,Philipp Petzschner,Arnaud Clement,6-2; 3-0 RET,Q,43,5,1,18,28,17,18,7,10,0,0,6,24,28,5,5,16,40,9,16,9,24,2,5,5,18,40
2003-09-29 00:00:00.000,Metz France ATP World Tour,HARD,2,Fabrice Santoro,Alexander Popp,Fabrice Santoro,2-6; 6-3; 6-4,Q,117,2,3,59,87,41,59,15,28,4,7,14,56,87,4,5,60,95,39,60,17,35,8,11,13,56,95
2003-09-29 00:00:00.000,Metz France ATP World Tour,HARD,2,Fernando Gonzalez,Andrei Pavel,Fernando Gonzalez,6-3; 6-4,S,60,5,3,34,48,31,34,9,14,0,0,10,40,48,5,0,42,59,28,42,10,17,3,5,9,38,59
2003-09-29 00:00:00.000,Metz France ATP World Tour,HARD,2,Arnaud Clement,Fabrice Santoro,Arnaud Clement,6-2; 6-1,S,67,5,1,28,45,20,28,9,17,5,7,8,29,45,2,0,26,51,13,26,6,25,1,7,7,19,51
2003-09-29 00:00:00.000,Metz France ATP World Tour,HARD,2,Arnaud Clement,Fernando Gonzalez,Arnaud Clement,6-3; 1-6; 6-3,F,103,12,1,52,82,34,52,22,30,2,4,13,56,82,7,3,44,74,34,44,13,30,4,6,12,47,74
2003-09-29 00:00:00.000,Moscow Russia ATP World Tour,HARD,2,Igor Andreev,Sjeng Schalken,Igor Andreev,6-3; 6-1,R32,56,0,4,27,52,24,27,12,25,1,1,8,36,52,0,1,35,52,21,35,4,17,2,6,8,25,52
2003-09-29 00:00:00.000,Moscow Russia ATP World Tour,HARD,2,Ivan Ljubicic,Tomas Zib,Ivan Ljubicic,6-2; 6-4,R32,73,13,2,24,47,21,24,17,23,4,4,9,38,47,0,3,29,63,20,29,17,34,6,9,9,37,63
2003-09-29 00:00:00.000,Moscow Russia ATP World Tour,HARD,2,Tuomas Ketola,Juan Ignacio Chela,Tuomas Ketola,6-4; 6-7(5); 7-5,R32,145,4,5,64,124,46,64,28,60,14,18,17,74,124,3,7,63,109,39,63,26,46,5,11,17,65,109
2003-09-29 00:00:00.000,Moscow Russia ATP World Tour,HARD,2,Paul-Henri Mathieu,Feliciano Lopez,Paul-Henri Mathieu,6-1; 6-4,R32,63,5,1,29,44,25,29,8,15,2,3,9,33,44,2,7,25,58,19,25,10,33,5,9,8,29,58
2003-09-29 00:00:00.000,Moscow Russia ATP World Tour,HARD,2,Taylor Dent,Felix Mantilla,Taylor Dent,6-2; 6-0,R32,46,10,6,25,44,21,25,9,19,1,1,7,30,44,0,3,22,43,10,22,9,21,3,8,7,19,43
2003-09-29 00:00:00.000,Moscow Russia ATP World Tour,HARD,2,Olivier Rochus,Jonas Bjorkman,Olivier Rochus,6-4; 6-4,R32,88,1,1,46,62,30,46,10,16,1,3,10,40,62,5,7,29,66,23,29,12,37,6,10,10,35,66
2003-09-29 00:00:00.000,Moscow Russia ATP World Tour,HARD,2,Marc Rosset,David Prinosil,Marc Rosset,6-1; 6-1,R32,51,6,3,25,47,19,25,14,22,2,2,7,33,47,1,5,22,41,15,22,3,19,2,7,7,18,41
2003-09-29 00:00:00.000,Moscow Russia ATP World Tour,HARD,2,Karol Kucera,Nicolas Massu,Karol Kucera,6-7(4); 6-2; 6-2,R32,142,6,3,51,83,40,51,16,32,3,5,14,56,83,3,5,48,94,25,48,26,46,3,9,14,51,94
2003-09-29 00:00:00.000,Moscow Russia ATP World Tour,HARD,2,Max Mirnyi,Nikolay Davydenko,Max Mirnyi,6-3; 4-6; 6-3,R32,92,12,3,59,85,50,59,9,26,1,2,14,59,85,3,2,50,70,38,50,13,20,0,3,14,51,70
2003-09-29 00:00:00.000,Moscow Russia ATP World Tour,HARD,2,Stefan Koubek,Mikhail Youzhny,Stefan Koubek,7-6(4); 6-0,R32,72,1,6,39,73,30,39,16,34,4,5,9,46,73,0,4,31,63,17,31,16,32,8,12,9,33,63
2003-09-29 00:00:00.000,Moscow Russia ATP World Tour,HARD,2,Vincent Spadea,Andrei Stoliarov,Vincent Spadea,1-6; 6-4; 6-4,R32,138,8,11,63,130,40,63,24,67,19,26,14,64,130,6,4,39,95,28,39,23,56,11,17,13,51,95
2003-09-29 00:00:00.000,Moscow Russia ATP World Tour,HARD,2,Wayne Black,Marat Safin,Wayne Black,6-4; 6-7(5); 6-4,R32,139,0,3,55,100,39,55,30,45,6,7,16,69,100,18,2,56,101,40,56,25,45,7,10,16,65,101
2003-09-29 00:00:00.000,Moscow Russia ATP World Tour,HARD,2,Yevgeny Kafelnikov,Igor Kunitsyn,Yevgeny Kafelnikov,6-0; 7-6(11),R32,86,7,2,33,62,28,33,16,29,1,2,9,44,62,2,3,34,67,21,34,16,33,6,10,9,37,67
2003-09-29 00:00:00.000,Moscow Russia ATP World Tour,HARD,2,Sargis Sargsian,Filippo Volandri,Sargis Sargsian,6-1; 6-2,R32,47,4,1,24,43,19,24,14,19,0,0,8,33,43,0,3,28,45,14,28,7,17,3,7,7,21,45
2003-09-29 00:00:00.000,Moscow Russia ATP World Tour,HARD,2,Irakli Labadze,Jarkko Nieminen,Irakli Labadze,3-6; 6-4; 6-2,R32,97,9,5,49,78,38,49,17,29,8,10,13,55,78,6,4,57,95,36,57,17,38,9,13,14,53,95
2003-09-29 00:00:00.000,Moscow Russia ATP World Tour,HARD,2,Agustin Calleri,Denis Golovanov,Agustin Calleri,6-2; 6-2,R32,52,4,1,27,44,21,27,9,17,0,1,8,30,44,1,4,26,47,15,26,6,21,3,8,8,21,47
2003-09-29 00:00:00.000,Moscow Russia ATP World Tour,HARD,2,Igor Andreev,Ivan Ljubicic,Igor Andreev,6-4; 7-6(7),R16,92,4,2,49,81,32,49,19,32,3,5,11,51,81,15,3,44,67,35,44,9,23,2,5,11,44,67
2003-09-29 00:00:00.000,Moscow Russia ATP World Tour,HARD,2,Paul-Henri Mathieu,Tuomas Ketola,Paul-Henri Mathieu,6-2; 6-4,R16,68,11,0,28,45,25,28,12,17,0,0,9,37,45,4,4,34,69,23,34,16,35,5,8,9,39,69
2003-09-29 00:00:00.000,Moscow Russia ATP World Tour,HARD,2,Taylor Dent,Olivier Rochus,Taylor Dent,6-4; 2-6; 6-4,R16,93,10,5,31,73,25,31,28,42,1,3,14,53,73,0,1,45,80,32,45,21,35,2,4,14,53,80
2003-09-29 00:00:00.000,Moscow Russia ATP World Tour,HARD,2,Marc Rosset,Karol Kucera,Marc Rosset,7-5; 7-6(6),R16,125,11,6,47,89,33,47,21,42,2,5,12,54,89,4,5,53,89,35,53,14,36,7,11,12,49,89
2003-09-29 00:00:00.000,Moscow Russia ATP World Tour,HARD,2,Stefan Koubek,Max Mirnyi,Stefan Koubek,6-3; 4-6; 7-6(8),R16,124,1,1,68,96,49,68,19,28,4,5,15,68,96,13,3,85,111,61,85,11,26,6,8,16,72,111
2003-09-29 00:00:00.000,Moscow Russia ATP World Tour,HARD,2,Vincent Spadea,Wayne Black,Vincent Spadea,5-7; 7-5; 6-3,R16,153,6,5,51,98,36,51,26,47,4,8,17,62,98,2,2,74,118,43,74,23,44,8,13,16,66,118
2003-09-29 00:00:00.000,Moscow Russia ATP World Tour,HARD,2,Sargis Sargsian,Yevgeny Kafelnikov,Sargis Sargsian,6-4; 2-6; 6-4,R16,111,8,2,52,83,38,52,15,31,3,6,14,53,83,7,3,63,93,44,63,13,30,6,9,14,57,93
2003-09-29 00:00:00.000,Moscow Russia ATP World Tour,HARD,2,Agustin Calleri,Irakli Labadze,Agustin Calleri,6-4; 3-6; 6-1,R16,103,5,3,55,83,36,55,11,28,4,9,13,47,83,4,7,52,79,34,52,7,27,4,11,13,41,79
2003-09-29 00:00:00.000,Moscow Russia ATP World Tour,HARD,2,Paul-Henri Mathieu,Igor Andreev,Paul-Henri Mathieu,2-6; 6-3; 7-5,Q,121,2,7,45,95,32,45,22,50,6,10,15,54,95,6,1,48,73,32,48,15,25,1,5,14,47,73
2003-09-29 00:00:00.000,Moscow Russia ATP World Tour,HARD,2,Taylor Dent,Marc Rosset,Taylor Dent,6-3; 6-4,Q,72,8,3,33,60,26,33,18,27,4,4,10,44,60,1,4,31,56,22,31,12,25,1,3,9,34,56
2003-09-29 00:00:00.000,Moscow Russia ATP World Tour,HARD,2,Vincent Spadea,Stefan Koubek,Vincent Spadea,2-6; 7-6(2); 6-3,Q,114,4,4,58,99,36,58,25,41,6,10,15,61,99,0,2,58,90,41,58,15,32,2,5,14,56,90
2003-09-29 00:00:00.000,Moscow Russia ATP World Tour,HARD,2,Sargis Sargsian,Agustin Calleri,Sargis Sargsian,6-3; 6-4,Q,73,2,2,32,54,25,32,11,22,3,5,10,36,54,6,2,40,61,26,40,5,21,6,10,9,31,61
2003-09-29 00:00:00.000,Moscow Russia ATP World Tour,HARD,2,Taylor Dent,Paul-Henri Mathieu,Taylor Dent,6-3; 2-6; 7-6(1),S,125,17,8,50,92,42,50,19,42,3,6,15,61,92,4,4,40,93,27,40,32,53,2,4,14,59,93
2003-09-29 00:00:00.000,Moscow Russia ATP World Tour,HARD,2,Sargis Sargsian,Vincent Spadea,Sargis Sargsian,6-2; 6-2,S,64,2,1,30,47,20,30,12,17,2,3,8,32,47,0,2,24,46,16,24,6,22,5,10,8,22,46
2003-09-29 00:00:00.000,Moscow Russia ATP World Tour,HARD,2,Taylor Dent,Sargis Sargsian,Taylor Dent,7-6(5); 6-4,F,93,6,5,36,70,31,36,21,34,2,2,11,52,70,1,2,46,72,32,46,19,26,1,2,11,51,72
2003-09-29 00:00:00.000,Tokyo Japan ATP World Tour,HARD,2,Rainer Schuettler,N/A Bye,Rainer Schuettler,,R64,0,0,0,0,0,0,0,0,0,0,0,0,0,0,0,0,0,0,0,0,0,0,0,0,0,0,0
2003-09-29 00:00:00.000,Tokyo Japan ATP World Tour,HARD,2,Satoshi Iwabuchi,Cecil Mamiit,Satoshi Iwabuchi,7-6(4); 6-2,R64,76,6,1,40,57,26,40,15,17,1,2,10,41,57,7,2,30,56,23,30,11,26,1,4,10,34,56
2003-09-29 00:00:00.000,Tokyo Japan ATP World Tour,HARD,2,Robert Kendrick,Wayne Arthurs,Robert Kendrick,7-6(3); 6-4,R64,78,6,3,48,76,37,48,17,28,5,5,11,54,76,12,4,50,73,39,50,10,23,6,7,11,49,73
2003-09-29 00:00:00.000,Tokyo Japan ATP World Tour,HARD,2,Brian Vahaly,N/A Bye,Brian Vahaly,,R64,0,0,0,0,0,0,0,0,0,0,0,0,0,0,0,0,0,0,0,0,0,0,0,0,0,0,0
2003-09-29 00:00:00.000,Tokyo Japan ATP World Tour,HARD,2,Eric Taino,N/A Bye,Eric Taino,,R64,0,0,0,0,0,0,0,0,0,0,0,0,0,0,0,0,0,0,0,0,0,0,0,0,0,0,0
2003-09-29 00:00:00.000,Tokyo Japan ATP World Tour,HARD,2,Scott Draper,Jan Vacek,Scott Draper,6-3; 7-6(4),R64,71,7,2,50,80,38,50,18,30,6,6,11,56,80,7,5,40,59,32,40,10,19,0,1,10,42,59
2003-09-29 00:00:00.000,Tokyo Japan ATP World Tour,HARD,2,Alex Bogomolov Jr.,Ivo Heuberger,Alex Bogomolov Jr.,6-2; 7-6(1),R64,77,3,0,44,59,35,44,7,15,1,2,10,42,59,11,3,39,75,28,39,14,36,6,9,10,42,75
2003-09-29 00:00:00.000,Tokyo Japan ATP World Tour,HARD,2,Nicolas Kiefer,N/A Bye,Nicolas Kiefer,,R64,0,0,0,0,0,0,0,0,0,0,0,0,0,0,0,0,0,0,0,0,0,0,0,0,0,0,0
2003-09-29 00:00:00.000,Tokyo Japan ATP World Tour,HARD,2,Jiri Novak,N/A Bye,Jiri Novak,,R64,0,0,0,0,0,0,0,0,0,0,0,0,0,0,0,0,0,0,0,0,0,0,0,0,0,0,0
2003-09-29 00:00:00.000,Tokyo Japan ATP World Tour,HARD,2,Bjorn Phau,Jeff Salzenstein,Bjorn Phau,6-7(1); 7-6(4); 7-6(3),R64,146,7,5,52,112,39,52,31,60,4,9,18,70,112,12,4,77,121,56,77,19,44,8,13,18,75,121
2003-09-29 00:00:00.000,Tokyo Japan ATP World Tour,HARD,2,Cyril Saulnier,Justin Gimelstob,Cyril Saulnier,7-6(5); 3-6; 6-1,R64,191,7,7,46,81,33,46,23,35,2,5,14,56,81,8,11,57,102,45,57,14,45,6,10,14,59,102
2003-09-29 00:00:00.000,Tokyo Japan ATP World Tour,HARD,2,Lars Burgsmuller,N/A Bye,Lars Burgsmuller,,R64,0,0,0,0,0,0,0,0,0,0,0,0,0,0,0,0,0,0,0,0,0,0,0,0,0,0,0
2003-09-29 00:00:00.000,Tokyo Japan ATP World Tour,HARD,2,Mario Ancic,N/A Bye,Mario Ancic,,R64,0,0,0,0,0,0,0,0,0,0,0,0,0,0,0,0,0,0,0,0,0,0,0,0,0,0,0
2003-09-29 00:00:00.000,Tokyo Japan ATP World Tour,HARD,2,Tasuku Iwami,Werner Eschauer,Tasuku Iwami,6-0; 6-4,R64,63,7,3,29,54,25,29,12,25,6,6,8,37,54,7,1,28,44,19,28,5,16,3,7,8,24,44
2003-09-29 00:00:00.000,Tokyo Japan ATP World Tour,HARD,2,Federico Browne,Takahiro Terachi,Federico Browne,6-3; 6-4,R64,86,3,2,30,63,25,30,13,33,6,8,9,38,63,2,4,56,79,30,56,11,23,13,18,10,41,79
2003-09-29 00:00:00.000,Tokyo Japan ATP World Tour,HARD,2,Mark Philippoussis,N/A Bye,Mark Philippoussis,,R64,0,0,0,0,0,0,0,0,0,0,0,0,0,0,0,0,0,0,0,0,0,0,0,0,0,0,0
2003-09-29 00:00:00.000,Tokyo Japan ATP World Tour,HARD,2,Hyung-Taik Lee,N/A Bye,Hyung-Taik Lee,,R64,0,0,0,0,0,0,0,0,0,0,0,0,0,0,0,0,0,0,0,0,0,0,0,0,0,0,0
2003-09-29 00:00:00.000,Tokyo Japan ATP World Tour,HARD,2,Fernando Verdasco,Glenn Weiner,Fernando Verdasco,6-4; 6-2,R64,73,6,7,37,66,29,37,13,29,5,6,9,42,66,3,4,34,62,24,34,9,28,5,9,9,33,62
2003-09-29 00:00:00.000,Tokyo Japan ATP World Tour,HARD,2,Gouichi Motomura,Martin Vassallo Arguello,Gouichi Motomura,6-0; 6-3,R64,61,2,3,26,45,22,26,11,19,0,0,8,33,45,6,6,26,56,16,26,11,30,4,8,7,27,56
2003-09-29 00:00:00.000,Tokyo Japan ATP World Tour,HARD,2,Kenneth Carlsen,N/A Bye,Kenneth Carlsen,,R64,0,0,0,0,0,0,0,0,0,0,0,0,0,0,0,0,0,0,0,0,0,0,0,0,0,0,0
2003-09-29 00:00:00.000,Tokyo Japan ATP World Tour,HARD,2,Wesley Moodie,N/A Bye,Wesley Moodie,,R64,0,0,0,0,0,0,0,0,0,0,0,0,0,0,0,0,0,0,0,0,0,0,0,0,0,0,0
2003-09-29 00:00:00.000,Tokyo Japan ATP World Tour,HARD,2,Takao Suzuki,Alexander Waske,Takao Suzuki,7-6(5); 6-3,R64,93,12,2,46,76,35,46,13,30,5,7,10,48,76,8,4,50,70,33,50,6,20,2,6,11,39,70
2003-09-29 00:00:00.000,Tokyo Japan ATP World Tour,HARD,2,Dick Norman,George Bastl,Dick Norman,7-5; 6-4,R64,85,8,1,39,58,33,39,13,19,1,1,11,46,58,2,2,39,57,29,39,10,18,2,4,11,39,57
2003-09-29 00:00:00.000,Tokyo Japan ATP World Tour,HARD,2,Paradorn Srichaphan,N/A Bye,Paradorn Srichaphan,,R64,0,0,0,0,0,0,0,0,0,0,0,0,0,0,0,0,0,0,0,0,0,0,0,0,0,0,0
2003-09-29 00:00:00.000,Tokyo Japan ATP World Tour,HARD,2,Jan-Michael Gambill,N/A Bye,Jan-Michael Gambill,,R64,0,0,0,0,0,0,0,0,0,0,0,0,0,0,0,0,0,0,0,0,0,0,0,0,0,0,0
2003-09-29 00:00:00.000,Tokyo Japan ATP World Tour,HARD,2,Bohdan Ulihrach,Ivan Miranda,Bohdan Ulihrach,2-6; 6-4; 6-4,R64,114,5,5,61,94,38,61,13,33,7,13,14,51,94,4,2,65,98,40,65,10,33,2,8,14,50,98
2003-09-29 00:00:00.000,Tokyo Japan ATP World Tour,HARD,2,Michel Kratochvil,Tomas Berdych,Michel Kratochvil,7-6(2); 4-6; 6-3,R64,118,11,0,61,93,49,61,21,32,3,4,16,70,93,13,3,62,93,47,62,16,31,4,5,15,63,93
2003-09-29 00:00:00.000,Tokyo Japan ATP World Tour,HARD,2,John van Lottum,N/A Bye,John van Lottum,,R64,0,0,0,0,0,0,0,0,0,0,0,0,0,0,0,0,0,0,0,0,0,0,0,0,0,0,0
2003-09-29 00:00:00.000,Tokyo Japan ATP World Tour,HARD,2,Gregory Carraz,N/A Bye,Gregory Carraz,,R64,0,0,0,0,0,0,0,0,0,0,0,0,0,0,0,0,0,0,0,0,0,0,0,0,0,0,0
2003-09-29 00:00:00.000,Tokyo Japan ATP World Tour,HARD,2,Dennis van Scheppingen,Andreas Vinciguerra,Dennis van Scheppingen,4-6; 6-4; 6-1,R64,76,5,1,45,72,36,45,18,27,3,4,14,54,72,3,3,40,77,28,40,21,37,2,5,13,49,77
2003-09-29 00:00:00.000,Tokyo Japan ATP World Tour,HARD,2,Ivo Karlovic,Robin Soderling,Ivo Karlovic,6-4; 6-4,R64,69,8,4,36,57,31,36,13,21,2,2,10,44,57,3,2,53,68,34,53,9,15,4,6,10,43,68
2003-09-29 00:00:00.000,Tokyo Japan ATP World Tour,HARD,2,Sebastien Grosjean,N/A Bye,Sebastien Grosjean,,R64,0,0,0,0,0,0,0,0,0,0,0,0,0,0,0,0,0,0,0,0,0,0,0,0,0,0,0
2003-09-29 00:00:00.000,Tokyo Japan ATP World Tour,HARD,2,Rainer Schuettler,Satoshi Iwabuchi,Rainer Schuettler,6-0; 6-4,R32,53,4,1,25,39,20,25,11,14,3,4,8,31,39,0,4,30,54,16,30,9,24,4,9,8,25,54
2003-09-29 00:00:00.000,Tokyo Japan ATP World Tour,HARD,2,Robert Kendrick,Brian Vahaly,Robert Kendrick,6-2; 3-6; 6-4,R32,118,7,7,47,81,34,47,16,34,3,6,13,50,81,1,6,84,119,50,84,14,35,13,18,14,64,119
2003-09-29 00:00:00.000,Tokyo Japan ATP World Tour,HARD,2,Scott Draper,Eric Taino,Scott Draper,6-2; 7-6(5),R32,84,14,2,44,72,37,44,14,28,6,6,10,51,72,6,6,32,69,21,32,20,37,2,4,10,41,69
2003-09-29 00:00:00.000,Tokyo Japan ATP World Tour,HARD,2,Nicolas Kiefer,Alex Bogomolov Jr.,Nicolas Kiefer,7-5; 7-6(7),R32,121,4,0,42,80,29,42,22,38,2,5,12,51,80,1,2,73,92,44,73,7,19,8,12,12,51,92
2003-09-29 00:00:00.000,Tokyo Japan ATP World Tour,HARD,2,Jiri Novak,Bjorn Phau,Jiri Novak,7-6(2); 6-2,R32,73,4,0,41,58,32,41,11,17,2,3,10,43,58,3,3,39,78,24,39,21,39,7,10,10,45,78
2003-09-29 00:00:00.000,Tokyo Japan ATP World Tour,HARD,2,Cyril Saulnier,Lars Burgsmuller,Cyril Saulnier,7-6(6); 7-6(4),R32,98,11,5,40,72,33,40,19,32,0,1,12,52,72,7,5,59,88,41,59,14,29,1,2,12,55,88
2003-09-29 00:00:00.000,Tokyo Japan ATP World Tour,HARD,2,Mario Ancic,Tasuku Iwami,Mario Ancic,6-2; 7-5,R32,79,3,0,44,65,31,44,12,21,5,6,10,43,65,2,1,26,56,19,26,12,30,4,8,10,31,56
2003-09-29 00:00:00.000,Tokyo Japan ATP World Tour,HARD,2,Mark Philippoussis,Federico Browne,Mark Philippoussis,6-4; 6-3,R32,68,18,2,35,59,30,35,13,24,0,0,10,43,59,1,1,36,53,23,36,11,17,0,2,9,34,53
2003-09-29 00:00:00.000,Tokyo Japan ATP World Tour,HARD,2,Hyung-Taik Lee,Fernando Verdasco,Hyung-Taik Lee,6-3; 6-7(3); 6-3,R32,118,4,1,68,98,53,68,18,30,4,4,16,71,98,4,8,57,90,43,57,17,33,3,5,14,60,90
2003-09-29 00:00:00.000,Tokyo Japan ATP World Tour,HARD,2,Kenneth Carlsen,Gouichi Motomura,Kenneth Carlsen,6-2; 7-6(4),R32,92,15,2,43,69,37,43,11,26,0,1,10,48,69,2,1,41,63,26,41,12,22,2,5,10,38,63
2003-09-29 00:00:00.000,Tokyo Japan ATP World Tour,HARD,2,Takao Suzuki,Wesley Moodie,Takao Suzuki,6-1; 7-6(3),R32,64,12,2,32,58,30,32,17,26,1,1,10,47,58,9,3,33,47,25,33,7,14,0,2,9,32,47
2003-09-29 00:00:00.000,Tokyo Japan ATP World Tour,HARD,2,Paradorn Srichaphan,Dick Norman,Paradorn Srichaphan,4-6; 7-6(3); 7-6(2),R32,131,8,5,56,98,46,56,23,42,4,7,17,69,98,16,6,63,99,47,63,20,36,3,5,17,67,99
2003-09-29 00:00:00.000,Tokyo Japan ATP World Tour,HARD,2,Jan-Michael Gambill,Bohdan Ulihrach,Jan-Michael Gambill,6-3; 6-4,R32,66,7,3,23,50,22,23,17,27,1,2,10,39,50,3,2,43,58,26,43,7,15,6,9,9,33,58
2003-09-29 00:00:00.000,Tokyo Japan ATP World Tour,HARD,2,Michel Kratochvil,John van Lottum,Michel Kratochvil,6-2; 6-3,R32,69,3,2,26,45,21,26,12,19,0,1,9,33,45,3,1,27,52,14,27,12,25,3,7,8,26,52
2003-09-29 00:00:00.000,Tokyo Japan ATP World Tour,HARD,2,Dennis van Scheppingen,Gregory Carraz,Dennis van Scheppingen,7-5; 1-6; 7-5,R32,92,5,4,56,82,42,56,15,26,3,6,15,57,82,8,7,58,90,46,58,15,32,6,9,16,61,90
2003-09-29 00:00:00.000,Tokyo Japan ATP World Tour,HARD,2,Sebastien Grosjean,Ivo Karlovic,Sebastien Grosjean,6-3; 7-6(8),R32,91,5,1,34,69,28,34,26,35,2,2,11,54,69,9,6,39,65,34,39,11,26,3,4,10,45,65
2003-09-29 00:00:00.000,Tokyo Japan ATP World Tour,HARD,2,Rainer Schuettler,Robert Kendrick,Rainer Schuettler,6-3; 6-2,R16,69,6,0,28,51,24,28,15,23,2,2,9,39,51,6,4,36,64,23,36,12,28,6,9,8,35,64
2003-09-29 00:00:00.000,Tokyo Japan ATP World Tour,HARD,2,Scott Draper,Nicolas Kiefer,Scott Draper,7-5; 6-2,R16,86,8,4,35,60,27,35,15,25,5,6,10,42,60,4,7,35,71,25,35,12,36,5,9,10,37,71
2003-09-29 00:00:00.000,Tokyo Japan ATP World Tour,HARD,2,Cyril Saulnier,Jiri Novak,Cyril Saulnier,4-6; 7-5; 6-4,R16,115,11,2,56,96,36,56,19,40,2,7,16,55,96,9,0,63,94,38,63,16,31,1,7,16,54,94
2003-09-29 00:00:00.000,Tokyo Japan ATP World Tour,HARD,2,Mark Philippoussis,Mario Ancic,Mark Philippoussis,6-4; 7-5,R16,78,7,1,40,65,34,40,8,25,3,5,11,42,65,4,2,42,61,26,42,10,19,0,4,11,36,61
2003-09-29 00:00:00.000,Tokyo Japan ATP World Tour,HARD,2,Hyung-Taik Lee,Kenneth Carlsen,Hyung-Taik Lee,6-3; 6-4,R16,84,3,1,41,61,33,41,8,20,2,3,10,41,61,9,1,38,62,27,38,9,24,9,12,9,36,62
2003-09-29 00:00:00.000,Tokyo Japan ATP World Tour,HARD,2,Paradorn Srichaphan,Takao Suzuki,Paradorn Srichaphan,6-2; 7-6(3),R16,103,6,2,35,70,28,35,22,35,4,4,10,50,70,8,5,51,86,34,51,16,35,6,8,10,50,86
2003-09-29 00:00:00.000,Tokyo Japan ATP World Tour,HARD,2,Jan-Michael Gambill,Michel Kratochvil,Jan-Michael Gambill,6-3; 7-5,R16,99,13,3,37,66,31,37,14,29,1,2,11,45,66,1,6,40,64,27,40,10,24,2,5,10,37,64
2003-09-29 00:00:00.000,Tokyo Japan ATP World Tour,HARD,2,Sebastien Grosjean,Dennis van Scheppingen,Sebastien Grosjean,6-3; 7-6(3),R16,89,12,2,35,69,31,35,16,34,5,7,11,47,69,4,3,36,71,24,36,17,35,7,10,10,41,71
2003-09-29 00:00:00.000,Tokyo Japan ATP World Tour,HARD,2,Rainer Schuettler,Scott Draper,Rainer Schuettler,6-3; 6-3,Q,69,3,2,40,59,29,40,12,19,2,2,9,41,59,2,0,33,54,18,33,13,21,1,4,9,31,54
2003-09-29 00:00:00.000,Tokyo Japan ATP World Tour,HARD,2,Cyril Saulnier,Mark Philippoussis,Cyril Saulnier,5-2 RET,Q,31,0,0,12,19,10,12,4,7,0,0,3,14,19,1,2,16,27,9,16,5,11,1,3,4,14,27
2003-09-29 00:00:00.000,Tokyo Japan ATP World Tour,HARD,2,Paradorn Srichaphan,Hyung-Taik Lee,Paradorn Srichaphan,4-6; 7-6(5); 6-3,Q,142,6,2,52,86,39,52,22,34,0,2,15,61,86,2,3,56,109,42,56,27,53,7,10,16,69,109
2003-09-29 00:00:00.000,Tokyo Japan ATP World Tour,HARD,2,Sebastien Grosjean,Jan-Michael Gambill,Sebastien Grosjean,6-3; 7-6(4),Q,96,14,0,38,64,32,38,17,26,0,1,11,49,64,9,0,40,73,32,40,13,33,5,7,10,45,73
2003-09-29 00:00:00.000,Tokyo Japan ATP World Tour,HARD,2,Rainer Schuettler,Cyril Saulnier,Rainer Schuettler,6-3; 6-2,S,76,5,0,40,52,33,40,7,12,5,5,9,40,52,3,4,42,71,24,42,13,29,4,7,8,37,71
2003-09-29 00:00:00.000,Tokyo Japan ATP World Tour,HARD,2,Sebastien Grosjean,Paradorn Srichaphan,Sebastien Grosjean,4-6; 6-3; 6-4,S,122,7,4,50,102,40,50,30,52,6,7,15,70,102,8,3,48,77,39,48,14,29,5,7,14,53,77
2003-09-29 00:00:00.000,Tokyo Japan ATP World Tour,HARD,2,Rainer Schuettler,Sebastien Grosjean,Rainer Schuettler,7-6(5); 6-2,F,88,4,2,44,66,36,44,10,22,4,5,10,46,66,7,0,43,70,29,43,12,27,2,5,10,41,70
2003-10-06 00:00:00.000,Lyon France ATP World Tour,HARD,2,Rainer Schuettler,Paul-Henri Mathieu,Rainer Schuettler,6-2; 6-2,R32,68,3,3,29,44,22,29,10,15,0,0,8,32,44,1,2,20,53,13,20,13,33,2,6,8,26,53
2003-10-06 00:00:00.000,Lyon France ATP World Tour,HARD,2,Ivan Ljubicic,Nicolas Lapentti,Ivan Ljubicic,6-2; 7-6(3),R32,91,16,2,40,63,32,40,13,23,3,4,10,45,63,2,4,42,74,27,42,13,32,4,7,10,40,74
2003-10-06 00:00:00.000,Lyon France ATP World Tour,HARD,2,Xavier Malisse,Andrei Pavel,Xavier Malisse,5-7; 6-3; 6-4,R32,108,11,3,52,90,45,52,22,38,1,2,16,67,90,8,4,52,94,40,52,22,42,1,3,15,62,94
2003-10-06 00:00:00.000,Lyon France ATP World Tour,HARD,2,Thomas Enqvist,Wayne Ferreira,Thomas Enqvist,7-6(7); 7-6(3),R32,111,11,4,52,88,41,52,21,36,3,4,12,62,88,14,4,66,113,46,66,23,47,9,10,12,69,113
2003-10-06 00:00:00.000,Lyon France ATP World Tour,HARD,2,Mikhail Youzhny,Felix Mantilla,Mikhail Youzhny,6-3; 7-6(2),R32,87,6,5,31,66,24,31,18,35,1,4,10,42,66,3,1,43,74,27,43,11,31,3,8,11,38,74
2003-10-06 00:00:00.000,Lyon France ATP World Tour,HARD,2,Dominik Hrbaty,Rafael Nadal,Dominik Hrbaty,6-3; 7-5,R32,77,4,4,30,55,25,30,14,25,1,3,11,39,55,2,7,52,72,31,52,7,20,4,8,10,38,72
2003-10-06 00:00:00.000,Lyon France ATP World Tour,HARD,2,Robby Ginepri,Raemon Sluiter,Robby Ginepri,7-6(5); 6-3,R32,73,10,3,32,60,26,32,14,28,2,4,10,40,60,9,5,51,86,33,51,15,35,7,11,11,48,86
2003-10-06 00:00:00.000,Lyon France ATP World Tour,HARD,2,Cyril Saulnier,Mardy Fish,Cyril Saulnier,7-5; 6-3,R32,76,14,9,41,68,35,41,13,27,1,1,11,48,68,9,2,40,61,31,40,9,21,3,5,10,40,61
2003-10-06 00:00:00.000,Lyon France ATP World Tour,HARD,2,Fabrice Santoro,Marat Safin,Fabrice Santoro,6-1; 6-4,R32,64,2,0,20,44,20,20,15,24,0,1,9,35,44,4,0,29,46,17,29,7,17,1,5,8,24,46
2003-10-06 00:00:00.000,Lyon France ATP World Tour,HARD,2,Marc Rosset,Alex Corretja,Marc Rosset,7-6(3); 7-6(5),R32,123,26,4,47,84,41,47,23,37,3,3,12,64,84,5,5,45,81,35,45,22,36,3,3,12,57,81
2003-10-06 00:00:00.000,Lyon France ATP World Tour,HARD,2,Olivier Rochus,Thierry Ascione,Olivier Rochus,3-6; 7-6(4); 6-3,R32,126,3,3,67,96,44,67,14,29,4,8,14,58,96,11,7,64,107,43,64,19,43,3,8,16,62,107
2003-10-06 00:00:00.000,Lyon France ATP World Tour,HARD,2,Paradorn Srichaphan,David Sanchez,Paradorn Srichaphan,6-1; 6-1,R32,40,2,6,16,35,14,16,11,19,1,2,7,25,35,0,2,19,39,9,19,3,20,2,8,7,12,39
2003-10-06 00:00:00.000,Lyon France ATP World Tour,HARD,2,Fernando Vicente,Yevgeny Kafelnikov,Fernando Vicente,6-2; 6-3,R32,66,4,2,24,50,20,24,12,26,2,3,8,32,50,1,3,31,65,17,31,14,34,6,11,9,31,65
2003-10-06 00:00:00.000,Lyon France ATP World Tour,HARD,2,Arnaud Clement,Flavio Saretta,Arnaud Clement,6-3; 6-4,R32,78,7,3,34,54,30,34,12,20,2,2,10,42,54,4,4,26,62,20,26,18,36,4,6,9,38,62
2003-10-06 00:00:00.000,Lyon France ATP World Tour,HARD,2,Hicham Arazi,Radek Stepanek,Hicham Arazi,6-7(7); 7-5; 7-6(5),R32,167,6,1,78,120,58,78,24,42,5,7,18,82,120,11,6,79,128,62,79,19,49,10,13,18,81,128
2003-10-06 00:00:00.000,Lyon France ATP World Tour,HARD,2,Nicolas Mahut,Sebastien Grosjean,Nicolas Mahut,4-6; 6-3 RET,R32,74,9,4,28,53,22,28,15,25,2,3,9,37,53,6,2,28,56,24,28,12,28,1,3,10,36,56
2003-10-06 00:00:00.000,Lyon France ATP World Tour,HARD,2,Rainer Schuettler,Ivan Ljubicic,Rainer Schuettler,4-6; 7-6(2); 7-5,R16,143,6,3,72,113,52,72,24,41,8,10,17,76,113,18,3,48,95,39,48,28,47,1,3,17,67,95
2003-10-06 00:00:00.000,Lyon France ATP World Tour,HARD,2,Xavier Malisse,Thomas Enqvist,Xavier Malisse,6-3; 6-4,R16,79,5,4,28,51,18,28,15,23,1,3,9,33,51,5,10,26,75,17,26,20,49,3,8,10,37,75
2003-10-06 00:00:00.000,Lyon France ATP World Tour,HARD,2,Mikhail Youzhny,Dominik Hrbaty,Mikhail Youzhny,1-6; 7-6(1); 6-2,R16,106,6,4,49,89,39,49,18,40,7,10,13,57,89,7,6,51,97,39,51,19,46,7,10,14,58,97
2003-10-06 00:00:00.000,Lyon France ATP World Tour,HARD,2,Robby Ginepri,Cyril Saulnier,Robby Ginepri,4-6; 6-3; 6-4,R16,102,13,6,49,95,39,49,26,46,3,4,15,65,95,10,5,43,82,32,43,21,39,3,5,14,53,82
2003-10-06 00:00:00.000,Lyon France ATP World Tour,HARD,2,Fabrice Santoro,Marc Rosset,Fabrice Santoro,6-3; 5-7; 6-4,R16,133,10,3,59,95,44,59,20,36,4,6,16,64,95,24,14,54,96,44,54,18,42,5,8,15,62,96
2003-10-06 00:00:00.000,Lyon France ATP World Tour,HARD,2,Paradorn Srichaphan,Olivier Rochus,Paradorn Srichaphan,6-3; 6-2,R16,62,5,3,31,60,25,31,15,29,3,4,9,40,60,1,2,34,49,19,34,4,15,4,8,8,23,49
2003-10-06 00:00:00.000,Lyon France ATP World Tour,HARD,2,Arnaud Clement,Fernando Vicente,Arnaud Clement,6-1; 6-4,R16,76,5,3,30,54,26,30,9,24,2,4,9,35,54,1,3,34,57,19,34,8,23,4,9,8,27,57
2003-10-06 00:00:00.000,Lyon France ATP World Tour,HARD,2,Hicham Arazi,Nicolas Mahut,Hicham Arazi,6-2; 6-4,R16,64,2,0,30,47,26,30,11,17,1,1,9,37,47,2,3,32,55,21,32,10,23,4,7,9,31,55
2003-10-06 00:00:00.000,Lyon France ATP World Tour,HARD,2,Rainer Schuettler,Xavier Malisse,Rainer Schuettler,7-6(2); 6-4,Q,95,4,2,35,61,23,35,19,26,1,4,11,42,61,1,1,46,76,27,46,15,30,6,10,11,42,76
2003-10-06 00:00:00.000,Lyon France ATP World Tour,HARD,2,Mikhail Youzhny,Robby Ginepri,Mikhail Youzhny,7-6(3); 6-2,Q,86,2,3,38,72,32,38,16,34,5,6,10,48,72,2,2,42,76,26,42,15,34,7,10,10,41,76
2003-10-06 00:00:00.000,Lyon France ATP World Tour,HARD,2,Paradorn Srichaphan,Fabrice Santoro,Paradorn Srichaphan,1-6; 6-3; 7-6(4),Q,137,5,4,44,90,33,44,23,46,4,8,14,56,90,1,0,71,110,48,71,16,39,3,6,14,64,110
2003-10-06 00:00:00.000,Lyon France ATP World Tour,HARD,2,Arnaud Clement,Hicham Arazi,Arnaud Clement,6-3; 6-4,Q,90,6,2,50,79,38,50,14,29,5,5,10,52,79,1,0,31,51,19,31,12,20,0,2,9,31,51
2003-10-06 00:00:00.000,Lyon France ATP World Tour,HARD,2,Rainer Schuettler,Mikhail Youzhny,Rainer Schuettler,6-3; 3-6; 7-5,S,141,1,4,60,100,32,60,18,40,12,20,15,50,100,4,3,54,102,29,54,20,48,7,16,15,49,102
2003-10-06 00:00:00.000,Lyon France ATP World Tour,HARD,2,Arnaud Clement,Paradorn Srichaphan,Arnaud Clement,6-2; 6-3,S,69,2,2,29,42,27,29,6,13,0,0,8,33,42,5,5,35,66,21,35,12,31,7,11,9,33,66
2003-10-06 00:00:00.000,Lyon France ATP World Tour,HARD,2,Rainer Schuettler,Arnaud Clement,Rainer Schuettler,7-5; 6-3,F,111,6,2,34,64,22,34,19,30,2,4,11,41,64,3,2,37,67,22,37,15,30,6,10,10,37,67
2003-10-06 00:00:00.000,Vienna Austria ATP World Tour,HARD,2,Roger Federer,David Ferrer,Roger Federer,6-2; 6-2,R32,56,1,0,31,47,21,31,13,16,1,1,8,34,47,0,3,32,57,15,32,13,25,2,6,8,28,57
2003-10-06 00:00:00.000,Vienna Austria ATP World Tour,HARD,2,Karol Beck,James Blake,Karol Beck,3-6; 6-3; 7-6(6),R32,118,5,9,47,102,32,47,26,55,11,15,15,58,102,3,4,52,94,37,52,19,42,5,9,15,56,94
2003-10-06 00:00:00.000,Vienna Austria ATP World Tour,HARD,2,Jarkko Nieminen,Karol Kucera,Jarkko Nieminen,7-6(4); 6-0,R32,80,2,1,40,58,26,40,10,18,1,3,9,36,58,4,5,28,63,19,28,12,35,4,9,9,31,63
2003-10-06 00:00:00.000,Vienna Austria ATP World Tour,HARD,2,Juan Ignacio Chela,Nicolas Massu,Juan Ignacio Chela,7-5; 7-6(4),R32,101,2,3,45,76,33,45,14,31,3,6,12,47,76,2,3,39,77,21,39,22,38,5,9,12,43,77
2003-10-06 00:00:00.000,Vienna Austria ATP World Tour,HARD,2,Feliciano Lopez,Jiri Novak,Feliciano Lopez,6-4; 7-6(3),R32,83,8,3,40,70,32,40,18,30,2,3,11,50,70,2,5,45,73,31,45,15,28,7,9,11,46,73
2003-10-06 00:00:00.000,Vienna Austria ATP World Tour,HARD,2,Stefan Koubek,Nikolay Davydenko,Stefan Koubek,6-2; 4-6; 7-6(3),R32,123,4,1,59,95,41,59,19,36,6,10,15,60,95,0,3,71,95,42,71,11,24,3,8,15,53,95
2003-10-06 00:00:00.000,Vienna Austria ATP World Tour,HARD,2,Max Mirnyi,Jan-Michael Gambill,Max Mirnyi,6-4; 6-2,R32,69,5,2,38,57,32,38,9,19,5,5,9,41,57,7,3,33,55,22,33,12,22,4,7,9,34,55
2003-10-06 00:00:00.000,Vienna Austria ATP World Tour,HARD,2,Agustin Calleri,Mariano Zabaleta,Agustin Calleri,6-4; 6-2,R32,66,7,1,29,47,23,29,10,18,0,2,9,33,47,2,4,36,59,19,36,9,23,2,7,9,28,59
2003-10-06 00:00:00.000,Vienna Austria ATP World Tour,HARD,2,Albert Costa,Sargis Sargsian,Albert Costa,6-4; 6-4,R32,84,7,2,23,52,22,23,16,29,0,1,10,38,52,7,1,38,60,29,38,7,22,4,7,10,36,60
2003-10-06 00:00:00.000,Vienna Austria ATP World Tour,HARD,2,Jonas Bjorkman,Filippo Volandri,Jonas Bjorkman,6-1; 6-4,R32,62,2,0,27,46,22,27,12,19,1,2,9,34,46,1,4,29,58,15,29,12,29,4,8,8,27,58
2003-10-06 00:00:00.000,Vienna Austria ATP World Tour,HARD,2,Tim Henman,Stefano Pescosolido,Tim Henman,6-2; 6-3,R32,70,6,4,24,50,20,24,15,26,1,2,9,35,50,1,6,28,56,17,28,12,28,7,11,8,29,56
2003-10-06 00:00:00.000,Vienna Austria ATP World Tour,HARD,2,Sjeng Schalken,Alexander Waske,Sjeng Schalken,4-6; 6-1; 6-2,R32,106,1,2,55,71,39,55,10,16,1,3,13,49,71,6,4,41,78,25,41,18,37,4,9,12,43,78
2003-10-06 00:00:00.000,Vienna Austria ATP World Tour,HARD,2,Jurgen Melzer,Tommy Robredo,Jurgen Melzer,6-2; 6-7(4); 7-6(3),R32,140,6,9,61,120,43,61,32,59,9,12,16,75,120,1,7,97,129,62,97,14,32,5,10,16,76,129
2003-10-06 00:00:00.000,Vienna Austria ATP World Tour,HARD,2,Nicolas Kiefer,Alexander Peya,Nicolas Kiefer,7-5; 7-5,R32,103,7,2,31,65,23,31,21,34,2,4,12,44,65,1,2,46,82,30,46,15,36,5,9,12,45,82
2003-10-06 00:00:00.000,Vienna Austria ATP World Tour,HARD,2,Vincent Spadea,Davide Sanguinetti,Vincent Spadea,6-7(4); 6-4; 1-0 RET,R32,91,6,5,43,73,29,43,16,30,7,10,11,45,73,6,5,52,83,36,52,10,31,5,10,12,46,83
2003-10-06 00:00:00.000,Vienna Austria ATP World Tour,HARD,2,Carlos Moya,Fernando Gonzalez,Carlos Moya,6-4; 6-7(6); 6-1,R32,105,15,6,48,89,42,48,23,41,1,1,15,65,89,3,7,43,83,31,43,23,40,3,6,14,54,83
2003-10-06 00:00:00.000,Vienna Austria ATP World Tour,HARD,2,Roger Federer,Karol Beck,Roger Federer,6-3; 4-6; 6-4,R16,116,2,7,42,83,34,42,19,41,0,4,15,53,83,6,11,50,100,32,50,24,50,9,14,14,56,100
2003-10-06 00:00:00.000,Vienna Austria ATP World Tour,HARD,2,Jarkko Nieminen,Juan Ignacio Chela,Jarkko Nieminen,6-2; 6-7(10); 6-3,R16,132,2,3,63,93,41,63,16,30,3,5,14,57,93,4,3,59,109,41,59,17,50,7,13,15,58,109
2003-10-06 00:00:00.000,Vienna Austria ATP World Tour,HARD,2,Feliciano Lopez,Stefan Koubek,Feliciano Lopez,6-2; 6-2,R16,48,9,0,25,38,22,25,10,13,0,0,8,32,38,0,4,31,54,19,31,6,23,3,7,8,25,54
2003-10-06 00:00:00.000,Vienna Austria ATP World Tour,HARD,2,Max Mirnyi,Agustin Calleri,Max Mirnyi,W/O,R16,0,0,0,0,0,0,0,0,0,0,0,0,0,0,0,0,0,0,0,0,0,0,0,0,0,0,0
2003-10-06 00:00:00.000,Vienna Austria ATP World Tour,HARD,2,Jonas Bjorkman,Albert Costa,Jonas Bjorkman,6-3; 6-4,R16,92,8,3,34,67,25,34,19,33,3,4,10,44,67,9,1,44,64,27,44,11,20,3,6,9,38,64
2003-10-06 00:00:00.000,Vienna Austria ATP World Tour,HARD,2,Tim Henman,Sjeng Schalken,Tim Henman,6-2; 2-6; 6-2,R16,96,5,2,35,68,30,35,16,33,2,4,12,46,68,0,0,49,66,31,49,9,17,6,10,12,40,66
2003-10-06 00:00:00.000,Vienna Austria ATP World Tour,HARD,2,Nicolas Kiefer,Jurgen Melzer,Nicolas Kiefer,6-3; 6-4,R16,94,4,4,28,58,19,28,16,30,2,5,10,35,58,4,3,45,76,25,45,12,31,12,17,9,37,76
2003-10-06 00:00:00.000,Vienna Austria ATP World Tour,HARD,2,Carlos Moya,Vincent Spadea,Carlos Moya,6-2; 6-1,R16,52,7,2,21,35,19,21,10,14,2,2,7,29,35,2,3,31,54,16,31,10,23,4,9,8,26,54
2003-10-06 00:00:00.000,Vienna Austria ATP World Tour,HARD,2,Roger Federer,Jarkko Nieminen,Roger Federer,6-3; 6-3,Q,60,6,0,40,61,30,40,11,21,2,2,9,41,61,2,1,26,47,17,26,12,21,1,4,9,29,47
2003-10-06 00:00:00.000,Vienna Austria ATP World Tour,HARD,2,Max Mirnyi,Feliciano Lopez,Max Mirnyi,7-6(5); 6-4,Q,77,5,2,41,59,38,41,12,18,0,0,11,50,59,8,1,57,73,40,57,10,16,2,3,11,50,73
2003-10-06 00:00:00.000,Vienna Austria ATP World Tour,HARD,2,Tim Henman,Jonas Bjorkman,Tim Henman,6-1; 6-4,Q,76,1,2,30,60,20,30,19,30,5,6,9,39,60,1,4,30,49,17,30,8,19,2,6,8,25,49
2003-10-06 00:00:00.000,Vienna Austria ATP World Tour,HARD,2,Carlos Moya,Nicolas Kiefer,Carlos Moya,6-4; 7-6(5),Q,108,11,10,39,73,32,39,18,34,6,7,11,50,73,6,6,34,81,24,34,25,47,5,7,11,49,81
2003-10-06 00:00:00.000,Vienna Austria ATP World Tour,HARD,2,Roger Federer,Max Mirnyi,Roger Federer,6-2; 7-6(2),S,74,4,0,37,57,31,37,17,20,0,0,10,48,57,4,3,41,66,26,41,14,25,0,2,10,40,66
2003-10-06 00:00:00.000,Vienna Austria ATP World Tour,HARD,2,Carlos Moya,Tim Henman,Carlos Moya,7-6(1); 7-5,S,101,4,6,40,76,34,40,18,36,2,4,12,52,76,5,7,38,75,26,38,20,37,6,9,12,46,75
2003-10-06 00:00:00.000,Vienna Austria ATP World Tour,HARD,2,Roger Federer,Carlos Moya,Roger Federer,6-3; 6-3; 6-3,F,93,10,2,55,84,46,55,16,29,0,0,14,62,84,1,7,35,78,26,35,19,43,3,7,13,45,78
2003-10-13 00:00:00.000,ATP Masters Series Madrid Spain ATP World Tour,HARD,2,Juan Carlos Ferrero,N/A Bye,Juan Carlos Ferrero,,R64,0,0,0,0,0,0,0,0,0,0,0,0,0,0,0,0,0,0,0,0,0,0,0,0,0,0,0
2003-10-13 00:00:00.000,ATP Masters Series Madrid Spain ATP World Tour,HARD,2,Wayne Ferreira,Ivan Ljubicic,Wayne Ferreira,7-6(7); 7-6(5),R64,120,11,3,50,91,39,50,24,41,5,6,12,63,91,9,4,52,99,39,52,24,47,3,4,12,63,99
2003-10-13 00:00:00.000,ATP Masters Series Madrid Spain ATP World Tour,HARD,2,Thomas Enqvist,Yevgeny Kafelnikov,Thomas Enqvist,6-3 RET,R64,44,5,0,20,40,15,20,13,20,3,3,5,28,40,5,3,17,35,12,17,8,18,7,8,4,20,35
2003-10-13 00:00:00.000,ATP Masters Series Madrid Spain ATP World Tour,HARD,2,Felix Mantilla,N/A Bye,Felix Mantilla,,R64,0,0,0,0,0,0,0,0,0,0,0,0,0,0,0,0,0,0,0,0,0,0,0,0,0,0,0
2003-10-13 00:00:00.000,ATP Masters Series Madrid Spain ATP World Tour,HARD,2,Sjeng Schalken,N/A Bye,Sjeng Schalken,,R64,0,0,0,0,0,0,0,0,0,0,0,0,0,0,0,0,0,0,0,0,0,0,0,0,0,0,0
2003-10-13 00:00:00.000,ATP Masters Series Madrid Spain ATP World Tour,HARD,2,Jan-Michael Gambill,Nikolay Davydenko,Jan-Michael Gambill,6-3; 6-3,R64,87,7,2,33,59,27,33,14,26,2,2,9,41,59,4,4,38,72,23,38,17,34,2,5,9,40,72
2003-10-13 00:00:00.000,ATP Masters Series Madrid Spain ATP World Tour,HARD,2,Albert Costa,Fernando Gonzalez,Albert Costa,6-3; 7-6(3),R64,96,9,1,48,80,37,48,19,32,5,5,11,56,80,14,2,34,56,29,34,12,22,0,1,10,41,56
2003-10-13 00:00:00.000,ATP Masters Series Madrid Spain ATP World Tour,HARD,2,Paradorn Srichaphan,N/A Bye,Paradorn Srichaphan,,R64,0,0,0,0,0,0,0,0,0,0,0,0,0,0,0,0,0,0,0,0,0,0,0,0,0,0,0
2003-10-13 00:00:00.000,ATP Masters Series Madrid Spain ATP World Tour,HARD,2,Roger Federer,N/A Bye,Roger Federer,,R64,0,0,0,0,0,0,0,0,0,0,0,0,0,0,0,0,0,0,0,0,0,0,0,0,0,0,0
2003-10-13 00:00:00.000,ATP Masters Series Madrid Spain ATP World Tour,HARD,2,Alex Corretja,Rafael Nadal,Alex Corretja,6-2; 3-6; 6-4,R64,127,3,7,47,82,32,47,14,35,5,9,13,46,82,1,1,57,80,32,57,11,23,4,10,14,43,80
2003-10-13 00:00:00.000,ATP Masters Series Madrid Spain ATP World Tour,HARD,2,Mardy Fish,Tim Henman,Mardy Fish,7-6(4); 6-3,R64,101,7,4,32,77,29,32,25,45,1,2,11,54,77,3,4,35,66,26,35,16,31,1,3,10,42,66
2003-10-13 00:00:00.000,ATP Masters Series Madrid Spain ATP World Tour,HARD,2,Tommy Robredo,N/A Bye,Tommy Robredo,,R64,0,0,0,0,0,0,0,0,0,0,0,0,0,0,0,0,0,0,0,0,0,0,0,0,0,0,0
2003-10-13 00:00:00.000,ATP Masters Series Madrid Spain ATP World Tour,HARD,2,Mark Philippoussis,N/A Bye,Mark Philippoussis,,R64,0,0,0,0,0,0,0,0,0,0,0,0,0,0,0,0,0,0,0,0,0,0,0,0,0,0,0
2003-10-13 00:00:00.000,ATP Masters Series Madrid Spain ATP World Tour,HARD,2,Feliciano Lopez,Mariano Zabaleta,Feliciano Lopez,6-2; 3-6; 6-3,R64,111,6,4,38,72,27,38,25,34,1,3,13,52,72,3,4,58,94,35,58,19,36,8,12,13,54,94
2003-10-13 00:00:00.000,ATP Masters Series Madrid Spain ATP World Tour,HARD,2,Gaston Gaudio,Jarkko Nieminen,Gaston Gaudio,3-6; 7-5; 6-2,R64,100,8,2,56,82,41,56,15,26,1,3,14,56,82,2,3,54,84,35,54,16,30,4,8,15,51,84
2003-10-13 00:00:00.000,ATP Masters Series Madrid Spain ATP World Tour,HARD,2,Carlos Moya,N/A Bye,Carlos Moya,,R64,0,0,0,0,0,0,0,0,0,0,0,0,0,0,0,0,0,0,0,0,0,0,0,0,0,0,0
2003-10-13 00:00:00.000,ATP Masters Series Madrid Spain ATP World Tour,HARD,2,Sebastien Grosjean,N/A Bye,Sebastien Grosjean,,R64,0,0,0,0,0,0,0,0,0,0,0,0,0,0,0,0,0,0,0,0,0,0,0,0,0,0,0
2003-10-13 00:00:00.000,ATP Masters Series Madrid Spain ATP World Tour,HARD,2,David Ferrer,Mikhail Youzhny,David Ferrer,1-6; 6-4; 6-4,R64,105,1,2,52,82,32,52,16,30,3,8,14,48,82,2,3,37,83,28,37,21,46,1,5,13,49,83
2003-10-13 00:00:00.000,ATP Masters Series Madrid Spain ATP World Tour,HARD,2,Vincent Spadea,Christophe Rochus,Vincent Spadea,6-4; 7-5,R64,97,5,8,32,75,24,32,18,43,4,8,11,42,75,1,9,45,84,28,45,13,39,6,12,11,41,84
2003-10-13 00:00:00.000,ATP Masters Series Madrid Spain ATP World Tour,HARD,2,Agustin Calleri,N/A Bye,Agustin Calleri,,R64,0,0,0,0,0,0,0,0,0,0,0,0,0,0,0,0,0,0,0,0,0,0,0,0,0,0,0
2003-10-13 00:00:00.000,ATP Masters Series Madrid Spain ATP World Tour,HARD,2,Younes El Aynaoui,N/A Bye,Younes El Aynaoui,,R64,0,0,0,0,0,0,0,0,0,0,0,0,0,0,0,0,0,0,0,0,0,0,0,0,0,0,0
2003-10-13 00:00:00.000,ATP Masters Series Madrid Spain ATP World Tour,HARD,2,Jonas Bjorkman,Marat Safin,Jonas Bjorkman,4-6; 7-5; 6-4,R64,151,8,7,62,96,46,62,18,34,5,8,16,64,96,16,4,77,132,55,77,19,55,14,18,16,74,132
2003-10-13 00:00:00.000,ATP Masters Series Madrid Spain ATP World Tour,HARD,2,Robby Ginepri,Olivier Rochus,Robby Ginepri,6-3; 6-3,R64,69,9,2,39,64,33,39,9,25,4,5,9,42,64,1,3,29,61,19,29,15,32,5,9,9,34,61
2003-10-13 00:00:00.000,ATP Masters Series Madrid Spain ATP World Tour,HARD,2,Rainer Schuettler,N/A Bye,Rainer Schuettler,,R64,0,0,0,0,0,0,0,0,0,0,0,0,0,0,0,0,0,0,0,0,0,0,0,0,0,0,0
2003-10-13 00:00:00.000,ATP Masters Series Madrid Spain ATP World Tour,HARD,2,Jiri Novak,N/A Bye,Jiri Novak,,R64,0,0,0,0,0,0,0,0,0,0,0,0,0,0,0,0,0,0,0,0,0,0,0,0,0,0,0
2003-10-13 00:00:00.000,ATP Masters Series Madrid Spain ATP World Tour,HARD,2,Karol Kucera,Arnaud Clement,Karol Kucera,7-6(3); 4-6; 6-3,R64,150,15,5,43,103,36,43,31,60,2,6,16,67,103,7,1,56,94,38,56,19,38,3,7,15,57,94
2003-10-13 00:00:00.000,ATP Masters Series Madrid Spain ATP World Tour,HARD,2,Juan Ignacio Chela,Alberto Martin,Juan Ignacio Chela,6-4; 1-6; 6-1,R64,96,5,1,42,70,33,42,16,28,5,7,12,49,70,1,4,35,64,21,35,13,29,3,6,12,34,64
2003-10-13 00:00:00.000,ATP Masters Series Madrid Spain ATP World Tour,HARD,2,Martin Verkerk,N/A Bye,Martin Verkerk,,R64,0,0,0,0,0,0,0,0,0,0,0,0,0,0,0,0,0,0,0,0,0,0,0,0,0,0,0
2003-10-13 00:00:00.000,ATP Masters Series Madrid Spain ATP World Tour,HARD,2,Gustavo Kuerten,N/A Bye,Gustavo Kuerten,,R64,0,0,0,0,0,0,0,0,0,0,0,0,0,0,0,0,0,0,0,0,0,0,0,0,0,0,0
2003-10-13 00:00:00.000,ATP Masters Series Madrid Spain ATP World Tour,HARD,2,Nicolas Massu,Fernando Verdasco,Nicolas Massu,7-6(2); 6-4,R64,105,3,5,42,70,36,42,13,28,0,1,11,49,70,3,4,50,77,29,50,16,27,6,8,11,45,77
2003-10-13 00:00:00.000,ATP Masters Series Madrid Spain ATP World Tour,HARD,2,Max Mirnyi,James Blake,Max Mirnyi,7-5; 6-2,R64,80,6,2,34,62,23,34,17,28,3,4,10,40,62,1,4,54,76,34,54,7,22,4,8,10,41,76
2003-10-13 00:00:00.000,ATP Masters Series Madrid Spain ATP World Tour,HARD,2,Andy Roddick,N/A Bye,Andy Roddick,,R64,0,0,0,0,0,0,0,0,0,0,0,0,0,0,0,0,0,0,0,0,0,0,0,0,0,0,0
2003-10-13 00:00:00.000,ATP Masters Series Madrid Spain ATP World Tour,HARD,2,Juan Carlos Ferrero,Wayne Ferreira,Juan Carlos Ferrero,6-3; 2-6; 7-6(4),R32,117,5,4,48,92,35,48,24,44,4,8,15,59,92,7,3,51,82,41,51,12,31,1,4,14,53,82
2003-10-13 00:00:00.000,ATP Masters Series Madrid Spain ATP World Tour,HARD,2,Felix Mantilla,Thomas Enqvist,Felix Mantilla,6-2; 7-6(3),R32,82,8,0,27,66,23,27,28,39,4,4,10,51,66,9,1,32,63,29,32,12,31,3,5,10,41,63
2003-10-13 00:00:00.000,ATP Masters Series Madrid Spain ATP World Tour,HARD,2,Jan-Michael Gambill,Sjeng Schalken,Jan-Michael Gambill,7-6(6); 6-2,R32,110,9,3,45,89,34,45,23,44,10,11,10,57,89,3,3,51,72,32,51,8,21,3,6,10,40,72
2003-10-13 00:00:00.000,ATP Masters Series Madrid Spain ATP World Tour,HARD,2,Paradorn Srichaphan,Albert Costa,Paradorn Srichaphan,6-3; 6-7(5); 6-1,R32,125,15,0,53,91,43,53,23,38,4,5,15,66,91,9,3,44,81,34,44,16,37,5,9,13,50,81
2003-10-13 00:00:00.000,ATP Masters Series Madrid Spain ATP World Tour,HARD,2,Roger Federer,Alex Corretja,Roger Federer,6-4; 6-3,R32,70,5,2,34,50,28,34,11,16,0,1,10,39,50,4,3,35,60,23,35,12,25,5,8,9,35,60
2003-10-13 00:00:00.000,ATP Masters Series Madrid Spain ATP World Tour,HARD,2,Mardy Fish,Tommy Robredo,Mardy Fish,7-6(14); 6-2,R32,94,14,4,45,74,40,45,12,29,1,2,10,52,74,3,4,51,75,37,51,10,24,4,7,10,47,75
2003-10-13 00:00:00.000,ATP Masters Series Madrid Spain ATP World Tour,HARD,2,Feliciano Lopez,Mark Philippoussis,Feliciano Lopez,6-4; 3-6; 6-3,R32,108,17,8,47,79,39,47,17,32,2,3,14,56,79,12,4,48,89,36,48,24,41,2,4,14,60,89
2003-10-13 00:00:00.000,ATP Masters Series Madrid Spain ATP World Tour,HARD,2,Carlos Moya,Gaston Gaudio,Carlos Moya,3-6; 7-5; 6-3,R32,112,8,6,46,85,39,46,20,39,0,2,15,59,85,5,5,62,94,48,62,12,32,6,9,15,60,94
2003-10-13 00:00:00.000,ATP Masters Series Madrid Spain ATP World Tour,HARD,2,Sebastien Grosjean,David Ferrer,Sebastien Grosjean,6-4; 6-2,R32,70,7,1,27,55,24,27,15,28,3,3,9,39,55,3,1,28,52,23,28,8,24,3,6,9,31,52
2003-10-13 00:00:00.000,ATP Masters Series Madrid Spain ATP World Tour,HARD,2,Vincent Spadea,Agustin Calleri,Vincent Spadea,7-6(5); 3-6; 6-3,R32,128,9,2,52,94,39,52,29,42,3,4,15,68,94,10,9,56,106,48,56,22,50,2,3,15,70,106
2003-10-13 00:00:00.000,ATP Masters Series Madrid Spain ATP World Tour,HARD,2,Younes El Aynaoui,Jonas Bjorkman,Younes El Aynaoui,6-4; 6-4,R32,74,7,2,30,53,27,30,11,23,0,0,10,38,53,5,3,33,56,21,33,14,23,2,5,10,35,56
2003-10-13 00:00:00.000,ATP Masters Series Madrid Spain ATP World Tour,HARD,2,Robby Ginepri,Rainer Schuettler,Robby Ginepri,6-2; 6-4,R32,57,10,0,29,48,22,29,14,19,0,0,9,36,48,3,6,29,56,21,29,11,27,3,6,9,32,56
2003-10-13 00:00:00.000,ATP Masters Series Madrid Spain ATP World Tour,HARD,2,Jiri Novak,Karol Kucera,Jiri Novak,6-2; 1-6; 6-2,R32,87,3,3,40,66,3,40,10,26,4,7,12,13,66,5,5,28,66,21,28,18,38,5,9,11,39,66
2003-10-13 00:00:00.000,ATP Masters Series Madrid Spain ATP World Tour,HARD,2,Juan Ignacio Chela,Martin Verkerk,Juan Ignacio Chela,6-2; 6-2,R32,56,1,3,22,44,17,22,13,22,0,1,8,30,44,3,5,26,47,13,26,9,21,5,10,8,22,47
2003-10-13 00:00:00.000,ATP Masters Series Madrid Spain ATP World Tour,HARD,2,Nicolas Massu,Gustavo Kuerten,Nicolas Massu,6-3; 7-5,R32,110,7,2,45,70,32,45,15,25,5,6,11,47,70,13,1,43,78,33,43,14,35,8,11,10,47,78
2003-10-13 00:00:00.000,ATP Masters Series Madrid Spain ATP World Tour,HARD,2,Andy Roddick,Max Mirnyi,Andy Roddick,6-1; 6-7(9); 7-5,R32,121,21,3,53,90,44,53,26,37,3,3,15,70,90,9,4,63,105,48,63,24,42,7,11,16,72,105
2003-10-13 00:00:00.000,ATP Masters Series Madrid Spain ATP World Tour,HARD,2,Juan Carlos Ferrero,Felix Mantilla,Juan Carlos Ferrero,7-6(2); 7-6(0),R16,118,13,5,49,85,38,49,19,36,6,8,12,57,85,1,7,45,94,31,45,24,49,4,6,12,55,94
2003-10-13 00:00:00.000,ATP Masters Series Madrid Spain ATP World Tour,HARD,2,Paradorn Srichaphan,Jan-Michael Gambill,Paradorn Srichaphan,7-5; 6-4,R16,80,9,3,40,64,34,40,14,24,2,2,11,48,64,8,1,38,62,30,38,12,24,3,5,11,42,62
2003-10-13 00:00:00.000,ATP Masters Series Madrid Spain ATP World Tour,HARD,2,Roger Federer,Mardy Fish,Roger Federer,6-3; 7-6(4),R16,92,4,5,35,70,29,35,21,35,2,3,11,50,70,11,5,49,83,38,49,14,34,5,7,10,52,83
2003-10-13 00:00:00.000,ATP Masters Series Madrid Spain ATP World Tour,HARD,2,Feliciano Lopez,Carlos Moya,Feliciano Lopez,6-7(5); 6-1; 7-5,R16,130,17,8,58,106,50,58,27,48,6,7,16,77,106,4,3,57,108,41,57,26,51,7,11,15,67,108
2003-10-13 00:00:00.000,ATP Masters Series Madrid Spain ATP World Tour,HARD,2,Sebastien Grosjean,Vincent Spadea,Sebastien Grosjean,6-3; 6-2,R16,61,8,1,24,46,23,24,13,22,0,0,9,36,46,1,0,24,44,14,24,10,20,2,5,8,24,44
2003-10-13 00:00:00.000,ATP Masters Series Madrid Spain ATP World Tour,HARD,2,Younes El Aynaoui,Robby Ginepri,Younes El Aynaoui,6-4; 7-6(5),R16,96,8,1,55,83,39,55,15,28,5,6,11,54,83,10,3,46,75,31,46,16,29,3,5,11,47,75
2003-10-13 00:00:00.000,ATP Masters Series Madrid Spain ATP World Tour,HARD,2,Juan Ignacio Chela,Jiri Novak,Juan Ignacio Chela,3-6; 7-6(5); 6-2,R16,113,8,0,51,81,35,51,18,30,1,4,14,53,81,5,4,66,99,47,66,14,33,6,10,15,61,99
2003-10-13 00:00:00.000,ATP Masters Series Madrid Spain ATP World Tour,HARD,2,Nicolas Massu,Andy Roddick,Nicolas Massu,7-6(3); 6-2,R16,81,5,1,40,57,36,40,9,17,1,2,10,45,57,6,3,31,59,23,31,14,28,1,4,10,37,59
2003-10-13 00:00:00.000,ATP Masters Series Madrid Spain ATP World Tour,HARD,2,Juan Carlos Ferrero,Paradorn Srichaphan,Juan Carlos Ferrero,6-4; 6-2,Q,65,3,4,25,46,24,25,12,21,0,0,9,36,46,5,1,33,55,24,33,10,22,3,6,9,34,55
2003-10-13 00:00:00.000,ATP Masters Series Madrid Spain ATP World Tour,HARD,2,Roger Federer,Feliciano Lopez,Roger Federer,4-6; 7-6(3); 6-4,Q,136,10,4,52,98,42,52,25,46,7,8,16,67,98,14,6,63,116,51,63,23,53,11,12,16,74,116
2003-10-13 00:00:00.000,ATP Masters Series Madrid Spain ATP World Tour,HARD,2,Younes El Aynaoui,Sebastien Grosjean,Younes El Aynaoui,3-6; 7-6(6); 6-2,Q,110,4,1,58,80,44,58,16,22,2,3,14,60,80,10,2,41,86,34,41,27,45,1,3,15,61,86
2003-10-13 00:00:00.000,ATP Masters Series Madrid Spain ATP World Tour,HARD,2,Nicolas Massu,Juan Ignacio Chela,Nicolas Massu,6-7(5); 6-4; 6-4,Q,177,4,4,79,109,58,79,14,30,6,7,16,72,109,5,1,61,106,43,61,26,45,11,14,16,69,106
2003-10-13 00:00:00.000,ATP Masters Series Madrid Spain ATP World Tour,HARD,2,Juan Carlos Ferrero,Roger Federer,Juan Carlos Ferrero,6-4; 4-6; 6-4,S,112,5,3,52,85,40,52,20,33,1,2,15,60,85,13,6,54,86,43,54,17,32,2,4,15,60,86
2003-10-13 00:00:00.000,ATP Masters Series Madrid Spain ATP World Tour,HARD,2,Nicolas Massu,Younes El Aynaoui,Nicolas Massu,7-5; 6-4,S,101,2,2,50,63,38,50,9,13,2,2,11,47,63,5,2,46,69,34,46,11,23,2,4,11,45,69
2003-10-13 00:00:00.000,ATP Masters Series Madrid Spain ATP World Tour,HARD,2,Juan Carlos Ferrero,Nicolas Massu,Juan Carlos Ferrero,6-3; 6-4; 6-3,F,150,11,1,53,85,40,53,18,32,4,5,14,58,85,9,1,59,89,32,59,16,30,5,10,14,48,89
2003-10-20 00:00:00.000,Basel Switzerland ATP World Tour,HARD,2,Andy Roddick,Jean-Claude Scherrer,Andy Roddick,6-3; 7-6(4),R32,86,13,3,42,65,32,42,16,23,1,2,11,48,65,6,2,50,76,32,50,17,26,5,7,10,49,76
2003-10-20 00:00:00.000,Basel Switzerland ATP World Tour,HARD,2,Gilles Elseneer,Hyung-Taik Lee,Gilles Elseneer,6-2; 6-0,R32,56,6,2,30,41,24,30,6,11,0,0,7,30,41,2,1,38,54,17,38,5,16,6,11,7,22,54
2003-10-20 00:00:00.000,Basel Switzerland ATP World Tour,HARD,2,Olivier Rochus,Felix Mantilla,Olivier Rochus,6-7(4); 6-2; 7-6(10),R32,135,7,4,72,110,51,72,17,38,4,8,16,68,110,11,5,53,103,35,53,25,50,3,9,16,60,103
2003-10-20 00:00:00.000,Basel Switzerland ATP World Tour,HARD,2,Tommy Robredo,Michel Kratochvil,Tommy Robredo,6-4; 6-4,R32,69,5,1,37,54,28,37,13,17,1,1,10,41,54,1,2,36,60,27,36,12,24,5,7,10,39,60
2003-10-20 00:00:00.000,Basel Switzerland ATP World Tour,HARD,2,David Nalbandian,Ruben Ramirez Hidalgo,David Nalbandian,6-4; 6-0,R32,63,6,2,36,56,30,36,6,20,4,5,8,36,56,3,5,20,41,14,20,4,21,3,8,8,18,41
2003-10-20 00:00:00.000,Basel Switzerland ATP World Tour,HARD,2,Arnaud Clement,Paul-Henri Mathieu,Arnaud Clement,6-4; 7-6(4),R32,103,16,0,40,64,33,40,12,24,3,5,11,45,64,3,4,44,82,29,44,19,38,4,7,11,48,82
2003-10-20 00:00:00.000,Basel Switzerland ATP World Tour,HARD,2,Tomas Zib,Stanislas Wawrinka,Tomas Zib,7-6(0); 7-6(5),R32,88,2,1,56,85,41,56,14,29,6,9,12,55,85,12,4,39,68,28,39,17,29,4,7,12,45,68
2003-10-20 00:00:00.000,Basel Switzerland ATP World Tour,HARD,2,Tim Henman,Martin Verkerk,Tim Henman,6-2; 6-3,R32,64,7,2,31,46,26,31,8,15,1,2,9,34,46,2,2,35,54,19,35,8,19,1,5,8,27,54
2003-10-20 00:00:00.000,Basel Switzerland ATP World Tour,HARD,2,Jiri Novak,Arvind Parmar,Jiri Novak,3-6; 6-3; 6-0,R32,95,4,3,58,82,41,58,14,24,4,5,12,55,82,2,2,48,82,32,48,15,34,3,7,12,47,82
2003-10-20 00:00:00.000,Basel Switzerland ATP World Tour,HARD,2,Feliciano Lopez,Rafael Nadal,Feliciano Lopez,3-6; 6-3; 7-6(4),R32,122,13,5,49,97,38,49,30,48,8,10,15,68,97,0,2,80,98,52,80,13,18,1,3,15,65,98
2003-10-20 00:00:00.000,Basel Switzerland ATP World Tour,HARD,2,Michael Llodra,Bohdan Ulihrach,Michael Llodra,6-3; 6-4,R32,63,10,4,46,69,34,46,14,23,6,6,10,48,69,1,1,35,49,22,35,10,14,5,7,9,32,49
2003-10-20 00:00:00.000,Basel Switzerland ATP World Tour,HARD,2,Guillermo Coria,Fabrice Santoro,Guillermo Coria,5-7; 6-3; 6-0,R32,136,3,5,58,97,41,58,16,39,10,13,13,57,97,1,1,47,100,31,47,21,53,9,16,14,52,100
2003-10-20 00:00:00.000,Basel Switzerland ATP World Tour,HARD,2,Nicolas Lapentti,Ivo Heuberger,Nicolas Lapentti,6-3; 4-6; 7-5,R32,145,8,3,74,118,45,74,27,44,8,10,15,72,118,6,3,50,94,40,50,23,44,4,8,16,63,94
2003-10-20 00:00:00.000,Basel Switzerland ATP World Tour,HARD,2,Tomas Behrend,James Blake,Tomas Behrend,1-6; 6-3; 6-4,R32,94,5,2,49,82,34,49,17,33,4,6,13,51,82,4,2,55,83,42,55,12,28,9,11,13,54,83
2003-10-20 00:00:00.000,Basel Switzerland ATP World Tour,HARD,2,Ivan Ljubicic,Filippo Volandri,Ivan Ljubicic,6-3; 3-6; 6-2,R32,95,10,3,44,73,34,44,16,29,4,6,13,50,73,0,4,47,81,31,47,17,34,1,5,13,48,81
2003-10-20 00:00:00.000,Basel Switzerland ATP World Tour,HARD,2,Roger Federer,Marc Rosset,Roger Federer,6-1; 6-3,R32,57,3,2,27,49,21,27,13,22,1,1,8,34,49,2,7,27,50,18,27,8,23,4,8,8,26,50
2003-10-20 00:00:00.000,Basel Switzerland ATP World Tour,HARD,2,Andy Roddick,Gilles Elseneer,Andy Roddick,6-3; 7-6(5),R16,86,10,2,45,64,36,45,11,19,2,3,11,47,64,6,6,33,61,26,33,13,28,5,7,10,39,61
2003-10-20 00:00:00.000,Basel Switzerland ATP World Tour,HARD,2,Olivier Rochus,Tommy Robredo,Olivier Rochus,7-5; 6-1,R16,79,1,2,43,66,30,43,11,23,4,6,10,41,66,2,1,38,56,17,38,10,18,6,11,9,27,56
2003-10-20 00:00:00.000,Basel Switzerland ATP World Tour,HARD,2,David Nalbandian,Arnaud Clement,David Nalbandian,4-1 RET,R16,30,1,0,7,13,6,7,3,6,0,0,2,9,13,1,0,10,25,6,10,4,15,1,3,3,10,25
2003-10-20 00:00:00.000,Basel Switzerland ATP World Tour,HARD,2,Tim Henman,Tomas Zib,Tim Henman,6-3; 6-4,R16,81,14,4,35,63,31,35,12,28,7,8,10,43,63,2,0,29,47,18,29,11,18,1,4,9,29,47
2003-10-20 00:00:00.000,Basel Switzerland ATP World Tour,HARD,2,Feliciano Lopez,Jiri Novak,Feliciano Lopez,3-6; 7-5; 6-4,R16,93,13,3,64,101,47,64,20,37,8,10,16,67,101,9,2,60,86,44,60,16,26,2,4,15,60,86
2003-10-20 00:00:00.000,Basel Switzerland ATP World Tour,HARD,2,Guillermo Coria,Michael Llodra,Guillermo Coria,6-2; 6-7(5); 7-6(4),R16,139,5,0,73,107,55,73,20,34,3,4,16,75,107,8,1,77,110,57,77,16,33,6,9,16,73,110
2003-10-20 00:00:00.000,Basel Switzerland ATP World Tour,HARD,2,Nicolas Lapentti,Tomas Behrend,Nicolas Lapentti,7-6(2); 6-1,R16,71,11,0,36,55,34,36,13,19,0,0,10,47,55,3,0,38,58,23,38,12,20,3,5,9,35,58
2003-10-20 00:00:00.000,Basel Switzerland ATP World Tour,HARD,2,Ivan Ljubicic,Roger Federer,Ivan Ljubicic,7-6(5); 6-7(5); 6-4,R16,143,27,0,69,116,56,69,26,47,5,6,17,82,116,10,3,87,125,58,87,26,38,5,7,17,84,125
2003-10-20 00:00:00.000,Basel Switzerland ATP World Tour,HARD,2,Andy Roddick,Olivier Rochus,Andy Roddick,6-4; 6-4,Q,74,12,4,33,53,28,33,13,20,0,0,10,41,53,2,0,38,66,27,38,12,28,5,7,10,39,66
2003-10-20 00:00:00.000,Basel Switzerland ATP World Tour,HARD,2,David Nalbandian,Tim Henman,David Nalbandian,6-2; 6-4,Q,84,2,2,29,55,22,29,18,26,3,3,9,40,55,7,5,29,58,22,29,12,29,3,6,9,34,58
2003-10-20 00:00:00.000,Basel Switzerland ATP World Tour,HARD,2,Guillermo Coria,Feliciano Lopez,Guillermo Coria,6-1; 6-2,Q,49,1,0,28,37,25,28,7,9,0,0,8,32,37,3,0,22,46,13,22,9,24,5,9,7,22,46
2003-10-20 00:00:00.000,Basel Switzerland ATP World Tour,HARD,2,Ivan Ljubicic,Nicolas Lapentti,Ivan Ljubicic,2-6; 6-2; 6-3,Q,121,18,3,38,73,34,38,12,35,4,6,12,46,73,3,2,49,93,34,49,20,44,3,7,13,54,93
2003-10-20 00:00:00.000,Basel Switzerland ATP World Tour,HARD,2,David Nalbandian,Andy Roddick,David Nalbandian,7-5; 7-5,S,95,3,4,43,69,31,43,16,26,0,1,12,47,69,13,1,44,76,28,44,18,32,2,5,12,46,76
2003-10-20 00:00:00.000,Basel Switzerland ATP World Tour,HARD,2,Guillermo Coria,Ivan Ljubicic,Guillermo Coria,6-4; 6-4,S,77,3,0,35,59,26,35,17,24,4,4,10,43,59,11,2,36,56,25,36,12,20,2,4,10,37,56
2003-10-20 00:00:00.000,Basel Switzerland ATP World Tour,HARD,2,Guillermo Coria,David Nalbandian,Guillermo Coria,W/O,F,0,0,0,0,0,0,0,0,0,0,0,0,0,0,0,0,0,0,0,0,0,0,0,0,0,0,0
2003-10-20 00:00:00.000,St. Petersburg Russia ATP World Tour,HARD,2,Rainer Schuettler,Jean-Rene Lisnard,Rainer Schuettler,7-6(5); 6-1,R32,99,4,2,41,65,25,41,14,24,1,4,10,39,65,1,2,32,71,21,32,12,39,9,14,9,33,71
2003-10-20 00:00:00.000,St. Petersburg Russia ATP World Tour,HARD,2,Vladimir Voltchkov,Vadim Davletshin,Vladimir Voltchkov,7-6(3); 6-3,R32,96,5,4,36,70,30,36,20,34,6,7,11,50,70,6,6,42,79,30,42,20,37,5,7,10,50,79
2003-10-20 00:00:00.000,St. Petersburg Russia ATP World Tour,HARD,2,Yevgeny Kafelnikov,Nicolas Kiefer,Yevgeny Kafelnikov,2-6; 6-3; 6-4,R32,111,5,4,49,90,35,49,25,41,9,11,14,60,90,13,4,49,86,34,49,21,37,5,7,13,55,86
2003-10-20 00:00:00.000,St. Petersburg Russia ATP World Tour,HARD,2,Mikhail Youzhny,Andrei Pavel,Mikhail Youzhny,6-7(3); 7-6(1); 6-1,R32,139,1,7,47,106,35,47,33,59,2,5,16,68,106,5,5,69,115,49,69,16,46,5,10,15,65,115
2003-10-20 00:00:00.000,St. Petersburg Russia ATP World Tour,HARD,2,Igor Andreev,Max Mirnyi,Igor Andreev,6-4; 7-6(1),R32,80,5,3,36,63,28,36,18,27,0,1,11,46,63,1,0,45,68,24,45,18,23,2,4,11,42,68
2003-10-20 00:00:00.000,St. Petersburg Russia ATP World Tour,HARD,2,Sargis Sargsian,Radek Stepanek,Sargis Sargsian,6-3; 6-2,R32,59,6,1,32,52,25,32,14,20,0,0,9,39,52,5,2,21,41,17,21,7,20,0,3,8,24,41
2003-10-20 00:00:00.000,St. Petersburg Russia ATP World Tour,HARD,2,Lars Burgsmuller,Andy Ram,Lars Burgsmuller,2-6; 7-6(6); 6-1,R32,119,6,5,54,91,39,54,15,37,3,7,14,54,91,4,0,39,86,24,39,27,47,4,8,13,51,86
2003-10-20 00:00:00.000,St. Petersburg Russia ATP World Tour,HARD,2,Fernando Vicente,Marat Safin,Fernando Vicente,6-7(2); 6-4; 6-3,R32,130,3,3,56,97,45,56,21,41,4,6,16,66,97,13,2,40,92,32,40,26,52,4,8,15,58,92
2003-10-20 00:00:00.000,St. Petersburg Russia ATP World Tour,HARD,2,Vincent Spadea,Nikolay Davydenko,Vincent Spadea,4-6; 6-1; 6-2,R32,109,1,6,43,86,33,43,23,43,9,11,13,56,86,1,1,49,74,27,49,13,25,5,10,12,40,74
2003-10-20 00:00:00.000,St. Petersburg Russia ATP World Tour,HARD,2,Dominik Hrbaty,David Ferrer,Dominik Hrbaty,7-5; 6-2,R32,93,5,1,43,68,31,43,9,25,4,7,10,40,68,2,1,54,94,28,54,18,40,13,19,10,46,94
2003-10-20 00:00:00.000,St. Petersburg Russia ATP World Tour,HARD,2,Victor Hanescu,Frantisek Cermak,Victor Hanescu,7-5; 7-5,R32,95,3,1,49,80,35,49,18,31,5,7,12,53,80,2,2,52,83,32,52,16,31,5,9,12,48,83
2003-10-20 00:00:00.000,St. Petersburg Russia ATP World Tour,HARD,2,Gustavo Kuerten,Brian Vahaly,Gustavo Kuerten,7-6(5); 6-4,R32,73,11,1,41,70,33,41,15,29,4,5,11,48,70,3,1,32,62,20,32,22,30,0,2,11,42,62
2003-10-20 00:00:00.000,St. Petersburg Russia ATP World Tour,HARD,2,Gaston Gaudio,Alberto Martin,Gaston Gaudio,6-7(4); 7-6(5); 6-2,R32,151,5,7,77,128,52,77,28,51,2,4,16,80,128,5,3,58,104,43,58,24,46,3,7,16,67,104
2003-10-20 00:00:00.000,St. Petersburg Russia ATP World Tour,HARD,2,Alex Corretja,Jan Vacek,Alex Corretja,6-4; 6-1,R32,66,0,0,30,50,24,30,13,20,1,1,9,37,50,2,0,28,48,16,28,9,20,2,5,8,25,48
2003-10-20 00:00:00.000,St. Petersburg Russia ATP World Tour,HARD,2,Antony Dupuis,David Sanchez,Antony Dupuis,6-2; 6-3,R32,70,3,0,28,40,23,28,9,12,0,0,8,32,40,3,5,38,78,24,38,16,40,11,15,9,40,78
2003-10-20 00:00:00.000,St. Petersburg Russia ATP World Tour,HARD,2,Sebastien Grosjean,Stefan Koubek,Sebastien Grosjean,6-7(4); 6-3; 7-5,R32,140,7,8,49,98,36,49,25,49,3,6,16,61,98,1,7,82,124,48,82,23,42,12,18,17,71,124
2003-10-20 00:00:00.000,St. Petersburg Russia ATP World Tour,HARD,2,Rainer Schuettler,Vladimir Voltchkov,Rainer Schuettler,6-2; 6-3,R16,75,3,1,32,60,23,32,17,28,4,5,9,40,60,0,0,28,48,16,28,8,20,3,7,8,24,48
2003-10-20 00:00:00.000,St. Petersburg Russia ATP World Tour,HARD,2,Mikhail Youzhny,Yevgeny Kafelnikov,Mikhail Youzhny,6-2; 6-2,R16,63,10,2,31,52,25,31,8,21,2,3,8,33,52,3,3,36,60,18,36,9,24,7,12,8,27,60
2003-10-20 00:00:00.000,St. Petersburg Russia ATP World Tour,HARD,2,Sargis Sargsian,Igor Andreev,Sargis Sargsian,6-3; 6-2,R16,84,2,2,43,62,30,43,9,19,2,3,9,39,62,2,5,38,70,23,38,13,32,9,13,8,36,70
2003-10-20 00:00:00.000,St. Petersburg Russia ATP World Tour,HARD,2,Lars Burgsmuller,Fernando Vicente,Lars Burgsmuller,6-4; 6-4,R16,92,6,3,27,60,21,27,18,33,1,3,10,39,60,1,1,38,66,23,38,13,28,4,8,10,36,66
2003-10-20 00:00:00.000,St. Petersburg Russia ATP World Tour,HARD,2,Vincent Spadea,Dominik Hrbaty,Vincent Spadea,6-4; 4-6; 7-5,R16,125,3,1,63,117,41,63,27,54,3,7,16,68,117,12,6,55,92,44,55,12,37,0,5,16,56,92
2003-10-20 00:00:00.000,St. Petersburg Russia ATP World Tour,HARD,2,Gustavo Kuerten,Victor Hanescu,Gustavo Kuerten,7-6(1); 7-6(1),R16,92,11,0,48,75,40,48,15,27,2,3,12,55,75,8,3,54,75,36,54,12,21,1,2,12,48,75
2003-10-20 00:00:00.000,St. Petersburg Russia ATP World Tour,HARD,2,Alex Corretja,Gaston Gaudio,Alex Corretja,6-3; 6-1,R16,70,4,2,28,50,25,28,11,22,4,4,8,36,50,0,0,40,55,25,40,4,15,5,9,8,29,55
2003-10-20 00:00:00.000,St. Petersburg Russia ATP World Tour,HARD,2,Sebastien Grosjean,Antony Dupuis,Sebastien Grosjean,6-2; 6-2,R16,62,0,0,19,38,19,19,13,19,0,0,8,32,38,5,1,21,49,11,21,14,28,4,8,8,25,49
2003-10-20 00:00:00.000,St. Petersburg Russia ATP World Tour,HARD,2,Rainer Schuettler,Mikhail Youzhny,Rainer Schuettler,6-3; 6-3,Q,57,2,1,29,45,25,29,11,16,0,0,9,36,45,1,1,30,47,21,30,9,17,3,6,9,30,47
2003-10-20 00:00:00.000,St. Petersburg Russia ATP World Tour,HARD,2,Sargis Sargsian,Lars Burgsmuller,Sargis Sargsian,6-3; 6-1,Q,68,3,0,31,39,26,31,6,8,0,0,8,32,39,3,3,48,69,28,48,7,21,10,14,8,35,69
2003-10-20 00:00:00.000,St. Petersburg Russia ATP World Tour,HARD,2,Gustavo Kuerten,Vincent Spadea,Gustavo Kuerten,6-4; 7-6(4),Q,77,14,2,42,69,35,42,14,27,3,4,11,49,69,7,4,40,68,31,40,13,28,4,6,11,44,68
2003-10-20 00:00:00.000,St. Petersburg Russia ATP World Tour,HARD,2,Alex Corretja,Sebastien Grosjean,Alex Corretja,4-6; 6-2; 7-6(5),Q,145,4,2,54,93,44,54,17,39,6,9,15,61,93,6,5,45,93,30,45,30,48,6,10,15,60,93
2003-10-20 00:00:00.000,St. Petersburg Russia ATP World Tour,HARD,2,Sargis Sargsian,Rainer Schuettler,Sargis Sargsian,6-3; 6-3,S,72,1,1,33,53,20,33,15,20,1,3,9,35,53,3,7,25,56,16,25,11,31,3,8,9,27,56
2003-10-20 00:00:00.000,St. Petersburg Russia ATP World Tour,HARD,2,Gustavo Kuerten,Alex Corretja,Gustavo Kuerten,6-4; 6-3,S,84,6,1,28,52,22,28,16,24,0,0,9,38,52,4,0,46,69,30,46,13,23,3,6,10,43,69
2003-10-20 00:00:00.000,St. Petersburg Russia ATP World Tour,HARD,2,Gustavo Kuerten,Sargis Sargsian,Gustavo Kuerten,6-4; 6-3,F,78,8,0,22,53,19,22,21,31,1,2,10,40,53,2,2,42,66,23,42,13,24,6,9,9,36,66
2003-10-20 00:00:00.000,Stockholm Sweden ATP World Tour,HARD,2,John van Lottum,Paradorn Srichaphan,John van Lottum,7-5; 6-1,R32,77,3,1,36,55,30,36,9,19,4,4,9,39,55,8,1,47,65,32,47,5,18,5,9,10,37,65
2003-10-20 00:00:00.000,Stockholm Sweden ATP World Tour,HARD,2,Jonas Bjorkman,Andreas Vinciguerra,Jonas Bjorkman,4-6; 6-2; 6-1,R32,93,9,0,45,67,39,45,13,22,2,3,13,52,67,5,4,67,90,41,67,10,23,9,13,12,51,90
2003-10-20 00:00:00.000,Stockholm Sweden ATP World Tour,HARD,2,Robin Soderling,Wesley Moodie,Robin Soderling,4-6; 6-3; 6-3,R32,93,4,3,47,71,41,47,13,24,0,1,14,54,71,13,4,67,95,48,67,10,28,7,10,14,58,95
2003-10-20 00:00:00.000,Stockholm Sweden ATP World Tour,HARD,2,Juan Ignacio Chela,Wayne Ferreira,Juan Ignacio Chela,6-4; 6-2,R32,64,5,0,34,53,24,34,12,19,1,2,9,36,53,3,2,34,57,18,34,11,23,5,9,9,29,57
2003-10-20 00:00:00.000,Stockholm Sweden ATP World Tour,HARD,2,Fernando Gonzalez,Karol Beck,Fernando Gonzalez,3-6; 6-1; 6-1,R32,73,13,1,44,66,34,44,10,22,4,5,11,44,66,7,1,37,58,24,37,8,21,1,6,12,32,58
2003-10-20 00:00:00.000,Stockholm Sweden ATP World Tour,HARD,2,Joachim Johansson,Jan Frode Andersen,Joachim Johansson,7-5; 6-3,R32,83,11,2,25,46,24,25,16,21,0,0,10,40,46,6,3,38,66,31,38,10,28,5,8,11,41,66
2003-10-20 00:00:00.000,Stockholm Sweden ATP World Tour,HARD,2,Davide Sanguinetti,Jan-Michael Gambill,Davide Sanguinetti,5-4 RET,R32,0,4,0,12,20,8,12,5,8,1,2,4,13,20,1,2,17,32,10,17,6,15,4,6,5,16,32
2003-10-20 00:00:00.000,Stockholm Sweden ATP World Tour,HARD,2,Gregory Carraz,Jarkko Nieminen,Gregory Carraz,7-6(5); 5-7; 6-2,R32,111,19,6,60,93,51,60,15,33,0,2,16,66,93,11,2,81,107,57,81,9,26,1,4,16,66,107
2003-10-20 00:00:00.000,Stockholm Sweden ATP World Tour,HARD,2,Mardy Fish,Paul Baccanello,Mardy Fish,6-4; 7-6(4),R32,83,10,0,37,69,31,37,21,32,1,1,11,52,69,7,1,48,71,37,48,13,23,2,3,11,50,71
2003-10-20 00:00:00.000,Stockholm Sweden ATP World Tour,HARD,2,Julien Benneteau,Jurgen Melzer,Julien Benneteau,6-1; 6-1,R32,51,3,3,26,41,21,26,9,15,1,1,7,30,41,1,2,31,47,14,31,5,16,4,9,7,19,47
2003-10-20 00:00:00.000,Stockholm Sweden ATP World Tour,HARD,2,Mario Ancic,Ivo Karlovic,Mario Ancic,6-3; 6-2,R32,57,4,1,36,46,29,36,8,10,2,2,9,37,46,6,3,32,52,24,32,7,20,4,7,8,31,52
2003-10-20 00:00:00.000,Stockholm Sweden ATP World Tour,HARD,2,Raemon Sluiter,Nicolas Massu,Raemon Sluiter,6-3; 3-6; 7-5,R32,122,12,2,56,89,42,56,17,33,3,5,15,59,89,5,0,59,82,44,59,11,23,5,8,15,55,82
2003-10-20 00:00:00.000,Stockholm Sweden ATP World Tour,HARD,2,Kenneth Carlsen,Mariano Zabaleta,Kenneth Carlsen,6-2; 6-4,R32,80,4,1,36,58,27,36,14,22,5,5,9,41,58,5,3,45,70,29,45,10,25,7,10,9,39,70
2003-10-20 00:00:00.000,Stockholm Sweden ATP World Tour,HARD,2,Thomas Enqvist,Hicham Arazi,Thomas Enqvist,7-5; 6-3,R32,69,7,4,37,58,29,37,9,21,4,7,11,38,58,4,1,28,51,16,28,9,23,2,7,10,25,51
2003-10-20 00:00:00.000,Stockholm Sweden ATP World Tour,HARD,2,Robby Ginepri,Kristof Vliegen,Robby Ginepri,6-1; 6-3,R32,44,6,0,24,40,19,24,13,16,0,0,8,32,40,1,2,32,53,19,32,7,21,3,7,8,26,53
2003-10-20 00:00:00.000,Stockholm Sweden ATP World Tour,HARD,2,Taylor Dent,Sjeng Schalken,Taylor Dent,6-3; 7-5,R32,78,14,4,32,63,28,32,17,31,1,2,11,45,63,0,0,49,65,29,49,10,16,5,8,10,39,65
2003-10-20 00:00:00.000,Stockholm Sweden ATP World Tour,HARD,2,Jonas Bjorkman,John van Lottum,Jonas Bjorkman,6-1; 6-4,R16,73,8,1,31,46,26,31,10,15,0,0,9,36,46,0,2,36,58,23,36,8,22,7,10,8,31,58
2003-10-20 00:00:00.000,Stockholm Sweden ATP World Tour,HARD,2,Robin Soderling,Juan Ignacio Chela,Robin Soderling,6-4; 6-3,R16,72,5,0,52,65,39,52,6,13,8,8,9,45,65,4,1,35,51,25,35,7,16,0,3,10,32,51
2003-10-20 00:00:00.000,Stockholm Sweden ATP World Tour,HARD,2,Joachim Johansson,Fernando Gonzalez,Joachim Johansson,4-6; 6-4; 7-5,R16,95,28,5,57,76,52,57,9,19,1,3,16,61,76,21,4,60,95,50,60,16,35,3,6,16,66,95
2003-10-20 00:00:00.000,Stockholm Sweden ATP World Tour,HARD,2,Davide Sanguinetti,Gregory Carraz,Davide Sanguinetti,6-3; 2-6; 7-5,R16,98,5,4,53,81,39,53,12,28,0,3,14,51,81,16,10,50,84,40,50,15,34,4,8,15,55,84
2003-10-20 00:00:00.000,Stockholm Sweden ATP World Tour,HARD,2,Mardy Fish,Julien Benneteau,Mardy Fish,6-4; 6-4,R16,57,15,1,45,64,35,45,9,19,0,0,10,44,64,7,1,43,54,29,43,7,11,1,3,10,36,54
2003-10-20 00:00:00.000,Stockholm Sweden ATP World Tour,HARD,2,Mario Ancic,Raemon Sluiter,Mario Ancic,6-7(7); 6-4; 7-6(3),R16,125,18,3,70,106,55,70,22,36,3,4,17,77,106,10,6,78,119,59,78,17,41,3,5,17,76,119
2003-10-20 00:00:00.000,Stockholm Sweden ATP World Tour,HARD,2,Thomas Enqvist,Kenneth Carlsen,Thomas Enqvist,6-7(4); 6-4; 6-4,R16,140,13,2,62,106,48,62,25,44,3,4,16,73,106,23,0,74,109,53,74,19,35,9,12,16,72,109
2003-10-20 00:00:00.000,Stockholm Sweden ATP World Tour,HARD,2,Robby Ginepri,Taylor Dent,Robby Ginepri,6-7(2); 7-6(7); 6-4,R16,127,10,2,89,121,60,89,18,32,10,12,17,78,121,18,12,56,107,46,56,25,51,2,5,17,71,107
2003-10-20 00:00:00.000,Stockholm Sweden ATP World Tour,HARD,2,Robin Soderling,Jonas Bjorkman,Robin Soderling,6-4; 6-3,Q,64,7,1,31,44,28,31,9,13,0,0,9,37,44,9,2,37,63,27,37,11,26,3,6,10,38,63
2003-10-20 00:00:00.000,Stockholm Sweden ATP World Tour,HARD,2,Davide Sanguinetti,Joachim Johansson,Davide Sanguinetti,6-3; 6-2,Q,62,7,1,28,50,22,28,15,22,1,1,9,37,50,9,3,30,49,18,30,11,19,0,3,8,29,49
2003-10-20 00:00:00.000,Stockholm Sweden ATP World Tour,HARD,2,Mardy Fish,Mario Ancic,Mardy Fish,6-4; 6-7(7); 7-6(4),Q,146,14,3,63,111,54,63,28,48,2,2,17,82,111,16,2,90,130,57,90,30,40,8,9,17,87,130
2003-10-20 00:00:00.000,Stockholm Sweden ATP World Tour,HARD,2,Thomas Enqvist,Robby Ginepri,Thomas Enqvist,6-3; 6-4,Q,62,8,0,32,54,27,32,14,22,0,0,10,41,54,6,2,31,58,24,31,12,27,7,9,9,36,58
2003-10-20 00:00:00.000,Stockholm Sweden ATP World Tour,HARD,2,Robin Soderling,Davide Sanguinetti,Robin Soderling,7-6(2); 7-6(5),S,89,11,1,49,74,40,49,16,25,0,0,12,56,74,2,2,51,83,37,51,19,32,4,4,12,56,83
2003-10-20 00:00:00.000,Stockholm Sweden ATP World Tour,HARD,2,Mardy Fish,Thomas Enqvist,Mardy Fish,6-4; 7-5,S,80,16,6,37,66,31,37,14,29,2,3,11,45,66,12,3,36,59,27,36,9,23,0,3,11,36,59
2003-10-20 00:00:00.000,Stockholm Sweden ATP World Tour,HARD,2,Mardy Fish,Robin Soderling,Mardy Fish,7-5; 3-6; 7-6(4),F,124,17,1,63,94,50,63,14,31,1,3,16,64,94,15,4,86,115,61,86,13,29,5,7,17,74,115
2003-10-27 00:00:00.000,ATP Masters Series Paris France ATP World Tour,HARD,2,Juan Carlos Ferrero,N/A Bye,Juan Carlos Ferrero,,R64,0,0,0,0,0,0,0,0,0,0,0,0,0,0,0,0,0,0,0,0,0,0,0,0,0,0,0
2003-10-27 00:00:00.000,ATP Masters Series Paris France ATP World Tour,HARD,2,Nicolas Mahut,Jarkko Nieminen,Nicolas Mahut,4-6; 6-4; 7-5,R64,120,16,4,63,104,50,63,20,41,7,9,16,70,104,6,6,67,112,42,67,27,45,12,15,16,69,112
2003-10-27 00:00:00.000,ATP Masters Series Paris France ATP World Tour,HARD,2,Fabrice Santoro,Max Mirnyi,Fabrice Santoro,6-4; 4-6; 6-1,R64,111,3,5,46,76,36,46,15,30,2,4,13,51,76,10,5,52,97,35,52,21,45,10,15,14,56,97
2003-10-27 00:00:00.000,ATP Masters Series Paris France ATP World Tour,HARD,2,Jiri Novak,N/A Bye,Jiri Novak,,R64,0,0,0,0,0,0,0,0,0,0,0,0,0,0,0,0,0,0,0,0,0,0,0,0,0,0,0
2003-10-27 00:00:00.000,ATP Masters Series Paris France ATP World Tour,HARD,2,Younes El Aynaoui,N/A Bye,Younes El Aynaoui,,R64,0,0,0,0,0,0,0,0,0,0,0,0,0,0,0,0,0,0,0,0,0,0,0,0,0,0,0
2003-10-27 00:00:00.000,ATP Masters Series Paris France ATP World Tour,HARD,2,Hicham Arazi,Paul-Henri Mathieu,Hicham Arazi,7-5; 6-4,R64,102,8,4,41,63,35,41,13,22,6,6,11,48,63,8,1,37,80,29,37,20,43,6,8,11,49,80
2003-10-27 00:00:00.000,ATP Masters Series Paris France ATP World Tour,HARD,2,Karol Beck,Robby Ginepri,Karol Beck,7-6(5); 6-4,R64,78,8,4,38,70,30,38,19,32,4,6,11,49,70,3,3,33,69,23,33,20,36,1,4,11,43,69
2003-10-27 00:00:00.000,ATP Masters Series Paris France ATP World Tour,HARD,2,Paradorn Srichaphan,N/A Bye,Paradorn Srichaphan,,R64,0,0,0,0,0,0,0,0,0,0,0,0,0,0,0,0,0,0,0,0,0,0,0,0,0,0,0
2003-10-27 00:00:00.000,ATP Masters Series Paris France ATP World Tour,HARD,2,Guillermo Coria,N/A Bye,Guillermo Coria,,R64,0,0,0,0,0,0,0,0,0,0,0,0,0,0,0,0,0,0,0,0,0,0,0,0,0,0,0
2003-10-27 00:00:00.000,ATP Masters Series Paris France ATP World Tour,HARD,2,Feliciano Lopez,Mikhail Youzhny,Feliciano Lopez,7-6(4); 6-3,R64,68,8,2,46,75,40,46,16,29,5,5,11,56,75,4,3,36,59,29,36,13,23,0,1,10,42,59
2003-10-27 00:00:00.000,ATP Masters Series Paris France ATP World Tour,HARD,2,Andrei Pavel,Karol Kucera,Andrei Pavel,7-6(4); 6-2,R64,93,4,5,42,70,29,42,14,28,7,9,10,43,70,10,5,34,74,25,34,16,40,5,9,10,41,74
2003-10-27 00:00:00.000,ATP Masters Series Paris France ATP World Tour,HARD,2,Felix Mantilla,N/A Bye,Felix Mantilla,,R64,0,0,0,0,0,0,0,0,0,0,0,0,0,0,0,0,0,0,0,0,0,0,0,0,0,0,0
2003-10-27 00:00:00.000,ATP Masters Series Paris France ATP World Tour,HARD,2,Nicolas Massu,N/A Bye,Nicolas Massu,,R64,0,0,0,0,0,0,0,0,0,0,0,0,0,0,0,0,0,0,0,0,0,0,0,0,0,0,0
2003-10-27 00:00:00.000,ATP Masters Series Paris France ATP World Tour,HARD,2,Albert Costa,Mariano Zabaleta,Albert Costa,6-7(4); 6-4; 7-5,R64,149,12,4,61,107,45,61,26,46,5,7,17,71,107,10,5,64,110,43,64,27,46,8,12,17,70,110
2003-10-27 00:00:00.000,ATP Masters Series Paris France ATP World Tour,HARD,2,James Blake,Fernando Gonzalez,James Blake,6-3; 6-4,R64,61,8,2,41,63,31,41,13,22,2,2,10,44,63,3,6,27,52,20,27,12,25,3,5,9,32,52
2003-10-27 00:00:00.000,ATP Masters Series Paris France ATP World Tour,HARD,2,Rainer Schuettler,N/A Bye,Rainer Schuettler,,R64,0,0,0,0,0,0,0,0,0,0,0,0,0,0,0,0,0,0,0,0,0,0,0,0,0,0,0
2003-10-27 00:00:00.000,ATP Masters Series Paris France ATP World Tour,HARD,2,Sebastien Grosjean,N/A Bye,Sebastien Grosjean,,R64,0,0,0,0,0,0,0,0,0,0,0,0,0,0,0,0,0,0,0,0,0,0,0,0,0,0,0
2003-10-27 00:00:00.000,ATP Masters Series Paris France ATP World Tour,HARD,2,Tim Henman,Nikolay Davydenko,Tim Henman,6-3; 6-4,R64,74,5,1,31,55,24,31,16,24,2,3,10,40,55,2,3,26,53,16,26,14,27,3,6,9,30,53
2003-10-27 00:00:00.000,ATP Masters Series Paris France ATP World Tour,HARD,2,Gustavo Kuerten,Mardy Fish,Gustavo Kuerten,6-4; 7-6(2),R64,82,16,1,45,63,36,45,13,18,0,0,11,49,63,13,9,31,79,25,31,25,48,11,12,11,50,79
2003-10-27 00:00:00.000,ATP Masters Series Paris France ATP World Tour,HARD,2,Mark Philippoussis,N/A Bye,Mark Philippoussis,,R64,0,0,0,0,0,0,0,0,0,0,0,0,0,0,0,0,0,0,0,0,0,0,0,0,0,0,0
2003-10-27 00:00:00.000,ATP Masters Series Paris France ATP World Tour,HARD,2,Martin Verkerk,N/A Bye,Martin Verkerk,,R64,0,0,0,0,0,0,0,0,0,0,0,0,0,0,0,0,0,0,0,0,0,0,0,0,0,0,0
2003-10-27 00:00:00.000,ATP Masters Series Paris France ATP World Tour,HARD,2,Dominik Hrbaty,Vincent Spadea,Dominik Hrbaty,7-6(1); 6-1,R64,62,7,1,32,50,28,32,12,18,0,1,10,40,50,0,6,36,71,24,36,15,35,6,9,9,39,71
2003-10-27 00:00:00.000,ATP Masters Series Paris France ATP World Tour,HARD,2,Thierry Ascione,Juan Ignacio Chela,Thierry Ascione,6-0; 6-3,R64,45,2,1,27,40,25,27,8,13,0,0,8,33,40,4,6,28,47,16,28,7,19,3,7,7,23,47
2003-10-27 00:00:00.000,ATP Masters Series Paris France ATP World Tour,HARD,2,Roger Federer,N/A Bye,Roger Federer,,R64,0,0,0,0,0,0,0,0,0,0,0,0,0,0,0,0,0,0,0,0,0,0,0,0,0,0,0
2003-10-27 00:00:00.000,ATP Masters Series Paris France ATP World Tour,HARD,2,Nicolas Lapentti,N/A Bye,Nicolas Lapentti,,R64,0,0,0,0,0,0,0,0,0,0,0,0,0,0,0,0,0,0,0,0,0,0,0,0,0,0,0
2003-10-27 00:00:00.000,ATP Masters Series Paris France ATP World Tour,HARD,2,Jonas Bjorkman,Agustin Calleri,Jonas Bjorkman,6-4; 7-6(5),R64,91,7,2,42,70,34,42,16,28,3,4,11,50,70,9,2,33,67,26,33,17,34,0,2,11,43,67
2003-10-27 00:00:00.000,ATP Masters Series Paris France ATP World Tour,HARD,2,Gregory Carraz,Radek Stepanek,Gregory Carraz,2-6; 6-2; 7-6(3),R64,131,20,11,68,115,48,68,24,47,8,10,14,72,115,7,4,46,92,33,46,25,46,4,6,14,58,92
2003-10-27 00:00:00.000,ATP Masters Series Paris France ATP World Tour,HARD,2,Sjeng Schalken,N/A Bye,Sjeng Schalken,,R64,0,0,0,0,0,0,0,0,0,0,0,0,0,0,0,0,0,0,0,0,0,0,0,0,0,0,0
2003-10-27 00:00:00.000,ATP Masters Series Paris France ATP World Tour,HARD,2,Tommy Robredo,N/A Bye,Tommy Robredo,,R64,0,0,0,0,0,0,0,0,0,0,0,0,0,0,0,0,0,0,0,0,0,0,0,0,0,0,0
2003-10-27 00:00:00.000,ATP Masters Series Paris France ATP World Tour,HARD,2,Gaston Gaudio,Richard Gasquet,Gaston Gaudio,1-6; 7-6(11); 6-4,R64,106,1,4,56,81,45,56,15,25,2,5,14,60,81,18,6,61,100,47,61,20,39,0,2,15,67,100
2003-10-27 00:00:00.000,ATP Masters Series Paris France ATP World Tour,HARD,2,Victor Hanescu,Wayne Ferreira,Victor Hanescu,2-6; 6-4; 6-4,R64,120,7,3,61,99,42,61,17,38,7,10,14,59,99,7,0,63,107,45,63,19,44,11,14,14,64,107
2003-10-27 00:00:00.000,ATP Masters Series Paris France ATP World Tour,HARD,2,Andy Roddick,N/A Bye,Andy Roddick,,R64,0,0,0,0,0,0,0,0,0,0,0,0,0,0,0,0,0,0,0,0,0,0,0,0,0,0,0
2003-10-27 00:00:00.000,ATP Masters Series Paris France ATP World Tour,HARD,2,Juan Carlos Ferrero,Nicolas Mahut,Juan Carlos Ferrero,7-6(7); 6-4,R32,89,11,4,49,74,38,49,13,25,2,3,11,51,74,7,3,36,67,30,36,15,31,1,3,11,45,67
2003-10-27 00:00:00.000,ATP Masters Series Paris France ATP World Tour,HARD,2,Jiri Novak,Fabrice Santoro,Jiri Novak,6-4; 4-6; 6-0,R32,103,5,3,60,88,41,60,15,28,5,7,13,56,88,3,1,51,86,33,51,15,35,9,14,13,48,86
2003-10-27 00:00:00.000,ATP Masters Series Paris France ATP World Tour,HARD,2,Hicham Arazi,Younes El Aynaoui,Hicham Arazi,4-6; 6-3; 1-2 RET,R32,77,2,0,36,62,28,36,16,26,1,2,11,44,62,9,1,35,60,28,35,15,25,1,2,11,43,60
2003-10-27 00:00:00.000,ATP Masters Series Paris France ATP World Tour,HARD,2,Paradorn Srichaphan,Karol Beck,Paradorn Srichaphan,7-6(4); 6-3,R32,72,7,5,35,66,30,35,18,31,2,3,11,48,66,7,0,36,62,27,36,13,26,1,3,10,40,62
2003-10-27 00:00:00.000,ATP Masters Series Paris France ATP World Tour,HARD,2,Guillermo Coria,Feliciano Lopez,Guillermo Coria,6-3; 3-6; 6-3,R32,83,10,1,48,70,40,48,13,22,1,2,14,53,70,12,2,51,72,38,51,11,21,3,5,13,49,72
2003-10-27 00:00:00.000,ATP Masters Series Paris France ATP World Tour,HARD,2,Andrei Pavel,Felix Mantilla,Andrei Pavel,7-5; 7-6(6),R32,94,6,2,40,71,30,40,20,31,1,3,12,50,71,6,5,41,88,29,41,24,47,6,9,12,53,88
2003-10-27 00:00:00.000,ATP Masters Series Paris France ATP World Tour,HARD,2,Nicolas Massu,Albert Costa,Nicolas Massu,3-6; 6-1; 7-5,R32,129,8,3,40,80,30,40,23,40,1,3,14,53,80,10,2,45,83,33,45,18,38,8,12,14,51,83
2003-10-27 00:00:00.000,ATP Masters Series Paris France ATP World Tour,HARD,2,Rainer Schuettler,James Blake,Rainer Schuettler,4-6; 6-2; 6-3,R32,93,8,5,52,86,39,52,11,34,6,11,14,50,86,4,3,37,68,20,37,14,31,2,9,13,34,68
2003-10-27 00:00:00.000,ATP Masters Series Paris France ATP World Tour,HARD,2,Tim Henman,Sebastien Grosjean,Tim Henman,3-6; 6-4; 7-5,R32,142,1,5,55,92,37,55,20,37,3,7,15,57,92,5,3,40,101,26,40,31,61,3,8,16,57,101
2003-10-27 00:00:00.000,ATP Masters Series Paris France ATP World Tour,HARD,2,Gustavo Kuerten,Mark Philippoussis,Gustavo Kuerten,6-7(5); 7-6(11); 7-6(1),R32,126,19,3,68,112,61,68,29,44,0,0,18,90,112,31,8,71,111,64,71,22,40,0,0,18,86,111
2003-10-27 00:00:00.000,ATP Masters Series Paris France ATP World Tour,HARD,2,Martin Verkerk,Dominik Hrbaty,Martin Verkerk,7-6(3); 6-4,R32,87,15,3,40,74,34,40,20,34,2,2,11,54,74,7,2,38,72,32,38,18,34,1,2,11,50,72
2003-10-27 00:00:00.000,ATP Masters Series Paris France ATP World Tour,HARD,2,Roger Federer,Thierry Ascione,Roger Federer,7-6(5); 6-1,R32,60,6,2,38,61,27,38,18,23,0,0,10,45,61,1,0,32,51,23,32,10,19,0,2,9,33,51
2003-10-27 00:00:00.000,ATP Masters Series Paris France ATP World Tour,HARD,2,Jonas Bjorkman,Nicolas Lapentti,Jonas Bjorkman,6-4; 6-1,R32,68,2,1,32,47,29,32,6,15,1,1,8,35,47,6,5,43,70,29,43,8,27,2,6,9,37,70
2003-10-27 00:00:00.000,ATP Masters Series Paris France ATP World Tour,HARD,2,Gregory Carraz,Sjeng Schalken,Gregory Carraz,6-4; 2-6; 6-3,R32,115,16,15,56,94,46,56,12,38,9,11,13,58,94,1,4,70,97,40,70,18,27,8,11,14,58,97
2003-10-27 00:00:00.000,ATP Masters Series Paris France ATP World Tour,HARD,2,Tommy Robredo,Gaston Gaudio,Tommy Robredo,7-5; 6-3,R32,88,9,5,42,71,33,42,15,29,3,4,11,48,71,2,2,51,74,29,51,12,23,4,7,10,41,74
2003-10-27 00:00:00.000,ATP Masters Series Paris France ATP World Tour,HARD,2,Andy Roddick,Victor Hanescu,Andy Roddick,7-6(4); 7-6(4),R32,87,8,2,39,72,33,39,23,33,0,1,12,56,72,9,0,52,74,45,52,10,22,0,1,12,55,74
2003-10-27 00:00:00.000,ATP Masters Series Paris France ATP World Tour,HARD,2,Jiri Novak,Juan Carlos Ferrero,Jiri Novak,7-5; 7-5,R16,94,10,0,52,76,39,52,15,24,2,3,12,54,76,2,2,39,75,30,39,16,36,2,5,12,46,75
2003-10-27 00:00:00.000,ATP Masters Series Paris France ATP World Tour,HARD,2,Hicham Arazi,Paradorn Srichaphan,Hicham Arazi,7-6(3); 6-3,R16,76,3,0,35,63,28,35,16,28,0,1,11,44,63,6,2,23,56,20,23,17,33,1,3,10,37,56
2003-10-27 00:00:00.000,ATP Masters Series Paris France ATP World Tour,HARD,2,Andrei Pavel,Guillermo Coria,Andrei Pavel,W/O,R16,0,0,0,0,0,0,0,0,0,0,0,0,0,0,0,0,0,0,0,0,0,0,0,0,0,0,0
2003-10-27 00:00:00.000,ATP Masters Series Paris France ATP World Tour,HARD,2,Rainer Schuettler,Nicolas Massu,Rainer Schuettler,6-4; 7-5,R16,104,1,5,38,73,26,38,19,35,8,11,11,45,73,5,5,50,78,28,50,12,28,3,8,11,40,78
2003-10-27 00:00:00.000,ATP Masters Series Paris France ATP World Tour,HARD,2,Tim Henman,Gustavo Kuerten,Tim Henman,6-4; 6-2,R16,75,6,4,35,59,28,35,14,24,6,6,9,42,59,4,2,43,68,26,43,11,25,4,7,9,37,68
2003-10-27 00:00:00.000,ATP Masters Series Paris France ATP World Tour,HARD,2,Roger Federer,Martin Verkerk,Roger Federer,6-7(3); 7-6(12); 7-6(6),R16,146,16,3,71,113,64,71,26,42,0,1,18,90,113,24,12,72,129,64,72,29,57,3,4,18,93,129
2003-10-27 00:00:00.000,ATP Masters Series Paris France ATP World Tour,HARD,2,Jonas Bjorkman,Gregory Carraz,Jonas Bjorkman,6-3; 7-6(7),R16,87,6,3,50,74,35,50,15,24,1,1,11,50,74,12,2,38,63,29,38,13,25,0,1,10,42,63
2003-10-27 00:00:00.000,ATP Masters Series Paris France ATP World Tour,HARD,2,Andy Roddick,Tommy Robredo,Andy Roddick,6-3; 6-4,R16,62,13,2,35,59,30,35,13,24,1,1,10,43,59,1,3,33,54,26,33,9,21,3,5,9,35,54
2003-10-27 00:00:00.000,ATP Masters Series Paris France ATP World Tour,HARD,2,Jiri Novak,Hicham Arazi,Jiri Novak,6-2; 6-1,Q,62,5,3,36,61,28,36,13,25,5,5,8,41,61,1,1,21,41,12,21,7,20,2,6,7,19,41
2003-10-27 00:00:00.000,ATP Masters Series Paris France ATP World Tour,HARD,2,Andrei Pavel,Rainer Schuettler,Andrei Pavel,2-6; 6-3; 6-2,Q,113,2,3,53,96,37,53,22,43,10,12,12,59,96,5,5,36,77,30,36,15,41,5,9,13,45,77
2003-10-27 00:00:00.000,ATP Masters Series Paris France ATP World Tour,HARD,2,Tim Henman,Roger Federer,Tim Henman,7-6(5); 6-1,Q,79,4,3,37,68,29,37,18,31,2,2,10,47,68,3,2,30,54,22,30,11,24,0,2,9,33,54
2003-10-27 00:00:00.000,ATP Masters Series Paris France ATP World Tour,HARD,2,Andy Roddick,Jonas Bjorkman,Andy Roddick,7-5; 7-6(0),Q,86,19,2,40,67,38,40,16,27,0,0,12,54,67,5,2,40,67,30,40,16,27,1,2,12,46,67
2003-10-27 00:00:00.000,ATP Masters Series Paris France ATP World Tour,HARD,2,Andrei Pavel,Jiri Novak,Andrei Pavel,6-2; 4-6; 6-4,S,116,5,5,56,100,40,56,20,44,6,9,14,60,100,2,3,48,82,31,48,16,34,4,9,14,47,82
2003-10-27 00:00:00.000,ATP Masters Series Paris France ATP World Tour,HARD,2,Tim Henman,Andy Roddick,Tim Henman,7-6(4); 7-6(7),S,121,5,4,59,90,47,59,14,31,4,5,12,61,90,10,1,51,89,36,51,20,38,2,3,12,56,89
2003-10-27 00:00:00.000,ATP Masters Series Paris France ATP World Tour,HARD,2,Tim Henman,Andrei Pavel,Tim Henman,6-2; 7-6(6); 7-6(2),F,146,8,4,66,102,60,66,17,36,2,3,16,77,102,7,3,64,99,46,64,19,35,1,4,16,65,99
